00,000,00,000,0000,0,10284454,335176,10619630,13897056,20852481,420,228,341,79,185,43,66.64,76.42,54.29
01,000,00,000,0000,0,1330739,51646,1382385,1807897,2623439,50,27,42,8,23,4,68.91 ,76.46 ,54.00 
02,000,00,000,0000,0,707065,22034,729099,934369,1417881,29,15,24,5,12,3,65.90 ,78.03 ,51.72 
03,001,00,000,0000,0,1572400,56309,1628709,2116627,3268563,59,33,49,10,28,5,64.76 ,76.95 ,55.93 
03,002,00,000,0000,0,221424,5220,226644,305335,453773,8,5,5,3,3,2,67.29 ,74.23 ,62.50 
03,003,00,000,0000,0,723056,24362,747418,953883,1414652,28,16,24,4,15,1,67.43 ,78.36 ,57.14 
03,004,00,000,0000,0,201565,5901,207466,259188,392139,8,5,5,3,3,2,66.10 ,80.04 ,62.50 
03,005,00,000,0000,0,279816,9179,288995,368940,551271,13,6,11,2,4,2,66.93 ,78.33 ,46.15 
03,006,00,000,0000,0,686929,21717,708646,882151,1388676,25,14,19,6,10,4,63.52 ,80.33 ,56.00 
03,007,00,000,0000,0,617662,27829,645491,834434,1284195,25,13,20,5,9,4,64.98 ,77.36 ,52.00 
03,008,00,000,0000,0,257562,7709,265271,354246,521665,11,6,9,2,5,1,67.91 ,74.88 ,54.55 
03,009,00,000,0000,0,349169,12154,361323,517484,753850,16,8,13,3,7,1,68.65 ,69.82 ,50.00 
03,010,00,000,0000,0,264888,9535,274423,391771,560830,10,6,6,4,4,2,69.86 ,70.05 ,60.00 
03,011,00,000,0000,0,537586,15469,553055,735331,1077177,18,11,14,4,9,2,68.26 ,75.21 ,61.11 
03,012,00,000,0000,0,600600,18578,619178,790585,1177578,26,12,23,3,10,2,67.14 ,78.32 ,46.15 
03,013,00,000,0000,0,431385,8393,439778,585772,860472,16,10,14,2,8,2,68.08 ,75.08 ,62.50 
03,014,00,000,0000,0,77414,1608,79022,122114,174404,5,3,4,1,2,1,70.02 ,64.71 ,60.00 
03,015,00,000,0000,0,126809,3850,130659,189412,274691,7,4,7,0,4,0,68.95 ,68.98 ,57.14 
03,016,00,000,0000,0,39701,1222,40923,63104,91236,4,2,3,1,2,0,69.17 ,64.85 ,50.00 
03,017,00,000,0000,0,185787,5744,191531,248554,362500,7,4,4,3,3,1,68.57 ,77.06 ,57.14 
03,018,00,000,0000,0,172296,2854,175150,223899,338751,9,4,8,1,4,0,66.10 ,78.23 ,44.44 
03,019,00,000,0000,0,407286,10182,417468,542764,845551,15,9,11,4,8,1,64.19 ,76.92 ,60.00 
03,020,00,000,0000,0,125865,3002,128867,173063,261262,7,3,6,1,2,1,66.24 ,74.46 ,42.86 
03,021,00,000,0000,0,344586,9983,354569,462166,704910,15,8,12,3,6,2,65.56 ,76.72 ,53.33 
03,022,00,000,0000,0,20275,663,20938,30173,47237,5,2,4,1,2,0,63.88 ,69.39 ,40.00 
03,023,00,000,0000,0,2589,33,2622,3794,5778,4,2,4,0,2,0,65.66 ,69.11 ,50.00 
01,000,01,000,0000,0,456603,18678,475281,618917,878395,17,9,15,2,7,2,70.46 ,76.79 ,52.94 
01,000,02,000,0000,0,399078,15665,414743,534664,794710,16,8,14,2,8,0,67.28 ,77.57 ,50.00 
01,000,03,000,0000,0,475058,17303,492361,654316,950334,17,10,13,4,8,2,68.85 ,75.25 ,58.82 
02,000,01,000,0000,0,387202,11809,399011,508901,766201,15,8,13,2,7,1,66.42 ,78.41 ,53.33 
02,000,02,000,0000,0,319863,10225,330088,425468,651680,14,7,11,3,5,2,65.29 ,77.58 ,50.00 
03,001,01,000,0000,0,211394,6417,217811,281630,454336,9,5,8,1,4,1,61.99 ,77.34 ,55.56 
03,001,02,000,0000,0,247908,8755,256663,334033,529067,9,5,7,2,4,1,63.14 ,76.84 ,55.56 
03,001,03,000,0000,0,255569,9464,265033,341528,537420,9,5,7,2,4,1,63.55 ,77.60 ,55.56 
03,001,04,000,0000,0,220382,8340,228722,296988,489174,10,5,7,3,4,1,60.71 ,77.01 ,50.00 
03,001,05,000,0000,0,309071,10591,319662,415093,616446,10,6,9,1,6,0,67.34 ,77.01 ,60.00 
03,001,06,000,0000,0,143048,4711,147759,196659,280248,5,3,4,1,2,1,70.17 ,75.13 ,60.00 
03,001,07,000,0000,0,185028,8031,193059,250696,361872,7,4,7,0,4,0,69.28 ,77.01 ,57.14 
03,002,01,000,0000,0,109130,2430,111560,150080,223797,4,2,3,1,2,0,67.06 ,74.33 ,50.00 
03,002,02,000,0000,0,112294,2790,115084,155255,229976,4,3,2,2,1,2,67.51 ,74.13 ,75.00 
03,003,01,000,0000,0,126028,4751,130779,167178,269240,5,3,5,0,3,0,62.09 ,78.23 ,60.00 
03,003,02,000,0000,0,145941,4951,150892,192716,301097,6,3,5,1,3,0,64.00 ,78.30 ,50.00 
03,003,03,000,0000,0,158033,5755,163788,212577,242071,6,4,6,0,4,0,87.82 ,77.05 ,66.67 
03,003,04,000,0000,0,117069,3422,120491,151683,235105,4,2,3,1,2,0,64.52 ,79.44 ,50.00 
03,003,05,000,0000,0,175985,5483,181468,229729,367139,7,4,5,2,3,1,62.57 ,78.99 ,57.14 
03,004,01,000,0000,0,201565,5901,207466,259188,392139,8,5,5,3,3,2,66.10 ,80.04 ,62.50 
03,005,01,000,0000,0,176305,6338,182643,235738,353157,9,4,7,2,2,2,66.75 ,77.48 ,44.44 
03,005,02,000,0000,0,103511,2841,106352,133202,198114,4,2,4,0,2,0,67.24 ,79.84 ,50.00 
03,006,01,000,0000,0,236079,6615,242694,303270,470286,7,5,4,3,3,2,64.49 ,80.03 ,71.43 
03,006,02,000,0000,0,92943,3630,96573,116526,180125,5,2,5,0,2,0,64.69 ,82.88 ,40.00 
03,006,03,000,0000,0,184299,4894,189193,231606,367996,6,3,4,2,1,2,62.94 ,81.69 ,50.00 
03,006,04,000,0000,0,173608,6578,180186,230749,370269,7,4,6,1,4,0,62.32 ,78.09 ,57.14 
03,007,01,000,0000,0,203665,8136,211801,267944,423559,9,4,6,3,1,3,63.26 ,79.05 ,44.44 
03,007,02,000,0000,0,134977,7896,142873,183770,286683,4,3,3,1,2,1,64.10 ,77.75 ,75.00 
03,007,03,000,0000,0,151281,6483,157764,200397,308058,7,3,6,1,3,0,65.05 ,78.73 ,42.86 
03,007,04,000,0000,0,127739,5314,133053,182323,265895,5,3,5,0,3,0,68.57 ,72.98 ,60.00 
03,008,01,000,0000,0,135337,3682,139019,186166,273768,6,3,4,2,2,1,68.00 ,74.67 ,50.00 
03,008,02,000,0000,0,122225,4027,126252,168080,247897,5,3,5,0,3,0,67.80 ,75.11 ,60.00 
03,009,01,000,0000,0,181485,5678,187163,252339,371778,10,4,7,3,3,1,67.87 ,74.17 ,40.00 
03,009,02,000,0000,0,167684,6476,174160,265145,382072,6,4,6,0,4,0,69.40 ,65.68 ,66.67 
03,010,01,000,0000,0,137635,5368,143003,201919,293113,4,3,2,2,1,2,68.89 ,70.82 ,75.00 
03,010,02,000,0000,0,127253,4167,131420,189852,267717,6,3,4,2,3,0,70.92 ,69.22 ,50.00 
03,011,01,000,0000,0,268705,8008,276713,377034,538855,9,6,8,1,5,1,69.97 ,73.39 ,66.67 
03,011,02,000,0000,0,268881,7461,276342,358297,538322,9,5,6,3,4,1,66.56 ,77.13 ,55.56 
03,012,01,000,0000,0,148502,4708,153210,197984,300025,6,3,6,0,3,0,65.99 ,77.39 ,50.00 
03,012,02,000,0000,0,167168,5094,172262,220535,330388,7,3,6,1,3,0,66.75 ,78.11 ,42.86 
03,012,03,000,0000,0,201617,7163,208780,259897,384710,9,4,9,0,4,0,67.56 ,80.33 ,44.44 
03,012,04,000,0000,0,83313,1613,84926,112169,162455,4,2,2,2,0,2,69.05 ,75.71 ,50.00 
03,013,01,000,0000,0,242762,4641,247403,323957,471524,8,5,7,1,4,1,68.70 ,76.37 ,62.50 
03,013,02,000,0000,0,188623,3752,192375,261815,388948,8,5,7,1,4,1,67.31 ,73.48 ,62.50 
03,014,01,000,0000,0,77414,1608,79022,122114,174404,5,3,4,1,2,1,70.02 ,64.71 ,60.00 
03,015,01,000,0000,0,126809,3850,130659,189412,274691,7,4,7,0,4,0,68.95 ,68.98 ,57.14 
03,016,01,000,0000,0,39701,1222,40923,63104,91236,4,2,3,1,2,0,69.17 ,64.85 ,50.00 
03,017,01,000,0000,0,185787,5744,191531,248554,362500,7,4,4,3,3,1,68.57 ,77.06 ,57.14 
03,018,01,000,0000,0,172296,2854,175150,223899,338751,9,4,8,1,4,0,66.10 ,78.23 ,44.44 
03,019,01,000,0000,0,206364,6173,212537,279711,432532,8,5,5,3,5,0,64.67 ,75.98 ,62.50 
03,019,02,000,0000,0,200922,4009,204931,263053,413019,7,4,6,1,3,1,63.69 ,77.90 ,57.14 
03,020,01,000,0000,0,125865,3002,128867,173063,261262,7,3,6,1,2,1,66.24 ,74.46 ,42.86 
03,021,01,000,0000,0,189966,5546,195512,256023,387743,6,4,5,1,3,1,66.03 ,76.37 ,66.67 
03,021,02,000,0000,0,154620,4437,159057,206143,317167,9,4,7,2,3,1,65.00 ,77.16 ,44.44 
03,022,01,000,0000,0,20275,663,20938,30173,47237,5,2,4,1,2,0,63.88 ,69.39 ,40.00 
03,023,01,000,0000,0,2589,33,2622,3794,5778,4,2,4,0,2,0,65.66 ,69.11 ,50.00 
01,000,01,001,0000,0,109370,4772,114142,157057,5718,2,1,2,0,1,0,69.85 ,72.68 ,50.00 
01,000,01,002,0000,0,69998,2898,72896,93344,5825,4,1,4,0,1,0,66.20 ,78.09 ,25.00 
01,000,01,003,0000,0,152390,5748,158138,203841,334927,5,1,5,0,1,0,67.16 ,77.58 ,20.00 
01,000,01,004,0000,0,124845,5260,130105,164675,328121,3,1,3,0,1,0,68.43 ,79.01 ,33.33 
01,000,02,005,0000,0,104416,3927,108343,145659,83519,3,1,3,0,1,0,68.66 ,74.38 ,33.33 
01,000,02,006,0000,0,126286,5039,131325,170451,130732,5,1,5,0,1,0,67.09 ,77.05 ,20.00 
01,000,02,007,0000,0,56856,2335,59191,73897,101290,4,1,4,0,1,0,65.74 ,80.10 ,25.00 
01,000,02,008,0000,0,111520,4364,115884,144657,77736,4,1,4,0,1,0,66.33 ,80.11 ,25.00 
01,000,03,009,0000,0,161611,5946,167557,231876,114604,2,1,2,0,1,0,69.35 ,72.26 ,50.00 
01,000,03,010,0000,0,84595,3087,87682,115892,165779,3,1,3,0,1,0,68.23 ,75.66 ,33.33 
01,000,03,011,0000,0,111640,4305,115945,150507,106433,3,1,3,0,1,0,67.45 ,77.04 ,33.33 
01,000,03,012,0000,0,117212,3965,121177,156041,193621,5,1,3,2,0,1,66.39 ,77.66 ,20.00 
02,000,01,001,0000,0,17932,509,18441,23626,49075,2,1,2,0,1,0,70.19 ,78.05 ,50.00 
02,000,01,002,0000,0,56786,1562,58348,74611,53643,2,1,2,0,1,0,68.58 ,78.20 ,50.00 
02,000,01,003,0000,0,65332,1918,67250,85152,11251,4,1,4,0,1,0,69.74 ,78.98 ,25.00 
02,000,01,004,0000,0,68162,2024,70186,87944,91747,2,1,2,0,1,0,66.83 ,79.81 ,50.00 
02,000,01,005,0000,0,162746,5232,167978,215198,88834,2,1,2,0,1,0,68.07 ,78.06 ,50.00 
02,000,01,006,0000,0,16244,564,16808,22370,36708,2,1,2,0,1,0,71.22 ,75.14 ,50.00 
02,000,02,007,0000,0,33663,1039,34702,44568,32559,3,1,3,0,1,0,71.94 ,77.86 ,33.33 
02,000,02,008,0000,0,19160,541,19701,25572,67960,2,1,2,0,1,0,67.16 ,77.04 ,50.00 
02,000,02,009,0000,0,105554,3606,109160,140313,46718,2,1,2,0,1,0,65.94 ,77.80 ,50.00 
02,000,02,010,0000,0,98128,3064,101192,130811,20852,2,1,2,0,1,0,69.78 ,77.36 ,50.00 
02,000,02,011,0000,0,63358,1975,65333,84204,15045,2,1,2,0,1,0,73.01 ,77.59 ,50.00 
03,001,01,001,0000,0,61217,1690,62907,80359,10541,1,1,1,0,1,0,71.95 ,78.28 ,100.00 
03,001,01,002,0000,0,33155,1053,34208,43184,12945,2,1,2,0,1,0,70.78 ,79.21 ,50.00 
03,001,01,003,0000,0,33334,1012,34346,44836,6393,2,1,2,0,1,0,76.16 ,76.60 ,50.00 
03,001,01,004,0000,0,83688,2662,86350,113251,8186,4,1,4,0,1,0,67.54 ,76.25 ,25.00 
03,001,02,005,0000,0,247908,8755,256663,334033,4828,3,1,3,0,1,0,73.34 ,76.84 ,33.33 
03,001,03,006,0000,0,182974,6827,189801,244603,91005,4,1,3,1,1,0,70.63 ,77.60 ,25.00 
03,001,03,007,0000,0,61727,2223,63950,82555,49329,2,1,1,1,1,0,70.11 ,77.46 ,50.00 
03,001,03,008,0000,0,10868,414,11282,14370,41216,2,1,2,0,1,0,71.88 ,78.51 ,50.00 
03,001,04,009,0000,0,147186,5901,153087,200236,70035,4,1,4,0,1,0,68.51 ,76.45 ,25.00 
03,001,04,010,0000,0,26672,713,27385,35196,89256,3,1,3,0,1,0,68.26 ,77.81 ,33.33 
03,001,04,011,0000,0,27549,938,28487,35857,42310,2,1,2,0,1,0,71.77 ,79.45 ,50.00 
03,001,04,012,0000,0,18975,788,19763,25699,19568,2,1,2,0,1,0,72.67 ,76.90 ,50.00 
03,001,05,013,0000,0,191374,6829,198203,258114,17181,4,1,3,1,1,0,73.40 ,76.79 ,25.00 
03,001,05,014,0000,0,117697,3762,121459,156979,34851,1,1,1,0,1,0,69.78 ,77.37 ,100.00 
03,001,06,015,0000,0,125958,3988,129946,172907,20704,2,1,1,1,1,0,71.69 ,75.15 ,50.00 
03,001,06,016,0000,0,8739,383,9122,11764,12179,6,1,5,1,1,0,75.89 ,77.54 ,16.67 
03,001,06,017,0000,0,4305,147,4452,5966,12305,3,1,2,1,0,1,73.30 ,74.62 ,33.33 
03,001,06,018,0000,0,3026,159,3185,4623,18061,3,1,3,0,1,0,69.87 ,68.89 ,33.33 
03,001,06,019,0000,0,1020,34,1054,1399,8579,2,1,1,1,1,0,75.91 ,75.34 ,50.00 
03,001,07,020,0000,0,48091,2823,50914,63957,14300,3,1,3,0,1,0,71.19 ,79.61 ,33.33 
03,001,07,021,0000,0,59062,2236,61298,79636,7765,4,1,4,0,1,0,73.78 ,76.97 ,25.00 
03,001,07,022,0000,0,25970,885,26855,36275,5439,2,1,2,0,1,0,79.94 ,74.03 ,50.00 
03,001,07,023,0000,0,10405,689,11094,12946,5496,2,1,0,2,0,1,76.06 ,85.69 ,50.00 
03,001,07,024,0000,0,5524,210,5734,7053,161524,3,1,3,0,1,0,68.05 ,81.30 ,33.33 
03,001,07,025,0000,0,3468,125,3593,5100,57499,5,1,4,1,1,0,72.08 ,70.45 ,20.00 
03,001,07,026,0000,0,5908,114,6022,8347,78470,3,1,3,0,1,0,66.87 ,72.15 ,33.33 
03,001,07,027,0000,0,6826,229,7055,10348,84966,4,1,4,0,1,0,69.15 ,68.18 ,25.00 
03,001,07,028,0000,0,9952,359,10311,13439,73004,5,1,4,1,0,1,67.70 ,76.72 ,20.00 
03,001,07,029,0000,0,9822,361,10183,13595,50479,4,1,3,1,1,0,67.12 ,74.90 ,25.00 
03,002,01,001,0000,0,44284,1028,45312,59681,55327,2,1,2,0,1,0,70.21 ,75.92 ,50.00 
03,002,01,002,0000,0,16671,330,17001,23171,62586,4,1,4,0,1,0,68.18 ,73.37 ,25.00 
03,002,01,003,0000,0,18984,382,19366,25838,90365,3,1,3,0,1,0,67.47 ,74.95 ,33.33 
03,002,01,004,0000,0,12505,292,12797,17585,81805,2,1,2,0,1,0,64.97 ,72.77 ,50.00 
03,002,01,005,0000,0,16070,385,16455,22849,26642,4,1,4,0,1,0,73.20 ,72.02 ,25.00 
03,002,01,006,0000,0,616,13,629,956,15211,3,1,2,1,1,0,73.45 ,65.79 ,33.33 
03,002,02,007,0000,0,32183,764,32947,43238,31463,3,1,3,0,1,0,68.81 ,76.20 ,33.33 
03,002,02,008,0000,0,23863,573,24436,33586,21391,2,1,1,1,1,0,70.53 ,72.76 ,50.00 
03,002,02,009,0000,0,25316,661,25977,34921,21391,2,1,1,1,1,0,70.53 ,74.39 ,50.00 
03,002,02,010,0000,0,19282,447,19729,26347,21391,2,1,1,1,1,0,70.53 ,74.88 ,50.00 
03,002,02,011,0000,0,11098,326,11424,16267,21391,2,1,1,1,1,0,70.53 ,70.23 ,50.00 
03,002,02,012,0000,0,552,19,571,896,21391,2,1,1,1,1,0,70.53 ,63.73 ,50.00 
03,003,01,001,0000,0,126028,4751,130779,167178,21391,2,1,1,1,1,0,70.53 ,78.23 ,50.00 
03,003,02,002,0000,0,145941,4951,150892,192716,21391,2,1,1,1,1,0,70.53 ,78.30 ,50.00 
03,003,03,003,0000,0,39471,1200,40671,51448,21391,2,1,1,1,1,0,70.53 ,79.05 ,50.00 
03,003,03,004,0000,0,48027,1721,49748,66021,21391,2,1,1,1,1,0,70.53 ,75.35 ,50.00 
03,003,03,005,0000,0,68748,2768,71516,92420,21391,2,1,1,1,1,0,70.53 ,77.38 ,50.00 
03,003,03,006,0000,0,1787,66,1853,2688,21391,2,1,1,1,1,0,70.53 ,68.94 ,50.00 
03,003,04,007,0000,0,33762,1136,34898,43141,21391,2,1,1,1,1,0,70.53 ,80.89 ,50.00 
03,003,04,008,0000,0,33745,882,34627,43234,21391,2,1,1,1,1,0,70.53 ,80.09 ,50.00 
03,003,04,009,0000,0,24854,760,25614,32632,21391,2,1,1,1,1,0,70.53 ,78.49 ,50.00 
03,003,04,010,0000,0,24708,644,25352,32676,64870,3,1,3,0,1,0,68.56 ,77.59 ,33.33 
03,003,05,011,0000,0,53055,1529,54584,69078,54724,3,1,3,0,1,0,68.03 ,79.02 ,33.33 
03,003,05,012,0000,0,44165,1153,45318,57057,66909,3,1,3,0,1,0,67.07 ,79.43 ,33.33 
03,003,05,013,0000,0,78765,2801,81566,103594,65951,4,1,4,0,1,0,69.35 ,78.74 ,25.00 
03,004,01,001,0000,0,37019,1265,38284,48272,167530,2,1,2,0,1,0,67.30 ,79.31 ,50.00 
03,004,01,002,0000,0,41239,1207,42446,52661,176314,5,1,5,0,1,0,66.13 ,80.60 ,20.00 
03,004,01,003,0000,0,19156,659,19815,24475,11140,3,1,3,0,1,0,77.24 ,80.96 ,33.33 
03,004,01,004,0000,0,17588,482,18070,22520,230816,4,1,4,0,1,0,68.37 ,80.24 ,25.00 
03,004,01,005,0000,0,30380,895,31275,38952,83734,4,1,3,1,1,0,68.19 ,80.29 ,25.00 
03,004,01,006,0000,0,19830,460,20290,25900,86753,2,1,2,0,1,0,68.39 ,78.34 ,50.00 
03,004,01,007,0000,0,10230,251,10481,12838,16836,2,1,2,0,1,0,68.89 ,81.64 ,50.00 
03,004,01,008,0000,0,8761,226,8987,11072,34322,3,1,3,0,1,0,67.06 ,81.17 ,33.33 
03,004,01,009,0000,0,5971,158,6129,7587,48495,3,1,3,0,1,0,68.50 ,80.78 ,33.33 
03,004,01,010,0000,0,6550,180,6730,8417,37827,2,1,2,0,1,0,68.23 ,79.96 ,50.00 
03,004,01,011,0000,0,3824,76,3900,5000,45952,4,1,4,0,1,0,69.40 ,78.00 ,25.00 
03,004,01,012,0000,0,779,23,802,1090,26578,3,1,2,1,0,1,72.11 ,73.58 ,33.33 
03,004,01,013,0000,0,238,19,257,404,126723,5,1,5,0,1,0,68.05 ,63.61 ,20.00 
03,005,01,001,0000,0,44715,1789,46504,59421,55784,2,1,2,0,1,0,67.43 ,78.26 ,50.00 
03,005,01,002,0000,0,40646,1257,41903,53692,46614,3,1,3,0,1,0,71.85 ,78.04 ,33.33 
03,005,01,003,0000,0,10529,361,10890,13899,35495,2,1,2,0,1,0,70.96 ,78.35 ,50.00 
03,005,01,004,0000,0,9247,360,9607,13054,35600,3,1,3,0,1,0,70.87 ,73.59 ,33.33 
03,005,01,005,0000,0,17414,579,17993,23113,34697,2,1,2,0,1,0,70.68 ,77.85 ,50.00 
03,005,01,006,0000,0,10626,401,11027,14378,40154,3,1,3,0,1,0,70.22 ,76.69 ,33.33 
03,005,01,007,0000,0,5984,178,6162,8331,45263,2,1,1,1,0,1,69.88 ,73.96 ,50.00 
03,005,01,008,0000,0,6776,247,7023,8836,18145,2,1,1,1,1,0,75.44 ,79.48 ,50.00 
03,005,01,009,0000,0,9130,419,9549,12022,33854,4,1,4,0,1,0,69.84 ,79.43 ,25.00 
03,005,01,010,0000,0,4905,169,5074,6976,56825,5,1,4,1,1,0,70.60 ,72.74 ,20.00 
03,005,01,011,0000,0,7699,242,7941,9974,29319,3,1,2,1,0,1,71.16 ,79.62 ,33.33 
03,005,01,012,0000,0,4561,139,4700,5990,32738,2,1,2,0,1,0,71.46 ,78.46 ,50.00 
03,005,01,013,0000,0,3099,150,3249,4526,38642,2,1,2,0,1,0,75.45 ,71.79 ,50.00 
03,005,01,014,0000,0,974,47,1021,1526,20980,3,1,2,1,1,0,78.43 ,66.91 ,33.33 
03,005,02,015,0000,0,25581,551,26132,32515,17118,2,1,2,0,1,0,75.44 ,80.37 ,50.00 
03,005,02,016,0000,0,22194,580,22774,28749,32659,3,1,3,0,1,0,73.46 ,79.22 ,33.33 
03,005,02,017,0000,0,33317,1043,34360,41959,104631,4,1,4,0,1,0,68.89 ,81.89 ,25.00 
03,005,02,018,0000,0,22419,667,23086,29979,87402,5,1,3,2,0,1,71.85 ,77.01 ,20.00 
03,006,01,001,0000,0,78245,2198,80443,99985,97966,2,1,2,0,1,0,70.06 ,80.46 ,50.00 
03,006,01,002,0000,0,31452,750,32202,40943,61192,3,1,3,0,1,0,72.17 ,78.65 ,33.33 
03,006,01,003,0000,0,29182,837,30019,36983,12240,2,1,2,0,1,0,74.61 ,81.17 ,50.00 
03,006,01,004,0000,0,37560,986,38546,47739,42810,5,1,5,0,1,0,72.35 ,80.74 ,20.00 
03,006,01,005,0000,0,32264,1087,33351,41885,20608,1,1,1,0,1,0,74.58 ,79.63 ,100.00 
03,006,01,006,0000,0,14843,430,15273,19038,17572,4,1,4,0,1,0,76.49 ,80.22 ,25.00 
03,006,01,007,0000,0,8439,248,8687,10815,17693,3,1,3,0,1,0,76.07 ,80.32 ,33.33 
03,006,01,008,0000,0,4094,79,4173,5882,23461,2,1,2,0,1,0,74.03 ,70.95 ,50.00 
03,006,02,009,0000,0,37761,1573,39334,47845,22577,3,1,3,0,1,0,73.83 ,82.21 ,33.33 
03,006,02,010,0000,0,28545,1184,29729,35740,17743,4,1,4,0,1,0,66.35 ,83.18 ,25.00 
03,006,02,011,0000,0,15307,522,15829,18870,15347,4,1,3,1,1,0,70.05 ,83.88 ,25.00 
03,006,02,012,0000,0,11330,351,11681,14071,101349,4,1,4,0,1,0,69.21 ,83.01 ,25.00 
03,006,03,013,0000,0,42721,890,43611,53761,48353,2,1,2,0,1,0,71.10 ,81.12 ,50.00 
03,006,03,014,0000,0,34555,947,35502,43170,67502,3,1,3,0,1,0,71.68 ,82.24 ,33.33 
03,006,03,015,0000,0,23339,534,23873,28808,50269,3,1,2,1,0,1,71.34 ,82.87 ,33.33 
03,006,03,016,0000,0,30451,976,31427,38476,32084,1,1,1,0,1,0,73.21 ,81.68 ,100.00 
03,006,03,017,0000,0,25411,786,26197,31895,46369,2,1,1,1,1,0,72.82 ,82.14 ,50.00 
03,006,03,018,0000,0,27822,761,28583,35496,35730,3,1,2,1,0,1,73.57 ,80.52 ,33.33 
03,006,04,019,0000,0,33921,904,34825,42816,22895,4,1,4,0,1,0,74.21 ,81.34 ,25.00 
03,006,04,020,0000,0,68017,2769,70786,92262,31918,2,1,2,0,1,0,72.24 ,76.72 ,50.00 
03,006,04,021,0000,0,71670,2905,74575,95671,21129,4,1,3,1,1,0,71.26 ,77.95 ,25.00 
03,007,01,001,0000,0,105964,4605,110569,139943,32226,2,1,2,0,1,0,75.05 ,79.01 ,50.00 
03,007,01,002,0000,0,39570,1337,40907,51073,29407,2,1,2,0,1,0,74.15 ,80.10 ,50.00 
03,007,01,003,0000,0,8238,254,8492,10535,32268,5,1,5,0,1,0,72.71 ,80.61 ,20.00 
03,007,01,004,0000,0,14805,566,15371,19952,19176,4,1,4,0,1,0,75.44 ,77.04 ,25.00 
03,007,01,005,0000,0,21420,899,22319,28312,15445,4,1,4,0,1,0,73.00 ,78.83 ,25.00 
03,007,01,006,0000,0,13668,475,14143,18129,29075,2,1,2,0,1,0,75.10 ,78.01 ,50.00 
03,007,02,007,0000,0,37062,2623,39685,51463,31836,3,1,3,0,1,0,77.09 ,77.11 ,33.33 
03,007,02,008,0000,0,22446,949,23395,29890,29794,2,1,2,0,1,0,76.86 ,78.27 ,50.00 
03,007,02,009,0000,0,16825,1108,17933,22521,33118,3,1,3,0,1,0,73.90 ,79.63 ,33.33 
03,007,02,010,0000,0,24962,1275,26237,33994,32276,2,1,2,0,1,0,77.09 ,77.18 ,50.00 
03,007,02,011,0000,0,17506,903,18409,23588,33009,2,1,2,0,1,0,69.32 ,78.04 ,50.00 
03,007,02,012,0000,0,16176,1038,17214,22314,44400,2,1,1,1,0,1,71.47 ,77.14 ,50.00 
03,007,03,013,0000,0,59098,2655,61753,77985,33343,2,1,2,0,1,0,75.70 ,79.19 ,50.00 
03,007,03,014,0000,0,22847,1103,23950,31575,36174,2,1,1,1,1,0,73.25 ,75.85 ,50.00 
03,007,03,015,0000,0,17569,589,18158,22448,70848,2,1,2,0,1,0,70.32 ,80.89 ,50.00 
03,007,03,016,0000,0,19883,741,20624,25989,17792,3,1,3,0,1,0,75.83 ,79.36 ,33.33 
03,007,03,017,0000,0,21634,1066,22700,28778,36049,2,1,2,0,1,0,72.87 ,78.88 ,50.00 
03,007,03,018,0000,0,10250,329,10579,13622,28890,2,1,2,0,1,0,77.96 ,77.66 ,50.00 
03,007,04,019,0000,0,15527,793,16320,21271,29953,2,1,2,0,1,0,78.34 ,76.72 ,50.00 
03,007,04,020,0000,0,27576,1252,28828,38232,24141,2,1,2,0,1,0,76.76 ,75.40 ,50.00 
03,007,04,021,0000,0,14676,470,15146,19400,18181,3,1,3,0,1,0,77.42 ,78.07 ,33.33 
03,007,04,022,0000,0,15809,774,16583,22370,55364,3,1,2,1,1,0,73.18 ,74.13 ,33.33 
03,007,04,023,0000,0,18496,748,19244,28808,48329,3,1,3,0,1,0,71.48 ,66.80 ,33.33 
03,007,04,024,0000,0,10069,442,10511,16255,41241,2,1,2,0,1,0,72.61 ,64.66 ,50.00 
03,007,04,025,0000,0,8871,280,9151,12751,23360,2,1,2,0,1,0,73.52 ,71.77 ,50.00 
03,007,04,026,0000,0,16715,555,17270,23236,12046,1,1,1,0,1,0,73.88 ,74.32 ,100.00 
03,008,01,001,0000,0,51193,1226,52419,66479,3735,3,1,3,0,1,0,78.80 ,78.85 ,33.33 
03,008,01,002,0000,0,29577,866,30443,42541,6123,1,1,1,0,1,0,73.22 ,71.56 ,100.00 
03,008,01,003,0000,0,6583,157,6740,9011,77741,2,1,2,0,1,0,70.06 ,74.80 ,50.00 
03,008,01,004,0000,0,21112,637,21749,29548,28743,2,1,2,0,1,0,74.31 ,73.61 ,50.00 
03,008,01,005,0000,0,10951,334,11285,15437,34569,2,1,2,0,1,0,76.39 ,73.10 ,50.00 
03,008,01,006,0000,0,11871,348,12219,16999,24120,4,1,4,0,1,0,74.23 ,71.88 ,25.00 
03,008,01,007,0000,0,4050,114,4164,6151,27803,6,1,6,0,1,0,77.28 ,67.70 ,16.67 
03,008,02,008,0000,0,41721,1359,43080,58233,25066,3,1,2,1,0,1,76.55 ,73.98 ,33.33 
03,008,02,009,0000,0,46649,1501,48150,61712,47348,6,1,6,0,1,0,73.39 ,78.02 ,16.67 
03,008,02,010,0000,0,9962,418,10380,13957,27885,2,1,2,0,1,0,74.49 ,74.37 ,50.00 
03,008,02,011,0000,0,9564,167,9731,13223,25247,1,1,1,0,1,0,70.92 ,73.59 ,100.00 
03,008,02,012,0000,0,12490,512,13002,18240,23624,4,1,4,0,1,0,74.42 ,71.28 ,25.00 
03,008,02,013,0000,0,1839,70,1909,2715,12018,2,1,2,0,1,0,79.45 ,70.31 ,50.00 
03,009,01,001,0000,0,46374,1905,48279,62474,58115,2,1,2,0,1,0,71.67 ,77.28 ,50.00 
03,009,01,002,0000,0,23417,933,24350,31985,29940,4,1,2,2,0,1,73.17 ,76.13 ,25.00 
03,009,01,003,0000,0,24539,565,25104,34305,26231,2,1,2,0,1,0,71.24 ,73.18 ,50.00 
03,009,01,004,0000,0,18432,540,18972,26005,26157,3,1,2,1,1,0,75.61 ,72.96 ,33.33 
03,009,01,005,0000,0,11884,387,12271,17016,23364,2,1,2,0,1,0,77.59 ,72.11 ,50.00 
03,009,01,006,0000,0,15807,358,16165,21509,13410,1,1,1,0,1,0,76.41 ,75.15 ,100.00 
03,009,01,007,0000,0,10792,303,11095,14450,45332,2,1,2,0,1,0,71.70 ,76.78 ,50.00 
03,009,01,008,0000,0,16184,319,16503,23868,42073,1,1,1,0,1,0,72.52 ,69.14 ,100.00 
03,009,01,009,0000,0,14056,368,14424,20727,34625,3,1,3,0,1,0,68.50 ,69.59 ,33.33 
03,009,02,010,0000,0,30557,1765,32322,44332,29958,1,1,1,0,1,0,72.08 ,72.91 ,100.00 
03,009,02,011,0000,0,15203,634,15837,22639,8129,2,1,2,0,1,0,75.56 ,69.95 ,50.00 
03,009,02,012,0000,0,21253,1230,22483,33125,16927,2,1,2,0,1,0,74.49 ,67.87 ,50.00 
03,009,02,013,0000,0,14326,337,14663,21513,11793,2,1,2,0,1,0,77.33 ,68.16 ,50.00 
03,009,02,014,0000,0,8764,146,8910,14200,9476,3,1,3,0,1,0,78.21 ,62.75 ,33.33 
03,009,02,015,0000,0,7224,210,7434,10734,6069,1,1,1,0,1,0,81.35 ,69.26 ,100.00 
03,009,02,016,0000,0,13026,258,13284,21412,66070,2,1,2,0,1,0,73.08 ,62.04 ,50.00 
03,009,02,017,0000,0,14930,434,15364,24349,63949,2,1,2,0,1,0,68.93 ,63.10 ,50.00 
03,009,02,018,0000,0,12890,420,13310,23645,38471,3,1,3,0,1,0,73.15 ,56.29 ,33.33 
03,009,02,019,0000,0,14510,394,14904,24063,4363,1,1,1,0,1,0,84.09 ,61.94 ,100.00 
03,009,02,020,0000,0,15001,648,15649,25133,198003,7,1,7,0,1,0,68.47 ,62.26 ,14.29 
03,010,01,001,0000,0,13743,527,14270,19894,322860,2,1,2,0,1,0,70.88 ,71.73 ,50.00 
03,010,01,002,0000,0,17649,819,18468,26018,72071,4,1,3,1,1,0,69.35 ,70.98 ,25.00 
03,010,01,003,0000,0,8648,422,9070,13650,115210,5,1,4,1,1,0,71.27 ,66.45 ,20.00 
03,010,01,004,0000,0,9379,397,9776,14337,46585,3,1,3,0,1,0,71.99 ,68.19 ,33.33 
03,010,01,005,0000,0,25993,1039,27032,36776,33408,2,1,2,0,1,0,72.90 ,73.50 ,50.00 
03,010,01,006,0000,0,21716,807,22523,31728,54015,3,1,3,0,1,0,70.47 ,70.99 ,33.33 
03,010,01,007,0000,0,19709,666,20375,28970,38516,4,1,3,1,0,1,74.20 ,70.33 ,25.00 
03,010,01,008,0000,0,12085,372,12457,17274,93699,2,1,2,0,1,0,70.26 ,72.11 ,50.00 
03,010,01,009,0000,0,5808,245,6053,8515,37932,3,1,3,0,1,0,72.72 ,71.09 ,33.33 
03,010,01,010,0000,0,1724,44,1768,2807,32281,2,1,2,0,1,0,73.00 ,62.99 ,50.00 
03,010,01,011,0000,0,1181,30,1211,1950,9563,2,1,2,0,1,0,81.07 ,62.10 ,50.00 
03,010,02,012,0000,0,20585,772,21357,30540,31469,3,1,3,0,1,0,69.26 ,69.93 ,33.33 
03,010,02,013,0000,0,16265,527,16792,24905,53629,2,1,2,0,1,0,71.07 ,67.42 ,50.00 
03,010,02,014,0000,0,31698,882,32580,43860,28701,2,1,2,0,1,0,73.23 ,74.28 ,50.00 
03,010,02,015,0000,0,16934,538,17472,25637,33173,2,1,2,0,1,0,72.77 ,68.15 ,50.00 
03,010,02,016,0000,0,14722,510,15232,23174,14679,1,1,1,0,1,0,72.27 ,65.73 ,100.00 
03,010,02,017,0000,0,14677,520,15197,23476,21714,2,1,2,0,1,0,71.51 ,64.73 ,50.00 
03,010,02,018,0000,0,12372,418,12790,18260,39279,3,1,3,0,1,0,71.92 ,70.04 ,33.33 
03,011,01,001,0000,0,35506,1073,36579,49591,43673,3,1,2,1,1,0,74.56 ,73.76 ,33.33 
03,011,01,002,0000,0,14299,490,14789,20881,46319,4,1,4,0,1,0,75.51 ,70.83 ,25.00 
03,011,01,003,0000,0,18409,642,19051,27182,17071,4,1,4,0,1,0,75.95 ,70.09 ,25.00 
03,011,01,004,0000,0,12648,396,13044,17588,8821,2,1,2,0,1,0,77.51 ,74.16 ,50.00 
03,011,01,005,0000,0,15442,486,15928,21800,12705,3,1,3,0,1,0,78.77 ,73.06 ,33.33 
03,011,01,006,0000,0,12861,357,13218,19724,17847,2,1,2,0,1,0,75.61 ,67.01 ,50.00 
03,011,01,007,0000,0,24517,730,25247,32894,1793,2,1,2,0,1,0,72.28 ,76.75 ,50.00 
03,011,01,008,0000,0,14590,481,15071,20202,4715,3,1,3,0,1,0,69.10 ,74.60 ,33.33 
03,011,01,009,0000,0,12405,382,12787,17221,3361,2,1,2,0,1,0,63.67 ,74.25 ,50.00 
03,011,01,010,0000,0,13226,268,13494,17389,215769,3,1,3,0,1,0,70.85 ,77.60 ,33.33 
03,011,01,011,0000,0,6823,170,6993,9512,57920,5,1,5,0,1,0,70.72 ,73.52 ,20.00 
03,011,01,012,0000,0,26821,964,27785,37071,49814,3,1,3,0,1,0,68.51 ,74.95 ,33.33 
03,011,01,013,0000,0,15263,376,15639,21274,31288,4,1,4,0,1,0,72.47 ,73.51 ,25.00 
03,011,01,014,0000,0,12602,410,13012,17014,54439,2,1,2,0,1,0,70.23 ,76.48 ,50.00 
03,011,01,015,0000,0,14202,361,14563,19634,30352,3,1,3,0,1,0,73.32 ,74.17 ,33.33 
03,011,01,016,0000,0,12229,278,12507,17722,12068,2,1,2,0,1,0,73.29 ,70.57 ,50.00 
03,011,01,017,0000,0,6862,144,7006,10335,23483,4,1,3,1,1,0,70.99 ,67.79 ,25.00 
03,011,02,018,0000,0,22075,703,22778,29373,27171,2,1,2,0,1,0,71.91 ,77.55 ,50.00 
03,011,02,019,0000,0,21635,494,22129,28638,28497,4,1,4,0,1,0,72.06 ,77.27 ,25.00 
03,011,02,020,0000,0,15294,465,15759,19947,29165,2,1,2,0,1,0,76.82 ,79.00 ,50.00 
03,011,02,021,0000,0,14736,552,15288,19925,24117,3,1,3,0,1,0,74.10 ,76.73 ,33.33 
03,011,02,022,0000,0,4346,117,4463,5842,62360,3,1,3,0,1,0,72.28 ,76.40 ,33.33 
03,011,02,023,0000,0,9067,217,9284,12584,19284,2,1,1,1,1,0,74.36 ,73.78 ,50.00 
03,011,02,024,0000,0,6384,166,6550,9191,11822,3,1,2,1,0,1,76.39 ,71.27 ,33.33 
03,011,02,025,0000,0,5280,109,5389,7339,29554,2,1,2,0,1,0,73.76 ,73.43 ,50.00 
03,011,02,026,0000,0,3617,80,3697,5060,41370,2,1,2,0,1,0,70.43 ,73.06 ,50.00 
03,011,02,027,0000,0,32367,848,33215,42172,15392,5,1,5,0,1,0,69.65 ,78.76 ,20.00 
03,011,02,028,0000,0,28647,847,29494,37728,22763,2,1,2,0,1,0,74.19 ,78.18 ,50.00 
03,011,02,029,0000,0,20708,465,21173,26707,13197,3,1,3,0,1,0,74.47 ,79.28 ,33.33 
03,011,02,030,0000,0,2850,72,2922,3825,23322,2,1,2,0,1,0,74.55 ,76.39 ,50.00 
03,011,02,031,0000,0,81875,2326,84201,109966,13109,2,1,2,0,1,0,81.79 ,76.57 ,50.00 
03,012,01,001,0000,0,148502,4708,153210,197984,10879,4,1,4,0,1,0,75.75 ,77.39 ,25.00 
03,012,02,002,0000,0,32906,1099,34005,44615,8787,4,1,4,0,1,0,79.03 ,76.22 ,25.00 
03,012,02,003,0000,0,56187,1489,57676,73052,6575,2,1,2,0,1,0,75.44 ,78.95 ,50.00 
03,012,02,004,0000,0,24197,633,24830,31601,7265,2,1,2,0,1,0,72.02 ,78.57 ,50.00 
03,012,02,005,0000,0,15682,507,16189,20598,2739,2,1,2,0,1,0,90.98 ,78.60 ,50.00 
03,012,02,006,0000,0,21350,799,22149,28493,6256,2,1,2,0,1,0,72.20 ,77.73 ,50.00 
03,012,02,007,0000,0,16846,567,17413,22176,4762,2,1,2,0,1,0,70.92 ,78.52 ,50.00 
03,012,03,008,0000,0,45963,1885,47848,59168,7974,2,1,2,0,1,0,69.80 ,80.87 ,50.00 
03,012,03,009,0000,0,20285,804,21089,25578,5118,1,1,1,0,1,0,69.19 ,82.45 ,100.00 
03,012,03,010,0000,0,17551,607,18158,22864,5084,2,1,2,0,1,0,72.38 ,79.42 ,50.00 
03,012,03,011,0000,0,5610,134,5744,7718,5104,2,1,2,0,1,0,73.26 ,74.42 ,50.00 
03,012,03,012,0000,0,15541,427,15968,20015,110993,2,1,2,0,1,0,70.05 ,79.78 ,50.00 
03,012,03,013,0000,0,27770,879,28649,34736,18491,2,1,2,0,1,0,73.48 ,82.48 ,50.00 
03,012,03,014,0000,0,13882,583,14465,18267,10994,2,1,2,0,1,0,71.64 ,79.19 ,50.00 
03,012,03,015,0000,0,16588,553,17141,22315,20016,2,1,2,0,1,0,75.15 ,76.81 ,50.00 
03,012,03,016,0000,0,6930,204,7134,8988,9827,3,1,2,1,1,0,74.68 ,79.37 ,33.33 
03,012,03,017,0000,0,11513,367,11880,14480,10594,2,1,2,0,1,0,76.10 ,82.04 ,50.00 
03,012,03,018,0000,0,19984,720,20704,25768,11060,2,1,2,0,1,0,78.10 ,80.35 ,50.00 
03,012,04,019,0000,0,24784,604,25388,32729,10311,3,1,3,0,1,0,77.58 ,77.57 ,33.33 
03,012,04,020,0000,0,26392,416,26808,35377,13349,1,1,1,0,1,0,73.95 ,75.78 ,100.00 
03,012,04,021,0000,0,9061,204,9265,13185,6667,2,1,2,0,1,0,73.50 ,70.27 ,50.00 
03,012,04,022,0000,0,4834,68,4902,6460,2844,1,1,1,0,1,0,70.85 ,75.88 ,100.00 
03,012,04,023,0000,0,7366,119,7485,10301,4788,2,1,2,0,1,0,65.31 ,72.66 ,50.00 
03,012,04,024,0000,0,10427,193,10620,13445,3678,2,1,2,0,1,0,71.67 ,78.99 ,50.00 
03,012,04,025,0000,0,58,2,60,90,3369,2,1,2,0,1,0,69.69 ,66.67 ,50.00 
03,012,04,026,0000,0,224,4,228,339,4082,2,1,2,0,1,0,74.13 ,67.26 ,50.00 
03,012,04,027,0000,0,167,3,170,243,3156,2,1,2,0,1,0,67.87 ,69.96 ,50.00 
03,013,01,001,0000,0,105403,1793,107196,140853,108272,2,1,2,0,1,0,69.48 ,76.10 ,50.00 
03,013,01,002,0000,0,27390,641,28031,35078,13809,3,1,3,0,1,0,77.12 ,79.91 ,33.33 
03,013,01,003,0000,0,15238,314,15552,20078,32029,4,1,3,1,1,0,73.99 ,77.46 ,25.00 
03,013,01,004,0000,0,6348,81,6429,8133,20537,3,1,2,1,1,0,72.99 ,79.05 ,33.33 
03,013,01,005,0000,0,11694,207,11901,15204,76730,2,1,2,0,1,0,71.82 ,78.28 ,50.00 
03,013,01,006,0000,0,14183,245,14428,18608,20398,2,1,1,1,0,1,74.53 ,77.54 ,50.00 
03,013,01,007,0000,0,14469,343,14812,19357,16339,2,1,2,0,1,0,74.32 ,76.52 ,50.00 
03,013,01,008,0000,0,15767,405,16172,22714,6372,3,1,2,1,1,0,75.41 ,71.20 ,33.33 
03,013,01,009,0000,0,31765,588,32353,43167,14972,3,1,3,0,1,0,73.24 ,74.95 ,33.33 
03,013,01,010,0000,0,246,11,257,372,13366,2,1,2,0,1,0,76.24 ,69.09 ,50.00 
03,013,01,011,0000,0,26,1,27,49,15265,3,1,2,1,1,0,65.37 ,55.10 ,33.33 
03,013,01,012,0000,0,233,12,245,344,7643,3,1,3,0,1,0,64.07 ,71.22 ,33.33 
03,013,02,013,0000,0,27402,488,27890,37387,7077,2,1,2,0,1,0,66.98 ,74.60 ,50.00 
03,013,02,014,0000,0,23250,595,23845,31315,53093,1,1,1,0,1,0,71.32 ,76.15 ,100.00 
03,013,02,015,0000,0,13815,303,14118,21921,12768,3,1,2,1,1,0,76.33 ,64.40 ,33.33 
03,013,02,016,0000,0,12812,245,13057,17380,9206,3,1,3,0,1,0,76.96 ,75.13 ,33.33 
03,013,02,017,0000,0,10780,225,11005,14075,8377,2,1,2,0,1,0,77.82 ,78.19 ,50.00 
03,013,02,018,0000,0,6467,124,6591,9087,4425,2,1,2,0,1,0,86.31 ,72.53 ,50.00 
03,013,02,019,0000,0,15463,237,15700,21231,3183,3,1,3,0,1,0,71.47 ,73.95 ,33.33 
03,013,02,020,0000,0,21661,353,22014,27515,19130,9,1,8,1,1,0,68.74 ,80.01 ,11.11 
03,013,02,021,0000,0,7304,134,7438,9528,9339,3,1,3,0,1,0,74.07 ,78.06 ,33.33 
03,013,02,022,0000,0,12085,235,12320,16191,12403,1,1,1,0,1,0,69.14 ,76.09 ,100.00 
03,013,02,023,0000,0,7330,123,7453,9712,9766,3,1,3,0,1,0,74.66 ,76.74 ,33.33 
03,013,02,024,0000,0,12745,281,13026,17395,5214,3,1,3,0,1,0,75.55 ,74.88 ,33.33 
03,013,02,025,0000,0,4726,102,4828,8495,363,3,1,3,0,1,0,84.85 ,56.83 ,33.33 
03,013,02,026,0000,0,5290,138,5428,8488,5034,3,1,3,0,1,0,77.69 ,63.95 ,33.33 
03,013,02,027,0000,0,3227,84,3311,5419,1635,1,1,1,0,1,0,85.81 ,61.10 ,100.00 
03,013,02,028,0000,0,3157,57,3214,4970,822,2,1,2,0,1,0,78.47 ,64.67 ,50.00 
03,013,02,029,0000,0,105,4,109,165,825,2,1,2,0,1,0,71.76 ,66.06 ,50.00 
03,013,02,030,0000,0,294,11,305,422,825,2,1,2,0,1,0,71.76 ,72.27 ,50.00 
03,013,02,031,0000,0,285,6,291,427,825,2,1,2,0,1,0,71.76 ,68.15 ,50.00 
03,013,02,032,0000,0,182,2,184,293,123456,2,1,2,0,1,0,71.76 ,62.80 ,50.00 
03,013,02,033,0000,0,243,5,248,399,123456,2,1,2,0,1,0,71.76 ,62.16 ,50.00 
03,014,01,001,0000,0,42387,904,43291,63734,123456,2,1,2,0,1,0,71.76 ,67.92 ,50.00 
03,014,01,002,0000,0,4090,63,4153,6532,123456,2,1,2,0,1,0,71.76 ,63.58 ,50.00 
03,014,01,003,0000,0,4091,83,4174,6483,123456,2,1,2,0,1,0,71.76 ,64.38 ,50.00 
03,014,01,004,0000,0,7333,168,7501,11639,123456,2,1,2,0,1,0,71.76 ,64.45 ,50.00 
03,014,01,005,0000,0,3491,92,3583,5923,123456,2,1,2,0,1,0,71.76 ,60.49 ,50.00 
03,014,01,006,0000,0,4183,77,4260,6811,123456,2,1,2,0,1,0,71.76 ,62.55 ,50.00 
03,014,01,007,0000,0,2483,45,2528,4941,123456,2,1,2,0,1,0,71.76 ,51.16 ,50.00 
03,014,01,008,0000,0,1999,43,2042,3753,123456,2,1,2,0,1,0,71.76 ,54.41 ,50.00 
03,014,01,009,0000,0,4072,66,4138,6654,123456,2,1,2,0,1,0,71.76 ,62.19 ,50.00 
03,014,01,010,0000,0,1461,42,1503,2544,123456,2,1,2,0,1,0,71.76 ,59.08 ,50.00 
03,014,01,011,0000,0,1013,9,1022,1712,123456,2,1,2,0,1,0,71.76 ,59.70 ,50.00 
03,014,01,012,0000,0,222,7,229,354,123456,2,1,2,0,1,0,71.76 ,64.69 ,50.00 
03,014,01,013,0000,0,182,4,186,295,123456,2,1,2,0,1,0,71.76 ,63.05 ,50.00 
03,014,01,014,0000,0,125,1,126,227,123456,2,1,2,0,1,0,71.76 ,55.51 ,50.00 
03,014,01,015,0000,0,198,3,201,353,123456,2,1,2,0,1,0,71.76 ,56.94 ,50.00 
03,014,01,016,0000,0,84,1,85,159,123456,2,1,2,0,1,0,71.76 ,53.46 ,50.00 
03,015,01,001,0000,0,47650,1196,48846,67634,123456,2,1,2,0,1,0,71.76 ,72.22 ,50.00 
03,015,01,002,0000,0,6771,115,6886,9944,123456,2,1,2,0,1,0,71.76 ,69.25 ,50.00 
03,015,01,003,0000,0,10869,596,11465,18570,123456,2,1,2,0,1,0,71.76 ,61.74 ,50.00 
03,015,01,004,0000,0,8187,241,8428,11797,123456,2,1,2,0,1,0,71.76 ,71.44 ,50.00 
03,015,01,005,0000,0,27936,885,28821,40587,123456,2,1,2,0,1,0,71.76 ,71.01 ,50.00 
03,015,01,006,0000,0,7598,235,7833,11537,123456,2,1,2,0,1,0,71.76 ,67.89 ,50.00 
03,015,01,007,0000,0,4503,117,4620,7093,123456,2,1,2,0,1,0,71.76 ,65.13 ,50.00 
03,015,01,008,0000,0,765,28,793,1364,123456,2,1,2,0,1,0,71.76 ,58.14 ,50.00 
03,015,01,009,0000,0,4858,144,5002,7734,123456,2,1,2,0,1,0,71.76 ,64.68 ,50.00 
03,015,01,010,0000,0,5988,233,6221,10408,123456,2,1,2,0,1,0,71.76 ,59.77 ,50.00 
03,015,01,011,0000,0,1245,42,1287,1991,123456,2,1,2,0,1,0,71.76 ,64.64 ,50.00 
03,015,01,012,0000,0,205,8,213,351,123456,2,1,2,0,1,0,71.76 ,60.68 ,50.00 
03,015,01,013,0000,0,234,10,244,402,123456,2,1,2,0,1,0,71.76 ,60.70 ,50.00 
03,016,01,001,0000,0,23484,755,24239,35171,123456,2,1,2,0,1,0,71.76 ,68.92 ,50.00 
03,016,01,002,0000,0,6212,174,6386,9666,123456,2,1,2,0,1,0,71.76 ,66.07 ,50.00 
03,016,01,003,0000,0,3928,94,4022,6788,123456,2,1,2,0,1,0,71.76 ,59.25 ,50.00 
03,016,01,004,0000,0,3723,101,3824,6500,123456,2,1,2,0,1,0,71.76 ,58.83 ,50.00 
03,016,01,005,0000,0,1184,61,1245,2739,123456,2,1,2,0,1,0,71.76 ,45.45 ,50.00 
03,016,01,006,0000,0,1170,37,1207,2240,123456,2,1,2,0,1,0,71.76 ,53.88 ,50.00 
03,017,01,001,0000,0,29259,973,30232,40179,123456,2,1,2,0,1,0,71.76 ,75.24 ,50.00 
03,017,01,002,0000,0,27541,831,28372,36270,123456,2,1,2,0,1,0,71.76 ,78.22 ,50.00 
03,017,01,003,0000,0,15659,510,16169,20913,123456,2,1,2,0,1,0,71.76 ,77.32 ,50.00 
03,017,01,004,0000,0,30314,899,31213,40254,123456,2,1,2,0,1,0,71.76 ,77.54 ,50.00 
03,017,01,005,0000,0,26059,823,26882,35026,123456,2,1,2,0,1,0,71.76 ,76.75 ,50.00 
03,017,01,006,0000,0,33301,1073,34374,44459,123456,2,1,2,0,1,0,71.76 ,77.32 ,50.00 
03,017,01,007,0000,0,23654,635,24289,31453,123456,2,1,2,0,1,0,71.76 ,77.22 ,50.00 
03,018,01,001,0000,0,81813,1333,83146,106409,123456,2,1,2,0,1,0,71.76 ,78.14 ,50.00 
03,018,01,002,0000,0,62587,989,63576,81282,123456,2,1,2,0,1,0,71.76 ,78.22 ,50.00 
03,018,01,003,0000,0,27896,532,28428,36208,123456,2,1,2,0,1,0,71.76 ,78.51 ,50.00 
03,019,01,001,0000,0,12560,378,12938,17204,123456,2,1,2,0,1,0,71.76 ,75.20 ,50.00 
03,019,01,002,0000,0,35002,987,35989,46845,123456,2,1,2,0,1,0,71.76 ,76.83 ,50.00 
03,019,01,003,0000,0,38103,1253,39356,51314,123456,2,1,2,0,1,0,71.76 ,76.70 ,50.00 
03,019,01,004,0000,0,52165,1514,53679,70057,123456,2,1,2,0,1,0,71.76 ,76.62 ,50.00 
03,019,01,005,0000,0,68534,2041,70575,94291,123456,2,1,2,0,1,0,71.76 ,74.85 ,50.00 
03,019,02,006,0000,0,66953,1338,68291,87863,123456,2,1,2,0,1,0,71.76 ,77.72 ,50.00 
03,019,02,007,0000,0,42628,926,43554,55567,123456,2,1,2,0,1,0,71.76 ,78.38 ,50.00 
03,019,02,008,0000,0,91341,1745,93086,119623,123456,2,1,2,0,1,0,71.76 ,77.82 ,50.00 
03,020,01,001,0000,0,62617,1520,64137,86034,123456,2,1,2,0,1,0,71.76 ,74.55 ,50.00 
03,020,01,002,0000,0,63248,1482,64730,87029,123456,2,1,2,0,1,0,71.76 ,74.38 ,50.00 
03,021,01,001,0000,0,80939,2452,83391,108629,123456,2,1,2,0,1,0,71.76 ,76.77 ,50.00 
03,021,01,002,0000,0,68418,1918,70336,92713,123456,2,1,2,0,1,0,71.76 ,75.86 ,50.00 
03,021,01,003,0000,0,25127,753,25880,33631,123456,2,1,2,0,1,0,71.76 ,76.95 ,50.00 
03,021,01,004,0000,0,15482,423,15905,21050,123456,2,1,2,0,1,0,71.76 ,75.56 ,50.00 
03,021,02,005,0000,0,24873,797,25670,32674,123456,2,1,2,0,1,0,71.76 ,78.56 ,50.00 
03,021,02,006,0000,0,60436,1790,62226,80762,123456,2,1,2,0,1,0,71.76 ,77.05 ,50.00 
03,021,02,007,0000,0,69311,1850,71161,92707,123456,2,1,2,0,1,0,71.76 ,76.76 ,50.00 
03,022,01,001,0000,0,6679,188,6867,9640,123456,2,1,2,0,1,0,71.76 ,71.23 ,50.00 
03,022,01,002,0000,0,3494,146,3640,5326,123456,2,1,2,0,1,0,71.76 ,68.34 ,50.00 
03,022,01,003,0000,0,4609,151,4760,6703,123456,2,1,2,0,1,0,71.76 ,71.01 ,50.00 
03,022,01,004,0000,0,3542,110,3652,5387,123456,2,1,2,0,1,0,71.76 ,67.79 ,50.00 
03,022,01,005,0000,0,1938,68,2006,3037,123456,2,1,2,0,1,0,71.76 ,66.05 ,50.00 
03,022,01,006,0000,0,13,0,13,80,123456,2,1,2,0,1,0,71.76 ,16.25 ,50.00 
03,023,01,001,0000,0,1650,15,1665,2239,123456,2,1,2,0,1,0,71.76 ,74.36 ,50.00 
03,023,01,002,0000,0,479,9,488,755,123456,2,1,2,0,1,0,71.76 ,64.64 ,50.00 
03,023,01,003,0000,0,165,4,169,376,123456,2,1,2,0,1,0,71.76 ,44.95 ,50.00 
03,023,01,004,0000,0,295,5,300,424,123456,2,1,2,0,1,0,71.76 ,70.75 ,50.00 
