00,000,00,000,0000,0,2105812,37964,2143776,3022067,4129389,215,94,169,46,67,27,73.18 ,70.94 ,43.72 
01,000,00,000,0000,0,1342187,26366,1368553,1936966,2628928,109,51,81,28,34,17,73.68 ,70.65 ,46.79 
01,000,01,000,0000,0,277603,6358,283961,396984,538462,18,10,13,5,6,4,73.73 ,71.53 ,55.56 
01,000,02,000,0000,0,184506,3217,187723,260070,368761,12,7,7,5,5,2,70.53 ,72.18 ,58.33 
01,000,03,000,0000,0,225514,4512,230026,327581,441117,18,9,13,5,7,2,74.26 ,70.22 ,50.00 
01,000,04,000,0000,0,176828,3871,180699,261591,346929,16,7,13,3,5,2,75.40 ,69.08 ,43.75 
01,000,05,000,0000,0,187081,3958,191039,271710,364211,17,7,14,3,5,2,74.60 ,70.31 ,41.18 
01,000,06,000,0000,0,290655,4450,295105,419030,569448,28,11,21,7,6,5,73.59 ,70.43 ,39.29 
02,000,00,000,0000,0,763625,11598,775223,1085101,1500461,106,43,88,18,33,10,72.32 ,71.44 ,40.57 
02,000,01,000,0000,0,90649,1121,91770,126187,168634,10,5,8,2,4,1,74.83 ,72.73 ,50.00 
02,000,02,000,0000,0,160852,2208,163060,229552,325375,22,9,19,3,7,2,70.55 ,71.03 ,40.91 
02,000,03,000,0000,0,177153,2652,179805,256358,359734,26,10,21,5,7,3,71.26 ,70.14 ,38.46 
02,000,04,000,0000,0,155175,2575,157750,219877,293593,22,9,18,4,7,2,74.89 ,71.74 ,40.91 
02,000,05,000,0000,0,179796,3042,182838,253127,353125,26,10,22,4,8,2,71.68 ,72.23 ,38.46 
01,000,01,001,0000,0,127313,3532,130845,181773,474265,2,1,2,0,1,0,70.83 ,71.98 ,50.00 
01,000,01,002,0000,0,150290,2826,153116,215211,559558,6,1,6,0,1,0,73.50 ,71.15 ,16.67 
01,000,02,003,0000,0,126251,2100,128351,178193,1530298,3,1,3,0,1,0,71.42 ,72.03 ,33.33 
01,000,02,004,0000,0,58255,1117,59372,81877,1315020,3,1,2,1,1,0,73.08 ,72.51 ,33.33 
01,000,03,005,0000,0,102281,1988,104269,149587,537345,4,1,4,0,1,0,74.24 ,69.70 ,25.00 
01,000,03,006,0000,0,123233,2524,125757,177994,734052,3,1,2,1,0,1,75.40 ,70.65 ,33.33 
01,000,04,007,0000,0,110128,2431,112559,163767,556365,2,1,2,0,1,0,75.92 ,68.73 ,50.00 
01,000,04,008,0000,0,66700,1440,68140,97824,1105050,4,1,4,0,1,0,75.53 ,69.66 ,25.00 
01,000,05,009,0000,0,79228,1820,81048,117084,1240203,2,1,2,0,1,0,74.89 ,69.22 ,50.00 
01,000,05,010,0000,0,107853,2138,109991,154626,898611,4,1,3,1,1,0,74.87 ,71.13 ,25.00 
01,000,06,011,0000,0,159003,2509,161512,234425,239184,3,1,3,0,1,0,74.75 ,68.90 ,33.33 
01,000,06,012,0000,0,131652,1941,133593,184605,347641,4,1,4,0,1,0,74.43 ,72.37 ,25.00 
02,000,01,001,0000,0,17052,248,17300,23534,92362,3,1,3,0,1,0,76.25 ,73.51 ,33.33 
02,000,01,002,0000,0,57100,698,57798,79919,392084,4,1,4,0,1,0,74.56 ,72.32 ,25.00 
02,000,01,003,0000,0,16497,175,16672,22734,389488,2,1,2,0,1,0,71.17 ,73.34 ,50.00 
02,000,02,004,0000,0,84428,1311,85739,122030,1029644,4,1,2,2,1,0,70.90 ,70.26 ,25.00 
02,000,02,005,0000,0,76424,897,77321,107522,271949,2,1,0,2,0,1,72.09 ,71.91 ,50.00 
02,000,03,006,0000,0,177153,2652,179805,256358,756751,3,1,2,1,1,0,73.78 ,70.14 ,33.33 
02,000,04,007,0000,0,32982,527,33509,46829,68265,3,1,3,0,1,0,76.23 ,71.56 ,33.33 
02,000,04,008,0000,0,17608,276,17884,25371,10527,3,1,3,0,1,0,77.61 ,70.49 ,33.33 
02,000,04,009,0000,0,104585,1772,106357,147677,155496,5,1,4,1,0,1,66.42 ,72.02 ,20.00 
02,000,05,010,0000,0,105289,1984,107273,147153,81169,2,1,1,1,1,0,66.90 ,72.90 ,50.00 
02,000,05,011,0000,0,74507,1058,75565,105974,83691,3,1,3,0,1,0,66.61 ,71.31 ,33.33 
01,000,01,001,0001,0,2654,41,2695,3740,118173,3,1,3,0,1,0,71.99 ,72.06 ,33.33 
01,000,01,001,0002,0,2514,49,2563,3523,163727,7,1,6,1,1,0,73.82 ,72.75 ,14.29 
01,000,01,001,0003,0,2979,70,3049,4278,46538,2,1,2,0,1,0,73.84 ,71.27 ,50.00 
01,000,01,001,0004,0,3890,73,3963,5342,231133,5,1,5,0,1,0,66.46 ,74.19 ,20.00 
01,000,01,001,0005,0,3905,70,3975,5517,168134,7,1,6,1,1,0,65.91 ,72.05 ,14.29 
01,000,01,001,0006,0,3997,87,4084,5803,70467,3,1,3,0,1,0,67.30 ,70.38 ,33.33 
01,000,01,001,0007,0,3810,76,3886,5391,62493,2,1,1,1,1,0,67.71 ,72.08 ,50.00 
01,000,01,001,0008,0,4402,91,4493,6241,52316,4,1,3,1,1,0,66.01 ,71.99 ,25.00 
01,000,01,001,0009,0,4307,76,4383,6242,20114,4,1,3,1,0,1,73.10 ,70.22 ,25.00 
01,000,01,001,0010,0,3503,79,3582,5059,7445,4,1,4,0,1,0,78.94 ,70.80 ,25.00 
01,000,01,001,0011,0,2550,54,2604,3580,5994,2,1,2,0,1,0,81.73 ,72.74 ,50.00 
01,000,01,001,0012,0,2719,37,2756,3620,22788,2,1,1,1,1,0,71.42 ,76.13 ,50.00 
01,000,01,001,0013,0,3605,84,3689,5050,10850,2,1,2,0,1,0,75.86 ,73.05 ,50.00 
01,000,01,001,0014,0,2926,64,2990,4012,29160,4,1,4,0,1,0,69.65 ,74.53 ,25.00 
01,000,01,001,0015,0,2731,58,2789,3865,5944,2,1,2,0,1,0,85.70 ,72.16 ,50.00 
01,000,01,001,0016,0,2940,64,3004,4103,10298,3,1,3,0,1,0,81.65 ,73.21 ,33.33 
01,000,01,001,0017,0,4773,74,4847,6506,13552,2,1,2,0,1,0,78.87 ,74.50 ,50.00 
01,000,01,001,0018,0,2690,59,2749,3795,21379,2,1,1,1,1,0,71.43 ,72.44 ,50.00 
01,000,01,001,0019,0,1057,14,1071,1419,18438,2,1,2,0,1,0,75.60 ,75.48 ,50.00 
01,000,01,001,0020,0,5126,132,5258,7387,4273,1,1,1,0,1,0,73.84 ,71.18 ,100.00 
01,000,01,001,0021,0,4876,136,5012,7042,92385,3,1,2,1,1,0,68.86 ,71.17 ,33.33 
01,000,01,001,0022,0,4080,140,4220,5960,70372,3,1,2,1,1,0,67.72 ,70.81 ,33.33 
01,000,01,001,0023,0,3114,94,3208,4506,46679,3,1,3,0,1,0,71.97 ,71.19 ,33.33 
01,000,01,001,0024,0,3265,106,3371,4679,33217,3,1,3,0,1,0,70.90 ,72.05 ,33.33 
01,000,01,001,0025,0,3471,102,3573,4983,38137,3,1,3,0,1,0,71.08 ,71.70 ,33.33 
01,000,01,001,0026,0,1773,52,1825,2727,26645,2,1,2,0,1,0,72.27 ,66.92 ,50.00 
01,000,01,001,0027,0,3064,67,3131,4792,33963,3,1,3,0,1,0,71.40 ,65.34 ,33.33 
01,000,01,001,0028,0,2401,60,2461,3357,51543,3,1,3,0,1,0,71.25 ,73.31 ,33.33 
01,000,01,001,0029,0,3487,112,3599,5124,39229,2,1,2,0,1,0,71.55 ,70.24 ,50.00 
01,000,01,001,0030,0,2763,73,2836,3955,22112,2,1,2,0,1,0,74.34 ,71.71 ,50.00 
01,000,01,001,0031,0,3435,99,3534,4751,5718,2,1,2,0,1,0,69.85 ,74.38 ,50.00 
01,000,01,001,0032,0,2016,53,2069,2866,5825,4,1,4,0,1,0,66.20 ,72.19 ,25.00 
01,000,01,001,0033,0,2428,62,2490,3307,334927,5,1,5,0,1,0,67.16 ,75.29 ,20.00 
01,000,01,001,0034,0,2364,124,2488,3297,328121,3,1,3,0,1,0,68.43 ,75.46 ,33.33 
01,000,01,001,0035,0,2643,129,2772,3834,83519,3,1,3,0,1,0,68.66 ,72.30 ,33.33 
01,000,01,001,0036,0,2703,289,2992,4121,130732,5,1,5,0,1,0,67.09 ,72.60 ,20.00 
01,000,01,001,0037,0,3132,192,3324,4769,101290,4,1,4,0,1,0,65.74 ,69.70 ,25.00 
01,000,01,001,0038,0,5481,213,5694,7927,77736,4,1,4,0,1,0,66.33 ,71.83 ,25.00 
01,000,01,001,0039,0,1368,31,1399,1931,114604,2,1,2,0,1,0,69.35 ,72.45 ,50.00 
01,000,01,001,0040,0,1183,19,1202,1650,165779,3,1,3,0,1,0,68.23 ,72.85 ,33.33 
01,000,01,001,0041,0,671,16,687,979,106433,3,1,3,0,1,0,67.45 ,70.17 ,33.33 
01,000,01,001,0042,0,517,11,528,743,193621,5,1,3,2,0,1,66.39 ,71.06 ,20.00 
01,000,01,002,0043,0,2629,28,2657,3595,49075,2,1,2,0,1,0,70.19 ,73.91 ,50.00 
01,000,01,002,0044,0,1765,32,1797,2501,53643,2,1,2,0,1,0,68.58 ,71.85 ,50.00 
01,000,01,002,0045,0,2236,49,2285,3176,11251,4,1,4,0,1,0,69.74 ,71.95 ,25.00 
01,000,01,002,0046,0,2535,50,2585,4137,91747,2,1,2,0,1,0,66.83 ,62.48 ,50.00 
01,000,01,002,0047,0,3971,72,4043,5618,88834,2,1,2,0,1,0,68.07 ,71.97 ,50.00 
01,000,01,002,0048,0,3828,63,3891,5341,36708,2,1,2,0,1,0,71.22 ,72.85 ,50.00 
01,000,01,002,0049,0,4262,70,4332,5873,32559,3,1,3,0,1,0,71.94 ,73.76 ,33.33 
01,000,01,002,0050,0,4347,77,4424,6287,67960,2,1,2,0,1,0,67.16 ,70.37 ,50.00 
01,000,01,002,0051,0,3095,65,3160,4360,46718,2,1,2,0,1,0,65.94 ,72.48 ,50.00 
01,000,01,002,0052,0,2501,42,2543,3513,20852,2,1,2,0,1,0,69.78 ,72.39 ,50.00 
01,000,01,002,0053,0,4033,90,4123,5737,15045,2,1,2,0,1,0,73.01 ,71.87 ,50.00 
01,000,01,002,0054,0,2944,60,3004,4355,10541,1,1,1,0,1,0,71.95 ,68.98 ,100.00 
01,000,01,002,0055,0,3768,80,3848,5502,12945,2,1,2,0,1,0,70.78 ,69.94 ,50.00 
01,000,01,002,0056,0,2718,76,2794,4065,6393,2,1,2,0,1,0,76.16 ,68.73 ,50.00 
01,000,01,002,0057,0,2924,53,2977,4346,8186,4,1,4,0,1,0,67.54 ,68.50 ,25.00 
01,000,01,002,0058,0,3285,72,3357,4697,4828,3,1,3,0,1,0,73.34 ,71.47 ,33.33 
01,000,01,002,0059,0,4172,78,4250,5712,91005,4,1,3,1,1,0,70.63 ,74.40 ,25.00 
01,000,01,002,0060,0,2204,42,2246,3070,49329,2,1,1,1,1,0,70.11 ,73.16 ,50.00 
01,000,01,002,0061,0,3456,60,3516,4994,41216,2,1,2,0,1,0,71.88 ,70.40 ,50.00 
01,000,01,002,0062,0,4541,103,4644,6560,70035,4,1,4,0,1,0,68.51 ,70.79 ,25.00 
01,000,01,002,0063,0,4030,63,4093,5549,89256,3,1,3,0,1,0,68.26 ,73.76 ,33.33 
01,000,01,002,0064,0,4132,91,4223,5818,42310,2,1,2,0,1,0,71.77 ,72.59 ,50.00 
01,000,01,002,0065,0,2962,40,3002,3950,19568,2,1,2,0,1,0,72.67 ,76.00 ,50.00 
01,000,01,002,0066,0,3215,40,3255,4407,17181,4,1,3,1,1,0,73.40 ,73.86 ,25.00 
01,000,01,002,0067,0,2076,36,2112,3065,34851,1,1,1,0,1,0,69.78 ,68.91 ,100.00 
01,000,01,002,0068,0,4011,75,4086,5668,20704,2,1,1,1,1,0,71.69 ,72.09 ,50.00 
01,000,01,002,0069,0,2331,44,2375,3291,12179,6,1,5,1,1,0,75.89 ,72.17 ,16.67 
01,000,01,002,0070,0,3097,68,3165,4501,12305,3,1,2,1,0,1,73.30 ,70.32 ,33.33 
01,000,01,002,0071,0,2974,44,3018,4166,18061,3,1,3,0,1,0,69.87 ,72.44 ,33.33 
01,000,01,002,0072,0,3287,41,3328,4548,8579,2,1,1,1,1,0,75.91 ,73.18 ,50.00 
01,000,01,002,0073,0,3891,75,3966,5564,14300,3,1,3,0,1,0,71.19 ,71.28 ,33.33 
01,000,01,002,0074,0,2763,53,2816,3858,7765,4,1,4,0,1,0,73.78 ,72.99 ,25.00 
01,000,01,002,0075,0,3074,64,3138,4412,5439,2,1,2,0,1,0,79.94 ,71.12 ,50.00 
01,000,01,002,0076,0,4548,102,4650,6657,5496,2,1,0,2,0,1,76.06 ,69.85 ,50.00 
01,000,01,002,0077,0,3515,65,3580,4945,161524,3,1,3,0,1,0,68.05 ,72.40 ,33.33 
01,000,01,002,0078,0,3429,65,3494,4910,57499,5,1,4,1,1,0,72.08 ,71.16 ,20.00 
01,000,01,002,0079,0,2872,54,2926,4173,78470,3,1,3,0,1,0,66.87 ,70.12 ,33.33 
01,000,01,002,0080,0,2550,56,2606,3720,84966,4,1,4,0,1,0,69.15 ,70.05 ,25.00 
01,000,01,002,0081,0,3938,88,4026,5879,73004,5,1,4,1,0,1,67.70 ,68.48 ,20.00 
01,000,01,002,0082,0,3575,64,3639,5437,50479,4,1,3,1,1,0,67.12 ,66.93 ,25.00 
01,000,01,002,0083,0,4415,96,4511,6561,55327,2,1,2,0,1,0,70.21 ,68.75 ,50.00 
01,000,01,002,0084,0,3561,52,3613,5094,62586,4,1,4,0,1,0,68.18 ,70.93 ,25.00 
01,000,01,002,0085,0,769,11,780,1121,90365,3,1,3,0,1,0,67.47 ,69.58 ,33.33 
01,000,01,002,0086,0,866,17,883,1236,81805,2,1,2,0,1,0,64.97 ,71.44 ,50.00 
01,000,01,002,0087,0,1215,14,1229,1736,26642,4,1,4,0,1,0,73.20 ,70.79 ,25.00 
01,000,01,002,0088,0,1839,36,1875,2777,15211,3,1,2,1,1,0,73.45 ,67.52 ,33.33 
01,000,01,002,0089,0,973,17,990,1362,31463,3,1,3,0,1,0,68.81 ,72.69 ,33.33 
01,000,01,002,0090,0,918,14,932,1197,21391,2,1,1,1,1,0,70.53 ,77.86 ,50.00 
01,000,01,002,0091,0,865,20,885,1238,21391,2,1,1,1,1,0,70.53 ,71.49 ,50.00 
01,000,01,002,0092,0,1805,20,1825,2554,21391,2,1,1,1,1,0,70.53 ,71.46 ,50.00 
01,000,01,002,0093,0,1580,39,1619,2378,21391,2,1,1,1,1,0,70.53 ,68.08 ,50.00 
01,000,02,003,0094,0,4285,83,4368,6070,21391,2,1,1,1,1,0,70.53 ,71.96 ,50.00 
01,000,02,003,0095,0,4349,70,4419,6025,21391,2,1,1,1,1,0,70.53 ,73.34 ,50.00 
01,000,02,003,0096,0,3384,60,3444,4782,21391,2,1,1,1,1,0,70.53 ,72.02 ,50.00 
01,000,02,003,0097,0,3119,40,3159,4311,21391,2,1,1,1,1,0,70.53 ,73.28 ,50.00 
01,000,02,003,0098,0,2867,46,2913,4052,21391,2,1,1,1,1,0,70.53 ,71.89 ,50.00 
01,000,02,003,0099,0,4969,82,5051,7064,21391,2,1,1,1,1,0,70.53 ,71.50 ,50.00 
01,000,02,003,0100,0,4358,84,4442,6086,21391,2,1,1,1,1,0,70.53 ,72.99 ,50.00 
01,000,02,003,0101,0,3024,45,3069,4333,21391,2,1,1,1,1,0,70.53 ,70.83 ,50.00 
01,000,02,003,0102,0,4030,82,4112,5635,21391,2,1,1,1,1,0,70.53 ,72.97 ,50.00 
01,000,02,003,0103,0,4597,68,4665,6293,21391,2,1,1,1,1,0,70.53 ,74.13 ,50.00 
01,000,02,003,0104,0,2665,46,2711,3894,64870,3,1,3,0,1,0,68.56 ,69.62 ,33.33 
01,000,02,003,0105,0,3113,64,3177,4400,54724,3,1,3,0,1,0,68.03 ,72.20 ,33.33 
01,000,02,003,0106,0,3479,47,3526,4840,66909,3,1,3,0,1,0,67.07 ,72.85 ,33.33 
01,000,02,003,0107,0,3706,54,3760,5173,65951,4,1,4,0,1,0,69.35 ,72.69 ,25.00 
01,000,02,003,0108,0,3258,62,3320,4461,167530,2,1,2,0,1,0,67.30 ,74.42 ,50.00 
01,000,02,003,0109,0,3431,54,3485,4988,176314,5,1,5,0,1,0,66.13 ,69.87 ,20.00 
01,000,02,003,0110,0,4707,67,4774,6624,11140,3,1,3,0,1,0,77.24 ,72.07 ,33.33 
01,000,02,003,0111,0,3867,63,3930,5541,230816,4,1,4,0,1,0,68.37 ,70.93 ,25.00 
01,000,02,003,0112,0,4798,77,4875,6358,83734,4,1,3,1,1,0,68.19 ,76.68 ,25.00 
01,000,02,003,0113,0,2740,37,2777,3698,86753,2,1,2,0,1,0,68.39 ,75.09 ,50.00 
01,000,02,003,0114,0,4573,90,4663,6612,16836,2,1,2,0,1,0,68.89 ,70.52 ,50.00 
01,000,02,003,0115,0,3961,64,4025,5643,34322,3,1,3,0,1,0,67.06 ,71.33 ,33.33 
01,000,02,003,0116,0,3982,58,4040,5686,48495,3,1,3,0,1,0,68.50 ,71.05 ,33.33 
01,000,02,003,0117,0,2180,36,2216,3101,37827,2,1,2,0,1,0,68.23 ,71.46 ,50.00 
01,000,02,003,0118,0,2631,57,2688,3700,45952,4,1,4,0,1,0,69.40 ,72.65 ,25.00 
01,000,02,003,0119,0,3534,67,3601,4983,26578,3,1,2,1,0,1,72.11 ,72.27 ,33.33 
01,000,02,003,0120,0,1493,27,1520,2081,126723,5,1,5,0,1,0,68.05 ,73.04 ,20.00 
01,000,02,003,0121,0,4511,76,4587,6847,55784,2,1,2,0,1,0,67.43 ,66.99 ,50.00 
01,000,02,003,0122,0,2691,63,2754,3771,46614,3,1,3,0,1,0,71.85 ,73.03 ,33.33 
01,000,02,003,0123,0,3603,50,3653,5014,35495,2,1,2,0,1,0,70.96 ,72.86 ,50.00 
01,000,02,003,0124,0,3251,55,3306,4665,35600,3,1,3,0,1,0,70.87 ,70.87 ,33.33 
01,000,02,003,0125,0,2456,42,2498,3468,34697,2,1,2,0,1,0,70.68 ,72.03 ,50.00 
01,000,02,003,0126,0,2881,38,2919,4025,40154,3,1,3,0,1,0,70.22 ,72.52 ,33.33 
01,000,02,003,0127,0,3844,60,3904,5546,45263,2,1,1,1,0,1,69.88 ,70.39 ,50.00 
01,000,02,003,0128,0,2494,32,2526,3477,18145,2,1,1,1,1,0,75.44 ,72.65 ,50.00 
01,000,02,003,0129,0,512,3,515,772,33854,4,1,4,0,1,0,69.84 ,66.71 ,25.00 
01,000,02,003,0130,0,2908,51,2959,4174,56825,5,1,4,1,1,0,70.60 ,70.89 ,20.00 
01,000,02,004,0131,0,3122,53,3175,4607,29319,3,1,2,1,0,1,71.16 ,68.92 ,33.33 
01,000,02,004,0132,0,2366,45,2411,3344,32738,2,1,2,0,1,0,71.46 ,72.10 ,50.00 
01,000,02,004,0133,0,2330,41,2371,3240,38642,2,1,2,0,1,0,75.45 ,73.18 ,50.00 
01,000,02,004,0134,0,1951,25,1976,2689,20980,3,1,2,1,1,0,78.43 ,73.48 ,33.33 
01,000,02,004,0135,0,3709,73,3782,5312,17118,2,1,2,0,1,0,75.44 ,71.20 ,50.00 
01,000,02,004,0136,0,2380,51,2431,3316,32659,3,1,3,0,1,0,73.46 ,73.31 ,33.33 
01,000,02,004,0137,0,2536,46,2582,3590,104631,4,1,4,0,1,0,68.89 ,71.92 ,25.00 
01,000,02,004,0138,0,2446,47,2493,3496,87402,5,1,3,2,0,1,71.85 ,71.31 ,20.00 
01,000,02,004,0139,0,2632,40,2672,3644,97966,2,1,2,0,1,0,70.06 ,73.33 ,50.00 
01,000,02,004,0140,0,3531,84,3615,4993,61192,3,1,3,0,1,0,72.17 ,72.40 ,33.33 
01,000,02,004,0141,0,4262,94,4356,6019,12240,2,1,2,0,1,0,74.61 ,72.37 ,50.00 
01,000,02,004,0142,0,2494,55,2549,3327,42810,5,1,5,0,1,0,72.35 ,76.62 ,20.00 
01,000,02,004,0143,0,2624,77,2701,3757,20608,1,1,1,0,1,0,74.58 ,71.89 ,100.00 
01,000,02,004,0144,0,2865,67,2932,3973,17572,4,1,4,0,1,0,76.49 ,73.80 ,25.00 
01,000,02,004,0145,0,3097,56,3153,4224,17693,3,1,3,0,1,0,76.07 ,74.64 ,33.33 
01,000,02,004,0146,0,4603,86,4689,6561,23461,2,1,2,0,1,0,74.03 ,71.47 ,50.00 
01,000,02,004,0147,0,5234,76,5310,7182,22577,3,1,3,0,1,0,73.83 ,73.93 ,33.33 
01,000,02,004,0148,0,3205,44,3249,4437,17743,4,1,4,0,1,0,66.35 ,73.23 ,25.00 
01,000,02,004,0149,0,2868,57,2925,4166,15347,4,1,3,1,1,0,70.05 ,70.21 ,25.00 
01,000,03,005,0150,0,3397,47,3444,4757,101349,4,1,4,0,1,0,69.21 ,72.40 ,25.00 
01,000,03,005,0151,0,4652,80,4732,6853,48353,2,1,2,0,1,0,71.10 ,69.05 ,50.00 
01,000,03,005,0152,0,3846,57,3903,5628,67502,3,1,3,0,1,0,71.68 ,69.35 ,33.33 
01,000,03,005,0153,0,2573,49,2622,3715,50269,3,1,2,1,0,1,71.34 ,70.58 ,33.33 
01,000,03,005,0154,0,2944,47,2991,4293,32084,1,1,1,0,1,0,73.21 ,69.67 ,100.00 
01,000,03,005,0155,0,2769,61,2830,4107,46369,2,1,1,1,1,0,72.82 ,68.91 ,50.00 
01,000,03,005,0156,0,2486,34,2520,3722,35730,3,1,2,1,0,1,73.57 ,67.71 ,33.33 
01,000,03,005,0157,0,2431,50,2481,3631,22895,4,1,4,0,1,0,74.21 ,68.33 ,25.00 
01,000,03,005,0158,0,2414,45,2459,3610,31918,2,1,2,0,1,0,72.24 ,68.12 ,50.00 
01,000,03,005,0159,0,4115,69,4184,6075,21129,4,1,3,1,1,0,71.26 ,68.87 ,25.00 
01,000,03,005,0160,0,3269,40,3309,4739,32226,2,1,2,0,1,0,75.05 ,69.82 ,50.00 
01,000,03,005,0161,0,1496,32,1528,2192,29407,2,1,2,0,1,0,74.15 ,69.71 ,50.00 
01,000,03,005,0162,0,2348,56,2404,3441,32268,5,1,5,0,1,0,72.71 ,69.86 ,20.00 
01,000,03,005,0163,0,3294,76,3370,4708,19176,4,1,4,0,1,0,75.44 ,71.58 ,25.00 
01,000,03,005,0164,0,4565,108,4673,7022,15445,4,1,4,0,1,0,73.00 ,66.55 ,25.00 
01,000,03,005,0165,0,3821,74,3895,5385,29075,2,1,2,0,1,0,75.10 ,72.33 ,50.00 
01,000,03,005,0166,0,3228,51,3279,5288,31836,3,1,3,0,1,0,77.09 ,62.01 ,33.33 
01,000,03,005,0167,0,5064,68,5132,6898,29794,2,1,2,0,1,0,76.86 ,74.40 ,50.00 
01,000,03,005,0168,0,3318,51,3369,4664,33118,3,1,3,0,1,0,73.90 ,72.23 ,33.33 
01,000,03,005,0169,0,4034,58,4092,5586,32276,2,1,2,0,1,0,77.09 ,73.25 ,50.00 
01,000,03,005,0170,0,4361,91,4452,6464,33009,2,1,2,0,1,0,69.32 ,68.87 ,50.00 
01,000,03,005,0171,0,4045,82,4127,5843,44400,2,1,1,1,0,1,71.47 ,70.63 ,50.00 
01,000,03,005,0172,0,3621,84,3705,5143,33343,2,1,2,0,1,0,75.70 ,72.04 ,50.00 
01,000,03,005,0173,0,4004,84,4088,6227,36174,2,1,1,1,1,0,73.25 ,65.65 ,50.00 
01,000,03,005,0174,0,2168,48,2216,3084,70848,2,1,2,0,1,0,70.32 ,71.85 ,50.00 
01,000,03,005,0175,0,1703,46,1749,2528,17792,3,1,3,0,1,0,75.83 ,69.19 ,33.33 
01,000,03,005,0176,0,2148,54,2202,3101,36049,2,1,2,0,1,0,72.87 ,71.01 ,50.00 
01,000,03,005,0177,0,3764,92,3856,5473,28890,2,1,2,0,1,0,77.96 ,70.45 ,50.00 
01,000,03,005,0178,0,1650,41,1691,2444,29953,2,1,2,0,1,0,78.34 ,69.19 ,50.00 
01,000,03,005,0179,0,2050,41,2091,2975,24141,2,1,2,0,1,0,76.76 ,70.29 ,50.00 
01,000,03,005,0180,0,3227,72,3299,4752,18181,3,1,3,0,1,0,77.42 ,69.42 ,33.33 
01,000,03,005,0181,0,1436,32,1468,2132,55364,3,1,2,1,1,0,73.18 ,68.86 ,33.33 
01,000,03,005,0182,0,2040,68,2108,3107,48329,3,1,3,0,1,0,71.48 ,67.85 ,33.33 
01,000,03,006,0183,0,2837,49,2886,4402,41241,2,1,2,0,1,0,72.61 ,65.56 ,50.00 
01,000,03,006,0184,0,2710,58,2768,3897,23360,2,1,2,0,1,0,73.52 ,71.03 ,50.00 
01,000,03,006,0185,0,1686,27,1713,2552,12046,1,1,1,0,1,0,73.88 ,67.12 ,100.00 
01,000,03,006,0186,0,1546,27,1573,2466,3735,3,1,3,0,1,0,78.80 ,63.79 ,33.33 
01,000,03,006,0187,0,2277,29,2306,3299,6123,1,1,1,0,1,0,73.22 ,69.90 ,100.00 
01,000,03,006,0188,0,3341,81,3422,4816,77741,2,1,2,0,1,0,70.06 ,71.05 ,50.00 
01,000,03,006,0189,0,2616,51,2667,3927,28743,2,1,2,0,1,0,74.31 ,67.91 ,50.00 
01,000,03,006,0190,0,3964,63,4027,5766,34569,2,1,2,0,1,0,76.39 ,69.84 ,50.00 
01,000,03,006,0191,0,3910,61,3971,5745,24120,4,1,4,0,1,0,74.23 ,69.12 ,25.00 
01,000,03,006,0192,0,2059,56,2115,2926,27803,6,1,6,0,1,0,77.28 ,72.28 ,16.67 
01,000,03,006,0193,0,2648,60,2708,3898,25066,3,1,2,1,0,1,76.55 ,69.47 ,33.33 
01,000,03,006,0194,0,2110,40,2150,3077,47348,6,1,6,0,1,0,73.39 ,69.87 ,16.67 
01,000,03,006,0195,0,2929,66,2995,4219,27885,2,1,2,0,1,0,74.49 ,70.99 ,50.00 
01,000,03,006,0196,0,2527,59,2586,3760,25247,1,1,1,0,1,0,70.92 ,68.78 ,100.00 
01,000,03,006,0197,0,2482,59,2541,3586,23624,4,1,4,0,1,0,74.42 ,70.86 ,25.00 
01,000,03,006,0198,0,3289,63,3352,4571,12018,2,1,2,0,1,0,79.45 ,73.33 ,50.00 
01,000,03,006,0199,0,3065,71,3136,4571,58115,2,1,2,0,1,0,71.67 ,68.61 ,50.00 
01,000,03,006,0200,0,3066,72,3138,4437,29940,4,1,2,2,0,1,73.17 ,70.72 ,25.00 
01,000,03,006,0201,0,2142,44,2186,3020,26231,2,1,2,0,1,0,71.24 ,72.38 ,50.00 
01,000,03,006,0202,0,4040,78,4118,5824,26157,3,1,2,1,1,0,75.61 ,70.71 ,33.33 
01,000,03,006,0203,0,1625,39,1664,2369,23364,2,1,2,0,1,0,77.59 ,70.24 ,50.00 
01,000,03,006,0204,0,3523,66,3589,5245,13410,1,1,1,0,1,0,76.41 ,68.43 ,100.00 
01,000,03,006,0205,0,3271,42,3313,4516,45332,2,1,2,0,1,0,71.70 ,73.36 ,50.00 
01,000,03,006,0206,0,2667,53,2720,3810,42073,1,1,1,0,1,0,72.52 ,71.39 ,100.00 
01,000,03,006,0207,0,4571,101,4672,6484,34625,3,1,3,0,1,0,68.50 ,72.05 ,33.33 
01,000,03,006,0208,0,3802,88,3890,5423,29958,1,1,1,0,1,0,72.08 ,71.73 ,100.00 
01,000,03,006,0209,0,3130,129,3259,4608,8129,2,1,2,0,1,0,75.56 ,70.72 ,50.00 
01,000,03,006,0210,0,2710,52,2762,3911,16927,2,1,2,0,1,0,74.49 ,70.62 ,50.00 
01,000,03,006,0211,0,3919,80,3999,5512,11793,2,1,2,0,1,0,77.33 ,72.55 ,50.00 
01,000,03,006,0212,0,5373,86,5459,7578,9476,3,1,3,0,1,0,78.21 ,72.04 ,33.33 
01,000,03,006,0213,0,2878,40,2918,4139,6069,1,1,1,0,1,0,81.35 ,70.50 ,100.00 
01,000,03,006,0214,0,3647,67,3714,5367,66070,2,1,2,0,1,0,73.08 ,69.20 ,50.00 
01,000,03,006,0215,0,4580,69,4649,6558,63949,2,1,2,0,1,0,68.93 ,70.89 ,50.00 
01,000,03,006,0216,0,2730,62,2792,3946,38471,3,1,3,0,1,0,73.15 ,70.76 ,33.33 
01,000,03,006,0217,0,2642,46,2688,3745,4363,1,1,1,0,1,0,84.09 ,71.78 ,100.00 
01,000,03,006,0218,0,4225,69,4294,5874,198003,7,1,7,0,1,0,68.47 ,73.10 ,14.29 
01,000,03,006,0219,0,1871,35,1906,2736,322860,2,1,2,0,1,0,70.88 ,69.66 ,50.00 
01,000,03,006,0220,0,2428,52,2480,3485,72071,4,1,3,1,1,0,69.35 ,71.16 ,25.00 
01,000,03,006,0221,0,3961,82,4043,5621,115210,5,1,4,1,1,0,71.27 ,71.93 ,20.00 
01,000,03,006,0222,0,2790,85,2875,3994,46585,3,1,3,0,1,0,71.99 ,71.98 ,33.33 
01,000,03,006,0223,0,1646,67,1713,2314,33408,2,1,2,0,1,0,72.90 ,74.03 ,50.00 
01,000,04,007,0224,0,1651,45,1696,2418,54015,3,1,3,0,1,0,70.47 ,70.14 ,33.33 
01,000,04,007,0225,0,2245,57,2302,3582,38516,4,1,3,1,0,1,74.20 ,64.27 ,25.00 
01,000,04,007,0226,0,1577,43,1620,2587,93699,2,1,2,0,1,0,70.26 ,62.62 ,50.00 
01,000,04,007,0227,0,2742,60,2802,4139,37932,3,1,3,0,1,0,72.72 ,67.70 ,33.33 
01,000,04,007,0228,0,1116,34,1150,1873,32281,2,1,2,0,1,0,73.00 ,61.40 ,50.00 
01,000,04,007,0229,0,2748,81,2829,4440,9563,2,1,2,0,1,0,81.07 ,63.72 ,50.00 
01,000,04,007,0230,0,1646,51,1697,2801,31469,3,1,3,0,1,0,69.26 ,60.59 ,33.33 
01,000,04,007,0231,0,3136,65,3201,4684,53629,2,1,2,0,1,0,71.07 ,68.34 ,50.00 
01,000,04,007,0232,0,1884,48,1932,2989,28701,2,1,2,0,1,0,73.23 ,64.64 ,50.00 
01,000,04,007,0233,0,1682,42,1724,2641,33173,2,1,2,0,1,0,72.77 ,65.28 ,50.00 
01,000,04,007,0234,0,2009,52,2061,3273,14679,1,1,1,0,1,0,72.27 ,62.97 ,100.00 
01,000,04,007,0235,0,1919,48,1967,3027,21714,2,1,2,0,1,0,71.51 ,64.98 ,50.00 
01,000,04,007,0236,0,2728,61,2789,4054,39279,3,1,3,0,1,0,71.92 ,68.80 ,33.33 
01,000,04,007,0237,0,2277,25,2302,3075,43673,3,1,2,1,1,0,74.56 ,74.86 ,33.33 
01,000,04,007,0238,0,5394,94,5488,7762,46319,4,1,4,0,1,0,75.51 ,70.70 ,25.00 
01,000,04,007,0239,0,1560,39,1599,2170,17071,4,1,4,0,1,0,75.95 ,73.69 ,25.00 
01,000,04,007,0240,0,4481,102,4583,6418,8821,2,1,2,0,1,0,77.51 ,71.41 ,50.00 
01,000,04,007,0241,0,715,10,725,1022,12705,3,1,3,0,1,0,78.77 ,70.94 ,33.33 
01,000,04,007,0242,0,2782,52,2834,3983,17847,2,1,2,0,1,0,75.61 ,71.15 ,50.00 
01,000,04,007,0243,0,2707,92,2799,4027,1793,2,1,2,0,1,0,72.28 ,69.51 ,50.00 
01,000,04,007,0244,0,3481,74,3555,5033,4715,3,1,3,0,1,0,69.10 ,70.63 ,33.33 
01,000,04,007,0245,0,2761,62,2823,4011,3361,2,1,2,0,1,0,63.67 ,70.38 ,50.00 
01,000,04,007,0246,0,2979,98,3077,4505,215769,3,1,3,0,1,0,70.85 ,68.30 ,33.33 
01,000,04,007,0247,0,2968,61,3029,4976,57920,5,1,5,0,1,0,70.72 ,60.87 ,20.00 
01,000,04,007,0248,0,4636,95,4731,6678,49814,3,1,3,0,1,0,68.51 ,70.84 ,33.33 
01,000,04,007,0249,0,2379,50,2429,3381,31288,4,1,4,0,1,0,72.47 ,71.84 ,25.00 
01,000,04,007,0250,0,4018,90,4108,5819,54439,2,1,2,0,1,0,70.23 ,70.60 ,50.00 
01,000,04,007,0251,0,3621,84,3705,5388,30352,3,1,3,0,1,0,73.32 ,68.76 ,33.33 
01,000,04,007,0252,0,4174,68,4242,6089,12068,2,1,2,0,1,0,73.29 ,69.67 ,50.00 
01,000,04,007,0253,0,2848,50,2898,4189,23483,4,1,3,1,1,0,70.99 ,69.18 ,25.00 
01,000,04,007,0254,0,2491,47,2538,3798,27171,2,1,2,0,1,0,71.91 ,66.82 ,50.00 
01,000,04,007,0255,0,2736,56,2792,4119,28497,4,1,4,0,1,0,72.06 ,67.78 ,25.00 
01,000,04,007,0256,0,1985,41,2026,2900,29165,2,1,2,0,1,0,76.82 ,69.86 ,50.00 
01,000,04,007,0257,0,3390,80,3470,4935,24117,3,1,3,0,1,0,74.10 ,70.31 ,33.33 
01,000,04,007,0258,0,3176,45,3221,4297,62360,3,1,3,0,1,0,72.28 ,74.96 ,33.33 
01,000,04,007,0259,0,2414,48,2462,3551,19284,2,1,1,1,1,0,74.36 ,69.33 ,50.00 
01,000,04,007,0260,0,2306,50,2356,3393,11822,3,1,2,1,0,1,76.39 ,69.44 ,33.33 
01,000,04,007,0261,0,1695,35,1730,2543,29554,2,1,2,0,1,0,73.76 ,68.03 ,50.00 
01,000,04,007,0262,0,3214,82,3296,4896,41370,2,1,2,0,1,0,70.43 ,67.32 ,50.00 
01,000,04,007,0263,0,2085,40,2125,3098,15392,5,1,5,0,1,0,69.65 ,68.59 ,20.00 
01,000,04,007,0264,0,2046,50,2096,2875,22763,2,1,2,0,1,0,74.19 ,72.90 ,50.00 
01,000,04,007,0265,0,1726,24,1750,2328,13197,3,1,3,0,1,0,74.47 ,75.17 ,33.33 
01,000,04,008,0266,0,1821,56,1877,2858,23322,2,1,2,0,1,0,74.55 ,65.68 ,50.00 
01,000,04,008,0267,0,1863,41,1904,2774,13109,2,1,2,0,1,0,81.79 ,68.64 ,50.00 
01,000,04,008,0268,0,2561,83,2644,3853,10879,4,1,4,0,1,0,75.75 ,68.62 ,25.00 
01,000,04,008,0269,0,1992,43,2035,2976,8787,4,1,4,0,1,0,79.03 ,68.38 ,25.00 
01,000,04,008,0270,0,2883,64,2947,4278,6575,2,1,2,0,1,0,75.44 ,68.89 ,50.00 
01,000,04,008,0271,0,2123,54,2177,3231,7265,2,1,2,0,1,0,72.02 ,67.38 ,50.00 
01,000,04,008,0272,0,2528,48,2576,3762,2739,2,1,2,0,1,0,90.98 ,68.47 ,50.00 
01,000,04,008,0273,0,2967,72,3039,4238,6256,2,1,2,0,1,0,72.20 ,71.71 ,50.00 
01,000,04,008,0274,0,2829,61,2890,4047,4762,2,1,2,0,1,0,70.92 ,71.41 ,50.00 
01,000,04,008,0275,0,2094,39,2133,3201,7974,2,1,2,0,1,0,69.80 ,66.64 ,50.00 
01,000,04,008,0276,0,5135,105,5240,7582,5118,1,1,1,0,1,0,69.19 ,69.11 ,100.00 
01,000,04,008,0277,0,2140,41,2181,3221,5084,2,1,2,0,1,0,72.38 ,67.71 ,50.00 
01,000,04,008,0278,0,3493,61,3554,5171,5104,2,1,2,0,1,0,73.26 ,68.73 ,50.00 
01,000,04,008,0279,0,1643,29,1672,2367,110993,2,1,2,0,1,0,70.05 ,70.64 ,50.00 
01,000,04,008,0280,0,1828,47,1875,2655,18491,2,1,2,0,1,0,73.48 ,70.62 ,50.00 
01,000,04,008,0281,0,2618,67,2685,3886,10994,2,1,2,0,1,0,71.64 ,69.09 ,50.00 
01,000,04,008,0282,0,1792,36,1828,2647,20016,2,1,2,0,1,0,75.15 ,69.06 ,50.00 
01,000,04,008,0283,0,2140,39,2179,3093,9827,3,1,2,1,1,0,74.68 ,70.45 ,33.33 
01,000,04,008,0284,0,1851,47,1898,2873,10594,2,1,2,0,1,0,76.10 ,66.06 ,50.00 
01,000,04,008,0285,0,3124,68,3192,4487,11060,2,1,2,0,1,0,78.10 ,71.14 ,50.00 
01,000,04,008,0286,0,3708,65,3773,5250,10311,3,1,3,0,1,0,77.58 ,71.87 ,33.33 
01,000,04,008,0287,0,4408,86,4494,6339,13349,1,1,1,0,1,0,73.95 ,70.89 ,100.00 
01,000,04,008,0288,0,3276,64,3340,4697,6667,2,1,2,0,1,0,73.50 ,71.11 ,50.00 
01,000,04,008,0289,0,3325,66,3391,4681,2844,1,1,1,0,1,0,70.85 ,72.44 ,100.00 
01,000,04,008,0290,0,2558,58,2616,3657,4788,2,1,2,0,1,0,65.31 ,71.53 ,50.00 
01,000,05,009,0291,0,1721,51,1772,2569,3678,2,1,2,0,1,0,71.67 ,68.98 ,50.00 
01,000,05,009,0292,0,1723,33,1756,2503,3369,2,1,2,0,1,0,69.69 ,70.16 ,50.00 
01,000,05,009,0293,0,1510,42,1552,2261,4082,2,1,2,0,1,0,74.13 ,68.64 ,50.00 
01,000,05,009,0294,0,2624,64,2688,3828,3156,2,1,2,0,1,0,67.87 ,70.22 ,50.00 
01,000,05,009,0295,0,2615,57,2672,3856,108272,2,1,2,0,1,0,69.48 ,69.29 ,50.00 
01,000,05,009,0296,0,3234,62,3296,4622,13809,3,1,3,0,1,0,77.12 ,71.31 ,33.33 
01,000,05,009,0297,0,3102,58,3160,4460,32029,4,1,3,1,1,0,73.99 ,70.85 ,25.00 
01,000,05,009,0298,0,1948,43,1991,2841,20537,3,1,2,1,1,0,72.99 ,70.08 ,33.33 
01,000,05,009,0299,0,3107,51,3158,4402,76730,2,1,2,0,1,0,71.82 ,71.74 ,50.00 
01,000,05,009,0300,0,2536,66,2602,3641,20398,2,1,1,1,0,1,74.53 ,71.46 ,50.00 
01,000,05,009,0301,0,3489,61,3550,5070,16339,2,1,2,0,1,0,74.32 ,70.02 ,50.00 
01,000,05,009,0302,0,3024,75,3099,4429,6372,3,1,2,1,1,0,75.41 ,69.97 ,33.33 
01,000,05,009,0303,0,2191,40,2231,3166,14972,3,1,3,0,1,0,73.24 ,70.47 ,33.33 
01,000,05,009,0304,0,3921,86,4007,5759,13366,2,1,2,0,1,0,76.24 ,69.58 ,50.00 
01,000,05,009,0305,0,2011,27,2038,2981,15265,3,1,2,1,1,0,65.37 ,68.37 ,33.33 
01,000,05,009,0306,0,1781,27,1808,2560,7643,3,1,3,0,1,0,64.07 ,70.63 ,33.33 
01,000,05,009,0307,0,1806,28,1834,2629,7077,2,1,2,0,1,0,66.98 ,69.76 ,50.00 
01,000,05,009,0308,0,1979,43,2022,2887,53093,1,1,1,0,1,0,71.32 ,70.04 ,100.00 
01,000,05,009,0309,0,4170,80,4250,5983,12768,3,1,2,1,1,0,76.33 ,71.03 ,33.33 
01,000,05,009,0310,0,3287,92,3379,5046,9206,3,1,3,0,1,0,76.96 ,66.96 ,33.33 
01,000,05,009,0311,0,4349,99,4448,6213,8377,2,1,2,0,1,0,77.82 ,71.59 ,50.00 
01,000,05,009,0312,0,685,11,696,1107,4425,2,1,2,0,1,0,86.31 ,62.87 ,50.00 
01,000,05,009,0313,0,1841,48,1889,2972,3183,3,1,3,0,1,0,71.47 ,63.56 ,33.33 
01,000,05,009,0314,0,1516,36,1552,2472,19130,9,1,8,1,1,0,68.74 ,62.78 ,11.11 
01,000,05,009,0315,0,1853,62,1915,2825,9339,3,1,3,0,1,0,74.07 ,67.79 ,33.33 
01,000,05,009,0316,0,2298,55,2353,3581,12403,1,1,1,0,1,0,69.14 ,65.71 ,100.00 
01,000,05,009,0317,0,2261,78,2339,3528,9766,3,1,3,0,1,0,74.66 ,66.30 ,33.33 
01,000,05,009,0318,0,2402,53,2455,3562,5214,3,1,3,0,1,0,75.55 ,68.92 ,33.33 
01,000,05,009,0319,0,2587,82,2669,4019,363,3,1,3,0,1,0,84.85 ,66.41 ,33.33 
01,000,05,009,0320,0,3677,96,3773,5332,5034,3,1,3,0,1,0,77.69 ,70.76 ,33.33 
01,000,05,009,0321,0,3980,114,4094,5980,1635,1,1,1,0,1,0,85.81 ,68.46 ,100.00 
01,000,05,010,0322,0,2634,75,2709,4088,822,2,1,2,0,1,0,78.47 ,66.27 ,50.00 
01,000,05,010,0323,0,1658,36,1694,2733,825,2,1,2,0,1,0,71.76 ,61.98 ,50.00 
01,000,05,010,0324,0,1820,52,1872,2890,825,2,1,2,0,1,0,71.76 ,64.78 ,50.00 
01,000,05,010,0325,0,3787,100,3887,5710,825,2,1,2,0,1,0,71.76 ,68.07 ,50.00 
01,000,05,010,0326,0,3366,77,3443,5162,123456,2,1,2,0,1,0,71.76 ,66.70 ,50.00 
01,000,05,010,0327,0,2974,66,3040,4429,123456,2,1,2,0,1,0,71.76 ,68.64 ,50.00 
01,000,05,010,0328,0,2974,60,3034,4232,123456,2,1,2,0,1,0,71.76 ,71.69 ,50.00 
01,000,05,010,0329,0,2217,49,2266,3128,123456,2,1,2,0,1,0,71.76 ,72.44 ,50.00 
01,000,05,010,0330,0,2592,71,2663,3679,123456,2,1,2,0,1,0,71.76 ,72.38 ,50.00 
01,000,05,010,0331,0,2823,44,2867,3851,123456,2,1,2,0,1,0,71.76 ,74.45 ,50.00 
01,000,05,010,0332,0,4689,84,4773,6664,123456,2,1,2,0,1,0,71.76 ,71.62 ,50.00 
01,000,05,010,0333,0,3003,58,3061,4439,123456,2,1,2,0,1,0,71.76 ,68.96 ,50.00 
01,000,05,010,0334,0,2400,32,2432,3324,123456,2,1,2,0,1,0,71.76 ,73.16 ,50.00 
01,000,05,010,0335,0,5388,84,5472,7285,123456,2,1,2,0,1,0,71.76 ,75.11 ,50.00 
01,000,05,010,0336,0,3159,67,3226,4610,123456,2,1,2,0,1,0,71.76 ,69.98 ,50.00 
01,000,05,010,0337,0,4222,88,4310,5990,123456,2,1,2,0,1,0,71.76 ,71.95 ,50.00 
01,000,05,010,0338,0,2618,63,2681,3950,123456,2,1,2,0,1,0,71.76 ,67.87 ,50.00 
01,000,05,010,0339,0,4877,97,4974,7030,123456,2,1,2,0,1,0,71.76 ,70.75 ,50.00 
01,000,05,010,0340,0,3150,65,3215,4509,123456,2,1,2,0,1,0,71.76 ,71.30 ,50.00 
01,000,05,010,0341,0,2254,43,2297,3152,123456,2,1,2,0,1,0,71.76 ,72.87 ,50.00 
01,000,05,010,0342,0,3892,77,3969,5414,123456,2,1,2,0,1,0,71.76 ,73.31 ,50.00 
01,000,05,010,0343,0,2693,39,2732,3793,123456,2,1,2,0,1,0,71.76 ,72.03 ,50.00 
01,000,05,010,0344,0,1898,36,1934,2703,123456,2,1,2,0,1,0,71.76 ,71.55 ,50.00 
01,000,05,010,0345,0,3872,72,3944,5857,123456,2,1,2,0,1,0,71.76 ,67.34 ,50.00 
01,000,05,010,0346,0,3121,62,3183,4408,123456,2,1,2,0,1,0,71.76 ,72.21 ,50.00 
01,000,05,010,0347,0,2384,44,2428,3437,123456,2,1,2,0,1,0,71.76 ,70.64 ,50.00 
01,000,05,010,0348,0,1759,30,1789,2413,123456,2,1,2,0,1,0,71.76 ,74.14 ,50.00 
01,000,05,010,0349,0,2811,49,2860,3942,123456,2,1,2,0,1,0,71.76 ,72.55 ,50.00 
01,000,05,010,0350,0,2385,47,2432,3291,123456,2,1,2,0,1,0,71.76 ,73.90 ,50.00 
01,000,05,010,0351,0,2880,51,2931,4019,123456,2,1,2,0,1,0,71.76 ,72.93 ,50.00 
01,000,05,010,0352,0,2823,56,2879,3967,123456,2,1,2,0,1,0,71.76 ,72.57 ,50.00 
01,000,05,010,0353,0,3680,70,3750,5203,123456,2,1,2,0,1,0,71.76 ,72.07 ,50.00 
01,000,05,010,0354,0,3511,55,3566,4856,123456,2,1,2,0,1,0,71.76 ,73.43 ,50.00 
01,000,05,010,0355,0,3215,49,3264,4366,123456,2,1,2,0,1,0,71.76 ,74.76 ,50.00 
01,000,05,010,0356,0,2491,50,2541,3529,123456,2,1,2,0,1,0,71.76 ,72.00 ,50.00 
01,000,05,010,0357,0,1833,40,1873,2573,123456,2,1,2,0,1,0,71.76 ,72.79 ,50.00 
01,000,06,011,0358,0,3063,42,3105,4569,123456,2,1,2,0,1,0,71.76 ,67.96 ,50.00 
01,000,06,011,0359,0,2561,49,2610,3850,123456,2,1,2,0,1,0,71.76 ,67.79 ,50.00 
01,000,06,011,0360,0,3353,49,3402,4937,123456,2,1,2,0,1,0,71.76 ,68.91 ,50.00 
01,000,06,011,0361,0,4154,70,4224,6278,123456,2,1,2,0,1,0,71.76 ,67.28 ,50.00 
01,000,06,011,0362,0,2752,74,2826,4547,123456,2,1,2,0,1,0,71.76 ,62.15 ,50.00 
01,000,06,011,0363,0,3777,40,3817,5492,123456,2,1,2,0,1,0,71.76 ,69.50 ,50.00 
01,000,06,011,0364,0,3479,51,3530,5193,123456,2,1,2,0,1,0,71.76 ,67.98 ,50.00 
01,000,06,011,0365,0,1870,38,1908,2768,123456,2,1,2,0,1,0,71.76 ,68.93 ,50.00 
01,000,06,011,0366,0,2459,31,2490,3657,123456,2,1,2,0,1,0,71.76 ,68.09 ,50.00 
01,000,06,011,0367,0,4027,81,4108,6385,123456,2,1,2,0,1,0,71.76 ,64.34 ,50.00 
01,000,06,011,0368,0,3130,40,3170,4531,123456,2,1,2,0,1,0,71.76 ,69.96 ,50.00 
01,000,06,011,0369,0,2429,30,2459,3604,123456,2,1,2,0,1,0,71.76 ,68.23 ,50.00 
01,000,06,011,0370,0,2236,39,2275,3308,123456,2,1,2,0,1,0,71.76 ,68.77 ,50.00 
01,000,06,011,0371,0,3464,56,3520,5061,123456,2,1,2,0,1,0,71.76 ,69.55 ,50.00 
01,000,06,011,0372,0,3035,38,3073,5248,123456,2,1,2,0,1,0,71.76 ,58.56 ,50.00 
01,000,06,011,0373,0,2718,34,2752,3957,123456,2,1,2,0,1,0,71.76 ,69.55 ,50.00 
01,000,06,011,0374,0,2994,48,3042,4326,123456,2,1,2,0,1,0,71.76 ,70.32 ,50.00 
01,000,06,011,0375,0,1850,22,1872,2623,123456,2,1,2,0,1,0,71.76 ,71.37 ,50.00 
01,000,06,011,0376,0,2026,34,2060,2872,123456,2,1,2,0,1,0,71.76 ,71.73 ,50.00 
01,000,06,011,0377,0,2854,45,2899,3953,123456,2,1,2,0,1,0,71.76 ,73.34 ,50.00 
01,000,06,011,0378,0,2883,61,2944,4108,123456,2,1,2,0,1,0,71.76 ,71.67 ,50.00 
01,000,06,011,0379,0,3601,50,3651,5291,123456,2,1,2,0,1,0,71.76 ,69.00 ,50.00 
01,000,06,011,0380,0,3592,46,3638,5105,123456,2,1,2,0,1,0,71.76 ,71.26 ,50.00 
01,000,06,011,0381,0,2004,31,2035,2979,123456,2,1,2,0,1,0,71.76 ,68.31 ,50.00 
01,000,06,011,0382,0,2746,45,2791,4082,123456,2,1,2,0,1,0,71.76 ,68.37 ,50.00 
01,000,06,011,0383,0,3375,50,3425,4851,123456,2,1,2,0,1,0,71.76 ,70.60 ,50.00 
01,000,06,011,0384,0,2950,54,3004,4359,123456,2,1,2,0,1,0,71.76 ,68.91 ,50.00 
01,000,06,011,0385,0,2953,44,2997,4436,123456,2,1,2,0,1,0,71.76 ,67.56 ,50.00 
01,000,06,011,0386,0,3450,56,3506,4905,123456,2,1,2,0,1,0,71.76 ,71.48 ,50.00 
01,000,06,011,0387,0,3247,64,3311,4665,123456,2,1,2,0,1,0,71.76 ,70.98 ,50.00 
01,000,06,011,0388,0,2491,44,2535,3524,123456,2,1,2,0,1,0,71.76 ,71.94 ,50.00 
01,000,06,011,0389,0,2468,37,2505,3521,123456,2,1,2,0,1,0,71.76 ,71.14 ,50.00 
01,000,06,011,0390,0,2336,36,2372,3494,123456,2,1,2,0,1,0,71.76 ,67.89 ,50.00 
01,000,06,011,0391,0,3339,42,3381,4949,123456,2,1,2,0,1,0,71.76 ,68.32 ,50.00 
01,000,06,011,0392,0,4319,51,4370,5963,123456,2,1,2,0,1,0,71.76 ,73.29 ,50.00 
01,000,06,011,0393,0,1766,28,1794,2619,123456,2,1,2,0,1,0,71.76 ,68.50 ,50.00 
01,000,06,011,0394,0,1656,26,1682,2384,123456,2,1,2,0,1,0,71.76 ,70.55 ,50.00 
01,000,06,011,0395,0,4767,54,4821,6869,123456,2,1,2,0,1,0,71.76 ,70.18 ,50.00 
01,000,06,011,0396,0,2126,23,2149,3226,123456,2,1,2,0,1,0,71.76 ,66.62 ,50.00 
01,000,06,011,0397,0,4228,59,4287,6442,123456,2,1,2,0,1,0,71.76 ,66.55 ,50.00 
01,000,06,011,0398,0,3518,53,3571,4927,123456,2,1,2,0,1,0,71.76 ,72.48 ,50.00 
01,000,06,011,0399,0,3189,52,3241,4466,123456,2,1,2,0,1,0,71.76 ,72.57 ,50.00 
01,000,06,011,0400,0,4347,77,4424,6052,123456,2,1,2,0,1,0,71.76 ,73.10 ,50.00 
01,000,06,011,0401,0,2404,30,2434,3399,123456,2,1,2,0,1,0,71.76 ,71.61 ,50.00 
01,000,06,011,0402,0,2566,53,2619,4095,123456,2,1,2,0,1,0,71.76 ,63.96 ,50.00 
01,000,06,011,0403,0,3057,48,3105,4826,123456,2,1,2,0,1,0,71.76 ,64.34 ,50.00 
01,000,06,011,0404,0,3304,52,3356,4899,123456,2,1,2,0,1,0,71.76 ,68.50 ,50.00 
01,000,06,011,0405,0,2505,48,2553,3872,123456,2,1,2,0,1,0,71.76 ,65.93 ,50.00 
01,000,06,011,0406,0,3143,58,3201,4737,123456,2,1,2,0,1,0,71.76 ,67.57 ,50.00 
01,000,06,011,0407,0,2310,48,2358,3414,123456,2,1,2,0,1,0,71.76 ,69.07 ,50.00 
01,000,06,011,0408,0,3571,68,3639,5278,123456,2,1,2,0,1,0,71.76 ,68.95 ,50.00 
01,000,06,011,0409,0,4274,81,4355,6226,123456,2,1,2,0,1,0,71.76 ,69.95 ,50.00 
01,000,06,011,0410,0,2287,29,2316,3303,123456,2,1,2,0,1,0,71.76 ,70.12 ,50.00 
01,000,06,012,0411,0,2991,34,3025,4224,123456,2,1,2,0,1,0,71.76 ,71.61 ,50.00 
01,000,06,012,0412,0,3618,54,3672,5158,123456,2,1,2,0,1,0,71.76 ,71.19 ,50.00 
01,000,06,012,0413,0,2516,30,2546,3464,123456,2,1,2,0,1,0,71.76 ,73.50 ,50.00 
01,000,06,012,0414,0,3514,66,3580,4922,123456,2,1,2,0,1,0,71.76 ,72.73 ,50.00 
01,000,06,012,0415,0,2637,46,2683,3711,123456,2,1,2,0,1,0,71.76 ,72.30 ,50.00 
01,000,06,012,0416,0,3090,54,3144,4348,123456,2,1,2,0,1,0,71.76 ,72.31 ,50.00 
01,000,06,012,0417,0,2712,35,2747,3638,123456,2,1,2,0,1,0,71.76 ,75.51 ,50.00 
01,000,06,012,0418,0,2493,40,2533,3513,123456,2,1,2,0,1,0,71.76 ,72.10 ,50.00 
01,000,06,012,0419,0,3905,60,3965,5497,123456,2,1,2,0,1,0,71.76 ,72.13 ,50.00 
01,000,06,012,0420,0,2936,42,2978,4207,123456,2,1,2,0,1,0,71.76 ,70.79 ,50.00 
01,000,06,012,0421,0,2080,35,2115,2816,123456,2,1,2,0,1,0,71.76 ,75.11 ,50.00 
01,000,06,012,0422,0,2745,27,2772,3800,123456,2,1,2,0,1,0,71.76 ,72.95 ,50.00 
01,000,06,012,0423,0,4847,76,4923,6743,123456,2,1,2,0,1,0,71.76 ,73.01 ,50.00 
01,000,06,012,0424,0,1744,35,1779,2528,123456,2,1,2,0,1,0,71.76 ,70.37 ,50.00 
01,000,06,012,0425,0,4115,54,4169,5779,123456,2,1,2,0,1,0,71.76 ,72.14 ,50.00 
01,000,06,012,0426,0,3428,61,3489,4867,123456,2,1,2,0,1,0,71.76 ,71.69 ,50.00 
01,000,06,012,0427,0,3108,42,3150,4473,123456,2,1,2,0,1,0,71.76 ,70.42 ,50.00 
01,000,06,012,0428,0,3538,51,3589,4837,123456,2,1,2,0,1,0,71.76 ,74.20 ,50.00 
01,000,06,012,0429,0,3365,44,3409,4541,123456,2,1,2,0,1,0,71.76 ,75.07 ,50.00 
01,000,06,012,0430,0,3858,52,3910,5384,123456,2,1,2,0,1,0,71.76 ,72.62 ,50.00 
01,000,06,012,0431,0,2125,30,2155,2996,123456,2,1,2,0,1,0,71.76 ,71.93 ,50.00 
01,000,06,012,0432,0,3291,47,3338,4685,123456,2,1,2,0,1,0,71.76 ,71.25 ,50.00 
01,000,06,012,0433,0,3572,40,3612,4934,123456,2,1,2,0,1,0,71.76 ,73.21 ,50.00 
01,000,06,012,0434,0,4155,63,4218,5866,123456,2,1,2,0,1,0,71.76 ,71.91 ,50.00 
01,000,06,012,0435,0,2506,64,2570,3789,123456,2,1,2,0,1,0,71.76 ,67.83 ,50.00 
01,000,06,012,0436,0,3878,61,3939,5545,123456,2,1,2,0,1,0,71.76 ,71.04 ,50.00 
01,000,06,012,0437,0,4302,50,4352,5739,123456,2,1,2,0,1,0,71.76 ,75.83 ,50.00 
01,000,06,012,0438,0,4836,81,4917,6885,123456,2,1,2,0,1,0,71.76 ,71.42 ,50.00 
01,000,06,012,0439,0,3900,64,3964,5348,123456,2,1,2,0,1,0,71.76 ,74.12 ,50.00 
01,000,06,012,0440,0,2108,27,2135,2892,123456,2,1,2,0,1,0,71.76 ,73.82 ,50.00 
01,000,06,012,0441,0,4696,72,4768,6517,123456,2,1,2,0,1,0,71.76 ,73.16 ,50.00 
01,000,06,012,0442,0,6175,79,6254,8681,123456,2,1,2,0,1,0,71.76 ,72.04 ,50.00 
01,000,06,012,0443,0,5223,80,5303,7217,123456,2,1,2,0,1,0,71.76 ,73.48 ,50.00 
01,000,06,012,0444,0,3906,50,3956,5427,123456,2,1,2,0,1,0,71.76 ,72.89 ,50.00 
01,000,06,012,0445,0,3463,41,3504,5042,123456,2,1,2,0,1,0,71.76 ,69.50 ,50.00 
01,000,06,012,0446,0,2565,38,2603,3635,123456,2,1,2,0,1,0,71.76 ,71.61 ,50.00 
01,000,06,012,0447,0,5557,88,5645,7967,123456,2,1,2,0,1,0,71.76 ,70.85 ,50.00 
01,000,06,012,0448,0,1657,21,1678,2305,123456,2,1,2,0,1,0,71.76 ,72.80 ,50.00 
01,000,06,012,0449,0,497,7,504,685,123456,2,1,2,0,1,0,71.76 ,73.58 ,50.00 
02,000,01,001,0001,0,929,12,941,1253,123456,2,1,2,0,1,0,71.76 ,75.10 ,50.00 
02,000,01,001,0002,0,398,5,403,523,123456,2,1,2,0,1,0,71.76 ,77.06 ,50.00 
02,000,01,001,0003,0,576,4,580,780,123456,2,1,2,0,1,0,71.76 ,74.36 ,50.00 
02,000,01,001,0004,0,936,14,950,1324,123456,2,1,2,0,1,0,71.76 ,71.75 ,50.00 
02,000,01,001,0005,0,881,20,901,1215,123456,2,1,2,0,1,0,71.76 ,74.16 ,50.00 
02,000,01,001,0006,0,1638,23,1661,2197,123456,2,1,2,0,1,0,71.76 ,75.60 ,50.00 
02,000,01,001,0007,0,692,9,701,930,123456,2,1,2,0,1,0,71.76 ,75.38 ,50.00 
02,000,01,001,0008,0,511,4,515,707,123456,2,1,2,0,1,0,71.76 ,72.84 ,50.00 
02,000,01,001,0009,0,817,11,828,1164,123456,2,1,2,0,1,0,71.76 ,71.13 ,50.00 
02,000,01,001,0010,0,590,7,597,838,123456,2,1,2,0,1,0,71.76 ,71.24 ,50.00 
02,000,01,001,0011,0,1354,34,1388,1848,123456,2,1,2,0,1,0,71.76 ,75.11 ,50.00 
02,000,01,001,0012,0,765,9,774,1080,123456,2,1,2,0,1,0,71.76 ,71.67 ,50.00 
02,000,01,001,0013,0,813,13,826,1130,123456,2,1,2,0,1,0,71.76 ,73.10 ,50.00 
02,000,01,001,0014,0,834,10,844,1160,123456,2,1,2,0,1,0,71.76 ,72.76 ,50.00 
02,000,01,001,0015,0,899,9,908,1237,123456,2,1,2,0,1,0,71.76 ,73.40 ,50.00 
02,000,01,001,0016,0,534,4,538,662,123456,2,1,2,0,1,0,71.76 ,81.27 ,50.00 
02,000,01,001,0017,0,1206,18,1224,1773,123456,2,1,2,0,1,0,71.76 ,69.04 ,50.00 
02,000,01,001,0018,0,908,17,925,1270,123456,2,1,2,0,1,0,71.76 ,72.83 ,50.00 
02,000,01,001,0019,0,548,5,553,735,123456,2,1,2,0,1,0,71.76 ,75.24 ,50.00 
02,000,01,001,0020,0,589,6,595,771,123456,2,1,2,0,1,0,71.76 ,77.17 ,50.00 
02,000,01,001,0021,0,634,14,648,937,123456,2,1,2,0,1,0,71.76 ,69.16 ,50.00 
02,000,01,002,0022,0,1496,10,1506,2053,123456,2,1,2,0,1,0,71.76 ,73.36 ,50.00 
02,000,01,002,0023,0,1467,18,1485,2099,123456,2,1,2,0,1,0,71.76 ,70.75 ,50.00 
02,000,01,002,0024,0,3170,31,3201,4256,123456,2,1,2,0,1,0,71.76 ,75.21 ,50.00 
02,000,01,002,0025,0,2830,30,2860,3914,123456,2,1,2,0,1,0,71.76 ,73.07 ,50.00 
02,000,01,002,0026,0,1115,10,1125,1473,123456,2,1,2,0,1,0,71.76 ,76.37 ,50.00 
02,000,01,002,0027,0,938,14,952,1223,123456,2,1,2,0,1,0,71.76 ,77.84 ,50.00 
02,000,01,002,0028,0,1521,15,1536,2005,123456,2,1,2,0,1,0,71.76 ,76.61 ,50.00 
02,000,01,002,0029,0,2884,32,2916,3970,123456,2,1,2,0,1,0,71.76 ,73.45 ,50.00 
02,000,01,002,0030,0,595,7,602,847,123456,2,1,2,0,1,0,71.76 ,71.07 ,50.00 
02,000,01,002,0031,0,1124,14,1138,1540,123456,2,1,2,0,1,0,71.76 ,73.90 ,50.00 
02,000,01,002,0032,0,1269,17,1286,1741,123456,2,1,2,0,1,0,71.76 ,73.87 ,50.00 
02,000,01,002,0033,0,2238,20,2258,3020,123456,2,1,2,0,1,0,71.76 ,74.77 ,50.00 
02,000,01,002,0034,0,2079,29,2108,2849,123456,2,1,2,0,1,0,71.76 ,73.99 ,50.00 
02,000,01,002,0035,0,1560,15,1575,2113,123456,2,1,2,0,1,0,71.76 ,74.54 ,50.00 
02,000,01,002,0036,0,3397,58,3455,5025,123456,2,1,2,0,1,0,71.76 ,68.76 ,50.00 
02,000,01,002,0037,0,686,10,696,1007,123456,2,1,2,0,1,0,71.76 ,69.12 ,50.00 
02,000,01,002,0038,0,6517,96,6613,9594,123456,2,1,2,0,1,0,71.76 ,68.93 ,50.00 
02,000,01,002,0039,0,2298,33,2331,3166,123456,2,1,2,0,1,0,71.76 ,73.63 ,50.00 
02,000,01,002,0040,0,2023,17,2040,2810,123456,2,1,2,0,1,0,71.76 ,72.60 ,50.00 
02,000,01,002,0041,0,1606,17,1623,2299,123456,2,1,2,0,1,0,71.76 ,70.60 ,50.00 
02,000,01,002,0042,0,1134,12,1146,1580,123456,2,1,2,0,1,0,71.76 ,72.53 ,50.00 
02,000,01,002,0043,0,754,6,760,964,123456,2,1,2,0,1,0,71.76 ,78.84 ,50.00 
02,000,01,002,0044,0,664,11,675,1004,123456,2,1,2,0,1,0,71.76 ,67.23 ,50.00 
02,000,01,002,0045,0,1123,14,1137,1519,123456,2,1,2,0,1,0,71.76 ,74.85 ,50.00 
02,000,01,002,0046,0,1105,12,1117,1577,123456,2,1,2,0,1,0,71.76 ,70.83 ,50.00 
02,000,01,002,0047,0,1091,14,1105,1498,123456,2,1,2,0,1,0,71.76 ,73.77 ,50.00 
02,000,01,002,0048,0,1162,15,1177,1553,123456,2,1,2,0,1,0,71.76 ,75.79 ,50.00 
02,000,01,002,0049,0,1169,21,1190,1657,123456,2,1,2,0,1,0,71.76 ,71.82 ,50.00 
02,000,01,002,0050,0,587,8,595,836,123456,2,1,2,0,1,0,71.76 ,71.17 ,50.00 
02,000,01,002,0051,0,741,9,750,1061,123456,2,1,2,0,1,0,71.76 ,70.69 ,50.00 
02,000,01,002,0052,0,837,9,846,1182,123456,2,1,2,0,1,0,71.76 ,71.57 ,50.00 
02,000,01,002,0053,0,807,15,822,1153,123456,2,1,2,0,1,0,71.76 ,71.29 ,50.00 
02,000,01,002,0054,0,671,12,683,949,123456,2,1,2,0,1,0,71.76 ,71.97 ,50.00 
02,000,01,002,0055,0,1094,12,1106,1532,123456,2,1,2,0,1,0,71.76 ,72.19 ,50.00 
02,000,01,002,0056,0,991,13,1004,1421,123456,2,1,2,0,1,0,71.76 ,70.65 ,50.00 
02,000,01,002,0057,0,1047,9,1056,1577,123456,2,1,2,0,1,0,71.76 ,66.96 ,50.00 
02,000,01,002,0058,0,846,7,853,1214,123456,2,1,2,0,1,0,71.76 ,70.26 ,50.00 
02,000,01,002,0059,0,464,6,470,638,123456,2,1,2,0,1,0,71.76 ,73.67 ,50.00 
02,000,01,003,0060,0,945,8,953,1279,123456,2,1,2,0,1,0,71.76 ,74.51 ,50.00 
02,000,01,003,0061,0,828,7,835,1120,123456,2,1,2,0,1,0,71.76 ,74.55 ,50.00 
02,000,01,003,0062,0,1188,16,1204,1659,123456,2,1,2,0,1,0,71.76 ,72.57 ,50.00 
02,000,01,003,0063,0,1475,22,1497,2040,123456,2,1,2,0,1,0,71.76 ,73.38 ,50.00 
02,000,01,003,0064,0,2011,16,2027,2707,123456,2,1,2,0,1,0,71.76 ,74.88 ,50.00 
02,000,01,003,0065,0,915,9,924,1273,123456,2,1,2,0,1,0,71.76 ,72.58 ,50.00 
02,000,01,003,0066,0,896,11,907,1346,123456,2,1,2,0,1,0,71.76 ,67.38 ,50.00 
02,000,01,003,0067,0,1732,16,1748,2403,123456,2,1,2,0,1,0,71.76 ,72.74 ,50.00 
02,000,01,003,0068,0,1196,14,1210,1642,123456,2,1,2,0,1,0,71.76 ,73.69 ,50.00 
02,000,01,003,0069,0,1854,14,1868,2567,123456,2,1,2,0,1,0,71.76 ,72.77 ,50.00 
02,000,01,003,0070,0,1189,12,1201,1620,123456,2,1,2,0,1,0,71.76 ,74.14 ,50.00 
02,000,01,003,0071,0,674,8,682,965,123456,2,1,2,0,1,0,71.76 ,70.67 ,50.00 
02,000,01,003,0072,0,1594,22,1616,2113,123456,2,1,2,0,1,0,71.76 ,76.48 ,50.00 
02,000,02,004,0073,0,1169,16,1185,1777,123456,2,1,2,0,1,0,71.76 ,66.69 ,50.00 
02,000,02,004,0074,0,937,15,952,1254,123456,2,1,2,0,1,0,71.76 ,75.92 ,50.00 
02,000,02,004,0075,0,446,6,452,615,123456,2,1,2,0,1,0,71.76 ,73.50 ,50.00 
02,000,02,004,0076,0,619,4,623,794,123456,2,1,2,0,1,0,71.76 ,78.46 ,50.00 
02,000,02,004,0077,0,417,6,423,565,123456,2,1,2,0,1,0,71.76 ,74.87 ,50.00 
02,000,02,004,0078,0,703,9,712,920,123456,2,1,2,0,1,0,71.76 ,77.39 ,50.00 
02,000,02,004,0079,0,795,4,799,1047,123456,2,1,2,0,1,0,71.76 ,76.31 ,50.00 
02,000,02,004,0080,0,617,12,629,836,123456,2,1,2,0,1,0,71.76 ,75.24 ,50.00 
02,000,02,004,0081,0,2153,16,2169,2941,123456,2,1,2,0,1,0,71.76 ,73.75 ,50.00 
02,000,02,004,0082,0,1084,16,1100,1496,123456,2,1,2,0,1,0,71.76 ,73.53 ,50.00 
02,000,02,004,0083,0,482,15,497,647,123456,2,1,2,0,1,0,71.76 ,76.82 ,50.00 
02,000,02,004,0084,0,1438,17,1455,1990,123456,2,1,2,0,1,0,71.76 ,73.12 ,50.00 
02,000,02,004,0085,0,929,12,941,1236,123456,2,1,2,0,1,0,71.76 ,76.13 ,50.00 
02,000,02,004,0086,0,1237,12,1249,1710,123456,2,1,2,0,1,0,71.76 ,73.04 ,50.00 
02,000,02,004,0087,0,1794,18,1812,2511,123456,2,1,2,0,1,0,71.76 ,72.16 ,50.00 
02,000,02,004,0088,0,956,10,966,1307,123456,2,1,2,0,1,0,71.76 ,73.91 ,50.00 
02,000,02,004,0089,0,1285,13,1298,1761,123456,2,1,2,0,1,0,71.76 ,73.71 ,50.00 
02,000,02,004,0090,0,1039,10,1049,1480,123456,2,1,2,0,1,0,71.76 ,70.88 ,50.00 
02,000,02,004,0091,0,710,10,720,940,123456,2,1,2,0,1,0,71.76 ,76.60 ,50.00 
02,000,02,004,0092,0,931,10,941,1202,123456,2,1,2,0,1,0,71.76 ,78.29 ,50.00 
02,000,02,004,0093,0,726,13,739,988,123456,2,1,2,0,1,0,71.76 ,74.80 ,50.00 
02,000,02,004,0094,0,352,4,356,449,123456,2,1,2,0,1,0,71.76 ,79.29 ,50.00 
02,000,02,004,0095,0,406,3,409,581,123456,2,1,2,0,1,0,71.76 ,70.40 ,50.00 
02,000,02,004,0096,0,426,5,431,589,123456,2,1,2,0,1,0,71.76 ,73.17 ,50.00 
02,000,02,004,0097,0,601,5,606,787,123456,2,1,2,0,1,0,71.76 ,77.00 ,50.00 
02,000,02,004,0098,0,403,6,409,545,123456,2,1,2,0,1,0,71.76 ,75.05 ,50.00 
02,000,02,004,0099,0,590,6,596,773,123456,2,1,2,0,1,0,71.76 ,77.10 ,50.00 
02,000,02,004,0100,0,844,9,853,1110,123456,2,1,2,0,1,0,71.76 ,76.85 ,50.00 
02,000,02,004,0101,0,961,22,983,1417,123456,2,1,2,0,1,0,71.76 ,69.37 ,50.00 
02,000,02,004,0102,0,876,15,891,1214,123456,2,1,2,0,1,0,71.76 ,73.39 ,50.00 
02,000,02,004,0103,0,2493,36,2529,3378,123456,2,1,2,0,1,0,71.76 ,74.87 ,50.00 
02,000,02,004,0104,0,1226,20,1246,1678,123456,2,1,2,0,1,0,71.76 ,74.26 ,50.00 
02,000,02,004,0105,0,795,15,810,1093,123456,2,1,2,0,1,0,71.76 ,74.11 ,50.00 
02,000,02,004,0106,0,1680,24,1704,2318,123456,2,1,2,0,1,0,71.76 ,73.51 ,50.00 
02,000,02,004,0107,0,1437,12,1449,1926,123456,2,1,2,0,1,0,71.76 ,75.23 ,50.00 
02,000,02,004,0108,0,1086,16,1102,1583,123456,2,1,2,0,1,0,71.76 ,69.61 ,50.00 
02,000,02,004,0109,0,1256,22,1278,1775,123456,2,1,2,0,1,0,71.76 ,72.00 ,50.00 
02,000,02,004,0110,0,6398,112,6510,9169,123456,2,1,2,0,1,0,71.76 ,71.00 ,50.00 
02,000,02,004,0111,0,11489,250,11739,17404,123456,2,1,2,0,1,0,71.76 ,67.45 ,50.00 
02,000,02,004,0112,0,3010,44,3054,4306,123456,2,1,2,0,1,0,71.76 ,70.92 ,50.00 
02,000,02,004,0113,0,5769,75,5844,8373,123456,2,1,2,0,1,0,71.76 ,69.80 ,50.00 
02,000,02,004,0114,0,10184,143,10327,15122,123456,2,1,2,0,1,0,71.76 ,68.29 ,50.00 
02,000,02,004,0115,0,11679,223,11902,18423,123456,2,1,2,0,1,0,71.76 ,64.60 ,50.00 
02,000,02,005,0116,0,5496,70,5566,8009,123456,2,1,2,0,1,0,71.76 ,69.50 ,50.00 
02,000,02,005,0117,0,1555,21,1576,2209,123456,2,1,2,0,1,0,71.76 ,71.34 ,50.00 
02,000,02,005,0118,0,2717,39,2756,4102,123456,2,1,2,0,1,0,71.76 ,67.19 ,50.00 
02,000,02,005,0119,0,1865,16,1881,2667,123456,2,1,2,0,1,0,71.76 ,70.53 ,50.00 
02,000,02,005,0120,0,1879,18,1897,2648,123456,2,1,2,0,1,0,71.76 ,71.64 ,50.00 
02,000,02,005,0121,0,1556,18,1574,2451,123456,2,1,2,0,1,0,71.76 ,64.22 ,50.00 
02,000,02,005,0122,0,2244,27,2271,3184,123456,2,1,2,0,1,0,71.76 ,71.33 ,50.00 
02,000,02,005,0123,0,1744,21,1765,2533,123456,2,1,2,0,1,0,71.76 ,69.68 ,50.00 
02,000,02,005,0124,0,2510,31,2541,3395,123456,2,1,2,0,1,0,71.76 ,74.85 ,50.00 
02,000,02,005,0125,0,1790,13,1803,2307,123456,2,1,2,0,1,0,71.76 ,78.15 ,50.00 
02,000,02,005,0126,0,2285,28,2313,3152,123456,2,1,2,0,1,0,71.76 ,73.38 ,50.00 
02,000,02,005,0127,0,1187,13,1200,1620,123456,2,1,2,0,1,0,71.76 ,74.07 ,50.00 
02,000,02,005,0128,0,2193,27,2220,3089,123456,2,1,2,0,1,0,71.76 ,71.87 ,50.00 
02,000,02,005,0129,0,7098,84,7182,10661,123456,2,1,2,0,1,0,71.76 ,67.37 ,50.00 
02,000,02,005,0130,0,1151,25,1176,1657,123456,2,1,2,0,1,0,71.76 ,70.97 ,50.00 
02,000,02,005,0131,0,2118,28,2146,2816,123456,2,1,2,0,1,0,71.76 ,76.21 ,50.00 
02,000,02,005,0132,0,1476,23,1499,1941,123456,2,1,2,0,1,0,71.76 ,77.23 ,50.00 
02,000,02,005,0133,0,2260,29,2289,3026,123456,2,1,2,0,1,0,71.76 ,75.64 ,50.00 
02,000,02,005,0134,0,1494,19,1513,2178,123456,2,1,2,0,1,0,71.76 ,69.47 ,50.00 
02,000,02,005,0135,0,1484,21,1505,1996,123456,2,1,2,0,1,0,71.76 ,75.40 ,50.00 
02,000,02,005,0136,0,1372,17,1389,1799,123456,2,1,2,0,1,0,71.76 ,77.21 ,50.00 
02,000,02,005,0137,0,2664,34,2698,3574,123456,2,1,2,0,1,0,71.76 ,75.49 ,50.00 
02,000,02,005,0138,0,1158,8,1166,1529,123456,2,1,2,0,1,0,71.76 ,76.26 ,50.00 
02,000,02,005,0139,0,2035,19,2054,2769,123456,2,1,2,0,1,0,71.76 ,74.18 ,50.00 
02,000,02,005,0140,0,1567,21,1588,2202,123456,2,1,2,0,1,0,71.76 ,72.12 ,50.00 
02,000,02,005,0141,0,1559,18,1577,2217,123456,2,1,2,0,1,0,71.76 ,71.13 ,50.00 
02,000,02,005,0142,0,1548,17,1565,2085,123456,2,1,2,0,1,0,71.76 ,75.06 ,50.00 
02,000,02,005,0143,0,2179,17,2196,2997,123456,2,1,2,0,1,0,71.76 ,73.27 ,50.00 
02,000,02,005,0144,0,2344,27,2371,3231,123456,2,1,2,0,1,0,71.76 ,73.38 ,50.00 
02,000,02,005,0145,0,1397,12,1409,1973,123456,2,1,2,0,1,0,71.76 ,71.41 ,50.00 
02,000,02,005,0146,0,1852,31,1883,2515,123456,2,1,2,0,1,0,71.76 ,74.87 ,50.00 
02,000,02,005,0147,0,2060,23,2083,2908,123456,2,1,2,0,1,0,71.76 ,71.63 ,50.00 
02,000,02,005,0148,0,3893,42,3935,5527,123456,2,1,2,0,1,0,71.76 ,71.20 ,50.00 
02,000,02,005,0149,0,2264,28,2292,3329,123456,2,1,2,0,1,0,71.76 ,68.85 ,50.00 
02,000,02,005,0150,0,688,2,690,899,123456,2,1,2,0,1,0,71.76 ,76.75 ,50.00 
02,000,02,005,0151,0,663,2,665,882,123456,2,1,2,0,1,0,71.76 ,75.40 ,50.00 
02,000,02,005,0152,0,1079,8,1087,1445,123456,2,1,2,0,1,0,71.76 ,75.22 ,50.00 
02,000,03,006,0153,0,2015,18,2033,2917,123456,2,1,2,0,1,0,71.76 ,69.69 ,50.00 
02,000,03,006,0154,0,3863,48,3911,5511,123456,2,1,2,0,1,0,71.76 ,70.97 ,50.00 
02,000,03,006,0155,0,2403,40,2443,3413,123456,2,1,2,0,1,0,71.76 ,71.58 ,50.00 
02,000,03,006,0156,0,2338,26,2364,3343,123456,2,1,2,0,1,0,71.76 ,70.71 ,50.00 
02,000,03,006,0157,0,3464,58,3522,5008,123456,2,1,2,0,1,0,71.76 ,70.33 ,50.00 
02,000,03,006,0158,0,2188,29,2217,2928,123456,2,1,2,0,1,0,71.76 ,75.72 ,50.00 
02,000,03,006,0159,0,10537,174,10711,15720,123456,2,1,2,0,1,0,71.76 ,68.14 ,50.00 
02,000,03,006,0160,0,4965,92,5057,7097,123456,2,1,2,0,1,0,71.76 ,71.26 ,50.00 
02,000,03,006,0161,0,3855,62,3917,5549,123456,2,1,2,0,1,0,71.76 ,70.59 ,50.00 
02,000,03,006,0162,0,1501,10,1511,2009,123456,2,1,2,0,1,0,71.76 ,75.21 ,50.00 
02,000,03,006,0163,0,1059,18,1077,1485,123456,2,1,2,0,1,0,71.76 ,72.53 ,50.00 
02,000,03,006,0164,0,3007,36,3043,4227,123456,2,1,2,0,1,0,71.76 ,71.99 ,50.00 
02,000,03,006,0165,0,2452,41,2493,3510,123456,2,1,2,0,1,0,71.76 ,71.03 ,50.00 
02,000,03,006,0166,0,2635,43,2678,3861,123456,2,1,2,0,1,0,71.76 ,69.36 ,50.00 
02,000,03,006,0167,0,4133,66,4199,6110,123456,2,1,2,0,1,0,71.76 ,68.72 ,50.00 
02,000,03,006,0168,0,2201,29,2230,3357,123456,2,1,2,0,1,0,71.76 ,66.43 ,50.00 
02,000,03,006,0169,0,2885,36,2921,4340,123456,2,1,2,0,1,0,71.76 ,67.30 ,50.00 
02,000,03,006,0170,0,1939,33,1972,2925,123456,2,1,2,0,1,0,71.76 ,67.42 ,50.00 
02,000,03,006,0171,0,3463,45,3508,5078,123456,2,1,2,0,1,0,71.76 ,69.08 ,50.00 
02,000,03,006,0172,0,1893,28,1921,2593,123456,2,1,2,0,1,0,71.76 ,74.08 ,50.00 
02,000,03,006,0173,0,1812,28,1840,2649,123456,2,1,2,0,1,0,71.76 ,69.46 ,50.00 
02,000,03,006,0174,0,3990,57,4047,5946,123456,2,1,2,0,1,0,71.76 ,68.06 ,50.00 
02,000,03,006,0175,0,1718,30,1748,2520,123456,2,1,2,0,1,0,71.76 ,69.37 ,50.00 
02,000,03,006,0176,0,1578,31,1609,2372,123456,2,1,2,0,1,0,71.76 ,67.83 ,50.00 
02,000,03,006,0177,0,2542,56,2598,3900,123456,2,1,2,0,1,0,71.76 ,66.62 ,50.00 
02,000,03,006,0178,0,2632,33,2665,3831,123456,2,1,2,0,1,0,71.76 ,69.56 ,50.00 
02,000,03,006,0179,0,3696,56,3752,5663,123456,2,1,2,0,1,0,71.76 ,66.25 ,50.00 
02,000,03,006,0180,0,2665,41,2706,3842,123456,2,1,2,0,1,0,71.76 ,70.43 ,50.00 
02,000,03,006,0181,0,3023,50,3073,4415,123456,2,1,2,0,1,0,71.76 ,69.60 ,50.00 
02,000,03,006,0182,0,4387,53,4440,6497,123456,2,1,2,0,1,0,71.76 ,68.34 ,50.00 
02,000,03,006,0183,0,1904,28,1932,2912,123456,2,1,2,0,1,0,71.76 ,66.35 ,50.00 
02,000,03,006,0184,0,1912,30,1942,2830,123456,2,1,2,0,1,0,71.76 ,68.62 ,50.00 
02,000,03,006,0185,0,2747,42,2789,4026,123456,2,1,2,0,1,0,71.76 ,69.27 ,50.00 
02,000,03,006,0186,0,1740,20,1760,2491,123456,2,1,2,0,1,0,71.76 ,70.65 ,50.00 
02,000,03,006,0187,0,1454,18,1472,2011,123456,2,1,2,0,1,0,71.76 ,73.20 ,50.00 
02,000,03,006,0188,0,2314,33,2347,3276,123456,2,1,2,0,1,0,71.76 ,71.64 ,50.00 
02,000,03,006,0189,0,1900,25,1925,2884,123456,2,1,2,0,1,0,71.76 ,66.75 ,50.00 
02,000,03,006,0190,0,5594,67,5661,8417,123456,2,1,2,0,1,0,71.76 ,67.26 ,50.00 
02,000,03,006,0191,0,2196,22,2218,3174,123456,2,1,2,0,1,0,71.76 ,69.88 ,50.00 
02,000,03,006,0192,0,1071,12,1083,1542,123456,2,1,2,0,1,0,71.76 ,70.23 ,50.00 
02,000,03,006,0193,0,1296,10,1306,1831,123456,2,1,2,0,1,0,71.76 ,71.33 ,50.00 
02,000,03,006,0194,0,1994,25,2019,2974,123456,2,1,2,0,1,0,71.76 ,67.89 ,50.00 
02,000,03,006,0195,0,1498,12,1510,2091,123456,2,1,2,0,1,0,71.76 ,72.21 ,50.00 
02,000,03,006,0196,0,2581,33,2614,3951,123456,2,1,2,0,1,0,71.76 ,66.16 ,50.00 
02,000,03,006,0197,0,2752,34,2786,3998,123456,2,1,2,0,1,0,71.76 ,69.68 ,50.00 
02,000,03,006,0198,0,2242,39,2281,3149,123456,2,1,2,0,1,0,71.76 ,72.44 ,50.00 
02,000,03,006,0199,0,1877,38,1915,2663,123456,2,1,2,0,1,0,71.76 ,71.91 ,50.00 
02,000,03,006,0200,0,1106,15,1121,1474,123456,2,1,2,0,1,0,71.76 ,76.05 ,50.00 
02,000,03,006,0201,0,1229,21,1250,1683,123456,2,1,2,0,1,0,71.76 ,74.27 ,50.00 
02,000,03,006,0202,0,1032,21,1053,1448,123456,2,1,2,0,1,0,71.76 ,72.72 ,50.00 
02,000,03,006,0203,0,739,10,749,1056,123456,2,1,2,0,1,0,71.76 ,70.93 ,50.00 
02,000,03,006,0204,0,1869,24,1893,2744,123456,2,1,2,0,1,0,71.76 ,68.99 ,50.00 
02,000,03,006,0205,0,1745,30,1775,2444,123456,2,1,2,0,1,0,71.76 ,72.63 ,50.00 
02,000,03,006,0206,0,1315,12,1327,1950,123456,2,1,2,0,1,0,71.76 ,68.05 ,50.00 
02,000,03,006,0207,0,1227,19,1246,1726,123456,2,1,2,0,1,0,71.76 ,72.19 ,50.00 
02,000,03,006,0208,0,660,10,670,873,123456,2,1,2,0,1,0,71.76 ,76.75 ,50.00 
02,000,03,006,0209,0,787,14,801,1112,123456,2,1,2,0,1,0,71.76 ,72.03 ,50.00 
02,000,03,006,0210,0,1189,19,1208,1617,123456,2,1,2,0,1,0,71.76 ,74.71 ,50.00 
02,000,03,006,0211,0,1525,23,1548,2073,123456,2,1,2,0,1,0,71.76 ,74.67 ,50.00 
02,000,03,006,0212,0,2405,39,2444,3249,123456,2,1,2,0,1,0,71.76 ,75.22 ,50.00 
02,000,03,006,0213,0,2787,50,2837,3960,123456,2,1,2,0,1,0,71.76 ,71.64 ,50.00 
02,000,03,006,0214,0,2509,42,2551,3965,123456,2,1,2,0,1,0,71.76 ,64.34 ,50.00 
02,000,03,006,0215,0,1172,9,1181,1581,123456,2,1,2,0,1,0,71.76 ,74.70 ,50.00 
02,000,03,006,0216,0,1327,16,1343,1797,123456,2,1,2,0,1,0,71.76 ,74.74 ,50.00 
02,000,03,006,0217,0,1455,18,1473,2061,123456,2,1,2,0,1,0,71.76 ,71.47 ,50.00 
02,000,03,006,0218,0,728,9,737,976,123456,2,1,2,0,1,0,71.76 ,75.51 ,50.00 
02,000,03,006,0219,0,837,13,850,1176,123456,2,1,2,0,1,0,71.76 ,72.28 ,50.00 
02,000,03,006,0220,0,898,16,914,1395,123456,2,1,2,0,1,0,71.76 ,65.52 ,50.00 
02,000,03,006,0221,0,955,20,975,1421,123456,2,1,2,0,1,0,71.76 ,68.61 ,50.00 
02,000,03,006,0222,0,552,12,564,839,123456,2,1,2,0,1,0,71.76 ,67.22 ,50.00 
02,000,03,006,0223,0,330,8,338,452,123456,2,1,2,0,1,0,71.76 ,74.78 ,50.00 
02,000,03,006,0224,0,794,6,800,1174,123456,2,1,2,0,1,0,71.76 ,68.14 ,50.00 
02,000,03,006,0225,0,2747,59,2806,3965,123456,2,1,2,0,1,0,71.76 ,70.77 ,50.00 
02,000,03,006,0226,0,817,8,825,1158,123456,2,1,2,0,1,0,71.76 ,71.24 ,50.00 
02,000,03,006,0227,0,649,15,664,1086,123456,2,1,2,0,1,0,71.76 ,61.14 ,50.00 
02,000,03,006,0228,0,1064,19,1083,1571,123456,2,1,2,0,1,0,71.76 ,68.94 ,50.00 
02,000,03,006,0229,0,878,10,888,1148,123456,2,1,2,0,1,0,71.76 ,77.35 ,50.00 
02,000,03,006,0230,0,1473,25,1498,1985,123456,2,1,2,0,1,0,71.76 ,75.47 ,50.00 
02,000,03,006,0231,0,905,17,922,1252,123456,2,1,2,0,1,0,71.76 ,73.64 ,50.00 
02,000,03,006,0232,0,300,4,304,431,123456,2,1,2,0,1,0,71.76 ,70.53 ,50.00 
02,000,03,006,0233,0,1904,33,1937,2672,123456,2,1,2,0,1,0,71.76 ,72.49 ,50.00 
02,000,03,006,0234,0,1415,34,1449,1923,123456,2,1,2,0,1,0,71.76 ,75.35 ,50.00 
02,000,03,006,0235,0,585,12,597,774,123456,2,1,2,0,1,0,71.76 ,77.13 ,50.00 
02,000,03,006,0236,0,902,9,911,1149,123456,2,1,2,0,1,0,71.76 ,79.29 ,50.00 
02,000,03,006,0237,0,879,11,890,1172,123456,2,1,2,0,1,0,71.76 ,75.94 ,50.00 
02,000,03,006,0238,0,991,19,1010,1345,123456,2,1,2,0,1,0,71.76 ,75.09 ,50.00 
02,000,03,006,0239,0,961,21,982,1276,123456,2,1,2,0,1,0,71.76 ,76.96 ,50.00 
02,000,03,006,0240,0,1600,25,1625,2369,123456,2,1,2,0,1,0,71.76 ,68.59 ,50.00 
02,000,04,007,0241,0,1344,22,1366,1960,123456,2,1,2,0,1,0,71.76 ,69.69 ,50.00 
02,000,04,007,0242,0,874,9,883,1315,123456,2,1,2,0,1,0,71.76 ,67.15 ,50.00 
02,000,04,007,0243,0,1568,15,1583,2289,123456,2,1,2,0,1,0,71.76 ,69.16 ,50.00 
02,000,04,007,0244,0,955,12,967,1339,123456,2,1,2,0,1,0,71.76 ,72.22 ,50.00 
02,000,04,007,0245,0,1192,22,1214,1631,123456,2,1,2,0,1,0,71.76 ,74.43 ,50.00 
02,000,04,007,0246,0,519,10,529,747,123456,2,1,2,0,1,0,71.76 ,70.82 ,50.00 
02,000,04,007,0247,0,546,8,554,811,123456,2,1,2,0,1,0,71.76 ,68.31 ,50.00 
02,000,04,007,0248,0,1329,36,1365,2003,123456,2,1,2,0,1,0,71.76 ,68.15 ,50.00 
02,000,04,007,0249,0,771,6,777,1094,123456,2,1,2,0,1,0,71.76 ,71.02 ,50.00 
02,000,04,007,0250,0,582,5,587,790,123456,2,1,2,0,1,0,71.76 ,74.30 ,50.00 
02,000,04,007,0251,0,1020,26,1046,1451,123456,2,1,2,0,1,0,71.76 ,72.09 ,50.00 
02,000,04,007,0252,0,824,4,828,1096,123456,2,1,2,0,1,0,71.76 ,75.55 ,50.00 
02,000,04,007,0253,0,1509,34,1543,2108,123456,2,1,2,0,1,0,71.76 ,73.20 ,50.00 
02,000,04,007,0254,0,1746,31,1777,2514,123456,2,1,2,0,1,0,71.76 ,70.68 ,50.00 
02,000,04,007,0255,0,1696,21,1717,2443,123456,2,1,2,0,1,0,71.76 ,70.28 ,50.00 
02,000,04,007,0256,0,1279,21,1300,1772,123456,2,1,2,0,1,0,71.76 ,73.36 ,50.00 
02,000,04,007,0257,0,2126,41,2167,2943,123456,2,1,2,0,1,0,71.76 ,73.63 ,50.00 
02,000,04,007,0258,0,828,11,839,1196,123456,2,1,2,0,1,0,71.76 ,70.15 ,50.00 
02,000,04,007,0259,0,794,5,799,1172,123456,2,1,2,0,1,0,71.76 ,68.17 ,50.00 
02,000,04,007,0260,0,662,12,674,950,123456,2,1,2,0,1,0,71.76 ,70.95 ,50.00 
02,000,04,007,0261,0,642,15,657,911,123456,2,1,2,0,1,0,71.76 ,72.12 ,50.00 
02,000,04,007,0262,0,1666,23,1689,2241,123456,2,1,2,0,1,0,71.76 ,75.37 ,50.00 
02,000,04,007,0263,0,1625,31,1656,2578,123456,2,1,2,0,1,0,71.76 ,64.24 ,50.00 
02,000,04,007,0264,0,660,13,673,923,123456,2,1,2,0,1,0,71.76 ,72.91 ,50.00 
02,000,04,007,0265,0,885,16,901,1238,123456,2,1,2,0,1,0,71.76 ,72.78 ,50.00 
02,000,04,007,0266,0,810,8,818,1150,123456,2,1,2,0,1,0,71.76 ,71.13 ,50.00 
02,000,04,007,0267,0,685,10,695,925,123456,2,1,2,0,1,0,71.76 ,75.14 ,50.00 
02,000,04,007,0268,0,666,8,674,948,123456,2,1,2,0,1,0,71.76 ,71.10 ,50.00 
02,000,04,007,0269,0,655,7,662,962,123456,2,1,2,0,1,0,71.76 ,68.81 ,50.00 
02,000,04,007,0270,0,669,14,683,872,123456,2,1,2,0,1,0,71.76 ,78.33 ,50.00 
02,000,04,007,0271,0,723,10,733,987,123456,2,1,2,0,1,0,71.76 ,74.27 ,50.00 
02,000,04,007,0272,0,1132,21,1153,1470,123456,2,1,2,0,1,0,71.76 ,78.44 ,50.00 
02,000,04,008,0273,0,559,10,569,807,123456,2,1,2,0,1,0,71.76 ,70.51 ,50.00 
02,000,04,008,0274,0,866,11,877,1212,123456,2,1,2,0,1,0,71.76 ,72.36 ,50.00 
02,000,04,008,0275,0,1030,13,1043,1448,123456,2,1,2,0,1,0,71.76 ,72.03 ,50.00 
02,000,04,008,0276,0,624,12,636,888,123456,2,1,2,0,1,0,71.76 ,71.62 ,50.00 
02,000,04,008,0277,0,613,14,627,921,123456,2,1,2,0,1,0,71.76 ,68.08 ,50.00 
02,000,04,008,0278,0,2179,36,2215,3141,123456,2,1,2,0,1,0,71.76 ,70.52 ,50.00 
02,000,04,008,0279,0,691,13,704,979,123456,2,1,2,0,1,0,71.76 ,71.91 ,50.00 
02,000,04,008,0280,0,762,12,774,1129,123456,2,1,2,0,1,0,71.76 ,68.56 ,50.00 
02,000,04,008,0281,0,932,13,945,1420,123456,2,1,2,0,1,0,71.76 ,66.55 ,50.00 
02,000,04,008,0282,0,517,6,523,777,123456,2,1,2,0,1,0,71.76 ,67.31 ,50.00 
02,000,04,008,0283,0,739,7,746,1084,123456,2,1,2,0,1,0,71.76 ,68.82 ,50.00 
02,000,04,008,0284,0,830,8,838,1232,123456,2,1,2,0,1,0,71.76 ,68.02 ,50.00 
02,000,04,008,0285,0,766,17,783,1095,123456,2,1,2,0,1,0,71.76 ,71.51 ,50.00 
02,000,04,008,0286,0,1243,21,1264,1730,123456,2,1,2,0,1,0,71.76 ,73.06 ,50.00 
02,000,04,008,0287,0,703,16,719,1038,123456,2,1,2,0,1,0,71.76 ,69.27 ,50.00 
02,000,04,008,0288,0,718,17,735,1018,123456,2,1,2,0,1,0,71.76 ,72.20 ,50.00 
02,000,04,008,0289,0,1031,16,1047,1549,123456,2,1,2,0,1,0,71.76 ,67.59 ,50.00 
02,000,04,008,0290,0,984,13,997,1347,123456,2,1,2,0,1,0,71.76 ,74.02 ,50.00 
02,000,04,008,0291,0,797,5,802,1103,123456,2,1,2,0,1,0,71.76 ,72.71 ,50.00 
02,000,04,008,0292,0,1024,16,1040,1453,123456,2,1,2,0,1,0,71.76 ,71.58 ,50.00 
02,000,04,009,0293,0,503,10,513,681,123456,2,1,2,0,1,0,71.76 ,75.33 ,50.00 
02,000,04,009,0294,0,969,12,981,1398,123456,2,1,2,0,1,0,71.76 ,70.17 ,50.00 
02,000,04,009,0295,0,1157,19,1176,1488,123456,2,1,2,0,1,0,71.76 ,79.03 ,50.00 
02,000,04,009,0296,0,1195,24,1219,1626,123456,2,1,2,0,1,0,71.76 ,74.97 ,50.00 
02,000,04,009,0297,0,1048,11,1059,1461,123456,2,1,2,0,1,0,71.76 ,72.48 ,50.00 
02,000,04,009,0298,0,1083,23,1106,1527,123456,2,1,2,0,1,0,71.76 ,72.43 ,50.00 
02,000,04,009,0299,0,1037,24,1061,1487,123456,2,1,2,0,1,0,71.76 ,71.35 ,50.00 
02,000,04,009,0300,0,506,10,516,706,123456,2,1,2,0,1,0,71.76 ,73.09 ,50.00 
02,000,04,009,0301,0,1154,23,1177,1626,123456,2,1,2,0,1,0,71.76 ,72.39 ,50.00 
02,000,04,009,0302,0,1628,35,1663,2635,123456,2,1,2,0,1,0,71.76 ,63.11 ,50.00 
02,000,04,009,0303,0,1010,11,1021,1296,123456,2,1,2,0,1,0,71.76 ,78.78 ,50.00 
02,000,04,009,0304,0,1077,13,1090,1486,123456,2,1,2,0,1,0,71.76 ,73.35 ,50.00 
02,000,04,009,0305,0,1320,19,1339,1887,123456,2,1,2,0,1,0,71.76 ,70.96 ,50.00 
02,000,04,009,0306,0,1206,15,1221,1756,123456,2,1,2,0,1,0,71.76 ,69.53 ,50.00 
02,000,04,009,0307,0,1469,26,1495,1915,123456,2,1,2,0,1,0,71.76 ,78.07 ,50.00 
02,000,04,009,0308,0,927,11,938,1276,123456,2,1,2,0,1,0,71.76 ,73.51 ,50.00 
02,000,04,009,0309,0,2002,49,2051,2993,123456,2,1,2,0,1,0,71.76 ,68.53 ,50.00 
02,000,04,009,0310,0,1664,29,1693,2336,123456,2,1,2,0,1,0,71.76 ,72.47 ,50.00 
02,000,04,009,0311,0,1863,35,1898,2626,123456,2,1,2,0,1,0,71.76 ,72.28 ,50.00 
02,000,04,009,0312,0,1576,23,1599,2176,123456,2,1,2,0,1,0,71.76 ,73.48 ,50.00 
02,000,04,009,0313,0,783,10,793,1396,123456,2,1,2,0,1,0,71.76 ,56.81 ,50.00 
02,000,04,009,0314,0,2027,40,2067,2836,123456,2,1,2,0,1,0,71.76 ,72.88 ,50.00 
02,000,04,009,0315,0,1207,25,1232,1773,123456,2,1,2,0,1,0,71.76 ,69.49 ,50.00 
02,000,04,009,0316,0,1388,28,1416,2016,123456,2,1,2,0,1,0,71.76 ,70.24 ,50.00 
02,000,04,009,0317,0,1205,8,1213,1624,123456,2,1,2,0,1,0,71.76 ,74.69 ,50.00 
02,000,04,009,0318,0,564,9,573,797,123456,2,1,2,0,1,0,71.76 ,71.89 ,50.00 
02,000,04,009,0319,0,1086,22,1108,1481,123456,2,1,2,0,1,0,71.76 ,74.81 ,50.00 
02,000,04,009,0320,0,2106,34,2140,3003,123456,2,1,2,0,1,0,71.76 ,71.26 ,50.00 
02,000,04,009,0321,0,1248,21,1269,1796,123456,2,1,2,0,1,0,71.76 ,70.66 ,50.00 
02,000,04,009,0322,0,2265,37,2302,3204,123456,2,1,2,0,1,0,71.76 ,71.85 ,50.00 
02,000,04,009,0323,0,1235,17,1252,1799,123456,2,1,2,0,1,0,71.76 ,69.59 ,50.00 
02,000,04,009,0324,0,1854,34,1888,2773,123456,2,1,2,0,1,0,71.76 ,68.09 ,50.00 
02,000,04,009,0325,0,1686,26,1712,2490,123456,2,1,2,0,1,0,71.76 ,68.76 ,50.00 
02,000,04,009,0326,0,948,16,964,1419,123456,2,1,2,0,1,0,71.76 ,67.94 ,50.00 
02,000,04,009,0327,0,1121,32,1153,1590,123456,2,1,2,0,1,0,71.76 ,72.52 ,50.00 
02,000,04,009,0328,0,1482,21,1503,1961,123456,2,1,2,0,1,0,71.76 ,76.64 ,50.00 
02,000,04,009,0329,0,1538,35,1573,2253,123456,2,1,2,0,1,0,71.76 ,69.82 ,50.00 
02,000,04,009,0330,0,1273,9,1282,1684,123456,2,1,2,0,1,0,71.76 ,76.13 ,50.00 
02,000,04,009,0331,0,1115,11,1126,1527,123456,2,1,2,0,1,0,71.76 ,73.74 ,50.00 
02,000,04,009,0332,0,1811,27,1838,2469,123456,2,1,2,0,1,0,71.76 ,74.44 ,50.00 
02,000,04,009,0333,0,1387,25,1412,1971,123456,2,1,2,0,1,0,71.76 ,71.64 ,50.00 
02,000,04,009,0334,0,2536,40,2576,3768,123456,2,1,2,0,1,0,71.76 ,68.37 ,50.00 
02,000,04,009,0335,0,1233,16,1249,1760,123456,2,1,2,0,1,0,71.76 ,70.97 ,50.00 
02,000,04,009,0336,0,976,11,987,1341,123456,2,1,2,0,1,0,71.76 ,73.60 ,50.00 
02,000,04,009,0337,0,2695,53,2748,3893,123456,2,1,2,0,1,0,71.76 ,70.59 ,50.00 
02,000,04,009,0338,0,1388,26,1414,2032,123456,2,1,2,0,1,0,71.76 ,69.59 ,50.00 
02,000,04,009,0339,0,1273,19,1292,1765,123456,2,1,2,0,1,0,71.76 ,73.20 ,50.00 
02,000,04,009,0340,0,1063,15,1078,1491,123456,2,1,2,0,1,0,71.76 ,72.30 ,50.00 
02,000,04,009,0341,0,1961,29,1990,2767,123456,2,1,2,0,1,0,71.76 ,71.92 ,50.00 
02,000,04,009,0342,0,929,18,947,1315,123456,2,1,2,0,1,0,71.76 ,72.02 ,50.00 
02,000,04,009,0343,0,783,11,794,1071,123456,2,1,2,0,1,0,71.76 ,74.14 ,50.00 
02,000,04,009,0344,0,1440,17,1457,1962,123456,2,1,2,0,1,0,71.76 ,74.26 ,50.00 
02,000,04,009,0345,0,1629,33,1662,2173,123456,2,1,2,0,1,0,71.76 ,76.48 ,50.00 
02,000,04,009,0346,0,2149,35,2184,2901,123456,2,1,2,0,1,0,71.76 ,75.28 ,50.00 
02,000,04,009,0347,0,2154,34,2188,2884,123456,2,1,2,0,1,0,71.76 ,75.87 ,50.00 
02,000,04,009,0348,0,1809,37,1846,2548,123456,2,1,2,0,1,0,71.76 ,72.45 ,50.00 
02,000,04,009,0349,0,1716,36,1752,2267,123456,2,1,2,0,1,0,71.76 ,77.28 ,50.00 
02,000,04,009,0350,0,1735,31,1766,2395,123456,2,1,2,0,1,0,71.76 ,73.74 ,50.00 
02,000,04,009,0351,0,1204,18,1222,1707,123456,2,1,2,0,1,0,71.76 ,71.59 ,50.00 
02,000,04,009,0352,0,1977,30,2007,2762,123456,2,1,2,0,1,0,71.76 ,72.66 ,50.00 
02,000,04,009,0353,0,2926,55,2981,4387,123456,2,1,2,0,1,0,71.76 ,67.95 ,50.00 
02,000,04,009,0354,0,2740,45,2785,3865,123456,2,1,2,0,1,0,71.76 ,72.06 ,50.00 
02,000,04,009,0355,0,2380,63,2443,3532,123456,2,1,2,0,1,0,71.76 ,69.17 ,50.00 
02,000,04,009,0356,0,2913,56,2969,4060,123456,2,1,2,0,1,0,71.76 ,73.13 ,50.00 
02,000,04,009,0357,0,1652,20,1672,2343,123456,2,1,2,0,1,0,71.76 ,71.36 ,50.00 
02,000,04,009,0358,0,1733,25,1758,2406,123456,2,1,2,0,1,0,71.76 ,73.07 ,50.00 
02,000,04,009,0359,0,2863,50,2913,3902,123456,2,1,2,0,1,0,71.76 ,74.65 ,50.00 
02,000,04,009,0360,0,1495,23,1518,2009,123456,2,1,2,0,1,0,71.76 ,75.56 ,50.00 
02,000,04,009,0361,0,1510,17,1527,2127,123456,2,1,2,0,1,0,71.76 ,71.79 ,50.00 
02,000,05,010,0362,0,5448,106,5554,8044,123456,2,1,2,0,1,0,71.76 ,69.05 ,50.00 
02,000,05,010,0363,0,1820,43,1863,2520,123456,2,1,2,0,1,0,71.76 ,73.93 ,50.00 
02,000,05,010,0364,0,2250,36,2286,3202,123456,2,1,2,0,1,0,71.76 ,71.39 ,50.00 
02,000,05,010,0365,0,1320,22,1342,1709,123456,2,1,2,0,1,0,71.76 ,78.53 ,50.00 
02,000,05,010,0366,0,1098,8,1106,1500,123456,2,1,2,0,1,0,71.76 ,73.73 ,50.00 
02,000,05,010,0367,0,1349,21,1370,1896,123456,2,1,2,0,1,0,71.76 ,72.26 ,50.00 
02,000,05,010,0368,0,1269,28,1297,2060,123456,2,1,2,0,1,0,71.76 ,62.96 ,50.00 
02,000,05,010,0369,0,559,6,565,756,123456,2,1,2,0,1,0,71.76 ,74.74 ,50.00 
02,000,05,010,0370,0,1296,19,1315,1765,123456,2,1,2,0,1,0,71.76 ,74.50 ,50.00 
02,000,05,010,0371,0,1303,16,1319,1752,123456,2,1,2,0,1,0,71.76 ,75.29 ,50.00 
02,000,05,010,0372,0,1799,21,1820,2506,123456,2,1,2,0,1,0,71.76 ,72.63 ,50.00 
02,000,05,010,0373,0,967,11,978,1329,123456,2,1,2,0,1,0,71.76 ,73.59 ,50.00 
02,000,05,010,0374,0,676,11,687,920,123456,2,1,2,0,1,0,71.76 ,74.67 ,50.00 
02,000,05,010,0375,0,679,12,691,983,123456,2,1,2,0,1,0,71.76 ,70.30 ,50.00 
02,000,05,010,0376,0,1226,22,1248,1584,123456,2,1,2,0,1,0,71.76 ,78.79 ,50.00 
02,000,05,010,0377,0,1551,30,1581,1983,123456,2,1,2,0,1,0,71.76 ,79.73 ,50.00 
02,000,05,010,0378,0,1692,33,1725,2306,123456,2,1,2,0,1,0,71.76 ,74.80 ,50.00 
02,000,05,010,0379,0,1577,28,1605,2046,123456,2,1,2,0,1,0,71.76 ,78.45 ,50.00 
02,000,05,010,0380,0,2670,42,2712,3750,123456,2,1,2,0,1,0,71.76 ,72.32 ,50.00 
02,000,05,010,0381,0,919,14,933,1167,123456,2,1,2,0,1,0,71.76 ,79.95 ,50.00 
02,000,05,010,0382,0,1424,40,1464,1986,123456,2,1,2,0,1,0,71.76 ,73.72 ,50.00 
02,000,05,010,0383,0,785,5,790,1008,123456,2,1,2,0,1,0,71.76 ,78.37 ,50.00 
02,000,05,010,0384,0,853,12,865,1074,123456,2,1,2,0,1,0,71.76 ,80.54 ,50.00 
02,000,05,010,0385,0,2122,36,2158,2783,123456,2,1,2,0,1,0,71.76 ,77.54 ,50.00 
02,000,05,010,0386,0,1648,36,1684,2100,123456,2,1,2,0,1,0,71.76 ,80.19 ,50.00 
02,000,05,010,0387,0,2278,51,2329,3188,123456,2,1,2,0,1,0,71.76 ,73.06 ,50.00 
02,000,05,010,0388,0,2727,63,2790,3832,123456,2,1,2,0,1,0,71.76 ,72.81 ,50.00 
02,000,05,010,0389,0,613,16,629,837,123456,2,1,2,0,1,0,71.76 ,75.15 ,50.00 
02,000,05,010,0390,0,1350,41,1391,1969,123456,2,1,2,0,1,0,71.76 ,70.64 ,50.00 
02,000,05,010,0391,0,1829,29,1858,2616,123456,2,1,2,0,1,0,71.76 ,71.02 ,50.00 
02,000,05,010,0392,0,1537,18,1555,2064,123456,2,1,2,0,1,0,71.76 ,75.34 ,50.00 
02,000,05,010,0393,0,1603,48,1651,2458,123456,2,1,2,0,1,0,71.76 ,67.17 ,50.00 
02,000,05,010,0394,0,1873,34,1907,2804,123456,2,1,2,0,1,0,71.76 ,68.01 ,50.00 
02,000,05,010,0395,0,2042,43,2085,3097,123456,2,1,2,0,1,0,71.76 ,67.32 ,50.00 
02,000,05,010,0396,0,2963,80,3043,4283,123456,2,1,2,0,1,0,71.76 ,71.05 ,50.00 
02,000,05,010,0397,0,1650,34,1684,2288,123456,2,1,2,0,1,0,71.76 ,73.60 ,50.00 
02,000,05,010,0398,0,1952,31,1983,2736,123456,2,1,2,0,1,0,71.76 ,72.48 ,50.00 
02,000,05,010,0399,0,1879,29,1908,2585,123456,2,1,2,0,1,0,71.76 ,73.81 ,50.00 
02,000,05,010,0400,0,1359,35,1394,2069,123456,2,1,2,0,1,0,71.76 ,67.38 ,50.00 
02,000,05,010,0401,0,1779,36,1815,2568,123456,2,1,2,0,1,0,71.76 ,70.68 ,50.00 
02,000,05,010,0402,0,1309,31,1340,1940,123456,2,1,2,0,1,0,71.76 ,69.07 ,50.00 
02,000,05,010,0403,0,2549,57,2606,3514,123456,2,1,2,0,1,0,71.76 ,74.16 ,50.00 
02,000,05,010,0404,0,1895,41,1936,2677,123456,2,1,2,0,1,0,71.76 ,72.32 ,50.00 
02,000,05,010,0405,0,874,21,895,1262,123456,2,1,2,0,1,0,71.76 ,70.92 ,50.00 
02,000,05,010,0406,0,3297,56,3353,4461,123456,2,1,2,0,1,0,71.76 ,75.16 ,50.00 
02,000,05,010,0407,0,1784,37,1821,2376,123456,2,1,2,0,1,0,71.76 ,76.64 ,50.00 
02,000,05,010,0408,0,3343,56,3399,4651,123456,2,1,2,0,1,0,71.76 ,73.08 ,50.00 
02,000,05,010,0409,0,1869,37,1906,2492,123456,2,1,2,0,1,0,71.76 ,76.48 ,50.00 
02,000,05,010,0410,0,1442,18,1460,1987,123456,2,1,2,0,1,0,71.76 ,73.48 ,50.00 
02,000,05,010,0411,0,2579,44,2623,3509,123456,2,1,2,0,1,0,71.76 ,74.75 ,50.00 
02,000,05,010,0412,0,2406,39,2445,3440,123456,2,1,2,0,1,0,71.76 ,71.08 ,50.00 
02,000,05,010,0413,0,2149,43,2192,2934,123456,2,1,2,0,1,0,71.76 ,74.71 ,50.00 
02,000,05,010,0414,0,2107,42,2149,2716,123456,2,1,2,0,1,0,71.76 ,79.12 ,50.00 
02,000,05,010,0415,0,1987,31,2018,2701,123456,2,1,2,0,1,0,71.76 ,74.71 ,50.00 
02,000,05,010,0416,0,1936,31,1967,2701,123456,2,1,2,0,1,0,71.76 ,72.82 ,50.00 
02,000,05,010,0417,0,1588,38,1626,2316,123456,2,1,2,0,1,0,71.76 ,70.21 ,50.00 
02,000,05,010,0418,0,1674,28,1702,2423,123456,2,1,2,0,1,0,71.76 ,70.24 ,50.00 
02,000,05,010,0419,0,2860,54,2914,4180,123456,2,1,2,0,1,0,71.76 ,69.71 ,50.00 
02,000,05,010,0420,0,1907,34,1941,2750,123456,2,1,2,0,1,0,71.76 ,70.58 ,50.00 
02,000,05,011,0421,0,1240,18,1258,1709,123456,2,1,2,0,1,0,71.76 ,73.61 ,50.00 
02,000,05,011,0422,0,2157,35,2192,3062,123456,2,1,2,0,1,0,71.76 ,71.59 ,50.00 
02,000,05,011,0423,0,1661,24,1685,2338,123456,2,1,2,0,1,0,71.76 ,72.07 ,50.00 
02,000,05,011,0424,0,1110,15,1125,1488,123456,2,1,2,0,1,0,71.76 ,75.60 ,50.00 
02,000,05,011,0425,0,1949,36,1985,2761,123456,2,1,2,0,1,0,71.76 ,71.89 ,50.00 
02,000,05,011,0426,0,1310,12,1322,1814,123456,2,1,2,0,1,0,71.76 ,72.88 ,50.00 
02,000,05,011,0427,0,973,15,988,1409,123456,2,1,2,0,1,0,71.76 ,70.12 ,50.00 
02,000,05,011,0428,0,1406,16,1422,1932,123456,2,1,2,0,1,0,71.76 ,73.60 ,50.00 
02,000,05,011,0429,0,1168,21,1189,1747,123456,2,1,2,0,1,0,71.76 ,68.06 ,50.00 
02,000,05,011,0430,0,2894,42,2936,4239,123456,2,1,2,0,1,0,71.76 ,69.26 ,50.00 
02,000,05,011,0431,0,1485,21,1506,2079,123456,2,1,2,0,1,0,71.76 ,72.44 ,50.00 
02,000,05,011,0432,0,1974,42,2016,2887,123456,2,1,2,0,1,0,71.76 ,69.83 ,50.00 
02,000,05,011,0433,0,1726,25,1751,2407,123456,2,1,2,0,1,0,71.76 ,72.75 ,50.00 
02,000,05,011,0434,0,2103,25,2128,3227,123456,2,1,2,0,1,0,71.76 ,65.94 ,50.00 
02,000,05,011,0435,0,2300,29,2329,3357,123456,2,1,2,0,1,0,71.76 ,69.38 ,50.00 
02,000,05,011,0436,0,974,19,993,1357,123456,2,1,2,0,1,0,71.76 ,73.18 ,50.00 
02,000,05,011,0437,0,1647,35,1682,2370,123456,2,1,2,0,1,0,71.76 ,70.97 ,50.00 
02,000,05,011,0438,0,1676,23,1699,2461,123456,2,1,2,0,1,0,71.76 ,69.04 ,50.00 
02,000,05,011,0439,0,1154,21,1175,1589,123456,2,1,2,0,1,0,71.76 ,73.95 ,50.00 
02,000,05,011,0440,0,2175,28,2203,2887,123456,2,1,2,0,1,0,71.76 ,76.31 ,50.00 
02,000,05,011,0441,0,1522,13,1535,2065,123456,2,1,2,0,1,0,71.76 ,74.33 ,50.00 
02,000,05,011,0442,0,3488,39,3527,4926,123456,2,1,2,0,1,0,71.76 ,71.60 ,50.00 
02,000,05,011,0443,0,2206,37,2243,3097,123456,2,1,2,0,1,0,71.76 ,72.42 ,50.00 
02,000,05,011,0444,0,1328,27,1355,1912,123456,2,1,2,0,1,0,71.76 ,70.87 ,50.00 
02,000,05,011,0445,0,1277,22,1299,1808,123456,2,1,2,0,1,0,71.76 ,71.85 ,50.00 
02,000,05,011,0446,0,823,14,837,1102,123456,2,1,2,0,1,0,71.76 ,75.95 ,50.00 
02,000,05,011,0447,0,954,15,969,1266,123456,2,1,2,0,1,0,71.76 ,76.54 ,50.00 
02,000,05,011,0448,0,2091,27,2118,3036,123456,2,1,2,0,1,0,71.76 ,69.76 ,50.00 
02,000,05,011,0449,0,1181,27,1208,1721,123456,2,1,2,0,1,0,71.76 ,70.19 ,50.00 
02,000,05,011,0450,0,1543,28,1571,2177,123456,2,1,2,0,1,0,71.76 ,72.16 ,50.00 
02,000,05,011,0451,0,3863,51,3914,5610,123456,2,1,2,0,1,0,71.76 ,69.77 ,50.00 
02,000,05,011,0452,0,1916,30,1946,2768,123456,2,1,2,0,1,0,71.76 ,70.30 ,50.00 
02,000,05,011,0453,0,1771,23,1794,2284,123456,2,1,2,0,1,0,71.76 ,78.55 ,50.00 
02,000,05,011,0454,0,1625,21,1646,2098,123456,2,1,2,0,1,0,71.76 ,78.46 ,50.00 
02,000,05,011,0455,0,1193,14,1207,1535,123456,2,1,2,0,1,0,71.76 ,78.63 ,50.00 
02,000,05,011,0456,0,1514,18,1532,2080,123456,2,1,2,0,1,0,71.76 ,73.65 ,50.00 
02,000,05,011,0457,0,1241,12,1253,1653,123456,2,1,2,0,1,0,71.76 ,75.80 ,50.00 
02,000,05,011,0458,0,1733,27,1760,2418,123456,2,1,2,0,1,0,71.76 ,72.79 ,50.00 
02,000,05,011,0459,0,3216,34,3250,4632,123456,2,1,2,0,1,0,71.76 ,70.16 ,50.00 
02,000,05,011,0460,0,1580,12,1592,2369,123456,2,1,2,0,1,0,71.76 ,67.20 ,50.00 
02,000,05,011,0461,0,1589,12,1601,2479,123456,2,1,2,0,1,0,71.76 ,64.58 ,50.00 
02,000,05,011,0462,0,1883,25,1908,2885,123456,2,1,2,0,1,0,71.76 ,66.14 ,50.00 
02,000,05,011,0463,0,1888,28,1916,2933,123456,2,1,2,0,1,0,71.76 ,65.33 ,50.00 
