00,000,00,000,0000,0,6255321,192061,6447382,10069401,15000901,827,319,760,67,301,18,67.13 ,64.03 ,38.57 
03,001,00,000,0000,0,1044573,26733,1071306,2236468,3388741,74,29,65,9,26,3,66.00 ,47.90 ,39.19 
03,002,00,000,0000,0,204436,4734,209170,314541,465828,31,12,25,6,11,1,67.52 ,66.50 ,38.71 
03,003,00,000,0000,0,547139,16009,563148,1034243,1595481,39,13,36,3,13,0,64.82 ,54.45 ,33.33 
03,004,00,000,0000,0,187047,5175,192222,278052,418264,35,13,34,1,13,0,66.48 ,69.13 ,37.14 
03,005,00,000,0000,0,247254,7157,254411,378337,558936,48,18,39,9,15,3,67.69 ,67.24 ,37.50 
03,006,00,000,0000,0,604815,20510,625325,927456,1438396,65,21,61,4,20,1,64.48 ,67.42 ,32.31 
03,007,00,000,0000,0,628004,24509,652513,857455,1292791,69,26,65,4,24,2,66.33 ,76.10 ,37.68 
03,008,00,000,0000,0,244611,11202,255813,373237,545557,39,13,34,5,12,1,68.41 ,68.54 ,33.33 
03,009,00,000,0000,0,387653,11161,398814,524496,751537,45,20,44,1,19,1,69.79 ,76.04 ,44.44 
03,010,00,000,0000,0,287320,9144,296464,401418,566725,44,18,40,4,16,2,70.83 ,73.85 ,40.91 
03,011,00,000,0000,0,517393,13975,531368,755552,1092344,88,31,79,9,31,0,69.17 ,70.33 ,35.23 
03,012,00,000,0000,0,587729,18506,606235,834697,1217661,67,27,63,4,25,2,68.55 ,72.63 ,40.30 
03,013,00,000,0000,0,444507,8355,452862,629047,912445,83,33,81,2,33,0,68.94 ,71.99 ,39.76 
03,014,00,000,0000,0,107649,4259,111908,175688,252911,37,16,36,1,16,0,69.47 ,63.70 ,43.24 
03,015,00,000,0000,0,139340,7500,146840,245324,357972,31,13,27,4,12,1,68.53 ,59.86 ,41.94 
03,016,00,000,0000,0,45450,2174,47624,64234,89731,10,6,9,1,5,1,71.59 ,74.14 ,60.00 
03,017,00,000,0000,0,25897,774,26671,33010,48700,15,6,15,0,6,0,67.78 ,80.80 ,40.00 
03,018,00,000,0000,0,4504,184,4688,6146,6881,7,4,7,0,4,0,89.32 ,76.28 ,57.14 
03,001,01,001,0000,0,162594,4775,167369,338061,521394,2,1,2,0,1,0,64.84 ,49.51 ,50.00 
03,001,01,002,0000,0,117335,3608,120943,248841,377499,2,1,2,0,1,0,65.92 ,48.60 ,50.00 
03,001,01,003,0000,0,119150,2440,121590,262443,383458,3,1,3,0,1,0,68.44 ,46.33 ,33.33 
03,001,01,004,0000,0,66434,2032,68466,156991,230566,2,1,2,0,1,0,68.09 ,43.61 ,50.00 
03,001,01,005,0000,0,88461,2188,90649,215932,350852,3,1,1,2,0,1,61.55 ,41.98 ,33.33 
03,001,01,006,0000,0,74156,806,74962,181492,256639,3,1,3,0,1,0,70.72 ,41.30 ,33.33 
03,001,01,007,0000,0,42939,705,43644,88675,142555,2,1,2,0,1,0,62.20 ,49.22 ,50.00 
03,001,01,008,0000,0,19367,1685,21052,46374,73515,1,1,1,0,1,0,63.08 ,45.40 ,100.00 
03,001,01,009,0000,0,25165,409,25574,49140,75511,4,1,3,1,1,0,65.08 ,52.04 ,25.00 
03,001,01,010,0000,0,31035,1320,32355,70640,103555,2,1,2,0,1,0,68.21 ,45.80 ,50.00 
03,001,01,011,0000,0,38673,572,39245,95723,134262,3,1,1,2,0,1,71.30 ,41.00 ,33.33 
03,001,01,012,0000,0,23753,628,24381,35606,50546,2,1,2,0,1,0,70.44 ,68.47 ,50.00 
03,001,01,013,0000,0,57247,1192,58439,131031,208692,2,1,2,0,1,0,62.79 ,44.60 ,50.00 
03,001,01,014,0000,0,46485,849,47334,91994,149810,4,1,3,1,1,0,61.41 ,51.45 ,25.00 
03,001,01,015,0000,0,20426,343,20769,39883,62077,4,1,4,0,1,0,64.25 ,52.07 ,25.00 
03,001,01,016,0000,0,20203,408,20611,37900,60444,3,1,3,0,1,0,62.70 ,54.38 ,33.33 
03,001,01,017,0000,0,16057,484,16541,30041,46233,2,1,2,0,1,0,64.98 ,55.06 ,50.00 
03,001,01,018,0000,0,6136,155,6291,13186,19108,4,1,3,1,0,1,69.01 ,47.71 ,25.00 
03,001,01,019,0000,0,4017,70,4087,5783,7281,2,1,2,0,1,0,79.43 ,70.67 ,50.00 
03,001,01,020,0000,0,3899,48,3947,4662,5980,5,1,4,1,1,0,77.96 ,84.66 ,20.00 
03,001,01,021,0000,0,8924,147,9071,14390,20927,2,1,2,0,1,0,68.76 ,63.04 ,50.00 
03,001,01,022,0000,0,5311,76,5387,7180,9933,3,1,3,0,1,0,72.28 ,75.03 ,33.33 
03,001,01,023,0000,0,6791,1193,7984,16621,24861,1,1,1,0,1,0,66.86 ,48.04 ,100.00 
03,001,01,024,0000,0,3558,56,3614,4885,6246,3,1,3,0,1,0,78.21 ,73.98 ,33.33 
03,001,01,025,0000,0,6504,83,6587,8557,10654,2,1,2,0,1,0,80.32 ,76.98 ,50.00 
03,001,01,026,0000,0,7716,103,7819,10425,13630,2,1,2,0,1,0,76.49 ,75.00 ,50.00 
03,001,01,027,0000,0,10848,163,11011,14046,20406,2,1,1,1,1,0,68.83 ,78.39 ,50.00 
03,001,01,028,0000,0,9518,167,9685,13506,18627,2,1,2,0,1,0,72.51 ,71.71 ,50.00 
03,001,01,029,0000,0,1871,28,1899,2460,3480,2,1,2,0,1,0,70.69 ,77.20 ,50.00 
03,002,01,001,0000,0,39106,719,39825,60665,92564,2,1,2,0,1,0,65.54 ,65.65 ,50.00 
03,002,01,002,0000,0,24268,963,25231,44190,67869,2,1,2,0,1,0,65.11 ,57.10 ,50.00 
03,002,01,003,0000,0,22441,584,23025,33438,48794,3,1,2,1,1,0,68.53 ,68.86 ,33.33 
03,002,01,004,0000,0,15941,470,16411,22894,33919,2,1,1,1,1,0,67.50 ,71.68 ,50.00 
03,002,01,005,0000,0,18521,393,18914,25961,38385,2,1,2,0,1,0,67.63 ,72.86 ,50.00 
03,002,01,006,0000,0,13891,300,14191,18431,26388,4,1,4,0,1,0,69.85 ,77.00 ,25.00 
03,002,01,007,0000,0,15136,265,15401,23376,33341,2,1,1,1,1,0,70.11 ,65.88 ,50.00 
03,002,01,008,0000,0,22291,480,22771,35400,52020,2,1,1,1,1,0,68.05 ,64.32 ,50.00 
03,002,01,009,0000,0,16334,200,16534,26417,38352,2,1,2,0,1,0,68.88 ,62.59 ,50.00 
03,002,01,010,0000,0,10997,262,11259,16323,22633,2,1,2,0,1,0,72.12 ,68.98 ,50.00 
03,002,01,011,0000,0,2737,34,2771,3733,5637,3,1,2,1,0,1,66.22 ,74.23 ,33.33 
03,002,01,012,0000,0,2773,64,2837,3713,5926,5,1,4,1,1,0,62.66 ,76.41 ,20.00 
03,003,01,001,0000,0,88134,3417,91551,185992,290696,3,1,3,0,1,0,63.98 ,49.22 ,33.33 
03,003,01,002,0000,0,107181,2567,109748,201951,308577,4,1,4,0,1,0,65.45 ,54.34 ,25.00 
03,003,01,003,0000,0,30472,631,31103,54376,81974,3,1,3,0,1,0,66.33 ,57.20 ,33.33 
03,003,01,004,0000,0,39970,884,40854,75859,116623,5,1,4,1,1,0,65.05 ,53.86 ,20.00 
03,003,01,005,0000,0,26529,714,27243,50223,78630,2,1,2,0,1,0,63.87 ,54.24 ,50.00 
03,003,01,006,0000,0,29546,722,30268,46656,73209,3,1,2,1,1,0,63.73 ,64.87 ,33.33 
03,003,01,007,0000,0,33713,821,34534,71080,107370,2,1,2,0,1,0,66.20 ,48.58 ,50.00 
03,003,01,008,0000,0,52481,2411,54892,98764,153205,3,1,3,0,1,0,64.47 ,55.58 ,33.33 
03,003,01,009,0000,0,34304,661,34965,61772,95592,3,1,2,1,1,0,64.62 ,56.60 ,33.33 
03,003,01,010,0000,0,55460,2188,57648,112147,178469,3,1,3,0,1,0,62.84 ,51.40 ,33.33 
03,003,01,011,0000,0,22656,399,23055,33497,48967,4,1,4,0,1,0,68.41 ,68.83 ,25.00 
03,003,01,012,0000,0,21256,457,21713,34170,50571,2,1,2,0,1,0,67.57 ,63.54 ,50.00 
03,003,01,013,0000,0,5437,137,5574,7756,11598,2,1,2,0,1,0,66.87 ,71.87 ,50.00 
03,004,01,001,0000,0,31502,937,32439,52457,81228,2,1,2,0,1,0,64.58 ,61.84 ,50.00 
03,004,01,002,0000,0,35728,940,36668,55512,84003,3,1,3,0,1,0,66.08 ,66.05 ,33.33 
03,004,01,003,0000,0,16890,379,17269,24895,36703,3,1,3,0,1,0,67.83 ,69.37 ,33.33 
03,004,01,004,0000,0,16612,278,16890,22719,32346,2,1,1,1,1,0,70.24 ,74.34 ,50.00 
03,004,01,005,0000,0,28033,1569,29602,40811,62881,3,1,3,0,1,0,64.90 ,72.53 ,33.33 
03,004,01,006,0000,0,17435,294,17729,27531,43095,3,1,3,0,1,0,63.88 ,64.40 ,33.33 
03,004,01,007,0000,0,9456,216,9672,13256,19464,2,1,2,0,1,0,68.11 ,72.96 ,50.00 
03,004,01,008,0000,0,8154,137,8291,10986,15413,2,1,2,0,1,0,71.28 ,75.47 ,50.00 
03,004,01,009,0000,0,6152,116,6268,7468,10584,2,1,2,0,1,0,70.56 ,83.93 ,50.00 
03,004,01,010,0000,0,6569,96,6665,8839,12599,2,1,2,0,1,0,70.16 ,75.40 ,50.00 
03,004,01,011,0000,0,4104,57,4161,4933,6577,4,1,4,0,1,0,75.00 ,84.35 ,25.00 
03,004,01,012,0000,0,3781,98,3879,5301,8437,3,1,3,0,1,0,62.83 ,73.17 ,33.33 
03,004,01,013,0000,0,2631,58,2689,3344,4934,4,1,4,0,1,0,67.77 ,80.41 ,25.00 
03,005,01,001,0000,0,37964,839,38803,60647,89800,5,1,5,0,1,0,67.54 ,63.98 ,20.00 
03,005,01,002,0000,0,22408,450,22858,33117,49209,4,1,4,0,1,0,67.30 ,69.02 ,25.00 
03,005,01,003,0000,0,20657,329,20986,28971,42491,3,1,3,0,1,0,68.18 ,72.44 ,33.33 
03,005,01,004,0000,0,27830,435,28265,43562,67062,3,1,3,0,1,0,64.96 ,64.88 ,33.33 
03,005,01,005,0000,0,33609,1189,34798,55863,85427,2,1,2,0,1,0,65.39 ,62.29 ,50.00 
03,005,01,006,0000,0,18757,434,19191,30013,43601,2,1,1,1,1,0,68.84 ,63.94 ,50.00 
03,005,01,007,0000,0,9692,196,9888,13897,20169,2,1,1,1,1,0,68.90 ,71.15 ,50.00 
03,005,01,008,0000,0,8302,178,8480,12912,18110,3,1,2,1,1,0,71.30 ,65.68 ,33.33 
03,005,01,009,0000,0,13507,1762,15269,23244,34684,1,1,1,0,1,0,67.02 ,65.69 ,100.00 
03,005,01,010,0000,0,10850,178,11028,14620,21003,2,1,1,1,0,1,69.61 ,75.43 ,50.00 
03,005,01,011,0000,0,6362,174,6536,9592,13050,4,1,4,0,1,0,73.50 ,68.14 ,25.00 
03,005,01,012,0000,0,7075,105,7180,8789,12607,4,1,3,1,1,0,69.72 ,81.69 ,25.00 
03,005,01,013,0000,0,8942,145,9087,12060,18246,2,1,2,0,1,0,66.10 ,75.35 ,50.00 
03,005,01,014,0000,0,4684,89,4773,6717,9318,2,1,1,1,0,1,72.09 ,71.06 ,50.00 
03,005,01,015,0000,0,5663,475,6138,9933,14692,1,1,1,0,1,0,67.61 ,61.79 ,100.00 
03,005,01,016,0000,0,4272,84,4356,5857,8119,2,1,2,0,1,0,72.14 ,74.37 ,50.00 
03,005,01,017,0000,0,3267,50,3317,4460,5846,3,1,2,1,1,0,76.29 ,74.37 ,33.33 
03,005,01,018,0000,0,3413,45,3458,4083,5502,3,1,1,2,0,1,74.21 ,84.69 ,33.33 
03,006,01,001,0000,0,57595,1669,59264,102649,159391,4,1,3,1,1,0,64.40 ,57.73 ,25.00 
03,006,01,002,0000,0,27679,858,28537,41306,60258,5,1,5,0,1,0,68.55 ,69.09 ,20.00 
03,006,01,003,0000,0,32800,693,33493,49152,77903,5,1,5,0,1,0,63.09 ,68.14 ,20.00 
03,006,01,004,0000,0,38484,1340,39824,55278,84300,2,1,2,0,1,0,65.57 ,72.04 ,50.00 
03,006,01,005,0000,0,35607,759,36366,44798,70758,6,1,5,1,1,0,63.31 ,81.18 ,16.67 
03,006,01,006,0000,0,23465,529,23994,30261,48258,2,1,1,1,0,1,62.71 ,79.29 ,50.00 
03,006,01,007,0000,0,26525,550,27075,36545,54808,5,1,5,0,1,0,66.68 ,74.09 ,20.00 
03,006,01,008,0000,0,27689,572,28261,38604,59778,2,1,2,0,1,0,64.58 ,73.21 ,50.00 
03,006,01,009,0000,0,27430,988,28418,52429,80794,3,1,3,0,1,0,64.89 ,54.20 ,33.33 
03,006,01,010,0000,0,29117,781,29898,45897,73528,4,1,4,0,1,0,62.42 ,65.14 ,25.00 
03,006,01,011,0000,0,14718,385,15103,19191,27160,2,1,2,0,1,0,70.66 ,78.70 ,50.00 
03,006,01,012,0000,0,8253,201,8454,10861,15309,2,1,2,0,1,0,70.95 ,77.84 ,50.00 
03,006,01,013,0000,0,15456,439,15895,19591,30108,2,1,2,0,1,0,65.07 ,81.13 ,50.00 
03,006,01,014,0000,0,9242,867,10109,14415,21134,1,1,1,0,1,0,68.21 ,70.13 ,100.00 
03,006,01,015,0000,0,29409,860,30269,40793,62663,4,1,4,0,1,0,65.10 ,74.20 ,25.00 
03,006,01,016,0000,0,22096,3123,25219,33566,52787,1,1,1,0,1,0,63.59 ,75.13 ,100.00 
03,006,01,017,0000,0,29319,870,30189,38488,60085,3,1,2,1,1,0,64.06 ,78.44 ,33.33 
03,006,01,018,0000,0,30376,809,31185,44041,67066,3,1,3,0,1,0,65.67 ,70.81 ,33.33 
03,006,01,019,0000,0,56257,1901,58158,99584,156287,3,1,3,0,1,0,63.72 ,58.40 ,33.33 
03,006,01,020,0000,0,57142,2189,59331,101753,165134,2,1,2,0,1,0,61.62 ,58.31 ,50.00 
03,006,01,021,0000,0,6156,127,6283,8254,10887,4,1,4,0,1,0,75.82 ,76.12 ,25.00 
03,007,01,001,0000,0,100705,3015,103720,144942,224365,5,1,5,0,1,0,64.60 ,71.56 ,20.00 
03,007,01,002,0000,0,37250,1570,38820,52757,81541,3,1,3,0,1,0,64.70 ,73.58 ,33.33 
03,007,01,003,0000,0,40858,1336,42194,52943,82746,3,1,3,0,1,0,63.98 ,79.70 ,33.33 
03,007,01,004,0000,0,7020,978,7998,10761,16365,1,1,1,0,1,0,65.76 ,74.32 ,100.00 
03,007,01,005,0000,0,17368,376,17744,20771,32577,2,1,2,0,1,0,63.76 ,85.43 ,50.00 
03,007,01,006,0000,0,25243,392,25635,30748,47321,4,1,4,0,1,0,64.98 ,83.37 ,25.00 
03,007,01,007,0000,0,18667,374,19041,23575,36634,5,1,5,0,1,0,64.35 ,80.77 ,20.00 
03,007,01,008,0000,0,22125,518,22643,29391,45139,3,1,3,0,1,0,65.11 ,77.04 ,33.33 
03,007,01,009,0000,0,12636,1382,14018,18443,26614,1,1,1,0,1,0,69.30 ,76.01 ,100.00 
03,007,01,010,0000,0,56000,1387,57387,80752,126183,4,1,4,0,1,0,64.00 ,71.07 ,25.00 
03,007,01,011,0000,0,27655,429,28084,35001,54636,2,1,2,0,1,0,64.06 ,80.24 ,50.00 
03,007,01,012,0000,0,23773,516,24289,32269,46791,4,1,4,0,1,0,68.96 ,75.27 ,25.00 
03,007,01,013,0000,0,18413,290,18703,23088,34330,3,1,3,0,1,0,67.25 ,81.01 ,33.33 
03,007,01,014,0000,0,20465,405,20870,24223,35333,2,1,2,0,1,0,68.56 ,86.16 ,50.00 
03,007,01,015,0000,0,17714,325,18039,22886,34142,4,1,4,0,1,0,67.03 ,78.82 ,25.00 
03,007,01,016,0000,0,20327,482,20809,26476,39906,4,1,4,0,1,0,66.35 ,78.60 ,25.00 
03,007,01,017,0000,0,23227,748,23975,29514,44536,2,1,1,1,0,1,66.27 ,81.23 ,50.00 
03,007,01,018,0000,0,10269,340,10609,13581,18820,2,1,2,0,1,0,72.16 ,78.12 ,50.00 
03,007,01,019,0000,0,17071,367,17438,22159,33260,3,1,3,0,1,0,66.62 ,78.69 ,33.33 
03,007,01,020,0000,0,26606,3182,29788,38630,57404,1,1,1,0,1,0,67.29 ,77.11 ,100.00 
03,007,01,021,0000,0,16240,263,16503,19901,28622,3,1,2,1,0,1,69.53 ,82.93 ,33.33 
03,007,01,022,0000,0,14783,467,15250,22520,33199,2,1,1,1,1,0,67.83 ,67.72 ,50.00 
03,007,01,023,0000,0,17417,3690,21107,29513,39709,1,1,1,0,1,0,74.32 ,71.52 ,100.00 
03,007,01,024,0000,0,12558,200,12758,16381,21853,2,1,1,1,1,0,74.96 ,77.88 ,50.00 
03,007,01,025,0000,0,9672,152,9824,12733,17384,2,1,2,0,1,0,73.25 ,77.15 ,50.00 
03,007,01,026,0000,0,13942,1325,15267,23497,33381,1,1,1,0,1,0,70.39 ,64.97 ,100.00 
03,008,01,001,0000,0,47691,1138,48829,68293,103917,3,1,3,0,1,0,65.72 ,71.50 ,33.33 
03,008,01,002,0000,0,36978,992,37970,60073,87626,3,1,2,1,1,0,68.56 ,63.21 ,33.33 
03,008,01,003,0000,0,42203,1512,43715,63871,96029,2,1,2,0,1,0,66.51 ,68.44 ,50.00 
03,008,01,004,0000,0,21824,5270,27094,43068,62656,1,1,1,0,1,0,68.74 ,62.91 ,100.00 
03,008,01,005,0000,0,6638,87,6725,8948,12282,2,1,2,0,1,0,72.85 ,75.16 ,50.00 
03,008,01,006,0000,0,22065,825,22890,29855,42887,4,1,3,1,0,1,69.61 ,76.67 ,25.00 
03,008,01,007,0000,0,11910,158,12068,15365,21460,3,1,3,0,1,0,71.60 ,78.54 ,33.33 
03,008,01,008,0000,0,10404,170,10574,13789,18531,5,1,4,1,1,0,74.41 ,76.68 ,20.00 
03,008,01,009,0000,0,8031,137,8168,13266,18008,2,1,2,0,1,0,73.67 ,61.57 ,50.00 
03,008,01,010,0000,0,10793,196,10989,18009,25140,3,1,3,0,1,0,71.63 ,61.02 ,33.33 
03,008,01,011,0000,0,11629,130,11759,16831,23893,3,1,2,1,1,0,70.44 ,69.87 ,33.33 
03,008,01,012,0000,0,7286,489,7775,11565,18074,2,1,2,0,1,0,63.99 ,67.23 ,50.00 
03,008,01,013,0000,0,7159,98,7257,10304,15054,6,1,5,1,1,0,68.45 ,70.43 ,16.67 
03,009,01,001,0000,0,46566,1347,47913,64676,97470,2,1,2,0,1,0,66.35 ,74.08 ,50.00 
03,009,01,002,0000,0,22597,1450,24047,32480,47662,2,1,2,0,1,0,68.15 ,74.04 ,50.00 
03,009,01,003,0000,0,32932,1000,33932,45412,66521,2,1,2,0,1,0,68.27 ,74.72 ,50.00 
03,009,01,004,0000,0,25127,524,25651,34750,50680,2,1,2,0,1,0,68.57 ,73.82 ,50.00 
03,009,01,005,0000,0,13989,1770,15759,22882,32785,1,1,1,0,1,0,69.79 ,68.87 ,100.00 
03,009,01,006,0000,0,24630,706,25336,33305,48111,3,1,3,0,1,0,69.23 ,76.07 ,33.33 
03,009,01,007,0000,0,19373,445,19818,25905,36602,4,1,3,1,0,1,70.77 ,76.50 ,25.00 
03,009,01,008,0000,0,12809,353,13162,16934,23904,2,1,2,0,1,0,70.84 ,77.73 ,50.00 
03,009,01,009,0000,0,17021,312,17333,21990,32102,3,1,3,0,1,0,68.50 ,78.82 ,33.33 
03,009,01,010,0000,0,11278,308,11586,14610,21565,3,1,3,0,1,0,67.75 ,79.30 ,33.33 
03,009,01,011,0000,0,17571,274,17845,23902,32671,2,1,2,0,1,0,73.16 ,74.66 ,50.00 
03,009,01,012,0000,0,16218,285,16503,21019,29867,2,1,2,0,1,0,70.38 ,78.51 ,50.00 
03,009,01,013,0000,0,17810,335,18145,22155,32235,2,1,2,0,1,0,68.73 ,81.90 ,50.00 
03,009,01,014,0000,0,11422,304,11726,14317,19915,2,1,2,0,1,0,71.89 ,81.90 ,50.00 
03,009,01,015,0000,0,9020,142,9162,11078,15702,2,1,2,0,1,0,70.55 ,82.70 ,50.00 
03,009,01,016,0000,0,18020,337,18357,21774,30268,2,1,2,0,1,0,71.94 ,84.31 ,50.00 
03,009,01,017,0000,0,16855,280,17135,24332,33179,2,1,2,0,1,0,73.34 ,70.42 ,50.00 
03,009,01,018,0000,0,15725,330,16055,23282,31886,2,1,2,0,1,0,73.02 ,68.96 ,50.00 
03,009,01,019,0000,0,19266,382,19648,24458,34597,2,1,2,0,1,0,70.69 ,80.33 ,50.00 
03,009,01,020,0000,0,19424,277,19701,25235,33815,3,1,3,0,1,0,74.63 ,78.07 ,33.33 
03,010,01,001,0000,0,16209,314,16523,20531,30578,3,1,2,1,1,0,67.14 ,80.48 ,33.33 
03,010,01,002,0000,0,21114,701,21815,30935,44779,2,1,1,1,0,1,69.08 ,70.52 ,50.00 
03,010,01,003,0000,0,18870,333,19203,25140,34595,2,1,2,0,1,0,72.67 ,76.38 ,50.00 
03,010,01,004,0000,0,19101,398,19499,26169,36608,3,1,2,1,0,1,71.48 ,74.51 ,33.33 
03,010,01,005,0000,0,33768,772,34540,45837,68016,3,1,3,0,1,0,67.39 ,75.35 ,33.33 
03,010,01,006,0000,0,8478,1064,9542,13972,18727,2,1,1,1,1,0,74.61 ,68.29 ,50.00 
03,010,01,007,0000,0,18985,323,19308,25771,36401,3,1,3,0,1,0,70.80 ,74.92 ,33.33 
03,010,01,008,0000,0,15779,398,16177,23104,30422,2,1,2,0,1,0,75.95 ,70.02 ,50.00 
03,010,01,009,0000,0,13913,1779,15692,23424,31518,2,1,2,0,1,0,74.32 ,66.99 ,50.00 
03,010,01,010,0000,0,15537,292,15829,18602,24915,2,1,2,0,1,0,74.66 ,85.09 ,50.00 
03,010,01,011,0000,0,10628,194,10822,14236,19138,2,1,2,0,1,0,74.39 ,76.02 ,50.00 
03,010,01,012,0000,0,27307,990,28297,38227,54617,2,1,2,0,1,0,69.99 ,74.02 ,50.00 
03,010,01,013,0000,0,22266,765,23031,32871,48112,2,1,2,0,1,0,68.32 ,70.06 ,50.00 
03,010,01,014,0000,0,20269,474,20743,29182,41908,2,1,2,0,1,0,69.63 ,71.08 ,50.00 
03,010,01,015,0000,0,13321,192,13513,17138,24025,5,1,5,0,1,0,71.33 ,78.85 ,20.00 
03,010,01,016,0000,0,6639,80,6719,8865,12226,2,1,2,0,1,0,72.51 ,75.79 ,50.00 
03,010,01,017,0000,0,2166,25,2191,2867,3729,2,1,2,0,1,0,76.88 ,76.42 ,50.00 
03,010,01,018,0000,0,2970,50,3020,4547,6411,3,1,3,0,1,0,70.92 ,66.42 ,33.33 
03,011,01,001,0000,0,33653,794,34447,50732,75598,3,1,2,1,1,0,67.11 ,67.90 ,33.33 
03,011,01,002,0000,0,14701,380,15081,20931,29270,2,1,2,0,1,0,71.51 ,72.05 ,50.00 
03,011,01,003,0000,0,16383,2060,18443,26842,36485,1,1,1,0,1,0,73.57 ,68.71 ,100.00 
03,011,01,004,0000,0,11422,928,12350,17731,24670,1,1,1,0,1,0,71.87 ,69.65 ,100.00 
03,011,01,005,0000,0,15502,338,15840,21770,29174,3,1,2,1,1,0,74.62 ,72.76 ,33.33 
03,011,01,006,0000,0,14151,220,14371,19386,26145,4,1,4,0,1,0,74.15 ,74.13 ,25.00 
03,011,01,007,0000,0,25433,345,25778,33398,47559,3,1,2,1,1,0,70.22 ,77.18 ,33.33 
03,011,01,008,0000,0,15616,211,15827,20305,28542,4,1,3,1,1,0,71.14 ,77.95 ,25.00 
03,011,01,009,0000,0,12715,160,12875,17481,25550,2,1,1,1,1,0,68.42 ,73.65 ,50.00 
03,011,01,010,0000,0,11638,320,11958,17466,24128,2,1,2,0,1,0,72.39 ,68.46 ,50.00 
03,011,01,011,0000,0,7684,128,7812,9544,12517,2,1,2,0,1,0,76.25 ,81.85 ,50.00 
03,011,01,012,0000,0,27582,403,27985,38289,56960,4,1,3,1,1,0,67.22 ,73.09 ,25.00 
03,011,01,013,0000,0,15952,245,16197,21376,30848,5,1,5,0,1,0,69.29 ,75.77 ,20.00 
03,011,01,014,0000,0,13940,210,14150,17523,25884,2,1,2,0,1,0,67.70 ,80.75 ,50.00 
03,011,01,015,0000,0,14430,244,14674,19536,26452,2,1,1,1,1,0,73.85 ,75.11 ,50.00 
03,011,01,016,0000,0,13708,202,13910,17812,23833,3,1,3,0,1,0,74.74 ,78.09 ,33.33 
03,011,01,017,0000,0,8664,115,8779,10361,14117,2,1,2,0,1,0,73.39 ,84.73 ,50.00 
03,011,01,018,0000,0,21235,345,21580,30471,44490,4,1,3,1,1,0,68.49 ,70.82 ,25.00 
03,011,01,019,0000,0,20210,467,20677,29175,41796,6,1,6,0,1,0,69.80 ,70.87 ,16.67 
03,011,01,020,0000,0,14572,467,15039,21023,32225,3,1,3,0,1,0,65.24 ,71.54 ,33.33 
03,011,01,021,0000,0,16072,456,16528,20417,29370,2,1,2,0,1,0,69.52 ,80.95 ,50.00 
03,011,01,022,0000,0,5197,72,5269,5929,8062,4,1,4,0,1,0,73.54 ,88.87 ,25.00 
03,011,01,023,0000,0,9554,146,9700,12605,17468,3,1,3,0,1,0,72.16 ,76.95 ,33.33 
03,011,01,024,0000,0,7930,128,8058,9248,12389,2,1,2,0,1,0,74.65 ,87.13 ,50.00 
03,011,01,025,0000,0,6125,68,6193,7402,9739,2,1,2,0,1,0,76.00 ,83.67 ,50.00 
03,011,01,026,0000,0,4172,42,4214,5061,6231,3,1,2,1,1,0,81.22 ,83.26 ,33.33 
03,011,01,027,0000,0,31228,1259,32487,44251,64877,2,1,2,0,1,0,68.21 ,73.42 ,50.00 
03,011,01,028,0000,0,27829,517,28346,39788,61475,4,1,4,0,1,0,64.72 ,71.24 ,25.00 
03,011,01,029,0000,0,20566,286,20852,27264,39241,3,1,3,0,1,0,69.48 ,76.48 ,33.33 
03,011,01,030,0000,0,3017,75,3092,3671,4661,2,1,2,0,1,0,78.76 ,84.23 ,50.00 
03,011,01,031,0000,0,56512,2344,58856,118764,182588,3,1,3,0,1,0,65.04 ,49.56 ,33.33 
03,012,01,001,0000,0,120977,4480,125457,210291,313269,4,1,4,0,1,0,67.13 ,59.66 ,25.00 
03,012,01,002,0000,0,37197,541,37738,46621,71488,3,1,2,1,0,1,65.22 ,80.95 ,33.33 
03,012,01,003,0000,0,55902,1420,57322,77584,114385,3,1,1,2,0,1,67.83 ,73.88 ,33.33 
03,012,01,004,0000,0,24862,484,25346,32818,47118,2,1,2,0,1,0,69.65 ,77.23 ,50.00 
03,012,01,005,0000,0,17554,418,17972,22526,32821,4,1,4,0,1,0,68.63 ,79.78 ,25.00 
03,012,01,006,0000,0,22969,468,23437,31078,47239,3,1,3,0,1,0,65.79 ,75.41 ,33.33 
03,012,01,007,0000,0,18327,545,18872,25098,35214,2,1,2,0,1,0,71.27 ,75.19 ,50.00 
03,012,01,008,0000,0,34774,4692,39466,60971,91032,1,1,1,0,1,0,66.98 ,64.73 ,100.00 
03,012,01,009,0000,0,19863,564,20427,26863,38284,2,1,2,0,1,0,70.17 ,76.04 ,50.00 
03,012,01,010,0000,0,18217,337,18554,23083,32980,2,1,2,0,1,0,69.99 ,80.38 ,50.00 
03,012,01,011,0000,0,6512,95,6607,7908,10010,4,1,4,0,1,0,79.00 ,83.55 ,25.00 
03,012,01,012,0000,0,14372,288,14660,20614,31112,2,1,2,0,1,0,66.26 ,71.12 ,50.00 
03,012,01,013,0000,0,29208,704,29912,35726,52933,2,1,2,0,1,0,67.49 ,83.73 ,50.00 
03,012,01,014,0000,0,14897,340,15237,19305,27428,2,1,2,0,1,0,70.38 ,78.93 ,50.00 
03,012,01,015,0000,0,18745,361,19106,22881,33388,3,1,3,0,1,0,68.53 ,83.50 ,33.33 
03,012,01,016,0000,0,9108,209,9317,10563,14060,2,1,2,0,1,0,75.13 ,88.20 ,50.00 
03,012,01,017,0000,0,13465,206,13671,15755,22040,3,1,3,0,1,0,71.48 ,86.77 ,33.33 
03,012,01,018,0000,0,20660,631,21291,27167,39865,2,1,2,0,1,0,68.15 ,78.37 ,50.00 
03,012,01,019,0000,0,24726,320,25046,32638,45396,4,1,3,1,1,0,71.90 ,76.74 ,25.00 
03,012,01,020,0000,0,26846,526,27372,35179,48405,2,1,2,0,1,0,72.68 ,77.81 ,50.00 
03,012,01,021,0000,0,8735,280,9015,13283,18229,2,1,2,0,1,0,72.87 ,67.87 ,50.00 
03,012,01,022,0000,0,5409,39,5448,6519,9120,2,1,2,0,1,0,71.48 ,83.57 ,50.00 
03,012,01,023,0000,0,7700,151,7851,10530,13715,2,1,2,0,1,0,76.78 ,74.56 ,50.00 
03,012,01,024,0000,0,11859,110,11969,13419,18473,2,1,2,0,1,0,72.64 ,89.19 ,50.00 
03,012,01,025,0000,0,1141,27,1168,1303,1702,3,1,3,0,1,0,76.56 ,89.64 ,33.33 
03,012,01,026,0000,0,2008,247,2255,3022,4772,1,1,1,0,1,0,63.33 ,74.62 ,100.00 
03,012,01,027,0000,0,1696,23,1719,1952,3183,3,1,3,0,1,0,61.33 ,88.06 ,33.33 
03,013,01,001,0000,0,93377,1482,94859,145040,215171,4,1,4,0,1,0,67.41 ,65.40 ,25.00 
03,013,01,002,0000,0,25672,412,26084,38981,58066,3,1,2,1,1,0,67.13 ,66.91 ,33.33 
03,013,01,003,0000,0,22515,720,23235,32109,49179,2,1,2,0,1,0,65.29 ,72.36 ,50.00 
03,013,01,004,0000,0,15208,244,15452,22191,31366,2,1,2,0,1,0,70.75 ,69.63 ,50.00 
03,013,01,005,0000,0,26481,718,27199,35957,53793,3,1,3,0,1,0,66.84 ,75.64 ,33.33 
03,013,01,006,0000,0,14583,309,14892,20754,29866,3,1,3,0,1,0,69.49 ,71.75 ,33.33 
03,013,01,007,0000,0,6524,61,6585,8295,11884,3,1,3,0,1,0,69.80 ,79.39 ,33.33 
03,013,01,008,0000,0,12370,224,12594,15669,23094,2,1,2,0,1,0,67.85 ,80.38 ,50.00 
03,013,01,009,0000,0,15022,221,15243,18972,27528,2,1,2,0,1,0,68.92 ,80.34 ,50.00 
03,013,01,010,0000,0,15697,386,16083,19624,28856,2,1,2,0,1,0,68.01 ,81.96 ,50.00 
03,013,01,011,0000,0,15698,292,15990,22567,30421,4,1,4,0,1,0,74.18 ,70.86 ,25.00 
03,013,01,012,0000,0,12853,215,13068,17729,24786,2,1,2,0,1,0,71.53 ,73.71 ,50.00 
03,013,01,013,0000,0,27933,505,28438,43923,63380,6,1,6,0,1,0,69.30 ,64.75 ,16.67 
03,013,01,014,0000,0,10751,164,10915,14152,19550,2,1,2,0,1,0,72.39 ,77.13 ,50.00 
03,013,01,015,0000,0,6711,86,6797,8945,12108,2,1,1,1,1,0,73.88 ,75.99 ,50.00 
03,013,01,016,0000,0,15883,228,16111,21496,30719,2,1,2,0,1,0,69.98 ,74.95 ,50.00 
03,013,01,017,0000,0,22934,475,23409,27938,41984,2,1,2,0,1,0,66.54 ,83.79 ,50.00 
03,013,01,018,0000,0,7642,130,7772,9805,14243,2,1,2,0,1,0,68.84 ,79.27 ,50.00 
03,013,01,019,0000,0,11423,186,11609,16465,23700,4,1,4,0,1,0,69.47 ,70.51 ,25.00 
03,013,01,020,0000,0,6959,111,7070,9670,13870,2,1,2,0,1,0,69.72 ,73.11 ,50.00 
03,013,01,021,0000,0,12391,220,12611,17359,24202,2,1,2,0,1,0,71.73 ,72.65 ,50.00 
03,013,01,022,0000,0,7372,109,7481,9608,12529,2,1,2,0,1,0,76.69 ,77.86 ,50.00 
03,013,01,023,0000,0,5834,95,5929,8424,11530,2,1,2,0,1,0,73.06 ,70.38 ,50.00 
03,013,01,024,0000,0,5099,94,5193,6851,9075,2,1,2,0,1,0,75.49 ,75.80 ,50.00 
03,013,01,025,0000,0,4216,102,4318,5245,6720,2,1,2,0,1,0,78.05 ,82.33 ,50.00 
03,013,01,026,0000,0,3836,58,3894,4914,7113,2,1,2,0,1,0,69.08 ,79.24 ,50.00 
03,013,01,027,0000,0,2203,36,2239,2555,2844,3,1,3,0,1,0,89.84 ,87.63 ,33.33 
03,013,01,028,0000,0,3419,53,3472,4338,6163,3,1,3,0,1,0,70.39 ,80.04 ,33.33 
03,013,01,029,0000,0,2439,50,2489,3253,4780,3,1,3,0,1,0,68.05 ,76.51 ,33.33 
03,013,01,030,0000,0,3747,221,3968,5343,7958,1,1,1,0,1,0,67.14 ,74.27 ,100.00 
03,013,01,031,0000,0,2689,60,2749,3438,5283,2,1,2,0,1,0,65.08 ,79.96 ,50.00 
03,013,01,032,0000,0,2574,40,2614,3634,5247,3,1,3,0,1,0,69.26 ,71.93 ,33.33 
03,013,01,033,0000,0,2452,48,2500,3803,5437,2,1,2,0,1,0,69.95 ,65.74 ,50.00 
03,014,01,001,0000,0,49300,1065,50365,75878,111352,5,1,4,1,1,0,68.14 ,66.38 ,20.00 
03,014,01,002,0000,0,7665,110,7775,13815,19965,2,1,2,0,1,0,69.20 ,56.28 ,50.00 
03,014,01,003,0000,0,5126,74,5200,8042,11650,2,1,2,0,1,0,69.03 ,64.66 ,50.00 
03,014,01,004,0000,0,8601,916,9517,14855,20480,1,1,1,0,1,0,72.53 ,64.07 ,100.00 
03,014,01,005,0000,0,4951,93,5044,7548,10493,3,1,3,0,1,0,71.93 ,66.83 ,33.33 
03,014,01,006,0000,0,5067,124,5191,8306,11429,4,1,4,0,1,0,72.67 ,62.50 ,25.00 
03,014,01,007,0000,0,4368,616,4984,9315,12694,1,1,1,0,1,0,73.38 ,53.51 ,100.00 
03,014,01,008,0000,0,4593,57,4650,8508,11610,3,1,3,0,1,0,73.28 ,54.65 ,33.33 
03,014,01,009,0000,0,5608,567,6175,9978,14307,1,1,1,0,1,0,69.74 ,61.89 ,100.00 
03,014,01,010,0000,0,2726,186,2912,4821,6954,1,1,1,0,1,0,69.33 ,60.40 ,100.00 
03,014,01,011,0000,0,1394,15,1409,1759,2513,2,1,2,0,1,0,70.00 ,80.10 ,50.00 
03,014,01,012,0000,0,1945,60,2005,3088,4925,2,1,2,0,1,0,62.70 ,64.93 ,50.00 
03,014,01,013,0000,0,1493,216,1709,2611,3869,1,1,1,0,1,0,67.49 ,65.45 ,100.00 
03,014,01,014,0000,0,1782,18,1800,2291,3396,5,1,5,0,1,0,67.46 ,78.57 ,20.00 
03,014,01,015,0000,0,1674,87,1761,2973,4284,1,1,1,0,1,0,69.40 ,59.23 ,100.00 
03,014,01,016,0000,0,1356,55,1411,1900,2990,3,1,3,0,1,0,63.55 ,74.26 ,33.33 
03,015,01,001,0000,0,42181,1395,43576,72222,108878,2,1,1,1,1,0,66.33 ,60.34 ,50.00 
03,015,01,002,0000,0,6342,678,7020,11042,15008,1,1,1,0,1,0,73.57 ,63.58 ,100.00 
03,015,01,003,0000,0,13522,500,14022,24273,33948,3,1,2,1,1,0,71.50 ,57.77 ,33.33 
03,015,01,004,0000,0,7464,1036,8500,14236,20235,1,1,1,0,1,0,70.35 ,59.71 ,100.00 
03,015,01,005,0000,0,24215,2486,26701,48847,71852,1,1,1,0,1,0,67.98 ,54.66 ,100.00 
03,015,01,006,0000,0,10276,176,10452,15260,21169,3,1,2,1,0,1,72.09 ,68.49 ,33.33 
03,015,01,007,0000,0,7501,167,7668,12592,17832,3,1,3,0,1,0,70.61 ,60.90 ,33.33 
03,015,01,008,0000,0,2777,44,2821,5034,7120,3,1,3,0,1,0,70.70 ,56.04 ,33.33 
03,015,01,009,0000,0,6513,107,6620,11286,16011,3,1,3,0,1,0,70.49 ,58.66 ,33.33 
03,015,01,010,0000,0,5463,581,6044,11282,15265,1,1,1,0,1,0,73.91 ,53.57 ,100.00 
03,015,01,011,0000,0,6730,158,6888,9559,15099,3,1,3,0,1,0,63.31 ,72.06 ,33.33 
03,015,01,012,0000,0,3261,98,3359,4814,7930,4,1,4,0,1,0,60.71 ,69.78 ,25.00 
03,015,01,013,0000,0,3095,74,3169,4877,7625,3,1,2,1,1,0,63.96 ,64.98 ,33.33 
03,016,01,001,0000,0,25045,759,25804,34688,52288,2,1,1,1,0,1,66.34 ,74.39 ,50.00 
03,016,01,002,0000,0,6969,123,7092,9462,12763,2,1,2,0,1,0,74.14 ,74.95 ,50.00 
03,016,01,003,0000,0,4750,547,5297,6902,8930,1,1,1,0,1,0,77.29 ,76.75 ,100.00 
03,016,01,004,0000,0,3914,667,4581,6788,8616,1,1,1,0,1,0,78.78 ,67.49 ,100.00 
03,016,01,005,0000,0,2962,52,3014,3991,3159,2,1,2,0,1,0,126.34 ,75.52 ,50.00 
03,016,01,006,0000,0,1810,26,1836,2403,3975,2,1,2,0,1,0,60.45 ,76.40 ,50.00 
03,017,01,001,0000,0,8287,246,8533,10533,16462,5,1,5,0,1,0,63.98 ,81.01 ,20.00 
03,017,01,002,0000,0,4366,157,4523,5799,8244,2,1,2,0,1,0,70.34 ,78.00 ,50.00 
03,017,01,003,0000,0,6054,172,6226,7419,11048,3,1,3,0,1,0,67.15 ,83.92 ,33.33 
03,017,01,004,0000,0,4607,146,4753,5884,8263,2,1,2,0,1,0,71.21 ,80.78 ,50.00 
03,017,01,005,0000,0,2554,53,2607,3277,4584,2,1,2,0,1,0,71.49 ,79.55 ,50.00 
03,017,01,006,0000,0,29,0,29,98,99,1,1,1,0,1,0,98.99 ,29.59 ,100.00 
03,018,01,001,0000,0,2318,88,2406,3214,4020,2,1,2,0,1,0,79.95 ,74.86 ,50.00 
03,018,01,002,0000,0,1028,29,1057,1332,1391,2,1,2,0,1,0,95.76 ,79.35 ,50.00 
03,018,01,003,0000,0,830,17,847,1103,755,2,1,2,0,1,0,146.09 ,76.79 ,50.00 
03,018,01,004,0000,0,328,50,378,497,715,1,1,1,0,1,0,69.51 ,76.06 ,100.00 
