00,000,00,000,0000,0,9572532,77336,9649868,16258979,22190495,368,168,306,62,138,30,73.27,59.35 ,45.65
01,000,00,000,0000,0,1197619,6666,1204285,1965286,2614502,52,20,43,9,15,5,75.17 ,61.28 ,38.46 
01,000,01,000,0000,0,609374,3341,612715,1003742,1344200,22,10,18,4,8,2,74.67 ,61.04 ,45.45 
01,000,02,000,0000,0,588245,3325,591570,961544,1270302,30,10,25,5,7,3,75.69 ,61.52 ,33.33 
02,000,00,000,0000,0,636090,3955,640045,1112501,1501799,25,11,22,3,10,1,74.08 ,57.53 ,44.00 
02,000,01,000,0000,0,363585,2186,365771,635837,864940,14,6,12,2,5,1,73.51 ,57.53 ,42.86 
02,000,02,000,0000,0,272505,1769,274274,476664,636859,11,5,10,1,5,0,74.85 ,57.54 ,45.45 
03,001,00,000,0000,0,1512504,12053,1524557,2679770,3655040,53,28,45,8,23,5,73.32 ,56.89 ,52.83 
03,001,01,000,0000,0,431598,3551,435149,783824,1091374,14,8,13,1,7,1,71.82 ,55.52 ,57.14 
03,001,02,000,0000,0,549524,4594,554118,981318,1365854,19,11,16,3,9,2,71.85 ,56.47 ,57.89 
03,001,03,000,0000,0,531382,3908,535290,914628,1197812,20,9,16,4,7,2,76.36 ,58.53 ,45.00 
03,002,00,000,0000,0,184661,1349,186010,329857,448845,4,3,3,1,3,0,73.49 ,56.39 ,75.00 
03,002,01,000,0000,0,184661,1349,186010,329857,448845,4,3,3,1,3,0,73.49 ,56.39 ,75.00 
03,003,00,000,0000,0,736843,6811,743654,1263071,1792301,28,13,21,7,10,3,70.47 ,58.88 ,46.43 
03,003,01,000,0000,0,736843,6811,743654,1263071,1792301,28,13,21,7,10,3,70.47 ,58.88 ,46.43 
03,004,00,000,0000,0,188287,2032,190319,315470,445551,5,3,4,1,3,0,70.80 ,60.33 ,60.00 
03,005,00,000,0000,0,239807,2162,241969,402651,551340,10,4,10,0,4,0,73.03 ,60.09 ,40.00 
03,006,00,000,0000,0,632372,6949,639321,1068959,1507171,22,11,19,3,9,2,70.92 ,59.81 ,50.00 
03,007,00,000,0000,0,642945,7181,650126,950566,1312298,19,10,16,3,9,1,72.44 ,68.39 ,52.63 
03,008,00,000,0000,0,215726,1677,217403,379609,512471,11,4,11,0,4,0,74.07 ,57.27 ,36.36 
03,009,00,000,0000,0,349862,3451,353313,551467,737057,18,6,14,4,4,2,74.82 ,64.07 ,33.33 
03,010,00,000,0000,0,250266,2520,252786,417378,553546,11,4,10,1,3,1,75.40 ,60.57 ,36.36 
03,011,00,000,0000,0,508166,3874,512040,825961,1102838,16,8,12,4,7,1,74.89 ,61.99 ,50.00 
03,012,00,000,0000,0,545184,4690,549874,910134,1222508,16,9,13,3,7,2,74.45 ,60.42 ,56.25 
03,013,00,000,0000,0,393749,2537,396286,631058,847798,11,6,9,2,5,1,74.43 ,62.80 ,54.55 
03,014,00,000,0000,0,61988,355,62343,121819,162540,3,1,2,1,1,0,74.95 ,51.18 ,33.33 
03,015,00,000,0000,0,95768,822,96590,197038,262047,6,2,6,0,2,0,75.19 ,49.02 ,33.33 
03,016,00,000,0000,0,37833,332,38165,69339,91625,3,1,3,0,1,0,75.68 ,55.04 ,33.33 
03,017,00,000,0000,0,150669,1247,151916,285671,384918,5,3,3,2,2,1,74.22 ,53.18 ,60.00 
03,018,00,000,0000,0,147028,1065,148093,272074,382917,9,3,8,1,3,0,71.05 ,54.43 ,33.33 
03,019,00,000,0000,0,398166,2791,400957,712274,1009990,18,8,13,5,6,2,70.52 ,56.29 ,44.44 
03,020,00,000,0000,0,103207,629,103836,193209,269472,4,2,3,1,1,1,71.70 ,53.74 ,50.00 
03,021,00,000,0000,0,316895,1871,318766,550411,751187,12,6,9,3,4,2,73.27 ,57.91 ,50.00 
04,001,00,000,0000,0,22446,270,22716,46449,61805,4,1,4,0,1,0,75.15 ,48.91 ,25.00 
04,002,00,000,0000,0,4451,47,4498,6957,8929,3,1,3,0,1,0,77.91 ,64.65 ,33.33 
03,004,01,000,0000,0,188287,2032,190319,315470,445551,5,3,4,1,3,0,70.80 ,60.33 ,60.00 
03,005,01,000,0000,0,239807,2162,241969,402651,551340,10,4,10,0,4,0,73.03 ,60.09 ,40.00 
03,006,01,000,0000,0,632372,6949,639321,1068959,1507171,22,11,19,3,9,2,70.92 ,59.81 ,50.00 
03,007,01,000,0000,0,642945,7181,650126,950566,1312298,19,10,16,3,9,1,72.44 ,68.39 ,52.63 
03,008,01,000,0000,0,215726,1677,217403,379609,512471,11,4,11,0,4,0,74.07 ,57.27 ,36.36 
03,009,01,000,0000,0,349862,3451,353313,551467,737057,18,6,14,4,4,2,74.82 ,64.07 ,33.33 
03,010,01,000,0000,0,250266,2520,252786,417378,553546,11,4,10,1,3,1,75.40 ,60.57 ,36.36 
03,011,01,000,0000,0,508166,3874,512040,825961,1102838,16,8,12,4,7,1,74.89 ,61.99 ,50.00 
03,012,01,000,0000,0,545184,4690,549874,910134,1222508,16,9,13,3,7,2,74.45 ,60.42 ,56.25 
03,013,01,000,0000,0,393749,2537,396286,631058,847798,11,6,9,2,5,1,74.43 ,62.80 ,54.55 
03,014,01,000,0000,0,61988,355,62343,121819,162540,3,1,2,1,1,0,74.95 ,51.18 ,33.33 
03,015,01,000,0000,0,95768,822,96590,197038,262047,6,2,6,0,2,0,75.19 ,49.02 ,33.33 
03,016,01,000,0000,0,37833,332,38165,69339,91625,3,1,3,0,1,0,75.68 ,55.04 ,33.33 
03,017,01,000,0000,0,150669,1247,151916,285671,384918,5,3,3,2,2,1,74.22 ,53.18 ,60.00 
03,018,01,000,0000,0,147028,1065,148093,272074,382917,9,3,8,1,3,0,71.05 ,54.43 ,33.33 
03,019,01,000,0000,0,398166,2791,400957,712274,1009990,18,8,13,5,6,2,70.52 ,56.29 ,44.44 
03,020,01,000,0000,0,103207,629,103836,193209,269472,4,2,3,1,1,1,71.70 ,53.74 ,50.00 
03,021,01,000,0000,0,316895,1871,318766,550411,751187,12,6,9,3,4,2,73.27 ,57.91 ,50.00 
04,001,01,000,0000,0,22446,270,22716,46449,61805,4,1,4,0,1,0,75.15 ,48.91 ,25.00 
04,002,01,000,0000,0,4451,47,4498,6957,8929,3,1,3,0,1,0,77.91 ,64.65 ,33.33 
01,000,01,001,0000,0,112522 ,627 ,113149 ,185644 ,0,3,1,3,0,1,0,77.75,60.95 ,33.33
01,000,01,002,0000,0,131957 ,751 ,132708 ,218248 ,0,3,1,3,0,1,0,77.75,60.81 ,33.33
01,000,01,003,0000,0,112055 ,601 ,112656 ,185409 ,0,3,1,3,0,1,0,77.75,60.76 ,33.33
01,000,01,004,0000,0,50487 ,339 ,50826 ,83275 ,0,3,1,3,0,1,0,77.75,61.03 ,33.33
01,000,01,005,0000,0,93833 ,479 ,94312 ,152857 ,0,3,1,3,0,1,0,77.75,61.70 ,33.33
01,000,01,006,0000,0,108520 ,544 ,109064 ,178309 ,0,3,1,3,0,1,0,77.75,61.17 ,33.33
01,000,02,007,0000,0,98874 ,595 ,99469 ,166863 ,0,3,1,3,0,1,0,77.75,59.61 ,33.33
01,000,02,008,0000,0,58848 ,428 ,59276 ,98182 ,0,3,1,3,0,1,0,77.75,60.37 ,33.33
01,000,02,009,0000,0,72479 ,395 ,72874 ,117025 ,0,3,1,3,0,1,0,77.75,62.27 ,33.33
01,000,02,010,0000,0,94218 ,613 ,94831 ,154400 ,0,3,1,3,0,1,0,77.75,61.42 ,33.33
01,000,02,011,0000,0,145272 ,675 ,145947 ,235791 ,0,3,1,3,0,1,0,77.75,61.90 ,33.33
01,000,02,012,0000,0,118554 ,619 ,119173 ,189283 ,0,3,1,3,0,1,0,77.75,62.96 ,33.33
02,000,01,001,0000,0,14134 ,77 ,14211 ,23352 ,0,3,1,3,0,1,0,77.75,60.86 ,33.33
02,000,01,002,0000,0,50214 ,318 ,50532 ,83957 ,0,3,1,3,0,1,0,77.75,60.19 ,33.33
02,000,01,003,0000,0,12430 ,102 ,12532 ,22801 ,0,3,1,3,0,1,0,77.75,54.96 ,33.33
02,000,01,004,0000,0,73572 ,399 ,73971 ,128397 ,0,3,1,3,0,1,0,77.75,57.61 ,33.33
02,000,01,005,0000,0,65134 ,413 ,65547 ,113346 ,0,3,1,3,0,1,0,77.75,57.83 ,33.33
02,000,01,006,0000,0,148101 ,877 ,148978 ,263984 ,0,3,1,3,0,1,0,77.75,56.43 ,33.33
02,000,02,007,0000,0,26541 ,157 ,26698 ,46181 ,0,3,1,3,0,1,0,77.75,57.81 ,33.33
02,000,02,008,0000,0,14043 ,81 ,14124 ,24880 ,0,3,1,3,0,1,0,77.75,56.77 ,33.33
02,000,02,009,0000,0,83992 ,487 ,84479 ,147697 ,0,3,1,3,0,1,0,77.75,57.20 ,33.33
02,000,02,010,0000,0,87174 ,678 ,87852 ,148997 ,0,3,1,3,0,1,0,77.75,58.96 ,33.33
02,000,02,011,0000,0,60755 ,366 ,61121 ,108909 ,0,3,1,3,0,1,0,77.75,56.12 ,33.33
03,001,01,001,0000,0,221664 ,1812 ,223476 ,396739 ,0,3,1,3,0,1,0,77.75,56.33 ,33.33
03,001,01,002,0000,0,88129 ,682 ,88811 ,162696 ,0,3,1,3,0,1,0,77.75,54.59 ,33.33
03,001,01,003,0000,0,58022 ,519 ,58541 ,108597 ,0,3,1,3,0,1,0,77.75,53.91 ,33.33
03,001,01,004,0000,0,31767 ,285 ,32052 ,57091 ,0,3,1,3,0,1,0,77.75,56.14 ,33.33
03,001,01,005,0000,0,32016 ,253 ,32269 ,58701 ,0,3,1,3,0,1,0,77.75,54.97 ,33.33
03,001,02,006,0000,0,163385 ,1483 ,164868 ,283062 ,0,3,1,3,0,1,0,77.75,58.24 ,33.33
03,001,02,007,0000,0,66222 ,537 ,66759 ,123571 ,0,3,1,3,0,1,0,77.75,54.02 ,33.33
03,001,02,008,0000,0,148060 ,1125 ,149185 ,268483 ,0,3,1,3,0,1,0,77.75,55.57 ,33.33
03,001,02,009,0000,0,28841 ,222 ,29063 ,51348 ,0,3,1,3,0,1,0,77.75,56.60 ,33.33
03,001,02,010,0000,0,27357 ,226 ,27583 ,47532 ,0,3,1,3,0,1,0,77.75,58.03 ,33.33
03,001,02,011,0000,0,20716 ,181 ,20897 ,36857 ,0,3,1,3,0,1,0,77.75,56.70 ,33.33
03,001,02,012,0000,0,50047 ,428 ,50475 ,92064 ,0,3,1,3,0,1,0,77.75,54.83 ,33.33
03,001,02,013,0000,0,12490 ,115 ,12605 ,22258 ,0,3,1,3,0,1,0,77.75,56.63 ,33.33
03,001,02,014,0000,0,9499 ,67 ,9566 ,17011 ,0,3,1,3,0,1,0,77.75,56.23 ,33.33
03,001,02,015,0000,0,4926 ,50 ,4976 ,8511 ,0,3,1,3,0,1,0,77.75,58.47 ,33.33
03,001,02,016,0000,0,9642 ,77 ,9719 ,16079 ,0,3,1,3,0,1,0,77.75,60.45 ,33.33
03,001,02,017,0000,0,8339 ,83 ,8422 ,14542 ,0,3,1,3,0,1,0,77.75,57.92 ,33.33
03,001,03,018,0000,0,183200 ,1403 ,184603 ,310099 ,0,3,1,3,0,1,0,77.75,59.53 ,33.33
03,001,03,019,0000,0,104754 ,702 ,105456 ,174459 ,0,3,1,3,0,1,0,77.75,60.45 ,33.33
03,001,03,020,0000,0,126732 ,752 ,127484 ,214686 ,0,3,1,3,0,1,0,77.75,59.38 ,33.33
03,001,03,021,0000,0,8354 ,67 ,8421 ,15589 ,0,3,1,3,0,1,0,77.75,54.02 ,33.33
03,001,03,022,0000,0,3475 ,30 ,3505 ,6000 ,0,3,1,3,0,1,0,77.75,58.42 ,33.33
03,001,03,023,0000,0,2970 ,22 ,2992 ,5133 ,0,3,1,3,0,1,0,77.75,58.29 ,33.33
03,001,03,024,0000,0,1253 ,9 ,1262 ,2153 ,0,3,1,3,0,1,0,77.75,58.62 ,33.33
03,001,03,025,0000,0,67747 ,654 ,68401 ,128479 ,0,3,1,3,0,1,0,77.75,53.24 ,33.33
03,001,03,026,0000,0,18964 ,145 ,19109 ,33746 ,0,3,1,3,0,1,0,77.75,56.63 ,33.33
03,001,03,027,0000,0,2979 ,26 ,3005 ,4894 ,0,3,1,3,0,1,0,76.14,61.40 ,33.33
03,001,03,028,0000,0,4709 ,43 ,4752 ,8254 ,0,3,1,3,0,1,0,76.14,57.57 ,33.33
03,001,03,029,0000,0,6245 ,55 ,6300 ,11136 ,0,3,1,3,0,1,0,76.14,56.57 ,33.33
03,002,01,001,0000,0,37409 ,253 ,37662 ,66387 ,0,3,1,3,0,1,0,76.14,56.73 ,33.33
03,002,01,002,0000,0,27368 ,199 ,27567 ,50152 ,0,3,1,3,0,1,0,76.14,54.97 ,33.33
03,002,01,003,0000,0,18131 ,133 ,18264 ,33261 ,0,3,1,3,0,1,0,76.14,54.91 ,33.33
03,002,01,004,0000,0,13845 ,100 ,13945 ,24030 ,0,3,1,3,0,1,0,76.14,58.03 ,33.33
03,002,01,005,0000,0,15966 ,126 ,16092 ,27513 ,0,3,1,3,0,1,0,76.14,58.49 ,33.33
03,002,01,006,0000,0,11021 ,62 ,11083 ,19258 ,0,3,1,3,0,1,0,76.14,57.55 ,33.33
03,002,01,007,0000,0,13435 ,99 ,13534 ,24378 ,0,3,1,3,0,1,0,76.14,55.52 ,33.33
03,002,01,008,0000,0,21265 ,153 ,21418 ,38037 ,0,3,1,3,0,1,0,76.14,56.31 ,33.33
03,002,01,009,0000,0,16087 ,130 ,16217 ,28636 ,0,3,1,3,0,1,0,76.14,56.63 ,33.33
03,002,01,010,0000,0,9312 ,86 ,9398 ,16506 ,0,3,1,3,0,1,0,76.14,56.94 ,33.33
03,002,01,011,0000,0,516 ,5 ,521 ,1008 ,0,3,1,3,0,1,0,76.14,51.69 ,33.33
03,002,01,012,0000,0,306 ,3 ,309 ,691 ,0,3,1,3,0,1,0,76.14,44.72 ,33.33
03,003,01,001,0000,0,139853 ,1048 ,140901 ,250605 ,0,3,1,3,0,1,0,76.14,56.22 ,33.33
03,003,01,002,0000,0,48488 ,498 ,48986 ,84967 ,0,3,1,3,0,1,0,76.14,57.65 ,33.33
03,003,01,003,0000,0,67672 ,758 ,68430 ,117642 ,0,3,1,3,0,1,0,76.14,58.17 ,33.33
03,003,01,004,0000,0,43353 ,437 ,43790 ,77633 ,0,3,1,3,0,1,0,76.14,56.41 ,33.33
03,003,01,005,0000,0,32408 ,322 ,32730 ,53405 ,0,3,1,3,0,1,0,76.14,61.29 ,33.33
03,003,01,006,0000,0,35165 ,354 ,35519 ,57873 ,0,3,1,3,0,1,0,76.14,61.37 ,33.33
03,003,01,007,0000,0,1536 ,13 ,1549 ,2757 ,0,3,1,3,0,1,0,76.14,56.18 ,33.33
03,003,01,008,0000,0,144051 ,1213 ,145264 ,241429 ,0,3,1,3,0,1,0,76.14,60.17 ,33.33
03,003,01,009,0000,0,78952 ,750 ,79702 ,134742 ,0,3,1,3,0,1,0,76.14,59.15 ,33.33
03,003,01,010,0000,0,53900 ,591 ,54491 ,92488 ,0,3,1,3,0,1,0,76.14,58.92 ,33.33
03,003,01,011,0000,0,43803 ,401 ,44204 ,75328 ,0,3,1,3,0,1,0,76.14,58.68 ,33.33
03,003,01,012,0000,0,23239 ,181 ,23420 ,35470 ,0,3,1,3,0,1,0,76.14,66.03 ,33.33
03,003,01,013,0000,0,24423 ,245 ,24668 ,38732 ,0,3,1,3,0,1,0,76.14,63.69 ,33.33
03,004,01,001,0000,0,41410 ,366 ,41776 ,70140 ,0,3,1,3,0,1,0,76.14,59.56 ,33.33
03,004,01,002,0000,0,36270 ,370 ,36640 ,63278 ,0,3,1,3,0,1,0,76.14,57.90 ,33.33
03,004,01,003,0000,0,17018 ,204 ,17222 ,26931 ,0,3,1,3,0,1,0,76.14,63.95 ,33.33
03,004,01,004,0000,0,15004 ,190 ,15194 ,23858 ,0,3,1,3,0,1,0,76.14,63.69 ,33.33
03,004,01,005,0000,0,28525 ,360 ,28885 ,48781 ,0,3,1,3,0,1,0,76.14,59.21 ,33.33
03,004,01,006,0000,0,19069 ,193 ,19262 ,33089 ,0,3,1,3,0,1,0,76.14,58.21 ,33.33
03,004,01,007,0000,0,9248 ,103 ,9351 ,14823 ,0,3,1,3,0,1,0,76.14,63.08 ,33.33
03,004,01,008,0000,0,7070 ,73 ,7143 ,11017 ,0,3,1,3,0,1,0,76.14,64.84 ,33.33
03,004,01,009,0000,0,4883 ,67 ,4950 ,7754 ,0,3,1,3,0,1,0,76.14,63.84 ,33.33
03,004,01,010,0000,0,5786 ,50 ,5836 ,9523 ,0,3,1,3,0,1,0,76.14,61.28 ,33.33
03,004,01,011,0000,0,3311 ,45 ,3356 ,4906 ,0,3,1,3,0,1,0,76.14,68.41 ,33.33
03,004,01,012,0000,0,510 ,10 ,520 ,982 ,0,3,1,3,0,1,0,76.14,52.95 ,33.33
03,004,01,013,0000,0,183 ,1 ,184 ,388 ,0,3,1,3,0,1,0,76.14,47.42 ,33.33
03,005,01,001,0000,0,38447 ,340 ,38787 ,66119 ,0,3,1,3,0,1,0,76.14,58.66 ,33.33
03,005,01,002,0000,0,21398 ,197 ,21595 ,35470 ,0,3,1,3,0,1,0,76.14,60.88 ,33.33
03,005,01,003,0000,0,18511 ,158 ,18669 ,30002 ,0,3,1,3,0,1,0,76.14,62.23 ,33.33
03,005,01,004,0000,0,29370 ,256 ,29626 ,50747 ,0,3,1,3,0,1,0,76.14,58.38 ,33.33
03,005,01,005,0000,0,37364 ,321 ,37685 ,64496 ,0,3,1,3,0,1,0,76.14,58.43 ,33.33
03,005,01,006,0000,0,18767 ,139 ,18906 ,30782 ,0,3,1,3,0,1,0,76.14,61.42 ,33.33
03,005,01,007,0000,0,9072 ,99 ,9171 ,14429 ,0,3,1,3,0,1,0,76.14,63.56 ,33.33
03,005,01,008,0000,0,7591 ,68 ,7659 ,12603 ,0,3,1,3,0,1,0,76.14,60.77 ,33.33
03,005,01,009,0000,0,14645 ,144 ,14789 ,25009 ,0,3,1,3,0,1,0,76.14,59.13 ,33.33
03,005,01,010,0000,0,9077 ,74 ,9151 ,15072 ,0,3,1,3,0,1,0,76.14,60.72 ,33.33
03,005,01,011,0000,0,4387 ,42 ,4429 ,7531 ,0,3,1,3,0,1,0,76.14,58.81 ,33.33
03,005,01,012,0000,0,5844 ,59 ,5903 ,9208 ,0,3,1,3,0,1,0,76.14,64.11 ,33.33
03,005,01,013,0000,0,8053 ,85 ,8138 ,12920 ,0,3,1,3,0,1,0,76.14,62.99 ,33.33
03,005,01,014,0000,0,3899 ,42 ,3941 ,6492 ,0,3,1,3,0,1,0,76.14,60.71 ,33.33
03,005,01,015,0000,0,6347 ,55 ,6402 ,10437 ,0,3,1,3,0,1,0,76.14,61.34 ,33.33
03,005,01,016,0000,0,3609 ,47 ,3656 ,5737 ,0,3,1,3,0,1,0,76.14,63.73 ,33.33
03,005,01,017,0000,0,2533 ,29 ,2562 ,4160 ,0,3,1,3,0,1,0,76.14,61.59 ,33.33
03,005,01,018,0000,0,893 ,7 ,900 ,1437 ,0,3,1,3,0,1,0,76.14,62.63 ,33.33
03,006,01,001,0000,0,65804 ,717 ,66521 ,114878 ,0,3,1,3,0,1,0,76.14,57.91 ,33.33
03,006,01,002,0000,0,70684 ,640 ,71324 ,126058 ,0,3,1,3,0,1,0,76.14,56.58 ,33.33
03,006,01,003,0000,0,69442 ,665 ,70107 ,118524 ,0,3,1,3,0,1,0,76.14,59.15 ,33.33
03,006,01,004,0000,0,24550 ,294 ,24844 ,41726 ,0,3,1,3,0,1,0,76.14,59.54 ,33.33
03,006,01,005,0000,0,33516 ,388 ,33904 ,55282 ,0,3,1,3,0,1,0,76.14,61.33 ,33.33
03,006,01,006,0000,0,37962 ,411 ,38373 ,61357 ,0,3,1,3,0,1,0,76.14,62.54 ,33.33
03,006,01,007,0000,0,31944 ,354 ,32298 ,52343 ,0,3,1,3,0,1,0,76.14,61.70 ,33.33
03,006,01,008,0000,0,20895 ,268 ,21163 ,36377 ,0,3,1,3,0,1,0,76.14,58.18 ,33.33
03,006,01,009,0000,0,25223 ,326 ,25549 ,39602 ,0,3,1,3,0,1,0,76.14,64.51 ,33.33
03,006,01,010,0000,0,27231 ,351 ,27582 ,45237 ,0,3,1,3,0,1,0,76.14,60.97 ,33.33
03,006,01,011,0000,0,36938 ,364 ,37302 ,65086 ,0,3,1,3,0,1,0,76.14,57.31 ,33.33
03,006,01,012,0000,0,32207 ,392 ,32599 ,56578 ,0,3,1,3,0,1,0,76.14,57.62 ,33.33
03,006,01,013,0000,0,12316 ,113 ,12429 ,19709 ,0,3,1,3,0,1,0,76.14,63.06 ,33.33
03,006,01,014,0000,0,7226 ,114 ,7340 ,11731 ,0,3,1,3,0,1,0,76.14,62.57 ,33.33
03,006,01,015,0000,0,13645 ,192 ,13837 ,22557 ,0,3,1,3,0,1,0,76.14,61.34 ,33.33
03,006,01,016,0000,0,9636 ,112 ,9748 ,15514 ,0,3,1,3,0,1,0,76.14,62.83 ,33.33
03,006,01,017,0000,0,28437 ,319 ,28756 ,46446 ,0,3,1,3,0,1,0,76.14,61.91 ,33.33
03,006,01,018,0000,0,24421 ,277 ,24698 ,38974 ,0,3,1,3,0,1,0,76.14,63.37 ,33.33
03,006,01,019,0000,0,28450 ,304 ,28754 ,47905 ,0,3,1,3,0,1,0,76.14,60.02 ,33.33
03,006,01,020,0000,0,28748 ,329 ,29077 ,47065 ,0,3,1,3,0,1,0,76.14,61.78 ,33.33
03,006,01,021,0000,0,3097 ,19 ,3116 ,6010 ,0,3,1,3,0,1,0,76.14,51.85 ,33.33
03,007,01,001,0000,0,109216 ,1084 ,110300 ,165422 ,0,3,1,3,0,1,0,76.14,66.68 ,33.33
03,007,01,002,0000,0,22493 ,233 ,22726 ,33282 ,0,3,1,3,0,1,0,76.14,68.28 ,33.33
03,007,01,003,0000,0,13616 ,202 ,13818 ,19455 ,0,3,1,3,0,1,0,76.14,71.03 ,33.33
03,007,01,004,0000,0,41694 ,425 ,42119 ,59915 ,0,3,1,3,0,1,0,76.14,70.30 ,33.33
03,007,01,005,0000,0,25384 ,355 ,25739 ,34806 ,0,3,1,3,0,1,0,76.14,73.95 ,33.33
03,007,01,006,0000,0,19108 ,242 ,19350 ,27082 ,0,3,1,3,0,1,0,76.14,71.45 ,33.33
03,007,01,007,0000,0,42770 ,472 ,43242 ,62752 ,0,3,1,3,0,1,0,76.14,68.91 ,33.33
03,007,01,008,0000,0,8543 ,114 ,8657 ,12230 ,0,3,1,3,0,1,0,76.14,70.78 ,33.33
03,007,01,009,0000,0,16897 ,211 ,17108 ,24515 ,0,3,1,3,0,1,0,76.14,69.79 ,33.33
03,007,01,010,0000,0,57535 ,640 ,58175 ,89772 ,0,3,1,3,0,1,0,76.14,64.80 ,33.33
03,007,01,011,0000,0,17893 ,174 ,18067 ,26476 ,0,3,1,3,0,1,0,76.14,68.24 ,33.33
03,007,01,012,0000,0,20226 ,226 ,20452 ,29280 ,0,3,1,3,0,1,0,76.14,69.85 ,33.33
03,007,01,013,0000,0,27137 ,254 ,27391 ,39219 ,0,3,1,3,0,1,0,76.14,69.84 ,33.33
03,007,01,014,0000,0,19632 ,240 ,19872 ,25986 ,0,3,1,3,0,1,0,76.14,76.47 ,33.33
03,007,01,015,0000,0,17788 ,199 ,17987 ,25937 ,0,3,1,3,0,1,0,76.14,69.35 ,33.33
03,007,01,016,0000,0,22140 ,239 ,22379 ,34016 ,0,3,1,3,0,1,0,76.14,65.79 ,33.33
03,007,01,017,0000,0,22524 ,253 ,22777 ,32875 ,0,3,1,3,0,1,0,76.14,69.28 ,33.33
03,007,01,018,0000,0,9679 ,100 ,9779 ,13769 ,0,3,1,3,0,1,0,76.14,71.02 ,33.33
03,007,01,019,0000,0,16003 ,179 ,16182 ,24180 ,0,3,1,3,0,1,0,76.14,66.92 ,33.33
03,007,01,020,0000,0,15792 ,203 ,15995 ,24625 ,0,3,1,3,0,1,0,76.14,64.95 ,33.33
03,007,01,021,0000,0,14632 ,165 ,14797 ,21440 ,0,3,1,3,0,1,0,76.14,69.02 ,33.33
03,007,01,022,0000,0,15431 ,193 ,15624 ,23957 ,0,3,1,3,0,1,0,76.14,65.22 ,33.33
03,007,01,023,0000,0,28714 ,372 ,29086 ,41111 ,0,3,1,3,0,1,0,76.14,70.75 ,33.33
03,007,01,024,0000,0,19017 ,202 ,19219 ,29317 ,0,3,1,3,0,1,0,76.14,65.56 ,33.33
03,007,01,025,0000,0,10179 ,112 ,10291 ,16140 ,0,3,1,3,0,1,0,76.14,63.76 ,33.33
03,007,01,026,0000,0,8902 ,92 ,8994 ,13007 ,0,3,1,3,0,1,0,76.14,69.15 ,33.33
03,008,01,001,0000,0,45053 ,322 ,45375 ,74885 ,0,3,1,3,0,1,0,76.14,60.59 ,33.33
03,008,01,002,0000,0,33491 ,250 ,33741 ,62585 ,0,3,1,3,0,1,0,76.14,53.91 ,33.33
03,008,01,003,0000,0,42038 ,323 ,42361 ,71485 ,0,3,1,3,0,1,0,76.14,59.26 ,33.33
03,008,01,004,0000,0,25098 ,175 ,25273 ,44723 ,0,3,1,3,0,1,0,76.14,56.51 ,33.33
03,008,01,005,0000,0,5438 ,38 ,5476 ,9350 ,0,3,1,3,0,1,0,76.14,58.57 ,33.33
03,008,01,006,0000,0,18068 ,173 ,18241 ,31719 ,0,3,1,3,0,1,0,76.14,57.51 ,33.33
03,008,01,007,0000,0,9169 ,53 ,9222 ,15557 ,0,3,1,3,0,1,0,76.14,59.28 ,33.33
03,008,01,008,0000,0,7641 ,71 ,7712 ,13416 ,0,3,1,3,0,1,0,76.14,57.48 ,33.33
03,008,01,009,0000,0,7069 ,65 ,7134 ,13399 ,0,3,1,3,0,1,0,76.14,53.24 ,33.33
03,008,01,010,0000,0,8868 ,101 ,8969 ,17190 ,0,3,1,3,0,1,0,76.14,52.18 ,33.33
03,008,01,011,0000,0,9159 ,66 ,9225 ,16547 ,0,3,1,3,0,1,0,76.14,55.75 ,33.33
03,008,01,012,0000,0,3337 ,32 ,3369 ,6026 ,0,3,1,3,0,1,0,76.14,55.91 ,33.33
03,008,01,013,0000,0,1297 ,8 ,1305 ,2727 ,0,3,1,3,0,1,0,76.14,47.85 ,33.33
03,009,01,001,0000,0,48167 ,502 ,48669 ,73573 ,0,3,1,3,0,1,0,76.14,66.15 ,33.33
03,009,01,002,0000,0,23068 ,189 ,23257 ,35313 ,0,3,1,3,0,1,0,76.14,65.86 ,33.33
03,009,01,003,0000,0,31522 ,332 ,31854 ,50182 ,0,3,1,3,0,1,0,76.14,63.48 ,33.33
03,009,01,004,0000,0,23866 ,232 ,24098 ,36423 ,0,3,1,3,0,1,0,76.14,66.16 ,33.33
03,009,01,005,0000,0,15305 ,163 ,15468 ,23967 ,0,3,1,3,0,1,0,76.14,64.54 ,33.33
03,009,01,006,0000,0,21223 ,209 ,21432 ,33971 ,0,3,1,3,0,1,0,76.14,63.09 ,33.33
03,009,01,007,0000,0,16794 ,208 ,17002 ,26725 ,0,3,1,3,0,1,0,76.14,63.62 ,33.33
03,009,01,008,0000,0,11005 ,117 ,11122 ,17125 ,0,3,1,3,0,1,0,76.14,64.95 ,33.33
03,009,01,009,0000,0,15814 ,147 ,15961 ,23561 ,0,3,1,3,0,1,0,76.14,67.74 ,33.33
03,009,01,010,0000,0,10392 ,100 ,10492 ,15244 ,0,3,1,3,0,1,0,76.14,68.83 ,33.33
03,009,01,011,0000,0,15433 ,111 ,15544 ,24317 ,0,3,1,3,0,1,0,76.14,63.92 ,33.33
03,009,01,012,0000,0,14052 ,172 ,14224 ,22077 ,0,3,1,3,0,1,0,76.14,64.43 ,33.33
03,009,01,013,0000,0,14950 ,146 ,15096 ,24104 ,0,3,1,3,0,1,0,76.14,62.63 ,33.33
03,009,01,014,0000,0,8993 ,77 ,9070 ,14452 ,0,3,1,3,0,1,0,76.14,62.76 ,33.33
03,009,01,015,0000,0,7872 ,62 ,7934 ,11519 ,0,3,1,3,0,1,0,76.14,68.88 ,33.33
03,009,01,016,0000,0,13196 ,123 ,13319 ,21837 ,0,3,1,3,0,1,0,76.14,60.99 ,33.33
03,009,01,017,0000,0,14975 ,159 ,15134 ,24570 ,0,3,1,3,0,1,0,76.14,61.60 ,33.33
03,009,01,018,0000,0,12598 ,131 ,12729 ,22862 ,0,3,1,3,0,1,0,76.14,55.68 ,33.33
03,009,01,019,0000,0,14897 ,120 ,15017 ,25034 ,0,3,1,3,0,1,0,76.14,59.99 ,33.33
03,009,01,020,0000,0,15740 ,151 ,15891 ,24611 ,0,3,1,3,0,1,0,76.14,64.57 ,33.33
03,010,01,001,0000,0,14350 ,148 ,14498 ,24298 ,0,3,1,3,0,1,0,76.14,59.67 ,33.33
03,010,01,002,0000,0,19709 ,204 ,19913 ,32107 ,0,3,1,3,0,1,0,76.14,62.02 ,33.33
03,010,01,003,0000,0,15164 ,185 ,15349 ,25149 ,0,3,1,3,0,1,0,76.14,61.03 ,33.33
03,010,01,004,0000,0,16190 ,133 ,16323 ,26496 ,0,3,1,3,0,1,0,76.14,61.61 ,33.33
03,010,01,005,0000,0,30178 ,305 ,30483 ,52454 ,0,3,1,3,0,1,0,76.14,58.11 ,33.33
03,010,01,006,0000,0,7844 ,67 ,7911 ,13422 ,0,3,1,3,0,1,0,76.14,58.94 ,33.33
03,010,01,007,0000,0,16333 ,137 ,16470 ,26622 ,0,3,1,3,0,1,0,76.14,61.87 ,33.33
03,010,01,008,0000,0,12947 ,127 ,13074 ,22404 ,0,3,1,3,0,1,0,76.14,58.36 ,33.33
03,010,01,009,0000,0,14172 ,153 ,14325 ,23627 ,0,3,1,3,0,1,0,76.14,60.63 ,33.33
03,010,01,010,0000,0,12183 ,146 ,12329 ,17744 ,0,3,1,3,0,1,0,76.14,69.48 ,33.33
03,010,01,011,0000,0,9270 ,81 ,9351 ,14139 ,0,3,1,3,0,1,0,76.14,66.14 ,33.33
03,010,01,012,0000,0,26017 ,273 ,26290 ,41484 ,0,3,1,3,0,1,0,76.14,63.37 ,33.33
03,010,01,013,0000,0,20129 ,200 ,20329 ,35638 ,0,3,1,3,0,1,0,76.14,57.04 ,33.33
03,010,01,014,0000,0,17778 ,190 ,17968 ,30555 ,0,3,1,3,0,1,0,76.14,58.81 ,33.33
03,010,01,015,0000,0,10144 ,106 ,10250 ,17345 ,0,3,1,3,0,1,0,76.14,59.09 ,33.33
03,010,01,016,0000,0,5357 ,47 ,5404 ,9173 ,0,3,1,3,0,1,0,76.14,58.91 ,33.33
03,010,01,017,0000,0,1521 ,9 ,1530 ,2829 ,0,3,1,3,0,1,0,76.14,54.08 ,33.33
03,010,01,018,0000,0,980 ,9 ,989 ,1892 ,0,3,1,3,0,1,0,76.14,52.27 ,33.33
03,011,01,001,0000,0,32935 ,271 ,33206 ,56382 ,0,3,1,3,0,1,0,76.14,58.89 ,33.33
03,011,01,002,0000,0,13623 ,114 ,13737 ,21810 ,0,3,1,3,0,1,0,76.14,62.98 ,33.33
03,011,01,003,0000,0,16344 ,141 ,16485 ,26246 ,0,3,1,3,0,1,0,76.14,62.81 ,33.33
03,011,01,004,0000,0,11596 ,90 ,11686 ,18298 ,0,3,1,3,0,1,0,76.14,63.86 ,33.33
03,011,01,005,0000,0,13646 ,128 ,13774 ,21698 ,0,3,1,3,0,1,0,76.14,63.48 ,33.33
03,011,01,006,0000,0,10731 ,91 ,10822 ,19242 ,0,3,1,3,0,1,0,76.14,56.24 ,33.33
03,011,01,007,0000,0,23726 ,154 ,23880 ,35319 ,0,3,1,3,0,1,0,76.14,67.61 ,33.33
03,011,01,008,0000,0,13779 ,83 ,13862 ,21000 ,0,3,1,3,0,1,0,76.14,66.01 ,33.33
03,011,01,009,0000,0,11479 ,106 ,11585 ,18319 ,0,3,1,3,0,1,0,76.14,63.24 ,33.33
03,011,01,010,0000,0,11564 ,92 ,11656 ,17809 ,0,3,1,3,0,1,0,76.14,65.45 ,33.33
03,011,01,011,0000,0,5937 ,50 ,5987 ,9551 ,0,3,1,3,0,1,0,76.14,62.68 ,33.33
03,011,01,012,0000,0,27093 ,175 ,27268 ,43569 ,0,3,1,3,0,1,0,76.14,62.59 ,33.33
03,011,01,013,0000,0,14330 ,97 ,14427 ,22297 ,0,3,1,3,0,1,0,76.14,64.70 ,33.33
03,011,01,014,0000,0,12862 ,128 ,12990 ,19202 ,0,3,1,3,0,1,0,76.14,67.65 ,33.33
03,011,01,015,0000,0,13153 ,102 ,13255 ,20047 ,0,3,1,3,0,1,0,76.14,66.12 ,33.33
03,011,01,016,0000,0,11790 ,74 ,11864 ,18385 ,0,3,1,3,0,1,0,76.14,64.53 ,33.33
03,011,01,017,0000,0,6872 ,54 ,6926 ,10360 ,0,3,1,3,0,1,0,76.14,66.85 ,33.33
03,011,01,018,0000,0,20737 ,156 ,20893 ,33505 ,0,3,1,3,0,1,0,76.14,62.36 ,33.33
03,011,01,019,0000,0,19417 ,191 ,19608 ,31218 ,0,3,1,3,0,1,0,76.14,62.81 ,33.33
03,011,01,020,0000,0,15527 ,102 ,15629 ,25217 ,0,3,1,3,0,1,0,76.14,61.98 ,33.33
03,011,01,021,0000,0,14603 ,146 ,14749 ,22334 ,0,3,1,3,0,1,0,76.14,66.04 ,33.33
03,011,01,022,0000,0,4110 ,30 ,4140 ,6297 ,0,3,1,3,0,1,0,76.14,65.75 ,33.33
03,011,01,023,0000,0,8092 ,64 ,8156 ,12750 ,0,3,1,3,0,1,0,76.14,63.97 ,33.33
03,011,01,024,0000,0,5535 ,51 ,5586 ,8967 ,0,3,1,3,0,1,0,76.14,62.30 ,33.33
03,011,01,025,0000,0,4852 ,24 ,4876 ,7295 ,0,3,1,3,0,1,0,76.14,66.84 ,33.33
03,011,01,026,0000,0,3155 ,26 ,3181 ,4836 ,0,3,1,3,0,1,0,76.14,65.78 ,33.33
03,011,01,027,0000,0,30850 ,232 ,31082 ,50983 ,0,3,1,3,0,1,0,76.14,60.97 ,33.33
03,011,01,028,0000,0,28353 ,185 ,28538 ,45953 ,0,3,1,3,0,1,0,76.14,62.10 ,33.33
03,011,01,029,0000,0,18948 ,163 ,19111 ,28840 ,0,3,1,3,0,1,0,76.14,66.27 ,33.33
03,011,01,030,0000,0,2555 ,18 ,2573 ,3761 ,0,3,1,3,0,1,0,76.14,68.41 ,33.33
03,011,01,031,0000,0,79972 ,536 ,80508 ,144471 ,0,3,1,3,0,1,0,76.14,55.73 ,33.33
03,012,01,001,0000,0,137424 ,980 ,138404 ,243247 ,0,3,1,3,0,1,0,76.14,56.90 ,33.33
03,012,01,002,0000,0,30646 ,298 ,30944 ,50706 ,0,3,1,3,0,1,0,76.14,61.03 ,33.33
03,012,01,003,0000,0,48515 ,447 ,48962 ,81788 ,0,3,1,3,0,1,0,76.14,59.86 ,33.33
03,012,01,004,0000,0,21467 ,160 ,21627 ,33680 ,0,3,1,3,0,1,0,76.14,64.21 ,33.33
03,012,01,005,0000,0,14881 ,133 ,15014 ,24177 ,0,3,1,3,0,1,0,76.14,62.10 ,33.33
03,012,01,006,0000,0,25367 ,234 ,25601 ,43528 ,0,3,1,3,0,1,0,76.14,58.82 ,33.33
03,012,01,007,0000,0,18349 ,148 ,18497 ,30834 ,0,3,1,3,0,1,0,76.14,59.99 ,33.33
03,012,01,008,0000,0,42315 ,342 ,42657 ,68767 ,0,3,1,3,0,1,0,76.14,62.03 ,33.33
03,012,01,009,0000,0,18146 ,163 ,18309 ,28283 ,0,3,1,3,0,1,0,76.14,64.73 ,33.33
03,012,01,010,0000,0,15182 ,152 ,15334 ,23988 ,0,3,1,3,0,1,0,76.14,63.92 ,33.33
03,012,01,011,0000,0,5085 ,43 ,5128 ,7556 ,0,3,1,3,0,1,0,76.14,67.87 ,33.33
03,012,01,012,0000,0,13321 ,141 ,13462 ,22371 ,0,3,1,3,0,1,0,76.14,60.18 ,33.33
03,012,01,013,0000,0,24921 ,310 ,25231 ,39481 ,0,3,1,3,0,1,0,76.14,63.91 ,33.33
03,012,01,014,0000,0,13207 ,125 ,13332 ,21651 ,0,3,1,3,0,1,0,76.14,61.58 ,33.33
03,012,01,015,0000,0,14260 ,123 ,14383 ,24507 ,0,3,1,3,0,1,0,76.14,58.69 ,33.33
03,012,01,016,0000,0,6545 ,72 ,6617 ,10669 ,0,3,1,3,0,1,0,76.14,62.02 ,33.33
03,012,01,017,0000,0,11025 ,98 ,11123 ,15833 ,0,3,1,3,0,1,0,76.14,70.25 ,33.33
03,012,01,018,0000,0,17557 ,135 ,17692 ,28758 ,0,3,1,3,0,1,0,76.14,61.52 ,33.33
03,012,01,019,0000,0,20290 ,171 ,20461 ,32431 ,0,3,1,3,0,1,0,76.14,63.09 ,33.33
03,012,01,020,0000,0,21272 ,161 ,21433 ,34883 ,0,3,1,3,0,1,0,76.14,61.44 ,33.33
03,012,01,021,0000,0,6830 ,86 ,6916 ,12385 ,0,3,1,3,0,1,0,76.14,55.84 ,33.33
03,012,01,022,0000,0,4094 ,29 ,4123 ,6627 ,0,3,1,3,0,1,0,76.14,62.22 ,33.33
03,012,01,023,0000,0,5560 ,56 ,5616 ,9716 ,0,3,1,3,0,1,0,76.14,57.80 ,33.33
03,012,01,024,0000,0,8593 ,79 ,8672 ,13476 ,0,3,1,3,0,1,0,76.14,64.35 ,33.33
03,012,01,025,0000,0,43 ,0 ,43 ,106 ,0,3,1,3,0,1,0,76.14,40.57 ,33.33
03,012,01,026,0000,0,159 ,2 ,161 ,356 ,0,3,1,3,0,1,0,76.14,45.22 ,33.33
03,012,01,027,0000,0,130 ,2 ,132 ,330 ,0,3,1,3,0,1,0,76.14,40.00 ,33.33
03,013,01,001,0000,0,96026 ,527 ,96553 ,156587 ,0,3,1,3,0,1,0,76.14,61.66 ,33.33
03,013,01,002,0000,0,24767 ,146 ,24913 ,41241 ,0,3,1,3,0,1,0,76.14,60.41 ,33.33
03,013,01,003,0000,0,20943 ,115 ,21058 ,35741 ,0,3,1,3,0,1,0,76.14,58.92 ,33.33
03,013,01,004,0000,0,12734 ,118 ,12852 ,22807 ,0,3,1,3,0,1,0,76.14,56.35 ,33.33
03,013,01,005,0000,0,27883 ,185 ,28068 ,39585 ,0,3,1,3,0,1,0,76.14,70.91 ,33.33
03,013,01,006,0000,0,14874 ,89 ,14963 ,23033 ,0,3,1,3,0,1,0,76.14,64.96 ,33.33
03,013,01,007,0000,0,6177 ,35 ,6212 ,9130 ,0,3,1,3,0,1,0,76.14,68.04 ,33.33
03,013,01,008,0000,0,11958 ,66 ,12024 ,17286 ,0,3,1,3,0,1,0,76.14,69.56 ,33.33
03,013,01,009,0000,0,13439 ,101 ,13540 ,19904 ,0,3,1,3,0,1,0,76.14,68.03 ,33.33
03,013,01,010,0000,0,13173 ,107 ,13280 ,20873 ,0,3,1,3,0,1,0,76.14,63.62 ,33.33
03,013,01,011,0000,0,13994 ,88 ,14082 ,22283 ,0,3,1,3,0,1,0,76.14,63.20 ,33.33
03,013,01,012,0000,0,11362 ,96 ,11458 ,17439 ,0,3,1,3,0,1,0,76.14,65.70 ,33.33
03,013,01,013,0000,0,27430 ,190 ,27620 ,44703 ,0,3,1,3,0,1,0,76.14,61.79 ,33.33
03,013,01,014,0000,0,10134 ,58 ,10192 ,14579 ,0,3,1,3,0,1,0,76.14,69.91 ,33.33
03,013,01,015,0000,0,5552 ,32 ,5584 ,8958 ,0,3,1,3,0,1,0,76.14,62.34 ,33.33
03,013,01,016,0000,0,12855 ,79 ,12934 ,21643 ,0,3,1,3,0,1,0,76.14,59.76 ,33.33
03,013,01,017,0000,0,19393 ,101 ,19494 ,29916 ,0,3,1,3,0,1,0,76.14,65.16 ,33.33
03,013,01,018,0000,0,7051 ,50 ,7101 ,11098 ,0,3,1,3,0,1,0,76.14,63.98 ,33.33
03,013,01,019,0000,0,10087 ,63 ,10150 ,16838 ,0,3,1,3,0,1,0,76.14,60.28 ,33.33
03,013,01,020,0000,0,6278 ,48 ,6326 ,9815 ,0,3,1,3,0,1,0,76.14,64.45 ,33.33
03,013,01,021,0000,0,11399 ,62 ,11461 ,17484 ,0,3,1,3,0,1,0,76.14,65.55 ,33.33
03,013,01,022,0000,0,4823 ,31 ,4854 ,10004 ,0,3,1,3,0,1,0,76.14,48.52 ,33.33
03,013,01,023,0000,0,4900 ,52 ,4952 ,7978 ,0,3,1,3,0,1,0,76.14,62.07 ,33.33
03,013,01,024,0000,0,2690 ,71 ,2761 ,5217 ,0,3,1,3,0,1,0,76.14,52.92 ,33.33
03,013,01,025,0000,0,2817 ,14 ,2831 ,4798 ,0,3,1,3,0,1,0,76.14,59.00 ,33.33
03,013,01,026,0000,0,176 ,6 ,182 ,383 ,0,3,1,3,0,1,0,76.14,47.52 ,33.33
03,013,01,027,0000,0,23 ,1 ,24 ,60 ,0,3,1,3,0,1,0,76.14,40.00 ,33.33
03,013,01,028,0000,0,164 ,2 ,166 ,312 ,0,3,1,3,0,1,0,76.14,53.21 ,33.33
03,013,01,029,0000,0,67 ,0 ,67 ,153 ,0,3,1,3,0,1,0,76.14,43.79 ,33.33
03,013,01,030,0000,0,130 ,2 ,132 ,266 ,0,3,1,3,0,1,0,76.14,49.62 ,33.33
03,013,01,031,0000,0,151 ,1 ,152 ,320 ,0,3,1,3,0,1,0,76.14,47.50 ,33.33
03,013,01,032,0000,0,119 ,0 ,119 ,289 ,0,3,1,3,0,1,0,76.14,41.18 ,33.33
03,013,01,033,0000,0,180 ,1 ,181 ,335 ,0,3,1,3,0,1,0,76.14,54.03 ,33.33
03,014,01,001,0000,0,35256 ,187 ,35443 ,67084 ,0,3,1,3,0,1,0,76.14,52.83 ,33.33
03,014,01,002,0000,0,3087 ,10 ,3097 ,6313 ,0,3,1,3,0,1,0,76.14,49.06 ,33.33
03,014,01,003,0000,0,3315 ,29 ,3344 ,6082 ,0,3,1,3,0,1,0,76.14,54.98 ,33.33
03,014,01,004,0000,0,5591 ,40 ,5631 ,10929 ,0,3,1,3,0,1,0,76.14,51.52 ,33.33
03,014,01,005,0000,0,2704 ,16 ,2720 ,5473 ,0,3,1,3,0,1,0,76.14,49.70 ,33.33
03,014,01,006,0000,0,3001 ,16 ,3017 ,6125 ,0,3,1,3,0,1,0,76.14,49.26 ,33.33
03,014,01,007,0000,0,1889 ,13 ,1902 ,3963 ,0,3,1,3,0,1,0,76.14,47.99 ,33.33
03,014,01,008,0000,0,1343 ,9 ,1352 ,3126 ,0,3,1,3,0,1,0,76.14,43.25 ,33.33
03,014,01,009,0000,0,3120 ,14 ,3134 ,6060 ,0,3,1,3,0,1,0,76.14,51.72 ,33.33
03,014,01,010,0000,0,1168 ,11 ,1179 ,3054 ,0,3,1,3,0,1,0,76.14,38.61 ,33.33
03,014,01,011,0000,0,928 ,4 ,932 ,2265 ,0,3,1,3,0,1,0,76.14,41.15 ,33.33
03,014,01,012,0000,0,153 ,3 ,156 ,306 ,0,3,1,3,0,1,0,76.14,50.98 ,33.33
03,014,01,013,0000,0,136 ,1 ,137 ,278 ,0,3,1,3,0,1,0,76.14,49.28 ,33.33
03,014,01,014,0000,0,68 ,1 ,69 ,140 ,0,3,1,3,0,1,0,76.14,49.29 ,33.33
03,014,01,015,0000,0,138 ,1 ,139 ,337 ,0,3,1,3,0,1,0,76.14,41.25 ,33.33
03,014,01,016,0000,0,91 ,0 ,91 ,284 ,0,3,1,3,0,1,0,76.14,32.04 ,33.33
03,015,01,001,0000,0,35699 ,288 ,35987 ,72373 ,0,3,1,3,0,1,0,76.14,49.72 ,33.33
03,015,01,002,0000,0,6094 ,57 ,6151 ,12378 ,0,3,1,3,0,1,0,76.14,49.69 ,33.33
03,015,01,003,0000,0,766 ,7 ,773 ,1720 ,0,3,1,3,0,1,0,76.14,44.94 ,33.33
03,015,01,004,0000,0,23898 ,191 ,24089 ,49979 ,0,3,1,3,0,1,0,76.14,48.20 ,33.33
03,015,01,005,0000,0,5646 ,41 ,5687 ,11316 ,0,3,1,3,0,1,0,76.14,50.26 ,33.33
03,015,01,006,0000,0,4795 ,38 ,4833 ,8936 ,0,3,1,3,0,1,0,76.14,54.08 ,33.33
03,015,01,007,0000,0,3192 ,32 ,3224 ,6238 ,0,3,1,3,0,1,0,76.14,51.68 ,33.33
03,015,01,008,0000,0,423 ,6 ,429 ,970 ,0,3,1,3,0,1,0,76.14,44.23 ,33.33
03,015,01,009,0000,0,132 ,2 ,134 ,303 ,0,3,1,3,0,1,0,76.14,44.22 ,33.33
03,015,01,010,0000,0,3423 ,22 ,3445 ,6988 ,0,3,1,3,0,1,0,76.14,49.30 ,33.33
03,015,01,011,0000,0,7654 ,105 ,7759 ,16780 ,0,3,1,3,0,1,0,76.14,46.24 ,33.33
03,015,01,012,0000,0,3893 ,33 ,3926 ,8741 ,0,3,1,3,0,1,0,76.14,44.91 ,33.33
03,015,01,013,0000,0,153 ,0 ,153 ,316 ,0,3,1,3,0,1,0,76.14,48.42 ,33.33
03,016,01,001,0000,0,22710 ,172 ,22882 ,39610 ,0,3,1,3,0,1,0,76.14,57.77 ,33.33
03,016,01,002,0000,0,6028 ,47 ,6075 ,10114 ,0,3,1,3,0,1,0,76.14,60.07 ,33.33
03,016,01,003,0000,0,3642 ,70 ,3712 ,7248 ,0,3,1,3,0,1,0,76.14,51.21 ,33.33
03,016,01,004,0000,0,3377 ,25 ,3402 ,6594 ,0,3,1,3,0,1,0,76.14,51.59 ,33.33
03,016,01,005,0000,0,1121 ,10 ,1131 ,3369 ,0,3,1,3,0,1,0,76.14,33.57 ,33.33
03,016,01,006,0000,0,955 ,8 ,963 ,2404 ,0,3,1,3,0,1,0,76.14,40.06 ,33.33
03,017,01,001,0000,0,22415 ,202 ,22617 ,41972 ,0,3,1,3,0,1,0,76.14,53.89 ,33.33
03,017,01,002,0000,0,20524 ,159 ,20683 ,38036 ,0,3,1,3,0,1,0,76.14,54.38 ,33.33
03,017,01,003,0000,0,20786 ,167 ,20953 ,37328 ,0,3,1,3,0,1,0,76.14,56.13 ,33.33
03,017,01,004,0000,0,21262 ,205 ,21467 ,40233 ,0,3,1,3,0,1,0,76.14,53.36 ,33.33
03,017,01,005,0000,0,31388 ,224 ,31612 ,61041 ,0,3,1,3,0,1,0,76.14,51.79 ,33.33
03,017,01,006,0000,0,14056 ,117 ,14173 ,27411 ,0,3,1,3,0,1,0,76.14,51.71 ,33.33
03,017,01,007,0000,0,20238 ,173 ,20411 ,39650 ,0,3,1,3,0,1,0,76.14,51.48 ,33.33
03,018,01,001,0000,0,69943 ,468 ,70411 ,126916 ,0,3,1,3,0,1,0,76.14,55.48 ,33.33
03,018,01,002,0000,0,52396 ,393 ,52789 ,97311 ,0,3,1,3,0,1,0,76.14,54.25 ,33.33
03,018,01,003,0000,0,24689 ,204 ,24893 ,47847 ,0,3,1,3,0,1,0,76.14,52.03 ,33.33
03,019,01,001,0000,0,8999 ,67 ,9066 ,15908 ,0,3,1,3,0,1,0,76.14,56.99 ,33.33
03,019,01,002,0000,0,30565 ,222 ,30787 ,52084 ,0,3,1,3,0,1,0,76.14,59.11 ,33.33
03,019,01,003,0000,0,46455 ,335 ,46790 ,81943 ,0,3,1,3,0,1,0,76.14,57.10 ,33.33
03,019,01,004,0000,0,41425 ,309 ,41734 ,75103 ,0,3,1,3,0,1,0,76.14,55.57 ,33.33
03,019,01,005,0000,0,59116 ,366 ,59482 ,107103 ,0,3,1,3,0,1,0,76.14,55.54 ,33.33
03,019,01,006,0000,0,70564 ,464 ,71028 ,127386 ,0,3,1,3,0,1,0,76.14,55.76 ,33.33
03,019,01,007,0000,0,51214 ,393 ,51607 ,92451 ,0,3,1,3,0,1,0,76.14,55.82 ,33.33
03,019,01,008,0000,0,89828 ,635 ,90463 ,160296 ,0,3,1,3,0,1,0,76.14,56.43 ,33.33
03,020,01,001,0000,0,50731 ,272 ,51003 ,94367 ,0,3,1,3,0,1,0,76.14,54.05 ,33.33
03,020,01,002,0000,0,52476 ,357 ,52833 ,98842 ,0,3,1,3,0,1,0,76.14,53.45 ,33.33
03,021,01,001,0000,0,75839 ,422 ,76261 ,134193 ,0,3,1,3,0,1,0,76.14,56.83 ,33.33
03,021,01,002,0000,0,57845 ,359 ,58204 ,99829 ,0,3,1,3,0,1,0,76.14,58.30 ,33.33
03,021,01,003,0000,0,37554 ,218 ,37772 ,64031 ,0,3,1,3,0,1,0,76.14,58.99 ,33.33
03,021,01,004,0000,0,53309 ,340 ,53649 ,93354 ,0,3,1,3,0,1,0,76.14,57.47 ,33.33
03,021,01,005,0000,0,71821 ,427 ,72248 ,120244 ,0,3,1,3,0,1,0,76.14,60.08 ,33.33
03,021,01,006,0000,0,20527 ,105 ,20632 ,38760 ,0,3,1,3,0,1,0,76.14,53.23 ,33.33
04,001,01,001,0000,0,7221 ,88 ,7309 ,15396 ,0,3,1,3,0,1,0,76.14,47.47 ,33.33
04,001,01,002,0000,0,4044 ,65 ,4109 ,8361 ,0,3,1,3,0,1,0,76.14,49.14 ,33.33
04,001,01,003,0000,0,5120 ,72 ,5192 ,10146 ,0,3,1,3,0,1,0,76.14,51.17 ,33.33
04,001,01,004,0000,0,3761 ,34 ,3795 ,7812 ,0,3,1,3,0,1,0,76.14,48.58 ,33.33
04,001,01,005,0000,0,2254 ,11 ,2265 ,4472 ,0,3,1,3,0,1,0,76.14,50.65 ,33.33
04,001,01,006,0000,0,46 ,0 ,46 ,262 ,0,3,1,3,0,1,0,76.14,17.56 ,33.33
04,002,01,001,0000,0,2690 ,27 ,2717 ,4078 ,0,3,1,3,0,1,0,76.14,66.63 ,33.33
04,002,01,002,0000,0,874 ,16 ,890 ,1371 ,0,3,1,3,0,1,0,76.14,64.92 ,33.33
04,002,01,003,0000,0,490 ,0 ,490 ,865 ,0,3,1,3,0,1,0,76.14,56.65 ,33.33
04,002,01,004,0000,0,397 ,4 ,401 ,643 ,0,3,1,3,0,1,0,76.14,62.36 ,33.33
01,000,01,001,0001,0,2362 ,12 ,2374 ,3797 ,0,3,1,3,0,1,0,76.14,62.52 ,33.33
01,000,01,001,0002,0,2185 ,12 ,2197 ,3577 ,0,3,1,3,0,1,0,76.14,61.42 ,33.33
01,000,01,001,0003,0,2544 ,22 ,2566 ,4232 ,0,3,1,3,0,1,0,76.14,60.63 ,33.33
01,000,01,001,0004,0,3386 ,24 ,3410 ,5309 ,0,3,1,3,0,1,0,76.14,64.23 ,33.33
01,000,01,001,0005,0,3375 ,10 ,3385 ,5627 ,0,3,1,3,0,1,0,76.14,60.16 ,33.33
01,000,01,001,0006,0,3776 ,11 ,3787 ,6048 ,0,3,1,3,0,1,0,76.14,62.62 ,33.33
01,000,01,001,0007,0,3416 ,18 ,3434 ,5415 ,0,3,1,3,0,1,0,76.14,63.42 ,33.33
01,000,01,001,0008,0,4117 ,25 ,4142 ,6393 ,0,3,1,3,0,1,0,76.14,64.79 ,33.33
01,000,01,001,0009,0,3965 ,18 ,3983 ,6604 ,0,3,1,3,0,1,0,76.14,60.31 ,33.33
01,000,01,001,0010,0,3215 ,9 ,3224 ,5233 ,0,3,1,3,0,1,0,76.14,61.61 ,33.33
01,000,01,001,0011,0,2278 ,10 ,2288 ,3548 ,0,3,1,3,0,1,0,76.14,64.49 ,33.33
01,000,01,001,0012,0,2418 ,18 ,2436 ,3632 ,0,3,1,3,0,1,0,76.14,67.07 ,33.33
01,000,01,001,0013,0,3170 ,25 ,3195 ,5152 ,0,3,1,3,0,1,0,76.14,62.01 ,33.33
01,000,01,001,0014,0,2512 ,15 ,2527 ,4059 ,0,3,1,3,0,1,0,76.14,62.26 ,33.33
01,000,01,001,0015,0,2323 ,11 ,2334 ,3827 ,0,3,1,3,0,1,0,76.14,60.99 ,33.33
01,000,01,001,0016,0,2453 ,22 ,2475 ,4121 ,0,3,1,3,0,1,0,76.14,60.06 ,33.33
01,000,01,001,0017,0,4280 ,22 ,4302 ,6788 ,0,3,1,3,0,1,0,76.14,63.38 ,33.33
01,000,01,001,0018,0,2301 ,9 ,2310 ,3886 ,0,3,1,3,0,1,0,76.14,59.44 ,33.33
01,000,01,001,0019,0,899 ,2 ,901 ,1487 ,0,3,1,3,0,1,0,76.14,60.59 ,33.33
01,000,01,001,0020,0,4641 ,28 ,4669 ,7650 ,0,3,1,3,0,1,0,76.14,61.03 ,33.33
01,000,01,001,0021,0,4299 ,27 ,4326 ,7634 ,0,3,1,3,0,1,0,76.14,56.67 ,33.33
01,000,01,001,0022,0,3490 ,16 ,3506 ,6002 ,0,3,1,3,0,1,0,76.14,58.41 ,33.33
01,000,01,001,0023,0,2695 ,10 ,2705 ,4545 ,0,3,1,3,0,1,0,76.14,59.52 ,33.33
01,000,01,001,0024,0,2875 ,9 ,2884 ,4769 ,0,3,1,3,0,1,0,76.14,60.47 ,33.33
01,000,01,001,0025,0,3052 ,13 ,3065 ,5091 ,0,3,1,3,0,1,0,76.14,60.20 ,33.33
01,000,01,001,0026,0,1563 ,12 ,1575 ,2729 ,0,3,1,3,0,1,0,76.14,57.71 ,33.33
01,000,01,001,0027,0,2605 ,12 ,2617 ,4855 ,0,3,1,3,0,1,0,76.14,53.90 ,33.33
01,000,01,001,0028,0,2087 ,20 ,2107 ,3385 ,0,3,1,3,0,1,0,76.14,62.25 ,33.33
01,000,01,001,0029,0,3109 ,18 ,3127 ,5151 ,0,3,1,3,0,1,0,76.14,60.71 ,33.33
01,000,01,001,0030,0,2503 ,9 ,2512 ,4058 ,0,3,1,3,0,1,0,76.14,61.90 ,33.33
01,000,01,001,0031,0,3021 ,18 ,3039 ,4768 ,0,3,1,3,0,1,0,76.14,63.74 ,33.33
01,000,01,001,0032,0,1758 ,10 ,1768 ,2849 ,0,3,1,3,0,1,0,76.14,62.06 ,33.33
01,000,01,001,0033,0,2240 ,8 ,2248 ,3333 ,0,3,1,3,0,1,0,76.14,67.45 ,33.33
01,000,01,001,0034,0,2007 ,12 ,2019 ,3309 ,0,3,1,3,0,1,0,76.14,61.02 ,33.33
01,000,01,001,0035,0,2250 ,13 ,2263 ,3931 ,0,3,1,3,0,1,0,76.14,57.57 ,33.33
01,000,01,001,0036,0,2483 ,12 ,2495 ,4192 ,0,3,1,3,0,1,0,76.14,59.52 ,33.33
01,000,01,001,0037,0,2829 ,23 ,2852 ,5054 ,0,3,1,3,0,1,0,76.14,56.43 ,33.33
01,000,01,001,0038,0,4876 ,38 ,4914 ,8248 ,0,3,1,3,0,1,0,76.14,59.58 ,33.33
01,000,01,001,0039,0,1121 ,8 ,1129 ,1954 ,0,3,1,3,0,1,0,76.14,57.78 ,33.33
01,000,01,001,0040,0,1028 ,7 ,1035 ,1678 ,0,3,1,3,0,1,0,76.14,61.68 ,33.33
01,000,01,001,0041,0,564 ,5 ,569 ,985 ,0,3,1,3,0,1,0,76.14,57.77 ,33.33
01,000,01,001,0042,0,451 ,4 ,455 ,739 ,0,3,1,3,0,1,0,76.14,61.57 ,33.33
01,000,01,002,0043,0,2147 ,9 ,2156 ,3475 ,0,3,1,3,0,1,0,76.14,62.04 ,33.33
01,000,01,002,0044,0,1570 ,9 ,1579 ,2672 ,0,3,1,3,0,1,0,76.14,59.09 ,33.33
01,000,01,002,0045,0,2095 ,12 ,2107 ,3297 ,0,3,1,3,0,1,0,76.14,63.91 ,33.33
01,000,01,002,0046,0,2208 ,14 ,2222 ,4423 ,0,3,1,3,0,1,0,76.14,50.24 ,33.33
01,000,01,002,0047,0,3693 ,23 ,3716 ,5789 ,0,3,1,3,0,1,0,76.14,64.19 ,33.33
01,000,01,002,0048,0,3235 ,44 ,3279 ,5218 ,0,3,1,3,0,1,0,76.14,62.84 ,33.33
01,000,01,002,0049,0,3762 ,15 ,3777 ,6071 ,0,3,1,3,0,1,0,76.14,62.21 ,33.33
01,000,01,002,0050,0,3711 ,18 ,3729 ,6347 ,0,3,1,3,0,1,0,76.14,58.75 ,33.33
01,000,01,002,0051,0,2674 ,10 ,2684 ,4398 ,0,3,1,3,0,1,0,76.14,61.03 ,33.33
01,000,01,002,0052,0,2080 ,11 ,2091 ,3473 ,0,3,1,3,0,1,0,76.14,60.21 ,33.33
01,000,01,002,0053,0,3472 ,20 ,3492 ,5752 ,0,3,1,3,0,1,0,76.14,60.71 ,33.33
01,000,01,002,0054,0,2627 ,17 ,2644 ,4479 ,0,3,1,3,0,1,0,76.14,59.03 ,33.33
01,000,01,002,0055,0,3176 ,18 ,3194 ,5519 ,0,3,1,3,0,1,0,76.14,57.87 ,33.33
01,000,01,002,0056,0,2297 ,12 ,2309 ,4016 ,0,3,1,3,0,1,0,76.14,57.50 ,33.33
01,000,01,002,0057,0,2439 ,23 ,2462 ,4318 ,0,3,1,3,0,1,0,76.14,57.02 ,33.33
01,000,01,002,0058,0,2787 ,18 ,2805 ,4830 ,0,3,1,3,0,1,0,76.14,58.07 ,33.33
01,000,01,002,0059,0,3644 ,17 ,3661 ,5881 ,0,3,1,3,0,1,0,76.14,62.25 ,33.33
01,000,01,002,0060,0,1838 ,10 ,1848 ,3118 ,0,3,1,3,0,1,0,76.14,59.27 ,33.33
01,000,01,002,0061,0,2850 ,24 ,2874 ,5049 ,0,3,1,3,0,1,0,76.14,56.92 ,33.33
01,000,01,002,0062,0,3856 ,22 ,3878 ,6687 ,0,3,1,3,0,1,0,76.14,57.99 ,33.33
01,000,01,002,0063,0,3438 ,15 ,3453 ,5681 ,0,3,1,3,0,1,0,76.14,60.78 ,33.33
01,000,01,002,0064,0,3513 ,13 ,3526 ,5791 ,0,3,1,3,0,1,0,76.14,60.89 ,33.33
01,000,01,002,0065,0,2378 ,17 ,2395 ,3904 ,0,3,1,3,0,1,0,76.14,61.35 ,33.33
01,000,01,002,0066,0,2785 ,17 ,2802 ,4463 ,0,3,1,3,0,1,0,76.14,62.78 ,33.33
01,000,01,002,0067,0,1822 ,11 ,1833 ,3116 ,0,3,1,3,0,1,0,76.14,58.83 ,33.33
01,000,01,002,0068,0,3624 ,13 ,3637 ,5753 ,0,3,1,3,0,1,0,76.14,63.22 ,33.33
01,000,01,002,0069,0,2003 ,11 ,2014 ,3308 ,0,3,1,3,0,1,0,76.14,60.88 ,33.33
01,000,01,002,0070,0,2796 ,13 ,2809 ,4618 ,0,3,1,3,0,1,0,76.14,60.83 ,33.33
01,000,01,002,0071,0,2648 ,15 ,2663 ,4208 ,0,3,1,3,0,1,0,76.14,63.28 ,33.33
01,000,01,002,0072,0,2980 ,9 ,2989 ,4631 ,0,3,1,3,0,1,0,76.14,64.54 ,33.33
01,000,01,002,0073,0,3478 ,22 ,3500 ,5767 ,0,3,1,3,0,1,0,76.14,60.69 ,33.33
01,000,01,002,0074,0,2666 ,15 ,2681 ,4116 ,0,3,1,3,0,1,0,76.14,65.14 ,33.33
01,000,01,002,0075,0,2825 ,11 ,2836 ,4526 ,0,3,1,3,0,1,0,76.14,62.66 ,33.33
01,000,01,002,0076,0,4036 ,20 ,4056 ,6788 ,0,3,1,3,0,1,0,76.14,59.75 ,33.33
01,000,01,002,0077,0,3131 ,16 ,3147 ,4988 ,0,3,1,3,0,1,0,76.14,63.09 ,33.33
01,000,01,002,0078,0,3093 ,21 ,3114 ,4990 ,0,3,1,3,0,1,0,76.14,62.40 ,33.33
01,000,01,002,0079,0,2579 ,14 ,2593 ,4130 ,0,3,1,3,0,1,0,76.14,62.78 ,33.33
01,000,01,002,0080,0,2337 ,13 ,2350 ,3810 ,0,3,1,3,0,1,0,76.14,61.6797900262,33.33
01,000,01,002,0081,0,3637 ,25 ,3662 ,5946 ,0,3,1,3,0,1,0,76.14,61.5876219307,33.33
01,000,01,002,0082,0,3306 ,22 ,3328 ,5511 ,0,3,1,3,0,1,0,76.14,60.3883142805,33.33
01,000,01,002,0083,0,4028 ,12 ,4040 ,6673 ,0,3,1,3,0,1,0,76.14,60.5424846396,33.33
01,000,01,002,0084,0,3221 ,21 ,3242 ,5110 ,0,3,1,3,0,1,0,76.14,63.4442270059,33.33
01,000,01,002,0085,0,685 ,4 ,689 ,1148 ,0,3,1,3,0,1,0,76.14,60.0174216028,33.33
01,000,01,002,0086,0,744 ,5 ,749 ,1234 ,0,3,1,3,0,1,0,76.14,60.6969205835,33.33
01,000,01,002,0087,0,1036 ,6 ,1042 ,1747 ,0,3,1,3,0,1,0,76.14,59.6451058958,33.33
01,000,01,002,0088,0,1616 ,9 ,1625 ,2759 ,0,3,1,3,0,1,0,76.14,58.8981515042,33.33
01,000,01,002,0089,0,812 ,3 ,815 ,1367 ,0,3,1,3,0,1,0,76.14,59.6196049744,33.33
01,000,01,002,0090,0,769 ,10 ,779 ,1189 ,0,3,1,3,0,1,0,76.14,65.5172413793,33.33
01,000,01,002,0091,0,710 ,7 ,717 ,1231 ,0,3,1,3,0,1,0,76.14,58.2453290008,33.33
01,000,01,002,0092,0,1586 ,6 ,1592 ,2471 ,0,3,1,3,0,1,0,76.14,64.4273573452,33.33
01,000,01,002,0093,0,1514 ,9 ,1523 ,2462 ,0,3,1,3,0,1,0,76.14,61.8602761982,33.33
01,000,01,003,0094,0,3838 ,16 ,3854 ,6197 ,0,3,1,3,0,1,0,76.14,62.1913829272,33.33
01,000,01,003,0095,0,3953 ,21 ,3974 ,6372 ,0,3,1,3,0,1,0,76.14,62.366603892,33.33
01,000,01,003,0096,0,3116 ,9 ,3125 ,5027 ,0,3,1,3,0,1,0,76.14,62.1643127114,33.33
01,000,01,003,0097,0,2756 ,15 ,2771 ,4409 ,0,3,1,3,0,1,0,76.14,62.8487185303,33.33
01,000,01,003,0098,0,2454 ,9 ,2463 ,4011 ,0,3,1,3,0,1,0,76.14,61.4061331339,33.33
01,000,01,003,0099,0,2536 ,13 ,2549 ,4153 ,0,3,1,3,0,1,0,76.14,61.3773176017,33.33
01,000,01,003,0100,0,4463 ,25 ,4488 ,7183 ,0,3,1,3,0,1,0,76.14,62.4808575804,33.33
01,000,01,003,0101,0,3850 ,29 ,3879 ,6234 ,0,3,1,3,0,1,0,76.14,62.2232916266,33.33
01,000,01,003,0102,0,2755 ,14 ,2769 ,4518 ,0,3,1,3,0,1,0,76.14,61.2881806109,33.33
01,000,01,003,0103,0,3725 ,26 ,3751 ,5765 ,0,3,1,3,0,1,0,76.14,65.0650477016,33.33
01,000,01,003,0104,0,4031 ,7 ,4038 ,6452 ,0,3,1,3,0,1,0,76.14,62.5852448853,33.33
01,000,01,003,0105,0,2309 ,10 ,2319 ,3926 ,0,3,1,3,0,1,0,76.14,59.0677534386,33.33
01,000,01,003,0106,0,2897 ,11 ,2908 ,4727 ,0,3,1,3,0,1,0,76.14,61.5189337846,33.33
01,000,01,003,0107,0,2659 ,13 ,2672 ,4529 ,0,3,1,3,0,1,0,76.14,58.9975712078,33.33
01,000,01,003,0108,0,3152 ,13 ,3165 ,5011 ,0,3,1,3,0,1,0,76.14,63.1610456995,33.33
01,000,01,003,0109,0,3299 ,12 ,3311 ,5298 ,0,3,1,3,0,1,0,76.14,62.4952812382,33.33
01,000,01,003,0110,0,2911 ,22 ,2933 ,4520 ,0,3,1,3,0,1,0,76.14,64.889380531,33.33
01,000,01,003,0111,0,3078 ,15 ,3093 ,5278 ,0,3,1,3,0,1,0,76.14,58.6017430845,33.33
01,000,01,003,0112,0,4108 ,20 ,4128 ,6991 ,0,3,1,3,0,1,0,76.14,59.0473465885,33.33
01,000,01,003,0113,0,2841 ,14 ,2855 ,4763 ,0,3,1,3,0,1,0,76.14,59.9412135209,33.33
01,000,01,003,0114,0,3362 ,19 ,3381 ,5860 ,0,3,1,3,0,1,0,76.14,57.6962457338,33.33
01,000,01,003,0115,0,2170 ,9 ,2179 ,3597 ,0,3,1,3,0,1,0,76.14,60.5782596608,33.33
01,000,01,003,0116,0,453 ,0 ,453 ,792 ,0,3,1,3,0,1,0,76.14,57.196969697,33.33
01,000,01,003,0117,0,3507 ,27 ,3534 ,5778 ,0,3,1,3,0,1,0,76.14,61.1630321911,33.33
01,000,01,003,0118,0,4404 ,23 ,4427 ,6386 ,0,3,1,3,0,1,0,76.14,69.3235202004,33.33
01,000,01,003,0119,0,2399 ,11 ,2410 ,3702 ,0,3,1,3,0,1,0,76.14,65.0999459751,33.33
01,000,01,003,0120,0,3887 ,26 ,3913 ,6974 ,0,3,1,3,0,1,0,76.14,56.1084026384,33.33
01,000,01,003,0121,0,3385 ,24 ,3409 ,5942 ,0,3,1,3,0,1,0,76.14,57.3712554695,33.33
01,000,01,003,0122,0,3084 ,22 ,3106 ,5267 ,0,3,1,3,0,1,0,76.14,58.9709512056,33.33
01,000,01,003,0123,0,3345 ,22 ,3367 ,5902 ,0,3,1,3,0,1,0,76.14,57.0484581498,33.33
01,000,01,003,0124,0,1946 ,16 ,1962 ,3273 ,0,3,1,3,0,1,0,76.14,59.945004583,33.33
01,000,01,003,0125,0,2129 ,10 ,2139 ,3611 ,0,3,1,3,0,1,0,76.14,59.2356687898,33.33
01,000,01,003,0126,0,2420 ,11 ,2431 ,3916 ,0,3,1,3,0,1,0,76.14,62.0786516854,33.33
01,000,01,003,0127,0,3125 ,30 ,3155 ,5144 ,0,3,1,3,0,1,0,76.14,61.333592535,33.33
01,000,01,003,0128,0,851 ,5 ,856 ,1422 ,0,3,1,3,0,1,0,76.14,60.1969057665,33.33
01,000,01,003,0129,0,4447 ,21 ,4468 ,8456 ,0,3,1,3,0,1,0,76.14,52.8382213813,33.33
01,000,01,003,0130,0,2410 ,11 ,2421 ,4023 ,0,3,1,3,0,1,0,76.14,60.1789709172,33.33
01,000,01,004,0131,0,2637 ,9 ,2646 ,4810 ,0,3,1,3,0,1,0,76.14,55.0103950104,33.33
01,000,01,004,0132,0,1910 ,13 ,1923 ,3297 ,0,3,1,3,0,1,0,76.14,58.3257506824,33.33
01,000,01,004,0133,0,1887 ,13 ,1900 ,3195 ,0,3,1,3,0,1,0,76.14,59.4679186228,33.33
01,000,01,004,0134,0,1480 ,10 ,1490 ,2581 ,0,3,1,3,0,1,0,76.14,57.7295621852,33.33
01,000,01,004,0135,0,3408 ,16 ,3424 ,5738 ,0,3,1,3,0,1,0,76.14,59.6723597072,33.33
01,000,01,004,0136,0,2100 ,15 ,2115 ,3313 ,0,3,1,3,0,1,0,76.14,63.8394204648,33.33
01,000,01,004,0137,0,2164 ,15 ,2179 ,3635 ,0,3,1,3,0,1,0,76.14,59.9449793673,33.33
01,000,01,004,0138,0,2106 ,17 ,2123 ,3531 ,0,3,1,3,0,1,0,76.14,60.1246105919,33.33
01,000,01,004,0139,0,2246 ,14 ,2260 ,3653 ,0,3,1,3,0,1,0,76.14,61.8669586641,33.33
01,000,01,004,0140,0,3112 ,25 ,3137 ,5045 ,0,3,1,3,0,1,0,76.14,62.1803766105,33.33
01,000,01,004,0141,0,3770 ,31 ,3801 ,6118 ,0,3,1,3,0,1,0,76.14,62.1281464531,33.33
01,000,01,004,0142,0,2218 ,12 ,2230 ,3341 ,0,3,1,3,0,1,0,76.14,66.7464830889,33.33
01,000,01,004,0143,0,2333 ,16 ,2349 ,3806 ,0,3,1,3,0,1,0,76.14,61.718339464,33.33
01,000,01,004,0144,0,2448 ,16 ,2464 ,3965 ,0,3,1,3,0,1,0,76.14,62.1437578815,33.33
01,000,01,004,0145,0,2709 ,12 ,2721 ,4286 ,0,3,1,3,0,1,0,76.14,63.4857676155,33.33
01,000,01,004,0146,0,3903 ,32 ,3935 ,6786 ,0,3,1,3,0,1,0,76.14,57.987032125,33.33
01,000,01,004,0147,0,4422 ,30 ,4452 ,7161 ,0,3,1,3,0,1,0,76.14,62.1700879765,33.33
01,000,01,004,0148,0,2974 ,22 ,2996 ,4652 ,0,3,1,3,0,1,0,76.14,64.4024075666,33.33
01,000,01,004,0149,0,2660 ,21 ,2681 ,4362 ,0,3,1,3,0,1,0,76.14,61.4626318203,33.33
01,000,01,005,0150,0,2890 ,17 ,2907 ,4672 ,0,3,1,3,0,1,0,76.14,62.2217465753,33.33
01,000,01,005,0151,0,4309 ,20 ,4329 ,6847 ,0,3,1,3,0,1,0,76.14,63.2247699723,33.33
01,000,01,005,0152,0,3485 ,19 ,3504 ,5585 ,0,3,1,3,0,1,0,76.14,62.739480752,33.33
01,000,01,005,0153,0,2285 ,14 ,2299 ,3716 ,0,3,1,3,0,1,0,76.14,61.8675995694,33.33
01,000,01,005,0154,0,2630 ,10 ,2640 ,4219 ,0,3,1,3,0,1,0,76.14,62.5740696848,33.33
01,000,01,005,0155,0,2354 ,11 ,2365 ,4010 ,0,3,1,3,0,1,0,76.14,58.9775561097,33.33
01,000,01,005,0156,0,2223 ,5 ,2228 ,3708 ,0,3,1,3,0,1,0,76.14,60.0862998921,33.33
01,000,01,005,0157,0,2220 ,8 ,2228 ,3624 ,0,3,1,3,0,1,0,76.14,61.4790286976,33.33
01,000,01,005,0158,0,2157 ,11 ,2168 ,3579 ,0,3,1,3,0,1,0,76.14,60.5755797709,33.33
01,000,01,005,0159,0,3664 ,19 ,3683 ,6057 ,0,3,1,3,0,1,0,76.14,60.8056793792,33.33
01,000,01,005,0160,0,4488 ,9 ,4497 ,6997 ,0,3,1,3,0,1,0,76.14,64.2704016007,33.33
01,000,01,005,0161,0,1322 ,12 ,1334 ,2124 ,0,3,1,3,0,1,0,76.14,62.8060263653,33.33
01,000,01,005,0162,0,2224 ,19 ,2243 ,3525 ,0,3,1,3,0,1,0,76.14,63.6312056738,33.33
01,000,01,005,0163,0,3045 ,9 ,3054 ,4896 ,0,3,1,3,0,1,0,76.14,62.3774509804,33.33
01,000,01,005,0164,0,4194 ,20 ,4214 ,7081 ,0,3,1,3,0,1,0,76.14,59.5113684508,33.33
01,000,01,005,0165,0,3437 ,15 ,3452 ,5406 ,0,3,1,3,0,1,0,76.14,63.8549759526,33.33
01,000,01,005,0166,0,2844 ,10 ,2854 ,5614 ,0,3,1,3,0,1,0,76.14,50.8371927325,33.33
01,000,01,005,0167,0,4289 ,39 ,4328 ,6893 ,0,3,1,3,0,1,0,76.14,62.788335993,33.33
01,000,01,005,0168,0,3029 ,9 ,3038 ,4689 ,0,3,1,3,0,1,0,76.14,64.7899338878,33.33
01,000,01,005,0169,0,3687 ,21 ,3708 ,5572 ,0,3,1,3,0,1,0,76.14,66.5470208184,33.33
01,000,01,005,0170,0,4072 ,7 ,4079 ,6678 ,0,3,1,3,0,1,0,76.14,61.0811620246,33.33
01,000,01,005,0171,0,3699 ,23 ,3722 ,6060 ,0,3,1,3,0,1,0,76.14,61.4191419142,33.33
01,000,01,005,0172,0,3313 ,18 ,3331 ,5239 ,0,3,1,3,0,1,0,76.14,63.5808360374,33.33
01,000,01,005,0173,0,3751 ,22 ,3773 ,6404 ,0,3,1,3,0,1,0,76.14,58.9163023111,33.33
01,000,01,005,0174,0,1833 ,16 ,1849 ,3079 ,0,3,1,3,0,1,0,76.14,60.0519649237,33.33
01,000,01,005,0175,0,1630 ,8 ,1638 ,2598 ,0,3,1,3,0,1,0,76.14,63.0484988453,33.33
01,000,01,005,0176,0,1909 ,15 ,1924 ,3112 ,0,3,1,3,0,1,0,76.14,61.8251928021,33.33
01,000,01,005,0177,0,3429 ,18 ,3447 ,5482 ,0,3,1,3,0,1,0,76.14,62.8785114922,33.33
01,000,01,005,0178,0,1542 ,8 ,1550 ,2468 ,0,3,1,3,0,1,0,76.14,62.8038897893,33.33
01,000,01,005,0179,0,1812 ,5 ,1817 ,3059 ,0,3,1,3,0,1,0,76.14,59.3984962406,33.33
01,000,01,005,0180,0,2903 ,17 ,2920 ,4702 ,0,3,1,3,0,1,0,76.14,62.1012335177,33.33
01,000,01,005,0181,0,1309 ,11 ,1320 ,2080 ,0,3,1,3,0,1,0,76.14,63.4615384615,33.33
01,000,01,005,0182,0,1855 ,14 ,1869 ,3082 ,0,3,1,3,0,1,0,76.14,60.642439974,33.33
01,000,01,006,0183,0,2647 ,10 ,2657 ,4840 ,0,3,1,3,0,1,0,76.14,54.8966942149,33.33
01,000,01,006,0184,0,2466 ,11 ,2477 ,3909 ,0,3,1,3,0,1,0,76.14,63.3665899207,33.33
01,000,01,006,0185,0,1462 ,5 ,1467 ,2478 ,0,3,1,3,0,1,0,76.14,59.200968523,33.33
01,000,01,006,0186,0,1440 ,6 ,1446 ,2578 ,0,3,1,3,0,1,0,76.14,56.089992242,33.33
01,000,01,006,0187,0,1788 ,7 ,1795 ,2927 ,0,3,1,3,0,1,0,76.14,61.3255893406,33.33
01,000,01,006,0188,0,2990 ,12 ,3002 ,4811 ,0,3,1,3,0,1,0,76.14,62.3986697152,33.33
01,000,01,006,0189,0,2226 ,7 ,2233 ,3896 ,0,3,1,3,0,1,0,76.14,57.3151950719,33.33
01,000,01,006,0190,0,3578 ,15 ,3593 ,5831 ,0,3,1,3,0,1,0,76.14,61.6189332876,33.33
01,000,01,006,0191,0,3797 ,7 ,3804 ,6201 ,0,3,1,3,0,1,0,76.14,61.3449443638,33.33
01,000,01,006,0192,0,1761 ,13 ,1774 ,2921 ,0,3,1,3,0,1,0,76.14,60.7326258131,33.33
01,000,01,006,0193,0,2391 ,15 ,2406 ,4046 ,0,3,1,3,0,1,0,76.14,59.4661393969,33.33
01,000,01,006,0194,0,1860 ,8 ,1868 ,3095 ,0,3,1,3,0,1,0,76.14,60.3554119548,33.33
01,000,01,006,0195,0,2705 ,18 ,2723 ,4267 ,0,3,1,3,0,1,0,76.14,63.8153269276,33.33
01,000,01,006,0196,0,2116 ,14 ,2130 ,3765 ,0,3,1,3,0,1,0,76.14,56.5737051793,33.33
01,000,01,006,0197,0,2155 ,14 ,2169 ,3573 ,0,3,1,3,0,1,0,76.14,60.7052896725,33.33
01,000,01,006,0198,0,2880 ,16 ,2896 ,4624 ,0,3,1,3,0,1,0,76.14,62.6297577855,33.33
01,000,01,006,0199,0,2698 ,19 ,2717 ,4589 ,0,3,1,3,0,1,0,76.14,59.2067988669,33.33
01,000,01,006,0200,0,2606 ,14 ,2620 ,4363 ,0,3,1,3,0,1,0,76.14,60.0504240202,33.33
01,000,01,006,0201,0,1934 ,10 ,1944 ,3068 ,0,3,1,3,0,1,0,76.14,63.3637548892,33.33
01,000,01,006,0202,0,3605 ,19 ,3624 ,5736 ,0,3,1,3,0,1,0,76.14,63.179916318,33.33
01,000,01,006,0203,0,1180 ,10 ,1190 ,2067 ,0,3,1,3,0,1,0,76.14,57.5713594582,33.33
01,000,01,006,0204,0,3127 ,12 ,3139 ,5306 ,0,3,1,3,0,1,0,76.14,59.159442141,33.33
01,000,01,006,0205,0,2707 ,6 ,2713 ,4456 ,0,3,1,3,0,1,0,76.14,60.8842010772,33.33
01,000,01,006,0206,0,2312 ,11 ,2323 ,3766 ,0,3,1,3,0,1,0,76.14,61.6834838024,33.33
01,000,01,006,0207,0,4033 ,22 ,4055 ,6488 ,0,3,1,3,0,1,0,76.14,62.5,33.33
01,000,01,006,0208,0,3282 ,15 ,3297 ,5385 ,0,3,1,3,0,1,0,76.14,61.2256267409,33.33
01,000,01,006,0209,0,2761 ,28 ,2789 ,4421 ,0,3,1,3,0,1,0,76.14,63.0852748247,33.33
01,000,01,006,0210,0,2506 ,16 ,2522 ,4042 ,0,3,1,3,0,1,0,76.14,62.3948540327,33.33
01,000,01,006,0211,0,3438 ,16 ,3454 ,5459 ,0,3,1,3,0,1,0,76.14,63.2716614765,33.33
01,000,01,006,0212,0,4744 ,28 ,4772 ,7555 ,0,3,1,3,0,1,0,76.14,63.1634679021,33.33
01,000,01,006,0213,0,2499 ,6 ,2505 ,4102 ,0,3,1,3,0,1,0,76.14,61.0677718186,33.33
01,000,01,006,0214,0,3292 ,10 ,3302 ,5449 ,0,3,1,3,0,1,0,76.14,60.5982749128,33.33
01,000,01,006,0215,0,3854 ,22 ,3876 ,6536 ,0,3,1,3,0,1,0,76.14,59.3023255814,33.33
01,000,01,006,0216,0,2424 ,13 ,2437 ,3951 ,0,3,1,3,0,1,0,76.14,61.6805871931,33.33
01,000,01,006,0217,0,2299 ,18 ,2317 ,3687 ,0,3,1,3,0,1,0,76.14,62.8424193111,33.33
01,000,01,006,0218,0,3723 ,21 ,3744 ,5972 ,0,3,1,3,0,1,0,76.14,62.6925653048,33.33
01,000,01,006,0219,0,1633 ,5 ,1638 ,2666 ,0,3,1,3,0,1,0,76.14,61.44036009,33.33
01,000,01,006,0220,0,2171 ,9 ,2180 ,3542 ,0,3,1,3,0,1,0,76.14,61.5471485037,33.33
01,000,01,006,0221,0,3483 ,17 ,3500 ,5662 ,0,3,1,3,0,1,0,76.14,61.8156128576,33.33
01,000,01,006,0222,0,2539 ,10 ,2549 ,4039 ,0,3,1,3,0,1,0,76.14,63.109680614,33.33
01,000,01,006,0223,0,1408 ,9 ,1417 ,2240 ,0,3,1,3,0,1,0,76.14,63.2589285714,33.33
01,000,02,007,0224,0,1475 ,15 ,1490 ,2439 ,0,3,1,3,0,1,0,76.14,61.09 ,33.33
01,000,02,007,0225,0,1912 ,22 ,1934 ,3646 ,0,3,1,3,0,1,0,76.14,53.04 ,33.33
01,000,02,007,0226,0,1464 ,8 ,1472 ,2592 ,0,3,1,3,0,1,0,76.14,56.79 ,33.33
01,000,02,007,0227,0,2410 ,9 ,2419 ,4072 ,0,3,1,3,0,1,0,76.14,59.41 ,33.33
01,000,02,007,0228,0,975 ,9 ,984 ,1869 ,0,3,1,3,0,1,0,76.14,52.65 ,33.33
01,000,02,007,0229,0,2319 ,12 ,2331 ,4280 ,0,3,1,3,0,1,0,76.14,54.46 ,33.33
01,000,02,007,0230,0,1383 ,12 ,1395 ,2811 ,0,3,1,3,0,1,0,76.14,49.63 ,33.33
01,000,02,007,0231,0,2803 ,18 ,2821 ,4774 ,0,3,1,3,0,1,0,76.14,59.09 ,33.33
01,000,02,007,0232,0,1771 ,11 ,1782 ,3091 ,0,3,1,3,0,1,0,76.14,57.65 ,33.33
01,000,02,007,0233,0,1481 ,13 ,1494 ,2664 ,0,3,1,3,0,1,0,76.14,56.08 ,33.33
01,000,02,007,0234,0,1779 ,16 ,1795 ,3506 ,0,3,1,3,0,1,0,76.14,51.20 ,33.33
01,000,02,007,0235,0,1660 ,15 ,1675 ,3079 ,0,3,1,3,0,1,0,76.14,54.40 ,33.33
01,000,02,007,0236,0,2315 ,11 ,2326 ,3958 ,0,3,1,3,0,1,0,76.14,58.77 ,33.33
01,000,02,007,0237,0,2120 ,12 ,2132 ,3120 ,0,3,1,3,0,1,0,76.14,68.33 ,33.33
01,000,02,007,0238,0,4814 ,25 ,4839 ,7616 ,0,3,1,3,0,1,0,76.14,63.54 ,33.33
01,000,02,007,0239,0,1642 ,10 ,1652 ,2633 ,0,3,1,3,0,1,0,76.14,62.74 ,33.33
01,000,02,007,0240,0,4100 ,16 ,4116 ,6632 ,0,3,1,3,0,1,0,76.14,62.06 ,33.33
01,000,02,007,0241,0,599 ,4 ,603 ,944 ,0,3,1,3,0,1,0,76.14,63.88 ,33.33
01,000,02,007,0242,0,2400 ,13 ,2413 ,4027 ,0,3,1,3,0,1,0,76.14,59.92 ,33.33
01,000,02,007,0243,0,2414 ,15 ,2429 ,4106 ,0,3,1,3,0,1,0,76.14,59.16 ,33.33
01,000,02,007,0244,0,3088 ,24 ,3112 ,5017 ,0,3,1,3,0,1,0,76.14,62.03 ,33.33
01,000,02,007,0245,0,2343 ,24 ,2367 ,3970 ,0,3,1,3,0,1,0,76.14,59.62 ,33.33
01,000,02,007,0246,0,2687 ,10 ,2697 ,4487 ,0,3,1,3,0,1,0,76.14,60.11 ,33.33
01,000,02,007,0247,0,2703 ,20 ,2723 ,5701 ,0,3,1,3,0,1,0,76.14,47.76 ,33.33
01,000,02,007,0248,0,4012 ,26 ,4038 ,6589 ,0,3,1,3,0,1,0,76.14,61.28 ,33.33
01,000,02,007,0249,0,2049 ,11 ,2060 ,3382 ,0,3,1,3,0,1,0,76.14,60.91 ,33.33
01,000,02,007,0250,0,3532 ,20 ,3552 ,5975 ,0,3,1,3,0,1,0,76.14,59.45 ,33.33
01,000,02,007,0251,0,3297 ,15 ,3312 ,5488 ,0,3,1,3,0,1,0,76.14,60.35 ,33.33
01,000,02,007,0252,0,3861 ,14 ,3875 ,6284 ,0,3,1,3,0,1,0,76.14,61.66 ,33.33
01,000,02,007,0253,0,2482 ,6 ,2488 ,4072 ,0,3,1,3,0,1,0,76.14,61.10 ,33.33
01,000,02,007,0254,0,2279 ,17 ,2296 ,3860 ,0,3,1,3,0,1,0,76.14,59.48 ,33.33
01,000,02,007,0255,0,2443 ,9 ,2452 ,4114 ,0,3,1,3,0,1,0,76.14,59.60 ,33.33
01,000,02,007,0256,0,1749 ,10 ,1759 ,2848 ,0,3,1,3,0,1,0,76.14,61.76 ,33.33
01,000,02,007,0257,0,3025 ,21 ,3046 ,4953 ,0,3,1,3,0,1,0,76.14,61.50 ,33.33
01,000,02,007,0258,0,2875 ,16 ,2891 ,4251 ,0,3,1,3,0,1,0,76.14,68.01 ,33.33
01,000,02,007,0259,0,2157 ,14 ,2171 ,3544 ,0,3,1,3,0,1,0,76.14,61.26 ,33.33
01,000,02,007,0260,0,2024 ,13 ,2037 ,3284 ,0,3,1,3,0,1,0,76.14,62.03 ,33.33
01,000,02,007,0261,0,1495 ,6 ,1501 ,2563 ,0,3,1,3,0,1,0,76.14,58.56 ,33.33
01,000,02,007,0262,0,2878 ,18 ,2896 ,4775 ,0,3,1,3,0,1,0,76.14,60.65 ,33.33
01,000,02,007,0263,0,1919 ,10 ,1929 ,3214 ,0,3,1,3,0,1,0,76.14,60.02 ,33.33
01,000,02,007,0264,0,2605 ,17 ,2622 ,4290 ,0,3,1,3,0,1,0,76.14,61.12 ,33.33
01,000,02,007,0265,0,1535 ,8 ,1543 ,2343 ,0,3,1,3,0,1,0,76.14,65.86 ,33.33
01,000,02,008,0266,0,1647 ,15 ,1662 ,2866 ,0,3,1,3,0,1,0,76.14,57.99 ,33.33
01,000,02,008,0267,0,1678 ,10 ,1688 ,2795 ,0,3,1,3,0,1,0,76.14,60.39 ,33.33
01,000,02,008,0268,0,2227 ,15 ,2242 ,3867 ,0,3,1,3,0,1,0,76.14,57.98 ,33.33
01,000,02,008,0269,0,1801 ,11 ,1812 ,3000 ,0,3,1,3,0,1,0,76.14,60.40 ,33.33
01,000,02,008,0270,0,2522 ,19 ,2541 ,4254 ,0,3,1,3,0,1,0,76.14,59.73 ,33.33
01,000,02,008,0271,0,1911 ,13 ,1924 ,3304 ,0,3,1,3,0,1,0,76.14,58.23 ,33.33
01,000,02,008,0272,0,2257 ,13 ,2270 ,3966 ,0,3,1,3,0,1,0,76.14,57.24 ,33.33
01,000,02,008,0273,0,2630 ,23 ,2653 ,4198 ,0,3,1,3,0,1,0,76.14,63.20 ,33.33
01,000,02,008,0274,0,2465 ,16 ,2481 ,4033 ,0,3,1,3,0,1,0,76.14,61.52 ,33.33
01,000,02,008,0275,0,1858 ,15 ,1873 ,3195 ,0,3,1,3,0,1,0,76.14,58.62 ,33.33
01,000,02,008,0276,0,4541 ,27 ,4568 ,7620 ,0,3,1,3,0,1,0,76.14,59.95 ,33.33
01,000,02,008,0277,0,1913 ,19 ,1932 ,3327 ,0,3,1,3,0,1,0,76.14,58.07 ,33.33
01,000,02,008,0278,0,3117 ,27 ,3144 ,5121 ,0,3,1,3,0,1,0,76.14,61.39 ,33.33
01,000,02,008,0279,0,1442 ,15 ,1457 ,2351 ,0,3,1,3,0,1,0,76.14,61.97 ,33.33
01,000,02,008,0280,0,1614 ,11 ,1625 ,2689 ,0,3,1,3,0,1,0,76.14,60.43 ,33.33
01,000,02,008,0281,0,2264 ,24 ,2288 ,3839 ,0,3,1,3,0,1,0,76.14,59.60 ,33.33
01,000,02,008,0282,0,1608 ,11 ,1619 ,2637 ,0,3,1,3,0,1,0,76.14,61.40 ,33.33
01,000,02,008,0283,0,1839 ,7 ,1846 ,3089 ,0,3,1,3,0,1,0,76.14,59.76 ,33.33
01,000,02,008,0284,0,1621 ,13 ,1634 ,3065 ,0,3,1,3,0,1,0,76.14,53.31 ,33.33
01,000,02,008,0285,0,2612 ,27 ,2639 ,4451 ,0,3,1,3,0,1,0,76.14,59.29 ,33.33
01,000,02,008,0286,0,3220 ,25 ,3245 ,5238 ,0,3,1,3,0,1,0,76.14,61.95 ,33.33
01,000,02,008,0287,0,3920 ,25 ,3945 ,6236 ,0,3,1,3,0,1,0,76.14,63.26 ,33.33
01,000,02,008,0288,0,2888 ,16 ,2904 ,4754 ,0,3,1,3,0,1,0,76.14,61.09 ,33.33
01,000,02,008,0289,0,2966 ,17 ,2983 ,4661 ,0,3,1,3,0,1,0,76.14,64.00 ,33.33
01,000,02,008,0290,0,2287 ,14 ,2301 ,3626 ,0,3,1,3,0,1,0,76.14,63.46 ,33.33
01,000,02,009,0291,0,1554 ,11 ,1565 ,2536 ,0,3,1,3,0,1,0,76.14,61.71 ,33.33
01,000,02,009,0292,0,1559 ,13 ,1572 ,2485 ,0,3,1,3,0,1,0,76.14,63.26 ,33.33
01,000,02,009,0293,0,1454 ,7 ,1461 ,2240 ,0,3,1,3,0,1,0,76.14,65.22 ,33.33
01,000,02,009,0294,0,2434 ,14 ,2448 ,3946 ,0,3,1,3,0,1,0,76.14,62.04 ,33.33
01,000,02,009,0295,0,2389 ,14 ,2403 ,3808 ,0,3,1,3,0,1,0,76.14,63.10 ,33.33
01,000,02,009,0296,0,3031 ,17 ,3048 ,4695 ,0,3,1,3,0,1,0,76.14,64.92 ,33.33
01,000,02,009,0297,0,2762 ,17 ,2779 ,4435 ,0,3,1,3,0,1,0,76.14,62.66 ,33.33
01,000,02,009,0298,0,1738 ,7 ,1745 ,2808 ,0,3,1,3,0,1,0,76.14,62.14 ,33.33
01,000,02,009,0299,0,2867 ,6 ,2873 ,4392 ,0,3,1,3,0,1,0,76.14,65.41 ,33.33
01,000,02,009,0300,0,2223 ,13 ,2236 ,3575 ,0,3,1,3,0,1,0,76.14,62.55 ,33.33
01,000,02,009,0301,0,2976 ,11 ,2987 ,4941 ,0,3,1,3,0,1,0,76.14,60.45 ,33.33
01,000,02,009,0302,0,2765 ,10 ,2775 ,4379 ,0,3,1,3,0,1,0,76.14,63.37 ,33.33
01,000,02,009,0303,0,1857 ,15 ,1872 ,3066 ,0,3,1,3,0,1,0,76.14,61.06 ,33.33
01,000,02,009,0304,0,3454 ,34 ,3488 ,5689 ,0,3,1,3,0,1,0,76.14,61.31 ,33.33
01,000,02,009,0305,0,1788 ,12 ,1800 ,3002 ,0,3,1,3,0,1,0,76.14,59.96 ,33.33
01,000,02,009,0306,0,1577 ,3 ,1580 ,2469 ,0,3,1,3,0,1,0,76.14,63.99 ,33.33
01,000,02,009,0307,0,1411 ,5 ,1416 ,2206 ,0,3,1,3,0,1,0,76.14,64.19 ,33.33
01,000,02,009,0308,0,1686 ,9 ,1695 ,2772 ,0,3,1,3,0,1,0,76.14,61.15 ,33.33
01,000,02,009,0309,0,4032 ,21 ,4053 ,6228 ,0,3,1,3,0,1,0,76.14,65.08 ,33.33
01,000,02,009,0310,0,3014 ,21 ,3035 ,5423 ,0,3,1,3,0,1,0,76.14,55.97 ,33.33
01,000,02,009,0311,0,4100 ,36 ,4136 ,6319 ,0,3,1,3,0,1,0,76.14,65.45 ,33.33
01,000,02,009,0312,0,644 ,3 ,647 ,1098 ,0,3,1,3,0,1,0,76.14,58.93 ,33.33
01,000,02,009,0313,0,1737 ,15 ,1752 ,3004 ,0,3,1,3,0,1,0,76.14,58.3222370173,33.33
01,000,02,009,0314,0,1319 ,4 ,1323 ,2438 ,0,3,1,3,0,1,0,76.14,54.2657916325,33.33
01,000,02,009,0315,0,1682 ,8 ,1690 ,2785 ,0,3,1,3,0,1,0,76.14,60.6822262118,33.33
01,000,02,009,0316,0,2210 ,6 ,2216 ,3681 ,0,3,1,3,0,1,0,76.14,60.2010323282,33.33
01,000,02,009,0317,0,2081 ,7 ,2088 ,3394 ,0,3,1,3,0,1,0,76.14,61.5203299941,33.33
01,000,02,009,0318,0,2181 ,11 ,2192 ,3549 ,0,3,1,3,0,1,0,76.14,61.7638771485,33.33
01,000,02,009,0319,0,2590 ,13 ,2603 ,4138 ,0,3,1,3,0,1,0,76.14,62.9047849203,33.33
01,000,02,009,0320,0,3473 ,19 ,3492 ,5454 ,0,3,1,3,0,1,0,76.14,64.0264026403,33.33
01,000,02,009,0321,0,3891 ,13 ,3904 ,6070 ,0,3,1,3,0,1,0,76.14,64.3163097199,33.33
01,000,02,010,0322,0,2457 ,21 ,2478 ,4248 ,0,3,1,3,0,1,0,76.14,58.3333333333,33.33
01,000,02,010,0323,0,1485 ,15 ,1500 ,2774 ,0,3,1,3,0,1,0,76.14,54.0735400144,33.33
01,000,02,010,0324,0,1605 ,10 ,1615 ,2962 ,0,3,1,3,0,1,0,76.14,54.5239702903,33.33
01,000,02,010,0325,0,3405 ,24 ,3429 ,5855 ,0,3,1,3,0,1,0,76.14,58.5653287788,33.33
01,000,02,010,0326,0,2892 ,15 ,2907 ,4909 ,0,3,1,3,0,1,0,76.14,59.2177632919,33.33
01,000,02,010,0327,0,2607 ,20 ,2627 ,4487 ,0,3,1,3,0,1,0,76.14,58.5469133051,33.33
01,000,02,010,0328,0,2547 ,11 ,2558 ,4238 ,0,3,1,3,0,1,0,76.14,60.3586597452,33.33
01,000,02,010,0329,0,1914 ,15 ,1929 ,3057 ,0,3,1,3,0,1,0,76.14,63.1010794897,33.33
01,000,02,010,0330,0,2286 ,14 ,2300 ,3557 ,0,3,1,3,0,1,0,76.14,64.6612313748,33.33
01,000,02,010,0331,0,2465 ,15 ,2480 ,4183 ,0,3,1,3,0,1,0,76.14,59.2875926369,33.33
01,000,02,010,0332,0,2661 ,21 ,2682 ,4464 ,0,3,1,3,0,1,0,76.14,60.0806451613,33.33
01,000,02,010,0333,0,4205 ,30 ,4235 ,7004 ,0,3,1,3,0,1,0,76.14,60.4654483152,33.33
01,000,02,010,0334,0,2591 ,18 ,2609 ,4525 ,0,3,1,3,0,1,0,76.14,57.6574585635,33.33
01,000,02,010,0335,0,2247 ,19 ,2266 ,3903 ,0,3,1,3,0,1,0,76.14,58.0579041763,33.33
01,000,02,010,0336,0,4093 ,30 ,4123 ,6916 ,0,3,1,3,0,1,0,76.14,59.6153846154,33.33
01,000,02,010,0337,0,2497 ,13 ,2510 ,4052 ,0,3,1,3,0,1,0,76.14,61.9447186575,33.33
01,000,02,010,0338,0,3702 ,27 ,3729 ,6043 ,0,3,1,3,0,1,0,76.14,61.7077610458,33.33
01,000,02,010,0339,0,3328 ,21 ,3349 ,5864 ,0,3,1,3,0,1,0,76.14,57.1111869031,33.33
01,000,02,010,0340,0,2161 ,18 ,2179 ,3548 ,0,3,1,3,0,1,0,76.14,61.4148816234,33.33
01,000,02,010,0341,0,2019 ,13 ,2032 ,3233 ,0,3,1,3,0,1,0,76.14,62.8518403959,33.33
01,000,02,010,0342,0,2613 ,18 ,2631 ,4251 ,0,3,1,3,0,1,0,76.14,61.8913196895,33.33
01,000,02,010,0343,0,2283 ,18 ,2301 ,3748 ,0,3,1,3,0,1,0,76.14,61.3927427962,33.33
01,000,02,010,0344,0,2653 ,18 ,2671 ,4410 ,0,3,1,3,0,1,0,76.14,60.566893424,33.33
01,000,02,010,0345,0,2458 ,18 ,2476 ,3952 ,0,3,1,3,0,1,0,76.14,62.6518218623,33.33
01,000,02,010,0346,0,1651 ,5 ,1656 ,2675 ,0,3,1,3,0,1,0,76.14,61.9065420561,33.33
01,000,02,010,0347,0,1640 ,6 ,1646 ,2481 ,0,3,1,3,0,1,0,76.14,66.3442160419,33.33
01,000,02,010,0348,0,2040 ,13 ,2053 ,3180 ,0,3,1,3,0,1,0,76.14,64.5597484277,33.33
01,000,02,010,0349,0,3209 ,27 ,3236 ,5159 ,0,3,1,3,0,1,0,76.14,62.7253343671,33.33
01,000,02,010,0350,0,2452 ,17 ,2469 ,3983 ,0,3,1,3,0,1,0,76.14,61.9884509164,33.33
01,000,02,010,0351,0,2720 ,12 ,2732 ,4322 ,0,3,1,3,0,1,0,76.14,63.2114761684,33.33
01,000,02,010,0352,0,2899 ,16 ,2915 ,4327 ,0,3,1,3,0,1,0,76.14,67.367691241,33.33
01,000,02,010,0353,0,2191 ,10 ,2201 ,3292 ,0,3,1,3,0,1,0,76.14,66.8590522479,33.33
01,000,02,010,0354,0,5023 ,21 ,5044 ,7375 ,0,3,1,3,0,1,0,76.14,68.393220339,33.33
01,000,02,010,0355,0,3331 ,25 ,3356 ,5365 ,0,3,1,3,0,1,0,76.14,62.5535880708,33.33
01,000,02,010,0356,0,2201 ,12 ,2213 ,3425 ,0,3,1,3,0,1,0,76.14,64.6131386861,33.33
01,000,02,010,0357,0,1687 ,7 ,1694 ,2633 ,0,3,1,3,0,1,0,76.14,64.3372578807,33.33
01,000,02,011,0358,0,2842 ,13 ,2855 ,4581 ,0,3,1,3,0,1,0,76.14,62.3226369788,33.33
01,000,02,011,0359,0,2342 ,10 ,2352 ,3876 ,0,3,1,3,0,1,0,76.14,60.6811145511,33.33
01,000,02,011,0360,0,3083 ,15 ,3098 ,4981 ,0,3,1,3,0,1,0,76.14,62.1963461152,33.33
01,000,02,011,0361,0,3824 ,15 ,3839 ,6280 ,0,3,1,3,0,1,0,76.14,61.1305732484,33.33
01,000,02,011,0362,0,2520 ,11 ,2531 ,4614 ,0,3,1,3,0,1,0,76.14,54.8547897703,33.33
01,000,02,011,0363,0,3519 ,11 ,3530 ,5443 ,0,3,1,3,0,1,0,76.14,64.8539408414,33.33
01,000,02,011,0364,0,3325 ,10 ,3335 ,5457 ,0,3,1,3,0,1,0,76.14,61.1141652923,33.33
01,000,02,011,0365,0,1733 ,5 ,1738 ,2690 ,0,3,1,3,0,1,0,76.14,64.6096654275,33.33
01,000,02,011,0366,0,2269 ,12 ,2281 ,3678 ,0,3,1,3,0,1,0,76.14,62.0174007613,33.33
01,000,02,011,0367,0,3668 ,20 ,3688 ,6387 ,0,3,1,3,0,1,0,76.14,57.7422890246,33.33
01,000,02,011,0368,0,2961 ,9 ,2970 ,4611 ,0,3,1,3,0,1,0,76.14,64.4111906311,33.33
01,000,02,011,0369,0,2211 ,8 ,2219 ,3595 ,0,3,1,3,0,1,0,76.14,61.7246175243,33.33
01,000,02,011,0370,0,2047 ,8 ,2055 ,3260 ,0,3,1,3,0,1,0,76.14,63.036809816,33.33
01,000,02,011,0371,0,3149 ,17 ,3166 ,5103 ,0,3,1,3,0,1,0,76.14,62.041936116,33.33
01,000,02,011,0372,0,2837 ,18 ,2855 ,5742 ,0,3,1,3,0,1,0,76.14,49.7213514455,33.33
01,000,02,011,0373,0,2569 ,9 ,2578 ,4007 ,0,3,1,3,0,1,0,76.14,64.3374095333,33.33
01,000,02,011,0374,0,2714 ,7 ,2721 ,4361 ,0,3,1,3,0,1,0,76.14,62.3939463426,33.33
01,000,02,011,0375,0,1682 ,3 ,1685 ,2555 ,0,3,1,3,0,1,0,76.14,65.9491193738,33.33
01,000,02,011,0376,0,1882 ,13 ,1895 ,2924 ,0,3,1,3,0,1,0,76.14,64.8084815321,33.33
01,000,02,011,0377,0,2619 ,10 ,2629 ,3905 ,0,3,1,3,0,1,0,76.14,67.323943662,33.33
01,000,02,011,0378,0,2624 ,14 ,2638 ,4042 ,0,3,1,3,0,1,0,76.14,65.2647204354,33.33
01,000,02,011,0379,0,3222 ,14 ,3236 ,5251 ,0,3,1,3,0,1,0,76.14,61.6263568844,33.33
01,000,02,011,0380,0,3397 ,19 ,3416 ,5169 ,0,3,1,3,0,1,0,76.14,66.0862836139,33.33
01,000,02,011,0381,0,1850 ,16 ,1866 ,2960 ,0,3,1,3,0,1,0,76.14,63.0405405405,33.33
01,000,02,011,0382,0,2510 ,10 ,2520 ,4066 ,0,3,1,3,0,1,0,76.14,61.9773733399,33.33
01,000,02,011,0383,0,3281 ,17 ,3298 ,4979 ,0,3,1,3,0,1,0,76.14,66.2382004419,33.33
01,000,02,011,0384,0,2623 ,23 ,2646 ,4355 ,0,3,1,3,0,1,0,76.14,60.757749713,33.33
01,000,02,011,0385,0,2695 ,10 ,2705 ,4454 ,0,3,1,3,0,1,0,76.14,60.7319263583,33.33
01,000,02,011,0386,0,3033 ,12 ,3045 ,4980 ,0,3,1,3,0,1,0,76.14,61.1445783133,33.33
01,000,02,011,0387,0,2870 ,11 ,2881 ,4725 ,0,3,1,3,0,1,0,76.14,60.9735449735,33.33
01,000,02,011,0388,0,2116 ,9 ,2125 ,3470 ,0,3,1,3,0,1,0,76.14,61.2391930836,33.33
01,000,02,011,0389,0,2222 ,13 ,2235 ,3568 ,0,3,1,3,0,1,0,76.14,62.6401345291,33.33
01,000,02,011,0390,0,2151 ,6 ,2157 ,3493 ,0,3,1,3,0,1,0,76.14,61.7520755797,33.33
01,000,02,011,0391,0,3040 ,14 ,3054 ,4957 ,0,3,1,3,0,1,0,76.14,61.6098446641,33.33
01,000,02,011,0392,0,4043 ,19 ,4062 ,5939 ,0,3,1,3,0,1,0,76.14,68.395352753,33.33
01,000,02,011,0393,0,1674 ,7 ,1681 ,2722 ,0,3,1,3,0,1,0,76.14,61.7560617193,33.33
01,000,02,011,0394,0,1074 ,5 ,1079 ,1774 ,0,3,1,3,0,1,0,76.14,60.8229988726,33.33
01,000,02,011,0395,0,4459 ,16 ,4475 ,6928 ,0,3,1,3,0,1,0,76.14,64.5929561201,33.33
01,000,02,011,0396,0,2068 ,10 ,2078 ,3306 ,0,3,1,3,0,1,0,76.14,62.8554143981,33.33
01,000,02,011,0397,0,3990 ,21 ,4011 ,6473 ,0,3,1,3,0,1,0,76.14,61.9650857408,33.33
01,000,02,011,0398,0,3218 ,17 ,3235 ,5071 ,0,3,1,3,0,1,0,76.14,63.7941234471,33.33
01,000,02,011,0399,0,2825 ,14 ,2839 ,4498 ,0,3,1,3,0,1,0,76.14,63.1169408626,33.33
01,000,02,011,0400,0,3992 ,28 ,4020 ,6229 ,0,3,1,3,0,1,0,76.14,64.5368437952,33.33
01,000,02,011,0401,0,2161 ,15 ,2176 ,3566 ,0,3,1,3,0,1,0,76.14,61.0207515423,33.33
01,000,02,011,0402,0,2292 ,16 ,2308 ,4089 ,0,3,1,3,0,1,0,76.14,56.4441183663,33.33
01,000,02,011,0403,0,2798 ,13 ,2811 ,4870 ,0,3,1,3,0,1,0,76.14,57.7207392197,33.33
01,000,02,011,0404,0,3023 ,12 ,3035 ,4969 ,0,3,1,3,0,1,0,76.14,61.0786878648,33.33
01,000,02,011,0405,0,2325 ,8 ,2333 ,3970 ,0,3,1,3,0,1,0,76.14,58.765743073,33.33
01,000,02,011,0406,0,2925 ,12 ,2937 ,4769 ,0,3,1,3,0,1,0,76.14,61.5852379954,33.33
01,000,02,011,0407,0,2091 ,12 ,2103 ,3499 ,0,3,1,3,0,1,0,76.14,60.102886539,33.33
01,000,02,011,0408,0,3100 ,11 ,3111 ,5252 ,0,3,1,3,0,1,0,76.14,59.2345773039,33.33
01,000,02,011,0409,0,3852 ,20 ,3872 ,6285 ,0,3,1,3,0,1,0,76.14,61.6070007955,33.33
01,000,02,011,0410,0,1932 ,7 ,1939 ,3063 ,0,3,1,3,0,1,0,76.14,63.3039503754,33.33
01,000,02,012,0411,0,2661 ,15 ,2676 ,4363 ,0,3,1,3,0,1,0,76.14,61.3339445336,33.33
01,000,02,012,0412,0,3194 ,14 ,3208 ,5225 ,0,3,1,3,0,1,0,76.14,61.3971291866,33.33
01,000,02,012,0413,0,2252 ,5 ,2257 ,3520 ,0,3,1,3,0,1,0,76.14,64.1193181818,33.33
01,000,02,012,0414,0,3082 ,20 ,3102 ,4955 ,0,3,1,3,0,1,0,76.14,62.6034308779,33.33
01,000,02,012,0415,0,2302 ,13 ,2315 ,3573 ,0,3,1,3,0,1,0,76.14,64.7914917436,33.33
01,000,02,012,0416,0,2827 ,6 ,2833 ,4481 ,0,3,1,3,0,1,0,76.14,63.2224949788,33.33
01,000,02,012,0417,0,2424 ,11 ,2435 ,3737 ,0,3,1,3,0,1,0,76.14,65.1592186246,33.33
01,000,02,012,0418,0,2328 ,13 ,2341 ,3566 ,0,3,1,3,0,1,0,76.14,65.6477846326,33.33
01,000,02,012,0419,0,3614 ,21 ,3635 ,5625 ,0,3,1,3,0,1,0,76.14,64.6222222222,33.33
01,000,02,012,0420,0,2656 ,15 ,2671 ,4274 ,0,3,1,3,0,1,0,76.14,62.4941506785,33.33
01,000,02,012,0421,0,1868 ,11 ,1879 ,2758 ,0,3,1,3,0,1,0,76.14,68.1290790428,33.33
01,000,02,012,0422,0,2401 ,6 ,2407 ,3819 ,0,3,1,3,0,1,0,76.14,63.0269704111,33.33
01,000,02,012,0423,0,4391 ,13 ,4404 ,6891 ,0,3,1,3,0,1,0,76.14,63.9094471049,33.33
01,000,02,012,0424,0,1530 ,10 ,1540 ,2536 ,0,3,1,3,0,1,0,76.14,60.7255520505,33.33
01,000,02,012,0425,0,3695 ,20 ,3715 ,5897 ,0,3,1,3,0,1,0,76.14,62.9981346447,33.33
01,000,02,012,0426,0,3032 ,11 ,3043 ,5035 ,0,3,1,3,0,1,0,76.14,60.4369414101,33.33
01,000,02,012,0427,0,2786 ,13 ,2799 ,4824 ,0,3,1,3,0,1,0,76.14,58.0223880597,33.33
01,000,02,012,0428,0,3263 ,11 ,3274 ,4981 ,0,3,1,3,0,1,0,76.14,65.7297731379,33.33
01,000,02,012,0429,0,2985 ,10 ,2995 ,4619 ,0,3,1,3,0,1,0,76.14,64.8408746482,33.33
01,000,02,012,0430,0,3346 ,25 ,3371 ,5533 ,0,3,1,3,0,1,0,76.14,60.9253569492,33.33
01,000,02,012,0431,0,1866 ,8 ,1874 ,3055 ,0,3,1,3,0,1,0,76.14,61.3420621931,33.33
01,000,02,012,0432,0,3227 ,12 ,3239 ,5126 ,0,3,1,3,0,1,0,76.14,63.1876706984,33.33
01,000,02,012,0433,0,3287 ,14 ,3301 ,5008 ,0,3,1,3,0,1,0,76.14,65.9145367412,33.33
01,000,02,012,0434,0,3789 ,19 ,3808 ,5908 ,0,3,1,3,0,1,0,76.14,64.4549763033,33.33
01,000,02,012,0435,0,2156 ,34 ,2190 ,3850 ,0,3,1,3,0,1,0,76.14,56.8831168831,33.33
01,000,02,012,0436,0,3401 ,13 ,3414 ,5559 ,0,3,1,3,0,1,0,76.14,61.4139233675,33.33
01,000,02,012,0437,0,3957 ,22 ,3979 ,5950 ,0,3,1,3,0,1,0,76.14,66.8739495798,33.33
01,000,02,012,0438,0,4195 ,31 ,4226 ,6935 ,0,3,1,3,0,1,0,76.14,60.9372746936,33.33
01,000,02,012,0439,0,3433 ,15 ,3448 ,5456 ,0,3,1,3,0,1,0,76.14,63.1964809384,33.33
01,000,02,012,0440,0,1963 ,11 ,1974 ,3029 ,0,3,1,3,0,1,0,76.14,65.1700231099,33.33
01,000,02,012,0441,0,4224 ,15 ,4239 ,6573 ,0,3,1,3,0,1,0,76.14,64.4910999544,33.33
01,000,02,012,0442,0,5595 ,32 ,5627 ,8977 ,0,3,1,3,0,1,0,76.14,62.6824106049,33.33
01,000,02,012,0443,0,4522 ,40 ,4562 ,7151 ,0,3,1,3,0,1,0,76.14,63.7952733883,33.33
01,000,02,012,0444,0,3641 ,11 ,3652 ,5743 ,0,3,1,3,0,1,0,76.14,63.5904579488,33.33
01,000,02,012,0445,0,3182 ,23 ,3205 ,5245 ,0,3,1,3,0,1,0,76.14,61.105815062,33.33
01,000,02,012,0446,0,2338 ,16 ,2354 ,3814 ,0,3,1,3,0,1,0,76.14,61.7199790246,33.33
01,000,02,012,0447,0,5285 ,25 ,5310 ,8630 ,0,3,1,3,0,1,0,76.14,61.5295480881,33.33
01,000,02,012,0448,0,1452 ,10 ,1462 ,2358 ,0,3,1,3,0,1,0,76.14,62.0016963528,33.33
01,000,02,012,0449,0,404 ,5 ,409 ,704 ,0,3,1,3,0,1,0,76.14,58.0965909091,33.33
02,000,01,001,0001,0,815 ,4 ,819 ,1289 ,0,3,1,3,0,1,0,76.14,63.54 ,33.33
02,000,01,001,0002,0,309 ,1 ,310 ,477 ,0,3,1,3,0,1,0,76.14,64.99 ,33.33
02,000,01,001,0003,0,432 ,2 ,434 ,724 ,0,3,1,3,0,1,0,76.14,59.94 ,33.33
02,000,01,001,0004,0,817 ,6 ,823 ,1329 ,0,3,1,3,0,1,0,76.14,61.93 ,33.33
02,000,01,001,0005,0,704 ,2 ,706 ,1185 ,0,3,1,3,0,1,0,76.14,59.58 ,33.33
02,000,01,001,0006,0,1344 ,11 ,1355 ,2219 ,0,3,1,3,0,1,0,76.14,61.06 ,33.33
02,000,01,001,0007,0,612 ,5 ,617 ,940 ,0,3,1,3,0,1,0,76.14,65.64 ,33.33
02,000,01,001,0008,0,460 ,0 ,460 ,698 ,0,3,1,3,0,1,0,76.14,65.90 ,33.33
02,000,01,001,0009,0,750 ,5 ,755 ,1227 ,0,3,1,3,0,1,0,76.14,61.53 ,33.33
02,000,01,001,0010,0,493 ,3 ,496 ,829 ,0,3,1,3,0,1,0,76.14,59.83 ,33.33
02,000,01,001,0011,0,1084 ,3 ,1087 ,1860 ,0,3,1,3,0,1,0,76.14,58.44 ,33.33
02,000,01,001,0012,0,637 ,2 ,639 ,1095 ,0,3,1,3,0,1,0,76.14,58.36 ,33.33
02,000,01,001,0013,0,660 ,4 ,664 ,1101 ,0,3,1,3,0,1,0,76.14,60.31 ,33.33
02,000,01,001,0014,0,682 ,3 ,685 ,1175 ,0,3,1,3,0,1,0,76.14,58.30 ,33.33
02,000,01,001,0015,0,740 ,7 ,747 ,1200 ,0,3,1,3,0,1,0,76.14,62.25 ,33.33
02,000,01,001,0016,0,392 ,1 ,393 ,599 ,0,3,1,3,0,1,0,76.14,65.61 ,33.33
02,000,01,001,0017,0,978 ,5 ,983 ,1802 ,0,3,1,3,0,1,0,76.14,54.55 ,33.33
02,000,01,001,0018,0,754 ,8 ,762 ,1245 ,0,3,1,3,0,1,0,76.14,61.20 ,33.33
02,000,01,001,0019,0,449 ,2 ,451 ,718 ,0,3,1,3,0,1,0,76.14,62.81 ,33.33
02,000,01,001,0020,0,451 ,2 ,453 ,705 ,0,3,1,3,0,1,0,76.14,64.26 ,33.33
02,000,01,001,0021,0,571 ,1 ,572 ,935 ,0,3,1,3,0,1,0,76.14,61.18 ,33.33
02,000,01,002,0022,0,1278 ,9 ,1287 ,2012 ,0,3,1,3,0,1,0,76.14,63.97 ,33.33
02,000,01,002,0023,0,1248 ,11 ,1259 ,2089 ,0,3,1,3,0,1,0,76.14,60.27 ,33.33
02,000,01,002,0024,0,2805 ,17 ,2822 ,4265 ,0,3,1,3,0,1,0,76.14,66.17 ,33.33
02,000,01,002,0025,0,2348 ,13 ,2361 ,3874 ,0,3,1,3,0,1,0,76.14,60.94 ,33.33
02,000,01,002,0026,0,962 ,0 ,962 ,1457 ,0,3,1,3,0,1,0,76.14,66.03 ,33.33
02,000,01,002,0027,0,771 ,6 ,777 ,1194 ,0,3,1,3,0,1,0,76.14,65.08 ,33.33
02,000,01,002,0028,0,1341 ,4 ,1345 ,2084 ,0,3,1,3,0,1,0,76.14,64.54 ,33.33
02,000,01,002,0029,0,2337 ,9 ,2346 ,3951 ,0,3,1,3,0,1,0,76.14,59.38 ,33.33
02,000,01,002,0030,0,586 ,3 ,589 ,830 ,0,3,1,3,0,1,0,76.14,70.96 ,33.33
02,000,01,002,0031,0,919 ,10 ,929 ,1480 ,0,3,1,3,0,1,0,76.14,62.77 ,33.33
02,000,01,002,0032,0,1069 ,9 ,1078 ,1839 ,0,3,1,3,0,1,0,76.14,58.62 ,33.33
02,000,01,002,0033,0,1945 ,12 ,1957 ,3218 ,0,3,1,3,0,1,0,76.14,60.81 ,33.33
02,000,01,002,0034,0,1764 ,13 ,1777 ,2800 ,0,3,1,3,0,1,0,76.14,63.46 ,33.33
02,000,01,002,0035,0,1594 ,13 ,1607 ,2610 ,0,3,1,3,0,1,0,76.14,61.57 ,33.33
02,000,01,002,0036,0,3081 ,23 ,3104 ,5468 ,0,3,1,3,0,1,0,76.14,56.77 ,33.33
02,000,01,002,0037,0,1555 ,3 ,1558 ,2784 ,0,3,1,3,0,1,0,76.14,55.96 ,33.33
02,000,01,002,0038,0,6087 ,23 ,6110 ,10616 ,0,3,1,3,0,1,0,76.14,57.55 ,33.33
02,000,01,002,0039,0,2247 ,8 ,2255 ,3626 ,0,3,1,3,0,1,0,76.14,62.19 ,33.33
02,000,01,002,0040,0,1702 ,6 ,1708 ,2857 ,0,3,1,3,0,1,0,76.14,59.78 ,33.33
02,000,01,002,0041,0,1408 ,2 ,1410 ,2333 ,0,3,1,3,0,1,0,76.14,60.44 ,33.33
02,000,01,002,0042,0,840 ,10 ,850 ,1492 ,0,3,1,3,0,1,0,76.14,56.97 ,33.33
02,000,01,002,0043,0,752 ,14 ,766 ,1176 ,0,3,1,3,0,1,0,76.14,65.14 ,33.33
02,000,01,002,0044,0,607 ,7 ,614 ,1240 ,0,3,1,3,0,1,0,76.14,49.52 ,33.33
02,000,01,002,0045,0,893 ,4 ,897 ,1488 ,0,3,1,3,0,1,0,76.14,60.28 ,33.33
02,000,01,002,0046,0,930 ,12 ,942 ,1524 ,0,3,1,3,0,1,0,76.14,61.81 ,33.33
02,000,01,002,0047,0,775 ,8 ,783 ,1310 ,0,3,1,3,0,1,0,76.14,59.77 ,33.33
02,000,01,002,0048,0,957 ,10 ,967 ,1550 ,0,3,1,3,0,1,0,76.14,62.39 ,33.33
02,000,01,002,0049,0,922 ,6 ,928 ,1560 ,0,3,1,3,0,1,0,76.14,59.49 ,33.33
02,000,01,002,0050,0,504 ,4 ,508 ,804 ,0,3,1,3,0,1,0,76.14,63.18 ,33.33
02,000,01,002,0051,0,586 ,9 ,595 ,1034 ,0,3,1,3,0,1,0,76.14,57.54 ,33.33
02,000,01,002,0052,0,649 ,7 ,656 ,1158 ,0,3,1,3,0,1,0,76.14,56.65 ,33.33
02,000,01,002,0053,0,676 ,7 ,683 ,1150 ,0,3,1,3,0,1,0,76.14,59.39 ,33.33
02,000,01,002,0054,0,580 ,2 ,582 ,912 ,0,3,1,3,0,1,0,76.14,63.82 ,33.33
02,000,01,002,0055,0,843 ,4 ,847 ,1419 ,0,3,1,3,0,1,0,76.14,59.69 ,33.33
02,000,01,002,0056,0,769 ,7 ,776 ,1409 ,0,3,1,3,0,1,0,76.14,55.07 ,33.33
02,000,01,002,0057,0,873 ,7 ,880 ,1568 ,0,3,1,3,0,1,0,76.14,56.12 ,33.33
02,000,01,002,0058,0,694 ,5 ,699 ,1174 ,0,3,1,3,0,1,0,76.14,59.54 ,33.33
02,000,01,002,0059,0,317 ,1 ,318 ,602 ,0,3,1,3,0,1,0,76.14,52.82 ,33.33
02,000,01,003,0060,0,699 ,8 ,707 ,1230 ,0,3,1,3,0,1,0,76.14,57.48 ,33.33
02,000,01,003,0061,0,626 ,6 ,632 ,1077 ,0,3,1,3,0,1,0,76.14,58.68 ,33.33
02,000,01,003,0062,0,910 ,10 ,920 ,1682 ,0,3,1,3,0,1,0,76.14,54.70 ,33.33
02,000,01,003,0063,0,1126 ,6 ,1132 ,2094 ,0,3,1,3,0,1,0,76.14,54.06 ,33.33
02,000,01,003,0064,0,1445 ,18 ,1463 ,2761 ,0,3,1,3,0,1,0,76.14,52.99 ,33.33
02,000,01,003,0065,0,720 ,6 ,726 ,1264 ,0,3,1,3,0,1,0,76.14,57.44 ,33.33
02,000,01,003,0066,0,714 ,13 ,727 ,1292 ,0,3,1,3,0,1,0,76.14,56.27 ,33.33
02,000,01,003,0067,0,1266 ,7 ,1273 ,2431 ,0,3,1,3,0,1,0,76.14,52.37 ,33.33
02,000,01,003,0068,0,929 ,7 ,936 ,1670 ,0,3,1,3,0,1,0,76.14,56.05 ,33.33
02,000,01,003,0069,0,1353 ,6 ,1359 ,2557 ,0,3,1,3,0,1,0,76.14,53.15 ,33.33
02,000,01,003,0070,0,929 ,6 ,935 ,1624 ,0,3,1,3,0,1,0,76.14,57.57 ,33.33
02,000,01,003,0071,0,475 ,5 ,480 ,926 ,0,3,1,3,0,1,0,76.14,51.84 ,33.33
02,000,01,003,0072,0,1238 ,4 ,1242 ,2193 ,0,3,1,3,0,1,0,76.14,56.63 ,33.33
02,000,01,004,0073,0,934 ,10 ,944 ,2016 ,0,3,1,3,0,1,0,76.14,46.83 ,33.33
02,000,01,004,0074,0,779 ,4 ,783 ,1194 ,0,3,1,3,0,1,0,76.14,65.58 ,33.33
02,000,01,004,0075,0,363 ,6 ,369 ,591 ,0,3,1,3,0,1,0,76.14,62.44 ,33.33
02,000,01,004,0076,0,430 ,4 ,434 ,692 ,0,3,1,3,0,1,0,76.14,62.72 ,33.33
02,000,01,004,0077,0,346 ,6 ,352 ,566 ,0,3,1,3,0,1,0,76.14,62.19 ,33.33
02,000,01,004,0078,0,598 ,1 ,599 ,887 ,0,3,1,3,0,1,0,76.14,67.53 ,33.33
02,000,01,004,0079,0,653 ,3 ,656 ,1025 ,0,3,1,3,0,1,0,76.14,64.00 ,33.33
02,000,01,004,0080,0,521 ,1 ,522 ,817 ,0,3,1,3,0,1,0,76.14,63.89 ,33.33
02,000,01,004,0081,0,1802 ,12 ,1814 ,2890 ,0,3,1,3,0,1,0,76.14,62.77 ,33.33
02,000,01,004,0082,0,910 ,10 ,920 ,1436 ,0,3,1,3,0,1,0,76.14,64.07 ,33.33
02,000,01,004,0083,0,436 ,1 ,437 ,586 ,0,3,1,3,0,1,0,76.14,74.57 ,33.33
02,000,01,004,0084,0,1260 ,7 ,1267 ,1946 ,0,3,1,3,0,1,0,76.14,65.11 ,33.33
02,000,01,004,0085,0,824 ,2 ,826 ,1226 ,0,3,1,3,0,1,0,76.14,67.37 ,33.33
02,000,01,004,0086,0,1044 ,5 ,1049 ,1718 ,0,3,1,3,0,1,0,76.14,61.06 ,33.33
02,000,01,004,0087,0,1504 ,9 ,1513 ,2491 ,0,3,1,3,0,1,0,76.14,60.74 ,33.33
02,000,01,004,0088,0,920 ,2 ,922 ,1325 ,0,3,1,3,0,1,0,76.14,69.58 ,33.33
02,000,01,004,0089,0,56 ,0 ,56 ,158 ,0,3,1,3,0,1,0,76.14,35.44 ,33.33
02,000,01,004,0090,0,981 ,6 ,987 ,1505 ,0,3,1,3,0,1,0,76.14,65.58 ,33.33
02,000,01,004,0091,0,19 ,0 ,19 ,46 ,0,3,1,3,0,1,0,76.14,41.30 ,33.33
02,000,01,004,0092,0,766 ,3 ,769 ,1152 ,0,3,1,3,0,1,0,76.14,66.75 ,33.33
02,000,01,004,0093,0,598 ,4 ,602 ,914 ,0,3,1,3,0,1,0,76.14,65.86 ,33.33
02,000,01,004,0094,0,236 ,0 ,236 ,368 ,0,3,1,3,0,1,0,76.14,64.13 ,33.33
02,000,01,004,0095,0,344 ,0 ,344 ,583 ,0,3,1,3,0,1,0,76.14,59.01 ,33.33
02,000,01,004,0096,0,370 ,0 ,370 ,568 ,0,3,1,3,0,1,0,76.14,65.14 ,33.33
02,000,01,004,0097,0,480 ,2 ,482 ,768 ,0,3,1,3,0,1,0,76.14,62.76 ,33.33
02,000,01,004,0098,0,330 ,14 ,344 ,535 ,0,3,1,3,0,1,0,76.14,64.30 ,33.33
02,000,01,004,0099,0,458 ,0 ,458 ,713 ,0,3,1,3,0,1,0,76.14,64.24 ,33.33
02,000,01,004,0100,0,709 ,9 ,718 ,1091 ,0,3,1,3,0,1,0,76.14,65.81 ,33.33
02,000,01,004,0101,0,865 ,7 ,872 ,1418 ,0,3,1,3,0,1,0,76.14,61.50 ,33.33
02,000,01,004,0102,0,734 ,4 ,738 ,1184 ,0,3,1,3,0,1,0,76.14,62.33 ,33.33
02,000,01,004,0103,0,3891 ,13 ,3904 ,5654 ,0,3,1,3,0,1,0,76.14,69.05 ,33.33
02,000,01,004,0104,0,15 ,0 ,15 ,59 ,0,3,1,3,0,1,0,76.14,25.42 ,33.33
02,000,01,004,0105,0,783 ,3 ,786 ,1113 ,0,3,1,3,0,1,0,76.14,70.62 ,33.33
02,000,01,004,0106,0,1520 ,9 ,1529 ,2292 ,0,3,1,3,0,1,0,76.14,66.71 ,33.33
02,000,01,004,0107,0,1323 ,6 ,1329 ,1895 ,0,3,1,3,0,1,0,76.14,70.13 ,33.33
02,000,01,004,0108,0,960 ,4 ,964 ,1541 ,0,3,1,3,0,1,0,76.14,62.56 ,33.33
02,000,01,004,0109,0,1143 ,8 ,1151 ,1705 ,0,3,1,3,0,1,0,76.14,67.51 ,33.33
02,000,01,004,0110,0,5530 ,34 ,5564 ,9892 ,0,3,1,3,0,1,0,76.14,56.25 ,33.33
02,000,01,004,0111,0,10476 ,43 ,10519 ,19036 ,0,3,1,3,0,1,0,76.14,55.26 ,33.33
02,000,01,004,0112,0,2626 ,18 ,2644 ,4518 ,0,3,1,3,0,1,0,76.14,58.52 ,33.33
02,000,01,004,0113,0,5134 ,25 ,5159 ,9288 ,0,3,1,3,0,1,0,76.14,55.54 ,33.33
02,000,01,004,0114,0,9511 ,49 ,9560 ,18155 ,0,3,1,3,0,1,0,76.14,52.66 ,33.33
02,000,01,004,0115,0,10390 ,55 ,10445 ,20840 ,0,3,1,3,0,1,0,76.14,50.12 ,33.33
02,000,01,005,0116,0,5218 ,33 ,5251 ,9737 ,0,3,1,3,0,1,0,76.14,53.93 ,33.33
02,000,01,005,0117,0,1278 ,9 ,1287 ,2239 ,0,3,1,3,0,1,0,76.14,57.48 ,33.33
02,000,01,005,0118,0,2225 ,14 ,2239 ,4287 ,0,3,1,3,0,1,0,76.14,52.23 ,33.33
02,000,01,005,0119,0,1506 ,10 ,1516 ,2691 ,0,3,1,3,0,1,0,76.14,56.34 ,33.33
02,000,01,005,0120,0,1586 ,11 ,1597 ,2626 ,0,3,1,3,0,1,0,76.14,60.81 ,33.33
02,000,01,005,0121,0,1269 ,11 ,1280 ,2550 ,0,3,1,3,0,1,0,76.14,50.20 ,33.33
02,000,01,005,0122,0,1839 ,12 ,1851 ,3231 ,0,3,1,3,0,1,0,76.14,57.29 ,33.33
02,000,01,005,0123,0,1622 ,9 ,1631 ,3051 ,0,3,1,3,0,1,0,76.14,53.46 ,33.33
02,000,01,005,0124,0,1992 ,10 ,2002 ,3362 ,0,3,1,3,0,1,0,76.14,59.55 ,33.33
02,000,01,005,0125,0,1379 ,4 ,1383 ,2296 ,0,3,1,3,0,1,0,76.14,60.24 ,33.33
02,000,01,005,0126,0,1881 ,11 ,1892 ,3136 ,0,3,1,3,0,1,0,76.14,60.33 ,33.33
02,000,01,005,0127,0,951 ,7 ,958 ,1591 ,0,3,1,3,0,1,0,76.14,60.21 ,33.33
02,000,01,005,0128,0,1709 ,7 ,1716 ,3148 ,0,3,1,3,0,1,0,76.14,54.51 ,33.33
02,000,01,005,0129,0,5855 ,29 ,5884 ,10955 ,0,3,1,3,0,1,0,76.14,53.71 ,33.33
02,000,01,005,0130,0,1069 ,12 ,1081 ,1654 ,0,3,1,3,0,1,0,76.14,65.36 ,33.33
02,000,01,005,0131,0,1857 ,13 ,1870 ,2874 ,0,3,1,3,0,1,0,76.14,65.07 ,33.33
02,000,01,005,0132,0,1455 ,7 ,1462 ,2160 ,0,3,1,3,0,1,0,76.14,67.69 ,33.33
02,000,01,005,0133,0,1872 ,18 ,1890 ,3005 ,0,3,1,3,0,1,0,76.14,62.90 ,33.33
02,000,01,005,0134,0,1204 ,8 ,1212 ,2236 ,0,3,1,3,0,1,0,76.14,54.20 ,33.33
02,000,01,005,0135,0,1232 ,9 ,1241 ,1992 ,0,3,1,3,0,1,0,76.14,62.30 ,33.33
02,000,01,005,0136,0,2032 ,10 ,2042 ,3208 ,0,3,1,3,0,1,0,76.14,63.65 ,33.33
02,000,01,005,0137,0,1600 ,5 ,1605 ,2780 ,0,3,1,3,0,1,0,76.14,57.73 ,33.33
02,000,01,005,0138,0,926 ,7 ,933 ,1541 ,0,3,1,3,0,1,0,76.14,60.55 ,33.33
02,000,01,005,0139,0,1777 ,7 ,1784 ,3143 ,0,3,1,3,0,1,0,76.14,56.76 ,33.33
02,000,01,005,0140,0,1383 ,6 ,1389 ,2403 ,0,3,1,3,0,1,0,76.14,57.80 ,33.33
02,000,01,005,0141,0,1334 ,10 ,1344 ,2354 ,0,3,1,3,0,1,0,76.14,57.09 ,33.33
02,000,01,005,0142,0,1320 ,9 ,1329 ,2091 ,0,3,1,3,0,1,0,76.14,63.56 ,33.33
02,000,01,005,0143,0,1981 ,12 ,1993 ,3106 ,0,3,1,3,0,1,0,76.14,64.17 ,33.33
02,000,01,005,0144,0,1925 ,8 ,1933 ,3241 ,0,3,1,3,0,1,0,76.14,59.64 ,33.33
02,000,01,005,0145,0,1164 ,7 ,1171 ,2013 ,0,3,1,3,0,1,0,76.14,58.17 ,33.33
02,000,01,005,0146,0,1737 ,15 ,1752 ,2853 ,0,3,1,3,0,1,0,76.14,61.41 ,33.33
02,000,01,005,0147,0,1821 ,12 ,1833 ,3152 ,0,3,1,3,0,1,0,76.14,58.15 ,33.33
02,000,01,005,0148,0,3235 ,14 ,3249 ,5803 ,0,3,1,3,0,1,0,76.14,55.99 ,33.33
02,000,01,005,0149,0,1879 ,9 ,1888 ,3468 ,0,3,1,3,0,1,0,76.14,54.44 ,33.33
02,000,01,005,0150,0,591 ,34 ,625 ,1035 ,0,3,1,3,0,1,0,76.14,60.39 ,33.33
02,000,01,005,0151,0,498 ,2 ,500 ,847 ,0,3,1,3,0,1,0,76.14,59.03 ,33.33
02,000,01,005,0152,0,932 ,2 ,934 ,1487 ,0,3,1,3,0,1,0,76.14,62.81 ,33.33
02,000,01,006,0153,0,1677 ,9 ,1686 ,3106 ,0,3,1,3,0,1,0,76.14,54.28 ,33.33
02,000,01,006,0154,0,3138 ,29 ,3167 ,5867 ,0,3,1,3,0,1,0,76.14,53.98 ,33.33
02,000,01,006,0155,0,1873 ,4 ,1877 ,3437 ,0,3,1,3,0,1,0,76.14,54.61 ,33.33
02,000,01,006,0156,0,1907 ,16 ,1923 ,3414 ,0,3,1,3,0,1,0,76.14,56.33 ,33.33
02,000,01,006,0157,0,2943 ,21 ,2964 ,5523 ,0,3,1,3,0,1,0,76.14,53.67 ,33.33
02,000,01,006,0158,0,1927 ,12 ,1939 ,3116 ,0,3,1,3,0,1,0,76.14,62.23 ,33.33
02,000,01,006,0159,0,8997 ,42 ,9039 ,16308 ,0,3,1,3,0,1,0,76.14,55.43 ,33.33
02,000,01,006,0160,0,4302 ,29 ,4331 ,7418 ,0,3,1,3,0,1,0,76.14,58.39 ,33.33
02,000,01,006,0161,0,3247 ,22 ,3269 ,5881 ,0,3,1,3,0,1,0,76.14,55.59 ,33.33
02,000,01,006,0162,0,1216 ,9 ,1225 ,2029 ,0,3,1,3,0,1,0,76.14,60.37 ,33.33
02,000,01,006,0163,0,887 ,6 ,893 ,1508 ,0,3,1,3,0,1,0,76.14,59.22 ,33.33
02,000,01,006,0164,0,2442 ,16 ,2458 ,4406 ,0,3,1,3,0,1,0,76.14,55.79 ,33.33
02,000,01,006,0165,0,2134 ,13 ,2147 ,3789 ,0,3,1,3,0,1,0,76.14,56.66 ,33.33
02,000,01,006,0166,0,2329 ,11 ,2340 ,4109 ,0,3,1,3,0,1,0,76.14,56.95 ,33.33
02,000,01,006,0167,0,3649 ,18 ,3667 ,6516 ,0,3,1,3,0,1,0,76.14,56.28 ,33.33
02,000,01,006,0168,0,1935 ,12 ,1947 ,3434 ,0,3,1,3,0,1,0,76.14,56.70 ,33.33
02,000,01,006,0169,0,2449 ,17 ,2466 ,4468 ,0,3,1,3,0,1,0,76.14,55.19 ,33.33
02,000,01,006,0170,0,1561 ,6 ,1567 ,3115 ,0,3,1,3,0,1,0,76.14,50.30 ,33.33
02,000,01,006,0171,0,2964 ,19 ,2983 ,5265 ,0,3,1,3,0,1,0,76.14,56.66 ,33.33
02,000,01,006,0172,0,1597 ,6 ,1603 ,2668 ,0,3,1,3,0,1,0,76.14,60.08 ,33.33
02,000,01,006,0173,0,1637 ,4 ,1641 ,2789 ,0,3,1,3,0,1,0,76.14,58.84 ,33.33
02,000,01,006,0174,0,3415 ,21 ,3436 ,6399 ,0,3,1,3,0,1,0,76.14,53.70 ,33.33
02,000,01,006,0175,0,1477 ,9 ,1486 ,2636 ,0,3,1,3,0,1,0,76.14,56.37 ,33.33
02,000,01,006,0176,0,1281 ,5 ,1286 ,2433 ,0,3,1,3,0,1,0,76.14,52.86 ,33.33
02,000,01,006,0177,0,2260 ,10 ,2270 ,4177 ,0,3,1,3,0,1,0,76.14,54.35 ,33.33
02,000,01,006,0178,0,2334 ,13 ,2347 ,3950 ,0,3,1,3,0,1,0,76.14,59.42 ,33.33
02,000,01,006,0179,0,3103 ,15 ,3118 ,5900 ,0,3,1,3,0,1,0,76.14,52.85 ,33.33
02,000,01,006,0180,0,2238 ,8 ,2246 ,3921 ,0,3,1,3,0,1,0,76.14,57.28 ,33.33
02,000,01,006,0181,0,2541 ,17 ,2558 ,5230 ,0,3,1,3,0,1,0,76.14,48.91 ,33.33
02,000,01,006,0182,0,3683 ,31 ,3714 ,7034 ,0,3,1,3,0,1,0,76.14,52.80 ,33.33
02,000,01,006,0183,0,1593 ,4 ,1597 ,3029 ,0,3,1,3,0,1,0,76.14,52.72 ,33.33
02,000,01,006,0184,0,1490 ,9 ,1499 ,2902 ,0,3,1,3,0,1,0,76.14,51.65 ,33.33
02,000,01,006,0185,0,2274 ,13 ,2287 ,4003 ,0,3,1,3,0,1,0,76.14,57.13 ,33.33
02,000,01,006,0186,0,1448 ,10 ,1458 ,2611 ,0,3,1,3,0,1,0,76.14,55.84 ,33.33
02,000,01,006,0187,0,1201 ,7 ,1208 ,2018 ,0,3,1,3,0,1,0,76.14,59.86 ,33.33
02,000,01,006,0188,0,1919 ,13 ,1932 ,3229 ,0,3,1,3,0,1,0,76.14,59.83 ,33.33
02,000,01,006,0189,0,1567 ,20 ,1587 ,2951 ,0,3,1,3,0,1,0,76.14,53.78 ,33.33
02,000,01,006,0190,0,4667 ,34 ,4701 ,8910 ,0,3,1,3,0,1,0,76.14,52.76 ,33.33
02,000,01,006,0191,0,1926 ,13 ,1939 ,3281 ,0,3,1,3,0,1,0,76.14,59.10 ,33.33
02,000,01,006,0192,0,911 ,4 ,915 ,1506 ,0,3,1,3,0,1,0,76.14,60.76 ,33.33
02,000,01,006,0193,0,1074 ,7 ,1081 ,1980 ,0,3,1,3,0,1,0,76.14,54.60 ,33.33
02,000,01,006,0194,0,1584 ,3 ,1587 ,2911 ,0,3,1,3,0,1,0,76.14,54.52 ,33.33
02,000,01,006,0195,0,1067 ,10 ,1077 ,2016 ,0,3,1,3,0,1,0,76.14,53.42 ,33.33
02,000,01,006,0196,0,2175 ,11 ,2186 ,4224 ,0,3,1,3,0,1,0,76.14,51.75 ,33.33
02,000,01,006,0197,0,2278 ,21 ,2299 ,4133 ,0,3,1,3,0,1,0,76.14,55.63 ,33.33
02,000,01,006,0198,0,1897 ,7 ,1904 ,3123 ,0,3,1,3,0,1,0,76.14,60.97 ,33.33
02,000,01,006,0199,0,1614 ,5 ,1619 ,2657 ,0,3,1,3,0,1,0,76.14,60.93 ,33.33
02,000,01,006,0200,0,875 ,4 ,879 ,1428 ,0,3,1,3,0,1,0,76.14,61.55 ,33.33
02,000,01,006,0201,0,1034 ,7 ,1041 ,1666 ,0,3,1,3,0,1,0,76.14,62.48 ,33.33
02,000,01,006,0202,0,900 ,6 ,906 ,1443 ,0,3,1,3,0,1,0,76.14,62.79 ,33.33
02,000,01,006,0203,0,616 ,3 ,619 ,1056 ,0,3,1,3,0,1,0,76.14,58.62 ,33.33
02,000,01,006,0204,0,1623 ,9 ,1632 ,2752 ,0,3,1,3,0,1,0,76.14,59.30 ,33.33
02,000,01,006,0205,0,1465 ,9 ,1474 ,2415 ,0,3,1,3,0,1,0,76.14,61.04 ,33.33
02,000,01,006,0206,0,1078 ,4 ,1082 ,1915 ,0,3,1,3,0,1,0,76.14,56.50 ,33.33
02,000,01,006,0207,0,1035 ,8 ,1043 ,1667 ,0,3,1,3,0,1,0,76.14,62.57 ,33.33
02,000,01,006,0208,0,527 ,6 ,533 ,874 ,0,3,1,3,0,1,0,76.14,60.98 ,33.33
02,000,01,006,0209,0,653 ,0 ,653 ,1102 ,0,3,1,3,0,1,0,76.14,59.26 ,33.33
02,000,01,006,0210,0,994 ,5 ,999 ,1586 ,0,3,1,3,0,1,0,76.14,62.99 ,33.33
02,000,01,006,0211,0,1262 ,5 ,1267 ,2029 ,0,3,1,3,0,1,0,76.14,62.44 ,33.33
02,000,01,006,0212,0,1878 ,15 ,1893 ,3162 ,0,3,1,3,0,1,0,76.14,59.87 ,33.33
02,000,01,006,0213,0,2217 ,19 ,2236 ,3925 ,0,3,1,3,0,1,0,76.14,56.97 ,33.33
02,000,01,006,0214,0,2141 ,13 ,2154 ,3946 ,0,3,1,3,0,1,0,76.14,54.59 ,33.33
02,000,01,006,0215,0,905 ,3 ,908 ,1557 ,0,3,1,3,0,1,0,76.14,58.32 ,33.33
02,000,01,006,0216,0,1018 ,7 ,1025 ,1767 ,0,3,1,3,0,1,0,76.14,58.01 ,33.33
02,000,01,006,0217,0,1140 ,4 ,1144 ,2039 ,0,3,1,3,0,1,0,76.14,56.11 ,33.33
02,000,01,006,0218,0,581 ,7 ,588 ,918 ,0,3,1,3,0,1,0,76.14,64.05 ,33.33
02,000,01,006,0219,0,666 ,0 ,666 ,1069 ,0,3,1,3,0,1,0,76.14,62.30 ,33.33
02,000,01,006,0220,0,758 ,3 ,761 ,1416 ,0,3,1,3,0,1,0,76.14,53.74 ,33.33
02,000,01,006,0221,0,762 ,1 ,763 ,1393 ,0,3,1,3,0,1,0,76.14,54.77 ,33.33
02,000,01,006,0222,0,460 ,5 ,465 ,827 ,0,3,1,3,0,1,0,76.14,56.23 ,33.33
02,000,01,006,0223,0,277 ,0 ,277 ,403 ,0,3,1,3,0,1,0,76.14,68.73 ,33.33
02,000,01,006,0224,0,656 ,3 ,659 ,1163 ,0,3,1,3,0,1,0,76.14,56.66 ,33.33
02,000,01,006,0225,0,2310 ,7 ,2317 ,3977 ,0,3,1,3,0,1,0,76.14,58.26 ,33.33
02,000,01,006,0226,0,653 ,1 ,654 ,1143 ,0,3,1,3,0,1,0,76.14,57.22 ,33.33
02,000,01,006,0227,0,537 ,5 ,542 ,1109 ,0,3,1,3,0,1,0,76.14,48.87 ,33.33
02,000,01,006,0228,0,925 ,8 ,933 ,1674 ,0,3,1,3,0,1,0,76.14,55.73 ,33.33
02,000,01,006,0229,0,698 ,2 ,700 ,1114 ,0,3,1,3,0,1,0,76.14,62.84 ,33.33
02,000,01,006,0230,0,1099 ,6 ,1105 ,1861 ,0,3,1,3,0,1,0,76.14,59.38 ,33.33
02,000,01,006,0231,0,698 ,7 ,705 ,1209 ,0,3,1,3,0,1,0,76.14,58.31 ,33.33
02,000,01,006,0232,0,255 ,4 ,259 ,398 ,0,3,1,3,0,1,0,76.14,65.08 ,33.33
02,000,01,006,0233,0,1511 ,7 ,1518 ,2637 ,0,3,1,3,0,1,0,76.14,57.57 ,33.33
02,000,01,006,0234,0,1132 ,10 ,1142 ,1900 ,0,3,1,3,0,1,0,76.14,60.11 ,33.33
02,000,01,006,0235,0,536 ,6 ,542 ,844 ,0,3,1,3,0,1,0,76.14,64.22 ,33.33
02,000,01,006,0236,0,777 ,5 ,782 ,1139 ,0,3,1,3,0,1,0,76.14,68.66 ,33.33
02,000,01,006,0237,0,718 ,7 ,725 ,1176 ,0,3,1,3,0,1,0,76.14,61.65 ,33.33
02,000,01,006,0238,0,788 ,2 ,790 ,1326 ,0,3,1,3,0,1,0,76.14,59.58 ,33.33
02,000,01,006,0239,0,749 ,7 ,756 ,1275 ,0,3,1,3,0,1,0,76.14,59.29 ,33.33
02,000,01,006,0240,0,1366 ,6 ,1372 ,2354 ,0,3,1,3,0,1,0,76.14,58.28 ,33.33
02,000,02,007,0241,0,1126 ,5 ,1131 ,1928 ,0,3,1,3,0,1,0,76.14,58.66 ,33.33
02,000,02,007,0242,0,668 ,1 ,669 ,1253 ,0,3,1,3,0,1,0,76.14,53.39 ,33.33
02,000,02,007,0243,0,1369 ,6 ,1375 ,2560 ,0,3,1,3,0,1,0,76.14,53.71 ,33.33
02,000,02,007,0244,0,761 ,6 ,767 ,1294 ,0,3,1,3,0,1,0,76.14,59.27 ,33.33
02,000,02,007,0245,0,988 ,7 ,995 ,1588 ,0,3,1,3,0,1,0,76.14,62.66 ,33.33
02,000,02,007,0246,0,413 ,8 ,421 ,735 ,0,3,1,3,0,1,0,76.14,57.28 ,33.33
02,000,02,007,0247,0,453 ,1 ,454 ,863 ,0,3,1,3,0,1,0,76.14,52.61 ,33.33
02,000,02,007,0248,0,1085 ,5 ,1090 ,2023 ,0,3,1,3,0,1,0,76.14,53.88 ,33.33
02,000,02,007,0249,0,610 ,6 ,616 ,1028 ,0,3,1,3,0,1,0,76.14,59.92 ,33.33
02,000,02,007,0250,0,489 ,3 ,492 ,798 ,0,3,1,3,0,1,0,76.14,61.65 ,33.33
02,000,02,007,0251,0,780 ,7 ,787 ,1456 ,0,3,1,3,0,1,0,76.14,54.05 ,33.33
02,000,02,007,0252,0,624 ,8 ,632 ,1077 ,0,3,1,3,0,1,0,76.14,58.68 ,33.33
02,000,02,007,0253,0,1286 ,4 ,1290 ,2077 ,0,3,1,3,0,1,0,76.14,62.11 ,33.33
02,000,02,007,0254,0,1487 ,8 ,1495 ,2606 ,0,3,1,3,0,1,0,76.14,57.37 ,33.33
02,000,02,007,0255,0,1409 ,7 ,1416 ,2400 ,0,3,1,3,0,1,0,76.14,59.00 ,33.33
02,000,02,007,0256,0,1082 ,4 ,1086 ,1786 ,0,3,1,3,0,1,0,76.14,60.81 ,33.33
02,000,02,007,0257,0,1773 ,13 ,1786 ,2995 ,0,3,1,3,0,1,0,76.14,59.63 ,33.33
02,000,02,007,0258,0,698 ,5 ,703 ,1136 ,0,3,1,3,0,1,0,76.14,61.88 ,33.33
02,000,02,007,0259,0,631 ,2 ,633 ,1129 ,0,3,1,3,0,1,0,76.14,56.07 ,33.33
02,000,02,007,0260,0,501 ,3 ,504 ,922 ,0,3,1,3,0,1,0,76.14,54.66 ,33.33
02,000,02,007,0261,0,535 ,4 ,539 ,887 ,0,3,1,3,0,1,0,76.14,60.77 ,33.33
02,000,02,007,0262,0,1347 ,8 ,1355 ,2205 ,0,3,1,3,0,1,0,76.14,61.45 ,33.33
02,000,02,007,0263,0,1337 ,10 ,1347 ,2693 ,0,3,1,3,0,1,0,76.14,50.02 ,33.33
02,000,02,007,0264,0,486 ,2 ,488 ,826 ,0,3,1,3,0,1,0,76.14,59.08 ,33.33
02,000,02,007,0265,0,676 ,0 ,676 ,1169 ,0,3,1,3,0,1,0,76.14,57.83 ,33.33
02,000,02,007,0266,0,543 ,4 ,547 ,948 ,0,3,1,3,0,1,0,76.14,57.70 ,33.33
02,000,02,007,0267,0,522 ,4 ,526 ,948 ,0,3,1,3,0,1,0,76.14,55.49 ,33.33
02,000,02,007,0268,0,545 ,2 ,547 ,908 ,0,3,1,3,0,1,0,76.14,60.24 ,33.33
02,000,02,007,0269,0,545 ,3 ,548 ,968 ,0,3,1,3,0,1,0,76.14,56.61 ,33.33
02,000,02,007,0270,0,525 ,2 ,527 ,842 ,0,3,1,3,0,1,0,76.14,62.59 ,33.33
02,000,02,007,0271,0,465 ,1 ,466 ,784 ,0,3,1,3,0,1,0,76.14,59.44 ,33.33
02,000,02,007,0272,0,782 ,8 ,790 ,1349 ,0,3,1,3,0,1,0,76.14,58.56 ,33.33
02,000,02,008,0273,0,469 ,2 ,471 ,784 ,0,3,1,3,0,1,0,76.14,60.08 ,33.33
02,000,02,008,0274,0,643 ,5 ,648 ,1151 ,0,3,1,3,0,1,0,76.14,56.30 ,33.33
02,000,02,008,0275,0,811 ,6 ,817 ,1417 ,0,3,1,3,0,1,0,76.14,57.66 ,33.33
02,000,02,008,0276,0,527 ,2 ,529 ,904 ,0,3,1,3,0,1,0,76.14,58.52 ,33.33
02,000,02,008,0277,0,525 ,4 ,529 ,911 ,0,3,1,3,0,1,0,76.14,58.07 ,33.33
02,000,02,008,0278,0,1681 ,11 ,1692 ,3029 ,0,3,1,3,0,1,0,76.14,55.86 ,33.33
02,000,02,008,0279,0,548 ,3 ,551 ,926 ,0,3,1,3,0,1,0,76.14,59.50 ,33.33
02,000,02,008,0280,0,613 ,5 ,618 ,1148 ,0,3,1,3,0,1,0,76.14,53.83 ,33.33
02,000,02,008,0281,0,793 ,3 ,796 ,1416 ,0,3,1,3,0,1,0,76.14,56.21 ,33.33
02,000,02,008,0282,0,417 ,2 ,419 ,745 ,0,3,1,3,0,1,0,76.14,56.24 ,33.33
02,000,02,008,0283,0,603 ,3 ,606 ,1044 ,0,3,1,3,0,1,0,76.14,58.05 ,33.33
02,000,02,008,0284,0,684 ,2 ,686 ,1257 ,0,3,1,3,0,1,0,76.14,54.57 ,33.33
02,000,02,008,0285,0,596 ,2 ,598 ,1080 ,0,3,1,3,0,1,0,76.14,55.37 ,33.33
02,000,02,008,0286,0,1017 ,5 ,1022 ,1711 ,0,3,1,3,0,1,0,76.14,59.73 ,33.33
02,000,02,008,0287,0,605 ,5 ,610 ,1163 ,0,3,1,3,0,1,0,76.14,52.45 ,33.33
02,000,02,008,0288,0,507 ,5 ,512 ,949 ,0,3,1,3,0,1,0,76.14,53.95 ,33.33
02,000,02,008,0289,0,825 ,3 ,828 ,1536 ,0,3,1,3,0,1,0,76.14,53.91 ,33.33
02,000,02,008,0290,0,747 ,8 ,755 ,1263 ,0,3,1,3,0,1,0,76.14,59.78 ,33.33
02,000,02,008,0291,0,657 ,2 ,659 ,1085 ,0,3,1,3,0,1,0,76.14,60.74 ,33.33
02,000,02,008,0292,0,775 ,3 ,778 ,1361 ,0,3,1,3,0,1,0,76.14,57.16 ,33.33
02,000,02,009,0293,0,339 ,1 ,340 ,584 ,0,3,1,3,0,1,0,76.14,58.22 ,33.33
02,000,02,009,0294,0,805 ,3 ,808 ,1333 ,0,3,1,3,0,1,0,76.14,60.62 ,33.33
02,000,02,009,0295,0,859 ,6 ,865 ,1423 ,0,3,1,3,0,1,0,76.14,60.79 ,33.33
02,000,02,009,0296,0,966 ,7 ,973 ,1664 ,0,3,1,3,0,1,0,76.14,58.47 ,33.33
02,000,02,009,0297,0,836 ,2 ,838 ,1460 ,0,3,1,3,0,1,0,76.14,57.40 ,33.33
02,000,02,009,0298,0,865 ,8 ,873 ,1530 ,0,3,1,3,0,1,0,76.14,57.06 ,33.33
02,000,02,009,0299,0,821 ,6 ,827 ,1560 ,0,3,1,3,0,1,0,76.14,53.01 ,33.33
02,000,02,009,0300,0,395 ,3 ,398 ,692 ,0,3,1,3,0,1,0,76.14,57.51 ,33.33
02,000,02,009,0301,0,1004 ,6 ,1010 ,1840 ,0,3,1,3,0,1,0,76.14,54.89 ,33.33
02,000,02,009,0302,0,1297 ,9 ,1306 ,2707 ,0,3,1,3,0,1,0,76.14,48.25 ,33.33
02,000,02,009,0303,0,691 ,4 ,695 ,1154 ,0,3,1,3,0,1,0,76.14,60.23 ,33.33
02,000,02,009,0304,0,888 ,7 ,895 ,1437 ,0,3,1,3,0,1,0,76.14,62.28 ,33.33
02,000,02,009,0305,0,1043 ,2 ,1045 ,1868 ,0,3,1,3,0,1,0,76.14,55.94 ,33.33
02,000,02,009,0306,0,748 ,7 ,755 ,1415 ,0,3,1,3,0,1,0,76.14,53.36 ,33.33
02,000,02,009,0307,0,1257 ,6 ,1263 ,1971 ,0,3,1,3,0,1,0,76.14,64.08 ,33.33
02,000,02,009,0308,0,744 ,2 ,746 ,1258 ,0,3,1,3,0,1,0,76.14,59.30 ,33.33
02,000,02,009,0309,0,1631 ,7 ,1638 ,3031 ,0,3,1,3,0,1,0,76.14,54.04 ,33.33
02,000,02,009,0310,0,1274 ,4 ,1278 ,2285 ,0,3,1,3,0,1,0,76.14,55.93 ,33.33
02,000,02,009,0311,0,1528 ,8 ,1536 ,2639 ,0,3,1,3,0,1,0,76.14,58.20 ,33.33
02,000,02,009,0312,0,1338 ,5 ,1343 ,2153 ,0,3,1,3,0,1,0,76.14,62.38 ,33.33
02,000,02,009,0313,0,706 ,3 ,709 ,1715 ,0,3,1,3,0,1,0,76.14,41.34 ,33.33
02,000,02,009,0314,0,1625 ,4 ,1629 ,2831 ,0,3,1,3,0,1,0,76.14,57.54 ,33.33
02,000,02,009,0315,0,1025 ,4 ,1029 ,1797 ,0,3,1,3,0,1,0,76.14,57.26 ,33.33
02,000,02,009,0316,0,1169 ,8 ,1177 ,2164 ,0,3,1,3,0,1,0,76.14,54.39 ,33.33
02,000,02,009,0317,0,947 ,6 ,953 ,1556 ,0,3,1,3,0,1,0,76.14,61.25 ,33.33
02,000,02,009,0318,0,472 ,3 ,475 ,780 ,0,3,1,3,0,1,0,76.14,60.90 ,33.33
02,000,02,009,0319,0,810 ,5 ,815 ,1444 ,0,3,1,3,0,1,0,76.14,56.44 ,33.33
02,000,02,009,0320,0,1745 ,11 ,1756 ,3013 ,0,3,1,3,0,1,0,76.14,58.28 ,33.33
02,000,02,009,0321,0,970 ,13 ,983 ,1795 ,0,3,1,3,0,1,0,76.14,54.76 ,33.33
02,000,02,009,0322,0,1825 ,10 ,1835 ,3262 ,0,3,1,3,0,1,0,76.14,56.25 ,33.33
02,000,02,009,0323,0,1067 ,3 ,1070 ,1832 ,0,3,1,3,0,1,0,76.14,58.41 ,33.33
02,000,02,009,0324,0,1604 ,8 ,1612 ,2844 ,0,3,1,3,0,1,0,76.14,56.68 ,33.33
02,000,02,009,0325,0,1413 ,5 ,1418 ,2559 ,0,3,1,3,0,1,0,76.14,55.41 ,33.33
02,000,02,009,0326,0,721 ,2 ,723 ,1414 ,0,3,1,3,0,1,0,76.14,51.13 ,33.33
02,000,02,009,0327,0,945 ,6 ,951 ,1547 ,0,3,1,3,0,1,0,76.14,61.47 ,33.33
02,000,02,009,0328,0,1219 ,7 ,1226 ,1902 ,0,3,1,3,0,1,0,76.14,64.46 ,33.33
02,000,02,009,0329,0,1321 ,7 ,1328 ,2379 ,0,3,1,3,0,1,0,76.14,55.82 ,33.33
02,000,02,009,0330,0,1006 ,4 ,1010 ,1622 ,0,3,1,3,0,1,0,76.14,62.27 ,33.33
02,000,02,009,0331,0,963 ,5 ,968 ,1535 ,0,3,1,3,0,1,0,76.14,63.06 ,33.33
02,000,02,009,0332,0,1417 ,10 ,1427 ,2347 ,0,3,1,3,0,1,0,76.14,60.80 ,33.33
02,000,02,009,0333,0,1157 ,2 ,1159 ,1979 ,0,3,1,3,0,1,0,76.14,58.56 ,33.33
02,000,02,009,0334,0,2201 ,8 ,2209 ,3874 ,0,3,1,3,0,1,0,76.14,57.02 ,33.33
02,000,02,009,0335,0,980 ,7 ,987 ,1687 ,0,3,1,3,0,1,0,76.14,58.51 ,33.33
02,000,02,009,0336,0,800 ,3 ,803 ,1361 ,0,3,1,3,0,1,0,76.14,59.00 ,33.33
02,000,02,009,0337,0,2299 ,10 ,2309 ,3951 ,0,3,1,3,0,1,0,76.14,58.44 ,33.33
02,000,02,009,0338,0,1164 ,8 ,1172 ,2036 ,0,3,1,3,0,1,0,76.14,57.56 ,33.33
02,000,02,009,0339,0,913 ,6 ,919 ,1547 ,0,3,1,3,0,1,0,76.14,59.41 ,33.33
02,000,02,009,0340,0,890 ,2 ,892 ,1501 ,0,3,1,3,0,1,0,76.14,59.43 ,33.33
02,000,02,009,0341,0,1564 ,7 ,1571 ,2741 ,0,3,1,3,0,1,0,76.14,57.31 ,33.33
02,000,02,009,0342,0,817 ,6 ,823 ,1335 ,0,3,1,3,0,1,0,76.14,61.65 ,33.33
02,000,02,009,0343,0,607 ,9 ,616 ,1019 ,0,3,1,3,0,1,0,76.14,60.45 ,33.33
02,000,02,009,0344,0,1154 ,4 ,1158 ,1943 ,0,3,1,3,0,1,0,76.14,59.60 ,33.33
02,000,02,009,0345,0,1243 ,11 ,1254 ,2175 ,0,3,1,3,0,1,0,76.14,57.66 ,33.33
02,000,02,009,0346,0,1773 ,18 ,1791 ,2899 ,0,3,1,3,0,1,0,76.14,61.78 ,33.33
02,000,02,009,0347,0,1659 ,11 ,1670 ,2835 ,0,3,1,3,0,1,0,76.14,58.91 ,33.33
02,000,02,009,0348,0,1404 ,10 ,1414 ,2555 ,0,3,1,3,0,1,0,76.14,55.34 ,33.33
02,000,02,009,0349,0,1138 ,6 ,1144 ,2003 ,0,3,1,3,0,1,0,76.14,57.11 ,33.33
02,000,02,009,0350,0,1381 ,11 ,1392 ,2354 ,0,3,1,3,0,1,0,76.14,59.13 ,33.33
02,000,02,009,0351,0,954 ,4 ,958 ,1782 ,0,3,1,3,0,1,0,76.14,53.76 ,33.33
02,000,02,009,0352,0,1445 ,15 ,1460 ,2721 ,0,3,1,3,0,1,0,76.14,53.66 ,33.33
02,000,02,009,0353,0,2291 ,15 ,2306 ,4595 ,0,3,1,3,0,1,0,76.14,50.18 ,33.33
02,000,02,009,0354,0,2174 ,15 ,2189 ,3899 ,0,3,1,3,0,1,0,76.14,56.14 ,33.33
02,000,02,009,0355,0,2017 ,8 ,2025 ,3610 ,0,3,1,3,0,1,0,76.14,56.09 ,33.33
02,000,02,009,0356,0,2304 ,15 ,2319 ,4135 ,0,3,1,3,0,1,0,76.14,56.08 ,33.33
02,000,02,009,0357,0,1415 ,9 ,1424 ,2349 ,0,3,1,3,0,1,0,76.14,60.62 ,33.33
02,000,02,009,0358,0,1265 ,7 ,1272 ,2425 ,0,3,1,3,0,1,0,76.14,52.45 ,33.33
02,000,02,009,0359,0,2251 ,12 ,2263 ,3850 ,0,3,1,3,0,1,0,76.14,58.78 ,33.33
02,000,02,009,0360,0,1208 ,10 ,1218 ,2066 ,0,3,1,3,0,1,0,76.14,58.95 ,33.33
02,000,02,009,0361,0,1225 ,11 ,1236 ,2128 ,0,3,1,3,0,1,0,76.14,58.08 ,33.33
02,000,02,010,0362,0,4314 ,28 ,4342 ,8072 ,0,3,1,3,0,1,0,76.14,53.79 ,33.33
02,000,02,010,0363,0,1406 ,12 ,1418 ,2405 ,0,3,1,3,0,1,0,76.14,58.96 ,33.33
02,000,02,010,0364,0,1870 ,9 ,1879 ,3171 ,0,3,1,3,0,1,0,76.14,59.26 ,33.33
02,000,02,010,0365,0,1114 ,9 ,1123 ,1816 ,0,3,1,3,0,1,0,76.14,61.84 ,33.33
02,000,02,010,0366,0,864 ,3 ,867 ,1434 ,0,3,1,3,0,1,0,76.14,60.46 ,33.33
02,000,02,010,0367,0,1156 ,7 ,1163 ,1870 ,0,3,1,3,0,1,0,76.14,62.19 ,33.33
02,000,02,010,0368,0,1081 ,5 ,1086 ,2226 ,0,3,1,3,0,1,0,76.14,48.79 ,33.33
02,000,02,010,0369,0,427 ,3 ,430 ,707 ,0,3,1,3,0,1,0,76.14,60.82 ,33.33
02,000,02,010,0370,0,1040 ,8 ,1048 ,1727 ,0,3,1,3,0,1,0,76.14,60.68 ,33.33
02,000,02,010,0371,0,992 ,10 ,1002 ,1554 ,0,3,1,3,0,1,0,76.14,64.48 ,33.33
02,000,02,010,0372,0,1434 ,15 ,1449 ,2436 ,0,3,1,3,0,1,0,76.14,59.48 ,33.33
02,000,02,010,0373,0,777 ,7 ,784 ,1274 ,0,3,1,3,0,1,0,76.14,61.54 ,33.33
02,000,02,010,0374,0,481 ,1 ,482 ,766 ,0,3,1,3,0,1,0,76.14,62.92 ,33.33
02,000,02,010,0375,0,497 ,6 ,503 ,875 ,0,3,1,3,0,1,0,76.14,57.49 ,33.33
02,000,02,010,0376,0,882 ,6 ,888 ,1479 ,0,3,1,3,0,1,0,76.14,60.04 ,33.33
02,000,02,010,0377,0,1201 ,10 ,1211 ,1919 ,0,3,1,3,0,1,0,76.14,63.11 ,33.33
02,000,02,010,0378,0,1429 ,8 ,1437 ,2296 ,0,3,1,3,0,1,0,76.14,62.59 ,33.33
02,000,02,010,0379,0,1282 ,39 ,1321 ,2050 ,0,3,1,3,0,1,0,76.14,64.44 ,33.33
02,000,02,010,0380,0,2251 ,9 ,2260 ,3868 ,0,3,1,3,0,1,0,76.14,58.43 ,33.33
02,000,02,010,0381,0,758 ,8 ,766 ,1140 ,0,3,1,3,0,1,0,76.14,67.19 ,33.33
02,000,02,010,0382,0,1172 ,7 ,1179 ,2010 ,0,3,1,3,0,1,0,76.14,58.66 ,33.33
02,000,02,010,0383,0,553 ,6 ,559 ,856 ,0,3,1,3,0,1,0,76.14,65.30 ,33.33
02,000,02,010,0384,0,706 ,5 ,711 ,1033 ,0,3,1,3,0,1,0,76.14,68.83 ,33.33
02,000,02,010,0385,0,2806 ,17 ,2823 ,4338 ,0,3,1,3,0,1,0,76.14,65.08 ,33.33
02,000,02,010,0386,0,1459 ,4 ,1463 ,2066 ,0,3,1,3,0,1,0,76.14,70.81 ,33.33
02,000,02,010,0387,0,1948 ,14 ,1962 ,3323 ,0,3,1,3,0,1,0,76.14,59.04 ,33.33
02,000,02,010,0388,0,2275 ,19 ,2294 ,3802 ,0,3,1,3,0,1,0,76.14,60.34 ,33.33
02,000,02,010,0389,0,485 ,0 ,485 ,841 ,0,3,1,3,0,1,0,76.14,57.67 ,33.33
02,000,02,010,0390,0,1073 ,9 ,1082 ,1928 ,0,3,1,3,0,1,0,76.14,56.12 ,33.33
02,000,02,010,0391,0,1495 ,11 ,1506 ,2603 ,0,3,1,3,0,1,0,76.14,57.86 ,33.33
02,000,02,010,0392,0,1146 ,51 ,1197 ,1940 ,0,3,1,3,0,1,0,76.14,61.70 ,33.33
02,000,02,010,0393,0,1350 ,9 ,1359 ,2512 ,0,3,1,3,0,1,0,76.14,54.10 ,33.33
02,000,02,010,0394,0,1600 ,10 ,1610 ,2845 ,0,3,1,3,0,1,0,76.14,56.59 ,33.33
02,000,02,010,0395,0,1681 ,14 ,1695 ,3098 ,0,3,1,3,0,1,0,76.14,54.71 ,33.33
02,000,02,010,0396,0,2616 ,13 ,2629 ,4621 ,0,3,1,3,0,1,0,76.14,56.89 ,33.33
02,000,02,010,0397,0,1416 ,14 ,1430 ,2347 ,0,3,1,3,0,1,0,76.14,60.93 ,33.33
02,000,02,010,0398,0,1717 ,6 ,1723 ,2850 ,0,3,1,3,0,1,0,76.14,60.46 ,33.33
02,000,02,010,0399,0,1622 ,12 ,1634 ,2593 ,0,3,1,3,0,1,0,76.14,63.02 ,33.33
02,000,02,010,0400,0,1136 ,7 ,1143 ,2115 ,0,3,1,3,0,1,0,76.14,54.04 ,33.33
02,000,02,010,0401,0,1521 ,9 ,1530 ,2706 ,0,3,1,3,0,1,0,76.14,56.54 ,33.33
02,000,02,010,0402,0,1123 ,6 ,1129 ,2012 ,0,3,1,3,0,1,0,76.14,56.11 ,33.33
02,000,02,010,0403,0,2333 ,19 ,2352 ,3820 ,0,3,1,3,0,1,0,76.14,61.57 ,33.33
02,000,02,010,0404,0,1642 ,3 ,1645 ,2804 ,0,3,1,3,0,1,0,76.14,58.67 ,33.33
02,000,02,010,0405,0,733 ,6 ,739 ,1278 ,0,3,1,3,0,1,0,76.14,57.82 ,33.33
02,000,02,010,0406,0,2684 ,20 ,2704 ,4550 ,0,3,1,3,0,1,0,76.14,59.43 ,33.33
02,000,02,010,0407,0,1442 ,8 ,1450 ,2301 ,0,3,1,3,0,1,0,76.14,63.02 ,33.33
02,000,02,010,0408,0,2731 ,14 ,2745 ,4716 ,0,3,1,3,0,1,0,76.14,58.21 ,33.33
02,000,02,010,0409,0,1447 ,6 ,1453 ,2409 ,0,3,1,3,0,1,0,76.14,60.32 ,33.33
02,000,02,010,0410,0,1164 ,24 ,1188 ,2028 ,0,3,1,3,0,1,0,76.14,58.58 ,33.33
02,000,02,010,0411,0,2173 ,15 ,2188 ,3641 ,0,3,1,3,0,1,0,76.14,60.09 ,33.33
02,000,02,010,0412,0,1941 ,11 ,1952 ,3524 ,0,3,1,3,0,1,0,76.14,55.39 ,33.33
02,000,02,010,0413,0,1627 ,10 ,1637 ,2878 ,0,3,1,3,0,1,0,76.14,56.88 ,33.33
02,000,02,010,0414,0,1633 ,6 ,1639 ,2599 ,0,3,1,3,0,1,0,76.14,63.06 ,33.33
02,000,02,010,0415,0,1510 ,6 ,1516 ,2516 ,0,3,1,3,0,1,0,76.14,60.25 ,33.33
02,000,02,010,0416,0,1476 ,11 ,1487 ,2610 ,0,3,1,3,0,1,0,76.14,56.97 ,33.33
02,000,02,010,0417,0,1322 ,22 ,1344 ,2421 ,0,3,1,3,0,1,0,76.14,55.51 ,33.33
02,000,02,010,0418,0,1309 ,7 ,1316 ,2394 ,0,3,1,3,0,1,0,76.14,54.97 ,33.33
02,000,02,010,0419,0,2339 ,37 ,2376 ,4261 ,0,3,1,3,0,1,0,76.14,55.76 ,33.33
02,000,02,010,0420,0,1512 ,7 ,1519 ,2723 ,0,3,1,3,0,1,0,76.14,55.78 ,33.33
02,000,02,011,0421,0,1022 ,5 ,1027 ,1732 ,0,3,1,3,0,1,0,76.14,59.30 ,33.33
02,000,02,011,0422,0,1925 ,10 ,1935 ,3214 ,0,3,1,3,0,1,0,76.14,60.21 ,33.33
02,000,02,011,0423,0,1391 ,10 ,1401 ,2422 ,0,3,1,3,0,1,0,76.14,57.84 ,33.33
02,000,02,011,0424,0,929 ,9 ,938 ,1560 ,0,3,1,3,0,1,0,76.14,60.13 ,33.33
02,000,02,011,0425,0,1594 ,11 ,1605 ,2844 ,0,3,1,3,0,1,0,76.14,56.43 ,33.33
02,000,02,011,0426,0,1084 ,5 ,1089 ,1877 ,0,3,1,3,0,1,0,76.14,58.02 ,33.33
02,000,02,011,0427,0,885 ,4 ,889 ,1650 ,0,3,1,3,0,1,0,76.14,53.88 ,33.33
02,000,02,011,0428,0,1237 ,6 ,1243 ,2020 ,0,3,1,3,0,1,0,76.14,61.53 ,33.33
02,000,02,011,0429,0,1027 ,7 ,1034 ,1867 ,0,3,1,3,0,1,0,76.14,55.38 ,33.33
02,000,02,011,0430,0,2498 ,20 ,2518 ,4560 ,0,3,1,3,0,1,0,76.14,55.22 ,33.33
02,000,02,011,0431,0,1298 ,8 ,1306 ,2199 ,0,3,1,3,0,1,0,76.14,59.39 ,33.33
02,000,02,011,0432,0,1726 ,7 ,1733 ,3031 ,0,3,1,3,0,1,0,76.14,57.18 ,33.33
02,000,02,011,0433,0,1429 ,8 ,1437 ,2440 ,0,3,1,3,0,1,0,76.14,58.89 ,33.33
02,000,02,011,0434,0,1764 ,9 ,1773 ,3266 ,0,3,1,3,0,1,0,76.14,54.29 ,33.33
02,000,02,011,0435,0,1924 ,11 ,1935 ,3553 ,0,3,1,3,0,1,0,76.14,54.46 ,33.33
02,000,02,011,0436,0,936 ,4 ,940 ,1620 ,0,3,1,3,0,1,0,76.14,58.02 ,33.33
02,000,02,011,0437,0,1340 ,14 ,1354 ,2523 ,0,3,1,3,0,1,0,76.14,53.67 ,33.33
02,000,02,011,0438,0,1291 ,6 ,1297 ,2180 ,0,3,1,3,0,1,0,76.14,59.50 ,33.33
02,000,02,011,0439,0,1120 ,2 ,1122 ,1844 ,0,3,1,3,0,1,0,76.14,60.85 ,33.33
02,000,02,011,0440,0,1804 ,11 ,1815 ,3101 ,0,3,1,3,0,1,0,76.14,58.53 ,33.33
02,000,02,011,0441,0,1216 ,9 ,1225 ,2122 ,0,3,1,3,0,1,0,76.14,57.73 ,33.33
02,000,02,011,0442,0,3042 ,18 ,3060 ,5450 ,0,3,1,3,0,1,0,76.14,56.15 ,33.33
02,000,02,011,0443,0,1705 ,9 ,1714 ,3106 ,0,3,1,3,0,1,0,76.14,55.18 ,33.33
02,000,02,011,0444,0,1201 ,17 ,1218 ,1971 ,0,3,1,3,0,1,0,76.14,61.80 ,33.33
02,000,02,011,0445,0,1069 ,9 ,1078 ,1903 ,0,3,1,3,0,1,0,76.14,56.65 ,33.33
02,000,02,011,0446,0,802 ,9 ,811 ,1302 ,0,3,1,3,0,1,0,76.14,62.29 ,33.33
02,000,02,011,0447,0,787 ,3 ,790 ,1397 ,0,3,1,3,0,1,0,76.14,56.55 ,33.33
02,000,02,011,0448,0,1708 ,9 ,1717 ,3107 ,0,3,1,3,0,1,0,76.14,55.26 ,33.33
02,000,02,011,0449,0,1064 ,3 ,1067 ,1813 ,0,3,1,3,0,1,0,76.14,58.85 ,33.33
02,000,02,011,0450,0,1272 ,8 ,1280 ,2187 ,0,3,1,3,0,1,0,76.14,58.53 ,33.33
02,000,02,011,0451,0,3239 ,17 ,3256 ,6111 ,0,3,1,3,0,1,0,76.14,53.28 ,33.33
02,000,02,011,0452,0,1469 ,2 ,1471 ,2798 ,0,3,1,3,0,1,0,76.14,52.57 ,33.33
02,000,02,011,0453,0,1400 ,9 ,1409 ,2234 ,0,3,1,3,0,1,0,76.14,63.07 ,33.33
02,000,02,011,0454,0,1295 ,11 ,1306 ,2049 ,0,3,1,3,0,1,0,76.14,63.74 ,33.33
02,000,02,011,0455,0,954 ,7 ,961 ,1470 ,0,3,1,3,0,1,0,76.14,65.37 ,33.33
02,000,02,011,0456,0,1198 ,5 ,1203 ,2002 ,0,3,1,3,0,1,0,76.14,60.09 ,33.33
02,000,02,011,0457,0,915 ,1 ,916 ,1557 ,0,3,1,3,0,1,0,76.14,58.83 ,33.33
02,000,02,011,0458,0,1298 ,13 ,1311 ,2251 ,0,3,1,3,0,1,0,76.14,58.24 ,33.33
02,000,02,011,0459,0,2153 ,14 ,2167 ,4455 ,0,3,1,3,0,1,0,76.14,48.64 ,33.33
02,000,02,011,0460,0,1082 ,4 ,1086 ,2287 ,0,3,1,3,0,1,0,76.14,47.49 ,33.33
02,000,02,011,0461,0,1161 ,4 ,1165 ,2357 ,0,3,1,3,0,1,0,76.14,49.43 ,33.33
02,000,02,011,0462,0,1261 ,10 ,1271 ,2713 ,0,3,1,3,0,1,0,76.14,46.85 ,33.33
02,000,02,011,0463,0,1240 ,8 ,1248 ,2764 ,0,3,1,3,0,1,0,76.14,45.15 ,33.33
03,001,01,001,0001,0,682 ,1 ,683 ,1183 ,0,3,1,3,0,1,0,76.14,57.73 ,33.33
03,001,01,001,0002,0,684 ,6 ,690 ,1223 ,0,3,1,3,0,1,0,76.14,56.42 ,33.33
03,001,01,001,0003,0,390 ,1 ,391 ,656 ,0,3,1,3,0,1,0,76.14,59.60 ,33.33
03,001,01,001,0004,0,597 ,6 ,603 ,1028 ,0,3,1,3,0,1,0,76.14,58.66 ,33.33
03,001,01,001,0005,0,846 ,6 ,852 ,1445 ,0,3,1,3,0,1,0,76.14,58.96 ,33.33
03,001,01,001,0006,0,2116 ,27 ,2143 ,3726 ,0,3,1,3,0,1,0,76.14,57.51 ,33.33
03,001,01,001,0007,0,1348 ,16 ,1364 ,2548 ,0,3,1,3,0,1,0,76.14,53.53 ,33.33
03,001,01,001,0008,0,2790 ,15 ,2805 ,5549 ,0,3,1,3,0,1,0,76.14,50.55 ,33.33
03,001,01,001,0009,0,1994 ,9 ,2003 ,3555 ,0,3,1,3,0,1,0,76.14,56.34 ,33.33
03,001,01,001,0010,0,1237 ,6 ,1243 ,2204 ,0,3,1,3,0,1,0,76.14,56.3974591652,33.33
03,001,01,001,0011,0,1893 ,18 ,1911 ,3520 ,0,3,1,3,0,1,0,76.14,54.29 ,33.33
03,001,01,001,0012,0,2698 ,21 ,2719 ,4465 ,0,3,1,3,0,1,0,76.14,60.90 ,33.33
03,001,01,001,0013,0,1481 ,14 ,1495 ,2384 ,0,3,1,3,0,1,0,76.14,62.71 ,33.33
03,001,01,001,0014,0,1350 ,9 ,1359 ,2276 ,0,3,1,3,0,1,0,76.14,59.71 ,33.33
03,001,01,001,0015,0,1249 ,19 ,1268 ,2165 ,0,3,1,3,0,1,0,76.14,58.5681293303,33.33
03,001,01,001,0016,0,2159 ,26 ,2185 ,3269 ,0,3,1,3,0,1,0,76.14,66.84 ,33.33
03,001,01,001,0017,0,1307 ,7 ,1314 ,2141 ,0,3,1,3,0,1,0,76.14,61.37 ,33.33
03,001,01,001,0018,0,2043 ,16 ,2059 ,3728 ,0,3,1,3,0,1,0,76.14,55.2306866953,33.33
03,001,01,001,0019,0,1842 ,16 ,1858 ,3382 ,0,3,1,3,0,1,0,76.14,54.94 ,33.33
03,001,01,001,0020,0,2260 ,25 ,2285 ,4156 ,0,3,1,3,0,1,0,76.14,54.98 ,33.33
03,001,01,001,0021,0,1534 ,18 ,1552 ,2467 ,0,3,1,3,0,1,0,76.14,62.91 ,33.33
03,001,01,001,0022,0,1120 ,8 ,1128 ,1768 ,0,3,1,3,0,1,0,76.14,63.8009049774,33.33
03,001,01,001,0023,0,1917 ,14 ,1931 ,3141 ,0,3,1,3,0,1,0,76.14,61.48 ,33.33
03,001,01,001,0024,0,2266 ,10 ,2276 ,3725 ,0,3,1,3,0,1,0,76.14,61.10 ,33.33
03,001,01,001,0025,0,2028 ,8 ,2036 ,3593 ,0,3,1,3,0,1,0,76.14,56.67 ,33.33
03,001,01,001,0026,0,1794 ,18 ,1812 ,3196 ,0,3,1,3,0,1,0,76.14,56.70 ,33.33
03,001,01,001,0027,0,1829 ,7 ,1836 ,3359 ,0,3,1,3,0,1,0,76.14,54.66 ,33.33
03,001,01,001,0028,0,1416 ,6 ,1422 ,2539 ,0,3,1,3,0,1,0,76.14,56.0063016936,33.33
03,001,01,001,0029,0,1476 ,5 ,1481 ,2341 ,0,3,1,3,0,1,0,76.14,63.26 ,33.33
03,001,01,001,0030,0,1395 ,6 ,1401 ,2418 ,0,3,1,3,0,1,0,76.14,57.9404466501,33.33
03,001,01,001,0031,0,1202 ,10 ,1212 ,2093 ,0,3,1,3,0,1,0,76.14,57.91 ,33.33
03,001,01,001,0032,0,1403 ,8 ,1411 ,2532 ,0,3,1,3,0,1,0,76.14,55.73 ,33.33
03,001,01,001,0033,0,1120 ,9 ,1129 ,2017 ,0,3,1,3,0,1,0,76.14,55.97 ,33.33
03,001,01,001,0034,0,2273 ,23 ,2296 ,4148 ,0,3,1,3,0,1,0,76.14,55.35 ,33.33
03,001,01,001,0035,0,2167 ,17 ,2184 ,4005 ,0,3,1,3,0,1,0,76.14,54.53 ,33.33
03,001,01,001,0036,0,2248 ,7 ,2255 ,4202 ,0,3,1,3,0,1,0,76.14,53.66 ,33.33
03,001,01,001,0037,0,2605 ,15 ,2620 ,4898 ,0,3,1,3,0,1,0,76.14,53.49 ,33.33
03,001,01,001,0038,0,1746 ,15 ,1761 ,3254 ,0,3,1,3,0,1,0,76.14,54.12 ,33.33
03,001,01,001,0039,0,1484 ,9 ,1493 ,2637 ,0,3,1,3,0,1,0,76.14,56.6173682215,33.33
03,001,01,001,0040,0,1467 ,14 ,1481 ,2638 ,0,3,1,3,0,1,0,76.14,56.14 ,33.33
03,001,01,001,0041,0,1538 ,15 ,1553 ,2744 ,0,3,1,3,0,1,0,76.14,56.60 ,33.33
03,001,01,001,0042,0,3309 ,28 ,3337 ,6188 ,0,3,1,3,0,1,0,76.14,53.93 ,33.33
03,001,01,001,0043,0,1584 ,10 ,1594 ,2898 ,0,3,1,3,0,1,0,76.14,55.0034506556,33.33
03,001,01,001,0044,0,1737 ,12 ,1749 ,3024 ,0,3,1,3,0,1,0,76.14,57.84 ,33.33
03,001,01,001,0045,0,2727 ,21 ,2748 ,4871 ,0,3,1,3,0,1,0,76.14,56.42 ,33.33
03,001,01,001,0046,0,1480 ,13 ,1493 ,2913 ,0,3,1,3,0,1,0,76.14,51.2530037762,33.33
03,001,01,001,0047,0,1484 ,5 ,1489 ,2692 ,0,3,1,3,0,1,0,76.14,55.31 ,33.33
03,001,01,001,0048,0,2271 ,23 ,2294 ,4084 ,0,3,1,3,0,1,0,76.14,56.17 ,33.33
03,001,01,001,0049,0,1552 ,10 ,1562 ,3057 ,0,3,1,3,0,1,0,76.14,51.10 ,33.33
03,001,01,001,0050,0,1644 ,10 ,1654 ,2945 ,0,3,1,3,0,1,0,76.14,56.16 ,33.33
03,001,01,001,0051,0,2011 ,9 ,2020 ,3662 ,0,3,1,3,0,1,0,76.14,55.16 ,33.33
03,001,01,001,0052,0,1018 ,6 ,1024 ,1839 ,0,3,1,3,0,1,0,76.14,55.6824361066,33.33
03,001,01,001,0053,0,1519 ,8 ,1527 ,2666 ,0,3,1,3,0,1,0,76.14,57.28 ,33.33
03,001,01,001,0054,0,1336 ,10 ,1346 ,2517 ,0,3,1,3,0,1,0,76.14,53.4763607469,33.33
03,001,01,001,0055,0,3965 ,36 ,4001 ,6930 ,0,3,1,3,0,1,0,76.14,57.73 ,33.33
03,001,01,001,0056,0,1250 ,12 ,1262 ,2161 ,0,3,1,3,0,1,0,76.14,58.40 ,33.33
03,001,01,001,0057,0,2435 ,18 ,2453 ,4220 ,0,3,1,3,0,1,0,76.14,58.1279620853,33.33
03,001,01,001,0058,0,1303 ,8 ,1311 ,2298 ,0,3,1,3,0,1,0,76.14,57.05 ,33.33
03,001,01,001,0059,0,1282 ,8 ,1290 ,2533 ,0,3,1,3,0,1,0,76.14,50.93 ,33.33
03,001,01,001,0060,0,2457 ,20 ,2477 ,4774 ,0,3,1,3,0,1,0,76.14,51.89 ,33.33
03,001,01,001,0061,0,827 ,7 ,834 ,1474 ,0,3,1,3,0,1,0,76.14,56.58 ,33.33
03,001,01,001,0062,0,2527 ,32 ,2559 ,4466 ,0,3,1,3,0,1,0,76.14,57.30 ,33.33
03,001,01,001,0063,0,2126 ,24 ,2150 ,3496 ,0,3,1,3,0,1,0,76.14,61.50 ,33.33
03,001,01,001,0064,0,1994 ,12 ,2006 ,3468 ,0,3,1,3,0,1,0,76.14,57.84 ,33.33
03,001,01,001,0065,0,1402 ,18 ,1420 ,2519 ,0,3,1,3,0,1,0,76.14,56.37 ,33.33
03,001,01,001,0066,0,2421 ,14 ,2435 ,4165 ,0,3,1,3,0,1,0,76.14,58.46 ,33.33
03,001,01,001,0067,0,1085 ,7 ,1092 ,1878 ,0,3,1,3,0,1,0,76.14,58.1469648562,33.33
03,001,01,001,0068,0,1359 ,8 ,1367 ,2403 ,0,3,1,3,0,1,0,76.14,56.89 ,33.33
03,001,01,001,0069,0,1470 ,11 ,1481 ,2636 ,0,3,1,3,0,1,0,76.14,56.18 ,33.33
03,001,01,001,0070,0,1341 ,4 ,1345 ,2477 ,0,3,1,3,0,1,0,76.14,54.2995559144,33.33
03,001,01,001,0071,0,3032 ,23 ,3055 ,5593 ,0,3,1,3,0,1,0,76.14,54.62 ,33.33
03,001,01,001,0072,0,1279 ,14 ,1293 ,2344 ,0,3,1,3,0,1,0,76.14,55.16 ,33.33
03,001,01,001,0073,0,1473 ,10 ,1483 ,2442 ,0,3,1,3,0,1,0,76.14,60.7289107289,33.33
03,001,01,001,0074,0,2138 ,15 ,2153 ,4044 ,0,3,1,3,0,1,0,76.14,53.24 ,33.33
03,001,01,001,0075,0,1398 ,14 ,1412 ,2409 ,0,3,1,3,0,1,0,76.14,58.61 ,33.33
03,001,01,001,0076,0,1660 ,8 ,1668 ,3028 ,0,3,1,3,0,1,0,76.14,55.09 ,33.33
03,001,01,001,0077,0,1697 ,12 ,1709 ,2895 ,0,3,1,3,0,1,0,76.14,59.0328151986,33.33
03,001,01,001,0078,0,1465 ,9 ,1474 ,2675 ,0,3,1,3,0,1,0,76.14,55.10 ,33.33
03,001,01,001,0079,0,1705 ,14 ,1719 ,2994 ,0,3,1,3,0,1,0,76.14,57.41 ,33.33
03,001,01,001,0080,0,1573 ,19 ,1592 ,2930 ,0,3,1,3,0,1,0,76.14,54.33 ,33.33
03,001,01,001,0081,0,2461 ,16 ,2477 ,4287 ,0,3,1,3,0,1,0,76.14,57.78 ,33.33
03,001,01,001,0082,0,1737 ,12 ,1749 ,3032 ,0,3,1,3,0,1,0,76.14,57.68 ,33.33
03,001,01,001,0083,0,1296 ,11 ,1307 ,2197 ,0,3,1,3,0,1,0,76.14,59.49 ,33.33
03,001,01,001,0084,0,1931 ,13 ,1944 ,3418 ,0,3,1,3,0,1,0,76.14,56.88 ,33.33
03,001,01,001,0085,0,922 ,4 ,926 ,1599 ,0,3,1,3,0,1,0,76.14,57.9111944966,33.33
03,001,01,001,0086,0,1724 ,14 ,1738 ,2995 ,0,3,1,3,0,1,0,76.14,58.03 ,33.33
03,001,01,001,0087,0,1222 ,11 ,1233 ,2761 ,0,3,1,3,0,1,0,76.14,44.6577327055,33.33
03,001,01,001,0088,0,1002 ,8 ,1010 ,1628 ,0,3,1,3,0,1,0,76.14,62.04 ,33.33
03,001,01,001,0089,0,1628 ,16 ,1644 ,3005 ,0,3,1,3,0,1,0,76.14,54.71 ,33.33
03,001,01,001,0090,0,1767 ,9 ,1776 ,3042 ,0,3,1,3,0,1,0,76.14,58.38 ,33.33
03,001,01,001,0091,0,1464 ,4 ,1468 ,2528 ,0,3,1,3,0,1,0,76.14,58.07 ,33.33
03,001,01,001,0092,0,1706 ,25 ,1731 ,2888 ,0,3,1,3,0,1,0,76.14,59.9376731302,33.33
03,001,01,001,0093,0,2482 ,21 ,2503 ,4154 ,0,3,1,3,0,1,0,76.14,60.26 ,33.33
03,001,01,001,0094,0,1548 ,11 ,1559 ,2708 ,0,3,1,3,0,1,0,76.14,57.57 ,33.33
03,001,01,001,0095,0,1642 ,16 ,1658 ,2757 ,0,3,1,3,0,1,0,76.14,60.14 ,33.33
03,001,01,001,0096,0,1675 ,18 ,1693 ,2912 ,0,3,1,3,0,1,0,76.14,58.14 ,33.33
03,001,01,001,0097,0,2735 ,17 ,2752 ,4801 ,0,3,1,3,0,1,0,76.14,57.32 ,33.33
03,001,01,001,0098,0,2220 ,18 ,2238 ,3807 ,0,3,1,3,0,1,0,76.14,58.79 ,33.33
03,001,01,001,0099,0,3348 ,35 ,3383 ,6412 ,0,3,1,3,0,1,0,76.14,52.76 ,33.33
03,001,01,001,0100,0,1653 ,13 ,1666 ,2707 ,0,3,1,3,0,1,0,76.14,61.54 ,33.33
03,001,01,001,0101,0,498 ,5 ,503 ,910 ,0,3,1,3,0,1,0,76.14,55.27 ,33.33
03,001,01,001,0102,0,1447 ,13 ,1460 ,2754 ,0,3,1,3,0,1,0,76.14,53.01 ,33.33
03,001,01,001,0103,0,1993 ,16 ,2009 ,3580 ,0,3,1,3,0,1,0,76.14,56.1173184358,33.33
03,001,01,001,0104,0,1869 ,16 ,1885 ,3272 ,0,3,1,3,0,1,0,76.14,57.61 ,33.33
03,001,01,001,0105,0,1446 ,21 ,1467 ,2366 ,0,3,1,3,0,1,0,76.14,62.00 ,33.33
03,001,01,001,0106,0,1098 ,10 ,1108 ,1780 ,0,3,1,3,0,1,0,76.14,62.2471910112,33.33
03,001,01,001,0107,0,2718 ,25 ,2743 ,5189 ,0,3,1,3,0,1,0,76.14,52.86 ,33.33
03,001,01,001,0108,0,2688 ,19 ,2707 ,4488 ,0,3,1,3,0,1,0,76.14,60.316399287,33.33
03,001,01,001,0109,0,1936 ,19 ,1955 ,3340 ,0,3,1,3,0,1,0,76.14,58.5329341317,33.33
03,001,01,001,0110,0,1729 ,11 ,1740 ,3561 ,0,3,1,3,0,1,0,76.14,48.8626790227,33.33
03,001,01,001,0111,0,2304 ,17 ,2321 ,4269 ,0,3,1,3,0,1,0,76.14,54.3687046147,33.33
03,001,01,001,0112,0,1600 ,12 ,1612 ,3020 ,0,3,1,3,0,1,0,76.14,53.3774834437,33.33
03,001,01,001,0113,0,1516 ,15 ,1531 ,2757 ,0,3,1,3,0,1,0,76.14,55.5313746826,33.33
03,001,01,001,0114,0,610 ,5 ,615 ,1013 ,0,3,1,3,0,1,0,76.14,60.7107601185,33.33
03,001,01,001,0115,0,2175 ,22 ,2197 ,3907 ,0,3,1,3,0,1,0,76.14,56.2324033786,33.33
03,001,01,001,0116,0,1055 ,38 ,1093 ,1780 ,0,3,1,3,0,1,0,76.14,61.404494382,33.33
03,001,01,001,0117,0,1995 ,13 ,2008 ,3438 ,0,3,1,3,0,1,0,76.14,58.4060500291,33.33
03,001,01,001,0118,0,1354 ,22 ,1376 ,2236 ,0,3,1,3,0,1,0,76.14,61.5384615385,33.33
03,001,01,001,0119,0,2246 ,25 ,2271 ,4080 ,0,3,1,3,0,1,0,76.14,55.6617647059,33.33
03,001,01,001,0120,0,1393 ,21 ,1414 ,2371 ,0,3,1,3,0,1,0,76.14,59.6372838465,33.33
03,001,01,001,0121,0,3137 ,29 ,3166 ,6070 ,0,3,1,3,0,1,0,76.14,52.15815486,33.33
03,001,01,001,0122,0,1812 ,13 ,1825 ,3648 ,0,3,1,3,0,1,0,76.14,50.0274122807,33.33
03,001,01,001,0123,0,2299 ,21 ,2320 ,4397 ,0,3,1,3,0,1,0,76.14,52.7632476689,33.33
03,001,01,001,0124,0,4120 ,32 ,4152 ,8328 ,0,3,1,3,0,1,0,76.14,49.855907781,33.33
03,001,01,001,0125,0,1486 ,17 ,1503 ,2636 ,0,3,1,3,0,1,0,76.14,57.0182094082,33.33
03,001,01,001,0126,0,1647 ,15 ,1662 ,2985 ,0,3,1,3,0,1,0,76.14,55.6783919598,33.33
03,001,01,002,0127,0,728 ,8 ,736 ,1235 ,0,3,1,3,0,1,0,76.14,59.5951417004,33.33
03,001,01,002,0128,0,359 ,0 ,359 ,623 ,0,3,1,3,0,1,0,76.14,57.6243980738,33.33
03,001,01,002,0129,0,2034 ,15 ,2049 ,3468 ,0,3,1,3,0,1,0,76.14,59.0830449827,33.33
03,001,01,002,0130,0,2012 ,21 ,2033 ,3676 ,0,3,1,3,0,1,0,76.14,55.3046789989,33.33
03,001,01,002,0131,0,1526 ,15 ,1541 ,2871 ,0,3,1,3,0,1,0,76.14,53.6746778126,33.33
03,001,01,002,0132,0,2830 ,22 ,2852 ,5432 ,0,3,1,3,0,1,0,76.14,52.5036818851,33.33
03,001,01,002,0133,0,1952 ,17 ,1969 ,3618 ,0,3,1,3,0,1,0,76.14,54.4223327805,33.33
03,001,01,002,0134,0,2168 ,17 ,2185 ,4174 ,0,3,1,3,0,1,0,76.14,52.3478677528,33.33
03,001,01,002,0135,0,1335 ,10 ,1345 ,3255 ,0,3,1,3,0,1,0,76.14,41.3210445469,33.33
03,001,01,002,0136,0,945 ,10 ,955 ,1641 ,0,3,1,3,0,1,0,76.14,58.196221816,33.33
03,001,01,002,0137,0,1078 ,7 ,1085 ,1565 ,0,3,1,3,0,1,0,76.14,69.3290734824,33.33
03,001,01,002,0138,0,1698 ,11 ,1709 ,3206 ,0,3,1,3,0,1,0,76.14,53.3063006862,33.33
03,001,01,002,0139,0,2405 ,20 ,2425 ,4293 ,0,3,1,3,0,1,0,76.14,56.487304915,33.33
03,001,01,002,0140,0,2335 ,15 ,2350 ,4146 ,0,3,1,3,0,1,0,76.14,56.6811384467,33.33
03,001,01,002,0141,0,2297 ,14 ,2311 ,4143 ,0,3,1,3,0,1,0,76.14,55.7808351436,33.33
03,001,01,002,0142,0,2083 ,20 ,2103 ,3741 ,0,3,1,3,0,1,0,76.14,56.2149157979,33.33
03,001,01,002,0143,0,2277 ,19 ,2296 ,4431 ,0,3,1,3,0,1,0,76.14,51.8167456556,33.33
03,001,01,002,0144,0,1778 ,17 ,1795 ,3153 ,0,3,1,3,0,1,0,76.14,56.9299080241,33.33
03,001,01,002,0145,0,1472 ,11 ,1483 ,2603 ,0,3,1,3,0,1,0,76.14,56.9727237803,33.33
03,001,01,002,0146,0,1922 ,16 ,1938 ,3562 ,0,3,1,3,0,1,0,76.14,54.4076361595,33.33
03,001,01,002,0147,0,2355 ,22 ,2377 ,4063 ,0,3,1,3,0,1,0,76.14,58.5035687915,33.33
03,001,01,002,0148,0,1475 ,8 ,1483 ,2540 ,0,3,1,3,0,1,0,76.14,58.3858267717,33.33
03,001,01,002,0149,0,3454 ,19 ,3473 ,5948 ,0,3,1,3,0,1,0,76.14,58.3893745797,33.33
03,001,01,002,0150,0,1339 ,7 ,1346 ,2503 ,0,3,1,3,0,1,0,76.14,53.7754694367,33.33
03,001,01,002,0151,0,2169 ,20 ,2189 ,4119 ,0,3,1,3,0,1,0,76.14,53.1439669823,33.33
03,001,01,002,0152,0,1443 ,10 ,1453 ,2714 ,0,3,1,3,0,1,0,76.14,53.5372144436,33.33
03,001,01,002,0153,0,1776 ,8 ,1784 ,3336 ,0,3,1,3,0,1,0,76.14,53.4772182254,33.33
03,001,01,002,0154,0,1894 ,14 ,1908 ,3335 ,0,3,1,3,0,1,0,76.14,57.2113943028,33.33
03,001,01,002,0155,0,1308 ,14 ,1322 ,2383 ,0,3,1,3,0,1,0,76.14,55.4762903903,33.33
03,001,01,002,0156,0,1284 ,8 ,1292 ,2242 ,0,3,1,3,0,1,0,76.14,57.6271186441,33.33
03,001,01,002,0157,0,1265 ,10 ,1275 ,2212 ,0,3,1,3,0,1,0,76.14,57.6401446655,33.33
03,001,01,002,0158,0,2529 ,19 ,2548 ,4838 ,0,3,1,3,0,1,0,76.14,52.6663910707,33.33
03,001,01,002,0159,0,739 ,11 ,750 ,1321 ,0,3,1,3,0,1,0,76.14,56.7751703255,33.33
03,001,01,002,0160,0,2876 ,19 ,2895 ,5238 ,0,3,1,3,0,1,0,76.14,55.2691867125,33.33
03,001,01,002,0161,0,1328 ,7 ,1335 ,2386 ,0,3,1,3,0,1,0,76.14,55.9513830679,33.33
03,001,01,002,0162,0,3020 ,20 ,3040 ,5601 ,0,3,1,3,0,1,0,76.14,54.2760221389,33.33
03,001,01,002,0163,0,1284 ,18 ,1302 ,2418 ,0,3,1,3,0,1,0,76.14,53.8461538462,33.33
03,001,01,002,0164,0,1994 ,17 ,2011 ,3982 ,0,3,1,3,0,1,0,76.14,50.5022601708,33.33
03,001,01,002,0165,0,1845 ,15 ,1860 ,3376 ,0,3,1,3,0,1,0,76.14,55.0947867299,33.33
03,001,01,002,0166,0,2229 ,10 ,2239 ,4151 ,0,3,1,3,0,1,0,76.14,53.9388099253,33.33
03,001,01,002,0167,0,2797 ,18 ,2815 ,5512 ,0,3,1,3,0,1,0,76.14,51.0703918723,33.33
03,001,01,002,0168,0,1868 ,10 ,1878 ,3462 ,0,3,1,3,0,1,0,76.14,54.2461005199,33.33
03,001,01,002,0169,0,1833 ,11 ,1844 ,3428 ,0,3,1,3,0,1,0,76.14,53.7922987165,33.33
03,001,01,002,0170,0,1735 ,13 ,1748 ,3229 ,0,3,1,3,0,1,0,76.14,54.1344069371,33.33
03,001,01,002,0171,0,2798 ,26 ,2824 ,5168 ,0,3,1,3,0,1,0,76.14,54.6439628483,33.33
03,001,01,002,0172,0,1985 ,21 ,2006 ,3779 ,0,3,1,3,0,1,0,76.14,53.0828261445,33.33
03,001,01,002,0173,0,2273 ,22 ,2295 ,4576 ,0,3,1,3,0,1,0,76.14,50.152972028,33.33
03,001,01,003,0174,0,1781 ,23 ,1804 ,3546 ,0,3,1,3,0,1,0,76.14,50.8742244783,33.33
03,001,01,003,0175,0,1771 ,16 ,1787 ,3257 ,0,3,1,3,0,1,0,76.14,54.8664415106,33.33
03,001,01,003,0176,0,1576 ,18 ,1594 ,2948 ,0,3,1,3,0,1,0,76.14,54.0705563094,33.33
03,001,01,003,0177,0,821 ,8 ,829 ,1496 ,0,3,1,3,0,1,0,76.14,55.4144385027,33.33
03,001,01,003,0178,0,1744 ,13 ,1757 ,3494 ,0,3,1,3,0,1,0,76.14,50.2862049227,33.33
03,001,01,003,0179,0,1331 ,14 ,1345 ,2757 ,0,3,1,3,0,1,0,76.14,48.7849111353,33.33
03,001,01,003,0180,0,1506 ,18 ,1524 ,2947 ,0,3,1,3,0,1,0,76.14,51.713607058,33.33
03,001,01,003,0181,0,1766 ,13 ,1779 ,3554 ,0,3,1,3,0,1,0,76.14,50.0562746201,33.33
03,001,01,003,0182,0,1871 ,19 ,1890 ,3725 ,0,3,1,3,0,1,0,76.14,50.7382550336,33.33
03,001,01,003,0183,0,2760 ,24 ,2784 ,4910 ,0,3,1,3,0,1,0,76.14,56.700610998,33.33
03,001,01,003,0184,0,1228 ,9 ,1237 ,2535 ,0,3,1,3,0,1,0,76.14,48.7968441815,33.33
03,001,01,003,0185,0,1611 ,12 ,1623 ,2988 ,0,3,1,3,0,1,0,76.14,54.3172690763,33.33
03,001,01,003,0186,0,978 ,8 ,986 ,1943 ,0,3,1,3,0,1,0,76.14,50.7462686567,33.33
03,001,01,003,0187,0,720 ,4 ,724 ,1275 ,0,3,1,3,0,1,0,76.14,56.7843137255,33.33
03,001,01,003,0188,0,1700 ,7 ,1707 ,2941 ,0,3,1,3,0,1,0,76.14,58.0414824889,33.33
03,001,01,003,0189,0,1095 ,12 ,1107 ,1892 ,0,3,1,3,0,1,0,76.14,58.5095137421,33.33
03,001,01,003,0190,0,2374 ,25 ,2399 ,4077 ,0,3,1,3,0,1,0,76.14,58.8422859946,33.33
03,001,01,003,0191,0,1522 ,13 ,1535 ,2874 ,0,3,1,3,0,1,0,76.14,53.409881698,33.33
03,001,01,003,0192,0,1444 ,16 ,1460 ,2494 ,0,3,1,3,0,1,0,76.14,58.5404971933,33.33
03,001,01,003,0193,0,1373 ,5 ,1378 ,2382 ,0,3,1,3,0,1,0,76.14,57.8505457599,33.33
03,001,01,003,0194,0,1828 ,20 ,1848 ,3220 ,0,3,1,3,0,1,0,76.14,57.3913043478,33.33
03,001,01,003,0195,0,676 ,6 ,682 ,1285 ,0,3,1,3,0,1,0,76.14,53.0739299611,33.33
03,001,01,003,0196,0,645 ,6 ,651 ,1064 ,0,3,1,3,0,1,0,76.14,61.1842105263,33.33
03,001,01,003,0197,0,639 ,2 ,641 ,990 ,0,3,1,3,0,1,0,76.14,64.7474747475,33.33
03,001,01,003,0198,0,1834 ,15 ,1849 ,3679 ,0,3,1,3,0,1,0,76.14,50.258222343,33.33
03,001,01,003,0199,0,1702 ,21 ,1723 ,3107 ,0,3,1,3,0,1,0,76.14,55.4554232379,33.33
03,001,01,003,0200,0,1973 ,14 ,1987 ,4138 ,0,3,1,3,0,1,0,76.14,48.0183663606,33.33
03,001,01,003,0201,0,1785 ,11 ,1796 ,3439 ,0,3,1,3,0,1,0,76.14,52.2244838616,33.33
03,001,01,003,0202,0,1260 ,11 ,1271 ,2319 ,0,3,1,3,0,1,0,76.14,54.8081069426,33.33
03,001,01,003,0203,0,1105 ,9 ,1114 ,2176 ,0,3,1,3,0,1,0,76.14,51.1948529412,33.33
03,001,01,003,0204,0,965 ,6 ,971 ,2034 ,0,3,1,3,0,1,0,76.14,47.738446411,33.33
03,001,01,003,0205,0,1646 ,10 ,1656 ,2969 ,0,3,1,3,0,1,0,76.14,55.7763556753,33.33
03,001,01,003,0206,0,2115 ,19 ,2134 ,4091 ,0,3,1,3,0,1,0,76.14,52.1632852603,33.33
03,001,01,003,0207,0,1461 ,15 ,1476 ,2620 ,0,3,1,3,0,1,0,76.14,56.3358778626,33.33
03,001,01,003,0208,0,1555 ,14 ,1569 ,2980 ,0,3,1,3,0,1,0,76.14,52.6510067114,33.33
03,001,01,003,0209,0,1606 ,17 ,1623 ,2944 ,0,3,1,3,0,1,0,76.14,55.129076087,33.33
03,001,01,003,0210,0,707 ,5 ,712 ,1335 ,0,3,1,3,0,1,0,76.14,53.3333333333,33.33
03,001,01,003,0211,0,752 ,12 ,764 ,1268 ,0,3,1,3,0,1,0,76.14,60.2523659306,33.33
03,001,01,003,0212,0,707 ,7 ,714 ,1338 ,0,3,1,3,0,1,0,76.14,53.3632286996,33.33
03,001,01,003,0213,0,414 ,4 ,418 ,647 ,0,3,1,3,0,1,0,76.14,64.6058732612,33.33
03,001,01,003,0214,0,764 ,10 ,774 ,1328 ,0,3,1,3,0,1,0,76.14,58.2831325301,33.33
03,001,01,003,0215,0,911 ,8 ,919 ,1591 ,0,3,1,3,0,1,0,76.14,57.7624135764,33.33
03,001,01,004,0216,0,258 ,1 ,259 ,448 ,0,3,1,3,0,1,0,76.14,57.8125,33.33
03,001,01,004,0217,0,529 ,5 ,534 ,892 ,0,3,1,3,0,1,0,76.14,59.865470852,33.33
03,001,01,004,0218,0,794 ,15 ,809 ,1439 ,0,3,1,3,0,1,0,76.14,56.2195969423,33.33
03,001,01,004,0219,0,1125 ,16 ,1141 ,1826 ,0,3,1,3,0,1,0,76.14,62.4863088719,33.33
03,001,01,004,0220,0,527 ,4 ,531 ,845 ,0,3,1,3,0,1,0,76.14,62.8402366864,33.33
03,001,01,004,0221,0,2404 ,11 ,2415 ,4138 ,0,3,1,3,0,1,0,76.14,58.3615273079,33.33
03,001,01,004,0222,0,2253 ,17 ,2270 ,4304 ,0,3,1,3,0,1,0,76.14,52.7416356877,33.33
03,001,01,004,0223,0,493 ,4 ,497 ,762 ,0,3,1,3,0,1,0,76.14,65.2230971129,33.33
03,001,01,004,0224,0,2776 ,34 ,2810 ,5061 ,0,3,1,3,0,1,0,76.14,55.5226239874,33.33
03,001,01,004,0225,0,2379 ,18 ,2397 ,4397 ,0,3,1,3,0,1,0,76.14,54.5144416648,33.33
03,001,01,004,0226,0,1564 ,12 ,1576 ,2652 ,0,3,1,3,0,1,0,76.14,59.4268476621,33.33
03,001,01,004,0227,0,807 ,4 ,811 ,1352 ,0,3,1,3,0,1,0,76.14,59.9852071006,33.33
03,001,01,004,0228,0,3331 ,28 ,3359 ,6172 ,0,3,1,3,0,1,0,76.14,54.4232015554,33.33
03,001,01,004,0229,0,2063 ,12 ,2075 ,3670 ,0,3,1,3,0,1,0,76.14,56.5395095368,33.33
03,001,01,004,0230,0,1757 ,21 ,1778 ,3482 ,0,3,1,3,0,1,0,76.14,51.0626076967,33.33
03,001,01,004,0231,0,1938 ,28 ,1966 ,3539 ,0,3,1,3,0,1,0,76.14,55.5524159367,33.33
03,001,01,004,0232,0,1919 ,15 ,1934 ,3486 ,0,3,1,3,0,1,0,76.14,55.4790590935,33.33
03,001,01,004,0233,0,2372 ,15 ,2387 ,4063 ,0,3,1,3,0,1,0,76.14,58.7496923456,33.33
03,001,01,004,0234,0,2338 ,24 ,2362 ,4358 ,0,3,1,3,0,1,0,76.14,54.199173933,33.33
03,001,01,004,0235,0,140 ,1 ,141 ,205 ,0,3,1,3,0,1,0,76.14,68.7804878049,33.33
03,001,01,005,0236,0,195 ,4 ,199 ,317 ,0,3,1,3,0,1,0,76.14,62.7760252366,33.33
03,001,01,005,0237,0,237 ,4 ,241 ,402 ,0,3,1,3,0,1,0,76.14,59.9502487562,33.33
03,001,01,005,0238,0,1443 ,12 ,1455 ,2576 ,0,3,1,3,0,1,0,76.14,56.4829192547,33.33
03,001,01,005,0239,0,818 ,6 ,824 ,1478 ,0,3,1,3,0,1,0,76.14,55.751014885,33.33
03,001,01,005,0240,0,495 ,7 ,502 ,926 ,0,3,1,3,0,1,0,76.14,54.211663067,33.33
03,001,01,005,0241,0,2739 ,15 ,2754 ,5023 ,0,3,1,3,0,1,0,76.14,54.8277921561,33.33
03,001,01,005,0242,0,2899 ,23 ,2922 ,5732 ,0,3,1,3,0,1,0,76.14,50.9769713887,33.33
03,001,01,005,0243,0,2924 ,23 ,2947 ,5459 ,0,3,1,3,0,1,0,76.14,53.9842461989,33.33
03,001,01,005,0244,0,1703 ,5 ,1708 ,3142 ,0,3,1,3,0,1,0,76.14,54.3602800764,33.33
03,001,01,005,0245,0,2718 ,11 ,2729 ,5119 ,0,3,1,3,0,1,0,76.14,53.3111935925,33.33
03,001,01,005,0246,0,1931 ,14 ,1945 ,3822 ,0,3,1,3,0,1,0,76.14,50.8895866039,33.33
03,001,01,005,0247,0,1874 ,16 ,1890 ,3510 ,0,3,1,3,0,1,0,76.14,53.8461538462,33.33
03,001,01,005,0248,0,1804 ,13 ,1817 ,3185 ,0,3,1,3,0,1,0,76.14,57.0486656201,33.33
03,001,01,005,0249,0,1459 ,24 ,1483 ,2511 ,0,3,1,3,0,1,0,76.14,59.0601354042,33.33
03,001,01,005,0250,0,555 ,2 ,557 ,940 ,0,3,1,3,0,1,0,76.14,59.2553191489,33.33
03,001,01,005,0251,0,262 ,4 ,266 ,466 ,0,3,1,3,0,1,0,76.14,57.0815450644,33.33
03,001,01,005,0252,0,549 ,4 ,553 ,873 ,0,3,1,3,0,1,0,76.14,63.3447880871,33.33
03,001,01,005,0253,0,445 ,3 ,448 ,796 ,0,3,1,3,0,1,0,76.14,56.2814070352,33.33
03,001,01,005,0254,0,439 ,2 ,441 ,783 ,0,3,1,3,0,1,0,76.14,56.3218390805,33.33
03,001,01,005,0255,0,1238 ,9 ,1247 ,2396 ,0,3,1,3,0,1,0,76.14,52.0450751252,33.33
03,001,01,005,0256,0,733 ,4 ,737 ,1246 ,0,3,1,3,0,1,0,76.14,59.1492776886,33.33
03,001,01,005,0257,0,1128 ,4 ,1132 ,1841 ,0,3,1,3,0,1,0,76.14,61.4883215644,33.33
03,001,01,005,0258,0,1226 ,18 ,1244 ,2311 ,0,3,1,3,0,1,0,76.14,53.8295110342,33.33
03,001,01,005,0259,0,544 ,4 ,548 ,842 ,0,3,1,3,0,1,0,76.14,65.0831353919,33.33
03,001,01,005,0260,0,967 ,12 ,979 ,1732 ,0,3,1,3,0,1,0,76.14,56.5242494226,33.33
03,001,01,005,0261,0,691 ,10 ,701 ,1273 ,0,3,1,3,0,1,0,76.14,55.0667714061,33.33
03,001,02,006,0262,0,1967 ,17 ,1984 ,3572 ,0,3,1,3,0,1,0,76.14,55.54 ,33.33
03,001,02,006,0263,0,2268 ,16 ,2284 ,3662 ,0,3,1,3,0,1,0,76.14,62.37 ,33.33
03,001,02,006,0264,0,922 ,1 ,923 ,1722 ,0,3,1,3,0,1,0,76.14,53.60 ,33.33
03,001,02,006,0265,0,1036 ,13 ,1049 ,1772 ,0,3,1,3,0,1,0,76.14,59.20 ,33.33
03,001,02,006,0266,0,725 ,2 ,727 ,1098 ,0,3,1,3,0,1,0,76.14,66.21 ,33.33
03,001,02,006,0267,0,1109 ,10 ,1119 ,1825 ,0,3,1,3,0,1,0,76.14,61.32 ,33.33
03,001,02,006,0268,0,1856 ,25 ,1881 ,3031 ,0,3,1,3,0,1,0,76.14,62.06 ,33.33
03,001,02,006,0269,0,234 ,6 ,240 ,376 ,0,3,1,3,0,1,0,76.14,63.83 ,33.33
03,001,02,006,0270,0,2445 ,11 ,2456 ,4282 ,0,3,1,3,0,1,0,76.14,57.36 ,33.33
03,001,02,006,0271,0,1892 ,17 ,1909 ,3196 ,0,3,1,3,0,1,0,76.14,59.73 ,33.33
03,001,02,006,0272,0,1690 ,12 ,1702 ,3114 ,0,3,1,3,0,1,0,76.14,54.66 ,33.33
03,001,02,006,0273,0,1564 ,19 ,1583 ,2657 ,0,3,1,3,0,1,0,76.14,59.58 ,33.33
03,001,02,006,0274,0,2508 ,16 ,2524 ,4933 ,0,3,1,3,0,1,0,76.14,51.17 ,33.33
03,001,02,006,0275,0,1025 ,10 ,1035 ,1743 ,0,3,1,3,0,1,0,76.14,59.38 ,33.33
03,001,02,006,0276,0,1755 ,10 ,1765 ,2567 ,0,3,1,3,0,1,0,76.14,68.76 ,33.33
03,001,02,006,0277,0,2095 ,12 ,2107 ,3506 ,0,3,1,3,0,1,0,76.14,60.10 ,33.33
03,001,02,006,0278,0,3022 ,16 ,3038 ,5002 ,0,3,1,3,0,1,0,76.14,60.74 ,33.33
03,001,02,006,0279,0,2048 ,19 ,2067 ,3373 ,0,3,1,3,0,1,0,76.14,61.28 ,33.33
03,001,02,006,0280,0,1626 ,11 ,1637 ,2810 ,0,3,1,3,0,1,0,76.14,58.26 ,33.33
03,001,02,006,0281,0,2794 ,18 ,2812 ,4603 ,0,3,1,3,0,1,0,76.14,61.09 ,33.33
03,001,02,006,0282,0,2864 ,19 ,2883 ,4901 ,0,3,1,3,0,1,0,76.14,58.82 ,33.33
03,001,02,006,0283,0,1473 ,4 ,1477 ,2579 ,0,3,1,3,0,1,0,76.14,57.27 ,33.33
03,001,02,006,0284,0,2745 ,16 ,2761 ,5060 ,0,3,1,3,0,1,0,76.14,54.57 ,33.33
03,001,02,006,0285,0,848 ,10 ,858 ,1528 ,0,3,1,3,0,1,0,76.14,56.15 ,33.33
03,001,02,006,0286,0,801 ,6 ,807 ,1481 ,0,3,1,3,0,1,0,76.14,54.49 ,33.33
03,001,02,006,0287,0,858 ,10 ,868 ,1437 ,0,3,1,3,0,1,0,76.14,60.40 ,33.33
03,001,02,006,0288,0,1008 ,9 ,1017 ,1748 ,0,3,1,3,0,1,0,76.14,58.18 ,33.33
03,001,02,006,0289,0,888 ,8 ,896 ,1489 ,0,3,1,3,0,1,0,76.14,60.17 ,33.33
03,001,02,006,0290,0,741 ,11 ,752 ,1189 ,0,3,1,3,0,1,0,76.14,63.25 ,33.33
03,001,02,006,0291,0,723 ,13 ,736 ,1246 ,0,3,1,3,0,1,0,76.14,59.07 ,33.33
03,001,02,006,0292,0,845 ,8 ,853 ,1557 ,0,3,1,3,0,1,0,76.14,54.78 ,33.33
03,001,02,006,0293,0,700 ,10 ,710 ,1151 ,0,3,1,3,0,1,0,76.14,61.69 ,33.33
03,001,02,006,0294,0,847 ,7 ,854 ,1431 ,0,3,1,3,0,1,0,76.14,59.68 ,33.33
03,001,02,006,0295,0,833 ,8 ,841 ,1427 ,0,3,1,3,0,1,0,76.14,58.93 ,33.33
03,001,02,006,0296,0,1073 ,15 ,1088 ,1860 ,0,3,1,3,0,1,0,76.14,58.49 ,33.33
03,001,02,006,0297,0,943 ,10 ,953 ,1590 ,0,3,1,3,0,1,0,76.14,59.94 ,33.33
03,001,02,006,0298,0,670 ,6 ,676 ,1090 ,0,3,1,3,0,1,0,76.14,62.02 ,33.33
03,001,02,006,0299,0,657 ,7 ,664 ,1091 ,0,3,1,3,0,1,0,76.14,60.86 ,33.33
03,001,02,006,0300,0,1004 ,9 ,1013 ,1545 ,0,3,1,3,0,1,0,76.14,65.57 ,33.33
03,001,02,006,0301,0,529 ,9 ,538 ,769 ,0,3,1,3,0,1,0,76.14,69.96 ,33.33
03,001,02,006,0302,0,862 ,11 ,873 ,1596 ,0,3,1,3,0,1,0,76.14,54.70 ,33.33
03,001,02,006,0303,0,1751 ,13 ,1764 ,3085 ,0,3,1,3,0,1,0,76.14,57.18 ,33.33
03,001,02,006,0304,0,667 ,9 ,676 ,1194 ,0,3,1,3,0,1,0,76.14,56.62 ,33.33
03,001,02,006,0305,0,1219 ,14 ,1233 ,2090 ,0,3,1,3,0,1,0,76.14,59.00 ,33.33
03,001,02,006,0306,0,1199 ,10 ,1209 ,2110 ,0,3,1,3,0,1,0,76.14,57.30 ,33.33
03,001,02,006,0307,0,1322 ,12 ,1334 ,2148 ,0,3,1,3,0,1,0,76.14,62.10 ,33.33
03,001,02,006,0308,0,1682 ,10 ,1692 ,2908 ,0,3,1,3,0,1,0,76.14,58.18 ,33.33
03,001,02,006,0309,0,2110 ,14 ,2124 ,3653 ,0,3,1,3,0,1,0,76.14,58.14 ,33.33
03,001,02,006,0310,0,824 ,8 ,832 ,1317 ,0,3,1,3,0,1,0,76.14,63.17 ,33.33
03,001,02,006,0311,0,658 ,5 ,663 ,1019 ,0,3,1,3,0,1,0,76.14,65.06 ,33.33
03,001,02,006,0312,0,899 ,5 ,904 ,1498 ,0,3,1,3,0,1,0,76.14,60.35 ,33.33
03,001,02,006,0313,0,1019 ,13 ,1032 ,1676 ,0,3,1,3,0,1,0,76.14,61.58 ,33.33
03,001,02,006,0314,0,967 ,8 ,975 ,1615 ,0,3,1,3,0,1,0,76.14,60.37 ,33.33
03,001,02,006,0315,0,1295 ,8 ,1303 ,2110 ,0,3,1,3,0,1,0,76.14,61.75 ,33.33
03,001,02,006,0316,0,907 ,10 ,917 ,1513 ,0,3,1,3,0,1,0,76.14,60.61 ,33.33
03,001,02,006,0317,0,514 ,2 ,516 ,836 ,0,3,1,3,0,1,0,76.14,61.72 ,33.33
03,001,02,006,0318,0,890 ,10 ,900 ,1451 ,0,3,1,3,0,1,0,76.14,62.03 ,33.33
03,001,02,006,0319,0,1071 ,9 ,1080 ,1724 ,0,3,1,3,0,1,0,76.14,62.65 ,33.33
03,001,02,006,0320,0,1139 ,9 ,1148 ,1956 ,0,3,1,3,0,1,0,76.14,58.69 ,33.33
03,001,02,006,0321,0,912 ,5 ,917 ,1671 ,0,3,1,3,0,1,0,76.14,54.88 ,33.33
03,001,02,006,0322,0,404 ,1 ,405 ,752 ,0,3,1,3,0,1,0,76.14,53.86 ,33.33
03,001,02,006,0323,0,852 ,15 ,867 ,1317 ,0,3,1,3,0,1,0,76.14,65.83 ,33.33
03,001,02,006,0324,0,388 ,1 ,389 ,659 ,0,3,1,3,0,1,0,76.14,59.03 ,33.33
03,001,02,006,0325,0,1233 ,16 ,1249 ,2118 ,0,3,1,3,0,1,0,76.14,58.97 ,33.33
03,001,02,006,0326,0,980 ,8 ,988 ,1701 ,0,3,1,3,0,1,0,76.14,58.08 ,33.33
03,001,02,006,0327,0,1133 ,4 ,1137 ,2059 ,0,3,1,3,0,1,0,76.14,55.22 ,33.33
03,001,02,006,0328,0,838 ,6 ,844 ,1405 ,0,3,1,3,0,1,0,76.14,60.07 ,33.33
03,001,02,006,0329,0,615 ,28 ,643 ,1084 ,0,3,1,3,0,1,0,76.14,59.32 ,33.33
03,001,02,006,0330,0,1007 ,10 ,1017 ,1712 ,0,3,1,3,0,1,0,76.14,59.40 ,33.33
03,001,02,006,0331,0,1096 ,9 ,1105 ,2056 ,0,3,1,3,0,1,0,76.14,53.75 ,33.33
03,001,02,006,0332,0,1530 ,17 ,1547 ,2588 ,0,3,1,3,0,1,0,76.14,59.78 ,33.33
03,001,02,006,0333,0,920 ,8 ,928 ,1656 ,0,3,1,3,0,1,0,76.14,56.04 ,33.33
03,001,02,006,0334,0,710 ,8 ,718 ,1154 ,0,3,1,3,0,1,0,76.14,62.22 ,33.33
03,001,02,006,0335,0,755 ,8 ,763 ,1303 ,0,3,1,3,0,1,0,76.14,58.56 ,33.33
03,001,02,006,0336,0,1291 ,11 ,1302 ,2250 ,0,3,1,3,0,1,0,76.14,57.87 ,33.33
03,001,02,006,0337,0,1521 ,20 ,1541 ,2571 ,0,3,1,3,0,1,0,76.14,59.94 ,33.33
03,001,02,006,0338,0,926 ,15 ,941 ,1582 ,0,3,1,3,0,1,0,76.14,59.48 ,33.33
03,001,02,006,0339,0,1095 ,5 ,1100 ,1833 ,0,3,1,3,0,1,0,76.14,60.01 ,33.33
03,001,02,006,0340,0,2182 ,19 ,2201 ,3753 ,0,3,1,3,0,1,0,76.14,58.65 ,33.33
03,001,02,006,0341,0,1823 ,21 ,1844 ,3143 ,0,3,1,3,0,1,0,76.14,58.67 ,33.33
03,001,02,006,0342,0,2351 ,24 ,2375 ,4270 ,0,3,1,3,0,1,0,76.14,55.62 ,33.33
03,001,02,006,0343,0,1102 ,22 ,1124 ,1872 ,0,3,1,3,0,1,0,76.14,60.04 ,33.33
03,001,02,006,0344,0,1011 ,14 ,1025 ,1633 ,0,3,1,3,0,1,0,76.14,62.77 ,33.33
03,001,02,006,0345,0,1269 ,12 ,1281 ,2074 ,0,3,1,3,0,1,0,76.14,61.76 ,33.33
03,001,02,006,0346,0,1976 ,19 ,1995 ,3391 ,0,3,1,3,0,1,0,76.14,58.83 ,33.33
03,001,02,006,0347,0,1767 ,15 ,1782 ,2838 ,0,3,1,3,0,1,0,76.14,62.79 ,33.33
03,001,02,006,0348,0,1467 ,15 ,1482 ,2423 ,0,3,1,3,0,1,0,76.14,61.16 ,33.33
03,001,02,006,0349,0,1586 ,17 ,1603 ,2735 ,0,3,1,3,0,1,0,76.14,58.61 ,33.33
03,001,02,006,0350,0,1682 ,13 ,1695 ,2805 ,0,3,1,3,0,1,0,76.14,60.43 ,33.33
03,001,02,006,0351,0,1632 ,12 ,1644 ,2745 ,0,3,1,3,0,1,0,76.14,59.89 ,33.33
03,001,02,006,0352,0,2453 ,30 ,2483 ,4070 ,0,3,1,3,0,1,0,76.14,61.01 ,33.33
03,001,02,006,0353,0,1282 ,8 ,1290 ,2178 ,0,3,1,3,0,1,0,76.14,59.23 ,33.33
03,001,02,006,0354,0,2143 ,17 ,2160 ,3608 ,0,3,1,3,0,1,0,76.14,59.87 ,33.33
03,001,02,006,0355,0,1618 ,18 ,1636 ,2857 ,0,3,1,3,0,1,0,76.14,57.26 ,33.33
03,001,02,006,0356,0,1283 ,10 ,1293 ,2417 ,0,3,1,3,0,1,0,76.14,53.50 ,33.33
03,001,02,006,0357,0,1486 ,8 ,1494 ,2744 ,0,3,1,3,0,1,0,76.14,54.45 ,33.33
03,001,02,006,0358,0,2190 ,23 ,2213 ,3974 ,0,3,1,3,0,1,0,76.14,55.69 ,33.33
03,001,02,006,0359,0,2279 ,15 ,2294 ,4133 ,0,3,1,3,0,1,0,76.14,55.50 ,33.33
03,001,02,006,0360,0,2387 ,21 ,2408 ,4484 ,0,3,1,3,0,1,0,76.14,53.70 ,33.33
03,001,02,006,0361,0,1970 ,9 ,1979 ,3756 ,0,3,1,3,0,1,0,76.14,52.69 ,33.33
03,001,02,006,0362,0,3148 ,23 ,3171 ,5931 ,0,3,1,3,0,1,0,76.14,53.46 ,33.33
03,001,02,006,0363,0,1560 ,10 ,1570 ,3109 ,0,3,1,3,0,1,0,76.14,50.50 ,33.33
03,001,02,006,0364,0,1973 ,18 ,1991 ,3325 ,0,3,1,3,0,1,0,76.14,59.88 ,33.33
03,001,02,006,0365,0,1193 ,9 ,1202 ,2268 ,0,3,1,3,0,1,0,76.14,53.00 ,33.33
03,001,02,006,0366,0,1445 ,13 ,1458 ,2667 ,0,3,1,3,0,1,0,76.14,54.67 ,33.33
03,001,02,006,0367,0,1125 ,15 ,1140 ,1979 ,0,3,1,3,0,1,0,76.14,57.60 ,33.33
03,001,02,006,0368,0,1204 ,10 ,1214 ,2007 ,0,3,1,3,0,1,0,76.14,60.49 ,33.33
03,001,02,006,0369,0,1191 ,16 ,1207 ,1987 ,0,3,1,3,0,1,0,76.14,60.74 ,33.33
03,001,02,006,0370,0,1846 ,28 ,1874 ,3161 ,0,3,1,3,0,1,0,76.14,59.29 ,33.33
03,001,02,006,0371,0,1126 ,19 ,1145 ,2058 ,0,3,1,3,0,1,0,76.14,55.64 ,33.33
03,001,02,006,0372,0,2007 ,21 ,2028 ,3667 ,0,3,1,3,0,1,0,76.14,55.30 ,33.33
03,001,02,006,0373,0,1204 ,12 ,1216 ,2228 ,0,3,1,3,0,1,0,76.14,54.58 ,33.33
03,001,02,006,0374,0,1446 ,14 ,1460 ,2668 ,0,3,1,3,0,1,0,76.14,54.72 ,33.33
03,001,02,006,0375,0,966 ,13 ,979 ,1778 ,0,3,1,3,0,1,0,76.14,55.06 ,33.33
03,001,02,006,0376,0,1669 ,9 ,1678 ,2901 ,0,3,1,3,0,1,0,76.14,57.84 ,33.33
03,001,02,006,0377,0,1228 ,12 ,1240 ,2165 ,0,3,1,3,0,1,0,76.14,57.27 ,33.33
03,001,02,006,0378,0,1791 ,12 ,1803 ,3001 ,0,3,1,3,0,1,0,76.14,60.08 ,33.33
03,001,02,006,0379,0,1800 ,17 ,1817 ,3191 ,0,3,1,3,0,1,0,76.14,56.94 ,33.33
03,001,02,006,0380,0,1692 ,19 ,1711 ,3085 ,0,3,1,3,0,1,0,76.14,55.46 ,33.33
03,001,02,007,0381,0,2166 ,17 ,2183 ,3899 ,0,3,1,3,0,1,0,76.14,55.9887150551,33.33
03,001,02,007,0382,0,1768 ,12 ,1780 ,3340 ,0,3,1,3,0,1,0,76.14,53.2934131737,33.33
03,001,02,007,0383,0,1550 ,14 ,1564 ,2688 ,0,3,1,3,0,1,0,76.14,58.1845238095,33.33
03,001,02,007,0384,0,1841 ,21 ,1862 ,3268 ,0,3,1,3,0,1,0,76.14,56.976744186,33.33
03,001,02,007,0385,0,2046 ,17 ,2063 ,3679 ,0,3,1,3,0,1,0,76.14,56.075020386,33.33
03,001,02,007,0386,0,1563 ,12 ,1575 ,2822 ,0,3,1,3,0,1,0,76.14,55.811481219,33.33
03,001,02,007,0387,0,1418 ,6 ,1424 ,2446 ,0,3,1,3,0,1,0,76.14,58.2174979558,33.33
03,001,02,007,0388,0,1677 ,15 ,1692 ,3163 ,0,3,1,3,0,1,0,76.14,53.4935188113,33.33
03,001,02,007,0389,0,1768 ,9 ,1777 ,3581 ,0,3,1,3,0,1,0,76.14,49.6230103323,33.33
03,001,02,007,0390,0,952 ,16 ,968 ,1766 ,0,3,1,3,0,1,0,76.14,54.8131370328,33.33
03,001,02,007,0391,0,595 ,5 ,600 ,1151 ,0,3,1,3,0,1,0,76.14,52.1285838401,33.33
03,001,02,007,0392,0,2147 ,15 ,2162 ,4136 ,0,3,1,3,0,1,0,76.14,52.2727272727,33.33
03,001,02,007,0393,0,2206 ,18 ,2224 ,4368 ,0,3,1,3,0,1,0,76.14,50.9157509158,33.33
03,001,02,007,0394,0,2315 ,15 ,2330 ,4574 ,0,3,1,3,0,1,0,76.14,50.9400961959,33.33
03,001,02,007,0395,0,2128 ,31 ,2159 ,4303 ,0,3,1,3,0,1,0,76.14,50.1742970021,33.33
03,001,02,007,0396,0,1499 ,8 ,1507 ,3043 ,0,3,1,3,0,1,0,76.14,49.5234965495,33.33
03,001,02,007,0397,0,2286 ,15 ,2301 ,4213 ,0,3,1,3,0,1,0,76.14,54.6166627107,33.33
03,001,02,007,0398,0,1781 ,13 ,1794 ,3104 ,0,3,1,3,0,1,0,76.14,57.7963917526,33.33
03,001,02,007,0399,0,1982 ,29 ,2011 ,3725 ,0,3,1,3,0,1,0,76.14,53.9865771812,33.33
03,001,02,007,0400,0,1591 ,16 ,1607 ,2717 ,0,3,1,3,0,1,0,76.14,59.1461170409,33.33
03,001,02,007,0401,0,1269 ,18 ,1287 ,2313 ,0,3,1,3,0,1,0,76.14,55.6420233463,33.33
03,001,02,007,0402,0,2178 ,15 ,2193 ,4059 ,0,3,1,3,0,1,0,76.14,54.0280857354,33.33
03,001,02,007,0403,0,2441 ,12 ,2453 ,4701 ,0,3,1,3,0,1,0,76.14,52.1803871517,33.33
03,001,02,007,0404,0,1471 ,16 ,1487 ,2615 ,0,3,1,3,0,1,0,76.14,56.8642447419,33.33
03,001,02,007,0405,0,976 ,7 ,983 ,1728 ,0,3,1,3,0,1,0,76.14,56.8865740741,33.33
03,001,02,007,0406,0,2138 ,4 ,2142 ,3996 ,0,3,1,3,0,1,0,76.14,53.6036036036,33.33
03,001,02,007,0407,0,1178 ,15 ,1193 ,2768 ,0,3,1,3,0,1,0,76.14,43.0997109827,33.33
03,001,02,007,0408,0,1677 ,12 ,1689 ,2766 ,0,3,1,3,0,1,0,76.14,61.0629067245,33.33
03,001,02,007,0409,0,1251 ,11 ,1262 ,2199 ,0,3,1,3,0,1,0,76.14,57.3897226012,33.33
03,001,02,007,0410,0,1189 ,12 ,1201 ,2070 ,0,3,1,3,0,1,0,76.14,58.0193236715,33.33
03,001,02,007,0411,0,1440 ,7 ,1447 ,2602 ,0,3,1,3,0,1,0,76.14,55.6110684089,33.33
03,001,02,007,0412,0,1402 ,21 ,1423 ,2357 ,0,3,1,3,0,1,0,76.14,60.373355961,33.33
03,001,02,007,0413,0,3368 ,16 ,3384 ,6437 ,0,3,1,3,0,1,0,76.14,52.5710734814,33.33
03,001,02,007,0414,0,3200 ,22 ,3222 ,6260 ,0,3,1,3,0,1,0,76.14,51.4696485623,33.33
03,001,02,007,0415,0,2021 ,18 ,2039 ,3906 ,0,3,1,3,0,1,0,76.14,52.2017409114,33.33
03,001,02,007,0416,0,909 ,10 ,919 ,1740 ,0,3,1,3,0,1,0,76.14,52.816091954,33.33
03,001,02,007,0417,0,1576 ,10 ,1586 ,2975 ,0,3,1,3,0,1,0,76.14,53.3109243697,33.33
03,001,02,007,0418,0,1259 ,7 ,1266 ,2093 ,0,3,1,3,0,1,0,76.14,60.4873387482,33.33
03,001,02,008,0419,0,2596 ,30 ,2626 ,4443 ,0,3,1,3,0,1,0,76.14,59.1042088679,33.33
03,001,02,008,0420,0,2060 ,14 ,2074 ,3420 ,0,3,1,3,0,1,0,76.14,60.6432748538,33.33
03,001,02,008,0421,0,2664 ,15 ,2679 ,4278 ,0,3,1,3,0,1,0,76.14,62.6227208976,33.33
03,001,02,008,0422,0,2239 ,19 ,2258 ,3689 ,0,3,1,3,0,1,0,76.14,61.2089997289,33.33
03,001,02,008,0423,0,1098 ,10 ,1108 ,1738 ,0,3,1,3,0,1,0,76.14,63.751438435,33.33
03,001,02,008,0424,0,1855 ,19 ,1874 ,3046 ,0,3,1,3,0,1,0,76.14,61.523309258,33.33
03,001,02,008,0425,0,1846 ,17 ,1863 ,3076 ,0,3,1,3,0,1,0,76.14,60.5656697009,33.33
03,001,02,008,0426,0,1518 ,14 ,1532 ,3336 ,0,3,1,3,0,1,0,76.14,45.9232613909,33.33
03,001,02,008,0427,0,893 ,2 ,895 ,1438 ,0,3,1,3,0,1,0,76.14,62.2392211405,33.33
03,001,02,008,0428,0,992 ,9 ,1001 ,1574 ,0,3,1,3,0,1,0,76.14,63.5959339263,33.33
03,001,02,008,0429,0,1302 ,8 ,1310 ,2204 ,0,3,1,3,0,1,0,76.14,59.4373865699,33.33
03,001,02,008,0430,0,1860 ,17 ,1877 ,3232 ,0,3,1,3,0,1,0,76.14,58.0754950495,33.33
03,001,02,008,0431,0,1253 ,9 ,1262 ,2102 ,0,3,1,3,0,1,0,76.14,60.0380589914,33.33
03,001,02,008,0432,0,1657 ,7 ,1664 ,3125 ,0,3,1,3,0,1,0,76.14,53.248,33.33
03,001,02,008,0433,0,1413 ,13 ,1426 ,2780 ,0,3,1,3,0,1,0,76.14,51.2949640288,33.33
03,001,02,008,0434,0,2188 ,17 ,2205 ,3944 ,0,3,1,3,0,1,0,76.14,55.9077079108,33.33
03,001,02,008,0435,0,2013 ,17 ,2030 ,3660 ,0,3,1,3,0,1,0,76.14,55.4644808743,33.33
03,001,02,008,0436,0,1517 ,9 ,1526 ,2839 ,0,3,1,3,0,1,0,76.14,53.7513208876,33.33
03,001,02,008,0437,0,2328 ,26 ,2354 ,4310 ,0,3,1,3,0,1,0,76.14,54.6171693735,33.33
03,001,02,008,0438,0,1282 ,8 ,1290 ,2344 ,0,3,1,3,0,1,0,76.14,55.0341296928,33.33
03,001,02,008,0439,0,1594 ,8 ,1602 ,2718 ,0,3,1,3,0,1,0,76.14,58.940397351,33.33
03,001,02,008,0440,0,1564 ,15 ,1579 ,2865 ,0,3,1,3,0,1,0,76.14,55.1134380454,33.33
03,001,02,008,0441,0,1380 ,7 ,1387 ,2355 ,0,3,1,3,0,1,0,76.14,58.8959660297,33.33
03,001,02,008,0442,0,1136 ,10 ,1146 ,2057 ,0,3,1,3,0,1,0,76.14,55.7122022363,33.33
03,001,02,008,0443,0,2299 ,32 ,2331 ,3968 ,0,3,1,3,0,1,0,76.14,58.7449596774,33.33
03,001,02,008,0444,0,1329 ,27 ,1356 ,2400 ,0,3,1,3,0,1,0,76.14,56.5,33.33
03,001,02,008,0445,0,2374 ,9 ,2383 ,4332 ,0,3,1,3,0,1,0,76.14,55.0092336103,33.33
03,001,02,008,0446,0,1864 ,17 ,1881 ,3220 ,0,3,1,3,0,1,0,76.14,58.4161490683,33.33
03,001,02,008,0447,0,903 ,6 ,909 ,1585 ,0,3,1,3,0,1,0,76.14,57.3501577287,33.33
03,001,02,008,0448,0,2737 ,20 ,2757 ,4700 ,0,3,1,3,0,1,0,76.14,58.6595744681,33.33
03,001,02,008,0449,0,2159 ,11 ,2170 ,3692 ,0,3,1,3,0,1,0,76.14,58.7757313109,33.33
03,001,02,008,0450,0,1074 ,9 ,1083 ,1754 ,0,3,1,3,0,1,0,76.14,61.7445838084,33.33
03,001,02,008,0451,0,1313 ,4 ,1317 ,2228 ,0,3,1,3,0,1,0,76.14,59.1113105925,33.33
03,001,02,008,0452,0,2138 ,18 ,2156 ,3737 ,0,3,1,3,0,1,0,76.14,57.6933369013,33.33
03,001,02,008,0453,0,2234 ,16 ,2250 ,3872 ,0,3,1,3,0,1,0,76.14,58.1095041322,33.33
03,001,02,008,0454,0,1604 ,14 ,1618 ,2704 ,0,3,1,3,0,1,0,76.14,59.8372781065,33.33
03,001,02,008,0455,0,1544 ,16 ,1560 ,2881 ,0,3,1,3,0,1,0,76.14,54.1478653245,33.33
03,001,02,008,0456,0,1734 ,12 ,1746 ,3061 ,0,3,1,3,0,1,0,76.14,57.0401829467,33.33
03,001,02,008,0457,0,1438 ,5 ,1443 ,2771 ,0,3,1,3,0,1,0,76.14,52.0750631541,33.33
03,001,02,008,0458,0,2608 ,18 ,2626 ,4578 ,0,3,1,3,0,1,0,76.14,57.3612931411,33.33
03,001,02,008,0459,0,944 ,8 ,952 ,1755 ,0,3,1,3,0,1,0,76.14,54.245014245,33.33
03,001,02,008,0460,0,2611 ,10 ,2621 ,4686 ,0,3,1,3,0,1,0,76.14,55.9325650875,33.33
03,001,02,008,0461,0,3250 ,19 ,3269 ,6054 ,0,3,1,3,0,1,0,76.14,53.9973571193,33.33
03,001,02,008,0462,0,2907 ,16 ,2923 ,5607 ,0,3,1,3,0,1,0,76.14,52.1312644908,33.33
03,001,02,008,0463,0,3147 ,24 ,3171 ,5817 ,0,3,1,3,0,1,0,76.14,54.5126353791,33.33
03,001,02,008,0464,0,1539 ,14 ,1553 ,2710 ,0,3,1,3,0,1,0,76.14,57.3062730627,33.33
03,001,02,008,0465,0,1696 ,12 ,1708 ,3119 ,0,3,1,3,0,1,0,76.14,54.7611413915,33.33
03,001,02,008,0466,0,2077 ,14 ,2091 ,3796 ,0,3,1,3,0,1,0,76.14,55.0842992624,33.33
03,001,02,008,0467,0,2245 ,12 ,2257 ,3952 ,0,3,1,3,0,1,0,76.14,57.1103238866,33.33
03,001,02,008,0468,0,1659 ,11 ,1670 ,3048 ,0,3,1,3,0,1,0,76.14,54.7900262467,33.33
03,001,02,008,0469,0,923 ,9 ,932 ,1429 ,0,3,1,3,0,1,0,76.14,65.2204338698,33.33
03,001,02,008,0470,0,1190 ,11 ,1201 ,2000 ,0,3,1,3,0,1,0,76.14,60.05,33.33
03,001,02,008,0471,0,2658 ,21 ,2679 ,4607 ,0,3,1,3,0,1,0,76.14,58.1506403299,33.33
03,001,02,008,0472,0,1241 ,13 ,1254 ,1973 ,0,3,1,3,0,1,0,76.14,63.5580334516,33.33
03,001,02,008,0473,0,1156 ,8 ,1164 ,1937 ,0,3,1,3,0,1,0,76.14,60.092927207,33.33
03,001,02,008,0474,0,2773 ,14 ,2787 ,5359 ,0,3,1,3,0,1,0,76.14,52.0059712633,33.33
03,001,02,008,0475,0,1819 ,13 ,1832 ,3607 ,0,3,1,3,0,1,0,76.14,50.7901303022,33.33
03,001,02,008,0476,0,964 ,3 ,967 ,1759 ,0,3,1,3,0,1,0,76.14,54.9744172825,33.33
03,001,02,008,0477,0,2439 ,18 ,2457 ,4690 ,0,3,1,3,0,1,0,76.14,52.3880597015,33.33
03,001,02,008,0478,0,790 ,12 ,802 ,1516 ,0,3,1,3,0,1,0,76.14,52.9023746702,33.33
03,001,02,008,0479,0,2258 ,14 ,2272 ,4399 ,0,3,1,3,0,1,0,76.14,51.6481018413,33.33
03,001,02,008,0480,0,2753 ,15 ,2768 ,5004 ,0,3,1,3,0,1,0,76.14,55.3157474021,33.33
03,001,02,008,0481,0,1045 ,14 ,1059 ,1955 ,0,3,1,3,0,1,0,76.14,54.168797954,33.33
03,001,02,008,0482,0,1158 ,8 ,1166 ,2055 ,0,3,1,3,0,1,0,76.14,56.7396593674,33.33
03,001,02,008,0483,0,1462 ,13 ,1475 ,2689 ,0,3,1,3,0,1,0,76.14,54.8531052436,33.33
03,001,02,008,0484,0,1265 ,4 ,1269 ,2216 ,0,3,1,3,0,1,0,76.14,57.2653429603,33.33
03,001,02,008,0485,0,1425 ,11 ,1436 ,2650 ,0,3,1,3,0,1,0,76.14,54.1886792453,33.33
03,001,02,008,0486,0,1097 ,9 ,1106 ,2009 ,0,3,1,3,0,1,0,76.14,55.0522648084,33.33
03,001,02,008,0487,0,2821 ,15 ,2836 ,5048 ,0,3,1,3,0,1,0,76.14,56.1806656101,33.33
03,001,02,008,0488,0,1960 ,15 ,1975 ,3825 ,0,3,1,3,0,1,0,76.14,51.6339869281,33.33
03,001,02,008,0489,0,1990 ,8 ,1998 ,3862 ,0,3,1,3,0,1,0,76.14,51.7348524081,33.33
03,001,02,008,0490,0,2284 ,14 ,2298 ,4450 ,0,3,1,3,0,1,0,76.14,51.6404494382,33.33
03,001,02,008,0491,0,1302 ,6 ,1308 ,2387 ,0,3,1,3,0,1,0,76.14,54.7968160871,33.33
03,001,02,008,0492,0,1326 ,12 ,1338 ,2491 ,0,3,1,3,0,1,0,76.14,53.7133681253,33.33
03,001,02,008,0493,0,1254 ,12 ,1266 ,2508 ,0,3,1,3,0,1,0,76.14,50.4784688995,33.33
03,001,02,008,0494,0,1967 ,23 ,1990 ,3772 ,0,3,1,3,0,1,0,76.14,52.7571580064,33.33
03,001,02,008,0495,0,1722 ,10 ,1732 ,3618 ,0,3,1,3,0,1,0,76.14,47.8717523494,33.33
03,001,02,008,0496,0,1470 ,12 ,1482 ,2884 ,0,3,1,3,0,1,0,76.14,51.386962552,33.33
03,001,02,008,0497,0,2148 ,15 ,2163 ,4483 ,0,3,1,3,0,1,0,76.14,48.2489404417,33.33
03,001,02,008,0498,0,1522 ,13 ,1535 ,2926 ,0,3,1,3,0,1,0,76.14,52.4606971975,33.33
03,001,02,008,0499,0,1493 ,17 ,1510 ,2753 ,0,3,1,3,0,1,0,76.14,54.8492553578,33.33
03,001,02,008,0500,0,987 ,5 ,992 ,1973 ,0,3,1,3,0,1,0,76.14,50.2787633046,33.33
03,001,02,008,0501,0,1485 ,13 ,1498 ,2778 ,0,3,1,3,0,1,0,76.14,53.9236861051,33.33
03,001,02,008,0502,0,2238 ,31 ,2269 ,4271 ,0,3,1,3,0,1,0,76.14,53.1257316788,33.33
03,001,02,009,0503,0,2205 ,18 ,2223 ,3801 ,0,3,1,3,0,1,0,76.14,58.4846093133,33.33
03,001,02,009,0504,0,667 ,3 ,670 ,1116 ,0,3,1,3,0,1,0,76.14,60.0358422939,33.33
03,001,02,009,0505,0,1410 ,15 ,1425 ,2508 ,0,3,1,3,0,1,0,76.14,56.8181818182,33.33
03,001,02,009,0506,0,1506 ,18 ,1524 ,2746 ,0,3,1,3,0,1,0,76.14,55.4989075018,33.33
03,001,02,009,0507,0,750 ,6 ,756 ,1270 ,0,3,1,3,0,1,0,76.14,59.5275590551,33.33
03,001,02,009,0508,0,2310 ,19 ,2329 ,4177 ,0,3,1,3,0,1,0,76.14,55.7577208523,33.33
03,001,02,009,0509,0,1187 ,11 ,1198 ,2257 ,0,3,1,3,0,1,0,76.14,53.079308817,33.33
03,001,02,009,0510,0,1548 ,15 ,1563 ,3051 ,0,3,1,3,0,1,0,76.14,51.2291052114,33.33
03,001,02,009,0511,0,1550 ,15 ,1565 ,2693 ,0,3,1,3,0,1,0,76.14,58.1136279242,33.33
03,001,02,009,0512,0,735 ,5 ,740 ,1168 ,0,3,1,3,0,1,0,76.14,63.3561643836,33.33
03,001,02,009,0513,0,1692 ,11 ,1703 ,2830 ,0,3,1,3,0,1,0,76.14,60.1766784452,33.33
03,001,02,009,0514,0,1494 ,7 ,1501 ,2600 ,0,3,1,3,0,1,0,76.14,57.7307692308,33.33
03,001,02,009,0515,0,1736 ,14 ,1750 ,3218 ,0,3,1,3,0,1,0,76.14,54.3816034804,33.33
03,001,02,009,0516,0,1564 ,8 ,1572 ,2563 ,0,3,1,3,0,1,0,76.14,61.3343737807,33.33
03,001,02,009,0517,0,2094 ,14 ,2108 ,3621 ,0,3,1,3,0,1,0,76.14,58.2159624413,33.33
03,001,02,009,0518,0,2759 ,23 ,2782 ,5128 ,0,3,1,3,0,1,0,76.14,54.2511700468,33.33
03,001,02,009,0519,0,2342 ,12 ,2354 ,4754 ,0,3,1,3,0,1,0,76.14,49.5161968868,33.33
03,001,02,009,0520,0,1292 ,8 ,1300 ,1847 ,0,3,1,3,0,1,0,76.14,70.3844071467,33.33
03,001,02,010,0521,0,547 ,7 ,554 ,866 ,0,3,1,3,0,1,0,76.14,63.9722863741,33.33
03,001,02,010,0522,0,1615 ,15 ,1630 ,2829 ,0,3,1,3,0,1,0,76.14,57.6175326971,33.33
03,001,02,010,0523,0,2427 ,19 ,2446 ,4398 ,0,3,1,3,0,1,0,76.14,55.6161891769,33.33
03,001,02,010,0524,0,2660 ,14 ,2674 ,4645 ,0,3,1,3,0,1,0,76.14,57.5672766416,33.33
03,001,02,010,0525,0,1615 ,8 ,1623 ,2652 ,0,3,1,3,0,1,0,76.14,61.1990950226,33.33
03,001,02,010,0526,0,1891 ,24 ,1915 ,3146 ,0,3,1,3,0,1,0,76.14,60.8709472346,33.33
03,001,02,010,0527,0,2152 ,16 ,2168 ,4131 ,0,3,1,3,0,1,0,76.14,52.4812394093,33.33
03,001,02,010,0528,0,1827 ,19 ,1846 ,3205 ,0,3,1,3,0,1,0,76.14,57.5975039002,33.33
03,001,02,010,0529,0,2359 ,17 ,2376 ,4181 ,0,3,1,3,0,1,0,76.14,56.8285099259,33.33
03,001,02,010,0530,0,1741 ,15 ,1756 ,2949 ,0,3,1,3,0,1,0,76.14,59.5456086809,33.33
03,001,02,010,0531,0,1079 ,12 ,1091 ,1812 ,0,3,1,3,0,1,0,76.14,60.2097130243,33.33
03,001,02,010,0532,0,1592 ,16 ,1608 ,2712 ,0,3,1,3,0,1,0,76.14,59.2920353982,33.33
03,001,02,010,0533,0,1798 ,13 ,1811 ,3097 ,0,3,1,3,0,1,0,76.14,58.4759444624,33.33
03,001,02,010,0534,0,1858 ,14 ,1872 ,3034 ,0,3,1,3,0,1,0,76.14,61.7007251154,33.33
03,001,02,010,0535,0,2196 ,17 ,2213 ,3875 ,0,3,1,3,0,1,0,76.14,57.1096774194,33.33
03,001,02,011,0536,0,1917 ,19 ,1936 ,3426 ,0,3,1,3,0,1,0,76.14,56.509048453,33.33
03,001,02,011,0537,0,1877 ,21 ,1898 ,3480 ,0,3,1,3,0,1,0,76.14,54.5402298851,33.33
03,001,02,011,0538,0,1913 ,10 ,1923 ,3308 ,0,3,1,3,0,1,0,76.14,58.1318016929,33.33
03,001,02,011,0539,0,1948 ,15 ,1963 ,3261 ,0,3,1,3,0,1,0,76.14,60.1962588163,33.33
03,001,02,011,0540,0,1351 ,10 ,1361 ,2332 ,0,3,1,3,0,1,0,76.14,58.3619210978,33.33
03,001,02,011,0541,0,697 ,16 ,713 ,1101 ,0,3,1,3,0,1,0,76.14,64.7593097184,33.33
03,001,02,011,0542,0,749 ,11 ,760 ,1267 ,0,3,1,3,0,1,0,76.14,59.9842146803,33.33
03,001,02,011,0543,0,469 ,6 ,475 ,746 ,0,3,1,3,0,1,0,76.14,63.672922252,33.33
03,001,02,011,0544,0,1751 ,12 ,1763 ,3361 ,0,3,1,3,0,1,0,76.14,52.4546265992,33.33
03,001,02,011,0545,0,2044 ,11 ,2055 ,4015 ,0,3,1,3,0,1,0,76.14,51.1830635118,33.33
03,001,02,011,0546,0,2173 ,15 ,2188 ,3960 ,0,3,1,3,0,1,0,76.14,55.2525252525,33.33
03,001,02,011,0547,0,1439 ,15 ,1454 ,2760 ,0,3,1,3,0,1,0,76.14,52.6811594203,33.33
03,001,02,011,0548,0,579 ,7 ,586 ,949 ,0,3,1,3,0,1,0,76.14,61.7492096944,33.33
03,001,02,011,0549,0,594 ,4 ,598 ,933 ,0,3,1,3,0,1,0,76.14,64.0943193998,33.33
03,001,02,011,0550,0,452 ,1 ,453 ,637 ,0,3,1,3,0,1,0,76.14,71.114599686,33.33
03,001,02,011,0551,0,283 ,2 ,285 ,446 ,0,3,1,3,0,1,0,76.14,63.9013452915,33.33
03,001,02,011,0552,0,480 ,6 ,486 ,875 ,0,3,1,3,0,1,0,76.14,55.5428571429,33.33
03,001,02,012,0553,0,345 ,5 ,350 ,571 ,0,3,1,3,0,1,0,76.14,61.295971979,33.33
03,001,02,012,0554,0,612 ,4 ,616 ,946 ,0,3,1,3,0,1,0,76.14,65.1162790698,33.33
03,001,02,012,0555,0,760 ,9 ,769 ,1339 ,0,3,1,3,0,1,0,76.14,57.430918596,33.33
03,001,02,012,0556,0,848 ,9 ,857 ,1373 ,0,3,1,3,0,1,0,76.14,62.4180626366,33.33
03,001,02,012,0557,0,401 ,0 ,401 ,786 ,0,3,1,3,0,1,0,76.14,51.0178117048,33.33
03,001,02,012,0558,0,485 ,5 ,490 ,811 ,0,3,1,3,0,1,0,76.14,60.4192355117,33.33
03,001,02,012,0559,0,1161 ,10 ,1171 ,2152 ,0,3,1,3,0,1,0,76.14,54.4144981413,33.33
03,001,02,012,0560,0,1000 ,18 ,1018 ,1823 ,0,3,1,3,0,1,0,76.14,55.8420186506,33.33
03,001,02,012,0561,0,604 ,3 ,607 ,1008 ,0,3,1,3,0,1,0,76.14,60.2182539683,33.33
03,001,02,012,0562,0,480 ,2 ,482 ,781 ,0,3,1,3,0,1,0,76.14,61.7157490397,33.33
03,001,02,012,0563,0,575 ,9 ,584 ,1053 ,0,3,1,3,0,1,0,76.14,55.4605887939,33.33
03,001,02,012,0564,0,2674 ,18 ,2692 ,4727 ,0,3,1,3,0,1,0,76.14,56.9494393907,33.33
03,001,02,012,0565,0,3689 ,27 ,3716 ,6750 ,0,3,1,3,0,1,0,76.14,55.0518518519,33.33
03,001,02,012,0566,0,2193 ,14 ,2207 ,4231 ,0,3,1,3,0,1,0,76.14,52.1626093122,33.33
03,001,02,012,0567,0,1126 ,11 ,1137 ,2119 ,0,3,1,3,0,1,0,76.14,53.6573855592,33.33
03,001,02,012,0568,0,1688 ,10 ,1698 ,3445 ,0,3,1,3,0,1,0,76.14,49.2888243832,33.33
03,001,02,012,0569,0,758 ,6 ,764 ,1290 ,0,3,1,3,0,1,0,76.14,59.2248062016,33.33
03,001,02,012,0570,0,643 ,2 ,645 ,1060 ,0,3,1,3,0,1,0,76.14,60.8490566038,33.33
03,001,02,012,0571,0,4698 ,26 ,4724 ,9083 ,0,3,1,3,0,1,0,76.14,52.0092480458,33.33
03,001,02,012,0572,0,7272 ,48 ,7320 ,14277 ,0,3,1,3,0,1,0,76.14,51.271275478,33.33
03,001,02,012,0573,0,902 ,9 ,911 ,1679 ,0,3,1,3,0,1,0,76.14,54.2584871948,33.33
03,001,02,012,0574,0,5469 ,57 ,5526 ,10307 ,0,3,1,3,0,1,0,76.14,53.6140487048,33.33
03,001,02,012,0575,0,1997 ,26 ,2023 ,3540 ,0,3,1,3,0,1,0,76.14,57.1468926554,33.33
03,001,02,012,0576,0,840 ,8 ,848 ,1472 ,0,3,1,3,0,1,0,76.14,57.6086956522,33.33
03,001,02,012,0577,0,583 ,11 ,594 ,1038 ,0,3,1,3,0,1,0,76.14,57.225433526,33.33
03,001,02,012,0578,0,522 ,6 ,528 ,798 ,0,3,1,3,0,1,0,76.14,66.1654135338,33.33
03,001,02,012,0579,0,744 ,8 ,752 ,1341 ,0,3,1,3,0,1,0,76.14,56.0775540641,33.33
03,001,02,012,0580,0,482 ,6 ,488 ,733 ,0,3,1,3,0,1,0,76.14,66.5757162347,33.33
03,001,02,012,0581,0,458 ,3 ,461 ,728 ,0,3,1,3,0,1,0,76.14,63.3241758242,33.33
03,001,02,012,0582,0,289 ,3 ,292 ,674 ,0,3,1,3,0,1,0,76.14,43.3234421365,33.33
03,001,02,012,0583,0,861 ,9 ,870 ,1477 ,0,3,1,3,0,1,0,76.14,58.9031821259,33.33
03,001,02,012,0584,0,2165 ,19 ,2184 ,3755 ,0,3,1,3,0,1,0,76.14,58.1624500666,33.33
03,001,02,012,0585,0,2723 ,27 ,2750 ,4897 ,0,3,1,3,0,1,0,76.14,56.1568307127,33.33
03,001,02,013,0586,0,2438 ,18 ,2456 ,4420 ,0,3,1,3,0,1,0,76.14,55.5656108597,33.33
03,001,02,013,0587,0,1262 ,14 ,1276 ,2269 ,0,3,1,3,0,1,0,76.14,56.236227413,33.33
03,001,02,013,0588,0,901 ,10 ,911 ,1511 ,0,3,1,3,0,1,0,76.14,60.2911978822,33.33
03,001,02,013,0589,0,1346 ,11 ,1357 ,2469 ,0,3,1,3,0,1,0,76.14,54.9615228838,33.33
03,001,02,013,0590,0,653 ,6 ,659 ,1133 ,0,3,1,3,0,1,0,76.14,58.1641659312,33.33
03,001,02,013,0591,0,2270 ,23 ,2293 ,4445 ,0,3,1,3,0,1,0,76.14,51.5860517435,33.33
03,001,02,013,0592,0,1406 ,9 ,1415 ,2541 ,0,3,1,3,0,1,0,76.14,55.6867375049,33.33
03,001,02,013,0593,0,741 ,8 ,749 ,1296 ,0,3,1,3,0,1,0,76.14,57.7932098765,33.33
03,001,02,013,0594,0,761 ,3 ,764 ,1109 ,0,3,1,3,0,1,0,76.14,68.8908926961,33.33
03,001,02,013,0595,0,712 ,13 ,725 ,1065 ,0,3,1,3,0,1,0,76.14,68.0751173709,33.33
03,001,02,014,0596,0,217 ,1 ,218 ,353 ,0,3,1,3,0,1,0,76.14,61.7563739377,33.33
03,001,02,014,0597,0,2075 ,10 ,2085 ,3678 ,0,3,1,3,0,1,0,76.14,56.6884176183,33.33
03,001,02,014,0598,0,468 ,4 ,472 ,884 ,0,3,1,3,0,1,0,76.14,53.3936651584,33.33
03,001,02,014,0599,0,487 ,4 ,491 ,800 ,0,3,1,3,0,1,0,76.14,61.375,33.33
03,001,02,014,0600,0,2637 ,20 ,2657 ,5076 ,0,3,1,3,0,1,0,76.14,52.3443656422,33.33
03,001,02,014,0601,0,261 ,4 ,265 ,459 ,0,3,1,3,0,1,0,76.14,57.734204793,33.33
03,001,02,014,0602,0,354 ,4 ,358 ,529 ,0,3,1,3,0,1,0,76.14,67.6748582231,33.33
03,001,02,014,0603,0,466 ,4 ,470 ,764 ,0,3,1,3,0,1,0,76.14,61.5183246073,33.33
03,001,02,014,0604,0,851 ,7 ,858 ,1599 ,0,3,1,3,0,1,0,76.14,53.6585365854,33.33
03,001,02,014,0605,0,367 ,2 ,369 ,648 ,0,3,1,3,0,1,0,76.14,56.9444444444,33.33
03,001,02,014,0606,0,313 ,2 ,315 ,492 ,0,3,1,3,0,1,0,76.14,64.0243902439,33.33
03,001,02,014,0607,0,390 ,3 ,393 ,620 ,0,3,1,3,0,1,0,76.14,63.3870967742,33.33
03,001,02,014,0608,0,613 ,2 ,615 ,1109 ,0,3,1,3,0,1,0,76.14,55.4553651939,33.33
03,001,02,015,0609,0,524 ,4 ,528 ,895 ,0,3,1,3,0,1,0,76.14,58.9944134078,33.33
03,001,02,015,0610,0,682 ,6 ,688 ,1085 ,0,3,1,3,0,1,0,76.14,63.4101382488,33.33
03,001,02,015,0611,0,985 ,10 ,995 ,1790 ,0,3,1,3,0,1,0,76.14,55.5865921788,33.33
03,001,02,015,0612,0,411 ,2 ,413 ,726 ,0,3,1,3,0,1,0,76.14,56.8870523416,33.33
03,001,02,015,0613,0,729 ,9 ,738 ,1213 ,0,3,1,3,0,1,0,76.14,60.8408903545,33.33
03,001,02,015,0614,0,675 ,7 ,682 ,1240 ,0,3,1,3,0,1,0,76.14,55,33.33
03,001,02,015,0615,0,155 ,1 ,156 ,300 ,0,3,1,3,0,1,0,76.14,52,33.33
03,001,02,015,0616,0,301 ,3 ,304 ,499 ,0,3,1,3,0,1,0,76.14,60.9218436874,33.33
03,001,02,015,0617,0,464 ,8 ,472 ,763 ,0,3,1,3,0,1,0,76.14,61.8610747051,33.33
03,001,02,016,0618,0,304 ,0 ,304 ,443 ,0,3,1,3,0,1,0,76.14,68.6230248307,33.33
03,001,02,016,0619,0,406 ,6 ,412 ,635 ,0,3,1,3,0,1,0,76.14,64.8818897638,33.33
03,001,02,016,0620,0,292 ,0 ,292 ,470 ,0,3,1,3,0,1,0,76.14,62.1276595745,33.33
03,001,02,016,0621,0,915 ,3 ,918 ,1594 ,0,3,1,3,0,1,0,76.14,57.590966123,33.33
03,001,02,016,0622,0,4032 ,31 ,4063 ,6916 ,0,3,1,3,0,1,0,76.14,58.7478311163,33.33
03,001,02,016,0623,0,886 ,12 ,898 ,1428 ,0,3,1,3,0,1,0,76.14,62.8851540616,33.33
03,001,02,016,0624,0,570 ,6 ,576 ,995 ,0,3,1,3,0,1,0,76.14,57.8894472362,33.33
03,001,02,016,0625,0,233 ,3 ,236 ,377 ,0,3,1,3,0,1,0,76.14,62.599469496,33.33
03,001,02,016,0626,0,353 ,4 ,357 ,544 ,0,3,1,3,0,1,0,76.14,65.625,33.33
03,001,02,016,0627,0,367 ,5 ,372 ,601 ,0,3,1,3,0,1,0,76.14,61.8968386023,33.33
03,001,02,016,0628,0,512 ,5 ,517 ,835 ,0,3,1,3,0,1,0,76.14,61.9161676647,33.33
03,001,02,016,0629,0,120 ,1 ,121 ,191 ,0,3,1,3,0,1,0,76.14,63.3507853403,33.33
03,001,02,016,0630,0,294 ,1 ,295 ,467 ,0,3,1,3,0,1,0,76.14,63.1691648822,33.33
03,001,02,016,0631,0,358 ,0 ,358 ,583 ,0,3,1,3,0,1,0,76.14,61.4065180103,33.33
03,001,02,017,0632,0,1864 ,10 ,1874 ,3137 ,0,3,1,3,0,1,0,76.14,59.7386037616,33.33
03,001,02,017,0633,0,1033 ,15 ,1048 ,1949 ,0,3,1,3,0,1,0,76.14,53.7711646998,33.33
03,001,02,017,0634,0,898 ,18 ,916 ,1721 ,0,3,1,3,0,1,0,76.14,53.2248692621,33.33
03,001,02,017,0635,0,1364 ,8 ,1372 ,2403 ,0,3,1,3,0,1,0,76.14,57.0952975447,33.33
03,001,02,017,0636,0,1347 ,14 ,1361 ,2195 ,0,3,1,3,0,1,0,76.14,62.0045558087,33.33
03,001,02,017,0637,0,307 ,4 ,311 ,469 ,0,3,1,3,0,1,0,76.14,66.3113006397,33.33
03,001,02,017,0638,0,464 ,5 ,469 ,779 ,0,3,1,3,0,1,0,76.14,60.2053915276,33.33
03,001,02,017,0639,0,301 ,1 ,302 ,528 ,0,3,1,3,0,1,0,76.14,57.196969697,33.33
03,001,02,017,0640,0,298 ,4 ,302 ,554 ,0,3,1,3,0,1,0,76.14,54.5126353791,33.33
03,001,02,017,0641,0,463 ,4 ,467 ,807 ,0,3,1,3,0,1,0,76.14,57.8686493185,33.33
03,001,03,018,0642,0,2064 ,21 ,2085 ,3867 ,0,3,1,3,0,1,0,76.14,53.92 ,33.33
03,001,03,018,0643,0,671 ,3 ,674 ,1154 ,0,3,1,3,0,1,0,76.14,58.41 ,33.33
03,001,03,018,0644,0,3008 ,15 ,3023 ,5022 ,0,3,1,3,0,1,0,76.14,60.20 ,33.33
03,001,03,018,0645,0,2641 ,13 ,2654 ,4348 ,0,3,1,3,0,1,0,76.14,61.04 ,33.33
03,001,03,018,0646,0,1276 ,9 ,1285 ,2211 ,0,3,1,3,0,1,0,76.14,58.12 ,33.33
03,001,03,018,0647,0,2179 ,12 ,2191 ,3767 ,0,3,1,3,0,1,0,76.14,58.16 ,33.33
03,001,03,018,0648,0,1787 ,12 ,1799 ,3027 ,0,3,1,3,0,1,0,76.14,59.43 ,33.33
03,001,03,018,0649,0,1718 ,4 ,1722 ,2799 ,0,3,1,3,0,1,0,76.14,61.52 ,33.33
03,001,03,018,0650,0,2188 ,25 ,2213 ,3843 ,0,3,1,3,0,1,0,76.14,57.59 ,33.33
03,001,03,018,0651,0,1915 ,16 ,1931 ,3382 ,0,3,1,3,0,1,0,76.14,57.10 ,33.33
03,001,03,018,0652,0,2096 ,20 ,2116 ,3555 ,0,3,1,3,0,1,0,76.14,59.52 ,33.33
03,001,03,018,0653,0,2420 ,19 ,2439 ,3914 ,0,3,1,3,0,1,0,76.14,62.31 ,33.33
03,001,03,018,0654,0,2297 ,16 ,2313 ,3901 ,0,3,1,3,0,1,0,76.14,59.29 ,33.33
03,001,03,018,0655,0,2379 ,23 ,2402 ,4190 ,0,3,1,3,0,1,0,76.14,57.33 ,33.33
03,001,03,018,0656,0,1912 ,12 ,1924 ,3242 ,0,3,1,3,0,1,0,76.14,59.35 ,33.33
03,001,03,018,0657,0,2419 ,22 ,2441 ,4091 ,0,3,1,3,0,1,0,76.14,59.67 ,33.33
03,001,03,018,0658,0,3701 ,18 ,3719 ,6397 ,0,3,1,3,0,1,0,76.14,58.14 ,33.33
03,001,03,018,0659,0,2387 ,16 ,2403 ,4105 ,0,3,1,3,0,1,0,76.14,58.54 ,33.33
03,001,03,018,0660,0,3804 ,23 ,3827 ,6713 ,0,3,1,3,0,1,0,76.14,57.01 ,33.33
03,001,03,018,0661,0,2201 ,17 ,2218 ,3602 ,0,3,1,3,0,1,0,76.14,61.58 ,33.33
03,001,03,018,0662,0,2029 ,20 ,2049 ,3538 ,0,3,1,3,0,1,0,76.14,57.91 ,33.33
03,001,03,018,0663,0,2010 ,14 ,2024 ,3383 ,0,3,1,3,0,1,0,76.14,59.83 ,33.33
03,001,03,018,0664,0,1315 ,13 ,1328 ,2161 ,0,3,1,3,0,1,0,76.14,61.45 ,33.33
03,001,03,018,0665,0,2099 ,10 ,2109 ,3273 ,0,3,1,3,0,1,0,76.14,64.44 ,33.33
03,001,03,018,0666,0,1545 ,22 ,1567 ,2679 ,0,3,1,3,0,1,0,76.14,58.49 ,33.33
03,001,03,018,0667,0,1026 ,6 ,1032 ,1570 ,0,3,1,3,0,1,0,76.14,65.73 ,33.33
03,001,03,018,0668,0,1957 ,13 ,1970 ,3101 ,0,3,1,3,0,1,0,76.14,63.53 ,33.33
03,001,03,018,0669,0,1548 ,9 ,1557 ,2510 ,0,3,1,3,0,1,0,76.14,62.03 ,33.33
03,001,03,018,0670,0,2249 ,12 ,2261 ,3509 ,0,3,1,3,0,1,0,76.14,64.43 ,33.33
03,001,03,018,0671,0,2581 ,19 ,2600 ,4022 ,0,3,1,3,0,1,0,76.14,64.64 ,33.33
03,001,03,018,0672,0,2247 ,5 ,2252 ,3457 ,0,3,1,3,0,1,0,76.14,65.14 ,33.33
03,001,03,018,0673,0,2017 ,15 ,2032 ,3267 ,0,3,1,3,0,1,0,76.14,62.20 ,33.33
03,001,03,018,0674,0,2176 ,16 ,2192 ,3700 ,0,3,1,3,0,1,0,76.14,59.24 ,33.33
03,001,03,018,0675,0,1746 ,11 ,1757 ,2944 ,0,3,1,3,0,1,0,76.14,59.68 ,33.33
03,001,03,018,0676,0,1504 ,13 ,1517 ,2340 ,0,3,1,3,0,1,0,76.14,64.83 ,33.33
03,001,03,018,0677,0,2589 ,23 ,2612 ,4075 ,0,3,1,3,0,1,0,76.14,64.10 ,33.33
03,001,03,018,0678,0,3166 ,24 ,3190 ,5304 ,0,3,1,3,0,1,0,76.14,60.14 ,33.33
03,001,03,018,0679,0,2399 ,14 ,2413 ,4085 ,0,3,1,3,0,1,0,76.14,59.07 ,33.33
03,001,03,018,0680,0,2068 ,15 ,2083 ,3403 ,0,3,1,3,0,1,0,76.14,61.21 ,33.33
03,001,03,018,0681,0,1311 ,13 ,1324 ,2175 ,0,3,1,3,0,1,0,76.14,60.87 ,33.33
03,001,03,018,0682,0,2084 ,15 ,2099 ,3430 ,0,3,1,3,0,1,0,76.14,61.20 ,33.33
03,001,03,018,0683,0,1414 ,14 ,1428 ,2373 ,0,3,1,3,0,1,0,76.14,60.18 ,33.33
03,001,03,018,0684,0,1870 ,19 ,1889 ,3196 ,0,3,1,3,0,1,0,76.14,59.11 ,33.33
03,001,03,018,0685,0,1623 ,9 ,1632 ,2617 ,0,3,1,3,0,1,0,76.14,62.36 ,33.33
03,001,03,018,0686,0,2994 ,23 ,3017 ,5615 ,0,3,1,3,0,1,0,76.14,53.73 ,33.33
03,001,03,018,0687,0,2541 ,12 ,2553 ,3887 ,0,3,1,3,0,1,0,76.14,65.68 ,33.33
03,001,03,018,0688,0,2073 ,21 ,2094 ,3367 ,0,3,1,3,0,1,0,76.14,62.19 ,33.33
03,001,03,018,0689,0,2599 ,27 ,2626 ,4403 ,0,3,1,3,0,1,0,76.14,59.64 ,33.33
03,001,03,018,0690,0,1895 ,8 ,1903 ,3084 ,0,3,1,3,0,1,0,76.14,61.71 ,33.33
03,001,03,018,0691,0,1728 ,15 ,1743 ,2849 ,0,3,1,3,0,1,0,76.14,61.18 ,33.33
03,001,03,018,0692,0,1679 ,7 ,1686 ,2738 ,0,3,1,3,0,1,0,76.14,61.58 ,33.33
03,001,03,018,0693,0,1251 ,6 ,1257 ,1944 ,0,3,1,3,0,1,0,76.14,64.66 ,33.33
03,001,03,018,0694,0,214 ,3 ,217 ,329 ,0,3,1,3,0,1,0,76.14,65.96 ,33.33
03,001,03,018,0695,0,2422 ,21 ,2443 ,4167 ,0,3,1,3,0,1,0,76.14,58.63 ,33.33
03,001,03,018,0696,0,1379 ,10 ,1389 ,2163 ,0,3,1,3,0,1,0,76.14,64.22 ,33.33
03,001,03,018,0697,0,1939 ,18 ,1957 ,3187 ,0,3,1,3,0,1,0,76.14,61.41 ,33.33
03,001,03,018,0698,0,1904 ,14 ,1918 ,4054 ,0,3,1,3,0,1,0,76.14,47.31 ,33.33
03,001,03,018,0699,0,2213 ,14 ,2227 ,3897 ,0,3,1,3,0,1,0,76.14,57.15 ,33.33
03,001,03,018,0700,0,1228 ,13 ,1241 ,2020 ,0,3,1,3,0,1,0,76.14,61.44 ,33.33
03,001,03,018,0701,0,2684 ,19 ,2703 ,4602 ,0,3,1,3,0,1,0,76.14,58.74 ,33.33
03,001,03,018,0702,0,2253 ,20 ,2273 ,3730 ,0,3,1,3,0,1,0,76.14,60.94 ,33.33
03,001,03,018,0703,0,2358 ,25 ,2383 ,3961 ,0,3,1,3,0,1,0,76.14,60.16 ,33.33
03,001,03,018,0704,0,1942 ,15 ,1957 ,3165 ,0,3,1,3,0,1,0,76.14,61.83 ,33.33
03,001,03,018,0705,0,2559 ,31 ,2590 ,4236 ,0,3,1,3,0,1,0,76.14,61.14 ,33.33
03,001,03,018,0706,0,2596 ,13 ,2609 ,4188 ,0,3,1,3,0,1,0,76.14,62.30 ,33.33
03,001,03,018,0707,0,1608 ,10 ,1618 ,2654 ,0,3,1,3,0,1,0,76.14,60.96 ,33.33
03,001,03,018,0708,0,1646 ,8 ,1654 ,2815 ,0,3,1,3,0,1,0,76.14,58.76 ,33.33
03,001,03,018,0709,0,2360 ,16 ,2376 ,4238 ,0,3,1,3,0,1,0,76.14,56.06 ,33.33
03,001,03,018,0710,0,840 ,11 ,851 ,1423 ,0,3,1,3,0,1,0,76.14,59.80 ,33.33
03,001,03,018,0711,0,1889 ,15 ,1904 ,3201 ,0,3,1,3,0,1,0,76.14,59.48 ,33.33
03,001,03,018,0712,0,322 ,1 ,323 ,518 ,0,3,1,3,0,1,0,76.14,62.36 ,33.33
03,001,03,018,0713,0,2685 ,26 ,2711 ,4563 ,0,3,1,3,0,1,0,76.14,59.41 ,33.33
03,001,03,018,0714,0,1504 ,9 ,1513 ,2240 ,0,3,1,3,0,1,0,76.14,67.54 ,33.33
03,001,03,018,0715,0,1506 ,10 ,1516 ,2558 ,0,3,1,3,0,1,0,76.14,59.27 ,33.33
03,001,03,018,0716,0,2039 ,18 ,2057 ,3602 ,0,3,1,3,0,1,0,76.14,57.11 ,33.33
03,001,03,018,0717,0,1088 ,24 ,1112 ,2557 ,0,3,1,3,0,1,0,76.14,43.49 ,33.33
03,001,03,018,0718,0,1302 ,10 ,1312 ,2199 ,0,3,1,3,0,1,0,76.14,59.66 ,33.33
03,001,03,018,0719,0,1749 ,12 ,1761 ,3323 ,0,3,1,3,0,1,0,76.14,52.99 ,33.33
03,001,03,018,0720,0,2626 ,12 ,2638 ,4633 ,0,3,1,3,0,1,0,76.14,56.94 ,33.33
03,001,03,018,0721,0,1755 ,17 ,1772 ,3110 ,0,3,1,3,0,1,0,76.14,56.98 ,33.33
03,001,03,018,0722,0,2245 ,23 ,2268 ,3897 ,0,3,1,3,0,1,0,76.14,58.20 ,33.33
03,001,03,018,0723,0,1846 ,19 ,1865 ,3024 ,0,3,1,3,0,1,0,76.14,61.67 ,33.33
03,001,03,018,0724,0,1126 ,5 ,1131 ,1827 ,0,3,1,3,0,1,0,76.14,61.90 ,33.33
03,001,03,018,0725,0,1772 ,16 ,1788 ,2957 ,0,3,1,3,0,1,0,76.14,60.47 ,33.33
03,001,03,018,0726,0,2003 ,14 ,2017 ,3341 ,0,3,1,3,0,1,0,76.14,60.37 ,33.33
03,001,03,018,0727,0,1565 ,17 ,1582 ,2777 ,0,3,1,3,0,1,0,76.14,56.97 ,33.33
03,001,03,018,0728,0,2146 ,24 ,2170 ,3997 ,0,3,1,3,0,1,0,76.14,54.29 ,33.33
03,001,03,018,0729,0,2086 ,12 ,2098 ,3694 ,0,3,1,3,0,1,0,76.14,56.79 ,33.33
03,001,03,018,0730,0,2041 ,16 ,2057 ,3546 ,0,3,1,3,0,1,0,76.14,58.01 ,33.33
03,001,03,018,0731,0,1801 ,17 ,1818 ,3158 ,0,3,1,3,0,1,0,76.14,57.57 ,33.33
03,001,03,018,0732,0,1421 ,14 ,1435 ,2599 ,0,3,1,3,0,1,0,76.14,55.21 ,33.33
03,001,03,018,0733,0,2235 ,8 ,2243 ,3471 ,0,3,1,3,0,1,0,76.14,64.62 ,33.33
03,001,03,018,0734,0,1907 ,24 ,1931 ,3349 ,0,3,1,3,0,1,0,76.14,57.66 ,33.33
03,001,03,019,0735,0,910 ,3 ,913 ,1472 ,0,3,1,3,0,1,0,76.14,62.02 ,33.33
03,001,03,019,0736,0,636 ,9 ,645 ,1054 ,0,3,1,3,0,1,0,76.14,61.20 ,33.33
03,001,03,019,0737,0,1293 ,10 ,1303 ,2150 ,0,3,1,3,0,1,0,76.14,60.60 ,33.33
03,001,03,019,0738,0,2026 ,17 ,2043 ,3365 ,0,3,1,3,0,1,0,76.14,60.71 ,33.33
03,001,03,019,0739,0,1876 ,14 ,1890 ,3181 ,0,3,1,3,0,1,0,76.14,59.42 ,33.33
03,001,03,019,0740,0,1956 ,13 ,1969 ,3163 ,0,3,1,3,0,1,0,76.14,62.25 ,33.33
03,001,03,019,0741,0,1854 ,11 ,1865 ,3063 ,0,3,1,3,0,1,0,76.14,60.89 ,33.33
03,001,03,019,0742,0,688 ,7 ,695 ,1079 ,0,3,1,3,0,1,0,76.14,64.41 ,33.33
03,001,03,019,0743,0,1565 ,3 ,1568 ,2560 ,0,3,1,3,0,1,0,76.14,61.25 ,33.33
03,001,03,019,0744,0,1729 ,8 ,1737 ,2936 ,0,3,1,3,0,1,0,76.14,59.16 ,33.33
03,001,03,019,0745,0,1214 ,12 ,1226 ,2042 ,0,3,1,3,0,1,0,76.14,60.04 ,33.33
03,001,03,019,0746,0,1834 ,12 ,1846 ,3904 ,0,3,1,3,0,1,0,76.14,47.28 ,33.33
03,001,03,019,0747,0,1692 ,3 ,1695 ,2675 ,0,3,1,3,0,1,0,76.14,63.36 ,33.33
03,001,03,019,0748,0,2338 ,12 ,2350 ,4059 ,0,3,1,3,0,1,0,76.14,57.90 ,33.33
03,001,03,019,0749,0,2347 ,18 ,2365 ,3764 ,0,3,1,3,0,1,0,76.14,62.83 ,33.33
03,001,03,019,0750,0,1811 ,16 ,1827 ,3096 ,0,3,1,3,0,1,0,76.14,59.01 ,33.33
03,001,03,019,0751,0,1579 ,12 ,1591 ,2568 ,0,3,1,3,0,1,0,76.14,61.95 ,33.33
03,001,03,019,0752,0,1564 ,6 ,1570 ,2548 ,0,3,1,3,0,1,0,76.14,61.62 ,33.33
03,001,03,019,0753,0,2385 ,15 ,2400 ,3967 ,0,3,1,3,0,1,0,76.14,60.50 ,33.33
03,001,03,019,0754,0,2443 ,19 ,2462 ,4048 ,0,3,1,3,0,1,0,76.14,60.82 ,33.33
03,001,03,019,0755,0,2268 ,17 ,2285 ,3863 ,0,3,1,3,0,1,0,76.14,59.15 ,33.33
03,001,03,019,0756,0,2327 ,11 ,2338 ,3781 ,0,3,1,3,0,1,0,76.14,61.84 ,33.33
03,001,03,019,0757,0,1922 ,20 ,1942 ,3333 ,0,3,1,3,0,1,0,76.14,58.27 ,33.33
03,001,03,019,0758,0,1516 ,10 ,1526 ,2513 ,0,3,1,3,0,1,0,76.14,60.72 ,33.33
03,001,03,019,0759,0,1847 ,12 ,1859 ,2953 ,0,3,1,3,0,1,0,76.14,62.95 ,33.33
03,001,03,019,0760,0,1355 ,6 ,1361 ,2293 ,0,3,1,3,0,1,0,76.14,59.35 ,33.33
03,001,03,019,0761,0,1658 ,3 ,1661 ,2726 ,0,3,1,3,0,1,0,76.14,60.93 ,33.33
03,001,03,019,0762,0,2108 ,13 ,2121 ,3421 ,0,3,1,3,0,1,0,76.14,62.00 ,33.33
03,001,03,019,0763,0,1422 ,7 ,1429 ,2526 ,0,3,1,3,0,1,0,76.14,56.57 ,33.33
03,001,03,019,0764,0,1524 ,7 ,1531 ,2505 ,0,3,1,3,0,1,0,76.14,61.12 ,33.33
03,001,03,019,0765,0,2362 ,17 ,2379 ,3837 ,0,3,1,3,0,1,0,76.14,62.00 ,33.33
03,001,03,019,0766,0,1513 ,13 ,1526 ,2623 ,0,3,1,3,0,1,0,76.14,58.18 ,33.33
03,001,03,019,0767,0,1763 ,11 ,1774 ,2936 ,0,3,1,3,0,1,0,76.14,60.42 ,33.33
03,001,03,019,0768,0,2444 ,17 ,2461 ,4023 ,0,3,1,3,0,1,0,76.14,61.17 ,33.33
03,001,03,019,0769,0,2114 ,11 ,2125 ,3545 ,0,3,1,3,0,1,0,76.14,59.94 ,33.33
03,001,03,019,0770,0,1871 ,9 ,1880 ,3200 ,0,3,1,3,0,1,0,76.14,58.75 ,33.33
03,001,03,019,0771,0,1337 ,6 ,1343 ,2165 ,0,3,1,3,0,1,0,76.14,62.03 ,33.33
03,001,03,019,0772,0,2111 ,11 ,2122 ,3531 ,0,3,1,3,0,1,0,76.14,60.10 ,33.33
03,001,03,019,0773,0,1246 ,7 ,1253 ,2078 ,0,3,1,3,0,1,0,76.14,60.30 ,33.33
03,001,03,019,0774,0,2129 ,18 ,2147 ,3464 ,0,3,1,3,0,1,0,76.14,61.98 ,33.33
03,001,03,019,0775,0,1562 ,14 ,1576 ,2603 ,0,3,1,3,0,1,0,76.14,60.55 ,33.33
03,001,03,019,0776,0,2012 ,10 ,2022 ,3290 ,0,3,1,3,0,1,0,76.14,61.46 ,33.33
03,001,03,019,0777,0,1932 ,16 ,1948 ,3123 ,0,3,1,3,0,1,0,76.14,62.38 ,33.33
03,001,03,019,0778,0,1066 ,7 ,1073 ,1750 ,0,3,1,3,0,1,0,76.14,61.31 ,33.33
03,001,03,019,0779,0,2252 ,14 ,2266 ,3678 ,0,3,1,3,0,1,0,76.14,61.61 ,33.33
03,001,03,019,0780,0,2356 ,20 ,2376 ,3906 ,0,3,1,3,0,1,0,76.14,60.83 ,33.33
03,001,03,019,0781,0,2571 ,25 ,2596 ,4195 ,0,3,1,3,0,1,0,76.14,61.88 ,33.33
03,001,03,019,0782,0,3305 ,17 ,3322 ,5430 ,0,3,1,3,0,1,0,76.14,61.18 ,33.33
03,001,03,019,0783,0,2947 ,12 ,2959 ,5348 ,0,3,1,3,0,1,0,76.14,55.33 ,33.33
03,001,03,019,0784,0,1989 ,14 ,2003 ,3287 ,0,3,1,3,0,1,0,76.14,60.94 ,33.33
03,001,03,019,0785,0,603 ,7 ,610 ,891 ,0,3,1,3,0,1,0,76.14,68.46 ,33.33
03,001,03,019,0786,0,467 ,6 ,473 ,766 ,0,3,1,3,0,1,0,76.14,61.75 ,33.33
03,001,03,019,0787,0,582 ,8 ,590 ,923 ,0,3,1,3,0,1,0,76.14,63.92 ,33.33
03,001,03,019,0788,0,460 ,3 ,463 ,696 ,0,3,1,3,0,1,0,76.14,66.52 ,33.33
03,001,03,019,0789,0,1474 ,14 ,1488 ,2377 ,0,3,1,3,0,1,0,76.14,62.60 ,33.33
03,001,03,019,0790,0,1296 ,11 ,1307 ,2202 ,0,3,1,3,0,1,0,76.14,59.36 ,33.33
03,001,03,019,0791,0,1333 ,11 ,1344 ,2136 ,0,3,1,3,0,1,0,76.14,62.92 ,33.33
03,001,03,019,0792,0,936 ,11 ,947 ,1606 ,0,3,1,3,0,1,0,76.14,58.97 ,33.33
03,001,03,019,0793,0,1011 ,7 ,1018 ,1750 ,0,3,1,3,0,1,0,76.14,58.17 ,33.33
03,001,03,019,0794,0,1364 ,10 ,1374 ,2173 ,0,3,1,3,0,1,0,76.14,63.23 ,33.33
03,001,03,019,0795,0,1329 ,8 ,1337 ,2192 ,0,3,1,3,0,1,0,76.14,60.99 ,33.33
03,001,03,019,0796,0,1330 ,11 ,1341 ,2127 ,0,3,1,3,0,1,0,76.14,63.05 ,33.33
03,001,03,020,0797,0,852 ,7 ,859 ,1465 ,0,3,1,3,0,1,0,76.14,58.63 ,33.33
03,001,03,020,0798,0,659 ,3 ,662 ,1126 ,0,3,1,3,0,1,0,76.14,58.79 ,33.33
03,001,03,020,0799,0,1249 ,11 ,1260 ,2244 ,0,3,1,3,0,1,0,76.14,56.15 ,33.33
03,001,03,020,0800,0,839 ,9 ,848 ,1392 ,0,3,1,3,0,1,0,76.14,60.92 ,33.33
03,001,03,020,0801,0,450 ,5 ,455 ,691 ,0,3,1,3,0,1,0,76.14,65.85 ,33.33
03,001,03,020,0802,0,1397 ,4 ,1401 ,2091 ,0,3,1,3,0,1,0,76.14,67.00 ,33.33
03,001,03,020,0803,0,2821 ,11 ,2832 ,5600 ,0,3,1,3,0,1,0,76.14,50.57 ,33.33
03,001,03,020,0804,0,3118 ,11 ,3129 ,4895 ,0,3,1,3,0,1,0,76.14,63.92 ,33.33
03,001,03,020,0805,0,1372 ,14 ,1386 ,2276 ,0,3,1,3,0,1,0,76.14,60.90 ,33.33
03,001,03,020,0806,0,3192 ,19 ,3211 ,5483 ,0,3,1,3,0,1,0,76.14,58.56 ,33.33
03,001,03,020,0807,0,3449 ,25 ,3474 ,5794 ,0,3,1,3,0,1,0,76.14,59.96 ,33.33
03,001,03,020,0808,0,1183 ,15 ,1198 ,1972 ,0,3,1,3,0,1,0,76.14,60.75 ,33.33
03,001,03,020,0809,0,1779 ,14 ,1793 ,2989 ,0,3,1,3,0,1,0,76.14,59.99 ,33.33
03,001,03,020,0810,0,1361 ,9 ,1370 ,2209 ,0,3,1,3,0,1,0,76.14,62.02 ,33.33
03,001,03,020,0811,0,3267 ,15 ,3282 ,5549 ,0,3,1,3,0,1,0,76.14,59.15 ,33.33
03,001,03,020,0812,0,1889 ,11 ,1900 ,3158 ,0,3,1,3,0,1,0,76.14,60.16 ,33.33
03,001,03,020,0813,0,1244 ,8 ,1252 ,2058 ,0,3,1,3,0,1,0,76.14,60.84 ,33.33
03,001,03,020,0814,0,1549 ,11 ,1560 ,2512 ,0,3,1,3,0,1,0,76.14,62.10 ,33.33
03,001,03,020,0815,0,2114 ,7 ,2121 ,3349 ,0,3,1,3,0,1,0,76.14,63.33 ,33.33
03,001,03,020,0816,0,1720 ,7 ,1727 ,2829 ,0,3,1,3,0,1,0,76.14,61.05 ,33.33
03,001,03,020,0817,0,1966 ,16 ,1982 ,3334 ,0,3,1,3,0,1,0,76.14,59.45 ,33.33
03,001,03,020,0818,0,1548 ,7 ,1555 ,2496 ,0,3,1,3,0,1,0,76.14,62.30 ,33.33
03,001,03,020,0819,0,2093 ,8 ,2101 ,3414 ,0,3,1,3,0,1,0,76.14,61.54 ,33.33
03,001,03,020,0820,0,1896 ,6 ,1902 ,3336 ,0,3,1,3,0,1,0,76.14,57.01 ,33.33
03,001,03,020,0821,0,523 ,2 ,525 ,802 ,0,3,1,3,0,1,0,76.14,65.46 ,33.33
03,001,03,020,0822,0,2258 ,6 ,2264 ,3618 ,0,3,1,3,0,1,0,76.14,62.58 ,33.33
03,001,03,020,0823,0,1825 ,5 ,1830 ,2968 ,0,3,1,3,0,1,0,76.14,61.66 ,33.33
03,001,03,020,0824,0,2178 ,15 ,2193 ,3570 ,0,3,1,3,0,1,0,76.14,61.43 ,33.33
03,001,03,020,0825,0,1900 ,7 ,1907 ,3183 ,0,3,1,3,0,1,0,76.14,59.91 ,33.33
03,001,03,020,0826,0,2121 ,11 ,2132 ,3318 ,0,3,1,3,0,1,0,76.14,64.26 ,33.33
03,001,03,020,0827,0,2369 ,6 ,2375 ,3815 ,0,3,1,3,0,1,0,76.14,62.25 ,33.33
03,001,03,020,0828,0,1669 ,9 ,1678 ,3037 ,0,3,1,3,0,1,0,76.14,55.25 ,33.33
03,001,03,020,0829,0,2242 ,14 ,2256 ,3794 ,0,3,1,3,0,1,0,76.14,59.46 ,33.33
03,001,03,020,0830,0,2638 ,15 ,2653 ,4480 ,0,3,1,3,0,1,0,76.14,59.22 ,33.33
03,001,03,020,0831,0,2788 ,13 ,2801 ,4555 ,0,3,1,3,0,1,0,76.14,61.49 ,33.33
03,001,03,020,0832,0,3264 ,21 ,3285 ,5489 ,0,3,1,3,0,1,0,76.14,59.85 ,33.33
03,001,03,020,0833,0,1593 ,11 ,1604 ,2629 ,0,3,1,3,0,1,0,76.14,61.01 ,33.33
03,001,03,020,0834,0,1296 ,4 ,1300 ,1906 ,0,3,1,3,0,1,0,76.14,68.21 ,33.33
03,001,03,020,0835,0,1452 ,19 ,1471 ,2525 ,0,3,1,3,0,1,0,76.14,58.26 ,33.33
03,001,03,020,0836,0,1339 ,10 ,1349 ,2109 ,0,3,1,3,0,1,0,76.14,63.96 ,33.33
03,001,03,020,0837,0,727 ,4 ,731 ,1301 ,0,3,1,3,0,1,0,76.14,56.19 ,33.33
03,001,03,020,0838,0,1074 ,10 ,1084 ,1803 ,0,3,1,3,0,1,0,76.14,60.12 ,33.33
03,001,03,020,0839,0,3420 ,22 ,3442 ,6025 ,0,3,1,3,0,1,0,76.14,57.13 ,33.33
03,001,03,020,0840,0,2541 ,20 ,2561 ,4393 ,0,3,1,3,0,1,0,76.14,58.30 ,33.33
03,001,03,020,0841,0,2338 ,13 ,2351 ,4058 ,0,3,1,3,0,1,0,76.14,57.93 ,33.33
03,001,03,020,0842,0,1858 ,16 ,1874 ,3118 ,0,3,1,3,0,1,0,76.14,60.10 ,33.33
03,001,03,020,0843,0,2345 ,12 ,2357 ,3982 ,0,3,1,3,0,1,0,76.14,59.19 ,33.33
03,001,03,020,0844,0,3818 ,19 ,3837 ,6954 ,0,3,1,3,0,1,0,76.14,55.18 ,33.33
03,001,03,020,0845,0,1852 ,7 ,1859 ,3109 ,0,3,1,3,0,1,0,76.14,59.79 ,33.33
03,001,03,020,0846,0,2701 ,23 ,2724 ,4742 ,0,3,1,3,0,1,0,76.14,57.44 ,33.33
03,001,03,020,0847,0,1452 ,4 ,1456 ,2682 ,0,3,1,3,0,1,0,76.14,54.29 ,33.33
03,001,03,020,0848,0,1511 ,5 ,1516 ,2544 ,0,3,1,3,0,1,0,76.14,59.59 ,33.33
03,001,03,020,0849,0,1793 ,9 ,1802 ,2767 ,0,3,1,3,0,1,0,76.14,65.12 ,33.33
03,001,03,020,0850,0,2622 ,19 ,2641 ,4635 ,0,3,1,3,0,1,0,76.14,56.98 ,33.33
03,001,03,020,0851,0,2406 ,7 ,2413 ,4594 ,0,3,1,3,0,1,0,76.14,52.53 ,33.33
03,001,03,020,0852,0,2407 ,25 ,2432 ,4271 ,0,3,1,3,0,1,0,76.14,56.94 ,33.33
03,001,03,020,0853,0,2637 ,16 ,2653 ,4445 ,0,3,1,3,0,1,0,76.14,59.69 ,33.33
03,001,03,020,0854,0,2109 ,7 ,2116 ,3475 ,0,3,1,3,0,1,0,76.14,60.89 ,33.33
03,001,03,020,0855,0,457 ,3 ,460 ,730 ,0,3,1,3,0,1,0,76.14,63.01 ,33.33
03,001,03,020,0856,0,896 ,4 ,900 ,1520 ,0,3,1,3,0,1,0,76.14,59.21 ,33.33
03,001,03,020,0857,0,2245 ,13 ,2258 ,3962 ,0,3,1,3,0,1,0,76.14,56.99 ,33.33
03,001,03,020,0858,0,2366 ,18 ,2384 ,4036 ,0,3,1,3,0,1,0,76.14,59.07 ,33.33
03,001,03,020,0859,0,1805 ,10 ,1815 ,3177 ,0,3,1,3,0,1,0,76.14,57.13 ,33.33
03,001,03,020,0860,0,426 ,3 ,429 ,754 ,0,3,1,3,0,1,0,76.14,56.90 ,33.33
03,001,03,020,0861,0,1280 ,9 ,1289 ,2115 ,0,3,1,3,0,1,0,76.14,60.95 ,33.33
03,001,03,020,0862,0,1307 ,18 ,1325 ,2238 ,0,3,1,3,0,1,0,76.14,59.20 ,33.33
03,001,03,020,0863,0,768 ,7 ,775 ,1346 ,0,3,1,3,0,1,0,76.14,57.58 ,33.33
03,001,03,020,0864,0,644 ,6 ,650 ,1090 ,0,3,1,3,0,1,0,76.14,59.63 ,33.33
03,001,03,020,0865,0,465 ,2 ,467 ,760 ,0,3,1,3,0,1,0,76.14,61.45 ,33.33
03,001,03,021,0866,0,1030 ,8 ,1038 ,1881 ,0,3,1,3,0,1,0,76.14,55.18 ,33.33
03,001,03,021,0867,0,986 ,9 ,995 ,1855 ,0,3,1,3,0,1,0,76.14,53.64 ,33.33
03,001,03,021,0868,0,1138 ,14 ,1152 ,2094 ,0,3,1,3,0,1,0,76.14,55.01 ,33.33
03,001,03,021,0869,0,787 ,3 ,790 ,1547 ,0,3,1,3,0,1,0,76.14,51.07 ,33.33
03,001,03,021,0870,0,1368 ,9 ,1377 ,2467 ,0,3,1,3,0,1,0,76.14,55.82 ,33.33
03,001,03,021,0871,0,1901 ,11 ,1912 ,3694 ,0,3,1,3,0,1,0,76.14,51.76 ,33.33
03,001,03,021,0872,0,833 ,9 ,842 ,1563 ,0,3,1,3,0,1,0,76.14,53.87 ,33.33
03,001,03,021,0873,0,311 ,4 ,315 ,488 ,0,3,1,3,0,1,0,76.14,64.55 ,33.33
03,001,03,022,0874,0,263 ,1 ,264 ,395 ,0,3,1,3,0,1,0,76.14,66.84 ,33.33
03,001,03,022,0875,0,394 ,4 ,398 ,670 ,0,3,1,3,0,1,0,76.14,59.40 ,33.33
03,001,03,022,0876,0,385 ,5 ,390 ,600 ,0,3,1,3,0,1,0,76.14,65.00 ,33.33
03,001,03,022,0877,0,162 ,2 ,164 ,294 ,0,3,1,3,0,1,0,76.14,55.78 ,33.33
03,001,03,022,0878,0,265 ,4 ,269 ,437 ,0,3,1,3,0,1,0,76.14,61.56 ,33.33
03,001,03,022,0879,0,381 ,3 ,384 ,697 ,0,3,1,3,0,1,0,76.14,55.09 ,33.33
03,001,03,022,0880,0,118 ,1 ,119 ,231 ,0,3,1,3,0,1,0,76.14,51.52 ,33.33
03,001,03,022,0881,0,410 ,5 ,415 ,756 ,0,3,1,3,0,1,0,76.14,54.89 ,33.33
03,001,03,022,0882,0,266 ,1 ,267 ,567 ,0,3,1,3,0,1,0,76.14,47.09 ,33.33
03,001,03,022,0883,0,139 ,1 ,140 ,241 ,0,3,1,3,0,1,0,76.14,58.09 ,33.33
03,001,03,022,0884,0,274 ,0 ,274 ,432 ,0,3,1,3,0,1,0,76.14,63.43 ,33.33
03,001,03,022,0885,0,418 ,3 ,421 ,680 ,0,3,1,3,0,1,0,76.14,61.91 ,33.33
03,001,03,023,0886,0,637 ,3 ,640 ,1024 ,0,3,1,3,0,1,0,76.14,62.50 ,33.33
03,001,03,023,0887,0,346 ,6 ,352 ,564 ,0,3,1,3,0,1,0,76.14,62.41 ,33.33
03,001,03,023,0888,0,530 ,3 ,533 ,964 ,0,3,1,3,0,1,0,76.14,55.29 ,33.33
03,001,03,023,0889,0,210 ,1 ,211 ,381 ,0,3,1,3,0,1,0,76.14,55.38 ,33.33
03,001,03,023,0890,0,408 ,5 ,413 ,711 ,0,3,1,3,0,1,0,76.14,58.09 ,33.33
03,001,03,023,0891,0,428 ,2 ,430 ,713 ,0,3,1,3,0,1,0,76.14,60.31 ,33.33
03,001,03,023,0892,0,411 ,2 ,413 ,776 ,0,3,1,3,0,1,0,76.14,53.22 ,33.33
03,001,03,024,0893,0,368 ,2 ,370 ,626 ,0,3,1,3,0,1,0,76.14,59.11 ,33.33
03,001,03,024,0894,0,603 ,7 ,610 ,1075 ,0,3,1,3,0,1,0,76.14,56.74 ,33.33
03,001,03,024,0895,0,95 ,0 ,95 ,147 ,0,3,1,3,0,1,0,76.14,64.63 ,33.33
03,001,03,024,0896,0,135 ,0 ,135 ,215 ,0,3,1,3,0,1,0,76.14,62.79 ,33.33
03,001,03,024,0897,0,52 ,0 ,52 ,90 ,0,3,1,3,0,1,0,76.14,57.78 ,33.33
03,001,03,025,0898,0,852 ,9 ,861 ,1527 ,0,3,1,3,0,1,0,76.14,56.39 ,33.33
03,001,03,025,0899,0,672 ,6 ,678 ,1207 ,0,3,1,3,0,1,0,76.14,56.17 ,33.33
03,001,03,025,0900,0,513 ,1 ,514 ,928 ,0,3,1,3,0,1,0,76.14,55.39 ,33.33
03,001,03,025,0901,0,1506 ,8 ,1514 ,2810 ,0,3,1,3,0,1,0,76.14,53.88 ,33.33
03,001,03,025,0902,0,1047 ,3 ,1050 ,1927 ,0,3,1,3,0,1,0,76.14,54.49 ,33.33
03,001,03,025,0903,0,212 ,2 ,214 ,370 ,0,3,1,3,0,1,0,76.14,57.84 ,33.33
03,001,03,025,0904,0,2357 ,15 ,2372 ,4317 ,0,3,1,3,0,1,0,76.14,54.95 ,33.33
03,001,03,025,0905,0,1220 ,27 ,1247 ,2371 ,0,3,1,3,0,1,0,76.14,52.59 ,33.33
03,001,03,025,0906,0,1613 ,9 ,1622 ,3010 ,0,3,1,3,0,1,0,76.14,53.89 ,33.33
03,001,03,025,0907,0,1574 ,11 ,1585 ,2844 ,0,3,1,3,0,1,0,76.14,55.73 ,33.33
03,001,03,025,0908,0,2689 ,18 ,2707 ,5243 ,0,3,1,3,0,1,0,76.14,51.63 ,33.33
03,001,03,025,0909,0,1743 ,16 ,1759 ,3395 ,0,3,1,3,0,1,0,76.14,51.81 ,33.33
03,001,03,025,0910,0,1446 ,17 ,1463 ,2670 ,0,3,1,3,0,1,0,76.14,54.79 ,33.33
03,001,03,025,0911,0,1712 ,11 ,1723 ,3126 ,0,3,1,3,0,1,0,76.14,55.12 ,33.33
03,001,03,025,0912,0,1616 ,17 ,1633 ,3086 ,0,3,1,3,0,1,0,76.14,52.92 ,33.33
03,001,03,025,0913,0,1684 ,12 ,1696 ,3266 ,0,3,1,3,0,1,0,76.14,51.93 ,33.33
03,001,03,025,0914,0,4525 ,27 ,4552 ,8303 ,0,3,1,3,0,1,0,76.14,54.82 ,33.33
03,001,03,025,0915,0,757 ,6 ,763 ,1376 ,0,3,1,3,0,1,0,76.14,55.45 ,33.33
03,001,03,025,0916,0,664 ,3 ,667 ,1245 ,0,3,1,3,0,1,0,76.14,53.57 ,33.33
03,001,03,025,0917,0,280 ,0 ,280 ,490 ,0,3,1,3,0,1,0,76.14,57.14 ,33.33
03,001,03,025,0918,0,1885 ,25 ,1910 ,3732 ,0,3,1,3,0,1,0,76.14,51.18 ,33.33
03,001,03,025,0919,0,1014 ,16 ,1030 ,1663 ,0,3,1,3,0,1,0,76.14,61.94 ,33.33
03,001,03,025,0920,0,2092 ,142 ,2234 ,4159 ,0,3,1,3,0,1,0,76.14,53.71 ,33.33
03,001,03,025,0921,0,1697 ,6 ,1703 ,3492 ,0,3,1,3,0,1,0,76.14,48.77 ,33.33
03,001,03,025,0922,0,670 ,6 ,676 ,1164 ,0,3,1,3,0,1,0,76.14,58.08 ,33.33
03,001,03,025,0923,0,471 ,2 ,473 ,781 ,0,3,1,3,0,1,0,76.14,60.56 ,33.33
03,001,03,025,0924,0,516 ,8 ,524 ,866 ,0,3,1,3,0,1,0,76.14,60.51 ,33.33
03,001,03,025,0925,0,1649 ,12 ,1661 ,3228 ,0,3,1,3,0,1,0,76.14,51.46 ,33.33
03,001,03,025,0926,0,1813 ,12 ,1825 ,3753 ,0,3,1,3,0,1,0,76.14,48.63 ,33.33
03,001,03,025,0927,0,833 ,8 ,841 ,1628 ,0,3,1,3,0,1,0,76.14,51.66 ,33.33
03,001,03,025,0928,0,2556 ,31 ,2587 ,5064 ,0,3,1,3,0,1,0,76.14,51.09 ,33.33
03,001,03,025,0929,0,1987 ,12 ,1999 ,4148 ,0,3,1,3,0,1,0,76.14,48.19 ,33.33
03,001,03,025,0930,0,713 ,5 ,718 ,1569 ,0,3,1,3,0,1,0,76.14,45.76 ,33.33
03,001,03,025,0931,0,2470 ,19 ,2489 ,5054 ,0,3,1,3,0,1,0,76.14,49.25 ,33.33
03,001,03,025,0932,0,1084 ,4 ,1088 ,2223 ,0,3,1,3,0,1,0,76.14,48.94 ,33.33
03,001,03,025,0933,0,1086 ,22 ,1108 ,2101 ,0,3,1,3,0,1,0,76.14,52.74 ,33.33
03,001,03,025,0934,0,1132 ,6 ,1138 ,2367 ,0,3,1,3,0,1,0,76.14,48.08 ,33.33
03,001,03,025,0935,0,2320 ,15 ,2335 ,4595 ,0,3,1,3,0,1,0,76.14,50.82 ,33.33
03,001,03,025,0936,0,2151 ,10 ,2161 ,4048 ,0,3,1,3,0,1,0,76.14,53.38 ,33.33
03,001,03,025,0937,0,2181 ,14 ,2195 ,4043 ,0,3,1,3,0,1,0,76.14,54.29 ,33.33
03,001,03,025,0938,0,1513 ,6 ,1519 ,2578 ,0,3,1,3,0,1,0,76.14,58.92 ,33.33
03,001,03,025,0939,0,548 ,5 ,553 ,955 ,0,3,1,3,0,1,0,76.14,57.91 ,33.33
03,001,03,025,0940,0,2226 ,20 ,2246 ,3893 ,0,3,1,3,0,1,0,76.14,57.69 ,33.33
03,001,03,025,0941,0,1515 ,6 ,1521 ,2840 ,0,3,1,3,0,1,0,76.14,53.56 ,33.33
03,001,03,025,0942,0,1424 ,12 ,1436 ,2382 ,0,3,1,3,0,1,0,76.14,60.29 ,33.33
03,001,03,025,0943,0,1519 ,12 ,1531 ,2642 ,0,3,1,3,0,1,0,76.14,57.95 ,33.33
03,001,03,026,0944,0,457 ,3 ,460 ,777 ,0,3,1,3,0,1,0,76.14,59.20 ,33.33
03,001,03,026,0945,0,1022 ,6 ,1028 ,1672 ,0,3,1,3,0,1,0,76.14,61.48 ,33.33
03,001,03,026,0946,0,764 ,2 ,766 ,1277 ,0,3,1,3,0,1,0,76.14,59.98 ,33.33
03,001,03,026,0947,0,375 ,5 ,380 ,596 ,0,3,1,3,0,1,0,76.14,63.76 ,33.33
03,001,03,026,0948,0,901 ,9 ,910 ,1562 ,0,3,1,3,0,1,0,76.14,58.26 ,33.33
03,001,03,026,0949,0,685 ,7 ,692 ,1264 ,0,3,1,3,0,1,0,76.14,54.75 ,33.33
03,001,03,026,0950,0,1999 ,11 ,2010 ,3538 ,0,3,1,3,0,1,0,76.14,56.81 ,33.33
03,001,03,026,0951,0,1156 ,6 ,1162 ,2361 ,0,3,1,3,0,1,0,76.14,49.22 ,33.33
03,001,03,026,0952,0,979 ,8 ,987 ,1762 ,0,3,1,3,0,1,0,76.14,56.02 ,33.33
03,001,03,026,0953,0,580 ,6 ,586 ,1064 ,0,3,1,3,0,1,0,76.14,55.08 ,33.33
03,001,03,026,0954,0,160 ,2 ,162 ,288 ,0,3,1,3,0,1,0,76.14,56.25 ,33.33
03,001,03,026,0955,0,296 ,4 ,300 ,484 ,0,3,1,3,0,1,0,76.14,61.98 ,33.33
03,001,03,026,0956,0,225 ,1 ,226 ,340 ,0,3,1,3,0,1,0,76.14,66.47 ,33.33
03,001,03,026,0957,0,83 ,0 ,83 ,109 ,0,3,1,3,0,1,0,76.14,76.15 ,33.33
03,001,03,026,0958,0,833 ,8 ,841 ,1613 ,0,3,1,3,0,1,0,76.14,52.14 ,33.33
03,001,03,026,0959,0,1528 ,12 ,1540 ,2782 ,0,3,1,3,0,1,0,76.14,55.36 ,33.33
03,001,03,026,0960,0,695 ,1 ,696 ,1273 ,0,3,1,3,0,1,0,76.14,54.67 ,33.33
03,001,03,026,0961,0,908 ,7 ,915 ,1830 ,0,3,1,3,0,1,0,76.14,50.00 ,33.33
03,001,03,026,0962,0,282 ,1 ,283 ,540 ,0,3,1,3,0,1,0,76.14,52.41 ,33.33
03,001,03,026,0963,0,304 ,2 ,306 ,559 ,0,3,1,3,0,1,0,76.14,54.74 ,33.33
03,001,03,026,0964,0,197 ,0 ,197 ,403 ,0,3,1,3,0,1,0,76.14,48.88 ,33.33
03,001,03,026,0965,0,137 ,0 ,137 ,240 ,0,3,1,3,0,1,0,76.14,57.08 ,33.33
03,001,03,026,0966,0,204 ,3 ,207 ,376 ,0,3,1,3,0,1,0,76.14,55.05 ,33.33
03,001,03,026,0967,0,146 ,0 ,146 ,255 ,0,3,1,3,0,1,0,76.14,57.25 ,33.33
03,001,03,026,0968,0,161 ,2 ,163 ,267 ,0,3,1,3,0,1,0,76.14,61.05 ,33.33
03,001,03,026,0969,0,245 ,5 ,250 ,430 ,0,3,1,3,0,1,0,76.14,58.14 ,33.33
03,001,03,026,0970,0,232 ,3 ,235 ,417 ,0,3,1,3,0,1,0,76.14,56.35 ,33.33
03,001,03,026,0971,0,382 ,4 ,386 ,579 ,0,3,1,3,0,1,0,76.14,66.67 ,33.33
03,001,03,026,0972,0,193 ,0 ,193 ,318 ,0,3,1,3,0,1,0,76.14,60.69 ,33.33
03,001,03,026,0973,0,175 ,1 ,176 ,254 ,0,3,1,3,0,1,0,76.14,69.29 ,33.33
03,001,03,026,0974,0,394 ,7 ,401 ,753 ,0,3,1,3,0,1,0,76.14,53.25 ,33.33
03,001,03,026,0975,0,589 ,5 ,594 ,960 ,0,3,1,3,0,1,0,76.14,61.88 ,33.33
03,001,03,026,0976,0,995 ,10 ,1005 ,1694 ,0,3,1,3,0,1,0,76.14,59.33 ,33.33
03,001,03,026,0977,0,682 ,4 ,686 ,1109 ,0,3,1,3,0,1,0,76.14,61.86 ,33.33
03,001,03,027,0978,0,262 ,3 ,265 ,436 ,0,3,1,3,0,1,0,76.14,60.78 ,33.33
03,001,03,027,0979,0,179 ,3 ,182 ,305 ,0,3,1,3,0,1,0,76.14,59.67 ,33.33
03,001,03,027,0980,0,181 ,1 ,182 ,272 ,0,3,1,3,0,1,0,76.14,66.91 ,33.33
03,001,03,027,0981,0,355 ,8 ,363 ,555 ,0,3,1,3,0,1,0,76.14,65.41 ,33.33
03,001,03,027,0982,0,177 ,3 ,180 ,271 ,0,3,1,3,0,1,0,76.14,66.42 ,33.33
03,001,03,027,0983,0,423 ,1 ,424 ,677 ,0,3,1,3,0,1,0,76.14,62.63 ,33.33
03,001,03,027,0984,0,280 ,2 ,282 ,421 ,0,3,1,3,0,1,0,76.14,66.98 ,33.33
03,001,03,027,0985,0,601 ,5 ,606 ,988 ,0,3,1,3,0,1,0,76.14,61.34 ,33.33
03,001,03,027,0986,0,73 ,0 ,73 ,147 ,0,3,1,3,0,1,0,76.14,49.66 ,33.33
03,001,03,027,0987,0,254 ,0 ,254 ,479 ,0,3,1,3,0,1,0,76.14,53.03 ,33.33
03,001,03,027,0988,0,105 ,0 ,105 ,183 ,0,3,1,3,0,1,0,76.14,57.38 ,33.33
03,001,03,027,0989,0,89 ,0 ,89 ,160 ,0,3,1,3,0,1,0,76.14,55.63 ,33.33
03,001,03,028,0990,0,313 ,4 ,317 ,544 ,0,3,1,3,0,1,0,76.14,58.27 ,33.33
03,001,03,028,0991,0,536 ,7 ,543 ,896 ,0,3,1,3,0,1,0,76.14,60.60 ,33.33
03,001,03,028,0992,0,252 ,2 ,254 ,466 ,0,3,1,3,0,1,0,76.14,54.51 ,33.33
03,001,03,028,0993,0,995 ,9 ,1004 ,1807 ,0,3,1,3,0,1,0,76.14,55.56 ,33.33
03,001,03,028,0994,0,201 ,1 ,202 ,343 ,0,3,1,3,0,1,0,76.14,58.89 ,33.33
03,001,03,028,0995,0,569 ,4 ,573 ,947 ,0,3,1,3,0,1,0,76.14,60.51 ,33.33
03,001,03,028,0996,0,385 ,4 ,389 ,710 ,0,3,1,3,0,1,0,76.14,54.79 ,33.33
03,001,03,028,0997,0,279 ,1 ,280 ,486 ,0,3,1,3,0,1,0,76.14,57.61 ,33.33
03,001,03,028,0998,0,257 ,5 ,262 ,406 ,0,3,1,3,0,1,0,76.14,64.53 ,33.33
03,001,03,028,0999,0,272 ,3 ,275 ,470 ,0,3,1,3,0,1,0,76.14,58.51 ,33.33
03,001,03,028,1000,0,371 ,3 ,374 ,641 ,0,3,1,3,0,1,0,76.14,58.35 ,33.33
03,001,03,028,1001,0,279 ,0 ,279 ,538 ,0,3,1,3,0,1,0,76.14,51.86 ,33.33
03,001,03,029,1002,0,555 ,8 ,563 ,919 ,0,3,1,3,0,1,0,76.14,61.26 ,33.33
03,001,03,029,1003,0,256 ,4 ,260 ,439 ,0,3,1,3,0,1,0,76.14,59.23 ,33.33
03,001,03,029,1004,0,272 ,3 ,275 ,494 ,0,3,1,3,0,1,0,76.14,55.67 ,33.33
03,001,03,029,1005,0,404 ,0 ,404 ,755 ,0,3,1,3,0,1,0,76.14,53.51 ,33.33
03,001,03,029,1006,0,902 ,5 ,907 ,1636 ,0,3,1,3,0,1,0,76.14,55.44 ,33.33
03,001,03,029,1007,0,435 ,5 ,440 ,884 ,0,3,1,3,0,1,0,76.14,49.77 ,33.33
03,001,03,029,1008,0,397 ,3 ,400 ,679 ,0,3,1,3,0,1,0,76.14,58.91 ,33.33
03,001,03,029,1009,0,960 ,13 ,973 ,1613 ,0,3,1,3,0,1,0,76.14,60.32 ,33.33
03,001,03,029,1010,0,1043 ,4 ,1047 ,1977 ,0,3,1,3,0,1,0,76.14,52.96 ,33.33
03,001,03,029,1011,0,455 ,6 ,461 ,810 ,0,3,1,3,0,1,0,76.14,56.91 ,33.33
03,001,03,029,1012,0,566 ,4 ,570 ,930 ,0,3,1,3,0,1,0,76.14,61.29 ,33.33
03,002,01,001,0001,0,370 ,4 ,374 ,629 ,0,3,1,3,0,1,0,76.14,59.46 ,33.33
03,002,01,001,0002,0,870 ,6 ,876 ,1628 ,0,3,1,3,0,1,0,76.14,53.81 ,33.33
03,002,01,001,0003,0,714 ,3 ,717 ,1128 ,0,3,1,3,0,1,0,76.14,63.56 ,33.33
03,002,01,001,0004,0,679 ,4 ,683 ,1167 ,0,3,1,3,0,1,0,76.14,58.53 ,33.33
03,002,01,001,0005,0,1844 ,17 ,1861 ,3346 ,0,3,1,3,0,1,0,76.14,55.62 ,33.33
03,002,01,001,0006,0,2328 ,13 ,2341 ,4120 ,0,3,1,3,0,1,0,76.14,56.82 ,33.33
03,002,01,001,0007,0,1044 ,8 ,1052 ,1855 ,0,3,1,3,0,1,0,76.14,56.71 ,33.33
03,002,01,001,0008,0,594 ,7 ,601 ,1073 ,0,3,1,3,0,1,0,76.14,56.01 ,33.33
03,002,01,001,0009,0,778 ,8 ,786 ,1291 ,0,3,1,3,0,1,0,76.14,60.88 ,33.33
03,002,01,001,0010,0,567 ,2 ,569 ,951 ,0,3,1,3,0,1,0,76.14,59.83 ,33.33
03,002,01,001,0011,0,664 ,0 ,664 ,1254 ,0,3,1,3,0,1,0,76.14,52.95 ,33.33
03,002,01,001,0012,0,815 ,4 ,819 ,1508 ,0,3,1,3,0,1,0,76.14,54.31 ,33.33
03,002,01,001,0013,0,1526 ,8 ,1534 ,2729 ,0,3,1,3,0,1,0,76.14,56.21 ,33.33
03,002,01,001,0014,0,1291 ,22 ,1313 ,2361 ,0,3,1,3,0,1,0,76.14,55.61 ,33.33
03,002,01,001,0015,0,2529 ,20 ,2549 ,4695 ,0,3,1,3,0,1,0,76.14,54.29 ,33.33
03,002,01,001,0016,0,309 ,0 ,309 ,534 ,0,3,1,3,0,1,0,76.14,57.87 ,33.33
03,002,01,001,0017,0,360 ,2 ,362 ,596 ,0,3,1,3,0,1,0,76.14,60.74 ,33.33
03,002,01,001,0018,0,761 ,3 ,764 ,1276 ,0,3,1,3,0,1,0,76.14,59.87 ,33.33
03,002,01,001,0019,0,790 ,5 ,795 ,1340 ,0,3,1,3,0,1,0,76.14,59.33 ,33.33
03,002,01,001,0020,0,583 ,2 ,585 ,995 ,0,3,1,3,0,1,0,76.14,58.79 ,33.33
03,002,01,001,0021,0,1661 ,8 ,1669 ,3040 ,0,3,1,3,0,1,0,76.14,54.90 ,33.33
03,002,01,001,0022,0,2171 ,17 ,2188 ,3919 ,0,3,1,3,0,1,0,76.14,55.83 ,33.33
03,002,01,001,0023,0,687 ,1 ,688 ,1143 ,0,3,1,3,0,1,0,76.14,60.19 ,33.33
03,002,01,001,0024,0,1362 ,8 ,1370 ,2379 ,0,3,1,3,0,1,0,76.14,57.59 ,33.33
03,002,01,001,0025,0,412 ,3 ,415 ,768 ,0,3,1,3,0,1,0,76.14,54.04 ,33.33
03,002,01,001,0026,0,717 ,6 ,723 ,1207 ,0,3,1,3,0,1,0,76.14,59.90 ,33.33
03,002,01,001,0027,0,757 ,5 ,762 ,1373 ,0,3,1,3,0,1,0,76.14,55.50 ,33.33
03,002,01,001,0028,0,336 ,1 ,337 ,590 ,0,3,1,3,0,1,0,76.14,57.12 ,33.33
03,002,01,001,0029,0,460 ,6 ,466 ,781 ,0,3,1,3,0,1,0,76.14,59.67 ,33.33
03,002,01,001,0030,0,812 ,8 ,820 ,1453 ,0,3,1,3,0,1,0,76.14,56.43 ,33.33
03,002,01,001,0031,0,1337 ,5 ,1342 ,2278 ,0,3,1,3,0,1,0,76.14,58.91 ,33.33
03,002,01,001,0032,0,1363 ,9 ,1372 ,2553 ,0,3,1,3,0,1,0,76.14,53.74 ,33.33
03,002,01,001,0033,0,700 ,5 ,705 ,1216 ,0,3,1,3,0,1,0,76.14,57.98 ,33.33
03,002,01,001,0034,0,1461 ,12 ,1473 ,2564 ,0,3,1,3,0,1,0,76.14,57.45 ,33.33
03,002,01,001,0035,0,475 ,3 ,478 ,925 ,0,3,1,3,0,1,0,76.14,51.68 ,33.33
03,002,01,001,0036,0,808 ,5 ,813 ,1438 ,0,3,1,3,0,1,0,76.14,56.54 ,33.33
03,002,01,001,0037,0,801 ,3 ,804 ,1444 ,0,3,1,3,0,1,0,76.14,55.68 ,33.33
03,002,01,001,0038,0,617 ,1 ,618 ,1019 ,0,3,1,3,0,1,0,76.14,60.65 ,33.33
03,002,01,001,0039,0,467 ,4 ,471 ,795 ,0,3,1,3,0,1,0,76.14,59.25 ,33.33
03,002,01,001,0040,0,589 ,5 ,594 ,1026 ,0,3,1,3,0,1,0,76.14,57.89 ,33.33
03,002,01,002,0041,0,280 ,2 ,282 ,491 ,0,3,1,3,0,1,0,76.14,57.43 ,33.33
03,002,01,002,0042,0,329 ,3 ,332 ,535 ,0,3,1,3,0,1,0,76.14,62.06 ,33.33
03,002,01,002,0043,0,257 ,2 ,259 ,494 ,0,3,1,3,0,1,0,76.14,52.43 ,33.33
03,002,01,002,0044,0,704 ,7 ,711 ,1273 ,0,3,1,3,0,1,0,76.14,55.85 ,33.33
03,002,01,002,0045,0,1309 ,12 ,1321 ,2469 ,0,3,1,3,0,1,0,76.14,53.50 ,33.33
03,002,01,002,0046,0,1113 ,8 ,1121 ,2080 ,0,3,1,3,0,1,0,76.14,53.89 ,33.33
03,002,01,002,0047,0,1042 ,7 ,1049 ,2077 ,0,3,1,3,0,1,0,76.14,50.51 ,33.33
03,002,01,002,0048,0,1281 ,6 ,1287 ,2248 ,0,3,1,3,0,1,0,76.14,57.25 ,33.33
03,002,01,002,0049,0,754 ,18 ,772 ,1335 ,0,3,1,3,0,1,0,76.14,57.83 ,33.33
03,002,01,002,0050,0,820 ,2 ,822 ,1320 ,0,3,1,3,0,1,0,76.14,62.27 ,33.33
03,002,01,002,0051,0,476 ,5 ,481 ,829 ,0,3,1,3,0,1,0,76.14,58.02 ,33.33
03,002,01,002,0052,0,375 ,4 ,379 ,710 ,0,3,1,3,0,1,0,76.14,53.38 ,33.33
03,002,01,002,0053,0,471 ,1 ,472 ,829 ,0,3,1,3,0,1,0,76.14,56.94 ,33.33
03,002,01,002,0054,0,379 ,0 ,379 ,604 ,0,3,1,3,0,1,0,76.14,62.75 ,33.33
03,002,01,002,0055,0,412 ,1 ,413 ,702 ,0,3,1,3,0,1,0,76.14,58.83 ,33.33
03,002,01,002,0056,0,1957 ,19 ,1976 ,3526 ,0,3,1,3,0,1,0,76.14,56.04 ,33.33
03,002,01,002,0057,0,2642 ,15 ,2657 ,4896 ,0,3,1,3,0,1,0,76.14,54.27 ,33.33
03,002,01,002,0058,0,2981 ,18 ,2999 ,5562 ,0,3,1,3,0,1,0,76.14,53.92 ,33.33
03,002,01,002,0059,0,1874 ,15 ,1889 ,3428 ,0,3,1,3,0,1,0,76.14,55.11 ,33.33
03,002,01,002,0060,0,1053 ,5 ,1058 ,1878 ,0,3,1,3,0,1,0,76.14,56.34 ,33.33
03,002,01,002,0061,0,517 ,5 ,522 ,1074 ,0,3,1,3,0,1,0,76.14,48.60 ,33.33
03,002,01,002,0062,0,1561 ,7 ,1568 ,2992 ,0,3,1,3,0,1,0,76.14,52.41 ,33.33
03,002,01,002,0063,0,2212 ,17 ,2229 ,4083 ,0,3,1,3,0,1,0,76.14,54.59 ,33.33
03,002,01,002,0064,0,1318 ,11 ,1329 ,2380 ,0,3,1,3,0,1,0,76.14,55.84 ,33.33
03,002,01,002,0065,0,1251 ,9 ,1260 ,2337 ,0,3,1,3,0,1,0,76.14,53.92 ,33.33
03,002,01,003,0066,0,1671 ,12 ,1683 ,3006 ,0,3,1,3,0,1,0,76.14,55.99 ,33.33
03,002,01,003,0067,0,462 ,6 ,468 ,778 ,0,3,1,3,0,1,0,76.14,60.15 ,33.33
03,002,01,003,0068,0,1573 ,6 ,1579 ,2948 ,0,3,1,3,0,1,0,76.14,53.56 ,33.33
03,002,01,003,0069,0,600 ,2 ,602 ,948 ,0,3,1,3,0,1,0,76.14,63.50 ,33.33
03,002,01,003,0070,0,631 ,7 ,638 ,1189 ,0,3,1,3,0,1,0,76.14,53.66 ,33.33
03,002,01,003,0071,0,115 ,3 ,118 ,237 ,0,3,1,3,0,1,0,76.14,49.79 ,33.33
03,002,01,003,0072,0,1079 ,10 ,1089 ,2121 ,0,3,1,3,0,1,0,76.14,51.34 ,33.33
03,002,01,003,0073,0,623 ,7 ,630 ,1084 ,0,3,1,3,0,1,0,76.14,58.12 ,33.33
03,002,01,003,0074,0,2508 ,14 ,2522 ,4961 ,0,3,1,3,0,1,0,76.14,50.84 ,33.33
03,002,01,003,0075,0,1311 ,12 ,1323 ,2330 ,0,3,1,3,0,1,0,76.14,56.78 ,33.33
03,002,01,003,0076,0,711 ,4 ,715 ,1193 ,0,3,1,3,0,1,0,76.14,59.93 ,33.33
03,002,01,003,0077,0,334 ,2 ,336 ,566 ,0,3,1,3,0,1,0,76.14,59.36 ,33.33
03,002,01,003,0078,0,266 ,1 ,267 ,524 ,0,3,1,3,0,1,0,76.14,50.95 ,33.33
03,002,01,003,0079,0,334 ,0 ,334 ,609 ,0,3,1,3,0,1,0,76.14,54.84 ,33.33
03,002,01,003,0080,0,286 ,1 ,287 ,464 ,0,3,1,3,0,1,0,76.14,61.85 ,33.33
03,002,01,003,0081,0,347 ,6 ,353 ,633 ,0,3,1,3,0,1,0,76.14,55.77 ,33.33
03,002,01,003,0082,0,322 ,0 ,322 ,502 ,0,3,1,3,0,1,0,76.14,64.14 ,33.33
03,002,01,003,0083,0,635 ,3 ,638 ,1055 ,0,3,1,3,0,1,0,76.14,60.47 ,33.33
03,002,01,003,0084,0,572 ,3 ,575 ,1045 ,0,3,1,3,0,1,0,76.14,55.02 ,33.33
03,002,01,003,0085,0,673 ,4 ,677 ,1189 ,0,3,1,3,0,1,0,76.14,56.94 ,33.33
03,002,01,003,0086,0,801 ,5 ,806 ,1611 ,0,3,1,3,0,1,0,76.14,50.03 ,33.33
03,002,01,003,0087,0,635 ,4 ,639 ,1148 ,0,3,1,3,0,1,0,76.14,55.66 ,33.33
03,002,01,003,0088,0,698 ,3 ,701 ,1313 ,0,3,1,3,0,1,0,76.14,53.39 ,33.33
03,002,01,003,0089,0,161 ,5 ,166 ,301 ,0,3,1,3,0,1,0,76.14,55.15 ,33.33
03,002,01,003,0090,0,408 ,4 ,412 ,785 ,0,3,1,3,0,1,0,76.14,52.48 ,33.33
03,002,01,003,0091,0,375 ,9 ,384 ,721 ,0,3,1,3,0,1,0,76.14,53.26 ,33.33
03,002,01,004,0092,0,190 ,0 ,190 ,366 ,0,3,1,3,0,1,0,76.14,51.91 ,33.33
03,002,01,004,0093,0,394 ,2 ,396 ,735 ,0,3,1,3,0,1,0,76.14,53.88 ,33.33
03,002,01,004,0094,0,495 ,3 ,498 ,910 ,0,3,1,3,0,1,0,76.14,54.73 ,33.33
03,002,01,004,0095,0,223 ,0 ,223 ,391 ,0,3,1,3,0,1,0,76.14,57.03 ,33.33
03,002,01,004,0096,0,939 ,5 ,944 ,1400 ,0,3,1,3,0,1,0,76.14,67.43 ,33.33
03,002,01,004,0097,0,506 ,4 ,510 ,932 ,0,3,1,3,0,1,0,76.14,54.72 ,33.33
03,002,01,004,0098,0,360 ,4 ,364 ,625 ,0,3,1,3,0,1,0,76.14,58.24 ,33.33
03,002,01,004,0099,0,771 ,7 ,778 ,1431 ,0,3,1,3,0,1,0,76.14,54.37 ,33.33
03,002,01,004,0100,0,711 ,6 ,717 ,1223 ,0,3,1,3,0,1,0,76.14,58.63 ,33.33
03,002,01,004,0101,0,505 ,3 ,508 ,751 ,0,3,1,3,0,1,0,76.14,67.64 ,33.33
03,002,01,004,0102,0,343 ,0 ,343 ,543 ,0,3,1,3,0,1,0,76.14,63.17 ,33.33
03,002,01,004,0103,0,401 ,3 ,404 ,622 ,0,3,1,3,0,1,0,76.14,64.95 ,33.33
03,002,01,004,0104,0,376 ,6 ,382 ,622 ,0,3,1,3,0,1,0,76.14,61.41 ,33.33
03,002,01,004,0105,0,538 ,3 ,541 ,993 ,0,3,1,3,0,1,0,76.14,54.48 ,33.33
03,002,01,004,0106,0,1087 ,5 ,1092 ,1803 ,0,3,1,3,0,1,0,76.14,60.57 ,33.33
03,002,01,004,0107,0,1312 ,8 ,1320 ,2410 ,0,3,1,3,0,1,0,76.14,54.77 ,33.33
03,002,01,004,0108,0,512 ,7 ,519 ,999 ,0,3,1,3,0,1,0,76.14,51.95 ,33.33
03,002,01,004,0109,0,873 ,5 ,878 ,1666 ,0,3,1,3,0,1,0,76.14,52.70 ,33.33
03,002,01,004,0110,0,384 ,2 ,386 ,693 ,0,3,1,3,0,1,0,76.14,55.70 ,33.33
03,002,01,004,0111,0,754 ,8 ,762 ,1277 ,0,3,1,3,0,1,0,76.14,59.67 ,33.33
03,002,01,004,0112,0,585 ,5 ,590 ,942 ,0,3,1,3,0,1,0,76.14,62.63 ,33.33
03,002,01,004,0113,0,596 ,5 ,601 ,974 ,0,3,1,3,0,1,0,76.14,61.70 ,33.33
03,002,01,004,0114,0,626 ,7 ,633 ,1085 ,0,3,1,3,0,1,0,76.14,58.34 ,33.33
03,002,01,004,0115,0,364 ,2 ,366 ,637 ,0,3,1,3,0,1,0,76.14,57.46 ,33.33
03,002,01,005,0116,0,810 ,9 ,819 ,1402 ,0,3,1,3,0,1,0,76.14,58.42 ,33.33
03,002,01,005,0117,0,979 ,7 ,986 ,1643 ,0,3,1,3,0,1,0,76.14,60.01 ,33.33
03,002,01,005,0118,0,1871 ,17 ,1888 ,3451 ,0,3,1,3,0,1,0,76.14,54.71 ,33.33
03,002,01,005,0119,0,1235 ,7 ,1242 ,2163 ,0,3,1,3,0,1,0,76.14,57.42 ,33.33
03,002,01,005,0120,0,416 ,3 ,419 ,681 ,0,3,1,3,0,1,0,76.14,61.53 ,33.33
03,002,01,005,0121,0,851 ,1 ,852 ,1407 ,0,3,1,3,0,1,0,76.14,60.55 ,33.33
03,002,01,005,0122,0,670 ,7 ,677 ,1095 ,0,3,1,3,0,1,0,76.14,61.83 ,33.33
03,002,01,005,0123,0,840 ,10 ,850 ,1377 ,0,3,1,3,0,1,0,76.14,61.73 ,33.33
03,002,01,005,0124,0,1065 ,10 ,1075 ,1872 ,0,3,1,3,0,1,0,76.14,57.43 ,33.33
03,002,01,005,0125,0,1315 ,11 ,1326 ,2289 ,0,3,1,3,0,1,0,76.14,57.93 ,33.33
03,002,01,005,0126,0,640 ,7 ,647 ,1071 ,0,3,1,3,0,1,0,76.14,60.41 ,33.33
03,002,01,005,0127,0,437 ,2 ,439 ,726 ,0,3,1,3,0,1,0,76.14,60.47 ,33.33
03,002,01,005,0128,0,537 ,3 ,540 ,908 ,0,3,1,3,0,1,0,76.14,59.47 ,33.33
03,002,01,005,0129,0,655 ,4 ,659 ,1113 ,0,3,1,3,0,1,0,76.14,59.21 ,33.33
03,002,01,005,0130,0,1339 ,5 ,1344 ,2213 ,0,3,1,3,0,1,0,76.14,60.73 ,33.33
03,002,01,005,0131,0,1544 ,19 ,1563 ,2763 ,0,3,1,3,0,1,0,76.14,56.57 ,33.33
03,002,01,005,0132,0,510 ,1 ,511 ,931 ,0,3,1,3,0,1,0,76.14,54.89 ,33.33
03,002,01,005,0133,0,252 ,3 ,255 ,408 ,0,3,1,3,0,1,0,76.14,62.50 ,33.33
03,002,01,006,0134,0,1075 ,13 ,1088 ,1849 ,0,3,1,3,0,1,0,76.14,58.84 ,33.33
03,002,01,006,0135,0,450 ,1 ,451 ,815 ,0,3,1,3,0,1,0,76.14,55.34 ,33.33
03,002,01,006,0136,0,1003 ,7 ,1010 ,1666 ,0,3,1,3,0,1,0,76.14,60.62 ,33.33
03,002,01,006,0137,0,508 ,5 ,513 ,975 ,0,3,1,3,0,1,0,76.14,52.62 ,33.33
03,002,01,006,0138,0,448 ,3 ,451 ,798 ,0,3,1,3,0,1,0,76.14,56.52 ,33.33
03,002,01,006,0139,0,915 ,4 ,919 ,1711 ,0,3,1,3,0,1,0,76.14,53.71 ,33.33
03,002,01,006,0140,0,835 ,3 ,838 ,1542 ,0,3,1,3,0,1,0,76.14,54.35 ,33.33
03,002,01,006,0141,0,489 ,1 ,490 ,820 ,0,3,1,3,0,1,0,76.14,59.76 ,33.33
03,002,01,006,0142,0,1444 ,6 ,1450 ,2544 ,0,3,1,3,0,1,0,76.14,57.00 ,33.33
03,002,01,006,0143,0,567 ,2 ,569 ,973 ,0,3,1,3,0,1,0,76.14,58.48 ,33.33
03,002,01,006,0144,0,542 ,4 ,546 ,937 ,0,3,1,3,0,1,0,76.14,58.27 ,33.33
03,002,01,006,0145,0,1259 ,6 ,1265 ,2054 ,0,3,1,3,0,1,0,76.14,61.59 ,33.33
03,002,01,006,0146,0,488 ,2 ,490 ,882 ,0,3,1,3,0,1,0,76.14,55.56 ,33.33
03,002,01,006,0147,0,998 ,5 ,1003 ,1692 ,0,3,1,3,0,1,0,76.14,59.28 ,33.33
03,002,01,007,0148,0,2255 ,11 ,2266 ,4255 ,0,3,1,3,0,1,0,76.14,53.25 ,33.33
03,002,01,007,0149,0,941 ,8 ,949 ,1829 ,0,3,1,3,0,1,0,76.14,51.89 ,33.33
03,002,01,007,0150,0,729 ,4 ,733 ,1222 ,0,3,1,3,0,1,0,76.14,59.98 ,33.33
03,002,01,007,0151,0,543 ,1 ,544 ,969 ,0,3,1,3,0,1,0,76.14,56.14 ,33.33
03,002,01,007,0152,0,783 ,9 ,792 ,1449 ,0,3,1,3,0,1,0,76.14,54.66 ,33.33
03,002,01,007,0153,0,621 ,8 ,629 ,1198 ,0,3,1,3,0,1,0,76.14,52.50 ,33.33
03,002,01,007,0154,0,794 ,7 ,801 ,1400 ,0,3,1,3,0,1,0,76.14,57.21 ,33.33
03,002,01,007,0155,0,376 ,2 ,378 ,711 ,0,3,1,3,0,1,0,76.14,53.16 ,33.33
03,002,01,007,0156,0,885 ,2 ,887 ,1601 ,0,3,1,3,0,1,0,76.14,55.40 ,33.33
03,002,01,007,0157,0,624 ,5 ,629 ,1093 ,0,3,1,3,0,1,0,76.14,57.55 ,33.33
03,002,01,007,0158,0,1202 ,4 ,1206 ,2098 ,0,3,1,3,0,1,0,76.14,57.48 ,33.33
03,002,01,007,0159,0,1366 ,13 ,1379 ,2466 ,0,3,1,3,0,1,0,76.14,55.92 ,33.33
03,002,01,007,0160,0,475 ,2 ,477 ,840 ,0,3,1,3,0,1,0,76.14,56.79 ,33.33
03,002,01,007,0161,0,460 ,1 ,461 ,815 ,0,3,1,3,0,1,0,76.14,56.56 ,33.33
03,002,01,007,0162,0,553 ,14 ,567 ,972 ,0,3,1,3,0,1,0,76.14,58.33 ,33.33
03,002,01,007,0163,0,828 ,8 ,836 ,1460 ,0,3,1,3,0,1,0,76.14,57.26 ,33.33
03,002,01,008,0164,0,636 ,6 ,642 ,1050 ,0,3,1,3,0,1,0,76.14,61.14 ,33.33
03,002,01,008,0165,0,787 ,7 ,794 ,1344 ,0,3,1,3,0,1,0,76.14,59.08 ,33.33
03,002,01,008,0166,0,574 ,3 ,577 ,1000 ,0,3,1,3,0,1,0,76.14,57.70 ,33.33
03,002,01,008,0167,0,481 ,3 ,484 ,812 ,0,3,1,3,0,1,0,76.14,59.61 ,33.33
03,002,01,008,0168,0,562 ,3 ,565 ,924 ,0,3,1,3,0,1,0,76.14,61.15 ,33.33
03,002,01,008,0169,0,1243 ,7 ,1250 ,2165 ,0,3,1,3,0,1,0,76.14,57.74 ,33.33
03,002,01,008,0170,0,1112 ,10 ,1122 ,1897 ,0,3,1,3,0,1,0,76.14,59.15 ,33.33
03,002,01,008,0171,0,607 ,7 ,614 ,1109 ,0,3,1,3,0,1,0,76.14,55.37 ,33.33
03,002,01,008,0172,0,496 ,3 ,499 ,821 ,0,3,1,3,0,1,0,76.14,60.78 ,33.33
03,002,01,008,0173,0,387 ,3 ,390 ,694 ,0,3,1,3,0,1,0,76.14,56.20 ,33.33
03,002,01,008,0174,0,840 ,9 ,849 ,1331 ,0,3,1,3,0,1,0,76.14,63.79 ,33.33
03,002,01,008,0175,0,475 ,3 ,478 ,799 ,0,3,1,3,0,1,0,76.14,59.82 ,33.33
03,002,01,008,0176,0,707 ,6 ,713 ,1232 ,0,3,1,3,0,1,0,76.14,57.87 ,33.33
03,002,01,008,0177,0,1686 ,9 ,1695 ,3287 ,0,3,1,3,0,1,0,76.14,51.57 ,33.33
03,002,01,008,0178,0,1299 ,4 ,1303 ,2385 ,0,3,1,3,0,1,0,76.14,54.63 ,33.33
03,002,01,008,0179,0,646 ,7 ,653 ,1197 ,0,3,1,3,0,1,0,76.14,54.55 ,33.33
03,002,01,008,0180,0,2540 ,18 ,2558 ,4487 ,0,3,1,3,0,1,0,76.14,57.01 ,33.33
03,002,01,008,0181,0,1481 ,11 ,1492 ,2697 ,0,3,1,3,0,1,0,76.14,55.32 ,33.33
03,002,01,008,0182,0,1196 ,6 ,1202 ,2194 ,0,3,1,3,0,1,0,76.14,54.79 ,33.33
03,002,01,008,0183,0,533 ,6 ,539 ,1062 ,0,3,1,3,0,1,0,76.14,50.75 ,33.33
03,002,01,008,0184,0,1186 ,7 ,1193 ,2244 ,0,3,1,3,0,1,0,76.14,53.16 ,33.33
03,002,01,008,0185,0,697 ,4 ,701 ,1347 ,0,3,1,3,0,1,0,76.14,52.04 ,33.33
03,002,01,008,0186,0,615 ,7 ,622 ,1121 ,0,3,1,3,0,1,0,76.14,55.49 ,33.33
03,002,01,008,0187,0,479 ,4 ,483 ,838 ,0,3,1,3,0,1,0,76.14,57.64 ,33.33
03,002,01,009,0188,0,935 ,6 ,941 ,1563 ,0,3,1,3,0,1,0,76.14,60.20 ,33.33
03,002,01,009,0189,0,893 ,9 ,902 ,1465 ,0,3,1,3,0,1,0,76.14,61.57 ,33.33
03,002,01,009,0190,0,1179 ,17 ,1196 ,2087 ,0,3,1,3,0,1,0,76.14,57.31 ,33.33
03,002,01,009,0191,0,829 ,0 ,829 ,1470 ,0,3,1,3,0,1,0,76.14,56.39 ,33.33
03,002,01,009,0192,0,521 ,7 ,528 ,1027 ,0,3,1,3,0,1,0,76.14,51.41 ,33.33
03,002,01,009,0193,0,1164 ,8 ,1172 ,2095 ,0,3,1,3,0,1,0,76.14,55.94 ,33.33
03,002,01,009,0194,0,859 ,6 ,865 ,1480 ,0,3,1,3,0,1,0,76.14,58.45 ,33.33
03,002,01,009,0195,0,1584 ,8 ,1592 ,2762 ,0,3,1,3,0,1,0,76.14,57.64 ,33.33
03,002,01,009,0196,0,1589 ,17 ,1606 ,2758 ,0,3,1,3,0,1,0,76.14,58.23 ,33.33
03,002,01,009,0197,0,1298 ,9 ,1307 ,2397 ,0,3,1,3,0,1,0,76.14,54.53 ,33.33
03,002,01,009,0198,0,733 ,2 ,735 ,1352 ,0,3,1,3,0,1,0,76.14,54.36 ,33.33
03,002,01,009,0199,0,787 ,9 ,796 ,1449 ,0,3,1,3,0,1,0,76.14,54.93 ,33.33
03,002,01,009,0200,0,1094 ,11 ,1105 ,1937 ,0,3,1,3,0,1,0,76.14,57.05 ,33.33
03,002,01,009,0201,0,1295 ,13 ,1308 ,2332 ,0,3,1,3,0,1,0,76.14,56.09 ,33.33
03,002,01,009,0202,0,1327 ,8 ,1335 ,2462 ,0,3,1,3,0,1,0,76.14,54.22 ,33.33
03,002,01,010,0203,0,140 ,1 ,141 ,236 ,0,3,1,3,0,1,0,76.14,59.75 ,33.33
03,002,01,010,0204,0,309 ,5 ,314 ,562 ,0,3,1,3,0,1,0,76.14,55.87 ,33.33
03,002,01,010,0205,0,402 ,5 ,407 ,782 ,0,3,1,3,0,1,0,76.14,52.05 ,33.33
03,002,01,010,0206,0,375 ,9 ,384 ,653 ,0,3,1,3,0,1,0,76.14,58.81 ,33.33
03,002,01,010,0207,0,254 ,4 ,258 ,456 ,0,3,1,3,0,1,0,76.14,56.58 ,33.33
03,002,01,010,0208,0,644 ,5 ,649 ,1097 ,0,3,1,3,0,1,0,76.14,59.16 ,33.33
03,002,01,010,0209,0,632 ,2 ,634 ,1142 ,0,3,1,3,0,1,0,76.14,55.52 ,33.33
03,002,01,010,0210,0,479 ,5 ,484 ,789 ,0,3,1,3,0,1,0,76.14,61.34 ,33.33
03,002,01,010,0211,0,550 ,3 ,553 ,992 ,0,3,1,3,0,1,0,76.14,55.75 ,33.33
03,002,01,010,0212,0,1656 ,15 ,1671 ,3148 ,0,3,1,3,0,1,0,76.14,53.08 ,33.33
03,002,01,010,0213,0,393 ,1 ,394 ,679 ,0,3,1,3,0,1,0,76.14,58.03 ,33.33
03,002,01,010,0214,0,271 ,2 ,273 ,559 ,0,3,1,3,0,1,0,76.14,48.84 ,33.33
03,002,01,010,0215,0,238 ,1 ,239 ,470 ,0,3,1,3,0,1,0,76.14,50.85 ,33.33
03,002,01,010,0216,0,409 ,5 ,414 ,670 ,0,3,1,3,0,1,0,76.14,61.79 ,33.33
03,002,01,010,0217,0,623 ,7 ,630 ,1095 ,0,3,1,3,0,1,0,76.14,57.53 ,33.33
03,002,01,010,0218,0,471 ,5 ,476 ,778 ,0,3,1,3,0,1,0,76.14,61.18 ,33.33
03,002,01,010,0219,0,774 ,5 ,779 ,1258 ,0,3,1,3,0,1,0,76.14,61.92 ,33.33
03,002,01,010,0220,0,692 ,6 ,698 ,1140 ,0,3,1,3,0,1,0,76.14,61.23 ,33.33
03,002,01,011,0221,0,49 ,1 ,50 ,109 ,0,3,1,3,0,1,0,76.14,45.87 ,33.33
03,002,01,011,0222,0,49 ,2 ,51 ,93 ,0,3,1,3,0,1,0,76.14,54.84 ,33.33
03,002,01,011,0223,0,128 ,0 ,128 ,247 ,0,3,1,3,0,1,0,76.14,51.82 ,33.33
03,002,01,011,0224,0,130 ,1 ,131 ,232 ,0,3,1,3,0,1,0,76.14,56.47 ,33.33
03,002,01,011,0225,0,39 ,0 ,39 ,80 ,0,3,1,3,0,1,0,76.14,48.75 ,33.33
03,002,01,011,0226,0,26 ,0 ,26 ,45 ,0,3,1,3,0,1,0,76.14,57.78 ,33.33
03,002,01,011,0227,0,32 ,1 ,33 ,64 ,0,3,1,3,0,1,0,76.14,51.56 ,33.33
03,002,01,011,0228,0,18 ,0 ,18 ,49 ,0,3,1,3,0,1,0,76.14,36.73 ,33.33
03,002,01,011,0229,0,34 ,0 ,34 ,73 ,0,3,1,3,0,1,0,76.14,46.58 ,33.33
03,002,01,011,0230,0,11 ,0 ,11 ,16 ,0,3,1,3,0,1,0,76.14,68.75 ,33.33
03,002,01,012,0231,0,93 ,0 ,93 ,210 ,0,3,1,3,0,1,0,76.14,44.29 ,33.33
03,002,01,012,0232,0,33 ,0 ,33 ,81 ,0,3,1,3,0,1,0,76.14,40.74 ,33.33
03,002,01,012,0233,0,34 ,0 ,34 ,62 ,0,3,1,3,0,1,0,76.14,54.84 ,33.33
03,002,01,012,0234,0,32 ,1 ,33 ,60 ,0,3,1,3,0,1,0,76.14,55.00 ,33.33
03,002,01,012,0235,0,39 ,1 ,40 ,110 ,0,3,1,3,0,1,0,76.14,36.36 ,33.33
03,002,01,012,0236,0,11 ,0 ,11 ,30 ,0,3,1,3,0,1,0,76.14,36.67 ,33.33
03,002,01,012,0237,0,64 ,1 ,65 ,138 ,0,3,1,3,0,1,0,76.14,47.10 ,33.33
03,003,01,001,0001,0,3168 ,24 ,3192 ,5318 ,0,3,1,3,0,1,0,76.14,60.02 ,33.33
03,003,01,001,0002,0,2740 ,24 ,2764 ,4821 ,0,3,1,3,0,1,0,76.14,57.33 ,33.33
03,003,01,001,0003,0,2431 ,29 ,2460 ,4207 ,0,3,1,3,0,1,0,76.14,58.47 ,33.33
03,003,01,001,0004,0,2652 ,10 ,2662 ,4405 ,0,3,1,3,0,1,0,76.14,60.43 ,33.33
03,003,01,001,0005,0,1935 ,5 ,1940 ,3386 ,0,3,1,3,0,1,0,76.14,57.29 ,33.33
03,003,01,001,0006,0,3169 ,21 ,3190 ,5280 ,0,3,1,3,0,1,0,76.14,60.42 ,33.33
03,003,01,001,0007,0,2484 ,18 ,2502 ,4354 ,0,3,1,3,0,1,0,76.14,57.46 ,33.33
03,003,01,001,0008,0,1445 ,8 ,1453 ,2604 ,0,3,1,3,0,1,0,76.14,55.80 ,33.33
03,003,01,001,0009,0,1066 ,6 ,1072 ,1800 ,0,3,1,3,0,1,0,76.14,59.56 ,33.33
03,003,01,001,0010,0,570 ,5 ,575 ,900 ,0,3,1,3,0,1,0,76.14,63.89 ,33.33
03,003,01,001,0011,0,826 ,3 ,829 ,1500 ,0,3,1,3,0,1,0,76.14,55.27 ,33.33
03,003,01,001,0012,0,880 ,7 ,887 ,1387 ,0,3,1,3,0,1,0,76.14,63.95 ,33.33
03,003,01,001,0013,0,454 ,0 ,454 ,747 ,0,3,1,3,0,1,0,76.14,60.78 ,33.33
03,003,01,001,0014,0,822 ,9 ,831 ,1384 ,0,3,1,3,0,1,0,76.14,60.04 ,33.33
03,003,01,001,0015,0,591 ,7 ,598 ,928 ,0,3,1,3,0,1,0,76.14,64.44 ,33.33
03,003,01,001,0016,0,2726 ,15 ,2741 ,4782 ,0,3,1,3,0,1,0,76.14,57.32 ,33.33
03,003,01,001,0017,0,868 ,9 ,877 ,1349 ,0,3,1,3,0,1,0,76.14,65.01 ,33.33
03,003,01,001,0018,0,807 ,9 ,816 ,1344 ,0,3,1,3,0,1,0,76.14,60.71 ,33.33
03,003,01,001,0019,0,758 ,9 ,767 ,1297 ,0,3,1,3,0,1,0,76.14,59.14 ,33.33
03,003,01,001,0020,0,577 ,3 ,580 ,909 ,0,3,1,3,0,1,0,76.14,63.81 ,33.33
03,003,01,001,0021,0,1033 ,3 ,1036 ,1695 ,0,3,1,3,0,1,0,76.14,61.12 ,33.33
03,003,01,001,0022,0,2806 ,20 ,2826 ,4753 ,0,3,1,3,0,1,0,76.14,59.46 ,33.33
03,003,01,001,0023,0,2654 ,11 ,2665 ,4865 ,0,3,1,3,0,1,0,76.14,54.78 ,33.33
03,003,01,001,0024,0,1635 ,12 ,1647 ,3006 ,0,3,1,3,0,1,0,76.14,54.79 ,33.33
03,003,01,001,0025,0,2016 ,15 ,2031 ,3668 ,0,3,1,3,0,1,0,76.14,55.37 ,33.33
03,003,01,001,0026,0,2418 ,16 ,2434 ,4439 ,0,3,1,3,0,1,0,76.14,54.83 ,33.33
03,003,01,001,0027,0,1896 ,17 ,1913 ,3465 ,0,3,1,3,0,1,0,76.14,55.21 ,33.33
03,003,01,001,0028,0,1595 ,14 ,1609 ,2784 ,0,3,1,3,0,1,0,76.14,57.79 ,33.33
03,003,01,001,0029,0,3115 ,15 ,3130 ,6086 ,0,3,1,3,0,1,0,76.14,51.43 ,33.33
03,003,01,001,0030,0,2497 ,20 ,2517 ,4374 ,0,3,1,3,0,1,0,76.14,57.54 ,33.33
03,003,01,001,0031,0,2605 ,16 ,2621 ,4387 ,0,3,1,3,0,1,0,76.14,59.74 ,33.33
03,003,01,001,0032,0,1559 ,10 ,1569 ,2463 ,0,3,1,3,0,1,0,76.14,63.70 ,33.33
03,003,01,001,0033,0,2254 ,16 ,2270 ,3812 ,0,3,1,3,0,1,0,76.14,59.55 ,33.33
03,003,01,001,0034,0,2403 ,14 ,2417 ,4226 ,0,3,1,3,0,1,0,76.14,57.19 ,33.33
03,003,01,001,0035,0,1790 ,22 ,1812 ,3016 ,0,3,1,3,0,1,0,76.14,60.08 ,33.33
03,003,01,001,0036,0,2081 ,29 ,2110 ,3784 ,0,3,1,3,0,1,0,76.14,55.76 ,33.33
03,003,01,001,0037,0,1599 ,15 ,1614 ,3102 ,0,3,1,3,0,1,0,76.14,52.03 ,33.33
03,003,01,001,0038,0,2308 ,17 ,2325 ,4441 ,0,3,1,3,0,1,0,76.14,52.35 ,33.33
03,003,01,001,0039,0,3086 ,16 ,3102 ,5836 ,0,3,1,3,0,1,0,76.14,53.15 ,33.33
03,003,01,001,0040,0,1893 ,19 ,1912 ,3296 ,0,3,1,3,0,1,0,76.14,58.01 ,33.33
03,003,01,001,0041,0,2397 ,21 ,2418 ,4009 ,0,3,1,3,0,1,0,76.14,60.31 ,33.33
03,003,01,001,0042,0,2332 ,13 ,2345 ,4155 ,0,3,1,3,0,1,0,76.14,56.44 ,33.33
03,003,01,001,0043,0,2314 ,13 ,2327 ,3829 ,0,3,1,3,0,1,0,76.14,60.77 ,33.33
03,003,01,001,0044,0,3960 ,20 ,3980 ,7789 ,0,3,1,3,0,1,0,76.14,51.10 ,33.33
03,003,01,001,0045,0,1187 ,12 ,1199 ,1931 ,0,3,1,3,0,1,0,76.14,62.09 ,33.33
03,003,01,001,0046,0,1658 ,12 ,1670 ,2948 ,0,3,1,3,0,1,0,76.14,56.65 ,33.33
03,003,01,001,0047,0,3010 ,17 ,3027 ,6231 ,0,3,1,3,0,1,0,76.14,48.58 ,33.33
03,003,01,001,0048,0,3418 ,14 ,3432 ,6991 ,0,3,1,3,0,1,0,76.14,49.09 ,33.33
03,003,01,001,0049,0,1571 ,25 ,1596 ,2431 ,0,3,1,3,0,1,0,76.14,65.65 ,33.33
03,003,01,001,0050,0,2466 ,26 ,2492 ,4446 ,0,3,1,3,0,1,0,76.14,56.05 ,33.33
03,003,01,001,0051,0,3302 ,36 ,3338 ,5558 ,0,3,1,3,0,1,0,76.14,60.06 ,33.33
03,003,01,001,0052,0,2873 ,19 ,2892 ,5171 ,0,3,1,3,0,1,0,76.14,55.93 ,33.33
03,003,01,001,0053,0,2550 ,14 ,2564 ,5215 ,0,3,1,3,0,1,0,76.14,49.17 ,33.33
03,003,01,001,0054,0,2660 ,16 ,2676 ,4721 ,0,3,1,3,0,1,0,76.14,56.68 ,33.33
03,003,01,001,0055,0,1573 ,12 ,1585 ,2862 ,0,3,1,3,0,1,0,76.14,55.38 ,33.33
03,003,01,001,0056,0,1899 ,11 ,1910 ,3291 ,0,3,1,3,0,1,0,76.14,58.04 ,33.33
03,003,01,001,0057,0,928 ,6 ,934 ,1393 ,0,3,1,3,0,1,0,76.14,67.05 ,33.33
03,003,01,001,0058,0,939 ,13 ,952 ,1572 ,0,3,1,3,0,1,0,76.14,60.56 ,33.33
03,003,01,001,0059,0,1080 ,12 ,1092 ,1840 ,0,3,1,3,0,1,0,76.14,59.35 ,33.33
03,003,01,001,0060,0,2509 ,20 ,2529 ,4246 ,0,3,1,3,0,1,0,76.14,59.56 ,33.33
03,003,01,001,0061,0,2013 ,12 ,2025 ,3370 ,0,3,1,3,0,1,0,76.14,60.09 ,33.33
03,003,01,001,0062,0,2121 ,10 ,2131 ,3555 ,0,3,1,3,0,1,0,76.14,59.94 ,33.33
03,003,01,001,0063,0,3587 ,27 ,3614 ,6817 ,0,3,1,3,0,1,0,76.14,53.01 ,33.33
03,003,01,001,0064,0,3167 ,27 ,3194 ,5973 ,0,3,1,3,0,1,0,76.14,53.47 ,33.33
03,003,01,001,0065,0,2349 ,25 ,2374 ,4932 ,0,3,1,3,0,1,0,76.14,48.13 ,33.33
03,003,01,001,0066,0,1252 ,14 ,1266 ,2600 ,0,3,1,3,0,1,0,76.14,48.69 ,33.33
03,003,01,001,0067,0,2234 ,19 ,2253 ,4684 ,0,3,1,3,0,1,0,76.14,48.10 ,33.33
03,003,01,001,0068,0,2241 ,27 ,2268 ,4473 ,0,3,1,3,0,1,0,76.14,50.70 ,33.33
03,003,01,001,0069,0,2051 ,17 ,2068 ,3372 ,0,3,1,3,0,1,0,76.14,61.33 ,33.33
03,003,01,002,0070,0,2854 ,28 ,2882 ,4614 ,0,3,1,3,0,1,0,76.14,62.46 ,33.33
03,003,01,002,0071,0,3305 ,27 ,3332 ,5151 ,0,3,1,3,0,1,0,76.14,64.69 ,33.33
03,003,01,002,0072,0,2590 ,15 ,2605 ,4347 ,0,3,1,3,0,1,0,76.14,59.93 ,33.33
03,003,01,002,0073,0,2314 ,12 ,2326 ,3803 ,0,3,1,3,0,1,0,76.14,61.16 ,33.33
03,003,01,002,0074,0,1060 ,7 ,1067 ,1904 ,0,3,1,3,0,1,0,76.14,56.04 ,33.33
03,003,01,002,0075,0,426 ,0 ,426 ,641 ,0,3,1,3,0,1,0,76.14,66.46 ,33.33
03,003,01,002,0076,0,1798 ,14 ,1812 ,2527 ,0,3,1,3,0,1,0,76.14,71.71 ,33.33
03,003,01,002,0077,0,1069 ,16 ,1085 ,1754 ,0,3,1,3,0,1,0,76.14,61.86 ,33.33
03,003,01,002,0078,0,1361 ,12 ,1373 ,2609 ,0,3,1,3,0,1,0,76.14,52.63 ,33.33
03,003,01,002,0079,0,2293 ,40 ,2333 ,4359 ,0,3,1,3,0,1,0,76.14,53.52 ,33.33
03,003,01,002,0080,0,1374 ,18 ,1392 ,2644 ,0,3,1,3,0,1,0,76.14,52.65 ,33.33
03,003,01,002,0081,0,877 ,10 ,887 ,1505 ,0,3,1,3,0,1,0,76.14,58.94 ,33.33
03,003,01,002,0082,0,1780 ,19 ,1799 ,3150 ,0,3,1,3,0,1,0,76.14,57.11 ,33.33
03,003,01,002,0083,0,1659 ,17 ,1676 ,2960 ,0,3,1,3,0,1,0,76.14,56.62 ,33.33
03,003,01,002,0084,0,1249 ,11 ,1260 ,1963 ,0,3,1,3,0,1,0,76.14,64.19 ,33.33
03,003,01,002,0085,0,2786 ,25 ,2811 ,4719 ,0,3,1,3,0,1,0,76.14,59.57 ,33.33
03,003,01,002,0086,0,2114 ,19 ,2133 ,3965 ,0,3,1,3,0,1,0,76.14,53.80 ,33.33
03,003,01,002,0087,0,1669 ,16 ,1685 ,2834 ,0,3,1,3,0,1,0,76.14,59.46 ,33.33
03,003,01,002,0088,0,2169 ,31 ,2200 ,4122 ,0,3,1,3,0,1,0,76.14,53.37 ,33.33
03,003,01,002,0089,0,1177 ,8 ,1185 ,2537 ,0,3,1,3,0,1,0,76.14,46.71 ,33.33
03,003,01,002,0090,0,1672 ,11 ,1683 ,3279 ,0,3,1,3,0,1,0,76.14,51.33 ,33.33
03,003,01,002,0091,0,1845 ,15 ,1860 ,2903 ,0,3,1,3,0,1,0,76.14,64.07 ,33.33
03,003,01,002,0092,0,742 ,6 ,748 ,1141 ,0,3,1,3,0,1,0,76.14,65.56 ,33.33
03,003,01,002,0093,0,1418 ,6 ,1424 ,2851 ,0,3,1,3,0,1,0,76.14,49.95 ,33.33
03,003,01,002,0094,0,1298 ,66 ,1364 ,2755 ,0,3,1,3,0,1,0,76.14,49.51 ,33.33
03,003,01,002,0095,0,1164 ,13 ,1177 ,2642 ,0,3,1,3,0,1,0,76.14,44.55 ,33.33
03,003,01,002,0096,0,818 ,13 ,831 ,1333 ,0,3,1,3,0,1,0,76.14,62.34 ,33.33
03,003,01,002,0097,0,797 ,5 ,802 ,1307 ,0,3,1,3,0,1,0,76.14,61.36 ,33.33
03,003,01,002,0098,0,810 ,8 ,818 ,1399 ,0,3,1,3,0,1,0,76.14,58.47 ,33.33
03,003,01,002,0099,0,2000 ,10 ,2010 ,3249 ,0,3,1,3,0,1,0,76.14,61.87 ,33.33
03,003,01,003,0100,0,1744 ,11 ,1755 ,3561 ,0,3,1,3,0,1,0,76.14,49.28 ,33.33
03,003,01,003,0101,0,1677 ,16 ,1693 ,2905 ,0,3,1,3,0,1,0,76.14,58.28 ,33.33
03,003,01,003,0102,0,812 ,11 ,823 ,1335 ,0,3,1,3,0,1,0,76.14,61.65 ,33.33
03,003,01,003,0103,0,1261 ,11 ,1272 ,2160 ,0,3,1,3,0,1,0,76.14,58.89 ,33.33
03,003,01,003,0104,0,1698 ,21 ,1719 ,3055 ,0,3,1,3,0,1,0,76.14,56.27 ,33.33
03,003,01,003,0105,0,1763 ,27 ,1790 ,3105 ,0,3,1,3,0,1,0,76.14,57.65 ,33.33
03,003,01,003,0106,0,1848 ,14 ,1862 ,2955 ,0,3,1,3,0,1,0,76.14,63.01 ,33.33
03,003,01,003,0107,0,1710 ,27 ,1737 ,2818 ,0,3,1,3,0,1,0,76.14,61.64 ,33.33
03,003,01,003,0108,0,2840 ,49 ,2889 ,4970 ,0,3,1,3,0,1,0,76.14,58.13 ,33.33
03,003,01,003,0109,0,1891 ,18 ,1909 ,3050 ,0,3,1,3,0,1,0,76.14,62.59 ,33.33
03,003,01,003,0110,0,1693 ,17 ,1710 ,2913 ,0,3,1,3,0,1,0,76.14,58.70 ,33.33
03,003,01,003,0111,0,2473 ,28 ,2501 ,3939 ,0,3,1,3,0,1,0,76.14,63.49 ,33.33
03,003,01,003,0112,0,1523 ,17 ,1540 ,3024 ,0,3,1,3,0,1,0,76.14,50.93 ,33.33
03,003,01,003,0113,0,2387 ,29 ,2416 ,4176 ,0,3,1,3,0,1,0,76.14,57.85 ,33.33
03,003,01,003,0114,0,1640 ,29 ,1669 ,3084 ,0,3,1,3,0,1,0,76.14,54.12 ,33.33
03,003,01,003,0115,0,1221 ,12 ,1233 ,2059 ,0,3,1,3,0,1,0,76.14,59.88 ,33.33
03,003,01,003,0116,0,1458 ,13 ,1471 ,2428 ,0,3,1,3,0,1,0,76.14,60.58 ,33.33
03,003,01,003,0117,0,1455 ,21 ,1476 ,2708 ,0,3,1,3,0,1,0,76.14,54.51 ,33.33
03,003,01,003,0118,0,959 ,13 ,972 ,1722 ,0,3,1,3,0,1,0,76.14,56.45 ,33.33
03,003,01,003,0119,0,1807 ,13 ,1820 ,3163 ,0,3,1,3,0,1,0,76.14,57.54 ,33.33
03,003,01,003,0120,0,1205 ,7 ,1212 ,2253 ,0,3,1,3,0,1,0,76.14,53.79 ,33.33
03,003,01,003,0121,0,1487 ,17 ,1504 ,2541 ,0,3,1,3,0,1,0,76.14,59.19 ,33.33
03,003,01,003,0122,0,824 ,5 ,829 ,1451 ,0,3,1,3,0,1,0,76.14,57.13 ,33.33
03,003,01,003,0123,0,1317 ,18 ,1335 ,2202 ,0,3,1,3,0,1,0,76.14,60.63 ,33.33
03,003,01,003,0124,0,1042 ,18 ,1060 ,1821 ,0,3,1,3,0,1,0,76.14,58.21 ,33.33
03,003,01,003,0125,0,2152 ,12 ,2164 ,3967 ,0,3,1,3,0,1,0,76.14,54.55 ,33.33
03,003,01,003,0126,0,1814 ,17 ,1831 ,3320 ,0,3,1,3,0,1,0,76.14,55.15 ,33.33
03,003,01,003,0127,0,1562 ,12 ,1574 ,2601 ,0,3,1,3,0,1,0,76.14,60.52 ,33.33
03,003,01,003,0128,0,2432 ,33 ,2465 ,4530 ,0,3,1,3,0,1,0,76.14,54.42 ,33.33
03,003,01,003,0129,0,2516 ,31 ,2547 ,3707 ,0,3,1,3,0,1,0,76.14,68.71 ,33.33
03,003,01,003,0130,0,777 ,11 ,788 ,1370 ,0,3,1,3,0,1,0,76.14,57.52 ,33.33
03,003,01,003,0131,0,2066 ,24 ,2090 ,3372 ,0,3,1,3,0,1,0,76.14,61.98 ,33.33
03,003,01,003,0132,0,1808 ,21 ,1829 ,3138 ,0,3,1,3,0,1,0,76.14,58.29 ,33.33
03,003,01,003,0133,0,1072 ,11 ,1083 ,1814 ,0,3,1,3,0,1,0,76.14,59.70 ,33.33
03,003,01,003,0134,0,1479 ,13 ,1492 ,2373 ,0,3,1,3,0,1,0,76.14,62.87 ,33.33
03,003,01,003,0135,0,1228 ,16 ,1244 ,2070 ,0,3,1,3,0,1,0,76.14,60.10 ,33.33
03,003,01,003,0136,0,1262 ,15 ,1277 ,2116 ,0,3,1,3,0,1,0,76.14,60.35 ,33.33
03,003,01,003,0137,0,2023 ,11 ,2034 ,3505 ,0,3,1,3,0,1,0,76.14,58.03 ,33.33
03,003,01,003,0138,0,1495 ,23 ,1518 ,2614 ,0,3,1,3,0,1,0,76.14,58.07 ,33.33
03,003,01,003,0139,0,1240 ,13 ,1253 ,2201 ,0,3,1,3,0,1,0,76.14,56.93 ,33.33
03,003,01,003,0140,0,818 ,11 ,829 ,1520 ,0,3,1,3,0,1,0,76.14,54.54 ,33.33
03,003,01,003,0141,0,864 ,6 ,870 ,1556 ,0,3,1,3,0,1,0,76.14,55.91 ,33.33
03,003,01,003,0142,0,1329 ,16 ,1345 ,2470 ,0,3,1,3,0,1,0,76.14,54.45 ,33.33
03,003,01,004,0143,0,1986 ,22 ,2008 ,3322 ,0,3,1,3,0,1,0,76.14,60.45 ,33.33
03,003,01,004,0144,0,2068 ,24 ,2092 ,3489 ,0,3,1,3,0,1,0,76.14,59.96 ,33.33
03,003,01,004,0145,0,1744 ,61 ,1805 ,3099 ,0,3,1,3,0,1,0,76.14,58.24 ,33.33
03,003,01,004,0146,0,1282 ,11 ,1293 ,2185 ,0,3,1,3,0,1,0,76.14,59.18 ,33.33
03,003,01,004,0147,0,1390 ,11 ,1401 ,2236 ,0,3,1,3,0,1,0,76.14,62.66 ,33.33
03,003,01,004,0148,0,1696 ,12 ,1708 ,2962 ,0,3,1,3,0,1,0,76.14,57.66 ,33.33
03,003,01,004,0149,0,745 ,6 ,751 ,1164 ,0,3,1,3,0,1,0,76.14,64.52 ,33.33
03,003,01,004,0150,0,886 ,5 ,891 ,1348 ,0,3,1,3,0,1,0,76.14,66.10 ,33.33
03,003,01,004,0151,0,1929 ,17 ,1946 ,2938 ,0,3,1,3,0,1,0,76.14,66.24 ,33.33
03,003,01,004,0152,0,5057 ,42 ,5099 ,10525 ,0,3,1,3,0,1,0,76.14,48.45 ,33.33
03,003,01,004,0153,0,1570 ,9 ,1579 ,3005 ,0,3,1,3,0,1,0,76.14,52.55 ,33.33
03,003,01,004,0154,0,1480 ,14 ,1494 ,2751 ,0,3,1,3,0,1,0,76.14,54.31 ,33.33
03,003,01,004,0155,0,1802 ,13 ,1815 ,3212 ,0,3,1,3,0,1,0,76.14,56.51 ,33.33
03,003,01,004,0156,0,1133 ,7 ,1140 ,1820 ,0,3,1,3,0,1,0,76.14,62.64 ,33.33
03,003,01,004,0157,0,942 ,15 ,957 ,1776 ,0,3,1,3,0,1,0,76.14,53.89 ,33.33
03,003,01,004,0158,0,2175 ,13 ,2188 ,4577 ,0,3,1,3,0,1,0,76.14,47.80 ,33.33
03,003,01,004,0159,0,3178 ,22 ,3200 ,6123 ,0,3,1,3,0,1,0,76.14,52.26 ,33.33
03,003,01,004,0160,0,1956 ,18 ,1974 ,3829 ,0,3,1,3,0,1,0,76.14,51.55 ,33.33
03,003,01,004,0161,0,865 ,11 ,876 ,1832 ,0,3,1,3,0,1,0,76.14,47.82 ,33.33
03,003,01,004,0162,0,1219 ,14 ,1233 ,1890 ,0,3,1,3,0,1,0,76.14,65.24 ,33.33
03,003,01,004,0163,0,842 ,9 ,851 ,1455 ,0,3,1,3,0,1,0,76.14,58.49 ,33.33
03,003,01,004,0164,0,1969 ,14 ,1983 ,3200 ,0,3,1,3,0,1,0,76.14,61.97 ,33.33
03,003,01,004,0165,0,831 ,7 ,838 ,1242 ,0,3,1,3,0,1,0,76.14,67.47 ,33.33
03,003,01,004,0166,0,1026 ,11 ,1037 ,1552 ,0,3,1,3,0,1,0,76.14,66.82 ,33.33
03,003,01,004,0167,0,1422 ,22 ,1444 ,2195 ,0,3,1,3,0,1,0,76.14,65.79 ,33.33
03,003,01,004,0168,0,2160 ,27 ,2187 ,3906 ,0,3,1,3,0,1,0,76.14,55.99 ,33.33
03,003,01,005,0169,0,3405 ,23 ,3428 ,5212 ,0,3,1,3,0,1,0,76.14,65.77 ,33.33
03,003,01,005,0170,0,2716 ,18 ,2734 ,4398 ,0,3,1,3,0,1,0,76.14,62.16 ,33.33
03,003,01,005,0171,0,1848 ,23 ,1871 ,3281 ,0,3,1,3,0,1,0,76.14,57.03 ,33.33
03,003,01,005,0172,0,894 ,10 ,904 ,1442 ,0,3,1,3,0,1,0,76.14,62.69 ,33.33
03,003,01,005,0173,0,2989 ,42 ,3031 ,5102 ,0,3,1,3,0,1,0,76.14,59.41 ,33.33
03,003,01,005,0174,0,2427 ,23 ,2450 ,3769 ,0,3,1,3,0,1,0,76.14,65.00 ,33.33
03,003,01,005,0175,0,2740 ,30 ,2770 ,4405 ,0,3,1,3,0,1,0,76.14,62.88 ,33.33
03,003,01,005,0176,0,929 ,13 ,942 ,1341 ,0,3,1,3,0,1,0,76.14,70.25 ,33.33
03,003,01,005,0177,0,477 ,4 ,481 ,694 ,0,3,1,3,0,1,0,76.14,69.31 ,33.33
03,003,01,005,0178,0,1680 ,24 ,1704 ,2535 ,0,3,1,3,0,1,0,76.14,67.22 ,33.33
03,003,01,005,0179,0,2475 ,24 ,2499 ,4502 ,0,3,1,3,0,1,0,76.14,55.51 ,33.33
03,003,01,005,0180,0,1478 ,11 ,1489 ,2352 ,0,3,1,3,0,1,0,76.14,63.31 ,33.33
03,003,01,005,0181,0,823 ,4 ,827 ,1414 ,0,3,1,3,0,1,0,76.14,58.49 ,33.33
03,003,01,005,0182,0,1482 ,17 ,1499 ,2539 ,0,3,1,3,0,1,0,76.14,59.04 ,33.33
03,003,01,005,0183,0,1102 ,8 ,1110 ,1764 ,0,3,1,3,0,1,0,76.14,62.93 ,33.33
03,003,01,005,0184,0,1254 ,10 ,1264 ,2017 ,0,3,1,3,0,1,0,76.14,62.67 ,33.33
03,003,01,005,0185,0,1062 ,12 ,1074 ,1738 ,0,3,1,3,0,1,0,76.14,61.80 ,33.33
03,003,01,005,0186,0,1370 ,10 ,1380 ,2354 ,0,3,1,3,0,1,0,76.14,58.62 ,33.33
03,003,01,005,0187,0,1257 ,16 ,1273 ,2546 ,0,3,1,3,0,1,0,76.14,50.00 ,33.33
03,003,01,006,0188,0,1061 ,12 ,1073 ,1624 ,0,3,1,3,0,1,0,76.14,66.07 ,33.33
03,003,01,006,0189,0,675 ,5 ,680 ,1039 ,0,3,1,3,0,1,0,76.14,65.45 ,33.33
03,003,01,006,0190,0,2232 ,12 ,2244 ,3769 ,0,3,1,3,0,1,0,76.14,59.54 ,33.33
03,003,01,006,0191,0,2020 ,23 ,2043 ,3371 ,0,3,1,3,0,1,0,76.14,60.61 ,33.33
03,003,01,006,0192,0,2366 ,19 ,2385 ,3997 ,0,3,1,3,0,1,0,76.14,59.67 ,33.33
03,003,01,006,0193,0,670 ,8 ,678 ,1078 ,0,3,1,3,0,1,0,76.14,62.89 ,33.33
03,003,01,006,0194,0,588 ,2 ,590 ,944 ,0,3,1,3,0,1,0,76.14,62.50 ,33.33
03,003,01,006,0195,0,723 ,9 ,732 ,1063 ,0,3,1,3,0,1,0,76.14,68.86 ,33.33
03,003,01,006,0196,0,949 ,13 ,962 ,1536 ,0,3,1,3,0,1,0,76.14,62.63 ,33.33
03,003,01,006,0197,0,1707 ,19 ,1726 ,2744 ,0,3,1,3,0,1,0,76.14,62.90 ,33.33
03,003,01,006,0198,0,1274 ,13 ,1287 ,2146 ,0,3,1,3,0,1,0,76.14,59.97 ,33.33
03,003,01,006,0199,0,592 ,6 ,598 ,951 ,0,3,1,3,0,1,0,76.14,62.88 ,33.33
03,003,01,006,0200,0,519 ,3 ,522 ,876 ,0,3,1,3,0,1,0,76.14,59.59 ,33.33
03,003,01,006,0201,0,1020 ,14 ,1034 ,1546 ,0,3,1,3,0,1,0,76.14,66.88 ,33.33
03,003,01,006,0202,0,1270 ,17 ,1287 ,2047 ,0,3,1,3,0,1,0,76.14,62.87 ,33.33
03,003,01,006,0203,0,1691 ,20 ,1711 ,3025 ,0,3,1,3,0,1,0,76.14,56.56 ,33.33
03,003,01,006,0204,0,1240 ,15 ,1255 ,1794 ,0,3,1,3,0,1,0,76.14,69.96 ,33.33
03,003,01,006,0205,0,1678 ,19 ,1697 ,2588 ,0,3,1,3,0,1,0,76.14,65.57 ,33.33
03,003,01,006,0206,0,1326 ,11 ,1337 ,2353 ,0,3,1,3,0,1,0,76.14,56.82 ,33.33
03,003,01,006,0207,0,1236 ,10 ,1246 ,2074 ,0,3,1,3,0,1,0,76.14,60.08 ,33.33
03,003,01,006,0208,0,1235 ,12 ,1247 ,2085 ,0,3,1,3,0,1,0,76.14,59.81 ,33.33
03,003,01,006,0209,0,1668 ,28 ,1696 ,2889 ,0,3,1,3,0,1,0,76.14,58.71 ,33.33
03,003,01,006,0210,0,2382 ,19 ,2401 ,3915 ,0,3,1,3,0,1,0,76.14,61.33 ,33.33
03,003,01,006,0211,0,692 ,5 ,697 ,1129 ,0,3,1,3,0,1,0,76.14,61.74 ,33.33
03,003,01,006,0212,0,1085 ,15 ,1100 ,1856 ,0,3,1,3,0,1,0,76.14,59.27 ,33.33
03,003,01,006,0213,0,1784 ,10 ,1794 ,2976 ,0,3,1,3,0,1,0,76.14,60.28 ,33.33
03,003,01,006,0214,0,1482 ,15 ,1497 ,2458 ,0,3,1,3,0,1,0,76.14,60.90 ,33.33
03,003,01,007,0215,0,714 ,7 ,721 ,1205 ,0,3,1,3,0,1,0,76.14,59.83 ,33.33
03,003,01,007,0216,0,373 ,1 ,374 ,618 ,0,3,1,3,0,1,0,76.14,60.52 ,33.33
03,003,01,007,0217,0,29 ,0 ,29 ,49 ,0,3,1,3,0,1,0,76.14,59.18 ,33.33
03,003,01,007,0218,0,15 ,1 ,16 ,38 ,0,3,1,3,0,1,0,76.14,42.11 ,33.33
03,003,01,007,0219,0,156 ,2 ,158 ,290 ,0,3,1,3,0,1,0,76.14,54.48 ,33.33
03,003,01,007,0220,0,68 ,0 ,68 ,103 ,0,3,1,3,0,1,0,76.14,66.02 ,33.33
03,003,01,007,0221,0,14 ,0 ,14 ,40 ,0,3,1,3,0,1,0,76.14,35.00 ,33.33
03,003,01,007,0222,0,16 ,0 ,16 ,51 ,0,3,1,3,0,1,0,76.14,31.37 ,33.33
03,003,01,007,0223,0,13 ,0 ,13 ,37 ,0,3,1,3,0,1,0,76.14,35.14 ,33.33
03,003,01,007,0224,0,138 ,2 ,140 ,326 ,0,3,1,3,0,1,0,76.14,42.94 ,33.33
03,003,01,008,0225,0,1758 ,17 ,1775 ,3398 ,0,3,1,3,0,1,0,76.14,52.24 ,33.33
03,003,01,008,0226,0,2020 ,13 ,2033 ,3515 ,0,3,1,3,0,1,0,76.14,57.84 ,33.33
03,003,01,008,0227,0,2945 ,18 ,2963 ,5526 ,0,3,1,3,0,1,0,76.14,53.62 ,33.33
03,003,01,008,0228,0,2075 ,14 ,2089 ,3445 ,0,3,1,3,0,1,0,76.14,60.64 ,33.33
03,003,01,008,0229,0,1525 ,13 ,1538 ,2480 ,0,3,1,3,0,1,0,76.14,62.02 ,33.33
03,003,01,008,0230,0,2432 ,31 ,2463 ,3852 ,0,3,1,3,0,1,0,76.14,63.94 ,33.33
03,003,01,008,0231,0,2681 ,28 ,2709 ,4139 ,0,3,1,3,0,1,0,76.14,65.45 ,33.33
03,003,01,008,0232,0,2808 ,31 ,2839 ,4527 ,0,3,1,3,0,1,0,76.14,62.71 ,33.33
03,003,01,008,0233,0,1929 ,17 ,1946 ,2839 ,0,3,1,3,0,1,0,76.14,68.55 ,33.33
03,003,01,008,0234,0,1372 ,11 ,1383 ,2015 ,0,3,1,3,0,1,0,76.14,68.64 ,33.33
03,003,01,008,0235,0,2131 ,16 ,2147 ,3628 ,0,3,1,3,0,1,0,76.14,59.18 ,33.33
03,003,01,008,0236,0,1981 ,14 ,1995 ,3535 ,0,3,1,3,0,1,0,76.14,56.44 ,33.33
03,003,01,008,0237,0,1265 ,11 ,1276 ,2090 ,0,3,1,3,0,1,0,76.14,61.05 ,33.33
03,003,01,008,0238,0,1272 ,18 ,1290 ,2189 ,0,3,1,3,0,1,0,76.14,58.93 ,33.33
03,003,01,008,0239,0,1532 ,23 ,1555 ,2409 ,0,3,1,3,0,1,0,76.14,64.55 ,33.33
03,003,01,008,0240,0,1305 ,14 ,1319 ,2334 ,0,3,1,3,0,1,0,76.14,56.51 ,33.33
03,003,01,008,0241,0,1600 ,14 ,1614 ,2602 ,0,3,1,3,0,1,0,76.14,62.03 ,33.33
03,003,01,008,0242,0,1794 ,21 ,1815 ,2795 ,0,3,1,3,0,1,0,76.14,64.94 ,33.33
03,003,01,008,0243,0,1301 ,17 ,1318 ,2255 ,0,3,1,3,0,1,0,76.14,58.45 ,33.33
03,003,01,008,0244,0,1924 ,18 ,1942 ,3424 ,0,3,1,3,0,1,0,76.14,56.72 ,33.33
03,003,01,008,0245,0,1440 ,10 ,1450 ,2527 ,0,3,1,3,0,1,0,76.14,57.38 ,33.33
03,003,01,008,0246,0,1794 ,11 ,1805 ,2902 ,0,3,1,3,0,1,0,76.14,62.20 ,33.33
03,003,01,008,0247,0,1978 ,14 ,1992 ,3256 ,0,3,1,3,0,1,0,76.14,61.18 ,33.33
03,003,01,008,0248,0,2007 ,13 ,2020 ,3449 ,0,3,1,3,0,1,0,76.14,58.57 ,33.33
03,003,01,008,0249,0,1461 ,10 ,1471 ,2319 ,0,3,1,3,0,1,0,76.14,63.43 ,33.33
03,003,01,008,0250,0,1128 ,12 ,1140 ,1858 ,0,3,1,3,0,1,0,76.14,61.36 ,33.33
03,003,01,008,0251,0,1368 ,5 ,1373 ,2276 ,0,3,1,3,0,1,0,76.14,60.33 ,33.33
03,003,01,008,0252,0,1426 ,16 ,1442 ,2446 ,0,3,1,3,0,1,0,76.14,58.95 ,33.33
03,003,01,008,0253,0,912 ,11 ,923 ,1511 ,0,3,1,3,0,1,0,76.14,61.09 ,33.33
03,003,01,008,0254,0,1648 ,6 ,1654 ,2810 ,0,3,1,3,0,1,0,76.14,58.86 ,33.33
03,003,01,008,0255,0,1969 ,21 ,1990 ,3454 ,0,3,1,3,0,1,0,76.14,57.61 ,33.33
03,003,01,008,0256,0,2809 ,20 ,2829 ,5388 ,0,3,1,3,0,1,0,76.14,52.51 ,33.33
03,003,01,008,0257,0,594 ,3 ,597 ,1094 ,0,3,1,3,0,1,0,76.14,54.57 ,33.33
03,003,01,008,0258,0,3752 ,33 ,3785 ,5897 ,0,3,1,3,0,1,0,76.14,64.19 ,33.33
03,003,01,008,0259,0,1620 ,6 ,1626 ,2715 ,0,3,1,3,0,1,0,76.14,59.89 ,33.33
03,003,01,008,0260,0,1775 ,17 ,1792 ,2712 ,0,3,1,3,0,1,0,76.14,66.08 ,33.33
03,003,01,008,0261,0,2291 ,22 ,2313 ,3433 ,0,3,1,3,0,1,0,76.14,67.38 ,33.33
03,003,01,008,0262,0,1365 ,23 ,1388 ,2301 ,0,3,1,3,0,1,0,76.14,60.32 ,33.33
03,003,01,008,0263,0,1735 ,16 ,1751 ,3010 ,0,3,1,3,0,1,0,76.14,58.17 ,33.33
03,003,01,008,0264,0,1460 ,16 ,1476 ,2415 ,0,3,1,3,0,1,0,76.14,61.12 ,33.33
03,003,01,008,0265,0,2146 ,15 ,2161 ,3474 ,0,3,1,3,0,1,0,76.14,62.20 ,33.33
03,003,01,008,0266,0,1382 ,18 ,1400 ,2417 ,0,3,1,3,0,1,0,76.14,57.92 ,33.33
03,003,01,008,0267,0,2487 ,25 ,2512 ,4465 ,0,3,1,3,0,1,0,76.14,56.26 ,33.33
03,003,01,008,0268,0,2103 ,17 ,2120 ,3379 ,0,3,1,3,0,1,0,76.14,62.74 ,33.33
03,003,01,008,0269,0,3212 ,27 ,3239 ,5423 ,0,3,1,3,0,1,0,76.14,59.73 ,33.33
03,003,01,008,0270,0,1284 ,13 ,1297 ,2020 ,0,3,1,3,0,1,0,76.14,64.21 ,33.33
03,003,01,008,0271,0,2222 ,22 ,2244 ,3723 ,0,3,1,3,0,1,0,76.14,60.27 ,33.33
03,003,01,008,0272,0,1036 ,7 ,1043 ,2411 ,0,3,1,3,0,1,0,76.14,43.26 ,33.33
03,003,01,008,0273,0,1991 ,14 ,2005 ,3180 ,0,3,1,3,0,1,0,76.14,63.05 ,33.33
03,003,01,008,0274,0,3440 ,36 ,3476 ,6125 ,0,3,1,3,0,1,0,76.14,56.75 ,33.33
03,003,01,008,0275,0,2464 ,15 ,2479 ,4078 ,0,3,1,3,0,1,0,76.14,60.79 ,33.33
03,003,01,008,0276,0,1512 ,14 ,1526 ,2604 ,0,3,1,3,0,1,0,76.14,58.60 ,33.33
03,003,01,008,0277,0,2079 ,11 ,2090 ,3626 ,0,3,1,3,0,1,0,76.14,57.64 ,33.33
03,003,01,008,0278,0,3089 ,20 ,3109 ,5088 ,0,3,1,3,0,1,0,76.14,61.10 ,33.33
03,003,01,008,0279,0,3295 ,21 ,3316 ,5444 ,0,3,1,3,0,1,0,76.14,60.91 ,33.33
03,003,01,008,0280,0,2377 ,17 ,2394 ,4262 ,0,3,1,3,0,1,0,76.14,56.17 ,33.33
03,003,01,008,0281,0,2537 ,16 ,2553 ,4253 ,0,3,1,3,0,1,0,76.14,60.03 ,33.33
03,003,01,008,0282,0,696 ,6 ,702 ,1080 ,0,3,1,3,0,1,0,76.14,65.00 ,33.33
03,003,01,008,0283,0,1055 ,5 ,1060 ,1898 ,0,3,1,3,0,1,0,76.14,55.85 ,33.33
03,003,01,008,0284,0,1193 ,11 ,1204 ,2134 ,0,3,1,3,0,1,0,76.14,56.42 ,33.33
03,003,01,008,0285,0,2656 ,24 ,2680 ,4454 ,0,3,1,3,0,1,0,76.14,60.17 ,33.33
03,003,01,008,0286,0,1577 ,14 ,1591 ,2519 ,0,3,1,3,0,1,0,76.14,63.16 ,33.33
03,003,01,008,0287,0,607 ,3 ,610 ,1022 ,0,3,1,3,0,1,0,76.14,59.69 ,33.33
03,003,01,008,0288,0,516 ,3 ,519 ,830 ,0,3,1,3,0,1,0,76.14,62.53 ,33.33
03,003,01,008,0289,0,592 ,6 ,598 ,972 ,0,3,1,3,0,1,0,76.14,61.52 ,33.33
03,003,01,008,0290,0,643 ,3 ,646 ,1052 ,0,3,1,3,0,1,0,76.14,61.41 ,33.33
03,003,01,008,0291,0,1327 ,15 ,1342 ,2065 ,0,3,1,3,0,1,0,76.14,64.99 ,33.33
03,003,01,008,0292,0,2203 ,23 ,2226 ,3551 ,0,3,1,3,0,1,0,76.14,62.69 ,33.33
03,003,01,008,0293,0,2524 ,18 ,2542 ,4392 ,0,3,1,3,0,1,0,76.14,57.88 ,33.33
03,003,01,008,0294,0,1959 ,11 ,1970 ,3265 ,0,3,1,3,0,1,0,76.14,60.34 ,33.33
03,003,01,008,0295,0,1602 ,13 ,1615 ,2656 ,0,3,1,3,0,1,0,76.14,60.81 ,33.33
03,003,01,008,0296,0,2395 ,17 ,2412 ,4134 ,0,3,1,3,0,1,0,76.14,58.35 ,33.33
03,003,01,008,0297,0,1948 ,12 ,1960 ,3304 ,0,3,1,3,0,1,0,76.14,59.32 ,33.33
03,003,01,008,0298,0,1261 ,11 ,1272 ,2011 ,0,3,1,3,0,1,0,76.14,63.25 ,33.33
03,003,01,008,0299,0,779 ,7 ,786 ,1260 ,0,3,1,3,0,1,0,76.14,62.38 ,33.33
03,003,01,008,0300,0,2170 ,13 ,2183 ,3509 ,0,3,1,3,0,1,0,76.14,62.21 ,33.33
03,003,01,008,0301,0,2021 ,14 ,2035 ,3164 ,0,3,1,3,0,1,0,76.14,64.32 ,33.33
03,003,01,008,0302,0,1902 ,15 ,1917 ,2868 ,0,3,1,3,0,1,0,76.14,66.84 ,33.33
03,003,01,008,0303,0,1587 ,17 ,1604 ,2547 ,0,3,1,3,0,1,0,76.14,62.98 ,33.33
03,003,01,009,0304,0,1869 ,21 ,1890 ,3218 ,0,3,1,3,0,1,0,76.14,58.73 ,33.33
03,003,01,009,0305,0,1564 ,25 ,1589 ,2604 ,0,3,1,3,0,1,0,76.14,61.02 ,33.33
03,003,01,009,0306,0,2153 ,17 ,2170 ,3845 ,0,3,1,3,0,1,0,76.14,56.44 ,33.33
03,003,01,009,0307,0,1238 ,18 ,1256 ,2349 ,0,3,1,3,0,1,0,76.14,53.47 ,33.33
03,003,01,009,0308,0,1835 ,15 ,1850 ,3100 ,0,3,1,3,0,1,0,76.14,59.68 ,33.33
03,003,01,009,0309,0,1916 ,11 ,1927 ,3445 ,0,3,1,3,0,1,0,76.14,55.94 ,33.33
03,003,01,009,0310,0,1350 ,20 ,1370 ,2237 ,0,3,1,3,0,1,0,76.14,61.24 ,33.33
03,003,01,009,0311,0,1332 ,14 ,1346 ,2126 ,0,3,1,3,0,1,0,76.14,63.31 ,33.33
03,003,01,009,0312,0,2452 ,21 ,2473 ,4100 ,0,3,1,3,0,1,0,76.14,60.32 ,33.33
03,003,01,009,0313,0,2444 ,18 ,2462 ,3860 ,0,3,1,3,0,1,0,76.14,63.78 ,33.33
03,003,01,009,0314,0,908 ,13 ,921 ,1508 ,0,3,1,3,0,1,0,76.14,61.07 ,33.33
03,003,01,009,0315,0,1655 ,17 ,1672 ,2913 ,0,3,1,3,0,1,0,76.14,57.40 ,33.33
03,003,01,009,0316,0,1584 ,9 ,1593 ,2969 ,0,3,1,3,0,1,0,76.14,53.65 ,33.33
03,003,01,009,0317,0,1375 ,14 ,1389 ,2717 ,0,3,1,3,0,1,0,76.14,51.12 ,33.33
03,003,01,009,0318,0,2407 ,17 ,2424 ,4212 ,0,3,1,3,0,1,0,76.14,57.55 ,33.33
03,003,01,009,0319,0,1847 ,20 ,1867 ,3086 ,0,3,1,3,0,1,0,76.14,60.50 ,33.33
03,003,01,009,0320,0,1840 ,23 ,1863 ,3510 ,0,3,1,3,0,1,0,76.14,53.08 ,33.33
03,003,01,009,0321,0,1846 ,11 ,1857 ,3475 ,0,3,1,3,0,1,0,76.14,53.44 ,33.33
03,003,01,009,0322,0,2109 ,17 ,2126 ,3586 ,0,3,1,3,0,1,0,76.14,59.29 ,33.33
03,003,01,009,0323,0,1985 ,16 ,2001 ,3472 ,0,3,1,3,0,1,0,76.14,57.63 ,33.33
03,003,01,009,0324,0,2959 ,27 ,2986 ,4943 ,0,3,1,3,0,1,0,76.14,60.41 ,33.33
03,003,01,009,0325,0,2308 ,22 ,2330 ,3747 ,0,3,1,3,0,1,0,76.14,62.18 ,33.33
03,003,01,009,0326,0,1778 ,14 ,1792 ,2915 ,0,3,1,3,0,1,0,76.14,61.48 ,33.33
03,003,01,009,0327,0,1423 ,12 ,1435 ,2275 ,0,3,1,3,0,1,0,76.14,63.08 ,33.33
03,003,01,009,0328,0,1459 ,12 ,1471 ,2447 ,0,3,1,3,0,1,0,76.14,60.11 ,33.33
03,003,01,009,0329,0,2093 ,16 ,2109 ,3495 ,0,3,1,3,0,1,0,76.14,60.34 ,33.33
03,003,01,009,0330,0,964 ,11 ,975 ,1554 ,0,3,1,3,0,1,0,76.14,62.74 ,33.33
03,003,01,009,0331,0,2260 ,22 ,2282 ,3976 ,0,3,1,3,0,1,0,76.14,57.39 ,33.33
03,003,01,009,0332,0,1822 ,9 ,1831 ,3322 ,0,3,1,3,0,1,0,76.14,55.12 ,33.33
03,003,01,009,0333,0,1177 ,10 ,1187 ,2148 ,0,3,1,3,0,1,0,76.14,55.26 ,33.33
03,003,01,009,0334,0,2073 ,18 ,2091 ,3511 ,0,3,1,3,0,1,0,76.14,59.56 ,33.33
03,003,01,009,0335,0,1179 ,13 ,1192 ,1812 ,0,3,1,3,0,1,0,76.14,65.78 ,33.33
03,003,01,009,0336,0,1672 ,24 ,1696 ,2691 ,0,3,1,3,0,1,0,76.14,63.02 ,33.33
03,003,01,009,0337,0,2082 ,20 ,2102 ,3499 ,0,3,1,3,0,1,0,76.14,60.07 ,33.33
03,003,01,009,0338,0,1918 ,16 ,1934 ,3286 ,0,3,1,3,0,1,0,76.14,58.86 ,33.33
03,003,01,009,0339,0,1342 ,12 ,1354 ,2210 ,0,3,1,3,0,1,0,76.14,61.27 ,33.33
03,003,01,009,0340,0,1711 ,19 ,1730 ,2989 ,0,3,1,3,0,1,0,76.14,57.88 ,33.33
03,003,01,009,0341,0,2422 ,22 ,2444 ,4014 ,0,3,1,3,0,1,0,76.14,60.89 ,33.33
03,003,01,009,0342,0,1782 ,12 ,1794 ,3143 ,0,3,1,3,0,1,0,76.14,57.08 ,33.33
03,003,01,009,0343,0,1892 ,18 ,1910 ,3213 ,0,3,1,3,0,1,0,76.14,59.45 ,33.33
03,003,01,009,0344,0,1540 ,26 ,1566 ,2561 ,0,3,1,3,0,1,0,76.14,61.15 ,33.33
03,003,01,009,0345,0,1846 ,16 ,1862 ,3014 ,0,3,1,3,0,1,0,76.14,61.78 ,33.33
03,003,01,009,0346,0,527 ,8 ,535 ,881 ,0,3,1,3,0,1,0,76.14,60.73 ,33.33
03,003,01,009,0347,0,983 ,16 ,999 ,1498 ,0,3,1,3,0,1,0,76.14,66.69 ,33.33
03,003,01,009,0348,0,1395 ,12 ,1407 ,2221 ,0,3,1,3,0,1,0,76.14,63.35 ,33.33
03,003,01,009,0349,0,636 ,6 ,642 ,1045 ,0,3,1,3,0,1,0,76.14,61.44 ,33.33
03,003,01,010,0350,0,2264 ,28 ,2292 ,3826 ,0,3,1,3,0,1,0,76.14,59.91 ,33.33
03,003,01,010,0351,0,951 ,6 ,957 ,1496 ,0,3,1,3,0,1,0,76.14,63.97 ,33.33
03,003,01,010,0352,0,1982 ,16 ,1998 ,3025 ,0,3,1,3,0,1,0,76.14,66.05 ,33.33
03,003,01,010,0353,0,449 ,5 ,454 ,685 ,0,3,1,3,0,1,0,76.14,66.28 ,33.33
03,003,01,010,0354,0,657 ,5 ,662 ,1111 ,0,3,1,3,0,1,0,76.14,59.59 ,33.33
03,003,01,010,0355,0,796 ,14 ,810 ,1387 ,0,3,1,3,0,1,0,76.14,58.40 ,33.33
03,003,01,010,0356,0,2172 ,25 ,2197 ,3909 ,0,3,1,3,0,1,0,76.14,56.20 ,33.33
03,003,01,010,0357,0,1427 ,14 ,1441 ,2550 ,0,3,1,3,0,1,0,76.14,56.51 ,33.33
03,003,01,010,0358,0,1662 ,23 ,1685 ,3223 ,0,3,1,3,0,1,0,76.14,52.28 ,33.33
03,003,01,010,0359,0,1931 ,11 ,1942 ,3773 ,0,3,1,3,0,1,0,76.14,51.47 ,33.33
03,003,01,010,0360,0,1507 ,12 ,1519 ,2669 ,0,3,1,3,0,1,0,76.14,56.91 ,33.33
03,003,01,010,0361,0,1820 ,16 ,1836 ,3683 ,0,3,1,3,0,1,0,76.14,49.85 ,33.33
03,003,01,010,0362,0,1857 ,11 ,1868 ,2857 ,0,3,1,3,0,1,0,76.14,65.38 ,33.33
03,003,01,010,0363,0,1246 ,12 ,1258 ,2189 ,0,3,1,3,0,1,0,76.14,57.47 ,33.33
03,003,01,010,0364,0,1879 ,15 ,1894 ,2973 ,0,3,1,3,0,1,0,76.14,63.71 ,33.33
03,003,01,010,0365,0,755 ,9 ,764 ,1164 ,0,3,1,3,0,1,0,76.14,65.64 ,33.33
03,003,01,010,0366,0,937 ,12 ,949 ,1574 ,0,3,1,3,0,1,0,76.14,60.29 ,33.33
03,003,01,010,0367,0,1259 ,6 ,1265 ,2017 ,0,3,1,3,0,1,0,76.14,62.72 ,33.33
03,003,01,010,0368,0,2217 ,23 ,2240 ,3912 ,0,3,1,3,0,1,0,76.14,57.26 ,33.33
03,003,01,010,0369,0,1783 ,22 ,1805 ,2935 ,0,3,1,3,0,1,0,76.14,61.50 ,33.33
03,003,01,010,0370,0,1734 ,19 ,1753 ,2776 ,0,3,1,3,0,1,0,76.14,63.15 ,33.33
03,003,01,010,0371,0,1335 ,18 ,1353 ,2261 ,0,3,1,3,0,1,0,76.14,59.84 ,33.33
03,003,01,010,0372,0,1860 ,23 ,1883 ,3041 ,0,3,1,3,0,1,0,76.14,61.92 ,33.33
03,003,01,010,0373,0,2520 ,28 ,2548 ,4068 ,0,3,1,3,0,1,0,76.14,62.64 ,33.33
03,003,01,010,0374,0,1154 ,16 ,1170 ,1882 ,0,3,1,3,0,1,0,76.14,62.17 ,33.33
03,003,01,010,0375,0,1727 ,20 ,1747 ,3282 ,0,3,1,3,0,1,0,76.14,53.23 ,33.33
03,003,01,010,0376,0,1735 ,41 ,1776 ,3289 ,0,3,1,3,0,1,0,76.14,54.00 ,33.33
03,003,01,010,0377,0,1419 ,8 ,1427 ,2285 ,0,3,1,3,0,1,0,76.14,62.45 ,33.33
03,003,01,010,0378,0,2364 ,44 ,2408 ,4198 ,0,3,1,3,0,1,0,76.14,57.36 ,33.33
03,003,01,010,0379,0,847 ,10 ,857 ,1787 ,0,3,1,3,0,1,0,76.14,47.96 ,33.33
03,003,01,010,0380,0,1306 ,21 ,1327 ,2088 ,0,3,1,3,0,1,0,76.14,63.55 ,33.33
03,003,01,010,0381,0,1140 ,8 ,1148 ,1863 ,0,3,1,3,0,1,0,76.14,61.62 ,33.33
03,003,01,010,0382,0,1361 ,15 ,1376 ,2397 ,0,3,1,3,0,1,0,76.14,57.41 ,33.33
03,003,01,010,0383,0,2021 ,16 ,2037 ,3185 ,0,3,1,3,0,1,0,76.14,63.96 ,33.33
03,003,01,010,0384,0,1826 ,19 ,1845 ,3128 ,0,3,1,3,0,1,0,76.14,58.98 ,33.33
03,003,01,011,0385,0,1979 ,17 ,1996 ,3534 ,0,3,1,3,0,1,0,76.14,56.48 ,33.33
03,003,01,011,0386,0,1473 ,18 ,1491 ,2481 ,0,3,1,3,0,1,0,76.14,60.10 ,33.33
03,003,01,011,0387,0,2433 ,12 ,2445 ,3876 ,0,3,1,3,0,1,0,76.14,63.08 ,33.33
03,003,01,011,0388,0,1061 ,11 ,1072 ,1952 ,0,3,1,3,0,1,0,76.14,54.92 ,33.33
03,003,01,011,0389,0,1779 ,32 ,1811 ,3205 ,0,3,1,3,0,1,0,76.14,56.51 ,33.33
03,003,01,011,0390,0,1369 ,6 ,1375 ,2450 ,0,3,1,3,0,1,0,76.14,56.12 ,33.33
03,003,01,011,0391,0,1668 ,13 ,1681 ,2887 ,0,3,1,3,0,1,0,76.14,58.23 ,33.33
03,003,01,011,0392,0,1437 ,24 ,1461 ,2437 ,0,3,1,3,0,1,0,76.14,59.95 ,33.33
03,003,01,011,0393,0,1820 ,16 ,1836 ,3110 ,0,3,1,3,0,1,0,76.14,59.04 ,33.33
03,003,01,011,0394,0,1249 ,8 ,1257 ,2255 ,0,3,1,3,0,1,0,76.14,55.74 ,33.33
03,003,01,011,0395,0,1634 ,19 ,1653 ,2968 ,0,3,1,3,0,1,0,76.14,55.69 ,33.33
03,003,01,011,0396,0,1242 ,7 ,1249 ,1934 ,0,3,1,3,0,1,0,76.14,64.58 ,33.33
03,003,01,011,0397,0,1695 ,13 ,1708 ,2909 ,0,3,1,3,0,1,0,76.14,58.71 ,33.33
03,003,01,011,0398,0,1621 ,11 ,1632 ,2840 ,0,3,1,3,0,1,0,76.14,57.46 ,33.33
03,003,01,011,0399,0,1265 ,16 ,1281 ,2197 ,0,3,1,3,0,1,0,76.14,58.31 ,33.33
03,003,01,011,0400,0,1552 ,19 ,1571 ,2824 ,0,3,1,3,0,1,0,76.14,55.63 ,33.33
03,003,01,011,0401,0,1051 ,5 ,1056 ,1933 ,0,3,1,3,0,1,0,76.14,54.63 ,33.33
03,003,01,011,0402,0,2050 ,21 ,2071 ,3290 ,0,3,1,3,0,1,0,76.14,62.95 ,33.33
03,003,01,011,0403,0,1866 ,21 ,1887 ,3301 ,0,3,1,3,0,1,0,76.14,57.16 ,33.33
03,003,01,011,0404,0,1081 ,17 ,1098 ,1905 ,0,3,1,3,0,1,0,76.14,57.64 ,33.33
03,003,01,011,0405,0,1963 ,18 ,1981 ,3113 ,0,3,1,3,0,1,0,76.14,63.64 ,33.33
03,003,01,011,0406,0,748 ,10 ,758 ,1295 ,0,3,1,3,0,1,0,76.14,58.53 ,33.33
03,003,01,011,0407,0,631 ,4 ,635 ,1144 ,0,3,1,3,0,1,0,76.14,55.51 ,33.33
03,003,01,011,0408,0,1301 ,5 ,1306 ,2142 ,0,3,1,3,0,1,0,76.14,60.97 ,33.33
03,003,01,011,0409,0,1941 ,8 ,1949 ,3094 ,0,3,1,3,0,1,0,76.14,62.99 ,33.33
03,003,01,011,0410,0,1725 ,12 ,1737 ,2780 ,0,3,1,3,0,1,0,76.14,62.48 ,33.33
03,003,01,011,0411,0,1414 ,14 ,1428 ,2562 ,0,3,1,3,0,1,0,76.14,55.74 ,33.33
03,003,01,011,0412,0,1541 ,19 ,1560 ,2889 ,0,3,1,3,0,1,0,76.14,54.00 ,33.33
03,003,01,011,0413,0,763 ,2 ,765 ,1340 ,0,3,1,3,0,1,0,76.14,57.09 ,33.33
03,003,01,011,0414,0,451 ,3 ,454 ,681 ,0,3,1,3,0,1,0,76.14,66.67 ,33.33
03,003,01,012,0415,0,1626 ,6 ,1632 ,2416 ,0,3,1,3,0,1,0,76.14,67.55 ,33.33
03,003,01,012,0416,0,2014 ,16 ,2030 ,3033 ,0,3,1,3,0,1,0,76.14,66.93 ,33.33
03,003,01,012,0417,0,814 ,7 ,821 ,1246 ,0,3,1,3,0,1,0,76.14,65.89 ,33.33
03,003,01,012,0418,0,1878 ,14 ,1892 ,3016 ,0,3,1,3,0,1,0,76.14,62.73 ,33.33
03,003,01,012,0419,0,1122 ,15 ,1137 ,1689 ,0,3,1,3,0,1,0,76.14,67.32 ,33.33
03,003,01,012,0420,0,765 ,2 ,767 ,1193 ,0,3,1,3,0,1,0,76.14,64.29 ,33.33
03,003,01,012,0421,0,958 ,5 ,963 ,1326 ,0,3,1,3,0,1,0,76.14,72.62 ,33.33
03,003,01,012,0422,0,1359 ,12 ,1371 ,2099 ,0,3,1,3,0,1,0,76.14,65.32 ,33.33
03,003,01,012,0423,0,1188 ,11 ,1199 ,1835 ,0,3,1,3,0,1,0,76.14,65.34 ,33.33
03,003,01,012,0424,0,1754 ,12 ,1766 ,2916 ,0,3,1,3,0,1,0,76.14,60.56 ,33.33
03,003,01,012,0425,0,847 ,6 ,853 ,1318 ,0,3,1,3,0,1,0,76.14,64.72 ,33.33
03,003,01,012,0426,0,999 ,7 ,1006 ,1446 ,0,3,1,3,0,1,0,76.14,69.57 ,33.33
03,003,01,012,0427,0,704 ,8 ,712 ,1087 ,0,3,1,3,0,1,0,76.14,65.50 ,33.33
03,003,01,012,0428,0,507 ,4 ,511 ,858 ,0,3,1,3,0,1,0,76.14,59.56 ,33.33
03,003,01,012,0429,0,434 ,2 ,436 ,653 ,0,3,1,3,0,1,0,76.14,66.77 ,33.33
03,003,01,012,0430,0,700 ,5 ,705 ,1042 ,0,3,1,3,0,1,0,76.14,67.66 ,33.33
03,003,01,012,0431,0,676 ,7 ,683 ,1017 ,0,3,1,3,0,1,0,76.14,67.16 ,33.33
03,003,01,012,0432,0,1544 ,14 ,1558 ,2225 ,0,3,1,3,0,1,0,76.14,70.02 ,33.33
03,003,01,012,0433,0,619 ,3 ,622 ,937 ,0,3,1,3,0,1,0,76.14,66.38 ,33.33
03,003,01,012,0434,0,435 ,5 ,440 ,690 ,0,3,1,3,0,1,0,76.14,63.77 ,33.33
03,003,01,012,0435,0,574 ,2 ,576 ,799 ,0,3,1,3,0,1,0,76.14,72.09 ,33.33
03,003,01,012,0436,0,1017 ,8 ,1025 ,1556 ,0,3,1,3,0,1,0,76.14,65.87 ,33.33
03,003,01,012,0437,0,705 ,10 ,715 ,1073 ,0,3,1,3,0,1,0,76.14,66.64 ,33.33
03,003,01,013,0438,0,1505 ,9 ,1514 ,2354 ,0,3,1,3,0,1,0,76.14,64.32 ,33.33
03,003,01,013,0439,0,769 ,14 ,783 ,1094 ,0,3,1,3,0,1,0,76.14,71.57 ,33.33
03,003,01,013,0440,0,816 ,8 ,824 ,1292 ,0,3,1,3,0,1,0,76.14,63.78 ,33.33
03,003,01,013,0441,0,769 ,5 ,774 ,1179 ,0,3,1,3,0,1,0,76.14,65.65 ,33.33
03,003,01,013,0442,0,1055 ,5 ,1060 ,1570 ,0,3,1,3,0,1,0,76.14,67.52 ,33.33
03,003,01,013,0443,0,499 ,4 ,503 ,688 ,0,3,1,3,0,1,0,76.14,73.11 ,33.33
03,003,01,013,0444,0,520 ,9 ,529 ,746 ,0,3,1,3,0,1,0,76.14,70.91 ,33.33
03,003,01,013,0445,0,443 ,4 ,447 ,660 ,0,3,1,3,0,1,0,76.14,67.73 ,33.33
03,003,01,013,0446,0,738 ,9 ,747 ,1228 ,0,3,1,3,0,1,0,76.14,60.83 ,33.33
03,003,01,013,0447,0,1134 ,3 ,1137 ,1905 ,0,3,1,3,0,1,0,76.14,59.69 ,33.33
03,003,01,013,0448,0,1261 ,8 ,1269 ,1947 ,0,3,1,3,0,1,0,76.14,65.18 ,33.33
03,003,01,013,0449,0,1123 ,13 ,1136 ,1796 ,0,3,1,3,0,1,0,76.14,63.25 ,33.33
03,003,01,013,0450,0,702 ,13 ,715 ,1075 ,0,3,1,3,0,1,0,76.14,66.51 ,33.33
03,003,01,013,0451,0,2231 ,26 ,2257 ,3631 ,0,3,1,3,0,1,0,76.14,62.16 ,33.33
03,003,01,013,0452,0,1152 ,14 ,1166 ,1960 ,0,3,1,3,0,1,0,76.14,59.49 ,33.33
03,003,01,013,0453,0,1046 ,11 ,1057 ,1731 ,0,3,1,3,0,1,0,76.14,61.06 ,33.33
03,003,01,013,0454,0,1632 ,11 ,1643 ,2574 ,0,3,1,3,0,1,0,76.14,63.83 ,33.33
03,003,01,013,0455,0,1196 ,6 ,1202 ,1831 ,0,3,1,3,0,1,0,76.14,65.65 ,33.33
03,003,01,013,0456,0,636 ,3 ,639 ,967 ,0,3,1,3,0,1,0,76.14,66.08 ,33.33
03,003,01,013,0457,0,1161 ,27 ,1188 ,1871 ,0,3,1,3,0,1,0,76.14,63.50 ,33.33
03,003,01,013,0458,0,2158 ,23 ,2181 ,3557 ,0,3,1,3,0,1,0,76.14,61.32 ,33.33
03,003,01,013,0459,0,996 ,6 ,1002 ,1682 ,0,3,1,3,0,1,0,76.14,59.57 ,33.33
03,003,01,013,0460,0,881 ,14 ,895 ,1394 ,0,3,1,3,0,1,0,76.14,64.20 ,33.33
03,004,01,001,0001,0,906 ,6 ,912 ,1485 ,0,3,1,3,0,1,0,76.14,61.41 ,33.33
03,004,01,001,0002,0,183 ,0 ,183 ,254 ,0,3,1,3,0,1,0,76.14,72.05 ,33.33
03,004,01,001,0003,0,955 ,17 ,972 ,1680 ,0,3,1,3,0,1,0,76.14,57.86 ,33.33
03,004,01,001,0004,0,398 ,4 ,402 ,571 ,0,3,1,3,0,1,0,76.14,70.40 ,33.33
03,004,01,001,0005,0,1596 ,15 ,1611 ,2523 ,0,3,1,3,0,1,0,76.14,63.85 ,33.33
03,004,01,001,0006,0,3607 ,35 ,3642 ,6385 ,0,3,1,3,0,1,0,76.14,57.04 ,33.33
03,004,01,001,0007,0,2817 ,22 ,2839 ,5049 ,0,3,1,3,0,1,0,76.14,56.23 ,33.33
03,004,01,001,0008,0,1553 ,5 ,1558 ,2612 ,0,3,1,3,0,1,0,76.14,59.65 ,33.33
03,004,01,001,0009,0,2173 ,12 ,2185 ,3667 ,0,3,1,3,0,1,0,76.14,59.59 ,33.33
03,004,01,001,0010,0,1991 ,10 ,2001 ,3552 ,0,3,1,3,0,1,0,76.14,56.33 ,33.33
03,004,01,001,0011,0,3906 ,32 ,3938 ,6842 ,0,3,1,3,0,1,0,76.14,57.56 ,33.33
03,004,01,001,0012,0,1720 ,16 ,1736 ,2882 ,0,3,1,3,0,1,0,76.14,60.24 ,33.33
03,004,01,001,0013,0,2205 ,21 ,2226 ,3894 ,0,3,1,3,0,1,0,76.14,57.16 ,33.33
03,004,01,001,0014,0,2107 ,31 ,2138 ,3746 ,0,3,1,3,0,1,0,76.14,57.07 ,33.33
03,004,01,001,0015,0,3018 ,25 ,3043 ,5333 ,0,3,1,3,0,1,0,76.14,57.06 ,33.33
03,004,01,001,0016,0,2103 ,23 ,2126 ,3635 ,0,3,1,3,0,1,0,76.14,58.49 ,33.33
03,004,01,001,0017,0,1997 ,27 ,2024 ,3344 ,0,3,1,3,0,1,0,76.14,60.53 ,33.33
03,004,01,001,0018,0,812 ,6 ,818 ,1229 ,0,3,1,3,0,1,0,76.14,66.56 ,33.33
03,004,01,001,0019,0,1180 ,12 ,1192 ,1836 ,0,3,1,3,0,1,0,76.14,64.92 ,33.33
03,004,01,001,0020,0,620 ,3 ,623 ,919 ,0,3,1,3,0,1,0,76.14,67.79 ,33.33
03,004,01,001,0021,0,1127 ,10 ,1137 ,1726 ,0,3,1,3,0,1,0,76.14,65.87 ,33.33
03,004,01,001,0022,0,710 ,7 ,717 ,1094 ,0,3,1,3,0,1,0,76.14,65.54 ,33.33
03,004,01,001,0023,0,780 ,6 ,786 ,1425 ,0,3,1,3,0,1,0,76.14,55.16 ,33.33
03,004,01,001,0024,0,908 ,6 ,914 ,1435 ,0,3,1,3,0,1,0,76.14,63.69 ,33.33
03,004,01,001,0025,0,892 ,4 ,896 ,1314 ,0,3,1,3,0,1,0,76.14,68.19 ,33.33
03,004,01,001,0026,0,1146 ,11 ,1157 ,1708 ,0,3,1,3,0,1,0,76.14,67.74 ,33.33
03,004,01,002,0027,0,221 ,2 ,223 ,379 ,0,3,1,3,0,1,0,76.14,58.84 ,33.33
03,004,01,002,0028,0,217 ,1 ,218 ,344 ,0,3,1,3,0,1,0,76.14,63.37 ,33.33
03,004,01,002,0029,0,216 ,5 ,221 ,368 ,0,3,1,3,0,1,0,76.14,60.05 ,33.33
03,004,01,002,0030,0,1061 ,15 ,1076 ,1866 ,0,3,1,3,0,1,0,76.14,57.66 ,33.33
03,004,01,002,0031,0,3618 ,35 ,3653 ,6630 ,0,3,1,3,0,1,0,76.14,55.10 ,33.33
03,004,01,002,0032,0,1680 ,20 ,1700 ,2810 ,0,3,1,3,0,1,0,76.14,60.50 ,33.33
03,004,01,002,0033,0,906 ,15 ,921 ,1554 ,0,3,1,3,0,1,0,76.14,59.27 ,33.33
03,004,01,002,0034,0,2040 ,20 ,2060 ,3681 ,0,3,1,3,0,1,0,76.14,55.96 ,33.33
03,004,01,002,0035,0,1123 ,3 ,1126 ,1758 ,0,3,1,3,0,1,0,76.14,64.05 ,33.33
03,004,01,002,0036,0,752 ,9 ,761 ,1132 ,0,3,1,3,0,1,0,76.14,67.23 ,33.33
03,004,01,002,0037,0,516 ,5 ,521 ,785 ,0,3,1,3,0,1,0,76.14,66.37 ,33.33
03,004,01,002,0038,0,1361 ,7 ,1368 ,2408 ,0,3,1,3,0,1,0,76.14,56.81 ,33.33
03,004,01,002,0039,0,1876 ,21 ,1897 ,3215 ,0,3,1,3,0,1,0,76.14,59.00 ,33.33
03,004,01,002,0040,0,1649 ,17 ,1666 ,2800 ,0,3,1,3,0,1,0,76.14,59.50 ,33.33
03,004,01,002,0041,0,941 ,10 ,951 ,1417 ,0,3,1,3,0,1,0,76.14,67.11 ,33.33
03,004,01,002,0042,0,808 ,7 ,815 ,1416 ,0,3,1,3,0,1,0,76.14,57.56 ,33.33
03,004,01,002,0043,0,900 ,8 ,908 ,1401 ,0,3,1,3,0,1,0,76.14,64.81 ,33.33
03,004,01,002,0044,0,3296 ,36 ,3332 ,5509 ,0,3,1,3,0,1,0,76.14,60.48 ,33.33
03,004,01,002,0045,0,3068 ,38 ,3106 ,5689 ,0,3,1,3,0,1,0,76.14,54.60 ,33.33
03,004,01,002,0046,0,311 ,1 ,312 ,511 ,0,3,1,3,0,1,0,76.14,61.06 ,33.33
03,004,01,002,0047,0,2769 ,35 ,2804 ,4967 ,0,3,1,3,0,1,0,76.14,56.45 ,33.33
03,004,01,002,0048,0,3736 ,39 ,3775 ,6897 ,0,3,1,3,0,1,0,76.14,54.73 ,33.33
03,004,01,002,0049,0,1976 ,10 ,1986 ,3582 ,0,3,1,3,0,1,0,76.14,55.44 ,33.33
03,004,01,002,0050,0,863 ,7 ,870 ,1508 ,0,3,1,3,0,1,0,76.14,57.69 ,33.33
03,004,01,002,0051,0,366 ,4 ,370 ,651 ,0,3,1,3,0,1,0,76.14,56.84 ,33.33
03,004,01,003,0052,0,709 ,5 ,714 ,1033 ,0,3,1,3,0,1,0,76.14,69.12 ,33.33
03,004,01,003,0053,0,425 ,6 ,431 ,679 ,0,3,1,3,0,1,0,76.14,63.48 ,33.33
03,004,01,003,0054,0,673 ,18 ,691 ,1059 ,0,3,1,3,0,1,0,76.14,65.25 ,33.33
03,004,01,003,0055,0,1527 ,18 ,1545 ,2373 ,0,3,1,3,0,1,0,76.14,65.11 ,33.33
03,004,01,003,0056,0,972 ,9 ,981 ,1746 ,0,3,1,3,0,1,0,76.14,56.19 ,33.33
03,004,01,003,0057,0,1158 ,12 ,1170 ,1857 ,0,3,1,3,0,1,0,76.14,63.00 ,33.33
03,004,01,003,0058,0,1835 ,22 ,1857 ,2921 ,0,3,1,3,0,1,0,76.14,63.57 ,33.33
03,004,01,003,0059,0,893 ,13 ,906 ,1374 ,0,3,1,3,0,1,0,76.14,65.94 ,33.33
03,004,01,003,0060,0,314 ,0 ,314 ,451 ,0,3,1,3,0,1,0,76.14,69.62 ,33.33
03,004,01,003,0061,0,469 ,6 ,475 ,716 ,0,3,1,3,0,1,0,76.14,66.34 ,33.33
03,004,01,003,0062,0,394 ,1 ,395 ,605 ,0,3,1,3,0,1,0,76.14,65.29 ,33.33
03,004,01,003,0063,0,777 ,10 ,787 ,1083 ,0,3,1,3,0,1,0,76.14,72.67 ,33.33
03,004,01,003,0064,0,728 ,8 ,736 ,1112 ,0,3,1,3,0,1,0,76.14,66.19 ,33.33
03,004,01,003,0065,0,567 ,3 ,570 ,801 ,0,3,1,3,0,1,0,76.14,71.16 ,33.33
03,004,01,003,0066,0,2268 ,24 ,2292 ,3922 ,0,3,1,3,0,1,0,76.14,58.44 ,33.33
03,004,01,003,0067,0,1063 ,29 ,1092 ,1714 ,0,3,1,3,0,1,0,76.14,63.71 ,33.33
03,004,01,003,0068,0,1134 ,13 ,1147 ,1807 ,0,3,1,3,0,1,0,76.14,63.48 ,33.33
03,004,01,003,0069,0,652 ,5 ,657 ,1012 ,0,3,1,3,0,1,0,76.14,64.92 ,33.33
03,004,01,003,0070,0,460 ,2 ,462 ,666 ,0,3,1,3,0,1,0,76.14,69.37 ,33.33
03,004,01,004,0071,0,386 ,5 ,391 ,544 ,0,3,1,3,0,1,0,76.14,71.88 ,33.33
03,004,01,004,0072,0,1045 ,11 ,1056 ,1750 ,0,3,1,3,0,1,0,76.14,60.34 ,33.33
03,004,01,004,0073,0,519 ,7 ,526 ,750 ,0,3,1,3,0,1,0,76.14,70.13 ,33.33
03,004,01,004,0074,0,2189 ,19 ,2208 ,3616 ,0,3,1,3,0,1,0,76.14,61.06 ,33.33
03,004,01,004,0075,0,481 ,5 ,486 ,740 ,0,3,1,3,0,1,0,76.14,65.68 ,33.33
03,004,01,004,0076,0,674 ,9 ,683 ,1080 ,0,3,1,3,0,1,0,76.14,63.24 ,33.33
03,004,01,004,0077,0,633 ,12 ,645 ,1029 ,0,3,1,3,0,1,0,76.14,62.68 ,33.33
03,004,01,004,0078,0,1748 ,20 ,1768 ,2949 ,0,3,1,3,0,1,0,76.14,59.95 ,33.33
03,004,01,004,0079,0,485 ,3 ,488 ,775 ,0,3,1,3,0,1,0,76.14,62.97 ,33.33
03,004,01,004,0080,0,741 ,18 ,759 ,1212 ,0,3,1,3,0,1,0,76.14,62.62 ,33.33
03,004,01,004,0081,0,600 ,8 ,608 ,974 ,0,3,1,3,0,1,0,76.14,62.42 ,33.33
03,004,01,004,0082,0,410 ,5 ,415 ,602 ,0,3,1,3,0,1,0,76.14,68.94 ,33.33
03,004,01,004,0083,0,330 ,4 ,334 ,530 ,0,3,1,3,0,1,0,76.14,63.02 ,33.33
03,004,01,004,0084,0,380 ,4 ,384 ,638 ,0,3,1,3,0,1,0,76.14,60.19 ,33.33
03,004,01,004,0085,0,514 ,7 ,521 ,890 ,0,3,1,3,0,1,0,76.14,58.54 ,33.33
03,004,01,004,0086,0,495 ,3 ,498 ,735 ,0,3,1,3,0,1,0,76.14,67.76 ,33.33
03,004,01,004,0087,0,1171 ,19 ,1190 ,1830 ,0,3,1,3,0,1,0,76.14,65.03 ,33.33
03,004,01,004,0088,0,657 ,14 ,671 ,968 ,0,3,1,3,0,1,0,76.14,69.32 ,33.33
03,004,01,004,0089,0,576 ,5 ,581 ,843 ,0,3,1,3,0,1,0,76.14,68.92 ,33.33
03,004,01,004,0090,0,424 ,4 ,428 ,607 ,0,3,1,3,0,1,0,76.14,70.51 ,33.33
03,004,01,004,0091,0,546 ,8 ,554 ,796 ,0,3,1,3,0,1,0,76.14,69.60 ,33.33
03,004,01,005,0092,0,1549 ,16 ,1565 ,2404 ,0,3,1,3,0,1,0,76.14,65.10 ,33.33
03,004,01,005,0093,0,1668 ,21 ,1689 ,3052 ,0,3,1,3,0,1,0,76.14,55.34 ,33.33
03,004,01,005,0094,0,2100 ,29 ,2129 ,3561 ,0,3,1,3,0,1,0,76.14,59.79 ,33.33
03,004,01,005,0095,0,2258 ,32 ,2290 ,3861 ,0,3,1,3,0,1,0,76.14,59.31 ,33.33
03,004,01,005,0096,0,552 ,5 ,557 ,827 ,0,3,1,3,0,1,0,76.14,67.35 ,33.33
03,004,01,005,0097,0,775 ,10 ,785 ,1323 ,0,3,1,3,0,1,0,76.14,59.33 ,33.33
03,004,01,005,0098,0,1476 ,16 ,1492 ,2376 ,0,3,1,3,0,1,0,76.14,62.79 ,33.33
03,004,01,005,0099,0,1397 ,9 ,1406 ,2143 ,0,3,1,3,0,1,0,76.14,65.61 ,33.33
03,004,01,005,0100,0,2106 ,24 ,2130 ,3513 ,0,3,1,3,0,1,0,76.14,60.63 ,33.33
03,004,01,005,0101,0,1315 ,14 ,1329 ,2187 ,0,3,1,3,0,1,0,76.14,60.77 ,33.33
03,004,01,005,0102,0,899 ,12 ,911 ,1787 ,0,3,1,3,0,1,0,76.14,50.98 ,33.33
03,004,01,005,0103,0,1543 ,20 ,1563 ,2582 ,0,3,1,3,0,1,0,76.14,60.53 ,33.33
03,004,01,005,0104,0,648 ,7 ,655 ,1017 ,0,3,1,3,0,1,0,76.14,64.41 ,33.33
03,004,01,005,0105,0,1377 ,12 ,1389 ,2346 ,0,3,1,3,0,1,0,76.14,59.21 ,33.33
03,004,01,005,0106,0,1304 ,12 ,1316 ,2171 ,0,3,1,3,0,1,0,76.14,60.62 ,33.33
03,004,01,005,0107,0,758 ,12 ,770 ,1342 ,0,3,1,3,0,1,0,76.14,57.38 ,33.33
03,004,01,005,0108,0,2079 ,37 ,2116 ,3743 ,0,3,1,3,0,1,0,76.14,56.53 ,33.33
03,004,01,005,0109,0,1853 ,24 ,1877 ,3441 ,0,3,1,3,0,1,0,76.14,54.55 ,33.33
03,004,01,005,0110,0,1412 ,18 ,1430 ,2466 ,0,3,1,3,0,1,0,76.14,57.99 ,33.33
03,004,01,005,0111,0,1456 ,30 ,1486 ,2639 ,0,3,1,3,0,1,0,76.14,56.31 ,33.33
03,004,01,006,0112,0,611 ,6 ,617 ,885 ,0,3,1,3,0,1,0,76.14,69.72 ,33.33
03,004,01,006,0113,0,1034 ,16 ,1050 ,1687 ,0,3,1,3,0,1,0,76.14,62.24 ,33.33
03,004,01,006,0114,0,884 ,6 ,890 ,1375 ,0,3,1,3,0,1,0,76.14,64.73 ,33.33
03,004,01,006,0115,0,1303 ,14 ,1317 ,2259 ,0,3,1,3,0,1,0,76.14,58.30 ,33.33
03,004,01,006,0116,0,487 ,7 ,494 ,786 ,0,3,1,3,0,1,0,76.14,62.85 ,33.33
03,004,01,006,0117,0,1279 ,22 ,1301 ,2066 ,0,3,1,3,0,1,0,76.14,62.97 ,33.33
03,004,01,006,0118,0,819 ,12 ,831 ,1370 ,0,3,1,3,0,1,0,76.14,60.66 ,33.33
03,004,01,006,0119,0,1393 ,15 ,1408 ,2381 ,0,3,1,3,0,1,0,76.14,59.13 ,33.33
03,004,01,006,0120,0,3247 ,24 ,3271 ,5860 ,0,3,1,3,0,1,0,76.14,55.82 ,33.33
03,004,01,006,0121,0,800 ,9 ,809 ,1492 ,0,3,1,3,0,1,0,76.14,54.22 ,33.33
03,004,01,006,0122,0,612 ,9 ,621 ,972 ,0,3,1,3,0,1,0,76.14,63.89 ,33.33
03,004,01,006,0123,0,4097 ,31 ,4128 ,7324 ,0,3,1,3,0,1,0,76.14,56.36 ,33.33
03,004,01,006,0124,0,2503 ,22 ,2525 ,4632 ,0,3,1,3,0,1,0,76.14,54.51 ,33.33
03,004,01,007,0125,0,279 ,3 ,282 ,429 ,0,3,1,3,0,1,0,76.14,65.73 ,33.33
03,004,01,007,0126,0,323 ,4 ,327 ,486 ,0,3,1,3,0,1,0,76.14,67.28 ,33.33
03,004,01,007,0127,0,548 ,7 ,555 ,858 ,0,3,1,3,0,1,0,76.14,64.69 ,33.33
03,004,01,007,0128,0,249 ,1 ,250 ,390 ,0,3,1,3,0,1,0,76.14,64.10 ,33.33
03,004,01,007,0129,0,1458 ,17 ,1475 ,2329 ,0,3,1,3,0,1,0,76.14,63.33 ,33.33
03,004,01,007,0130,0,929 ,9 ,938 ,1428 ,0,3,1,3,0,1,0,76.14,65.69 ,33.33
03,004,01,007,0131,0,357 ,0 ,357 ,535 ,0,3,1,3,0,1,0,76.14,66.73 ,33.33
03,004,01,007,0132,0,380 ,4 ,384 ,647 ,0,3,1,3,0,1,0,76.14,59.35 ,33.33
03,004,01,007,0133,0,1308 ,16 ,1324 ,2121 ,0,3,1,3,0,1,0,76.14,62.42 ,33.33
03,004,01,007,0134,0,938 ,12 ,950 ,1468 ,0,3,1,3,0,1,0,76.14,64.71 ,33.33
03,004,01,007,0135,0,1783 ,21 ,1804 ,3066 ,0,3,1,3,0,1,0,76.14,58.84 ,33.33
03,004,01,007,0136,0,696 ,9 ,705 ,1066 ,0,3,1,3,0,1,0,76.14,66.14 ,33.33
03,004,01,008,0137,0,1957 ,14 ,1971 ,3211 ,0,3,1,3,0,1,0,76.14,61.38 ,33.33
03,004,01,008,0138,0,560 ,4 ,564 ,843 ,0,3,1,3,0,1,0,76.14,66.90 ,33.33
03,004,01,008,0139,0,108 ,2 ,110 ,157 ,0,3,1,3,0,1,0,76.14,70.06 ,33.33
03,004,01,008,0140,0,110 ,1 ,111 ,165 ,0,3,1,3,0,1,0,76.14,67.27 ,33.33
03,004,01,008,0141,0,217 ,3 ,220 ,333 ,0,3,1,3,0,1,0,76.14,66.07 ,33.33
03,004,01,008,0142,0,639 ,11 ,650 ,1048 ,0,3,1,3,0,1,0,76.14,62.02 ,33.33
03,004,01,008,0143,0,552 ,7 ,559 ,846 ,0,3,1,3,0,1,0,76.14,66.08 ,33.33
03,004,01,008,0144,0,301 ,6 ,307 ,467 ,0,3,1,3,0,1,0,76.14,65.74 ,33.33
03,004,01,008,0145,0,736 ,6 ,742 ,1077 ,0,3,1,3,0,1,0,76.14,68.90 ,33.33
03,004,01,008,0146,0,1013 ,7 ,1020 ,1532 ,0,3,1,3,0,1,0,76.14,66.58 ,33.33
03,004,01,008,0147,0,877 ,12 ,889 ,1338 ,0,3,1,3,0,1,0,76.14,66.44 ,33.33
03,004,01,009,0148,0,734 ,8 ,742 ,1143 ,0,3,1,3,0,1,0,76.14,64.92 ,33.33
03,004,01,009,0149,0,799 ,16 ,815 ,1249 ,0,3,1,3,0,1,0,76.14,65.25 ,33.33
03,004,01,009,0150,0,313 ,3 ,316 ,508 ,0,3,1,3,0,1,0,76.14,62.20 ,33.33
03,004,01,009,0151,0,1490 ,23 ,1513 ,2360 ,0,3,1,3,0,1,0,76.14,64.11 ,33.33
03,004,01,009,0152,0,452 ,2 ,454 ,780 ,0,3,1,3,0,1,0,76.14,58.21 ,33.33
03,004,01,009,0153,0,250 ,2 ,252 ,387 ,0,3,1,3,0,1,0,76.14,65.12 ,33.33
03,004,01,009,0154,0,453 ,6 ,459 ,664 ,0,3,1,3,0,1,0,76.14,69.13 ,33.33
03,004,01,009,0155,0,205 ,4 ,209 ,362 ,0,3,1,3,0,1,0,76.14,57.73 ,33.33
03,004,01,009,0156,0,187 ,3 ,190 ,301 ,0,3,1,3,0,1,0,76.14,63.12 ,33.33
03,004,01,010,0157,0,2021 ,16 ,2037 ,3703 ,0,3,1,3,0,1,0,76.14,55.01 ,33.33
03,004,01,010,0158,0,597 ,4 ,601 ,1013 ,0,3,1,3,0,1,0,76.14,59.33 ,33.33
03,004,01,010,0159,0,504 ,4 ,508 ,756 ,0,3,1,3,0,1,0,76.14,67.20 ,33.33
03,004,01,010,0160,0,696 ,4 ,700 ,1069 ,0,3,1,3,0,1,0,76.14,65.48 ,33.33
03,004,01,010,0161,0,425 ,6 ,431 ,638 ,0,3,1,3,0,1,0,76.14,67.55 ,33.33
03,004,01,010,0162,0,499 ,7 ,506 ,707 ,0,3,1,3,0,1,0,76.14,71.57 ,33.33
03,004,01,010,0163,0,415 ,6 ,421 ,632 ,0,3,1,3,0,1,0,76.14,66.61 ,33.33
03,004,01,010,0164,0,361 ,1 ,362 ,557 ,0,3,1,3,0,1,0,76.14,64.99 ,33.33
03,004,01,010,0165,0,268 ,2 ,270 ,448 ,0,3,1,3,0,1,0,76.14,60.27 ,33.33
03,004,01,011,0166,0,606 ,9 ,615 ,865 ,0,3,1,3,0,1,0,76.14,71.10 ,33.33
03,004,01,011,0167,0,494 ,1 ,495 ,708 ,0,3,1,3,0,1,0,76.14,69.92 ,33.33
03,004,01,011,0168,0,437 ,3 ,440 ,615 ,0,3,1,3,0,1,0,76.14,71.54 ,33.33
03,004,01,011,0169,0,430 ,6 ,436 ,609 ,0,3,1,3,0,1,0,76.14,71.59 ,33.33
03,004,01,011,0170,0,765 ,10 ,775 ,1209 ,0,3,1,3,0,1,0,76.14,64.10 ,33.33
03,004,01,011,0171,0,579 ,16 ,595 ,900 ,0,3,1,3,0,1,0,76.14,66.11 ,33.33
03,004,01,012,0172,0,244 ,9 ,253 ,445 ,0,3,1,3,0,1,0,76.14,56.85 ,33.33
03,004,01,012,0173,0,67 ,0 ,67 ,122 ,0,3,1,3,0,1,0,76.14,54.92 ,33.33
03,004,01,012,0174,0,76 ,1 ,77 ,165 ,0,3,1,3,0,1,0,76.14,46.67 ,33.33
03,004,01,012,0175,0,62 ,0 ,62 ,128 ,0,3,1,3,0,1,0,76.14,48.44 ,33.33
03,004,01,012,0176,0,27 ,0 ,27 ,40 ,0,3,1,3,0,1,0,76.14,67.50 ,33.33
03,004,01,012,0177,0,8 ,0 ,8 ,25 ,0,3,1,3,0,1,0,76.14,32.00 ,33.33
03,004,01,012,0178,0,24 ,0 ,24 ,55 ,0,3,1,3,0,1,0,76.14,43.64 ,33.33
03,004,01,012,0179,0,2 ,0 ,2 ,2 ,0,3,1,3,0,1,0,76.14,100.00 ,33.33
03,004,01,013,0180,0,80 ,1 ,81 ,143 ,0,3,1,3,0,1,0,76.14,56.64 ,33.33
03,004,01,013,0181,0,31 ,0 ,31 ,59 ,0,3,1,3,0,1,0,76.14,52.54 ,33.33
03,004,01,013,0182,0,10 ,0 ,10 ,21 ,0,3,1,3,0,1,0,76.14,47.62 ,33.33
03,004,01,013,0183,0,62 ,0 ,62 ,165 ,0,3,1,3,0,1,0,76.14,37.58 ,33.33
03,005,01,001,0001,0,596 ,4 ,600 ,1015 ,0,3,1,3,0,1,0,76.14,59.11 ,33.33
03,005,01,001,0002,0,602 ,5 ,607 ,1051 ,0,3,1,3,0,1,0,76.14,57.75 ,33.33
03,005,01,001,0003,0,1830 ,18 ,1848 ,3101 ,0,3,1,3,0,1,0,76.14,59.59 ,33.33
03,005,01,001,0004,0,2223 ,22 ,2245 ,3790 ,0,3,1,3,0,1,0,76.14,59.23 ,33.33
03,005,01,001,0005,0,1345 ,12 ,1357 ,2303 ,0,3,1,3,0,1,0,76.14,58.92 ,33.33
03,005,01,001,0006,0,1973 ,17 ,1990 ,3339 ,0,3,1,3,0,1,0,76.14,59.60 ,33.33
03,005,01,001,0007,0,524 ,6 ,530 ,894 ,0,3,1,3,0,1,0,76.14,59.28 ,33.33
03,005,01,001,0008,0,1459 ,13 ,1472 ,2727 ,0,3,1,3,0,1,0,76.14,53.98 ,33.33
03,005,01,001,0009,0,594 ,10 ,604 ,960 ,0,3,1,3,0,1,0,76.14,62.92 ,33.33
03,005,01,001,0010,0,599 ,4 ,603 ,983 ,0,3,1,3,0,1,0,76.14,61.34 ,33.33
03,005,01,001,0011,0,383 ,7 ,390 ,647 ,0,3,1,3,0,1,0,76.14,60.28 ,33.33
03,005,01,001,0012,0,874 ,11 ,885 ,1475 ,0,3,1,3,0,1,0,76.14,60,33.33
03,005,01,001,0013,0,1370 ,15 ,1385 ,2322 ,0,3,1,3,0,1,0,76.14,59.65 ,33.33
03,005,01,001,0014,0,2086 ,9 ,2095 ,3566 ,0,3,1,3,0,1,0,76.14,58.75 ,33.33
03,005,01,001,0015,0,1813 ,15 ,1828 ,3010 ,0,3,1,3,0,1,0,76.14,60.73 ,33.33
03,005,01,001,0016,0,1086 ,5 ,1091 ,1764 ,0,3,1,3,0,1,0,76.14,61.85 ,33.33
03,005,01,001,0017,0,2587 ,21 ,2608 ,4356 ,0,3,1,3,0,1,0,76.14,59.8714416896,33.33
03,005,01,001,0018,0,1810 ,18 ,1828 ,3131 ,0,3,1,3,0,1,0,76.14,58.38 ,33.33
03,005,01,001,0019,0,1630 ,13 ,1643 ,2568 ,0,3,1,3,0,1,0,76.14,63.98 ,33.33
03,005,01,001,0020,0,1850 ,12 ,1862 ,3310 ,0,3,1,3,0,1,0,76.14,56.253776435,33.33
03,005,01,001,0021,0,1501 ,17 ,1518 ,2641 ,0,3,1,3,0,1,0,76.14,57.478227944,33.33
03,005,01,001,0022,0,2072 ,16 ,2088 ,3543 ,0,3,1,3,0,1,0,76.14,58.93 ,33.33
03,005,01,001,0023,0,2379 ,19 ,2398 ,4272 ,0,3,1,3,0,1,0,76.14,56.13 ,33.33
03,005,01,001,0024,0,2768 ,28 ,2796 ,4969 ,0,3,1,3,0,1,0,76.14,56.2688669752,33.33
03,005,01,001,0025,0,615 ,6 ,621 ,1087 ,0,3,1,3,0,1,0,76.14,57.1297148114,33.33
03,005,01,001,0026,0,825 ,4 ,829 ,1504 ,0,3,1,3,0,1,0,76.14,55.12 ,33.33
03,005,01,001,0027,0,1053 ,13 ,1066 ,1791 ,0,3,1,3,0,1,0,76.14,59.52 ,33.33
03,005,01,002,0028,0,1056 ,8 ,1064 ,1767 ,0,3,1,3,0,1,0,76.14,60.22 ,33.33
03,005,01,002,0029,0,996 ,2 ,998 ,1663 ,0,3,1,3,0,1,0,76.14,60.01 ,33.33
03,005,01,002,0030,0,512 ,7 ,519 ,896 ,0,3,1,3,0,1,0,76.14,57.92 ,33.33
03,005,01,002,0031,0,833 ,9 ,842 ,1328 ,0,3,1,3,0,1,0,76.14,63.40 ,33.33
03,005,01,002,0032,0,709 ,9 ,718 ,1124 ,0,3,1,3,0,1,0,76.14,63.88 ,33.33
03,005,01,002,0033,0,994 ,9 ,1003 ,1690 ,0,3,1,3,0,1,0,76.14,59.35 ,33.33
03,005,01,002,0034,0,587 ,4 ,591 ,1029 ,0,3,1,3,0,1,0,76.14,57.43 ,33.33
03,005,01,002,0035,0,1268 ,7 ,1275 ,2164 ,0,3,1,3,0,1,0,76.14,58.92 ,33.33
03,005,01,002,0036,0,2039 ,20 ,2059 ,3380 ,0,3,1,3,0,1,0,76.14,60.92 ,33.33
03,005,01,002,0037,0,1152 ,9 ,1161 ,1808 ,0,3,1,3,0,1,0,76.14,64.2146017699,33.33
03,005,01,002,0038,0,602 ,7 ,609 ,1002 ,0,3,1,3,0,1,0,76.14,60.7784431138,33.33
03,005,01,002,0039,0,390 ,2 ,392 ,602 ,0,3,1,3,0,1,0,76.14,65.12 ,33.33
03,005,01,002,0040,0,683 ,3 ,686 ,1117 ,0,3,1,3,0,1,0,76.14,61.41 ,33.33
03,005,01,002,0041,0,921 ,5 ,926 ,1485 ,0,3,1,3,0,1,0,76.14,62.36 ,33.33
03,005,01,002,0042,0,1025 ,9 ,1034 ,1712 ,0,3,1,3,0,1,0,76.14,60.40 ,33.33
03,005,01,002,0043,0,731 ,7 ,738 ,1236 ,0,3,1,3,0,1,0,76.14,59.71 ,33.33
03,005,01,002,0044,0,430 ,4 ,434 ,607 ,0,3,1,3,0,1,0,76.14,71.50 ,33.33
03,005,01,002,0045,0,575 ,3 ,578 ,882 ,0,3,1,3,0,1,0,76.14,65.53 ,33.33
03,005,01,002,0046,0,428 ,9 ,437 ,713 ,0,3,1,3,0,1,0,76.14,61.29 ,33.33
03,005,01,002,0047,0,861 ,7 ,868 ,1469 ,0,3,1,3,0,1,0,76.14,59.09 ,33.33
03,005,01,002,0048,0,902 ,20 ,922 ,1542 ,0,3,1,3,0,1,0,76.14,59.79 ,33.33
03,005,01,002,0049,0,912 ,13 ,925 ,1633 ,0,3,1,3,0,1,0,76.14,56.64 ,33.33
03,005,01,002,0050,0,1216 ,14 ,1230 ,2033 ,0,3,1,3,0,1,0,76.14,60.50 ,33.33
03,005,01,002,0051,0,772 ,4 ,776 ,1216 ,0,3,1,3,0,1,0,76.14,63.82 ,33.33
03,005,01,002,0052,0,804 ,6 ,810 ,1372 ,0,3,1,3,0,1,0,76.14,59.04 ,33.33
03,005,01,003,0053,0,768 ,2 ,770 ,1251 ,0,3,1,3,0,1,0,76.14,61.55 ,33.33
03,005,01,003,0054,0,1365 ,18 ,1383 ,2137 ,0,3,1,3,0,1,0,76.14,64.7168928404,33.33
03,005,01,003,0055,0,2228 ,11 ,2239 ,3786 ,0,3,1,3,0,1,0,76.14,59.14 ,33.33
03,005,01,003,0056,0,521 ,1 ,522 ,752 ,0,3,1,3,0,1,0,76.14,69.41 ,33.33
03,005,01,003,0057,0,933 ,6 ,939 ,1505 ,0,3,1,3,0,1,0,76.14,62.39 ,33.33
03,005,01,003,0058,0,1479 ,20 ,1499 ,2573 ,0,3,1,3,0,1,0,76.14,58.26 ,33.33
03,005,01,003,0059,0,1124 ,6 ,1130 ,1765 ,0,3,1,3,0,1,0,76.14,64.0226628895,33.33
03,005,01,003,0060,0,353 ,1 ,354 ,535 ,0,3,1,3,0,1,0,76.14,66.1682242991,33.33
03,005,01,003,0061,0,624 ,5 ,629 ,943 ,0,3,1,3,0,1,0,76.14,66.70 ,33.33
03,005,01,003,0062,0,297 ,2 ,299 ,468 ,0,3,1,3,0,1,0,76.14,63.89 ,33.33
03,005,01,003,0063,0,515 ,7 ,522 ,789 ,0,3,1,3,0,1,0,76.14,66.16 ,33.33
03,005,01,003,0064,0,419 ,3 ,422 ,689 ,0,3,1,3,0,1,0,76.14,61.25 ,33.33
03,005,01,003,0065,0,625 ,2 ,627 ,988 ,0,3,1,3,0,1,0,76.14,63.46 ,33.33
03,005,01,003,0066,0,535 ,5 ,540 ,825 ,0,3,1,3,0,1,0,76.14,65.45 ,33.33
03,005,01,003,0067,0,411 ,3 ,414 ,643 ,0,3,1,3,0,1,0,76.14,64.3856920684,33.33
03,005,01,003,0068,0,766 ,9 ,775 ,1170 ,0,3,1,3,0,1,0,76.14,66.2393162393,33.33
03,005,01,003,0069,0,797 ,7 ,804 ,1330 ,0,3,1,3,0,1,0,76.14,60.4511278195,33.33
03,005,01,003,0070,0,943 ,7 ,950 ,1470 ,0,3,1,3,0,1,0,76.14,64.63 ,33.33
03,005,01,003,0071,0,1371 ,15 ,1386 ,2213 ,0,3,1,3,0,1,0,76.14,62.63 ,33.33
03,005,01,003,0072,0,747 ,8 ,755 ,1249 ,0,3,1,3,0,1,0,76.14,60.45 ,33.33
03,005,01,003,0073,0,439 ,7 ,446 ,747 ,0,3,1,3,0,1,0,76.14,59.71 ,33.33
03,005,01,003,0074,0,795 ,8 ,803 ,1378 ,0,3,1,3,0,1,0,76.14,58.27 ,33.33
03,005,01,003,0075,0,456 ,5 ,461 ,796 ,0,3,1,3,0,1,0,76.14,57.91 ,33.33
03,005,01,004,0076,0,1176 ,6 ,1182 ,1909 ,0,3,1,3,0,1,0,76.14,61.92 ,33.33
03,005,01,004,0077,0,1478 ,12 ,1490 ,2383 ,0,3,1,3,0,1,0,76.14,62.53 ,33.33
03,005,01,004,0078,0,1365 ,12 ,1377 ,2313 ,0,3,1,3,0,1,0,76.14,59.53307393,33.33
03,005,01,004,0079,0,1689 ,7 ,1696 ,2869 ,0,3,1,3,0,1,0,76.14,59.11 ,33.33
03,005,01,004,0080,0,1882 ,22 ,1904 ,3140 ,0,3,1,3,0,1,0,76.14,60.64 ,33.33
03,005,01,004,0081,0,1575 ,19 ,1594 ,2711 ,0,3,1,3,0,1,0,76.14,58.80 ,33.33
03,005,01,004,0082,0,1308 ,10 ,1318 ,2299 ,0,3,1,3,0,1,0,76.14,57.33 ,33.33
03,005,01,004,0083,0,1583 ,16 ,1599 ,2838 ,0,3,1,3,0,1,0,76.14,56.3424947146,33.33
03,005,01,004,0084,0,2799 ,15 ,2814 ,4518 ,0,3,1,3,0,1,0,76.14,62.28 ,33.33
03,005,01,004,0085,0,1569 ,14 ,1583 ,3043 ,0,3,1,3,0,1,0,76.14,52.02 ,33.33
03,005,01,004,0086,0,1254 ,11 ,1265 ,2150 ,0,3,1,3,0,1,0,76.14,58.84 ,33.33
03,005,01,004,0087,0,565 ,7 ,572 ,968 ,0,3,1,3,0,1,0,76.14,59.09 ,33.33
03,005,01,004,0088,0,1340 ,12 ,1352 ,2298 ,0,3,1,3,0,1,0,76.14,58.83 ,33.33
03,005,01,004,0089,0,688 ,7 ,695 ,1257 ,0,3,1,3,0,1,0,76.14,55.29 ,33.33
03,005,01,004,0090,0,956 ,9 ,965 ,1673 ,0,3,1,3,0,1,0,76.14,57.68 ,33.33
03,005,01,004,0091,0,331 ,3 ,334 ,544 ,0,3,1,3,0,1,0,76.14,61.40 ,33.33
03,005,01,004,0092,0,1318 ,8 ,1326 ,2329 ,0,3,1,3,0,1,0,76.14,56.93 ,33.33
03,005,01,004,0093,0,953 ,17 ,970 ,1472 ,0,3,1,3,0,1,0,76.14,65.90 ,33.33
03,005,01,004,0094,0,622 ,8 ,630 ,1125 ,0,3,1,3,0,1,0,76.14,56.00 ,33.33
03,005,01,004,0095,0,1744 ,19 ,1763 ,3142 ,0,3,1,3,0,1,0,76.14,56.11 ,33.33
03,005,01,004,0096,0,1165 ,6 ,1171 ,2140 ,0,3,1,3,0,1,0,76.14,54.72 ,33.33
03,005,01,004,0097,0,1481 ,14 ,1495 ,2693 ,0,3,1,3,0,1,0,76.14,55.51 ,33.33
03,005,01,004,0098,0,529 ,2 ,531 ,933 ,0,3,1,3,0,1,0,76.14,56.9131832797,33.33
03,005,01,005,0099,0,1259 ,8 ,1267 ,2073 ,0,3,1,3,0,1,0,76.14,61.12 ,33.33
03,005,01,005,0100,0,1146 ,8 ,1154 ,1776 ,0,3,1,3,0,1,0,76.14,64.98 ,33.33
03,005,01,005,0101,0,1662 ,13 ,1675 ,2805 ,0,3,1,3,0,1,0,76.14,59.7147950089,33.33
03,005,01,005,0102,0,2067 ,14 ,2081 ,3475 ,0,3,1,3,0,1,0,76.14,59.88 ,33.33
03,005,01,005,0103,0,1720 ,13 ,1733 ,2912 ,0,3,1,3,0,1,0,76.14,59.51 ,33.33
03,005,01,005,0104,0,1404 ,10 ,1414 ,2393 ,0,3,1,3,0,1,0,76.14,59.0890096114,33.33
03,005,01,005,0105,0,486 ,5 ,491 ,788 ,0,3,1,3,0,1,0,76.14,62.31 ,33.33
03,005,01,005,0106,0,1546 ,15 ,1561 ,2774 ,0,3,1,3,0,1,0,76.14,56.27 ,33.33
03,005,01,005,0107,0,2532 ,16 ,2548 ,4353 ,0,3,1,3,0,1,0,76.14,58.53 ,33.33
03,005,01,005,0108,0,934 ,5 ,939 ,1528 ,0,3,1,3,0,1,0,76.14,61.4528795812,33.33
03,005,01,005,0109,0,506 ,3 ,509 ,798 ,0,3,1,3,0,1,0,76.14,63.78 ,33.33
03,005,01,005,0110,0,614 ,6 ,620 ,976 ,0,3,1,3,0,1,0,76.14,63.52 ,33.33
03,005,01,005,0111,0,722 ,9 ,731 ,1237 ,0,3,1,3,0,1,0,76.14,59.09 ,33.33
03,005,01,005,0112,0,1185 ,8 ,1193 ,2105 ,0,3,1,3,0,1,0,76.14,56.67 ,33.33
03,005,01,005,0113,0,1428 ,12 ,1440 ,2539 ,0,3,1,3,0,1,0,76.14,56.72 ,33.33
03,005,01,005,0114,0,3079 ,25 ,3104 ,5501 ,0,3,1,3,0,1,0,76.14,56.43 ,33.33
03,005,01,005,0115,0,1487 ,14 ,1501 ,2755 ,0,3,1,3,0,1,0,76.14,54.48 ,33.33
03,005,01,005,0116,0,1556 ,18 ,1574 ,2836 ,0,3,1,3,0,1,0,76.14,55.50 ,33.33
03,005,01,005,0117,0,1395 ,13 ,1408 ,2609 ,0,3,1,3,0,1,0,76.14,53.97 ,33.33
03,005,01,005,0118,0,1297 ,11 ,1308 ,2385 ,0,3,1,3,0,1,0,76.14,54.8427672956,33.33
03,005,01,005,0119,0,924 ,10 ,934 ,1631 ,0,3,1,3,0,1,0,76.14,57.27 ,33.33
03,005,01,005,0120,0,950 ,10 ,960 ,1646 ,0,3,1,3,0,1,0,76.14,58.3232077764,33.33
03,005,01,005,0121,0,1000 ,11 ,1011 ,1924 ,0,3,1,3,0,1,0,76.14,52.55 ,33.33
03,005,01,005,0122,0,1582 ,17 ,1599 ,2754 ,0,3,1,3,0,1,0,76.14,58.06 ,33.33
03,005,01,005,0123,0,857 ,7 ,864 ,1319 ,0,3,1,3,0,1,0,76.14,65.50 ,33.33
03,005,01,005,0124,0,827 ,11 ,838 ,1316 ,0,3,1,3,0,1,0,76.14,63.68 ,33.33
03,005,01,005,0125,0,586 ,5 ,591 ,867 ,0,3,1,3,0,1,0,76.14,68.17 ,33.33
03,005,01,005,0126,0,1459 ,16 ,1475 ,2460 ,0,3,1,3,0,1,0,76.14,59.96 ,33.33
03,005,01,005,0127,0,1154 ,8 ,1162 ,1961 ,0,3,1,3,0,1,0,76.14,59.255481897,33.33
03,005,01,006,0128,0,894 ,4 ,898 ,1377 ,0,3,1,3,0,1,0,76.14,65.21 ,33.33
03,005,01,006,0129,0,660 ,4 ,664 ,956 ,0,3,1,3,0,1,0,76.14,69.46 ,33.33
03,005,01,006,0130,0,881 ,5 ,886 ,1422 ,0,3,1,3,0,1,0,76.14,62.31 ,33.33
03,005,01,006,0131,0,2120 ,16 ,2136 ,3462 ,0,3,1,3,0,1,0,76.14,61.70 ,33.33
03,005,01,006,0132,0,1349 ,8 ,1357 ,2222 ,0,3,1,3,0,1,0,76.14,61.07 ,33.33
03,005,01,006,0133,0,832 ,1 ,833 ,1272 ,0,3,1,3,0,1,0,76.14,65.49 ,33.33
03,005,01,006,0134,0,796 ,5 ,801 ,1220 ,0,3,1,3,0,1,0,76.14,65.66 ,33.33
03,005,01,006,0135,0,1471 ,12 ,1483 ,2414 ,0,3,1,3,0,1,0,76.14,61.43 ,33.33
03,005,01,006,0136,0,921 ,9 ,930 ,1321 ,0,3,1,3,0,1,0,76.14,70.40 ,33.33
03,005,01,006,0137,0,420 ,4 ,424 ,641 ,0,3,1,3,0,1,0,76.14,66.15 ,33.33
03,005,01,006,0138,0,829 ,4 ,833 ,1381 ,0,3,1,3,0,1,0,76.14,60.32 ,33.33
03,005,01,006,0139,0,912 ,5 ,917 ,1563 ,0,3,1,3,0,1,0,76.14,58.67 ,33.33
03,005,01,006,0140,0,750 ,5 ,755 ,1302 ,0,3,1,3,0,1,0,76.14,57.99 ,33.33
03,005,01,006,0141,0,557 ,6 ,563 ,1010 ,0,3,1,3,0,1,0,76.14,55.74 ,33.33
03,005,01,006,0142,0,619 ,10 ,629 ,1134 ,0,3,1,3,0,1,0,76.14,55.47 ,33.33
03,005,01,006,0143,0,544 ,5 ,549 ,993 ,0,3,1,3,0,1,0,76.14,55.29 ,33.33
03,005,01,006,0144,0,470 ,2 ,472 ,721 ,0,3,1,3,0,1,0,76.14,65.46 ,33.33
03,005,01,006,0145,0,653 ,5 ,658 ,1097 ,0,3,1,3,0,1,0,76.14,59.98 ,33.33
03,005,01,006,0146,0,409 ,4 ,413 ,644 ,0,3,1,3,0,1,0,76.14,64.13 ,33.33
03,005,01,006,0147,0,797 ,11 ,808 ,1311 ,0,3,1,3,0,1,0,76.14,61.63 ,33.33
03,005,01,006,0148,0,488 ,4 ,492 ,813 ,0,3,1,3,0,1,0,76.14,60.52 ,33.33
03,005,01,006,0149,0,651 ,5 ,656 ,1221 ,0,3,1,3,0,1,0,76.14,53.7264537265,33.33
03,005,01,006,0150,0,744 ,5 ,749 ,1285 ,0,3,1,3,0,1,0,76.14,58.2879377432,33.33
03,005,01,007,0151,0,1424 ,15 ,1439 ,2160 ,0,3,1,3,0,1,0,76.14,66.62 ,33.33
03,005,01,007,0152,0,776 ,3 ,779 ,1168 ,0,3,1,3,0,1,0,76.14,66.70 ,33.33
03,005,01,007,0153,0,544 ,2 ,546 ,814 ,0,3,1,3,0,1,0,76.14,67.08 ,33.33
03,005,01,007,0154,0,983 ,5 ,988 ,1604 ,0,3,1,3,0,1,0,76.14,61.5960099751,33.33
03,005,01,007,0155,0,656 ,11 ,667 ,1033 ,0,3,1,3,0,1,0,76.14,64.5692158761,33.33
03,005,01,007,0156,0,351 ,7 ,358 ,555 ,0,3,1,3,0,1,0,76.14,64.50 ,33.33
03,005,01,007,0157,0,471 ,17 ,488 ,756 ,0,3,1,3,0,1,0,76.14,64.55 ,33.33
03,005,01,007,0158,0,1225 ,10 ,1235 ,2073 ,0,3,1,3,0,1,0,76.14,59.58 ,33.33
03,005,01,007,0159,0,1296 ,16 ,1312 ,2142 ,0,3,1,3,0,1,0,76.14,61.2511671335,33.33
03,005,01,007,0160,0,922 ,9 ,931 ,1423 ,0,3,1,3,0,1,0,76.14,65.4251581167,33.33
03,005,01,007,0161,0,424 ,4 ,428 ,701 ,0,3,1,3,0,1,0,76.14,61.0556348074,33.33
03,005,01,008,0162,0,1054 ,5 ,1059 ,1693 ,0,3,1,3,0,1,0,76.14,62.5516834022,33.33
03,005,01,008,0163,0,484 ,5 ,489 ,666 ,0,3,1,3,0,1,0,76.14,73.4234234234,33.33
03,005,01,008,0164,0,728 ,5 ,733 ,1255 ,0,3,1,3,0,1,0,76.14,58.406374502,33.33
03,005,01,008,0165,0,1005 ,5 ,1010 ,1684 ,0,3,1,3,0,1,0,76.14,59.9762470309,33.33
03,005,01,008,0166,0,761 ,7 ,768 ,1365 ,0,3,1,3,0,1,0,76.14,56.2637362637,33.33
03,005,01,008,0167,0,351 ,7 ,358 ,623 ,0,3,1,3,0,1,0,76.14,57.4638844302,33.33
03,005,01,008,0168,0,453 ,8 ,461 ,733 ,0,3,1,3,0,1,0,76.14,62.8922237381,33.33
03,005,01,008,0169,0,458 ,1 ,459 ,720 ,0,3,1,3,0,1,0,76.14,63.75,33.33
03,005,01,008,0170,0,330 ,4 ,334 ,512 ,0,3,1,3,0,1,0,76.14,65.234375,33.33
03,005,01,008,0171,0,892 ,6 ,898 ,1588 ,0,3,1,3,0,1,0,76.14,56.5491183879,33.33
03,005,01,008,0172,0,555 ,9 ,564 ,920 ,0,3,1,3,0,1,0,76.14,61.3043478261,33.33
03,005,01,008,0173,0,520 ,6 ,526 ,844 ,0,3,1,3,0,1,0,76.14,62.3222748815,33.33
03,005,01,009,0174,0,983 ,12 ,995 ,1577 ,0,3,1,3,0,1,0,76.14,63.0944831959,33.33
03,005,01,009,0175,0,1292 ,11 ,1303 ,2168 ,0,3,1,3,0,1,0,76.14,60.1014760148,33.33
03,005,01,009,0176,0,1574 ,12 ,1586 ,2837 ,0,3,1,3,0,1,0,76.14,55.9041240747,33.33
03,005,01,009,0177,0,1133 ,8 ,1141 ,1985 ,0,3,1,3,0,1,0,76.14,57.4811083123,33.33
03,005,01,009,0178,0,976 ,10 ,986 ,1743 ,0,3,1,3,0,1,0,76.14,56.5691336776,33.33
03,005,01,009,0179,0,560 ,10 ,570 ,983 ,0,3,1,3,0,1,0,76.14,57.985757884,33.33
03,005,01,009,0180,0,664 ,6 ,670 ,1069 ,0,3,1,3,0,1,0,76.14,62.6753975678,33.33
03,005,01,009,0181,0,269 ,2 ,271 ,396 ,0,3,1,3,0,1,0,76.14,68.4343434343,33.33
03,005,01,009,0182,0,974 ,8 ,982 ,1690 ,0,3,1,3,0,1,0,76.14,58.1065088757,33.33
03,005,01,009,0183,0,807 ,13 ,820 ,1444 ,0,3,1,3,0,1,0,76.14,56.7867036011,33.33
03,005,01,009,0184,0,218 ,1 ,219 ,308 ,0,3,1,3,0,1,0,76.14,71.1038961039,33.33
03,005,01,009,0185,0,1072 ,9 ,1081 ,1810 ,0,3,1,3,0,1,0,76.14,59.7237569061,33.33
03,005,01,009,0186,0,671 ,12 ,683 ,1139 ,0,3,1,3,0,1,0,76.14,59.964881475,33.33
03,005,01,009,0187,0,816 ,7 ,823 ,1359 ,0,3,1,3,0,1,0,76.14,60.5592347314,33.33
03,005,01,009,0188,0,809 ,7 ,816 ,1375 ,0,3,1,3,0,1,0,76.14,59.3454545455,33.33
03,005,01,009,0189,0,781 ,8 ,789 ,1381 ,0,3,1,3,0,1,0,76.14,57.132512672,33.33
03,005,01,009,0190,0,699 ,4 ,703 ,1180 ,0,3,1,3,0,1,0,76.14,59.5762711864,33.33
03,005,01,009,0191,0,147 ,3 ,150 ,252 ,0,3,1,3,0,1,0,76.14,59.5238095238,33.33
03,005,01,009,0192,0,200 ,1 ,201 ,313 ,0,3,1,3,0,1,0,76.14,64.2172523962,33.33
03,005,01,010,0193,0,2565 ,20 ,2585 ,4187 ,0,3,1,3,0,1,0,76.14,61.7387150705,33.33
03,005,01,010,0194,0,769 ,8 ,777 ,1268 ,0,3,1,3,0,1,0,76.14,61.2776025237,33.33
03,005,01,010,0195,0,757 ,5 ,762 ,1241 ,0,3,1,3,0,1,0,76.14,61.4020950846,33.33
03,005,01,010,0196,0,1064 ,13 ,1077 ,1733 ,0,3,1,3,0,1,0,76.14,62.1465666474,33.33
03,005,01,010,0197,0,642 ,5 ,647 ,1099 ,0,3,1,3,0,1,0,76.14,58.8717015469,33.33
03,005,01,010,0198,0,658 ,4 ,662 ,1059 ,0,3,1,3,0,1,0,76.14,62.5118035883,33.33
03,005,01,010,0199,0,1604 ,9 ,1613 ,2824 ,0,3,1,3,0,1,0,76.14,57.1175637394,33.33
03,005,01,010,0200,0,416 ,3 ,419 ,628 ,0,3,1,3,0,1,0,76.14,66.7197452229,33.33
03,005,01,010,0201,0,275 ,5 ,280 ,494 ,0,3,1,3,0,1,0,76.14,56.6801619433,33.33
03,005,01,010,0202,0,327 ,2 ,329 ,539 ,0,3,1,3,0,1,0,76.14,61.038961039,33.33
03,005,01,011,0203,0,705 ,8 ,713 ,1196 ,0,3,1,3,0,1,0,76.14,59.6153846154,33.33
03,005,01,011,0204,0,399 ,9 ,408 ,651 ,0,3,1,3,0,1,0,76.14,62.6728110599,33.33
03,005,01,011,0205,0,600 ,3 ,603 ,1033 ,0,3,1,3,0,1,0,76.14,58.3736689255,33.33
03,005,01,011,0206,0,505 ,5 ,510 ,851 ,0,3,1,3,0,1,0,76.14,59.9294947121,33.33
03,005,01,011,0207,0,514 ,2 ,516 ,961 ,0,3,1,3,0,1,0,76.14,53.6940686785,33.33
03,005,01,011,0208,0,670 ,5 ,675 ,1054 ,0,3,1,3,0,1,0,76.14,64.0417457306,33.33
03,005,01,011,0209,0,612 ,9 ,621 ,1031 ,0,3,1,3,0,1,0,76.14,60.2327837051,33.33
03,005,01,011,0210,0,234 ,1 ,235 ,473 ,0,3,1,3,0,1,0,76.14,49.6828752643,33.33
03,005,01,011,0211,0,148 ,0 ,148 ,281 ,0,3,1,3,0,1,0,76.14,52.6690391459,33.33
03,005,01,012,0212,0,1562 ,10 ,1572 ,2419 ,0,3,1,3,0,1,0,76.14,64.9855312112,33.33
03,005,01,012,0213,0,1005 ,13 ,1018 ,1581 ,0,3,1,3,0,1,0,76.14,64.3896268185,33.33
03,005,01,012,0214,0,426 ,4 ,430 ,683 ,0,3,1,3,0,1,0,76.14,62.9575402635,33.33
03,005,01,012,0215,0,588 ,8 ,596 ,866 ,0,3,1,3,0,1,0,76.14,68.8221709007,33.33
03,005,01,012,0216,0,234 ,4 ,238 ,353 ,0,3,1,3,0,1,0,76.14,67.4220963173,33.33
03,005,01,012,0217,0,1088 ,14 ,1102 ,1868 ,0,3,1,3,0,1,0,76.14,58.9935760171,33.33
03,005,01,012,0218,0,719 ,4 ,723 ,1092 ,0,3,1,3,0,1,0,76.14,66.2087912088,33.33
03,005,01,012,0219,0,222 ,2 ,224 ,346 ,0,3,1,3,0,1,0,76.14,64.7398843931,33.33
03,005,01,013,0220,0,2503 ,17 ,2520 ,3968 ,0,3,1,3,0,1,0,76.14,63.5080645161,33.33
03,005,01,013,0221,0,1700 ,27 ,1727 ,3026 ,0,3,1,3,0,1,0,76.14,57.0720423001,33.33
03,005,01,013,0222,0,1044 ,13 ,1057 ,1650 ,0,3,1,3,0,1,0,76.14,64.0606060606,33.33
03,005,01,013,0223,0,904 ,8 ,912 ,1366 ,0,3,1,3,0,1,0,76.14,66.7642752562,33.33
03,005,01,013,0224,0,842 ,5 ,847 ,1339 ,0,3,1,3,0,1,0,76.14,63.2561613144,33.33
03,005,01,013,0225,0,274 ,5 ,279 ,399 ,0,3,1,3,0,1,0,76.14,69.9248120301,33.33
03,005,01,013,0226,0,786 ,10 ,796 ,1172 ,0,3,1,3,0,1,0,76.14,67.9180887372,33.33
03,005,01,014,0227,0,372 ,7 ,379 ,603 ,0,3,1,3,0,1,0,76.14,62.8524046434,33.33
03,005,01,014,0228,0,364 ,7 ,371 ,565 ,0,3,1,3,0,1,0,76.14,65.6637168142,33.33
03,005,01,014,0229,0,521 ,6 ,527 ,883 ,0,3,1,3,0,1,0,76.14,59.6828992072,33.33
03,005,01,014,0230,0,393 ,1 ,394 ,647 ,0,3,1,3,0,1,0,76.14,60.8964451314,33.33
03,005,01,014,0231,0,537 ,7 ,544 ,945 ,0,3,1,3,0,1,0,76.14,57.5661375661,33.33
03,005,01,014,0232,0,309 ,2 ,311 ,511 ,0,3,1,3,0,1,0,76.14,60.8610567515,33.33
03,005,01,014,0233,0,325 ,3 ,328 ,525 ,0,3,1,3,0,1,0,76.14,62.4761904762,33.33
03,005,01,014,0234,0,652 ,4 ,656 ,1127 ,0,3,1,3,0,1,0,76.14,58.2076308784,33.33
03,005,01,014,0235,0,426 ,5 ,431 ,686 ,0,3,1,3,0,1,0,76.14,62.8279883382,33.33
03,005,01,015,0236,0,1057 ,7 ,1064 ,1787 ,0,3,1,3,0,1,0,76.14,59.5411303861,33.33
03,005,01,015,0237,0,310 ,2 ,312 ,478 ,0,3,1,3,0,1,0,76.14,65.2719665272,33.33
03,005,01,015,0238,0,577 ,0 ,577 ,960 ,0,3,1,3,0,1,0,76.14,60.1041666667,33.33
03,005,01,015,0239,0,1888 ,16 ,1904 ,3106 ,0,3,1,3,0,1,0,76.14,61.3007083065,33.33
03,005,01,015,0240,0,338 ,4 ,342 ,539 ,0,3,1,3,0,1,0,76.14,63.4508348794,33.33
03,005,01,015,0241,0,298 ,1 ,299 ,496 ,0,3,1,3,0,1,0,76.14,60.2822580645,33.33
03,005,01,015,0242,0,804 ,13 ,817 ,1356 ,0,3,1,3,0,1,0,76.14,60.2507374631,33.33
03,005,01,015,0243,0,461 ,3 ,464 ,712 ,0,3,1,3,0,1,0,76.14,65.1685393258,33.33
03,005,01,015,0244,0,614 ,9 ,623 ,1003 ,0,3,1,3,0,1,0,76.14,62.1136590229,33.33
03,005,01,016,0245,0,1382 ,13 ,1395 ,2127 ,0,3,1,3,0,1,0,76.14,65.5853314528,33.33
03,005,01,016,0246,0,365 ,5 ,370 ,580 ,0,3,1,3,0,1,0,76.14,63.7931034483,33.33
03,005,01,016,0247,0,510 ,8 ,518 ,849 ,0,3,1,3,0,1,0,76.14,61.0129564193,33.33
03,005,01,016,0248,0,148 ,2 ,150 ,230 ,0,3,1,3,0,1,0,76.14,65.2173913043,33.33
03,005,01,016,0249,0,320 ,6 ,326 ,519 ,0,3,1,3,0,1,0,76.14,62.8131021195,33.33
03,005,01,016,0250,0,380 ,6 ,386 ,604 ,0,3,1,3,0,1,0,76.14,63.9072847682,33.33
03,005,01,016,0251,0,278 ,2 ,280 ,462 ,0,3,1,3,0,1,0,76.14,60.6060606061,33.33
03,005,01,016,0252,0,226 ,5 ,231 ,366 ,0,3,1,3,0,1,0,76.14,63.1147540984,33.33
03,005,01,017,0253,0,448 ,5 ,453 ,755 ,0,3,1,3,0,1,0,76.14,60,33.33
03,005,01,017,0254,0,246 ,1 ,247 ,358 ,0,3,1,3,0,1,0,76.14,68.9944134078,33.33
03,005,01,017,0255,0,387 ,3 ,390 ,629 ,0,3,1,3,0,1,0,76.14,62.0031796502,33.33
03,005,01,017,0256,0,357 ,6 ,363 ,592 ,0,3,1,3,0,1,0,76.14,61.3175675676,33.33
03,005,01,017,0257,0,555 ,10 ,565 ,928 ,0,3,1,3,0,1,0,76.14,60.8836206897,33.33
03,005,01,017,0258,0,363 ,2 ,365 ,627 ,0,3,1,3,0,1,0,76.14,58.2137161085,33.33
03,005,01,017,0259,0,177 ,2 ,179 ,271 ,0,3,1,3,0,1,0,76.14,66.0516605166,33.33
03,005,01,018,0260,0,91 ,2 ,93 ,139 ,0,3,1,3,0,1,0,76.14,66.9064748201,33.33
03,005,01,018,0261,0,216 ,0 ,216 ,358 ,0,3,1,3,0,1,0,76.14,60.3351955307,33.33
03,005,01,018,0262,0,410 ,5 ,415 ,621 ,0,3,1,3,0,1,0,76.14,66.8276972625,33.33
03,005,01,018,0263,0,50 ,0 ,50 ,91 ,0,3,1,3,0,1,0,76.14,54.9450549451,33.33
03,005,01,018,0264,0,74 ,0 ,74 ,123 ,0,3,1,3,0,1,0,76.14,60.162601626,33.33
03,005,01,018,0265,0,18 ,0 ,18 ,27 ,0,3,1,3,0,1,0,76.14,66.6666666667,33.33
03,005,01,018,0266,0,20 ,0 ,20 ,51 ,0,3,1,3,0,1,0,76.14,39.2156862745,33.33
03,005,01,018,0267,0,14 ,0 ,14 ,27 ,0,3,1,3,0,1,0,76.14,51.8518518519,33.33
03,006,01,001,0001,0,1173 ,19 ,1192 ,1981 ,0,3,1,3,0,1,0,76.14,60.17 ,33.33
03,006,01,001,0002,0,590 ,5 ,595 ,1025 ,0,3,1,3,0,1,0,76.14,58.05 ,33.33
03,006,01,001,0003,0,541 ,5 ,546 ,885 ,0,3,1,3,0,1,0,76.14,61.69 ,33.33
03,006,01,001,0004,0,609 ,3 ,612 ,916 ,0,3,1,3,0,1,0,76.14,66.81 ,33.33
03,006,01,001,0005,0,491 ,4 ,495 ,795 ,0,3,1,3,0,1,0,76.14,62.26 ,33.33
03,006,01,001,0006,0,2720 ,31 ,2751 ,4527 ,0,3,1,3,0,1,0,76.14,60.77 ,33.33
03,006,01,001,0007,0,1309 ,15 ,1324 ,2264 ,0,3,1,3,0,1,0,76.14,58.48 ,33.33
03,006,01,001,0008,0,1339 ,25 ,1364 ,2502 ,0,3,1,3,0,1,0,76.14,54.52 ,33.33
03,006,01,001,0009,0,2256 ,31 ,2287 ,3729 ,0,3,1,3,0,1,0,76.14,61.33 ,33.33
03,006,01,001,0010,0,3688 ,41 ,3729 ,6701 ,0,3,1,3,0,1,0,76.14,55.65 ,33.33
03,006,01,001,0011,0,1070 ,6 ,1076 ,1728 ,0,3,1,3,0,1,0,76.14,62.27 ,33.33
03,006,01,001,0012,0,733 ,2 ,735 ,1138 ,0,3,1,3,0,1,0,76.14,64.59 ,33.33
03,006,01,001,0013,0,1662 ,12 ,1674 ,2779 ,0,3,1,3,0,1,0,76.14,60.24 ,33.33
03,006,01,001,0014,0,563 ,7 ,570 ,833 ,0,3,1,3,0,1,0,76.14,68.43 ,33.33
03,006,01,001,0015,0,493 ,5 ,498 ,792 ,0,3,1,3,0,1,0,76.14,62.88 ,33.33
03,006,01,001,0016,0,2822 ,19 ,2841 ,4834 ,0,3,1,3,0,1,0,76.14,58.77 ,33.33
03,006,01,001,0017,0,1291 ,7 ,1298 ,2278 ,0,3,1,3,0,1,0,76.14,56.98 ,33.33
03,006,01,001,0018,0,1614 ,19 ,1633 ,2751 ,0,3,1,3,0,1,0,76.14,59.36 ,33.33
03,006,01,001,0019,0,3979 ,39 ,4018 ,7659 ,0,3,1,3,0,1,0,76.14,52.46 ,33.33
03,006,01,001,0020,0,2723 ,24 ,2747 ,4995 ,0,3,1,3,0,1,0,76.14,54.99 ,33.33
03,006,01,001,0021,0,802 ,4 ,806 ,1362 ,0,3,1,3,0,1,0,76.14,59.18 ,33.33
03,006,01,001,0022,0,589 ,5 ,594 ,1037 ,0,3,1,3,0,1,0,76.14,57.28 ,33.33
03,006,01,001,0023,0,2650 ,32 ,2682 ,4701 ,0,3,1,3,0,1,0,76.14,57.05 ,33.33
03,006,01,001,0024,0,4847 ,61 ,4908 ,8797 ,0,3,1,3,0,1,0,76.14,55.79 ,33.33
03,006,01,001,0025,0,2114 ,27 ,2141 ,3559 ,0,3,1,3,0,1,0,76.14,60.16 ,33.33
03,006,01,001,0026,0,1429 ,18 ,1447 ,2450 ,0,3,1,3,0,1,0,76.14,59.06 ,33.33
03,006,01,001,0027,0,4127 ,37 ,4164 ,7530 ,0,3,1,3,0,1,0,76.14,55.30 ,33.33
03,006,01,001,0028,0,5537 ,62 ,5599 ,10053 ,0,3,1,3,0,1,0,76.14,55.69 ,33.33
03,006,01,001,0029,0,958 ,6 ,964 ,1495 ,0,3,1,3,0,1,0,76.14,64.48 ,33.33
03,006,01,001,0030,0,2335 ,20 ,2355 ,4072 ,0,3,1,3,0,1,0,76.14,57.83 ,33.33
03,006,01,001,0031,0,1742 ,20 ,1762 ,2972 ,0,3,1,3,0,1,0,76.14,59.29 ,33.33
03,006,01,001,0032,0,1680 ,27 ,1707 ,2848 ,0,3,1,3,0,1,0,76.14,59.94 ,33.33
03,006,01,001,0033,0,1048 ,14 ,1062 ,1728 ,0,3,1,3,0,1,0,76.14,61.46 ,33.33
03,006,01,001,0034,0,1408 ,16 ,1424 ,2384 ,0,3,1,3,0,1,0,76.14,59.73 ,33.33
03,006,01,001,0035,0,1122 ,21 ,1143 ,1841 ,0,3,1,3,0,1,0,76.14,62.09 ,33.33
03,006,01,001,0036,0,1750 ,28 ,1778 ,2937 ,0,3,1,3,0,1,0,76.14,60.54 ,33.33
03,006,01,002,0037,0,1850 ,18 ,1868 ,2997 ,0,3,1,3,0,1,0,76.14,62.33 ,33.33
03,006,01,002,0038,0,3594 ,31 ,3625 ,6835 ,0,3,1,3,0,1,0,76.14,53.04 ,33.33
03,006,01,002,0039,0,2251 ,24 ,2275 ,3816 ,0,3,1,3,0,1,0,76.14,59.62 ,33.33
03,006,01,002,0040,0,1728 ,32 ,1760 ,2829 ,0,3,1,3,0,1,0,76.14,62.21 ,33.33
03,006,01,002,0041,0,2922 ,29 ,2951 ,5523 ,0,3,1,3,0,1,0,76.14,53.43 ,33.33
03,006,01,002,0042,0,2968 ,19 ,2987 ,5470 ,0,3,1,3,0,1,0,76.14,54.61 ,33.33
03,006,01,002,0043,0,1977 ,18 ,1995 ,3548 ,0,3,1,3,0,1,0,76.14,56.23 ,33.33
03,006,01,002,0044,0,1555 ,22 ,1577 ,2614 ,0,3,1,3,0,1,0,76.14,60.33 ,33.33
03,006,01,002,0045,0,2071 ,32 ,2103 ,3415 ,0,3,1,3,0,1,0,76.14,61.58 ,33.33
03,006,01,002,0046,0,1381 ,3 ,1384 ,2158 ,0,3,1,3,0,1,0,76.14,64.13 ,33.33
03,006,01,002,0047,0,622 ,9 ,631 ,940 ,0,3,1,3,0,1,0,76.14,67.13 ,33.33
03,006,01,002,0048,0,2954 ,18 ,2972 ,5543 ,0,3,1,3,0,1,0,76.14,53.62 ,33.33
03,006,01,002,0049,0,2622 ,26 ,2648 ,4803 ,0,3,1,3,0,1,0,76.14,55.13 ,33.33
03,006,01,002,0050,0,2491 ,24 ,2515 ,4275 ,0,3,1,3,0,1,0,76.14,58.83 ,33.33
03,006,01,002,0051,0,3648 ,31 ,3679 ,6746 ,0,3,1,3,0,1,0,76.14,54.54 ,33.33
03,006,01,002,0052,0,3471 ,33 ,3504 ,6365 ,0,3,1,3,0,1,0,76.14,55.05 ,33.33
03,006,01,002,0053,0,3227 ,24 ,3251 ,5696 ,0,3,1,3,0,1,0,76.14,57.08 ,33.33
03,006,01,002,0054,0,1840 ,24 ,1864 ,3299 ,0,3,1,3,0,1,0,76.14,56.50 ,33.33
03,006,01,002,0055,0,2490 ,14 ,2504 ,4398 ,0,3,1,3,0,1,0,76.14,56.93 ,33.33
03,006,01,002,0056,0,1958 ,19 ,1977 ,3242 ,0,3,1,3,0,1,0,76.14,60.98 ,33.33
03,006,01,002,0057,0,2540 ,23 ,2563 ,4584 ,0,3,1,3,0,1,0,76.14,55.91 ,33.33
03,006,01,002,0058,0,3331 ,25 ,3356 ,5916 ,0,3,1,3,0,1,0,76.14,56.73 ,33.33
03,006,01,002,0059,0,4295 ,29 ,4324 ,7863 ,0,3,1,3,0,1,0,76.14,54.99 ,33.33
03,006,01,002,0060,0,2075 ,17 ,2092 ,3935 ,0,3,1,3,0,1,0,76.14,53.16 ,33.33
03,006,01,002,0061,0,2302 ,23 ,2325 ,4139 ,0,3,1,3,0,1,0,76.14,56.17 ,33.33
03,006,01,002,0062,0,3521 ,34 ,3555 ,6117 ,0,3,1,3,0,1,0,76.14,58.12 ,33.33
03,006,01,002,0063,0,5000 ,39 ,5039 ,8992 ,0,3,1,3,0,1,0,76.14,56.04 ,33.33
03,006,01,003,0064,0,3309 ,30 ,3339 ,5237 ,0,3,1,3,0,1,0,76.14,63.76 ,33.33
03,006,01,003,0065,0,4492 ,45 ,4537 ,7950 ,0,3,1,3,0,1,0,76.14,57.07 ,33.33
03,006,01,003,0066,0,3565 ,28 ,3593 ,6191 ,0,3,1,3,0,1,0,76.14,58.04 ,33.33
03,006,01,003,0067,0,3898 ,35 ,3933 ,6804 ,0,3,1,3,0,1,0,76.14,57.80 ,33.33
03,006,01,003,0068,0,5652 ,52 ,5704 ,9310 ,0,3,1,3,0,1,0,76.14,61.27 ,33.33
03,006,01,003,0069,0,2989 ,35 ,3024 ,5018 ,0,3,1,3,0,1,0,76.14,60.26 ,33.33
03,006,01,003,0070,0,4415 ,38 ,4453 ,7003 ,0,3,1,3,0,1,0,76.14,63.59 ,33.33
03,006,01,003,0071,0,4232 ,48 ,4280 ,6987 ,0,3,1,3,0,1,0,76.14,61.26 ,33.33
03,006,01,003,0072,0,3930 ,36 ,3966 ,6881 ,0,3,1,3,0,1,0,76.14,57.64 ,33.33
03,006,01,003,0073,0,7002 ,75 ,7077 ,12574 ,0,3,1,3,0,1,0,76.14,56.28 ,33.33
03,006,01,003,0074,0,6118 ,60 ,6178 ,11733 ,0,3,1,3,0,1,0,76.14,52.65 ,33.33
03,006,01,003,0075,0,5341 ,55 ,5396 ,9329 ,0,3,1,3,0,1,0,76.14,57.84 ,33.33
03,006,01,003,0076,0,2529 ,26 ,2555 ,4246 ,0,3,1,3,0,1,0,76.14,60.17 ,33.33
03,006,01,003,0077,0,2093 ,29 ,2122 ,3271 ,0,3,1,3,0,1,0,76.14,64.87 ,33.33
03,006,01,003,0078,0,776 ,4 ,780 ,1176 ,0,3,1,3,0,1,0,76.14,66.33 ,33.33
03,006,01,003,0079,0,3599 ,19 ,3618 ,5762 ,0,3,1,3,0,1,0,76.14,62.79 ,33.33
03,006,01,003,0080,0,586 ,4 ,590 ,810 ,0,3,1,3,0,1,0,76.14,72.84 ,33.33
03,006,01,003,0081,0,2790 ,24 ,2814 ,4660 ,0,3,1,3,0,1,0,76.14,60.39 ,33.33
03,006,01,003,0082,0,2126 ,22 ,2148 ,3582 ,0,3,1,3,0,1,0,76.14,59.97 ,33.33
03,006,01,004,0083,0,762 ,10 ,772 ,1229 ,0,3,1,3,0,1,0,76.14,62.82 ,33.33
03,006,01,004,0084,0,505 ,5 ,510 ,810 ,0,3,1,3,0,1,0,76.14,62.96 ,33.33
03,006,01,004,0085,0,741 ,10 ,751 ,1268 ,0,3,1,3,0,1,0,76.14,59.23 ,33.33
03,006,01,004,0086,0,1151 ,16 ,1167 ,1889 ,0,3,1,3,0,1,0,76.14,61.78 ,33.33
03,006,01,004,0087,0,1315 ,10 ,1325 ,2188 ,0,3,1,3,0,1,0,76.14,60.56 ,33.33
03,006,01,004,0088,0,623 ,4 ,627 ,954 ,0,3,1,3,0,1,0,76.14,65.72 ,33.33
03,006,01,004,0089,0,868 ,5 ,873 ,1460 ,0,3,1,3,0,1,0,76.14,59.79 ,33.33
03,006,01,004,0090,0,1904 ,18 ,1922 ,3232 ,0,3,1,3,0,1,0,76.14,59.47 ,33.33
03,006,01,004,0091,0,1059 ,10 ,1069 ,1842 ,0,3,1,3,0,1,0,76.14,58.03 ,33.33
03,006,01,004,0092,0,1802 ,31 ,1833 ,3148 ,0,3,1,3,0,1,0,76.14,58.23 ,33.33
03,006,01,004,0093,0,777 ,9 ,786 ,1422 ,0,3,1,3,0,1,0,76.14,55.27 ,33.33
03,006,01,004,0094,0,2675 ,48 ,2723 ,4591 ,0,3,1,3,0,1,0,76.14,59.31 ,33.33
03,006,01,004,0095,0,880 ,12 ,892 ,1468 ,0,3,1,3,0,1,0,76.14,60.76 ,33.33
03,006,01,004,0096,0,629 ,6 ,635 ,965 ,0,3,1,3,0,1,0,76.14,65.80 ,33.33
03,006,01,004,0097,0,578 ,3 ,581 ,888 ,0,3,1,3,0,1,0,76.14,65.43 ,33.33
03,006,01,004,0098,0,1204 ,9 ,1213 ,1910 ,0,3,1,3,0,1,0,76.14,63.51 ,33.33
03,006,01,004,0099,0,728 ,10 ,738 ,1397 ,0,3,1,3,0,1,0,76.14,52.83 ,33.33
03,006,01,004,0100,0,1091 ,14 ,1105 ,1899 ,0,3,1,3,0,1,0,76.14,58.19 ,33.33
03,006,01,004,0101,0,1018 ,12 ,1030 ,1746 ,0,3,1,3,0,1,0,76.14,58.99 ,33.33
03,006,01,004,0102,0,969 ,15 ,984 ,1647 ,0,3,1,3,0,1,0,76.14,59.74 ,33.33
03,006,01,004,0103,0,691 ,5 ,696 ,1218 ,0,3,1,3,0,1,0,76.14,57.14 ,33.33
03,006,01,004,0104,0,950 ,17 ,967 ,1757 ,0,3,1,3,0,1,0,76.14,55.04 ,33.33
03,006,01,004,0105,0,433 ,4 ,437 ,746 ,0,3,1,3,0,1,0,76.14,58.58 ,33.33
03,006,01,004,0106,0,439 ,3 ,442 ,653 ,0,3,1,3,0,1,0,76.14,67.69 ,33.33
03,006,01,004,0107,0,758 ,8 ,766 ,1399 ,0,3,1,3,0,1,0,76.14,54.75 ,33.33
03,006,01,005,0108,0,811 ,8 ,819 ,1287 ,0,3,1,3,0,1,0,76.14,63.64 ,33.33
03,006,01,005,0109,0,713 ,6 ,719 ,1203 ,0,3,1,3,0,1,0,76.14,59.77 ,33.33
03,006,01,005,0110,0,985 ,12 ,997 ,1646 ,0,3,1,3,0,1,0,76.14,60.57 ,33.33
03,006,01,005,0111,0,497 ,6 ,503 ,779 ,0,3,1,3,0,1,0,76.14,64.57 ,33.33
03,006,01,005,0112,0,1239 ,10 ,1249 ,1988 ,0,3,1,3,0,1,0,76.14,62.83 ,33.33
03,006,01,005,0113,0,1237 ,13 ,1250 ,1986 ,0,3,1,3,0,1,0,76.14,62.94 ,33.33
03,006,01,005,0114,0,1931 ,23 ,1954 ,3131 ,0,3,1,3,0,1,0,76.14,62.41 ,33.33
03,006,01,005,0115,0,1165 ,4 ,1169 ,1862 ,0,3,1,3,0,1,0,76.14,62.78 ,33.33
03,006,01,005,0116,0,2009 ,28 ,2037 ,3477 ,0,3,1,3,0,1,0,76.14,58.58 ,33.33
03,006,01,005,0117,0,544 ,9 ,553 ,863 ,0,3,1,3,0,1,0,76.14,64.08 ,33.33
03,006,01,005,0118,0,585 ,2 ,587 ,936 ,0,3,1,3,0,1,0,76.14,62.71 ,33.33
03,006,01,005,0119,0,1535 ,23 ,1558 ,2651 ,0,3,1,3,0,1,0,76.14,58.77 ,33.33
03,006,01,005,0120,0,838 ,9 ,847 ,1110 ,0,3,1,3,0,1,0,76.14,76.31 ,33.33
03,006,01,005,0121,0,715 ,4 ,719 ,1096 ,0,3,1,3,0,1,0,76.14,65.60 ,33.33
03,006,01,005,0122,0,1024 ,15 ,1039 ,1589 ,0,3,1,3,0,1,0,76.14,65.39 ,33.33
03,006,01,005,0123,0,2770 ,31 ,2801 ,4627 ,0,3,1,3,0,1,0,76.14,60.54 ,33.33
03,006,01,005,0124,0,871 ,11 ,882 ,1469 ,0,3,1,3,0,1,0,76.14,60.04 ,33.33
03,006,01,005,0125,0,918 ,6 ,924 ,1586 ,0,3,1,3,0,1,0,76.14,58.26 ,33.33
03,006,01,005,0126,0,619 ,13 ,632 ,1066 ,0,3,1,3,0,1,0,76.14,59.29 ,33.33
03,006,01,005,0127,0,2078 ,22 ,2100 ,3420 ,0,3,1,3,0,1,0,76.14,61.40 ,33.33
03,006,01,005,0128,0,716 ,5 ,721 ,1231 ,0,3,1,3,0,1,0,76.14,58.57 ,33.33
03,006,01,005,0129,0,1968 ,27 ,1995 ,3255 ,0,3,1,3,0,1,0,76.14,61.29 ,33.33
03,006,01,005,0130,0,1431 ,25 ,1456 ,2376 ,0,3,1,3,0,1,0,76.14,61.28 ,33.33
03,006,01,005,0131,0,2202 ,30 ,2232 ,4122 ,0,3,1,3,0,1,0,76.14,54.15 ,33.33
03,006,01,005,0132,0,889 ,13 ,902 ,1386 ,0,3,1,3,0,1,0,76.14,65.08 ,33.33
03,006,01,005,0133,0,928 ,9 ,937 ,1495 ,0,3,1,3,0,1,0,76.14,62.68 ,33.33
03,006,01,005,0134,0,720 ,6 ,726 ,1244 ,0,3,1,3,0,1,0,76.14,58.36 ,33.33
03,006,01,005,0135,0,722 ,10 ,732 ,1081 ,0,3,1,3,0,1,0,76.14,67.72 ,33.33
03,006,01,005,0136,0,856 ,8 ,864 ,1320 ,0,3,1,3,0,1,0,76.14,65.45 ,33.33
03,006,01,006,0137,0,810 ,10 ,820 ,1202 ,0,3,1,3,0,1,0,76.14,68.22 ,33.33
03,006,01,006,0138,0,707 ,4 ,711 ,1075 ,0,3,1,3,0,1,0,76.14,66.14 ,33.33
03,006,01,006,0139,0,1249 ,10 ,1259 ,2042 ,0,3,1,3,0,1,0,76.14,61.66 ,33.33
03,006,01,006,0140,0,465 ,5 ,470 ,730 ,0,3,1,3,0,1,0,76.14,64.38 ,33.33
03,006,01,006,0141,0,1181 ,7 ,1188 ,1784 ,0,3,1,3,0,1,0,76.14,66.59 ,33.33
03,006,01,006,0142,0,945 ,6 ,951 ,1478 ,0,3,1,3,0,1,0,76.14,64.34 ,33.33
03,006,01,006,0143,0,508 ,4 ,512 ,724 ,0,3,1,3,0,1,0,76.14,70.72 ,33.33
03,006,01,006,0144,0,329 ,2 ,331 ,449 ,0,3,1,3,0,1,0,76.14,73.72 ,33.33
03,006,01,006,0145,0,1539 ,24 ,1563 ,2410 ,0,3,1,3,0,1,0,76.14,64.85 ,33.33
03,006,01,006,0146,0,3356 ,28 ,3384 ,5464 ,0,3,1,3,0,1,0,76.14,61.93 ,33.33
03,006,01,006,0147,0,755 ,12 ,767 ,1296 ,0,3,1,3,0,1,0,76.14,59.18 ,33.33
03,006,01,006,0148,0,946 ,9 ,955 ,1488 ,0,3,1,3,0,1,0,76.14,64.18 ,33.33
03,006,01,006,0149,0,2059 ,21 ,2080 ,3622 ,0,3,1,3,0,1,0,76.14,57.43 ,33.33
03,006,01,006,0150,0,1715 ,18 ,1733 ,2770 ,0,3,1,3,0,1,0,76.14,62.56 ,33.33
03,006,01,006,0151,0,1177 ,18 ,1195 ,1861 ,0,3,1,3,0,1,0,76.14,64.21 ,33.33
03,006,01,006,0152,0,2109 ,26 ,2135 ,3665 ,0,3,1,3,0,1,0,76.14,58.25 ,33.33
03,006,01,006,0153,0,977 ,9 ,986 ,1518 ,0,3,1,3,0,1,0,76.14,64.95 ,33.33
03,006,01,006,0154,0,800 ,15 ,815 ,1312 ,0,3,1,3,0,1,0,76.14,62.12 ,33.33
03,006,01,006,0155,0,894 ,8 ,902 ,1317 ,0,3,1,3,0,1,0,76.14,68.49 ,33.33
03,006,01,006,0156,0,728 ,12 ,740 ,1275 ,0,3,1,3,0,1,0,76.14,58.04 ,33.33
03,006,01,006,0157,0,691 ,12 ,703 ,1117 ,0,3,1,3,0,1,0,76.14,62.94 ,33.33
03,006,01,006,0158,0,853 ,5 ,858 ,1285 ,0,3,1,3,0,1,0,76.14,66.77 ,33.33
03,006,01,006,0159,0,1087 ,7 ,1094 ,1993 ,0,3,1,3,0,1,0,76.14,54.89 ,33.33
03,006,01,006,0160,0,1284 ,8 ,1292 ,2186 ,0,3,1,3,0,1,0,76.14,59.10 ,33.33
03,006,01,006,0161,0,1055 ,12 ,1067 ,1742 ,0,3,1,3,0,1,0,76.14,61.25 ,33.33
03,006,01,006,0162,0,1182 ,18 ,1200 ,2155 ,0,3,1,3,0,1,0,76.14,55.68 ,33.33
03,006,01,006,0163,0,3559 ,35 ,3594 ,5845 ,0,3,1,3,0,1,0,76.14,61.49 ,33.33
03,006,01,006,0164,0,1753 ,22 ,1775 ,2871 ,0,3,1,3,0,1,0,76.14,61.83 ,33.33
03,006,01,006,0165,0,806 ,12 ,818 ,1103 ,0,3,1,3,0,1,0,76.14,74.16 ,33.33
03,006,01,006,0166,0,1024 ,14 ,1038 ,1328 ,0,3,1,3,0,1,0,76.14,78.16 ,33.33
03,006,01,006,0167,0,669 ,11 ,680 ,1031 ,0,3,1,3,0,1,0,76.14,65.96 ,33.33
03,006,01,006,0168,0,750 ,7 ,757 ,1219 ,0,3,1,3,0,1,0,76.14,62.10 ,33.33
03,006,01,007,0169,0,806 ,10 ,816 ,1361 ,0,3,1,3,0,1,0,76.14,59.96 ,33.33
03,006,01,007,0170,0,1470 ,12 ,1482 ,2178 ,0,3,1,3,0,1,0,76.14,68.04 ,33.33
03,006,01,007,0171,0,706 ,7 ,713 ,1160 ,0,3,1,3,0,1,0,76.14,61.47 ,33.33
03,006,01,007,0172,0,382 ,2 ,384 ,540 ,0,3,1,3,0,1,0,76.14,71.11 ,33.33
03,006,01,007,0173,0,1388 ,25 ,1413 ,2390 ,0,3,1,3,0,1,0,76.14,59.12 ,33.33
03,006,01,007,0174,0,1610 ,17 ,1627 ,2643 ,0,3,1,3,0,1,0,76.14,61.56 ,33.33
03,006,01,007,0175,0,2240 ,18 ,2258 ,3652 ,0,3,1,3,0,1,0,76.14,61.83 ,33.33
03,006,01,007,0176,0,2229 ,19 ,2248 ,3871 ,0,3,1,3,0,1,0,76.14,58.07 ,33.33
03,006,01,007,0177,0,3094 ,34 ,3128 ,5128 ,0,3,1,3,0,1,0,76.14,61.00 ,33.33
03,006,01,007,0178,0,3376 ,46 ,3422 ,5545 ,0,3,1,3,0,1,0,76.14,61.71 ,33.33
03,006,01,007,0179,0,543 ,5 ,548 ,844 ,0,3,1,3,0,1,0,76.14,64.93 ,33.33
03,006,01,007,0180,0,1344 ,8 ,1352 ,2300 ,0,3,1,3,0,1,0,76.14,58.78 ,33.33
03,006,01,007,0181,0,1938 ,19 ,1957 ,3385 ,0,3,1,3,0,1,0,76.14,57.81 ,33.33
03,006,01,007,0182,0,809 ,8 ,817 ,1244 ,0,3,1,3,0,1,0,76.14,65.68 ,33.33
03,006,01,007,0183,0,1386 ,14 ,1400 ,2381 ,0,3,1,3,0,1,0,76.14,58.80 ,33.33
03,006,01,007,0184,0,1185 ,22 ,1207 ,1870 ,0,3,1,3,0,1,0,76.14,64.55 ,33.33
03,006,01,007,0185,0,1426 ,16 ,1442 ,2171 ,0,3,1,3,0,1,0,76.14,66.42 ,33.33
03,006,01,007,0186,0,1606 ,16 ,1622 ,2428 ,0,3,1,3,0,1,0,76.14,66.80 ,33.33
03,006,01,007,0187,0,2117 ,19 ,2136 ,3417 ,0,3,1,3,0,1,0,76.14,62.51 ,33.33
03,006,01,007,0188,0,1099 ,13 ,1112 ,1845 ,0,3,1,3,0,1,0,76.14,60.27 ,33.33
03,006,01,007,0189,0,1190 ,24 ,1214 ,1990 ,0,3,1,3,0,1,0,76.14,61.01 ,33.33
03,006,01,008,0190,0,1472 ,23 ,1495 ,2615 ,0,3,1,3,0,1,0,76.14,57.17 ,33.33
03,006,01,008,0191,0,1219 ,31 ,1250 ,1983 ,0,3,1,3,0,1,0,76.14,63.04 ,33.33
03,006,01,008,0192,0,1859 ,22 ,1881 ,3330 ,0,3,1,3,0,1,0,76.14,56.49 ,33.33
03,006,01,008,0193,0,330 ,4 ,334 ,552 ,0,3,1,3,0,1,0,76.14,60.51 ,33.33
03,006,01,008,0194,0,694 ,7 ,701 ,1120 ,0,3,1,3,0,1,0,76.14,62.59 ,33.33
03,006,01,008,0195,0,442 ,4 ,446 ,728 ,0,3,1,3,0,1,0,76.14,61.26 ,33.33
03,006,01,008,0196,0,3121 ,55 ,3176 ,5226 ,0,3,1,3,0,1,0,76.14,60.77 ,33.33
03,006,01,008,0197,0,1493 ,12 ,1505 ,2698 ,0,3,1,3,0,1,0,76.14,55.78 ,33.33
03,006,01,008,0198,0,1636 ,18 ,1654 ,2914 ,0,3,1,3,0,1,0,76.14,56.76 ,33.33
03,006,01,008,0199,0,2894 ,33 ,2927 ,5130 ,0,3,1,3,0,1,0,76.14,57.06 ,33.33
03,006,01,008,0200,0,2073 ,22 ,2095 ,3833 ,0,3,1,3,0,1,0,76.14,54.66 ,33.33
03,006,01,008,0201,0,1072 ,13 ,1085 ,1793 ,0,3,1,3,0,1,0,76.14,60.51 ,33.33
03,006,01,008,0202,0,1232 ,7 ,1239 ,2181 ,0,3,1,3,0,1,0,76.14,56.81 ,33.33
03,006,01,008,0203,0,1358 ,17 ,1375 ,2274 ,0,3,1,3,0,1,0,76.14,60.47 ,33.33
03,006,01,009,0204,0,1216 ,24 ,1240 ,1847 ,0,3,1,3,0,1,0,76.14,67.14 ,33.33
03,006,01,009,0205,0,877 ,11 ,888 ,1455 ,0,3,1,3,0,1,0,76.14,61.03 ,33.33
03,006,01,009,0206,0,1731 ,16 ,1747 ,2699 ,0,3,1,3,0,1,0,76.14,64.73 ,33.33
03,006,01,009,0207,0,1558 ,24 ,1582 ,2540 ,0,3,1,3,0,1,0,76.14,62.28 ,33.33
03,006,01,009,0208,0,2129 ,25 ,2154 ,3330 ,0,3,1,3,0,1,0,76.14,64.68 ,33.33
03,006,01,009,0209,0,1265 ,15 ,1280 ,1926 ,0,3,1,3,0,1,0,76.14,66.46 ,33.33
03,006,01,009,0210,0,2576 ,28 ,2604 ,4095 ,0,3,1,3,0,1,0,76.14,63.59 ,33.33
03,006,01,009,0211,0,1164 ,26 ,1190 ,1819 ,0,3,1,3,0,1,0,76.14,65.42 ,33.33
03,006,01,009,0212,0,1725 ,14 ,1739 ,2641 ,0,3,1,3,0,1,0,76.14,65.85 ,33.33
03,006,01,009,0213,0,1805 ,21 ,1826 ,2841 ,0,3,1,3,0,1,0,76.14,64.27 ,33.33
03,006,01,009,0214,0,1319 ,14 ,1333 ,2063 ,0,3,1,3,0,1,0,76.14,64.61 ,33.33
03,006,01,009,0215,0,877 ,17 ,894 ,1370 ,0,3,1,3,0,1,0,76.14,65.26 ,33.33
03,006,01,009,0216,0,950 ,12 ,962 ,1515 ,0,3,1,3,0,1,0,76.14,63.50 ,33.33
03,006,01,009,0217,0,1316 ,22 ,1338 ,2018 ,0,3,1,3,0,1,0,76.14,66.30 ,33.33
03,006,01,009,0218,0,1744 ,17 ,1761 ,2835 ,0,3,1,3,0,1,0,76.14,62.12 ,33.33
03,006,01,009,0219,0,1002 ,11 ,1013 ,1546 ,0,3,1,3,0,1,0,76.14,65.52 ,33.33
03,006,01,009,0220,0,1143 ,17 ,1160 ,1788 ,0,3,1,3,0,1,0,76.14,64.88 ,33.33
03,006,01,009,0221,0,826 ,12 ,838 ,1274 ,0,3,1,3,0,1,0,76.14,65.78 ,33.33
03,006,01,010,0222,0,1583 ,20 ,1603 ,2556 ,0,3,1,3,0,1,0,76.14,62.72 ,33.33
03,006,01,010,0223,0,966 ,4 ,970 ,1604 ,0,3,1,3,0,1,0,76.14,60.47 ,33.33
03,006,01,010,0224,0,1350 ,19 ,1369 ,2156 ,0,3,1,3,0,1,0,76.14,63.50 ,33.33
03,006,01,010,0225,0,1292 ,11 ,1303 ,1996 ,0,3,1,3,0,1,0,76.14,65.28 ,33.33
03,006,01,010,0226,0,1346 ,17 ,1363 ,2108 ,0,3,1,3,0,1,0,76.14,64.66 ,33.33
03,006,01,010,0227,0,1211 ,20 ,1231 ,1892 ,0,3,1,3,0,1,0,76.14,65.06 ,33.33
03,006,01,010,0228,0,2181 ,28 ,2209 ,3537 ,0,3,1,3,0,1,0,76.14,62.45 ,33.33
03,006,01,010,0229,0,603 ,9 ,612 ,919 ,0,3,1,3,0,1,0,76.14,66.59 ,33.33
03,006,01,010,0230,0,3150 ,28 ,3178 ,5443 ,0,3,1,3,0,1,0,76.14,58.39 ,33.33
03,006,01,010,0231,0,2353 ,36 ,2389 ,4112 ,0,3,1,3,0,1,0,76.14,58.10 ,33.33
03,006,01,010,0232,0,1323 ,13 ,1336 ,2111 ,0,3,1,3,0,1,0,76.14,63.29 ,33.33
03,006,01,010,0233,0,1777 ,25 ,1802 ,3266 ,0,3,1,3,0,1,0,76.14,55.17 ,33.33
03,006,01,010,0234,0,1534 ,17 ,1551 ,2581 ,0,3,1,3,0,1,0,76.14,60.09 ,33.33
03,006,01,010,0235,0,3493 ,46 ,3539 ,6213 ,0,3,1,3,0,1,0,76.14,56.96 ,33.33
03,006,01,010,0236,0,1408 ,18 ,1426 ,2260 ,0,3,1,3,0,1,0,76.14,63.10 ,33.33
03,006,01,010,0237,0,1661 ,40 ,1701 ,2483 ,0,3,1,3,0,1,0,76.14,68.51 ,33.33
03,006,01,011,0238,0,849 ,8 ,857 ,1377 ,0,3,1,3,0,1,0,76.14,62.24 ,33.33
03,006,01,011,0239,0,1221 ,16 ,1237 ,2066 ,0,3,1,3,0,1,0,76.14,59.87 ,33.33
03,006,01,011,0240,0,4810 ,41 ,4851 ,8758 ,0,3,1,3,0,1,0,76.14,55.39 ,33.33
03,006,01,011,0241,0,4059 ,32 ,4091 ,7344 ,0,3,1,3,0,1,0,76.14,55.71 ,33.33
03,006,01,011,0242,0,1931 ,18 ,1949 ,3522 ,0,3,1,3,0,1,0,76.14,55.34 ,33.33
03,006,01,011,0243,0,1739 ,16 ,1755 ,3021 ,0,3,1,3,0,1,0,76.14,58.09 ,33.33
03,006,01,011,0244,0,1931 ,18 ,1949 ,3832 ,0,3,1,3,0,1,0,76.14,50.86 ,33.33
03,006,01,011,0245,0,1664 ,17 ,1681 ,2844 ,0,3,1,3,0,1,0,76.14,59.11 ,33.33
03,006,01,011,0246,0,3645 ,33 ,3678 ,6591 ,0,3,1,3,0,1,0,76.14,55.80 ,33.33
03,006,01,011,0247,0,5234 ,61 ,5295 ,8897 ,0,3,1,3,0,1,0,76.14,59.51 ,33.33
03,006,01,011,0248,0,1022 ,10 ,1032 ,1783 ,0,3,1,3,0,1,0,76.14,57.88 ,33.33
03,006,01,011,0249,0,1951 ,21 ,1972 ,3527 ,0,3,1,3,0,1,0,76.14,55.91 ,33.33
03,006,01,011,0250,0,2459 ,26 ,2485 ,4059 ,0,3,1,3,0,1,0,76.14,61.22 ,33.33
03,006,01,011,0251,0,1918 ,23 ,1941 ,3216 ,0,3,1,3,0,1,0,76.14,60.35 ,33.33
03,006,01,011,0252,0,856 ,7 ,863 ,1422 ,0,3,1,3,0,1,0,76.14,60.69 ,33.33
03,006,01,011,0253,0,1649 ,17 ,1666 ,2827 ,0,3,1,3,0,1,0,76.14,58.93 ,33.33
03,006,01,012,0254,0,2088 ,41 ,2129 ,3760 ,0,3,1,3,0,1,0,76.14,56.62 ,33.33
03,006,01,012,0255,0,2082 ,23 ,2105 ,3769 ,0,3,1,3,0,1,0,76.14,55.85 ,33.33
03,006,01,012,0256,0,2397 ,15 ,2412 ,4404 ,0,3,1,3,0,1,0,76.14,54.77 ,33.33
03,006,01,012,0257,0,2074 ,19 ,2093 ,3801 ,0,3,1,3,0,1,0,76.14,55.06 ,33.33
03,006,01,012,0258,0,2059 ,17 ,2076 ,3782 ,0,3,1,3,0,1,0,76.14,54.89 ,33.33
03,006,01,012,0259,0,1696 ,14 ,1710 ,3182 ,0,3,1,3,0,1,0,76.14,53.74 ,33.33
03,006,01,012,0260,0,1712 ,27 ,1739 ,3090 ,0,3,1,3,0,1,0,76.14,56.28 ,33.33
03,006,01,012,0261,0,5547 ,79 ,5626 ,10213 ,0,3,1,3,0,1,0,76.14,55.09 ,33.33
03,006,01,012,0262,0,3556 ,37 ,3593 ,6126 ,0,3,1,3,0,1,0,76.14,58.65 ,33.33
03,006,01,012,0263,0,3089 ,49 ,3138 ,5237 ,0,3,1,3,0,1,0,76.14,59.92 ,33.33
03,006,01,012,0264,0,1786 ,20 ,1806 ,2715 ,0,3,1,3,0,1,0,76.14,66.52 ,33.33
03,006,01,012,0265,0,2136 ,38 ,2174 ,3349 ,0,3,1,3,0,1,0,76.14,64.91 ,33.33
03,006,01,012,0266,0,1985 ,13 ,1998 ,3150 ,0,3,1,3,0,1,0,76.14,63.43 ,33.33
03,006,01,013,0267,0,1726 ,12 ,1738 ,2826 ,0,3,1,3,0,1,0,76.14,61.50 ,33.33
03,006,01,013,0268,0,1017 ,12 ,1029 ,1701 ,0,3,1,3,0,1,0,76.14,60.49 ,33.33
03,006,01,013,0269,0,821 ,7 ,828 ,1261 ,0,3,1,3,0,1,0,76.14,65.66 ,33.33
03,006,01,013,0270,0,552 ,4 ,556 ,909 ,0,3,1,3,0,1,0,76.14,61.17 ,33.33
03,006,01,013,0271,0,724 ,11 ,735 ,1185 ,0,3,1,3,0,1,0,76.14,62.03 ,33.33
03,006,01,013,0272,0,1192 ,9 ,1201 ,1922 ,0,3,1,3,0,1,0,76.14,62.49 ,33.33
03,006,01,013,0273,0,1705 ,26 ,1731 ,2625 ,0,3,1,3,0,1,0,76.14,65.94 ,33.33
03,006,01,013,0274,0,442 ,4 ,446 ,693 ,0,3,1,3,0,1,0,76.14,64.36 ,33.33
03,006,01,013,0275,0,1651 ,14 ,1665 ,2572 ,0,3,1,3,0,1,0,76.14,64.74 ,33.33
03,006,01,013,0276,0,791 ,3 ,794 ,1265 ,0,3,1,3,0,1,0,76.14,62.77 ,33.33
03,006,01,013,0277,0,550 ,4 ,554 ,890 ,0,3,1,3,0,1,0,76.14,62.25 ,33.33
03,006,01,013,0278,0,363 ,2 ,365 ,586 ,0,3,1,3,0,1,0,76.14,62.29 ,33.33
03,006,01,013,0279,0,782 ,5 ,787 ,1274 ,0,3,1,3,0,1,0,76.14,61.77 ,33.33
03,006,01,014,0280,0,645 ,12 ,657 ,1052 ,0,3,1,3,0,1,0,76.14,62.45 ,33.33
03,006,01,014,0281,0,729 ,8 ,737 ,1171 ,0,3,1,3,0,1,0,76.14,62.94 ,33.33
03,006,01,014,0282,0,655 ,16 ,671 ,1056 ,0,3,1,3,0,1,0,76.14,63.54 ,33.33
03,006,01,014,0283,0,733 ,15 ,748 ,1219 ,0,3,1,3,0,1,0,76.14,61.36 ,33.33
03,006,01,014,0284,0,436 ,11 ,447 ,684 ,0,3,1,3,0,1,0,76.14,65.35 ,33.33
03,006,01,014,0285,0,858 ,26 ,884 ,1386 ,0,3,1,3,0,1,0,76.14,63.78 ,33.33
03,006,01,014,0286,0,1065 ,11 ,1076 ,1720 ,0,3,1,3,0,1,0,76.14,62.56 ,33.33
03,006,01,014,0287,0,558 ,5 ,563 ,945 ,0,3,1,3,0,1,0,76.14,59.58 ,33.33
03,006,01,014,0288,0,768 ,9 ,777 ,1274 ,0,3,1,3,0,1,0,76.14,60.99 ,33.33
03,006,01,014,0289,0,779 ,1 ,780 ,1224 ,0,3,1,3,0,1,0,76.14,63.73 ,33.33
03,006,01,015,0290,0,632 ,13 ,645 ,991 ,0,3,1,3,0,1,0,76.14,65.09 ,33.33
03,006,01,015,0291,0,942 ,12 ,954 ,1544 ,0,3,1,3,0,1,0,76.14,61.79 ,33.33
03,006,01,015,0292,0,2119 ,10 ,2129 ,3549 ,0,3,1,3,0,1,0,76.14,59.99 ,33.33
03,006,01,015,0293,0,2739 ,54 ,2793 ,4708 ,0,3,1,3,0,1,0,76.14,59.32 ,33.33
03,006,01,015,0294,0,983 ,12 ,995 ,1703 ,0,3,1,3,0,1,0,76.14,58.43 ,33.33
03,006,01,015,0295,0,1680 ,20 ,1700 ,2882 ,0,3,1,3,0,1,0,76.14,58.99 ,33.33
03,006,01,015,0296,0,1274 ,22 ,1296 ,2069 ,0,3,1,3,0,1,0,76.14,62.64 ,33.33
03,006,01,015,0297,0,649 ,9 ,658 ,1050 ,0,3,1,3,0,1,0,76.14,62.67 ,33.33
03,006,01,015,0298,0,875 ,8 ,883 ,1342 ,0,3,1,3,0,1,0,76.14,65.80 ,33.33
03,006,01,015,0299,0,1014 ,13 ,1027 ,1543 ,0,3,1,3,0,1,0,76.14,66.56 ,33.33
03,006,01,015,0300,0,738 ,19 ,757 ,1176 ,0,3,1,3,0,1,0,76.14,64.37 ,33.33
03,006,01,016,0301,0,662 ,6 ,668 ,1067 ,0,3,1,3,0,1,0,76.14,62.61 ,33.33
03,006,01,016,0302,0,697 ,13 ,710 ,1106 ,0,3,1,3,0,1,0,76.14,64.20 ,33.33
03,006,01,016,0303,0,1348 ,17 ,1365 ,2408 ,0,3,1,3,0,1,0,76.14,56.69 ,33.33
03,006,01,016,0304,0,763 ,6 ,769 ,1196 ,0,3,1,3,0,1,0,76.14,64.30 ,33.33
03,006,01,016,0305,0,723 ,12 ,735 ,1144 ,0,3,1,3,0,1,0,76.14,64.25 ,33.33
03,006,01,016,0306,0,1113 ,12 ,1125 ,1577 ,0,3,1,3,0,1,0,76.14,71.34 ,33.33
03,006,01,016,0307,0,531 ,4 ,535 ,877 ,0,3,1,3,0,1,0,76.14,61.00 ,33.33
03,006,01,016,0308,0,1018 ,10 ,1028 ,1631 ,0,3,1,3,0,1,0,76.14,63.03 ,33.33
03,006,01,016,0309,0,538 ,5 ,543 ,981 ,0,3,1,3,0,1,0,76.14,55.35 ,33.33
03,006,01,016,0310,0,852 ,14 ,866 ,1370 ,0,3,1,3,0,1,0,76.14,63.21 ,33.33
03,006,01,016,0311,0,826 ,8 ,834 ,1379 ,0,3,1,3,0,1,0,76.14,60.48 ,33.33
03,006,01,016,0312,0,565 ,5 ,570 ,778 ,0,3,1,3,0,1,0,76.14,73.26 ,33.33
03,006,01,017,0313,0,3654 ,28 ,3682 ,5936 ,0,3,1,3,0,1,0,76.14,62.03 ,33.33
03,006,01,017,0314,0,1253 ,12 ,1265 ,2111 ,0,3,1,3,0,1,0,76.14,59.92 ,33.33
03,006,01,017,0315,0,2110 ,33 ,2143 ,3314 ,0,3,1,3,0,1,0,76.14,64.67 ,33.33
03,006,01,017,0316,0,1684 ,22 ,1706 ,2541 ,0,3,1,3,0,1,0,76.14,67.14 ,33.33
03,006,01,017,0317,0,1178 ,13 ,1191 ,1938 ,0,3,1,3,0,1,0,76.14,61.46 ,33.33
03,006,01,017,0318,0,5464 ,48 ,5512 ,9579 ,0,3,1,3,0,1,0,76.14,57.54 ,33.33
03,006,01,017,0319,0,3089 ,30 ,3119 ,5397 ,0,3,1,3,0,1,0,76.14,57.79 ,33.33
03,006,01,017,0320,0,1375 ,20 ,1395 ,2073 ,0,3,1,3,0,1,0,76.14,67.29 ,33.33
03,006,01,017,0321,0,988 ,9 ,997 ,1464 ,0,3,1,3,0,1,0,76.14,68.10 ,33.33
03,006,01,017,0322,0,1305 ,10 ,1315 ,1999 ,0,3,1,3,0,1,0,76.14,65.78 ,33.33
03,006,01,017,0323,0,1113 ,11 ,1124 ,1635 ,0,3,1,3,0,1,0,76.14,68.75 ,33.33
03,006,01,017,0324,0,2221 ,37 ,2258 ,3652 ,0,3,1,3,0,1,0,76.14,61.83 ,33.33
03,006,01,017,0325,0,950 ,20 ,970 ,1495 ,0,3,1,3,0,1,0,76.14,64.88 ,33.33
03,006,01,017,0326,0,864 ,12 ,876 ,1412 ,0,3,1,3,0,1,0,76.14,62.04 ,33.33
03,006,01,017,0327,0,693 ,8 ,701 ,1093 ,0,3,1,3,0,1,0,76.14,64.14 ,33.33
03,006,01,017,0328,0,496 ,6 ,502 ,807 ,0,3,1,3,0,1,0,76.14,62.21 ,33.33
03,006,01,018,0329,0,2371 ,23 ,2394 ,3700 ,0,3,1,3,0,1,0,76.14,64.70 ,33.33
03,006,01,018,0330,0,557 ,4 ,561 ,802 ,0,3,1,3,0,1,0,76.14,69.95 ,33.33
03,006,01,018,0331,0,2033 ,23 ,2056 ,3257 ,0,3,1,3,0,1,0,76.14,63.13 ,33.33
03,006,01,018,0332,0,881 ,13 ,894 ,1292 ,0,3,1,3,0,1,0,76.14,69.20 ,33.33
03,006,01,018,0333,0,1470 ,22 ,1492 ,2240 ,0,3,1,3,0,1,0,76.14,66.61 ,33.33
03,006,01,018,0334,0,1317 ,10 ,1327 ,2244 ,0,3,1,3,0,1,0,76.14,59.14 ,33.33
03,006,01,018,0335,0,1577 ,9 ,1586 ,2593 ,0,3,1,3,0,1,0,76.14,61.16 ,33.33
03,006,01,018,0336,0,1199 ,11 ,1210 ,1821 ,0,3,1,3,0,1,0,76.14,66.45 ,33.33
03,006,01,018,0337,0,529 ,8 ,537 ,832 ,0,3,1,3,0,1,0,76.14,64.54 ,33.33
03,006,01,018,0338,0,922 ,12 ,934 ,1336 ,0,3,1,3,0,1,0,76.14,69.91 ,33.33
03,006,01,018,0339,0,1013 ,10 ,1023 ,1471 ,0,3,1,3,0,1,0,76.14,69.54 ,33.33
03,006,01,018,0340,0,608 ,9 ,617 ,885 ,0,3,1,3,0,1,0,76.14,69.72 ,33.33
03,006,01,018,0341,0,842 ,8 ,850 ,1324 ,0,3,1,3,0,1,0,76.14,64.20 ,33.33
03,006,01,018,0342,0,2941 ,29 ,2970 ,4952 ,0,3,1,3,0,1,0,76.14,59.98 ,33.33
03,006,01,018,0343,0,2381 ,32 ,2413 ,3820 ,0,3,1,3,0,1,0,76.14,63.17 ,33.33
03,006,01,018,0344,0,1943 ,28 ,1971 ,3461 ,0,3,1,3,0,1,0,76.14,56.95 ,33.33
03,006,01,018,0345,0,1837 ,26 ,1863 ,2944 ,0,3,1,3,0,1,0,76.14,63.28 ,33.33
03,006,01,019,0346,0,1372 ,13 ,1385 ,2272 ,0,3,1,3,0,1,0,76.14,60.96 ,33.33
03,006,01,019,0347,0,1422 ,10 ,1432 ,2403 ,0,3,1,3,0,1,0,76.14,59.59 ,33.33
03,006,01,019,0348,0,1062 ,14 ,1076 ,1612 ,0,3,1,3,0,1,0,76.14,66.75 ,33.33
03,006,01,019,0349,0,1534 ,18 ,1552 ,2603 ,0,3,1,3,0,1,0,76.14,59.62 ,33.33
03,006,01,019,0350,0,639 ,6 ,645 ,994 ,0,3,1,3,0,1,0,76.14,64.89 ,33.33
03,006,01,019,0351,0,1373 ,11 ,1384 ,1973 ,0,3,1,3,0,1,0,76.14,70.15 ,33.33
03,006,01,019,0352,0,2770 ,29 ,2799 ,4317 ,0,3,1,3,0,1,0,76.14,64.84 ,33.33
03,006,01,019,0353,0,1498 ,37 ,1535 ,2538 ,0,3,1,3,0,1,0,76.14,60.48 ,33.33
03,006,01,019,0354,0,2468 ,30 ,2498 ,3917 ,0,3,1,3,0,1,0,76.14,63.77 ,33.33
03,006,01,019,0355,0,2232 ,19 ,2251 ,3933 ,0,3,1,3,0,1,0,76.14,57.23 ,33.33
03,006,01,019,0356,0,2564 ,30 ,2594 ,4453 ,0,3,1,3,0,1,0,76.14,58.25 ,33.33
03,006,01,019,0357,0,1188 ,15 ,1203 ,2059 ,0,3,1,3,0,1,0,76.14,58.43 ,33.33
03,006,01,019,0358,0,2635 ,24 ,2659 ,4657 ,0,3,1,3,0,1,0,76.14,57.10 ,33.33
03,006,01,019,0359,0,900 ,8 ,908 ,1364 ,0,3,1,3,0,1,0,76.14,66.57 ,33.33
03,006,01,019,0360,0,3045 ,24 ,3069 ,5609 ,0,3,1,3,0,1,0,76.14,54.72 ,33.33
03,006,01,019,0361,0,1748 ,16 ,1764 ,3201 ,0,3,1,3,0,1,0,76.14,55.11 ,33.33
03,006,01,020,0362,0,732 ,7 ,739 ,1121 ,0,3,1,3,0,1,0,76.14,65.92 ,33.33
03,006,01,020,0363,0,4259 ,46 ,4305 ,7476 ,0,3,1,3,0,1,0,76.14,57.58 ,33.33
03,006,01,020,0364,0,2304 ,27 ,2331 ,3990 ,0,3,1,3,0,1,0,76.14,58.42 ,33.33
03,006,01,020,0365,0,1158 ,14 ,1172 ,1809 ,0,3,1,3,0,1,0,76.14,64.79 ,33.33
03,006,01,020,0366,0,1027 ,9 ,1036 ,1586 ,0,3,1,3,0,1,0,76.14,65.32 ,33.33
03,006,01,020,0367,0,583 ,8 ,591 ,937 ,0,3,1,3,0,1,0,76.14,63.07 ,33.33
03,006,01,020,0368,0,653 ,4 ,657 ,1077 ,0,3,1,3,0,1,0,76.14,61.00 ,33.33
03,006,01,020,0369,0,2822 ,30 ,2852 ,4866 ,0,3,1,3,0,1,0,76.14,58.61 ,33.33
03,006,01,020,0370,0,1863 ,19 ,1882 ,3073 ,0,3,1,3,0,1,0,76.14,61.24 ,33.33
03,006,01,020,0371,0,896 ,12 ,908 ,1458 ,0,3,1,3,0,1,0,76.14,62.28 ,33.33
03,006,01,020,0372,0,1241 ,9 ,1250 ,2000 ,0,3,1,3,0,1,0,76.14,62.50 ,33.33
03,006,01,020,0373,0,1593 ,23 ,1616 ,2388 ,0,3,1,3,0,1,0,76.14,67.67 ,33.33
03,006,01,020,0374,0,1236 ,12 ,1248 ,1982 ,0,3,1,3,0,1,0,76.14,62.97 ,33.33
03,006,01,020,0375,0,1038 ,14 ,1052 ,1685 ,0,3,1,3,0,1,0,76.14,62.43 ,33.33
03,006,01,020,0376,0,721 ,6 ,727 ,1163 ,0,3,1,3,0,1,0,76.14,62.51 ,33.33
03,006,01,020,0377,0,1463 ,23 ,1486 ,2400 ,0,3,1,3,0,1,0,76.14,61.92 ,33.33
03,006,01,020,0378,0,1236 ,17 ,1253 ,1967 ,0,3,1,3,0,1,0,76.14,63.70 ,33.33
03,006,01,020,0379,0,1826 ,17 ,1843 ,2850 ,0,3,1,3,0,1,0,76.14,64.67 ,33.33
03,006,01,020,0380,0,650 ,2 ,652 ,1039 ,0,3,1,3,0,1,0,76.14,62.75 ,33.33
03,006,01,020,0381,0,1447 ,30 ,1477 ,2198 ,0,3,1,3,0,1,0,76.14,67.20 ,33.33
03,006,01,021,0382,0,851 ,5 ,856 ,1405 ,0,3,1,3,0,1,0,76.14,60.93 ,33.33
03,006,01,021,0383,0,249 ,1 ,250 ,459 ,0,3,1,3,0,1,0,76.14,54.47 ,33.33
03,006,01,021,0384,0,580 ,7 ,587 ,1031 ,0,3,1,3,0,1,0,76.14,56.94 ,33.33
03,006,01,021,0385,0,279 ,1 ,280 ,526 ,0,3,1,3,0,1,0,76.14,53.23 ,33.33
03,006,01,021,0386,0,294 ,1 ,295 ,541 ,0,3,1,3,0,1,0,76.14,54.53 ,33.33
03,006,01,021,0387,0,226 ,1 ,227 ,371 ,0,3,1,3,0,1,0,76.14,61.19 ,33.33
03,006,01,021,0388,0,474 ,3 ,477 ,1304 ,0,3,1,3,0,1,0,76.14,36.58 ,33.33
03,006,01,021,0389,0,144 ,0 ,144 ,373 ,0,3,1,3,0,1,0,76.14,38.61 ,33.33
03,007,01,001,0001,0,1763 ,15 ,1778 ,2734 ,0,3,1,3,0,1,0,76.14,65.03 ,33.33
03,007,01,001,0002,0,1045 ,7 ,1052 ,1591 ,0,3,1,3,0,1,0,76.14,66.12 ,33.33
03,007,01,001,0003,0,957 ,6 ,963 ,1519 ,0,3,1,3,0,1,0,76.14,63.40 ,33.33
03,007,01,001,0004,0,1357 ,9 ,1366 ,2060 ,0,3,1,3,0,1,0,76.14,66.31 ,33.33
03,007,01,001,0005,0,692 ,6 ,698 ,1002 ,0,3,1,3,0,1,0,76.14,69.66 ,33.33
03,007,01,001,0006,0,1001 ,11 ,1012 ,1381 ,0,3,1,3,0,1,0,76.14,73.28 ,33.33
03,007,01,001,0007,0,1505 ,14 ,1519 ,2344 ,0,3,1,3,0,1,0,76.14,64.80 ,33.33
03,007,01,001,0008,0,493 ,6 ,499 ,758 ,0,3,1,3,0,1,0,76.14,65.83 ,33.33
03,007,01,001,0009,0,623 ,8 ,631 ,930 ,0,3,1,3,0,1,0,76.14,67.85 ,33.33
03,007,01,001,0010,0,533 ,0 ,533 ,799 ,0,3,1,3,0,1,0,76.14,66.71 ,33.33
03,007,01,001,0011,0,910 ,14 ,924 ,1423 ,0,3,1,3,0,1,0,76.14,64.93 ,33.33
03,007,01,001,0012,0,508 ,6 ,514 ,792 ,0,3,1,3,0,1,0,76.14,64.90 ,33.33
03,007,01,001,0013,0,1460 ,7 ,1467 ,2232 ,0,3,1,3,0,1,0,76.14,65.73 ,33.33
03,007,01,001,0014,0,1624 ,9 ,1633 ,2323 ,0,3,1,3,0,1,0,76.14,70.30 ,33.33
03,007,01,001,0015,0,1000 ,13 ,1013 ,1397 ,0,3,1,3,0,1,0,76.14,72.51 ,33.33
03,007,01,001,0016,0,1288 ,17 ,1305 ,2144 ,0,3,1,3,0,1,0,76.14,60.87 ,33.33
03,007,01,001,0017,0,3918 ,36 ,3954 ,6248 ,0,3,1,3,0,1,0,76.14,63.28 ,33.33
03,007,01,001,0018,0,2485 ,22 ,2507 ,3629 ,0,3,1,3,0,1,0,76.14,69.08 ,33.33
03,007,01,001,0019,0,3345 ,24 ,3369 ,5255 ,0,3,1,3,0,1,0,76.14,64.11 ,33.33
03,007,01,001,0020,0,4104 ,46 ,4150 ,6512 ,0,3,1,3,0,1,0,76.14,63.73 ,33.33
03,007,01,001,0021,0,1012 ,9 ,1021 ,1500 ,0,3,1,3,0,1,0,76.14,68.07 ,33.33
03,007,01,001,0022,0,746 ,6 ,752 ,1062 ,0,3,1,3,0,1,0,76.14,70.81 ,33.33
03,007,01,001,0023,0,1890 ,23 ,1913 ,2783 ,0,3,1,3,0,1,0,76.14,68.74 ,33.33
03,007,01,001,0024,0,1996 ,16 ,2012 ,3067 ,0,3,1,3,0,1,0,76.14,65.60 ,33.33
03,007,01,001,0025,0,626 ,6 ,632 ,884 ,0,3,1,3,0,1,0,76.14,71.49 ,33.33
03,007,01,001,0026,0,647 ,6 ,653 ,972 ,0,3,1,3,0,1,0,76.14,67.18 ,33.33
03,007,01,001,0027,0,839 ,13 ,852 ,1198 ,0,3,1,3,0,1,0,76.14,71.12 ,33.33
03,007,01,001,0028,0,657 ,7 ,664 ,968 ,0,3,1,3,0,1,0,76.14,68.60 ,33.33
03,007,01,001,0029,0,1642 ,18 ,1660 ,2469 ,0,3,1,3,0,1,0,76.14,67.23 ,33.33
03,007,01,001,0030,0,845 ,7 ,852 ,1229 ,0,3,1,3,0,1,0,76.14,69.32 ,33.33
03,007,01,001,0031,0,1810 ,19 ,1829 ,2662 ,0,3,1,3,0,1,0,76.14,68.71 ,33.33
03,007,01,001,0032,0,1783 ,16 ,1799 ,2769 ,0,3,1,3,0,1,0,76.14,64.97 ,33.33
03,007,01,001,0033,0,777 ,10 ,787 ,1178 ,0,3,1,3,0,1,0,76.14,66.81 ,33.33
03,007,01,001,0034,0,2065 ,22 ,2087 ,3327 ,0,3,1,3,0,1,0,76.14,62.73 ,33.33
03,007,01,001,0035,0,2249 ,18 ,2267 ,3539 ,0,3,1,3,0,1,0,76.14,64.06 ,33.33
03,007,01,001,0036,0,2922 ,31 ,2953 ,4468 ,0,3,1,3,0,1,0,76.14,66.09 ,33.33
03,007,01,001,0037,0,1996 ,19 ,2015 ,3048 ,0,3,1,3,0,1,0,76.14,66.11 ,33.33
03,007,01,001,0038,0,1674 ,17 ,1691 ,2511 ,0,3,1,3,0,1,0,76.14,67.34 ,33.33
03,007,01,001,0039,0,1056 ,14 ,1070 ,1511 ,0,3,1,3,0,1,0,76.14,70.81 ,33.33
03,007,01,001,0040,0,1173 ,7 ,1180 ,1781 ,0,3,1,3,0,1,0,76.14,66.25 ,33.33
03,007,01,001,0041,0,1918 ,22 ,1940 ,2855 ,0,3,1,3,0,1,0,76.14,67.95 ,33.33
03,007,01,001,0042,0,1815 ,23 ,1838 ,2747 ,0,3,1,3,0,1,0,76.14,66.91 ,33.33
03,007,01,001,0043,0,2592 ,38 ,2630 ,3998 ,0,3,1,3,0,1,0,76.14,65.78 ,33.33
03,007,01,001,0044,0,1171 ,11 ,1182 ,1792 ,0,3,1,3,0,1,0,76.14,65.96 ,33.33
03,007,01,001,0045,0,1019 ,9 ,1028 ,1589 ,0,3,1,3,0,1,0,76.14,64.69 ,33.33
03,007,01,001,0046,0,641 ,8 ,649 ,951 ,0,3,1,3,0,1,0,76.14,68.24 ,33.33
03,007,01,001,0047,0,964 ,9 ,973 ,1496 ,0,3,1,3,0,1,0,76.14,65.04 ,33.33
03,007,01,001,0048,0,940 ,5 ,945 ,1445 ,0,3,1,3,0,1,0,76.14,65.40 ,33.33
03,007,01,001,0049,0,1172 ,7 ,1179 ,1727 ,0,3,1,3,0,1,0,76.14,68.27 ,33.33
03,007,01,001,0050,0,2502 ,17 ,2519 ,3780 ,0,3,1,3,0,1,0,76.14,66.64 ,33.33
03,007,01,001,0051,0,2499 ,16 ,2515 ,3747 ,0,3,1,3,0,1,0,76.14,67.12 ,33.33
03,007,01,001,0052,0,580 ,9 ,589 ,818 ,0,3,1,3,0,1,0,76.14,72.00 ,33.33
03,007,01,001,0053,0,1565 ,10 ,1575 ,2224 ,0,3,1,3,0,1,0,76.14,70.82 ,33.33
03,007,01,001,0054,0,746 ,6 ,752 ,1042 ,0,3,1,3,0,1,0,76.14,72.17 ,33.33
03,007,01,001,0055,0,1457 ,16 ,1473 ,2258 ,0,3,1,3,0,1,0,76.14,65.23 ,33.33
03,007,01,001,0056,0,3723 ,45 ,3768 ,5828 ,0,3,1,3,0,1,0,76.14,64.65 ,33.33
03,007,01,001,0057,0,1438 ,17 ,1455 ,2288 ,0,3,1,3,0,1,0,76.14,63.59 ,33.33
03,007,01,001,0058,0,2649 ,29 ,2678 ,3982 ,0,3,1,3,0,1,0,76.14,67.25 ,33.33
03,007,01,001,0059,0,1389 ,19 ,1408 ,2145 ,0,3,1,3,0,1,0,76.14,65.64 ,33.33
03,007,01,001,0060,0,1065 ,18 ,1083 ,1631 ,0,3,1,3,0,1,0,76.14,66.40 ,33.33
03,007,01,001,0061,0,1783 ,19 ,1802 ,2626 ,0,3,1,3,0,1,0,76.14,68.62 ,33.33
03,007,01,001,0062,0,1993 ,18 ,2011 ,2820 ,0,3,1,3,0,1,0,76.14,71.31 ,33.33
03,007,01,001,0063,0,2321 ,17 ,2338 ,3654 ,0,3,1,3,0,1,0,76.14,63.98 ,33.33
03,007,01,001,0064,0,1627 ,12 ,1639 ,2242 ,0,3,1,3,0,1,0,76.14,73.10 ,33.33
03,007,01,001,0065,0,3761 ,43 ,3804 ,6011 ,0,3,1,3,0,1,0,76.14,63.28 ,33.33
03,007,01,001,0066,0,716 ,26 ,742 ,1109 ,0,3,1,3,0,1,0,76.14,66.91 ,33.33
03,007,01,001,0067,0,731 ,4 ,735 ,987 ,0,3,1,3,0,1,0,76.14,74.47 ,33.33
03,007,01,001,0068,0,1821 ,20 ,1841 ,2719 ,0,3,1,3,0,1,0,76.14,67.71 ,33.33
03,007,01,001,0069,0,652 ,3 ,655 ,803 ,0,3,1,3,0,1,0,76.14,81.57 ,33.33
03,007,01,001,0070,0,686 ,7 ,693 ,993 ,0,3,1,3,0,1,0,76.14,69.79 ,33.33
03,007,01,001,0071,0,570 ,3 ,573 ,782 ,0,3,1,3,0,1,0,76.14,73.27 ,33.33
03,007,01,001,0072,0,882 ,6 ,888 ,1201 ,0,3,1,3,0,1,0,76.14,73.94 ,33.33
03,007,01,001,0073,0,812 ,12 ,824 ,1133 ,0,3,1,3,0,1,0,76.14,72.73 ,33.33
03,007,01,002,0074,0,1997 ,12 ,2009 ,2805 ,0,3,1,3,0,1,0,76.14,71.62 ,33.33
03,007,01,002,0075,0,1124 ,15 ,1139 ,1611 ,0,3,1,3,0,1,0,76.14,70.70 ,33.33
03,007,01,002,0076,0,1511 ,14 ,1525 ,2216 ,0,3,1,3,0,1,0,76.14,68.82 ,33.33
03,007,01,002,0077,0,712 ,11 ,723 ,1015 ,0,3,1,3,0,1,0,76.14,71.23 ,33.33
03,007,01,002,0078,0,964 ,9 ,973 ,1332 ,0,3,1,3,0,1,0,76.14,73.05 ,33.33
03,007,01,002,0079,0,1018 ,15 ,1033 ,1472 ,0,3,1,3,0,1,0,76.14,70.18 ,33.33
03,007,01,002,0080,0,498 ,2 ,500 ,681 ,0,3,1,3,0,1,0,76.14,73.42 ,33.33
03,007,01,002,0081,0,1144 ,11 ,1155 ,1568 ,0,3,1,3,0,1,0,76.14,73.66 ,33.33
03,007,01,002,0082,0,2725 ,30 ,2755 ,3957 ,0,3,1,3,0,1,0,76.14,69.62 ,33.33
03,007,01,002,0083,0,1561 ,19 ,1580 ,2349 ,0,3,1,3,0,1,0,76.14,67.26 ,33.33
03,007,01,002,0084,0,2381 ,23 ,2404 ,3694 ,0,3,1,3,0,1,0,76.14,65.08 ,33.33
03,007,01,002,0085,0,900 ,10 ,910 ,1299 ,0,3,1,3,0,1,0,76.14,70.05 ,33.33
03,007,01,002,0086,0,1944 ,28 ,1972 ,2944 ,0,3,1,3,0,1,0,76.14,66.98 ,33.33
03,007,01,002,0087,0,561 ,5 ,566 ,832 ,0,3,1,3,0,1,0,76.14,68.03 ,33.33
03,007,01,002,0088,0,592 ,5 ,597 ,952 ,0,3,1,3,0,1,0,76.14,62.71 ,33.33
03,007,01,002,0089,0,1026 ,7 ,1033 ,1623 ,0,3,1,3,0,1,0,76.14,63.65 ,33.33
03,007,01,002,0090,0,882 ,9 ,891 ,1472 ,0,3,1,3,0,1,0,76.14,60.53 ,33.33
03,007,01,002,0091,0,953 ,8 ,961 ,1460 ,0,3,1,3,0,1,0,76.14,65.82 ,33.33
03,007,01,003,0092,0,1201 ,21 ,1222 ,1692 ,0,3,1,3,0,1,0,76.14,72.22 ,33.33
03,007,01,003,0093,0,981 ,12 ,993 ,1339 ,0,3,1,3,0,1,0,76.14,74.16 ,33.33
03,007,01,003,0094,0,1155 ,23 ,1178 ,1616 ,0,3,1,3,0,1,0,76.14,72.90 ,33.33
03,007,01,003,0095,0,429 ,3 ,432 ,561 ,0,3,1,3,0,1,0,76.14,77.01 ,33.33
03,007,01,003,0096,0,1608 ,16 ,1624 ,2251 ,0,3,1,3,0,1,0,76.14,72.15 ,33.33
03,007,01,003,0097,0,1473 ,23 ,1496 ,2178 ,0,3,1,3,0,1,0,76.14,68.69 ,33.33
03,007,01,003,0098,0,1045 ,24 ,1069 ,1539 ,0,3,1,3,0,1,0,76.14,69.46 ,33.33
03,007,01,003,0099,0,621 ,19 ,640 ,887 ,0,3,1,3,0,1,0,76.14,72.15 ,33.33
03,007,01,003,0100,0,673 ,9 ,682 ,937 ,0,3,1,3,0,1,0,76.14,72.79 ,33.33
03,007,01,003,0101,0,726 ,9 ,735 ,1054 ,0,3,1,3,0,1,0,76.14,69.73 ,33.33
03,007,01,003,0102,0,468 ,5 ,473 ,672 ,0,3,1,3,0,1,0,76.14,70.39 ,33.33
03,007,01,003,0103,0,1036 ,11 ,1047 ,1470 ,0,3,1,3,0,1,0,76.14,71.22 ,33.33
03,007,01,003,0104,0,871 ,9 ,880 ,1240 ,0,3,1,3,0,1,0,76.14,70.97 ,33.33
03,007,01,003,0105,0,651 ,8 ,659 ,973 ,0,3,1,3,0,1,0,76.14,67.73 ,33.33
03,007,01,003,0106,0,678 ,10 ,688 ,1046 ,0,3,1,3,0,1,0,76.14,65.77 ,33.33
03,007,01,004,0107,0,805 ,7 ,812 ,1167 ,0,3,1,3,0,1,0,76.14,69.58 ,33.33
03,007,01,004,0108,0,373 ,4 ,377 ,556 ,0,3,1,3,0,1,0,76.14,67.81 ,33.33
03,007,01,004,0109,0,662 ,7 ,669 ,976 ,0,3,1,3,0,1,0,76.14,68.55 ,33.33
03,007,01,004,0110,0,611 ,6 ,617 ,856 ,0,3,1,3,0,1,0,76.14,72.08 ,33.33
03,007,01,004,0111,0,679 ,6 ,685 ,978 ,0,3,1,3,0,1,0,76.14,70.04 ,33.33
03,007,01,004,0112,0,1265 ,14 ,1279 ,1919 ,0,3,1,3,0,1,0,76.14,66.65 ,33.33
03,007,01,004,0113,0,761 ,15 ,776 ,1176 ,0,3,1,3,0,1,0,76.14,65.99 ,33.33
03,007,01,004,0114,0,209 ,2 ,211 ,322 ,0,3,1,3,0,1,0,76.14,65.53 ,33.33
03,007,01,004,0115,0,497 ,5 ,502 ,648 ,0,3,1,3,0,1,0,76.14,77.47 ,33.33
03,007,01,004,0116,0,548 ,4 ,552 ,753 ,0,3,1,3,0,1,0,76.14,73.31 ,33.33
03,007,01,004,0117,0,824 ,15 ,839 ,1125 ,0,3,1,3,0,1,0,76.14,74.58 ,33.33
03,007,01,004,0118,0,398 ,4 ,402 ,595 ,0,3,1,3,0,1,0,76.14,67.56 ,33.33
03,007,01,004,0119,0,665 ,1 ,666 ,925 ,0,3,1,3,0,1,0,76.14,72.00 ,33.33
03,007,01,004,0120,0,864 ,11 ,875 ,1268 ,0,3,1,3,0,1,0,76.14,69.01 ,33.33
03,007,01,004,0121,0,2262 ,16 ,2278 ,3357 ,0,3,1,3,0,1,0,76.14,67.86 ,33.33
03,007,01,004,0122,0,2552 ,18 ,2570 ,3718 ,0,3,1,3,0,1,0,76.14,69.12 ,33.33
03,007,01,004,0123,0,2210 ,24 ,2234 ,3385 ,0,3,1,3,0,1,0,76.14,66.00 ,33.33
03,007,01,004,0124,0,3817 ,38 ,3855 ,5534 ,0,3,1,3,0,1,0,76.14,69.66 ,33.33
03,007,01,004,0125,0,2778 ,32 ,2810 ,4202 ,0,3,1,3,0,1,0,76.14,66.87 ,33.33
03,007,01,004,0126,0,2271 ,29 ,2300 ,3187 ,0,3,1,3,0,1,0,76.14,72.17 ,33.33
03,007,01,004,0127,0,1142 ,14 ,1156 ,1651 ,0,3,1,3,0,1,0,76.14,70.02 ,33.33
03,007,01,004,0128,0,2104 ,24 ,2128 ,2905 ,0,3,1,3,0,1,0,76.14,73.25 ,33.33
03,007,01,004,0129,0,1687 ,11 ,1698 ,2333 ,0,3,1,3,0,1,0,76.14,72.78 ,33.33
03,007,01,004,0130,0,2023 ,21 ,2044 ,2873 ,0,3,1,3,0,1,0,76.14,71.15 ,33.33
03,007,01,004,0131,0,2099 ,21 ,2120 ,2887 ,0,3,1,3,0,1,0,76.14,73.43 ,33.33
03,007,01,004,0132,0,1260 ,17 ,1277 ,1807 ,0,3,1,3,0,1,0,76.14,70.67 ,33.33
03,007,01,004,0133,0,1667 ,12 ,1679 ,2218 ,0,3,1,3,0,1,0,76.14,75.70 ,33.33
03,007,01,004,0134,0,2133 ,18 ,2151 ,3119 ,0,3,1,3,0,1,0,76.14,68.96 ,33.33
03,007,01,004,0135,0,2528 ,29 ,2557 ,3475 ,0,3,1,3,0,1,0,76.14,73.58 ,33.33
03,007,01,005,0136,0,1456 ,20 ,1476 ,2082 ,0,3,1,3,0,1,0,76.14,70.89 ,33.33
03,007,01,005,0137,0,804 ,7 ,811 ,1099 ,0,3,1,3,0,1,0,76.14,73.79 ,33.33
03,007,01,005,0138,0,796 ,21 ,817 ,1077 ,0,3,1,3,0,1,0,76.14,75.86 ,33.33
03,007,01,005,0139,0,920 ,17 ,937 ,1242 ,0,3,1,3,0,1,0,76.14,75.44 ,33.33
03,007,01,005,0140,0,517 ,10 ,527 ,727 ,0,3,1,3,0,1,0,76.14,72.49 ,33.33
03,007,01,005,0141,0,887 ,14 ,901 ,1159 ,0,3,1,3,0,1,0,76.14,77.74 ,33.33
03,007,01,005,0142,0,795 ,14 ,809 ,1081 ,0,3,1,3,0,1,0,76.14,74.84 ,33.33
03,007,01,005,0143,0,1575 ,17 ,1592 ,2201 ,0,3,1,3,0,1,0,76.14,72.33 ,33.33
03,007,01,005,0144,0,1021 ,26 ,1047 ,1342 ,0,3,1,3,0,1,0,76.14,78.02 ,33.33
03,007,01,005,0145,0,975 ,14 ,989 ,1273 ,0,3,1,3,0,1,0,76.14,77.69 ,33.33
03,007,01,005,0146,0,1526 ,19 ,1545 ,2093 ,0,3,1,3,0,1,0,76.14,73.82 ,33.33
03,007,01,005,0147,0,1207 ,11 ,1218 ,1686 ,0,3,1,3,0,1,0,76.14,72.24 ,33.33
03,007,01,005,0148,0,1460 ,21 ,1481 ,2092 ,0,3,1,3,0,1,0,76.14,70.79 ,33.33
03,007,01,005,0149,0,817 ,10 ,827 ,1100 ,0,3,1,3,0,1,0,76.14,75.18 ,33.33
03,007,01,005,0150,0,782 ,7 ,789 ,1033 ,0,3,1,3,0,1,0,76.14,76.38 ,33.33
03,007,01,005,0151,0,1518 ,22 ,1540 ,2102 ,0,3,1,3,0,1,0,76.14,73.26 ,33.33
03,007,01,005,0152,0,1359 ,16 ,1375 ,1826 ,0,3,1,3,0,1,0,76.14,75.30 ,33.33
03,007,01,005,0153,0,1561 ,24 ,1585 ,2088 ,0,3,1,3,0,1,0,76.14,75.91 ,33.33
03,007,01,005,0154,0,872 ,11 ,883 ,1192 ,0,3,1,3,0,1,0,76.14,74.08 ,33.33
03,007,01,005,0155,0,958 ,14 ,972 ,1272 ,0,3,1,3,0,1,0,76.14,76.42 ,33.33
03,007,01,005,0156,0,1972 ,23 ,1995 ,2862 ,0,3,1,3,0,1,0,76.14,69.71 ,33.33
03,007,01,005,0157,0,1606 ,17 ,1623 ,2177 ,0,3,1,3,0,1,0,76.14,74.55 ,33.33
03,007,01,006,0158,0,1118 ,13 ,1131 ,1616 ,0,3,1,3,0,1,0,76.14,69.99 ,33.33
03,007,01,006,0159,0,1037 ,18 ,1055 ,1480 ,0,3,1,3,0,1,0,76.14,71.28 ,33.33
03,007,01,006,0160,0,1413 ,12 ,1425 ,2069 ,0,3,1,3,0,1,0,76.14,68.87 ,33.33
03,007,01,006,0161,0,877 ,11 ,888 ,1186 ,0,3,1,3,0,1,0,76.14,74.87 ,33.33
03,007,01,006,0162,0,1169 ,18 ,1187 ,1658 ,0,3,1,3,0,1,0,76.14,71.59 ,33.33
03,007,01,006,0163,0,2201 ,38 ,2239 ,3262 ,0,3,1,3,0,1,0,76.14,68.64 ,33.33
03,007,01,006,0164,0,1891 ,19 ,1910 ,2652 ,0,3,1,3,0,1,0,76.14,72.02 ,33.33
03,007,01,006,0165,0,1464 ,15 ,1479 ,1999 ,0,3,1,3,0,1,0,76.14,73.99 ,33.33
03,007,01,006,0166,0,847 ,8 ,855 ,1129 ,0,3,1,3,0,1,0,76.14,75.73 ,33.33
03,007,01,006,0167,0,2438 ,35 ,2473 ,3573 ,0,3,1,3,0,1,0,76.14,69.21 ,33.33
03,007,01,006,0168,0,1185 ,13 ,1198 ,1756 ,0,3,1,3,0,1,0,76.14,68.22 ,33.33
03,007,01,006,0169,0,1035 ,15 ,1050 ,1366 ,0,3,1,3,0,1,0,76.14,76.87 ,33.33
03,007,01,006,0170,0,1022 ,10 ,1032 ,1428 ,0,3,1,3,0,1,0,76.14,72.27 ,33.33
03,007,01,006,0171,0,1411 ,17 ,1428 ,1908 ,0,3,1,3,0,1,0,76.14,74.84 ,33.33
03,007,01,007,0172,0,2725 ,33 ,2758 ,4182 ,0,3,1,3,0,1,0,76.14,65.95 ,33.33
03,007,01,007,0173,0,2271 ,17 ,2288 ,3557 ,0,3,1,3,0,1,0,76.14,64.32 ,33.33
03,007,01,007,0174,0,351 ,2 ,353 ,444 ,0,3,1,3,0,1,0,76.14,79.50 ,33.33
03,007,01,007,0175,0,934 ,10 ,944 ,1401 ,0,3,1,3,0,1,0,76.14,67.38 ,33.33
03,007,01,007,0176,0,1991 ,17 ,2008 ,3115 ,0,3,1,3,0,1,0,76.14,64.46 ,33.33
03,007,01,007,0177,0,1565 ,15 ,1580 ,2426 ,0,3,1,3,0,1,0,76.14,65.13 ,33.33
03,007,01,007,0178,0,990 ,17 ,1007 ,1389 ,0,3,1,3,0,1,0,76.14,72.50 ,33.33
03,007,01,007,0179,0,609 ,1 ,610 ,778 ,0,3,1,3,0,1,0,76.14,78.41 ,33.33
03,007,01,007,0180,0,1238 ,19 ,1257 ,1726 ,0,3,1,3,0,1,0,76.14,72.83 ,33.33
03,007,01,007,0181,0,1665 ,19 ,1684 ,2446 ,0,3,1,3,0,1,0,76.14,68.85 ,33.33
03,007,01,007,0182,0,917 ,6 ,923 ,1246 ,0,3,1,3,0,1,0,76.14,74.08 ,33.33
03,007,01,007,0183,0,1141 ,14 ,1155 ,1543 ,0,3,1,3,0,1,0,76.14,74.85 ,33.33
03,007,01,007,0184,0,1198 ,13 ,1211 ,1760 ,0,3,1,3,0,1,0,76.14,68.81 ,33.33
03,007,01,007,0185,0,872 ,11 ,883 ,1238 ,0,3,1,3,0,1,0,76.14,71.32 ,33.33
03,007,01,007,0186,0,3641 ,29 ,3670 ,5672 ,0,3,1,3,0,1,0,76.14,64.70 ,33.33
03,007,01,007,0187,0,1027 ,15 ,1042 ,1544 ,0,3,1,3,0,1,0,76.14,67.49 ,33.33
03,007,01,007,0188,0,1120 ,9 ,1129 ,1715 ,0,3,1,3,0,1,0,76.14,65.83 ,33.33
03,007,01,007,0189,0,1649 ,20 ,1669 ,2417 ,0,3,1,3,0,1,0,76.14,69.05 ,33.33
03,007,01,007,0190,0,1941 ,18 ,1959 ,2661 ,0,3,1,3,0,1,0,76.14,73.62 ,33.33
03,007,01,007,0191,0,620 ,10 ,630 ,793 ,0,3,1,3,0,1,0,76.14,79.45 ,33.33
03,007,01,007,0192,0,1483 ,20 ,1503 ,2271 ,0,3,1,3,0,1,0,76.14,66.18 ,33.33
03,007,01,007,0193,0,1477 ,19 ,1496 ,2070 ,0,3,1,3,0,1,0,76.14,72.27 ,33.33
03,007,01,007,0194,0,802 ,10 ,812 ,1083 ,0,3,1,3,0,1,0,76.14,74.98 ,33.33
03,007,01,007,0195,0,1714 ,26 ,1740 ,2578 ,0,3,1,3,0,1,0,76.14,67.49 ,33.33
03,007,01,007,0196,0,1929 ,17 ,1946 ,2772 ,0,3,1,3,0,1,0,76.14,70.20 ,33.33
03,007,01,007,0197,0,1118 ,10 ,1128 ,1652 ,0,3,1,3,0,1,0,76.14,68.28 ,33.33
03,007,01,007,0198,0,584 ,9 ,593 ,856 ,0,3,1,3,0,1,0,76.14,69.28 ,33.33
03,007,01,007,0199,0,833 ,8 ,841 ,1205 ,0,3,1,3,0,1,0,76.14,69.79 ,33.33
03,007,01,007,0200,0,1259 ,26 ,1285 ,1714 ,0,3,1,3,0,1,0,76.14,74.97 ,33.33
03,007,01,007,0201,0,1905 ,22 ,1927 ,2855 ,0,3,1,3,0,1,0,76.14,67.50 ,33.33
03,007,01,007,0202,0,1201 ,10 ,1211 ,1643 ,0,3,1,3,0,1,0,76.14,73.71 ,33.33
03,007,01,008,0203,0,1332 ,22 ,1354 ,1930 ,0,3,1,3,0,1,0,76.14,70.16 ,33.33
03,007,01,008,0204,0,780 ,15 ,795 ,1148 ,0,3,1,3,0,1,0,76.14,69.25 ,33.33
03,007,01,008,0205,0,1336 ,26 ,1362 ,2019 ,0,3,1,3,0,1,0,76.14,67.46 ,33.33
03,007,01,008,0206,0,872 ,10 ,882 ,1157 ,0,3,1,3,0,1,0,76.14,76.23 ,33.33
03,007,01,008,0207,0,710 ,6 ,716 ,1034 ,0,3,1,3,0,1,0,76.14,69.25 ,33.33
03,007,01,008,0208,0,1188 ,13 ,1201 ,1679 ,0,3,1,3,0,1,0,76.14,71.53 ,33.33
03,007,01,008,0209,0,1531 ,15 ,1546 ,2167 ,0,3,1,3,0,1,0,76.14,71.34 ,33.33
03,007,01,008,0210,0,794 ,7 ,801 ,1096 ,0,3,1,3,0,1,0,76.14,73.08 ,33.33
03,007,01,009,0211,0,2740 ,35 ,2775 ,4280 ,0,3,1,3,0,1,0,76.14,64.84 ,33.33
03,007,01,009,0212,0,1074 ,16 ,1090 ,1545 ,0,3,1,3,0,1,0,76.14,70.55 ,33.33
03,007,01,009,0213,0,873 ,10 ,883 ,1224 ,0,3,1,3,0,1,0,76.14,72.14 ,33.33
03,007,01,009,0214,0,1210 ,19 ,1229 ,1630 ,0,3,1,3,0,1,0,76.14,75.40 ,33.33
03,007,01,009,0215,0,1109 ,9 ,1118 ,1550 ,0,3,1,3,0,1,0,76.14,72.13 ,33.33
03,007,01,009,0216,0,1100 ,12 ,1112 ,1582 ,0,3,1,3,0,1,0,76.14,70.29 ,33.33
03,007,01,009,0217,0,1418 ,13 ,1431 ,2217 ,0,3,1,3,0,1,0,76.14,64.55 ,33.33
03,007,01,009,0218,0,1214 ,18 ,1232 ,1692 ,0,3,1,3,0,1,0,76.14,72.81 ,33.33
03,007,01,009,0219,0,823 ,9 ,832 ,1200 ,0,3,1,3,0,1,0,76.14,69.33 ,33.33
03,007,01,009,0220,0,1010 ,18 ,1028 ,1491 ,0,3,1,3,0,1,0,76.14,68.95 ,33.33
03,007,01,009,0221,0,814 ,11 ,825 ,1144 ,0,3,1,3,0,1,0,76.14,72.12 ,33.33
03,007,01,009,0222,0,651 ,7 ,658 ,974 ,0,3,1,3,0,1,0,76.14,67.56 ,33.33
03,007,01,009,0223,0,1428 ,13 ,1441 ,2000 ,0,3,1,3,0,1,0,76.14,72.05 ,33.33
03,007,01,009,0224,0,1433 ,21 ,1454 ,1986 ,0,3,1,3,0,1,0,76.14,73.21 ,33.33
03,007,01,010,0225,0,709 ,12 ,721 ,1105 ,0,3,1,3,0,1,0,76.14,65.25 ,33.33
03,007,01,010,0226,0,1704 ,17 ,1721 ,2611 ,0,3,1,3,0,1,0,76.14,65.91 ,33.33
03,007,01,010,0227,0,1779 ,24 ,1803 ,2902 ,0,3,1,3,0,1,0,76.14,62.13 ,33.33
03,007,01,010,0228,0,1735 ,11 ,1746 ,2667 ,0,3,1,3,0,1,0,76.14,65.47 ,33.33
03,007,01,010,0229,0,544 ,6 ,550 ,799 ,0,3,1,3,0,1,0,76.14,68.84 ,33.33
03,007,01,010,0230,0,1711 ,21 ,1732 ,2707 ,0,3,1,3,0,1,0,76.14,63.98 ,33.33
03,007,01,010,0231,0,636 ,4 ,640 ,933 ,0,3,1,3,0,1,0,76.14,68.60 ,33.33
03,007,01,010,0232,0,497 ,3 ,500 ,695 ,0,3,1,3,0,1,0,76.14,71.94 ,33.33
03,007,01,010,0233,0,1176 ,11 ,1187 ,1723 ,0,3,1,3,0,1,0,76.14,68.89 ,33.33
03,007,01,010,0234,0,2832 ,35 ,2867 ,4597 ,0,3,1,3,0,1,0,76.14,62.37 ,33.33
03,007,01,010,0235,0,1451 ,18 ,1469 ,2283 ,0,3,1,3,0,1,0,76.14,64.35 ,33.33
03,007,01,010,0236,0,2499 ,27 ,2526 ,3766 ,0,3,1,3,0,1,0,76.14,67.07 ,33.33
03,007,01,010,0237,0,2306 ,23 ,2329 ,3573 ,0,3,1,3,0,1,0,76.14,65.18 ,33.33
03,007,01,010,0238,0,2697 ,30 ,2727 ,4195 ,0,3,1,3,0,1,0,76.14,65.01 ,33.33
03,007,01,010,0239,0,1013 ,6 ,1019 ,1525 ,0,3,1,3,0,1,0,76.14,66.82 ,33.33
03,007,01,010,0240,0,1207 ,18 ,1225 ,1796 ,0,3,1,3,0,1,0,76.14,68.21 ,33.33
03,007,01,010,0241,0,889 ,6 ,895 ,1304 ,0,3,1,3,0,1,0,76.14,68.63 ,33.33
03,007,01,010,0242,0,1211 ,14 ,1225 ,1862 ,0,3,1,3,0,1,0,76.14,65.79 ,33.33
03,007,01,010,0243,0,1298 ,12 ,1310 ,2078 ,0,3,1,3,0,1,0,76.14,63.04 ,33.33
03,007,01,010,0244,0,2981 ,35 ,3016 ,5130 ,0,3,1,3,0,1,0,76.14,58.79 ,33.33
03,007,01,010,0245,0,1621 ,19 ,1640 ,2545 ,0,3,1,3,0,1,0,76.14,64.44 ,33.33
03,007,01,010,0246,0,1526 ,12 ,1538 ,2474 ,0,3,1,3,0,1,0,76.14,62.17 ,33.33
03,007,01,010,0247,0,1205 ,14 ,1219 ,1909 ,0,3,1,3,0,1,0,76.14,63.86 ,33.33
03,007,01,010,0248,0,1230 ,19 ,1249 ,2011 ,0,3,1,3,0,1,0,76.14,62.11 ,33.33
03,007,01,010,0249,0,968 ,18 ,986 ,1576 ,0,3,1,3,0,1,0,76.14,62.56 ,33.33
03,007,01,010,0250,0,1384 ,11 ,1395 ,2110 ,0,3,1,3,0,1,0,76.14,66.11 ,33.33
03,007,01,010,0251,0,1642 ,22 ,1664 ,2507 ,0,3,1,3,0,1,0,76.14,66.37 ,33.33
03,007,01,010,0252,0,1359 ,13 ,1372 ,2018 ,0,3,1,3,0,1,0,76.14,67.99 ,33.33
03,007,01,010,0253,0,2066 ,14 ,2080 ,3117 ,0,3,1,3,0,1,0,76.14,66.73 ,33.33
03,007,01,010,0254,0,1602 ,17 ,1619 ,2249 ,0,3,1,3,0,1,0,76.14,71.99 ,33.33
03,007,01,010,0255,0,1439 ,23 ,1462 ,2254 ,0,3,1,3,0,1,0,76.14,64.86 ,33.33
03,007,01,010,0256,0,1420 ,10 ,1430 ,2278 ,0,3,1,3,0,1,0,76.14,62.77 ,33.33
03,007,01,010,0257,0,1141 ,14 ,1155 ,1695 ,0,3,1,3,0,1,0,76.14,68.14 ,33.33
03,007,01,010,0258,0,774 ,8 ,782 ,1264 ,0,3,1,3,0,1,0,76.14,61.87 ,33.33
03,007,01,010,0259,0,451 ,6 ,457 ,733 ,0,3,1,3,0,1,0,76.14,62.35 ,33.33
03,007,01,010,0260,0,1204 ,12 ,1216 ,1853 ,0,3,1,3,0,1,0,76.14,65.62 ,33.33
03,007,01,010,0261,0,1277 ,14 ,1291 ,2040 ,0,3,1,3,0,1,0,76.14,63.28 ,33.33
03,007,01,010,0262,0,1043 ,12 ,1055 ,1685 ,0,3,1,3,0,1,0,76.14,62.61 ,33.33
03,007,01,010,0263,0,1076 ,11 ,1087 ,1643 ,0,3,1,3,0,1,0,76.14,66.16 ,33.33
03,007,01,010,0264,0,917 ,17 ,934 ,1527 ,0,3,1,3,0,1,0,76.14,61.17 ,33.33
03,007,01,010,0265,0,1315 ,21 ,1336 ,2033 ,0,3,1,3,0,1,0,76.14,65.72 ,33.33
03,007,01,011,0266,0,1487 ,15 ,1502 ,2125 ,0,3,1,3,0,1,0,76.14,70.68 ,33.33
03,007,01,011,0267,0,1055 ,14 ,1069 ,1553 ,0,3,1,3,0,1,0,76.14,68.83 ,33.33
03,007,01,011,0268,0,655 ,9 ,664 ,925 ,0,3,1,3,0,1,0,76.14,71.78 ,33.33
03,007,01,011,0269,0,946 ,7 ,953 ,1373 ,0,3,1,3,0,1,0,76.14,69.41 ,33.33
03,007,01,011,0270,0,908 ,11 ,919 ,1281 ,0,3,1,3,0,1,0,76.14,71.74 ,33.33
03,007,01,011,0271,0,953 ,7 ,960 ,1453 ,0,3,1,3,0,1,0,76.14,66.07 ,33.33
03,007,01,011,0272,0,732 ,6 ,738 ,1099 ,0,3,1,3,0,1,0,76.14,67.15 ,33.33
03,007,01,011,0273,0,836 ,7 ,843 ,1187 ,0,3,1,3,0,1,0,76.14,71.02 ,33.33
03,007,01,011,0274,0,1452 ,9 ,1461 ,2163 ,0,3,1,3,0,1,0,76.14,67.55 ,33.33
03,007,01,011,0275,0,1458 ,12 ,1470 ,2159 ,0,3,1,3,0,1,0,76.14,68.09 ,33.33
03,007,01,011,0276,0,1201 ,17 ,1218 ,1800 ,0,3,1,3,0,1,0,76.14,67.67 ,33.33
03,007,01,011,0277,0,922 ,5 ,927 ,1243 ,0,3,1,3,0,1,0,76.14,74.58 ,33.33
03,007,01,011,0278,0,1662 ,8 ,1670 ,2540 ,0,3,1,3,0,1,0,76.14,65.75 ,33.33
03,007,01,011,0279,0,1164 ,15 ,1179 ,1791 ,0,3,1,3,0,1,0,76.14,65.83 ,33.33
03,007,01,011,0280,0,1123 ,11 ,1134 ,1760 ,0,3,1,3,0,1,0,76.14,64.43 ,33.33
03,007,01,011,0281,0,1339 ,21 ,1360 ,2024 ,0,3,1,3,0,1,0,76.14,67.19 ,33.33
03,007,01,012,0282,0,588 ,5 ,593 ,794 ,0,3,1,3,0,1,0,76.14,74.69 ,33.33
03,007,01,012,0283,0,975 ,4 ,979 ,1469 ,0,3,1,3,0,1,0,76.14,66.64 ,33.33
03,007,01,012,0284,0,1228 ,13 ,1241 ,1846 ,0,3,1,3,0,1,0,76.14,67.23 ,33.33
03,007,01,012,0285,0,1276 ,6 ,1282 ,1910 ,0,3,1,3,0,1,0,76.14,67.12 ,33.33
03,007,01,012,0286,0,1091 ,12 ,1103 ,1634 ,0,3,1,3,0,1,0,76.14,67.50 ,33.33
03,007,01,012,0287,0,870 ,17 ,887 ,1374 ,0,3,1,3,0,1,0,76.14,64.56 ,33.33
03,007,01,012,0288,0,693 ,7 ,700 ,955 ,0,3,1,3,0,1,0,76.14,73.30 ,33.33
03,007,01,012,0289,0,628 ,13 ,641 ,875 ,0,3,1,3,0,1,0,76.14,73.26 ,33.33
03,007,01,012,0290,0,1432 ,18 ,1450 ,2107 ,0,3,1,3,0,1,0,76.14,68.82 ,33.33
03,007,01,012,0291,0,912 ,8 ,920 ,1356 ,0,3,1,3,0,1,0,76.14,67.85 ,33.33
03,007,01,012,0292,0,802 ,12 ,814 ,1065 ,0,3,1,3,0,1,0,76.14,76.43 ,33.33
03,007,01,012,0293,0,1070 ,20 ,1090 ,1550 ,0,3,1,3,0,1,0,76.14,70.32 ,33.33
03,007,01,012,0294,0,1156 ,17 ,1173 ,1657 ,0,3,1,3,0,1,0,76.14,70.79 ,33.33
03,007,01,012,0295,0,1077 ,9 ,1086 ,1524 ,0,3,1,3,0,1,0,76.14,71.26 ,33.33
03,007,01,012,0296,0,805 ,7 ,812 ,1206 ,0,3,1,3,0,1,0,76.14,67.33 ,33.33
03,007,01,012,0297,0,612 ,3 ,615 ,866 ,0,3,1,3,0,1,0,76.14,71.02 ,33.33
03,007,01,012,0298,0,497 ,10 ,507 ,720 ,0,3,1,3,0,1,0,76.14,70.42 ,33.33
03,007,01,012,0299,0,532 ,3 ,535 ,740 ,0,3,1,3,0,1,0,76.14,72.30 ,33.33
03,007,01,012,0300,0,477 ,8 ,485 ,687 ,0,3,1,3,0,1,0,76.14,70.60 ,33.33
03,007,01,012,0301,0,651 ,8 ,659 ,951 ,0,3,1,3,0,1,0,76.14,69.30 ,33.33
03,007,01,012,0302,0,614 ,8 ,622 ,835 ,0,3,1,3,0,1,0,76.14,74.49 ,33.33
03,007,01,012,0303,0,462 ,3 ,465 ,681 ,0,3,1,3,0,1,0,76.14,68.28 ,33.33
03,007,01,012,0304,0,809 ,10 ,819 ,1130 ,0,3,1,3,0,1,0,76.14,72.48 ,33.33
03,007,01,012,0305,0,969 ,5 ,974 ,1348 ,0,3,1,3,0,1,0,76.14,72.26 ,33.33
03,007,01,013,0306,0,866 ,4 ,870 ,1245 ,0,3,1,3,0,1,0,76.14,69.88 ,33.33
03,007,01,013,0307,0,562 ,5 ,567 ,748 ,0,3,1,3,0,1,0,76.14,75.80 ,33.33
03,007,01,013,0308,0,978 ,14 ,992 ,1404 ,0,3,1,3,0,1,0,76.14,70.66 ,33.33
03,007,01,013,0309,0,350 ,1 ,351 ,479 ,0,3,1,3,0,1,0,76.14,73.28 ,33.33
03,007,01,013,0310,0,1868 ,19 ,1887 ,2855 ,0,3,1,3,0,1,0,76.14,66.09 ,33.33
03,007,01,013,0311,0,1317 ,11 ,1328 ,1851 ,0,3,1,3,0,1,0,76.14,71.75 ,33.33
03,007,01,013,0312,0,1564 ,20 ,1584 ,2255 ,0,3,1,3,0,1,0,76.14,70.24 ,33.33
03,007,01,013,0313,0,901 ,5 ,906 ,1255 ,0,3,1,3,0,1,0,76.14,72.19 ,33.33
03,007,01,013,0314,0,1666 ,9 ,1675 ,2371 ,0,3,1,3,0,1,0,76.14,70.65 ,33.33
03,007,01,013,0315,0,1565 ,14 ,1579 ,2255 ,0,3,1,3,0,1,0,76.14,70.02 ,33.33
03,007,01,013,0316,0,1330 ,7 ,1337 ,1969 ,0,3,1,3,0,1,0,76.14,67.90 ,33.33
03,007,01,013,0317,0,567 ,6 ,573 ,755 ,0,3,1,3,0,1,0,76.14,75.89 ,33.33
03,007,01,013,0318,0,1123 ,11 ,1134 ,1650 ,0,3,1,3,0,1,0,76.14,68.73 ,33.33
03,007,01,013,0319,0,1545 ,19 ,1564 ,2220 ,0,3,1,3,0,1,0,76.14,70.45 ,33.33
03,007,01,013,0320,0,542 ,4 ,546 ,777 ,0,3,1,3,0,1,0,76.14,70.27 ,33.33
03,007,01,013,0321,0,850 ,11 ,861 ,1262 ,0,3,1,3,0,1,0,76.14,68.23 ,33.33
03,007,01,013,0322,0,1029 ,10 ,1039 ,1553 ,0,3,1,3,0,1,0,76.14,66.90 ,33.33
03,007,01,013,0323,0,2456 ,16 ,2472 ,3643 ,0,3,1,3,0,1,0,76.14,67.86 ,33.33
03,007,01,013,0324,0,463 ,10 ,473 ,640 ,0,3,1,3,0,1,0,76.14,73.91 ,33.33
03,007,01,013,0325,0,927 ,7 ,934 ,1254 ,0,3,1,3,0,1,0,76.14,74.48 ,33.33
03,007,01,013,0326,0,522 ,9 ,531 ,721 ,0,3,1,3,0,1,0,76.14,73.65 ,33.33
03,007,01,013,0327,0,866 ,11 ,877 ,1271 ,0,3,1,3,0,1,0,76.14,69.00 ,33.33
03,007,01,013,0328,0,942 ,8 ,950 ,1325 ,0,3,1,3,0,1,0,76.14,71.70 ,33.33
03,007,01,013,0329,0,1317 ,15 ,1332 ,1921 ,0,3,1,3,0,1,0,76.14,69.34 ,33.33
03,007,01,013,0330,0,1021 ,8 ,1029 ,1540 ,0,3,1,3,0,1,0,76.14,66.82 ,33.33
03,007,01,014,0331,0,1074 ,17 ,1091 ,1520 ,0,3,1,3,0,1,0,76.14,71.78 ,33.33
03,007,01,014,0332,0,1072 ,14 ,1086 ,1473 ,0,3,1,3,0,1,0,76.14,73.73 ,33.33
03,007,01,014,0333,0,907 ,9 ,916 ,1168 ,0,3,1,3,0,1,0,76.14,78.42 ,33.33
03,007,01,014,0334,0,650 ,10 ,660 ,834 ,0,3,1,3,0,1,0,76.14,79.14 ,33.33
03,007,01,014,0335,0,1251 ,13 ,1264 ,1631 ,0,3,1,3,0,1,0,76.14,77.50 ,33.33
03,007,01,014,0336,0,726 ,7 ,733 ,924 ,0,3,1,3,0,1,0,76.14,79.33 ,33.33
03,007,01,014,0337,0,902 ,23 ,925 ,1283 ,0,3,1,3,0,1,0,76.14,72.10 ,33.33
03,007,01,014,0338,0,780 ,10 ,790 ,1036 ,0,3,1,3,0,1,0,76.14,76.25 ,33.33
03,007,01,014,0339,0,558 ,6 ,564 ,702 ,0,3,1,3,0,1,0,76.14,80.34 ,33.33
03,007,01,014,0340,0,889 ,9 ,898 ,1158 ,0,3,1,3,0,1,0,76.14,77.55 ,33.33
03,007,01,014,0341,0,1000 ,25 ,1025 ,1365 ,0,3,1,3,0,1,0,76.14,75.09 ,33.33
03,007,01,014,0342,0,1506 ,10 ,1516 ,1949 ,0,3,1,3,0,1,0,76.14,77.78 ,33.33
03,007,01,014,0343,0,956 ,9 ,965 ,1241 ,0,3,1,3,0,1,0,76.14,77.76 ,33.33
03,007,01,014,0344,0,298 ,3 ,301 ,393 ,0,3,1,3,0,1,0,76.14,76.59 ,33.33
03,007,01,014,0345,0,762 ,9 ,771 ,1058 ,0,3,1,3,0,1,0,76.14,72.87 ,33.33
03,007,01,014,0346,0,609 ,7 ,616 ,770 ,0,3,1,3,0,1,0,76.14,80.00 ,33.33
03,007,01,014,0347,0,978 ,12 ,990 ,1315 ,0,3,1,3,0,1,0,76.14,75.29 ,33.33
03,007,01,014,0348,0,666 ,3 ,669 ,826 ,0,3,1,3,0,1,0,76.14,80.99 ,33.33
03,007,01,014,0349,0,1056 ,10 ,1066 ,1463 ,0,3,1,3,0,1,0,76.14,72.86 ,33.33
03,007,01,014,0350,0,1053 ,9 ,1062 ,1369 ,0,3,1,3,0,1,0,76.14,77.57 ,33.33
03,007,01,014,0351,0,1003 ,11 ,1014 ,1264 ,0,3,1,3,0,1,0,76.14,80.22 ,33.33
03,007,01,014,0352,0,936 ,14 ,950 ,1244 ,0,3,1,3,0,1,0,76.14,76.37 ,33.33
03,007,01,015,0353,0,1827 ,22 ,1849 ,2725 ,0,3,1,3,0,1,0,76.14,67.85 ,33.33
03,007,01,015,0354,0,831 ,7 ,838 ,1211 ,0,3,1,3,0,1,0,76.14,69.20 ,33.33
03,007,01,015,0355,0,996 ,10 ,1006 ,1450 ,0,3,1,3,0,1,0,76.14,69.38 ,33.33
03,007,01,015,0356,0,817 ,12 ,829 ,1132 ,0,3,1,3,0,1,0,76.14,73.23 ,33.33
03,007,01,015,0357,0,1093 ,21 ,1114 ,1621 ,0,3,1,3,0,1,0,76.14,68.72 ,33.33
03,007,01,015,0358,0,1144 ,11 ,1155 ,1733 ,0,3,1,3,0,1,0,76.14,66.65 ,33.33
03,007,01,015,0359,0,910 ,7 ,917 ,1329 ,0,3,1,3,0,1,0,76.14,69.00 ,33.33
03,007,01,015,0360,0,1089 ,7 ,1096 ,1688 ,0,3,1,3,0,1,0,76.14,64.93 ,33.33
03,007,01,015,0361,0,1240 ,17 ,1257 ,1794 ,0,3,1,3,0,1,0,76.14,70.07 ,33.33
03,007,01,015,0362,0,430 ,7 ,437 ,589 ,0,3,1,3,0,1,0,76.14,74.19 ,33.33
03,007,01,015,0363,0,714 ,9 ,723 ,1070 ,0,3,1,3,0,1,0,76.14,67.57 ,33.33
03,007,01,015,0364,0,792 ,7 ,799 ,1159 ,0,3,1,3,0,1,0,76.14,68.94 ,33.33
03,007,01,015,0365,0,530 ,5 ,535 ,839 ,0,3,1,3,0,1,0,76.14,63.77 ,33.33
03,007,01,015,0366,0,597 ,8 ,605 ,891 ,0,3,1,3,0,1,0,76.14,67.90 ,33.33
03,007,01,015,0367,0,1168 ,12 ,1180 ,1704 ,0,3,1,3,0,1,0,76.14,69.25 ,33.33
03,007,01,015,0368,0,932 ,9 ,941 ,1322 ,0,3,1,3,0,1,0,76.14,71.18 ,33.33
03,007,01,015,0369,0,634 ,5 ,639 ,868 ,0,3,1,3,0,1,0,76.14,73.62 ,33.33
03,007,01,015,0370,0,891 ,9 ,900 ,1202 ,0,3,1,3,0,1,0,76.14,74.88 ,33.33
03,007,01,015,0371,0,545 ,4 ,549 ,766 ,0,3,1,3,0,1,0,76.14,71.67 ,33.33
03,007,01,015,0372,0,608 ,10 ,618 ,844 ,0,3,1,3,0,1,0,76.14,73.22 ,33.33
03,007,01,016,0373,0,579 ,7 ,586 ,868 ,0,3,1,3,0,1,0,76.14,67.51 ,33.33
03,007,01,016,0374,0,1048 ,16 ,1064 ,1998 ,0,3,1,3,0,1,0,76.14,53.25 ,33.33
03,007,01,016,0375,0,397 ,3 ,400 ,624 ,0,3,1,3,0,1,0,76.14,64.10 ,33.33
03,007,01,016,0376,0,997 ,15 ,1012 ,1487 ,0,3,1,3,0,1,0,76.14,68.06 ,33.33
03,007,01,016,0377,0,979 ,11 ,990 ,1468 ,0,3,1,3,0,1,0,76.14,67.44 ,33.33
03,007,01,016,0378,0,804 ,6 ,810 ,1232 ,0,3,1,3,0,1,0,76.14,65.75 ,33.33
03,007,01,016,0379,0,1069 ,9 ,1078 ,1691 ,0,3,1,3,0,1,0,76.14,63.75 ,33.33
03,007,01,016,0380,0,454 ,6 ,460 ,646 ,0,3,1,3,0,1,0,76.14,71.21 ,33.33
03,007,01,016,0381,0,1900 ,16 ,1916 ,2848 ,0,3,1,3,0,1,0,76.14,67.28 ,33.33
03,007,01,016,0382,0,1436 ,15 ,1451 ,2152 ,0,3,1,3,0,1,0,76.14,67.43 ,33.33
03,007,01,016,0383,0,718 ,6 ,724 ,1100 ,0,3,1,3,0,1,0,76.14,65.82 ,33.33
03,007,01,016,0384,0,869 ,9 ,878 ,1282 ,0,3,1,3,0,1,0,76.14,68.49 ,33.33
03,007,01,016,0385,0,1321 ,12 ,1333 ,1979 ,0,3,1,3,0,1,0,76.14,67.36 ,33.33
03,007,01,016,0386,0,1310 ,18 ,1328 ,2069 ,0,3,1,3,0,1,0,76.14,64.19 ,33.33
03,007,01,016,0387,0,1090 ,19 ,1109 ,1609 ,0,3,1,3,0,1,0,76.14,68.92 ,33.33
03,007,01,016,0388,0,897 ,7 ,904 ,1316 ,0,3,1,3,0,1,0,76.14,68.69 ,33.33
03,007,01,016,0389,0,998 ,20 ,1018 ,1644 ,0,3,1,3,0,1,0,76.14,61.92 ,33.33
03,007,01,016,0390,0,2232 ,17 ,2249 ,3457 ,0,3,1,3,0,1,0,76.14,65.06 ,33.33
03,007,01,016,0391,0,884 ,8 ,892 ,1323 ,0,3,1,3,0,1,0,76.14,67.42 ,33.33
03,007,01,016,0392,0,987 ,11 ,998 ,1520 ,0,3,1,3,0,1,0,76.14,65.66 ,33.33
03,007,01,016,0393,0,611 ,7 ,618 ,888 ,0,3,1,3,0,1,0,76.14,69.59 ,33.33
03,007,01,016,0394,0,560 ,1 ,561 ,815 ,0,3,1,3,0,1,0,76.14,68.83 ,33.33
03,007,01,017,0395,0,1749 ,8 ,1757 ,2581 ,0,3,1,3,0,1,0,76.14,68.07 ,33.33
03,007,01,017,0396,0,2565 ,36 ,2601 ,3832 ,0,3,1,3,0,1,0,76.14,67.88 ,33.33
03,007,01,017,0397,0,1615 ,8 ,1623 ,2478 ,0,3,1,3,0,1,0,76.14,65.50 ,33.33
03,007,01,017,0398,0,509 ,10 ,519 ,785 ,0,3,1,3,0,1,0,76.14,66.11 ,33.33
03,007,01,017,0399,0,724 ,6 ,730 ,1041 ,0,3,1,3,0,1,0,76.14,70.12 ,33.33
03,007,01,017,0400,0,754 ,6 ,760 ,1079 ,0,3,1,3,0,1,0,76.14,70.44 ,33.33
03,007,01,017,0401,0,962 ,13 ,975 ,1433 ,0,3,1,3,0,1,0,76.14,68.04 ,33.33
03,007,01,017,0402,0,673 ,12 ,685 ,986 ,0,3,1,3,0,1,0,76.14,69.47 ,33.33
03,007,01,017,0403,0,816 ,14 ,830 ,1243 ,0,3,1,3,0,1,0,76.14,66.77 ,33.33
03,007,01,017,0404,0,582 ,10 ,592 ,829 ,0,3,1,3,0,1,0,76.14,71.41 ,33.33
03,007,01,017,0405,0,1281 ,14 ,1295 ,1905 ,0,3,1,3,0,1,0,76.14,67.98 ,33.33
03,007,01,017,0406,0,1015 ,11 ,1026 ,1473 ,0,3,1,3,0,1,0,76.14,69.65 ,33.33
03,007,01,017,0407,0,980 ,13 ,993 ,1398 ,0,3,1,3,0,1,0,76.14,71.03 ,33.33
03,007,01,017,0408,0,822 ,13 ,835 ,1114 ,0,3,1,3,0,1,0,76.14,74.96 ,33.33
03,007,01,017,0409,0,684 ,2 ,686 ,980 ,0,3,1,3,0,1,0,76.14,70.00 ,33.33
03,007,01,017,0410,0,745 ,8 ,753 ,1061 ,0,3,1,3,0,1,0,76.14,70.97 ,33.33
03,007,01,017,0411,0,700 ,7 ,707 ,998 ,0,3,1,3,0,1,0,76.14,70.84 ,33.33
03,007,01,017,0412,0,730 ,11 ,741 ,1032 ,0,3,1,3,0,1,0,76.14,71.80 ,33.33
03,007,01,017,0413,0,498 ,3 ,501 ,684 ,0,3,1,3,0,1,0,76.14,73.25 ,33.33
03,007,01,017,0414,0,640 ,2 ,642 ,887 ,0,3,1,3,0,1,0,76.14,72.38 ,33.33
03,007,01,017,0415,0,668 ,9 ,677 ,945 ,0,3,1,3,0,1,0,76.14,71.64 ,33.33
03,007,01,017,0416,0,554 ,6 ,560 ,808 ,0,3,1,3,0,1,0,76.14,69.31 ,33.33
03,007,01,017,0417,0,952 ,14 ,966 ,1354 ,0,3,1,3,0,1,0,76.14,71.34 ,33.33
03,007,01,017,0418,0,1306 ,17 ,1323 ,1949 ,0,3,1,3,0,1,0,76.14,67.88 ,33.33
03,007,01,018,0419,0,717 ,10 ,727 ,1022 ,0,3,1,3,0,1,0,76.14,71.14 ,33.33
03,007,01,018,0420,0,507 ,4 ,511 ,718 ,0,3,1,3,0,1,0,76.14,71.17 ,33.33
03,007,01,018,0421,0,575 ,10 ,585 ,874 ,0,3,1,3,0,1,0,76.14,66.93 ,33.33
03,007,01,018,0422,0,710 ,7 ,717 ,1026 ,0,3,1,3,0,1,0,76.14,69.88 ,33.33
03,007,01,018,0423,0,442 ,2 ,444 ,647 ,0,3,1,3,0,1,0,76.14,68.62 ,33.33
03,007,01,018,0424,0,486 ,6 ,492 ,660 ,0,3,1,3,0,1,0,76.14,74.55 ,33.33
03,007,01,018,0425,0,702 ,6 ,708 ,999 ,0,3,1,3,0,1,0,76.14,70.87 ,33.33
03,007,01,018,0426,0,714 ,5 ,719 ,1038 ,0,3,1,3,0,1,0,76.14,69.27 ,33.33
03,007,01,018,0427,0,631 ,7 ,638 ,880 ,0,3,1,3,0,1,0,76.14,72.50 ,33.33
03,007,01,018,0428,0,363 ,1 ,364 ,489 ,0,3,1,3,0,1,0,76.14,74.44 ,33.33
03,007,01,018,0429,0,620 ,9 ,629 ,951 ,0,3,1,3,0,1,0,76.14,66.14 ,33.33
03,007,01,018,0430,0,576 ,11 ,587 ,863 ,0,3,1,3,0,1,0,76.14,68.02 ,33.33
03,007,01,018,0431,0,585 ,6 ,591 ,798 ,0,3,1,3,0,1,0,76.14,74.06 ,33.33
03,007,01,018,0432,0,574 ,4 ,578 ,792 ,0,3,1,3,0,1,0,76.14,72.98 ,33.33
03,007,01,018,0433,0,533 ,2 ,535 ,729 ,0,3,1,3,0,1,0,76.14,73.39 ,33.33
03,007,01,018,0434,0,477 ,6 ,483 ,666 ,0,3,1,3,0,1,0,76.14,72.52 ,33.33
03,007,01,018,0435,0,467 ,4 ,471 ,617 ,0,3,1,3,0,1,0,76.14,76.34 ,33.33
03,007,01,019,0436,0,1592 ,17 ,1609 ,2325 ,0,3,1,3,0,1,0,76.14,69.20 ,33.33
03,007,01,019,0437,0,1212 ,4 ,1216 ,1725 ,0,3,1,3,0,1,0,76.14,70.49 ,33.33
03,007,01,019,0438,0,2683 ,33 ,2716 ,3902 ,0,3,1,3,0,1,0,76.14,69.61 ,33.33
03,007,01,019,0439,0,1040 ,17 ,1057 ,1590 ,0,3,1,3,0,1,0,76.14,66.48 ,33.33
03,007,01,019,0440,0,923 ,11 ,934 ,1400 ,0,3,1,3,0,1,0,76.14,66.71 ,33.33
03,007,01,019,0441,0,531 ,7 ,538 ,807 ,0,3,1,3,0,1,0,76.14,66.67 ,33.33
03,007,01,019,0442,0,446 ,4 ,450 ,629 ,0,3,1,3,0,1,0,76.14,71.54 ,33.33
03,007,01,019,0443,0,515 ,2 ,517 ,743 ,0,3,1,3,0,1,0,76.14,69.58 ,33.33
03,007,01,019,0444,0,909 ,8 ,917 ,1395 ,0,3,1,3,0,1,0,76.14,65.73 ,33.33
03,007,01,019,0445,0,845 ,8 ,853 ,1287 ,0,3,1,3,0,1,0,76.14,66.28 ,33.33
03,007,01,019,0446,0,1066 ,8 ,1074 ,1729 ,0,3,1,3,0,1,0,76.14,62.12 ,33.33
03,007,01,019,0447,0,1469 ,25 ,1494 ,2309 ,0,3,1,3,0,1,0,76.14,64.70 ,33.33
03,007,01,019,0448,0,720 ,10 ,730 ,1058 ,0,3,1,3,0,1,0,76.14,69.00 ,33.33
03,007,01,019,0449,0,1099 ,15 ,1114 ,1741 ,0,3,1,3,0,1,0,76.14,63.99 ,33.33
03,007,01,019,0450,0,953 ,10 ,963 ,1540 ,0,3,1,3,0,1,0,76.14,62.53 ,33.33
03,007,01,020,0451,0,1047 ,19 ,1066 ,1752 ,0,3,1,3,0,1,0,76.14,60.84 ,33.33
03,007,01,020,0452,0,423 ,4 ,427 ,677 ,0,3,1,3,0,1,0,76.14,63.07 ,33.33
03,007,01,020,0453,0,605 ,4 ,609 ,942 ,0,3,1,3,0,1,0,76.14,64.65 ,33.33
03,007,01,020,0454,0,1030 ,11 ,1041 ,1624 ,0,3,1,3,0,1,0,76.14,64.10 ,33.33
03,007,01,020,0455,0,931 ,17 ,948 ,1429 ,0,3,1,3,0,1,0,76.14,66.34 ,33.33
03,007,01,020,0456,0,1105 ,19 ,1124 ,1708 ,0,3,1,3,0,1,0,76.14,65.81 ,33.33
03,007,01,020,0457,0,893 ,16 ,909 ,1316 ,0,3,1,3,0,1,0,76.14,69.07 ,33.33
03,007,01,020,0458,0,885 ,12 ,897 ,1462 ,0,3,1,3,0,1,0,76.14,61.35 ,33.33
03,007,01,020,0459,0,1326 ,26 ,1352 ,2064 ,0,3,1,3,0,1,0,76.14,65.50 ,33.33
03,007,01,020,0460,0,1196 ,10 ,1206 ,1848 ,0,3,1,3,0,1,0,76.14,65.26 ,33.33
03,007,01,020,0461,0,1228 ,10 ,1238 ,1916 ,0,3,1,3,0,1,0,76.14,64.61 ,33.33
03,007,01,020,0462,0,507 ,9 ,516 ,802 ,0,3,1,3,0,1,0,76.14,64.34 ,33.33
03,007,01,020,0463,0,744 ,3 ,747 ,1119 ,0,3,1,3,0,1,0,76.14,66.76 ,33.33
03,007,01,020,0464,0,571 ,10 ,581 ,970 ,0,3,1,3,0,1,0,76.14,59.90 ,33.33
03,007,01,020,0465,0,458 ,9 ,467 ,737 ,0,3,1,3,0,1,0,76.14,63.36 ,33.33
03,007,01,020,0466,0,605 ,2 ,607 ,896 ,0,3,1,3,0,1,0,76.14,67.75 ,33.33
03,007,01,020,0467,0,837 ,8 ,845 ,1199 ,0,3,1,3,0,1,0,76.14,70.48 ,33.33
03,007,01,020,0468,0,600 ,8 ,608 ,883 ,0,3,1,3,0,1,0,76.14,68.86 ,33.33
03,007,01,020,0469,0,801 ,6 ,807 ,1281 ,0,3,1,3,0,1,0,76.14,63.00 ,33.33
03,007,01,021,0470,0,817 ,9 ,826 ,1233 ,0,3,1,3,0,1,0,76.14,66.99 ,33.33
03,007,01,021,0471,0,504 ,3 ,507 ,669 ,0,3,1,3,0,1,0,76.14,75.78 ,33.33
03,007,01,021,0472,0,1389 ,18 ,1407 ,2063 ,0,3,1,3,0,1,0,76.14,68.20 ,33.33
03,007,01,021,0473,0,860 ,5 ,865 ,1283 ,0,3,1,3,0,1,0,76.14,67.42 ,33.33
03,007,01,021,0474,0,827 ,6 ,833 ,1206 ,0,3,1,3,0,1,0,76.14,69.07 ,33.33
03,007,01,021,0475,0,687 ,6 ,693 ,1000 ,0,3,1,3,0,1,0,76.14,69.30 ,33.33
03,007,01,021,0476,0,782 ,10 ,792 ,1140 ,0,3,1,3,0,1,0,76.14,69.47 ,33.33
03,007,01,021,0477,0,671 ,5 ,676 ,1024 ,0,3,1,3,0,1,0,76.14,66.02 ,33.33
03,007,01,021,0478,0,451 ,9 ,460 ,653 ,0,3,1,3,0,1,0,76.14,70.44 ,33.33
03,007,01,021,0479,0,609 ,7 ,616 ,851 ,0,3,1,3,0,1,0,76.14,72.39 ,33.33
03,007,01,021,0480,0,737 ,6 ,743 ,1014 ,0,3,1,3,0,1,0,76.14,73.27 ,33.33
03,007,01,021,0481,0,832 ,14 ,846 ,1235 ,0,3,1,3,0,1,0,76.14,68.50 ,33.33
03,007,01,021,0482,0,1050 ,11 ,1061 ,1697 ,0,3,1,3,0,1,0,76.14,62.52 ,33.33
03,007,01,021,0483,0,609 ,11 ,620 ,826 ,0,3,1,3,0,1,0,76.14,75.06 ,33.33
03,007,01,021,0484,0,635 ,6 ,641 ,861 ,0,3,1,3,0,1,0,76.14,74.45 ,33.33
03,007,01,021,0485,0,985 ,9 ,994 ,1457 ,0,3,1,3,0,1,0,76.14,68.22 ,33.33
03,007,01,021,0486,0,1061 ,10 ,1071 ,1553 ,0,3,1,3,0,1,0,76.14,68.96 ,33.33
03,007,01,021,0487,0,200 ,1 ,201 ,287 ,0,3,1,3,0,1,0,76.14,70.03 ,33.33
03,007,01,021,0488,0,407 ,12 ,419 ,637 ,0,3,1,3,0,1,0,76.14,65.78 ,33.33
03,007,01,021,0489,0,519 ,7 ,526 ,751 ,0,3,1,3,0,1,0,76.14,70.04 ,33.33
03,007,01,022,0490,0,1438 ,21 ,1459 ,2286 ,0,3,1,3,0,1,0,76.14,63.82 ,33.33
03,007,01,022,0491,0,964 ,10 ,974 ,1583 ,0,3,1,3,0,1,0,76.14,61.53 ,33.33
03,007,01,022,0492,0,1056 ,7 ,1063 ,1597 ,0,3,1,3,0,1,0,76.14,66.56 ,33.33
03,007,01,022,0493,0,1442 ,14 ,1456 ,2154 ,0,3,1,3,0,1,0,76.14,67.60 ,33.33
03,007,01,022,0494,0,789 ,12 ,801 ,1168 ,0,3,1,3,0,1,0,76.14,68.58 ,33.33
03,007,01,022,0495,0,942 ,22 ,964 ,1459 ,0,3,1,3,0,1,0,76.14,66.07 ,33.33
03,007,01,022,0496,0,1964 ,24 ,1988 ,2986 ,0,3,1,3,0,1,0,76.14,66.58 ,33.33
03,007,01,022,0497,0,1074 ,13 ,1087 ,1618 ,0,3,1,3,0,1,0,76.14,67.18 ,33.33
03,007,01,022,0498,0,474 ,8 ,482 ,701 ,0,3,1,3,0,1,0,76.14,68.76 ,33.33
03,007,01,022,0499,0,370 ,2 ,372 ,594 ,0,3,1,3,0,1,0,76.14,62.63 ,33.33
03,007,01,022,0500,0,1025 ,17 ,1042 ,1627 ,0,3,1,3,0,1,0,76.14,64.04 ,33.33
03,007,01,022,0501,0,692 ,9 ,701 ,1161 ,0,3,1,3,0,1,0,76.14,60.38 ,33.33
03,007,01,022,0502,0,518 ,14 ,532 ,809 ,0,3,1,3,0,1,0,76.14,65.76 ,33.33
03,007,01,022,0503,0,590 ,6 ,596 ,900 ,0,3,1,3,0,1,0,76.14,66.22 ,33.33
03,007,01,022,0504,0,812 ,5 ,817 ,1353 ,0,3,1,3,0,1,0,76.14,60.38 ,33.33
03,007,01,022,0505,0,610 ,4 ,614 ,969 ,0,3,1,3,0,1,0,76.14,63.36 ,33.33
03,007,01,022,0506,0,671 ,5 ,676 ,992 ,0,3,1,3,0,1,0,76.14,68.15 ,33.33
03,007,01,023,0507,0,1436 ,16 ,1452 ,2071 ,0,3,1,3,0,1,0,76.14,70.11 ,33.33
03,007,01,023,0508,0,1953 ,21 ,1974 ,2873 ,0,3,1,3,0,1,0,76.14,68.71 ,33.33
03,007,01,023,0509,0,933 ,21 ,954 ,1324 ,0,3,1,3,0,1,0,76.14,72.05 ,33.33
03,007,01,023,0510,0,1782 ,20 ,1802 ,2762 ,0,3,1,3,0,1,0,76.14,65.24 ,33.33
03,007,01,023,0511,0,1143 ,15 ,1158 ,1636 ,0,3,1,3,0,1,0,76.14,70.78 ,33.33
03,007,01,023,0512,0,974 ,12 ,986 ,1462 ,0,3,1,3,0,1,0,76.14,67.44 ,33.33
03,007,01,023,0513,0,823 ,6 ,829 ,1202 ,0,3,1,3,0,1,0,76.14,68.97 ,33.33
03,007,01,023,0514,0,805 ,11 ,816 ,1077 ,0,3,1,3,0,1,0,76.14,75.77 ,33.33
03,007,01,023,0515,0,765 ,8 ,773 ,1105 ,0,3,1,3,0,1,0,76.14,69.95 ,33.33
03,007,01,023,0516,0,845 ,7 ,852 ,1205 ,0,3,1,3,0,1,0,76.14,70.71 ,33.33
03,007,01,023,0517,0,1624 ,19 ,1643 ,2445 ,0,3,1,3,0,1,0,76.14,67.20 ,33.33
03,007,01,023,0518,0,1437 ,20 ,1457 ,2095 ,0,3,1,3,0,1,0,76.14,69.55 ,33.33
03,007,01,023,0519,0,930 ,17 ,947 ,1407 ,0,3,1,3,0,1,0,76.14,67.31 ,33.33
03,007,01,023,0520,0,1192 ,19 ,1211 ,1659 ,0,3,1,3,0,1,0,76.14,73.00 ,33.33
03,007,01,023,0521,0,921 ,14 ,935 ,1293 ,0,3,1,3,0,1,0,76.14,72.31 ,33.33
03,007,01,023,0522,0,593 ,2 ,595 ,817 ,0,3,1,3,0,1,0,76.14,72.83 ,33.33
03,007,01,023,0523,0,1083 ,30 ,1113 ,1545 ,0,3,1,3,0,1,0,76.14,72.04 ,33.33
03,007,01,023,0524,0,928 ,11 ,939 ,1275 ,0,3,1,3,0,1,0,76.14,73.65 ,33.33
03,007,01,023,0525,0,774 ,11 ,785 ,1090 ,0,3,1,3,0,1,0,76.14,72.02 ,33.33
03,007,01,023,0526,0,2541 ,28 ,2569 ,3527 ,0,3,1,3,0,1,0,76.14,72.84 ,33.33
03,007,01,023,0527,0,933 ,12 ,945 ,1320 ,0,3,1,3,0,1,0,76.14,71.59 ,33.33
03,007,01,023,0528,0,738 ,10 ,748 ,1015 ,0,3,1,3,0,1,0,76.14,73.69 ,33.33
03,007,01,023,0529,0,637 ,5 ,642 ,875 ,0,3,1,3,0,1,0,76.14,73.37 ,33.33
03,007,01,023,0530,0,913 ,10 ,923 ,1232 ,0,3,1,3,0,1,0,76.14,74.92 ,33.33
03,007,01,023,0531,0,717 ,14 ,731 ,1036 ,0,3,1,3,0,1,0,76.14,70.56 ,33.33
03,007,01,023,0532,0,753 ,5 ,758 ,1030 ,0,3,1,3,0,1,0,76.14,73.59 ,33.33
03,007,01,023,0533,0,541 ,8 ,549 ,733 ,0,3,1,3,0,1,0,76.14,74.90 ,33.33
03,007,01,024,0534,0,628 ,4 ,632 ,1033 ,0,3,1,3,0,1,0,76.14,61.18 ,33.33
03,007,01,024,0535,0,286 ,4 ,290 ,510 ,0,3,1,3,0,1,0,76.14,56.86 ,33.33
03,007,01,024,0536,0,523 ,6 ,529 ,870 ,0,3,1,3,0,1,0,76.14,60.80 ,33.33
03,007,01,024,0537,0,350 ,6 ,356 ,637 ,0,3,1,3,0,1,0,76.14,55.89 ,33.33
03,007,01,024,0538,0,654 ,7 ,661 ,947 ,0,3,1,3,0,1,0,76.14,69.80 ,33.33
03,007,01,024,0539,0,1264 ,13 ,1277 ,1867 ,0,3,1,3,0,1,0,76.14,68.40 ,33.33
03,007,01,024,0540,0,871 ,15 ,886 ,1392 ,0,3,1,3,0,1,0,76.14,63.65 ,33.33
03,007,01,024,0541,0,497 ,7 ,504 ,994 ,0,3,1,3,0,1,0,76.14,50.70 ,33.33
03,007,01,024,0542,0,479 ,7 ,486 ,729 ,0,3,1,3,0,1,0,76.14,66.67 ,33.33
03,007,01,024,0543,0,509 ,7 ,516 ,725 ,0,3,1,3,0,1,0,76.14,71.17 ,33.33
03,007,01,024,0544,0,678 ,6 ,684 ,996 ,0,3,1,3,0,1,0,76.14,68.67 ,33.33
03,007,01,024,0545,0,450 ,6 ,456 ,675 ,0,3,1,3,0,1,0,76.14,67.56 ,33.33
03,007,01,024,0546,0,367 ,4 ,371 ,606 ,0,3,1,3,0,1,0,76.14,61.22 ,33.33
03,007,01,024,0547,0,1295 ,20 ,1315 ,2089 ,0,3,1,3,0,1,0,76.14,62.95 ,33.33
03,007,01,024,0548,0,547 ,6 ,553 ,795 ,0,3,1,3,0,1,0,76.14,69.56 ,33.33
03,007,01,024,0549,0,507 ,4 ,511 ,804 ,0,3,1,3,0,1,0,76.14,63.56 ,33.33
03,007,01,024,0550,0,871 ,12 ,883 ,1389 ,0,3,1,3,0,1,0,76.14,63.57 ,33.33
03,007,01,024,0551,0,470 ,3 ,473 ,782 ,0,3,1,3,0,1,0,76.14,60.49 ,33.33
03,007,01,024,0552,0,960 ,10 ,970 ,1368 ,0,3,1,3,0,1,0,76.14,70.91 ,33.33
03,007,01,024,0553,0,294 ,5 ,299 ,547 ,0,3,1,3,0,1,0,76.14,54.66 ,33.33
03,007,01,024,0554,0,1016 ,7 ,1023 ,1438 ,0,3,1,3,0,1,0,76.14,71.14 ,33.33
03,007,01,024,0555,0,1380 ,14 ,1394 ,2079 ,0,3,1,3,0,1,0,76.14,67.05 ,33.33
03,007,01,024,0556,0,505 ,0 ,505 ,721 ,0,3,1,3,0,1,0,76.14,70.04 ,33.33
03,007,01,024,0557,0,738 ,5 ,743 ,1042 ,0,3,1,3,0,1,0,76.14,71.31 ,33.33
03,007,01,024,0558,0,883 ,4 ,887 ,1349 ,0,3,1,3,0,1,0,76.14,65.75 ,33.33
03,007,01,024,0559,0,1995 ,20 ,2015 ,2933 ,0,3,1,3,0,1,0,76.14,68.70 ,33.33
03,007,01,025,0560,0,833 ,10 ,843 ,1313 ,0,3,1,3,0,1,0,76.14,64.20 ,33.33
03,007,01,025,0561,0,892 ,18 ,910 ,1426 ,0,3,1,3,0,1,0,76.14,63.81 ,33.33
03,007,01,025,0562,0,573 ,6 ,579 ,869 ,0,3,1,3,0,1,0,76.14,66.63 ,33.33
03,007,01,025,0563,0,803 ,8 ,811 ,1265 ,0,3,1,3,0,1,0,76.14,64.11 ,33.33
03,007,01,025,0564,0,689 ,8 ,697 ,1062 ,0,3,1,3,0,1,0,76.14,65.63 ,33.33
03,007,01,025,0565,0,817 ,7 ,824 ,1205 ,0,3,1,3,0,1,0,76.14,68.38 ,33.33
03,007,01,025,0566,0,509 ,4 ,513 ,767 ,0,3,1,3,0,1,0,76.14,66.88 ,33.33
03,007,01,025,0567,0,727 ,6 ,733 ,1215 ,0,3,1,3,0,1,0,76.14,60.33 ,33.33
03,007,01,025,0568,0,610 ,7 ,617 ,904 ,0,3,1,3,0,1,0,76.14,68.25 ,33.33
03,007,01,025,0569,0,433 ,5 ,438 ,747 ,0,3,1,3,0,1,0,76.14,58.63 ,33.33
03,007,01,025,0570,0,792 ,9 ,801 ,1168 ,0,3,1,3,0,1,0,76.14,68.58 ,33.33
03,007,01,025,0571,0,843 ,7 ,850 ,1328 ,0,3,1,3,0,1,0,76.14,64.01 ,33.33
03,007,01,025,0572,0,610 ,9 ,619 ,1067 ,0,3,1,3,0,1,0,76.14,58.01 ,33.33
03,007,01,025,0573,0,455 ,2 ,457 ,803 ,0,3,1,3,0,1,0,76.14,56.91 ,33.33
03,007,01,025,0574,0,593 ,6 ,599 ,1001 ,0,3,1,3,0,1,0,76.14,59.84 ,33.33
03,007,01,026,0575,0,749 ,9 ,758 ,1100 ,0,3,1,3,0,1,0,76.14,68.91 ,33.33
03,007,01,026,0576,0,1205 ,25 ,1230 ,1725 ,0,3,1,3,0,1,0,76.14,71.30 ,33.33
03,007,01,026,0577,0,564 ,3 ,567 ,804 ,0,3,1,3,0,1,0,76.14,70.52 ,33.33
03,007,01,026,0578,0,522 ,5 ,527 ,798 ,0,3,1,3,0,1,0,76.14,66.04 ,33.33
03,007,01,026,0579,0,1081 ,14 ,1095 ,1512 ,0,3,1,3,0,1,0,76.14,72.42 ,33.33
03,007,01,026,0580,0,465 ,6 ,471 ,655 ,0,3,1,3,0,1,0,76.14,71.91 ,33.33
03,007,01,026,0581,0,685 ,2 ,687 ,971 ,0,3,1,3,0,1,0,76.14,70.75 ,33.33
03,007,01,026,0582,0,803 ,13 ,816 ,1163 ,0,3,1,3,0,1,0,76.14,70.16 ,33.33
03,007,01,026,0583,0,356 ,2 ,358 ,555 ,0,3,1,3,0,1,0,76.14,64.50 ,33.33
03,007,01,026,0584,0,611 ,5 ,616 ,889 ,0,3,1,3,0,1,0,76.14,69.29 ,33.33
03,007,01,026,0585,0,460 ,2 ,462 ,719 ,0,3,1,3,0,1,0,76.14,64.26 ,33.33
03,007,01,026,0586,0,423 ,3 ,426 ,655 ,0,3,1,3,0,1,0,76.14,65.04 ,33.33
03,007,01,026,0587,0,537 ,3 ,540 ,784 ,0,3,1,3,0,1,0,76.14,68.88 ,33.33
03,007,01,026,0588,0,441 ,0 ,441 ,677 ,0,3,1,3,0,1,0,76.14,65.14 ,33.33
03,008,01,001,0001,0,564 ,4 ,568 ,942 ,0,3,1,3,0,1,0,76.14,60.30 ,33.33
03,008,01,001,0002,0,849 ,4 ,853 ,1377 ,0,3,1,3,0,1,0,76.14,61.95 ,33.33
03,008,01,001,0003,0,557 ,2 ,559 ,813 ,0,3,1,3,0,1,0,76.14,68.76 ,33.33
03,008,01,001,0004,0,378 ,0 ,378 ,547 ,0,3,1,3,0,1,0,76.14,69.10 ,33.33
03,008,01,001,0005,0,424 ,2 ,426 ,677 ,0,3,1,3,0,1,0,76.14,62.92 ,33.33
03,008,01,001,0006,0,306 ,0 ,306 ,440 ,0,3,1,3,0,1,0,76.14,69.55 ,33.33
03,008,01,001,0007,0,654 ,1 ,655 ,1036 ,0,3,1,3,0,1,0,76.14,63.22 ,33.33
03,008,01,001,0008,0,2504 ,21 ,2525 ,4344 ,0,3,1,3,0,1,0,76.14,58.13 ,33.33
03,008,01,001,0009,0,1714 ,15 ,1729 ,2767 ,0,3,1,3,0,1,0,76.14,62.49 ,33.33
03,008,01,001,0010,0,1178 ,12 ,1190 ,1799 ,0,3,1,3,0,1,0,76.14,66.15 ,33.33
03,008,01,001,0011,0,1948 ,22 ,1970 ,3317 ,0,3,1,3,0,1,0,76.14,59.39 ,33.33
03,008,01,001,0012,0,3043 ,11 ,3054 ,5166 ,0,3,1,3,0,1,0,76.14,59.12 ,33.33
03,008,01,001,0013,0,1235 ,5 ,1240 ,1988 ,0,3,1,3,0,1,0,76.14,62.3742454728,33.33
03,008,01,001,0014,0,517 ,2 ,519 ,884 ,0,3,1,3,0,1,0,76.14,58.71 ,33.33
03,008,01,001,0015,0,2280 ,21 ,2301 ,3881 ,0,3,1,3,0,1,0,76.14,59.29 ,33.33
03,008,01,001,0016,0,234 ,3 ,237 ,406 ,0,3,1,3,0,1,0,76.14,58.37 ,33.33
03,008,01,001,0017,0,1259 ,5 ,1264 ,1986 ,0,3,1,3,0,1,0,76.14,63.65 ,33.33
03,008,01,001,0018,0,3069 ,19 ,3088 ,4858 ,0,3,1,3,0,1,0,76.14,63.57 ,33.33
03,008,01,001,0019,0,3039 ,17 ,3056 ,5042 ,0,3,1,3,0,1,0,76.14,60.61 ,33.33
03,008,01,001,0020,0,863 ,9 ,872 ,1361 ,0,3,1,3,0,1,0,76.14,64.07 ,33.33
03,008,01,001,0021,0,334 ,3 ,337 ,575 ,0,3,1,3,0,1,0,76.14,58.61 ,33.33
03,008,01,001,0022,0,1132 ,4 ,1136 ,1756 ,0,3,1,3,0,1,0,76.14,64.69 ,33.33
03,008,01,001,0023,0,1235 ,5 ,1240 ,1799 ,0,3,1,3,0,1,0,76.14,68.9271817676,33.33
03,008,01,001,0024,0,981 ,8 ,989 ,1457 ,0,3,1,3,0,1,0,76.14,67.88 ,33.33
03,008,01,001,0025,0,1425 ,8 ,1433 ,2338 ,0,3,1,3,0,1,0,76.14,61.29 ,33.33
03,008,01,001,0026,0,3467 ,27 ,3494 ,5879 ,0,3,1,3,0,1,0,76.14,59.43 ,33.33
03,008,01,001,0027,0,2304 ,28 ,2332 ,4153 ,0,3,1,3,0,1,0,76.14,56.1521791476,33.33
03,008,01,001,0028,0,2137 ,19 ,2156 ,3849 ,0,3,1,3,0,1,0,76.14,56.01 ,33.33
03,008,01,001,0029,0,1405 ,12 ,1417 ,2464 ,0,3,1,3,0,1,0,76.14,57.51 ,33.33
03,008,01,001,0030,0,1477 ,14 ,1491 ,2507 ,0,3,1,3,0,1,0,76.14,59.47 ,33.33
03,008,01,001,0031,0,665 ,3 ,668 ,1234 ,0,3,1,3,0,1,0,76.14,54.13 ,33.33
03,008,01,001,0032,0,473 ,9 ,482 ,744 ,0,3,1,3,0,1,0,76.14,64.78 ,33.33
03,008,01,001,0033,0,422 ,4 ,426 ,719 ,0,3,1,3,0,1,0,76.14,59.25 ,33.33
03,008,01,001,0034,0,981 ,3 ,984 ,1780 ,0,3,1,3,0,1,0,76.14,55.28 ,33.33
03,008,01,002,0035,0,1590 ,9 ,1599 ,2920 ,0,3,1,3,0,1,0,76.14,54.76 ,33.33
03,008,01,002,0036,0,1630 ,8 ,1638 ,3077 ,0,3,1,3,0,1,0,76.14,53.23 ,33.33
03,008,01,002,0037,0,538 ,8 ,546 ,909 ,0,3,1,3,0,1,0,76.14,60.0660066007,33.33
03,008,01,002,0038,0,1249 ,11 ,1260 ,2375 ,0,3,1,3,0,1,0,76.14,53.05 ,33.33
03,008,01,002,0039,0,1737 ,11 ,1748 ,3133 ,0,3,1,3,0,1,0,76.14,55.7931694861,33.33
03,008,01,002,0040,0,1055 ,7 ,1062 ,1925 ,0,3,1,3,0,1,0,76.14,55.17 ,33.33
03,008,01,002,0041,0,1113 ,10 ,1123 ,2164 ,0,3,1,3,0,1,0,76.14,51.89 ,33.33
03,008,01,002,0042,0,1231 ,8 ,1239 ,2246 ,0,3,1,3,0,1,0,76.14,55.16 ,33.33
03,008,01,002,0043,0,1764 ,11 ,1775 ,3454 ,0,3,1,3,0,1,0,76.14,51.39 ,33.33
03,008,01,002,0044,0,728 ,4 ,732 ,1181 ,0,3,1,3,0,1,0,76.14,61.98 ,33.33
03,008,01,002,0045,0,2936 ,20 ,2956 ,5631 ,0,3,1,3,0,1,0,76.14,52.50 ,33.33
03,008,01,002,0046,0,554 ,1 ,555 ,940 ,0,3,1,3,0,1,0,76.14,59.04 ,33.33
03,008,01,002,0047,0,1212 ,8 ,1220 ,2282 ,0,3,1,3,0,1,0,76.14,53.46 ,33.33
03,008,01,002,0048,0,2902 ,25 ,2927 ,5797 ,0,3,1,3,0,1,0,76.14,50.49 ,33.33
03,008,01,002,0049,0,1477 ,14 ,1491 ,3051 ,0,3,1,3,0,1,0,76.14,48.87 ,33.33
03,008,01,002,0050,0,522 ,6 ,528 ,996 ,0,3,1,3,0,1,0,76.14,53.01 ,33.33
03,008,01,002,0051,0,528 ,6 ,534 ,972 ,0,3,1,3,0,1,0,76.14,54.94 ,33.33
03,008,01,002,0052,0,535 ,9 ,544 ,904 ,0,3,1,3,0,1,0,76.14,60.18 ,33.33
03,008,01,002,0053,0,542 ,3 ,545 ,1023 ,0,3,1,3,0,1,0,76.14,53.27 ,33.33
03,008,01,002,0054,0,205 ,1 ,206 ,372 ,0,3,1,3,0,1,0,76.14,55.38 ,33.33
03,008,01,002,0055,0,619 ,4 ,623 ,1277 ,0,3,1,3,0,1,0,76.14,48.79 ,33.33
03,008,01,002,0056,0,708 ,5 ,713 ,1313 ,0,3,1,3,0,1,0,76.14,54.30 ,33.33
03,008,01,002,0057,0,808 ,5 ,813 ,1542 ,0,3,1,3,0,1,0,76.14,52.7237354086,33.33
03,008,01,002,0058,0,663 ,3 ,666 ,1212 ,0,3,1,3,0,1,0,76.14,54.9504950495,33.33
03,008,01,002,0059,0,419 ,2 ,421 ,659 ,0,3,1,3,0,1,0,76.14,63.88 ,33.33
03,008,01,002,0060,0,434 ,2 ,436 ,794 ,0,3,1,3,0,1,0,76.14,54.91 ,33.33
03,008,01,002,0061,0,891 ,3 ,894 ,1547 ,0,3,1,3,0,1,0,76.14,57.79 ,33.33
03,008,01,002,0062,0,676 ,10 ,686 ,1195 ,0,3,1,3,0,1,0,76.14,57.41 ,33.33
03,008,01,002,0063,0,415 ,0 ,415 ,674 ,0,3,1,3,0,1,0,76.14,61.57 ,33.33
03,008,01,002,0064,0,477 ,7 ,484 ,973 ,0,3,1,3,0,1,0,76.14,49.7430626927,33.33
03,008,01,002,0065,0,1360 ,15 ,1375 ,2422 ,0,3,1,3,0,1,0,76.14,56.7712634187,33.33
03,008,01,002,0066,0,633 ,4 ,637 ,1154 ,0,3,1,3,0,1,0,76.14,55.20 ,33.33
03,008,01,002,0067,0,1340 ,10 ,1350 ,2471 ,0,3,1,3,0,1,0,76.14,54.63 ,33.33
03,008,01,003,0068,0,1196 ,11 ,1207 ,1986 ,0,3,1,3,0,1,0,76.14,60.78 ,33.33
03,008,01,003,0069,0,2079 ,14 ,2093 ,3475 ,0,3,1,3,0,1,0,76.14,60.23 ,33.33
03,008,01,003,0070,0,1284 ,8 ,1292 ,2033 ,0,3,1,3,0,1,0,76.14,63.55 ,33.33
03,008,01,003,0071,0,458 ,7 ,465 ,717 ,0,3,1,3,0,1,0,76.14,64.85 ,33.33
03,008,01,003,0072,0,773 ,4 ,777 ,1256 ,0,3,1,3,0,1,0,76.14,61.86 ,33.33
03,008,01,003,0073,0,1374 ,9 ,1383 ,2249 ,0,3,1,3,0,1,0,76.14,61.49 ,33.33
03,008,01,003,0074,0,3118 ,26 ,3144 ,5423 ,0,3,1,3,0,1,0,76.14,57.98 ,33.33
03,008,01,003,0075,0,3667 ,14 ,3681 ,6153 ,0,3,1,3,0,1,0,76.14,59.82 ,33.33
03,008,01,003,0076,0,1664 ,9 ,1673 ,2751 ,0,3,1,3,0,1,0,76.14,60.81 ,33.33
03,008,01,003,0077,0,1481 ,12 ,1493 ,2477 ,0,3,1,3,0,1,0,76.14,60.27 ,33.33
03,008,01,003,0078,0,1959 ,16 ,1975 ,3504 ,0,3,1,3,0,1,0,76.14,56.3641552511,33.33
03,008,01,003,0079,0,1140 ,6 ,1146 ,1821 ,0,3,1,3,0,1,0,76.14,62.93 ,33.33
03,008,01,003,0080,0,1597 ,19 ,1616 ,2811 ,0,3,1,3,0,1,0,76.14,57.49 ,33.33
03,008,01,003,0081,0,2825 ,26 ,2851 ,5118 ,0,3,1,3,0,1,0,76.14,55.71 ,33.33
03,008,01,003,0082,0,1991 ,10 ,2001 ,3379 ,0,3,1,3,0,1,0,76.14,59.22 ,33.33
03,008,01,003,0083,0,1689 ,13 ,1702 ,2922 ,0,3,1,3,0,1,0,76.14,58.25 ,33.33
03,008,01,003,0084,0,1284 ,11 ,1295 ,2045 ,0,3,1,3,0,1,0,76.14,63.33 ,33.33
03,008,01,003,0085,0,748 ,12 ,760 ,1240 ,0,3,1,3,0,1,0,76.14,61.29 ,33.33
03,008,01,003,0086,0,1431 ,12 ,1443 ,2407 ,0,3,1,3,0,1,0,76.14,59.95 ,33.33
03,008,01,003,0087,0,2631 ,12 ,2643 ,4525 ,0,3,1,3,0,1,0,76.14,58.41 ,33.33
03,008,01,003,0088,0,1141 ,8 ,1149 ,1909 ,0,3,1,3,0,1,0,76.14,60.19 ,33.33
03,008,01,003,0089,0,1097 ,13 ,1110 ,1910 ,0,3,1,3,0,1,0,76.14,58.1151832461,33.33
03,008,01,003,0090,0,2056 ,13 ,2069 ,3479 ,0,3,1,3,0,1,0,76.14,59.47 ,33.33
03,008,01,003,0091,0,580 ,4 ,584 ,923 ,0,3,1,3,0,1,0,76.14,63.27 ,33.33
03,008,01,003,0092,0,903 ,17 ,920 ,1661 ,0,3,1,3,0,1,0,76.14,55.388320289,33.33
03,008,01,003,0093,0,601 ,3 ,604 ,1019 ,0,3,1,3,0,1,0,76.14,59.27 ,33.33
03,008,01,003,0094,0,1271 ,14 ,1285 ,2292 ,0,3,1,3,0,1,0,76.14,56.06 ,33.33
03,008,01,004,0095,0,1281 ,3 ,1284 ,2106 ,0,3,1,3,0,1,0,76.14,60.97 ,33.33
03,008,01,004,0096,0,446 ,2 ,448 ,689 ,0,3,1,3,0,1,0,76.14,65.02 ,33.33
03,008,01,004,0097,0,2372 ,18 ,2390 ,4423 ,0,3,1,3,0,1,0,76.14,54.04 ,33.33
03,008,01,004,0098,0,1852 ,12 ,1864 ,3179 ,0,3,1,3,0,1,0,76.14,58.63 ,33.33
03,008,01,004,0099,0,1183 ,14 ,1197 ,2188 ,0,3,1,3,0,1,0,76.14,54.71 ,33.33
03,008,01,004,0100,0,1873 ,20 ,1893 ,3392 ,0,3,1,3,0,1,0,76.14,55.81 ,33.33
03,008,01,004,0101,0,623 ,3 ,626 ,1051 ,0,3,1,3,0,1,0,76.14,59.5623215985,33.33
03,008,01,004,0102,0,663 ,1 ,664 ,1087 ,0,3,1,3,0,1,0,76.14,61.09 ,33.33
03,008,01,004,0103,0,752 ,4 ,756 ,1312 ,0,3,1,3,0,1,0,76.14,57.62 ,33.33
03,008,01,004,0104,0,448 ,2 ,450 ,748 ,0,3,1,3,0,1,0,76.14,60.16 ,33.33
03,008,01,004,0105,0,261 ,0 ,261 ,425 ,0,3,1,3,0,1,0,76.14,61.41 ,33.33
03,008,01,004,0106,0,2307 ,9 ,2316 ,4277 ,0,3,1,3,0,1,0,76.14,54.15 ,33.33
03,008,01,004,0107,0,1732 ,13 ,1745 ,3291 ,0,3,1,3,0,1,0,76.14,53.02 ,33.33
03,008,01,004,0108,0,946 ,6 ,952 ,1643 ,0,3,1,3,0,1,0,76.14,57.94 ,33.33
03,008,01,004,0109,0,1538 ,11 ,1549 ,2705 ,0,3,1,3,0,1,0,76.14,57.26 ,33.33
03,008,01,004,0110,0,363 ,6 ,369 ,661 ,0,3,1,3,0,1,0,76.14,55.82 ,33.33
03,008,01,004,0111,0,954 ,7 ,961 ,1830 ,0,3,1,3,0,1,0,76.14,52.51 ,33.33
03,008,01,004,0112,0,563 ,4 ,567 ,992 ,0,3,1,3,0,1,0,76.14,57.16 ,33.33
03,008,01,004,0113,0,769 ,9 ,778 ,1322 ,0,3,1,3,0,1,0,76.14,58.8502269289,33.33
03,008,01,004,0114,0,399 ,4 ,403 ,715 ,0,3,1,3,0,1,0,76.14,56.3636363636,33.33
03,008,01,004,0115,0,365 ,3 ,368 ,618 ,0,3,1,3,0,1,0,76.14,59.55 ,33.33
03,008,01,004,0116,0,814 ,7 ,821 ,1459 ,0,3,1,3,0,1,0,76.14,56.27141878,33.33
03,008,01,004,0117,0,567 ,3 ,570 ,889 ,0,3,1,3,0,1,0,76.14,64.12 ,33.33
03,008,01,004,0118,0,345 ,1 ,346 ,575 ,0,3,1,3,0,1,0,76.14,60.17 ,33.33
03,008,01,004,0119,0,476 ,0 ,476 ,867 ,0,3,1,3,0,1,0,76.14,54.90 ,33.33
03,008,01,004,0120,0,275 ,4 ,279 ,532 ,0,3,1,3,0,1,0,76.14,52.44 ,33.33
03,008,01,004,0121,0,401 ,3 ,404 ,710 ,0,3,1,3,0,1,0,76.14,56.90 ,33.33
03,008,01,004,0122,0,530 ,6 ,536 ,1037 ,0,3,1,3,0,1,0,76.14,51.69 ,33.33
03,008,01,005,0123,0,587 ,7 ,594 ,951 ,0,3,1,3,0,1,0,76.14,62.4605678233,33.33
03,008,01,005,0124,0,542 ,4 ,546 ,932 ,0,3,1,3,0,1,0,76.14,58.5836909871,33.33
03,008,01,005,0125,0,339 ,1 ,340 ,558 ,0,3,1,3,0,1,0,76.14,60.93 ,33.33
03,008,01,005,0126,0,644 ,11 ,655 ,1219 ,0,3,1,3,0,1,0,76.14,53.73 ,33.33
03,008,01,005,0127,0,365 ,1 ,366 ,562 ,0,3,1,3,0,1,0,76.14,65.12 ,33.33
03,008,01,005,0128,0,288 ,1 ,289 ,448 ,0,3,1,3,0,1,0,76.14,64.51 ,33.33
03,008,01,005,0129,0,601 ,3 ,604 ,894 ,0,3,1,3,0,1,0,76.14,67.56 ,33.33
03,008,01,005,0130,0,766 ,6 ,772 ,1401 ,0,3,1,3,0,1,0,76.14,55.10 ,33.33
03,008,01,005,0131,0,542 ,1 ,543 ,907 ,0,3,1,3,0,1,0,76.14,59.87 ,33.33
03,008,01,005,0132,0,553 ,2 ,555 ,1064 ,0,3,1,3,0,1,0,76.14,52.16 ,33.33
03,008,01,005,0133,0,211 ,1 ,212 ,414 ,0,3,1,3,0,1,0,76.14,51.21 ,33.33
03,008,01,006,0134,0,557 ,4 ,561 ,1018 ,0,3,1,3,0,1,0,76.14,55.11 ,33.33
03,008,01,006,0135,0,1596 ,14 ,1610 ,2953 ,0,3,1,3,0,1,0,76.14,54.52 ,33.33
03,008,01,006,0136,0,1113 ,8 ,1121 ,2024 ,0,3,1,3,0,1,0,76.14,55.39 ,33.33
03,008,01,006,0137,0,860 ,5 ,865 ,1557 ,0,3,1,3,0,1,0,76.14,55.56 ,33.33
03,008,01,006,0138,0,607 ,4 ,611 ,1031 ,0,3,1,3,0,1,0,76.14,59.26 ,33.33
03,008,01,006,0139,0,605 ,3 ,608 ,1003 ,0,3,1,3,0,1,0,76.14,60.62 ,33.33
03,008,01,006,0140,0,2067 ,11 ,2078 ,3646 ,0,3,1,3,0,1,0,76.14,56.99 ,33.33
03,008,01,006,0141,0,898 ,7 ,905 ,1629 ,0,3,1,3,0,1,0,76.14,55.56 ,33.33
03,008,01,006,0142,0,497 ,8 ,505 ,850 ,0,3,1,3,0,1,0,76.14,59.41 ,33.33
03,008,01,006,0143,0,611 ,12 ,623 ,988 ,0,3,1,3,0,1,0,76.14,63.06 ,33.33
03,008,01,006,0144,0,2664,27,2691,4591,0,3,1,3,0,1,0,76.14,58.61 ,33.33
03,008,01,006,0147,0,758 ,7 ,765 ,1243 ,0,3,1,3,0,1,0,76.14,61.54 ,33.33
03,008,01,006,0148,0,549 ,9 ,558 ,932 ,0,3,1,3,0,1,0,76.14,59.87 ,33.33
03,008,01,006,0149,0,855 ,14 ,869 ,1486 ,0,3,1,3,0,1,0,76.14,58.4791386272,33.33
03,008,01,006,0150,0,766 ,4 ,770 ,1497 ,0,3,1,3,0,1,0,76.14,51.44 ,33.33
03,008,01,006,0151,0,641 ,9 ,650 ,1132 ,0,3,1,3,0,1,0,76.14,57.42 ,33.33
03,008,01,006,0152,0,469 ,6 ,475 ,808 ,0,3,1,3,0,1,0,76.14,58.79 ,33.33
03,008,01,006,0153,0,516 ,6 ,522 ,880 ,0,3,1,3,0,1,0,76.14,59.32 ,33.33
03,008,01,006,0154,0,459 ,3 ,462 ,814 ,0,3,1,3,0,1,0,76.14,56.76 ,33.33
03,008,01,006,0155,0,980 ,12 ,992 ,1637 ,0,3,1,3,0,1,0,76.14,60.5986560782,33.33
03,008,01,007,0156,0,812 ,7 ,819 ,1573 ,0,3,1,3,0,1,0,76.14,52.0661157025,33.33
03,008,01,007,0157,0,990 ,6 ,996 ,1672 ,0,3,1,3,0,1,0,76.14,59.5693779904,33.33
03,008,01,007,0158,0,749 ,3 ,752 ,1180 ,0,3,1,3,0,1,0,76.14,63.7288135593,33.33
03,008,01,007,0159,0,1226 ,11 ,1237 ,1846 ,0,3,1,3,0,1,0,76.14,67.0097508126,33.33
03,008,01,007,0160,0,592 ,3 ,595 ,1017 ,0,3,1,3,0,1,0,76.14,58.5054080629,33.33
03,008,01,007,0161,0,382 ,1 ,383 ,603 ,0,3,1,3,0,1,0,76.14,63.5157545605,33.33
03,008,01,007,0162,0,861 ,3 ,864 ,1524 ,0,3,1,3,0,1,0,76.14,56.6929133858,33.33
03,008,01,007,0163,0,539 ,5 ,544 ,895 ,0,3,1,3,0,1,0,76.14,60.782122905,33.33
03,008,01,007,0164,0,804 ,5 ,809 ,1352 ,0,3,1,3,0,1,0,76.14,59.8372781065,33.33
03,008,01,007,0165,0,847 ,3 ,850 ,1343 ,0,3,1,3,0,1,0,76.14,63.2911392405,33.33
03,008,01,007,0166,0,553 ,3 ,556 ,1070 ,0,3,1,3,0,1,0,76.14,51.9626168224,33.33
03,008,01,007,0167,0,417 ,3 ,420 ,714 ,0,3,1,3,0,1,0,76.14,58.8235294118,33.33
03,008,01,007,0168,0,397 ,0 ,397 ,768 ,0,3,1,3,0,1,0,76.14,51.6927083333,33.33
03,008,01,008,0169,0,473 ,7 ,480 ,840 ,0,3,1,3,0,1,0,76.14,57.1428571429,33.33
03,008,01,008,0170,0,284 ,6 ,290 ,516 ,0,3,1,3,0,1,0,76.14,56.2015503876,33.33
03,008,01,008,0171,0,430 ,1 ,431 ,734 ,0,3,1,3,0,1,0,76.14,58.719346049,33.33
03,008,01,008,0172,0,427 ,3 ,430 ,792 ,0,3,1,3,0,1,0,76.14,54.2929292929,33.33
03,008,01,008,0173,0,369 ,5 ,374 ,683 ,0,3,1,3,0,1,0,76.14,54.7584187408,33.33
03,008,01,008,0174,0,990 ,7 ,997 ,1755 ,0,3,1,3,0,1,0,76.14,56.8091168091,33.33
03,008,01,008,0175,0,145 ,0 ,145 ,263 ,0,3,1,3,0,1,0,76.14,55.1330798479,33.33
03,008,01,008,0176,0,425 ,2 ,427 ,711 ,0,3,1,3,0,1,0,76.14,60.0562587904,33.33
03,008,01,008,0177,0,303 ,3 ,306 ,545 ,0,3,1,3,0,1,0,76.14,56.1467889908,33.33
03,008,01,008,0178,0,657 ,7 ,664 ,1156 ,0,3,1,3,0,1,0,76.14,57.4394463668,33.33
03,008,01,008,0179,0,643 ,10 ,653 ,1110 ,0,3,1,3,0,1,0,76.14,58.8288288288,33.33
03,008,01,008,0180,0,534 ,4 ,538 ,945 ,0,3,1,3,0,1,0,76.14,56.9312169312,33.33
03,008,01,008,0181,0,253 ,4 ,257 ,470 ,0,3,1,3,0,1,0,76.14,54.6808510638,33.33
03,008,01,008,0182,0,430 ,1 ,431 ,706 ,0,3,1,3,0,1,0,76.14,61.0481586402,33.33
03,008,01,008,0183,0,314 ,4 ,318 ,538 ,0,3,1,3,0,1,0,76.14,59.1078066914,33.33
03,008,01,008,0184,0,357 ,3 ,360 ,673 ,0,3,1,3,0,1,0,76.14,53.4918276374,33.33
03,008,01,008,0185,0,283 ,1 ,284 ,436 ,0,3,1,3,0,1,0,76.14,65.1376146789,33.33
03,008,01,008,0186,0,324 ,3 ,327 ,543 ,0,3,1,3,0,1,0,76.14,60.2209944751,33.33
03,008,01,009,0187,0,970 ,13 ,983 ,1894 ,0,3,1,3,0,1,0,76.14,51.9007391763,33.33
03,008,01,009,0188,0,785 ,10 ,795 ,1514 ,0,3,1,3,0,1,0,76.14,52.5099075297,33.33
03,008,01,009,0189,0,555 ,5 ,560 ,1069 ,0,3,1,3,0,1,0,76.14,52.3854069224,33.33
03,008,01,009,0190,0,614 ,5 ,619 ,1224 ,0,3,1,3,0,1,0,76.14,50.5718954248,33.33
03,008,01,009,0191,0,492 ,5 ,497 ,947 ,0,3,1,3,0,1,0,76.14,52.4815205913,33.33
03,008,01,009,0192,0,710 ,6 ,716 ,1322 ,0,3,1,3,0,1,0,76.14,54.1603630862,33.33
03,008,01,009,0193,0,361 ,4 ,365 ,665 ,0,3,1,3,0,1,0,76.14,54.8872180451,33.33
03,008,01,009,0194,0,426 ,2 ,428 ,721 ,0,3,1,3,0,1,0,76.14,59.3619972261,33.33
03,008,01,009,0195,0,548 ,3 ,551 ,1020 ,0,3,1,3,0,1,0,76.14,54.0196078431,33.33
03,008,01,009,0196,0,405 ,4 ,409 ,809 ,0,3,1,3,0,1,0,76.14,50.5562422744,33.33
03,008,01,009,0197,0,257 ,1 ,258 ,522 ,0,3,1,3,0,1,0,76.14,49.4252873563,33.33
03,008,01,009,0198,0,533 ,6 ,539 ,953 ,0,3,1,3,0,1,0,76.14,56.5582371459,33.33
03,008,01,009,0199,0,413 ,1 ,414 ,739 ,0,3,1,3,0,1,0,76.14,56.0216508796,33.33
03,008,01,010,0200,0,868 ,5 ,873 ,1630 ,0,3,1,3,0,1,0,76.14,53.5582822086,33.33
03,008,01,010,0201,0,887 ,5 ,892 ,1681 ,0,3,1,3,0,1,0,76.14,53.0636525877,33.33
03,008,01,010,0202,0,408 ,3 ,411 ,756 ,0,3,1,3,0,1,0,76.14,54.3650793651,33.33
03,008,01,010,0203,0,720 ,7 ,727 ,1503 ,0,3,1,3,0,1,0,76.14,48.369926813,33.33
03,008,01,010,0204,0,337 ,7 ,344 ,694 ,0,3,1,3,0,1,0,76.14,49.5677233429,33.33
03,008,01,010,0205,0,405 ,8 ,413 ,824 ,0,3,1,3,0,1,0,76.14,50.1213592233,33.33
03,008,01,010,0206,0,955 ,11 ,966 ,1977 ,0,3,1,3,0,1,0,76.14,48.8619119879,33.33
03,008,01,010,0207,0,987 ,17 ,1004 ,1844 ,0,3,1,3,0,1,0,76.14,54.4468546638,33.33
03,008,01,010,0208,0,462 ,3 ,465 ,854 ,0,3,1,3,0,1,0,76.14,54.4496487119,33.33
03,008,01,010,0209,0,678 ,10 ,688 ,1198 ,0,3,1,3,0,1,0,76.14,57.429048414,33.33
03,008,01,010,0210,0,390 ,5 ,395 ,754 ,0,3,1,3,0,1,0,76.14,52.3872679045,33.33
03,008,01,010,0211,0,857 ,5 ,862 ,1605 ,0,3,1,3,0,1,0,76.14,53.707165109,33.33
03,008,01,010,0212,0,914 ,15 ,929 ,1870 ,0,3,1,3,0,1,0,76.14,49.679144385,33.33
03,008,01,011,0213,0,485 ,4 ,489 ,895 ,0,3,1,3,0,1,0,76.14,54.6368715084,33.33
03,008,01,011,0214,0,864 ,7 ,871 ,1624 ,0,3,1,3,0,1,0,76.14,53.6330049261,33.33
03,008,01,011,0215,0,441 ,2 ,443 ,720 ,0,3,1,3,0,1,0,76.14,61.5277777778,33.33
03,008,01,011,0216,0,602 ,3 ,605 ,1029 ,0,3,1,3,0,1,0,76.14,58.79494655,33.33
03,008,01,011,0217,0,298 ,3 ,301 ,529 ,0,3,1,3,0,1,0,76.14,56.8998109641,33.33
03,008,01,011,0218,0,560 ,2 ,562 ,990 ,0,3,1,3,0,1,0,76.14,56.7676767677,33.33
03,008,01,011,0219,0,769 ,5 ,774 ,1391 ,0,3,1,3,0,1,0,76.14,55.6434219986,33.33
03,008,01,011,0220,0,667 ,5 ,672 ,1061 ,0,3,1,3,0,1,0,76.14,63.3364750236,33.33
03,008,01,011,0221,0,797 ,4 ,801 ,1367 ,0,3,1,3,0,1,0,76.14,58.5954645208,33.33
03,008,01,011,0222,0,518 ,7 ,525 ,1041 ,0,3,1,3,0,1,0,76.14,50.4322766571,33.33
03,008,01,011,0223,0,582 ,4 ,586 ,1151 ,0,3,1,3,0,1,0,76.14,50.9122502172,33.33
03,008,01,011,0224,0,182 ,2 ,184 ,370 ,0,3,1,3,0,1,0,76.14,49.7297297297,33.33
03,008,01,011,0225,0,209 ,2 ,211 ,365 ,0,3,1,3,0,1,0,76.14,57.8082191781,33.33
03,008,01,011,0226,0,592 ,3 ,595 ,1161 ,0,3,1,3,0,1,0,76.14,51.2489233419,33.33
03,008,01,011,0227,0,189 ,4 ,193 ,347 ,0,3,1,3,0,1,0,76.14,55.6195965418,33.33
03,008,01,011,0228,0,213 ,2 ,215 ,361 ,0,3,1,3,0,1,0,76.14,59.5567867036,33.33
03,008,01,011,0229,0,517 ,1 ,518 ,914 ,0,3,1,3,0,1,0,76.14,56.6739606127,33.33
03,008,01,011,0230,0,307 ,3 ,310 ,541 ,0,3,1,3,0,1,0,76.14,57.3012939002,33.33
03,008,01,011,0231,0,367 ,3 ,370 ,690 ,0,3,1,3,0,1,0,76.14,53.6231884058,33.33
03,008,01,012,0232,0,8 ,0 ,8 ,16 ,0,3,1,3,0,1,0,76.14,50,33.33
03,008,01,012,0233,0,40 ,0 ,40 ,76 ,0,3,1,3,0,1,0,76.14,52.6315789474,33.33
03,008,01,012,0234,0,13 ,0 ,13 ,33 ,0,3,1,3,0,1,0,76.14,39.3939393939,33.33
03,008,01,012,0235,0,89 ,0 ,89 ,222 ,0,3,1,3,0,1,0,76.14,40.0900900901,33.33
03,008,01,012,0236,0,641 ,6 ,647 ,1100 ,0,3,1,3,0,1,0,76.14,58.8181818182,33.33
03,008,01,012,0237,0,452 ,5 ,457 ,745 ,0,3,1,3,0,1,0,76.14,61.3422818792,33.33
03,008,01,012,0238,0,311 ,7 ,318 ,530 ,0,3,1,3,0,1,0,76.14,60,33.33
03,008,01,012,0239,0,181 ,2 ,183 ,327 ,0,3,1,3,0,1,0,76.14,55.9633027523,33.33
03,008,01,012,0240,0,32 ,0 ,32 ,63 ,0,3,1,3,0,1,0,76.14,50.7936507937,33.33
03,008,01,012,0241,0,109 ,0 ,109 ,230 ,0,3,1,3,0,1,0,76.14,47.3913043478,33.33
03,008,01,012,0242,0,151 ,1 ,152 ,300 ,0,3,1,3,0,1,0,76.14,50.6666666667,33.33
03,008,01,012,0243,0,775 ,4 ,779 ,1365 ,0,3,1,3,0,1,0,76.14,57.0695970696,33.33
03,008,01,012,0244,0,380 ,5 ,385 ,734 ,0,3,1,3,0,1,0,76.14,52.4523160763,33.33
03,008,01,012,0245,0,155 ,2 ,157 ,285 ,0,3,1,3,0,1,0,76.14,55.0877192982,33.33
03,008,01,013,0246,0,279 ,1 ,280 ,541 ,0,3,1,3,0,1,0,76.14,51.7560073937,33.33
03,008,01,013,0247,0,590 ,3 ,593 ,1107 ,0,3,1,3,0,1,0,76.14,53.5682023487,33.33
03,008,01,013,0248,0,46 ,0 ,46 ,76 ,0,3,1,3,0,1,0,76.14,60.5263157895,33.33
03,008,01,013,0249,0,34 ,0 ,34 ,66 ,0,3,1,3,0,1,0,76.14,51.5151515152,33.33
03,008,01,013,0250,0,76 ,0 ,76 ,166 ,0,3,1,3,0,1,0,76.14,45.7831325301,33.33
03,008,01,013,0251,0,10 ,0 ,10 ,26 ,0,3,1,3,0,1,0,76.14,38.4615384615,33.33
03,008,01,013,0252,0,26 ,1 ,27 ,59 ,0,3,1,3,0,1,0,76.14,45.7627118644,33.33
03,008,01,013,0253,0,7 ,0 ,7 ,13 ,0,3,1,3,0,1,0,76.14,53.8461538462,33.33
03,008,01,013,0254,0,73 ,2 ,75 ,251 ,0,3,1,3,0,1,0,76.14,29.8804780876,33.33
03,008,01,013,0255,0,30 ,0 ,30 ,90 ,0,3,1,3,0,1,0,76.14,33.3333333333,33.33
03,008,01,013,0256,0,19 ,0 ,19 ,50 ,0,3,1,3,0,1,0,76.14,38,33.33
03,008,01,013,0257,0,10 ,0 ,10 ,29 ,0,3,1,3,0,1,0,76.14,34.4827586207,33.33
03,008,01,013,0258,0,34 ,0 ,34 ,85 ,0,3,1,3,0,1,0,76.14,40,33.33
03,008,01,013,0259,0,43 ,0 ,43 ,121 ,0,3,1,3,0,1,0,76.14,35.5371900826,33.33
03,008,01,013,0260,0,20 ,1 ,21 ,47 ,0,3,1,3,0,1,0,76.14,44.6808510638,33.33
03,009,01,001,0001,0,524 ,0 ,524 ,761 ,0,3,1,3,0,1,0,76.14,68.86 ,33.33
03,009,01,001,0002,0,485 ,5 ,490 ,695 ,0,3,1,3,0,1,0,76.14,70.50 ,33.33
03,009,01,001,0003,0,522 ,3 ,525 ,753 ,0,3,1,3,0,1,0,76.14,69.72 ,33.33
03,009,01,001,0004,0,666 ,8 ,674 ,914 ,0,3,1,3,0,1,0,76.14,73.74 ,33.33
03,009,01,001,0005,0,588 ,5 ,593 ,908 ,0,3,1,3,0,1,0,76.14,65.31 ,33.33
03,009,01,001,0006,0,1844 ,20 ,1864 ,2941 ,0,3,1,3,0,1,0,76.14,63.38 ,33.33
03,009,01,001,0007,0,2355 ,25 ,2380 ,3652 ,0,3,1,3,0,1,0,76.14,65.17 ,33.33
03,009,01,001,0008,0,2007 ,21 ,2028 ,3083 ,0,3,1,3,0,1,0,76.14,65.78 ,33.33
03,009,01,001,0009,0,1433 ,19 ,1452 ,2381 ,0,3,1,3,0,1,0,76.14,60.98 ,33.33
03,009,01,001,0010,0,1557 ,27 ,1584 ,2358 ,0,3,1,3,0,1,0,76.14,67.18 ,33.33
03,009,01,001,0011,0,1132 ,8 ,1140 ,1817 ,0,3,1,3,0,1,0,76.14,62.74 ,33.33
03,009,01,001,0012,0,970 ,15 ,985 ,1443 ,0,3,1,3,0,1,0,76.14,68.26 ,33.33
03,009,01,001,0013,0,713 ,5 ,718 ,1125 ,0,3,1,3,0,1,0,76.14,63.82 ,33.33
03,009,01,001,0014,0,1756 ,13 ,1769 ,2709 ,0,3,1,3,0,1,0,76.14,65.30 ,33.33
03,009,01,001,0015,0,1540 ,20 ,1560 ,2351 ,0,3,1,3,0,1,0,76.14,66.35 ,33.33
03,009,01,001,0016,0,1278 ,17 ,1295 ,2026 ,0,3,1,3,0,1,0,76.14,63.92 ,33.33
03,009,01,001,0017,0,2244 ,24 ,2268 ,3546 ,0,3,1,3,0,1,0,76.14,63.96 ,33.33
03,009,01,001,0018,0,1341 ,13 ,1354 ,2029 ,0,3,1,3,0,1,0,76.14,66.73 ,33.33
03,009,01,001,0019,0,2066 ,8 ,2074 ,3250 ,0,3,1,3,0,1,0,76.14,63.82 ,33.33
03,009,01,001,0020,0,1404 ,9 ,1413 ,2120 ,0,3,1,3,0,1,0,76.14,66.65 ,33.33
03,009,01,001,0021,0,804 ,8 ,812 ,1169 ,0,3,1,3,0,1,0,76.14,69.46 ,33.33
03,009,01,001,0022,0,507 ,22 ,529 ,752 ,0,3,1,3,0,1,0,76.14,70.35 ,33.33
03,009,01,001,0023,0,1170 ,12 ,1182 ,1780 ,0,3,1,3,0,1,0,76.14,66.40 ,33.33
03,009,01,001,0024,0,416 ,4 ,420 ,598 ,0,3,1,3,0,1,0,76.14,70.23 ,33.33
03,009,01,001,0025,0,991 ,19 ,1010 ,1622 ,0,3,1,3,0,1,0,76.14,62.27 ,33.33
03,009,01,001,0026,0,397 ,5 ,402 ,565 ,0,3,1,3,0,1,0,76.14,71.15 ,33.33
03,009,01,001,0027,0,1284 ,11 ,1295 ,1912 ,0,3,1,3,0,1,0,76.14,67.73 ,33.33
03,009,01,001,0028,0,3014 ,27 ,3041 ,4479 ,0,3,1,3,0,1,0,76.14,67.89 ,33.33
03,009,01,001,0029,0,2093 ,12 ,2105 ,3146 ,0,3,1,3,0,1,0,76.14,66.91 ,33.33
03,009,01,001,0030,0,1065 ,6 ,1071 ,1565 ,0,3,1,3,0,1,0,76.14,68.43 ,33.33
03,009,01,001,0031,0,2445 ,30 ,2475 ,3806 ,0,3,1,3,0,1,0,76.14,65.03 ,33.33
03,009,01,001,0032,0,626 ,6 ,632 ,944 ,0,3,1,3,0,1,0,76.14,66.95 ,33.33
03,009,01,001,0033,0,770 ,11 ,781 ,1239 ,0,3,1,3,0,1,0,76.14,63.03 ,33.33
03,009,01,001,0034,0,1208 ,11 ,1219 ,1708 ,0,3,1,3,0,1,0,76.14,71.37 ,33.33
03,009,01,001,0035,0,883 ,14 ,897 ,1258 ,0,3,1,3,0,1,0,76.14,71.30 ,33.33
03,009,01,001,0036,0,1625 ,17 ,1642 ,2566 ,0,3,1,3,0,1,0,76.14,63.99 ,33.33
03,009,01,001,0037,0,1643 ,18 ,1661 ,2471 ,0,3,1,3,0,1,0,76.14,67.22 ,33.33
03,009,01,001,0038,0,801 ,4 ,805 ,1131 ,0,3,1,3,0,1,0,76.14,71.18 ,33.33
03,009,01,002,0039,0,726 ,8 ,734 ,1131 ,0,3,1,3,0,1,0,76.14,64.90 ,33.33
03,009,01,002,0040,0,2835 ,15 ,2850 ,4560 ,0,3,1,3,0,1,0,76.14,62.50 ,33.33
03,009,01,002,0041,0,1220 ,3 ,1223 ,2020 ,0,3,1,3,0,1,0,76.14,60.54 ,33.33
03,009,01,002,0042,0,846 ,6 ,852 ,1315 ,0,3,1,3,0,1,0,76.14,64.79 ,33.33
03,009,01,002,0043,0,814 ,4 ,818 ,1249 ,0,3,1,3,0,1,0,76.14,65.49 ,33.33
03,009,01,002,0044,0,826 ,1 ,827 ,1258 ,0,3,1,3,0,1,0,76.14,65.74 ,33.33
03,009,01,002,0045,0,618 ,2 ,620 ,871 ,0,3,1,3,0,1,0,76.14,71.18 ,33.33
03,009,01,002,0046,0,604 ,5 ,609 ,924 ,0,3,1,3,0,1,0,76.14,65.91 ,33.33
03,009,01,002,0047,0,665 ,5 ,670 ,911 ,0,3,1,3,0,1,0,76.14,73.55 ,33.33
03,009,01,002,0048,0,480 ,6 ,486 ,736 ,0,3,1,3,0,1,0,76.14,66.03 ,33.33
03,009,01,002,0049,0,878 ,9 ,887 ,1175 ,0,3,1,3,0,1,0,76.14,75.49 ,33.33
03,009,01,002,0050,0,963 ,9 ,972 ,1472 ,0,3,1,3,0,1,0,76.14,66.03 ,33.33
03,009,01,002,0051,0,1199 ,17 ,1216 ,2010 ,0,3,1,3,0,1,0,76.14,60.50 ,33.33
03,009,01,002,0052,0,2788 ,22 ,2810 ,4359 ,0,3,1,3,0,1,0,76.14,64.46 ,33.33
03,009,01,002,0053,0,611 ,10 ,621 ,913 ,0,3,1,3,0,1,0,76.14,68.02 ,33.33
03,009,01,002,0054,0,575 ,4 ,579 ,828 ,0,3,1,3,0,1,0,76.14,69.93 ,33.33
03,009,01,002,0055,0,672 ,3 ,675 ,940 ,0,3,1,3,0,1,0,76.14,71.81 ,33.33
03,009,01,002,0056,0,1030 ,12 ,1042 ,1585 ,0,3,1,3,0,1,0,76.14,65.74 ,33.33
03,009,01,002,0057,0,643 ,13 ,656 ,968 ,0,3,1,3,0,1,0,76.14,67.77 ,33.33
03,009,01,002,0058,0,1631 ,11 ,1642 ,2448 ,0,3,1,3,0,1,0,76.14,67.08 ,33.33
03,009,01,002,0059,0,1424 ,16 ,1440 ,2062 ,0,3,1,3,0,1,0,76.14,69.84 ,33.33
03,009,01,002,0060,0,1020 ,8 ,1028 ,1578 ,0,3,1,3,0,1,0,76.14,65.15 ,33.33
03,009,01,003,0061,0,1423 ,16 ,1439 ,2303 ,0,3,1,3,0,1,0,76.14,62.48 ,33.33
03,009,01,003,0062,0,1066 ,5 ,1071 ,1695 ,0,3,1,3,0,1,0,76.14,63.19 ,33.33
03,009,01,003,0063,0,1682 ,15 ,1697 ,2652 ,0,3,1,3,0,1,0,76.14,63.99 ,33.33
03,009,01,003,0064,0,1377 ,9 ,1386 ,2410 ,0,3,1,3,0,1,0,76.14,57.51 ,33.33
03,009,01,003,0065,0,657 ,5 ,662 ,1045 ,0,3,1,3,0,1,0,76.14,63.35 ,33.33
03,009,01,003,0066,0,1801 ,16 ,1817 ,2968 ,0,3,1,3,0,1,0,76.14,61.22 ,33.33
03,009,01,003,0067,0,2126 ,15 ,2141 ,3502 ,0,3,1,3,0,1,0,76.14,61.14 ,33.33
03,009,01,003,0068,0,875 ,13 ,888 ,1349 ,0,3,1,3,0,1,0,76.14,65.83 ,33.33
03,009,01,003,0069,0,995 ,7 ,1002 ,1632 ,0,3,1,3,0,1,0,76.14,61.40 ,33.33
03,009,01,003,0070,0,1085 ,14 ,1099 ,1782 ,0,3,1,3,0,1,0,76.14,61.67 ,33.33
03,009,01,003,0071,0,1541 ,23 ,1564 ,2626 ,0,3,1,3,0,1,0,76.14,59.56 ,33.33
03,009,01,003,0072,0,1055 ,9 ,1064 ,1663 ,0,3,1,3,0,1,0,76.14,63.98 ,33.33
03,009,01,003,0073,0,604 ,10 ,614 ,942 ,0,3,1,3,0,1,0,76.14,65.18 ,33.33
03,009,01,003,0074,0,365 ,2 ,367 ,631 ,0,3,1,3,0,1,0,76.14,58.16 ,33.33
03,009,01,003,0075,0,1497 ,15 ,1512 ,2351 ,0,3,1,3,0,1,0,76.14,64.31 ,33.33
03,009,01,003,0076,0,552 ,9 ,561 ,789 ,0,3,1,3,0,1,0,76.14,71.10 ,33.33
03,009,01,003,0077,0,1073 ,21 ,1094 ,1727 ,0,3,1,3,0,1,0,76.14,63.35 ,33.33
03,009,01,003,0078,0,1058 ,6 ,1064 ,1575 ,0,3,1,3,0,1,0,76.14,67.56 ,33.33
03,009,01,003,0079,0,1809 ,23 ,1832 ,2838 ,0,3,1,3,0,1,0,76.14,64.55 ,33.33
03,009,01,003,0080,0,1415 ,24 ,1439 ,2271 ,0,3,1,3,0,1,0,76.14,63.36 ,33.33
03,009,01,003,0081,0,1634 ,17 ,1651 ,2467 ,0,3,1,3,0,1,0,76.14,66.92 ,33.33
03,009,01,003,0082,0,839 ,7 ,846 ,1307 ,0,3,1,3,0,1,0,76.14,64.73 ,33.33
03,009,01,003,0083,0,967 ,5 ,972 ,1319 ,0,3,1,3,0,1,0,76.14,73.69 ,33.33
03,009,01,003,0084,0,724 ,4 ,728 ,1181 ,0,3,1,3,0,1,0,76.14,61.64 ,33.33
03,009,01,003,0085,0,973 ,15 ,988 ,1497 ,0,3,1,3,0,1,0,76.14,66.00 ,33.33
03,009,01,003,0086,0,521 ,9 ,530 ,870 ,0,3,1,3,0,1,0,76.14,60.92 ,33.33
03,009,01,003,0087,0,588 ,6 ,594 ,976 ,0,3,1,3,0,1,0,76.14,60.86 ,33.33
03,009,01,003,0088,0,532 ,9 ,541 ,773 ,0,3,1,3,0,1,0,76.14,69.99 ,33.33
03,009,01,003,0089,0,688 ,3 ,691 ,1041 ,0,3,1,3,0,1,0,76.14,66.38 ,33.33
03,009,01,004,0090,0,1075 ,6 ,1081 ,1603 ,0,3,1,3,0,1,0,76.14,67.44 ,33.33
03,009,01,004,0091,0,1002 ,10 ,1012 ,1509 ,0,3,1,3,0,1,0,76.14,67.06 ,33.33
03,009,01,004,0092,0,1088 ,5 ,1093 ,1672 ,0,3,1,3,0,1,0,76.14,65.37 ,33.33
03,009,01,004,0093,0,1798 ,12 ,1810 ,2896 ,0,3,1,3,0,1,0,76.14,62.50 ,33.33
03,009,01,004,0094,0,294 ,3 ,297 ,441 ,0,3,1,3,0,1,0,76.14,67.35 ,33.33
03,009,01,004,0095,0,463 ,7 ,470 ,684 ,0,3,1,3,0,1,0,76.14,68.71 ,33.33
03,009,01,004,0096,0,409 ,1 ,410 ,632 ,0,3,1,3,0,1,0,76.14,64.87 ,33.33
03,009,01,004,0097,0,635 ,5 ,640 ,994 ,0,3,1,3,0,1,0,76.14,64.39 ,33.33
03,009,01,004,0098,0,1448 ,11 ,1459 ,2274 ,0,3,1,3,0,1,0,76.14,64.16 ,33.33
03,009,01,004,0099,0,2133 ,24 ,2157 ,3477 ,0,3,1,3,0,1,0,76.14,62.04 ,33.33
03,009,01,004,0100,0,870 ,5 ,875 ,1294 ,0,3,1,3,0,1,0,76.14,67.62 ,33.33
03,009,01,004,0101,0,1003 ,15 ,1018 ,1501 ,0,3,1,3,0,1,0,76.14,67.82 ,33.33
03,009,01,004,0102,0,1206 ,12 ,1218 ,1735 ,0,3,1,3,0,1,0,76.14,70.20 ,33.33
03,009,01,004,0103,0,601 ,6 ,607 ,891 ,0,3,1,3,0,1,0,76.14,68.13 ,33.33
03,009,01,004,0104,0,698 ,9 ,707 ,1105 ,0,3,1,3,0,1,0,76.14,63.98 ,33.33
03,009,01,004,0105,0,1003 ,10 ,1013 ,1499 ,0,3,1,3,0,1,0,76.14,67.58 ,33.33
03,009,01,004,0106,0,628 ,6 ,634 ,859 ,0,3,1,3,0,1,0,76.14,73.81 ,33.33
03,009,01,004,0107,0,709 ,9 ,718 ,974 ,0,3,1,3,0,1,0,76.14,73.72 ,33.33
03,009,01,004,0108,0,872 ,9 ,881 ,1360 ,0,3,1,3,0,1,0,76.14,64.78 ,33.33
03,009,01,004,0109,0,544 ,4 ,548 ,760 ,0,3,1,3,0,1,0,76.14,72.11 ,33.33
03,009,01,004,0110,0,584 ,1 ,585 ,813 ,0,3,1,3,0,1,0,76.14,71.96 ,33.33
03,009,01,004,0111,0,652 ,10 ,662 ,965 ,0,3,1,3,0,1,0,76.14,68.60 ,33.33
03,009,01,004,0112,0,863 ,13 ,876 ,1371 ,0,3,1,3,0,1,0,76.14,63.89 ,33.33
03,009,01,004,0113,0,634 ,5 ,639 ,970 ,0,3,1,3,0,1,0,76.14,65.88 ,33.33
03,009,01,004,0114,0,573 ,6 ,579 ,916 ,0,3,1,3,0,1,0,76.14,63.21 ,33.33
03,009,01,004,0115,0,1116 ,13 ,1129 ,1790 ,0,3,1,3,0,1,0,76.14,63.07 ,33.33
03,009,01,004,0116,0,965 ,15 ,980 ,1438 ,0,3,1,3,0,1,0,76.14,68.15 ,33.33
03,009,01,005,0117,0,624 ,5 ,629 ,917 ,0,3,1,3,0,1,0,76.14,68.59 ,33.33
03,009,01,005,0118,0,711 ,12 ,723 ,1018 ,0,3,1,3,0,1,0,76.14,71.02 ,33.33
03,009,01,005,0119,0,922 ,11 ,933 ,1390 ,0,3,1,3,0,1,0,76.14,67.12 ,33.33
03,009,01,005,0120,0,649 ,8 ,657 ,922 ,0,3,1,3,0,1,0,76.14,71.26 ,33.33
03,009,01,005,0121,0,797 ,14 ,811 ,1155 ,0,3,1,3,0,1,0,76.14,70.22 ,33.33
03,009,01,005,0122,0,1071 ,14 ,1085 ,1659 ,0,3,1,3,0,1,0,76.14,65.40 ,33.33
03,009,01,005,0123,0,843 ,7 ,850 ,1334 ,0,3,1,3,0,1,0,76.14,63.72 ,33.33
03,009,01,005,0124,0,856 ,10 ,866 ,1414 ,0,3,1,3,0,1,0,76.14,61.24 ,33.33
03,009,01,005,0125,0,937 ,13 ,950 ,1439 ,0,3,1,3,0,1,0,76.14,66.02 ,33.33
03,009,01,005,0126,0,1435 ,9 ,1444 ,2352 ,0,3,1,3,0,1,0,76.14,61.39 ,33.33
03,009,01,005,0127,0,961 ,12 ,973 ,1525 ,0,3,1,3,0,1,0,76.14,63.80 ,33.33
03,009,01,005,0128,0,578 ,13 ,591 ,883 ,0,3,1,3,0,1,0,76.14,66.93 ,33.33
03,009,01,005,0129,0,1129 ,9 ,1138 ,1882 ,0,3,1,3,0,1,0,76.14,60.47 ,33.33
03,009,01,005,0130,0,1137 ,8 ,1145 ,1821 ,0,3,1,3,0,1,0,76.14,62.88 ,33.33
03,009,01,005,0131,0,1131 ,6 ,1137 ,1788 ,0,3,1,3,0,1,0,76.14,63.59 ,33.33
03,009,01,005,0132,0,626 ,3 ,629 ,993 ,0,3,1,3,0,1,0,76.14,63.34 ,33.33
03,009,01,005,0133,0,898 ,9 ,907 ,1475 ,0,3,1,3,0,1,0,76.14,61.49 ,33.33
03,009,01,006,0134,0,545 ,7 ,552 ,789 ,0,3,1,3,0,1,0,76.14,69.96 ,33.33
03,009,01,006,0135,0,510 ,3 ,513 ,749 ,0,3,1,3,0,1,0,76.14,68.49 ,33.33
03,009,01,006,0136,0,337 ,4 ,341 ,512 ,0,3,1,3,0,1,0,76.14,66.60 ,33.33
03,009,01,006,0137,0,702 ,6 ,708 ,998 ,0,3,1,3,0,1,0,76.14,70.94 ,33.33
03,009,01,006,0138,0,267 ,4 ,271 ,430 ,0,3,1,3,0,1,0,76.14,63.02 ,33.33
03,009,01,006,0139,0,305 ,3 ,308 ,452 ,0,3,1,3,0,1,0,76.14,68.14 ,33.33
03,009,01,006,0140,0,292 ,1 ,293 ,417 ,0,3,1,3,0,1,0,76.14,70.26 ,33.33
03,009,01,006,0141,0,616 ,6 ,622 ,949 ,0,3,1,3,0,1,0,76.14,65.54 ,33.33
03,009,01,006,0142,0,374 ,0 ,374 ,551 ,0,3,1,3,0,1,0,76.14,67.88 ,33.33
03,009,01,006,0143,0,247 ,0 ,247 ,382 ,0,3,1,3,0,1,0,76.14,64.66 ,33.33
03,009,01,006,0144,0,421 ,6 ,427 ,669 ,0,3,1,3,0,1,0,76.14,63.83 ,33.33
03,009,01,006,0145,0,838 ,10 ,848 ,1356 ,0,3,1,3,0,1,0,76.14,62.54 ,33.33
03,009,01,006,0146,0,341 ,3 ,344 ,528 ,0,3,1,3,0,1,0,76.14,65.15 ,33.33
03,009,01,006,0147,0,3049 ,36 ,3085 ,4855 ,0,3,1,3,0,1,0,76.14,63.54 ,33.33
03,009,01,006,0148,0,898 ,8 ,906 ,1448 ,0,3,1,3,0,1,0,76.14,62.57 ,33.33
03,009,01,006,0149,0,3116 ,30 ,3146 ,5098 ,0,3,1,3,0,1,0,76.14,61.71 ,33.33
03,009,01,006,0150,0,746 ,6 ,752 ,1190 ,0,3,1,3,0,1,0,76.14,63.19 ,33.33
03,009,01,006,0151,0,622 ,7 ,629 ,977 ,0,3,1,3,0,1,0,76.14,64.38 ,33.33
03,009,01,006,0152,0,264 ,4 ,268 ,436 ,0,3,1,3,0,1,0,76.14,61.47 ,33.33
03,009,01,006,0153,0,537 ,2 ,539 ,853 ,0,3,1,3,0,1,0,76.14,63.19 ,33.33
03,009,01,006,0154,0,830 ,12 ,842 ,1427 ,0,3,1,3,0,1,0,76.14,59.00 ,33.33
03,009,01,006,0155,0,722 ,5 ,727 ,1213 ,0,3,1,3,0,1,0,76.14,59.93 ,33.33
03,009,01,006,0156,0,550 ,3 ,553 ,1013 ,0,3,1,3,0,1,0,76.14,54.59 ,33.33
03,009,01,006,0157,0,339 ,6 ,345 ,644 ,0,3,1,3,0,1,0,76.14,53.57 ,33.33
03,009,01,006,0158,0,1091 ,14 ,1105 ,1650 ,0,3,1,3,0,1,0,76.14,66.97 ,33.33
03,009,01,006,0159,0,1669 ,19 ,1688 ,2798 ,0,3,1,3,0,1,0,76.14,60.33 ,33.33
03,009,01,006,0160,0,647 ,4 ,651 ,1025 ,0,3,1,3,0,1,0,76.14,63.51 ,33.33
03,009,01,006,0161,0,348 ,0 ,348 ,562 ,0,3,1,3,0,1,0,76.14,61.92 ,33.33
03,009,01,007,0162,0,1376 ,17 ,1393 ,2089 ,0,3,1,3,0,1,0,76.14,66.68 ,33.33
03,009,01,007,0163,0,963 ,12 ,975 ,1545 ,0,3,1,3,0,1,0,76.14,63.11 ,33.33
03,009,01,007,0164,0,1682 ,25 ,1707 ,2845 ,0,3,1,3,0,1,0,76.14,60.00 ,33.33
03,009,01,007,0165,0,900 ,7 ,907 ,1436 ,0,3,1,3,0,1,0,76.14,63.16 ,33.33
03,009,01,007,0166,0,789 ,10 ,799 ,1167 ,0,3,1,3,0,1,0,76.14,68.47 ,33.33
03,009,01,007,0167,0,788 ,10 ,798 ,1212 ,0,3,1,3,0,1,0,76.14,65.84 ,33.33
03,009,01,007,0168,0,644 ,6 ,650 ,979 ,0,3,1,3,0,1,0,76.14,66.39 ,33.33
03,009,01,007,0169,0,1279 ,13 ,1292 ,2057 ,0,3,1,3,0,1,0,76.14,62.81 ,33.33
03,009,01,007,0170,0,1300 ,12 ,1312 ,1952 ,0,3,1,3,0,1,0,76.14,67.21 ,33.33
03,009,01,007,0171,0,926 ,5 ,931 ,1399 ,0,3,1,3,0,1,0,76.14,66.55 ,33.33
03,009,01,007,0172,0,504 ,6 ,510 ,688 ,0,3,1,3,0,1,0,76.14,74.13 ,33.33
03,009,01,007,0173,0,1111 ,31 ,1142 ,1924 ,0,3,1,3,0,1,0,76.14,59.36 ,33.33
03,009,01,007,0174,0,1169 ,13 ,1182 ,2018 ,0,3,1,3,0,1,0,76.14,58.57 ,33.33
03,009,01,007,0175,0,465 ,11 ,476 ,660 ,0,3,1,3,0,1,0,76.14,72.12 ,33.33
03,009,01,007,0176,0,785 ,10 ,795 ,1266 ,0,3,1,3,0,1,0,76.14,62.80 ,33.33
03,009,01,007,0177,0,219 ,2 ,221 ,321 ,0,3,1,3,0,1,0,76.14,68.85 ,33.33
03,009,01,007,0178,0,434 ,9 ,443 ,788 ,0,3,1,3,0,1,0,76.14,56.22 ,33.33
03,009,01,007,0179,0,676 ,3 ,679 ,1167 ,0,3,1,3,0,1,0,76.14,58.18 ,33.33
03,009,01,007,0180,0,328 ,2 ,330 ,537 ,0,3,1,3,0,1,0,76.14,61.45 ,33.33
03,009,01,007,0181,0,456 ,4 ,460 ,675 ,0,3,1,3,0,1,0,76.14,68.15 ,33.33
03,009,01,008,0182,0,521 ,3 ,524 ,785 ,0,3,1,3,0,1,0,76.14,66.75 ,33.33
03,009,01,008,0183,0,1363 ,17 ,1380 ,2086 ,0,3,1,3,0,1,0,76.14,66.16 ,33.33
03,009,01,008,0184,0,719 ,7 ,726 ,1096 ,0,3,1,3,0,1,0,76.14,66.24 ,33.33
03,009,01,008,0185,0,659 ,4 ,663 ,990 ,0,3,1,3,0,1,0,76.14,66.97 ,33.33
03,009,01,008,0186,0,1184 ,13 ,1197 ,1882 ,0,3,1,3,0,1,0,76.14,63.60 ,33.33
03,009,01,008,0187,0,1172 ,16 ,1188 ,1815 ,0,3,1,3,0,1,0,76.14,65.45 ,33.33
03,009,01,008,0188,0,833 ,10 ,843 ,1385 ,0,3,1,3,0,1,0,76.14,60.87 ,33.33
03,009,01,008,0189,0,786 ,5 ,791 ,1254 ,0,3,1,3,0,1,0,76.14,63.08 ,33.33
03,009,01,008,0190,0,495 ,5 ,500 ,804 ,0,3,1,3,0,1,0,76.14,62.19 ,33.33
03,009,01,008,0191,0,429 ,8 ,437 ,684 ,0,3,1,3,0,1,0,76.14,63.89 ,33.33
03,009,01,008,0192,0,777 ,6 ,783 ,1227 ,0,3,1,3,0,1,0,76.14,63.81 ,33.33
03,009,01,008,0193,0,573 ,8 ,581 ,832 ,0,3,1,3,0,1,0,76.14,69.83 ,33.33
03,009,01,008,0194,0,443 ,5 ,448 ,716 ,0,3,1,3,0,1,0,76.14,62.57 ,33.33
03,009,01,008,0195,0,518 ,5 ,523 ,781 ,0,3,1,3,0,1,0,76.14,66.97 ,33.33
03,009,01,008,0196,0,533 ,5 ,538 ,788 ,0,3,1,3,0,1,0,76.14,68.27 ,33.33
03,009,01,009,0197,0,2324 ,26 ,2350 ,3550 ,0,3,1,3,0,1,0,76.14,66.20 ,33.33
03,009,01,009,0198,0,614 ,6 ,620 ,917 ,0,3,1,3,0,1,0,76.14,67.61 ,33.33
03,009,01,009,0199,0,995 ,9 ,1004 ,1619 ,0,3,1,3,0,1,0,76.14,62.01 ,33.33
03,009,01,009,0200,0,864 ,6 ,870 ,1269 ,0,3,1,3,0,1,0,76.14,68.56 ,33.33
03,009,01,009,0201,0,798 ,9 ,807 ,1149 ,0,3,1,3,0,1,0,76.14,70.23 ,33.33
03,009,01,009,0202,0,1173 ,13 ,1186 ,1749 ,0,3,1,3,0,1,0,76.14,67.81 ,33.33
03,009,01,009,0203,0,1664 ,3 ,1667 ,2517 ,0,3,1,3,0,1,0,76.14,66.23 ,33.33
03,009,01,009,0204,0,892 ,10 ,902 ,1282 ,0,3,1,3,0,1,0,76.14,70.36 ,33.33
03,009,01,009,0205,0,1250 ,6 ,1256 ,1894 ,0,3,1,3,0,1,0,76.14,66.31 ,33.33
03,009,01,009,0206,0,782 ,11 ,793 ,1170 ,0,3,1,3,0,1,0,76.14,67.78 ,33.33
03,009,01,009,0207,0,1221 ,17 ,1238 ,1759 ,0,3,1,3,0,1,0,76.14,70.38 ,33.33
03,009,01,009,0208,0,1141 ,9 ,1150 ,1588 ,0,3,1,3,0,1,0,76.14,72.42 ,33.33
03,009,01,009,0209,0,937 ,16 ,953 ,1335 ,0,3,1,3,0,1,0,76.14,71.39 ,33.33
03,009,01,009,0210,0,1159 ,6 ,1165 ,1763 ,0,3,1,3,0,1,0,76.14,66.08 ,33.33
03,009,01,010,0211,0,730 ,8 ,738 ,1054 ,0,3,1,3,0,1,0,76.14,70.02 ,33.33
03,009,01,010,0212,0,2179 ,21 ,2200 ,3420 ,0,3,1,3,0,1,0,76.14,64.33 ,33.33
03,009,01,010,0213,0,1367 ,15 ,1382 ,2125 ,0,3,1,3,0,1,0,76.14,65.04 ,33.33
03,009,01,010,0214,0,437 ,4 ,441 ,594 ,0,3,1,3,0,1,0,76.14,74.24 ,33.33
03,009,01,010,0215,0,649 ,7 ,656 ,927 ,0,3,1,3,0,1,0,76.14,70.77 ,33.33
03,009,01,010,0216,0,1762 ,16 ,1778 ,2539 ,0,3,1,3,0,1,0,76.14,70.03 ,33.33
03,009,01,010,0217,0,473 ,8 ,481 ,654 ,0,3,1,3,0,1,0,76.14,73.55 ,33.33
03,009,01,010,0218,0,791 ,3 ,794 ,1111 ,0,3,1,3,0,1,0,76.14,71.47 ,33.33
03,009,01,010,0219,0,734 ,9 ,743 ,1044 ,0,3,1,3,0,1,0,76.14,71.17 ,33.33
03,009,01,010,0220,0,1270 ,9 ,1279 ,1776 ,0,3,1,3,0,1,0,76.14,72.02 ,33.33
03,009,01,011,0221,0,940 ,10 ,950 ,1446 ,0,3,1,3,0,1,0,76.14,65.70 ,33.33
03,009,01,011,0222,0,1054 ,3 ,1057 ,1654 ,0,3,1,3,0,1,0,76.14,63.91 ,33.33
03,009,01,011,0223,0,1149 ,8 ,1157 ,1772 ,0,3,1,3,0,1,0,76.14,65.29 ,33.33
03,009,01,011,0224,0,1041 ,6 ,1047 ,1626 ,0,3,1,3,0,1,0,76.14,64.39 ,33.33
03,009,01,011,0225,0,863 ,4 ,867 ,1244 ,0,3,1,3,0,1,0,76.14,69.69 ,33.33
03,009,01,011,0226,0,1278 ,5 ,1283 ,1987 ,0,3,1,3,0,1,0,76.14,64.57 ,33.33
03,009,01,011,0227,0,597 ,5 ,602 ,969 ,0,3,1,3,0,1,0,76.14,62.13 ,33.33
03,009,01,011,0228,0,854 ,7 ,861 ,1373 ,0,3,1,3,0,1,0,76.14,62.71 ,33.33
03,009,01,011,0229,0,592 ,3 ,595 ,918 ,0,3,1,3,0,1,0,76.14,64.81 ,33.33
03,009,01,011,0230,0,505 ,0 ,505 ,769 ,0,3,1,3,0,1,0,76.14,65.67 ,33.33
03,009,01,011,0231,0,979 ,11 ,990 ,1528 ,0,3,1,3,0,1,0,76.14,64.79 ,33.33
03,009,01,011,0232,0,1227 ,12 ,1239 ,1953 ,0,3,1,3,0,1,0,76.14,63.44 ,33.33
03,009,01,011,0233,0,599 ,5 ,604 ,928 ,0,3,1,3,0,1,0,76.14,65.09 ,33.33
03,009,01,011,0234,0,1099 ,10 ,1109 ,1794 ,0,3,1,3,0,1,0,76.14,61.82 ,33.33
03,009,01,011,0235,0,856 ,6 ,862 ,1426 ,0,3,1,3,0,1,0,76.14,60.45 ,33.33
03,009,01,011,0236,0,558 ,2 ,560 ,1001 ,0,3,1,3,0,1,0,76.14,55.94 ,33.33
03,009,01,011,0237,0,543 ,6 ,549 ,862 ,0,3,1,3,0,1,0,76.14,63.69 ,33.33
03,009,01,011,0238,0,699 ,8 ,707 ,1067 ,0,3,1,3,0,1,0,76.14,66.26 ,33.33
03,009,01,012,0239,0,841 ,10 ,851 ,1274 ,0,3,1,3,0,1,0,76.14,66.80 ,33.33
03,009,01,012,0240,0,888 ,8 ,896 ,1408 ,0,3,1,3,0,1,0,76.14,63.64 ,33.33
03,009,01,012,0241,0,1457 ,13 ,1470 ,2277 ,0,3,1,3,0,1,0,76.14,64.56 ,33.33
03,009,01,012,0242,0,1314 ,12 ,1326 ,2063 ,0,3,1,3,0,1,0,76.14,64.28 ,33.33
03,009,01,012,0243,0,1260 ,16 ,1276 ,2044 ,0,3,1,3,0,1,0,76.14,62.43 ,33.33
03,009,01,012,0244,0,870 ,10 ,880 ,1370 ,0,3,1,3,0,1,0,76.14,64.23 ,33.33
03,009,01,012,0245,0,1392 ,22 ,1414 ,2052 ,0,3,1,3,0,1,0,76.14,68.91 ,33.33
03,009,01,012,0246,0,595 ,5 ,600 ,913 ,0,3,1,3,0,1,0,76.14,65.72 ,33.33
03,009,01,012,0247,0,1082 ,23 ,1105 ,1748 ,0,3,1,3,0,1,0,76.14,63.22 ,33.33
03,009,01,012,0248,0,1209 ,11 ,1220 ,2060 ,0,3,1,3,0,1,0,76.14,59.22 ,33.33
03,009,01,012,0249,0,954 ,7 ,961 ,1518 ,0,3,1,3,0,1,0,76.14,63.31 ,33.33
03,009,01,012,0250,0,761 ,21 ,782 ,1214 ,0,3,1,3,0,1,0,76.14,64.42 ,33.33
03,009,01,012,0251,0,838 ,10 ,848 ,1282 ,0,3,1,3,0,1,0,76.14,66.15 ,33.33
03,009,01,012,0252,0,591 ,4 ,595 ,854 ,0,3,1,3,0,1,0,76.14,69.67 ,33.33
03,009,01,013,0253,0,2225 ,22 ,2247 ,3449 ,0,3,1,3,0,1,0,76.14,65.15 ,33.33
03,009,01,013,0254,0,1685 ,24 ,1709 ,2611 ,0,3,1,3,0,1,0,76.14,65.45 ,33.33
03,009,01,013,0255,0,860 ,6 ,866 ,1356 ,0,3,1,3,0,1,0,76.14,63.86 ,33.33
03,009,01,013,0256,0,1170 ,9 ,1179 ,1821 ,0,3,1,3,0,1,0,76.14,64.74 ,33.33
03,009,01,013,0257,0,878 ,4 ,882 ,1467 ,0,3,1,3,0,1,0,76.14,60.12 ,33.33
03,009,01,013,0258,0,1314 ,9 ,1323 ,2145 ,0,3,1,3,0,1,0,76.14,61.68 ,33.33
03,009,01,013,0259,0,1438 ,17 ,1455 ,2295 ,0,3,1,3,0,1,0,76.14,63.40 ,33.33
03,009,01,013,0260,0,1089 ,3 ,1092 ,1852 ,0,3,1,3,0,1,0,76.14,58.96 ,33.33
03,009,01,013,0261,0,1613 ,15 ,1628 ,2609 ,0,3,1,3,0,1,0,76.14,62.40 ,33.33
03,009,01,013,0262,0,487 ,6 ,493 ,789 ,0,3,1,3,0,1,0,76.14,62.48 ,33.33
03,009,01,013,0263,0,1377 ,19 ,1396 ,2231 ,0,3,1,3,0,1,0,76.14,62.57 ,33.33
03,009,01,013,0264,0,814 ,12 ,826 ,1479 ,0,3,1,3,0,1,0,76.14,55.85 ,33.33
03,009,01,014,0265,0,772 ,8 ,780 ,1280 ,0,3,1,3,0,1,0,76.14,60.94 ,33.33
03,009,01,014,0266,0,325 ,4 ,329 ,501 ,0,3,1,3,0,1,0,76.14,65.67 ,33.33
03,009,01,014,0267,0,1082 ,14 ,1096 ,1794 ,0,3,1,3,0,1,0,76.14,61.09 ,33.33
03,009,01,014,0268,0,990 ,6 ,996 ,1466 ,0,3,1,3,0,1,0,76.14,67.94 ,33.33
03,009,01,014,0269,0,769 ,8 ,777 ,1213 ,0,3,1,3,0,1,0,76.14,64.06 ,33.33
03,009,01,014,0270,0,519 ,3 ,522 ,995 ,0,3,1,3,0,1,0,76.14,52.46 ,33.33
03,009,01,014,0271,0,384 ,6 ,390 ,611 ,0,3,1,3,0,1,0,76.14,63.83 ,33.33
03,009,01,014,0272,0,645 ,4 ,649 ,966 ,0,3,1,3,0,1,0,76.14,67.18 ,33.33
03,009,01,014,0273,0,527 ,8 ,535 ,923 ,0,3,1,3,0,1,0,76.14,57.96 ,33.33
03,009,01,014,0274,0,1439 ,8 ,1447 ,2174 ,0,3,1,3,0,1,0,76.14,66.56 ,33.33
03,009,01,014,0275,0,777 ,5 ,782 ,1277 ,0,3,1,3,0,1,0,76.14,61.24 ,33.33
03,009,01,014,0276,0,764 ,3 ,767 ,1252 ,0,3,1,3,0,1,0,76.14,61.26 ,33.33
03,009,01,015,0277,0,1371 ,12 ,1383 ,1914 ,0,3,1,3,0,1,0,76.14,72.26 ,33.33
03,009,01,015,0278,0,987 ,6 ,993 ,1411 ,0,3,1,3,0,1,0,76.14,70.38 ,33.33
03,009,01,015,0279,0,968 ,9 ,977 ,1446 ,0,3,1,3,0,1,0,76.14,67.57 ,33.33
03,009,01,015,0280,0,1026 ,11 ,1037 ,1411 ,0,3,1,3,0,1,0,76.14,73.49 ,33.33
03,009,01,015,0281,0,933 ,7 ,940 ,1303 ,0,3,1,3,0,1,0,76.14,72.14 ,33.33
03,009,01,015,0282,0,636 ,2 ,638 ,970 ,0,3,1,3,0,1,0,76.14,65.77 ,33.33
03,009,01,015,0283,0,549 ,2 ,551 ,804 ,0,3,1,3,0,1,0,76.14,68.53 ,33.33
03,009,01,015,0284,0,793 ,8 ,801 ,1281 ,0,3,1,3,0,1,0,76.14,62.53 ,33.33
03,009,01,015,0285,0,609 ,5 ,614 ,979 ,0,3,1,3,0,1,0,76.14,62.72 ,33.33
03,009,01,016,0286,0,822 ,10 ,832 ,1251 ,0,3,1,3,0,1,0,76.14,66.51 ,33.33
03,009,01,016,0287,0,669 ,9 ,678 ,1051 ,0,3,1,3,0,1,0,76.14,64.51 ,33.33
03,009,01,016,0288,0,663 ,3 ,666 ,1059 ,0,3,1,3,0,1,0,76.14,62.89 ,33.33
03,009,01,016,0289,0,1203 ,10 ,1213 ,1975 ,0,3,1,3,0,1,0,76.14,61.42 ,33.33
03,009,01,016,0290,0,487 ,11 ,498 ,903 ,0,3,1,3,0,1,0,76.14,55.15 ,33.33
03,009,01,016,0291,0,809 ,7 ,816 ,1525 ,0,3,1,3,0,1,0,76.14,53.51 ,33.33
03,009,01,016,0292,0,1129 ,13 ,1142 ,1949 ,0,3,1,3,0,1,0,76.14,58.59 ,33.33
03,009,01,016,0293,0,365 ,4 ,369 ,659 ,0,3,1,3,0,1,0,76.14,55.99 ,33.33
03,009,01,016,0294,0,250 ,2 ,252 ,487 ,0,3,1,3,0,1,0,76.14,51.75 ,33.33
03,009,01,016,0295,0,405 ,6 ,411 ,699 ,0,3,1,3,0,1,0,76.14,58.80 ,33.33
03,009,01,016,0296,0,1162 ,8 ,1170 ,1926 ,0,3,1,3,0,1,0,76.14,60.75 ,33.33
03,009,01,016,0297,0,985 ,10 ,995 ,1579 ,0,3,1,3,0,1,0,76.14,63.01 ,33.33
03,009,01,016,0298,0,930 ,6 ,936 ,1473 ,0,3,1,3,0,1,0,76.14,63.54 ,33.33
03,009,01,016,0299,0,1939 ,11 ,1950 ,3260 ,0,3,1,3,0,1,0,76.14,59.82 ,33.33
03,009,01,016,0300,0,1378 ,13 ,1391 ,2041 ,0,3,1,3,0,1,0,76.14,68.15 ,33.33
03,009,01,017,0301,0,2008 ,25 ,2033 ,3222 ,0,3,1,3,0,1,0,76.14,63.10 ,33.33
03,009,01,017,0302,0,988 ,11 ,999 ,1657 ,0,3,1,3,0,1,0,76.14,60.29 ,33.33
03,009,01,017,0303,0,912 ,10 ,922 ,1503 ,0,3,1,3,0,1,0,76.14,61.34 ,33.33
03,009,01,017,0304,0,521 ,4 ,525 ,809 ,0,3,1,3,0,1,0,76.14,64.89 ,33.33
03,009,01,017,0305,0,696 ,7 ,703 ,1066 ,0,3,1,3,0,1,0,76.14,65.95 ,33.33
03,009,01,017,0306,0,681 ,5 ,686 ,1216 ,0,3,1,3,0,1,0,76.14,56.41 ,33.33
03,009,01,017,0307,0,626 ,3 ,629 ,1054 ,0,3,1,3,0,1,0,76.14,59.68 ,33.33
03,009,01,017,0308,0,468 ,1 ,469 ,921 ,0,3,1,3,0,1,0,76.14,50.92 ,33.33
03,009,01,017,0309,0,383 ,3 ,386 ,669 ,0,3,1,3,0,1,0,76.14,57.70 ,33.33
03,009,01,017,0310,0,542 ,6 ,548 ,877 ,0,3,1,3,0,1,0,76.14,62.49 ,33.33
03,009,01,017,0311,0,255 ,3 ,258 ,459 ,0,3,1,3,0,1,0,76.14,56.21 ,33.33
03,009,01,017,0312,0,718 ,7 ,725 ,1223 ,0,3,1,3,0,1,0,76.14,59.28 ,33.33
03,009,01,017,0313,0,952 ,14 ,966 ,1533 ,0,3,1,3,0,1,0,76.14,63.01 ,33.33
03,009,01,017,0314,0,691 ,5 ,696 ,1102 ,0,3,1,3,0,1,0,76.14,63.16 ,33.33
03,009,01,017,0315,0,532 ,9 ,541 ,923 ,0,3,1,3,0,1,0,76.14,58.61 ,33.33
03,009,01,017,0316,0,820 ,9 ,829 ,1329 ,0,3,1,3,0,1,0,76.14,62.38 ,33.33
03,009,01,017,0317,0,625 ,12 ,637 ,1023 ,0,3,1,3,0,1,0,76.14,62.27 ,33.33
03,009,01,017,0318,0,1034 ,11 ,1045 ,1659 ,0,3,1,3,0,1,0,76.14,62.99 ,33.33
03,009,01,017,0319,0,432 ,3 ,435 ,667 ,0,3,1,3,0,1,0,76.14,65.22 ,33.33
03,009,01,017,0320,0,576 ,7 ,583 ,918 ,0,3,1,3,0,1,0,76.14,63.51 ,33.33
03,009,01,017,0321,0,515 ,4 ,519 ,740 ,0,3,1,3,0,1,0,76.14,70.14 ,33.33
03,009,01,018,0322,0,1089 ,16 ,1105 ,1757 ,0,3,1,3,0,1,0,76.14,62.89 ,33.33
03,009,01,018,0323,0,1393 ,18 ,1411 ,2159 ,0,3,1,3,0,1,0,76.14,65.35 ,33.33
03,009,01,018,0324,0,443 ,2 ,445 ,716 ,0,3,1,3,0,1,0,76.14,62.15 ,33.33
03,009,01,018,0325,0,638 ,5 ,643 ,1080 ,0,3,1,3,0,1,0,76.14,59.54 ,33.33
03,009,01,018,0326,0,633 ,3 ,636 ,1094 ,0,3,1,3,0,1,0,76.14,58.14 ,33.33
03,009,01,018,0327,0,520 ,9 ,529 ,969 ,0,3,1,3,0,1,0,76.14,54.59 ,33.33
03,009,01,018,0328,0,451 ,6 ,457 ,874 ,0,3,1,3,0,1,0,76.14,52.29 ,33.33
03,009,01,018,0329,0,721 ,9 ,730 ,1209 ,0,3,1,3,0,1,0,76.14,60.38 ,33.33
03,009,01,018,0330,0,601 ,4 ,605 ,1141 ,0,3,1,3,0,1,0,76.14,53.02 ,33.33
03,009,01,018,0331,0,462 ,2 ,464 ,953 ,0,3,1,3,0,1,0,76.14,48.69 ,33.33
03,009,01,018,0332,0,337 ,6 ,343 ,647 ,0,3,1,3,0,1,0,76.14,53.01 ,33.33
03,009,01,018,0333,0,514 ,4 ,518 ,986 ,0,3,1,3,0,1,0,76.14,52.54 ,33.33
03,009,01,018,0334,0,228 ,4 ,232 ,414 ,0,3,1,3,0,1,0,76.14,56.04 ,33.33
03,009,01,018,0335,0,1036 ,10 ,1046 ,1794 ,0,3,1,3,0,1,0,76.14,58.31 ,33.33
03,009,01,018,0336,0,486 ,5 ,491 ,895 ,0,3,1,3,0,1,0,76.14,54.86 ,33.33
03,009,01,018,0337,0,386 ,5 ,391 ,814 ,0,3,1,3,0,1,0,76.14,48.03 ,33.33
03,009,01,018,0338,0,488 ,7 ,495 ,1021 ,0,3,1,3,0,1,0,76.14,48.48 ,33.33
03,009,01,018,0339,0,552 ,6 ,558 ,1141 ,0,3,1,3,0,1,0,76.14,48.90 ,33.33
03,009,01,018,0340,0,677 ,3 ,680 ,1283 ,0,3,1,3,0,1,0,76.14,53.00 ,33.33
03,009,01,018,0341,0,534 ,6 ,540 ,1086 ,0,3,1,3,0,1,0,76.14,49.72 ,33.33
03,009,01,018,0342,0,409 ,1 ,410 ,829 ,0,3,1,3,0,1,0,76.14,49.46 ,33.33
03,009,01,019,0343,0,712 ,5 ,717 ,1084 ,0,3,1,3,0,1,0,76.14,66.14 ,33.33
03,009,01,019,0344,0,868 ,10 ,878 ,1319 ,0,3,1,3,0,1,0,76.14,66.57 ,33.33
03,009,01,019,0345,0,411 ,0 ,411 ,693 ,0,3,1,3,0,1,0,76.14,59.31 ,33.33
03,009,01,019,0346,0,430 ,3 ,433 ,678 ,0,3,1,3,0,1,0,76.14,63.86 ,33.33
03,009,01,019,0347,0,449 ,7 ,456 ,931 ,0,3,1,3,0,1,0,76.14,48.98 ,33.33
03,009,01,019,0348,0,605 ,11 ,616 ,1001 ,0,3,1,3,0,1,0,76.14,61.54 ,33.33
03,009,01,019,0349,0,927 ,6 ,933 ,1472 ,0,3,1,3,0,1,0,76.14,63.38 ,33.33
03,009,01,019,0350,0,1096 ,5 ,1101 ,2095 ,0,3,1,3,0,1,0,76.14,52.55 ,33.33
03,009,01,019,0351,0,924 ,5 ,929 ,1753 ,0,3,1,3,0,1,0,76.14,52.99 ,33.33
03,009,01,019,0352,0,848 ,9 ,857 ,1525 ,0,3,1,3,0,1,0,76.14,56.20 ,33.33
03,009,01,019,0353,0,281 ,4 ,285 ,572 ,0,3,1,3,0,1,0,76.14,49.83 ,33.33
03,009,01,019,0354,0,876 ,8 ,884 ,1530 ,0,3,1,3,0,1,0,76.14,57.78 ,33.33
03,009,01,019,0355,0,464 ,8 ,472 ,803 ,0,3,1,3,0,1,0,76.14,58.78 ,33.33
03,009,01,019,0356,0,1098 ,9 ,1107 ,1702 ,0,3,1,3,0,1,0,76.14,65.04 ,33.33
03,009,01,019,0357,0,675 ,0 ,675 ,1033 ,0,3,1,3,0,1,0,76.14,65.34 ,33.33
03,009,01,019,0358,0,1170 ,7 ,1177 ,1866 ,0,3,1,3,0,1,0,76.14,63.08 ,33.33
03,009,01,019,0359,0,776 ,3 ,779 ,1317 ,0,3,1,3,0,1,0,76.14,59.15 ,33.33
03,009,01,019,0360,0,686 ,6 ,692 ,1060 ,0,3,1,3,0,1,0,76.14,65.28 ,33.33
03,009,01,019,0361,0,513 ,3 ,516 ,789 ,0,3,1,3,0,1,0,76.14,65.40 ,33.33
03,009,01,019,0362,0,641 ,7 ,648 ,1057 ,0,3,1,3,0,1,0,76.14,61.31 ,33.33
03,009,01,019,0363,0,447 ,4 ,451 ,754 ,0,3,1,3,0,1,0,76.14,59.81 ,33.33
03,009,01,020,0364,0,1503 ,9 ,1512 ,2278 ,0,3,1,3,0,1,0,76.14,66.37 ,33.33
03,009,01,020,0365,0,1323 ,12 ,1335 ,1943 ,0,3,1,3,0,1,0,76.14,68.71 ,33.33
03,009,01,020,0366,0,495 ,3 ,498 ,762 ,0,3,1,3,0,1,0,76.14,65.35 ,33.33
03,009,01,020,0367,0,473 ,5 ,478 ,745 ,0,3,1,3,0,1,0,76.14,64.16 ,33.33
03,009,01,020,0368,0,712 ,5 ,717 ,1080 ,0,3,1,3,0,1,0,76.14,66.39 ,33.33
03,009,01,020,0369,0,567 ,6 ,573 ,927 ,0,3,1,3,0,1,0,76.14,61.81 ,33.33
03,009,01,020,0370,0,774 ,8 ,782 ,1173 ,0,3,1,3,0,1,0,76.14,66.67 ,33.33
03,009,01,020,0371,0,496 ,3 ,499 ,794 ,0,3,1,3,0,1,0,76.14,62.85 ,33.33
03,009,01,020,0372,0,644 ,5 ,649 ,1068 ,0,3,1,3,0,1,0,76.14,60.77 ,33.33
03,009,01,020,0373,0,442 ,9 ,451 ,751 ,0,3,1,3,0,1,0,76.14,60.05 ,33.33
03,009,01,020,0374,0,410 ,2 ,412 ,683 ,0,3,1,3,0,1,0,76.14,60.32 ,33.33
03,009,01,020,0375,0,673 ,9 ,682 ,1204 ,0,3,1,3,0,1,0,76.14,56.64 ,33.33
03,009,01,020,0376,0,459 ,5 ,464 ,753 ,0,3,1,3,0,1,0,76.14,61.62 ,33.33
03,009,01,020,0377,0,650 ,8 ,658 ,1060 ,0,3,1,3,0,1,0,76.14,62.08 ,33.33
03,009,01,020,0378,0,644 ,10 ,654 ,1039 ,0,3,1,3,0,1,0,76.14,62.95 ,33.33
03,009,01,020,0379,0,536 ,5 ,541 ,892 ,0,3,1,3,0,1,0,76.14,60.65 ,33.33
03,009,01,020,0380,0,887 ,6 ,893 ,1228 ,0,3,1,3,0,1,0,76.14,72.72 ,33.33
03,009,01,020,0381,0,410 ,4 ,414 ,608 ,0,3,1,3,0,1,0,76.14,68.09 ,33.33
03,009,01,020,0382,0,521 ,8 ,529 ,786 ,0,3,1,3,0,1,0,76.14,67.30 ,33.33
03,009,01,020,0383,0,516 ,8 ,524 ,854 ,0,3,1,3,0,1,0,76.14,61.36 ,33.33
03,009,01,020,0384,0,523 ,5 ,528 ,838 ,0,3,1,3,0,1,0,76.14,63.01 ,33.33
03,009,01,020,0385,0,701 ,8 ,709 ,1060 ,0,3,1,3,0,1,0,76.14,66.89 ,33.33
03,009,01,020,0386,0,807 ,6 ,813 ,1257 ,0,3,1,3,0,1,0,76.14,64.68 ,33.33
03,009,01,020,0387,0,574 ,2 ,576 ,828 ,0,3,1,3,0,1,0,76.14,69.57 ,33.33
03,010,01,001,0001,0,993 ,9 ,1002 ,1791 ,0,3,1,3,0,1,0,76.14,55.95 ,33.33
03,010,01,001,0002,0,293 ,3 ,296 ,499 ,0,3,1,3,0,1,0,76.14,59.32 ,33.33
03,010,01,001,0003,0,832 ,9 ,841 ,1372 ,0,3,1,3,0,1,0,76.14,61.30 ,33.33
03,010,01,001,0004,0,980 ,8 ,988 ,1516 ,0,3,1,3,0,1,0,76.14,65.17 ,33.33
03,010,01,001,0005,0,733 ,5 ,738 ,1100 ,0,3,1,3,0,1,0,76.14,67.09 ,33.33
03,010,01,001,0006,0,502 ,9 ,511 ,868 ,0,3,1,3,0,1,0,76.14,58.87 ,33.33
03,010,01,001,0007,0,557 ,10 ,567 ,822 ,0,3,1,3,0,1,0,76.14,68.98 ,33.33
03,010,01,001,0008,0,758 ,10 ,768 ,1208 ,0,3,1,3,0,1,0,76.14,63.58 ,33.33
03,010,01,001,0009,0,575 ,5 ,580 ,894 ,0,3,1,3,0,1,0,76.14,64.88 ,33.33
03,010,01,001,0010,0,746 ,5 ,751 ,1206 ,0,3,1,3,0,1,0,76.14,62.27 ,33.33
03,010,01,001,0011,0,966 ,8 ,974 ,1855 ,0,3,1,3,0,1,0,76.14,52.51 ,33.33
03,010,01,001,0012,0,423 ,4 ,427 ,716 ,0,3,1,3,0,1,0,76.14,59.64 ,33.33
03,010,01,001,0013,0,390 ,4 ,394 ,564 ,0,3,1,3,0,1,0,76.14,69.86 ,33.33
03,010,01,001,0014,0,1346 ,7 ,1353 ,2189 ,0,3,1,3,0,1,0,76.14,61.8090452261,33.33
03,010,01,001,0015,0,1568 ,26 ,1594 ,2947 ,0,3,1,3,0,1,0,76.14,54.09 ,33.33
03,010,01,001,0016,0,1012 ,9 ,1021 ,1770 ,0,3,1,3,0,1,0,76.14,57.68 ,33.33
03,010,01,001,0017,0,1252 ,14 ,1266 ,2269 ,0,3,1,3,0,1,0,76.14,55.80 ,33.33
03,010,01,001,0018,0,424 ,3 ,427 ,712 ,0,3,1,3,0,1,0,76.14,59.97 ,33.33
03,010,01,002,0019,0,1099 ,10 ,1109 ,1812 ,0,3,1,3,0,1,0,76.14,61.20 ,33.33
03,010,01,002,0020,0,1133 ,13 ,1146 ,1866 ,0,3,1,3,0,1,0,76.14,61.41 ,33.33
03,010,01,002,0021,0,673 ,4 ,677 ,1107 ,0,3,1,3,0,1,0,76.14,61.16 ,33.33
03,010,01,002,0022,0,305 ,1 ,306 ,481 ,0,3,1,3,0,1,0,76.14,63.62 ,33.33
03,010,01,002,0023,0,438 ,6 ,444 ,710 ,0,3,1,3,0,1,0,76.14,62.5352112676,33.33
03,010,01,002,0024,0,428 ,4 ,432 ,699 ,0,3,1,3,0,1,0,76.14,61.8025751073,33.33
03,010,01,002,0025,0,510 ,4 ,514 ,781 ,0,3,1,3,0,1,0,76.14,65.81 ,33.33
03,010,01,002,0026,0,1150 ,7 ,1157 ,1842 ,0,3,1,3,0,1,0,76.14,62.81 ,33.33
03,010,01,002,0027,0,1439 ,22 ,1461 ,2444 ,0,3,1,3,0,1,0,76.14,59.78 ,33.33
03,010,01,002,0028,0,2209 ,21 ,2230 ,3786 ,0,3,1,3,0,1,0,76.14,58.9012150026,33.33
03,010,01,002,0029,0,429 ,7 ,436 ,667 ,0,3,1,3,0,1,0,76.14,65.3673163418,33.33
03,010,01,002,0030,0,428 ,1 ,429 ,694 ,0,3,1,3,0,1,0,76.14,61.82 ,33.33
03,010,01,002,0031,0,510 ,7 ,517 ,814 ,0,3,1,3,0,1,0,76.14,63.51 ,33.33
03,010,01,002,0032,0,692 ,4 ,696 ,1069 ,0,3,1,3,0,1,0,76.14,65.11 ,33.33
03,010,01,002,0033,0,423 ,3 ,426 ,641 ,0,3,1,3,0,1,0,76.14,66.46 ,33.33
03,010,01,002,0034,0,1653 ,22 ,1675 ,2660 ,0,3,1,3,0,1,0,76.14,62.97 ,33.33
03,010,01,002,0035,0,1129 ,18 ,1147 ,1838 ,0,3,1,3,0,1,0,76.14,62.40 ,33.33
03,010,01,002,0036,0,389 ,1 ,390 ,626 ,0,3,1,3,0,1,0,76.14,62.30 ,33.33
03,010,01,002,0037,0,558 ,1 ,559 ,988 ,0,3,1,3,0,1,0,76.14,56.58 ,33.33
03,010,01,002,0038,0,668 ,8 ,676 ,971 ,0,3,1,3,0,1,0,76.14,69.6189495366,33.33
03,010,01,002,0039,0,494 ,4 ,498 ,815 ,0,3,1,3,0,1,0,76.14,61.1042944785,33.33
03,010,01,002,0040,0,191 ,1 ,192 ,278 ,0,3,1,3,0,1,0,76.14,69.06 ,33.33
03,010,01,002,0041,0,502 ,6 ,508 ,792 ,0,3,1,3,0,1,0,76.14,64.14 ,33.33
03,010,01,002,0042,0,379 ,5 ,384 ,617 ,0,3,1,3,0,1,0,76.14,62.24 ,33.33
03,010,01,002,0043,0,653 ,10 ,663 ,1127 ,0,3,1,3,0,1,0,76.14,58.83 ,33.33
03,010,01,002,0044,0,891 ,12 ,903 ,1426 ,0,3,1,3,0,1,0,76.14,63.32 ,33.33
03,010,01,002,0045,0,336 ,2 ,338 ,556 ,0,3,1,3,0,1,0,76.14,60.79 ,33.33
03,010,01,003,0046,0,452 ,9 ,461 ,717 ,0,3,1,3,0,1,0,76.14,64.30 ,33.33
03,010,01,003,0047,0,249 ,3 ,252 ,442 ,0,3,1,3,0,1,0,76.14,57.01 ,33.33
03,010,01,003,0048,0,1103 ,9 ,1112 ,1706 ,0,3,1,3,0,1,0,76.14,65.18 ,33.33
03,010,01,003,0049,0,735 ,11 ,746 ,1203 ,0,3,1,3,0,1,0,76.14,62.01 ,33.33
03,010,01,003,0050,0,1116 ,22 ,1138 ,1809 ,0,3,1,3,0,1,0,76.14,62.91 ,33.33
03,010,01,003,0051,0,545 ,3 ,548 ,982 ,0,3,1,3,0,1,0,76.14,55.80 ,33.33
03,010,01,003,0052,0,472 ,4 ,476 ,783 ,0,3,1,3,0,1,0,76.14,60.79 ,33.33
03,010,01,003,0053,0,503 ,13 ,516 ,818 ,0,3,1,3,0,1,0,76.14,63.0806845966,33.33
03,010,01,003,0054,0,863 ,6 ,869 ,1371 ,0,3,1,3,0,1,0,76.14,63.3843909555,33.33
03,010,01,003,0055,0,993 ,11 ,1004 ,1607 ,0,3,1,3,0,1,0,76.14,62.48 ,33.33
03,010,01,003,0056,0,929 ,11 ,940 ,1521 ,0,3,1,3,0,1,0,76.14,61.80 ,33.33
03,010,01,003,0057,0,399 ,4 ,403 ,565 ,0,3,1,3,0,1,0,76.14,71.3274336283,33.33
03,010,01,003,0058,0,511 ,3 ,514 ,763 ,0,3,1,3,0,1,0,76.14,67.37 ,33.33
03,010,01,003,0059,0,648 ,13 ,661 ,1166 ,0,3,1,3,0,1,0,76.14,56.69 ,33.33
03,010,01,003,0060,0,1180 ,11 ,1191 ,1944 ,0,3,1,3,0,1,0,76.14,61.27 ,33.33
03,010,01,003,0061,0,215 ,1 ,216 ,326 ,0,3,1,3,0,1,0,76.14,66.26 ,33.33
03,010,01,003,0062,0,263 ,4 ,267 ,442 ,0,3,1,3,0,1,0,76.14,60.41 ,33.33
03,010,01,003,0063,0,206 ,1 ,207 ,338 ,0,3,1,3,0,1,0,76.14,61.24 ,33.33
03,010,01,003,0064,0,508 ,4 ,512 ,808 ,0,3,1,3,0,1,0,76.14,63.37 ,33.33
03,010,01,003,0065,0,617 ,9 ,626 ,1050 ,0,3,1,3,0,1,0,76.14,59.62 ,33.33
03,010,01,003,0066,0,657 ,4 ,661 ,1239 ,0,3,1,3,0,1,0,76.14,53.35 ,33.33
03,010,01,003,0067,0,1404 ,19 ,1423 ,2439 ,0,3,1,3,0,1,0,76.14,58.34 ,33.33
03,010,01,003,0068,0,596 ,10 ,606 ,1110 ,0,3,1,3,0,1,0,76.14,54.59 ,33.33
03,010,01,004,0069,0,338 ,4 ,342 ,494 ,0,3,1,3,0,1,0,76.14,69.23 ,33.33
03,010,01,004,0070,0,1183 ,9 ,1192 ,1988 ,0,3,1,3,0,1,0,76.14,59.96 ,33.33
03,010,01,004,0071,0,610 ,5 ,615 ,1012 ,0,3,1,3,0,1,0,76.14,60.77 ,33.33
03,010,01,004,0072,0,2885 ,20 ,2905 ,4980 ,0,3,1,3,0,1,0,76.14,58.3333333333,33.33
03,010,01,004,0073,0,697 ,11 ,708 ,1132 ,0,3,1,3,0,1,0,76.14,62.5441696113,33.33
03,010,01,004,0074,0,860 ,5 ,865 ,1414 ,0,3,1,3,0,1,0,76.14,61.17 ,33.33
03,010,01,004,0075,0,437 ,2 ,439 ,682 ,0,3,1,3,0,1,0,76.14,64.37 ,33.33
03,010,01,004,0076,0,466 ,3 ,469 ,808 ,0,3,1,3,0,1,0,76.14,58.04 ,33.33
03,010,01,004,0077,0,436 ,2 ,438 ,666 ,0,3,1,3,0,1,0,76.14,65.77 ,33.33
03,010,01,004,0078,0,179 ,1 ,180 ,303 ,0,3,1,3,0,1,0,76.14,59.41 ,33.33
03,010,01,004,0079,0,1126 ,14 ,1140 ,1751 ,0,3,1,3,0,1,0,76.14,65.11 ,33.33
03,010,01,004,0080,0,907 ,11 ,918 ,1458 ,0,3,1,3,0,1,0,76.14,62.96 ,33.33
03,010,01,004,0081,0,907 ,8 ,915 ,1496 ,0,3,1,3,0,1,0,76.14,61.1631016043,33.33
03,010,01,004,0082,0,510 ,3 ,513 ,837 ,0,3,1,3,0,1,0,76.14,61.2903225806,33.33
03,010,01,004,0083,0,900 ,10 ,910 ,1529 ,0,3,1,3,0,1,0,76.14,59.5160235448,33.33
03,010,01,004,0084,0,1137 ,10 ,1147 ,1920 ,0,3,1,3,0,1,0,76.14,59.74 ,33.33
03,010,01,004,0085,0,617 ,5 ,622 ,972 ,0,3,1,3,0,1,0,76.14,63.99 ,33.33
03,010,01,004,0086,0,473 ,0 ,473 ,689 ,0,3,1,3,0,1,0,76.14,68.65 ,33.33
03,010,01,004,0087,0,489 ,1 ,490 ,735 ,0,3,1,3,0,1,0,76.14,66.67 ,33.33
03,010,01,004,0088,0,531 ,6 ,537 ,848 ,0,3,1,3,0,1,0,76.14,63.33 ,33.33
03,010,01,004,0089,0,502 ,3 ,505 ,782 ,0,3,1,3,0,1,0,76.14,64.58 ,33.33
03,010,01,005,0090,0,1183 ,9 ,1192 ,2073 ,0,3,1,3,0,1,0,76.14,57.5012059817,33.33
03,010,01,005,0091,0,999 ,7 ,1006 ,1594 ,0,3,1,3,0,1,0,76.14,63.1116687578,33.33
03,010,01,005,0092,0,1770 ,17 ,1787 ,2996 ,0,3,1,3,0,1,0,76.14,59.65 ,33.33
03,010,01,005,0093,0,1180 ,8 ,1188 ,2081 ,0,3,1,3,0,1,0,76.14,57.09 ,33.33
03,010,01,005,0094,0,827 ,9 ,836 ,1357 ,0,3,1,3,0,1,0,76.14,61.61 ,33.33
03,010,01,005,0095,0,1110 ,8 ,1118 ,1791 ,0,3,1,3,0,1,0,76.14,62.42 ,33.33
03,010,01,005,0096,0,812 ,7 ,819 ,1368 ,0,3,1,3,0,1,0,76.14,59.87 ,33.33
03,010,01,005,0097,0,1072 ,12 ,1084 ,1669 ,0,3,1,3,0,1,0,76.14,64.95 ,33.33
03,010,01,005,0098,0,470 ,2 ,472 ,755 ,0,3,1,3,0,1,0,76.14,62.52 ,33.33
03,010,01,005,0099,0,412 ,9 ,421 ,721 ,0,3,1,3,0,1,0,76.14,58.39 ,33.33
03,010,01,005,0100,0,451 ,11 ,462 ,770 ,0,3,1,3,0,1,0,76.14,60.00 ,33.33
03,010,01,005,0101,0,1139 ,9 ,1148 ,1898 ,0,3,1,3,0,1,0,76.14,60.48 ,33.33
03,010,01,005,0102,0,537 ,4 ,541 ,908 ,0,3,1,3,0,1,0,76.14,59.58 ,33.33
03,010,01,005,0103,0,342 ,3 ,345 ,568 ,0,3,1,3,0,1,0,76.14,60.7394366197,33.33
03,010,01,005,0104,0,532 ,6 ,538 ,912 ,0,3,1,3,0,1,0,76.14,58.9912280702,33.33
03,010,01,005,0105,0,2070 ,17 ,2087 ,3664 ,0,3,1,3,0,1,0,76.14,56.9596069869,33.33
03,010,01,005,0106,0,995 ,10 ,1005 ,1787 ,0,3,1,3,0,1,0,76.14,56.2395075546,33.33
03,010,01,005,0107,0,2403 ,21 ,2424 ,4385 ,0,3,1,3,0,1,0,76.14,55.28 ,33.33
03,010,01,005,0108,0,1222 ,10 ,1232 ,2168 ,0,3,1,3,0,1,0,76.14,56.83 ,33.33
03,010,01,005,0109,0,1213 ,14 ,1227 ,2231 ,0,3,1,3,0,1,0,76.14,54.9977588525,33.33
03,010,01,005,0110,0,895 ,17 ,912 ,1629 ,0,3,1,3,0,1,0,76.14,55.985267035,33.33
03,010,01,005,0111,0,1016 ,7 ,1023 ,1754 ,0,3,1,3,0,1,0,76.14,58.3238312429,33.33
03,010,01,005,0112,0,1204 ,14 ,1218 ,2268 ,0,3,1,3,0,1,0,76.14,53.70 ,33.33
03,010,01,005,0113,0,1486 ,32 ,1518 ,2614 ,0,3,1,3,0,1,0,76.14,58.07 ,33.33
03,010,01,005,0114,0,1017 ,12 ,1029 ,1764 ,0,3,1,3,0,1,0,76.14,58.33 ,33.33
03,010,01,005,0115,0,1167 ,10 ,1177 ,2015 ,0,3,1,3,0,1,0,76.14,58.41 ,33.33
03,010,01,005,0116,0,1888 ,15 ,1903 ,3471 ,0,3,1,3,0,1,0,76.14,54.83 ,33.33
03,010,01,005,0117,0,766 ,5 ,771 ,1243 ,0,3,1,3,0,1,0,76.14,62.03 ,33.33
03,010,01,006,0118,0,846 ,10 ,856 ,1410 ,0,3,1,3,0,1,0,76.14,60.71 ,33.33
03,010,01,006,0119,0,423 ,5 ,428 ,725 ,0,3,1,3,0,1,0,76.14,59.03 ,33.33
03,010,01,006,0120,0,395 ,1 ,396 ,682 ,0,3,1,3,0,1,0,76.14,58.06 ,33.33
03,010,01,006,0121,0,469 ,4 ,473 ,817 ,0,3,1,3,0,1,0,76.14,57.89 ,33.33
03,010,01,006,0122,0,512 ,6 ,518 ,872 ,0,3,1,3,0,1,0,76.14,59.40 ,33.33
03,010,01,006,0123,0,709 ,2 ,711 ,1236 ,0,3,1,3,0,1,0,76.14,57.52 ,33.33
03,010,01,006,0124,0,533 ,4 ,537 ,930 ,0,3,1,3,0,1,0,76.14,57.74 ,33.33
03,010,01,006,0125,0,596 ,7 ,603 ,989 ,0,3,1,3,0,1,0,76.14,60.97 ,33.33
03,010,01,006,0126,0,607 ,5 ,612 ,1080 ,0,3,1,3,0,1,0,76.14,56.67 ,33.33
03,010,01,006,0127,0,435 ,4 ,439 ,786 ,0,3,1,3,0,1,0,76.14,55.85 ,33.33
03,010,01,006,0128,0,758 ,8 ,766 ,1275 ,0,3,1,3,0,1,0,76.14,60.08 ,33.33
03,010,01,006,0129,0,585 ,2 ,587 ,1013 ,0,3,1,3,0,1,0,76.14,57.95 ,33.33
03,010,01,006,0130,0,428 ,3 ,431 ,739 ,0,3,1,3,0,1,0,76.14,58.3220568336,33.33
03,010,01,006,0131,0,548 ,6 ,554 ,868 ,0,3,1,3,0,1,0,76.14,63.8248847926,33.33
03,010,01,007,0132,0,1155 ,9 ,1164 ,1775 ,0,3,1,3,0,1,0,76.14,65.58 ,33.33
03,010,01,007,0133,0,980 ,8 ,988 ,1632 ,0,3,1,3,0,1,0,76.14,60.54 ,33.33
03,010,01,007,0134,0,879 ,9 ,888 ,1448 ,0,3,1,3,0,1,0,76.14,61.3259668508,33.33
03,010,01,007,0135,0,911 ,3 ,914 ,1532 ,0,3,1,3,0,1,0,76.14,59.6605744125,33.33
03,010,01,007,0136,0,716 ,6 ,722 ,1170 ,0,3,1,3,0,1,0,76.14,61.71 ,33.33
03,010,01,007,0137,0,919 ,10 ,929 ,1515 ,0,3,1,3,0,1,0,76.14,61.32 ,33.33
03,010,01,007,0138,0,980 ,5 ,985 ,1614 ,0,3,1,3,0,1,0,76.14,61.03 ,33.33
03,010,01,007,0139,0,581 ,4 ,585 ,970 ,0,3,1,3,0,1,0,76.14,60.31 ,33.33
03,010,01,007,0140,0,1040 ,5 ,1045 ,1719 ,0,3,1,3,0,1,0,76.14,60.7911576498,33.33
03,010,01,007,0141,0,921 ,7 ,928 ,1436 ,0,3,1,3,0,1,0,76.14,64.62 ,33.33
03,010,01,007,0142,0,847 ,8 ,855 ,1429 ,0,3,1,3,0,1,0,76.14,59.83 ,33.33
03,010,01,007,0143,0,576 ,3 ,579 ,963 ,0,3,1,3,0,1,0,76.14,60.12 ,33.33
03,010,01,007,0144,0,660 ,12 ,672 ,988 ,0,3,1,3,0,1,0,76.14,68.02 ,33.33
03,010,01,007,0145,0,615 ,9 ,624 ,983 ,0,3,1,3,0,1,0,76.14,63.48 ,33.33
03,010,01,007,0146,0,698 ,6 ,704 ,1120 ,0,3,1,3,0,1,0,76.14,62.86 ,33.33
03,010,01,007,0147,0,672 ,3 ,675 ,1148 ,0,3,1,3,0,1,0,76.14,58.80 ,33.33
03,010,01,007,0148,0,645 ,5 ,650 ,1116 ,0,3,1,3,0,1,0,76.14,58.2437275986,33.33
03,010,01,007,0149,0,363 ,8 ,371 ,596 ,0,3,1,3,0,1,0,76.14,62.2483221477,33.33
03,010,01,007,0150,0,498 ,3 ,501 ,848 ,0,3,1,3,0,1,0,76.14,59.08 ,33.33
03,010,01,007,0151,0,388 ,1 ,389 ,598 ,0,3,1,3,0,1,0,76.14,65.05 ,33.33
03,010,01,007,0152,0,588 ,4 ,592 ,942 ,0,3,1,3,0,1,0,76.14,62.85 ,33.33
03,010,01,007,0153,0,350 ,7 ,357 ,580 ,0,3,1,3,0,1,0,76.14,61.55 ,33.33
03,010,01,007,0154,0,351 ,2 ,353 ,500 ,0,3,1,3,0,1,0,76.14,70.60 ,33.33
03,010,01,008,0155,0,743 ,10 ,753 ,1291 ,0,3,1,3,0,1,0,76.14,58.33 ,33.33
03,010,01,008,0156,0,505 ,5 ,510 ,940 ,0,3,1,3,0,1,0,76.14,54.26 ,33.33
03,010,01,008,0157,0,521 ,3 ,524 ,903 ,0,3,1,3,0,1,0,76.14,58.03 ,33.33
03,010,01,008,0158,0,187 ,5 ,192 ,294 ,0,3,1,3,0,1,0,76.14,65.31 ,33.33
03,010,01,008,0159,0,729 ,6 ,735 ,1233 ,0,3,1,3,0,1,0,76.14,59.61 ,33.33
03,010,01,008,0160,0,760 ,5 ,765 ,1287 ,0,3,1,3,0,1,0,76.14,59.44 ,33.33
03,010,01,008,0161,0,528 ,2 ,530 ,895 ,0,3,1,3,0,1,0,76.14,59.22 ,33.33
03,010,01,008,0162,0,422 ,2 ,424 ,745 ,0,3,1,3,0,1,0,76.14,56.91 ,33.33
03,010,01,008,0163,0,430 ,7 ,437 ,779 ,0,3,1,3,0,1,0,76.14,56.10 ,33.33
03,010,01,008,0164,0,849 ,7 ,856 ,1431 ,0,3,1,3,0,1,0,76.14,59.82 ,33.33
03,010,01,008,0165,0,343 ,2 ,345 ,628 ,0,3,1,3,0,1,0,76.14,54.9363057325,33.33
03,010,01,008,0166,0,505 ,7 ,512 ,791 ,0,3,1,3,0,1,0,76.14,64.7281921618,33.33
03,010,01,008,0167,0,671 ,6 ,677 ,1085 ,0,3,1,3,0,1,0,76.14,62.40 ,33.33
03,010,01,008,0168,0,562 ,6 ,568 ,919 ,0,3,1,3,0,1,0,76.14,61.81 ,33.33
03,010,01,008,0169,0,582 ,6 ,588 ,991 ,0,3,1,3,0,1,0,76.14,59.3340060545,33.33
03,010,01,008,0170,0,896 ,6 ,902 ,1453 ,0,3,1,3,0,1,0,76.14,62.078458362,33.33
03,010,01,008,0171,0,399 ,6 ,405 ,719 ,0,3,1,3,0,1,0,76.14,56.33 ,33.33
03,010,01,008,0172,0,274 ,10 ,284 ,561 ,0,3,1,3,0,1,0,76.14,50.62 ,33.33
03,010,01,008,0173,0,434 ,3 ,437 ,758 ,0,3,1,3,0,1,0,76.14,57.65 ,33.33
03,010,01,008,0174,0,492 ,6 ,498 ,954 ,0,3,1,3,0,1,0,76.14,52.20 ,33.33
03,010,01,008,0175,0,488 ,4 ,492 ,879 ,0,3,1,3,0,1,0,76.14,55.97 ,33.33
03,010,01,008,0176,0,328 ,3 ,331 ,630 ,0,3,1,3,0,1,0,76.14,52.54 ,33.33
03,010,01,008,0177,0,460 ,4 ,464 ,787 ,0,3,1,3,0,1,0,76.14,58.96 ,33.33
03,010,01,008,0178,0,505 ,3 ,508 ,838 ,0,3,1,3,0,1,0,76.14,60.62 ,33.33
03,010,01,008,0179,0,334 ,3 ,337 ,613 ,0,3,1,3,0,1,0,76.14,54.9755301794,33.33
03,010,01,009,0180,0,1053 ,10 ,1063 ,1822 ,0,3,1,3,0,1,0,76.14,58.3424807903,33.33
03,010,01,009,0181,0,602 ,8 ,610 ,1016 ,0,3,1,3,0,1,0,76.14,60.04 ,33.33
03,010,01,009,0182,0,996 ,7 ,1003 ,1623 ,0,3,1,3,0,1,0,76.14,61.80 ,33.33
03,010,01,009,0183,0,888 ,9 ,897 ,1475 ,0,3,1,3,0,1,0,76.14,60.81 ,33.33
03,010,01,009,0184,0,755 ,4 ,759 ,1267 ,0,3,1,3,0,1,0,76.14,59.91 ,33.33
03,010,01,009,0185,0,457 ,0 ,457 ,712 ,0,3,1,3,0,1,0,76.14,64.19 ,33.33
03,010,01,009,0186,0,285 ,1 ,286 ,455 ,0,3,1,3,0,1,0,76.14,62.86 ,33.33
03,010,01,009,0187,0,591 ,4 ,595 ,976 ,0,3,1,3,0,1,0,76.14,60.96 ,33.33
03,010,01,009,0188,0,625 ,3 ,628 ,1145 ,0,3,1,3,0,1,0,76.14,54.85 ,33.33
03,010,01,009,0189,0,502 ,4 ,506 ,871 ,0,3,1,3,0,1,0,76.14,58.09 ,33.33
03,010,01,009,0190,0,273 ,0 ,273 ,431 ,0,3,1,3,0,1,0,76.14,63.34 ,33.33
03,010,01,009,0191,0,641 ,8 ,649 ,1076 ,0,3,1,3,0,1,0,76.14,60.32 ,33.33
03,010,01,009,0192,0,215 ,2 ,217 ,381 ,0,3,1,3,0,1,0,76.14,56.96 ,33.33
03,010,01,009,0193,0,832 ,7 ,839 ,1370 ,0,3,1,3,0,1,0,76.14,61.24 ,33.33
03,010,01,009,0194,0,889 ,15 ,904 ,1310 ,0,3,1,3,0,1,0,76.14,69.01 ,33.33
03,010,01,009,0195,0,556 ,9 ,565 ,902 ,0,3,1,3,0,1,0,76.14,62.64 ,33.33
03,010,01,009,0196,0,413 ,9 ,422 ,772 ,0,3,1,3,0,1,0,76.14,54.66 ,33.33
03,010,01,009,0197,0,547 ,11 ,558 ,958 ,0,3,1,3,0,1,0,76.14,58.25 ,33.33
03,010,01,009,0198,0,466 ,4 ,470 ,815 ,0,3,1,3,0,1,0,76.14,57.67 ,33.33
03,010,01,009,0199,0,677 ,11 ,688 ,1138 ,0,3,1,3,0,1,0,76.14,60.46 ,33.33
03,010,01,009,0200,0,619 ,4 ,623 ,995 ,0,3,1,3,0,1,0,76.14,62.61 ,33.33
03,010,01,009,0201,0,769 ,18 ,787 ,1311 ,0,3,1,3,0,1,0,76.14,60.03 ,33.33
03,010,01,009,0202,0,521 ,5 ,526 ,806 ,0,3,1,3,0,1,0,76.14,65.26 ,33.33
03,010,01,010,0203,0,563 ,10 ,573 ,790 ,0,3,1,3,0,1,0,76.14,72.5316455696,33.33
03,010,01,010,0204,0,1041 ,17 ,1058 ,1532 ,0,3,1,3,0,1,0,76.14,69.0600522193,33.33
03,010,01,010,0205,0,888 ,11 ,899 ,1291 ,0,3,1,3,0,1,0,76.14,69.64 ,33.33
03,010,01,010,0206,0,653 ,6 ,659 ,903 ,0,3,1,3,0,1,0,76.14,72.98 ,33.33
03,010,01,010,0207,0,502 ,9 ,511 ,714 ,0,3,1,3,0,1,0,76.14,71.57 ,33.33
03,010,01,010,0208,0,949 ,9 ,958 ,1305 ,0,3,1,3,0,1,0,76.14,73.41 ,33.33
03,010,01,010,0209,0,277 ,1 ,278 ,429 ,0,3,1,3,0,1,0,76.14,64.8018648019,33.33
03,010,01,010,0210,0,341 ,2 ,343 ,472 ,0,3,1,3,0,1,0,76.14,72.67 ,33.33
03,010,01,010,0211,0,572 ,13 ,585 ,803 ,0,3,1,3,0,1,0,76.14,72.85 ,33.33
03,010,01,010,0212,0,291 ,3 ,294 ,445 ,0,3,1,3,0,1,0,76.14,66.07 ,33.33
03,010,01,010,0213,0,328 ,3 ,331 ,483 ,0,3,1,3,0,1,0,76.14,68.53 ,33.33
03,010,01,010,0214,0,400 ,8 ,408 ,595 ,0,3,1,3,0,1,0,76.14,68.57 ,33.33
03,010,01,010,0215,0,1031 ,11 ,1042 ,1534 ,0,3,1,3,0,1,0,76.14,67.93 ,33.33
03,010,01,010,0216,0,573 ,5 ,578 ,862 ,0,3,1,3,0,1,0,76.14,67.0533642691,33.33
03,010,01,010,0217,0,633 ,5 ,638 ,891 ,0,3,1,3,0,1,0,76.14,71.6049382716,33.33
03,010,01,010,0218,0,567 ,9 ,576 ,860 ,0,3,1,3,0,1,0,76.14,66.976744186,33.33
03,010,01,010,0219,0,331 ,5 ,336 ,524 ,0,3,1,3,0,1,0,76.14,64.1221374046,33.33
03,010,01,010,0220,0,421 ,2 ,423 ,585 ,0,3,1,3,0,1,0,76.14,72.3076923077,33.33
03,010,01,010,0221,0,579 ,3 ,582 ,828 ,0,3,1,3,0,1,0,76.14,70.2898550725,33.33
03,010,01,010,0222,0,312 ,2 ,314 ,475 ,0,3,1,3,0,1,0,76.14,66.1052631579,33.33
03,010,01,010,0223,0,456 ,6 ,462 ,673 ,0,3,1,3,0,1,0,76.14,68.6478454681,33.33
03,010,01,010,0224,0,475 ,6 ,481 ,750 ,0,3,1,3,0,1,0,76.14,64.1333333333,33.33
03,010,01,011,0225,0,328 ,5 ,333 ,512 ,0,3,1,3,0,1,0,76.14,65.0390625,33.33
03,010,01,011,0226,0,449 ,2 ,451 ,652 ,0,3,1,3,0,1,0,76.14,69.1717791411,33.33
03,010,01,011,0227,0,858 ,11 ,869 ,1334 ,0,3,1,3,0,1,0,76.14,65.1424287856,33.33
03,010,01,011,0228,0,788 ,6 ,794 ,1163 ,0,3,1,3,0,1,0,76.14,68.271711092,33.33
03,010,01,011,0229,0,308 ,2 ,310 ,464 ,0,3,1,3,0,1,0,76.14,66.8103448276,33.33
03,010,01,011,0230,0,735 ,9 ,744 ,1155 ,0,3,1,3,0,1,0,76.14,64.4155844156,33.33
03,010,01,011,0231,0,334 ,3 ,337 ,517 ,0,3,1,3,0,1,0,76.14,65.1837524178,33.33
03,010,01,011,0232,0,561 ,0 ,561 ,903 ,0,3,1,3,0,1,0,76.14,62.1262458472,33.33
03,010,01,011,0233,0,710 ,7 ,717 ,1116 ,0,3,1,3,0,1,0,76.14,64.247311828,33.33
03,010,01,011,0234,0,679 ,7 ,686 ,1078 ,0,3,1,3,0,1,0,76.14,63.6363636364,33.33
03,010,01,011,0235,0,557 ,1 ,558 ,922 ,0,3,1,3,0,1,0,76.14,60.5206073753,33.33
03,010,01,011,0236,0,600 ,9 ,609 ,925 ,0,3,1,3,0,1,0,76.14,65.8378378378,33.33
03,010,01,011,0237,0,914 ,8 ,922 ,1302 ,0,3,1,3,0,1,0,76.14,70.8141321045,33.33
03,010,01,011,0238,0,1046 ,7 ,1053 ,1528 ,0,3,1,3,0,1,0,76.14,68.9136125654,33.33
03,010,01,011,0239,0,403 ,4 ,407 ,568 ,0,3,1,3,0,1,0,76.14,71.6549295775,33.33
03,010,01,012,0240,0,1991 ,17 ,2008 ,3149 ,0,3,1,3,0,1,0,76.14,63.7662750079,33.33
03,010,01,012,0241,0,1429 ,6 ,1435 ,2160 ,0,3,1,3,0,1,0,76.14,66.4351851852,33.33
03,010,01,012,0242,0,1005 ,10 ,1015 ,1485 ,0,3,1,3,0,1,0,76.14,68.3501683502,33.33
03,010,01,012,0243,0,1003 ,11 ,1014 ,1628 ,0,3,1,3,0,1,0,76.14,62.285012285,33.33
03,010,01,012,0244,0,1145 ,13 ,1158 ,1796 ,0,3,1,3,0,1,0,76.14,64.4766146993,33.33
03,010,01,012,0245,0,406 ,10 ,416 ,642 ,0,3,1,3,0,1,0,76.14,64.7975077882,33.33
03,010,01,012,0246,0,1092 ,8 ,1100 ,1485 ,0,3,1,3,0,1,0,76.14,74.0740740741,33.33
03,010,01,012,0247,0,1217 ,13 ,1230 ,1954 ,0,3,1,3,0,1,0,76.14,62.9477993859,33.33
03,010,01,012,0248,0,557 ,4 ,561 ,839 ,0,3,1,3,0,1,0,76.14,66.8653158522,33.33
03,010,01,012,0249,0,1304 ,12 ,1316 ,1835 ,0,3,1,3,0,1,0,76.14,71.7166212534,33.33
03,010,01,012,0250,0,702 ,4 ,706 ,1104 ,0,3,1,3,0,1,0,76.14,63.9492753623,33.33
03,010,01,012,0251,0,463 ,3 ,466 ,681 ,0,3,1,3,0,1,0,76.14,68.4287812041,33.33
03,010,01,012,0252,0,392 ,1 ,393 ,529 ,0,3,1,3,0,1,0,76.14,74.2911153119,33.33
03,010,01,012,0253,0,813 ,12 ,825 ,1302 ,0,3,1,3,0,1,0,76.14,63.3640552995,33.33
03,010,01,012,0254,0,1341 ,16 ,1357 ,2199 ,0,3,1,3,0,1,0,76.14,61.7098681219,33.33
03,010,01,012,0255,0,1101 ,17 ,1118 ,1727 ,0,3,1,3,0,1,0,76.14,64.736537348,33.33
03,010,01,012,0256,0,1161 ,10 ,1171 ,1863 ,0,3,1,3,0,1,0,76.14,62.8556092324,33.33
03,010,01,012,0257,0,612 ,11 ,623 ,996 ,0,3,1,3,0,1,0,76.14,62.5502008032,33.33
03,010,01,012,0258,0,1926 ,20 ,1946 ,3623 ,0,3,1,3,0,1,0,76.14,53.7123930444,33.33
03,010,01,012,0259,0,1656 ,23 ,1679 ,2880 ,0,3,1,3,0,1,0,76.14,58.2986111111,33.33
03,010,01,012,0260,0,545 ,8 ,553 ,778 ,0,3,1,3,0,1,0,76.14,71.0796915167,33.33
03,010,01,012,0261,0,1115 ,16 ,1131 ,1848 ,0,3,1,3,0,1,0,76.14,61.2012987013,33.33
03,010,01,012,0262,0,1065 ,12 ,1077 ,1847 ,0,3,1,3,0,1,0,76.14,58.3107742285,33.33
03,010,01,012,0263,0,532 ,4 ,536 ,796 ,0,3,1,3,0,1,0,76.14,67.3366834171,33.33
03,010,01,012,0264,0,665 ,5 ,670 ,1023 ,0,3,1,3,0,1,0,76.14,65.4936461388,33.33
03,010,01,012,0265,0,779 ,7 ,786 ,1315 ,0,3,1,3,0,1,0,76.14,59.7718631179,33.33
03,010,01,013,0266,0,1003 ,7 ,1010 ,1635 ,0,3,1,3,0,1,0,76.14,61.7737003058,33.33
03,010,01,013,0267,0,522 ,7 ,529 ,857 ,0,3,1,3,0,1,0,76.14,61.7269544924,33.33
03,010,01,013,0268,0,475 ,3 ,478 ,749 ,0,3,1,3,0,1,0,76.14,63.8184245661,33.33
03,010,01,013,0269,0,503 ,6 ,509 ,882 ,0,3,1,3,0,1,0,76.14,57.7097505669,33.33
03,010,01,013,0270,0,762 ,4 ,766 ,1353 ,0,3,1,3,0,1,0,76.14,56.6149297857,33.33
03,010,01,013,0271,0,1410 ,15 ,1425 ,2629 ,0,3,1,3,0,1,0,76.14,54.2031190567,33.33
03,010,01,013,0272,0,1481 ,7 ,1488 ,2709 ,0,3,1,3,0,1,0,76.14,54.9280177187,33.33
03,010,01,013,0273,0,2949 ,29 ,2978 ,5582 ,0,3,1,3,0,1,0,76.14,53.3500537442,33.33
03,010,01,013,0274,0,2427 ,28 ,2455 ,4978 ,0,3,1,3,0,1,0,76.14,49.316994777,33.33
03,010,01,013,0275,0,1031 ,11 ,1042 ,1690 ,0,3,1,3,0,1,0,76.14,61.6568047337,33.33
03,010,01,013,0276,0,790 ,9 ,799 ,1348 ,0,3,1,3,0,1,0,76.14,59.2729970326,33.33
03,010,01,013,0277,0,1154 ,20 ,1174 ,2092 ,0,3,1,3,0,1,0,76.14,56.1185468451,33.33
03,010,01,013,0278,0,644 ,7 ,651 ,1084 ,0,3,1,3,0,1,0,76.14,60.0553505535,33.33
03,010,01,013,0279,0,736 ,4 ,740 ,1218 ,0,3,1,3,0,1,0,76.14,60.7553366174,33.33
03,010,01,013,0280,0,579 ,6 ,585 ,963 ,0,3,1,3,0,1,0,76.14,60.7476635514,33.33
03,010,01,013,0281,0,1210 ,14 ,1224 ,2011 ,0,3,1,3,0,1,0,76.14,60.8652411735,33.33
03,010,01,013,0282,0,506 ,7 ,513 ,738 ,0,3,1,3,0,1,0,76.14,69.512195122,33.33
03,010,01,013,0283,0,355 ,2 ,357 ,636 ,0,3,1,3,0,1,0,76.14,56.1320754717,33.33
03,010,01,013,0284,0,454 ,3 ,457 ,721 ,0,3,1,3,0,1,0,76.14,63.3841886269,33.33
03,010,01,013,0285,0,676 ,8 ,684 ,1104 ,0,3,1,3,0,1,0,76.14,61.9565217391,33.33
03,010,01,013,0286,0,246 ,0 ,246 ,332 ,0,3,1,3,0,1,0,76.14,74.0963855422,33.33
03,010,01,013,0287,0,216 ,3 ,219 ,327 ,0,3,1,3,0,1,0,76.14,66.9724770642,33.33
03,010,01,014,0288,0,1271 ,9 ,1280 ,2324 ,0,3,1,3,0,1,0,76.14,55.0774526678,33.33
03,010,01,014,0289,0,1079 ,11 ,1090 ,1910 ,0,3,1,3,0,1,0,76.14,57.0680628272,33.33
03,010,01,014,0290,0,452 ,5 ,457 ,784 ,0,3,1,3,0,1,0,76.14,58.2908163265,33.33
03,010,01,014,0291,0,532 ,9 ,541 ,872 ,0,3,1,3,0,1,0,76.14,62.0412844037,33.33
03,010,01,014,0292,0,825 ,15 ,840 ,1303 ,0,3,1,3,0,1,0,76.14,64.4666155027,33.33
03,010,01,014,0293,0,378 ,2 ,380 ,553 ,0,3,1,3,0,1,0,76.14,68.7160940325,33.33
03,010,01,014,0294,0,581 ,5 ,586 ,1054 ,0,3,1,3,0,1,0,76.14,55.5977229602,33.33
03,010,01,014,0295,0,2617 ,25 ,2642 ,4793 ,0,3,1,3,0,1,0,76.14,55.1220529939,33.33
03,010,01,014,0296,0,762 ,9 ,771 ,1270 ,0,3,1,3,0,1,0,76.14,60.7086614173,33.33
03,010,01,014,0297,0,752 ,10 ,762 ,1342 ,0,3,1,3,0,1,0,76.14,56.780923994,33.33
03,010,01,014,0298,0,960 ,7 ,967 ,1597 ,0,3,1,3,0,1,0,76.14,60.5510331872,33.33
03,010,01,014,0299,0,1085 ,9 ,1094 ,1735 ,0,3,1,3,0,1,0,76.14,63.0547550432,33.33
03,010,01,014,0300,0,620 ,1 ,621 ,1052 ,0,3,1,3,0,1,0,76.14,59.030418251,33.33
03,010,01,014,0301,0,451 ,8 ,459 ,777 ,0,3,1,3,0,1,0,76.14,59.0733590734,33.33
03,010,01,014,0302,0,566 ,3 ,569 ,913 ,0,3,1,3,0,1,0,76.14,62.3220153341,33.33
03,010,01,014,0303,0,349 ,3 ,352 ,560 ,0,3,1,3,0,1,0,76.14,62.8571428571,33.33
03,010,01,014,0304,0,1028 ,10 ,1038 ,1719 ,0,3,1,3,0,1,0,76.14,60.3839441536,33.33
03,010,01,014,0305,0,432 ,12 ,444 ,755 ,0,3,1,3,0,1,0,76.14,58.8079470199,33.33
03,010,01,014,0306,0,288 ,0 ,288 ,473 ,0,3,1,3,0,1,0,76.14,60.88794926,33.33
03,010,01,014,0307,0,1147 ,19 ,1166 ,1896 ,0,3,1,3,0,1,0,76.14,61.4978902954,33.33
03,010,01,014,0308,0,552 ,11 ,563 ,1002 ,0,3,1,3,0,1,0,76.14,56.1876247505,33.33
03,010,01,014,0309,0,138 ,2 ,140 ,281 ,0,3,1,3,0,1,0,76.14,49.8220640569,33.33
03,010,01,014,0310,0,453 ,3 ,456 ,814 ,0,3,1,3,0,1,0,76.14,56.0196560197,33.33
03,010,01,014,0311,0,460 ,2 ,462 ,776 ,0,3,1,3,0,1,0,76.14,59.5360824742,33.33
03,010,01,015,0312,0,1282 ,16 ,1298 ,2347 ,0,3,1,3,0,1,0,76.14,55.3046442267,33.33
03,010,01,015,0313,0,600 ,2 ,602 ,1006 ,0,3,1,3,0,1,0,76.14,59.8409542744,33.33
03,010,01,015,0314,0,2257 ,19 ,2276 ,3907 ,0,3,1,3,0,1,0,76.14,58.2544151523,33.33
03,010,01,015,0315,0,360 ,4 ,364 ,580 ,0,3,1,3,0,1,0,76.14,62.7586206897,33.33
03,010,01,015,0316,0,312 ,0 ,312 ,498 ,0,3,1,3,0,1,0,76.14,62.6506024096,33.33
03,010,01,015,0317,0,385 ,4 ,389 ,673 ,0,3,1,3,0,1,0,76.14,57.8008915305,33.33
03,010,01,015,0318,0,398 ,2 ,400 ,572 ,0,3,1,3,0,1,0,76.14,69.9300699301,33.33
03,010,01,015,0319,0,963 ,11 ,974 ,1698 ,0,3,1,3,0,1,0,76.14,57.3616018846,33.33
03,010,01,015,0320,0,513 ,4 ,517 ,941 ,0,3,1,3,0,1,0,76.14,54.9415515409,33.33
03,010,01,015,0321,0,292 ,5 ,297 ,519 ,0,3,1,3,0,1,0,76.14,57.225433526,33.33
03,010,01,015,0322,0,267 ,3 ,270 ,440 ,0,3,1,3,0,1,0,76.14,61.3636363636,33.33
03,010,01,015,0323,0,279 ,1 ,280 ,494 ,0,3,1,3,0,1,0,76.14,56.6801619433,33.33
03,010,01,015,0324,0,284 ,1 ,285 ,392 ,0,3,1,3,0,1,0,76.14,72.7040816327,33.33
03,010,01,015,0325,0,263 ,3 ,266 ,465 ,0,3,1,3,0,1,0,76.14,57.2043010753,33.33
03,010,01,015,0326,0,162 ,3 ,165 ,285 ,0,3,1,3,0,1,0,76.14,57.8947368421,33.33
03,010,01,015,0327,0,456 ,4 ,460 ,759 ,0,3,1,3,0,1,0,76.14,60.6060606061,33.33
03,010,01,015,0328,0,447 ,17 ,464 ,729 ,0,3,1,3,0,1,0,76.14,63.6488340192,33.33
03,010,01,015,0329,0,624 ,7 ,631 ,1040 ,0,3,1,3,0,1,0,76.14,60.6730769231,33.33
03,010,01,016,0330,0,637 ,9 ,646 ,1066 ,0,3,1,3,0,1,0,76.14,60.6003752345,33.33
03,010,01,016,0331,0,214 ,1 ,215 ,410 ,0,3,1,3,0,1,0,76.14,52.4390243902,33.33
03,010,01,016,0332,0,470 ,0 ,470 ,821 ,0,3,1,3,0,1,0,76.14,57.2472594397,33.33
03,010,01,016,0333,0,943 ,10 ,953 ,1675 ,0,3,1,3,0,1,0,76.14,56.8955223881,33.33
03,010,01,016,0334,0,482 ,5 ,487 ,831 ,0,3,1,3,0,1,0,76.14,58.6040914561,33.33
03,010,01,016,0335,0,512 ,5 ,517 ,807 ,0,3,1,3,0,1,0,76.14,64.0644361834,33.33
03,010,01,016,0336,0,587 ,4 ,591 ,830 ,0,3,1,3,0,1,0,76.14,71.2048192771,33.33
03,010,01,016,0337,0,461 ,4 ,465 ,830 ,0,3,1,3,0,1,0,76.14,56.0240963855,33.33
03,010,01,016,0338,0,528 ,6 ,534 ,953 ,0,3,1,3,0,1,0,76.14,56.0335781742,33.33
03,010,01,016,0339,0,292 ,1 ,293 ,542 ,0,3,1,3,0,1,0,76.14,54.0590405904,33.33
03,010,01,016,0340,0,231 ,2 ,233 ,408 ,0,3,1,3,0,1,0,76.14,57.1078431373,33.33
03,010,01,017,0341,0,512 ,3 ,515 ,976 ,0,3,1,3,0,1,0,76.14,52.7663934426,33.33
03,010,01,017,0342,0,253 ,0 ,253 ,469 ,0,3,1,3,0,1,0,76.14,53.9445628998,33.33
03,010,01,017,0343,0,179 ,3 ,182 ,300 ,0,3,1,3,0,1,0,76.14,60.6666666667,33.33
03,010,01,017,0344,0,378 ,2 ,380 ,708 ,0,3,1,3,0,1,0,76.14,53.6723163842,33.33
03,010,01,017,0345,0,199 ,1 ,200 ,376 ,0,3,1,3,0,1,0,76.14,53.1914893617,33.33
03,010,01,018,0346,0,188 ,0 ,188 ,335 ,0,3,1,3,0,1,0,76.14,56.1194029851,33.33
03,010,01,018,0347,0,92 ,0 ,92 ,170 ,0,3,1,3,0,1,0,76.14,54.1176470588,33.33
03,010,01,018,0348,0,85 ,1 ,86 ,210 ,0,3,1,3,0,1,0,76.14,40.9523809524,33.33
03,010,01,018,0349,0,174 ,2 ,176 ,307 ,0,3,1,3,0,1,0,76.14,57.328990228,33.33
03,010,01,018,0350,0,172 ,4 ,176 ,307 ,0,3,1,3,0,1,0,76.14,57.328990228,33.33
03,010,01,018,0351,0,5 ,0 ,5 ,19 ,0,3,1,3,0,1,0,76.14,26.3157894737,33.33
03,010,01,018,0352,0,153 ,1 ,154 ,275 ,0,3,1,3,0,1,0,76.14,56,33.33
03,010,01,018,0353,0,40 ,0 ,40 ,115 ,0,3,1,3,0,1,0,76.14,34.7826086957,33.33
03,010,01,018,0354,0,5 ,0 ,5 ,14 ,0,3,1,3,0,1,0,76.14,35.7142857143,33.33
03,010,01,018,0355,0,8 ,0 ,8 ,30 ,0,3,1,3,0,1,0,76.14,26.6666666667,33.33
03,010,01,018,0356,0,9 ,0 ,9 ,21 ,0,3,1,3,0,1,0,76.14,42.8571428571,33.33
03,010,01,018,0357,0,49 ,1 ,50 ,89 ,0,3,1,3,0,1,0,76.14,56.1797752809,33.33
03,011,01,001,0001,0,2538 ,13 ,2551 ,4451 ,0,3,1,3,0,1,0,76.14,57.31 ,33.33
03,011,01,001,0002,0,1451 ,7 ,1458 ,2399 ,0,3,1,3,0,1,0,76.14,60.78 ,33.33
03,011,01,001,0003,0,1536 ,36 ,1572 ,2708 ,0,3,1,3,0,1,0,76.14,58.05 ,33.33
03,011,01,001,0004,0,505 ,2 ,507 ,863 ,0,3,1,3,0,1,0,76.14,58.75 ,33.33
03,011,01,001,0005,0,795 ,6 ,801 ,1253 ,0,3,1,3,0,1,0,76.14,63.93 ,33.33
03,011,01,001,0006,0,647 ,5 ,652 ,986 ,0,3,1,3,0,1,0,76.14,66.13 ,33.33
03,011,01,001,0007,0,1797 ,15 ,1812 ,3135 ,0,3,1,3,0,1,0,76.14,57.80 ,33.33
03,011,01,001,0008,0,3827 ,27 ,3854 ,6647 ,0,3,1,3,0,1,0,76.14,57.98 ,33.33
03,011,01,001,0009,0,627 ,3 ,630 ,1078 ,0,3,1,3,0,1,0,76.14,58.44 ,33.33
03,011,01,001,0010,0,840 ,8 ,848 ,1434 ,0,3,1,3,0,1,0,76.14,59.14 ,33.33
03,011,01,001,0011,0,270 ,3 ,273 ,444 ,0,3,1,3,0,1,0,76.14,61.49 ,33.33
03,011,01,001,0012,0,1408 ,9 ,1417 ,2371 ,0,3,1,3,0,1,0,76.14,59.76 ,33.33
03,011,01,001,0013,0,883 ,7 ,890 ,1509 ,0,3,1,3,0,1,0,76.14,58.98 ,33.33
03,011,01,001,0014,0,1728 ,13 ,1741 ,3082 ,0,3,1,3,0,1,0,76.14,56.49 ,33.33
03,011,01,001,0015,0,1895 ,16 ,1911 ,3483 ,0,3,1,3,0,1,0,76.14,54.87 ,33.33
03,011,01,001,0016,0,1570 ,15 ,1585 ,2855 ,0,3,1,3,0,1,0,76.14,55.52 ,33.33
03,011,01,001,0017,0,2222 ,16 ,2238 ,4018 ,0,3,1,3,0,1,0,76.14,55.70 ,33.33
03,011,01,001,0018,0,971 ,5 ,976 ,1594 ,0,3,1,3,0,1,0,76.14,61.23 ,33.33
03,011,01,001,0019,0,798 ,10 ,808 ,1296 ,0,3,1,3,0,1,0,76.14,62.35 ,33.33
03,011,01,001,0020,0,915 ,5 ,920 ,1482 ,0,3,1,3,0,1,0,76.14,62.08 ,33.33
03,011,01,001,0021,0,1001 ,6 ,1007 ,1594 ,0,3,1,3,0,1,0,76.14,63.17 ,33.33
03,011,01,001,0022,0,1808 ,11 ,1819 ,3080 ,0,3,1,3,0,1,0,76.14,59.06 ,33.33
03,011,01,001,0023,0,851 ,9 ,860 ,1499 ,0,3,1,3,0,1,0,76.14,57.37 ,33.33
03,011,01,001,0024,0,205 ,1 ,206 ,359 ,0,3,1,3,0,1,0,76.14,57.38 ,33.33
03,011,01,001,0025,0,331 ,2 ,333 ,444 ,0,3,1,3,0,1,0,76.14,75.00 ,33.33
03,011,01,001,0026,0,480 ,4 ,484 ,734 ,0,3,1,3,0,1,0,76.14,65.94 ,33.33
03,011,01,001,0027,0,647 ,9 ,656 ,997 ,0,3,1,3,0,1,0,76.14,65.80 ,33.33
03,011,01,001,0028,0,389 ,8 ,397 ,587 ,0,3,1,3,0,1,0,76.14,67.63 ,33.33
03,011,01,002,0029,0,908 ,2 ,910 ,1411 ,0,3,1,3,0,1,0,76.14,64.49 ,33.33
03,011,01,002,0030,0,389 ,3 ,392 ,619 ,0,3,1,3,0,1,0,76.14,63.33 ,33.33
03,011,01,002,0031,0,275 ,3 ,278 ,379 ,0,3,1,3,0,1,0,76.14,73.35 ,33.33
03,011,01,002,0032,0,374 ,4 ,378 ,551 ,0,3,1,3,0,1,0,76.14,68.60 ,33.33
03,011,01,002,0033,0,341 ,4 ,345 ,532 ,0,3,1,3,0,1,0,76.14,64.85 ,33.33
03,011,01,002,0034,0,246 ,3 ,249 ,391 ,0,3,1,3,0,1,0,76.14,63.68 ,33.33
03,011,01,002,0035,0,503 ,2 ,505 ,784 ,0,3,1,3,0,1,0,76.14,64.41 ,33.33
03,011,01,002,0036,0,1760 ,13 ,1773 ,3262 ,0,3,1,3,0,1,0,76.14,54.35 ,33.33
03,011,01,002,0037,0,517 ,6 ,523 ,768 ,0,3,1,3,0,1,0,76.14,68.10 ,33.33
03,011,01,002,0038,0,588 ,8 ,596 ,968 ,0,3,1,3,0,1,0,76.14,61.57 ,33.33
03,011,01,002,0039,0,1943 ,19 ,1962 ,3283 ,0,3,1,3,0,1,0,76.14,59.76 ,33.33
03,011,01,002,0040,0,500 ,2 ,502 ,777 ,0,3,1,3,0,1,0,76.14,64.61 ,33.33
03,011,01,002,0041,0,488 ,5 ,493 ,769 ,0,3,1,3,0,1,0,76.14,64.11 ,33.33
03,011,01,002,0042,0,1036 ,9 ,1045 ,1633 ,0,3,1,3,0,1,0,76.14,63.99 ,33.33
03,011,01,002,0043,0,302 ,3 ,305 ,490 ,0,3,1,3,0,1,0,76.14,62.24 ,33.33
03,011,01,002,0044,0,221 ,4 ,225 ,297 ,0,3,1,3,0,1,0,76.14,75.76 ,33.33
03,011,01,002,0045,0,431 ,4 ,435 ,670 ,0,3,1,3,0,1,0,76.14,64.93 ,33.33
03,011,01,002,0046,0,274 ,1 ,275 ,474 ,0,3,1,3,0,1,0,76.14,58.02 ,33.33
03,011,01,002,0047,0,533 ,3 ,536 ,785 ,0,3,1,3,0,1,0,76.14,68.28 ,33.33
03,011,01,002,0048,0,284 ,3 ,287 ,416 ,0,3,1,3,0,1,0,76.14,68.99 ,33.33
03,011,01,002,0049,0,181 ,3 ,184 ,272 ,0,3,1,3,0,1,0,76.14,67.65 ,33.33
03,011,01,002,0050,0,273 ,0 ,273 ,374 ,0,3,1,3,0,1,0,76.14,72.99 ,33.33
03,011,01,002,0051,0,261 ,1 ,262 ,411 ,0,3,1,3,0,1,0,76.14,63.75 ,33.33
03,011,01,002,0052,0,359 ,2 ,361 ,545 ,0,3,1,3,0,1,0,76.14,66.24 ,33.33
03,011,01,002,0053,0,636 ,7 ,643 ,949 ,0,3,1,3,0,1,0,76.14,67.76 ,33.33
03,011,01,003,0054,0,1077 ,13 ,1090 ,1801 ,0,3,1,3,0,1,0,76.14,60.52 ,33.33
03,011,01,003,0055,0,1732 ,11 ,1743 ,2819 ,0,3,1,3,0,1,0,76.14,61.83 ,33.33
03,011,01,003,0056,0,934 ,6 ,940 ,1471 ,0,3,1,3,0,1,0,76.14,63.90 ,33.33
03,011,01,003,0057,0,968 ,7 ,975 ,1558 ,0,3,1,3,0,1,0,76.14,62.58 ,33.33
03,011,01,003,0058,0,575 ,2 ,577 ,859 ,0,3,1,3,0,1,0,76.14,67.17 ,33.33
03,011,01,003,0059,0,785 ,9 ,794 ,1360 ,0,3,1,3,0,1,0,76.14,58.38 ,33.33
03,011,01,003,0060,0,315 ,3 ,318 ,455 ,0,3,1,3,0,1,0,76.14,69.89 ,33.33
03,011,01,003,0061,0,365 ,6 ,371 ,622 ,0,3,1,3,0,1,0,76.14,59.65 ,33.33
03,011,01,003,0062,0,298 ,5 ,303 ,460 ,0,3,1,3,0,1,0,76.14,65.87 ,33.33
03,011,01,003,0063,0,335 ,0 ,335 ,646 ,0,3,1,3,0,1,0,76.14,51.86 ,33.33
03,011,01,003,0064,0,739 ,7 ,746 ,1227 ,0,3,1,3,0,1,0,76.14,60.80 ,33.33
03,011,01,003,0065,0,1089 ,17 ,1106 ,1873 ,0,3,1,3,0,1,0,76.14,59.05 ,33.33
03,011,01,003,0066,0,792 ,6 ,798 ,1235 ,0,3,1,3,0,1,0,76.14,64.62 ,33.33
03,011,01,003,0067,0,927 ,5 ,932 ,1406 ,0,3,1,3,0,1,0,76.14,66.29 ,33.33
03,011,01,003,0068,0,581 ,4 ,585 ,870 ,0,3,1,3,0,1,0,76.14,67.24 ,33.33
03,011,01,003,0069,0,462 ,5 ,467 ,681 ,0,3,1,3,0,1,0,76.14,68.58 ,33.33
03,011,01,003,0070,0,581 ,9 ,590 ,883 ,0,3,1,3,0,1,0,76.14,66.82 ,33.33
03,011,01,003,0071,0,579 ,4 ,583 ,932 ,0,3,1,3,0,1,0,76.14,62.55 ,33.33
03,011,01,003,0072,0,500 ,2 ,502 ,782 ,0,3,1,3,0,1,0,76.14,64.19 ,33.33
03,011,01,003,0073,0,784 ,7 ,791 ,1257 ,0,3,1,3,0,1,0,76.14,62.93 ,33.33
03,011,01,003,0074,0,474 ,5 ,479 ,704 ,0,3,1,3,0,1,0,76.14,68.04 ,33.33
03,011,01,003,0075,0,515 ,2 ,517 ,774 ,0,3,1,3,0,1,0,76.14,66.80 ,33.33
03,011,01,003,0076,0,557 ,1 ,558 ,913 ,0,3,1,3,0,1,0,76.14,61.12 ,33.33
03,011,01,003,0077,0,380 ,5 ,385 ,658 ,0,3,1,3,0,1,0,76.14,58.51 ,33.33
03,011,01,004,0078,0,920 ,9 ,929 ,1545 ,0,3,1,3,0,1,0,76.14,60.13 ,33.33
03,011,01,004,0079,0,1161 ,10 ,1171 ,1815 ,0,3,1,3,0,1,0,76.14,64.52 ,33.33
03,011,01,004,0080,0,494 ,4 ,498 ,717 ,0,3,1,3,0,1,0,76.14,69.46 ,33.33
03,011,01,004,0081,0,1540 ,8 ,1548 ,2494 ,0,3,1,3,0,1,0,76.14,62.07 ,33.33
03,011,01,004,0082,0,850 ,5 ,855 ,1291 ,0,3,1,3,0,1,0,76.14,66.23 ,33.33
03,011,01,004,0083,0,474 ,4 ,478 ,771 ,0,3,1,3,0,1,0,76.14,62.00 ,33.33
03,011,01,004,0084,0,959 ,10 ,969 ,1510 ,0,3,1,3,0,1,0,76.14,64.17 ,33.33
03,011,01,004,0085,0,1170 ,10 ,1180 ,1784 ,0,3,1,3,0,1,0,76.14,66.14 ,33.33
03,011,01,004,0086,0,905 ,4 ,909 ,1409 ,0,3,1,3,0,1,0,76.14,64.51 ,33.33
03,011,01,004,0087,0,431 ,4 ,435 ,666 ,0,3,1,3,0,1,0,76.14,65.32 ,33.33
03,011,01,004,0088,0,883 ,6 ,889 ,1391 ,0,3,1,3,0,1,0,76.14,63.91 ,33.33
03,011,01,004,0089,0,763 ,4 ,767 ,1255 ,0,3,1,3,0,1,0,76.14,61.12 ,33.33
03,011,01,004,0090,0,1046 ,12 ,1058 ,1650 ,0,3,1,3,0,1,0,76.14,64.12 ,33.33
03,011,01,005,0091,0,1005 ,10 ,1015 ,1526 ,0,3,1,3,0,1,0,76.14,66.51 ,33.33
03,011,01,005,0092,0,809 ,8 ,817 ,1295 ,0,3,1,3,0,1,0,76.14,63.09 ,33.33
03,011,01,005,0093,0,798 ,5 ,803 ,1253 ,0,3,1,3,0,1,0,76.14,64.09 ,33.33
03,011,01,005,0094,0,858 ,5 ,863 ,1333 ,0,3,1,3,0,1,0,76.14,64.74 ,33.33
03,011,01,005,0095,0,711 ,5 ,716 ,1180 ,0,3,1,3,0,1,0,76.14,60.68 ,33.33
03,011,01,005,0096,0,747 ,9 ,756 ,1278 ,0,3,1,3,0,1,0,76.14,59.15 ,33.33
03,011,01,005,0097,0,475 ,3 ,478 ,800 ,0,3,1,3,0,1,0,76.14,59.75 ,33.33
03,011,01,005,0098,0,333 ,4 ,337 ,479 ,0,3,1,3,0,1,0,76.14,70.35 ,33.33
03,011,01,005,0099,0,298 ,8 ,306 ,550 ,0,3,1,3,0,1,0,76.14,55.64 ,33.33
03,011,01,005,0100,0,489 ,7 ,496 ,777 ,0,3,1,3,0,1,0,76.14,63.84 ,33.33
03,011,01,005,0101,0,282 ,2 ,284 ,448 ,0,3,1,3,0,1,0,76.14,63.39 ,33.33
03,011,01,005,0102,0,697 ,4 ,701 ,1129 ,0,3,1,3,0,1,0,76.14,62.09 ,33.33
03,011,01,005,0103,0,372 ,1 ,373 ,545 ,0,3,1,3,0,1,0,76.14,68.44 ,33.33
03,011,01,005,0104,0,632 ,5 ,637 ,1048 ,0,3,1,3,0,1,0,76.14,60.78 ,33.33
03,011,01,005,0105,0,400 ,5 ,405 ,569 ,0,3,1,3,0,1,0,76.14,71.18 ,33.33
03,011,01,005,0106,0,981 ,7 ,988 ,1437 ,0,3,1,3,0,1,0,76.14,68.75 ,33.33
03,011,01,005,0107,0,969 ,10 ,979 ,1514 ,0,3,1,3,0,1,0,76.14,64.66 ,33.33
03,011,01,005,0108,0,757 ,6 ,763 ,1228 ,0,3,1,3,0,1,0,76.14,62.13 ,33.33
03,011,01,005,0109,0,818 ,5 ,823 ,1333 ,0,3,1,3,0,1,0,76.14,61.74 ,33.33
03,011,01,005,0110,0,731 ,13 ,744 ,1163 ,0,3,1,3,0,1,0,76.14,63.97 ,33.33
03,011,01,005,0111,0,484 ,6 ,490 ,813 ,0,3,1,3,0,1,0,76.14,60.27 ,33.33
03,011,01,006,0112,0,783 ,6 ,789 ,1455 ,0,3,1,3,0,1,0,76.14,54.23 ,33.33
03,011,01,006,0113,0,1358 ,12 ,1370 ,2354 ,0,3,1,3,0,1,0,76.14,58.20 ,33.33
03,011,01,006,0114,0,874 ,10 ,884 ,1542 ,0,3,1,3,0,1,0,76.14,57.33 ,33.33
03,011,01,006,0115,0,589 ,6 ,595 ,1166 ,0,3,1,3,0,1,0,76.14,51.03 ,33.33
03,011,01,006,0116,0,565 ,3 ,568 ,923 ,0,3,1,3,0,1,0,76.14,61.54 ,33.33
03,011,01,006,0117,0,851 ,8 ,859 ,1336 ,0,3,1,3,0,1,0,76.14,64.30 ,33.33
03,011,01,006,0118,0,520 ,5 ,525 ,902 ,0,3,1,3,0,1,0,76.14,58.20 ,33.33
03,011,01,006,0119,0,1248 ,13 ,1261 ,1875 ,0,3,1,3,0,1,0,76.14,67.25 ,33.33
03,011,01,006,0120,0,294 ,6 ,300 ,500 ,0,3,1,3,0,1,0,76.14,60.00 ,33.33
03,011,01,006,0121,0,252 ,1 ,253 ,467 ,0,3,1,3,0,1,0,76.14,54.18 ,33.33
03,011,01,006,0122,0,246 ,5 ,251 ,403 ,0,3,1,3,0,1,0,76.14,62.28 ,33.33
03,011,01,006,0123,0,1245 ,6 ,1251 ,2301 ,0,3,1,3,0,1,0,76.14,54.37 ,33.33
03,011,01,006,0124,0,108 ,0 ,108 ,773 ,0,3,1,3,0,1,0,76.14,13.97 ,33.33
03,011,01,006,0125,0,625 ,5 ,630 ,1161 ,0,3,1,3,0,1,0,76.14,54.26 ,33.33
03,011,01,006,0126,0,609 ,2 ,611 ,1129 ,0,3,1,3,0,1,0,76.14,54.12 ,33.33
03,011,01,006,0127,0,564 ,3 ,567 ,955 ,0,3,1,3,0,1,0,76.14,59.37 ,33.33
03,011,01,007,0128,0,448 ,0 ,448 ,617 ,0,3,1,3,0,1,0,76.14,72.61 ,33.33
03,011,01,007,0129,0,403 ,1 ,404 ,585 ,0,3,1,3,0,1,0,76.14,69.06 ,33.33
03,011,01,007,0130,0,1376 ,6 ,1382 ,2116 ,0,3,1,3,0,1,0,76.14,65.31 ,33.33
03,011,01,007,0131,0,1519 ,12 ,1531 ,2311 ,0,3,1,3,0,1,0,76.14,66.25 ,33.33
03,011,01,007,0132,0,912 ,7 ,919 ,1408 ,0,3,1,3,0,1,0,76.14,65.27 ,33.33
03,011,01,007,0133,0,1201 ,5 ,1206 ,1907 ,0,3,1,3,0,1,0,76.14,63.24 ,33.33
03,011,01,007,0134,0,886 ,10 ,896 ,1330 ,0,3,1,3,0,1,0,76.14,67.37 ,33.33
03,011,01,007,0135,0,680 ,2 ,682 ,1002 ,0,3,1,3,0,1,0,76.14,68.06 ,33.33
03,011,01,007,0136,0,1993 ,18 ,2011 ,2978 ,0,3,1,3,0,1,0,76.14,67.53 ,33.33
03,011,01,007,0137,0,773 ,2 ,775 ,1145 ,0,3,1,3,0,1,0,76.14,67.69 ,33.33
03,011,01,007,0138,0,1677 ,15 ,1692 ,2531 ,0,3,1,3,0,1,0,76.14,66.85 ,33.33
03,011,01,007,0139,0,459 ,5 ,464 ,660 ,0,3,1,3,0,1,0,76.14,70.30 ,33.33
03,011,01,007,0140,0,510 ,2 ,512 ,738 ,0,3,1,3,0,1,0,76.14,69.38 ,33.33
03,011,01,007,0141,0,1473 ,8 ,1481 ,2241 ,0,3,1,3,0,1,0,76.14,66.09 ,33.33
03,011,01,007,0142,0,1051 ,11 ,1062 ,1555 ,0,3,1,3,0,1,0,76.14,68.30 ,33.33
03,011,01,007,0143,0,635 ,2 ,637 ,952 ,0,3,1,3,0,1,0,76.14,66.91 ,33.33
03,011,01,007,0144,0,911 ,3 ,914 ,1322 ,0,3,1,3,0,1,0,76.14,69.14 ,33.33
03,011,01,007,0145,0,397 ,3 ,400 ,531 ,0,3,1,3,0,1,0,76.14,75.33 ,33.33
03,011,01,007,0146,0,655 ,9 ,664 ,959 ,0,3,1,3,0,1,0,76.14,69.24 ,33.33
03,011,01,007,0147,0,376 ,3 ,379 ,528 ,0,3,1,3,0,1,0,76.14,71.78 ,33.33
03,011,01,007,0148,0,796 ,9 ,805 ,1078 ,0,3,1,3,0,1,0,76.14,74.68 ,33.33
03,011,01,007,0149,0,705 ,4 ,709 ,1037 ,0,3,1,3,0,1,0,76.14,68.37 ,33.33
03,011,01,007,0150,0,394 ,0 ,394 ,627 ,0,3,1,3,0,1,0,76.14,62.84 ,33.33
03,011,01,007,0151,0,440 ,0 ,440 ,666 ,0,3,1,3,0,1,0,76.14,66.07 ,33.33
03,011,01,007,0152,0,516 ,2 ,518 ,741 ,0,3,1,3,0,1,0,76.14,69.91 ,33.33
03,011,01,007,0153,0,643 ,5 ,648 ,935 ,0,3,1,3,0,1,0,76.14,69.30 ,33.33
03,011,01,007,0154,0,581 ,2 ,583 ,842 ,0,3,1,3,0,1,0,76.14,69.24 ,33.33
03,011,01,007,0155,0,564 ,3 ,567 ,839 ,0,3,1,3,0,1,0,76.14,67.58 ,33.33
03,011,01,007,0156,0,752 ,5 ,757 ,1138 ,0,3,1,3,0,1,0,76.14,66.52 ,33.33
03,011,01,008,0157,0,641 ,4 ,645 ,958 ,0,3,1,3,0,1,0,76.14,67.33 ,33.33
03,011,01,008,0158,0,1719 ,4 ,1723 ,2633 ,0,3,1,3,0,1,0,76.14,65.44 ,33.33
03,011,01,008,0159,0,725 ,6 ,731 ,1138 ,0,3,1,3,0,1,0,76.14,64.24 ,33.33
03,011,01,008,0160,0,1023 ,8 ,1031 ,1539 ,0,3,1,3,0,1,0,76.14,66.99 ,33.33
03,011,01,008,0161,0,1385 ,12 ,1397 ,2180 ,0,3,1,3,0,1,0,76.14,64.08 ,33.33
03,011,01,008,0162,0,1378 ,4 ,1382 ,2126 ,0,3,1,3,0,1,0,76.14,65.00 ,33.33
03,011,01,008,0163,0,560 ,2 ,562 ,802 ,0,3,1,3,0,1,0,76.14,70.07 ,33.33
03,011,01,008,0164,0,543 ,1 ,544 ,766 ,0,3,1,3,0,1,0,76.14,71.02 ,33.33
03,011,01,008,0165,0,805 ,9 ,814 ,1220 ,0,3,1,3,0,1,0,76.14,66.72 ,33.33
03,011,01,008,0166,0,726 ,3 ,729 ,1140 ,0,3,1,3,0,1,0,76.14,63.95 ,33.33
03,011,01,008,0167,0,1205 ,5 ,1210 ,1858 ,0,3,1,3,0,1,0,76.14,65.12 ,33.33
03,011,01,008,0168,0,602 ,9 ,611 ,872 ,0,3,1,3,0,1,0,76.14,70.07 ,33.33
03,011,01,008,0169,0,860 ,4 ,864 ,1334 ,0,3,1,3,0,1,0,76.14,64.77 ,33.33
03,011,01,008,0170,0,761 ,4 ,765 ,1173 ,0,3,1,3,0,1,0,76.14,65.22 ,33.33
03,011,01,008,0171,0,846 ,8 ,854 ,1261 ,0,3,1,3,0,1,0,76.14,67.72 ,33.33
03,011,01,009,0172,0,1747 ,16 ,1763 ,2810 ,0,3,1,3,0,1,0,76.14,62.74 ,33.33
03,011,01,009,0173,0,1550 ,17 ,1567 ,2581 ,0,3,1,3,0,1,0,76.14,60.71 ,33.33
03,011,01,009,0174,0,825 ,4 ,829 ,1300 ,0,3,1,3,0,1,0,76.14,63.77 ,33.33
03,011,01,009,0175,0,617 ,8 ,625 ,1023 ,0,3,1,3,0,1,0,76.14,61.09 ,33.33
03,011,01,009,0176,0,574 ,6 ,580 ,889 ,0,3,1,3,0,1,0,76.14,65.24 ,33.33
03,011,01,009,0177,0,1778 ,15 ,1793 ,2936 ,0,3,1,3,0,1,0,76.14,61.07 ,33.33
03,011,01,009,0178,0,1269 ,11 ,1280 ,1946 ,0,3,1,3,0,1,0,76.14,65.78 ,33.33
03,011,01,009,0179,0,1045 ,8 ,1053 ,1585 ,0,3,1,3,0,1,0,76.14,66.44 ,33.33
03,011,01,009,0180,0,666 ,9 ,675 ,1088 ,0,3,1,3,0,1,0,76.14,62.04 ,33.33
03,011,01,009,0181,0,420 ,4 ,424 ,600 ,0,3,1,3,0,1,0,76.14,70.67 ,33.33
03,011,01,009,0182,0,521 ,6 ,527 ,830 ,0,3,1,3,0,1,0,76.14,63.49 ,33.33
03,011,01,009,0183,0,467 ,2 ,469 ,731 ,0,3,1,3,0,1,0,76.14,64.16 ,33.33
03,011,01,010,0184,0,1242 ,12 ,1254 ,1919 ,0,3,1,3,0,1,0,76.14,65.35 ,33.33
03,011,01,010,0185,0,1573 ,14 ,1587 ,2488 ,0,3,1,3,0,1,0,76.14,63.79 ,33.33
03,011,01,010,0186,0,644 ,4 ,648 ,989 ,0,3,1,3,0,1,0,76.14,65.52 ,33.33
03,011,01,010,0187,0,178 ,2 ,180 ,305 ,0,3,1,3,0,1,0,76.14,59.02 ,33.33
03,011,01,010,0188,0,316 ,0 ,316 ,476 ,0,3,1,3,0,1,0,76.14,66.39 ,33.33
03,011,01,010,0189,0,1179 ,11 ,1190 ,1862 ,0,3,1,3,0,1,0,76.14,63.91 ,33.33
03,011,01,010,0190,0,1874 ,12 ,1886 ,2901 ,0,3,1,3,0,1,0,76.14,65.01 ,33.33
03,011,01,010,0191,0,624 ,11 ,635 ,1110 ,0,3,1,3,0,1,0,76.14,57.21 ,33.33
03,011,01,010,0192,0,982 ,6 ,988 ,1396 ,0,3,1,3,0,1,0,76.14,70.77 ,33.33
03,011,01,010,0193,0,484 ,4 ,488 ,693 ,0,3,1,3,0,1,0,76.14,70.42 ,33.33
03,011,01,010,0194,0,415 ,2 ,417 ,592 ,0,3,1,3,0,1,0,76.14,70.44 ,33.33
03,011,01,010,0195,0,1496 ,9 ,1505 ,2172 ,0,3,1,3,0,1,0,76.14,69.29 ,33.33
03,011,01,010,0196,0,557 ,5 ,562 ,906 ,0,3,1,3,0,1,0,76.14,62.03 ,33.33
03,011,01,011,0197,0,712 ,5 ,717 ,1115 ,0,3,1,3,0,1,0,76.14,64.30 ,33.33
03,011,01,011,0198,0,509 ,5 ,514 ,782 ,0,3,1,3,0,1,0,76.14,65.73 ,33.33
03,011,01,011,0199,0,894 ,10 ,904 ,1525 ,0,3,1,3,0,1,0,76.14,59.28 ,33.33
03,011,01,011,0200,0,662 ,8 ,670 ,1072 ,0,3,1,3,0,1,0,76.14,62.50 ,33.33
03,011,01,011,0201,0,552 ,2 ,554 ,843 ,0,3,1,3,0,1,0,76.14,65.72 ,33.33
03,011,01,011,0202,0,421 ,4 ,425 ,688 ,0,3,1,3,0,1,0,76.14,61.77 ,33.33
03,011,01,011,0203,0,616 ,7 ,623 ,1050 ,0,3,1,3,0,1,0,76.14,59.33 ,33.33
03,011,01,011,0204,0,535 ,2 ,537 ,901 ,0,3,1,3,0,1,0,76.14,59.60 ,33.33
03,011,01,011,0205,0,580 ,3 ,583 ,937 ,0,3,1,3,0,1,0,76.14,62.22 ,33.33
03,011,01,011,0206,0,456 ,4 ,460 ,638 ,0,3,1,3,0,1,0,76.14,72.10 ,33.33
03,011,01,012,0207,0,1106 ,11 ,1117 ,1760 ,0,3,1,3,0,1,0,76.14,63.47 ,33.33
03,011,01,012,0208,0,1680 ,11 ,1691 ,2786 ,0,3,1,3,0,1,0,76.14,60.70 ,33.33
03,011,01,012,0209,0,2988 ,19 ,3007 ,4793 ,0,3,1,3,0,1,0,76.14,62.74 ,33.33
03,011,01,012,0210,0,3700 ,24 ,3724 ,6056 ,0,3,1,3,0,1,0,76.14,61.49 ,33.33
03,011,01,012,0211,0,5362 ,25 ,5387 ,9139 ,0,3,1,3,0,1,0,76.14,58.95 ,33.33
03,011,01,012,0212,0,2030 ,16 ,2046 ,3299 ,0,3,1,3,0,1,0,76.14,62.02 ,33.33
03,011,01,012,0213,0,1238 ,4 ,1242 ,1965 ,0,3,1,3,0,1,0,76.14,63.21 ,33.33
03,011,01,012,0214,0,605 ,6 ,611 ,861 ,0,3,1,3,0,1,0,76.14,70.96 ,33.33
03,011,01,012,0215,0,867 ,3 ,870 ,1349 ,0,3,1,3,0,1,0,76.14,64.49 ,33.33
03,011,01,012,0216,0,423 ,4 ,427 ,685 ,0,3,1,3,0,1,0,76.14,62.34 ,33.33
03,011,01,012,0217,0,256 ,1 ,257 ,392 ,0,3,1,3,0,1,0,76.14,65.56 ,33.33
03,011,01,012,0218,0,840 ,8 ,848 ,1371 ,0,3,1,3,0,1,0,76.14,61.85 ,33.33
03,011,01,012,0219,0,431 ,4 ,435 ,693 ,0,3,1,3,0,1,0,76.14,62.77 ,33.33
03,011,01,012,0220,0,570 ,3 ,573 ,855 ,0,3,1,3,0,1,0,76.14,67.02 ,33.33
03,011,01,012,0221,0,598 ,3 ,601 ,958 ,0,3,1,3,0,1,0,76.14,62.73 ,33.33
03,011,01,012,0222,0,699 ,6 ,705 ,1062 ,0,3,1,3,0,1,0,76.14,66.38 ,33.33
03,011,01,012,0223,0,574 ,5 ,579 ,843 ,0,3,1,3,0,1,0,76.14,68.68 ,33.33
03,011,01,012,0224,0,670 ,10 ,680 ,978 ,0,3,1,3,0,1,0,76.14,69.53 ,33.33
03,011,01,012,0225,0,848 ,6 ,854 ,1291 ,0,3,1,3,0,1,0,76.14,66.15 ,33.33
03,011,01,012,0226,0,1020 ,2 ,1022 ,1544 ,0,3,1,3,0,1,0,76.14,66.19 ,33.33
03,011,01,012,0227,0,588 ,4 ,592 ,889 ,0,3,1,3,0,1,0,76.14,66.59 ,33.33
03,011,01,013,0228,0,856 ,4 ,860 ,1293 ,0,3,1,3,0,1,0,76.14,66.51 ,33.33
03,011,01,013,0229,0,786 ,5 ,791 ,1299 ,0,3,1,3,0,1,0,76.14,60.89 ,33.33
03,011,01,013,0230,0,329 ,3 ,332 ,510 ,0,3,1,3,0,1,0,76.14,65.10 ,33.33
03,011,01,013,0231,0,564 ,3 ,567 ,911 ,0,3,1,3,0,1,0,76.14,62.24 ,33.33
03,011,01,013,0232,0,391 ,3 ,394 ,581 ,0,3,1,3,0,1,0,76.14,67.81 ,33.33
03,011,01,013,0233,0,2291 ,13 ,2304 ,3628 ,0,3,1,3,0,1,0,76.14,63.51 ,33.33
03,011,01,013,0234,0,918 ,6 ,924 ,1491 ,0,3,1,3,0,1,0,76.14,61.97 ,33.33
03,011,01,013,0235,0,873 ,8 ,881 ,1350 ,0,3,1,3,0,1,0,76.14,65.26 ,33.33
03,011,01,013,0236,0,968 ,5 ,973 ,1541 ,0,3,1,3,0,1,0,76.14,63.14 ,33.33
03,011,01,013,0237,0,391 ,2 ,393 ,569 ,0,3,1,3,0,1,0,76.14,69.07 ,33.33
03,011,01,013,0238,0,334 ,3 ,337 ,528 ,0,3,1,3,0,1,0,76.14,63.83 ,33.33
03,011,01,013,0239,0,538 ,10 ,548 ,873 ,0,3,1,3,0,1,0,76.14,62.77 ,33.33
03,011,01,013,0240,0,206 ,2 ,208 ,335 ,0,3,1,3,0,1,0,76.14,62.09 ,33.33
03,011,01,013,0241,0,437 ,1 ,438 ,644 ,0,3,1,3,0,1,0,76.14,68.01 ,33.33
03,011,01,013,0242,0,220 ,2 ,222 ,336 ,0,3,1,3,0,1,0,76.14,66.07 ,33.33
03,011,01,013,0243,0,296 ,1 ,297 ,424 ,0,3,1,3,0,1,0,76.14,70.05 ,33.33
03,011,01,013,0244,0,303 ,2 ,305 ,472 ,0,3,1,3,0,1,0,76.14,64.62 ,33.33
03,011,01,013,0245,0,208 ,1 ,209 ,330 ,0,3,1,3,0,1,0,76.14,63.33 ,33.33
03,011,01,013,0246,0,568 ,4 ,572 ,898 ,0,3,1,3,0,1,0,76.14,63.70 ,33.33
03,011,01,013,0247,0,269 ,2 ,271 ,440 ,0,3,1,3,0,1,0,76.14,61.59 ,33.33
03,011,01,013,0248,0,679 ,3 ,682 ,1088 ,0,3,1,3,0,1,0,76.14,62.68 ,33.33
03,011,01,013,0249,0,312 ,2 ,314 ,478 ,0,3,1,3,0,1,0,76.14,65.69 ,33.33
03,011,01,013,0250,0,477 ,1 ,478 ,676 ,0,3,1,3,0,1,0,76.14,70.71 ,33.33
03,011,01,013,0251,0,508 ,4 ,512 ,673 ,0,3,1,3,0,1,0,76.14,76.08 ,33.33
03,011,01,013,0252,0,314 ,3 ,317 ,479 ,0,3,1,3,0,1,0,76.14,66.18 ,33.33
03,011,01,013,0253,0,294 ,4 ,298 ,450 ,0,3,1,3,0,1,0,76.14,66.22 ,33.33
03,011,01,014,0254,0,1859 ,26 ,1885 ,2806 ,0,3,1,3,0,1,0,76.14,67.18 ,33.33
03,011,01,014,0255,0,2338 ,24 ,2362 ,3640 ,0,3,1,3,0,1,0,76.14,64.89 ,33.33
03,011,01,014,0256,0,1329 ,16 ,1345 ,1967 ,0,3,1,3,0,1,0,76.14,68.38 ,33.33
03,011,01,014,0257,0,929 ,7 ,936 ,1383 ,0,3,1,3,0,1,0,76.14,67.68 ,33.33
03,011,01,014,0258,0,1024 ,9 ,1033 ,1538 ,0,3,1,3,0,1,0,76.14,67.17 ,33.33
03,011,01,014,0259,0,909 ,10 ,919 ,1329 ,0,3,1,3,0,1,0,76.14,69.15 ,33.33
03,011,01,014,0260,0,850 ,8 ,858 ,1327 ,0,3,1,3,0,1,0,76.14,64.66 ,33.33
03,011,01,014,0261,0,603 ,8 ,611 ,817 ,0,3,1,3,0,1,0,76.14,74.79 ,33.33
03,011,01,014,0262,0,798 ,4 ,802 ,1196 ,0,3,1,3,0,1,0,76.14,67.06 ,33.33
03,011,01,014,0263,0,818 ,6 ,824 ,1176 ,0,3,1,3,0,1,0,76.14,70.07 ,33.33
03,011,01,014,0264,0,605 ,6 ,611 ,886 ,0,3,1,3,0,1,0,76.14,68.96 ,33.33
03,011,01,014,0265,0,297 ,3 ,300 ,389 ,0,3,1,3,0,1,0,76.14,77.12 ,33.33
03,011,01,014,0266,0,503 ,1 ,504 ,748 ,0,3,1,3,0,1,0,76.14,67.38 ,33.33
03,011,01,015,0267,0,354 ,0 ,354 ,547 ,0,3,1,3,0,1,0,76.14,64.72 ,33.33
03,011,01,015,0268,0,457 ,6 ,463 ,714 ,0,3,1,3,0,1,0,76.14,64.85 ,33.33
03,011,01,015,0269,0,349 ,3 ,352 ,498 ,0,3,1,3,0,1,0,76.14,70.68 ,33.33
03,011,01,015,0270,0,561 ,4 ,565 ,841 ,0,3,1,3,0,1,0,76.14,67.18 ,33.33
03,011,01,015,0271,0,686 ,4 ,690 ,940 ,0,3,1,3,0,1,0,76.14,73.40 ,33.33
03,011,01,015,0272,0,381 ,1 ,382 ,564 ,0,3,1,3,0,1,0,76.14,67.73 ,33.33
03,011,01,015,0273,0,314 ,3 ,317 ,435 ,0,3,1,3,0,1,0,76.14,72.87 ,33.33
03,011,01,015,0274,0,543 ,2 ,545 ,785 ,0,3,1,3,0,1,0,76.14,69.43 ,33.33
03,011,01,015,0275,0,1132 ,5 ,1137 ,1707 ,0,3,1,3,0,1,0,76.14,66.61 ,33.33
03,011,01,015,0276,0,249 ,0 ,249 ,356 ,0,3,1,3,0,1,0,76.14,69.94 ,33.33
03,011,01,015,0277,0,548 ,4 ,552 ,880 ,0,3,1,3,0,1,0,76.14,62.73 ,33.33
03,011,01,015,0278,0,527 ,3 ,530 ,842 ,0,3,1,3,0,1,0,76.14,62.95 ,33.33
03,011,01,015,0279,0,869 ,13 ,882 ,1428 ,0,3,1,3,0,1,0,76.14,61.76 ,33.33
03,011,01,015,0280,0,587 ,4 ,591 ,959 ,0,3,1,3,0,1,0,76.14,61.63 ,33.33
03,011,01,015,0281,0,418 ,2 ,420 ,615 ,0,3,1,3,0,1,0,76.14,68.29 ,33.33
03,011,01,015,0282,0,687 ,6 ,693 ,1045 ,0,3,1,3,0,1,0,76.14,66.32 ,33.33
03,011,01,015,0283,0,392 ,4 ,396 ,570 ,0,3,1,3,0,1,0,76.14,69.47 ,33.33
03,011,01,015,0284,0,517 ,8 ,525 ,724 ,0,3,1,3,0,1,0,76.14,72.51 ,33.33
03,011,01,015,0285,0,694 ,5 ,699 ,1067 ,0,3,1,3,0,1,0,76.14,65.51 ,33.33
03,011,01,015,0286,0,488 ,3 ,491 ,690 ,0,3,1,3,0,1,0,76.14,71.16 ,33.33
03,011,01,015,0287,0,610 ,2 ,612 ,912 ,0,3,1,3,0,1,0,76.14,67.11 ,33.33
03,011,01,015,0288,0,934 ,15 ,949 ,1609 ,0,3,1,3,0,1,0,76.14,58.98 ,33.33
03,011,01,015,0289,0,856 ,5 ,861 ,1319 ,0,3,1,3,0,1,0,76.14,65.28 ,33.33
03,011,01,016,0290,0,670 ,7 ,677 ,970 ,0,3,1,3,0,1,0,76.14,69.79 ,33.33
03,011,01,016,0291,0,850 ,5 ,855 ,1342 ,0,3,1,3,0,1,0,76.14,63.71 ,33.33
03,011,01,016,0292,0,691 ,8 ,699 ,1032 ,0,3,1,3,0,1,0,76.14,67.73 ,33.33
03,011,01,016,0293,0,1005 ,5 ,1010 ,1489 ,0,3,1,3,0,1,0,76.14,67.83 ,33.33
03,011,01,016,0294,0,626 ,7 ,633 ,912 ,0,3,1,3,0,1,0,76.14,69.41 ,33.33
03,011,01,016,0295,0,721 ,6 ,727 ,1031 ,0,3,1,3,0,1,0,76.14,70.51 ,33.33
03,011,01,016,0296,0,684 ,6 ,690 ,1078 ,0,3,1,3,0,1,0,76.14,64.01 ,33.33
03,011,01,016,0297,0,446 ,2 ,448 ,743 ,0,3,1,3,0,1,0,76.14,60.30 ,33.33
03,011,01,016,0298,0,461 ,1 ,462 ,634 ,0,3,1,3,0,1,0,76.14,72.87 ,33.33
03,011,01,016,0299,0,440 ,2 ,442 ,719 ,0,3,1,3,0,1,0,76.14,61.47 ,33.33
03,011,01,016,0300,0,427 ,2 ,429 ,619 ,0,3,1,3,0,1,0,76.14,69.31 ,33.33
03,011,01,016,0301,0,279 ,1 ,280 ,438 ,0,3,1,3,0,1,0,76.14,63.93 ,33.33
03,011,01,016,0302,0,587 ,1 ,588 ,909 ,0,3,1,3,0,1,0,76.14,64.69 ,33.33
03,011,01,016,0303,0,423 ,4 ,427 ,692 ,0,3,1,3,0,1,0,76.14,61.71 ,33.33
03,011,01,016,0304,0,910 ,2 ,912 ,1466 ,0,3,1,3,0,1,0,76.14,62.21 ,33.33
03,011,01,016,0305,0,787 ,5 ,792 ,1268 ,0,3,1,3,0,1,0,76.14,62.46 ,33.33
03,011,01,016,0306,0,1174 ,9 ,1183 ,2034 ,0,3,1,3,0,1,0,76.14,58.16 ,33.33
03,011,01,016,0307,0,609 ,1 ,610 ,1009 ,0,3,1,3,0,1,0,76.14,60.46 ,33.33
03,011,01,017,0308,0,632 ,11 ,643 ,891 ,0,3,1,3,0,1,0,76.14,72.17 ,33.33
03,011,01,017,0309,0,359 ,2 ,361 ,532 ,0,3,1,3,0,1,0,76.14,67.86 ,33.33
03,011,01,017,0310,0,246 ,4 ,250 ,379 ,0,3,1,3,0,1,0,76.14,65.96 ,33.33
03,011,01,017,0311,0,518 ,4 ,522 ,780 ,0,3,1,3,0,1,0,76.14,66.92 ,33.33
03,011,01,017,0312,0,872 ,10 ,882 ,1348 ,0,3,1,3,0,1,0,76.14,65.43 ,33.33
03,011,01,017,0313,0,520 ,5 ,525 ,774 ,0,3,1,3,0,1,0,76.14,67.83 ,33.33
03,011,01,017,0314,0,520 ,2 ,522 ,771 ,0,3,1,3,0,1,0,76.14,67.70 ,33.33
03,011,01,017,0315,0,421 ,1 ,422 ,600 ,0,3,1,3,0,1,0,76.14,70.33 ,33.33
03,011,01,017,0316,0,663 ,0 ,663 ,1055 ,0,3,1,3,0,1,0,76.14,62.84 ,33.33
03,011,01,017,0317,0,441 ,2 ,443 ,675 ,0,3,1,3,0,1,0,76.14,65.63 ,33.33
03,011,01,017,0318,0,781 ,8 ,789 ,1170 ,0,3,1,3,0,1,0,76.14,67.44 ,33.33
03,011,01,017,0319,0,440 ,1 ,441 ,696 ,0,3,1,3,0,1,0,76.14,63.36 ,33.33
03,011,01,017,0320,0,459 ,4 ,463 ,689 ,0,3,1,3,0,1,0,76.14,67.20 ,33.33
03,011,01,018,0321,0,1005 ,9 ,1014 ,1635 ,0,3,1,3,0,1,0,76.14,62.02 ,33.33
03,011,01,018,0322,0,2263 ,10 ,2273 ,3801 ,0,3,1,3,0,1,0,76.14,59.80 ,33.33
03,011,01,018,0323,0,900 ,2 ,902 ,1663 ,0,3,1,3,0,1,0,76.14,54.24 ,33.33
03,011,01,018,0324,0,2294 ,21 ,2315 ,3814 ,0,3,1,3,0,1,0,76.14,60.70 ,33.33
03,011,01,018,0325,0,285 ,1 ,286 ,437 ,0,3,1,3,0,1,0,76.14,65.45 ,33.33
03,011,01,018,0326,0,365 ,0 ,365 ,614 ,0,3,1,3,0,1,0,76.14,59.45 ,33.33
03,011,01,018,0327,0,287 ,4 ,291 ,441 ,0,3,1,3,0,1,0,76.14,65.99 ,33.33
03,011,01,018,0328,0,622 ,4 ,626 ,983 ,0,3,1,3,0,1,0,76.14,63.68 ,33.33
03,011,01,018,0329,0,1831 ,19 ,1850 ,3021 ,0,3,1,3,0,1,0,76.14,61.24 ,33.33
03,011,01,018,0330,0,1104 ,6 ,1110 ,1711 ,0,3,1,3,0,1,0,76.14,64.87 ,33.33
03,011,01,018,0331,0,736 ,8 ,744 ,1175 ,0,3,1,3,0,1,0,76.14,63.32 ,33.33
03,011,01,018,0332,0,1578 ,10 ,1588 ,2495 ,0,3,1,3,0,1,0,76.14,63.65 ,33.33
03,011,01,018,0333,0,1303 ,6 ,1309 ,2068 ,0,3,1,3,0,1,0,76.14,63.30 ,33.33
03,011,01,018,0334,0,1177 ,11 ,1188 ,1747 ,0,3,1,3,0,1,0,76.14,68.00 ,33.33
03,011,01,018,0335,0,1372 ,15 ,1387 ,2136 ,0,3,1,3,0,1,0,76.14,64.93 ,33.33
03,011,01,018,0336,0,858 ,8 ,866 ,1318 ,0,3,1,3,0,1,0,76.14,65.71 ,33.33
03,011,01,018,0337,0,315 ,4 ,319 ,477 ,0,3,1,3,0,1,0,76.14,66.88 ,33.33
03,011,01,018,0338,0,1269 ,10 ,1279 ,2090 ,0,3,1,3,0,1,0,76.14,61.20 ,33.33
03,011,01,018,0339,0,509 ,5 ,514 ,847 ,0,3,1,3,0,1,0,76.14,60.68 ,33.33
03,011,01,018,0340,0,664 ,3 ,667 ,1032 ,0,3,1,3,0,1,0,76.14,64.63 ,33.33
03,011,01,019,0341,0,599 ,3 ,602 ,921 ,0,3,1,3,0,1,0,76.14,65.36 ,33.33
03,011,01,019,0342,0,1702 ,16 ,1718 ,2757 ,0,3,1,3,0,1,0,76.14,62.31 ,33.33
03,011,01,019,0343,0,2522 ,25 ,2547 ,4239 ,0,3,1,3,0,1,0,76.14,60.08 ,33.33
03,011,01,019,0344,0,1321 ,11 ,1332 ,2152 ,0,3,1,3,0,1,0,76.14,61.90 ,33.33
03,011,01,019,0345,0,785 ,7 ,792 ,1282 ,0,3,1,3,0,1,0,76.14,61.78 ,33.33
03,011,01,019,0346,0,419 ,2 ,421 ,676 ,0,3,1,3,0,1,0,76.14,62.28 ,33.33
03,011,01,019,0347,0,283 ,1 ,284 ,445 ,0,3,1,3,0,1,0,76.14,63.82 ,33.33
03,011,01,019,0348,0,724 ,11 ,735 ,1171 ,0,3,1,3,0,1,0,76.14,62.77 ,33.33
03,011,01,019,0349,0,873 ,3 ,876 ,1248 ,0,3,1,3,0,1,0,76.14,70.19 ,33.33
03,011,01,019,0350,0,1204 ,18 ,1222 ,1883 ,0,3,1,3,0,1,0,76.14,64.90 ,33.33
03,011,01,019,0351,0,602 ,7 ,609 ,916 ,0,3,1,3,0,1,0,76.14,66.48 ,33.33
03,011,01,019,0352,0,986 ,10 ,996 ,1580 ,0,3,1,3,0,1,0,76.14,63.04 ,33.33
03,011,01,019,0353,0,422 ,5 ,427 ,664 ,0,3,1,3,0,1,0,76.14,64.31 ,33.33
03,011,01,019,0354,0,650 ,9 ,659 ,1054 ,0,3,1,3,0,1,0,76.14,62.52 ,33.33
03,011,01,019,0355,0,1095 ,18 ,1113 ,1760 ,0,3,1,3,0,1,0,76.14,63.24 ,33.33
03,011,01,019,0356,0,573 ,4 ,577 ,861 ,0,3,1,3,0,1,0,76.14,67.02 ,33.33
03,011,01,019,0357,0,615 ,9 ,624 ,999 ,0,3,1,3,0,1,0,76.14,62.46 ,33.33
03,011,01,019,0358,0,883 ,8 ,891 ,1389 ,0,3,1,3,0,1,0,76.14,64.15 ,33.33
03,011,01,019,0359,0,898 ,9 ,907 ,1392 ,0,3,1,3,0,1,0,76.14,65.16 ,33.33
03,011,01,019,0360,0,611 ,5 ,616 ,1027 ,0,3,1,3,0,1,0,76.14,59.98 ,33.33
03,011,01,019,0361,0,1650 ,10 ,1660 ,2802 ,0,3,1,3,0,1,0,76.14,59.24 ,33.33
03,011,01,020,0362,0,1413 ,16 ,1429 ,2463 ,0,3,1,3,0,1,0,76.14,58.02 ,33.33
03,011,01,020,0363,0,3201 ,20 ,3221 ,5352 ,0,3,1,3,0,1,0,76.14,60.18 ,33.33
03,011,01,020,0364,0,1243 ,6 ,1249 ,2011 ,0,3,1,3,0,1,0,76.14,62.11 ,33.33
03,011,01,020,0365,0,467 ,1 ,468 ,653 ,0,3,1,3,0,1,0,76.14,71.67 ,33.33
03,011,01,020,0366,0,542 ,3 ,545 ,920 ,0,3,1,3,0,1,0,76.14,59.24 ,33.33
03,011,01,020,0367,0,799 ,5 ,804 ,1221 ,0,3,1,3,0,1,0,76.14,65.85 ,33.33
03,011,01,020,0368,0,1591 ,8 ,1599 ,2428 ,0,3,1,3,0,1,0,76.14,65.86 ,33.33
03,011,01,020,0369,0,2093 ,17 ,2110 ,3435 ,0,3,1,3,0,1,0,76.14,61.43 ,33.33
03,011,01,020,0370,0,969 ,5 ,974 ,1535 ,0,3,1,3,0,1,0,76.14,63.45 ,33.33
03,011,01,020,0371,0,1854 ,11 ,1865 ,2945 ,0,3,1,3,0,1,0,76.14,63.33 ,33.33
03,011,01,020,0372,0,1355 ,10 ,1365 ,2254 ,0,3,1,3,0,1,0,76.14,60.56 ,33.33
03,011,01,021,0373,0,1336 ,15 ,1351 ,2052 ,0,3,1,3,0,1,0,76.14,65.84 ,33.33
03,011,01,021,0374,0,1118 ,18 ,1136 ,1798 ,0,3,1,3,0,1,0,76.14,63.18 ,33.33
03,011,01,021,0375,0,888 ,5 ,893 ,1375 ,0,3,1,3,0,1,0,76.14,64.95 ,33.33
03,011,01,021,0376,0,773 ,11 ,784 ,1138 ,0,3,1,3,0,1,0,76.14,68.89 ,33.33
03,011,01,021,0377,0,532 ,3 ,535 ,764 ,0,3,1,3,0,1,0,76.14,70.03 ,33.33
03,011,01,021,0378,0,1188 ,10 ,1198 ,1522 ,0,3,1,3,0,1,0,76.14,78.71 ,33.33
03,011,01,021,0379,0,609 ,16 ,625 ,1025 ,0,3,1,3,0,1,0,76.14,60.98 ,33.33
03,011,01,021,0380,0,1451 ,6 ,1457 ,2206 ,0,3,1,3,0,1,0,76.14,66.05 ,33.33
03,011,01,021,0381,0,1399 ,11 ,1410 ,2209 ,0,3,1,3,0,1,0,76.14,63.83 ,33.33
03,011,01,021,0382,0,427 ,3 ,430 ,636 ,0,3,1,3,0,1,0,76.14,67.61 ,33.33
03,011,01,021,0383,0,871 ,8 ,879 ,1390 ,0,3,1,3,0,1,0,76.14,63.24 ,33.33
03,011,01,021,0384,0,475 ,2 ,477 ,695 ,0,3,1,3,0,1,0,76.14,68.63 ,33.33
03,011,01,021,0385,0,1114 ,12 ,1126 ,1860 ,0,3,1,3,0,1,0,76.14,60.54 ,33.33
03,011,01,021,0386,0,1408 ,18 ,1426 ,2251 ,0,3,1,3,0,1,0,76.14,63.35 ,33.33
03,011,01,021,0387,0,646 ,2 ,648 ,909 ,0,3,1,3,0,1,0,76.14,71.29 ,33.33
03,011,01,021,0388,0,368 ,6 ,374 ,504 ,0,3,1,3,0,1,0,76.14,74.21 ,33.33
03,011,01,022,0389,0,1137 ,10 ,1147 ,1803 ,0,3,1,3,0,1,0,76.14,63.62 ,33.33
03,011,01,022,0390,0,1055 ,5 ,1060 ,1558 ,0,3,1,3,0,1,0,76.14,68.04 ,33.33
03,011,01,022,0391,0,559 ,9 ,568 ,873 ,0,3,1,3,0,1,0,76.14,65.06 ,33.33
03,011,01,022,0392,0,508 ,2 ,510 ,775 ,0,3,1,3,0,1,0,76.14,65.81 ,33.33
03,011,01,022,0393,0,378 ,0 ,378 ,559 ,0,3,1,3,0,1,0,76.14,67.62 ,33.33
03,011,01,022,0394,0,255 ,2 ,257 ,358 ,0,3,1,3,0,1,0,76.14,71.79 ,33.33
03,011,01,022,0395,0,218 ,2 ,220 ,371 ,0,3,1,3,0,1,0,76.14,59.30 ,33.33
03,011,01,023,0396,0,599 ,4 ,603 ,903 ,0,3,1,3,0,1,0,76.14,66.78 ,33.33
03,011,01,023,0397,0,2470 ,20 ,2490 ,4109 ,0,3,1,3,0,1,0,76.14,60.60 ,33.33
03,011,01,023,0398,0,854 ,7 ,861 ,1284 ,0,3,1,3,0,1,0,76.14,67.06 ,33.33
03,011,01,023,0399,0,886 ,5 ,891 ,1421 ,0,3,1,3,0,1,0,76.14,62.70 ,33.33
03,011,01,023,0400,0,326 ,3 ,329 ,502 ,0,3,1,3,0,1,0,76.14,65.54 ,33.33
03,011,01,023,0401,0,312 ,1 ,313 ,512 ,0,3,1,3,0,1,0,76.14,61.13 ,33.33
03,011,01,023,0402,0,526 ,4 ,530 ,770 ,0,3,1,3,0,1,0,76.14,68.83 ,33.33
03,011,01,023,0403,0,1061 ,12 ,1073 ,1560 ,0,3,1,3,0,1,0,76.14,68.78 ,33.33
03,011,01,023,0404,0,443 ,2 ,445 ,688 ,0,3,1,3,0,1,0,76.14,64.68 ,33.33
03,011,01,023,0405,0,615 ,6 ,621 ,1001 ,0,3,1,3,0,1,0,76.14,62.04 ,33.33
03,011,01,024,0406,0,1165 ,12 ,1177 ,1886 ,0,3,1,3,0,1,0,76.14,62.41 ,33.33
03,011,01,024,0407,0,723 ,6 ,729 ,1265 ,0,3,1,3,0,1,0,76.14,57.63 ,33.33
03,011,01,024,0408,0,482 ,2 ,484 ,808 ,0,3,1,3,0,1,0,76.14,59.90 ,33.33
03,011,01,024,0409,0,646 ,10 ,656 ,1046 ,0,3,1,3,0,1,0,76.14,62.72 ,33.33
03,011,01,024,0410,0,644 ,2 ,646 ,1000 ,0,3,1,3,0,1,0,76.14,64.60 ,33.33
03,011,01,024,0411,0,464 ,3 ,467 ,712 ,0,3,1,3,0,1,0,76.14,65.59 ,33.33
03,011,01,024,0412,0,1411 ,16 ,1427 ,2250 ,0,3,1,3,0,1,0,76.14,63.42 ,33.33
03,011,01,025,0413,0,942 ,5 ,947 ,1363 ,0,3,1,3,0,1,0,76.14,69.48 ,33.33
03,011,01,025,0414,0,562 ,4 ,566 ,796 ,0,3,1,3,0,1,0,76.14,71.11 ,33.33
03,011,01,025,0415,0,450 ,0 ,450 ,656 ,0,3,1,3,0,1,0,76.14,68.60 ,33.33
03,011,01,025,0416,0,334 ,2 ,336 ,481 ,0,3,1,3,0,1,0,76.14,69.85 ,33.33
03,011,01,025,0417,0,424 ,0 ,424 ,600 ,0,3,1,3,0,1,0,76.14,70.67 ,33.33
03,011,01,025,0418,0,514 ,4 ,518 ,792 ,0,3,1,3,0,1,0,76.14,65.40 ,33.33
03,011,01,025,0419,0,753 ,4 ,757 ,1173 ,0,3,1,3,0,1,0,76.14,64.54 ,33.33
03,011,01,025,0420,0,602 ,2 ,604 ,880 ,0,3,1,3,0,1,0,76.14,68.64 ,33.33
03,011,01,025,0421,0,271 ,3 ,274 ,554 ,0,3,1,3,0,1,0,76.14,49.46 ,33.33
03,011,01,026,0422,0,262 ,5 ,267 ,426 ,0,3,1,3,0,1,0,76.14,62.68 ,33.33
03,011,01,026,0423,0,448 ,3 ,451 ,677 ,0,3,1,3,0,1,0,76.14,66.62 ,33.33
03,011,01,026,0424,0,351 ,3 ,354 ,514 ,0,3,1,3,0,1,0,76.14,68.87 ,33.33
03,011,01,026,0425,0,577 ,2 ,579 ,858 ,0,3,1,3,0,1,0,76.14,67.48 ,33.33
03,011,01,026,0426,0,253 ,6 ,259 ,381 ,0,3,1,3,0,1,0,76.14,67.98 ,33.33
03,011,01,026,0427,0,307 ,3 ,310 ,454 ,0,3,1,3,0,1,0,76.14,68.28 ,33.33
03,011,01,026,0428,0,289 ,1 ,290 ,440 ,0,3,1,3,0,1,0,76.14,65.91 ,33.33
03,011,01,026,0429,0,204 ,1 ,205 ,314 ,0,3,1,3,0,1,0,76.14,65.29 ,33.33
03,011,01,026,0430,0,132 ,0 ,132 ,225 ,0,3,1,3,0,1,0,76.14,58.67 ,33.33
03,011,01,026,0431,0,332 ,2 ,334 ,547 ,0,3,1,3,0,1,0,76.14,61.06 ,33.33
03,011,01,027,0432,0,2524 ,17 ,2541 ,4094 ,0,3,1,3,0,1,0,76.14,62.07 ,33.33
03,011,01,027,0433,0,1462 ,10 ,1472 ,2253 ,0,3,1,3,0,1,0,76.14,65.34 ,33.33
03,011,01,027,0434,0,1188 ,4 ,1192 ,1950 ,0,3,1,3,0,1,0,76.14,61.13 ,33.33
03,011,01,027,0435,0,2404 ,16 ,2420 ,4585 ,0,3,1,3,0,1,0,76.14,52.78 ,33.33
03,011,01,027,0436,0,4177 ,25 ,4202 ,7034 ,0,3,1,3,0,1,0,76.14,59.74 ,33.33
03,011,01,027,0437,0,1536 ,12 ,1548 ,2636 ,0,3,1,3,0,1,0,76.14,58.73 ,33.33
03,011,01,027,0438,0,3852 ,33 ,3885 ,6628 ,0,3,1,3,0,1,0,76.14,58.61 ,33.33
03,011,01,027,0439,0,2467 ,17 ,2484 ,4151 ,0,3,1,3,0,1,0,76.14,59.84 ,33.33
03,011,01,027,0440,0,914 ,5 ,919 ,1323 ,0,3,1,3,0,1,0,76.14,69.46 ,33.33
03,011,01,027,0441,0,483 ,3 ,486 ,699 ,0,3,1,3,0,1,0,76.14,69.53 ,33.33
03,011,01,027,0442,0,1369 ,10 ,1379 ,2226 ,0,3,1,3,0,1,0,76.14,61.95 ,33.33
03,011,01,027,0443,0,2196 ,16 ,2212 ,3657 ,0,3,1,3,0,1,0,76.14,60.49 ,33.33
03,011,01,027,0444,0,724 ,13 ,737 ,1080 ,0,3,1,3,0,1,0,76.14,68.24 ,33.33
03,011,01,027,0445,0,1224 ,10 ,1234 ,1998 ,0,3,1,3,0,1,0,76.14,61.76 ,33.33
03,011,01,027,0446,0,1233 ,17 ,1250 ,2037 ,0,3,1,3,0,1,0,76.14,61.36 ,33.33
03,011,01,027,0447,0,1291 ,15 ,1306 ,1978 ,0,3,1,3,0,1,0,76.14,66.03 ,33.33
03,011,01,027,0448,0,867 ,4 ,871 ,1270 ,0,3,1,3,0,1,0,76.14,68.58 ,33.33
03,011,01,027,0449,0,939 ,5 ,944 ,1384 ,0,3,1,3,0,1,0,76.14,68.21 ,33.33
03,011,01,028,0450,0,2878 ,24 ,2902 ,4870 ,0,3,1,3,0,1,0,76.14,59.59 ,33.33
03,011,01,028,0451,0,1759 ,12 ,1771 ,2922 ,0,3,1,3,0,1,0,76.14,60.61 ,33.33
03,011,01,028,0452,0,1894 ,8 ,1902 ,3094 ,0,3,1,3,0,1,0,76.14,61.47 ,33.33
03,011,01,028,0453,0,1246 ,15 ,1261 ,2061 ,0,3,1,3,0,1,0,76.14,61.18 ,33.33
03,011,01,028,0454,0,1908 ,10 ,1918 ,2995 ,0,3,1,3,0,1,0,76.14,64.04 ,33.33
03,011,01,028,0455,0,1404 ,10 ,1414 ,2355 ,0,3,1,3,0,1,0,76.14,60.04 ,33.33
03,011,01,028,0456,0,1688 ,10 ,1698 ,2756 ,0,3,1,3,0,1,0,76.14,61.61 ,33.33
03,011,01,028,0457,0,1333 ,5 ,1338 ,2102 ,0,3,1,3,0,1,0,76.14,63.65 ,33.33
03,011,01,028,0458,0,1669 ,5 ,1674 ,2804 ,0,3,1,3,0,1,0,76.14,59.70 ,33.33
03,011,01,028,0459,0,920 ,8 ,928 ,1383 ,0,3,1,3,0,1,0,76.14,67.10 ,33.33
03,011,01,028,0460,0,838 ,3 ,841 ,1325 ,0,3,1,3,0,1,0,76.14,63.47 ,33.33
03,011,01,028,0461,0,1305 ,10 ,1315 ,2022 ,0,3,1,3,0,1,0,76.14,65.03 ,33.33
03,011,01,028,0462,0,383 ,4 ,387 ,607 ,0,3,1,3,0,1,0,76.14,63.76 ,33.33
03,011,01,028,0463,0,1094 ,4 ,1098 ,1672 ,0,3,1,3,0,1,0,76.14,65.67 ,33.33
03,011,01,028,0464,0,739 ,7 ,746 ,1196 ,0,3,1,3,0,1,0,76.14,62.37 ,33.33
03,011,01,028,0465,0,1202 ,5 ,1207 ,1966 ,0,3,1,3,0,1,0,76.14,61.39 ,33.33
03,011,01,028,0466,0,1318 ,6 ,1324 ,2117 ,0,3,1,3,0,1,0,76.14,62.54 ,33.33
03,011,01,028,0467,0,1392 ,9 ,1401 ,2190 ,0,3,1,3,0,1,0,76.14,63.97 ,33.33
03,011,01,028,0468,0,1182 ,8 ,1190 ,1930 ,0,3,1,3,0,1,0,76.14,61.66 ,33.33
03,011,01,028,0469,0,855 ,9 ,864 ,1354 ,0,3,1,3,0,1,0,76.14,63.81 ,33.33
03,011,01,028,0470,0,1346 ,13 ,1359 ,2232 ,0,3,1,3,0,1,0,76.14,60.89 ,33.33
03,011,01,029,0471,0,1277 ,5 ,1282 ,1947 ,0,3,1,3,0,1,0,76.14,65.84 ,33.33
03,011,01,029,0472,0,1242 ,9 ,1251 ,1892 ,0,3,1,3,0,1,0,76.14,66.12 ,33.33
03,011,01,029,0473,0,2179 ,26 ,2205 ,3390 ,0,3,1,3,0,1,0,76.14,65.04 ,33.33
03,011,01,029,0474,0,1677 ,11 ,1688 ,2470 ,0,3,1,3,0,1,0,76.14,68.34 ,33.33
03,011,01,029,0475,0,608 ,2 ,610 ,882 ,0,3,1,3,0,1,0,76.14,69.16 ,33.33
03,011,01,029,0476,0,495 ,5 ,500 ,758 ,0,3,1,3,0,1,0,76.14,65.96 ,33.33
03,011,01,029,0477,0,1739 ,16 ,1755 ,2741 ,0,3,1,3,0,1,0,76.14,64.03 ,33.33
03,011,01,029,0478,0,1930 ,13 ,1943 ,3021 ,0,3,1,3,0,1,0,76.14,64.32 ,33.33
03,011,01,029,0479,0,1232 ,10 ,1242 ,1916 ,0,3,1,3,0,1,0,76.14,64.82 ,33.33
03,011,01,029,0480,0,953 ,9 ,962 ,1448 ,0,3,1,3,0,1,0,76.14,66.44 ,33.33
03,011,01,029,0481,0,1331 ,13 ,1344 ,2119 ,0,3,1,3,0,1,0,76.14,63.43 ,33.33
03,011,01,029,0482,0,1043 ,10 ,1053 ,1536 ,0,3,1,3,0,1,0,76.14,68.55 ,33.33
03,011,01,029,0483,0,850 ,10 ,860 ,1219 ,0,3,1,3,0,1,0,76.14,70.55 ,33.33
03,011,01,029,0484,0,524 ,5 ,529 ,767 ,0,3,1,3,0,1,0,76.14,68.97 ,33.33
03,011,01,029,0485,0,573 ,4 ,577 ,775 ,0,3,1,3,0,1,0,76.14,74.45 ,33.33
03,011,01,029,0486,0,1007 ,9 ,1016 ,1555 ,0,3,1,3,0,1,0,76.14,65.34 ,33.33
03,011,01,029,0487,0,288 ,6 ,294 ,404 ,0,3,1,3,0,1,0,76.14,72.77 ,33.33
03,011,01,030,0488,0,829 ,6 ,835 ,1185 ,0,3,1,3,0,1,0,76.14,70.46 ,33.33
03,011,01,030,0489,0,452 ,3 ,455 ,690 ,0,3,1,3,0,1,0,76.14,65.94 ,33.33
03,011,01,030,0490,0,103 ,1 ,104 ,201 ,0,3,1,3,0,1,0,76.14,51.74 ,33.33
03,011,01,030,0491,0,217 ,3 ,220 ,311 ,0,3,1,3,0,1,0,76.14,70.74 ,33.33
03,011,01,030,0492,0,187 ,1 ,188 ,271 ,0,3,1,3,0,1,0,76.14,69.37 ,33.33
03,011,01,030,0493,0,203 ,1 ,204 ,297 ,0,3,1,3,0,1,0,76.14,68.69 ,33.33
03,011,01,030,0494,0,308 ,2 ,310 ,423 ,0,3,1,3,0,1,0,76.14,73.29 ,33.33
03,011,01,030,0495,0,256 ,1 ,257 ,383 ,0,3,1,3,0,1,0,76.14,67.10 ,33.33
03,011,01,031,0496,0,2157 ,9 ,2166 ,4310 ,0,3,1,3,0,1,0,76.14,50.26 ,33.33
03,011,01,031,0497,0,1620 ,11 ,1631 ,2963 ,0,3,1,3,0,1,0,76.14,55.05 ,33.33
03,011,01,031,0498,0,1826 ,11 ,1837 ,3624 ,0,3,1,3,0,1,0,76.14,50.69 ,33.33
03,011,01,031,0499,0,2368 ,17 ,2385 ,4393 ,0,3,1,3,0,1,0,76.14,54.29 ,33.33
03,011,01,031,0500,0,3360 ,23 ,3383 ,6003 ,0,3,1,3,0,1,0,76.14,56.36 ,33.33
03,011,01,031,0501,0,3081 ,15 ,3096 ,6306 ,0,3,1,3,0,1,0,76.14,49.10 ,33.33
03,011,01,031,0502,0,3133 ,18 ,3151 ,5813 ,0,3,1,3,0,1,0,76.14,54.21 ,33.33
03,011,01,031,0503,0,3189 ,24 ,3213 ,5790 ,0,3,1,3,0,1,0,76.14,55.49 ,33.33
03,011,01,031,0504,0,2314 ,15 ,2329 ,4493 ,0,3,1,3,0,1,0,76.14,51.84 ,33.33
03,011,01,031,0505,0,1285 ,7 ,1292 ,2214 ,0,3,1,3,0,1,0,76.14,58.36 ,33.33
03,011,01,031,0506,0,1354 ,9 ,1363 ,2599 ,0,3,1,3,0,1,0,76.14,52.44 ,33.33
03,011,01,031,0507,0,1894 ,13 ,1907 ,3875 ,0,3,1,3,0,1,0,76.14,49.21 ,33.33
03,011,01,031,0508,0,920 ,5 ,925 ,1523 ,0,3,1,3,0,1,0,76.14,60.74 ,33.33
03,011,01,031,0509,0,703 ,7 ,710 ,1090 ,0,3,1,3,0,1,0,76.14,65.14 ,33.33
03,011,01,031,0510,0,3454 ,18 ,3472 ,6419 ,0,3,1,3,0,1,0,76.14,54.09 ,33.33
03,011,01,031,0511,0,2621 ,21 ,2642 ,4433 ,0,3,1,3,0,1,0,76.14,59.60 ,33.33
03,011,01,031,0512,0,1355 ,12 ,1367 ,2256 ,0,3,1,3,0,1,0,76.14,60.59 ,33.33
03,011,01,031,0513,0,1993 ,17 ,2010 ,3526 ,0,3,1,3,0,1,0,76.14,57.01 ,33.33
03,011,01,031,0514,0,3529 ,25 ,3554 ,6580 ,0,3,1,3,0,1,0,76.14,54.01 ,33.33
03,011,01,031,0515,0,1157 ,5 ,1162 ,1879 ,0,3,1,3,0,1,0,76.14,61.84 ,33.33
03,011,01,031,0516,0,1021 ,9 ,1030 ,1733 ,0,3,1,3,0,1,0,76.14,59.43 ,33.33
03,011,01,031,0517,0,2415 ,12 ,2427 ,4282 ,0,3,1,3,0,1,0,76.14,56.68 ,33.33
03,011,01,031,0518,0,796 ,8 ,804 ,1301 ,0,3,1,3,0,1,0,76.14,61.80 ,33.33
03,011,01,031,0519,0,1858 ,14 ,1872 ,3009 ,0,3,1,3,0,1,0,76.14,62.21 ,33.33
03,011,01,031,0520,0,1889 ,15 ,1904 ,3255 ,0,3,1,3,0,1,0,76.14,58.49 ,33.33
03,011,01,031,0521,0,3158 ,10 ,3168 ,5507 ,0,3,1,3,0,1,0,76.14,57.53 ,33.33
03,011,01,031,0522,0,2136 ,20 ,2156 ,3525 ,0,3,1,3,0,1,0,76.14,61.16 ,33.33
03,011,01,031,0523,0,3035 ,23 ,3058 ,5355 ,0,3,1,3,0,1,0,76.14,57.11 ,33.33
03,011,01,031,0524,0,3449 ,22 ,3471 ,5939 ,0,3,1,3,0,1,0,76.14,58.44 ,33.33
03,011,01,031,0525,0,1076 ,6 ,1082 ,1750 ,0,3,1,3,0,1,0,76.14,61.83 ,33.33
03,011,01,031,0526,0,607 ,5 ,612 ,960 ,0,3,1,3,0,1,0,76.14,63.75 ,33.33
03,011,01,031,0527,0,934 ,8 ,942 ,1546 ,0,3,1,3,0,1,0,76.14,60.93 ,33.33
03,011,01,031,0528,0,1310 ,7 ,1317 ,2163 ,0,3,1,3,0,1,0,76.14,60.89 ,33.33
03,011,01,031,0529,0,5359 ,38 ,5397 ,10442 ,0,3,1,3,0,1,0,76.14,51.69 ,33.33
03,011,01,031,0530,0,1012 ,7 ,1019 ,1675 ,0,3,1,3,0,1,0,76.14,60.84 ,33.33
03,011,01,031,0531,0,853 ,6 ,859 ,1550 ,0,3,1,3,0,1,0,76.14,55.42 ,33.33
03,011,01,031,0532,0,1237 ,9 ,1246 ,2165 ,0,3,1,3,0,1,0,76.14,57.55 ,33.33
03,011,01,031,0533,0,1699 ,15 ,1714 ,2843 ,0,3,1,3,0,1,0,76.14,60.29 ,33.33
03,011,01,031,0534,0,2815 ,20 ,2835 ,5382 ,0,3,1,3,0,1,0,76.14,52.68 ,33.33
03,012,01,001,0001,0,778 ,4 ,782 ,1278 ,0,3,1,3,0,1,0,76.14,61.19 ,33.33
03,012,01,001,0002,0,493 ,1 ,494 ,865 ,0,3,1,3,0,1,0,76.14,57.11 ,33.33
03,012,01,001,0003,0,1395 ,10 ,1405 ,2298 ,0,3,1,3,0,1,0,76.14,61.14 ,33.33
03,012,01,001,0004,0,2959 ,36 ,2995 ,4994 ,0,3,1,3,0,1,0,76.14,59.97 ,33.33
03,012,01,001,0005,0,2334 ,20 ,2354 ,3996 ,0,3,1,3,0,1,0,76.14,58.91 ,33.33
03,012,01,001,0006,0,2494 ,17 ,2511 ,4435 ,0,3,1,3,0,1,0,76.14,56.62 ,33.33
03,012,01,001,0007,0,1387 ,6 ,1393 ,2441 ,0,3,1,3,0,1,0,76.14,57.07 ,33.33
03,012,01,001,0008,0,1609 ,18 ,1627 ,2825 ,0,3,1,3,0,1,0,76.14,57.59 ,33.33
03,012,01,001,0009,0,1672 ,13 ,1685 ,2980 ,0,3,1,3,0,1,0,76.14,56.54 ,33.33
03,012,01,001,0010,0,3717 ,22 ,3739 ,5951 ,0,3,1,3,0,1,0,76.14,62.83 ,33.33
03,012,01,001,0011,0,3064 ,18 ,3082 ,5293 ,0,3,1,3,0,1,0,76.14,58.23 ,33.33
03,012,01,001,0012,0,3028 ,17 ,3045 ,5765 ,0,3,1,3,0,1,0,76.14,52.82 ,33.33
03,012,01,001,0013,0,1369 ,11 ,1380 ,2411 ,0,3,1,3,0,1,0,76.14,57.24 ,33.33
03,012,01,001,0014,0,3104 ,19 ,3123 ,5909 ,0,3,1,3,0,1,0,76.14,52.85 ,33.33
03,012,01,001,0015,0,499 ,4 ,503 ,789 ,0,3,1,3,0,1,0,76.14,63.75 ,33.33
03,012,01,001,0016,0,293 ,4 ,297 ,484 ,0,3,1,3,0,1,0,76.14,61.36 ,33.33
03,012,01,001,0017,0,810 ,4 ,814 ,1311 ,0,3,1,3,0,1,0,76.14,62.09 ,33.33
03,012,01,001,0018,0,968 ,7 ,975 ,1643 ,0,3,1,3,0,1,0,76.14,59.34 ,33.33
03,012,01,001,0019,0,2897 ,16 ,2913 ,4874 ,0,3,1,3,0,1,0,76.14,59.77 ,33.33
03,012,01,001,0020,0,638 ,5 ,643 ,1054 ,0,3,1,3,0,1,0,76.14,61.01 ,33.33
03,012,01,001,0021,0,694 ,8 ,702 ,1086 ,0,3,1,3,0,1,0,76.14,64.64 ,33.33
03,012,01,001,0022,0,762 ,6 ,768 ,1442 ,0,3,1,3,0,1,0,76.14,53.26 ,33.33
03,012,01,001,0023,0,2286 ,14 ,2300 ,3780 ,0,3,1,3,0,1,0,76.14,60.85 ,33.33
03,012,01,001,0024,0,465 ,4 ,469 ,814 ,0,3,1,3,0,1,0,76.14,57.62 ,33.33
03,012,01,001,0025,0,2049 ,12 ,2061 ,3497 ,0,3,1,3,0,1,0,76.14,58.94 ,33.33
03,012,01,001,0026,0,2353 ,15 ,2368 ,4113 ,0,3,1,3,0,1,0,76.14,57.57 ,33.33
03,012,01,001,0027,0,3129 ,19 ,3148 ,5357 ,0,3,1,3,0,1,0,76.14,58.76 ,33.33
03,012,01,001,0028,0,1922 ,23 ,1945 ,3260 ,0,3,1,3,0,1,0,76.14,59.66 ,33.33
03,012,01,001,0029,0,599 ,8 ,607 ,912 ,0,3,1,3,0,1,0,76.14,66.56 ,33.33
03,012,01,001,0030,0,922 ,8 ,930 ,1586 ,0,3,1,3,0,1,0,76.14,58.64 ,33.33
03,012,01,001,0031,0,989 ,10 ,999 ,1582 ,0,3,1,3,0,1,0,76.14,63.15 ,33.33
03,012,01,001,0032,0,1175 ,8 ,1183 ,2084 ,0,3,1,3,0,1,0,76.14,56.77 ,33.33
03,012,01,001,0033,0,3005 ,18 ,3023 ,4823 ,0,3,1,3,0,1,0,76.14,62.68 ,33.33
03,012,01,001,0034,0,2260 ,14 ,2274 ,3887 ,0,3,1,3,0,1,0,76.14,58.50 ,33.33
03,012,01,001,0035,0,3007 ,17 ,3024 ,4802 ,0,3,1,3,0,1,0,76.14,62.97 ,33.33
03,012,01,001,0036,0,1249 ,10 ,1259 ,2027 ,0,3,1,3,0,1,0,76.14,62.11 ,33.33
03,012,01,001,0037,0,916 ,10 ,926 ,1662 ,0,3,1,3,0,1,0,76.14,55.72 ,33.33
03,012,01,001,0038,0,1240 ,12 ,1252 ,2254 ,0,3,1,3,0,1,0,76.14,55.55 ,33.33
03,012,01,001,0039,0,2362 ,16 ,2378 ,4078 ,0,3,1,3,0,1,0,76.14,58.31 ,33.33
03,012,01,001,0040,0,2767 ,16 ,2783 ,4639 ,0,3,1,3,0,1,0,76.14,59.99 ,33.33
03,012,01,001,0041,0,71 ,1 ,72 ,155 ,0,3,1,3,0,1,0,76.14,46.45 ,33.33
03,012,01,001,0042,0,680 ,1 ,681 ,1148 ,0,3,1,3,0,1,0,76.14,59.32 ,33.33
03,012,01,001,0043,0,2265 ,30 ,2295 ,3748 ,0,3,1,3,0,1,0,76.14,61.23 ,33.33
03,012,01,001,0044,0,1533 ,11 ,1544 ,2244 ,0,3,1,3,0,1,0,76.14,68.81 ,33.33
03,012,01,001,0045,0,2182 ,13 ,2195 ,3923 ,0,3,1,3,0,1,0,76.14,55.95 ,33.33
03,012,01,001,0046,0,1964 ,9 ,1973 ,3678 ,0,3,1,3,0,1,0,76.14,53.64 ,33.33
03,012,01,001,0047,0,1426 ,9 ,1435 ,2675 ,0,3,1,3,0,1,0,76.14,53.64 ,33.33
03,012,01,001,0048,0,1245 ,5 ,1250 ,2224 ,0,3,1,3,0,1,0,76.14,56.21 ,33.33
03,012,01,001,0049,0,1151 ,9 ,1160 ,2125 ,0,3,1,3,0,1,0,76.14,54.59 ,33.33
03,012,01,001,0050,0,2083 ,15 ,2098 ,3872 ,0,3,1,3,0,1,0,76.14,54.18 ,33.33
03,012,01,001,0051,0,1301 ,8 ,1309 ,2373 ,0,3,1,3,0,1,0,76.14,55.16 ,33.33
03,012,01,001,0052,0,1138 ,8 ,1146 ,1958 ,0,3,1,3,0,1,0,76.14,58.53 ,33.33
03,012,01,001,0053,0,1462 ,6 ,1468 ,2722 ,0,3,1,3,0,1,0,76.14,53.93 ,33.33
03,012,01,001,0054,0,1837 ,13 ,1850 ,3361 ,0,3,1,3,0,1,0,76.14,55.04 ,33.33
03,012,01,001,0055,0,2294 ,12 ,2306 ,4075 ,0,3,1,3,0,1,0,76.14,56.59 ,33.33
03,012,01,001,0056,0,1773 ,14 ,1787 ,3141 ,0,3,1,3,0,1,0,76.14,56.89 ,33.33
03,012,01,001,0057,0,1897 ,11 ,1908 ,3648 ,0,3,1,3,0,1,0,76.14,52.30 ,33.33
03,012,01,001,0058,0,3338 ,25 ,3363 ,6113 ,0,3,1,3,0,1,0,76.14,55.01 ,33.33
03,012,01,001,0059,0,1772 ,7 ,1779 ,3438 ,0,3,1,3,0,1,0,76.14,51.75 ,33.33
03,012,01,001,0060,0,1160 ,13 ,1173 ,1983 ,0,3,1,3,0,1,0,76.14,59.15 ,33.33
03,012,01,001,0061,0,2014 ,11 ,2025 ,3890 ,0,3,1,3,0,1,0,76.14,52.06 ,33.33
03,012,01,001,0062,0,1921 ,14 ,1935 ,3600 ,0,3,1,3,0,1,0,76.14,53.75 ,33.33
03,012,01,001,0063,0,4440 ,29 ,4469 ,8605 ,0,3,1,3,0,1,0,76.14,51.93 ,33.33
03,012,01,001,0064,0,1739 ,12 ,1751 ,3151 ,0,3,1,3,0,1,0,76.14,55.57 ,33.33
03,012,01,001,0065,0,2052 ,16 ,2068 ,3649 ,0,3,1,3,0,1,0,76.14,56.67 ,33.33
03,012,01,001,0066,0,1416 ,14 ,1430 ,2674 ,0,3,1,3,0,1,0,76.14,53.48 ,33.33
03,012,01,001,0067,0,2194 ,15 ,2209 ,3936 ,0,3,1,3,0,1,0,76.14,56.12 ,33.33
03,012,01,001,0068,0,976 ,10 ,986 ,2119 ,0,3,1,3,0,1,0,76.14,46.53 ,33.33
03,012,01,001,0069,0,2301 ,23 ,2324 ,4611 ,0,3,1,3,0,1,0,76.14,50.40 ,33.33
03,012,01,001,0070,0,1067 ,8 ,1075 ,1970 ,0,3,1,3,0,1,0,76.14,54.57 ,33.33
03,012,01,001,0071,0,1347 ,6 ,1353 ,2470 ,0,3,1,3,0,1,0,76.14,54.78 ,33.33
03,012,01,001,0072,0,2303 ,17 ,2320 ,4118 ,0,3,1,3,0,1,0,76.14,56.34 ,33.33
03,012,01,001,0073,0,1961 ,11 ,1972 ,3404 ,0,3,1,3,0,1,0,76.14,57.93 ,33.33
03,012,01,001,0074,0,1972 ,13 ,1985 ,3567 ,0,3,1,3,0,1,0,76.14,55.65 ,33.33
03,012,01,001,0075,0,1770 ,10 ,1780 ,2994 ,0,3,1,3,0,1,0,76.14,59.45 ,33.33
03,012,01,001,0076,0,2830 ,23 ,2853 ,5245 ,0,3,1,3,0,1,0,76.14,54.39 ,33.33
03,012,01,001,0077,0,1354 ,17 ,1371 ,2509 ,0,3,1,3,0,1,0,76.14,54.64 ,33.33
03,012,01,001,0078,0,1536 ,11 ,1547 ,2850 ,0,3,1,3,0,1,0,76.14,54.28 ,33.33
03,012,01,002,0079,0,1561 ,15 ,1576 ,2624 ,0,3,1,3,0,1,0,76.14,60.06 ,33.33
03,012,01,002,0080,0,1786 ,12 ,1798 ,2976 ,0,3,1,3,0,1,0,76.14,60.42 ,33.33
03,012,01,002,0081,0,1265 ,8 ,1273 ,2076 ,0,3,1,3,0,1,0,76.14,61.32 ,33.33
03,012,01,002,0082,0,1467 ,7 ,1474 ,2491 ,0,3,1,3,0,1,0,76.14,59.17 ,33.33
03,012,01,002,0083,0,2005 ,10 ,2015 ,3362 ,0,3,1,3,0,1,0,76.14,59.93 ,33.33
03,012,01,002,0084,0,1041 ,9 ,1050 ,1874 ,0,3,1,3,0,1,0,76.14,56.03 ,33.33
03,012,01,002,0085,0,1422 ,11 ,1433 ,2381 ,0,3,1,3,0,1,0,76.14,60.18 ,33.33
03,012,01,002,0086,0,1529 ,22 ,1551 ,2549 ,0,3,1,3,0,1,0,76.14,60.85 ,33.33
03,012,01,002,0087,0,998 ,40 ,1038 ,1690 ,0,3,1,3,0,1,0,76.14,61.42 ,33.33
03,012,01,002,0088,0,1881 ,12 ,1893 ,3131 ,0,3,1,3,0,1,0,76.14,60.46 ,33.33
03,012,01,002,0089,0,1732 ,11 ,1743 ,2897 ,0,3,1,3,0,1,0,76.14,60.17 ,33.33
03,012,01,002,0090,0,810 ,7 ,817 ,1193 ,0,3,1,3,0,1,0,76.14,68.48 ,33.33
03,012,01,002,0091,0,1041 ,17 ,1058 ,1643 ,0,3,1,3,0,1,0,76.14,64.39 ,33.33
03,012,01,002,0092,0,1205 ,13 ,1218 ,1958 ,0,3,1,3,0,1,0,76.14,62.21 ,33.33
03,012,01,002,0093,0,2052 ,22 ,2074 ,3528 ,0,3,1,3,0,1,0,76.14,58.79 ,33.33
03,012,01,002,0094,0,959 ,6 ,965 ,1629 ,0,3,1,3,0,1,0,76.14,59.24 ,33.33
03,012,01,002,0095,0,902 ,15 ,917 ,1359 ,0,3,1,3,0,1,0,76.14,67.48 ,33.33
03,012,01,002,0096,0,1794 ,4 ,1798 ,2810 ,0,3,1,3,0,1,0,76.14,63.99 ,33.33
03,012,01,002,0097,0,1100 ,10 ,1110 ,1714 ,0,3,1,3,0,1,0,76.14,64.76 ,33.33
03,012,01,002,0098,0,1085 ,8 ,1093 ,1660 ,0,3,1,3,0,1,0,76.14,65.84 ,33.33
03,012,01,002,0099,0,537 ,4 ,541 ,880 ,0,3,1,3,0,1,0,76.14,61.48 ,33.33
03,012,01,002,0100,0,449 ,8 ,457 ,743 ,0,3,1,3,0,1,0,76.14,61.51 ,33.33
03,012,01,002,0101,0,1213 ,18 ,1231 ,2089 ,0,3,1,3,0,1,0,76.14,58.93 ,33.33
03,012,01,002,0102,0,812 ,9 ,821 ,1449 ,0,3,1,3,0,1,0,76.14,56.66 ,33.33
03,012,01,003,0103,0,1247 ,13 ,1260 ,2019 ,0,3,1,3,0,1,0,76.14,62.41 ,33.33
03,012,01,003,0104,0,905 ,9 ,914 ,1392 ,0,3,1,3,0,1,0,76.14,65.66 ,33.33
03,012,01,003,0105,0,1059 ,8 ,1067 ,1547 ,0,3,1,3,0,1,0,76.14,68.97 ,33.33
03,012,01,003,0106,0,4859 ,52 ,4911 ,8340 ,0,3,1,3,0,1,0,76.14,58.88 ,33.33
03,012,01,003,0107,0,2968 ,25 ,2993 ,5342 ,0,3,1,3,0,1,0,76.14,56.03 ,33.33
03,012,01,003,0108,0,1164 ,17 ,1181 ,1963 ,0,3,1,3,0,1,0,76.14,60.16 ,33.33
03,012,01,003,0109,0,3517 ,25 ,3542 ,5723 ,0,3,1,3,0,1,0,76.14,61.89 ,33.33
03,012,01,003,0110,0,997 ,10 ,1007 ,1473 ,0,3,1,3,0,1,0,76.14,68.36 ,33.33
03,012,01,003,0111,0,708 ,13 ,721 ,1128 ,0,3,1,3,0,1,0,76.14,63.92 ,33.33
03,012,01,003,0112,0,691 ,9 ,700 ,1165 ,0,3,1,3,0,1,0,76.14,60.09 ,33.33
03,012,01,003,0113,0,1788 ,18 ,1806 ,2930 ,0,3,1,3,0,1,0,76.14,61.64 ,33.33
03,012,01,003,0114,0,1895 ,19 ,1914 ,3109 ,0,3,1,3,0,1,0,76.14,61.56 ,33.33
03,012,01,003,0115,0,3439 ,28 ,3467 ,6010 ,0,3,1,3,0,1,0,76.14,57.69 ,33.33
03,012,01,003,0116,0,3420 ,27 ,3447 ,5890 ,0,3,1,3,0,1,0,76.14,58.52 ,33.33
03,012,01,003,0117,0,2829 ,17 ,2846 ,4854 ,0,3,1,3,0,1,0,76.14,58.63 ,33.33
03,012,01,003,0118,0,2406 ,14 ,2420 ,3991 ,0,3,1,3,0,1,0,76.14,60.64 ,33.33
03,012,01,003,0119,0,1269 ,7 ,1276 ,2087 ,0,3,1,3,0,1,0,76.14,61.14 ,33.33
03,012,01,003,0120,0,3128 ,34 ,3162 ,5637 ,0,3,1,3,0,1,0,76.14,56.09 ,33.33
03,012,01,003,0121,0,839 ,7 ,846 ,1340 ,0,3,1,3,0,1,0,76.14,63.13 ,33.33
03,012,01,003,0122,0,2063 ,22 ,2085 ,3968 ,0,3,1,3,0,1,0,76.14,52.55 ,33.33
03,012,01,003,0123,0,881 ,14 ,895 ,1427 ,0,3,1,3,0,1,0,76.14,62.72 ,33.33
03,012,01,003,0124,0,1116 ,15 ,1131 ,1800 ,0,3,1,3,0,1,0,76.14,62.83 ,33.33
03,012,01,003,0125,0,1691 ,19 ,1710 ,2559 ,0,3,1,3,0,1,0,76.14,66.82 ,33.33
03,012,01,003,0126,0,847 ,7 ,854 ,1269 ,0,3,1,3,0,1,0,76.14,67.30 ,33.33
03,012,01,003,0127,0,1704 ,10 ,1714 ,3021 ,0,3,1,3,0,1,0,76.14,56.74 ,33.33
03,012,01,003,0128,0,1085 ,8 ,1093 ,1804 ,0,3,1,3,0,1,0,76.14,60.59 ,33.33
03,012,01,004,0129,0,1281 ,7 ,1288 ,2152 ,0,3,1,3,0,1,0,76.14,59.85 ,33.33
03,012,01,004,0130,0,2352 ,15 ,2367 ,4070 ,0,3,1,3,0,1,0,76.14,58.16 ,33.33
03,012,01,004,0131,0,2504 ,28 ,2532 ,3881 ,0,3,1,3,0,1,0,76.14,65.24 ,33.33
03,012,01,004,0132,0,1408 ,9 ,1417 ,2171 ,0,3,1,3,0,1,0,76.14,65.27 ,33.33
03,012,01,004,0133,0,1506 ,11 ,1517 ,2278 ,0,3,1,3,0,1,0,76.14,66.59 ,33.33
03,012,01,004,0134,0,1016 ,13 ,1029 ,1508 ,0,3,1,3,0,1,0,76.14,68.24 ,33.33
03,012,01,004,0135,0,799 ,11 ,810 ,1234 ,0,3,1,3,0,1,0,76.14,65.64 ,33.33
03,012,01,004,0136,0,1077 ,4 ,1081 ,1577 ,0,3,1,3,0,1,0,76.14,68.55 ,33.33
03,012,01,004,0137,0,1490 ,10 ,1500 ,2259 ,0,3,1,3,0,1,0,76.14,66.40 ,33.33
03,012,01,004,0138,0,2014 ,11 ,2025 ,3265 ,0,3,1,3,0,1,0,76.14,62.02 ,33.33
03,012,01,004,0139,0,705 ,5 ,710 ,1088 ,0,3,1,3,0,1,0,76.14,65.26 ,33.33
03,012,01,004,0140,0,668 ,1 ,669 ,944 ,0,3,1,3,0,1,0,76.14,70.87 ,33.33
03,012,01,004,0141,0,603 ,7 ,610 ,955 ,0,3,1,3,0,1,0,76.14,63.87 ,33.33
03,012,01,004,0142,0,518 ,5 ,523 ,814 ,0,3,1,3,0,1,0,76.14,64.25 ,33.33
03,012,01,004,0143,0,862 ,1 ,863 ,1342 ,0,3,1,3,0,1,0,76.14,64.31 ,33.33
03,012,01,004,0144,0,1076 ,3 ,1079 ,1670 ,0,3,1,3,0,1,0,76.14,64.61 ,33.33
03,012,01,004,0145,0,1155 ,13 ,1168 ,1861 ,0,3,1,3,0,1,0,76.14,62.76 ,33.33
03,012,01,004,0146,0,433 ,6 ,439 ,611 ,0,3,1,3,0,1,0,76.14,71.85 ,33.33
03,012,01,005,0147,0,588 ,10 ,598 ,947 ,0,3,1,3,0,1,0,76.14,63.15 ,33.33
03,012,01,005,0148,0,1261 ,10 ,1271 ,1976 ,0,3,1,3,0,1,0,76.14,64.32 ,33.33
03,012,01,005,0149,0,2459 ,21 ,2480 ,4105 ,0,3,1,3,0,1,0,76.14,60.41 ,33.33
03,012,01,005,0150,0,1528 ,12 ,1540 ,2509 ,0,3,1,3,0,1,0,76.14,61.38 ,33.33
03,012,01,005,0151,0,1541 ,7 ,1548 ,2481 ,0,3,1,3,0,1,0,76.14,62.39 ,33.33
03,012,01,005,0152,0,2846 ,26 ,2872 ,4537 ,0,3,1,3,0,1,0,76.14,63.30 ,33.33
03,012,01,005,0153,0,2109 ,25 ,2134 ,3518 ,0,3,1,3,0,1,0,76.14,60.66 ,33.33
03,012,01,005,0154,0,1662 ,15 ,1677 ,2664 ,0,3,1,3,0,1,0,76.14,62.95 ,33.33
03,012,01,005,0155,0,887 ,7 ,894 ,1440 ,0,3,1,3,0,1,0,76.14,62.08 ,33.33
03,012,01,006,0156,0,2569 ,28 ,2597 ,4234 ,0,3,1,3,0,1,0,76.14,61.34 ,33.33
03,012,01,006,0157,0,3126 ,24 ,3150 ,5399 ,0,3,1,3,0,1,0,76.14,58.34 ,33.33
03,012,01,006,0158,0,1239 ,14 ,1253 ,2104 ,0,3,1,3,0,1,0,76.14,59.55 ,33.33
03,012,01,006,0159,0,1381 ,13 ,1394 ,2166 ,0,3,1,3,0,1,0,76.14,64.36 ,33.33
03,012,01,006,0160,0,795 ,8 ,803 ,1328 ,0,3,1,3,0,1,0,76.14,60.47 ,33.33
03,012,01,006,0161,0,3736 ,35 ,3771 ,7182 ,0,3,1,3,0,1,0,76.14,52.51 ,33.33
03,012,01,006,0162,0,1313 ,8 ,1321 ,2322 ,0,3,1,3,0,1,0,76.14,56.89 ,33.33
03,012,01,006,0163,0,1131 ,21 ,1152 ,1695 ,0,3,1,3,0,1,0,76.14,67.96 ,33.33
03,012,01,006,0164,0,1140 ,6 ,1146 ,2008 ,0,3,1,3,0,1,0,76.14,57.07 ,33.33
03,012,01,006,0165,0,1478 ,8 ,1486 ,2637 ,0,3,1,3,0,1,0,76.14,56.35 ,33.33
03,012,01,006,0166,0,1224 ,4 ,1228 ,2088 ,0,3,1,3,0,1,0,76.14,58.81 ,33.33
03,012,01,006,0167,0,1776 ,16 ,1792 ,3140 ,0,3,1,3,0,1,0,76.14,57.07 ,33.33
03,012,01,006,0168,0,813 ,10 ,823 ,1316 ,0,3,1,3,0,1,0,76.14,62.54 ,33.33
03,012,01,006,0169,0,1427 ,17 ,1444 ,2362 ,0,3,1,3,0,1,0,76.14,61.13 ,33.33
03,012,01,006,0170,0,1819 ,21 ,1840 ,2933 ,0,3,1,3,0,1,0,76.14,62.73 ,33.33
03,012,01,006,0171,0,400 ,1 ,401 ,614 ,0,3,1,3,0,1,0,76.14,65.31 ,33.33
03,012,01,007,0172,0,4415 ,30 ,4445 ,7943 ,0,3,1,3,0,1,0,76.14,55.96 ,33.33
03,012,01,007,0173,0,1771 ,13 ,1784 ,2839 ,0,3,1,3,0,1,0,76.14,62.84 ,33.33
03,012,01,007,0174,0,4419 ,26 ,4445 ,7579 ,0,3,1,3,0,1,0,76.14,58.65 ,33.33
03,012,01,007,0175,0,1866 ,16 ,1882 ,2920 ,0,3,1,3,0,1,0,76.14,64.45 ,33.33
03,012,01,007,0176,0,3460 ,28 ,3488 ,5623 ,0,3,1,3,0,1,0,76.14,62.03 ,33.33
03,012,01,007,0177,0,1933 ,29 ,1962 ,3240 ,0,3,1,3,0,1,0,76.14,60.56 ,33.33
03,012,01,007,0178,0,485 ,6 ,491 ,690 ,0,3,1,3,0,1,0,76.14,71.16 ,33.33
03,012,01,008,0179,0,2064 ,20 ,2084 ,3784 ,0,3,1,3,0,1,0,76.14,55.07 ,33.33
03,012,01,008,0180,0,727 ,5 ,732 ,1207 ,0,3,1,3,0,1,0,76.14,60.65 ,33.33
03,012,01,008,0181,0,1877 ,10 ,1887 ,3147 ,0,3,1,3,0,1,0,76.14,59.96 ,33.33
03,012,01,008,0182,0,694 ,5 ,699 ,1157 ,0,3,1,3,0,1,0,76.14,60.41 ,33.33
03,012,01,008,0183,0,961 ,3 ,964 ,1440 ,0,3,1,3,0,1,0,76.14,66.94 ,33.33
03,012,01,008,0184,0,824 ,8 ,832 ,1244 ,0,3,1,3,0,1,0,76.14,66.88 ,33.33
03,012,01,008,0185,0,1681 ,16 ,1697 ,3012 ,0,3,1,3,0,1,0,76.14,56.34 ,33.33
03,012,01,008,0186,0,1678 ,13 ,1691 ,2971 ,0,3,1,3,0,1,0,76.14,56.92 ,33.33
03,012,01,008,0187,0,1810 ,16 ,1826 ,3075 ,0,3,1,3,0,1,0,76.14,59.38 ,33.33
03,012,01,008,0188,0,2609 ,16 ,2625 ,4511 ,0,3,1,3,0,1,0,76.14,58.19 ,33.33
03,012,01,008,0189,0,2219 ,22 ,2241 ,3794 ,0,3,1,3,0,1,0,76.14,59.07 ,33.33
03,012,01,008,0190,0,416 ,4 ,420 ,588 ,0,3,1,3,0,1,0,76.14,71.43 ,33.33
03,012,01,008,0191,0,1549 ,13 ,1562 ,2436 ,0,3,1,3,0,1,0,76.14,64.12 ,33.33
03,012,01,008,0192,0,1232 ,7 ,1239 ,1978 ,0,3,1,3,0,1,0,76.14,62.64 ,33.33
03,012,01,008,0193,0,2019 ,15 ,2034 ,3260 ,0,3,1,3,0,1,0,76.14,62.39 ,33.33
03,012,01,008,0194,0,2014 ,8 ,2022 ,3242 ,0,3,1,3,0,1,0,76.14,62.37 ,33.33
03,012,01,008,0195,0,993 ,14 ,1007 ,1470 ,0,3,1,3,0,1,0,76.14,68.50 ,33.33
03,012,01,008,0196,0,2760 ,25 ,2785 ,4741 ,0,3,1,3,0,1,0,76.14,58.74 ,33.33
03,012,01,008,0197,0,1179 ,11 ,1190 ,1955 ,0,3,1,3,0,1,0,76.14,60.87 ,33.33
03,012,01,008,0198,0,837 ,5 ,842 ,1321 ,0,3,1,3,0,1,0,76.14,63.74 ,33.33
03,012,01,008,0199,0,783 ,6 ,789 ,1306 ,0,3,1,3,0,1,0,76.14,60.41 ,33.33
03,012,01,008,0200,0,865 ,6 ,871 ,1277 ,0,3,1,3,0,1,0,76.14,68.21 ,33.33
03,012,01,008,0201,0,697 ,4 ,701 ,994 ,0,3,1,3,0,1,0,76.14,70.52 ,33.33
03,012,01,008,0202,0,2010 ,14 ,2024 ,3188 ,0,3,1,3,0,1,0,76.14,63.49 ,33.33
03,012,01,008,0203,0,1143 ,8 ,1151 ,1640 ,0,3,1,3,0,1,0,76.14,70.18 ,33.33
03,012,01,008,0204,0,523 ,9 ,532 ,731 ,0,3,1,3,0,1,0,76.14,72.78 ,33.33
03,012,01,008,0205,0,984 ,16 ,1000 ,1374 ,0,3,1,3,0,1,0,76.14,72.78 ,33.33
03,012,01,008,0206,0,510 ,7 ,517 ,790 ,0,3,1,3,0,1,0,76.14,65.44 ,33.33
03,012,01,008,0207,0,527 ,7 ,534 ,849 ,0,3,1,3,0,1,0,76.14,62.90 ,33.33
03,012,01,008,0208,0,277 ,2 ,279 ,419 ,0,3,1,3,0,1,0,76.14,66.59 ,33.33
03,012,01,008,0209,0,580 ,4 ,584 ,915 ,0,3,1,3,0,1,0,76.14,63.83 ,33.33
03,012,01,008,0210,0,1348 ,8 ,1356 ,2100 ,0,3,1,3,0,1,0,76.14,64.57 ,33.33
03,012,01,008,0211,0,878 ,3 ,881 ,1304 ,0,3,1,3,0,1,0,76.14,67.56 ,33.33
03,012,01,008,0212,0,793 ,8 ,801 ,1122 ,0,3,1,3,0,1,0,76.14,71.39 ,33.33
03,012,01,008,0213,0,254 ,4 ,258 ,425 ,0,3,1,3,0,1,0,76.14,60.71 ,33.33
03,012,01,009,0214,0,1098 ,11 ,1109 ,1764 ,0,3,1,3,0,1,0,76.14,62.87 ,33.33
03,012,01,009,0215,0,750 ,7 ,757 ,1134 ,0,3,1,3,0,1,0,76.14,66.75 ,33.33
03,012,01,009,0216,0,1367 ,20 ,1387 ,2111 ,0,3,1,3,0,1,0,76.14,65.70 ,33.33
03,012,01,009,0217,0,1345 ,11 ,1356 ,2176 ,0,3,1,3,0,1,0,76.14,62.32 ,33.33
03,012,01,009,0218,0,2126 ,13 ,2139 ,3282 ,0,3,1,3,0,1,0,76.14,65.17 ,33.33
03,012,01,009,0219,0,870 ,8 ,878 ,1266 ,0,3,1,3,0,1,0,76.14,69.35 ,33.33
03,012,01,009,0220,0,1209 ,20 ,1229 ,1950 ,0,3,1,3,0,1,0,76.14,63.03 ,33.33
03,012,01,009,0221,0,1338 ,9 ,1347 ,2132 ,0,3,1,3,0,1,0,76.14,63.18 ,33.33
03,012,01,009,0222,0,687 ,15 ,702 ,1055 ,0,3,1,3,0,1,0,76.14,66.54 ,33.33
03,012,01,009,0223,0,1601 ,12 ,1613 ,2727 ,0,3,1,3,0,1,0,76.14,59.15 ,33.33
03,012,01,009,0224,0,819 ,3 ,822 ,1146 ,0,3,1,3,0,1,0,76.14,71.73 ,33.33
03,012,01,009,0225,0,451 ,3 ,454 ,739 ,0,3,1,3,0,1,0,76.14,61.43 ,33.33
03,012,01,009,0226,0,974 ,4 ,978 ,1454 ,0,3,1,3,0,1,0,76.14,67.26 ,33.33
03,012,01,009,0227,0,1351 ,12 ,1363 ,2145 ,0,3,1,3,0,1,0,76.14,63.54 ,33.33
03,012,01,009,0228,0,687 ,6 ,693 ,1068 ,0,3,1,3,0,1,0,76.14,64.89 ,33.33
03,012,01,009,0229,0,1049 ,7 ,1056 ,1488 ,0,3,1,3,0,1,0,76.14,70.97 ,33.33
03,012,01,009,0230,0,424 ,2 ,426 ,646 ,0,3,1,3,0,1,0,76.14,65.94 ,33.33
03,012,01,010,0231,0,296 ,1 ,297 ,429 ,0,3,1,3,0,1,0,76.14,69.23 ,33.33
03,012,01,010,0232,0,725 ,12 ,737 ,1113 ,0,3,1,3,0,1,0,76.14,66.22 ,33.33
03,012,01,010,0233,0,1510 ,26 ,1536 ,2219 ,0,3,1,3,0,1,0,76.14,69.22 ,33.33
03,012,01,010,0234,0,1950 ,15 ,1965 ,3064 ,0,3,1,3,0,1,0,76.14,64.13 ,33.33
03,012,01,010,0235,0,1799 ,12 ,1811 ,2771 ,0,3,1,3,0,1,0,76.14,65.36 ,33.33
03,012,01,010,0236,0,1206 ,8 ,1214 ,1817 ,0,3,1,3,0,1,0,76.14,66.81 ,33.33
03,012,01,010,0237,0,2329 ,26 ,2355 ,3853 ,0,3,1,3,0,1,0,76.14,61.12 ,33.33
03,012,01,010,0238,0,1416 ,10 ,1426 ,2263 ,0,3,1,3,0,1,0,76.14,63.01 ,33.33
03,012,01,010,0239,0,1439 ,16 ,1455 ,2293 ,0,3,1,3,0,1,0,76.14,63.45 ,33.33
03,012,01,010,0240,0,1020 ,10 ,1030 ,1785 ,0,3,1,3,0,1,0,76.14,57.70 ,33.33
03,012,01,010,0241,0,1492 ,16 ,1508 ,2381 ,0,3,1,3,0,1,0,76.14,63.33 ,33.33
03,012,01,011,0242,0,275 ,0 ,275 ,365 ,0,3,1,3,0,1,0,76.14,75.34 ,33.33
03,012,01,011,0243,0,383 ,6 ,389 ,648 ,0,3,1,3,0,1,0,76.14,60.03 ,33.33
03,012,01,011,0244,0,685 ,3 ,688 ,945 ,0,3,1,3,0,1,0,76.14,72.80 ,33.33
03,012,01,011,0245,0,288 ,1 ,289 ,418 ,0,3,1,3,0,1,0,76.14,69.14 ,33.33
03,012,01,011,0246,0,564 ,6 ,570 ,892 ,0,3,1,3,0,1,0,76.14,63.90 ,33.33
03,012,01,011,0247,0,877 ,9 ,886 ,1316 ,0,3,1,3,0,1,0,76.14,67.33 ,33.33
03,012,01,011,0248,0,261 ,3 ,264 ,414 ,0,3,1,3,0,1,0,76.14,63.77 ,33.33
03,012,01,011,0249,0,285 ,3 ,288 ,420 ,0,3,1,3,0,1,0,76.14,68.57 ,33.33
03,012,01,011,0250,0,572 ,6 ,578 ,842 ,0,3,1,3,0,1,0,76.14,68.65 ,33.33
03,012,01,011,0251,0,895 ,6 ,901 ,1296 ,0,3,1,3,0,1,0,76.14,69.52 ,33.33
03,012,01,012,0252,0,2489 ,19 ,2508 ,4225 ,0,3,1,3,0,1,0,76.14,59.36 ,33.33
03,012,01,012,0253,0,1673 ,8 ,1681 ,2705 ,0,3,1,3,0,1,0,76.14,62.14 ,33.33
03,012,01,012,0254,0,1487 ,19 ,1506 ,2559 ,0,3,1,3,0,1,0,76.14,58.85 ,33.33
03,012,01,012,0255,0,1187 ,15 ,1202 ,2053 ,0,3,1,3,0,1,0,76.14,58.55 ,33.33
03,012,01,012,0256,0,766 ,4 ,770 ,1331 ,0,3,1,3,0,1,0,76.14,57.85 ,33.33
03,012,01,012,0257,0,736 ,6 ,742 ,1294 ,0,3,1,3,0,1,0,76.14,57.34 ,33.33
03,012,01,012,0258,0,1152 ,15 ,1167 ,1933 ,0,3,1,3,0,1,0,76.14,60.37 ,33.33
03,012,01,012,0259,0,691 ,9 ,700 ,1123 ,0,3,1,3,0,1,0,76.14,62.33 ,33.33
03,012,01,012,0260,0,1132 ,20 ,1152 ,1857 ,0,3,1,3,0,1,0,76.14,62.04 ,33.33
03,012,01,012,0261,0,441 ,5 ,446 ,725 ,0,3,1,3,0,1,0,76.14,61.52 ,33.33
03,012,01,012,0262,0,971 ,15 ,986 ,1587 ,0,3,1,3,0,1,0,76.14,62.13 ,33.33
03,012,01,012,0263,0,596 ,6 ,602 ,979 ,0,3,1,3,0,1,0,76.14,61.49 ,33.33
03,012,01,013,0264,0,1120 ,10 ,1130 ,1714 ,0,3,1,3,0,1,0,76.14,65.93 ,33.33
03,012,01,013,0265,0,1566 ,15 ,1581 ,2514 ,0,3,1,3,0,1,0,76.14,62.89 ,33.33
03,012,01,013,0266,0,1863 ,67 ,1930 ,2936 ,0,3,1,3,0,1,0,76.14,65.74 ,33.33
03,012,01,013,0267,0,1221 ,12 ,1233 ,1951 ,0,3,1,3,0,1,0,76.14,63.20 ,33.33
03,012,01,013,0268,0,985 ,8 ,993 ,1572 ,0,3,1,3,0,1,0,76.14,63.17 ,33.33
03,012,01,013,0269,0,596 ,4 ,600 ,891 ,0,3,1,3,0,1,0,76.14,67.34 ,33.33
03,012,01,013,0270,0,1403 ,16 ,1419 ,2198 ,0,3,1,3,0,1,0,76.14,64.56 ,33.33
03,012,01,013,0271,0,2149 ,22 ,2171 ,3566 ,0,3,1,3,0,1,0,76.14,60.88 ,33.33
03,012,01,013,0272,0,1777 ,15 ,1792 ,2902 ,0,3,1,3,0,1,0,76.14,61.75 ,33.33
03,012,01,013,0273,0,1643 ,21 ,1664 ,2687 ,0,3,1,3,0,1,0,76.14,61.93 ,33.33
03,012,01,013,0274,0,1442 ,20 ,1462 ,2190 ,0,3,1,3,0,1,0,76.14,66.76 ,33.33
03,012,01,013,0275,0,1375 ,14 ,1389 ,2148 ,0,3,1,3,0,1,0,76.14,64.66 ,33.33
03,012,01,013,0276,0,1740 ,17 ,1757 ,2772 ,0,3,1,3,0,1,0,76.14,63.38 ,33.33
03,012,01,013,0277,0,1537 ,17 ,1554 ,2633 ,0,3,1,3,0,1,0,76.14,59.02 ,33.33
03,012,01,013,0278,0,687 ,3 ,690 ,1158 ,0,3,1,3,0,1,0,76.14,59.59 ,33.33
03,012,01,013,0279,0,774 ,15 ,789 ,1190 ,0,3,1,3,0,1,0,76.14,66.30 ,33.33
03,012,01,013,0280,0,626 ,10 ,636 ,933 ,0,3,1,3,0,1,0,76.14,68.17 ,33.33
03,012,01,013,0281,0,788 ,7 ,795 ,1105 ,0,3,1,3,0,1,0,76.14,71.95 ,33.33
03,012,01,013,0282,0,644 ,11 ,655 ,879 ,0,3,1,3,0,1,0,76.14,74.52 ,33.33
03,012,01,013,0283,0,985 ,6 ,991 ,1542 ,0,3,1,3,0,1,0,76.14,64.27 ,33.33
03,012,01,014,0284,0,1623 ,15 ,1638 ,2565 ,0,3,1,3,0,1,0,76.14,63.86 ,33.33
03,012,01,014,0285,0,645 ,5 ,650 ,1053 ,0,3,1,3,0,1,0,76.14,61.73 ,33.33
03,012,01,014,0286,0,1754 ,18 ,1772 ,2776 ,0,3,1,3,0,1,0,76.14,63.83 ,33.33
03,012,01,014,0287,0,1146 ,14 ,1160 ,1919 ,0,3,1,3,0,1,0,76.14,60.45 ,33.33
03,012,01,014,0288,0,1026 ,7 ,1033 ,1773 ,0,3,1,3,0,1,0,76.14,58.26 ,33.33
03,012,01,014,0289,0,740 ,7 ,747 ,1159 ,0,3,1,3,0,1,0,76.14,64.45 ,33.33
03,012,01,014,0290,0,669 ,4 ,673 ,1065 ,0,3,1,3,0,1,0,76.14,63.19 ,33.33
03,012,01,014,0291,0,480 ,3 ,483 ,828 ,0,3,1,3,0,1,0,76.14,58.33 ,33.33
03,012,01,014,0292,0,998 ,9 ,1007 ,1693 ,0,3,1,3,0,1,0,76.14,59.48 ,33.33
03,012,01,014,0293,0,1147 ,10 ,1157 ,1881 ,0,3,1,3,0,1,0,76.14,61.51 ,33.33
03,012,01,014,0294,0,704 ,11 ,715 ,1179 ,0,3,1,3,0,1,0,76.14,60.64 ,33.33
03,012,01,014,0295,0,1218 ,7 ,1225 ,2010 ,0,3,1,3,0,1,0,76.14,60.95 ,33.33
03,012,01,014,0296,0,563 ,10 ,573 ,997 ,0,3,1,3,0,1,0,76.14,57.47 ,33.33
03,012,01,014,0297,0,494 ,5 ,499 ,753 ,0,3,1,3,0,1,0,76.14,66.27 ,33.33
03,012,01,015,0298,0,684 ,4 ,688 ,1048 ,0,3,1,3,0,1,0,76.14,65.65 ,33.33
03,012,01,015,0299,0,560 ,2 ,562 ,894 ,0,3,1,3,0,1,0,76.14,62.86 ,33.33
03,012,01,015,0300,0,984 ,6 ,990 ,1605 ,0,3,1,3,0,1,0,76.14,61.68 ,33.33
03,012,01,015,0301,0,1563 ,7 ,1570 ,2833 ,0,3,1,3,0,1,0,76.14,55.42 ,33.33
03,012,01,015,0302,0,824 ,9 ,833 ,1479 ,0,3,1,3,0,1,0,76.14,56.32 ,33.33
03,012,01,015,0303,0,1110 ,5 ,1115 ,1859 ,0,3,1,3,0,1,0,76.14,59.98 ,33.33
03,012,01,015,0304,0,713 ,4 ,717 ,1174 ,0,3,1,3,0,1,0,76.14,61.07 ,33.33
03,012,01,015,0305,0,574 ,1 ,575 ,983 ,0,3,1,3,0,1,0,76.14,58.49 ,33.33
03,012,01,015,0306,0,719 ,7 ,726 ,1197 ,0,3,1,3,0,1,0,76.14,60.65 ,33.33
03,012,01,015,0307,0,755 ,7 ,762 ,1278 ,0,3,1,3,0,1,0,76.14,59.62 ,33.33
03,012,01,015,0308,0,1689 ,24 ,1713 ,2962 ,0,3,1,3,0,1,0,76.14,57.83 ,33.33
03,012,01,015,0309,0,750 ,3 ,753 ,1190 ,0,3,1,3,0,1,0,76.14,63.28 ,33.33
03,012,01,015,0310,0,641 ,10 ,651 ,1061 ,0,3,1,3,0,1,0,76.14,61.36 ,33.33
03,012,01,015,0311,0,743 ,19 ,762 ,1270 ,0,3,1,3,0,1,0,76.14,60.00 ,33.33
03,012,01,015,0312,0,1951 ,15 ,1966 ,3674 ,0,3,1,3,0,1,0,76.14,53.51 ,33.33
03,012,01,016,0313,0,952 ,9 ,961 ,1484 ,0,3,1,3,0,1,0,76.14,64.76 ,33.33
03,012,01,016,0314,0,1092 ,11 ,1103 ,1748 ,0,3,1,3,0,1,0,76.14,63.10 ,33.33
03,012,01,016,0315,0,1332 ,20 ,1352 ,2378 ,0,3,1,3,0,1,0,76.14,56.85 ,33.33
03,012,01,016,0316,0,213 ,1 ,214 ,382 ,0,3,1,3,0,1,0,76.14,56.02 ,33.33
03,012,01,016,0317,0,1319 ,19 ,1338 ,2031 ,0,3,1,3,0,1,0,76.14,65.88 ,33.33
03,012,01,016,0318,0,1637 ,12 ,1649 ,2646 ,0,3,1,3,0,1,0,76.14,62.32 ,33.33
03,012,01,017,0319,0,1063 ,9 ,1072 ,1514 ,0,3,1,3,0,1,0,76.14,70.81 ,33.33
03,012,01,017,0320,0,1261 ,13 ,1274 ,1773 ,0,3,1,3,0,1,0,76.14,71.86 ,33.33
03,012,01,017,0321,0,1285 ,12 ,1297 ,1918 ,0,3,1,3,0,1,0,76.14,67.62 ,33.33
03,012,01,017,0322,0,694 ,4 ,698 ,966 ,0,3,1,3,0,1,0,76.14,72.26 ,33.33
03,012,01,017,0323,0,697 ,5 ,702 ,1083 ,0,3,1,3,0,1,0,76.14,64.82 ,33.33
03,012,01,017,0324,0,1285 ,9 ,1294 ,1818 ,0,3,1,3,0,1,0,76.14,71.18 ,33.33
03,012,01,017,0325,0,430 ,1 ,431 ,584 ,0,3,1,3,0,1,0,76.14,73.80 ,33.33
03,012,01,017,0326,0,503 ,1 ,504 ,717 ,0,3,1,3,0,1,0,76.14,70.29 ,33.33
03,012,01,017,0327,0,1058 ,8 ,1066 ,1555 ,0,3,1,3,0,1,0,76.14,68.55 ,33.33
03,012,01,017,0328,0,565 ,5 ,570 ,859 ,0,3,1,3,0,1,0,76.14,66.36 ,33.33
03,012,01,017,0329,0,756 ,14 ,770 ,1015 ,0,3,1,3,0,1,0,76.14,75.86 ,33.33
03,012,01,017,0330,0,1428 ,17 ,1445 ,2031 ,0,3,1,3,0,1,0,76.14,71.15 ,33.33
03,012,01,018,0331,0,1240 ,9 ,1249 ,1996 ,0,3,1,3,0,1,0,76.14,62.58 ,33.33
03,012,01,018,0332,0,1166 ,4 ,1170 ,1982 ,0,3,1,3,0,1,0,76.14,59.03 ,33.33
03,012,01,018,0333,0,1406 ,9 ,1415 ,2258 ,0,3,1,3,0,1,0,76.14,62.67 ,33.33
03,012,01,018,0334,0,794 ,1 ,795 ,1153 ,0,3,1,3,0,1,0,76.14,68.95 ,33.33
03,012,01,018,0335,0,621 ,5 ,626 ,1046 ,0,3,1,3,0,1,0,76.14,59.85 ,33.33
03,012,01,018,0336,0,614 ,6 ,620 ,926 ,0,3,1,3,0,1,0,76.14,66.95 ,33.33
03,012,01,018,0337,0,2059 ,20 ,2079 ,3417 ,0,3,1,3,0,1,0,76.14,60.84 ,33.33
03,012,01,018,0338,0,1201 ,10 ,1211 ,1873 ,0,3,1,3,0,1,0,76.14,64.66 ,33.33
03,012,01,018,0339,0,1475 ,12 ,1487 ,2322 ,0,3,1,3,0,1,0,76.14,64.04 ,33.33
03,012,01,018,0340,0,412 ,3 ,415 ,694 ,0,3,1,3,0,1,0,76.14,59.80 ,33.33
03,012,01,018,0341,0,1351 ,3 ,1354 ,2270 ,0,3,1,3,0,1,0,76.14,59.65 ,33.33
03,012,01,018,0342,0,1407 ,9 ,1416 ,2465 ,0,3,1,3,0,1,0,76.14,57.44 ,33.33
03,012,01,018,0343,0,959 ,9 ,968 ,1721 ,0,3,1,3,0,1,0,76.14,56.25 ,33.33
03,012,01,018,0344,0,1336 ,20 ,1356 ,2172 ,0,3,1,3,0,1,0,76.14,62.43 ,33.33
03,012,01,018,0345,0,1516 ,15 ,1531 ,2463 ,0,3,1,3,0,1,0,76.14,62.16 ,33.33
03,012,01,019,0346,0,1330 ,7 ,1337 ,2277 ,0,3,1,3,0,1,0,76.14,58.72 ,33.33
03,012,01,019,0347,0,1539 ,7 ,1546 ,2417 ,0,3,1,3,0,1,0,76.14,63.96 ,33.33
03,012,01,019,0348,0,513 ,2 ,515 ,888 ,0,3,1,3,0,1,0,76.14,58.00 ,33.33
03,012,01,019,0349,0,389 ,3 ,392 ,583 ,0,3,1,3,0,1,0,76.14,67.24 ,33.33
03,012,01,019,0350,0,490 ,7 ,497 ,751 ,0,3,1,3,0,1,0,76.14,66.18 ,33.33
03,012,01,019,0351,0,457 ,5 ,462 ,749 ,0,3,1,3,0,1,0,76.14,61.68 ,33.33
03,012,01,019,0352,0,367 ,1 ,368 ,577 ,0,3,1,3,0,1,0,76.14,63.78 ,33.33
03,012,01,019,0353,0,1123 ,5 ,1128 ,1945 ,0,3,1,3,0,1,0,76.14,57.99 ,33.33
03,012,01,019,0354,0,1770 ,23 ,1793 ,3039 ,0,3,1,3,0,1,0,76.14,59.00 ,33.33
03,012,01,019,0355,0,1117 ,12 ,1129 ,1901 ,0,3,1,3,0,1,0,76.14,59.39 ,33.33
03,012,01,019,0356,0,1118 ,15 ,1133 ,1851 ,0,3,1,3,0,1,0,76.14,61.21 ,33.33
03,012,01,019,0357,0,1023 ,11 ,1034 ,1536 ,0,3,1,3,0,1,0,76.14,67.32 ,33.33
03,012,01,019,0358,0,858 ,8 ,866 ,1453 ,0,3,1,3,0,1,0,76.14,59.60 ,33.33
03,012,01,019,0359,0,660 ,7 ,667 ,1004 ,0,3,1,3,0,1,0,76.14,66.43 ,33.33
03,012,01,019,0360,0,599 ,7 ,606 ,889 ,0,3,1,3,0,1,0,76.14,68.17 ,33.33
03,012,01,019,0361,0,880 ,7 ,887 ,1306 ,0,3,1,3,0,1,0,76.14,67.92 ,33.33
03,012,01,019,0362,0,635 ,3 ,638 ,920 ,0,3,1,3,0,1,0,76.14,69.35 ,33.33
03,012,01,019,0363,0,957 ,8 ,965 ,1358 ,0,3,1,3,0,1,0,76.14,71.06 ,33.33
03,012,01,019,0364,0,617 ,5 ,622 ,863 ,0,3,1,3,0,1,0,76.14,72.07 ,33.33
03,012,01,019,0365,0,1560 ,7 ,1567 ,2333 ,0,3,1,3,0,1,0,76.14,67.17 ,33.33
03,012,01,019,0366,0,1088 ,9 ,1097 ,1907 ,0,3,1,3,0,1,0,76.14,57.52 ,33.33
03,012,01,019,0367,0,393 ,4 ,397 ,659 ,0,3,1,3,0,1,0,76.14,60.24 ,33.33
03,012,01,019,0368,0,246 ,2 ,248 ,379 ,0,3,1,3,0,1,0,76.14,65.44 ,33.33
03,012,01,019,0369,0,425 ,5 ,430 ,640 ,0,3,1,3,0,1,0,76.14,67.19 ,33.33
03,012,01,019,0370,0,136 ,1 ,137 ,206 ,0,3,1,3,0,1,0,76.14,66.50 ,33.33
03,012,01,020,0371,0,1097 ,11 ,1108 ,1836 ,0,3,1,3,0,1,0,76.14,60.35 ,33.33
03,012,01,020,0372,0,822 ,7 ,829 ,1361 ,0,3,1,3,0,1,0,76.14,60.91 ,33.33
03,012,01,020,0373,0,914 ,3 ,917 ,1482 ,0,3,1,3,0,1,0,76.14,61.88 ,33.33
03,012,01,020,0374,0,1302 ,10 ,1312 ,2254 ,0,3,1,3,0,1,0,76.14,58.21 ,33.33
03,012,01,020,0375,0,1322 ,7 ,1329 ,2171 ,0,3,1,3,0,1,0,76.14,61.22 ,33.33
03,012,01,020,0376,0,1542 ,20 ,1562 ,2522 ,0,3,1,3,0,1,0,76.14,61.93 ,33.33
03,012,01,020,0377,0,1530 ,14 ,1544 ,2507 ,0,3,1,3,0,1,0,76.14,61.59 ,33.33
03,012,01,020,0378,0,1233 ,6 ,1239 ,2017 ,0,3,1,3,0,1,0,76.14,61.43 ,33.33
03,012,01,020,0379,0,956 ,6 ,962 ,1478 ,0,3,1,3,0,1,0,76.14,65.09 ,33.33
03,012,01,020,0380,0,1049 ,11 ,1060 ,1704 ,0,3,1,3,0,1,0,76.14,62.21 ,33.33
03,012,01,020,0381,0,868 ,6 ,874 ,1407 ,0,3,1,3,0,1,0,76.14,62.12 ,33.33
03,012,01,020,0382,0,1197 ,14 ,1211 ,1992 ,0,3,1,3,0,1,0,76.14,60.79 ,33.33
03,012,01,020,0383,0,1035 ,8 ,1043 ,1692 ,0,3,1,3,0,1,0,76.14,61.64 ,33.33
03,012,01,020,0384,0,593 ,3 ,596 ,1048 ,0,3,1,3,0,1,0,76.14,56.87 ,33.33
03,012,01,020,0385,0,676 ,10 ,686 ,1123 ,0,3,1,3,0,1,0,76.14,61.09 ,33.33
03,012,01,020,0386,0,1519 ,5 ,1524 ,2366 ,0,3,1,3,0,1,0,76.14,64.41 ,33.33
03,012,01,020,0387,0,1022 ,6 ,1028 ,1625 ,0,3,1,3,0,1,0,76.14,63.26 ,33.33
03,012,01,020,0388,0,845 ,5 ,850 ,1387 ,0,3,1,3,0,1,0,76.14,61.28 ,33.33
03,012,01,020,0389,0,742 ,3 ,745 ,1218 ,0,3,1,3,0,1,0,76.14,61.17 ,33.33
03,012,01,020,0390,0,1008 ,6 ,1014 ,1693 ,0,3,1,3,0,1,0,76.14,59.89 ,33.33
03,012,01,021,0391,0,528 ,13 ,541 ,1043 ,0,3,1,3,0,1,0,76.14,51.87 ,33.33
03,012,01,021,0392,0,745 ,9 ,754 ,1141 ,0,3,1,3,0,1,0,76.14,66.08 ,33.33
03,012,01,021,0393,0,746 ,11 ,757 ,1551 ,0,3,1,3,0,1,0,76.14,48.81 ,33.33
03,012,01,021,0394,0,728 ,3 ,731 ,1311 ,0,3,1,3,0,1,0,76.14,55.76 ,33.33
03,012,01,021,0395,0,507 ,3 ,510 ,885 ,0,3,1,3,0,1,0,76.14,57.63 ,33.33
03,012,01,021,0396,0,470 ,6 ,476 ,808 ,0,3,1,3,0,1,0,76.14,58.91 ,33.33
03,012,01,021,0397,0,400 ,7 ,407 ,735 ,0,3,1,3,0,1,0,76.14,55.37 ,33.33
03,012,01,021,0398,0,435 ,6 ,441 ,623 ,0,3,1,3,0,1,0,76.14,70.79 ,33.33
03,012,01,021,0399,0,207 ,3 ,210 ,344 ,0,3,1,3,0,1,0,76.14,61.05 ,33.33
03,012,01,021,0400,0,686 ,12 ,698 ,1352 ,0,3,1,3,0,1,0,76.14,51.63 ,33.33
03,012,01,021,0401,0,723 ,9 ,732 ,1496 ,0,3,1,3,0,1,0,76.14,48.93 ,33.33
03,012,01,021,0402,0,655 ,4 ,659 ,1096 ,0,3,1,3,0,1,0,76.14,60.13 ,33.33
03,012,01,022,0403,0,362 ,0 ,362 ,606 ,0,3,1,3,0,1,0,76.14,59.74 ,33.33
03,012,01,022,0404,0,685 ,3 ,688 ,1042 ,0,3,1,3,0,1,0,76.14,66.03 ,33.33
03,012,01,022,0405,0,530 ,4 ,534 ,833 ,0,3,1,3,0,1,0,76.14,64.11 ,33.33
03,012,01,022,0406,0,980 ,8 ,988 ,1591 ,0,3,1,3,0,1,0,76.14,62.10 ,33.33
03,012,01,022,0407,0,468 ,2 ,470 ,714 ,0,3,1,3,0,1,0,76.14,65.83 ,33.33
03,012,01,022,0408,0,447 ,6 ,453 ,715 ,0,3,1,3,0,1,0,76.14,63.36 ,33.33
03,012,01,022,0409,0,622 ,6 ,628 ,1126 ,0,3,1,3,0,1,0,76.14,55.77 ,33.33
03,012,01,023,0410,0,433 ,0 ,433 ,750 ,0,3,1,3,0,1,0,76.14,57.73 ,33.33
03,012,01,023,0411,0,371 ,4 ,375 ,773 ,0,3,1,3,0,1,0,76.14,48.51 ,33.33
03,012,01,023,0412,0,1056 ,9 ,1065 ,1886 ,0,3,1,3,0,1,0,76.14,56.47 ,33.33
03,012,01,023,0413,0,1027 ,17 ,1044 ,1738 ,0,3,1,3,0,1,0,76.14,60.07 ,33.33
03,012,01,023,0414,0,922 ,8 ,930 ,1506 ,0,3,1,3,0,1,0,76.14,61.75 ,33.33
03,012,01,023,0415,0,1013 ,9 ,1022 ,1758 ,0,3,1,3,0,1,0,76.14,58.13 ,33.33
03,012,01,023,0416,0,738 ,9 ,747 ,1305 ,0,3,1,3,0,1,0,76.14,57.24 ,33.33
03,012,01,024,0417,0,467 ,2 ,469 ,787 ,0,3,1,3,0,1,0,76.14,59.59 ,33.33
03,012,01,024,0418,0,567 ,7 ,574 ,1029 ,0,3,1,3,0,1,0,76.14,55.78 ,33.33
03,012,01,024,0419,0,269 ,2 ,271 ,483 ,0,3,1,3,0,1,0,76.14,56.11 ,33.33
03,012,01,024,0420,0,289 ,1 ,290 ,465 ,0,3,1,3,0,1,0,76.14,62.37 ,33.33
03,012,01,024,0421,0,600 ,9 ,609 ,1030 ,0,3,1,3,0,1,0,76.14,59.13 ,33.33
03,012,01,024,0422,0,1079 ,20 ,1099 ,1747 ,0,3,1,3,0,1,0,76.14,62.91 ,33.33
03,012,01,024,0423,0,380 ,5 ,385 ,608 ,0,3,1,3,0,1,0,76.14,63.32 ,33.33
03,012,01,024,0424,0,234 ,1 ,235 ,363 ,0,3,1,3,0,1,0,76.14,64.74 ,33.33
03,012,01,024,0425,0,259 ,3 ,262 ,405 ,0,3,1,3,0,1,0,76.14,64.69 ,33.33
03,012,01,024,0426,0,559 ,5 ,564 ,783 ,0,3,1,3,0,1,0,76.14,72.03 ,33.33
03,012,01,024,0427,0,418 ,2 ,420 ,644 ,0,3,1,3,0,1,0,76.14,65.22 ,33.33
03,012,01,024,0428,0,334 ,2 ,336 ,497 ,0,3,1,3,0,1,0,76.14,67.61 ,33.33
03,012,01,024,0429,0,814 ,4 ,818 ,1158 ,0,3,1,3,0,1,0,76.14,70.64 ,33.33
03,012,01,024,0430,0,663 ,1 ,664 ,981 ,0,3,1,3,0,1,0,76.14,67.69 ,33.33
03,012,01,024,0431,0,323 ,1 ,324 ,505 ,0,3,1,3,0,1,0,76.14,64.16 ,33.33
03,012,01,024,0432,0,462 ,3 ,465 ,676 ,0,3,1,3,0,1,0,76.14,68.79 ,33.33
03,012,01,024,0433,0,457 ,3 ,460 ,693 ,0,3,1,3,0,1,0,76.14,66.38 ,33.33
03,012,01,024,0434,0,419 ,8 ,427 ,622 ,0,3,1,3,0,1,0,76.14,68.65 ,33.33
03,012,01,025,0435,0,23 ,0 ,23 ,58 ,0,3,1,3,0,1,0,76.14,39.66 ,33.33
03,012,01,025,0436,0,11 ,0 ,11 ,23 ,0,3,1,3,0,1,0,76.14,47.83 ,33.33
03,012,01,025,0437,0,9 ,0 ,9 ,25 ,0,3,1,3,0,1,0,76.14,36.00 ,33.33
03,012,01,026,0438,0,19 ,0 ,19 ,42 ,0,3,1,3,0,1,0,76.14,45.24 ,33.33
03,012,01,026,0439,0,43 ,0 ,43 ,86 ,0,3,1,3,0,1,0,76.14,50.00 ,33.33
03,012,01,026,0440,0,24 ,0 ,24 ,59 ,0,3,1,3,0,1,0,76.14,40.68 ,33.33
03,012,01,026,0441,0,44 ,0 ,44 ,107 ,0,3,1,3,0,1,0,76.14,41.12 ,33.33
03,012,01,026,0442,0,6 ,2 ,8 ,18 ,0,3,1,3,0,1,0,76.14,44.44 ,33.33
03,012,01,026,0443,0,8 ,0 ,8 ,15 ,0,3,1,3,0,1,0,76.14,53.33 ,33.33
03,012,01,026,0444,0,4 ,0 ,4 ,10 ,0,3,1,3,0,1,0,76.14,40.00 ,33.33
03,012,01,026,0445,0,11 ,0 ,11 ,19 ,0,3,1,3,0,1,0,76.14,57.89 ,33.33
03,012,01,027,0446,0,61 ,0 ,61 ,187 ,0,3,1,3,0,1,0,76.14,32.62 ,33.33
03,012,01,027,0447,0,14 ,1 ,15 ,45 ,0,3,1,3,0,1,0,76.14,33.33 ,33.33
03,012,01,027,0448,0,55 ,1 ,56 ,98 ,0,3,1,3,0,1,0,76.14,57.14 ,33.33
03,013,01,001,0001,0,946 ,2 ,948 ,1465 ,0,3,1,3,0,1,0,76.14,64.71 ,33.33
03,013,01,001,0002,0,932 ,1 ,933 ,1470 ,0,3,1,3,0,1,0,76.14,63.47 ,33.33
03,013,01,001,0003,0,668 ,5 ,673 ,1058 ,0,3,1,3,0,1,0,76.14,63.61 ,33.33
03,013,01,001,0004,0,1702 ,9 ,1711 ,2792 ,0,3,1,3,0,1,0,76.14,61.28 ,33.33
03,013,01,001,0005,0,918 ,4 ,922 ,1456 ,0,3,1,3,0,1,0,76.14,63.32 ,33.33
03,013,01,001,0006,0,558 ,0 ,558 ,845 ,0,3,1,3,0,1,0,76.14,66.04 ,33.33
03,013,01,001,0007,0,923 ,5 ,928 ,1387 ,0,3,1,3,0,1,0,76.14,66.91 ,33.33
03,013,01,001,0008,0,892 ,3 ,895 ,1391 ,0,3,1,3,0,1,0,76.14,64.34 ,33.33
03,013,01,001,0009,0,762 ,3 ,765 ,1283 ,0,3,1,3,0,1,0,76.14,59.63 ,33.33
03,013,01,001,0010,0,897 ,2 ,899 ,1560 ,0,3,1,3,0,1,0,76.14,57.63 ,33.33
03,013,01,001,0011,0,574 ,5 ,579 ,909 ,0,3,1,3,0,1,0,76.14,63.70 ,33.33
03,013,01,001,0012,0,5176 ,31 ,5207 ,8622 ,0,3,1,3,0,1,0,76.14,60.39 ,33.33
03,013,01,001,0013,0,2399 ,12 ,2411 ,3920 ,0,3,1,3,0,1,0,76.14,61.5051020408,33.33
03,013,01,001,0014,0,1516 ,5 ,1521 ,2396 ,0,3,1,3,0,1,0,76.14,63.48 ,33.33
03,013,01,001,0015,0,2297 ,16 ,2313 ,3601 ,0,3,1,3,0,1,0,76.14,64.23 ,33.33
03,013,01,001,0016,0,1217 ,3 ,1220 ,2048 ,0,3,1,3,0,1,0,76.14,59.57 ,33.33
03,013,01,001,0017,0,3779 ,34 ,3813 ,6437 ,0,3,1,3,0,1,0,76.14,59.24 ,33.33
03,013,01,001,0018,0,651 ,1 ,652 ,993 ,0,3,1,3,0,1,0,76.14,65.66 ,33.33
03,013,01,001,0019,0,914 ,7 ,921 ,1390 ,0,3,1,3,0,1,0,76.14,66.2589928058,33.33
03,013,01,001,0020,0,689 ,3 ,692 ,1113 ,0,3,1,3,0,1,0,76.14,62.1743036837,33.33
03,013,01,001,0021,0,1775 ,5 ,1780 ,3020 ,0,3,1,3,0,1,0,76.14,58.94 ,33.33
03,013,01,001,0022,0,4213 ,21 ,4234 ,7091 ,0,3,1,3,0,1,0,76.14,59.709490904,33.33
03,013,01,001,0023,0,856 ,4 ,860 ,1316 ,0,3,1,3,0,1,0,76.14,65.3495440729,33.33
03,013,01,001,0024,0,769 ,3 ,772 ,1230 ,0,3,1,3,0,1,0,76.14,62.7642276423,33.33
03,013,01,001,0025,0,897 ,5 ,902 ,1382 ,0,3,1,3,0,1,0,76.14,65.27 ,33.33
03,013,01,001,0026,0,1255 ,8 ,1263 ,1976 ,0,3,1,3,0,1,0,76.14,63.92 ,33.33
03,013,01,001,0027,0,731 ,2 ,733 ,1134 ,0,3,1,3,0,1,0,76.14,64.64 ,33.33
03,013,01,001,0028,0,1194 ,11 ,1205 ,1939 ,0,3,1,3,0,1,0,76.14,62.15 ,33.33
03,013,01,001,0029,0,1758 ,12 ,1770 ,2780 ,0,3,1,3,0,1,0,76.14,63.67 ,33.33
03,013,01,001,0030,0,733 ,3 ,736 ,1119 ,0,3,1,3,0,1,0,76.14,65.77 ,33.33
03,013,01,001,0031,0,1428 ,8 ,1436 ,2223 ,0,3,1,3,0,1,0,76.14,64.5973909132,33.33
03,013,01,001,0032,0,1033 ,11 ,1044 ,1465 ,0,3,1,3,0,1,0,76.14,71.26 ,33.33
03,013,01,001,0033,0,2890 ,22 ,2912 ,4722 ,0,3,1,3,0,1,0,76.14,61.67 ,33.33
03,013,01,001,0034,0,328 ,1 ,329 ,526 ,0,3,1,3,0,1,0,76.14,62.55 ,33.33
03,013,01,001,0035,0,741 ,1 ,742 ,1038 ,0,3,1,3,0,1,0,76.14,71.48 ,33.33
03,013,01,001,0036,0,1030 ,12 ,1042 ,1559 ,0,3,1,3,0,1,0,76.14,66.84 ,33.33
03,013,01,001,0037,0,1492 ,12 ,1504 ,2388 ,0,3,1,3,0,1,0,76.14,62.98 ,33.33
03,013,01,001,0038,0,914 ,5 ,919 ,1359 ,0,3,1,3,0,1,0,76.14,67.62 ,33.33
03,013,01,001,0039,0,996 ,6 ,1002 ,1716 ,0,3,1,3,0,1,0,76.14,58.39 ,33.33
03,013,01,001,0040,0,494 ,3 ,497 ,771 ,0,3,1,3,0,1,0,76.14,64.46 ,33.33
03,013,01,001,0041,0,1846 ,4 ,1850 ,3020 ,0,3,1,3,0,1,0,76.14,61.26 ,33.33
03,013,01,001,0042,0,1055 ,8 ,1063 ,1778 ,0,3,1,3,0,1,0,76.14,59.79 ,33.33
03,013,01,001,0043,0,448 ,5 ,453 ,740 ,0,3,1,3,0,1,0,76.14,61.2162162162,33.33
03,013,01,001,0044,0,3895 ,25 ,3920 ,6655 ,0,3,1,3,0,1,0,76.14,58.9030803907,33.33
03,013,01,001,0045,0,4742 ,30 ,4772 ,7860 ,0,3,1,3,0,1,0,76.14,60.71 ,33.33
03,013,01,001,0046,0,4397 ,21 ,4418 ,7856 ,0,3,1,3,0,1,0,76.14,56.24 ,33.33
03,013,01,001,0047,0,1352 ,8 ,1360 ,2297 ,0,3,1,3,0,1,0,76.14,59.21 ,33.33
03,013,01,001,0048,0,994 ,4 ,998 ,1548 ,0,3,1,3,0,1,0,76.14,64.47 ,33.33
03,013,01,001,0049,0,1282 ,6 ,1288 ,1982 ,0,3,1,3,0,1,0,76.14,64.98 ,33.33
03,013,01,001,0050,0,2599 ,13 ,2612 ,4663 ,0,3,1,3,0,1,0,76.14,56.02 ,33.33
03,013,01,001,0051,0,1314 ,6 ,1320 ,2066 ,0,3,1,3,0,1,0,76.14,63.89 ,33.33
03,013,01,001,0052,0,2932 ,13 ,2945 ,4666 ,0,3,1,3,0,1,0,76.14,63.1161594514,33.33
03,013,01,001,0053,0,1701 ,7 ,1708 ,2717 ,0,3,1,3,0,1,0,76.14,62.86 ,33.33
03,013,01,001,0054,0,861 ,3 ,864 ,1258 ,0,3,1,3,0,1,0,76.14,68.68 ,33.33
03,013,01,001,0055,0,581 ,4 ,585 ,851 ,0,3,1,3,0,1,0,76.14,68.74 ,33.33
03,013,01,001,0056,0,657 ,4 ,661 ,1000 ,0,3,1,3,0,1,0,76.14,66.10 ,33.33
03,013,01,001,0057,0,3266 ,17 ,3283 ,5523 ,0,3,1,3,0,1,0,76.14,59.44 ,33.33
03,013,01,001,0058,0,1520 ,8 ,1528 ,2364 ,0,3,1,3,0,1,0,76.14,64.6362098139,33.33
03,013,01,001,0059,0,2049 ,6 ,2055 ,3478 ,0,3,1,3,0,1,0,76.14,59.09 ,33.33
03,013,01,001,0060,0,574 ,6 ,580 ,936 ,0,3,1,3,0,1,0,76.14,61.97 ,33.33
03,013,01,001,0061,0,1093 ,5 ,1098 ,1750 ,0,3,1,3,0,1,0,76.14,62.74 ,33.33
03,013,01,001,0062,0,953 ,7 ,960 ,1470 ,0,3,1,3,0,1,0,76.14,65.31 ,33.33
03,013,01,001,0063,0,616 ,1 ,617 ,933 ,0,3,1,3,0,1,0,76.14,66.13 ,33.33
03,013,01,001,0064,0,1362 ,10 ,1372 ,2286 ,0,3,1,3,0,1,0,76.14,60.0174978128,33.33
03,013,01,002,0065,0,393 ,4 ,397 ,587 ,0,3,1,3,0,1,0,76.14,67.6320272572,33.33
03,013,01,002,0066,0,2283 ,10 ,2293 ,4020 ,0,3,1,3,0,1,0,76.14,57.04 ,33.33
03,013,01,002,0067,0,497 ,1 ,498 ,709 ,0,3,1,3,0,1,0,76.14,70.24 ,33.33
03,013,01,002,0068,0,723 ,2 ,725 ,1137 ,0,3,1,3,0,1,0,76.14,63.76 ,33.33
03,013,01,002,0069,0,863 ,6 ,869 ,1431 ,0,3,1,3,0,1,0,76.14,60.73 ,33.33
03,013,01,002,0070,0,540 ,1 ,541 ,813 ,0,3,1,3,0,1,0,76.14,66.54 ,33.33
03,013,01,002,0071,0,2568 ,10 ,2578 ,4276 ,0,3,1,3,0,1,0,76.14,60.29 ,33.33
03,013,01,002,0072,0,3302 ,16 ,3318 ,5447 ,0,3,1,3,0,1,0,76.14,60.91 ,33.33
03,013,01,002,0073,0,1085 ,8 ,1093 ,1832 ,0,3,1,3,0,1,0,76.14,59.66 ,33.33
03,013,01,002,0074,0,712 ,4 ,716 ,1197 ,0,3,1,3,0,1,0,76.14,59.82 ,33.33
03,013,01,002,0075,0,1073 ,6 ,1079 ,1821 ,0,3,1,3,0,1,0,76.14,59.2531576057,33.33
03,013,01,002,0076,0,1223 ,7 ,1230 ,2058 ,0,3,1,3,0,1,0,76.14,59.7667638484,33.33
03,013,01,002,0077,0,3024 ,21 ,3045 ,5200 ,0,3,1,3,0,1,0,76.14,58.5576923077,33.33
03,013,01,002,0078,0,812 ,3 ,815 ,1381 ,0,3,1,3,0,1,0,76.14,59.0152063722,33.33
03,013,01,002,0079,0,765 ,7 ,772 ,1300 ,0,3,1,3,0,1,0,76.14,59.38 ,33.33
03,013,01,002,0080,0,508 ,5 ,513 ,864 ,0,3,1,3,0,1,0,76.14,59.38 ,33.33
03,013,01,002,0081,0,327 ,4 ,331 ,580 ,0,3,1,3,0,1,0,76.14,57.07 ,33.33
03,013,01,002,0082,0,882 ,3 ,885 ,1586 ,0,3,1,3,0,1,0,76.14,55.80 ,33.33
03,013,01,002,0083,0,1018 ,7 ,1025 ,1523 ,0,3,1,3,0,1,0,76.14,67.30 ,33.33
03,013,01,002,0084,0,1228 ,10 ,1238 ,1895 ,0,3,1,3,0,1,0,76.14,65.33 ,33.33
03,013,01,002,0085,0,941 ,11 ,952 ,1584 ,0,3,1,3,0,1,0,76.14,60.101010101,33.33
03,013,01,003,0086,0,1403 ,10 ,1413 ,2294 ,0,3,1,3,0,1,0,76.14,61.5954664342,33.33
03,013,01,003,0087,0,344 ,0 ,344 ,564 ,0,3,1,3,0,1,0,76.14,60.99 ,33.33
03,013,01,003,0088,0,301 ,0 ,301 ,454 ,0,3,1,3,0,1,0,76.14,66.30 ,33.33
03,013,01,003,0089,0,461 ,6 ,467 ,760 ,0,3,1,3,0,1,0,76.14,61.45 ,33.33
03,013,01,003,0090,0,324 ,2 ,326 ,533 ,0,3,1,3,0,1,0,76.14,61.16 ,33.33
03,013,01,003,0091,0,3511 ,29 ,3540 ,6073 ,0,3,1,3,0,1,0,76.14,58.29 ,33.33
03,013,01,003,0092,0,513 ,0 ,513 ,731 ,0,3,1,3,0,1,0,76.14,70.18 ,33.33
03,013,01,003,0093,0,462 ,5 ,467 ,814 ,0,3,1,3,0,1,0,76.14,57.37 ,33.33
03,013,01,003,0094,0,1087 ,6 ,1093 ,1879 ,0,3,1,3,0,1,0,76.14,58.17 ,33.33
03,013,01,003,0095,0,515 ,0 ,515 ,898 ,0,3,1,3,0,1,0,76.14,57.35 ,33.33
03,013,01,003,0096,0,856 ,9 ,865 ,1340 ,0,3,1,3,0,1,0,76.14,64.55 ,33.33
03,013,01,003,0097,0,412 ,0 ,412 ,724 ,0,3,1,3,0,1,0,76.14,56.91 ,33.33
03,013,01,003,0098,0,698 ,2 ,700 ,1336 ,0,3,1,3,0,1,0,76.14,52.40 ,33.33
03,013,01,003,0099,0,1044 ,7 ,1051 ,1932 ,0,3,1,3,0,1,0,76.14,54.40 ,33.33
03,013,01,003,0100,0,1446 ,4 ,1450 ,2638 ,0,3,1,3,0,1,0,76.14,54.97 ,33.33
03,013,01,003,0101,0,903 ,4 ,907 ,1598 ,0,3,1,3,0,1,0,76.14,56.76 ,33.33
03,013,01,003,0102,0,1120 ,6 ,1126 ,1786 ,0,3,1,3,0,1,0,76.14,63.05 ,33.33
03,013,01,003,0103,0,2127 ,5 ,2132 ,4003 ,0,3,1,3,0,1,0,76.14,53.26 ,33.33
03,013,01,003,0104,0,1145 ,6 ,1151 ,1825 ,0,3,1,3,0,1,0,76.14,63.07 ,33.33
03,013,01,003,0105,0,1005 ,7 ,1012 ,1608 ,0,3,1,3,0,1,0,76.14,62.94 ,33.33
03,013,01,003,0106,0,616 ,5 ,621 ,911 ,0,3,1,3,0,1,0,76.14,68.1668496158,33.33
03,013,01,003,0107,0,461 ,2 ,463 ,736 ,0,3,1,3,0,1,0,76.14,62.9076086957,33.33
03,013,01,003,0108,0,189 ,0 ,189 ,304 ,0,3,1,3,0,1,0,76.14,62.17 ,33.33
03,013,01,004,0109,0,587 ,5 ,592 ,976 ,0,3,1,3,0,1,0,76.14,60.66 ,33.33
03,013,01,004,0110,0,1127 ,13 ,1140 ,1977 ,0,3,1,3,0,1,0,76.14,57.66 ,33.33
03,013,01,004,0111,0,622 ,3 ,625 ,1087 ,0,3,1,3,0,1,0,76.14,57.50 ,33.33
03,013,01,004,0112,0,1832 ,18 ,1850 ,3459 ,0,3,1,3,0,1,0,76.14,53.4836657994,33.33
03,013,01,004,0113,0,1400 ,13 ,1413 ,2637 ,0,3,1,3,0,1,0,76.14,53.58 ,33.33
03,013,01,004,0114,0,408 ,8 ,416 ,770 ,0,3,1,3,0,1,0,76.14,54.03 ,33.33
03,013,01,004,0115,0,271 ,6 ,277 ,476 ,0,3,1,3,0,1,0,76.14,58.19 ,33.33
03,013,01,004,0116,0,245 ,3 ,248 ,466 ,0,3,1,3,0,1,0,76.14,53.22 ,33.33
03,013,01,004,0117,0,497 ,3 ,500 ,916 ,0,3,1,3,0,1,0,76.14,54.59 ,33.33
03,013,01,004,0118,0,440 ,6 ,446 ,727 ,0,3,1,3,0,1,0,76.14,61.35 ,33.33
03,013,01,004,0119,0,568 ,5 ,573 ,982 ,0,3,1,3,0,1,0,76.14,58.350305499,33.33
03,013,01,004,0120,0,836 ,4 ,840 ,1509 ,0,3,1,3,0,1,0,76.14,55.67 ,33.33
03,013,01,004,0121,0,1018 ,7 ,1025 ,1863 ,0,3,1,3,0,1,0,76.14,55.02 ,33.33
03,013,01,004,0122,0,739 ,5 ,744 ,1354 ,0,3,1,3,0,1,0,76.14,54.95 ,33.33
03,013,01,004,0123,0,769 ,6 ,775 ,1367 ,0,3,1,3,0,1,0,76.14,56.69 ,33.33
03,013,01,004,0124,0,777 ,6 ,783 ,1218 ,0,3,1,3,0,1,0,76.14,64.29 ,33.33
03,013,01,004,0125,0,598 ,7 ,605 ,1023 ,0,3,1,3,0,1,0,76.14,59.14 ,33.33
03,013,01,005,0126,0,1014 ,4 ,1018 ,1434 ,0,3,1,3,0,1,0,76.14,70.99 ,33.33
03,013,01,005,0127,0,1344 ,11 ,1355 ,1841 ,0,3,1,3,0,1,0,76.14,73.60 ,33.33
03,013,01,005,0128,0,1305 ,10 ,1315 ,1857 ,0,3,1,3,0,1,0,76.14,70.81 ,33.33
03,013,01,005,0129,0,388 ,1 ,389 ,527 ,0,3,1,3,0,1,0,76.14,73.81 ,33.33
03,013,01,005,0130,0,870 ,10 ,880 ,1123 ,0,3,1,3,0,1,0,76.14,78.36 ,33.33
03,013,01,005,0131,0,565 ,2 ,567 ,816 ,0,3,1,3,0,1,0,76.14,69.49 ,33.33
03,013,01,005,0132,0,270 ,4 ,274 ,364 ,0,3,1,3,0,1,0,76.14,75.27 ,33.33
03,013,01,005,0133,0,548 ,2 ,550 ,778 ,0,3,1,3,0,1,0,76.14,70.69 ,33.33
03,013,01,005,0134,0,2262 ,18 ,2280 ,3302 ,0,3,1,3,0,1,0,76.14,69.049061175,33.33
03,013,01,005,0135,0,365 ,0 ,365 ,500 ,0,3,1,3,0,1,0,76.14,73,33.33
03,013,01,005,0136,0,386 ,3 ,389 ,548 ,0,3,1,3,0,1,0,76.14,70.99 ,33.33
03,013,01,005,0137,0,903 ,8 ,911 ,1265 ,0,3,1,3,0,1,0,76.14,72.02 ,33.33
03,013,01,005,0138,0,1376 ,17 ,1393 ,2065 ,0,3,1,3,0,1,0,76.14,67.4576271186,33.33
03,013,01,005,0139,0,1156 ,10 ,1166 ,1735 ,0,3,1,3,0,1,0,76.14,67.20 ,33.33
03,013,01,005,0140,0,966 ,6 ,972 ,1506 ,0,3,1,3,0,1,0,76.14,64.54 ,33.33
03,013,01,005,0141,0,972 ,3 ,975 ,1400 ,0,3,1,3,0,1,0,76.14,69.64 ,33.33
03,013,01,005,0142,0,628 ,2 ,630 ,895 ,0,3,1,3,0,1,0,76.14,70.39 ,33.33
03,013,01,005,0143,0,1149 ,6 ,1155 ,1685 ,0,3,1,3,0,1,0,76.14,68.55 ,33.33
03,013,01,005,0144,0,1135 ,9 ,1144 ,1604 ,0,3,1,3,0,1,0,76.14,71.32 ,33.33
03,013,01,005,0145,0,978 ,6 ,984 ,1397 ,0,3,1,3,0,1,0,76.14,70.44 ,33.33
03,013,01,005,0146,0,783 ,3 ,786 ,995 ,0,3,1,3,0,1,0,76.14,78.99 ,33.33
03,013,01,005,0147,0,909 ,5 ,914 ,1267 ,0,3,1,3,0,1,0,76.14,72.14 ,33.33
03,013,01,005,0148,0,526 ,3 ,529 ,678 ,0,3,1,3,0,1,0,76.14,78.0235988201,33.33
03,013,01,005,0149,0,816 ,8 ,824 ,1107 ,0,3,1,3,0,1,0,76.14,74.4354110208,33.33
03,013,01,005,0150,0,946 ,4 ,950 ,1233 ,0,3,1,3,0,1,0,76.14,77.05 ,33.33
03,013,01,005,0151,0,693 ,7 ,700 ,919 ,0,3,1,3,0,1,0,76.14,76.17 ,33.33
03,013,01,005,0152,0,1313 ,4 ,1317 ,1805 ,0,3,1,3,0,1,0,76.14,72.96 ,33.33
03,013,01,005,0153,0,1015 ,6 ,1021 ,1493 ,0,3,1,3,0,1,0,76.14,68.39 ,33.33
03,013,01,005,0154,0,944 ,6 ,950 ,1452 ,0,3,1,3,0,1,0,76.14,65.43 ,33.33
03,013,01,005,0155,0,1358 ,7 ,1365 ,1994 ,0,3,1,3,0,1,0,76.14,68.46 ,33.33
03,013,01,006,0156,0,1409 ,8 ,1417 ,2263 ,0,3,1,3,0,1,0,76.14,62.62 ,33.33
03,013,01,006,0157,0,1746 ,10 ,1756 ,2819 ,0,3,1,3,0,1,0,76.14,62.29 ,33.33
03,013,01,006,0158,0,1058 ,6 ,1064 ,1524 ,0,3,1,3,0,1,0,76.14,69.82 ,33.33
03,013,01,006,0159,0,1193 ,3 ,1196 ,1907 ,0,3,1,3,0,1,0,76.14,62.72 ,33.33
03,013,01,006,0160,0,682 ,3 ,685 ,968 ,0,3,1,3,0,1,0,76.14,70.76 ,33.33
03,013,01,006,0161,0,1014 ,7 ,1021 ,1447 ,0,3,1,3,0,1,0,76.14,70.56 ,33.33
03,013,01,006,0162,0,713 ,9 ,722 ,1042 ,0,3,1,3,0,1,0,76.14,69.29 ,33.33
03,013,01,006,0163,0,526 ,2 ,528 ,777 ,0,3,1,3,0,1,0,76.14,67.95 ,33.33
03,013,01,006,0164,0,941 ,3 ,944 ,1445 ,0,3,1,3,0,1,0,76.14,65.33 ,33.33
03,013,01,006,0165,0,635 ,4 ,639 ,880 ,0,3,1,3,0,1,0,76.14,72.61 ,33.33
03,013,01,006,0166,0,732 ,6 ,738 ,1124 ,0,3,1,3,0,1,0,76.14,65.66 ,33.33
03,013,01,006,0167,0,783 ,8 ,791 ,1321 ,0,3,1,3,0,1,0,76.14,59.88 ,33.33
03,013,01,006,0168,0,1024 ,3 ,1027 ,1707 ,0,3,1,3,0,1,0,76.14,60.16 ,33.33
03,013,01,006,0169,0,729 ,4 ,733 ,1079 ,0,3,1,3,0,1,0,76.14,67.93 ,33.33
03,013,01,006,0170,0,1371 ,11 ,1382 ,2232 ,0,3,1,3,0,1,0,76.14,61.917562724,33.33
03,013,01,006,0171,0,318 ,2 ,320 ,498 ,0,3,1,3,0,1,0,76.14,64.2570281124,33.33
03,013,01,007,0172,0,1242 ,10 ,1252 ,1809 ,0,3,1,3,0,1,0,76.14,69.21 ,33.33
03,013,01,007,0173,0,568 ,1 ,569 ,827 ,0,3,1,3,0,1,0,76.14,68.80 ,33.33
03,013,01,007,0174,0,1079 ,7 ,1086 ,1572 ,0,3,1,3,0,1,0,76.14,69.08 ,33.33
03,013,01,007,0175,0,1475 ,4 ,1479 ,2283 ,0,3,1,3,0,1,0,76.14,64.7831800263,33.33
03,013,01,007,0176,0,765 ,9 ,774 ,1112 ,0,3,1,3,0,1,0,76.14,69.60 ,33.33
03,013,01,007,0177,0,574 ,2 ,576 ,843 ,0,3,1,3,0,1,0,76.14,68.33 ,33.33
03,013,01,007,0178,0,474 ,2 ,476 ,684 ,0,3,1,3,0,1,0,76.14,69.59 ,33.33
03,013,01,008,0179,0,1089 ,7 ,1096 ,1553 ,0,3,1,3,0,1,0,76.14,70.57 ,33.33
03,013,01,008,0180,0,885 ,1 ,886 ,1278 ,0,3,1,3,0,1,0,76.14,69.33 ,33.33
03,013,01,008,0181,0,964 ,6 ,970 ,1419 ,0,3,1,3,0,1,0,76.14,68.36 ,33.33
03,013,01,008,0182,0,691 ,5 ,696 ,1037 ,0,3,1,3,0,1,0,76.14,67.1166827387,33.33
03,013,01,008,0183,0,878 ,7 ,885 ,1235 ,0,3,1,3,0,1,0,76.14,71.6599190283,33.33
03,013,01,008,0184,0,958 ,2 ,960 ,1452 ,0,3,1,3,0,1,0,76.14,66.1157024793,33.33
03,013,01,008,0185,0,2386 ,14 ,2400 ,3629 ,0,3,1,3,0,1,0,76.14,66.1339211904,33.33
03,013,01,008,0186,0,959 ,3 ,962 ,1422 ,0,3,1,3,0,1,0,76.14,67.6511954993,33.33
03,013,01,008,0187,0,931 ,8 ,939 ,1252 ,0,3,1,3,0,1,0,76.14,75,33.33
03,013,01,008,0188,0,1262 ,8 ,1270 ,1692 ,0,3,1,3,0,1,0,76.14,75.0591016548,33.33
03,013,01,008,0189,0,955 ,5 ,960 ,1317 ,0,3,1,3,0,1,0,76.14,72.8929384966,33.33
03,013,01,009,0190,0,1376 ,9 ,1385 ,2206 ,0,3,1,3,0,1,0,76.14,62.783318223,33.33
03,013,01,009,0191,0,947 ,6 ,953 ,1394 ,0,3,1,3,0,1,0,76.14,68.3644189383,33.33
03,013,01,009,0192,0,983 ,7 ,990 ,1384 ,0,3,1,3,0,1,0,76.14,71.5317919075,33.33
03,013,01,009,0193,0,800 ,7 ,807 ,1125 ,0,3,1,3,0,1,0,76.14,71.7333333333,33.33
03,013,01,009,0194,0,517 ,5 ,522 ,790 ,0,3,1,3,0,1,0,76.14,66.0759493671,33.33
03,013,01,009,0195,0,744 ,3 ,747 ,1198 ,0,3,1,3,0,1,0,76.14,62.3539232053,33.33
03,013,01,009,0196,0,1079 ,12 ,1091 ,1729 ,0,3,1,3,0,1,0,76.14,63.1000578369,33.33
03,013,01,009,0197,0,863 ,2 ,865 ,1214 ,0,3,1,3,0,1,0,76.14,71.2520593081,33.33
03,013,01,009,0198,0,1138 ,5 ,1143 ,1575 ,0,3,1,3,0,1,0,76.14,72.5714285714,33.33
03,013,01,009,0199,0,1630 ,6 ,1636 ,2317 ,0,3,1,3,0,1,0,76.14,70.608545533,33.33
03,013,01,009,0200,0,1355 ,21 ,1376 ,1955 ,0,3,1,3,0,1,0,76.14,70.3836317136,33.33
03,013,01,009,0201,0,1167 ,12 ,1179 ,1741 ,0,3,1,3,0,1,0,76.14,67.7197013211,33.33
03,013,01,009,0202,0,530 ,4 ,534 ,823 ,0,3,1,3,0,1,0,76.14,64.8845686513,33.33
03,013,01,009,0203,0,310 ,2 ,312 ,453 ,0,3,1,3,0,1,0,76.14,68.8741721854,33.33
03,013,01,010,0204,0,1187 ,3 ,1190 ,1758 ,0,3,1,3,0,1,0,76.14,67.6905574516,33.33
03,013,01,010,0205,0,1471 ,13 ,1484 ,2284 ,0,3,1,3,0,1,0,76.14,64.9737302977,33.33
03,013,01,010,0206,0,1043 ,7 ,1050 ,1628 ,0,3,1,3,0,1,0,76.14,64.4963144963,33.33
03,013,01,010,0207,0,652 ,5 ,657 ,908 ,0,3,1,3,0,1,0,76.14,72.3568281938,33.33
03,013,01,010,0208,0,1745 ,18 ,1763 ,2699 ,0,3,1,3,0,1,0,76.14,65.32048907,33.33
03,013,01,010,0209,0,1126 ,13 ,1139 ,1851 ,0,3,1,3,0,1,0,76.14,61.5343057807,33.33
03,013,01,010,0210,0,549 ,5 ,554 ,864 ,0,3,1,3,0,1,0,76.14,64.1203703704,33.33
03,013,01,010,0211,0,1757 ,16 ,1773 ,2907 ,0,3,1,3,0,1,0,76.14,60.9907120743,33.33
03,013,01,010,0212,0,1704 ,7 ,1711 ,2964 ,0,3,1,3,0,1,0,76.14,57.7260458839,33.33
03,013,01,010,0213,0,650 ,4 ,654 ,971 ,0,3,1,3,0,1,0,76.14,67.3532440783,33.33
03,013,01,010,0214,0,913 ,9 ,922 ,1483 ,0,3,1,3,0,1,0,76.14,62.1712744437,33.33
03,013,01,010,0215,0,376 ,7 ,383 ,556 ,0,3,1,3,0,1,0,76.14,68.8848920863,33.33
03,013,01,011,0216,0,1307 ,8 ,1315 ,2152 ,0,3,1,3,0,1,0,76.14,61.1059479554,33.33
03,013,01,011,0217,0,896 ,3 ,899 ,1360 ,0,3,1,3,0,1,0,76.14,66.1029411765,33.33
03,013,01,011,0218,0,551 ,5 ,556 ,819 ,0,3,1,3,0,1,0,76.14,67.8876678877,33.33
03,013,01,011,0219,0,400 ,2 ,402 ,612 ,0,3,1,3,0,1,0,76.14,65.6862745098,33.33
03,013,01,011,0220,0,657 ,3 ,660 ,1019 ,0,3,1,3,0,1,0,76.14,64.7693817468,33.33
03,013,01,011,0221,0,716 ,5 ,721 ,1156 ,0,3,1,3,0,1,0,76.14,62.3702422145,33.33
03,013,01,011,0222,0,405 ,4 ,409 ,673 ,0,3,1,3,0,1,0,76.14,60.7726597325,33.33
03,013,01,011,0223,0,506 ,6 ,512 ,806 ,0,3,1,3,0,1,0,76.14,63.523573201,33.33
03,013,01,011,0224,0,454 ,1 ,455 ,712 ,0,3,1,3,0,1,0,76.14,63.904494382,33.33
03,013,01,011,0225,0,774 ,1 ,775 ,1313 ,0,3,1,3,0,1,0,76.14,59.0251332826,33.33
03,013,01,011,0226,0,876 ,4 ,880 ,1547 ,0,3,1,3,0,1,0,76.14,56.8842921784,33.33
03,013,01,011,0227,0,1167 ,14 ,1181 ,1948 ,0,3,1,3,0,1,0,76.14,60.6262833676,33.33
03,013,01,011,0228,0,786 ,4 ,790 ,1248 ,0,3,1,3,0,1,0,76.14,63.3012820513,33.33
03,013,01,011,0229,0,590 ,1 ,591 ,939 ,0,3,1,3,0,1,0,76.14,62.9392971246,33.33
03,013,01,011,0230,0,695 ,5 ,700 ,1047 ,0,3,1,3,0,1,0,76.14,66.8576886342,33.33
03,013,01,011,0231,0,687 ,6 ,693 ,1027 ,0,3,1,3,0,1,0,76.14,67.4780915287,33.33
03,013,01,011,0232,0,726 ,5 ,731 ,1104 ,0,3,1,3,0,1,0,76.14,66.2137681159,33.33
03,013,01,011,0233,0,875 ,9 ,884 ,1330 ,0,3,1,3,0,1,0,76.14,66.4661654135,33.33
03,013,01,011,0234,0,926 ,2 ,928 ,1471 ,0,3,1,3,0,1,0,76.14,63.086335826,33.33
03,013,01,012,0235,0,828 ,3 ,831 ,1251 ,0,3,1,3,0,1,0,76.14,66.4268585132,33.33
03,013,01,012,0236,0,539 ,1 ,540 ,783 ,0,3,1,3,0,1,0,76.14,68.9655172414,33.33
03,013,01,012,0237,0,924 ,6 ,930 ,1440 ,0,3,1,3,0,1,0,76.14,64.5833333333,33.33
03,013,01,012,0238,0,595 ,5 ,600 ,903 ,0,3,1,3,0,1,0,76.14,66.4451827243,33.33
03,013,01,012,0239,0,347 ,2 ,349 ,523 ,0,3,1,3,0,1,0,76.14,66.7304015296,33.33
03,013,01,012,0240,0,809 ,10 ,819 ,1232 ,0,3,1,3,0,1,0,76.14,66.4772727273,33.33
03,013,01,012,0241,0,833 ,9 ,842 ,1142 ,0,3,1,3,0,1,0,76.14,73.7302977233,33.33
03,013,01,012,0242,0,898 ,4 ,902 ,1334 ,0,3,1,3,0,1,0,76.14,67.616191904,33.33
03,013,01,012,0243,0,938 ,15 ,953 ,1651 ,0,3,1,3,0,1,0,76.14,57.7225923683,33.33
03,013,01,012,0244,0,1182 ,17 ,1199 ,1905 ,0,3,1,3,0,1,0,76.14,62.9396325459,33.33
03,013,01,012,0245,0,1020 ,3 ,1023 ,1566 ,0,3,1,3,0,1,0,76.14,65.3256704981,33.33
03,013,01,012,0246,0,1065 ,9 ,1074 ,1476 ,0,3,1,3,0,1,0,76.14,72.7642276423,33.33
03,013,01,012,0247,0,669 ,8 ,677 ,1063 ,0,3,1,3,0,1,0,76.14,63.6876763876,33.33
03,013,01,012,0248,0,715 ,4 ,719 ,1170 ,0,3,1,3,0,1,0,76.14,61.452991453,33.33
03,013,01,013,0249,0,2028 ,14 ,2042 ,3268 ,0,3,1,3,0,1,0,76.14,62.4847001224,33.33
03,013,01,013,0250,0,1648 ,9 ,1657 ,2743 ,0,3,1,3,0,1,0,76.14,60.4083120671,33.33
03,013,01,013,0251,0,916 ,6 ,922 ,1314 ,0,3,1,3,0,1,0,76.14,70.1674277017,33.33
03,013,01,013,0252,0,394 ,3 ,397 ,592 ,0,3,1,3,0,1,0,76.14,67.0608108108,33.33
03,013,01,013,0253,0,1331 ,8 ,1339 ,2111 ,0,3,1,3,0,1,0,76.14,63.4296541923,33.33
03,013,01,013,0254,0,1255 ,4 ,1259 ,1994 ,0,3,1,3,0,1,0,76.14,63.1394182548,33.33
03,013,01,013,0255,0,2572 ,15 ,2587 ,4044 ,0,3,1,3,0,1,0,76.14,63.9713155292,33.33
03,013,01,013,0256,0,1480 ,11 ,1491 ,2458 ,0,3,1,3,0,1,0,76.14,60.6590724166,33.33
03,013,01,013,0257,0,1117 ,7 ,1124 ,1621 ,0,3,1,3,0,1,0,76.14,69.3399136336,33.33
03,013,01,013,0258,0,1277 ,8 ,1285 ,1905 ,0,3,1,3,0,1,0,76.14,67.4540682415,33.33
03,013,01,013,0259,0,928 ,7 ,935 ,1566 ,0,3,1,3,0,1,0,76.14,59.7062579821,33.33
03,013,01,013,0260,0,1826 ,7 ,1833 ,2868 ,0,3,1,3,0,1,0,76.14,63.9121338912,33.33
03,013,01,013,0261,0,603 ,2 ,605 ,902 ,0,3,1,3,0,1,0,76.14,67.0731707317,33.33
03,013,01,013,0262,0,746 ,1 ,747 ,1099 ,0,3,1,3,0,1,0,76.14,67.9708826206,33.33
03,013,01,013,0263,0,1345 ,8 ,1353 ,2374 ,0,3,1,3,0,1,0,76.14,56.9924178602,33.33
03,013,01,013,0264,0,887 ,14 ,901 ,1465 ,0,3,1,3,0,1,0,76.14,61.5017064846,33.33
03,013,01,013,0265,0,1450 ,12 ,1462 ,2473 ,0,3,1,3,0,1,0,76.14,59.1184795795,33.33
03,013,01,013,0266,0,1418 ,13 ,1431 ,2474 ,0,3,1,3,0,1,0,76.14,57.8415521423,33.33
03,013,01,013,0267,0,830 ,12 ,842 ,1544 ,0,3,1,3,0,1,0,76.14,54.5336787565,33.33
03,013,01,013,0268,0,1081 ,9 ,1090 ,1756 ,0,3,1,3,0,1,0,76.14,62.0728929385,33.33
03,013,01,013,0269,0,1259 ,14 ,1273 ,2242 ,0,3,1,3,0,1,0,76.14,56.7796610169,33.33
03,013,01,013,0270,0,587 ,4 ,591 ,1143 ,0,3,1,3,0,1,0,76.14,51.7060367454,33.33
03,013,01,013,0271,0,452 ,2 ,454 ,747 ,0,3,1,3,0,1,0,76.14,60.7764390897,33.33
03,013,01,014,0272,0,1028 ,4 ,1032 ,1463 ,0,3,1,3,0,1,0,76.14,70.5399863295,33.33
03,013,01,014,0273,0,569 ,3 ,572 ,850 ,0,3,1,3,0,1,0,76.14,67.2941176471,33.33
03,013,01,014,0274,0,503 ,2 ,505 ,674 ,0,3,1,3,0,1,0,76.14,74.9258160237,33.33
03,013,01,014,0275,0,438 ,2 ,440 ,613 ,0,3,1,3,0,1,0,76.14,71.7781402936,33.33
03,013,01,014,0276,0,905 ,4 ,909 ,1328 ,0,3,1,3,0,1,0,76.14,68.4487951807,33.33
03,013,01,014,0277,0,689 ,5 ,694 ,959 ,0,3,1,3,0,1,0,76.14,72.3670490094,33.33
03,013,01,014,0278,0,446 ,1 ,447 ,605 ,0,3,1,3,0,1,0,76.14,73.8842975207,33.33
03,013,01,014,0279,0,335 ,3 ,338 ,477 ,0,3,1,3,0,1,0,76.14,70.8595387841,33.33
03,013,01,014,0280,0,1774 ,16 ,1790 ,2576 ,0,3,1,3,0,1,0,76.14,69.4875776398,33.33
03,013,01,014,0281,0,335 ,1 ,336 ,451 ,0,3,1,3,0,1,0,76.14,74.5011086475,33.33
03,013,01,014,0282,0,431 ,0 ,431 ,614 ,0,3,1,3,0,1,0,76.14,70.1954397394,33.33
03,013,01,014,0283,0,516 ,1 ,517 ,698 ,0,3,1,3,0,1,0,76.14,74.0687679083,33.33
03,013,01,014,0284,0,671 ,5 ,676 ,1088 ,0,3,1,3,0,1,0,76.14,62.1323529412,33.33
03,013,01,014,0285,0,787 ,5 ,792 ,1150 ,0,3,1,3,0,1,0,76.14,68.8695652174,33.33
03,013,01,014,0286,0,707 ,6 ,713 ,1033 ,0,3,1,3,0,1,0,76.14,69.0222652469,33.33
03,013,01,015,0287,0,1178 ,6 ,1184 ,1941 ,0,3,1,3,0,1,0,76.14,60.9994848016,33.33
03,013,01,015,0288,0,772 ,4 ,776 ,1183 ,0,3,1,3,0,1,0,76.14,65.595942519,33.33
03,013,01,015,0289,0,697 ,4 ,701 ,988 ,0,3,1,3,0,1,0,76.14,70.951417004,33.33
03,013,01,015,0290,0,494 ,2 ,496 ,743 ,0,3,1,3,0,1,0,76.14,66.7563930013,33.33
03,013,01,015,0291,0,1035 ,4 ,1039 ,1680 ,0,3,1,3,0,1,0,76.14,61.8452380952,33.33
03,013,01,015,0292,0,740 ,8 ,748 ,1339 ,0,3,1,3,0,1,0,76.14,55.8625840179,33.33
03,013,01,015,0293,0,636 ,4 ,640 ,1084 ,0,3,1,3,0,1,0,76.14,59.0405904059,33.33
03,013,01,016,0294,0,664 ,2 ,666 ,1219 ,0,3,1,3,0,1,0,76.14,54.6349466776,33.33
03,013,01,016,0295,0,500 ,6 ,506 ,856 ,0,3,1,3,0,1,0,76.14,59.1121495327,33.33
03,013,01,016,0296,0,632 ,3 ,635 ,975 ,0,3,1,3,0,1,0,76.14,65.1282051282,33.33
03,013,01,016,0297,0,416 ,1 ,417 ,659 ,0,3,1,3,0,1,0,76.14,63.277693475,33.33
03,013,01,016,0298,0,1085 ,7 ,1092 ,1813 ,0,3,1,3,0,1,0,76.14,60.2316602317,33.33
03,013,01,016,0299,0,2053 ,14 ,2067 ,3753 ,0,3,1,3,0,1,0,76.14,55.0759392486,33.33
03,013,01,016,0300,0,1264 ,3 ,1267 ,2060 ,0,3,1,3,0,1,0,76.14,61.5048543689,33.33
03,013,01,016,0301,0,1065 ,7 ,1072 ,1642 ,0,3,1,3,0,1,0,76.14,65.2862362972,33.33
03,013,01,016,0302,0,1312 ,8 ,1320 ,2172 ,0,3,1,3,0,1,0,76.14,60.773480663,33.33
03,013,01,016,0303,0,394 ,2 ,396 ,740 ,0,3,1,3,0,1,0,76.14,53.5135135135,33.33
03,013,01,016,0304,0,503 ,6 ,509 ,962 ,0,3,1,3,0,1,0,76.14,52.9106029106,33.33
03,013,01,016,0305,0,1761 ,10 ,1771 ,2793 ,0,3,1,3,0,1,0,76.14,63.4085213033,33.33
03,013,01,016,0306,0,425 ,0 ,425 ,632 ,0,3,1,3,0,1,0,76.14,67.246835443,33.33
03,013,01,016,0307,0,522 ,6 ,528 ,949 ,0,3,1,3,0,1,0,76.14,55.6375131718,33.33
03,013,01,016,0308,0,259 ,4 ,263 ,418 ,0,3,1,3,0,1,0,76.14,62.9186602871,33.33
03,013,01,017,0309,0,1180 ,2 ,1182 ,1632 ,0,3,1,3,0,1,0,76.14,72.4264705882,33.33
03,013,01,017,0310,0,1548 ,5 ,1553 ,2382 ,0,3,1,3,0,1,0,76.14,65.1973131822,33.33
03,013,01,017,0311,0,1382 ,3 ,1385 ,2042 ,0,3,1,3,0,1,0,76.14,67.8256611166,33.33
03,013,01,017,0312,0,517 ,3 ,520 ,764 ,0,3,1,3,0,1,0,76.14,68.0628272251,33.33
03,013,01,017,0313,0,573 ,4 ,577 ,809 ,0,3,1,3,0,1,0,76.14,71.3226205192,33.33
03,013,01,017,0314,0,1439 ,8 ,1447 ,2232 ,0,3,1,3,0,1,0,76.14,64.8297491039,33.33
03,013,01,017,0315,0,1345 ,5 ,1350 ,2047 ,0,3,1,3,0,1,0,76.14,65.9501709819,33.33
03,013,01,017,0316,0,1568 ,6 ,1574 ,2172 ,0,3,1,3,0,1,0,76.14,72.467771639,33.33
03,013,01,017,0317,0,1898 ,10 ,1908 ,2911 ,0,3,1,3,0,1,0,76.14,65.5444864308,33.33
03,013,01,017,0318,0,890 ,5 ,895 ,1265 ,0,3,1,3,0,1,0,76.14,70.7509881423,33.33
03,013,01,017,0319,0,1383 ,11 ,1394 ,2189 ,0,3,1,3,0,1,0,76.14,63.6820465966,33.33
03,013,01,017,0320,0,1088 ,8 ,1096 ,1695 ,0,3,1,3,0,1,0,76.14,64.6607669617,33.33
03,013,01,017,0321,0,895 ,9 ,904 ,1421 ,0,3,1,3,0,1,0,76.14,63.6171710063,33.33
03,013,01,017,0322,0,2387 ,9 ,2396 ,4115 ,0,3,1,3,0,1,0,76.14,58.2260024301,33.33
03,013,01,017,0323,0,1300 ,13 ,1313 ,2240 ,0,3,1,3,0,1,0,76.14,58.6160714286,33.33
03,013,01,018,0324,0,1292 ,5 ,1297 ,2062 ,0,3,1,3,0,1,0,76.14,62.9000969932,33.33
03,013,01,018,0325,0,980 ,4 ,984 ,1695 ,0,3,1,3,0,1,0,76.14,58.0530973451,33.33
03,013,01,018,0326,0,778 ,10 ,788 ,1157 ,0,3,1,3,0,1,0,76.14,68.1071737252,33.33
03,013,01,018,0327,0,783 ,4 ,787 ,1161 ,0,3,1,3,0,1,0,76.14,67.7863910422,33.33
03,013,01,018,0328,0,636 ,5 ,641 ,931 ,0,3,1,3,0,1,0,76.14,68.850698174,33.33
03,013,01,018,0329,0,969 ,11 ,980 ,1488 ,0,3,1,3,0,1,0,76.14,65.8602150538,33.33
03,013,01,018,0330,0,534 ,2 ,536 ,818 ,0,3,1,3,0,1,0,76.14,65.5256723716,33.33
03,013,01,018,0331,0,1079 ,9 ,1088 ,1786 ,0,3,1,3,0,1,0,76.14,60.9182530795,33.33
03,013,01,019,0332,0,885 ,2 ,887 ,1473 ,0,3,1,3,0,1,0,76.14,60.2172437203,33.33
03,013,01,019,0333,0,944 ,7 ,951 ,1628 ,0,3,1,3,0,1,0,76.14,58.4152334152,33.33
03,013,01,019,0334,0,506 ,4 ,510 ,822 ,0,3,1,3,0,1,0,76.14,62.0437956204,33.33
03,013,01,019,0335,0,972 ,2 ,974 ,1558 ,0,3,1,3,0,1,0,76.14,62.5160462131,33.33
03,013,01,019,0336,0,2033 ,11 ,2044 ,3259 ,0,3,1,3,0,1,0,76.14,62.7186253452,33.33
03,013,01,019,0337,0,587 ,4 ,591 ,911 ,0,3,1,3,0,1,0,76.14,64.8737650933,33.33
03,013,01,019,0338,0,658 ,6 ,664 ,1344 ,0,3,1,3,0,1,0,76.14,49.4047619048,33.33
03,013,01,019,0339,0,1029 ,10 ,1039 ,1895 ,0,3,1,3,0,1,0,76.14,54.8284960422,33.33
03,013,01,019,0340,0,1724 ,12 ,1736 ,2802 ,0,3,1,3,0,1,0,76.14,61.9557458958,33.33
03,013,01,019,0341,0,749 ,5 ,754 ,1146 ,0,3,1,3,0,1,0,76.14,65.7940663176,33.33
03,013,01,020,0342,0,1185 ,8 ,1193 ,1775 ,0,3,1,3,0,1,0,76.14,67.2112676056,33.33
03,013,01,020,0343,0,651 ,7 ,658 ,986 ,0,3,1,3,0,1,0,76.14,66.7342799189,33.33
03,013,01,020,0344,0,350 ,0 ,350 ,526 ,0,3,1,3,0,1,0,76.14,66.5399239544,33.33
03,013,01,020,0345,0,496 ,4 ,500 ,761 ,0,3,1,3,0,1,0,76.14,65.703022339,33.33
03,013,01,020,0346,0,656 ,5 ,661 ,1051 ,0,3,1,3,0,1,0,76.14,62.8924833492,33.33
03,013,01,020,0347,0,638 ,8 ,646 ,1001 ,0,3,1,3,0,1,0,76.14,64.5354645355,33.33
03,013,01,020,0348,0,641 ,2 ,643 ,1015 ,0,3,1,3,0,1,0,76.14,63.3497536946,33.33
03,013,01,020,0349,0,693 ,5 ,698 ,1149 ,0,3,1,3,0,1,0,76.14,60.7484769365,33.33
03,013,01,020,0350,0,587 ,8 ,595 ,965 ,0,3,1,3,0,1,0,76.14,61.6580310881,33.33
03,013,01,020,0351,0,381 ,1 ,382 ,586 ,0,3,1,3,0,1,0,76.14,65.1877133106,33.33
03,013,01,021,0352,0,1020 ,5 ,1025 ,1492 ,0,3,1,3,0,1,0,76.14,68.6997319035,33.33
03,013,01,021,0353,0,1044 ,14 ,1058 ,1622 ,0,3,1,3,0,1,0,76.14,65.2281134402,33.33
03,013,01,021,0354,0,614 ,1 ,615 ,922 ,0,3,1,3,0,1,0,76.14,66.7028199566,33.33
03,013,01,021,0355,0,1091 ,4 ,1095 ,1672 ,0,3,1,3,0,1,0,76.14,65.490430622,33.33
03,013,01,021,0356,0,1210 ,3 ,1213 ,1958 ,0,3,1,3,0,1,0,76.14,61.9509703779,33.33
03,013,01,021,0357,0,1385 ,7 ,1392 ,2220 ,0,3,1,3,0,1,0,76.14,62.7027027027,33.33
03,013,01,021,0358,0,818 ,7 ,825 ,1122 ,0,3,1,3,0,1,0,76.14,73.5294117647,33.33
03,013,01,021,0359,0,583 ,5 ,588 ,830 ,0,3,1,3,0,1,0,76.14,70.843373494,33.33
03,013,01,021,0360,0,820 ,3 ,823 ,1187 ,0,3,1,3,0,1,0,76.14,69.3344566133,33.33
03,013,01,021,0361,0,695 ,5 ,700 ,1038 ,0,3,1,3,0,1,0,76.14,67.4373795761,33.33
03,013,01,021,0362,0,719 ,5 ,724 ,1131 ,0,3,1,3,0,1,0,76.14,64.0141467728,33.33
03,013,01,021,0363,0,1400 ,3 ,1403 ,2290 ,0,3,1,3,0,1,0,76.14,61.2663755459,33.33
03,013,01,022,0364,0,1001 ,8 ,1009 ,1963 ,0,3,1,3,0,1,0,76.14,51.4009169638,33.33
03,013,01,022,0365,0,586 ,2 ,588 ,1101 ,0,3,1,3,0,1,0,76.14,53.4059945504,33.33
03,013,01,022,0366,0,472 ,3 ,475 ,928 ,0,3,1,3,0,1,0,76.14,51.1853448276,33.33
03,013,01,022,0367,0,703 ,0 ,703 ,1521 ,0,3,1,3,0,1,0,76.14,46.2195923734,33.33
03,013,01,022,0368,0,525 ,6 ,531 ,1169 ,0,3,1,3,0,1,0,76.14,45.4234388366,33.33
03,013,01,022,0369,0,460 ,3 ,463 ,1048 ,0,3,1,3,0,1,0,76.14,44.179389313,33.33
03,013,01,022,0370,0,685 ,5 ,690 ,1496 ,0,3,1,3,0,1,0,76.14,46.1229946524,33.33
03,013,01,022,0371,0,391 ,4 ,395 ,778 ,0,3,1,3,0,1,0,76.14,50.7712082262,33.33
03,013,01,023,0372,0,896 ,7 ,903 ,1349 ,0,3,1,3,0,1,0,76.14,66.9384729429,33.33
03,013,01,023,0373,0,425 ,3 ,428 ,589 ,0,3,1,3,0,1,0,76.14,72.6655348048,33.33
03,013,01,023,0374,0,430 ,6 ,436 ,711 ,0,3,1,3,0,1,0,76.14,61.3220815752,33.33
03,013,01,023,0375,0,468 ,6 ,474 ,763 ,0,3,1,3,0,1,0,76.14,62.123197903,33.33
03,013,01,023,0376,0,262 ,1 ,263 ,428 ,0,3,1,3,0,1,0,76.14,61.4485981308,33.33
03,013,01,023,0377,0,547 ,11 ,558 ,965 ,0,3,1,3,0,1,0,76.14,57.8238341969,33.33
03,013,01,023,0378,0,726 ,10 ,736 ,1313 ,0,3,1,3,0,1,0,76.14,56.0548362529,33.33
03,013,01,023,0379,0,281 ,1 ,282 ,415 ,0,3,1,3,0,1,0,76.14,67.9518072289,33.33
03,013,01,023,0380,0,265 ,1 ,266 ,455 ,0,3,1,3,0,1,0,76.14,58.4615384615,33.33
03,013,01,023,0381,0,312 ,3 ,315 ,513 ,0,3,1,3,0,1,0,76.14,61.4035087719,33.33
03,013,01,023,0382,0,288 ,3 ,291 ,477 ,0,3,1,3,0,1,0,76.14,61.0062893082,33.33
03,013,01,024,0383,0,649 ,5 ,654 ,1246 ,0,3,1,3,0,1,0,76.14,52.4879614767,33.33
03,013,01,024,0384,0,539 ,25 ,564 ,1073 ,0,3,1,3,0,1,0,76.14,52.5629077353,33.33
03,013,01,024,0385,0,570 ,20 ,590 ,1056 ,0,3,1,3,0,1,0,76.14,55.8712121212,33.33
03,013,01,024,0386,0,248 ,1 ,249 ,435 ,0,3,1,3,0,1,0,76.14,57.2413793103,33.33
03,013,01,024,0387,0,116 ,8 ,124 ,251 ,0,3,1,3,0,1,0,76.14,49.4023904382,33.33
03,013,01,024,0388,0,294 ,4 ,298 ,612 ,0,3,1,3,0,1,0,76.14,48.6928104575,33.33
03,013,01,024,0389,0,110 ,1 ,111 ,238 ,0,3,1,3,0,1,0,76.14,46.6386554622,33.33
03,013,01,024,0390,0,164 ,7 ,171 ,306 ,0,3,1,3,0,1,0,76.14,55.8823529412,33.33
03,013,01,025,0391,0,1153 ,8 ,1161 ,1769 ,0,3,1,3,0,1,0,76.14,65.6302996043,33.33
03,013,01,025,0392,0,631 ,0 ,631 ,1026 ,0,3,1,3,0,1,0,76.14,61.5009746589,33.33
03,013,01,025,0393,0,545 ,5 ,550 ,1040 ,0,3,1,3,0,1,0,76.14,52.8846153846,33.33
03,013,01,025,0394,0,488 ,1 ,489 ,963 ,0,3,1,3,0,1,0,76.14,50.7788161994,33.33
03,013,01,026,0395,0,55 ,2 ,57 ,105 ,0,3,1,3,0,1,0,76.14,54.2857142857,33.33
03,013,01,026,0396,0,2 ,0 ,2 ,12 ,0,3,1,3,0,1,0,76.14,16.6666666667,33.33
03,013,01,026,0397,0,4 ,0 ,4 ,14 ,0,3,1,3,0,1,0,76.14,28.5714285714,33.33
03,013,01,026,0398,0,4 ,0 ,4 ,15 ,0,3,1,3,0,1,0,76.14,26.6666666667,33.33
03,013,01,026,0399,0,15 ,1 ,16 ,46 ,0,3,1,3,0,1,0,76.14,34.7826086957,33.33
03,013,01,026,0400,0,23 ,0 ,23 ,39 ,0,3,1,3,0,1,0,76.14,58.9743589744,33.33
03,013,01,026,0401,0,5 ,0 ,5 ,12 ,0,3,1,3,0,1,0,76.14,41.6666666667,33.33
03,013,01,026,0402,0,18 ,0 ,18 ,30 ,0,3,1,3,0,1,0,76.14,60,33.33
03,013,01,026,0403,0,32 ,2 ,34 ,68 ,0,3,1,3,0,1,0,76.14,50,33.33
03,013,01,026,0404,0,18 ,1 ,19 ,42 ,0,3,1,3,0,1,0,76.14,45.2380952381,33.33
03,013,01,027,0405,0,12 ,1 ,13 ,27 ,0,3,1,3,0,1,0,76.14,48.1481481481,33.33
03,013,01,027,0406,0,2 ,0 ,2 ,3 ,0,3,1,3,0,1,0,76.14,66.6666666667,33.33
03,013,01,027,0407,0,2 ,0 ,2 ,4 ,0,3,1,3,0,1,0,76.14,50,33.33
03,013,01,027,0408,0,3 ,0 ,3 ,17 ,0,3,1,3,0,1,0,76.14,17.6470588235,33.33
03,013,01,027,0409,0,2 ,0 ,2 ,4 ,0,3,1,3,0,1,0,76.14,50,33.33
03,013,01,027,0410,0,2 ,0 ,2 ,5 ,0,3,1,3,0,1,0,76.14,40,33.33
03,013,01,028,0411,0,8 ,0 ,8 ,15 ,0,3,1,3,0,1,0,76.14,53.3333333333,33.33
03,013,01,028,0412,0,41 ,1 ,42 ,68 ,0,3,1,3,0,1,0,76.14,61.7647058824,33.33
03,013,01,028,0413,0,30 ,0 ,30 ,56 ,0,3,1,3,0,1,0,76.14,53.5714285714,33.33
03,013,01,028,0414,0,25 ,0 ,25 ,49 ,0,3,1,3,0,1,0,76.14,51.0204081633,33.33
03,013,01,028,0415,0,6 ,0 ,6 ,15 ,0,3,1,3,0,1,0,76.14,40,33.33
03,013,01,028,0416,0,54 ,1 ,55 ,109 ,0,3,1,3,0,1,0,76.14,50.4587155963,33.33
03,013,01,029,0417,0,25 ,0 ,25 ,46 ,0,3,1,3,0,1,0,76.14,54.347826087,33.33
03,013,01,029,0418,0,17 ,0 ,17 ,38 ,0,3,1,3,0,1,0,76.14,44.7368421053,33.33
03,013,01,029,0419,0,9 ,0 ,9 ,23 ,0,3,1,3,0,1,0,76.14,39.1304347826,33.33
03,013,01,029,0420,0,7 ,0 ,7 ,10 ,0,3,1,3,0,1,0,76.14,70,33.33
03,013,01,029,0421,0,1 ,0 ,1 ,9 ,0,3,1,3,0,1,0,76.14,11.1111111111,33.33
03,013,01,029,0422,0,8 ,0 ,8 ,27 ,0,3,1,3,0,1,0,76.14,29.6296296296,33.33
03,013,01,030,0423,0,7 ,0 ,7 ,20 ,0,3,1,3,0,1,0,76.14,35,33.33
03,013,01,030,0424,0,13 ,0 ,13 ,21 ,0,3,1,3,0,1,0,76.14,61.9047619048,33.33
03,013,01,030,0425,0,21 ,0 ,21 ,47 ,0,3,1,3,0,1,0,76.14,44.6808510638,33.33
03,013,01,030,0426,0,21 ,1 ,22 ,58 ,0,3,1,3,0,1,0,76.14,37.9310344828,33.33
03,013,01,030,0427,0,16 ,0 ,16 ,33 ,0,3,1,3,0,1,0,76.14,48.4848484848,33.33
03,013,01,030,0428,0,30 ,0 ,30 ,43 ,0,3,1,3,0,1,0,76.14,69.7674418605,33.33
03,013,01,030,0429,0,22 ,1 ,23 ,44 ,0,3,1,3,0,1,0,76.14,52.2727272727,33.33
03,013,01,031,0430,0,14 ,0 ,14 ,49 ,0,3,1,3,0,1,0,76.14,28.5714285714,33.33
03,013,01,031,0431,0,16 ,0 ,16 ,43 ,0,3,1,3,0,1,0,76.14,37.2093023256,33.33
03,013,01,031,0432,0,5 ,0 ,5 ,12 ,0,3,1,3,0,1,0,76.14,41.6666666667,33.33
03,013,01,031,0433,0,61 ,1 ,62 ,110 ,0,3,1,3,0,1,0,76.14,56.3636363636,33.33
03,013,01,031,0434,0,49 ,0 ,49 ,92 ,0,3,1,3,0,1,0,76.14,53.2608695652,33.33
03,013,01,031,0435,0,6 ,0 ,6 ,14 ,0,3,1,3,0,1,0,76.14,42.8571428571,33.33
03,013,01,032,0436,0,28 ,0 ,28 ,57 ,0,3,1,3,0,1,0,76.14,49.1228070175,33.33
03,013,01,032,0437,0,29 ,0 ,29 ,70 ,0,3,1,3,0,1,0,76.14,41.4285714286,33.33
03,013,01,032,0438,0,13 ,0 ,13 ,35 ,0,3,1,3,0,1,0,76.14,37.1428571429,33.33
03,013,01,032,0439,0,11 ,0 ,11 ,25 ,0,3,1,3,0,1,0,76.14,44,33.33
03,013,01,032,0440,0,7 ,0 ,7 ,25 ,0,3,1,3,0,1,0,76.14,28,33.33
03,013,01,032,0441,0,8 ,0 ,8 ,23 ,0,3,1,3,0,1,0,76.14,34.7826086957,33.33
03,013,01,032,0442,0,16 ,0 ,16 ,34 ,0,3,1,3,0,1,0,76.14,47.0588235294,33.33
03,013,01,032,0443,0,7 ,0 ,7 ,20 ,0,3,1,3,0,1,0,76.14,35,33.33
03,013,01,033,0444,0,82 ,0 ,82 ,143 ,0,3,1,3,0,1,0,76.14,57.3426573427,33.33
03,013,01,033,0445,0,8 ,0 ,8 ,22 ,0,3,1,3,0,1,0,76.14,36.3636363636,33.33
03,013,01,033,0446,0,11 ,0 ,11 ,19 ,0,3,1,3,0,1,0,76.14,57.8947368421,33.33
03,013,01,033,0447,0,47 ,0 ,47 ,97 ,0,3,1,3,0,1,0,76.14,48.4536082474,33.33
03,013,01,033,0448,0,21 ,1 ,22 ,31 ,0,3,1,3,0,1,0,76.14,70.9677419355,33.33
03,013,01,033,0449,0,11 ,0 ,11 ,23 ,0,3,1,3,0,1,0,76.14,47.8260869565,33.33
03,014,01,001,0001,0,502 ,4 ,506 ,983 ,0,3,1,3,0,1,0,76.14,51.48 ,33.33
03,014,01,001,0002,0,813 ,8 ,821 ,1429 ,0,3,1,3,0,1,0,76.14,57.45 ,33.33
03,014,01,001,0003,0,1881 ,5 ,1886 ,3441 ,0,3,1,3,0,1,0,76.14,54.81 ,33.33
03,014,01,001,0004,0,1476 ,10 ,1486 ,2833 ,0,3,1,3,0,1,0,76.14,52.45 ,33.33
03,014,01,001,0005,0,361 ,3 ,364 ,739 ,0,3,1,3,0,1,0,76.14,49.26 ,33.33
03,014,01,001,0006,0,571 ,2 ,573 ,1062 ,0,3,1,3,0,1,0,76.14,53.95 ,33.33
03,014,01,001,0007,0,209 ,1 ,210 ,434 ,0,3,1,3,0,1,0,76.14,48.39 ,33.33
03,014,01,001,0008,0,815 ,2 ,817 ,1588 ,0,3,1,3,0,1,0,76.14,51.45 ,33.33
03,014,01,001,0009,0,429 ,2 ,431 ,719 ,0,3,1,3,0,1,0,76.14,59.94 ,33.33
03,014,01,001,0010,0,320 ,4 ,324 ,569 ,0,3,1,3,0,1,0,76.14,56.94 ,33.33
03,014,01,001,0011,0,367 ,7 ,374 ,743 ,0,3,1,3,0,1,0,76.14,50.34 ,33.33
03,014,01,001,0012,0,427 ,3 ,430 ,821 ,0,3,1,3,0,1,0,76.14,52.38 ,33.33
03,014,01,001,0013,0,653 ,2 ,655 ,1328 ,0,3,1,3,0,1,0,76.14,49.32 ,33.33
03,014,01,001,0014,0,495 ,1 ,496 ,894 ,0,3,1,3,0,1,0,76.14,55.48 ,33.33
03,014,01,001,0015,0,524 ,1 ,525 ,918 ,0,3,1,3,0,1,0,76.14,57.19 ,33.33
03,014,01,001,0016,0,394 ,1 ,395 ,733 ,0,3,1,3,0,1,0,76.14,53.89 ,33.33
03,014,01,001,0017,0,228 ,1 ,229 ,431 ,0,3,1,3,0,1,0,76.14,53.13 ,33.33
03,014,01,001,0018,0,1592 ,5 ,1597 ,2887 ,0,3,1,3,0,1,0,76.14,55.32 ,33.33
03,014,01,001,0019,0,348 ,4 ,352 ,681 ,0,3,1,3,0,1,0,76.14,51.69 ,33.33
03,014,01,001,0020,0,229 ,3 ,232 ,440 ,0,3,1,3,0,1,0,76.14,52.73 ,33.33
03,014,01,001,0021,0,591 ,1 ,592 ,1118 ,0,3,1,3,0,1,0,76.14,52.95 ,33.33
03,014,01,001,0022,0,2424 ,14 ,2438 ,4724 ,0,3,1,3,0,1,0,76.14,51.61 ,33.33
03,014,01,001,0023,0,1235 ,3 ,1238 ,2212 ,0,3,1,3,0,1,0,76.14,55.97 ,33.33
03,014,01,001,0024,0,1409 ,6 ,1415 ,2586 ,0,3,1,3,0,1,0,76.14,54.72 ,33.33
03,014,01,001,0025,0,837 ,3 ,840 ,1616 ,0,3,1,3,0,1,0,76.14,51.98 ,33.33
03,014,01,001,0026,0,880 ,2 ,882 ,1707 ,0,3,1,3,0,1,0,76.14,51.67 ,33.33
03,014,01,001,0027,0,504 ,1 ,505 ,946 ,0,3,1,3,0,1,0,76.14,53.38 ,33.33
03,014,01,001,0028,0,622 ,2 ,624 ,1181 ,0,3,1,3,0,1,0,76.14,52.84 ,33.33
03,014,01,001,0029,0,603 ,2 ,605 ,1114 ,0,3,1,3,0,1,0,76.14,54.31 ,33.33
03,014,01,001,0030,0,2886 ,16 ,2902 ,5795 ,0,3,1,3,0,1,0,76.14,50.08 ,33.33
03,014,01,001,0031,0,1519 ,10 ,1529 ,3125 ,0,3,1,3,0,1,0,76.14,48.93 ,33.33
03,014,01,001,0032,0,828 ,8 ,836 ,1609 ,0,3,1,3,0,1,0,76.14,51.96 ,33.33
03,014,01,001,0033,0,499 ,6 ,505 ,956 ,0,3,1,3,0,1,0,76.14,52.82 ,33.33
03,014,01,001,0034,0,596 ,5 ,601 ,1143 ,0,3,1,3,0,1,0,76.14,52.58 ,33.33
03,014,01,001,0035,0,221 ,5 ,226 ,480 ,0,3,1,3,0,1,0,76.14,47.08 ,33.33
03,014,01,001,0036,0,808 ,7 ,815 ,1442 ,0,3,1,3,0,1,0,76.14,56.52 ,33.33
03,014,01,001,0037,0,507 ,4 ,511 ,1083 ,0,3,1,3,0,1,0,76.14,47.18 ,33.33
03,014,01,001,0038,0,1186 ,3 ,1189 ,2025 ,0,3,1,3,0,1,0,76.14,58.72 ,33.33
03,014,01,001,0039,0,789 ,1 ,790 ,1470 ,0,3,1,3,0,1,0,76.14,53.74 ,33.33
03,014,01,001,0040,0,957 ,5 ,962 ,1696 ,0,3,1,3,0,1,0,76.14,56.72 ,33.33
03,014,01,001,0041,0,467 ,2 ,469 ,943 ,0,3,1,3,0,1,0,76.14,49.73 ,33.33
03,014,01,001,0042,0,393 ,1 ,394 ,785 ,0,3,1,3,0,1,0,76.14,50.19 ,33.33
03,014,01,001,0043,0,498 ,0 ,498 ,862 ,0,3,1,3,0,1,0,76.14,57.77 ,33.33
03,014,01,001,0044,0,435 ,0 ,435 ,804 ,0,3,1,3,0,1,0,76.14,54.10 ,33.33
03,014,01,001,0045,0,431 ,4 ,435 ,872 ,0,3,1,3,0,1,0,76.14,49.89 ,33.33
03,014,01,001,0046,0,497 ,7 ,504 ,1117 ,0,3,1,3,0,1,0,76.14,45.12 ,33.33
03,014,01,002,0047,0,169 ,1 ,170 ,426 ,0,3,1,3,0,1,0,76.14,39.91 ,33.33
03,014,01,002,0048,0,61 ,0 ,61 ,138 ,0,3,1,3,0,1,0,76.14,44.20 ,33.33
03,014,01,002,0049,0,560 ,1 ,561 ,1125 ,0,3,1,3,0,1,0,76.14,49.87 ,33.33
03,014,01,002,0050,0,1283 ,4 ,1287 ,2388 ,0,3,1,3,0,1,0,76.14,53.89 ,33.33
03,014,01,002,0051,0,536 ,3 ,539 ,1106 ,0,3,1,3,0,1,0,76.14,48.73 ,33.33
03,014,01,002,0052,0,236 ,0 ,236 ,561 ,0,3,1,3,0,1,0,76.14,42.07 ,33.33
03,014,01,002,0053,0,199 ,1 ,200 ,478 ,0,3,1,3,0,1,0,76.14,41.84 ,33.33
03,014,01,002,0054,0,43 ,0 ,43 ,91 ,0,3,1,3,0,1,0,76.14,47.25 ,33.33
03,014,01,003,0055,0,834 ,7 ,841 ,1564 ,0,3,1,3,0,1,0,76.14,53.77 ,33.33
03,014,01,003,0056,0,508 ,8 ,516 ,850 ,0,3,1,3,0,1,0,76.14,60.71 ,33.33
03,014,01,003,0057,0,353 ,3 ,356 ,647 ,0,3,1,3,0,1,0,76.14,55.02 ,33.33
03,014,01,003,0058,0,524 ,2 ,526 ,953 ,0,3,1,3,0,1,0,76.14,55.19 ,33.33
03,014,01,003,0059,0,346 ,2 ,348 ,654 ,0,3,1,3,0,1,0,76.14,53.21 ,33.33
03,014,01,003,0060,0,644 ,7 ,651 ,1200 ,0,3,1,3,0,1,0,76.14,54.25 ,33.33
03,014,01,003,0061,0,106 ,0 ,106 ,214 ,0,3,1,3,0,1,0,76.14,49.53 ,33.33
03,014,01,004,0062,0,911 ,5 ,916 ,1701 ,0,3,1,3,0,1,0,76.14,53.85 ,33.33
03,014,01,004,0063,0,505 ,1 ,506 ,974 ,0,3,1,3,0,1,0,76.14,51.95 ,33.33
03,014,01,004,0064,0,465 ,3 ,468 ,994 ,0,3,1,3,0,1,0,76.14,47.08 ,33.33
03,014,01,004,0065,0,482 ,3 ,485 ,1040 ,0,3,1,3,0,1,0,76.14,46.63 ,33.33
03,014,01,004,0066,0,100 ,1 ,101 ,227 ,0,3,1,3,0,1,0,76.14,44.49 ,33.33
03,014,01,004,0067,0,1393 ,9 ,1402 ,2636 ,0,3,1,3,0,1,0,76.14,53.19 ,33.33
03,014,01,004,0068,0,311 ,5 ,316 ,649 ,0,3,1,3,0,1,0,76.14,48.69 ,33.33
03,014,01,004,0069,0,204 ,1 ,205 ,410 ,0,3,1,3,0,1,0,76.14,50.00 ,33.33
03,014,01,004,0070,0,103 ,1 ,104 ,218 ,0,3,1,3,0,1,0,76.14,47.71 ,33.33
03,014,01,004,0071,0,556 ,7 ,563 ,1047 ,0,3,1,3,0,1,0,76.14,53.77 ,33.33
03,014,01,004,0072,0,219 ,2 ,221 ,428 ,0,3,1,3,0,1,0,76.14,51.64 ,33.33
03,014,01,004,0073,0,216 ,1 ,217 ,351 ,0,3,1,3,0,1,0,76.14,61.82 ,33.33
03,014,01,004,0074,0,126 ,1 ,127 ,254 ,0,3,1,3,0,1,0,76.14,50.00 ,33.33
03,014,01,005,0075,0,360 ,1 ,361 ,725 ,0,3,1,3,0,1,0,76.14,49.79 ,33.33
03,014,01,005,0076,0,545 ,3 ,548 ,1056 ,0,3,1,3,0,1,0,76.14,51.89 ,33.33
03,014,01,005,0077,0,451 ,3 ,454 ,1033 ,0,3,1,3,0,1,0,76.14,43.95 ,33.33
03,014,01,005,0078,0,368 ,3 ,371 ,754 ,0,3,1,3,0,1,0,76.14,49.20 ,33.33
03,014,01,005,0079,0,312 ,1 ,313 ,593 ,0,3,1,3,0,1,0,76.14,52.78 ,33.33
03,014,01,005,0080,0,174 ,0 ,174 ,341 ,0,3,1,3,0,1,0,76.14,51.03 ,33.33
03,014,01,005,0081,0,494 ,5 ,499 ,971 ,0,3,1,3,0,1,0,76.14,51.39 ,33.33
03,014,01,006,0082,0,958 ,3 ,961 ,1839 ,0,3,1,3,0,1,0,76.14,52.26 ,33.33
03,014,01,006,0083,0,548 ,3 ,551 ,1191 ,0,3,1,3,0,1,0,76.14,46.26 ,33.33
03,014,01,006,0084,0,292 ,0 ,292 ,633 ,0,3,1,3,0,1,0,76.14,46.13 ,33.33
03,014,01,006,0085,0,35 ,1 ,36 ,104 ,0,3,1,3,0,1,0,76.14,34.62 ,33.33
03,014,01,006,0086,0,228 ,0 ,228 ,400 ,0,3,1,3,0,1,0,76.14,57.00 ,33.33
03,014,01,006,0087,0,368 ,1 ,369 ,741 ,0,3,1,3,0,1,0,76.14,49.80 ,33.33
03,014,01,006,0088,0,192 ,1 ,193 ,392 ,0,3,1,3,0,1,0,76.14,49.23 ,33.33
03,014,01,006,0089,0,174 ,4 ,178 ,353 ,0,3,1,3,0,1,0,76.14,50.42 ,33.33
03,014,01,006,0090,0,149 ,3 ,152 ,330 ,0,3,1,3,0,1,0,76.14,46.06 ,33.33
03,014,01,006,0091,0,57 ,0 ,57 ,142 ,0,3,1,3,0,1,0,76.14,40.14 ,33.33
03,014,01,007,0092,0,587 ,6 ,593 ,1208 ,0,3,1,3,0,1,0,76.14,49.09 ,33.33
03,014,01,007,0093,0,298 ,1 ,299 ,566 ,0,3,1,3,0,1,0,76.14,52.83 ,33.33
03,014,01,007,0094,0,93 ,1 ,94 ,201 ,0,3,1,3,0,1,0,76.14,46.77 ,33.33
03,014,01,007,0095,0,127 ,0 ,127 ,323 ,0,3,1,3,0,1,0,76.14,39.32 ,33.33
03,014,01,007,0096,0,312 ,2 ,314 ,618 ,0,3,1,3,0,1,0,76.14,50.81 ,33.33
03,014,01,007,0097,0,395 ,2 ,397 ,867 ,0,3,1,3,0,1,0,76.14,45.79 ,33.33
03,014,01,007,0098,0,77 ,1 ,78 ,180 ,0,3,1,3,0,1,0,76.14,43.33 ,33.33
03,014,01,008,0099,0,133 ,0 ,133 ,337 ,0,3,1,3,0,1,0,76.14,39.47 ,33.33
03,014,01,008,0100,0,146 ,0 ,146 ,360 ,0,3,1,3,0,1,0,76.14,40.56 ,33.33
03,014,01,008,0101,0,568 ,6 ,574 ,1280 ,0,3,1,3,0,1,0,76.14,44.84 ,33.33
03,014,01,008,0102,0,200 ,1 ,201 ,503 ,0,3,1,3,0,1,0,76.14,39.96 ,33.33
03,014,01,008,0103,0,115 ,0 ,115 ,263 ,0,3,1,3,0,1,0,76.14,43.73 ,33.33
03,014,01,008,0104,0,181 ,2 ,183 ,383 ,0,3,1,3,0,1,0,76.14,47.78 ,33.33
03,014,01,009,0105,0,460 ,1 ,461 ,904 ,0,3,1,3,0,1,0,76.14,51.00 ,33.33
03,014,01,009,0106,0,322 ,0 ,322 ,620 ,0,3,1,3,0,1,0,76.14,51.94 ,33.33
03,014,01,009,0107,0,371 ,2 ,373 ,681 ,0,3,1,3,0,1,0,76.14,54.77 ,33.33
03,014,01,009,0108,0,196 ,0 ,196 ,385 ,0,3,1,3,0,1,0,76.14,50.91 ,33.33
03,014,01,009,0109,0,576 ,2 ,578 ,1155 ,0,3,1,3,0,1,0,76.14,50.04 ,33.33
03,014,01,009,0110,0,674 ,2 ,676 ,1224 ,0,3,1,3,0,1,0,76.14,55.23 ,33.33
03,014,01,009,0111,0,229 ,4 ,233 ,462 ,0,3,1,3,0,1,0,76.14,50.43 ,33.33
03,014,01,009,0112,0,196 ,3 ,199 ,417 ,0,3,1,3,0,1,0,76.14,47.72 ,33.33
03,014,01,009,0113,0,96 ,0 ,96 ,212 ,0,3,1,3,0,1,0,76.14,45.28 ,33.33
03,014,01,010,0114,0,134 ,1 ,135 ,359 ,0,3,1,3,0,1,0,76.14,37.60 ,33.33
03,014,01,010,0115,0,533 ,4 ,537 ,1449 ,0,3,1,3,0,1,0,76.14,37.06 ,33.33
03,014,01,010,0116,0,443 ,6 ,449 ,1056 ,0,3,1,3,0,1,0,76.14,42.52 ,33.33
03,014,01,010,0117,0,26 ,0 ,26 ,93 ,0,3,1,3,0,1,0,76.14,27.96 ,33.33
03,014,01,010,0118,0,32 ,0 ,32 ,97 ,0,3,1,3,0,1,0,76.14,32.99 ,33.33
03,014,01,011,0119,0,358 ,0 ,358 ,806 ,0,3,1,3,0,1,0,76.14,44.42 ,33.33
03,014,01,011,0120,0,323 ,1 ,324 ,873 ,0,3,1,3,0,1,0,76.14,37.11 ,33.33
03,014,01,011,0121,0,247 ,3 ,250 ,586 ,0,3,1,3,0,1,0,76.14,42.66 ,33.33
03,014,01,012,0122,0,12 ,1 ,13 ,24 ,0,3,1,3,0,1,0,76.14,54.17 ,33.33
03,014,01,012,0123,0,26 ,0 ,26 ,51 ,0,3,1,3,0,1,0,76.14,50.98 ,33.33
03,014,01,012,0124,0,56 ,0 ,56 ,110 ,0,3,1,3,0,1,0,76.14,50.91 ,33.33
03,014,01,012,0125,0,40 ,0 ,40 ,72 ,0,3,1,3,0,1,0,76.14,55.56 ,33.33
03,014,01,012,0126,0,11 ,1 ,12 ,20 ,0,3,1,3,0,1,0,76.14,60.00 ,33.33
03,014,01,012,0127,0,8 ,1 ,9 ,29 ,0,3,1,3,0,1,0,76.14,31.03 ,33.33
03,014,01,013,0128,0,49 ,1 ,50 ,95 ,0,3,1,3,0,1,0,76.14,52.63 ,33.33
03,014,01,013,0129,0,10 ,0 ,10 ,23 ,0,3,1,3,0,1,0,76.14,43.48 ,33.33
03,014,01,013,0130,0,10 ,0 ,10 ,20 ,0,3,1,3,0,1,0,76.14,50.00 ,33.33
03,014,01,013,0131,0,17 ,0 ,17 ,36 ,0,3,1,3,0,1,0,76.14,47.22 ,33.33
03,014,01,013,0132,0,50 ,0 ,50 ,104 ,0,3,1,3,0,1,0,76.14,48.08 ,33.33
03,014,01,014,0133,0,28 ,0 ,28 ,62 ,0,3,1,3,0,1,0,76.14,45.16 ,33.33
03,014,01,014,0134,0,13 ,0 ,13 ,30 ,0,3,1,3,0,1,0,76.14,43.33 ,33.33
03,014,01,014,0135,0,15 ,1 ,16 ,24 ,0,3,1,3,0,1,0,76.14,66.67 ,33.33
03,014,01,014,0136,0,5 ,0 ,5 ,8 ,0,3,1,3,0,1,0,76.14,62.50 ,33.33
03,014,01,014,0137,0,7 ,0 ,7 ,16 ,0,3,1,3,0,1,0,76.14,43.75 ,33.33
03,014,01,015,0138,0,60 ,1 ,61 ,140 ,0,3,1,3,0,1,0,76.14,43.57 ,33.33
03,014,01,015,0139,0,31 ,0 ,31 ,65 ,0,3,1,3,0,1,0,76.14,47.69 ,33.33
03,014,01,015,0140,0,23 ,0 ,23 ,59 ,0,3,1,3,0,1,0,76.14,38.98 ,33.33
03,014,01,015,0141,0,6 ,0 ,6 ,16 ,0,3,1,3,0,1,0,76.14,37.50 ,33.33
03,014,01,015,0142,0,8 ,0 ,8 ,34 ,0,3,1,3,0,1,0,76.14,23.53 ,33.33
03,014,01,015,0143,0,10 ,0 ,10 ,23 ,0,3,1,3,0,1,0,76.14,43.48 ,33.33
03,014,01,016,0144,0,32 ,0 ,32 ,105 ,0,3,1,3,0,1,0,76.14,30.48 ,33.33
03,014,01,016,0145,0,46 ,0 ,46 ,116 ,0,3,1,3,0,1,0,76.14,39.66 ,33.33
03,014,01,016,0146,0,9 ,0 ,9 ,38 ,0,3,1,3,0,1,0,76.14,23.68 ,33.33
03,014,01,016,0147,0,4 ,0 ,4 ,25 ,0,3,1,3,0,1,0,76.14,16.00 ,33.33
03,015,01,001,0001,0,687 ,3 ,690 ,1307 ,0,3,1,3,0,1,0,76.14,52.79 ,33.33
03,015,01,001,0002,0,1460 ,19 ,1479 ,2790 ,0,3,1,3,0,1,0,76.14,53.01 ,33.33
03,015,01,001,0003,0,1164 ,17 ,1181 ,2380 ,0,3,1,3,0,1,0,76.14,49.62 ,33.33
03,015,01,001,0004,0,337 ,1 ,338 ,782 ,0,3,1,3,0,1,0,76.14,43.22 ,33.33
03,015,01,001,0005,0,807 ,5 ,812 ,1782 ,0,3,1,3,0,1,0,76.14,45.57 ,33.33
03,015,01,001,0006,0,1162 ,12 ,1174 ,2244 ,0,3,1,3,0,1,0,76.14,52.32 ,33.33
03,015,01,001,0007,0,935 ,9 ,944 ,1787 ,0,3,1,3,0,1,0,76.14,52.83 ,33.33
03,015,01,001,0008,0,1302 ,6 ,1308 ,2683 ,0,3,1,3,0,1,0,76.14,48.75 ,33.33
03,015,01,001,0009,0,638 ,7 ,645 ,1201 ,0,3,1,3,0,1,0,76.14,53.71 ,33.33
03,015,01,001,0010,0,233 ,2 ,235 ,491 ,0,3,1,3,0,1,0,76.14,47.86 ,33.33
03,015,01,001,0011,0,356 ,2 ,358 ,647 ,0,3,1,3,0,1,0,76.14,55.33 ,33.33
03,015,01,001,0012,0,331 ,4 ,335 ,571 ,0,3,1,3,0,1,0,76.14,58.6690017513,33.33
03,015,01,001,0013,0,215 ,0 ,215 ,345 ,0,3,1,3,0,1,0,76.14,62.3188405797,33.33
03,015,01,001,0014,0,312 ,0 ,312 ,552 ,0,3,1,3,0,1,0,76.14,56.52 ,33.33
03,015,01,001,0015,0,710 ,13 ,723 ,1342 ,0,3,1,3,0,1,0,76.14,53.87 ,33.33
03,015,01,001,0016,0,237 ,3 ,240 ,449 ,0,3,1,3,0,1,0,76.14,53.45 ,33.33
03,015,01,001,0017,0,374 ,1 ,375 ,675 ,0,3,1,3,0,1,0,76.14,55.56 ,33.33
03,015,01,001,0018,0,520 ,8 ,528 ,976 ,0,3,1,3,0,1,0,76.14,54.10 ,33.33
03,015,01,001,0019,0,323 ,3 ,326 ,607 ,0,3,1,3,0,1,0,76.14,53.71 ,33.33
03,015,01,001,0020,0,395 ,0 ,395 ,720 ,0,3,1,3,0,1,0,76.14,54.86 ,33.33
03,015,01,001,0021,0,530 ,4 ,534 ,1055 ,0,3,1,3,0,1,0,76.14,50.62 ,33.33
03,015,01,001,0022,0,408 ,3 ,411 ,836 ,0,3,1,3,0,1,0,76.14,49.16 ,33.33
03,015,01,001,0023,0,1465 ,16 ,1481 ,2843 ,0,3,1,3,0,1,0,76.14,52.0928596553,33.33
03,015,01,001,0024,0,828 ,6 ,834 ,1701 ,0,3,1,3,0,1,0,76.14,49.03 ,33.33
03,015,01,001,0025,0,1393 ,7 ,1400 ,2735 ,0,3,1,3,0,1,0,76.14,51.19 ,33.33
03,015,01,001,0026,0,1127 ,9 ,1136 ,2299 ,0,3,1,3,0,1,0,76.14,49.41 ,33.33
03,015,01,001,0027,0,1924 ,14 ,1938 ,4017 ,0,3,1,3,0,1,0,76.14,48.24 ,33.33
03,015,01,001,0028,0,1219 ,5 ,1224 ,2451 ,0,3,1,3,0,1,0,76.14,49.94 ,33.33
03,015,01,001,0029,0,1516 ,12 ,1528 ,3081 ,0,3,1,3,0,1,0,76.14,49.59 ,33.33
03,015,01,001,0030,0,770 ,9 ,779 ,1692 ,0,3,1,3,0,1,0,76.14,46.04 ,33.33
03,015,01,001,0031,0,477 ,4 ,481 ,1002 ,0,3,1,3,0,1,0,76.14,48.00 ,33.33
03,015,01,001,0032,0,263 ,3 ,266 ,495 ,0,3,1,3,0,1,0,76.14,53.74 ,33.33
03,015,01,001,0033,0,667 ,6 ,673 ,1225 ,0,3,1,3,0,1,0,76.14,54.9387755102,33.33
03,015,01,001,0034,0,415 ,7 ,422 ,799 ,0,3,1,3,0,1,0,76.14,52.816020025,33.33
03,015,01,001,0035,0,986 ,6 ,992 ,2006 ,0,3,1,3,0,1,0,76.14,49.45 ,33.33
03,015,01,001,0036,0,888 ,5 ,893 ,1760 ,0,3,1,3,0,1,0,76.14,50.74 ,33.33
03,015,01,001,0037,0,992 ,3 ,995 ,2121 ,0,3,1,3,0,1,0,76.14,46.91 ,33.33
03,015,01,001,0038,0,1053 ,5 ,1058 ,2490 ,0,3,1,3,0,1,0,76.14,42.49 ,33.33
03,015,01,001,0039,0,606 ,5 ,611 ,1202 ,0,3,1,3,0,1,0,76.14,50.83 ,33.33
03,015,01,001,0040,0,2070 ,16 ,2086 ,4344 ,0,3,1,3,0,1,0,76.14,48.02 ,33.33
03,015,01,001,0041,0,1586 ,13 ,1599 ,3285 ,0,3,1,3,0,1,0,76.14,48.68 ,33.33
03,015,01,001,0042,0,383 ,2 ,385 ,807 ,0,3,1,3,0,1,0,76.14,47.70755886,33.33
03,015,01,001,0043,0,1283 ,10 ,1293 ,2883 ,0,3,1,3,0,1,0,76.14,44.85 ,33.33
03,015,01,001,0044,0,352 ,3 ,355 ,913 ,0,3,1,3,0,1,0,76.14,38.88 ,33.33
03,015,01,002,0045,0,647 ,7 ,654 ,1264 ,0,3,1,3,0,1,0,76.14,51.7405063291,33.33
03,015,01,002,0046,0,455 ,4 ,459 ,822 ,0,3,1,3,0,1,0,76.14,55.84 ,33.33
03,015,01,002,0047,0,946 ,6 ,952 ,1906 ,0,3,1,3,0,1,0,76.14,49.95 ,33.33
03,015,01,002,0048,0,761 ,8 ,769 ,1609 ,0,3,1,3,0,1,0,76.14,47.79 ,33.33
03,015,01,002,0049,0,1153 ,12 ,1165 ,2441 ,0,3,1,3,0,1,0,76.14,47.73 ,33.33
03,015,01,002,0050,0,274 ,4 ,278 ,614 ,0,3,1,3,0,1,0,76.14,45.28 ,33.33
03,015,01,002,0051,0,1359 ,11 ,1370 ,2757 ,0,3,1,3,0,1,0,76.14,49.69 ,33.33
03,015,01,002,0052,0,499 ,5 ,504 ,965 ,0,3,1,3,0,1,0,76.14,52.23 ,33.33
03,015,01,003,0053,0,143 ,0 ,143 ,326 ,0,3,1,3,0,1,0,76.14,43.87 ,33.33
03,015,01,003,0054,0,189 ,1 ,190 ,346 ,0,3,1,3,0,1,0,76.14,54.91 ,33.33
03,015,01,003,0055,0,137 ,2 ,139 ,371 ,0,3,1,3,0,1,0,76.14,37.4663072776,33.33
03,015,01,003,0056,0,54 ,0 ,54 ,120 ,0,3,1,3,0,1,0,76.14,45,33.33
03,015,01,003,0057,0,54 ,0 ,54 ,153 ,0,3,1,3,0,1,0,76.14,35.29 ,33.33
03,015,01,003,0058,0,65 ,1 ,66 ,144 ,0,3,1,3,0,1,0,76.14,45.83 ,33.33
03,015,01,003,0059,0,49 ,1 ,50 ,104 ,0,3,1,3,0,1,0,76.14,48.08 ,33.33
03,015,01,003,0060,0,37 ,0 ,37 ,73 ,0,3,1,3,0,1,0,76.14,50.68 ,33.33
03,015,01,003,0061,0,38 ,2 ,40 ,83 ,0,3,1,3,0,1,0,76.14,48.19 ,33.33
03,015,01,004,0062,0,1472 ,9 ,1481 ,3200 ,0,3,1,3,0,1,0,76.14,46.28125,33.33
03,015,01,004,0063,0,1139 ,6 ,1145 ,2456 ,0,3,1,3,0,1,0,76.14,46.6205211726,33.33
03,015,01,004,0064,0,2267 ,26 ,2293 ,4625 ,0,3,1,3,0,1,0,76.14,49.58 ,33.33
03,015,01,004,0065,0,1673 ,13 ,1686 ,3609 ,0,3,1,3,0,1,0,76.14,46.72 ,33.33
03,015,01,004,0066,0,969 ,2 ,971 ,1997 ,0,3,1,3,0,1,0,76.14,48.6229344016,33.33
03,015,01,004,0067,0,580 ,6 ,586 ,1096 ,0,3,1,3,0,1,0,76.14,53.4671532847,33.33
03,015,01,004,0068,0,373 ,5 ,378 ,810 ,0,3,1,3,0,1,0,76.14,46.67 ,33.33
03,015,01,004,0069,0,1012 ,10 ,1022 ,2082 ,0,3,1,3,0,1,0,76.14,49.09 ,33.33
03,015,01,004,0070,0,1293 ,12 ,1305 ,2512 ,0,3,1,3,0,1,0,76.14,51.95 ,33.33
03,015,01,004,0071,0,983 ,3 ,986 ,2166 ,0,3,1,3,0,1,0,76.14,45.52 ,33.33
03,015,01,004,0072,0,1275 ,13 ,1288 ,2707 ,0,3,1,3,0,1,0,76.14,47.58 ,33.33
03,015,01,004,0073,0,2961 ,20 ,2981 ,5883 ,0,3,1,3,0,1,0,76.14,50.67 ,33.33
03,015,01,004,0074,0,1734 ,19 ,1753 ,3600 ,0,3,1,3,0,1,0,76.14,48.6944444444,33.33
03,015,01,004,0075,0,2208 ,16 ,2224 ,4585 ,0,3,1,3,0,1,0,76.14,48.505997819,33.33
03,015,01,004,0076,0,1444 ,8 ,1452 ,3190 ,0,3,1,3,0,1,0,76.14,45.52 ,33.33
03,015,01,004,0077,0,644 ,5 ,649 ,1420 ,0,3,1,3,0,1,0,76.14,45.70 ,33.33
03,015,01,004,0078,0,1400 ,16 ,1416 ,3118 ,0,3,1,3,0,1,0,76.14,45.41 ,33.33
03,015,01,004,0079,0,471 ,2 ,473 ,923 ,0,3,1,3,0,1,0,76.14,51.2459371614,33.33
03,015,01,005,0080,0,422 ,2 ,424 ,780 ,0,3,1,3,0,1,0,76.14,54.358974359,33.33
03,015,01,005,0081,0,161 ,1 ,162 ,285 ,0,3,1,3,0,1,0,76.14,56.8421052632,33.33
03,015,01,005,0082,0,901 ,6 ,907 ,1787 ,0,3,1,3,0,1,0,76.14,50.76 ,33.33
03,015,01,005,0083,0,551 ,3 ,554 ,1170 ,0,3,1,3,0,1,0,76.14,47.35 ,33.33
03,015,01,005,0084,0,331 ,1 ,332 ,629 ,0,3,1,3,0,1,0,76.14,52.78 ,33.33
03,015,01,005,0085,0,557 ,6 ,563 ,1059 ,0,3,1,3,0,1,0,76.14,53.16 ,33.33
03,015,01,005,0086,0,279 ,2 ,281 ,506 ,0,3,1,3,0,1,0,76.14,55.53 ,33.33
03,015,01,005,0087,0,68 ,1 ,69 ,145 ,0,3,1,3,0,1,0,76.14,47.59 ,33.33
03,015,01,005,0088,0,275 ,3 ,278 ,538 ,0,3,1,3,0,1,0,76.14,51.67 ,33.33
03,015,01,005,0089,0,538 ,3 ,541 ,1065 ,0,3,1,3,0,1,0,76.14,50.80 ,33.33
03,015,01,005,0090,0,869 ,9 ,878 ,1873 ,0,3,1,3,0,1,0,76.14,46.88 ,33.33
03,015,01,005,0091,0,177 ,1 ,178 ,347 ,0,3,1,3,0,1,0,76.14,51.30 ,33.33
03,015,01,005,0092,0,75 ,0 ,75 ,143 ,0,3,1,3,0,1,0,76.14,52.45 ,33.33
03,015,01,005,0093,0,104 ,0 ,104 ,235 ,0,3,1,3,0,1,0,76.14,44.26 ,33.33
03,015,01,005,0094,0,157 ,1 ,158 ,351 ,0,3,1,3,0,1,0,76.14,45.01 ,33.33
03,015,01,005,0095,0,181 ,2 ,183 ,403 ,0,3,1,3,0,1,0,76.14,45.41 ,33.33
03,015,01,006,0096,0,638 ,5 ,643 ,1153 ,0,3,1,3,0,1,0,76.14,55.77 ,33.33
03,015,01,006,0097,0,355 ,3 ,358 ,612 ,0,3,1,3,0,1,0,76.14,58.50 ,33.33
03,015,01,006,0098,0,407 ,2 ,409 ,675 ,0,3,1,3,0,1,0,76.14,60.59 ,33.33
03,015,01,006,0099,0,615 ,3 ,618 ,1086 ,0,3,1,3,0,1,0,76.14,56.91 ,33.33
03,015,01,006,0100,0,460 ,0 ,460 ,839 ,0,3,1,3,0,1,0,76.14,54.83 ,33.33
03,015,01,006,0101,0,106 ,1 ,107 ,215 ,0,3,1,3,0,1,0,76.14,49.7674418605,33.33
03,015,01,006,0102,0,593 ,5 ,598 ,1206 ,0,3,1,3,0,1,0,76.14,49.59 ,33.33
03,015,01,006,0103,0,327 ,5 ,332 ,622 ,0,3,1,3,0,1,0,76.14,53.38 ,33.33
03,015,01,006,0104,0,312 ,2 ,314 ,633 ,0,3,1,3,0,1,0,76.14,49.61 ,33.33
03,015,01,006,0105,0,426 ,7 ,433 ,817 ,0,3,1,3,0,1,0,76.14,52.9987760098,33.33
03,015,01,006,0106,0,492 ,5 ,497 ,969 ,0,3,1,3,0,1,0,76.14,51.2899896801,33.33
03,015,01,006,0107,0,64 ,0 ,64 ,109 ,0,3,1,3,0,1,0,76.14,58.72 ,33.33
03,015,01,007,0108,0,552 ,4 ,556 ,1032 ,0,3,1,3,0,1,0,76.14,53.88 ,33.33
03,015,01,007,0109,0,488 ,2 ,490 ,828 ,0,3,1,3,0,1,0,76.14,59.18 ,33.33
03,015,01,007,0110,0,119 ,1 ,120 ,283 ,0,3,1,3,0,1,0,76.14,42.40 ,33.33
03,015,01,007,0111,0,180 ,0 ,180 ,368 ,0,3,1,3,0,1,0,76.14,48.91 ,33.33
03,015,01,007,0112,0,383 ,5 ,388 ,697 ,0,3,1,3,0,1,0,76.14,55.67 ,33.33
03,015,01,007,0113,0,81 ,0 ,81 ,194 ,0,3,1,3,0,1,0,76.14,41.7525773196,33.33
03,015,01,007,0114,0,161 ,1 ,162 ,328 ,0,3,1,3,0,1,0,76.14,49.39 ,33.33
03,015,01,007,0115,0,40 ,0 ,40 ,104 ,0,3,1,3,0,1,0,76.14,38.46 ,33.33
03,015,01,007,0116,0,74 ,2 ,76 ,174 ,0,3,1,3,0,1,0,76.14,43.68 ,33.33
03,015,01,007,0117,0,253 ,3 ,256 ,423 ,0,3,1,3,0,1,0,76.14,60.52 ,33.33
03,015,01,007,0118,0,315 ,4 ,319 ,600 ,0,3,1,3,0,1,0,76.14,53.17 ,33.33
03,015,01,007,0119,0,139 ,4 ,143 ,317 ,0,3,1,3,0,1,0,76.14,45.1104100946,33.33
03,015,01,007,0120,0,162 ,2 ,164 ,367 ,0,3,1,3,0,1,0,76.14,44.6866485014,33.33
03,015,01,007,0121,0,245 ,4 ,249 ,523 ,0,3,1,3,0,1,0,76.14,47.61 ,33.33
03,015,01,008,0122,0,31 ,0 ,31 ,97 ,0,3,1,3,0,1,0,76.14,31.96 ,33.33
03,015,01,008,0123,0,69 ,0 ,69 ,138 ,0,3,1,3,0,1,0,76.14,50.00 ,33.33
03,015,01,008,0124,0,265 ,6 ,271 ,586 ,0,3,1,3,0,1,0,76.14,46.25 ,33.33
03,015,01,008,0125,0,23 ,0 ,23 ,74 ,0,3,1,3,0,1,0,76.14,31.08 ,33.33
03,015,01,008,0126,0,35 ,0 ,35 ,75 ,0,3,1,3,0,1,0,76.14,46.67 ,33.33
03,015,01,009,0127,0,15 ,1 ,16 ,44 ,0,3,1,3,0,1,0,76.14,36.36 ,33.33
03,015,01,009,0128,0,13 ,1 ,14 ,34 ,0,3,1,3,0,1,0,76.14,41.18 ,33.33
03,015,01,009,0129,0,24 ,0 ,24 ,47 ,0,3,1,3,0,1,0,76.14,51.06 ,33.33
03,015,01,009,0130,0,33 ,0 ,33 ,58 ,0,3,1,3,0,1,0,76.14,56.90 ,33.33
03,015,01,009,0131,0,10 ,0 ,10 ,34 ,0,3,1,3,0,1,0,76.14,29.41 ,33.33
03,015,01,009,0132,0,37 ,0 ,37 ,86 ,0,3,1,3,0,1,0,76.14,43.02 ,33.33
03,015,01,010,0133,0,887 ,3 ,890 ,1767 ,0,3,1,3,0,1,0,76.14,50.37 ,33.33
03,015,01,010,0134,0,766 ,6 ,772 ,1533 ,0,3,1,3,0,1,0,76.14,50.36 ,33.33
03,015,01,010,0135,0,215 ,1 ,216 ,387 ,0,3,1,3,0,1,0,76.14,55.8139534884,33.33
03,015,01,010,0136,0,381 ,1 ,382 ,813 ,0,3,1,3,0,1,0,76.14,46.9864698647,33.33
03,015,01,010,0137,0,166 ,0 ,166 ,369 ,0,3,1,3,0,1,0,76.14,44.99 ,33.33
03,015,01,010,0138,0,210 ,3 ,213 ,468 ,0,3,1,3,0,1,0,76.14,45.51 ,33.33
03,015,01,010,0139,0,120 ,1 ,121 ,276 ,0,3,1,3,0,1,0,76.14,43.8405797101,33.33
03,015,01,010,0140,0,25 ,0 ,25 ,51 ,0,3,1,3,0,1,0,76.14,49.0196078431,33.33
03,015,01,010,0141,0,327 ,2 ,329 ,605 ,0,3,1,3,0,1,0,76.14,54.38 ,33.33
03,015,01,010,0142,0,104 ,3 ,107 ,275 ,0,3,1,3,0,1,0,76.14,38.91 ,33.33
03,015,01,010,0143,0,222 ,2 ,224 ,444 ,0,3,1,3,0,1,0,76.14,50.45 ,33.33
03,015,01,011,0144,0,2122 ,21 ,2143 ,4269 ,0,3,1,3,0,1,0,76.14,50.20 ,33.33
03,015,01,011,0145,0,677 ,5 ,682 ,1322 ,0,3,1,3,0,1,0,76.14,51.59 ,33.33
03,015,01,011,0146,0,790 ,7 ,797 ,1643 ,0,3,1,3,0,1,0,76.14,48.51 ,33.33
03,015,01,011,0147,0,820 ,37 ,857 ,2392 ,0,3,1,3,0,1,0,76.14,35.83 ,33.33
03,015,01,011,0148,0,476 ,3 ,479 ,1001 ,0,3,1,3,0,1,0,76.14,47.85 ,33.33
03,015,01,011,0149,0,522 ,7 ,529 ,1080 ,0,3,1,3,0,1,0,76.14,48.98 ,33.33
03,015,01,011,0150,0,200 ,6 ,206 ,536 ,0,3,1,3,0,1,0,76.14,38.43 ,33.33
03,015,01,011,0151,0,146 ,1 ,147 ,358 ,0,3,1,3,0,1,0,76.14,41.06 ,33.33
03,015,01,011,0152,0,160 ,0 ,160 ,331 ,0,3,1,3,0,1,0,76.14,48.34 ,33.33
03,015,01,011,0153,0,405 ,4 ,409 ,930 ,0,3,1,3,0,1,0,76.14,43.98 ,33.33
03,015,01,011,0154,0,199 ,3 ,202 ,476 ,0,3,1,3,0,1,0,76.14,42.44 ,33.33
03,015,01,011,0155,0,173 ,5 ,178 ,455 ,0,3,1,3,0,1,0,76.14,39.12 ,33.33
03,015,01,011,0156,0,30 ,0 ,30 ,76 ,0,3,1,3,0,1,0,76.14,39.47 ,33.33
03,015,01,011,0157,0,482 ,2 ,484 ,939 ,0,3,1,3,0,1,0,76.14,51.54 ,33.33
03,015,01,011,0158,0,452 ,4 ,456 ,972 ,0,3,1,3,0,1,0,76.14,46.91 ,33.33
03,015,01,012,0159,0,202 ,2 ,204 ,420 ,0,3,1,3,0,1,0,76.14,48.57 ,33.33
03,015,01,012,0160,0,445 ,3 ,448 ,1120 ,0,3,1,3,0,1,0,76.14,40.00 ,33.33
03,015,01,012,0161,0,214 ,2 ,216 ,585 ,0,3,1,3,0,1,0,76.14,36.92 ,33.33
03,015,01,012,0162,0,223 ,4 ,227 ,547 ,0,3,1,3,0,1,0,76.14,41.50 ,33.33
03,015,01,012,0163,0,483 ,5 ,488 ,1031 ,0,3,1,3,0,1,0,76.14,47.33 ,33.33
03,015,01,012,0164,0,189 ,3 ,192 ,446 ,0,3,1,3,0,1,0,76.14,43.05 ,33.33
03,015,01,012,0165,0,407 ,2 ,409 ,837 ,0,3,1,3,0,1,0,76.14,48.86 ,33.33
03,015,01,012,0166,0,182 ,2 ,184 ,389 ,0,3,1,3,0,1,0,76.14,47.30 ,33.33
03,015,01,012,0167,0,696 ,5 ,701 ,1494 ,0,3,1,3,0,1,0,76.14,46.92 ,33.33
03,015,01,012,0168,0,200 ,0 ,200 ,507 ,0,3,1,3,0,1,0,76.14,39.45 ,33.33
03,015,01,012,0169,0,143 ,1 ,144 ,312 ,0,3,1,3,0,1,0,76.14,46.15 ,33.33
03,015,01,012,0170,0,218 ,3 ,221 ,517 ,0,3,1,3,0,1,0,76.14,42.75 ,33.33
03,015,01,012,0171,0,291 ,1 ,292 ,536 ,0,3,1,3,0,1,0,76.14,54.48 ,33.33
03,015,01,013,0172,0,9 ,0 ,9 ,19 ,0,3,1,3,0,1,0,76.14,47.3684210526,33.33
03,015,01,013,0173,0,13 ,0 ,13 ,37 ,0,3,1,3,0,1,0,76.14,35.1351351351,33.33
03,015,01,013,0174,0,16 ,0 ,16 ,25 ,0,3,1,3,0,1,0,76.14,64.00 ,33.33
03,015,01,013,0175,0,40 ,0 ,40 ,79 ,0,3,1,3,0,1,0,76.14,50.63 ,33.33
03,015,01,013,0176,0,39 ,0 ,39 ,87 ,0,3,1,3,0,1,0,76.14,44.8275862069,33.33
03,015,01,013,0177,0,36 ,0 ,36 ,69 ,0,3,1,3,0,1,0,76.14,52.17 ,33.33
03,016,01,001,0001,0,187 ,1 ,188 ,300 ,0,3,1,3,0,1,0,76.14,62.67 ,33.33
03,016,01,001,0002,0,187 ,0 ,187 ,319 ,0,3,1,3,0,1,0,76.14,58.62 ,33.33
03,016,01,001,0003,0,314 ,4 ,318 ,526 ,0,3,1,3,0,1,0,76.14,60.46 ,33.33
03,016,01,001,0004,0,283 ,4 ,287 ,491 ,0,3,1,3,0,1,0,76.14,58.45 ,33.33
03,016,01,001,0005,0,509 ,7 ,516 ,867 ,0,3,1,3,0,1,0,76.14,59.52 ,33.33
03,016,01,001,0006,0,585 ,5 ,590 ,978 ,0,3,1,3,0,1,0,76.14,60.33 ,33.33
03,016,01,001,0007,0,423 ,5 ,428 ,705 ,0,3,1,3,0,1,0,76.14,60.71 ,33.33
03,016,01,001,0008,0,1047 ,3 ,1050 ,1826 ,0,3,1,3,0,1,0,76.14,57.50 ,33.33
03,016,01,001,0009,0,671 ,5 ,676 ,1159 ,0,3,1,3,0,1,0,76.14,58.33 ,33.33
03,016,01,001,0010,0,1419 ,7 ,1426 ,2398 ,0,3,1,3,0,1,0,76.14,59.47 ,33.33
03,016,01,001,0011,0,2585 ,23 ,2608 ,4661 ,0,3,1,3,0,1,0,76.14,55.95 ,33.33
03,016,01,001,0012,0,1264 ,12 ,1276 ,2272 ,0,3,1,3,0,1,0,76.14,56.16 ,33.33
03,016,01,001,0013,0,686 ,3 ,689 ,1159 ,0,3,1,3,0,1,0,76.14,59.45 ,33.33
03,016,01,001,0014,0,1609 ,9 ,1618 ,2846 ,0,3,1,3,0,1,0,76.14,56.85 ,33.33
03,016,01,001,0015,0,1194 ,9 ,1203 ,2033 ,0,3,1,3,0,1,0,76.14,59.17 ,33.33
03,016,01,001,0016,0,1201 ,5 ,1206 ,2084 ,0,3,1,3,0,1,0,76.14,57.87 ,33.33
03,016,01,001,0017,0,763 ,5 ,768 ,1231 ,0,3,1,3,0,1,0,76.14,62.39 ,33.33
03,016,01,001,0018,0,403 ,7 ,410 ,686 ,0,3,1,3,0,1,0,76.14,59.77 ,33.33
03,016,01,001,0019,0,355 ,3 ,358 ,567 ,0,3,1,3,0,1,0,76.14,63.14 ,33.33
03,016,01,001,0020,0,873 ,10 ,883 ,1512 ,0,3,1,3,0,1,0,76.14,58.40 ,33.33
03,016,01,001,0021,0,221 ,4 ,225 ,323 ,0,3,1,3,0,1,0,76.14,69.66 ,33.33
03,016,01,001,0022,0,791 ,5 ,796 ,1374 ,0,3,1,3,0,1,0,76.14,57.93 ,33.33
03,016,01,001,0023,0,268 ,2 ,270 ,436 ,0,3,1,3,0,1,0,76.14,61.93 ,33.33
03,016,01,001,0024,0,365 ,0 ,365 ,604 ,0,3,1,3,0,1,0,76.14,60.43 ,33.33
03,016,01,001,0025,0,493 ,4 ,497 ,814 ,0,3,1,3,0,1,0,76.14,61.06 ,33.33
03,016,01,001,0026,0,258 ,1 ,259 ,387 ,0,3,1,3,0,1,0,76.14,66.93 ,33.33
03,016,01,001,0027,0,1071 ,7 ,1078 ,2034 ,0,3,1,3,0,1,0,76.14,53.00 ,33.33
03,016,01,001,0028,0,820 ,6 ,826 ,1406 ,0,3,1,3,0,1,0,76.14,58.75 ,33.33
03,016,01,001,0029,0,104 ,2 ,106 ,178 ,0,3,1,3,0,1,0,76.14,59.55 ,33.33
03,016,01,001,0030,0,207 ,2 ,209 ,336 ,0,3,1,3,0,1,0,76.14,62.20 ,33.33
03,016,01,001,0031,0,628 ,4 ,632 ,1064 ,0,3,1,3,0,1,0,76.14,59.40 ,33.33
03,016,01,001,0032,0,664 ,6 ,670 ,1231 ,0,3,1,3,0,1,0,76.14,54.43 ,33.33
03,016,01,001,0033,0,207 ,2 ,209 ,602 ,0,3,1,3,0,1,0,76.14,34.72 ,33.33
03,016,01,001,0034,0,55 ,0 ,55 ,201 ,0,3,1,3,0,1,0,76.14,27.36 ,33.33
03,016,01,002,0035,0,532 ,8 ,540 ,845 ,0,3,1,3,0,1,0,76.14,63.91 ,33.33
03,016,01,002,0036,0,187 ,1 ,188 ,306 ,0,3,1,3,0,1,0,76.14,61.44 ,33.33
03,016,01,002,0037,0,106 ,0 ,106 ,203 ,0,3,1,3,0,1,0,76.14,52.22 ,33.33
03,016,01,002,0038,0,148 ,1 ,149 ,243 ,0,3,1,3,0,1,0,76.14,61.32 ,33.33
03,016,01,002,0039,0,359 ,4 ,363 ,607 ,0,3,1,3,0,1,0,76.14,59.80 ,33.33
03,016,01,002,0040,0,169 ,3 ,172 ,279 ,0,3,1,3,0,1,0,76.14,61.65 ,33.33
03,016,01,002,0041,0,328 ,4 ,332 ,556 ,0,3,1,3,0,1,0,76.14,59.71 ,33.33
03,016,01,002,0042,0,263 ,0 ,263 ,459 ,0,3,1,3,0,1,0,76.14,57.30 ,33.33
03,016,01,002,0043,0,268 ,1 ,269 ,421 ,0,3,1,3,0,1,0,76.14,63.90 ,33.33
03,016,01,002,0044,0,64 ,0 ,64 ,108 ,0,3,1,3,0,1,0,76.14,59.26 ,33.33
03,016,01,002,0045,0,436 ,7 ,443 ,722 ,0,3,1,3,0,1,0,76.14,61.36 ,33.33
03,016,01,002,0046,0,90 ,0 ,90 ,165 ,0,3,1,3,0,1,0,76.14,54.55 ,33.33
03,016,01,002,0047,0,179 ,1 ,180 ,296 ,0,3,1,3,0,1,0,76.14,60.81 ,33.33
03,016,01,002,0048,0,143 ,1 ,144 ,228 ,0,3,1,3,0,1,0,76.14,63.16 ,33.33
03,016,01,002,0049,0,101 ,0 ,101 ,166 ,0,3,1,3,0,1,0,76.14,60.84 ,33.33
03,016,01,002,0050,0,130 ,0 ,130 ,189 ,0,3,1,3,0,1,0,76.14,68.78 ,33.33
03,016,01,002,0051,0,61 ,0 ,61 ,109 ,0,3,1,3,0,1,0,76.14,55.96 ,33.33
03,016,01,002,0052,0,402 ,2 ,404 ,628 ,0,3,1,3,0,1,0,76.14,64.33 ,33.33
03,016,01,002,0053,0,470 ,4 ,474 ,876 ,0,3,1,3,0,1,0,76.14,54.11 ,33.33
03,016,01,002,0054,0,303 ,1 ,304 ,532 ,0,3,1,3,0,1,0,76.14,57.14 ,33.33
03,016,01,002,0055,0,902 ,8 ,910 ,1535 ,0,3,1,3,0,1,0,76.14,59.28 ,33.33
03,016,01,002,0056,0,387 ,1 ,388 ,641 ,0,3,1,3,0,1,0,76.14,60.53 ,33.33
03,016,01,003,0057,0,279 ,2 ,281 ,441 ,0,3,1,3,0,1,0,76.14,63.72 ,33.33
03,016,01,003,0058,0,306 ,2 ,308 ,537 ,0,3,1,3,0,1,0,76.14,57.36 ,33.33
03,016,01,003,0059,0,53 ,1 ,54 ,89 ,0,3,1,3,0,1,0,76.14,60.67 ,33.33
03,016,01,003,0060,0,75 ,0 ,75 ,117 ,0,3,1,3,0,1,0,76.14,64.10 ,33.33
03,016,01,003,0061,0,123 ,2 ,125 ,239 ,0,3,1,3,0,1,0,76.14,52.30 ,33.33
03,016,01,003,0062,0,112 ,0 ,112 ,207 ,0,3,1,3,0,1,0,76.14,54.11 ,33.33
03,016,01,003,0063,0,98 ,0 ,98 ,145 ,0,3,1,3,0,1,0,76.14,67.59 ,33.33
03,016,01,003,0064,0,751 ,8 ,759 ,1306 ,0,3,1,3,0,1,0,76.14,58.12 ,33.33
03,016,01,003,0065,0,154 ,2 ,156 ,282 ,0,3,1,3,0,1,0,76.14,55.32 ,33.33
03,016,01,003,0066,0,373 ,4 ,377 ,644 ,0,3,1,3,0,1,0,76.14,58.54 ,33.33
03,016,01,003,0067,0,382 ,1 ,383 ,673 ,0,3,1,3,0,1,0,76.14,56.91 ,33.33
03,016,01,003,0068,0,510 ,4 ,514 ,1212 ,0,3,1,3,0,1,0,76.14,42.41 ,33.33
03,016,01,003,0069,0,276 ,41 ,317 ,972 ,0,3,1,3,0,1,0,76.14,32.61 ,33.33
03,016,01,003,0070,0,70 ,0 ,70 ,209 ,0,3,1,3,0,1,0,76.14,33.49 ,33.33
03,016,01,003,0071,0,80 ,3 ,83 ,175 ,0,3,1,3,0,1,0,76.14,47.43 ,33.33
03,016,01,004,0072,0,130 ,0 ,130 ,253 ,0,3,1,3,0,1,0,76.14,51.38 ,33.33
03,016,01,004,0073,0,194 ,2 ,196 ,387 ,0,3,1,3,0,1,0,76.14,50.65 ,33.33
03,016,01,004,0074,0,405 ,4 ,409 ,748 ,0,3,1,3,0,1,0,76.14,54.68 ,33.33
03,016,01,004,0075,0,135 ,0 ,135 ,262 ,0,3,1,3,0,1,0,76.14,51.53 ,33.33
03,016,01,004,0076,0,298 ,6 ,304 ,597 ,0,3,1,3,0,1,0,76.14,50.92 ,33.33
03,016,01,004,0077,0,58 ,2 ,60 ,120 ,0,3,1,3,0,1,0,76.14,50.00 ,33.33
03,016,01,004,0078,0,265 ,1 ,266 ,495 ,0,3,1,3,0,1,0,76.14,53.74 ,33.33
03,016,01,004,0079,0,97 ,0 ,97 ,188 ,0,3,1,3,0,1,0,76.14,51.60 ,33.33
03,016,01,004,0080,0,273 ,1 ,274 ,583 ,0,3,1,3,0,1,0,76.14,47.00 ,33.33
03,016,01,004,0081,0,627 ,4 ,631 ,1178 ,0,3,1,3,0,1,0,76.14,53.57 ,33.33
03,016,01,004,0082,0,895 ,5 ,900 ,1783 ,0,3,1,3,0,1,0,76.14,50.48 ,33.33
03,016,01,005,0083,0,186 ,0 ,186 ,410 ,0,3,1,3,0,1,0,76.14,45.37 ,33.33
03,016,01,005,0084,0,133 ,1 ,134 ,311 ,0,3,1,3,0,1,0,76.14,43.09 ,33.33
03,016,01,005,0085,0,75 ,0 ,75 ,217 ,0,3,1,3,0,1,0,76.14,34.56 ,33.33
03,016,01,005,0086,0,133 ,0 ,133 ,280 ,0,3,1,3,0,1,0,76.14,47.50 ,33.33
03,016,01,005,0087,0,413 ,5 ,418 ,1166 ,0,3,1,3,0,1,0,76.14,35.85 ,33.33
03,016,01,005,0088,0,29 ,1 ,30 ,266 ,0,3,1,3,0,1,0,76.14,11.28 ,33.33
03,016,01,005,0089,0,39 ,0 ,39 ,331 ,0,3,1,3,0,1,0,76.14,11.78 ,33.33
03,016,01,005,0090,0,16 ,0 ,16 ,171 ,0,3,1,3,0,1,0,76.14,9.36 ,33.33
03,016,01,005,0091,0,97 ,3 ,100 ,217 ,0,3,1,3,0,1,0,76.14,46.08 ,33.33
03,016,01,006,0092,0,84 ,0 ,84 ,221 ,0,3,1,3,0,1,0,76.14,38.01 ,33.33
03,016,01,006,0093,0,148 ,0 ,148 ,409 ,0,3,1,3,0,1,0,76.14,36.19 ,33.33
03,016,01,006,0094,0,172 ,3 ,175 ,442 ,0,3,1,3,0,1,0,76.14,39.59 ,33.33
03,016,01,006,0095,0,104 ,2 ,106 ,254 ,0,3,1,3,0,1,0,76.14,41.73 ,33.33
03,016,01,006,0096,0,99 ,2 ,101 ,247 ,0,3,1,3,0,1,0,76.14,40.89 ,33.33
03,016,01,006,0097,0,348 ,1 ,349 ,831 ,0,3,1,3,0,1,0,76.14,42.00 ,33.33
03,017,01,001,0001,0,383 ,3 ,386 ,566 ,0,3,1,3,0,1,0,76.14,68.20 ,33.33
03,017,01,001,0002,0,1464 ,30 ,1494 ,2888 ,0,3,1,3,0,1,0,76.14,51.73 ,33.33
03,017,01,001,0003,0,894 ,10 ,904 ,1545 ,0,3,1,3,0,1,0,76.14,58.51 ,33.33
03,017,01,001,0004,0,645 ,6 ,651 ,1281 ,0,3,1,3,0,1,0,76.14,50.82 ,33.33
03,017,01,001,0005,0,1597 ,17 ,1614 ,3392 ,0,3,1,3,0,1,0,76.14,47.58 ,33.33
03,017,01,001,0006,0,1513 ,13 ,1526 ,3390 ,0,3,1,3,0,1,0,76.14,45.01 ,33.33
03,017,01,001,0007,0,798 ,2 ,800 ,1480 ,0,3,1,3,0,1,0,76.14,54.05 ,33.33
03,017,01,001,0008,0,1011 ,7 ,1018 ,1904 ,0,3,1,3,0,1,0,76.14,53.47 ,33.33
03,017,01,001,0009,0,464 ,2 ,466 ,898 ,0,3,1,3,0,1,0,76.14,51.89 ,33.33
03,017,01,001,0010,0,499 ,4 ,503 ,988 ,0,3,1,3,0,1,0,76.14,50.91 ,33.33
03,017,01,001,0011,0,628 ,11 ,639 ,1216 ,0,3,1,3,0,1,0,76.14,52.55 ,33.33
03,017,01,001,0012,0,1062 ,11 ,1073 ,2060 ,0,3,1,3,0,1,0,76.14,52.09 ,33.33
03,017,01,001,0013,0,794 ,5 ,799 ,1350 ,0,3,1,3,0,1,0,76.14,59.1851851852,33.33
03,017,01,001,0014,0,1205 ,10 ,1215 ,2120 ,0,3,1,3,0,1,0,76.14,57.31 ,33.33
03,017,01,001,0015,0,1112 ,15 ,1127 ,2093 ,0,3,1,3,0,1,0,76.14,53.85 ,33.33
03,017,01,001,0016,0,839 ,9 ,848 ,1476 ,0,3,1,3,0,1,0,76.14,57.45 ,33.33
03,017,01,001,0017,0,1379 ,7 ,1386 ,2379 ,0,3,1,3,0,1,0,76.14,58.26 ,33.33
03,017,01,001,0018,0,794 ,5 ,799 ,1298 ,0,3,1,3,0,1,0,76.14,61.56 ,33.33
03,017,01,001,0019,0,698 ,5 ,703 ,1260 ,0,3,1,3,0,1,0,76.14,55.79 ,33.33
03,017,01,001,0020,0,764 ,3 ,767 ,1438 ,0,3,1,3,0,1,0,76.14,53.34 ,33.33
03,017,01,001,0021,0,706 ,5 ,711 ,1311 ,0,3,1,3,0,1,0,76.14,54.23 ,33.33
03,017,01,001,0022,0,693 ,5 ,698 ,1228 ,0,3,1,3,0,1,0,76.14,56.84 ,33.33
03,017,01,001,0023,0,664 ,4 ,668 ,1169 ,0,3,1,3,0,1,0,76.14,57.1428571429,33.33
03,017,01,001,0024,0,796 ,3 ,799 ,1442 ,0,3,1,3,0,1,0,76.14,55.4091539528,33.33
03,017,01,001,0025,0,562 ,6 ,568 ,1007 ,0,3,1,3,0,1,0,76.14,56.41 ,33.33
03,017,01,001,0026,0,451 ,4 ,455 ,793 ,0,3,1,3,0,1,0,76.14,57.38 ,33.33
03,017,01,002,0027,0,701 ,4 ,705 ,1174 ,0,3,1,3,0,1,0,76.14,60.05 ,33.33
03,017,01,002,0028,0,765 ,6 ,771 ,1231 ,0,3,1,3,0,1,0,76.14,62.63 ,33.33
03,017,01,002,0029,0,557 ,1 ,558 ,974 ,0,3,1,3,0,1,0,76.14,57.29 ,33.33
03,017,01,002,0030,0,1387 ,13 ,1400 ,2359 ,0,3,1,3,0,1,0,76.14,59.3471810089,33.33
03,017,01,002,0031,0,484 ,5 ,489 ,812 ,0,3,1,3,0,1,0,76.14,60.2216748768,33.33
03,017,01,002,0032,0,745 ,7 ,752 ,1245 ,0,3,1,3,0,1,0,76.14,60.40 ,33.33
03,017,01,002,0033,0,414 ,4 ,418 ,684 ,0,3,1,3,0,1,0,76.14,61.11 ,33.33
03,017,01,002,0034,0,907 ,10 ,917 ,1710 ,0,3,1,3,0,1,0,76.14,53.63 ,33.33
03,017,01,002,0035,0,838 ,4 ,842 ,1448 ,0,3,1,3,0,1,0,76.14,58.15 ,33.33
03,017,01,002,0036,0,888 ,11 ,899 ,1539 ,0,3,1,3,0,1,0,76.14,58.41 ,33.33
03,017,01,002,0037,0,1253 ,14 ,1267 ,2355 ,0,3,1,3,0,1,0,76.14,53.80 ,33.33
03,017,01,002,0038,0,1739 ,12 ,1751 ,3389 ,0,3,1,3,0,1,0,76.14,51.6671584538,33.33
03,017,01,002,0039,0,952 ,7 ,959 ,1836 ,0,3,1,3,0,1,0,76.14,52.2331154684,33.33
03,017,01,002,0040,0,1746 ,10 ,1756 ,3344 ,0,3,1,3,0,1,0,76.14,52.51 ,33.33
03,017,01,002,0041,0,1491 ,12 ,1503 ,2667 ,0,3,1,3,0,1,0,76.14,56.36 ,33.33
03,017,01,002,0042,0,2093 ,11 ,2104 ,3979 ,0,3,1,3,0,1,0,76.14,52.88 ,33.33
03,017,01,002,0043,0,1958 ,10 ,1968 ,3899 ,0,3,1,3,0,1,0,76.14,50.47 ,33.33
03,017,01,002,0044,0,1151 ,10 ,1161 ,2483 ,0,3,1,3,0,1,0,76.14,46.76 ,33.33
03,017,01,002,0045,0,455 ,8 ,463 ,908 ,0,3,1,3,0,1,0,76.14,50.99 ,33.33
03,017,01,003,0046,0,934 ,12 ,946 ,1726 ,0,3,1,3,0,1,0,76.14,54.81 ,33.33
03,017,01,003,0047,0,544 ,8 ,552 ,947 ,0,3,1,3,0,1,0,76.14,58.29 ,33.33
03,017,01,003,0048,0,869 ,8 ,877 ,1526 ,0,3,1,3,0,1,0,76.14,57.47 ,33.33
03,017,01,003,0049,0,974 ,9 ,983 ,1756 ,0,3,1,3,0,1,0,76.14,55.979498861,33.33
03,017,01,003,0050,0,1276 ,12 ,1288 ,2232 ,0,3,1,3,0,1,0,76.14,57.71 ,33.33
03,017,01,003,0051,0,580 ,4 ,584 ,1069 ,0,3,1,3,0,1,0,76.14,54.63 ,33.33
03,017,01,003,0052,0,554 ,3 ,557 ,1009 ,0,3,1,3,0,1,0,76.14,55.2031714569,33.33
03,017,01,003,0053,0,602 ,1 ,603 ,1078 ,0,3,1,3,0,1,0,76.14,55.9369202226,33.33
03,017,01,003,0054,0,574 ,3 ,577 ,1006 ,0,3,1,3,0,1,0,76.14,57.36 ,33.33
03,017,01,003,0055,0,974 ,6 ,980 ,1722 ,0,3,1,3,0,1,0,76.14,56.91 ,33.33
03,017,01,003,0056,0,447 ,5 ,452 ,857 ,0,3,1,3,0,1,0,76.14,52.74 ,33.33
03,017,01,003,0057,0,565 ,7 ,572 ,1033 ,0,3,1,3,0,1,0,76.14,55.37 ,33.33
03,017,01,003,0058,0,1442 ,8 ,1450 ,2822 ,0,3,1,3,0,1,0,76.14,51.38 ,33.33
03,017,01,003,0059,0,486 ,3 ,489 ,884 ,0,3,1,3,0,1,0,76.14,55.32 ,33.33
03,017,01,003,0060,0,760 ,6 ,766 ,1367 ,0,3,1,3,0,1,0,76.14,56.04 ,33.33
03,017,01,003,0061,0,461 ,7 ,468 ,858 ,0,3,1,3,0,1,0,76.14,54.55 ,33.33
03,017,01,003,0062,0,748 ,1 ,749 ,1363 ,0,3,1,3,0,1,0,76.14,54.95 ,33.33
03,017,01,003,0063,0,515 ,3 ,518 ,956 ,0,3,1,3,0,1,0,76.14,54.18 ,33.33
03,017,01,003,0064,0,498 ,4 ,502 ,942 ,0,3,1,3,0,1,0,76.14,53.29 ,33.33
03,017,01,003,0065,0,554 ,3 ,557 ,1032 ,0,3,1,3,0,1,0,76.14,53.97 ,33.33
03,017,01,003,0066,0,431 ,2 ,433 ,771 ,0,3,1,3,0,1,0,76.14,56.16 ,33.33
03,017,01,003,0067,0,622 ,8 ,630 ,1145 ,0,3,1,3,0,1,0,76.14,55.02 ,33.33
03,017,01,003,0068,0,676 ,7 ,683 ,1158 ,0,3,1,3,0,1,0,76.14,58.98 ,33.33
03,017,01,003,0069,0,1640 ,17 ,1657 ,2862 ,0,3,1,3,0,1,0,76.14,57.90 ,33.33
03,017,01,003,0070,0,1280 ,7 ,1287 ,2280 ,0,3,1,3,0,1,0,76.14,56.4473684211,33.33
03,017,01,003,0071,0,455 ,2 ,457 ,737 ,0,3,1,3,0,1,0,76.14,62.0081411126,33.33
03,017,01,003,0072,0,405 ,4 ,409 ,652 ,0,3,1,3,0,1,0,76.14,62.73 ,33.33
03,017,01,003,0073,0,511 ,2 ,513 ,848 ,0,3,1,3,0,1,0,76.14,60.50 ,33.33
03,017,01,003,0074,0,409 ,5 ,414 ,690 ,0,3,1,3,0,1,0,76.14,60.00 ,33.33
03,017,01,004,0075,0,467 ,5 ,472 ,774 ,0,3,1,3,0,1,0,76.14,60.98 ,33.33
03,017,01,004,0076,0,653 ,8 ,661 ,1113 ,0,3,1,3,0,1,0,76.14,59.39 ,33.33
03,017,01,004,0077,0,573 ,10 ,583 ,982 ,0,3,1,3,0,1,0,76.14,59.37 ,33.33
03,017,01,004,0078,0,600 ,7 ,607 ,1086 ,0,3,1,3,0,1,0,76.14,55.89 ,33.33
03,017,01,004,0079,0,525 ,6 ,531 ,957 ,0,3,1,3,0,1,0,76.14,55.49 ,33.33
03,017,01,004,0080,0,726 ,12 ,738 ,1284 ,0,3,1,3,0,1,0,76.14,57.476635514,33.33
03,017,01,004,0081,0,461 ,6 ,467 ,828 ,0,3,1,3,0,1,0,76.14,56.4009661836,33.33
03,017,01,004,0082,0,798 ,7 ,805 ,1410 ,0,3,1,3,0,1,0,76.14,57.0921985816,33.33
03,017,01,004,0083,0,636 ,9 ,645 ,1187 ,0,3,1,3,0,1,0,76.14,54.34 ,33.33
03,017,01,004,0084,0,737 ,5 ,742 ,1467 ,0,3,1,3,0,1,0,76.14,50.58 ,33.33
03,017,01,004,0085,0,1053 ,11 ,1064 ,1971 ,0,3,1,3,0,1,0,76.14,53.98 ,33.33
03,017,01,004,0086,0,345 ,3 ,348 ,654 ,0,3,1,3,0,1,0,76.14,53.21 ,33.33
03,017,01,004,0087,0,380 ,3 ,383 ,727 ,0,3,1,3,0,1,0,76.14,52.6822558459,33.33
03,017,01,004,0088,0,515 ,3 ,518 ,943 ,0,3,1,3,0,1,0,76.14,54.9310710498,33.33
03,017,01,004,0089,0,876 ,12 ,888 ,1649 ,0,3,1,3,0,1,0,76.14,53.85 ,33.33
03,017,01,004,0090,0,559 ,5 ,564 ,1128 ,0,3,1,3,0,1,0,76.14,50.00 ,33.33
03,017,01,004,0091,0,1676 ,7 ,1683 ,3138 ,0,3,1,3,0,1,0,76.14,53.63 ,33.33
03,017,01,004,0092,0,2819 ,27 ,2846 ,4812 ,0,3,1,3,0,1,0,76.14,59.14 ,33.33
03,017,01,004,0093,0,2197 ,15 ,2212 ,4675 ,0,3,1,3,0,1,0,76.14,47.32 ,33.33
03,017,01,004,0094,0,2210 ,18 ,2228 ,4977 ,0,3,1,3,0,1,0,76.14,44.77 ,33.33
03,017,01,004,0095,0,859 ,16 ,875 ,1632 ,0,3,1,3,0,1,0,76.14,53.62 ,33.33
03,017,01,004,0096,0,538 ,3 ,541 ,993 ,0,3,1,3,0,1,0,76.14,54.4813695871,33.33
03,017,01,004,0097,0,582 ,5 ,587 ,993 ,0,3,1,3,0,1,0,76.14,59.113796576,33.33
03,017,01,004,0098,0,477 ,2 ,479 ,853 ,0,3,1,3,0,1,0,76.14,56.15 ,33.33
03,017,01,005,0099,0,754 ,10 ,764 ,1453 ,0,3,1,3,0,1,0,76.14,52.58 ,33.33
03,017,01,005,0100,0,713 ,8 ,721 ,1332 ,0,3,1,3,0,1,0,76.14,54.1291291291,33.33
03,017,01,005,0101,0,658 ,3 ,661 ,1233 ,0,3,1,3,0,1,0,76.14,53.6090835361,33.33
03,017,01,005,0102,0,749 ,10 ,759 ,1302 ,0,3,1,3,0,1,0,76.14,58.29 ,33.33
03,017,01,005,0103,0,547 ,5 ,552 ,1025 ,0,3,1,3,0,1,0,76.14,53.85 ,33.33
03,017,01,005,0104,0,1265 ,9 ,1274 ,2274 ,0,3,1,3,0,1,0,76.14,56.02 ,33.33
03,017,01,005,0105,0,1002 ,4 ,1006 ,1963 ,0,3,1,3,0,1,0,76.14,51.25 ,33.33
03,017,01,005,0106,0,499 ,2 ,501 ,902 ,0,3,1,3,0,1,0,76.14,55.5432372506,33.33
03,017,01,005,0107,0,355 ,2 ,357 ,637 ,0,3,1,3,0,1,0,76.14,56.043956044,33.33
03,017,01,005,0108,0,1784 ,17 ,1801 ,3309 ,0,3,1,3,0,1,0,76.14,54.43 ,33.33
03,017,01,005,0109,0,2690 ,18 ,2708 ,5306 ,0,3,1,3,0,1,0,76.14,51.04 ,33.33
03,017,01,005,0110,0,2346 ,14 ,2360 ,4235 ,0,3,1,3,0,1,0,76.14,55.73 ,33.33
03,017,01,005,0111,0,1818 ,15 ,1833 ,3429 ,0,3,1,3,0,1,0,76.14,53.46 ,33.33
03,017,01,005,0112,0,1941 ,12 ,1953 ,3557 ,0,3,1,3,0,1,0,76.14,54.91 ,33.33
03,017,01,005,0113,0,1553 ,12 ,1565 ,2854 ,0,3,1,3,0,1,0,76.14,54.84 ,33.33
03,017,01,005,0114,0,1431 ,9 ,1440 ,2648 ,0,3,1,3,0,1,0,76.14,54.38 ,33.33
03,017,01,005,0115,0,1410 ,14 ,1424 ,2839 ,0,3,1,3,0,1,0,76.14,50.16 ,33.33
03,017,01,005,0116,0,1258 ,4 ,1262 ,2504 ,0,3,1,3,0,1,0,76.14,50.40 ,33.33
03,017,01,005,0117,0,1545 ,10 ,1555 ,3500 ,0,3,1,3,0,1,0,76.14,44.43 ,33.33
03,017,01,005,0118,0,1614 ,18 ,1632 ,3301 ,0,3,1,3,0,1,0,76.14,49.44 ,33.33
03,017,01,005,0119,0,1504 ,8 ,1512 ,3105 ,0,3,1,3,0,1,0,76.14,48.70 ,33.33
03,017,01,005,0120,0,1657 ,8 ,1665 ,3492 ,0,3,1,3,0,1,0,76.14,47.6804123711,33.33
03,017,01,005,0121,0,653 ,4 ,657 ,1319 ,0,3,1,3,0,1,0,76.14,49.81 ,33.33
03,017,01,005,0122,0,1642 ,8 ,1650 ,3522 ,0,3,1,3,0,1,0,76.14,46.85 ,33.33
03,017,01,006,0123,0,735 ,6 ,741 ,1377 ,0,3,1,3,0,1,0,76.14,53.81 ,33.33
03,017,01,006,0124,0,334 ,1 ,335 ,613 ,0,3,1,3,0,1,0,76.14,54.6492659054,33.33
03,017,01,006,0125,0,398 ,3 ,401 ,693 ,0,3,1,3,0,1,0,76.14,57.8643578644,33.33
03,017,01,006,0126,0,297 ,6 ,303 ,613 ,0,3,1,3,0,1,0,76.14,49.43 ,33.33
03,017,01,006,0127,0,1680 ,18 ,1698 ,3310 ,0,3,1,3,0,1,0,76.14,51.30 ,33.33
03,017,01,006,0128,0,1190 ,12 ,1202 ,2229 ,0,3,1,3,0,1,0,76.14,53.93 ,33.33
03,017,01,006,0129,0,1174 ,6 ,1180 ,2275 ,0,3,1,3,0,1,0,76.14,51.8681318681,33.33
03,017,01,006,0130,0,231 ,3 ,234 ,393 ,0,3,1,3,0,1,0,76.14,59.5419847328,33.33
03,017,01,006,0131,0,1857 ,15 ,1872 ,3655 ,0,3,1,3,0,1,0,76.14,51.22 ,33.33
03,017,01,006,0132,0,1175 ,12 ,1187 ,2237 ,0,3,1,3,0,1,0,76.14,53.06 ,33.33
03,017,01,006,0133,0,1213 ,10 ,1223 ,2253 ,0,3,1,3,0,1,0,76.14,54.28 ,33.33
03,017,01,006,0134,0,1560 ,7 ,1567 ,3387 ,0,3,1,3,0,1,0,76.14,46.2651313847,33.33
03,017,01,006,0135,0,2212 ,18 ,2230 ,4376 ,0,3,1,3,0,1,0,76.14,50.96 ,33.33
03,017,01,007,0136,0,1912 ,15 ,1927 ,3647 ,0,3,1,3,0,1,0,76.14,52.84 ,33.33
03,017,01,007,0137,0,1236 ,19 ,1255 ,2230 ,0,3,1,3,0,1,0,76.14,56.28 ,33.33
03,017,01,007,0138,0,1098 ,11 ,1109 ,1957 ,0,3,1,3,0,1,0,76.14,56.67 ,33.33
03,017,01,007,0139,0,2041 ,16 ,2057 ,3626 ,0,3,1,3,0,1,0,76.14,56.73 ,33.33
03,017,01,007,0140,0,1149 ,13 ,1162 ,2010 ,0,3,1,3,0,1,0,76.14,57.81 ,33.33
03,017,01,007,0141,0,1054 ,5 ,1059 ,2002 ,0,3,1,3,0,1,0,76.14,52.90 ,33.33
03,017,01,007,0142,0,787 ,5 ,792 ,1538 ,0,3,1,3,0,1,0,76.14,51.50 ,33.33
03,017,01,007,0143,0,467 ,11 ,478 ,926 ,0,3,1,3,0,1,0,76.14,51.62 ,33.33
03,017,01,007,0144,0,1559 ,14 ,1573 ,3210 ,0,3,1,3,0,1,0,76.14,49.0031152648,33.33
03,017,01,007,0145,0,698 ,9 ,707 ,1415 ,0,3,1,3,0,1,0,76.14,49.964664311,33.33
03,017,01,007,0146,0,1479 ,12 ,1491 ,3259 ,0,3,1,3,0,1,0,76.14,45.75 ,33.33
03,017,01,007,0147,0,1518 ,13 ,1531 ,3046 ,0,3,1,3,0,1,0,76.14,50.2626395272,33.33
03,017,01,007,0148,0,2075 ,10 ,2085 ,4485 ,0,3,1,3,0,1,0,76.14,46.49 ,33.33
03,017,01,007,0149,0,1544 ,11 ,1555 ,3351 ,0,3,1,3,0,1,0,76.14,46.40 ,33.33
03,017,01,007,0150,0,243 ,1 ,244 ,451 ,0,3,1,3,0,1,0,76.14,54.10 ,33.33
03,017,01,007,0151,0,182 ,0 ,182 ,300 ,0,3,1,3,0,1,0,76.14,60.67 ,33.33
03,017,01,007,0152,0,201 ,4 ,205 ,350 ,0,3,1,3,0,1,0,76.14,58.57 ,33.33
03,017,01,007,0153,0,739 ,3 ,742 ,1409 ,0,3,1,3,0,1,0,76.14,52.6614620298,33.33
03,017,01,007,0154,0,256 ,1 ,257 ,438 ,0,3,1,3,0,1,0,76.14,58.6757990868,33.33
03,018,01,001,0001,0,512 ,5 ,517 ,1232 ,0,3,1,3,0,1,0,76.14,41.96 ,33.33
03,018,01,001,0002,0,938 ,3 ,941 ,1735 ,0,3,1,3,0,1,0,76.14,54.24 ,33.33
03,018,01,001,0003,0,411 ,3 ,414 ,708 ,0,3,1,3,0,1,0,76.14,58.47 ,33.33
03,018,01,001,0004,0,411 ,2 ,413 ,757 ,0,3,1,3,0,1,0,76.14,54.56 ,33.33
03,018,01,001,0005,0,228 ,2 ,230 ,442 ,0,3,1,3,0,1,0,76.14,52.04 ,33.33
03,018,01,001,0006,0,282 ,2 ,284 ,481 ,0,3,1,3,0,1,0,76.14,59.04 ,33.33
03,018,01,001,0007,0,992 ,6 ,998 ,1735 ,0,3,1,3,0,1,0,76.14,57.52 ,33.33
03,018,01,001,0008,0,1989 ,11 ,2000 ,3530 ,0,3,1,3,0,1,0,76.14,56.66 ,33.33
03,018,01,001,0009,0,2074 ,24 ,2098 ,3837 ,0,3,1,3,0,1,0,76.14,54.68 ,33.33
03,018,01,001,0010,0,1957 ,6 ,1963 ,3624 ,0,3,1,3,0,1,0,76.14,54.17 ,33.33
03,018,01,001,0011,0,2209 ,11 ,2220 ,3908 ,0,3,1,3,0,1,0,76.14,56.8065506653,33.33
03,018,01,001,0012,0,1447 ,14 ,1461 ,2597 ,0,3,1,3,0,1,0,76.14,56.26 ,33.33
03,018,01,001,0013,0,1261 ,8 ,1269 ,2244 ,0,3,1,3,0,1,0,76.14,56.55 ,33.33
03,018,01,001,0014,0,1183 ,4 ,1187 ,2128 ,0,3,1,3,0,1,0,76.14,55.78 ,33.33
03,018,01,001,0015,0,1661 ,17 ,1678 ,2880 ,0,3,1,3,0,1,0,76.14,58.26 ,33.33
03,018,01,001,0016,0,2415 ,13 ,2428 ,4286 ,0,3,1,3,0,1,0,76.14,56.6495566962,33.33
03,018,01,001,0017,0,571 ,4 ,575 ,1059 ,0,3,1,3,0,1,0,76.14,54.2965061379,33.33
03,018,01,001,0018,0,1013 ,2 ,1015 ,1846 ,0,3,1,3,0,1,0,76.14,54.98 ,33.33
03,018,01,001,0019,0,1282 ,15 ,1297 ,2472 ,0,3,1,3,0,1,0,76.14,52.47 ,33.33
03,018,01,001,0020,0,1679 ,24 ,1703 ,3058 ,0,3,1,3,0,1,0,76.14,55.6899934598,33.33
03,018,01,001,0021,0,1039 ,14 ,1053 ,1759 ,0,3,1,3,0,1,0,76.14,59.8635588403,33.33
03,018,01,001,0022,0,1440 ,9 ,1449 ,2513 ,0,3,1,3,0,1,0,76.14,57.66 ,33.33
03,018,01,001,0023,0,2245 ,6 ,2251 ,3506 ,0,3,1,3,0,1,0,76.14,64.20 ,33.33
03,018,01,001,0024,0,1933 ,12 ,1945 ,3269 ,0,3,1,3,0,1,0,76.14,59.50 ,33.33
03,018,01,001,0025,0,499 ,5 ,504 ,852 ,0,3,1,3,0,1,0,76.14,59.15 ,33.33
03,018,01,001,0026,0,1382 ,11 ,1393 ,2184 ,0,3,1,3,0,1,0,76.14,63.78 ,33.33
03,018,01,001,0027,0,1828 ,9 ,1837 ,3210 ,0,3,1,3,0,1,0,76.14,57.23 ,33.33
03,018,01,001,0028,0,1512 ,10 ,1522 ,2768 ,0,3,1,3,0,1,0,76.14,54.99 ,33.33
03,018,01,001,0029,0,3013 ,16 ,3029 ,5109 ,0,3,1,3,0,1,0,76.14,59.29 ,33.33
03,018,01,001,0030,0,1271 ,11 ,1282 ,2264 ,0,3,1,3,0,1,0,76.14,56.63 ,33.33
03,018,01,001,0031,0,2150 ,19 ,2169 ,3946 ,0,3,1,3,0,1,0,76.14,54.9670552458,33.33
03,018,01,001,0032,0,1961 ,16 ,1977 ,3623 ,0,3,1,3,0,1,0,76.14,54.57 ,33.33
03,018,01,001,0033,0,2306 ,11 ,2317 ,4345 ,0,3,1,3,0,1,0,76.14,53.33 ,33.33
03,018,01,001,0034,0,1859 ,8 ,1867 ,3349 ,0,3,1,3,0,1,0,76.14,55.75 ,33.33
03,018,01,001,0035,0,537 ,0 ,537 ,874 ,0,3,1,3,0,1,0,76.14,61.44 ,33.33
03,018,01,001,0036,0,318 ,1 ,319 ,591 ,0,3,1,3,0,1,0,76.14,53.98 ,33.33
03,018,01,001,0037,0,391 ,3 ,394 ,688 ,0,3,1,3,0,1,0,76.14,57.27 ,33.33
03,018,01,001,0038,0,510 ,3 ,513 ,887 ,0,3,1,3,0,1,0,76.14,57.84 ,33.33
03,018,01,001,0039,0,711 ,8 ,719 ,1300 ,0,3,1,3,0,1,0,76.14,55.31 ,33.33
03,018,01,001,0040,0,2315 ,14 ,2329 ,4491 ,0,3,1,3,0,1,0,76.14,51.86 ,33.33
03,018,01,001,0041,0,1718 ,14 ,1732 ,3083 ,0,3,1,3,0,1,0,76.14,56.18 ,33.33
03,018,01,001,0042,0,459 ,1 ,460 ,858 ,0,3,1,3,0,1,0,76.14,53.61 ,33.33
03,018,01,001,0043,0,476 ,3 ,479 ,813 ,0,3,1,3,0,1,0,76.14,58.92 ,33.33
03,018,01,001,0044,0,389 ,5 ,394 ,712 ,0,3,1,3,0,1,0,76.14,55.34 ,33.33
03,018,01,001,0045,0,1628 ,7 ,1635 ,2976 ,0,3,1,3,0,1,0,76.14,54.94 ,33.33
03,018,01,001,0046,0,813 ,5 ,818 ,1496 ,0,3,1,3,0,1,0,76.14,54.679144385,33.33
03,018,01,001,0047,0,1722 ,11 ,1733 ,3249 ,0,3,1,3,0,1,0,76.14,53.34 ,33.33
03,018,01,001,0048,0,1557 ,11 ,1568 ,3018 ,0,3,1,3,0,1,0,76.14,51.95 ,33.33
03,018,01,001,0049,0,2597 ,20 ,2617 ,5001 ,0,3,1,3,0,1,0,76.14,52.3295340932,33.33
03,018,01,001,0050,0,1518 ,16 ,1534 ,2926 ,0,3,1,3,0,1,0,76.14,52.4265208476,33.33
03,018,01,001,0051,0,1861 ,7 ,1868 ,3472 ,0,3,1,3,0,1,0,76.14,53.80 ,33.33
03,018,01,001,0052,0,1470 ,6 ,1476 ,3225 ,0,3,1,3,0,1,0,76.14,45.77 ,33.33
03,018,01,002,0053,0,273 ,5 ,278 ,521 ,0,3,1,3,0,1,0,76.14,53.358925144,33.33
03,018,01,002,0054,0,469 ,5 ,474 ,793 ,0,3,1,3,0,1,0,76.14,59.7730138714,33.33
03,018,01,002,0055,0,335 ,3 ,338 ,528 ,0,3,1,3,0,1,0,76.14,64.0151515152,33.33
03,018,01,002,0056,0,293 ,2 ,295 ,538 ,0,3,1,3,0,1,0,76.14,54.83 ,33.33
03,018,01,002,0057,0,413 ,5 ,418 ,743 ,0,3,1,3,0,1,0,76.14,56.26 ,33.33
03,018,01,002,0058,0,699 ,6 ,705 ,1168 ,0,3,1,3,0,1,0,76.14,60.36 ,33.33
03,018,01,002,0059,0,685 ,4 ,689 ,1236 ,0,3,1,3,0,1,0,76.14,55.74 ,33.33
03,018,01,002,0060,0,1806 ,9 ,1815 ,3403 ,0,3,1,3,0,1,0,76.14,53.34 ,33.33
03,018,01,002,0061,0,640 ,6 ,646 ,1291 ,0,3,1,3,0,1,0,76.14,50.04 ,33.33
03,018,01,002,0062,0,2537 ,24 ,2561 ,4698 ,0,3,1,3,0,1,0,76.14,54.51 ,33.33
03,018,01,002,0063,0,1395 ,10 ,1405 ,2511 ,0,3,1,3,0,1,0,76.14,55.9538032656,33.33
03,018,01,002,0064,0,1499 ,16 ,1515 ,2740 ,0,3,1,3,0,1,0,76.14,55.29 ,33.33
03,018,01,002,0065,0,1879 ,25 ,1904 ,3422 ,0,3,1,3,0,1,0,76.14,55.64 ,33.33
03,018,01,002,0066,0,967 ,11 ,978 ,1471 ,0,3,1,3,0,1,0,76.14,66.49 ,33.33
03,018,01,002,0067,0,390 ,6 ,396 ,712 ,0,3,1,3,0,1,0,76.14,55.62 ,33.33
03,018,01,002,0068,0,391 ,2 ,393 ,656 ,0,3,1,3,0,1,0,76.14,59.91 ,33.33
03,018,01,002,0069,0,334 ,3 ,337 ,582 ,0,3,1,3,0,1,0,76.14,57.90 ,33.33
03,018,01,002,0070,0,710 ,12 ,722 ,1275 ,0,3,1,3,0,1,0,76.14,56.6274509804,33.33
03,018,01,002,0071,0,644 ,3 ,647 ,1157 ,0,3,1,3,0,1,0,76.14,55.9204840104,33.33
03,018,01,002,0072,0,521 ,3 ,524 ,906 ,0,3,1,3,0,1,0,76.14,57.8366445916,33.33
03,018,01,002,0073,0,1986 ,19 ,2005 ,4015 ,0,3,1,3,0,1,0,76.14,49.94 ,33.33
03,018,01,002,0074,0,2124 ,11 ,2135 ,4108 ,0,3,1,3,0,1,0,76.14,51.97 ,33.33
03,018,01,002,0075,0,1886 ,13 ,1899 ,3641 ,0,3,1,3,0,1,0,76.14,52.16 ,33.33
03,018,01,002,0076,0,1744 ,16 ,1760 ,3163 ,0,3,1,3,0,1,0,76.14,55.64 ,33.33
03,018,01,002,0077,0,1512 ,6 ,1518 ,2673 ,0,3,1,3,0,1,0,76.14,56.79 ,33.33
03,018,01,002,0078,0,1139 ,6 ,1145 ,2014 ,0,3,1,3,0,1,0,76.14,56.85 ,33.33
03,018,01,002,0079,0,1407 ,7 ,1414 ,3089 ,0,3,1,3,0,1,0,76.14,45.78 ,33.33
03,018,01,002,0080,0,1898 ,12 ,1910 ,3718 ,0,3,1,3,0,1,0,76.14,51.37 ,33.33
03,018,01,002,0081,0,1323 ,9 ,1332 ,2558 ,0,3,1,3,0,1,0,76.14,52.07 ,33.33
03,018,01,002,0082,0,780 ,6 ,786 ,1356 ,0,3,1,3,0,1,0,76.14,57.96 ,33.33
03,018,01,002,0083,0,2343 ,20 ,2363 ,4559 ,0,3,1,3,0,1,0,76.14,51.83 ,33.33
03,018,01,002,0084,0,2421 ,11 ,2432 ,4738 ,0,3,1,3,0,1,0,76.14,51.3296749683,33.33
03,018,01,002,0085,0,2172 ,13 ,2185 ,4280 ,0,3,1,3,0,1,0,76.14,51.05 ,33.33
03,018,01,002,0086,0,1254 ,4 ,1258 ,1965 ,0,3,1,3,0,1,0,76.14,64.02 ,33.33
03,018,01,002,0087,0,1689 ,11 ,1700 ,2913 ,0,3,1,3,0,1,0,76.14,58.36 ,33.33
03,018,01,002,0088,0,2024 ,15 ,2039 ,3756 ,0,3,1,3,0,1,0,76.14,54.29 ,33.33
03,018,01,002,0089,0,1762 ,11 ,1773 ,2830 ,0,3,1,3,0,1,0,76.14,62.65 ,33.33
03,018,01,002,0090,0,429 ,5 ,434 ,875 ,0,3,1,3,0,1,0,76.14,49.60 ,33.33
03,018,01,002,0091,0,1943 ,12 ,1955 ,3819 ,0,3,1,3,0,1,0,76.14,51.1914113642,33.33
03,018,01,002,0092,0,952 ,7 ,959 ,1765 ,0,3,1,3,0,1,0,76.14,54.33 ,33.33
03,018,01,002,0093,0,809 ,6 ,815 ,1542 ,0,3,1,3,0,1,0,76.14,52.85 ,33.33
03,018,01,002,0094,0,921 ,6 ,927 ,1838 ,0,3,1,3,0,1,0,76.14,50.44 ,33.33
03,018,01,002,0095,0,676 ,3 ,679 ,1191 ,0,3,1,3,0,1,0,76.14,57.01 ,33.33
03,018,01,002,0096,0,322 ,4 ,326 ,554 ,0,3,1,3,0,1,0,76.14,58.84 ,33.33
03,018,01,003,0097,0,1278 ,7 ,1285 ,2642 ,0,3,1,3,0,1,0,76.14,48.64 ,33.33
03,018,01,003,0098,0,1417 ,10 ,1427 ,2785 ,0,3,1,3,0,1,0,76.14,51.24 ,33.33
03,018,01,003,0099,0,1260 ,7 ,1267 ,2417 ,0,3,1,3,0,1,0,76.14,52.42 ,33.33
03,018,01,003,0100,0,1237 ,8 ,1245 ,2474 ,0,3,1,3,0,1,0,76.14,50.32 ,33.33
03,018,01,003,0101,0,1385 ,9 ,1394 ,2506 ,0,3,1,3,0,1,0,76.14,55.63 ,33.33
03,018,01,003,0102,0,966 ,14 ,980 ,1877 ,0,3,1,3,0,1,0,76.14,52.21 ,33.33
03,018,01,003,0103,0,874 ,6 ,880 ,1603 ,0,3,1,3,0,1,0,76.14,54.90 ,33.33
03,018,01,003,0104,0,1148 ,8 ,1156 ,1991 ,0,3,1,3,0,1,0,76.14,58.0612757408,33.33
03,018,01,003,0105,0,2380 ,32 ,2412 ,4766 ,0,3,1,3,0,1,0,76.14,50.60847671,33.33
03,018,01,003,0106,0,1009 ,8 ,1017 ,1903 ,0,3,1,3,0,1,0,76.14,53.44 ,33.33
03,018,01,003,0107,0,1278 ,5 ,1283 ,2422 ,0,3,1,3,0,1,0,76.14,52.97 ,33.33
03,018,01,003,0108,0,1036 ,9 ,1045 ,2059 ,0,3,1,3,0,1,0,76.14,50.75 ,33.33
03,018,01,003,0109,0,1363 ,9 ,1372 ,2799 ,0,3,1,3,0,1,0,76.14,49.02 ,33.33
03,018,01,003,0110,0,1103 ,5 ,1108 ,2053 ,0,3,1,3,0,1,0,76.14,53.9698002923,33.33
03,018,01,003,0111,0,512 ,5 ,517 ,980 ,0,3,1,3,0,1,0,76.14,52.7551020408,33.33
03,018,01,003,0112,0,899 ,4 ,903 ,1708 ,0,3,1,3,0,1,0,76.14,52.87 ,33.33
03,018,01,003,0113,0,955 ,9 ,964 ,1887 ,0,3,1,3,0,1,0,76.14,51.09 ,33.33
03,018,01,003,0114,0,645 ,8 ,653 ,1178 ,0,3,1,3,0,1,0,76.14,55.43 ,33.33
03,018,01,003,0115,0,1684 ,16 ,1700 ,3501 ,0,3,1,3,0,1,0,76.14,48.56 ,33.33
03,018,01,003,0116,0,438 ,4 ,442 ,801 ,0,3,1,3,0,1,0,76.14,55.18 ,33.33
03,018,01,003,0117,0,693 ,7 ,700 ,1332 ,0,3,1,3,0,1,0,76.14,52.55 ,33.33
03,018,01,003,0118,0,339 ,4 ,343 ,641 ,0,3,1,3,0,1,0,76.14,53.51 ,33.33
03,018,01,003,0119,0,366 ,5 ,371 ,722 ,0,3,1,3,0,1,0,76.14,51.39 ,33.33
03,018,01,003,0120,0,424 ,5 ,429 ,800 ,0,3,1,3,0,1,0,76.14,53.63 ,33.33
03,019,01,001,0001,0,1116 ,11 ,1127 ,1928 ,0,3,1,3,0,1,0,76.14,58.45 ,33.33
03,019,01,001,0002,0,976 ,4 ,980 ,1705 ,0,3,1,3,0,1,0,76.14,57.48 ,33.33
03,019,01,001,0003,0,922 ,3 ,925 ,1696 ,0,3,1,3,0,1,0,76.14,54.54 ,33.33
03,019,01,001,0004,0,1365 ,10 ,1375 ,2436 ,0,3,1,3,0,1,0,76.14,56.44 ,33.33
03,019,01,001,0005,0,1323 ,12 ,1335 ,2417 ,0,3,1,3,0,1,0,76.14,55.23 ,33.33
03,019,01,001,0006,0,1047 ,7 ,1054 ,1860 ,0,3,1,3,0,1,0,76.14,56.67 ,33.33
03,019,01,001,0007,0,1203 ,12 ,1215 ,2038 ,0,3,1,3,0,1,0,76.14,59.62 ,33.33
03,019,01,001,0008,0,1047 ,8 ,1055 ,1828 ,0,3,1,3,0,1,0,76.14,57.71 ,33.33
03,019,01,002,0009,0,1892 ,23 ,1915 ,3404 ,0,3,1,3,0,1,0,76.14,56.26 ,33.33
03,019,01,002,0010,0,2018 ,15 ,2033 ,3317 ,0,3,1,3,0,1,0,76.14,61.29 ,33.33
03,019,01,002,0011,0,1919 ,11 ,1930 ,3339 ,0,3,1,3,0,1,0,76.14,57.80 ,33.33
03,019,01,002,0012,0,1718 ,10 ,1728 ,2915 ,0,3,1,3,0,1,0,76.14,59.28 ,33.33
03,019,01,002,0013,0,1086 ,10 ,1096 ,1829 ,0,3,1,3,0,1,0,76.14,59.92 ,33.33
03,019,01,002,0014,0,1451 ,7 ,1458 ,2417 ,0,3,1,3,0,1,0,76.14,60.32 ,33.33
03,019,01,002,0015,0,1382 ,4 ,1386 ,2365 ,0,3,1,3,0,1,0,76.14,58.60 ,33.33
03,019,01,002,0016,0,1068 ,10 ,1078 ,1872 ,0,3,1,3,0,1,0,76.14,57.59 ,33.33
03,019,01,002,0017,0,2903 ,13 ,2916 ,4822 ,0,3,1,3,0,1,0,76.14,60.47 ,33.33
03,019,01,002,0018,0,1571 ,21 ,1592 ,2782 ,0,3,1,3,0,1,0,76.14,57.23 ,33.33
03,019,01,002,0019,0,2211 ,20 ,2231 ,4003 ,0,3,1,3,0,1,0,76.14,55.73 ,33.33
03,019,01,002,0020,0,1949 ,17 ,1966 ,3309 ,0,3,1,3,0,1,0,76.14,59.41 ,33.33
03,019,01,002,0021,0,1636 ,8 ,1644 ,2834 ,0,3,1,3,0,1,0,76.14,58.01 ,33.33
03,019,01,002,0022,0,1527 ,8 ,1535 ,2577 ,0,3,1,3,0,1,0,76.14,59.57 ,33.33
03,019,01,002,0023,0,1998 ,14 ,2012 ,3248 ,0,3,1,3,0,1,0,76.14,61.95 ,33.33
03,019,01,002,0024,0,1006 ,4 ,1010 ,1653 ,0,3,1,3,0,1,0,76.14,61.10 ,33.33
03,019,01,002,0025,0,3230 ,27 ,3257 ,5398 ,0,3,1,3,0,1,0,76.14,60.34 ,33.33
03,019,01,003,0026,0,1044 ,6 ,1050 ,2171 ,0,3,1,3,0,1,0,76.14,48.36 ,33.33
03,019,01,003,0027,0,960 ,7 ,967 ,1776 ,0,3,1,3,0,1,0,76.14,54.45 ,33.33
03,019,01,003,0028,0,1092 ,8 ,1100 ,1966 ,0,3,1,3,0,1,0,76.14,55.95 ,33.33
03,019,01,003,0029,0,2367 ,21 ,2388 ,4184 ,0,3,1,3,0,1,0,76.14,57.07 ,33.33
03,019,01,003,0030,0,1029 ,12 ,1041 ,1756 ,0,3,1,3,0,1,0,76.14,59.28 ,33.33
03,019,01,003,0031,0,1337 ,4 ,1341 ,2274 ,0,3,1,3,0,1,0,76.14,58.97 ,33.33
03,019,01,003,0032,0,1235 ,6 ,1241 ,2086 ,0,3,1,3,0,1,0,76.14,59.49 ,33.33
03,019,01,003,0033,0,2672 ,19 ,2691 ,4903 ,0,3,1,3,0,1,0,76.14,54.88 ,33.33
03,019,01,003,0034,0,1849 ,10 ,1859 ,3119 ,0,3,1,3,0,1,0,76.14,59.60 ,33.33
03,019,01,003,0035,0,2797 ,25 ,2822 ,4703 ,0,3,1,3,0,1,0,76.14,60.00 ,33.33
03,019,01,003,0036,0,1232 ,15 ,1247 ,2165 ,0,3,1,3,0,1,0,76.14,57.60 ,33.33
03,019,01,003,0037,0,1376 ,9 ,1385 ,2453 ,0,3,1,3,0,1,0,76.14,56.46 ,33.33
03,019,01,003,0038,0,1402 ,9 ,1411 ,2516 ,0,3,1,3,0,1,0,76.14,56.08 ,33.33
03,019,01,003,0039,0,3053 ,28 ,3081 ,5394 ,0,3,1,3,0,1,0,76.14,57.12 ,33.33
03,019,01,003,0040,0,1725 ,10 ,1735 ,3046 ,0,3,1,3,0,1,0,76.14,56.96 ,33.33
03,019,01,003,0041,0,1932 ,20 ,1952 ,3202 ,0,3,1,3,0,1,0,76.14,60.96 ,33.33
03,019,01,003,0042,0,2535 ,20 ,2555 ,4585 ,0,3,1,3,0,1,0,76.14,55.73 ,33.33
03,019,01,003,0043,0,2567 ,13 ,2580 ,4681 ,0,3,1,3,0,1,0,76.14,55.12 ,33.33
03,019,01,003,0044,0,1987 ,9 ,1996 ,3684 ,0,3,1,3,0,1,0,76.14,54.18 ,33.33
03,019,01,003,0045,0,1776 ,15 ,1791 ,3293 ,0,3,1,3,0,1,0,76.14,54.39 ,33.33
03,019,01,003,0046,0,1676 ,10 ,1686 ,2745 ,0,3,1,3,0,1,0,76.14,61.42 ,33.33
03,019,01,003,0047,0,2595 ,26 ,2621 ,4524 ,0,3,1,3,0,1,0,76.14,57.94 ,33.33
03,019,01,003,0048,0,2884 ,17 ,2901 ,5110 ,0,3,1,3,0,1,0,76.14,56.77 ,33.33
03,019,01,003,0049,0,1694 ,8 ,1702 ,2831 ,0,3,1,3,0,1,0,76.14,60.12 ,33.33
03,019,01,003,0050,0,1639 ,8 ,1647 ,2776 ,0,3,1,3,0,1,0,76.14,59.33 ,33.33
03,019,01,004,0051,0,1249 ,7 ,1256 ,2227 ,0,3,1,3,0,1,0,76.14,56.40 ,33.33
03,019,01,004,0052,0,1550 ,12 ,1562 ,2500 ,0,3,1,3,0,1,0,76.14,62.48 ,33.33
03,019,01,004,0053,0,2020 ,16 ,2036 ,3349 ,0,3,1,3,0,1,0,76.14,60.79 ,33.33
03,019,01,004,0054,0,2150 ,19 ,2169 ,3563 ,0,3,1,3,0,1,0,76.14,60.88 ,33.33
03,019,01,004,0055,0,1832 ,10 ,1842 ,3216 ,0,3,1,3,0,1,0,76.14,57.28 ,33.33
03,019,01,004,0056,0,1453 ,5 ,1458 ,2489 ,0,3,1,3,0,1,0,76.14,58.58 ,33.33
03,019,01,004,0057,0,1500 ,10 ,1510 ,2640 ,0,3,1,3,0,1,0,76.14,57.20 ,33.33
03,019,01,004,0058,0,1273 ,6 ,1279 ,2224 ,0,3,1,3,0,1,0,76.14,57.51 ,33.33
03,019,01,004,0059,0,1527 ,7 ,1534 ,3286 ,0,3,1,3,0,1,0,76.14,46.68 ,33.33
03,019,01,004,0060,0,1996 ,12 ,2008 ,3409 ,0,3,1,3,0,1,0,76.14,58.90 ,33.33
03,019,01,004,0061,0,2334 ,22 ,2356 ,4409 ,0,3,1,3,0,1,0,76.14,53.44 ,33.33
03,019,01,004,0062,0,1784 ,26 ,1810 ,3221 ,0,3,1,3,0,1,0,76.14,56.19 ,33.33
03,019,01,004,0063,0,1173 ,11 ,1184 ,2330 ,0,3,1,3,0,1,0,76.14,50.82 ,33.33
03,019,01,004,0064,0,1742 ,14 ,1756 ,2985 ,0,3,1,3,0,1,0,76.14,58.83 ,33.33
03,019,01,004,0065,0,2072 ,22 ,2094 ,3907 ,0,3,1,3,0,1,0,76.14,53.60 ,33.33
03,019,01,004,0066,0,2355 ,19 ,2374 ,4390 ,0,3,1,3,0,1,0,76.14,54.08 ,33.33
03,019,01,004,0067,0,1686 ,15 ,1701 ,3050 ,0,3,1,3,0,1,0,76.14,55.77 ,33.33
03,019,01,004,0068,0,3427 ,32 ,3459 ,6794 ,0,3,1,3,0,1,0,76.14,50.91 ,33.33
03,019,01,004,0069,0,2024 ,7 ,2031 ,3787 ,0,3,1,3,0,1,0,76.14,53.63 ,33.33
03,019,01,004,0070,0,2515 ,15 ,2530 ,4983 ,0,3,1,3,0,1,0,76.14,50.77 ,33.33
03,019,01,004,0071,0,1723 ,9 ,1732 ,3021 ,0,3,1,3,0,1,0,76.14,57.33 ,33.33
03,019,01,004,0072,0,2040 ,13 ,2053 ,3323 ,0,3,1,3,0,1,0,76.14,61.78 ,33.33
03,019,01,005,0073,0,955 ,4 ,959 ,1609 ,0,3,1,3,0,1,0,76.14,59.60 ,33.33
03,019,01,005,0074,0,953 ,4 ,957 ,1675 ,0,3,1,3,0,1,0,76.14,57.13 ,33.33
03,019,01,005,0075,0,1013 ,9 ,1022 ,1872 ,0,3,1,3,0,1,0,76.14,54.59 ,33.33
03,019,01,005,0076,0,2028 ,12 ,2040 ,3228 ,0,3,1,3,0,1,0,76.14,63.20 ,33.33
03,019,01,005,0077,0,1244 ,9 ,1253 ,2218 ,0,3,1,3,0,1,0,76.14,56.49 ,33.33
03,019,01,005,0078,0,688 ,6 ,694 ,1279 ,0,3,1,3,0,1,0,76.14,54.26 ,33.33
03,019,01,005,0079,0,995 ,13 ,1008 ,1829 ,0,3,1,3,0,1,0,76.14,55.11 ,33.33
03,019,01,005,0080,0,1220 ,5 ,1225 ,2163 ,0,3,1,3,0,1,0,76.14,56.63 ,33.33
03,019,01,005,0081,0,1110 ,9 ,1119 ,1985 ,0,3,1,3,0,1,0,76.14,56.37 ,33.33
03,019,01,005,0082,0,1964 ,17 ,1981 ,3186 ,0,3,1,3,0,1,0,76.14,62.18 ,33.33
03,019,01,005,0083,0,1753 ,10 ,1763 ,2954 ,0,3,1,3,0,1,0,76.14,59.68 ,33.33
03,019,01,005,0084,0,2127 ,15 ,2142 ,4027 ,0,3,1,3,0,1,0,76.14,53.19 ,33.33
03,019,01,005,0085,0,1972 ,13 ,1985 ,3298 ,0,3,1,3,0,1,0,76.14,60.19 ,33.33
03,019,01,005,0086,0,1519 ,12 ,1531 ,2617 ,0,3,1,3,0,1,0,76.14,58.50 ,33.33
03,019,01,005,0087,0,1496 ,9 ,1505 ,2847 ,0,3,1,3,0,1,0,76.14,52.86 ,33.33
03,019,01,005,0088,0,860 ,7 ,867 ,1531 ,0,3,1,3,0,1,0,76.14,56.63 ,33.33
03,019,01,005,0089,0,2331 ,12 ,2343 ,4196 ,0,3,1,3,0,1,0,76.14,55.84 ,33.33
03,019,01,005,0090,0,898 ,6 ,904 ,1688 ,0,3,1,3,0,1,0,76.14,53.55 ,33.33
03,019,01,005,0091,0,2822 ,14 ,2836 ,5158 ,0,3,1,3,0,1,0,76.14,54.98 ,33.33
03,019,01,005,0092,0,1762 ,12 ,1774 ,3322 ,0,3,1,3,0,1,0,76.14,53.40 ,33.33
03,019,01,005,0093,0,1579 ,7 ,1586 ,2748 ,0,3,1,3,0,1,0,76.14,57.71 ,33.33
03,019,01,005,0094,0,1612 ,6 ,1618 ,3775 ,0,3,1,3,0,1,0,76.14,42.86 ,33.33
03,019,01,005,0095,0,1393 ,10 ,1403 ,2435 ,0,3,1,3,0,1,0,76.14,57.62 ,33.33
03,019,01,005,0096,0,1602 ,11 ,1613 ,3067 ,0,3,1,3,0,1,0,76.14,52.59 ,33.33
03,019,01,005,0097,0,1817 ,8 ,1825 ,3606 ,0,3,1,3,0,1,0,76.14,50.61 ,33.33
03,019,01,005,0098,0,1657 ,12 ,1669 ,3231 ,0,3,1,3,0,1,0,76.14,51.66 ,33.33
03,019,01,005,0099,0,1189 ,5 ,1194 ,2277 ,0,3,1,3,0,1,0,76.14,52.44 ,33.33
03,019,01,005,0100,0,2211 ,17 ,2228 ,3932 ,0,3,1,3,0,1,0,76.14,56.66 ,33.33
03,019,01,005,0101,0,1633 ,10 ,1643 ,2964 ,0,3,1,3,0,1,0,76.14,55.43 ,33.33
03,019,01,005,0102,0,2222 ,15 ,2237 ,3785 ,0,3,1,3,0,1,0,76.14,59.10 ,33.33
03,019,01,005,0103,0,3133 ,20 ,3153 ,5557 ,0,3,1,3,0,1,0,76.14,56.74 ,33.33
03,019,01,005,0104,0,2450 ,11 ,2461 ,4288 ,0,3,1,3,0,1,0,76.14,57.39 ,33.33
03,019,01,005,0105,0,1349 ,3 ,1352 ,2576 ,0,3,1,3,0,1,0,76.14,52.48 ,33.33
03,019,01,005,0106,0,2685 ,18 ,2703 ,4897 ,0,3,1,3,0,1,0,76.14,55.20 ,33.33
03,019,01,005,0107,0,1482 ,7 ,1489 ,2830 ,0,3,1,3,0,1,0,76.14,52.61 ,33.33
03,019,01,005,0108,0,1392 ,8 ,1400 ,2453 ,0,3,1,3,0,1,0,76.14,57.07 ,33.33
03,019,01,006,0109,0,2185 ,17 ,2202 ,3767 ,0,3,1,3,0,1,0,76.14,58.46 ,33.33
03,019,01,006,0110,0,1542 ,5 ,1547 ,2931 ,0,3,1,3,0,1,0,76.14,52.78 ,33.33
03,019,01,006,0111,0,2782 ,18 ,2800 ,4721 ,0,3,1,3,0,1,0,76.14,59.31 ,33.33
03,019,01,006,0112,0,2107 ,14 ,2121 ,3627 ,0,3,1,3,0,1,0,76.14,58.48 ,33.33
03,019,01,006,0113,0,1378 ,14 ,1392 ,2370 ,0,3,1,3,0,1,0,76.14,58.73 ,33.33
03,019,01,006,0114,0,591 ,1 ,592 ,937 ,0,3,1,3,0,1,0,76.14,63.18 ,33.33
03,019,01,006,0115,0,2954 ,24 ,2978 ,5247 ,0,3,1,3,0,1,0,76.14,56.76 ,33.33
03,019,01,006,0116,0,1603 ,9 ,1612 ,3254 ,0,3,1,3,0,1,0,76.14,49.54 ,33.33
03,019,01,006,0117,0,1415 ,7 ,1422 ,2737 ,0,3,1,3,0,1,0,76.14,51.95 ,33.33
03,019,01,006,0118,0,2042 ,23 ,2065 ,3590 ,0,3,1,3,0,1,0,76.14,57.52 ,33.33
03,019,01,006,0119,0,2079 ,15 ,2094 ,3860 ,0,3,1,3,0,1,0,76.14,54.25 ,33.33
03,019,01,006,0120,0,2389 ,21 ,2410 ,4209 ,0,3,1,3,0,1,0,76.14,57.26 ,33.33
03,019,01,006,0121,0,1325 ,6 ,1331 ,2584 ,0,3,1,3,0,1,0,76.14,51.51 ,33.33
03,019,01,006,0122,0,1700 ,9 ,1709 ,3162 ,0,3,1,3,0,1,0,76.14,54.05 ,33.33
03,019,01,006,0123,0,1848 ,15 ,1863 ,3360 ,0,3,1,3,0,1,0,76.14,55.45 ,33.33
03,019,01,006,0124,0,2808 ,17 ,2825 ,5401 ,0,3,1,3,0,1,0,76.14,52.31 ,33.33
03,019,01,006,0125,0,2152 ,13 ,2165 ,4343 ,0,3,1,3,0,1,0,76.14,49.85 ,33.33
03,019,01,006,0126,0,2617 ,16 ,2633 ,4958 ,0,3,1,3,0,1,0,76.14,53.11 ,33.33
03,019,01,006,0127,0,1598 ,6 ,1604 ,2941 ,0,3,1,3,0,1,0,76.14,54.54 ,33.33
03,019,01,006,0128,0,1960 ,13 ,1973 ,3568 ,0,3,1,3,0,1,0,76.14,55.30 ,33.33
03,019,01,006,0129,0,2720 ,17 ,2737 ,4971 ,0,3,1,3,0,1,0,76.14,55.06 ,33.33
03,019,01,006,0130,0,1903 ,16 ,1919 ,3312 ,0,3,1,3,0,1,0,76.14,57.94 ,33.33
03,019,01,006,0131,0,605 ,7 ,612 ,940 ,0,3,1,3,0,1,0,76.14,65.11 ,33.33
03,019,01,006,0132,0,1629 ,7 ,1636 ,2872 ,0,3,1,3,0,1,0,76.14,56.96 ,33.33
03,019,01,006,0133,0,2286 ,14 ,2300 ,3982 ,0,3,1,3,0,1,0,76.14,57.76 ,33.33
03,019,01,006,0134,0,2698 ,16 ,2714 ,4710 ,0,3,1,3,0,1,0,76.14,57.62 ,33.33
03,019,01,006,0135,0,1319 ,13 ,1332 ,2132 ,0,3,1,3,0,1,0,76.14,62.48 ,33.33
03,019,01,006,0136,0,1540 ,19 ,1559 ,2606 ,0,3,1,3,0,1,0,76.14,59.82 ,33.33
03,019,01,006,0137,0,3251 ,18 ,3269 ,5522 ,0,3,1,3,0,1,0,76.14,59.20 ,33.33
03,019,01,006,0138,0,1051 ,2 ,1053 ,1983 ,0,3,1,3,0,1,0,76.14,53.10 ,33.33
03,019,01,006,0139,0,1886 ,12 ,1898 ,3529 ,0,3,1,3,0,1,0,76.14,53.78 ,33.33
03,019,01,006,0140,0,2118 ,22 ,2140 ,3847 ,0,3,1,3,0,1,0,76.14,55.63 ,33.33
03,019,01,006,0141,0,1092 ,4 ,1096 ,2057 ,0,3,1,3,0,1,0,76.14,53.28 ,33.33
03,019,01,006,0142,0,871 ,4 ,875 ,1740 ,0,3,1,3,0,1,0,76.14,50.29 ,33.33
03,019,01,006,0143,0,1813 ,9 ,1822 ,3100 ,0,3,1,3,0,1,0,76.14,58.77 ,33.33
03,019,01,006,0144,0,1307 ,5 ,1312 ,2302 ,0,3,1,3,0,1,0,76.14,56.99 ,33.33
03,019,01,006,0145,0,1574 ,5 ,1579 ,3069 ,0,3,1,3,0,1,0,76.14,51.45 ,33.33
03,019,01,006,0146,0,1826 ,11 ,1837 ,3145 ,0,3,1,3,0,1,0,76.14,58.41 ,33.33
03,019,01,007,0147,0,2819 ,33 ,2852 ,5064 ,0,3,1,3,0,1,0,76.14,56.32 ,33.33
03,019,01,007,0148,0,3504 ,18 ,3522 ,6520 ,0,3,1,3,0,1,0,76.14,54.02 ,33.33
03,019,01,007,0149,0,2490 ,28 ,2518 ,4032 ,0,3,1,3,0,1,0,76.14,62.45 ,33.33
03,019,01,007,0150,0,2300 ,20 ,2320 ,3903 ,0,3,1,3,0,1,0,76.14,59.44 ,33.33
03,019,01,007,0151,0,982 ,6 ,988 ,1503 ,0,3,1,3,0,1,0,76.14,65.74 ,33.33
03,019,01,007,0152,0,1721 ,12 ,1733 ,3163 ,0,3,1,3,0,1,0,76.14,54.79 ,33.33
03,019,01,007,0153,0,2585 ,27 ,2612 ,4536 ,0,3,1,3,0,1,0,76.14,57.58 ,33.33
03,019,01,007,0154,0,1529 ,9 ,1538 ,2356 ,0,3,1,3,0,1,0,76.14,65.28 ,33.33
03,019,01,007,0155,0,2496 ,18 ,2514 ,4849 ,0,3,1,3,0,1,0,76.14,51.85 ,33.33
03,019,01,007,0156,0,1644 ,14 ,1658 ,3045 ,0,3,1,3,0,1,0,76.14,54.45 ,33.33
03,019,01,007,0157,0,736 ,7 ,743 ,1298 ,0,3,1,3,0,1,0,76.14,57.24 ,33.33
03,019,01,007,0158,0,2129 ,12 ,2141 ,4167 ,0,3,1,3,0,1,0,76.14,51.38 ,33.33
03,019,01,007,0159,0,2297 ,21 ,2318 ,4470 ,0,3,1,3,0,1,0,76.14,51.86 ,33.33
03,019,01,007,0160,0,2386 ,17 ,2403 ,4424 ,0,3,1,3,0,1,0,76.14,54.32 ,33.33
03,019,01,007,0161,0,2389 ,16 ,2405 ,4011 ,0,3,1,3,0,1,0,76.14,59.96 ,33.33
03,019,01,007,0162,0,1454 ,11 ,1465 ,2726 ,0,3,1,3,0,1,0,76.14,53.74 ,33.33
03,019,01,007,0163,0,2355 ,24 ,2379 ,4107 ,0,3,1,3,0,1,0,76.14,57.93 ,33.33
03,019,01,007,0164,0,1492 ,9 ,1501 ,2684 ,0,3,1,3,0,1,0,76.14,55.92 ,33.33
03,019,01,007,0165,0,2075 ,19 ,2094 ,3863 ,0,3,1,3,0,1,0,76.14,54.21 ,33.33
03,019,01,007,0166,0,1832 ,13 ,1845 ,3235 ,0,3,1,3,0,1,0,76.14,57.03 ,33.33
03,019,01,007,0167,0,2051 ,15 ,2066 ,3658 ,0,3,1,3,0,1,0,76.14,56.48 ,33.33
03,019,01,007,0168,0,1256 ,9 ,1265 ,2313 ,0,3,1,3,0,1,0,76.14,54.69 ,33.33
03,019,01,007,0169,0,2514 ,17 ,2531 ,4750 ,0,3,1,3,0,1,0,76.14,53.28 ,33.33
03,019,01,007,0170,0,1942 ,8 ,1950 ,3465 ,0,3,1,3,0,1,0,76.14,56.28 ,33.33
03,019,01,007,0171,0,2236 ,10 ,2246 ,4309 ,0,3,1,3,0,1,0,76.14,52.12 ,33.33
03,019,01,008,0172,0,1652 ,8 ,1660 ,3009 ,0,3,1,3,0,1,0,76.14,55.17 ,33.33
03,019,01,008,0173,0,1833 ,13 ,1846 ,3181 ,0,3,1,3,0,1,0,76.14,58.03 ,33.33
03,019,01,008,0174,0,1792 ,18 ,1810 ,3066 ,0,3,1,3,0,1,0,76.14,59.03 ,33.33
03,019,01,008,0175,0,3032 ,25 ,3057 ,5546 ,0,3,1,3,0,1,0,76.14,55.12 ,33.33
03,019,01,008,0176,0,2558 ,14 ,2572 ,4700 ,0,3,1,3,0,1,0,76.14,54.72 ,33.33
03,019,01,008,0177,0,3610 ,19 ,3629 ,6141 ,0,3,1,3,0,1,0,76.14,59.09 ,33.33
03,019,01,008,0178,0,3731 ,41 ,3772 ,6404 ,0,3,1,3,0,1,0,76.14,58.90 ,33.33
03,019,01,008,0179,0,1953 ,14 ,1967 ,3613 ,0,3,1,3,0,1,0,76.14,54.44 ,33.33
03,019,01,008,0180,0,3398 ,19 ,3417 ,5911 ,0,3,1,3,0,1,0,76.14,57.81 ,33.33
03,019,01,008,0181,0,1803 ,12 ,1815 ,3275 ,0,3,1,3,0,1,0,76.14,55.42 ,33.33
03,019,01,008,0182,0,1762 ,6 ,1768 ,3136 ,0,3,1,3,0,1,0,76.14,56.38 ,33.33
03,019,01,008,0183,0,2483 ,14 ,2497 ,4334 ,0,3,1,3,0,1,0,76.14,57.61 ,33.33
03,019,01,008,0184,0,2448 ,21 ,2469 ,4205 ,0,3,1,3,0,1,0,76.14,58.72 ,33.33
03,019,01,008,0185,0,784 ,15 ,799 ,1424 ,0,3,1,3,0,1,0,76.14,56.11 ,33.33
03,019,01,008,0186,0,2615 ,16 ,2631 ,5050 ,0,3,1,3,0,1,0,76.14,52.10 ,33.33
03,019,01,008,0187,0,3243 ,22 ,3265 ,5234 ,0,3,1,3,0,1,0,76.14,62.38 ,33.33
03,019,01,008,0188,0,3160 ,19 ,3179 ,5377 ,0,3,1,3,0,1,0,76.14,59.12 ,33.33
03,019,01,008,0189,0,3748 ,26 ,3774 ,6463 ,0,3,1,3,0,1,0,76.14,58.39 ,33.33
03,019,01,008,0190,0,1265 ,9 ,1274 ,1953 ,0,3,1,3,0,1,0,76.14,65.23 ,33.33
03,019,01,008,0191,0,2688 ,14 ,2702 ,5127 ,0,3,1,3,0,1,0,76.14,52.70 ,33.33
03,019,01,008,0192,0,2894 ,21 ,2915 ,4844 ,0,3,1,3,0,1,0,76.14,60.18 ,33.33
03,019,01,008,0193,0,980 ,8 ,988 ,1631 ,0,3,1,3,0,1,0,76.14,60.58 ,33.33
03,019,01,008,0194,0,1042 ,5 ,1047 ,1600 ,0,3,1,3,0,1,0,76.14,65.44 ,33.33
03,019,01,008,0195,0,1040 ,10 ,1050 ,1728 ,0,3,1,3,0,1,0,76.14,60.76 ,33.33
03,019,01,008,0196,0,504 ,1 ,505 ,895 ,0,3,1,3,0,1,0,76.14,56.42 ,33.33
03,019,01,008,0197,0,493 ,2 ,495 ,811 ,0,3,1,3,0,1,0,76.14,61.04 ,33.33
03,019,01,008,0198,0,2483 ,26 ,2509 ,4307 ,0,3,1,3,0,1,0,76.14,58.25 ,33.33
03,019,01,008,0199,0,1776 ,12 ,1788 ,3467 ,0,3,1,3,0,1,0,76.14,51.57 ,33.33
03,019,01,008,0200,0,1644 ,12 ,1656 ,3243 ,0,3,1,3,0,1,0,76.14,51.06 ,33.33
03,019,01,008,0201,0,1841 ,12 ,1853 ,3495 ,0,3,1,3,0,1,0,76.14,53.02 ,33.33
03,019,01,008,0202,0,2418 ,11 ,2429 ,4522 ,0,3,1,3,0,1,0,76.14,53.72 ,33.33
03,019,01,008,0203,0,1382 ,16 ,1398 ,2494 ,0,3,1,3,0,1,0,76.14,56.05 ,33.33
03,019,01,008,0204,0,1287 ,13 ,1300 ,2295 ,0,3,1,3,0,1,0,76.14,56.64 ,33.33
03,019,01,008,0205,0,2010 ,21 ,2031 ,3716 ,0,3,1,3,0,1,0,76.14,54.66 ,33.33
03,019,01,008,0206,0,3037 ,17 ,3054 ,5448 ,0,3,1,3,0,1,0,76.14,56.06 ,33.33
03,019,01,008,0207,0,2180 ,15 ,2195 ,4217 ,0,3,1,3,0,1,0,76.14,52.05 ,33.33
03,019,01,008,0208,0,2389 ,19 ,2408 ,4380 ,0,3,1,3,0,1,0,76.14,54.98 ,33.33
03,019,01,008,0209,0,2089 ,16 ,2105 ,3769 ,0,3,1,3,0,1,0,76.14,55.85 ,33.33
03,019,01,008,0210,0,2673 ,17 ,2690 ,5081 ,0,3,1,3,0,1,0,76.14,52.94 ,33.33
03,019,01,008,0211,0,2202 ,12 ,2214 ,3924 ,0,3,1,3,0,1,0,76.14,56.42 ,33.33
03,019,01,008,0212,0,2073 ,16 ,2089 ,3640 ,0,3,1,3,0,1,0,76.14,57.39 ,33.33
03,019,01,008,0213,0,1833 ,8 ,1841 ,3640 ,0,3,1,3,0,1,0,76.14,50.58 ,33.33
03,020,01,001,0001,0,2274 ,13 ,2287 ,4192 ,0,3,1,3,0,1,0,76.14,54.56 ,33.33
03,020,01,001,0002,0,992 ,13 ,1005 ,1686 ,0,3,1,3,0,1,0,76.14,59.61 ,33.33
03,020,01,001,0003,0,353 ,0 ,353 ,632 ,0,3,1,3,0,1,0,76.14,55.85 ,33.33
03,020,01,001,0004,0,1853 ,7 ,1860 ,3513 ,0,3,1,3,0,1,0,76.14,52.95 ,33.33
03,020,01,001,0005,0,495 ,5 ,500 ,871 ,0,3,1,3,0,1,0,76.14,57.41 ,33.33
03,020,01,001,0006,0,2090 ,7 ,2097 ,3887 ,0,3,1,3,0,1,0,76.14,53.95 ,33.33
03,020,01,001,0007,0,1242 ,3 ,1245 ,2332 ,0,3,1,3,0,1,0,76.14,53.39 ,33.33
03,020,01,001,0008,0,1453 ,10 ,1463 ,2606 ,0,3,1,3,0,1,0,76.14,56.14 ,33.33
03,020,01,001,0009,0,1915 ,12 ,1927 ,3523 ,0,3,1,3,0,1,0,76.14,54.6977008232,33.33
03,020,01,001,0010,0,1738 ,8 ,1746 ,3243 ,0,3,1,3,0,1,0,76.14,53.84 ,33.33
03,020,01,001,0011,0,2183 ,10 ,2193 ,3866 ,0,3,1,3,0,1,0,76.14,56.73 ,33.33
03,020,01,001,0012,0,624 ,4 ,628 ,1114 ,0,3,1,3,0,1,0,76.14,56.37 ,33.33
03,020,01,001,0013,0,174 ,0 ,174 ,297 ,0,3,1,3,0,1,0,76.14,58.59 ,33.33
03,020,01,001,0014,0,275 ,1 ,276 ,452 ,0,3,1,3,0,1,0,76.14,61.06 ,33.33
03,020,01,001,0015,0,318 ,1 ,319 ,535 ,0,3,1,3,0,1,0,76.14,59.63 ,33.33
03,020,01,001,0016,0,305 ,3 ,308 ,518 ,0,3,1,3,0,1,0,76.14,59.46 ,33.33
03,020,01,001,0017,0,357 ,3 ,360 ,668 ,0,3,1,3,0,1,0,76.14,53.8922155689,33.33
03,020,01,001,0018,0,307 ,1 ,308 ,494 ,0,3,1,3,0,1,0,76.14,62.3481781377,33.33
03,020,01,001,0019,0,245 ,0 ,245 ,427 ,0,3,1,3,0,1,0,76.14,57.38 ,33.33
03,020,01,001,0020,0,720 ,5 ,725 ,1272 ,0,3,1,3,0,1,0,76.14,57.00 ,33.33
03,020,01,001,0021,0,357 ,1 ,358 ,626 ,0,3,1,3,0,1,0,76.14,57.19 ,33.33
03,020,01,001,0022,0,561 ,6 ,567 ,1011 ,0,3,1,3,0,1,0,76.14,56.08 ,33.33
03,020,01,001,0023,0,191 ,1 ,192 ,377 ,0,3,1,3,0,1,0,76.14,50.9283819629,33.33
03,020,01,001,0024,0,519 ,3 ,522 ,985 ,0,3,1,3,0,1,0,76.14,52.9949238579,33.33
03,020,01,001,0025,0,383 ,1 ,384 ,632 ,0,3,1,3,0,1,0,76.14,60.7594936709,33.33
03,020,01,001,0026,0,392 ,1 ,393 ,715 ,0,3,1,3,0,1,0,76.14,54.97 ,33.33
03,020,01,001,0027,0,416 ,5 ,421 ,706 ,0,3,1,3,0,1,0,76.14,59.63 ,33.33
03,020,01,001,0028,0,382 ,1 ,383 ,648 ,0,3,1,3,0,1,0,76.14,59.10 ,33.33
03,020,01,001,0029,0,702 ,8 ,710 ,1156 ,0,3,1,3,0,1,0,76.14,61.42 ,33.33
03,020,01,001,0030,0,337 ,0 ,337 ,612 ,0,3,1,3,0,1,0,76.14,55.07 ,33.33
03,020,01,001,0031,0,576 ,6 ,582 ,1063 ,0,3,1,3,0,1,0,76.14,54.75 ,33.33
03,020,01,001,0032,0,689 ,2 ,691 ,1276 ,0,3,1,3,0,1,0,76.14,54.15 ,33.33
03,020,01,001,0033,0,443 ,2 ,445 ,770 ,0,3,1,3,0,1,0,76.14,57.79 ,33.33
03,020,01,001,0034,0,779 ,3 ,782 ,1360 ,0,3,1,3,0,1,0,76.14,57.5,33.33
03,020,01,001,0035,0,892 ,3 ,895 ,1789 ,0,3,1,3,0,1,0,76.14,50.03 ,33.33
03,020,01,001,0036,0,732 ,4 ,736 ,1277 ,0,3,1,3,0,1,0,76.14,57.64 ,33.33
03,020,01,001,0037,0,828 ,3 ,831 ,1538 ,0,3,1,3,0,1,0,76.14,54.03 ,33.33
03,020,01,001,0038,0,1745 ,6 ,1751 ,3513 ,0,3,1,3,0,1,0,76.14,49.84 ,33.33
03,020,01,001,0039,0,1171 ,7 ,1178 ,2044 ,0,3,1,3,0,1,0,76.14,57.63 ,33.33
03,020,01,001,0040,0,1075 ,4 ,1079 ,2005 ,0,3,1,3,0,1,0,76.14,53.82 ,33.33
03,020,01,001,0041,0,2353 ,10 ,2363 ,4707 ,0,3,1,3,0,1,0,76.14,50.20 ,33.33
03,020,01,001,0042,0,1565 ,7 ,1572 ,3180 ,0,3,1,3,0,1,0,76.14,49.4339622642,33.33
03,020,01,001,0043,0,1068 ,9 ,1077 ,2194 ,0,3,1,3,0,1,0,76.14,49.09 ,33.33
03,020,01,001,0044,0,1649 ,7 ,1656 ,3202 ,0,3,1,3,0,1,0,76.14,51.72 ,33.33
03,020,01,001,0045,0,466 ,5 ,471 ,848 ,0,3,1,3,0,1,0,76.14,55.54 ,33.33
03,020,01,001,0046,0,382 ,2 ,384 ,639 ,0,3,1,3,0,1,0,76.14,60.09 ,33.33
03,020,01,001,0047,0,595 ,2 ,597 ,1040 ,0,3,1,3,0,1,0,76.14,57.40 ,33.33
03,020,01,001,0048,0,773 ,4 ,777 ,1455 ,0,3,1,3,0,1,0,76.14,53.40 ,33.33
03,020,01,001,0049,0,515 ,4 ,519 ,853 ,0,3,1,3,0,1,0,76.14,60.84 ,33.33
03,020,01,001,0050,0,282 ,3 ,285 ,477 ,0,3,1,3,0,1,0,76.14,59.75 ,33.33
03,020,01,001,0051,0,1432 ,11 ,1443 ,2735 ,0,3,1,3,0,1,0,76.14,52.76 ,33.33
03,020,01,001,0052,0,1114 ,4 ,1118 ,2153 ,0,3,1,3,0,1,0,76.14,51.93 ,33.33
03,020,01,001,0053,0,1636 ,7 ,1643 ,3079 ,0,3,1,3,0,1,0,76.14,53.36 ,33.33
03,020,01,001,0054,0,1370 ,4 ,1374 ,2734 ,0,3,1,3,0,1,0,76.14,50.26 ,33.33
03,020,01,001,0055,0,2448 ,20 ,2468 ,4840 ,0,3,1,3,0,1,0,76.14,50.99 ,33.33
03,020,01,002,0056,0,556 ,4 ,560 ,1015 ,0,3,1,3,0,1,0,76.14,55.1724137931,33.33
03,020,01,002,0057,0,355 ,0 ,355 ,596 ,0,3,1,3,0,1,0,76.14,59.5637583893,33.33
03,020,01,002,0058,0,251 ,1 ,252 ,477 ,0,3,1,3,0,1,0,76.14,52.83 ,33.33
03,020,01,002,0059,0,378 ,2 ,380 ,631 ,0,3,1,3,0,1,0,76.14,60.22 ,33.33
03,020,01,002,0060,0,285 ,1 ,286 ,531 ,0,3,1,3,0,1,0,76.14,53.86 ,33.33
03,020,01,002,0061,0,489 ,2 ,491 ,773 ,0,3,1,3,0,1,0,76.14,63.52 ,33.33
03,020,01,002,0062,0,330 ,3 ,333 ,581 ,0,3,1,3,0,1,0,76.14,57.31 ,33.33
03,020,01,002,0063,0,641 ,4 ,645 ,1126 ,0,3,1,3,0,1,0,76.14,57.28 ,33.33
03,020,01,002,0064,0,508 ,7 ,515 ,828 ,0,3,1,3,0,1,0,76.14,62.20 ,33.33
03,020,01,002,0065,0,450 ,2 ,452 ,810 ,0,3,1,3,0,1,0,76.14,55.80 ,33.33
03,020,01,002,0066,0,313 ,2 ,315 ,530 ,0,3,1,3,0,1,0,76.14,59.4339622642,33.33
03,020,01,002,0067,0,432 ,3 ,435 ,800 ,0,3,1,3,0,1,0,76.14,54.375,33.33
03,020,01,002,0068,0,317 ,3 ,320 ,528 ,0,3,1,3,0,1,0,76.14,60.6060606061,33.33
03,020,01,002,0069,0,341 ,0 ,341 ,543 ,0,3,1,3,0,1,0,76.14,62.80 ,33.33
03,020,01,002,0070,0,206 ,2 ,208 ,405 ,0,3,1,3,0,1,0,76.14,51.36 ,33.33
03,020,01,002,0071,0,195 ,0 ,195 ,367 ,0,3,1,3,0,1,0,76.14,53.13 ,33.33
03,020,01,002,0072,0,348 ,3 ,351 ,631 ,0,3,1,3,0,1,0,76.14,55.63 ,33.33
03,020,01,002,0073,0,447 ,5 ,452 ,712 ,0,3,1,3,0,1,0,76.14,63.48 ,33.33
03,020,01,002,0074,0,370 ,3 ,373 ,608 ,0,3,1,3,0,1,0,76.14,61.35 ,33.33
03,020,01,002,0075,0,3099 ,34 ,3133 ,6059 ,0,3,1,3,0,1,0,76.14,51.71 ,33.33
03,020,01,002,0076,0,521 ,4 ,525 ,911 ,0,3,1,3,0,1,0,76.14,57.63 ,33.33
03,020,01,002,0077,0,1856 ,15 ,1871 ,3676 ,0,3,1,3,0,1,0,76.14,50.90 ,33.33
03,020,01,002,0078,0,1128 ,7 ,1135 ,2062 ,0,3,1,3,0,1,0,76.14,55.04 ,33.33
03,020,01,002,0079,0,679 ,2 ,681 ,1282 ,0,3,1,3,0,1,0,76.14,53.12 ,33.33
03,020,01,002,0080,0,743 ,2 ,745 ,1310 ,0,3,1,3,0,1,0,76.14,56.87 ,33.33
03,020,01,002,0081,0,935 ,8 ,943 ,1819 ,0,3,1,3,0,1,0,76.14,51.84 ,33.33
03,020,01,002,0082,0,1777 ,13 ,1790 ,3240 ,0,3,1,3,0,1,0,76.14,55.2469135802,33.33
03,020,01,002,0083,0,1048 ,2 ,1050 ,2044 ,0,3,1,3,0,1,0,76.14,51.37 ,33.33
03,020,01,002,0084,0,440 ,2 ,442 ,772 ,0,3,1,3,0,1,0,76.14,57.25 ,33.33
03,020,01,002,0085,0,665 ,5 ,670 ,1240 ,0,3,1,3,0,1,0,76.14,54.0322580645,33.33
03,020,01,002,0086,0,562 ,4 ,566 ,991 ,0,3,1,3,0,1,0,76.14,57.11 ,33.33
03,020,01,002,0087,0,965 ,6 ,971 ,1953 ,0,3,1,3,0,1,0,76.14,49.72 ,33.33
03,020,01,002,0088,0,2347 ,15 ,2362 ,4478 ,0,3,1,3,0,1,0,76.14,52.75 ,33.33
03,020,01,002,0089,0,2260 ,13 ,2273 ,4369 ,0,3,1,3,0,1,0,76.14,52.0256351568,33.33
03,020,01,002,0090,0,3698 ,25 ,3723 ,7042 ,0,3,1,3,0,1,0,76.14,52.87 ,33.33
03,020,01,002,0091,0,1780 ,17 ,1797 ,3375 ,0,3,1,3,0,1,0,76.14,53.24 ,33.33
03,020,01,002,0092,0,2224 ,16 ,2240 ,4346 ,0,3,1,3,0,1,0,76.14,51.54 ,33.33
03,020,01,002,0093,0,1213 ,8 ,1221 ,2242 ,0,3,1,3,0,1,0,76.14,54.46 ,33.33
03,020,01,002,0094,0,686 ,4 ,690 ,1212 ,0,3,1,3,0,1,0,76.14,56.93 ,33.33
03,020,01,002,0095,0,675 ,3 ,678 ,1262 ,0,3,1,3,0,1,0,76.14,53.72 ,33.33
03,020,01,002,0096,0,1070 ,5 ,1075 ,1963 ,0,3,1,3,0,1,0,76.14,54.76 ,33.33
03,020,01,002,0097,0,1055 ,6 ,1061 ,2042 ,0,3,1,3,0,1,0,76.14,51.96 ,33.33
03,020,01,002,0098,0,290 ,2 ,292 ,491 ,0,3,1,3,0,1,0,76.14,59.47 ,33.33
03,020,01,002,0099,0,346 ,3 ,349 ,647 ,0,3,1,3,0,1,0,76.14,53.94 ,33.33
03,020,01,002,0100,0,789 ,6 ,795 ,1428 ,0,3,1,3,0,1,0,76.14,55.67 ,33.33
03,020,01,002,0101,0,692 ,3 ,695 ,1355 ,0,3,1,3,0,1,0,76.14,51.2915129151,33.33
03,020,01,002,0102,0,945 ,4 ,949 ,1851 ,0,3,1,3,0,1,0,76.14,51.27 ,33.33
03,020,01,002,0103,0,2077 ,15 ,2092 ,3989 ,0,3,1,3,0,1,0,76.14,52.4442216094,33.33
03,020,01,002,0104,0,4535 ,29 ,4564 ,9011 ,0,3,1,3,0,1,0,76.14,50.65 ,33.33
03,020,01,002,0105,0,1773 ,13 ,1786 ,3414 ,0,3,1,3,0,1,0,76.14,52.3140011716,33.33
03,020,01,002,0106,0,1262 ,11 ,1273 ,2350 ,0,3,1,3,0,1,0,76.14,54.17 ,33.33
03,020,01,002,0107,0,641 ,6 ,647 ,1215 ,0,3,1,3,0,1,0,76.14,53.25 ,33.33
03,020,01,002,0108,0,488 ,2 ,490 ,909 ,0,3,1,3,0,1,0,76.14,53.91 ,33.33
03,021,01,001,0001,0,1871 ,6 ,1877 ,3856 ,0,3,1,3,0,1,0,76.14,48.68 ,33.33
03,021,01,001,0002,0,1462 ,9 ,1471 ,2608 ,0,3,1,3,0,1,0,76.14,56.40 ,33.33
03,021,01,001,0003,0,2319 ,14 ,2333 ,4025 ,0,3,1,3,0,1,0,76.14,57.96 ,33.33
03,021,01,001,0004,0,1847 ,11 ,1858 ,3485 ,0,3,1,3,0,1,0,76.14,53.31 ,33.33
03,021,01,001,0005,0,1289 ,7 ,1296 ,2344 ,0,3,1,3,0,1,0,76.14,55.29 ,33.33
03,021,01,001,0006,0,2516 ,13 ,2529 ,4510 ,0,3,1,3,0,1,0,76.14,56.08 ,33.33
03,021,01,001,0007,0,1193 ,10 ,1203 ,2068 ,0,3,1,3,0,1,0,76.14,58.17 ,33.33
03,021,01,001,0008,0,2730 ,14 ,2744 ,4746 ,0,3,1,3,0,1,0,76.14,57.82 ,33.33
03,021,01,001,0009,0,1460 ,14 ,1474 ,2553 ,0,3,1,3,0,1,0,76.14,57.74 ,33.33
03,021,01,001,0010,0,1965 ,7 ,1972 ,3849 ,0,3,1,3,0,1,0,76.14,51.23 ,33.33
03,021,01,001,0011,0,1563 ,8 ,1571 ,2815 ,0,3,1,3,0,1,0,76.14,55.81 ,33.33
03,021,01,001,0012,0,2456 ,19 ,2475 ,4487 ,0,3,1,3,0,1,0,76.14,55.16 ,33.33
03,021,01,001,0013,0,1043 ,4 ,1047 ,1995 ,0,3,1,3,0,1,0,76.14,52.48 ,33.33
03,021,01,001,0014,0,1719 ,7 ,1726 ,3133 ,0,3,1,3,0,1,0,76.14,55.09 ,33.33
03,021,01,001,0015,0,2265 ,13 ,2278 ,4220 ,0,3,1,3,0,1,0,76.14,53.98 ,33.33
03,021,01,001,0016,0,1179 ,6 ,1185 ,2130 ,0,3,1,3,0,1,0,76.14,55.63 ,33.33
03,021,01,001,0017,0,3682 ,22 ,3704 ,6589 ,0,3,1,3,0,1,0,76.14,56.21 ,33.33
03,021,01,001,0018,0,1531 ,6 ,1537 ,2619 ,0,3,1,3,0,1,0,76.14,58.69 ,33.33
03,021,01,001,0019,0,1238 ,11 ,1249 ,1878 ,0,3,1,3,0,1,0,76.14,66.51 ,33.33
03,021,01,001,0020,0,1077 ,12 ,1089 ,1584 ,0,3,1,3,0,1,0,76.14,68.75 ,33.33
03,021,01,001,0021,0,2436 ,13 ,2449 ,4237 ,0,3,1,3,0,1,0,76.14,57.80 ,33.33
03,021,01,001,0022,0,1829 ,9 ,1838 ,3278 ,0,3,1,3,0,1,0,76.14,56.07 ,33.33
03,021,01,001,0023,0,1942 ,7 ,1949 ,3271 ,0,3,1,3,0,1,0,76.14,59.58 ,33.33
03,021,01,001,0024,0,2375 ,11 ,2386 ,4170 ,0,3,1,3,0,1,0,76.14,57.22 ,33.33
03,021,01,001,0025,0,872 ,2 ,874 ,1427 ,0,3,1,3,0,1,0,76.14,61.25 ,33.33
03,021,01,001,0026,0,1225 ,6 ,1231 ,2134 ,0,3,1,3,0,1,0,76.14,57.69 ,33.33
03,021,01,001,0027,0,1244 ,7 ,1251 ,2099 ,0,3,1,3,0,1,0,76.14,59.60 ,33.33
03,021,01,001,0028,0,1338 ,7 ,1345 ,2216 ,0,3,1,3,0,1,0,76.14,60.69 ,33.33
03,021,01,001,0029,0,1816 ,13 ,1829 ,3087 ,0,3,1,3,0,1,0,76.14,59.25 ,33.33
03,021,01,001,0030,0,825 ,10 ,835 ,1565 ,0,3,1,3,0,1,0,76.14,53.35 ,33.33
03,021,01,001,0031,0,1465 ,8 ,1473 ,2467 ,0,3,1,3,0,1,0,76.14,59.71 ,33.33
03,021,01,001,0032,0,1585 ,7 ,1592 ,2688 ,0,3,1,3,0,1,0,76.14,59.23 ,33.33
03,021,01,001,0033,0,876 ,7 ,883 ,1590 ,0,3,1,3,0,1,0,76.14,55.53 ,33.33
03,021,01,001,0034,0,1656 ,7 ,1663 ,2887 ,0,3,1,3,0,1,0,76.14,57.60 ,33.33
03,021,01,001,0035,0,2200 ,12 ,2212 ,3854 ,0,3,1,3,0,1,0,76.14,57.39 ,33.33
03,021,01,001,0036,0,1147 ,8 ,1155 ,2082 ,0,3,1,3,0,1,0,76.14,55.48 ,33.33
03,021,01,001,0037,0,2257 ,9 ,2266 ,4146 ,0,3,1,3,0,1,0,76.14,54.66 ,33.33
03,021,01,001,0038,0,1791 ,8 ,1799 ,3084 ,0,3,1,3,0,1,0,76.14,58.33 ,33.33
03,021,01,001,0039,0,1278 ,8 ,1286 ,2149 ,0,3,1,3,0,1,0,76.14,59.84 ,33.33
03,021,01,001,0040,0,933 ,5 ,938 ,1611 ,0,3,1,3,0,1,0,76.14,58.22 ,33.33
03,021,01,001,0041,0,698 ,3 ,701 ,1246 ,0,3,1,3,0,1,0,76.14,56.26 ,33.33
03,021,01,001,0042,0,1661 ,10 ,1671 ,2938 ,0,3,1,3,0,1,0,76.14,56.88 ,33.33
03,021,01,001,0043,0,2497 ,6 ,2503 ,4239 ,0,3,1,3,0,1,0,76.14,59.05 ,33.33
03,021,01,001,0044,0,1545 ,13 ,1558 ,2815 ,0,3,1,3,0,1,0,76.14,55.35 ,33.33
03,021,01,001,0045,0,1943 ,13 ,1956 ,3419 ,0,3,1,3,0,1,0,76.14,57.21 ,33.33
03,021,01,002,0046,0,1874 ,10 ,1884 ,3167 ,0,3,1,3,0,1,0,76.14,59.49 ,33.33
03,021,01,002,0047,0,1091 ,9 ,1100 ,1870 ,0,3,1,3,0,1,0,76.14,58.82 ,33.33
03,021,01,002,0048,0,2520 ,21 ,2541 ,4279 ,0,3,1,3,0,1,0,76.14,59.38 ,33.33
03,021,01,002,0049,0,1173 ,16 ,1189 ,1772 ,0,3,1,3,0,1,0,76.14,67.10 ,33.33
03,021,01,002,0050,0,857 ,11 ,868 ,1451 ,0,3,1,3,0,1,0,76.14,59.82 ,33.33
03,021,01,002,0051,0,435 ,3 ,438 ,745 ,0,3,1,3,0,1,0,76.14,58.79 ,33.33
03,021,01,002,0052,0,576 ,2 ,578 ,941 ,0,3,1,3,0,1,0,76.14,61.42 ,33.33
03,021,01,002,0053,0,632 ,5 ,637 ,1051 ,0,3,1,3,0,1,0,76.14,60.61 ,33.33
03,021,01,002,0054,0,555 ,2 ,557 ,920 ,0,3,1,3,0,1,0,76.14,60.54 ,33.33
03,021,01,002,0055,0,1954 ,11 ,1965 ,3356 ,0,3,1,3,0,1,0,76.14,58.55 ,33.33
03,021,01,002,0056,0,1490 ,9 ,1499 ,2625 ,0,3,1,3,0,1,0,76.14,57.10 ,33.33
03,021,01,002,0057,0,1312 ,11 ,1323 ,2161 ,0,3,1,3,0,1,0,76.14,61.22 ,33.33
03,021,01,002,0058,0,1577 ,9 ,1586 ,2512 ,0,3,1,3,0,1,0,76.14,63.14 ,33.33
03,021,01,002,0059,0,1352 ,5 ,1357 ,2352 ,0,3,1,3,0,1,0,76.14,57.70 ,33.33
03,021,01,002,0060,0,1884 ,11 ,1895 ,3110 ,0,3,1,3,0,1,0,76.14,60.93 ,33.33
03,021,01,002,0061,0,2296 ,12 ,2308 ,4066 ,0,3,1,3,0,1,0,76.14,56.76 ,33.33
03,021,01,002,0062,0,2660 ,20 ,2680 ,4732 ,0,3,1,3,0,1,0,76.14,56.64 ,33.33
03,021,01,002,0063,0,1759 ,8 ,1767 ,2959 ,0,3,1,3,0,1,0,76.14,59.72 ,33.33
03,021,01,002,0064,0,1193 ,4 ,1197 ,2055 ,0,3,1,3,0,1,0,76.14,58.25 ,33.33
03,021,01,002,0065,0,2302 ,12 ,2314 ,4108 ,0,3,1,3,0,1,0,76.14,56.33 ,33.33
03,021,01,002,0066,0,1139 ,6 ,1145 ,1878 ,0,3,1,3,0,1,0,76.14,60.97 ,33.33
03,021,01,002,0067,0,1926 ,15 ,1941 ,3510 ,0,3,1,3,0,1,0,76.14,55.30 ,33.33
03,021,01,002,0068,0,2272 ,12 ,2284 ,4114 ,0,3,1,3,0,1,0,76.14,55.52 ,33.33
03,021,01,002,0069,0,1809 ,18 ,1827 ,3177 ,0,3,1,3,0,1,0,76.14,57.51 ,33.33
03,021,01,002,0070,0,1757 ,6 ,1763 ,3092 ,0,3,1,3,0,1,0,76.14,57.02 ,33.33
03,021,01,002,0071,0,2362 ,15 ,2377 ,4042 ,0,3,1,3,0,1,0,76.14,58.81 ,33.33
03,021,01,002,0072,0,1113 ,4 ,1117 ,2383 ,0,3,1,3,0,1,0,76.14,46.87 ,33.33
03,021,01,002,0073,0,1317 ,8 ,1325 ,2442 ,0,3,1,3,0,1,0,76.14,54.26 ,33.33
03,021,01,002,0074,0,2088 ,13 ,2101 ,4057 ,0,3,1,3,0,1,0,76.14,51.79 ,33.33
03,021,01,002,0075,0,1010 ,7 ,1017 ,1825 ,0,3,1,3,0,1,0,76.14,55.73 ,33.33
03,021,01,002,0076,0,1193 ,7 ,1200 ,1859 ,0,3,1,3,0,1,0,76.14,64.55 ,33.33
03,021,01,002,0077,0,1335 ,4 ,1339 ,2178 ,0,3,1,3,0,1,0,76.14,61.48 ,33.33
03,021,01,002,0078,0,880 ,5 ,885 ,1452 ,0,3,1,3,0,1,0,76.14,60.95 ,33.33
03,021,01,002,0079,0,949 ,7 ,956 ,1516 ,0,3,1,3,0,1,0,76.14,63.06 ,33.33
03,021,01,002,0080,0,1513 ,6 ,1519 ,2638 ,0,3,1,3,0,1,0,76.14,57.58 ,33.33
03,021,01,002,0081,0,1249 ,4 ,1253 ,1954 ,0,3,1,3,0,1,0,76.14,64.12 ,33.33
03,021,01,002,0082,0,1063 ,5 ,1068 ,1784 ,0,3,1,3,0,1,0,76.14,59.87 ,33.33
03,021,01,002,0083,0,1061 ,7 ,1068 ,1836 ,0,3,1,3,0,1,0,76.14,58.17 ,33.33
03,021,01,002,0084,0,1195 ,9 ,1204 ,2033 ,0,3,1,3,0,1,0,76.14,59.22 ,33.33
03,021,01,002,0085,0,1122 ,10 ,1132 ,1827 ,0,3,1,3,0,1,0,76.14,61.96 ,33.33
03,021,01,003,0086,0,596 ,1 ,597 ,968 ,0,3,1,3,0,1,0,76.14,61.67 ,33.33
03,021,01,003,0087,0,747 ,5 ,752 ,1234 ,0,3,1,3,0,1,0,76.14,60.94 ,33.33
03,021,01,003,0088,0,737 ,1 ,738 ,1223 ,0,3,1,3,0,1,0,76.14,60.34 ,33.33
03,021,01,003,0089,0,891 ,5 ,896 ,1576 ,0,3,1,3,0,1,0,76.14,56.85 ,33.33
03,021,01,003,0090,0,824 ,2 ,826 ,1439 ,0,3,1,3,0,1,0,76.14,57.40 ,33.33
03,021,01,003,0091,0,1309 ,0 ,1309 ,2362 ,0,3,1,3,0,1,0,76.14,55.42 ,33.33
03,021,01,003,0092,0,1447 ,5 ,1452 ,2498 ,0,3,1,3,0,1,0,76.14,58.13 ,33.33
03,021,01,003,0093,0,815 ,4 ,819 ,1309 ,0,3,1,3,0,1,0,76.14,62.57 ,33.33
03,021,01,003,0094,0,790 ,5 ,795 ,1322 ,0,3,1,3,0,1,0,76.14,60.14 ,33.33
03,021,01,003,0095,0,778 ,1 ,779 ,1345 ,0,3,1,3,0,1,0,76.14,57.92 ,33.33
03,021,01,003,0096,0,832 ,2 ,834 ,1345 ,0,3,1,3,0,1,0,76.14,62.01 ,33.33
03,021,01,003,0097,0,837 ,6 ,843 ,1410 ,0,3,1,3,0,1,0,76.14,59.79 ,33.33
03,021,01,003,0098,0,808 ,14 ,822 ,1423 ,0,3,1,3,0,1,0,76.14,57.77 ,33.33
03,021,01,003,0099,0,978 ,6 ,984 ,1607 ,0,3,1,3,0,1,0,76.14,61.23 ,33.33
03,021,01,003,0100,0,902 ,8 ,910 ,1486 ,0,3,1,3,0,1,0,76.14,61.24 ,33.33
03,021,01,003,0101,0,866 ,6 ,872 ,1514 ,0,3,1,3,0,1,0,76.14,57.60 ,33.33
03,021,01,003,0102,0,803 ,7 ,810 ,1429 ,0,3,1,3,0,1,0,76.14,56.68 ,33.33
03,021,01,003,0103,0,1299 ,6 ,1305 ,2026 ,0,3,1,3,0,1,0,76.14,64.41 ,33.33
03,021,01,003,0104,0,1210 ,6 ,1216 ,2104 ,0,3,1,3,0,1,0,76.14,57.79 ,33.33
03,021,01,003,0105,0,2069 ,8 ,2077 ,3559 ,0,3,1,3,0,1,0,76.14,58.36 ,33.33
03,021,01,003,0106,0,1907 ,11 ,1918 ,3257 ,0,3,1,3,0,1,0,76.14,58.89 ,33.33
03,021,01,003,0107,0,1689 ,9 ,1698 ,2755 ,0,3,1,3,0,1,0,76.14,61.63 ,33.33
03,021,01,003,0108,0,776 ,3 ,779 ,1286 ,0,3,1,3,0,1,0,76.14,60.58 ,33.33
03,021,01,003,0109,0,1134 ,7 ,1141 ,2066 ,0,3,1,3,0,1,0,76.14,55.23 ,33.33
03,021,01,003,0110,0,1128 ,8 ,1136 ,1870 ,0,3,1,3,0,1,0,76.14,60.75 ,33.33
03,021,01,003,0111,0,729 ,3 ,732 ,1164 ,0,3,1,3,0,1,0,76.14,62.89 ,33.33
03,021,01,003,0112,0,802 ,3 ,805 ,1336 ,0,3,1,3,0,1,0,76.14,60.25 ,33.33
03,021,01,003,0113,0,970 ,10 ,980 ,1576 ,0,3,1,3,0,1,0,76.14,62.18 ,33.33
03,021,01,003,0114,0,1595 ,12 ,1607 ,2932 ,0,3,1,3,0,1,0,76.14,54.81 ,33.33
03,021,01,003,0115,0,611 ,2 ,613 ,1064 ,0,3,1,3,0,1,0,76.14,57.61 ,33.33
03,021,01,003,0116,0,785 ,9 ,794 ,1309 ,0,3,1,3,0,1,0,76.14,60.66 ,33.33
03,021,01,003,0117,0,661 ,0 ,661 ,1272 ,0,3,1,3,0,1,0,76.14,51.97 ,33.33
03,021,01,003,0118,0,1358 ,14 ,1372 ,2405 ,0,3,1,3,0,1,0,76.14,57.05 ,33.33
03,021,01,003,0119,0,572 ,6 ,578 ,965 ,0,3,1,3,0,1,0,76.14,59.90 ,33.33
03,021,01,003,0120,0,773 ,4 ,777 ,1309 ,0,3,1,3,0,1,0,76.14,59.36 ,33.33
03,021,01,003,0121,0,743 ,7 ,750 ,1222 ,0,3,1,3,0,1,0,76.14,61.37 ,33.33
03,021,01,003,0122,0,1037 ,10 ,1047 ,1777 ,0,3,1,3,0,1,0,76.14,58.92 ,33.33
03,021,01,003,0123,0,746 ,2 ,748 ,1287 ,0,3,1,3,0,1,0,76.14,58.12 ,33.33
03,021,01,004,0124,0,1351 ,12 ,1363 ,2293 ,0,3,1,3,0,1,0,76.14,59.44 ,33.33
03,021,01,004,0125,0,849 ,5 ,854 ,1775 ,0,3,1,3,0,1,0,76.14,48.11 ,33.33
03,021,01,004,0126,0,841 ,10 ,851 ,1419 ,0,3,1,3,0,1,0,76.14,59.97 ,33.33
03,021,01,004,0127,0,1183 ,7 ,1190 ,2053 ,0,3,1,3,0,1,0,76.14,57.96 ,33.33
03,021,01,004,0128,0,1349 ,4 ,1353 ,2233 ,0,3,1,3,0,1,0,76.14,60.59 ,33.33
03,021,01,004,0129,0,1676 ,10 ,1686 ,2775 ,0,3,1,3,0,1,0,76.14,60.76 ,33.33
03,021,01,004,0130,0,1152 ,1 ,1153 ,1978 ,0,3,1,3,0,1,0,76.14,58.29 ,33.33
03,021,01,004,0131,0,1004 ,5 ,1009 ,1791 ,0,3,1,3,0,1,0,76.14,56.34 ,33.33
03,021,01,004,0132,0,746 ,7 ,753 ,1120 ,0,3,1,3,0,1,0,76.14,67.23 ,33.33
03,021,01,004,0133,0,1108 ,8 ,1116 ,1848 ,0,3,1,3,0,1,0,76.14,60.39 ,33.33
03,021,01,004,0134,0,1001 ,7 ,1008 ,1744 ,0,3,1,3,0,1,0,76.14,57.80 ,33.33
03,021,01,004,0135,0,697 ,7 ,704 ,1202 ,0,3,1,3,0,1,0,76.14,58.57 ,33.33
03,021,01,004,0136,0,1226 ,16 ,1242 ,2021 ,0,3,1,3,0,1,0,76.14,61.45 ,33.33
03,021,01,004,0137,0,1688 ,9 ,1697 ,2868 ,0,3,1,3,0,1,0,76.14,59.17 ,33.33
03,021,01,004,0138,0,1197 ,11 ,1208 ,2018 ,0,3,1,3,0,1,0,76.14,59.86 ,33.33
03,021,01,004,0139,0,894 ,5 ,899 ,1430 ,0,3,1,3,0,1,0,76.14,62.87 ,33.33
03,021,01,004,0140,0,502 ,1 ,503 ,770 ,0,3,1,3,0,1,0,76.14,65.32 ,33.33
03,021,01,004,0141,0,558 ,7 ,565 ,830 ,0,3,1,3,0,1,0,76.14,68.07 ,33.33
03,021,01,004,0142,0,730 ,10 ,740 ,1206 ,0,3,1,3,0,1,0,76.14,61.36 ,33.33
03,021,01,004,0143,0,534 ,5 ,539 ,904 ,0,3,1,3,0,1,0,76.14,59.62 ,33.33
03,021,01,004,0144,0,888 ,6 ,894 ,1508 ,0,3,1,3,0,1,0,76.14,59.28 ,33.33
03,021,01,004,0145,0,1087 ,5 ,1092 ,1893 ,0,3,1,3,0,1,0,76.14,57.69 ,33.33
03,021,01,004,0146,0,856 ,5 ,861 ,1470 ,0,3,1,3,0,1,0,76.14,58.57 ,33.33
03,021,01,004,0147,0,956 ,2 ,958 ,1745 ,0,3,1,3,0,1,0,76.14,54.90 ,33.33
03,021,01,004,0148,0,699 ,7 ,706 ,1293 ,0,3,1,3,0,1,0,76.14,54.60 ,33.33
03,021,01,004,0149,0,979 ,2 ,981 ,1649 ,0,3,1,3,0,1,0,76.14,59.49 ,33.33
03,021,01,004,0150,0,1913 ,9 ,1922 ,3186 ,0,3,1,3,0,1,0,76.14,60.33 ,33.33
03,021,01,004,0151,0,1201 ,5 ,1206 ,2252 ,0,3,1,3,0,1,0,76.14,53.55 ,33.33
03,021,01,004,0152,0,892 ,4 ,896 ,1532 ,0,3,1,3,0,1,0,76.14,58.49 ,33.33
03,021,01,004,0153,0,832 ,4 ,836 ,1506 ,0,3,1,3,0,1,0,76.14,55.51 ,33.33
03,021,01,004,0154,0,771 ,4 ,775 ,1337 ,0,3,1,3,0,1,0,76.14,57.97 ,33.33
03,021,01,004,0155,0,690 ,2 ,692 ,1599 ,0,3,1,3,0,1,0,76.14,43.28 ,33.33
03,021,01,004,0156,0,1905 ,14 ,1919 ,3495 ,0,3,1,3,0,1,0,76.14,54.91 ,33.33
03,021,01,004,0157,0,2994 ,11 ,3005 ,5634 ,0,3,1,3,0,1,0,76.14,53.34 ,33.33
03,021,01,004,0158,0,2844 ,22 ,2866 ,5291 ,0,3,1,3,0,1,0,76.14,54.17 ,33.33
03,021,01,004,0159,0,835 ,4 ,839 ,1351 ,0,3,1,3,0,1,0,76.14,62.10 ,33.33
03,021,01,004,0160,0,2200 ,11 ,2211 ,4106 ,0,3,1,3,0,1,0,76.14,53.85 ,33.33
03,021,01,004,0161,0,1572 ,13 ,1585 ,2770 ,0,3,1,3,0,1,0,76.14,57.22 ,33.33
03,021,01,004,0162,0,862 ,7 ,869 ,1383 ,0,3,1,3,0,1,0,76.14,62.83 ,33.33
03,021,01,004,0163,0,1776 ,15 ,1791 ,3056 ,0,3,1,3,0,1,0,76.14,58.61 ,33.33
03,021,01,004,0164,0,2582 ,22 ,2604 ,4544 ,0,3,1,3,0,1,0,76.14,57.31 ,33.33
03,021,01,004,0165,0,2247 ,11 ,2258 ,4016 ,0,3,1,3,0,1,0,76.14,56.23 ,33.33
03,021,01,004,0166,0,1442 ,8 ,1450 ,2460 ,0,3,1,3,0,1,0,76.14,58.94 ,33.33
03,021,01,005,0167,0,360 ,3 ,363 ,584 ,0,3,1,3,0,1,0,76.14,62.16 ,33.33
03,021,01,005,0168,0,2052 ,14 ,2066 ,3650 ,0,3,1,3,0,1,0,76.14,56.60 ,33.33
03,021,01,005,0169,0,2432 ,11 ,2443 ,4267 ,0,3,1,3,0,1,0,76.14,57.25 ,33.33
03,021,01,005,0170,0,1713 ,15 ,1728 ,2763 ,0,3,1,3,0,1,0,76.14,62.54 ,33.33
03,021,01,005,0171,0,1993 ,10 ,2003 ,3345 ,0,3,1,3,0,1,0,76.14,59.88 ,33.33
03,021,01,005,0172,0,2134 ,12 ,2146 ,3639 ,0,3,1,3,0,1,0,76.14,58.97 ,33.33
03,021,01,005,0173,0,1651 ,13 ,1664 ,2793 ,0,3,1,3,0,1,0,76.14,59.58 ,33.33
03,021,01,005,0174,0,2520 ,18 ,2538 ,4184 ,0,3,1,3,0,1,0,76.14,60.66 ,33.33
03,021,01,005,0175,0,1554 ,9 ,1563 ,2532 ,0,3,1,3,0,1,0,76.14,61.73 ,33.33
03,021,01,005,0176,0,1155 ,5 ,1160 ,1947 ,0,3,1,3,0,1,0,76.14,59.58 ,33.33
03,021,01,005,0177,0,1380 ,8 ,1388 ,2171 ,0,3,1,3,0,1,0,76.14,63.93 ,33.33
03,021,01,005,0178,0,2266 ,18 ,2284 ,3844 ,0,3,1,3,0,1,0,76.14,59.42 ,33.33
03,021,01,005,0179,0,1562 ,8 ,1570 ,2531 ,0,3,1,3,0,1,0,76.14,62.03 ,33.33
03,021,01,005,0180,0,1944 ,14 ,1958 ,3722 ,0,3,1,3,0,1,0,76.14,52.61 ,33.33
03,021,01,005,0181,0,1720 ,9 ,1729 ,3161 ,0,3,1,3,0,1,0,76.14,54.70 ,33.33
03,021,01,005,0182,0,2026 ,11 ,2037 ,3548 ,0,3,1,3,0,1,0,76.14,57.41 ,33.33
03,021,01,005,0183,0,1717 ,16 ,1733 ,3033 ,0,3,1,3,0,1,0,76.14,57.14 ,33.33
03,021,01,005,0184,0,1008 ,7 ,1015 ,1503 ,0,3,1,3,0,1,0,76.14,67.53 ,33.33
03,021,01,005,0185,0,1888 ,8 ,1896 ,3311 ,0,3,1,3,0,1,0,76.14,57.26 ,33.33
03,021,01,005,0186,0,690 ,4 ,694 ,1042 ,0,3,1,3,0,1,0,76.14,66.60 ,33.33
03,021,01,005,0187,0,749 ,2 ,751 ,1301 ,0,3,1,3,0,1,0,76.14,57.72 ,33.33
03,021,01,005,0188,0,1105 ,7 ,1112 ,1701 ,0,3,1,3,0,1,0,76.14,65.37 ,33.33
03,021,01,005,0189,0,800 ,3 ,803 ,1333 ,0,3,1,3,0,1,0,76.14,60.24 ,33.33
03,021,01,005,0190,0,1051 ,7 ,1058 ,1810 ,0,3,1,3,0,1,0,76.14,58.45 ,33.33
03,021,01,005,0191,0,638 ,0 ,638 ,825 ,0,3,1,3,0,1,0,76.14,77.33 ,33.33
03,021,01,005,0192,0,1317 ,5 ,1322 ,2233 ,0,3,1,3,0,1,0,76.14,59.20 ,33.33
03,021,01,005,0193,0,930 ,4 ,934 ,1480 ,0,3,1,3,0,1,0,76.14,63.11 ,33.33
03,021,01,005,0194,0,1421 ,9 ,1430 ,2443 ,0,3,1,3,0,1,0,76.14,58.53 ,33.33
03,021,01,005,0195,0,1365 ,8 ,1373 ,2321 ,0,3,1,3,0,1,0,76.14,59.16 ,33.33
03,021,01,005,0196,0,1995 ,14 ,2009 ,3613 ,0,3,1,3,0,1,0,76.14,55.60 ,33.33
03,021,01,005,0197,0,2110 ,15 ,2125 ,4099 ,0,3,1,3,0,1,0,76.14,51.84 ,33.33
03,021,01,005,0198,0,1739 ,14 ,1753 ,3025 ,0,3,1,3,0,1,0,76.14,57.95 ,33.33
03,021,01,005,0199,0,1520 ,13 ,1533 ,2702 ,0,3,1,3,0,1,0,76.14,56.74 ,33.33
03,021,01,005,0200,0,1723 ,4 ,1727 ,2844 ,0,3,1,3,0,1,0,76.14,60.72 ,33.33
03,021,01,005,0201,0,2350 ,16 ,2366 ,3930 ,0,3,1,3,0,1,0,76.14,60.20 ,33.33
03,021,01,005,0202,0,1029 ,3 ,1032 ,1677 ,0,3,1,3,0,1,0,76.14,61.54 ,33.33
03,021,01,005,0203,0,1653 ,12 ,1665 ,2775 ,0,3,1,3,0,1,0,76.14,60.00 ,33.33
03,021,01,005,0204,0,2380 ,19 ,2399 ,4171 ,0,3,1,3,0,1,0,76.14,57.52 ,33.33
03,021,01,005,0205,0,2118 ,17 ,2135 ,3451 ,0,3,1,3,0,1,0,76.14,61.87 ,33.33
03,021,01,005,0206,0,1280 ,8 ,1288 ,1975 ,0,3,1,3,0,1,0,76.14,65.22 ,33.33
03,021,01,005,0207,0,862 ,2 ,864 ,1378 ,0,3,1,3,0,1,0,76.14,62.70 ,33.33
03,021,01,005,0208,0,1623 ,9 ,1632 ,2404 ,0,3,1,3,0,1,0,76.14,67.89 ,33.33
03,021,01,005,0209,0,822 ,3 ,825 ,1283 ,0,3,1,3,0,1,0,76.14,64.30 ,33.33
03,021,01,005,0210,0,706 ,8 ,714 ,1023 ,0,3,1,3,0,1,0,76.14,69.79 ,33.33
03,021,01,005,0211,0,850 ,4 ,854 ,1217 ,0,3,1,3,0,1,0,76.14,70.17 ,33.33
03,021,01,005,0212,0,700 ,1 ,701 ,886 ,0,3,1,3,0,1,0,76.14,79.12 ,33.33
03,021,01,005,0213,0,720 ,4 ,724 ,1059 ,0,3,1,3,0,1,0,76.14,68.37 ,33.33
03,021,01,005,0214,0,715 ,1 ,716 ,1089 ,0,3,1,3,0,1,0,76.14,65.75 ,33.33
03,021,01,005,0215,0,399 ,0 ,399 ,642 ,0,3,1,3,0,1,0,76.14,62.15 ,33.33
03,021,01,005,0216,0,984 ,2 ,986 ,1433 ,0,3,1,3,0,1,0,76.14,68.81 ,33.33
03,021,01,005,0217,0,402 ,0 ,402 ,551 ,0,3,1,3,0,1,0,76.14,72.96 ,33.33
03,021,01,006,0218,0,1721 ,11 ,1732 ,2955 ,0,3,1,3,0,1,0,76.14,58.61 ,33.33
03,021,01,006,0219,0,1182 ,8 ,1190 ,2276 ,0,3,1,3,0,1,0,76.14,52.28 ,33.33
03,021,01,006,0220,0,879 ,6 ,885 ,1435 ,0,3,1,3,0,1,0,76.14,61.67 ,33.33
03,021,01,006,0221,0,900 ,3 ,903 ,1493 ,0,3,1,3,0,1,0,76.14,60.48 ,33.33
03,021,01,006,0222,0,1206 ,7 ,1213 ,1943 ,0,3,1,3,0,1,0,76.14,62.43 ,33.33
03,021,01,006,0223,0,877 ,7 ,884 ,1502 ,0,3,1,3,0,1,0,76.14,58.85 ,33.33
03,021,01,006,0224,0,360 ,1 ,361 ,518 ,0,3,1,3,0,1,0,76.14,69.69 ,33.33
03,021,01,006,0225,0,795 ,1 ,796 ,1477 ,0,3,1,3,0,1,0,76.14,53.89 ,33.33
03,021,01,006,0226,0,1856 ,8 ,1864 ,3946 ,0,3,1,3,0,1,0,76.14,47.24 ,33.33
03,021,01,006,0227,0,2346 ,12 ,2358 ,4952 ,0,3,1,3,0,1,0,76.14,47.62 ,33.33
03,021,01,006,0228,0,1894 ,14 ,1908 ,3683 ,0,3,1,3,0,1,0,76.14,51.81 ,33.33
03,021,01,006,0229,0,1317 ,5 ,1322 ,2671 ,0,3,1,3,0,1,0,76.14,49.49 ,33.33
03,021,01,006,0230,0,1769 ,9 ,1778 ,3553 ,0,3,1,3,0,1,0,76.14,50.04 ,33.33
03,021,01,006,0231,0,1661 ,9 ,1670 ,3138 ,0,3,1,3,0,1,0,76.14,53.22 ,33.33
03,021,01,006,0232,0,1764 ,4 ,1768 ,3218 ,0,3,1,3,0,1,0,76.14,54.94 ,33.33
04,001,01,001,0001,0,1038 ,14 ,1052 ,2208 ,0,3,1,3,0,1,0,76.14,47.64 ,33.33
04,001,01,001,0002,0,1148 ,13 ,1161 ,2530 ,0,3,1,3,0,1,0,76.14,45.89 ,33.33
04,001,01,001,0003,0,1976 ,23 ,1999 ,4195 ,0,3,1,3,0,1,0,76.14,47.65 ,33.33
04,001,01,001,0004,0,814 ,11 ,825 ,1778 ,0,3,1,3,0,1,0,76.14,46.40 ,33.33
04,001,01,001,0005,0,658 ,10 ,668 ,1480 ,0,3,1,3,0,1,0,76.14,45.14 ,33.33
04,001,01,001,0006,0,418 ,4 ,422 ,795 ,0,3,1,3,0,1,0,76.14,53.08 ,33.33
04,001,01,001,0007,0,729 ,9 ,738 ,1467 ,0,3,1,3,0,1,0,76.14,50.31 ,33.33
04,001,01,001,0008,0,440 ,4 ,444 ,943 ,0,3,1,3,0,1,0,76.14,47.08 ,33.33
04,001,01,002,0009,0,655 ,13 ,668 ,1328 ,0,3,1,3,0,1,0,76.14,50.30 ,33.33
04,001,01,002,0010,0,871 ,17 ,888 ,1670 ,0,3,1,3,0,1,0,76.14,53.1736526946,33.33
04,001,01,002,0011,0,791 ,13 ,804 ,1683 ,0,3,1,3,0,1,0,76.14,47.7718360071,33.33
04,001,01,002,0012,0,778 ,10 ,788 ,1718 ,0,3,1,3,0,1,0,76.14,45.8672875437,33.33
04,001,01,002,0013,0,654 ,8 ,662 ,1398 ,0,3,1,3,0,1,0,76.14,47.3533619456,33.33
04,001,01,002,0014,0,295 ,4 ,299 ,564 ,0,3,1,3,0,1,0,76.14,53.0141843972,33.33
04,001,01,003,0015,0,1086 ,13 ,1099 ,2123 ,0,3,1,3,0,1,0,76.14,51.7663683467,33.33
04,001,01,003,0016,0,794 ,11 ,805 ,1572 ,0,3,1,3,0,1,0,76.14,51.2086513995,33.33
04,001,01,003,0017,0,328 ,5 ,333 ,664 ,0,3,1,3,0,1,0,76.14,50.1506024096,33.33
04,001,01,003,0018,0,345 ,4 ,349 ,652 ,0,3,1,3,0,1,0,76.14,53.527607362,33.33
04,001,01,003,0019,0,368 ,1 ,369 ,718 ,0,3,1,3,0,1,0,76.14,51.3927576602,33.33
04,001,01,003,0020,0,1039 ,17 ,1056 ,2098 ,0,3,1,3,0,1,0,76.14,50.3336510963,33.33
04,001,01,003,0021,0,509 ,13 ,522 ,950 ,0,3,1,3,0,1,0,76.14,54.9473684211,33.33
04,001,01,003,0022,0,651 ,8 ,659 ,1369 ,0,3,1,3,0,1,0,76.14,48.1373265157,33.33
04,001,01,004,0023,0,1042 ,8 ,1050 ,2242 ,0,3,1,3,0,1,0,76.14,46.8331846566,33.33
04,001,01,004,0024,0,430 ,6 ,436 ,870 ,0,3,1,3,0,1,0,76.14,50.1149425287,33.33
04,001,01,004,0025,0,448 ,8 ,456 ,965 ,0,3,1,3,0,1,0,76.14,47.2538860104,33.33
04,001,01,004,0026,0,317 ,1 ,318 ,646 ,0,3,1,3,0,1,0,76.14,49.226006192,33.33
04,001,01,004,0027,0,389 ,2 ,391 ,840 ,0,3,1,3,0,1,0,76.14,46.5476190476,33.33
04,001,01,004,0028,0,399 ,2 ,401 ,834 ,0,3,1,3,0,1,0,76.14,48.0815347722,33.33
04,001,01,004,0029,0,296 ,3 ,299 ,499 ,0,3,1,3,0,1,0,76.14,59.9198396794,33.33
04,001,01,004,0030,0,440 ,4 ,444 ,916 ,0,3,1,3,0,1,0,76.14,48.4716157205,33.33
04,001,01,005,0031,0,709 ,5 ,714 ,1350 ,0,3,1,3,0,1,0,76.14,52.8888888889,33.33
04,001,01,005,0032,0,277 ,1 ,278 ,580 ,0,3,1,3,0,1,0,76.14,47.9310344828,33.33
04,001,01,005,0033,0,396 ,2 ,398 ,838 ,0,3,1,3,0,1,0,76.14,47.4940334129,33.33
04,001,01,005,0034,0,280 ,1 ,281 ,579 ,0,3,1,3,0,1,0,76.14,48.5319516408,33.33
04,001,01,005,0035,0,592 ,2 ,594 ,1125 ,0,3,1,3,0,1,0,76.14,52.8,33.33
04,001,01,006,0036,0,27 ,0 ,27 ,103 ,0,3,1,3,0,1,0,76.14,26.213592233,33.33
04,001,01,006,0037,0,19 ,0 ,19 ,159 ,0,3,1,3,0,1,0,76.14,11.9496855346,33.33
04,002,01,001,0001,0,970 ,9 ,979 ,1347 ,0,3,1,3,0,1,0,76.14,72.68 ,33.33
04,002,01,001,0002,0,811 ,5 ,816 ,1210 ,0,3,1,3,0,1,0,76.14,67.44 ,33.33
04,002,01,001,0003,0,909 ,13 ,922 ,1521 ,0,3,1,3,0,1,0,76.14,60.62 ,33.33
04,002,01,002,0004,0,603 ,10 ,613 ,933 ,0,3,1,3,0,1,0,76.14,65.70 ,33.33
04,002,01,002,0005,0,271 ,6 ,277 ,438 ,0,3,1,3,0,1,0,76.14,63.24 ,33.33
04,002,01,003,0006,0,279 ,0 ,279 ,489 ,0,3,1,3,0,1,0,76.14,57.06 ,33.33
04,002,01,003,0007,0,211 ,0 ,211 ,376 ,0,3,1,3,0,1,0,76.14,56.12 ,33.33
04,002,01,004,0008,0,397 ,4 ,401 ,643 ,0,3,1,3,0,1,0,76.14,62.36 ,33.33
01,000,01,001,0001,1,1175 ,5 ,1180 ,1843 ,0,3,1,3,0,1,0,76.14,64.03 ,33.33
01,000,01,001,0001,2,1187 ,7 ,1194 ,1954 ,0,3,1,3,0,1,0,76.14,61.11 ,33.33
01,000,01,001,0002,3,1118 ,2 ,1120 ,1774 ,0,3,1,3,0,1,0,76.14,63.13 ,33.33
01,000,01,001,0002,4,1067 ,10 ,1077 ,1803 ,0,3,1,3,0,1,0,76.14,59.73 ,33.33
01,000,01,001,0003,5,837 ,8 ,845 ,1397 ,0,3,1,3,0,1,0,76.14,60.49 ,33.33
01,000,01,001,0003,6,867 ,9 ,876 ,1405 ,0,3,1,3,0,1,0,76.14,62.35 ,33.33
01,000,01,001,0003,7,840 ,5 ,845 ,1430 ,0,3,1,3,0,1,0,76.14,59.09 ,33.33
01,000,01,001,0004,8,1186 ,7 ,1193 ,1789 ,0,3,1,3,0,1,0,76.14,66.69 ,33.33
01,000,01,001,0004,9,1185 ,10 ,1195 ,1913 ,0,3,1,3,0,1,0,76.14,62.47 ,33.33
01,000,01,001,0004,10,1015 ,7 ,1022 ,1607 ,0,3,1,3,0,1,0,76.14,63.60 ,33.33
01,000,01,001,0005,11,1024 ,4 ,1028 ,1843 ,0,3,1,3,0,1,0,76.14,55.78 ,33.33
01,000,01,001,0005,12,1203 ,3 ,1206 ,1951 ,0,3,1,3,0,1,0,76.14,61.81 ,33.33
01,000,01,001,0005,13,1148 ,3 ,1151 ,1833 ,0,3,1,3,0,1,0,76.14,62.79 ,33.33
01,000,01,001,0006,14,874 ,3 ,877 ,1463 ,0,3,1,3,0,1,0,76.14,59.95 ,33.33
01,000,01,001,0006,15,958 ,2 ,960 ,1578 ,0,3,1,3,0,1,0,76.14,60.84 ,33.33
01,000,01,001,0006,16,1004 ,5 ,1009 ,1578 ,0,3,1,3,0,1,0,76.14,63.94 ,33.33
01,000,01,001,0006,17,940 ,1 ,941 ,1429 ,0,3,1,3,0,1,0,76.14,65.85 ,33.33
01,000,01,001,0007,18,1101 ,6 ,1107 ,1747 ,0,3,1,3,0,1,0,76.14,63.37 ,33.33
01,000,01,001,0007,19,1155 ,8 ,1163 ,1862 ,0,3,1,3,0,1,0,76.14,62.46 ,33.33
01,000,01,001,0007,20,1160 ,4 ,1164 ,1806 ,0,3,1,3,0,1,0,76.14,64.45 ,33.33
01,000,01,001,0008,21,1107 ,6 ,1113 ,1711 ,0,3,1,3,0,1,0,76.14,65.05 ,33.33
01,000,01,001,0008,22,1168 ,12 ,1180 ,1817 ,0,3,1,3,0,1,0,76.14,64.94 ,33.33
01,000,01,001,0008,23,929 ,3 ,932 ,1407 ,0,3,1,3,0,1,0,76.14,66.24 ,33.33
01,000,01,001,0008,24,913 ,4 ,917 ,1458 ,0,3,1,3,0,1,0,76.14,62.89 ,33.33
01,000,01,001,0009,25,985 ,6 ,991 ,1652 ,0,3,1,3,0,1,0,76.14,59.99 ,33.33
01,000,01,001,0009,26,1051 ,3 ,1054 ,1773 ,0,3,1,3,0,1,0,76.14,59.45 ,33.33
01,000,01,001,0009,27,1095 ,7 ,1102 ,1791 ,0,3,1,3,0,1,0,76.14,61.53 ,33.33
01,000,01,001,0009,28,834 ,2 ,836 ,1388 ,0,3,1,3,0,1,0,76.14,60.23 ,33.33
01,000,01,001,0010,29,1047 ,2 ,1049 ,1740 ,0,3,1,3,0,1,0,76.14,60.29 ,33.33
01,000,01,001,0010,30,1135 ,5 ,1140 ,1726 ,0,3,1,3,0,1,0,76.14,66.05 ,33.33
01,000,01,001,0010,31,1033 ,2 ,1035 ,1767 ,0,3,1,3,0,1,0,76.14,58.57 ,33.33
01,000,01,001,0011,32,1181 ,5 ,1186 ,1822 ,0,3,1,3,0,1,0,76.14,65.09 ,33.33
01,000,01,001,0011,33,1097 ,5 ,1102 ,1726 ,0,3,1,3,0,1,0,76.14,63.85 ,33.33
01,000,01,001,0012,34,1241 ,10 ,1251 ,1824 ,0,3,1,3,0,1,0,76.14,68.59 ,33.33
01,000,01,001,0012,35,1177 ,8 ,1185 ,1808 ,0,3,1,3,0,1,0,76.14,65.54 ,33.33
01,000,01,001,0013,36,1041 ,12 ,1053 ,1662 ,0,3,1,3,0,1,0,76.14,63.36 ,33.33
01,000,01,001,0013,37,1067 ,4 ,1071 ,1772 ,0,3,1,3,0,1,0,76.14,60.44 ,33.33
01,000,01,001,0013,38,1062 ,9 ,1071 ,1718 ,0,3,1,3,0,1,0,76.14,62.34 ,33.33
01,000,01,001,0014,39,1228 ,7 ,1235 ,2047 ,0,3,1,3,0,1,0,76.14,60.33 ,33.33
01,000,01,001,0014,40,1284 ,8 ,1292 ,2012 ,0,3,1,3,0,1,0,76.14,64.21 ,33.33
01,000,01,001,0015,41,1176 ,4 ,1180 ,1921 ,0,3,1,3,0,1,0,76.14,61.43 ,33.33
01,000,01,001,0015,42,1147 ,7 ,1154 ,1906 ,0,3,1,3,0,1,0,76.14,60.55 ,33.33
01,000,01,001,0016,43,873 ,10 ,883 ,1439 ,0,3,1,3,0,1,0,76.14,61.36 ,33.33
01,000,01,001,0016,44,742 ,5 ,747 ,1238 ,0,3,1,3,0,1,0,76.14,60.34 ,33.33
01,000,01,001,0016,45,838 ,7 ,845 ,1444 ,0,3,1,3,0,1,0,76.14,58.52 ,33.33
01,000,01,001,0017,46,1157 ,5 ,1162 ,1797 ,0,3,1,3,0,1,0,76.14,64.66 ,33.33
01,000,01,001,0017,47,917 ,4 ,921 ,1480 ,0,3,1,3,0,1,0,76.14,62.23 ,33.33
01,000,01,001,0017,48,1033 ,6 ,1039 ,1615 ,0,3,1,3,0,1,0,76.14,64.33 ,33.33
01,000,01,001,0017,49,1173 ,7 ,1180 ,1896 ,0,3,1,3,0,1,0,76.14,62.24 ,33.33
01,000,01,001,0018,50,1121 ,5 ,1126 ,1856 ,0,3,1,3,0,1,0,76.14,60.67 ,33.33
01,000,01,001,0018,51,1180 ,4 ,1184 ,2030 ,0,3,1,3,0,1,0,76.14,58.33 ,33.33
01,000,01,001,0019,52,899 ,2 ,901 ,1487 ,0,3,1,3,0,1,0,76.14,60.59 ,33.33
01,000,01,001,0020,53,1166 ,6 ,1172 ,1939 ,0,3,1,3,0,1,0,76.14,60.44 ,33.33
01,000,01,001,0020,54,1162 ,7 ,1169 ,1868 ,0,3,1,3,0,1,0,76.14,62.58 ,33.33
01,000,01,001,0020,55,1200 ,6 ,1206 ,1898 ,0,3,1,3,0,1,0,76.14,63.54 ,33.33
01,000,01,001,0020,56,1113 ,9 ,1122 ,1945 ,0,3,1,3,0,1,0,76.14,57.69 ,33.33
01,000,01,001,0021,57,965 ,5 ,970 ,2172 ,0,3,1,3,0,1,0,76.14,44.66 ,33.33
01,000,01,001,0021,58,1008 ,12 ,1020 ,1654 ,0,3,1,3,0,1,0,76.14,61.67 ,33.33
01,000,01,001,0021,59,1210 ,6 ,1216 ,1992 ,0,3,1,3,0,1,0,76.14,61.04 ,33.33
01,000,01,001,0021,60,1116 ,4 ,1120 ,1816 ,0,3,1,3,0,1,0,76.14,61.67 ,33.33
01,000,01,001,0022,61,958 ,6 ,964 ,1511 ,0,3,1,3,0,1,0,76.14,63.80 ,33.33
01,000,01,001,0022,62,834 ,1 ,835 ,1475 ,0,3,1,3,0,1,0,76.14,56.61 ,33.33
01,000,01,001,0022,63,828 ,4 ,832 ,1583 ,0,3,1,3,0,1,0,76.14,52.56 ,33.33
01,000,01,001,0022,64,870 ,5 ,875 ,1433 ,0,3,1,3,0,1,0,76.14,61.06 ,33.33
01,000,01,001,0023,65,971 ,6 ,977 ,1564 ,0,3,1,3,0,1,0,76.14,62.47 ,33.33
01,000,01,001,0023,66,859 ,3 ,862 ,1466 ,0,3,1,3,0,1,0,76.14,58.80 ,33.33
01,000,01,001,0023,67,865 ,1 ,866 ,1515 ,0,3,1,3,0,1,0,76.14,57.16 ,33.33
01,000,01,001,0024,68,911 ,9 ,920 ,1479 ,0,3,1,3,0,1,0,76.14,62.20 ,33.33
01,000,01,001,0024,69,919 ,0 ,919 ,1532 ,0,3,1,3,0,1,0,76.14,59.99 ,33.33
01,000,01,001,0024,70,1045 ,0 ,1045 ,1758 ,0,3,1,3,0,1,0,76.14,59.44 ,33.33
01,000,01,001,0025,71,1055 ,5 ,1060 ,1673 ,0,3,1,3,0,1,0,76.14,63.36 ,33.33
01,000,01,001,0025,72,969 ,0 ,969 ,1669 ,0,3,1,3,0,1,0,76.14,58.06 ,33.33
01,000,01,001,0025,73,1028 ,8 ,1036 ,1749 ,0,3,1,3,0,1,0,76.14,59.23 ,33.33
01,000,01,001,0026,74,779 ,5 ,784 ,1290 ,0,3,1,3,0,1,0,76.14,60.78 ,33.33
01,000,01,001,0026,75,784 ,7 ,791 ,1439 ,0,3,1,3,0,1,0,76.14,54.97 ,33.33
01,000,01,001,0027,76,914 ,2 ,916 ,1599 ,0,3,1,3,0,1,0,76.14,57.29 ,33.33
01,000,01,001,0027,77,817 ,4 ,821 ,1523 ,0,3,1,3,0,1,0,76.14,53.91 ,33.33
01,000,01,001,0027,78,874 ,6 ,880 ,1733 ,0,3,1,3,0,1,0,76.14,50.78 ,33.33
01,000,01,001,0028,79,1031 ,11 ,1042 ,1666 ,0,3,1,3,0,1,0,76.14,62.55 ,33.33
01,000,01,001,0028,80,1056 ,9 ,1065 ,1719 ,0,3,1,3,0,1,0,76.14,61.95 ,33.33
01,000,01,001,0029,81,1006 ,4 ,1010 ,1692 ,0,3,1,3,0,1,0,76.14,59.69 ,33.33
01,000,01,001,0029,82,1030 ,8 ,1038 ,1680 ,0,3,1,3,0,1,0,76.14,61.79 ,33.33
01,000,01,001,0029,83,1073 ,6 ,1079 ,1779 ,0,3,1,3,0,1,0,76.14,60.65 ,33.33
01,000,01,001,0030,84,1031 ,3 ,1034 ,1642 ,0,3,1,3,0,1,0,76.14,62.97 ,33.33
01,000,01,001,0030,85,704 ,3 ,707 ,1206 ,0,3,1,3,0,1,0,76.14,58.62 ,33.33
01,000,01,001,0030,86,768 ,3 ,771 ,1210 ,0,3,1,3,0,1,0,76.14,63.72 ,33.33
01,000,01,001,0031,87,926 ,9 ,935 ,1468 ,0,3,1,3,0,1,0,76.14,63.69 ,33.33
01,000,01,001,0031,88,1096 ,5 ,1101 ,1683 ,0,3,1,3,0,1,0,76.14,65.42 ,33.33
01,000,01,001,0031,89,999 ,4 ,1003 ,1617 ,0,3,1,3,0,1,0,76.14,62.03 ,33.33
01,000,01,001,0032,90,875 ,6 ,881 ,1382 ,0,3,1,3,0,1,0,76.14,63.75 ,33.33
01,000,01,001,0032,91,883 ,4 ,887 ,1467 ,0,3,1,3,0,1,0,76.14,60.46 ,33.33
01,000,01,001,0033,92,1181 ,2 ,1183 ,1696 ,0,3,1,3,0,1,0,76.14,69.75 ,33.33
01,000,01,001,0033,93,1059 ,6 ,1065 ,1637 ,0,3,1,3,0,1,0,76.14,65.06 ,33.33
01,000,01,001,0034,94,1056 ,5 ,1061 ,1710 ,0,3,1,3,0,1,0,76.14,62.05 ,33.33
01,000,01,001,0034,95,951 ,7 ,958 ,1599 ,0,3,1,3,0,1,0,76.14,59.91 ,33.33
01,000,01,001,0035,96,1149 ,8 ,1157 ,1968 ,0,3,1,3,0,1,0,76.14,58.79 ,33.33
01,000,01,001,0035,97,1101 ,5 ,1106 ,1963 ,0,3,1,3,0,1,0,76.14,56.34 ,33.33
01,000,01,001,0036,98,705 ,5 ,710 ,1185 ,0,3,1,3,0,1,0,76.14,59.92 ,33.33
01,000,01,001,0036,99,886 ,5 ,891 ,1440 ,0,3,1,3,0,1,0,76.14,61.88 ,33.33
01,000,01,001,0036,100,892 ,2 ,894 ,1567 ,0,3,1,3,0,1,0,76.14,57.05 ,33.33
01,000,01,001,0037,101,969 ,6 ,975 ,1755 ,0,3,1,3,0,1,0,76.14,55.56 ,33.33
01,000,01,001,0037,102,822 ,4 ,826 ,1506 ,0,3,1,3,0,1,0,76.14,54.85 ,33.33
01,000,01,001,0037,103,1038 ,13 ,1051 ,1793 ,0,3,1,3,0,1,0,76.14,58.62 ,33.33
01,000,01,001,0038,104,1087 ,7 ,1094 ,1837 ,0,3,1,3,0,1,0,76.14,59.55 ,33.33
01,000,01,001,0038,105,889 ,10 ,899 ,1596 ,0,3,1,3,0,1,0,76.14,56.33 ,33.33
01,000,01,001,0038,106,1115 ,1 ,1116 ,1914 ,0,3,1,3,0,1,0,76.14,58.31 ,33.33
01,000,01,001,0038,107,961 ,8 ,969 ,1642 ,0,3,1,3,0,1,0,76.14,59.01 ,33.33
01,000,01,001,0038,108,824 ,12 ,836 ,1259 ,0,3,1,3,0,1,0,76.14,66.40 ,33.33
01,000,01,001,0039,109,252 ,2 ,254 ,408 ,0,3,1,3,0,1,0,76.14,62.25 ,33.33
01,000,01,001,0039,110,869 ,6 ,875 ,1546 ,0,3,1,3,0,1,0,76.14,56.60 ,33.33
01,000,01,001,0040,111,434 ,4 ,438 ,720 ,0,3,1,3,0,1,0,76.14,60.83 ,33.33
01,000,01,001,0040,112,594 ,3 ,597 ,958 ,0,3,1,3,0,1,0,76.14,62.32 ,33.33
01,000,01,001,0041,113,564 ,5 ,569 ,985 ,0,3,1,3,0,1,0,76.14,57.77 ,33.33
01,000,01,001,0042,114,451 ,4 ,455 ,739 ,0,3,1,3,0,1,0,76.14,61.57 ,33.33
01,000,01,002,0043,115,1115 ,8 ,1123 ,1843 ,0,3,1,3,0,1,0,76.14,60.93 ,33.33
01,000,01,002,0043,116,1032 ,1 ,1033 ,1632 ,0,3,1,3,0,1,0,76.14,63.30 ,33.33
01,000,01,002,0044,117,778 ,7 ,785 ,1365 ,0,3,1,3,0,1,0,76.14,57.51 ,33.33
01,000,01,002,0044,118,792 ,2 ,794 ,1307 ,0,3,1,3,0,1,0,76.14,60.75 ,33.33
01,000,01,002,0045,119,755 ,5 ,760 ,1185 ,0,3,1,3,0,1,0,76.14,64.14 ,33.33
01,000,01,002,0045,120,427 ,3 ,430 ,738 ,0,3,1,3,0,1,0,76.14,58.27 ,33.33
01,000,01,002,0045,121,913 ,4 ,917 ,1374 ,0,3,1,3,0,1,0,76.14,66.74 ,33.33
01,000,01,002,0046,122,881 ,9 ,890 ,1460 ,0,3,1,3,0,1,0,76.14,60.96 ,33.33
01,000,01,002,0046,123,823 ,3 ,826 ,1382 ,0,3,1,3,0,1,0,76.14,59.77 ,33.33
01,000,01,002,0046,124,504 ,2 ,506 ,1581 ,0,3,1,3,0,1,0,76.14,32.01 ,33.33
01,000,01,002,0047,125,1185 ,5 ,1190 ,1901 ,0,3,1,3,0,1,0,76.14,62.60 ,33.33
01,000,01,002,0047,126,1202 ,9 ,1211 ,1859 ,0,3,1,3,0,1,0,76.14,65.14 ,33.33
01,000,01,002,0047,127,1306 ,9 ,1315 ,2029 ,0,3,1,3,0,1,0,76.14,64.81 ,33.33
01,000,01,002,0048,128,1084 ,35 ,1119 ,1741 ,0,3,1,3,0,1,0,76.14,64.27 ,33.33
01,000,01,002,0048,129,1044 ,5 ,1049 ,1604 ,0,3,1,3,0,1,0,76.14,65.40 ,33.33
01,000,01,002,0048,130,1107 ,4 ,1111 ,1873 ,0,3,1,3,0,1,0,76.14,59.32 ,33.33
01,000,01,002,0049,131,855 ,6 ,861 ,1417 ,0,3,1,3,0,1,0,76.14,60.76 ,33.33
01,000,01,002,0049,132,997 ,1 ,998 ,1559 ,0,3,1,3,0,1,0,76.14,64.02 ,33.33
01,000,01,002,0049,133,995 ,7 ,1002 ,1641 ,0,3,1,3,0,1,0,76.14,61.06 ,33.33
01,000,01,002,0049,134,915 ,1 ,916 ,1454 ,0,3,1,3,0,1,0,76.14,63.00 ,33.33
01,000,01,002,0050,135,1041 ,9 ,1050 ,1679 ,0,3,1,3,0,1,0,76.14,62.54 ,33.33
01,000,01,002,0050,136,887 ,3 ,890 ,1612 ,0,3,1,3,0,1,0,76.14,55.21 ,33.33
01,000,01,002,0050,137,956 ,4 ,960 ,1651 ,0,3,1,3,0,1,0,76.14,58.15 ,33.33
01,000,01,002,0050,138,827 ,2 ,829 ,1405 ,0,3,1,3,0,1,0,76.14,59.00 ,33.33
01,000,01,002,0051,139,822 ,2 ,824 ,1360 ,0,3,1,3,0,1,0,76.14,60.59 ,33.33
01,000,01,002,0051,140,863 ,4 ,867 ,1445 ,0,3,1,3,0,1,0,76.14,60.00 ,33.33
01,000,01,002,0051,141,989 ,4 ,993 ,1593 ,0,3,1,3,0,1,0,76.14,62.34 ,33.33
01,000,01,002,0052,142,988 ,7 ,995 ,1708 ,0,3,1,3,0,1,0,76.14,58.26 ,33.33
01,000,01,002,0052,143,1092 ,4 ,1096 ,1765 ,0,3,1,3,0,1,0,76.14,62.10 ,33.33
01,000,01,002,0053,144,1115 ,5 ,1120 ,1820 ,0,3,1,3,0,1,0,76.14,61.54 ,33.33
01,000,01,002,0053,145,1119 ,9 ,1128 ,1875 ,0,3,1,3,0,1,0,76.14,60.16 ,33.33
01,000,01,002,0053,146,1238 ,6 ,1244 ,2057 ,0,3,1,3,0,1,0,76.14,60.48 ,33.33
01,000,01,002,0054,147,788 ,6 ,794 ,1368 ,0,3,1,3,0,1,0,76.14,58.04 ,33.33
01,000,01,002,0054,148,954 ,4 ,958 ,1586 ,0,3,1,3,0,1,0,76.14,60.40 ,33.33
01,000,01,002,0054,149,885 ,7 ,892 ,1525 ,0,3,1,3,0,1,0,76.14,58.49 ,33.33
01,000,01,002,0055,150,1011 ,1 ,1012 ,1838 ,0,3,1,3,0,1,0,76.14,55.06 ,33.33
01,000,01,002,0055,151,1004 ,9 ,1013 ,1789 ,0,3,1,3,0,1,0,76.14,56.62 ,33.33
01,000,01,002,0055,152,1161 ,8 ,1169 ,1892 ,0,3,1,3,0,1,0,76.14,61.79 ,33.33
01,000,01,002,0056,153,716 ,4 ,720 ,1263 ,0,3,1,3,0,1,0,76.14,57.01 ,33.33
01,000,01,002,0056,154,783 ,5 ,788 ,1360 ,0,3,1,3,0,1,0,76.14,57.94 ,33.33
01,000,01,002,0056,155,798 ,3 ,801 ,1393 ,0,3,1,3,0,1,0,76.14,57.50 ,33.33
01,000,01,002,0057,156,788 ,9 ,797 ,1411 ,0,3,1,3,0,1,0,76.14,56.48 ,33.33
01,000,01,002,0057,157,764 ,7 ,771 ,1339 ,0,3,1,3,0,1,0,76.14,57.58 ,33.33
01,000,01,002,0057,158,887 ,7 ,894 ,1568 ,0,3,1,3,0,1,0,76.14,57.02 ,33.33
01,000,01,002,0058,159,923 ,6 ,929 ,1695 ,0,3,1,3,0,1,0,76.14,54.81 ,33.33
01,000,01,002,0058,160,921 ,9 ,930 ,1546 ,0,3,1,3,0,1,0,76.14,60.16 ,33.33
01,000,01,002,0058,161,943 ,3 ,946 ,1589 ,0,3,1,3,0,1,0,76.14,59.53 ,33.33
01,000,01,002,0059,162,1217 ,4 ,1221 ,1981 ,0,3,1,3,0,1,0,76.14,61.64 ,33.33
01,000,01,002,0059,163,1125 ,11 ,1136 ,1897 ,0,3,1,3,0,1,0,76.14,59.88 ,33.33
01,000,01,002,0059,164,1302 ,2 ,1304 ,2003 ,0,3,1,3,0,1,0,76.14,65.10 ,33.33
01,000,01,002,0060,165,952 ,5 ,957 ,1675 ,0,3,1,3,0,1,0,76.14,57.13 ,33.33
01,000,01,002,0060,166,886 ,5 ,891 ,1443 ,0,3,1,3,0,1,0,76.14,61.75 ,33.33
01,000,01,002,0061,167,951 ,5 ,956 ,1562 ,0,3,1,3,0,1,0,76.14,61.20 ,33.33
01,000,01,002,0061,168,942 ,6 ,948 ,1732 ,0,3,1,3,0,1,0,76.14,54.73 ,33.33
01,000,01,002,0061,169,957 ,13 ,970 ,1755 ,0,3,1,3,0,1,0,76.14,55.27 ,33.33
01,000,01,002,0062,170,1058 ,6 ,1064 ,1785 ,0,3,1,3,0,1,0,76.14,59.61 ,33.33
01,000,01,002,0062,171,989 ,8 ,997 ,1709 ,0,3,1,3,0,1,0,76.14,58.34 ,33.33
01,000,01,002,0062,172,890 ,6 ,896 ,1586 ,0,3,1,3,0,1,0,76.14,56.49 ,33.33
01,000,01,002,0062,173,919 ,2 ,921 ,1607 ,0,3,1,3,0,1,0,76.14,57.31 ,33.33
01,000,01,002,0063,174,1100 ,5 ,1105 ,1821 ,0,3,1,3,0,1,0,76.14,60.68 ,33.33
01,000,01,002,0063,175,1199 ,5 ,1204 ,1969 ,0,3,1,3,0,1,0,76.14,61.15 ,33.33
01,000,01,002,0063,176,1139 ,5 ,1144 ,1891 ,0,3,1,3,0,1,0,76.14,60.50 ,33.33
01,000,01,002,0064,177,1132 ,5 ,1137 ,1861 ,0,3,1,3,0,1,0,76.14,61.10 ,33.33
01,000,01,002,0064,178,1183 ,5 ,1188 ,1962 ,0,3,1,3,0,1,0,76.14,60.55 ,33.33
01,000,01,002,0064,179,1198 ,3 ,1201 ,1968 ,0,3,1,3,0,1,0,76.14,61.03 ,33.33
01,000,01,002,0065,180,793 ,6 ,799 ,1304 ,0,3,1,3,0,1,0,76.14,61.27 ,33.33
01,000,01,002,0065,181,776 ,6 ,782 ,1267 ,0,3,1,3,0,1,0,76.14,61.72 ,33.33
01,000,01,002,0065,182,809 ,5 ,814 ,1333 ,0,3,1,3,0,1,0,76.14,61.07 ,33.33
01,000,01,002,0066,183,869 ,3 ,872 ,1426 ,0,3,1,3,0,1,0,76.14,61.15 ,33.33
01,000,01,002,0066,184,801 ,7 ,808 ,1343 ,0,3,1,3,0,1,0,76.14,60.16 ,33.33
01,000,01,002,0066,185,1115 ,7 ,1122 ,1694 ,0,3,1,3,0,1,0,76.14,66.23 ,33.33
01,000,01,002,0067,186,895 ,5 ,900 ,1578 ,0,3,1,3,0,1,0,76.14,57.03 ,33.33
01,000,01,002,0067,187,927 ,6 ,933 ,1538 ,0,3,1,3,0,1,0,76.14,60.66 ,33.33
01,000,01,002,0068,188,1233 ,4 ,1237 ,1906 ,0,3,1,3,0,1,0,76.14,64.90 ,33.33
01,000,01,002,0068,189,1140 ,6 ,1146 ,1852 ,0,3,1,3,0,1,0,76.14,61.88 ,33.33
01,000,01,002,0068,190,1251 ,3 ,1254 ,1995 ,0,3,1,3,0,1,0,76.14,62.86 ,33.33
01,000,01,002,0069,191,1023 ,5 ,1028 ,1615 ,0,3,1,3,0,1,0,76.14,63.65 ,33.33
01,000,01,002,0069,192,980 ,6 ,986 ,1693 ,0,3,1,3,0,1,0,76.14,58.24 ,33.33
01,000,01,002,0070,193,835 ,3 ,838 ,1375 ,0,3,1,3,0,1,0,76.14,60.95 ,33.33
01,000,01,002,0070,194,978 ,3 ,981 ,1598 ,0,3,1,3,0,1,0,76.14,61.39 ,33.33
01,000,01,002,0070,195,983 ,7 ,990 ,1645 ,0,3,1,3,0,1,0,76.14,60.18 ,33.33
01,000,01,002,0071,196,761 ,5 ,766 ,1307 ,0,3,1,3,0,1,0,76.14,58.61 ,33.33
01,000,01,002,0071,197,892 ,4 ,896 ,1443 ,0,3,1,3,0,1,0,76.14,62.09 ,33.33
01,000,01,002,0071,198,995 ,6 ,1001 ,1458 ,0,3,1,3,0,1,0,76.14,68.66 ,33.33
01,000,01,002,0072,199,1035 ,1 ,1036 ,1547 ,0,3,1,3,0,1,0,76.14,66.97 ,33.33
01,000,01,002,0072,200,977 ,5 ,982 ,1480 ,0,3,1,3,0,1,0,76.14,66.35 ,33.33
01,000,01,002,0072,201,968 ,3 ,971 ,1604 ,0,3,1,3,0,1,0,76.14,60.54 ,33.33
01,000,01,002,0073,202,1134 ,4 ,1138 ,1894 ,0,3,1,3,0,1,0,76.14,60.08 ,33.33
01,000,01,002,0073,203,1230 ,6 ,1236 ,2035 ,0,3,1,3,0,1,0,76.14,60.74 ,33.33
01,000,01,002,0073,204,1114 ,12 ,1126 ,1838 ,0,3,1,3,0,1,0,76.14,61.26 ,33.33
01,000,01,002,0074,205,830 ,2 ,832 ,1276 ,0,3,1,3,0,1,0,76.14,65.20 ,33.33
01,000,01,002,0074,206,935 ,2 ,937 ,1423 ,0,3,1,3,0,1,0,76.14,65.85 ,33.33
01,000,01,002,0074,207,901 ,11 ,912 ,1417 ,0,3,1,3,0,1,0,76.14,64.36 ,33.33
01,000,01,002,0075,208,904 ,7 ,911 ,1486 ,0,3,1,3,0,1,0,76.14,61.31 ,33.33
01,000,01,002,0075,209,978 ,1 ,979 ,1567 ,0,3,1,3,0,1,0,76.14,62.48 ,33.33
01,000,01,002,0075,210,943 ,3 ,946 ,1473 ,0,3,1,3,0,1,0,76.14,64.22 ,33.33
01,000,01,002,0076,211,1039 ,4 ,1043 ,1741 ,0,3,1,3,0,1,0,76.14,59.91 ,33.33
01,000,01,002,0076,212,941 ,2 ,943 ,1536 ,0,3,1,3,0,1,0,76.14,61.39 ,33.33
01,000,01,002,0076,213,1019 ,3 ,1022 ,1678 ,0,3,1,3,0,1,0,76.14,60.91 ,33.33
01,000,01,002,0076,214,1037 ,11 ,1048 ,1833 ,0,3,1,3,0,1,0,76.14,57.17 ,33.33
01,000,01,002,0077,215,1040 ,4 ,1044 ,1676 ,0,3,1,3,0,1,0,76.14,62.29 ,33.33
01,000,01,002,0077,216,1016 ,6 ,1022 ,1581 ,0,3,1,3,0,1,0,76.14,64.64 ,33.33
01,000,01,002,0077,217,1075 ,6 ,1081 ,1731 ,0,3,1,3,0,1,0,76.14,62.45 ,33.33
01,000,01,002,0078,218,1078 ,5 ,1083 ,1684 ,0,3,1,3,0,1,0,76.14,64.31 ,33.33
01,000,01,002,0078,219,1084 ,9 ,1093 ,1779 ,0,3,1,3,0,1,0,76.14,61.44 ,33.33
01,000,01,002,0078,220,931 ,7 ,938 ,1527 ,0,3,1,3,0,1,0,76.14,61.43 ,33.33
01,000,01,002,0079,221,869 ,8 ,877 ,1417 ,0,3,1,3,0,1,0,76.14,61.89 ,33.33
01,000,01,002,0079,222,916 ,2 ,918 ,1418 ,0,3,1,3,0,1,0,76.14,64.74 ,33.33
01,000,01,002,0079,223,794 ,4 ,798 ,1295 ,0,3,1,3,0,1,0,76.14,61.62 ,33.33
01,000,01,002,0080,224,1158 ,4 ,1162 ,1856 ,0,3,1,3,0,1,0,76.14,62.61 ,33.33
01,000,01,002,0080,225,1179 ,9 ,1188 ,1954 ,0,3,1,3,0,1,0,76.14,60.8,33.33
01,000,01,002,0081,226,884 ,9 ,893 ,1438 ,0,3,1,3,0,1,0,76.14,62.1,33.33
01,000,01,002,0081,227,936 ,4 ,940 ,1510 ,0,3,1,3,0,1,0,76.14,62.25,33.33
01,000,01,002,0081,228,895 ,7 ,902 ,1535 ,0,3,1,3,0,1,0,76.14,58.76,33.33
01,000,01,002,0081,229,922 ,5 ,927 ,1463 ,0,3,1,3,0,1,0,76.14,63.36,33.33
01,000,01,002,0082,230,1097 ,3 ,1100 ,1790 ,0,3,1,3,0,1,0,76.14,61.45,33.33
01,000,01,002,0082,231,1090 ,9 ,1099 ,1762 ,0,3,1,3,0,1,0,76.14,62.37,33.33
01,000,01,002,0082,232,1119 ,10 ,1129 ,1959 ,0,3,1,3,0,1,0,76.14,57.63,33.33
01,000,01,002,0083,233,1036 ,3 ,1039 ,1735 ,0,3,1,3,0,1,0,76.14,59.88,33.33
01,000,01,002,0083,234,929 ,3 ,932 ,1548 ,0,3,1,3,0,1,0,76.14,60.21,33.33
01,000,01,002,0083,235,1043 ,3 ,1046 ,1712 ,0,3,1,3,0,1,0,76.14,61.1,33.33
01,000,01,002,0083,236,1020 ,3 ,1023 ,1678 ,0,3,1,3,0,1,0,76.14,60.97,33.33
01,000,01,002,0084,237,1057 ,3 ,1060 ,1672 ,0,3,1,3,0,1,0,76.14,63.4,33.33
01,000,01,002,0084,238,1140 ,5 ,1145 ,1785 ,0,3,1,3,0,1,0,76.14,64.15,33.33
01,000,01,002,0084,239,1024 ,13 ,1037 ,1653 ,0,3,1,3,0,1,0,76.14,62.73,33.33
01,000,01,002,0085,240,685 ,4 ,689 ,1148 ,0,3,1,3,0,1,0,76.14,60.02,33.33
01,000,01,002,0086,241,744 ,5 ,749 ,1234 ,0,3,1,3,0,1,0,76.14,60.7,33.33
01,000,01,002,0087,242,1036 ,6 ,1042 ,1747 ,0,3,1,3,0,1,0,76.14,59.65,33.33
01,000,01,002,0088,243,565 ,2 ,567 ,932 ,0,3,1,3,0,1,0,76.14,60.84,33.33
01,000,01,002,0088,244,593 ,2 ,595 ,1028 ,0,3,1,3,0,1,0,76.14,57.88,33.33
01,000,01,002,0088,245,458 ,5 ,463 ,799 ,0,3,1,3,0,1,0,76.14,57.95,33.33
01,000,01,002,0089,246,812 ,3 ,815 ,1367 ,0,3,1,3,0,1,0,76.14,59.62,33.33
01,000,01,002,0090,247,769 ,10 ,779 ,1189 ,0,3,1,3,0,1,0,76.14,65.52,33.33
01,000,01,002,0091,248,710 ,7 ,717 ,1231 ,0,3,1,3,0,1,0,76.14,58.25,33.33
01,000,01,002,0092,249,813 ,2 ,815 ,1264 ,0,3,1,3,0,1,0,76.14,64.48,33.33
01,000,01,002,0092,250,773 ,4 ,777 ,1207 ,0,3,1,3,0,1,0,76.14,64.37,33.33
01,000,01,002,0093,251,862 ,6 ,868 ,1386 ,0,3,1,3,0,1,0,76.14,62.63,33.33
01,000,01,002,0093,252,652 ,3 ,655 ,1076 ,0,3,1,3,0,1,0,76.14,60.87,33.33
01,000,01,003,0094,253,906 ,5 ,911 ,1476 ,0,3,1,3,0,1,0,76.14,61.72,33.33
01,000,01,003,0094,254,1009 ,4 ,1013 ,1603 ,0,3,1,3,0,1,0,76.14,63.19,33.33
01,000,01,003,0094,255,1004 ,3 ,1007 ,1588 ,0,3,1,3,0,1,0,76.14,63.41,33.33
01,000,01,003,0094,256,919 ,4 ,923 ,1530 ,0,3,1,3,0,1,0,76.14,60.33,33.33
01,000,01,003,0095,257,961 ,5 ,966 ,1524 ,0,3,1,3,0,1,0,76.14,63.39,33.33
01,000,01,003,0095,258,915 ,7 ,922 ,1531 ,0,3,1,3,0,1,0,76.14,60.22,33.33
01,000,01,003,0095,259,845 ,6 ,851 ,1416 ,0,3,1,3,0,1,0,76.14,60.1,33.33
01,000,01,003,0095,260,1232 ,3 ,1235 ,1901 ,0,3,1,3,0,1,0,76.14,64.97,33.33
01,000,01,003,0096,261,1066 ,3 ,1069 ,1677 ,0,3,1,3,0,1,0,76.14,63.74,33.33
01,000,01,003,0096,262,986 ,0 ,986 ,1603 ,0,3,1,3,0,1,0,76.14,61.51,33.33
01,000,01,003,0096,263,1064 ,6 ,1070 ,1747 ,0,3,1,3,0,1,0,76.14,61.25,33.33
01,000,01,003,0097,264,965 ,5 ,970 ,1521 ,0,3,1,3,0,1,0,76.14,63.77,33.33
01,000,01,003,0097,265,959 ,4 ,963 ,1517 ,0,3,1,3,0,1,0,76.14,63.48,33.33
01,000,01,003,0097,266,832 ,6 ,838 ,1371 ,0,3,1,3,0,1,0,76.14,61.12,33.33
01,000,01,003,0098,267,915 ,5 ,920 ,1466 ,0,3,1,3,0,1,0,76.14,62.76,33.33
01,000,01,003,0098,268,744 ,2 ,746 ,1188 ,0,3,1,3,0,1,0,76.14,62.79,33.33
01,000,01,003,0098,269,795 ,2 ,797 ,1357 ,0,3,1,3,0,1,0,76.14,58.73,33.33
01,000,01,003,0099,270,877 ,5 ,882 ,1463 ,0,3,1,3,0,1,0,76.14,60.29,33.33
01,000,01,003,0099,271,766 ,3 ,769 ,1245 ,0,3,1,3,0,1,0,76.14,61.77,33.33
01,000,01,003,0099,272,893 ,5 ,898 ,1445 ,0,3,1,3,0,1,0,76.14,62.15,33.33
01,000,01,003,0100,273,904 ,4 ,908 ,1440 ,0,3,1,3,0,1,0,76.14,63.06,33.33
01,000,01,003,0100,274,881 ,5 ,886 ,1441 ,0,3,1,3,0,1,0,76.14,61.49,33.33
01,000,01,003,0100,275,943 ,8 ,951 ,1549 ,0,3,1,3,0,1,0,76.14,61.39,33.33
01,000,01,003,0100,276,903 ,5 ,908 ,1445 ,0,3,1,3,0,1,0,76.14,62.84,33.33
01,000,01,003,0100,277,832 ,3 ,835 ,1308 ,0,3,1,3,0,1,0,76.14,63.84,33.33
01,000,01,003,0101,278,941 ,5 ,946 ,1520 ,0,3,1,3,0,1,0,76.14,62.24,33.33
01,000,01,003,0101,279,956 ,12 ,968 ,1546 ,0,3,1,3,0,1,0,76.14,62.61,33.33
01,000,01,003,0101,280,1043 ,4 ,1047 ,1626 ,0,3,1,3,0,1,0,76.14,64.39,33.33
01,000,01,003,0101,281,910 ,8 ,918 ,1542 ,0,3,1,3,0,1,0,76.14,59.53,33.33
01,000,01,003,0102,282,977 ,4 ,981 ,1513 ,0,3,1,3,0,1,0,76.14,64.84,33.33
01,000,01,003,0102,283,916 ,4 ,920 ,1487 ,0,3,1,3,0,1,0,76.14,61.87,33.33
01,000,01,003,0102,284,862 ,6 ,868 ,1518 ,0,3,1,3,0,1,0,76.14,57.18,33.33
01,000,01,003,0103,285,1038 ,8 ,1046 ,1602 ,0,3,1,3,0,1,0,76.14,65.29,33.33
01,000,01,003,0103,286,907 ,2 ,909 ,1363 ,0,3,1,3,0,1,0,76.14,66.69,33.33
01,000,01,003,0103,287,716 ,7 ,723 ,1143 ,0,3,1,3,0,1,0,76.14,63.25,33.33
01,000,01,003,0103,288,1064 ,9 ,1073 ,1657 ,0,3,1,3,0,1,0,76.14,64.76,33.33
01,000,01,003,0104,289,982 ,1 ,983 ,1506 ,0,3,1,3,0,1,0,76.14,65.27,33.33
01,000,01,003,0104,290,1070 ,2 ,1072 ,1734 ,0,3,1,3,0,1,0,76.14,61.82,33.33
01,000,01,003,0104,291,1019 ,2 ,1021 ,1662 ,0,3,1,3,0,1,0,76.14,61.43,33.33
01,000,01,003,0104,292,960 ,2 ,962 ,1550 ,0,3,1,3,0,1,0,76.14,62.06,33.33
01,000,01,003,0105,293,781 ,7 ,788 ,1317 ,0,3,1,3,0,1,0,76.14,59.83,33.33
01,000,01,003,0105,294,693 ,0 ,693 ,1218 ,0,3,1,3,0,1,0,76.14,56.9,33.33
01,000,01,003,0105,295,835 ,3 ,838 ,1391 ,0,3,1,3,0,1,0,76.14,60.24,33.33
01,000,01,003,0106,296,878 ,4 ,882 ,1510 ,0,3,1,3,0,1,0,76.14,58.41,33.33
01,000,01,003,0106,297,967 ,7 ,974 ,1570 ,0,3,1,3,0,1,0,76.14,62.04,33.33
01,000,01,003,0106,298,1052 ,0 ,1052 ,1647 ,0,3,1,3,0,1,0,76.14,63.87,33.33
01,000,01,003,0107,299,844 ,5 ,849 ,1536 ,0,3,1,3,0,1,0,76.14,55.27,33.33
01,000,01,003,0107,300,924 ,2 ,926 ,1577 ,0,3,1,3,0,1,0,76.14,58.72,33.33
01,000,01,003,0107,301,891 ,6 ,897 ,1416 ,0,3,1,3,0,1,0,76.14,63.35,33.33
01,000,01,003,0108,302,1041 ,9 ,1050 ,1646 ,0,3,1,3,0,1,0,76.14,63.79,33.33
01,000,01,003,0108,303,1037 ,2 ,1039 ,1729 ,0,3,1,3,0,1,0,76.14,60.09,33.33
01,000,01,003,0108,304,1074 ,2 ,1076 ,1636 ,0,3,1,3,0,1,0,76.14,65.77,33.33
01,000,01,003,0109,305,250 ,2 ,252 ,401 ,0,3,1,3,0,1,0,76.14,62.84,33.33
01,000,01,003,0109,306,1071 ,4 ,1075 ,1629 ,0,3,1,3,0,1,0,76.14,65.99,33.33
01,000,01,003,0109,307,1062 ,3 ,1065 ,1763 ,0,3,1,3,0,1,0,76.14,60.41,33.33
01,000,01,003,0109,308,916 ,3 ,919 ,1505 ,0,3,1,3,0,1,0,76.14,61.06,33.33
01,000,01,003,0110,309,1042 ,7 ,1049 ,1510 ,0,3,1,3,0,1,0,76.14,69.47,33.33
01,000,01,003,0110,310,909 ,13 ,922 ,1481 ,0,3,1,3,0,1,0,76.14,62.26,33.33
01,000,01,003,0110,311,960 ,2 ,962 ,1529 ,0,3,1,3,0,1,0,76.14,62.92,33.33
01,000,01,003,0111,312,1134 ,5 ,1139 ,1850 ,0,3,1,3,0,1,0,76.14,61.57,33.33
01,000,01,003,0111,313,959 ,7 ,966 ,1690 ,0,3,1,3,0,1,0,76.14,57.16 ,33.33
01,000,01,003,0111,314,985 ,3 ,988 ,1738 ,0,3,1,3,0,1,0,76.14,56.85,33.33
01,000,01,003,0112,315,1158 ,2 ,1160 ,1887 ,0,3,1,3,0,1,0,76.14,61.47,33.33
01,000,01,003,0112,316,895 ,4 ,899 ,1539 ,0,3,1,3,0,1,0,76.14,58.41,33.33
01,000,01,003,0112,317,1032 ,4 ,1036 ,1770 ,0,3,1,3,0,1,0,76.14,58.53,33.33
01,000,01,003,0112,318,1023 ,10 ,1033 ,1795 ,0,3,1,3,0,1,0,76.14,57.55,33.33
01,000,01,003,0113,319,918 ,3 ,921 ,1556 ,0,3,1,3,0,1,0,76.14,59.19,33.33
01,000,01,003,0113,320,1005 ,4 ,1009 ,1707 ,0,3,1,3,0,1,0,76.14,59.11,33.33
01,000,01,003,0113,321,918 ,7 ,925 ,1500 ,0,3,1,3,0,1,0,76.14,61.67,33.33
01,000,01,003,0114,322,771 ,7 ,778 ,1418 ,0,3,1,3,0,1,0,76.14,54.87,33.33
01,000,01,003,0114,323,870 ,3 ,873 ,1496 ,0,3,1,3,0,1,0,76.14,58.36,33.33
01,000,01,003,0114,324,885 ,4 ,889 ,1536 ,0,3,1,3,0,1,0,76.14,57.88,33.33
01,000,01,003,0114,325,836 ,5 ,841 ,1410 ,0,3,1,3,0,1,0,76.14,59.65,33.33
01,000,01,003,0115,326,1111 ,8 ,1119 ,1801 ,0,3,1,3,0,1,0,76.14,62.13,33.33
01,000,01,003,0115,327,1059 ,1 ,1060 ,1796 ,0,3,1,3,0,1,0,76.14,59.02,33.33
01,000,01,003,0116,328,453 ,0 ,453 ,792 ,0,3,1,3,0,1,0,76.14,57.2,33.33
01,000,01,003,0117,329,826 ,5 ,831 ,1408 ,0,3,1,3,0,1,0,76.14,59.02,33.33
01,000,01,003,0117,330,864 ,8 ,872 ,1417 ,0,3,1,3,0,1,0,76.14,61.54,33.33
01,000,01,003,0117,331,842 ,9 ,851 ,1419 ,0,3,1,3,0,1,0,76.14,59.97,33.33
01,000,01,003,0117,332,975 ,5 ,980 ,1534 ,0,3,1,3,0,1,0,76.14,63.89,33.33
01,000,01,003,0118,333,1192 ,7 ,1199 ,1776 ,0,3,1,3,0,1,0,76.14,67.51,33.33
01,000,01,003,0118,334,1086 ,5 ,1091 ,1637 ,0,3,1,3,0,1,0,76.14,66.65,33.33
01,000,01,003,0118,335,1065 ,5 ,1070 ,1493 ,0,3,1,3,0,1,0,76.14,71.67,33.33
01,000,01,003,0118,336,1061 ,6 ,1067 ,1480 ,0,3,1,3,0,1,0,76.14,72.09,33.33
01,000,01,003,0119,337,804 ,2 ,806 ,1282 ,0,3,1,3,0,1,0,76.14,62.87,33.33
01,000,01,003,0119,338,790 ,4 ,794 ,1225 ,0,3,1,3,0,1,0,76.14,64.82,33.33
01,000,01,003,0119,339,805 ,5 ,810 ,1195 ,0,3,1,3,0,1,0,76.14,67.78,33.33
01,000,01,003,0120,340,995 ,7 ,1002 ,1737 ,0,3,1,3,0,1,0,76.14,57.69,33.33
01,000,01,003,0120,341,1053 ,6 ,1059 ,1813 ,0,3,1,3,0,1,0,76.14,58.41,33.33
01,000,01,003,0120,342,866 ,4 ,870 ,1716 ,0,3,1,3,0,1,0,76.14,50.7,33.33
01,000,01,003,0120,343,973 ,9 ,982 ,1708 ,0,3,1,3,0,1,0,76.14,57.49,33.33
01,000,01,003,0121,344,885 ,2 ,887 ,1486 ,0,3,1,3,0,1,0,76.14,59.69,33.33
01,000,01,003,0121,345,851 ,9 ,860 ,1509 ,0,3,1,3,0,1,0,76.14,56.99,33.33
01,000,01,003,0121,346,839 ,2 ,841 ,1509 ,0,3,1,3,0,1,0,76.14,55.73,33.33
01,000,01,003,0121,347,810 ,11 ,821 ,1438 ,0,3,1,3,0,1,0,76.14,57.09,33.33
01,000,01,003,0122,348,1056 ,5 ,1061 ,1776 ,0,3,1,3,0,1,0,76.14,59.74,33.33
01,000,01,003,0122,349,955 ,6 ,961 ,1662 ,0,3,1,3,0,1,0,76.14,57.82,33.33
01,000,01,003,0122,350,1073 ,11 ,1084 ,1829 ,0,3,1,3,0,1,0,76.14,59.27,33.33
01,000,01,003,0123,351,790 ,6 ,796 ,1393 ,0,3,1,3,0,1,0,76.14,57.14,33.33
01,000,01,003,0123,352,913 ,6 ,919 ,1591 ,0,3,1,3,0,1,0,76.14,57.76,33.33
01,000,01,003,0123,353,808 ,7 ,815 ,1452 ,0,3,1,3,0,1,0,76.14,56.13,33.33
01,000,01,003,0123,354,834 ,3 ,837 ,1466 ,0,3,1,3,0,1,0,76.14,57.09,33.33
01,000,01,003,0124,355,451 ,4 ,455 ,797 ,0,3,1,3,0,1,0,76.14,57.09,33.33
01,000,01,003,0124,356,715 ,7 ,722 ,1143 ,0,3,1,3,0,1,0,76.14,63.17,33.33
01,000,01,003,0124,357,780 ,5 ,785 ,1333 ,0,3,1,3,0,1,0,76.14,58.89,33.33
01,000,01,003,0125,358,1030 ,5 ,1035 ,1705 ,0,3,1,3,0,1,0,76.14,60.7,33.33
01,000,01,003,0125,359,1099 ,5 ,1104 ,1906 ,0,3,1,3,0,1,0,76.14,57.92,33.33
01,000,01,003,0126,360,730 ,3 ,733 ,1229 ,0,3,1,3,0,1,0,76.14,59.64,33.33
01,000,01,003,0126,361,825 ,6 ,831 ,1300 ,0,3,1,3,0,1,0,76.14,63.92,33.33
01,000,01,003,0126,362,865 ,2 ,867 ,1387 ,0,3,1,3,0,1,0,76.14,62.51,33.33
01,000,01,003,0127,363,852 ,7 ,859 ,1347 ,0,3,1,3,0,1,0,76.14,63.77,33.33
01,000,01,003,0127,364,623 ,13 ,636 ,1052 ,0,3,1,3,0,1,0,76.14,60.46,33.33
01,000,01,003,0127,365,808 ,4 ,812 ,1340 ,0,3,1,3,0,1,0,76.14,60.6,33.33
01,000,01,003,0127,366,842 ,6 ,848 ,1405 ,0,3,1,3,0,1,0,76.14,60.36,33.33
01,000,01,003,0128,367,851 ,5 ,856 ,1422 ,0,3,1,3,0,1,0,76.14,60.2,33.33
01,000,01,003,0129,368,904 ,6 ,910 ,1604 ,0,3,1,3,0,1,0,76.14,56.73,33.33
01,000,01,003,0129,369,775 ,2 ,777 ,2166 ,0,3,1,3,0,1,0,76.14,35.87,33.33
01,000,01,003,0129,370,952 ,4 ,956 ,1607 ,0,3,1,3,0,1,0,76.14,59.49,33.33
01,000,01,003,0129,371,931 ,8 ,939 ,1553 ,0,3,1,3,0,1,0,76.14,60.46,33.33
01,000,01,003,0129,372,885 ,1 ,886 ,1526 ,0,3,1,3,0,1,0,76.14,58.06,33.33
01,000,01,003,0130,373,822 ,5 ,827 ,1344 ,0,3,1,3,0,1,0,76.14,61.53,33.33
01,000,01,003,0130,374,812 ,1 ,813 ,1339 ,0,3,1,3,0,1,0,76.14,60.72,33.33
01,000,01,003,0130,375,776 ,5 ,781 ,1340 ,0,3,1,3,0,1,0,76.14,58.28,33.33
01,000,01,004,0131,376,861 ,4 ,865 ,1445 ,0,3,1,3,0,1,0,76.14,59.86,33.33
01,000,01,004,0131,377,891 ,1 ,892 ,1536 ,0,3,1,3,0,1,0,76.14,58.07,33.33
01,000,01,004,0131,378,885 ,4 ,889 ,1829 ,0,3,1,3,0,1,0,76.14,48.61,33.33
01,000,01,004,0132,379,1007 ,7 ,1014 ,1824 ,0,3,1,3,0,1,0,76.14,55.59,33.33
01,000,01,004,0132,380,903 ,6 ,909 ,1473 ,0,3,1,3,0,1,0,76.14,61.71,33.33
01,000,01,004,0133,381,938 ,8 ,946 ,1532 ,0,3,1,3,0,1,0,76.14,61.75,33.33
01,000,01,004,0133,382,949 ,5 ,954 ,1663 ,0,3,1,3,0,1,0,76.14,57.37,33.33
01,000,01,004,0134,383,789 ,2 ,791 ,1353 ,0,3,1,3,0,1,0,76.14,58.46,33.33
01,000,01,004,0134,384,691 ,8 ,699 ,1228 ,0,3,1,3,0,1,0,76.14,56.92,33.33
01,000,01,004,0135,385,963 ,7 ,970 ,1663 ,0,3,1,3,0,1,0,76.14,58.33,33.33
01,000,01,004,0135,386,858 ,4 ,862 ,1441 ,0,3,1,3,0,1,0,76.14,59.82,33.33
01,000,01,004,0135,387,746 ,1 ,747 ,1275 ,0,3,1,3,0,1,0,76.14,58.59,33.33
01,000,01,004,0135,388,841 ,4 ,845 ,1359 ,0,3,1,3,0,1,0,76.14,62.18,33.33
01,000,01,004,0136,389,1090 ,10 ,1100 ,1685 ,0,3,1,3,0,1,0,76.14,65.28,33.33
01,000,01,004,0136,390,1010 ,5 ,1015 ,1628 ,0,3,1,3,0,1,0,76.14,62.35,33.33
01,000,01,004,0137,391,1164 ,5 ,1169 ,1874 ,0,3,1,3,0,1,0,76.14,62.38,33.33
01,000,01,004,0137,392,1000 ,10 ,1010 ,1761 ,0,3,1,3,0,1,0,76.14,57.35,33.33
01,000,01,004,0138,393,941 ,9 ,950 ,1662 ,0,3,1,3,0,1,0,76.14,57.16,33.33
01,000,01,004,0138,394,1165 ,8 ,1173 ,1869 ,0,3,1,3,0,1,0,76.14,62.76,33.33
01,000,01,004,0139,395,1066 ,9 ,1075 ,1769 ,0,3,1,3,0,1,0,76.14,60.77,33.33
01,000,01,004,0139,396,1180 ,5 ,1185 ,1884 ,0,3,1,3,0,1,0,76.14,62.9,33.33
01,000,01,004,0140,397,899 ,4 ,903 ,1489 ,0,3,1,3,0,1,0,76.14,60.64,33.33
01,000,01,004,0140,398,846 ,5 ,851 ,1386 ,0,3,1,3,0,1,0,76.14,61.4,33.33
01,000,01,004,0140,399,710 ,13 ,723 ,1120 ,0,3,1,3,0,1,0,76.14,64.55,33.33
01,000,01,004,0140,400,657 ,3 ,660 ,1050 ,0,3,1,3,0,1,0,76.14,62.86,33.33
01,000,01,004,0141,401,867 ,2 ,869 ,1363 ,0,3,1,3,0,1,0,76.14,63.76,33.33
01,000,01,004,0141,402,994 ,13 ,1007 ,1616 ,0,3,1,3,0,1,0,76.14,62.31,33.33
01,000,01,004,0141,403,813 ,5 ,818 ,1374 ,0,3,1,3,0,1,0,76.14,59.53,33.33
01,000,01,004,0141,404,1096 ,11 ,1107 ,1765 ,0,3,1,3,0,1,0,76.14,62.72,33.33
01,000,01,004,0142,405,1193 ,7 ,1200 ,1733 ,0,3,1,3,0,1,0,76.14,69.24,33.33
01,000,01,004,0142,406,1025 ,5 ,1030 ,1608 ,0,3,1,3,0,1,0,76.14,64.05,33.33
01,000,01,004,0143,407,1183 ,6 ,1189 ,1889 ,0,3,1,3,0,1,0,76.14,62.94,33.33
01,000,01,004,0143,408,1150 ,10 ,1160 ,1917 ,0,3,1,3,0,1,0,76.14,60.51,33.33
01,000,01,004,0144,409,1263 ,4 ,1267 ,2071 ,0,3,1,3,0,1,0,76.14,61.18,33.33
01,000,01,004,0144,410,1185 ,12 ,1197 ,1894 ,0,3,1,3,0,1,0,76.14,63.2,33.33
01,000,01,004,0145,411,906 ,0 ,906 ,1399 ,0,3,1,3,0,1,0,76.14,64.76,33.33
01,000,01,004,0145,412,883 ,5 ,888 ,1424 ,0,3,1,3,0,1,0,76.14,62.36,33.33
01,000,01,004,0145,413,920 ,7 ,927 ,1463 ,0,3,1,3,0,1,0,76.14,63.36,33.33
01,000,01,004,0146,414,755 ,7 ,762 ,1291 ,0,3,1,3,0,1,0,76.14,59.02,33.33
01,000,01,004,0146,415,742 ,8 ,750 ,1286 ,0,3,1,3,0,1,0,76.14,58.32,33.33
01,000,01,004,0146,416,816 ,10 ,826 ,1412 ,0,3,1,3,0,1,0,76.14,58.5,33.33
01,000,01,004,0146,417,754 ,4 ,758 ,1300 ,0,3,1,3,0,1,0,76.14,58.31,33.33
01,000,01,004,0146,418,836 ,3 ,839 ,1497 ,0,3,1,3,0,1,0,76.14,56.05,33.33
01,000,01,004,0147,419,794 ,4 ,798 ,1352 ,0,3,1,3,0,1,0,76.14,59.02,33.33
01,000,01,004,0147,420,994 ,9 ,1003 ,1576 ,0,3,1,3,0,1,0,76.14,63.64,33.33
01,000,01,004,0147,421,893 ,5 ,898 ,1454 ,0,3,1,3,0,1,0,76.14,61.76,33.33
01,000,01,004,0147,422,965 ,8 ,973 ,1507 ,0,3,1,3,0,1,0,76.14,64.57,33.33
01,000,01,004,0147,423,776 ,4 ,780 ,1272 ,0,3,1,3,0,1,0,76.14,61.32,33.33
01,000,01,004,0148,424,961 ,9 ,970 ,1501 ,0,3,1,3,0,1,0,76.14,64.62,33.33
01,000,01,004,0148,425,1066 ,6 ,1072 ,1593 ,0,3,1,3,0,1,0,76.14,67.29,33.33
01,000,01,004,0148,426,947 ,7 ,954 ,1558 ,0,3,1,3,0,1,0,76.14,61.23,33.33
01,000,01,004,0149,427,769 ,4 ,773 ,1282 ,0,3,1,3,0,1,0,76.14,60.3,33.33
01,000,01,004,0149,428,958 ,7 ,965 ,1569 ,0,3,1,3,0,1,0,76.14,61.5,33.33
01,000,01,004,0149,429,933 ,10 ,943 ,1511 ,0,3,1,3,0,1,0,76.14,62.41,33.33
01,000,01,005,0150,430,937 ,5 ,942 ,1517 ,0,3,1,3,0,1,0,76.14,62.1,33.33
01,000,01,005,0150,431,1016 ,4 ,1020 ,1600 ,0,3,1,3,0,1,0,76.14,63.75,33.33
01,000,01,005,0150,432,937 ,8 ,945 ,1555 ,0,3,1,3,0,1,0,76.14,60.77,33.33
01,000,01,005,0151,433,1163 ,3 ,1166 ,1837 ,0,3,1,3,0,1,0,76.14,63.47,33.33
01,000,01,005,0151,434,975 ,6 ,981 ,1596 ,0,3,1,3,0,1,0,76.14,61.47,33.33
01,000,01,005,0151,435,1206 ,5 ,1211 ,1859 ,0,3,1,3,0,1,0,76.14,65.14,33.33
01,000,01,005,0151,436,965 ,6 ,971 ,1555 ,0,3,1,3,0,1,0,76.14,62.44,33.33
01,000,01,005,0152,437,1146 ,7 ,1153 ,1783 ,0,3,1,3,0,1,0,76.14,64.67,33.33
01,000,01,005,0152,438,1187 ,6 ,1193 ,1974 ,0,3,1,3,0,1,0,76.14,60.44,33.33
01,000,01,005,0152,439,1152 ,6 ,1158 ,1828 ,0,3,1,3,0,1,0,76.14,63.35,33.33
01,000,01,005,0153,440,1122 ,8 ,1130 ,1830 ,0,3,1,3,0,1,0,76.14,61.75,33.33
01,000,01,005,0153,441,1163 ,6 ,1169 ,1886 ,0,3,1,3,0,1,0,76.14,61.98,33.33
01,000,01,005,0154,442,930 ,4 ,934 ,1515 ,0,3,1,3,0,1,0,76.14,61.65,33.33
01,000,01,005,0154,443,1050 ,2 ,1052 ,1682 ,0,3,1,3,0,1,0,76.14,62.54,33.33
01,000,01,005,0154,444,650 ,4 ,654 ,1022 ,0,3,1,3,0,1,0,76.14,63.99,33.33
01,000,01,005,0155,445,1227 ,9 ,1236 ,2006 ,0,3,1,3,0,1,0,76.14,61.62,33.33
01,000,01,005,0155,446,1127 ,2 ,1129 ,2004 ,0,3,1,3,0,1,0,76.14,56.34,33.33
01,000,01,005,0156,447,1120 ,2 ,1122 ,1851 ,0,3,1,3,0,1,0,76.14,60.62,33.33
01,000,01,005,0156,448,1103 ,3 ,1106 ,1857 ,0,3,1,3,0,1,0,76.14,59.56,33.33
01,000,01,005,0157,449,1029 ,6 ,1035 ,1699 ,0,3,1,3,0,1,0,76.14,60.92,33.33
01,000,01,005,0157,450,1191 ,2 ,1193 ,1925 ,0,3,1,3,0,1,0,76.14,61.97,33.33
01,000,01,005,0158,451,1043 ,6 ,1049 ,1700 ,0,3,1,3,0,1,0,76.14,61.71,33.33
01,000,01,005,0158,452,1114 ,5 ,1119 ,1879 ,0,3,1,3,0,1,0,76.14,59.55,33.33
01,000,01,005,0159,453,1181 ,4 ,1185 ,1990 ,0,3,1,3,0,1,0,76.14,59.55,33.33
01,000,01,005,0159,454,1157 ,7 ,1164 ,1941 ,0,3,1,3,0,1,0,76.14,59.97,33.33
01,000,01,005,0159,455,1326 ,8 ,1334 ,2126 ,0,3,1,3,0,1,0,76.14,62.75,33.33
01,000,01,005,0160,456,891 ,1 ,892 ,1440 ,0,3,1,3,0,1,0,76.14,61.94,33.33
01,000,01,005,0160,457,787 ,3 ,790 ,1239 ,0,3,1,3,0,1,0,76.14,63.76,33.33
01,000,01,005,0160,458,1420 ,4 ,1424 ,2124 ,0,3,1,3,0,1,0,76.14,67.04,33.33
01,000,01,005,0160,459,1390 ,1 ,1391 ,2194 ,0,3,1,3,0,1,0,76.14,63.4,33.33
01,000,01,005,0161,460,1322 ,12 ,1334 ,2124 ,0,3,1,3,0,1,0,76.14,62.81,33.33
01,000,01,005,0162,461,1119 ,7 ,1126 ,1767 ,0,3,1,3,0,1,0,76.14,63.72,33.33
01,000,01,005,0162,462,1105 ,12 ,1117 ,1758 ,0,3,1,3,0,1,0,76.14,63.54,33.33
01,000,01,005,0163,463,935 ,1 ,936 ,1555 ,0,3,1,3,0,1,0,76.14,60.19,33.33
01,000,01,005,0163,464,1064 ,1 ,1065 ,1621 ,0,3,1,3,0,1,0,76.14,65.7,33.33
01,000,01,005,0163,465,1046 ,7 ,1053 ,1720 ,0,3,1,3,0,1,0,76.14,61.22,33.33
01,000,01,005,0164,466,1039 ,8 ,1047 ,1685 ,0,3,1,3,0,1,0,76.14,62.14,33.33
01,000,01,005,0164,467,970 ,3 ,973 ,1747 ,0,3,1,3,0,1,0,76.14,55.7,33.33
01,000,01,005,0164,468,1167 ,6 ,1173 ,1894 ,0,3,1,3,0,1,0,76.14,61.93,33.33
01,000,01,005,0164,469,1018 ,3 ,1021 ,1755 ,0,3,1,3,0,1,0,76.14,58.18,33.33
01,000,01,005,0165,470,1228 ,3 ,1231 ,1894 ,0,3,1,3,0,1,0,76.14,64.99,33.33
01,000,01,005,0165,471,1203 ,4 ,1207 ,1813 ,0,3,1,3,0,1,0,76.14,66.57,33.33
01,000,01,005,0165,472,1006 ,8 ,1014 ,1699 ,0,3,1,3,0,1,0,76.14,59.68,33.33
01,000,01,005,0166,473,1074 ,4 ,1078 ,1810 ,0,3,1,3,0,1,0,76.14,59.56,33.33
01,000,01,005,0166,474,894 ,3 ,897 ,2297 ,0,3,1,3,0,1,0,76.14,39.05,33.33
01,000,01,005,0166,475,876 ,3 ,879 ,1507 ,0,3,1,3,0,1,0,76.14,58.33,33.33
01,000,01,005,0167,476,1127 ,10 ,1137 ,1775 ,0,3,1,3,0,1,0,76.14,64.06,33.33
01,000,01,005,0167,477,1037 ,9 ,1046 ,1712 ,0,3,1,3,0,1,0,76.14,61.1,33.33
01,000,01,005,0167,478,1107 ,13 ,1120 ,1785 ,0,3,1,3,0,1,0,76.14,62.75,33.33
01,000,01,005,0167,479,1018 ,7 ,1025 ,1621 ,0,3,1,3,0,1,0,76.14,63.23,33.33
01,000,01,005,0168,480,1043 ,3 ,1046 ,1575 ,0,3,1,3,0,1,0,76.14,66.41,33.33
01,000,01,005,0168,481,980 ,1 ,981 ,1538 ,0,3,1,3,0,1,0,76.14,63.78,33.33
01,000,01,005,0168,482,1006 ,5 ,1011 ,1576 ,0,3,1,3,0,1,0,76.14,64.15,33.33
01,000,01,005,0169,483,1354 ,8 ,1362 ,1977 ,0,3,1,3,0,1,0,76.14,68.89,33.33
01,000,01,005,0169,484,1150 ,7 ,1157 ,1834 ,0,3,1,3,0,1,0,76.14,63.09,33.33
01,000,01,005,0169,485,1183 ,6 ,1189 ,1761 ,0,3,1,3,0,1,0,76.14,67.52,33.33
01,000,01,005,0170,486,1056 ,2 ,1058 ,1742 ,0,3,1,3,0,1,0,76.14,60.73,33.33
01,000,01,005,0170,487,1061 ,1 ,1062 ,1673 ,0,3,1,3,0,1,0,76.14,63.48,33.33
01,000,01,005,0170,488,854 ,2 ,856 ,1522 ,0,3,1,3,0,1,0,76.14,56.24,33.33
01,000,01,005,0170,489,1101 ,2 ,1103 ,1741 ,0,3,1,3,0,1,0,76.14,63.35,33.33
01,000,01,005,0171,490,1205 ,7 ,1212 ,1956 ,0,3,1,3,0,1,0,76.14,61.96,33.33
01,000,01,005,0171,491,1185 ,7 ,1192 ,2000 ,0,3,1,3,0,1,0,76.14,59.6,33.33
01,000,01,005,0171,492,1309 ,9 ,1318 ,2104 ,0,3,1,3,0,1,0,76.14,62.64,33.33
01,000,01,005,0172,493,1135 ,6 ,1141 ,1766 ,0,3,1,3,0,1,0,76.14,64.61,33.33
01,000,01,005,0172,494,1080 ,6 ,1086 ,1700 ,0,3,1,3,0,1,0,76.14,63.88,33.33
01,000,01,005,0172,495,1098 ,6 ,1104 ,1773 ,0,3,1,3,0,1,0,76.14,62.27,33.33
01,000,01,005,0173,496,986 ,3 ,989 ,1591 ,0,3,1,3,0,1,0,76.14,62.16,33.33
01,000,01,005,0173,497,804 ,7 ,811 ,1412 ,0,3,1,3,0,1,0,76.14,57.44,33.33
01,000,01,005,0173,498,975 ,5 ,980 ,1641 ,0,3,1,3,0,1,0,76.14,59.72,33.33
01,000,01,005,0173,499,986 ,7 ,993 ,1760 ,0,3,1,3,0,1,0,76.14,56.42,33.33
01,000,01,005,0174,500,857 ,6 ,863 ,1516 ,0,3,1,3,0,1,0,76.14,56.93,33.33
01,000,01,005,0174,501,976 ,10 ,986 ,1563 ,0,3,1,3,0,1,0,76.14,63.08,33.33
01,000,01,005,0175,502,800 ,6 ,806 ,1318 ,0,3,1,3,0,1,0,76.14,61.15,33.33
01,000,01,005,0175,503,830 ,2 ,832 ,1280 ,0,3,1,3,0,1,0,76.14,65,33.33
01,000,01,005,0176,504,947 ,10 ,957 ,1574 ,0,3,1,3,0,1,0,76.14,60.8,33.33
01,000,01,005,0176,505,962 ,5 ,967 ,1538 ,0,3,1,3,0,1,0,76.14,62.87,33.33
01,000,01,005,0177,506,1068 ,5 ,1073 ,1731 ,0,3,1,3,0,1,0,76.14,61.99,33.33
01,000,01,005,0177,507,1213 ,7 ,1220 ,1933 ,0,3,1,3,0,1,0,76.14,63.11,33.33
01,000,01,005,0177,508,1148 ,6 ,1154 ,1818 ,0,3,1,3,0,1,0,76.14,63.48,33.33
01,000,01,005,0178,509,804 ,5 ,809 ,1293 ,0,3,1,3,0,1,0,76.14,62.57,33.33
01,000,01,005,0178,510,738 ,3 ,741 ,1175 ,0,3,1,3,0,1,0,76.14,63.06,33.33
01,000,01,005,0179,511,859 ,3 ,862 ,1450 ,0,3,1,3,0,1,0,76.14,59.45,33.33
01,000,01,005,0179,512,953 ,2 ,955 ,1609 ,0,3,1,3,0,1,0,76.14,59.35,33.33
01,000,01,005,0180,513,937 ,7 ,944 ,1508 ,0,3,1,3,0,1,0,76.14,62.6,33.33
01,000,01,005,0180,514,1120 ,4 ,1124 ,1765 ,0,3,1,3,0,1,0,76.14,63.68,33.33
01,000,01,005,0180,515,846 ,6 ,852 ,1429 ,0,3,1,3,0,1,0,76.14,59.62,33.33
01,000,01,005,0181,516,1309 ,11 ,1320 ,2080 ,0,3,1,3,0,1,0,76.14,63.46,33.33
01,000,01,005,0182,517,971 ,10 ,981 ,1591 ,0,3,1,3,0,1,0,76.14,61.66,33.33
01,000,01,005,0182,518,884 ,4 ,888 ,1491 ,0,3,1,3,0,1,0,76.14,59.56,33.33
01,000,01,006,0183,519,856 ,6 ,862 ,2135 ,0,3,1,3,0,1,0,76.14,40.37,33.33
01,000,01,006,0183,520,914 ,3 ,917 ,1336 ,0,3,1,3,0,1,0,76.14,68.64,33.33
01,000,01,006,0183,521,877 ,1 ,878 ,1369 ,0,3,1,3,0,1,0,76.14,64.13,33.33
01,000,01,006,0184,522,1238 ,2 ,1240 ,1966 ,0,3,1,3,0,1,0,76.14,63.07,33.33
01,000,01,006,0184,523,1228 ,9 ,1237 ,1943 ,0,3,1,3,0,1,0,76.14,63.66,33.33
01,000,01,006,0185,524,667 ,1 ,668 ,1101 ,0,3,1,3,0,1,0,76.14,60.67,33.33
01,000,01,006,0185,525,795 ,4 ,799 ,1377 ,0,3,1,3,0,1,0,76.14,58.02,33.33
01,000,01,006,0186,526,706 ,4 ,710 ,1288 ,0,3,1,3,0,1,0,76.14,55.12,33.33
01,000,01,006,0186,527,734 ,2 ,736 ,1290 ,0,3,1,3,0,1,0,76.14,57.05,33.33
01,000,01,006,0187,528,889 ,2 ,891 ,1460 ,0,3,1,3,0,1,0,76.14,61.03,33.33
01,000,01,006,0187,529,899 ,5 ,904 ,1467 ,0,3,1,3,0,1,0,76.14,61.62,33.33
01,000,01,006,0188,530,991 ,4 ,995 ,1609 ,0,3,1,3,0,1,0,76.14,61.84,33.33
01,000,01,006,0188,531,975 ,5 ,980 ,1594 ,0,3,1,3,0,1,0,76.14,61.48,33.33
01,000,01,006,0188,532,1024 ,3 ,1027 ,1608 ,0,3,1,3,0,1,0,76.14,63.87,33.33
01,000,01,006,0189,533,776 ,0 ,776 ,1317 ,0,3,1,3,0,1,0,76.14,58.92,33.33
01,000,01,006,0189,534,699 ,2 ,701 ,1266 ,0,3,1,3,0,1,0,76.14,55.37,33.33
01,000,01,006,0189,535,751 ,5 ,756 ,1313 ,0,3,1,3,0,1,0,76.14,57.58,33.33
01,000,01,006,0190,536,885 ,6 ,891 ,1390 ,0,3,1,3,0,1,0,76.14,64.1,33.33
01,000,01,006,0190,537,1029 ,1 ,1030 ,1632 ,0,3,1,3,0,1,0,76.14,63.11,33.33
01,000,01,006,0190,538,788 ,4 ,792 ,1308 ,0,3,1,3,0,1,0,76.14,60.55,33.33
01,000,01,006,0190,539,876 ,4 ,880 ,1501 ,0,3,1,3,0,1,0,76.14,58.63,33.33
01,000,01,006,0191,540,969 ,0 ,969 ,1528 ,0,3,1,3,0,1,0,76.14,63.42,33.33
01,000,01,006,0191,541,952 ,0 ,952 ,1535 ,0,3,1,3,0,1,0,76.14,62.02,33.33
01,000,01,006,0191,542,932 ,4 ,936 ,1514 ,0,3,1,3,0,1,0,76.14,61.82,33.33
01,000,01,006,0191,543,944 ,3 ,947 ,1624 ,0,3,1,3,0,1,0,76.14,58.31,33.33
01,000,01,006,0192,544,863 ,10 ,873 ,1511 ,0,3,1,3,0,1,0,76.14,57.78,33.33
01,000,01,006,0192,545,898 ,3 ,901 ,1410 ,0,3,1,3,0,1,0,76.14,63.9,33.33
01,000,01,006,0193,546,744 ,3 ,747 ,1288 ,0,3,1,3,0,1,0,76.14,58,33.33
01,000,01,006,0193,547,763 ,6 ,769 ,1280 ,0,3,1,3,0,1,0,76.14,60.08,33.33
01,000,01,006,0193,548,884 ,6 ,890 ,1478 ,0,3,1,3,0,1,0,76.14,60.22,33.33
01,000,01,006,0194,549,930 ,4 ,934 ,1534 ,0,3,1,3,0,1,0,76.14,60.89,33.33
01,000,01,006,0194,550,930 ,4 ,934 ,1561 ,0,3,1,3,0,1,0,76.14,59.83,33.33
01,000,01,006,0195,551,911 ,6 ,917 ,1465 ,0,3,1,3,0,1,0,76.14,62.59,33.33
01,000,01,006,0195,552,892 ,5 ,897 ,1403 ,0,3,1,3,0,1,0,76.14,63.93,33.33
01,000,01,006,0195,553,902 ,7 ,909 ,1399 ,0,3,1,3,0,1,0,76.14,64.97,33.33
01,000,01,006,0196,554,660 ,4 ,664 ,1221 ,0,3,1,3,0,1,0,76.14,54.38,33.33
01,000,01,006,0196,555,700 ,4 ,704 ,1245 ,0,3,1,3,0,1,0,76.14,56.55,33.33
01,000,01,006,0196,556,756 ,6 ,762 ,1299 ,0,3,1,3,0,1,0,76.14,58.66,33.33
01,000,01,006,0197,557,1081 ,8 ,1089 ,1842 ,0,3,1,3,0,1,0,76.14,59.12,33.33
01,000,01,006,0197,558,1074 ,6 ,1080 ,1731 ,0,3,1,3,0,1,0,76.14,62.39,33.33
01,000,01,006,0198,559,891 ,4 ,895 ,1493 ,0,3,1,3,0,1,0,76.14,59.95,33.33
01,000,01,006,0198,560,996 ,4 ,1000 ,1598 ,0,3,1,3,0,1,0,76.14,62.58,33.33
01,000,01,006,0198,561,993 ,8 ,1001 ,1533 ,0,3,1,3,0,1,0,76.14,65.3,33.33
01,000,01,006,0199,562,952 ,8 ,960 ,1606 ,0,3,1,3,0,1,0,76.14,59.78,33.33
01,000,01,006,0199,563,937 ,7 ,944 ,1582 ,0,3,1,3,0,1,0,76.14,59.67,33.33
01,000,01,006,0199,564,809 ,4 ,813 ,1401 ,0,3,1,3,0,1,0,76.14,58.03,33.33
01,000,01,006,0200,565,872 ,5 ,877 ,1478 ,0,3,1,3,0,1,0,76.14,59.34,33.33
01,000,01,006,0200,566,937 ,3 ,940 ,1495 ,0,3,1,3,0,1,0,76.14,62.88,33.33
01,000,01,006,0200,567,797 ,6 ,803 ,1390 ,0,3,1,3,0,1,0,76.14,57.77,33.33
01,000,01,006,0201,568,1034 ,7 ,1041 ,1605 ,0,3,1,3,0,1,0,76.14,64.86,33.33
01,000,01,006,0201,569,900 ,3 ,903 ,1463 ,0,3,1,3,0,1,0,76.14,61.72,33.33
01,000,01,006,0202,570,999 ,4 ,1003 ,1567 ,0,3,1,3,0,1,0,76.14,64.01,33.33
01,000,01,006,0202,571,876 ,4 ,880 ,1447 ,0,3,1,3,0,1,0,76.14,60.82,33.33
01,000,01,006,0202,572,853 ,3 ,856 ,1304 ,0,3,1,3,0,1,0,76.14,65.64,33.33
01,000,01,006,0202,573,877 ,8 ,885 ,1418 ,0,3,1,3,0,1,0,76.14,62.41,33.33
01,000,01,006,0203,574,686 ,3 ,689 ,1138 ,0,3,1,3,0,1,0,76.14,60.54,33.33
01,000,01,006,0203,575,494 ,7 ,501 ,929 ,0,3,1,3,0,1,0,76.14,53.93,33.33
01,000,01,006,0204,576,974 ,8 ,982 ,1688 ,0,3,1,3,0,1,0,76.14,58.18,33.33
01,000,01,006,0204,577,1068 ,2 ,1070 ,1803 ,0,3,1,3,0,1,0,76.14,59.35,33.33
01,000,01,006,0204,578,1085 ,2 ,1087 ,1815 ,0,3,1,3,0,1,0,76.14,59.89,33.33
01,000,01,006,0205,579,863 ,1 ,864 ,1455 ,0,3,1,3,0,1,0,76.14,59.38,33.33
01,000,01,006,0205,580,989 ,3 ,992 ,1606 ,0,3,1,3,0,1,0,76.14,61.77,33.33
01,000,01,006,0205,581,855 ,2 ,857 ,1395 ,0,3,1,3,0,1,0,76.14,61.43,33.33
01,000,01,006,0206,582,720 ,4 ,724 ,1148 ,0,3,1,3,0,1,0,76.14,63.07,33.33
01,000,01,006,0206,583,722 ,6 ,728 ,1206 ,0,3,1,3,0,1,0,76.14,60.36,33.33
01,000,01,006,0206,584,870 ,1 ,871 ,1412 ,0,3,1,3,0,1,0,76.14,61.69,33.33
01,000,01,006,0207,585,956 ,4 ,960 ,1591 ,0,3,1,3,0,1,0,76.14,60.34,33.33
01,000,01,006,0207,586,1050 ,4 ,1054 ,1694 ,0,3,1,3,0,1,0,76.14,62.22,33.33
01,000,01,006,0207,587,960 ,5 ,965 ,1515 ,0,3,1,3,0,1,0,76.14,63.7,33.33
01,000,01,006,0207,588,1067 ,9 ,1076 ,1688 ,0,3,1,3,0,1,0,76.14,63.74,33.33
01,000,01,006,0208,589,1064 ,10 ,1074 ,1784 ,0,3,1,3,0,1,0,76.14,60.2,33.33
01,000,01,006,0208,590,1220 ,2 ,1222 ,1903 ,0,3,1,3,0,1,0,76.14,64.21,33.33
01,000,01,006,0208,591,998 ,3 ,1001 ,1698 ,0,3,1,3,0,1,0,76.14,58.95,33.33
01,000,01,006,0209,592,860 ,17 ,877 ,1464 ,0,3,1,3,0,1,0,76.14,59.9,33.33
01,000,01,006,0209,593,946 ,6 ,952 ,1486 ,0,3,1,3,0,1,0,76.14,64.06,33.33
01,000,01,006,0209,594,955 ,5 ,960 ,1471 ,0,3,1,3,0,1,0,76.14,65.26,33.33
01,000,01,006,0210,595,857 ,5 ,862 ,1379 ,0,3,1,3,0,1,0,76.14,62.51,33.33
01,000,01,006,0210,596,887 ,4 ,891 ,1386 ,0,3,1,3,0,1,0,76.14,64.29,33.33
01,000,01,006,0210,597,762 ,7 ,769 ,1277 ,0,3,1,3,0,1,0,76.14,60.22,33.33
01,000,01,006,0211,598,1124 ,5 ,1129 ,1783 ,0,3,1,3,0,1,0,76.14,63.32,33.33
01,000,01,006,0211,599,1100 ,2 ,1102 ,1779 ,0,3,1,3,0,1,0,76.14,61.94,33.33
01,000,01,006,0211,600,1214 ,9 ,1223 ,1897 ,0,3,1,3,0,1,0,76.14,64.47,33.33
01,000,01,006,0212,601,954 ,2 ,956 ,1456 ,0,3,1,3,0,1,0,76.14,65.66,33.33
01,000,01,006,0212,602,886 ,5 ,891 ,1431 ,0,3,1,3,0,1,0,76.14,62.26,33.33
01,000,01,006,0212,603,1000 ,8 ,1008 ,1616 ,0,3,1,3,0,1,0,76.14,62.38,33.33
01,000,01,006,0212,604,1038 ,3 ,1041 ,1602 ,0,3,1,3,0,1,0,76.14,64.98,33.33
01,000,01,006,0212,605,866 ,10 ,876 ,1450 ,0,3,1,3,0,1,0,76.14,60.41,33.33
01,000,01,006,0213,606,810 ,2 ,812 ,1264 ,0,3,1,3,0,1,0,76.14,64.24,33.33
01,000,01,006,0213,607,845 ,3 ,848 ,1438 ,0,3,1,3,0,1,0,76.14,58.97,33.33
01,000,01,006,0213,608,844 ,1 ,845 ,1400 ,0,3,1,3,0,1,0,76.14,60.36,33.33
01,000,01,006,0214,609,854 ,3 ,857 ,1321 ,0,3,1,3,0,1,0,76.14,64.88,33.33
01,000,01,006,0214,610,893 ,0 ,893 ,1451 ,0,3,1,3,0,1,0,76.14,61.54,33.33
01,000,01,006,0214,611,815 ,6 ,821 ,1375 ,0,3,1,3,0,1,0,76.14,59.71,33.33
01,000,01,006,0214,612,730 ,1 ,731 ,1302 ,0,3,1,3,0,1,0,76.14,56.14,33.33
01,000,01,006,0215,613,834 ,5 ,839 ,1547 ,0,3,1,3,0,1,0,76.14,54.23,33.33
01,000,01,006,0215,614,923 ,9 ,932 ,1536 ,0,3,1,3,0,1,0,76.14,60.68,33.33
01,000,01,006,0215,615,1054 ,5 ,1059 ,1710 ,0,3,1,3,0,1,0,76.14,61.93,33.33
01,000,01,006,0215,616,1043 ,3 ,1046 ,1743 ,0,3,1,3,0,1,0,76.14,60.01,33.33
01,000,01,006,0216,617,723 ,1 ,724 ,1250 ,0,3,1,3,0,1,0,76.14,57.92,33.33
01,000,01,006,0216,618,877 ,5 ,882 ,1363 ,0,3,1,3,0,1,0,76.14,64.71,33.33
01,000,01,006,0216,619,824 ,7 ,831 ,1338 ,0,3,1,3,0,1,0,76.14,62.11,33.33
01,000,01,006,0217,620,635 ,5 ,640 ,1067 ,0,3,1,3,0,1,0,76.14,59.98,33.33
01,000,01,006,0217,621,781 ,7 ,788 ,1271 ,0,3,1,3,0,1,0,76.14,62,33.33
01,000,01,006,0217,622,883 ,6 ,889 ,1349 ,0,3,1,3,0,1,0,76.14,65.9,33.33
01,000,01,006,0218,623,930 ,7 ,937 ,1512 ,0,3,1,3,0,1,0,76.14,61.97,33.33
01,000,01,006,0218,624,944 ,4 ,948 ,1464 ,0,3,1,3,0,1,0,76.14,64.75,33.33
01,000,01,006,0218,625,873 ,4 ,877 ,1459 ,0,3,1,3,0,1,0,76.14,60.11,33.33
01,000,01,006,0218,626,976 ,6 ,982 ,1537 ,0,3,1,3,0,1,0,76.14,63.89,33.33
01,000,01,006,0219,627,864 ,1 ,865 ,1404 ,0,3,1,3,0,1,0,76.14,61.61,33.33
01,000,01,006,0219,628,769 ,4 ,773 ,1262 ,0,3,1,3,0,1,0,76.14,61.25,33.33
01,000,01,006,0220,629,1069 ,4 ,1073 ,1859 ,0,3,1,3,0,1,0,76.14,57.72,33.33
01,000,01,006,0220,630,1102 ,5 ,1107 ,1683 ,0,3,1,3,0,1,0,76.14,65.78,33.33
01,000,01,006,0221,631,1021 ,6 ,1027 ,1585 ,0,3,1,3,0,1,0,76.14,64.79,33.33
01,000,01,006,0221,632,806 ,1 ,807 ,1300 ,0,3,1,3,0,1,0,76.14,62.08,33.33
01,000,01,006,0221,633,811 ,4 ,815 ,1330 ,0,3,1,3,0,1,0,76.14,61.28,33.33
01,000,01,006,0221,634,845 ,6 ,851 ,1447 ,0,3,1,3,0,1,0,76.14,58.81,33.33
01,000,01,006,0222,635,891 ,2 ,893 ,1410 ,0,3,1,3,0,1,0,76.14,63.33,33.33
01,000,01,006,0222,636,830 ,0 ,830 ,1370 ,0,3,1,3,0,1,0,76.14,60.58,33.33
01,000,01,006,0222,637,818 ,8 ,826 ,1259 ,0,3,1,3,0,1,0,76.14,65.61,33.33
01,000,01,006,0223,638,642 ,5 ,647 ,983 ,0,3,1,3,0,1,0,76.14,65.82,33.33
01,000,01,006,0223,639,766 ,4 ,770 ,1257 ,0,3,1,3,0,1,0,76.14,61.26,33.33
01,000,02,007,0224,640,825 ,7 ,832 ,1428 ,0,3,1,3,0,1,0,76.14,58.26 ,33.33
01,000,02,007,0224,641,650 ,8 ,658 ,1011 ,0,3,1,3,0,1,0,76.14,65.08 ,33.33
01,000,02,007,0225,642,1026 ,12 ,1038 ,1995 ,0,3,1,3,0,1,0,76.14,52.03 ,33.33
01,000,02,007,0225,643,886 ,10 ,896 ,1651 ,0,3,1,3,0,1,0,76.14,54.27 ,33.33
01,000,02,007,0226,644,574 ,3 ,577 ,947 ,0,3,1,3,0,1,0,76.14,60.93 ,33.33
01,000,02,007,0226,645,890 ,5 ,895 ,1645 ,0,3,1,3,0,1,0,76.14,54.41 ,33.33
01,000,02,007,0227,646,1099 ,3 ,1102 ,1791 ,0,3,1,3,0,1,0,76.14,61.53 ,33.33
01,000,02,007,0227,647,1311 ,6 ,1317 ,2281 ,0,3,1,3,0,1,0,76.14,57.74 ,33.33
01,000,02,007,0228,648,975 ,9 ,984 ,1869 ,0,3,1,3,0,1,0,76.14,52.65 ,33.33
01,000,02,007,0229,649,763 ,2 ,765 ,1403 ,0,3,1,3,0,1,0,76.14,54.53 ,33.33
01,000,02,007,0229,650,743 ,6 ,749 ,1462 ,0,3,1,3,0,1,0,76.14,51.23 ,33.33
01,000,02,007,0229,651,813 ,4 ,817 ,1415 ,0,3,1,3,0,1,0,76.14,57.74 ,33.33
01,000,02,007,0230,652,709 ,4 ,713 ,1414 ,0,3,1,3,0,1,0,76.14,50.42 ,33.33
01,000,02,007,0230,653,674 ,8 ,682 ,1397 ,0,3,1,3,0,1,0,76.14,48.82 ,33.33
01,000,02,007,0231,654,1096 ,6 ,1102 ,1815 ,0,3,1,3,0,1,0,76.14,60.72 ,33.33
01,000,02,007,0231,655,946 ,9 ,955 ,1629 ,0,3,1,3,0,1,0,76.14,58.62 ,33.33
01,000,02,007,0231,656,761 ,3 ,764 ,1330 ,0,3,1,3,0,1,0,76.14,57.44 ,33.33
01,000,02,007,0232,657,910 ,7 ,917 ,1556 ,0,3,1,3,0,1,0,76.14,58.93 ,33.33
01,000,02,007,0232,658,861 ,4 ,865 ,1535 ,0,3,1,3,0,1,0,76.14,56.35 ,33.33
01,000,02,007,0233,659,865 ,11 ,876 ,1504 ,0,3,1,3,0,1,0,76.14,58.24 ,33.33
01,000,02,007,0233,660,616 ,2 ,618 ,1160 ,0,3,1,3,0,1,0,76.14,53.28 ,33.33
01,000,02,007,0234,661,984 ,12 ,996 ,1967 ,0,3,1,3,0,1,0,76.14,50.64 ,33.33
01,000,02,007,0234,662,795 ,4 ,799 ,1539 ,0,3,1,3,0,1,0,76.14,51.92 ,33.33
01,000,02,007,0235,663,982 ,8 ,990 ,1857 ,0,3,1,3,0,1,0,76.14,53.31 ,33.33
01,000,02,007,0235,664,678 ,7 ,685 ,1222 ,0,3,1,3,0,1,0,76.14,56.06 ,33.33
01,000,02,007,0236,665,1151 ,5 ,1156 ,2092 ,0,3,1,3,0,1,0,76.14,55.26 ,33.33
01,000,02,007,0236,666,1164 ,6 ,1170 ,1866 ,0,3,1,3,0,1,0,76.14,62.70 ,33.33
01,000,02,007,0237,667,997 ,7 ,1004 ,1481 ,0,3,1,3,0,1,0,76.14,67.79 ,33.33
01,000,02,007,0237,668,1123 ,5 ,1128 ,1639 ,0,3,1,3,0,1,0,76.14,68.82 ,33.33
01,000,02,007,0238,669,1214 ,5 ,1219 ,1951 ,0,3,1,3,0,1,0,76.14,62.48 ,33.33
01,000,02,007,0238,670,1270 ,12 ,1282 ,1996 ,0,3,1,3,0,1,0,76.14,64.23 ,33.33
01,000,02,007,0238,671,1257 ,5 ,1262 ,1961 ,0,3,1,3,0,1,0,76.14,64.35 ,33.33
01,000,02,007,0238,672,1073 ,3 ,1076 ,1708 ,0,3,1,3,0,1,0,76.14,63.00 ,33.33
01,000,02,007,0239,673,761 ,4 ,765 ,1237 ,0,3,1,3,0,1,0,76.14,61.84 ,33.33
01,000,02,007,0239,674,881 ,6 ,887 ,1396 ,0,3,1,3,0,1,0,76.14,63.54 ,33.33
01,000,02,007,0240,675,1143 ,4 ,1147 ,1796 ,0,3,1,3,0,1,0,76.14,63.86 ,33.33
01,000,02,007,0240,676,975 ,4 ,979 ,1588 ,0,3,1,3,0,1,0,76.14,61.65 ,33.33
01,000,02,007,0240,677,809 ,3 ,812 ,1364 ,0,3,1,3,0,1,0,76.14,59.53 ,33.33
01,000,02,007,0240,678,1173 ,5 ,1178 ,1884 ,0,3,1,3,0,1,0,76.14,62.53 ,33.33
01,000,02,007,0241,679,599 ,4 ,603 ,944 ,0,3,1,3,0,1,0,76.14,63.88 ,33.33
01,000,02,007,0242,680,1205 ,7 ,1212 ,1937 ,0,3,1,3,0,1,0,76.14,62.57 ,33.33
01,000,02,007,0242,681,1195 ,6 ,1201 ,2090 ,0,3,1,3,0,1,0,76.14,57.46 ,33.33
01,000,02,007,0243,682,1293 ,6 ,1299 ,2156 ,0,3,1,3,0,1,0,76.14,60.25 ,33.33
01,000,02,007,0243,683,1121 ,9 ,1130 ,1950 ,0,3,1,3,0,1,0,76.14,57.95 ,33.33
01,000,02,007,0244,684,1112 ,14 ,1126 ,1771 ,0,3,1,3,0,1,0,76.14,63.58 ,33.33
01,000,02,007,0244,685,1134 ,7 ,1141 ,1867 ,0,3,1,3,0,1,0,76.14,61.11 ,33.33
01,000,02,007,0244,686,842 ,3 ,845 ,1379 ,0,3,1,3,0,1,0,76.14,61.28 ,33.33
01,000,02,007,0245,687,1291 ,13 ,1304 ,2150 ,0,3,1,3,0,1,0,76.14,60.65 ,33.33
01,000,02,007,0245,688,1052 ,11 ,1063 ,1820 ,0,3,1,3,0,1,0,76.14,58.41 ,33.33
01,000,02,007,0246,689,957 ,2 ,959 ,1584 ,0,3,1,3,0,1,0,76.14,60.54 ,33.33
01,000,02,007,0246,690,923 ,4 ,927 ,1490 ,0,3,1,3,0,1,0,76.14,62.21 ,33.33
01,000,02,007,0246,691,807 ,4 ,811 ,1413 ,0,3,1,3,0,1,0,76.14,57.40 ,33.33
01,000,02,007,0247,692,852 ,4 ,856 ,2609 ,0,3,1,3,0,1,0,76.14,32.81 ,33.33
01,000,02,007,0247,693,987 ,6 ,993 ,1672 ,0,3,1,3,0,1,0,76.14,59.39 ,33.33
01,000,02,007,0247,694,864 ,10 ,874 ,1420 ,0,3,1,3,0,1,0,76.14,61.55 ,33.33
01,000,02,007,0248,695,1095 ,6 ,1101 ,1791 ,0,3,1,3,0,1,0,76.14,61.47 ,33.33
01,000,02,007,0248,696,1038 ,4 ,1042 ,1737 ,0,3,1,3,0,1,0,76.14,59.99 ,33.33
01,000,02,007,0248,697,998 ,7 ,1005 ,1570 ,0,3,1,3,0,1,0,76.14,64.01 ,33.33
01,000,02,007,0248,698,881 ,9 ,890 ,1491 ,0,3,1,3,0,1,0,76.14,59.69 ,33.33
01,000,02,007,0249,699,1024 ,1 ,1025 ,1644 ,0,3,1,3,0,1,0,76.14,62.35 ,33.33
01,000,02,007,0249,700,1025 ,10 ,1035 ,1738 ,0,3,1,3,0,1,0,76.14,59.55 ,33.33
01,000,02,007,0250,701,1242 ,2 ,1244 ,1998 ,0,3,1,3,0,1,0,76.14,62.26 ,33.33
01,000,02,007,0250,702,1196 ,6 ,1202 ,2031 ,0,3,1,3,0,1,0,76.14,59.18 ,33.33
01,000,02,007,0250,703,1094 ,12 ,1106 ,1946 ,0,3,1,3,0,1,0,76.14,56.83 ,33.33
01,000,02,007,0251,704,1138 ,7 ,1145 ,1883 ,0,3,1,3,0,1,0,76.14,60.81 ,33.33
01,000,02,007,0251,705,1084 ,3 ,1087 ,1802 ,0,3,1,3,0,1,0,76.14,60.32 ,33.33
01,000,02,007,0251,706,1075 ,5 ,1080 ,1803 ,0,3,1,3,0,1,0,76.14,59.90 ,33.33
01,000,02,007,0252,707,923 ,1 ,924 ,1479 ,0,3,1,3,0,1,0,76.14,62.47 ,33.33
01,000,02,007,0252,708,1040 ,5 ,1045 ,1709 ,0,3,1,3,0,1,0,76.14,61.15 ,33.33
01,000,02,007,0252,709,1007 ,6 ,1013 ,1655 ,0,3,1,3,0,1,0,76.14,61.21 ,33.33
01,000,02,007,0252,710,891 ,2 ,893 ,1441 ,0,3,1,3,0,1,0,76.14,61.97 ,33.33
01,000,02,007,0253,711,1345 ,3 ,1348 ,2165 ,0,3,1,3,0,1,0,76.14,62.26 ,33.33
01,000,02,007,0253,712,1137 ,3 ,1140 ,1907 ,0,3,1,3,0,1,0,76.14,59.78 ,33.33
01,000,02,007,0254,713,1146 ,5 ,1151 ,1902 ,0,3,1,3,0,1,0,76.14,60.52 ,33.33
01,000,02,007,0254,714,1133 ,12 ,1145 ,1958 ,0,3,1,3,0,1,0,76.14,58.48 ,33.33
01,000,02,007,0255,715,1165 ,4 ,1169 ,1945 ,0,3,1,3,0,1,0,76.14,60.10 ,33.33
01,000,02,007,0255,716,1278 ,5 ,1283 ,2169 ,0,3,1,3,0,1,0,76.14,59.15 ,33.33
01,000,02,007,0256,717,911 ,3 ,914 ,1480 ,0,3,1,3,0,1,0,76.14,61.76 ,33.33
01,000,02,007,0256,718,838 ,7 ,845 ,1368 ,0,3,1,3,0,1,0,76.14,61.77 ,33.33
01,000,02,007,0257,719,992 ,9 ,1001 ,1638 ,0,3,1,3,0,1,0,76.14,61.11 ,33.33
01,000,02,007,0257,720,992 ,6 ,998 ,1621 ,0,3,1,3,0,1,0,76.14,61.57 ,33.33
01,000,02,007,0257,721,1041 ,6 ,1047 ,1694 ,0,3,1,3,0,1,0,76.14,61.81 ,33.33
01,000,02,007,0258,722,931 ,3 ,934 ,1428 ,0,3,1,3,0,1,0,76.14,65.41 ,33.33
01,000,02,007,0258,723,1069 ,6 ,1075 ,1541 ,0,3,1,3,0,1,0,76.14,69.76 ,33.33
01,000,02,007,0258,724,875 ,7 ,882 ,1282 ,0,3,1,3,0,1,0,76.14,68.80 ,33.33
01,000,02,007,0259,725,1087 ,4 ,1091 ,1716 ,0,3,1,3,0,1,0,76.14,63.58 ,33.33
01,000,02,007,0259,726,1070 ,10 ,1080 ,1828 ,0,3,1,3,0,1,0,76.14,59.08 ,33.33
01,000,02,007,0260,727,955 ,5 ,960 ,1543 ,0,3,1,3,0,1,0,76.14,62.22 ,33.33
01,000,02,007,0260,728,1069 ,8 ,1077 ,1741 ,0,3,1,3,0,1,0,76.14,61.86 ,33.33
01,000,02,007,0261,729,757 ,3 ,760 ,1357 ,0,3,1,3,0,1,0,76.14,56.01 ,33.33
01,000,02,007,0261,730,738 ,3 ,741 ,1206 ,0,3,1,3,0,1,0,76.14,61.44 ,33.33
01,000,02,007,0262,731,1127 ,12 ,1139 ,1812 ,0,3,1,3,0,1,0,76.14,62.86 ,33.33
01,000,02,007,0262,732,848 ,4 ,852 ,1509 ,0,3,1,3,0,1,0,76.14,56.46 ,33.33
01,000,02,007,0262,733,903 ,2 ,905 ,1454 ,0,3,1,3,0,1,0,76.14,62.24 ,33.33
01,000,02,007,0263,734,1006 ,5 ,1011 ,1660 ,0,3,1,3,0,1,0,76.14,60.90 ,33.33
01,000,02,007,0263,735,913 ,5 ,918 ,1554 ,0,3,1,3,0,1,0,76.14,59.07 ,33.33
01,000,02,007,0264,736,884 ,8 ,892 ,1449 ,0,3,1,3,0,1,0,76.14,61.56 ,33.33
01,000,02,007,0264,737,876 ,4 ,880 ,1439 ,0,3,1,3,0,1,0,76.14,61.15 ,33.33
01,000,02,007,0264,738,845 ,5 ,850 ,1402 ,0,3,1,3,0,1,0,76.14,60.63 ,33.33
01,000,02,007,0265,739,925 ,3 ,928 ,1387 ,0,3,1,3,0,1,0,76.14,66.91 ,33.33
01,000,02,007,0265,740,610 ,5 ,615 ,956 ,0,3,1,3,0,1,0,76.14,64.33 ,33.33
01,000,02,008,0266,741,980 ,7 ,987 ,1668 ,0,3,1,3,0,1,0,76.14,59.17 ,33.33
01,000,02,008,0266,742,667 ,8 ,675 ,1198 ,0,3,1,3,0,1,0,76.14,56.34 ,33.33
01,000,02,008,0267,743,821 ,6 ,827 ,1380 ,0,3,1,3,0,1,0,76.14,59.93 ,33.33
01,000,02,008,0267,744,857 ,4 ,861 ,1415 ,0,3,1,3,0,1,0,76.14,60.85 ,33.33
01,000,02,008,0268,745,1223 ,9 ,1232 ,1966 ,0,3,1,3,0,1,0,76.14,62.67 ,33.33
01,000,02,008,0268,746,1004 ,6 ,1010 ,1901 ,0,3,1,3,0,1,0,76.14,53.13 ,33.33
01,000,02,008,0269,747,916 ,4 ,920 ,1498 ,0,3,1,3,0,1,0,76.14,61.42 ,33.33
01,000,02,008,0269,748,885 ,7 ,892 ,1502 ,0,3,1,3,0,1,0,76.14,59.39 ,33.33
01,000,02,008,0270,749,885 ,4 ,889 ,1572 ,0,3,1,3,0,1,0,76.14,56.55 ,33.33
01,000,02,008,0270,750,806 ,6 ,812 ,1306 ,0,3,1,3,0,1,0,76.14,62.17 ,33.33
01,000,02,008,0270,751,831 ,9 ,840 ,1376 ,0,3,1,3,0,1,0,76.14,61.05 ,33.33
01,000,02,008,0271,752,969 ,7 ,976 ,1698 ,0,3,1,3,0,1,0,76.14,57.48 ,33.33
01,000,02,008,0271,753,942 ,6 ,948 ,1606 ,0,3,1,3,0,1,0,76.14,59.03 ,33.33
01,000,02,008,0272,754,742 ,5 ,747 ,1342 ,0,3,1,3,0,1,0,76.14,55.66 ,33.33
01,000,02,008,0272,755,751 ,2 ,753 ,1269 ,0,3,1,3,0,1,0,76.14,59.34 ,33.33
01,000,02,008,0272,756,764 ,6 ,770 ,1355 ,0,3,1,3,0,1,0,76.14,56.83 ,33.33
01,000,02,008,0273,757,770 ,5 ,775 ,1294 ,0,3,1,3,0,1,0,76.14,59.89 ,33.33
01,000,02,008,0273,758,839 ,8 ,847 ,1332 ,0,3,1,3,0,1,0,76.14,63.59 ,33.33
01,000,02,008,0273,759,1021 ,10 ,1031 ,1572 ,0,3,1,3,0,1,0,76.14,65.59 ,33.33
01,000,02,008,0274,760,782 ,5 ,787 ,1299 ,0,3,1,3,0,1,0,76.14,60.59 ,33.33
01,000,02,008,0274,761,871 ,7 ,878 ,1442 ,0,3,1,3,0,1,0,76.14,60.89 ,33.33
01,000,02,008,0274,762,812 ,4 ,816 ,1292 ,0,3,1,3,0,1,0,76.14,63.16 ,33.33
01,000,02,008,0275,763,965 ,10 ,975 ,1636 ,0,3,1,3,0,1,0,76.14,59.60 ,33.33
01,000,02,008,0275,764,893 ,5 ,898 ,1559 ,0,3,1,3,0,1,0,76.14,57.60 ,33.33
01,000,02,008,0276,765,983 ,3 ,986 ,1509 ,0,3,1,3,0,1,0,76.14,65.34 ,33.33
01,000,02,008,0276,766,924 ,7 ,931 ,1590 ,0,3,1,3,0,1,0,76.14,58.55 ,33.33
01,000,02,008,0276,767,886 ,6 ,892 ,1505 ,0,3,1,3,0,1,0,76.14,59.27 ,33.33
01,000,02,008,0276,768,880 ,7 ,887 ,1537 ,0,3,1,3,0,1,0,76.14,57.71 ,33.33
01,000,02,008,0276,769,868 ,4 ,872 ,1479 ,0,3,1,3,0,1,0,76.14,58.96 ,33.33
01,000,02,008,0277,770,943 ,6 ,949 ,1632 ,0,3,1,3,0,1,0,76.14,58.15 ,33.33
01,000,02,008,0277,771,970 ,13 ,983 ,1695 ,0,3,1,3,0,1,0,76.14,57.99 ,33.33
01,000,02,008,0278,772,1081 ,7 ,1088 ,1774 ,0,3,1,3,0,1,0,76.14,61.33 ,33.33
01,000,02,008,0278,773,1058 ,11 ,1069 ,1719 ,0,3,1,3,0,1,0,76.14,62.19 ,33.33
01,000,02,008,0278,774,978 ,9 ,987 ,1628 ,0,3,1,3,0,1,0,76.14,60.63 ,33.33
01,000,02,008,0279,775,715 ,9 ,724 ,1187 ,0,3,1,3,0,1,0,76.14,60.99 ,33.33
01,000,02,008,0279,776,727 ,6 ,733 ,1164 ,0,3,1,3,0,1,0,76.14,62.97 ,33.33
01,000,02,008,0280,777,835 ,4 ,839 ,1413 ,0,3,1,3,0,1,0,76.14,59.38 ,33.33
01,000,02,008,0280,778,779 ,7 ,786 ,1276 ,0,3,1,3,0,1,0,76.14,61.60 ,33.33
01,000,02,008,0281,779,738 ,3 ,741 ,1249 ,0,3,1,3,0,1,0,76.14,59.33 ,33.33
01,000,02,008,0281,780,736 ,11 ,747 ,1242 ,0,3,1,3,0,1,0,76.14,60.14 ,33.33
01,000,02,008,0281,781,790 ,10 ,800 ,1348 ,0,3,1,3,0,1,0,76.14,59.35 ,33.33
01,000,02,008,0282,782,696 ,3 ,699 ,1145 ,0,3,1,3,0,1,0,76.14,61.05 ,33.33
01,000,02,008,0282,783,912 ,8 ,920 ,1492 ,0,3,1,3,0,1,0,76.14,61.66 ,33.33
01,000,02,008,0283,784,956 ,3 ,959 ,1522 ,0,3,1,3,0,1,0,76.14,63.01 ,33.33
01,000,02,008,0283,785,883 ,4 ,887 ,1567 ,0,3,1,3,0,1,0,76.14,56.60 ,33.33
01,000,02,008,0284,786,840 ,5 ,845 ,1308 ,0,3,1,3,0,1,0,76.14,64.60 ,33.33
01,000,02,008,0284,787,781 ,8 ,789 ,1757 ,0,3,1,3,0,1,0,76.14,44.91 ,33.33
01,000,02,008,0285,788,826 ,15 ,841 ,1541 ,0,3,1,3,0,1,0,76.14,54.57 ,33.33
01,000,02,008,0285,789,1029 ,6 ,1035 ,1647 ,0,3,1,3,0,1,0,76.14,62.84 ,33.33
01,000,02,008,0285,790,757 ,6 ,763 ,1263 ,0,3,1,3,0,1,0,76.14,60.41 ,33.33
01,000,02,008,0286,791,1134 ,8 ,1142 ,1827 ,0,3,1,3,0,1,0,76.14,62.51 ,33.33
01,000,02,008,0286,792,1040 ,7 ,1047 ,1701 ,0,3,1,3,0,1,0,76.14,61.55 ,33.33
01,000,02,008,0286,793,1046 ,10 ,1056 ,1710 ,0,3,1,3,0,1,0,76.14,61.75 ,33.33
01,000,02,008,0287,794,983 ,7 ,990 ,1564 ,0,3,1,3,0,1,0,76.14,63.30 ,33.33
01,000,02,008,0287,795,1019 ,2 ,1021 ,1601 ,0,3,1,3,0,1,0,76.14,63.77 ,33.33
01,000,02,008,0287,796,983 ,8 ,991 ,1539 ,0,3,1,3,0,1,0,76.14,64.39 ,33.33
01,000,02,008,0287,797,935 ,8 ,943 ,1532 ,0,3,1,3,0,1,0,76.14,61.55 ,33.33
01,000,02,008,0288,798,958 ,4 ,962 ,1626 ,0,3,1,3,0,1,0,76.14,59.16 ,33.33
01,000,02,008,0288,799,924 ,4 ,928 ,1504 ,0,3,1,3,0,1,0,76.14,61.70 ,33.33
01,000,02,008,0288,800,1006 ,8 ,1014 ,1624 ,0,3,1,3,0,1,0,76.14,62.44 ,33.33
01,000,02,008,0289,801,1006 ,8 ,1014 ,1625 ,0,3,1,3,0,1,0,76.14,62.40 ,33.33
01,000,02,008,0289,802,933 ,5 ,938 ,1467 ,0,3,1,3,0,1,0,76.14,63.94 ,33.33
01,000,02,008,0289,803,1027 ,4 ,1031 ,1569 ,0,3,1,3,0,1,0,76.14,65.71 ,33.33
01,000,02,008,0290,804,1063 ,9 ,1072 ,1658 ,0,3,1,3,0,1,0,76.14,64.66 ,33.33
01,000,02,008,0290,805,1224 ,5 ,1229 ,1968 ,0,3,1,3,0,1,0,76.14,62.45 ,33.33
01,000,02,009,0291,806,886 ,6 ,892 ,1434 ,0,3,1,3,0,1,0,76.14,62.20 ,33.33
01,000,02,009,0291,807,668 ,5 ,673 ,1102 ,0,3,1,3,0,1,0,76.14,61.07 ,33.33
01,000,02,009,0292,808,769 ,6 ,775 ,1287 ,0,3,1,3,0,1,0,76.14,60.22 ,33.33
01,000,02,009,0292,809,790 ,7 ,797 ,1198 ,0,3,1,3,0,1,0,76.14,66.53 ,33.33
01,000,02,009,0293,810,742 ,5 ,747 ,1095 ,0,3,1,3,0,1,0,76.14,68.22 ,33.33
01,000,02,009,0293,811,712 ,2 ,714 ,1145 ,0,3,1,3,0,1,0,76.14,62.36 ,33.33
01,000,02,009,0294,812,830 ,3 ,833 ,1262 ,0,3,1,3,0,1,0,76.14,66.01 ,33.33
01,000,02,009,0294,813,816 ,6 ,822 ,1315 ,0,3,1,3,0,1,0,76.14,62.51 ,33.33
01,000,02,009,0294,814,788 ,5 ,793 ,1369 ,0,3,1,3,0,1,0,76.14,57.93 ,33.33
01,000,02,009,0295,815,816 ,3 ,819 ,1279 ,0,3,1,3,0,1,0,76.14,64.03 ,33.33
01,000,02,009,0295,816,709 ,6 ,715 ,1120 ,0,3,1,3,0,1,0,76.14,63.84 ,33.33
01,000,02,009,0295,817,864 ,5 ,869 ,1409 ,0,3,1,3,0,1,0,76.14,61.67 ,33.33
01,000,02,009,0296,818,1100 ,9 ,1109 ,1666 ,0,3,1,3,0,1,0,76.14,66.57 ,33.33
01,000,02,009,0296,819,1025 ,3 ,1028 ,1558 ,0,3,1,3,0,1,0,76.14,65.98 ,33.33
01,000,02,009,0296,820,906 ,5 ,911 ,1471 ,0,3,1,3,0,1,0,76.14,61.93 ,33.33
01,000,02,009,0297,821,980 ,6 ,986 ,1558 ,0,3,1,3,0,1,0,76.14,63.29 ,33.33
01,000,02,009,0297,822,886 ,4 ,890 ,1445 ,0,3,1,3,0,1,0,76.14,61.59 ,33.33
01,000,02,009,0297,823,896 ,7 ,903 ,1432 ,0,3,1,3,0,1,0,76.14,63.06 ,33.33
01,000,02,009,0298,824,890 ,5 ,895 ,1419 ,0,3,1,3,0,1,0,76.14,63.07 ,33.33
01,000,02,009,0298,825,848 ,2 ,850 ,1389 ,0,3,1,3,0,1,0,76.14,61.20 ,33.33
01,000,02,009,0299,826,1062 ,1 ,1063 ,1535 ,0,3,1,3,0,1,0,76.14,69.25 ,33.33
01,000,02,009,0299,827,851 ,3 ,854 ,1366 ,0,3,1,3,0,1,0,76.14,62.52 ,33.33
01,000,02,009,0299,828,954 ,2 ,956 ,1491 ,0,3,1,3,0,1,0,76.14,64.12 ,33.33
01,000,02,009,0300,829,686 ,6 ,692 ,1130 ,0,3,1,3,0,1,0,76.14,61.24 ,33.33
01,000,02,009,0300,830,814 ,2 ,816 ,1264 ,0,3,1,3,0,1,0,76.14,64.56 ,33.33
01,000,02,009,0300,831,723 ,5 ,728 ,1181 ,0,3,1,3,0,1,0,76.14,61.64 ,33.33
01,000,02,009,0301,832,1072 ,4 ,1076 ,1773 ,0,3,1,3,0,1,0,76.14,60.69 ,33.33
01,000,02,009,0301,833,1069 ,4 ,1073 ,1719 ,0,3,1,3,0,1,0,76.14,62.42 ,33.33
01,000,02,009,0301,834,835 ,3 ,838 ,1449 ,0,3,1,3,0,1,0,76.14,57.83 ,33.33
01,000,02,009,0302,835,952 ,6 ,958 ,1488 ,0,3,1,3,0,1,0,76.14,64.38 ,33.33
01,000,02,009,0302,836,928 ,1 ,929 ,1497 ,0,3,1,3,0,1,0,76.14,62.06 ,33.33
01,000,02,009,0302,837,885 ,3 ,888 ,1394 ,0,3,1,3,0,1,0,76.14,63.70 ,33.33
01,000,02,009,0303,838,1001 ,10 ,1011 ,1653 ,0,3,1,3,0,1,0,76.14,61.16 ,33.33
01,000,02,009,0303,839,856 ,5 ,861 ,1413 ,0,3,1,3,0,1,0,76.14,60.93 ,33.33
01,000,02,009,0304,840,895 ,10 ,905 ,1530 ,0,3,1,3,0,1,0,76.14,59.15 ,33.33
01,000,02,009,0304,841,901 ,8 ,909 ,1453 ,0,3,1,3,0,1,0,76.14,62.56 ,33.33
01,000,02,009,0304,842,800 ,8 ,808 ,1349 ,0,3,1,3,0,1,0,76.14,59.90 ,33.33
01,000,02,009,0304,843,858 ,8 ,866 ,1357 ,0,3,1,3,0,1,0,76.14,63.82 ,33.33
01,000,02,009,0305,844,869 ,6 ,875 ,1437 ,0,3,1,3,0,1,0,76.14,60.89 ,33.33
01,000,02,009,0305,845,919 ,6 ,925 ,1565 ,0,3,1,3,0,1,0,76.14,59.11 ,33.33
01,000,02,009,0306,846,802 ,0 ,802 ,1255 ,0,3,1,3,0,1,0,76.14,63.90 ,33.33
01,000,02,009,0306,847,775 ,3 ,778 ,1214 ,0,3,1,3,0,1,0,76.14,64.09 ,33.33
01,000,02,009,0307,848,741 ,4 ,745 ,1119 ,0,3,1,3,0,1,0,76.14,66.58 ,33.33
01,000,02,009,0307,849,670 ,1 ,671 ,1087 ,0,3,1,3,0,1,0,76.14,61.73 ,33.33
01,000,02,009,0308,850,839 ,2 ,841 ,1443 ,0,3,1,3,0,1,0,76.14,58.28 ,33.33
01,000,02,009,0308,851,847 ,7 ,854 ,1329 ,0,3,1,3,0,1,0,76.14,64.26 ,33.33
01,000,02,009,0309,852,1087 ,7 ,1094 ,1662 ,0,3,1,3,0,1,0,76.14,65.82 ,33.33
01,000,02,009,0309,853,1062 ,4 ,1066 ,1613 ,0,3,1,3,0,1,0,76.14,66.09 ,33.33
01,000,02,009,0309,854,924 ,5 ,929 ,1470 ,0,3,1,3,0,1,0,76.14,63.20 ,33.33
01,000,02,009,0309,855,959 ,5 ,964 ,1483 ,0,3,1,3,0,1,0,76.14,65.00 ,33.33
01,000,02,009,0310,856,1015 ,11 ,1026 ,2224 ,0,3,1,3,0,1,0,76.14,46.13 ,33.33
01,000,02,009,0310,857,967 ,3 ,970 ,1567 ,0,3,1,3,0,1,0,76.14,61.90 ,33.33
01,000,02,009,0310,858,1032 ,7 ,1039 ,1632 ,0,3,1,3,0,1,0,76.14,63.66 ,33.33
01,000,02,009,0311,859,1029 ,8 ,1037 ,1574 ,0,3,1,3,0,1,0,76.14,65.88 ,33.33
01,000,02,009,0311,860,1047 ,8 ,1055 ,1588 ,0,3,1,3,0,1,0,76.14,66.44 ,33.33
01,000,02,009,0311,861,1029 ,9 ,1038 ,1602 ,0,3,1,3,0,1,0,76.14,64.79 ,33.33
01,000,02,009,0311,862,995 ,11 ,1006 ,1555 ,0,3,1,3,0,1,0,76.14,64.69 ,33.33
01,000,02,009,0312,863,644 ,3 ,647 ,1098 ,0,3,1,3,0,1,0,76.14,58.93 ,33.33
01,000,02,009,0313,864,802 ,6 ,808 ,1339 ,0,3,1,3,0,1,0,76.14,60.34,33.33
01,000,02,009,0313,865,935 ,9 ,944 ,1665 ,0,3,1,3,0,1,0,76.14,56.7,33.33
01,000,02,009,0314,866,634 ,4 ,638 ,1228 ,0,3,1,3,0,1,0,76.14,51.95,33.33
01,000,02,009,0314,867,685 ,0 ,685 ,1210 ,0,3,1,3,0,1,0,76.14,56.61,33.33
01,000,02,009,0315,868,877 ,5 ,882 ,1462 ,0,3,1,3,0,1,0,76.14,60.33,33.33
01,000,02,009,0315,869,805 ,3 ,808 ,1323 ,0,3,1,3,0,1,0,76.14,61.07,33.33
01,000,02,009,0316,870,1089 ,5 ,1094 ,1834 ,0,3,1,3,0,1,0,76.14,59.65,33.33
01,000,02,009,0316,871,1121 ,1 ,1122 ,1847 ,0,3,1,3,0,1,0,76.14,60.75,33.33
01,000,02,009,0317,872,1062 ,4 ,1066 ,1703 ,0,3,1,3,0,1,0,76.14,62.6,33.33
01,000,02,009,0317,873,1019 ,3 ,1022 ,1691 ,0,3,1,3,0,1,0,76.14,60.44,33.33
01,000,02,009,0318,874,735 ,3 ,738 ,1152 ,0,3,1,3,0,1,0,76.14,64.06,33.33
01,000,02,009,0318,875,720 ,4 ,724 ,1159 ,0,3,1,3,0,1,0,76.14,62.47,33.33
01,000,02,009,0318,876,726 ,4 ,730 ,1238 ,0,3,1,3,0,1,0,76.14,58.97,33.33
01,000,02,009,0319,877,882 ,3 ,885 ,1420 ,0,3,1,3,0,1,0,76.14,62.32,33.33
01,000,02,009,0319,878,866 ,4 ,870 ,1383 ,0,3,1,3,0,1,0,76.14,62.91,33.33
01,000,02,009,0319,879,842 ,6 ,848 ,1335 ,0,3,1,3,0,1,0,76.14,63.52,33.33
01,000,02,009,0320,880,893 ,4 ,897 ,1440 ,0,3,1,3,0,1,0,76.14,62.29,33.33
01,000,02,009,0320,881,788 ,1 ,789 ,1220 ,0,3,1,3,0,1,0,76.14,64.67,33.33
01,000,02,009,0320,882,888 ,7 ,895 ,1397 ,0,3,1,3,0,1,0,76.14,64.07,33.33
01,000,02,009,0320,883,904 ,7 ,911 ,1397 ,0,3,1,3,0,1,0,76.14,65.21,33.33
01,000,02,009,0321,884,846 ,3 ,849 ,1364 ,0,3,1,3,0,1,0,76.14,62.24,33.33
01,000,02,009,0321,885,1064 ,3 ,1067 ,1663 ,0,3,1,3,0,1,0,76.14,64.16,33.33
01,000,02,009,0321,886,875 ,6 ,881 ,1353 ,0,3,1,3,0,1,0,76.14,65.11,33.33
01,000,02,009,0321,887,1106 ,1 ,1107 ,1690 ,0,3,1,3,0,1,0,76.14,65.5,33.33
01,000,02,010,0322,888,893 ,5 ,898 ,1505 ,0,3,1,3,0,1,0,76.14,59.67,33.33
01,000,02,010,0322,889,624 ,8 ,632 ,1091 ,0,3,1,3,0,1,0,76.14,57.93,33.33
01,000,02,010,0322,890,940 ,8 ,948 ,1652 ,0,3,1,3,0,1,0,76.14,57.38,33.33
01,000,02,010,0323,891,666 ,5 ,671 ,1275 ,0,3,1,3,0,1,0,76.14,52.63,33.33
01,000,02,010,0323,892,819 ,10 ,829 ,1499 ,0,3,1,3,0,1,0,76.14,55.3,33.33
01,000,02,010,0324,893,852 ,3 ,855 ,1571 ,0,3,1,3,0,1,0,76.14,54.42,33.33
01,000,02,010,0324,894,753 ,7 ,760 ,1391 ,0,3,1,3,0,1,0,76.14,54.64,33.33
01,000,02,010,0325,895,828 ,7 ,835 ,1412 ,0,3,1,3,0,1,0,76.14,59.14,33.33
01,000,02,010,0325,896,905 ,7 ,912 ,1580 ,0,3,1,3,0,1,0,76.14,57.72,33.33
01,000,02,010,0325,897,800 ,4 ,804 ,1439 ,0,3,1,3,0,1,0,76.14,55.87,33.33
01,000,02,010,0325,898,872 ,6 ,878 ,1424 ,0,3,1,3,0,1,0,76.14,61.66,33.33
01,000,02,010,0326,899,925 ,5 ,930 ,1587 ,0,3,1,3,0,1,0,76.14,58.6,33.33
01,000,02,010,0326,900,927 ,3 ,930 ,1549 ,0,3,1,3,0,1,0,76.14,60.04,33.33
01,000,02,010,0326,901,1040 ,7 ,1047 ,1773 ,0,3,1,3,0,1,0,76.14,59.05,33.33
01,000,02,010,0327,902,901 ,8 ,909 ,1516 ,0,3,1,3,0,1,0,76.14,59.96,33.33
01,000,02,010,0327,903,914 ,5 ,919 ,1558 ,0,3,1,3,0,1,0,76.14,58.99,33.33
01,000,02,010,0327,904,792 ,7 ,799 ,1413 ,0,3,1,3,0,1,0,76.14,56.55,33.33
01,000,02,010,0328,905,1029 ,4 ,1033 ,1690 ,0,3,1,3,0,1,0,76.14,61.12,33.33
01,000,02,010,0328,906,676 ,2 ,678 ,1180 ,0,3,1,3,0,1,0,76.14,57.46,33.33
01,000,02,010,0328,907,842 ,5 ,847 ,1368 ,0,3,1,3,0,1,0,76.14,61.92,33.33
01,000,02,010,0329,908,980 ,5 ,985 ,1570 ,0,3,1,3,0,1,0,76.14,62.74,33.33
01,000,02,010,0329,909,934 ,10 ,944 ,1487 ,0,3,1,3,0,1,0,76.14,63.48,33.33
01,000,02,010,0330,910,1195 ,10 ,1205 ,1876 ,0,3,1,3,0,1,0,76.14,64.23,33.33
01,000,02,010,0330,911,1091 ,4 ,1095 ,1681 ,0,3,1,3,0,1,0,76.14,65.14,33.33
01,000,02,010,0331,912,846 ,6 ,852 ,1634 ,0,3,1,3,0,1,0,76.14,52.14,33.33
01,000,02,010,0331,913,742 ,4 ,746 ,1159 ,0,3,1,3,0,1,0,76.14,64.37,33.33
01,000,02,010,0331,914,877 ,5 ,882 ,1390 ,0,3,1,3,0,1,0,76.14,63.45,33.33
01,000,02,010,0332,915,995 ,5 ,1000 ,1748 ,0,3,1,3,0,1,0,76.14,57.21,33.33
01,000,02,010,0332,916,761 ,4 ,765 ,1236 ,0,3,1,3,0,1,0,76.14,61.89,33.33
01,000,02,010,0332,917,905 ,12 ,917 ,1480 ,0,3,1,3,0,1,0,76.14,61.96,33.33
01,000,02,010,0333,918,1026 ,8 ,1034 ,1626 ,0,3,1,3,0,1,0,76.14,63.59,33.33
01,000,02,010,0333,919,918 ,8 ,926 ,1555 ,0,3,1,3,0,1,0,76.14,59.55,33.33
01,000,02,010,0333,920,1161 ,4 ,1165 ,1871 ,0,3,1,3,0,1,0,76.14,62.27,33.33
01,000,02,010,0333,921,1100 ,10 ,1110 ,1952 ,0,3,1,3,0,1,0,76.14,56.86,33.33
01,000,02,010,0334,922,816 ,7 ,823 ,1453 ,0,3,1,3,0,1,0,76.14,56.64,33.33
01,000,02,010,0334,923,898 ,6 ,904 ,1536 ,0,3,1,3,0,1,0,76.14,58.85,33.33
01,000,02,010,0334,924,877 ,5 ,882 ,1536 ,0,3,1,3,0,1,0,76.14,57.42,33.33
01,000,02,010,0335,925,851 ,5 ,856 ,1384 ,0,3,1,3,0,1,0,76.14,61.85,33.33
01,000,02,010,0335,926,639 ,5 ,644 ,1230 ,0,3,1,3,0,1,0,76.14,52.36,33.33
01,000,02,010,0335,927,757 ,9 ,766 ,1289 ,0,3,1,3,0,1,0,76.14,59.43,33.33
01,000,02,010,0336,928,1152 ,12 ,1164 ,1794 ,0,3,1,3,0,1,0,76.14,64.88,33.33
01,000,02,010,0336,929,1112 ,7 ,1119 ,2185 ,0,3,1,3,0,1,0,76.14,51.21,33.33
01,000,02,010,0336,930,1055 ,4 ,1059 ,1713 ,0,3,1,3,0,1,0,76.14,61.82,33.33
01,000,02,010,0336,931,774 ,7 ,781 ,1224 ,0,3,1,3,0,1,0,76.14,63.81,33.33
01,000,02,010,0337,932,802 ,5 ,807 ,1314 ,0,3,1,3,0,1,0,76.14,61.42,33.33
01,000,02,010,0337,933,851 ,1 ,852 ,1331 ,0,3,1,3,0,1,0,76.14,64.01,33.33
01,000,02,010,0337,934,844 ,7 ,851 ,1407 ,0,3,1,3,0,1,0,76.14,60.48,33.33
01,000,02,010,0338,935,1001 ,11 ,1012 ,1643 ,0,3,1,3,0,1,0,76.14,61.59,33.33
01,000,02,010,0338,936,953 ,5 ,958 ,1544 ,0,3,1,3,0,1,0,76.14,62.05,33.33
01,000,02,010,0338,937,812 ,4 ,816 ,1273 ,0,3,1,3,0,1,0,76.14,64.1,33.33
01,000,02,010,0338,938,936 ,7 ,943 ,1583 ,0,3,1,3,0,1,0,76.14,59.57,33.33
01,000,02,010,0339,939,950 ,4 ,954 ,1568 ,0,3,1,3,0,1,0,76.14,60.84,33.33
01,000,02,010,0339,940,749 ,12 ,761 ,1463 ,0,3,1,3,0,1,0,76.14,52.02,33.33
01,000,02,010,0339,941,792 ,1 ,793 ,1430 ,0,3,1,3,0,1,0,76.14,55.45,33.33
01,000,02,010,0339,942,837 ,4 ,841 ,1403 ,0,3,1,3,0,1,0,76.14,59.94,33.33
01,000,02,010,0340,943,1068 ,10 ,1078 ,1773 ,0,3,1,3,0,1,0,76.14,60.8,33.33
01,000,02,010,0340,944,1093 ,8 ,1101 ,1775 ,0,3,1,3,0,1,0,76.14,62.03,33.33
01,000,02,010,0341,945,964 ,2 ,966 ,1545 ,0,3,1,3,0,1,0,76.14,62.52,33.33
01,000,02,010,0341,946,1055 ,11 ,1066 ,1688 ,0,3,1,3,0,1,0,76.14,63.15,33.33
01,000,02,010,0342,947,936 ,7 ,943 ,1474 ,0,3,1,3,0,1,0,76.14,63.98,33.33
01,000,02,010,0342,948,933 ,5 ,938 ,1580 ,0,3,1,3,0,1,0,76.14,59.37,33.33
01,000,02,010,0342,949,744 ,6 ,750 ,1197 ,0,3,1,3,0,1,0,76.14,62.66,33.33
01,000,02,010,0343,950,1085 ,7 ,1092 ,1777 ,0,3,1,3,0,1,0,76.14,61.45,33.33
01,000,02,010,0343,951,1198 ,11 ,1209 ,1971 ,0,3,1,3,0,1,0,76.14,61.34,33.33
01,000,02,010,0344,952,906 ,7 ,913 ,1505 ,0,3,1,3,0,1,0,76.14,60.66 ,33.33
01,000,02,010,0344,953,949 ,4 ,953 ,1591 ,0,3,1,3,0,1,0,76.14,59.9,33.33
01,000,02,010,0344,954,798 ,7 ,805 ,1314 ,0,3,1,3,0,1,0,76.14,61.26,33.33
01,000,02,010,0345,955,878 ,6 ,884 ,1395 ,0,3,1,3,0,1,0,76.14,63.37,33.33
01,000,02,010,0345,956,892 ,7 ,899 ,1431 ,0,3,1,3,0,1,0,76.14,62.82,33.33
01,000,02,010,0345,957,688 ,5 ,693 ,1126 ,0,3,1,3,0,1,0,76.14,61.55,33.33
01,000,02,010,0346,958,858 ,0 ,858 ,1437 ,0,3,1,3,0,1,0,76.14,59.71,33.33
01,000,02,010,0346,959,793 ,5 ,798 ,1238 ,0,3,1,3,0,1,0,76.14,64.46,33.33
01,000,02,010,0347,960,837 ,2 ,839 ,1248 ,0,3,1,3,0,1,0,76.14,67.23,33.33
01,000,02,010,0347,961,803 ,4 ,807 ,1233 ,0,3,1,3,0,1,0,76.14,65.45,33.33
01,000,02,010,0348,962,1002 ,4 ,1006 ,1522 ,0,3,1,3,0,1,0,76.14,66.1,33.33
01,000,02,010,0348,963,1038 ,9 ,1047 ,1658 ,0,3,1,3,0,1,0,76.14,63.15,33.33
01,000,02,010,0349,964,1162 ,6 ,1168 ,1867 ,0,3,1,3,0,1,0,76.14,62.56,33.33
01,000,02,010,0349,965,1069 ,7 ,1076 ,1727 ,0,3,1,3,0,1,0,76.14,62.3,33.33
01,000,02,010,0349,966,978 ,14 ,992 ,1565 ,0,3,1,3,0,1,0,76.14,63.39,33.33
01,000,02,010,0350,967,813 ,10 ,823 ,1264 ,0,3,1,3,0,1,0,76.14,65.11,33.33
01,000,02,010,0350,968,864 ,4 ,868 ,1385 ,0,3,1,3,0,1,0,76.14,62.67,33.33
01,000,02,010,0350,969,775 ,3 ,778 ,1334 ,0,3,1,3,0,1,0,76.14,58.32,33.33
01,000,02,010,0351,970,858 ,0 ,858 ,1398 ,0,3,1,3,0,1,0,76.14,61.37,33.33
01,000,02,010,0351,971,991 ,7 ,998 ,1654 ,0,3,1,3,0,1,0,76.14,60.34,33.33
01,000,02,010,0351,972,871 ,5 ,876 ,1270 ,0,3,1,3,0,1,0,76.14,68.98,33.33
01,000,02,010,0352,973,950 ,7 ,957 ,1329 ,0,3,1,3,0,1,0,76.14,72.01,33.33
01,000,02,010,0352,974,1036 ,5 ,1041 ,1550 ,0,3,1,3,0,1,0,76.14,67.16,33.33
01,000,02,010,0352,975,913 ,4 ,917 ,1448 ,0,3,1,3,0,1,0,76.14,63.33,33.33
01,000,02,010,0353,976,958 ,4 ,962 ,1554 ,0,3,1,3,0,1,0,76.14,61.9,33.33
01,000,02,010,0353,977,1233 ,6 ,1239 ,1738 ,0,3,1,3,0,1,0,76.14,71.29,33.33
01,000,02,010,0354,978,1091 ,7 ,1098 ,1525 ,0,3,1,3,0,1,0,76.14,72,33.33
01,000,02,010,0354,979,1013 ,2 ,1015 ,1486 ,0,3,1,3,0,1,0,76.14,68.3,33.33
01,000,02,010,0354,980,993 ,1 ,994 ,1481 ,0,3,1,3,0,1,0,76.14,67.12,33.33
01,000,02,010,0354,981,914 ,6 ,920 ,1448 ,0,3,1,3,0,1,0,76.14,63.54,33.33
01,000,02,010,0354,982,1012 ,5 ,1017 ,1435 ,0,3,1,3,0,1,0,76.14,70.87,33.33
01,000,02,010,0355,983,894 ,4 ,898 ,1498 ,0,3,1,3,0,1,0,76.14,59.95,33.33
01,000,02,010,0355,984,811 ,7 ,818 ,1401 ,0,3,1,3,0,1,0,76.14,58.39,33.33
01,000,02,010,0355,985,752 ,11 ,763 ,1172 ,0,3,1,3,0,1,0,76.14,65.1,33.33
01,000,02,010,0355,986,874 ,3 ,877 ,1294 ,0,3,1,3,0,1,0,76.14,67.77,33.33
01,000,02,010,0356,987,1094 ,6 ,1100 ,1768 ,0,3,1,3,0,1,0,76.14,62.22,33.33
01,000,02,010,0356,988,1107 ,6 ,1113 ,1657 ,0,3,1,3,0,1,0,76.14,67.17,33.33
01,000,02,010,0357,989,840 ,1 ,841 ,1325 ,0,3,1,3,0,1,0,76.14,63.47,33.33
01,000,02,010,0357,990,847 ,6 ,853 ,1308 ,0,3,1,3,0,1,0,76.14,65.21,33.33
01,000,02,011,0358,991,995 ,3 ,998 ,1534 ,0,3,1,3,0,1,0,76.14,65.06,33.33
01,000,02,011,0358,992,1008 ,4 ,1012 ,1567 ,0,3,1,3,0,1,0,76.14,64.58,33.33
01,000,02,011,0358,993,839 ,6 ,845 ,1480 ,0,3,1,3,0,1,0,76.14,57.09,33.33
01,000,02,011,0359,994,1180 ,8 ,1188 ,1952 ,0,3,1,3,0,1,0,76.14,60.86,33.33
01,000,02,011,0359,995,1162 ,2 ,1164 ,1924 ,0,3,1,3,0,1,0,76.14,60.5,33.33
01,000,02,011,0360,996,994 ,2 ,996 ,1628 ,0,3,1,3,0,1,0,76.14,61.18,33.33
01,000,02,011,0360,997,993 ,7 ,1000 ,1674 ,0,3,1,3,0,1,0,76.14,59.74,33.33
01,000,02,011,0360,998,1096 ,6 ,1102 ,1679 ,0,3,1,3,0,1,0,76.14,65.63,33.33
01,000,02,011,0361,999,977 ,4 ,981 ,1602 ,0,3,1,3,0,1,0,76.14,61.24,33.33
01,000,02,011,0361,1000,961 ,1 ,962 ,1539 ,0,3,1,3,0,1,0,76.14,62.51,33.33
01,000,02,011,0361,1001,882 ,2 ,884 ,1454 ,0,3,1,3,0,1,0,76.14,60.8,33.33
01,000,02,011,0361,1002,1004 ,8 ,1012 ,1685 ,0,3,1,3,0,1,0,76.14,60.06,33.33
01,000,02,011,0362,1003,791 ,3 ,794 ,1464 ,0,3,1,3,0,1,0,76.14,54.23,33.33
01,000,02,011,0362,1004,826 ,5 ,831 ,1546 ,0,3,1,3,0,1,0,76.14,53.75,33.33
01,000,02,011,0362,1005,903 ,3 ,906 ,1604 ,0,3,1,3,0,1,0,76.14,56.48,33.33
01,000,02,011,0363,1006,1102 ,5 ,1107 ,1643 ,0,3,1,3,0,1,0,76.14,67.38,33.33
01,000,02,011,0363,1007,1172 ,5 ,1177 ,1820 ,0,3,1,3,0,1,0,76.14,64.67,33.33
01,000,02,011,0363,1008,1245 ,1 ,1246 ,1980 ,0,3,1,3,0,1,0,76.14,62.93,33.33
01,000,02,011,0364,1009,1294 ,3 ,1297 ,2061 ,0,3,1,3,0,1,0,76.14,62.93,33.33
01,000,02,011,0364,1010,1242 ,5 ,1247 ,2007 ,0,3,1,3,0,1,0,76.14,62.13,33.33
01,000,02,011,0364,1011,789 ,2 ,791 ,1389 ,0,3,1,3,0,1,0,76.14,56.95,33.33
01,000,02,011,0365,1012,806 ,4 ,810 ,1241 ,0,3,1,3,0,1,0,76.14,65.27,33.33
01,000,02,011,0365,1013,927 ,1 ,928 ,1449 ,0,3,1,3,0,1,0,76.14,64.04,33.33
01,000,02,011,0366,1014,1100 ,7 ,1107 ,1761 ,0,3,1,3,0,1,0,76.14,62.86,33.33
01,000,02,011,0366,1015,1169 ,5 ,1174 ,1917 ,0,3,1,3,0,1,0,76.14,61.24,33.33
01,000,02,011,0367,1016,816 ,8 ,824 ,1461 ,0,3,1,3,0,1,0,76.14,56.4,33.33
01,000,02,011,0367,1017,821 ,3 ,824 ,1422 ,0,3,1,3,0,1,0,76.14,57.95,33.33
01,000,02,011,0367,1018,934 ,4 ,938 ,1630 ,0,3,1,3,0,1,0,76.14,57.55,33.33
01,000,02,011,0367,1019,1097 ,5 ,1102 ,1874 ,0,3,1,3,0,1,0,76.14,58.8,33.33
01,000,02,011,0368,1020,941 ,6 ,947 ,1476 ,0,3,1,3,0,1,0,76.14,64.16,33.33
01,000,02,011,0368,1021,877 ,1 ,878 ,1362 ,0,3,1,3,0,1,0,76.14,64.46,33.33
01,000,02,011,0368,1022,1143 ,2 ,1145 ,1773 ,0,3,1,3,0,1,0,76.14,64.58,33.33
01,000,02,011,0369,1023,1187 ,4 ,1191 ,1886 ,0,3,1,3,0,1,0,76.14,63.15,33.33
01,000,02,011,0369,1024,1024 ,4 ,1028 ,1709 ,0,3,1,3,0,1,0,76.14,60.15,33.33
01,000,02,011,0370,1025,978 ,5 ,983 ,1520 ,0,3,1,3,0,1,0,76.14,64.67,33.33
01,000,02,011,0370,1026,1069 ,3 ,1072 ,1740 ,0,3,1,3,0,1,0,76.14,61.61,33.33
01,000,02,011,0371,1027,1123 ,6 ,1129 ,1867 ,0,3,1,3,0,1,0,76.14,60.47,33.33
01,000,02,011,0371,1028,1011 ,5 ,1016 ,1637 ,0,3,1,3,0,1,0,76.14,62.06,33.33
01,000,02,011,0371,1029,1015 ,6 ,1021 ,1599 ,0,3,1,3,0,1,0,76.14,63.85,33.33
01,000,02,011,0372,1030,291 ,4 ,295 ,1785 ,0,3,1,3,0,1,0,76.14,16.53,33.33
01,000,02,011,0372,1031,955 ,7 ,962 ,1475 ,0,3,1,3,0,1,0,76.14,65.22,33.33
01,000,02,011,0372,1032,948 ,6 ,954 ,1456 ,0,3,1,3,0,1,0,76.14,65.52,33.33
01,000,02,011,0372,1033,643 ,1 ,644 ,1026 ,0,3,1,3,0,1,0,76.14,62.77,33.33
01,000,02,011,0373,1034,800 ,1 ,801 ,1249 ,0,3,1,3,0,1,0,76.14,64.13,33.33
01,000,02,011,0373,1035,871 ,2 ,873 ,1303 ,0,3,1,3,0,1,0,76.14,67,33.33
01,000,02,011,0373,1036,898 ,6 ,904 ,1455 ,0,3,1,3,0,1,0,76.14,62.13,33.33
01,000,02,011,0374,1037,785 ,1 ,786 ,1300 ,0,3,1,3,0,1,0,76.14,60.46,33.33
01,000,02,011,0374,1038,947 ,1 ,948 ,1490 ,0,3,1,3,0,1,0,76.14,63.62,33.33
01,000,02,011,0374,1039,982 ,5 ,987 ,1571 ,0,3,1,3,0,1,0,76.14,62.83,33.33
01,000,02,011,0375,1040,893 ,2 ,895 ,1347 ,0,3,1,3,0,1,0,76.14,66.44,33.33
01,000,02,011,0375,1041,789 ,1 ,790 ,1208 ,0,3,1,3,0,1,0,76.14,65.4,33.33
01,000,02,011,0376,1042,916 ,3 ,919 ,1437 ,0,3,1,3,0,1,0,76.14,63.95,33.33
01,000,02,011,0376,1043,966 ,10 ,976 ,1487 ,0,3,1,3,0,1,0,76.14,65.64,33.33
01,000,02,011,0377,1044,1406 ,2 ,1408 ,2048 ,0,3,1,3,0,1,0,76.14,68.75,33.33
01,000,02,011,0377,1045,1213 ,8 ,1221 ,1857 ,0,3,1,3,0,1,0,76.14,65.75,33.33
01,000,02,011,0378,1046,888 ,3 ,891 ,1326 ,0,3,1,3,0,1,0,76.14,67.19,33.33
01,000,02,011,0378,1047,937 ,2 ,939 ,1430 ,0,3,1,3,0,1,0,76.14,65.66,33.33
01,000,02,011,0378,1048,799 ,9 ,808 ,1286 ,0,3,1,3,0,1,0,76.14,62.83,33.33
01,000,02,011,0379,1049,1070 ,5 ,1075 ,1775 ,0,3,1,3,0,1,0,76.14,60.56,33.33
01,000,02,011,0379,1050,1095 ,4 ,1099 ,1713 ,0,3,1,3,0,1,0,76.14,64.16,33.33
01,000,02,011,0379,1051,1057 ,5 ,1062 ,1763 ,0,3,1,3,0,1,0,76.14,60.24,33.33
01,000,02,011,0380,1052,1109 ,8 ,1117 ,1719 ,0,3,1,3,0,1,0,76.14,64.98,33.33
01,000,02,011,0380,1053,1115 ,7 ,1122 ,1672 ,0,3,1,3,0,1,0,76.14,67.11,33.33
01,000,02,011,0380,1054,1173 ,4 ,1177 ,1778 ,0,3,1,3,0,1,0,76.14,66.2,33.33
01,000,02,011,0381,1055,883 ,8 ,891 ,1424 ,0,3,1,3,0,1,0,76.14,62.57,33.33
01,000,02,011,0381,1056,967 ,8 ,975 ,1536 ,0,3,1,3,0,1,0,76.14,63.48,33.33
01,000,02,011,0382,1057,821 ,3 ,824 ,1279 ,0,3,1,3,0,1,0,76.14,64.43,33.33
01,000,02,011,0382,1058,882 ,3 ,885 ,1429 ,0,3,1,3,0,1,0,76.14,61.93,33.33
01,000,02,011,0382,1059,807 ,4 ,811 ,1358 ,0,3,1,3,0,1,0,76.14,59.72,33.33
01,000,02,011,0383,1060,1104 ,6 ,1110 ,1605 ,0,3,1,3,0,1,0,76.14,69.16,33.33
01,000,02,011,0383,1061,1121 ,3 ,1124 ,1732 ,0,3,1,3,0,1,0,76.14,64.9,33.33
01,000,02,011,0383,1062,1056 ,8 ,1064 ,1642 ,0,3,1,3,0,1,0,76.14,64.8,33.33
01,000,02,011,0384,1063,938 ,8 ,946 ,1512 ,0,3,1,3,0,1,0,76.14,62.57,33.33
01,000,02,011,0384,1064,753 ,9 ,762 ,1276 ,0,3,1,3,0,1,0,76.14,59.72,33.33
01,000,02,011,0384,1065,932 ,6 ,938 ,1567 ,0,3,1,3,0,1,0,76.14,59.86,33.33
01,000,02,011,0385,1066,950 ,4 ,954 ,1586 ,0,3,1,3,0,1,0,76.14,60.15,33.33
01,000,02,011,0385,1067,900 ,2 ,902 ,1482 ,0,3,1,3,0,1,0,76.14,60.86,33.33
01,000,02,011,0385,1068,845 ,4 ,849 ,1386 ,0,3,1,3,0,1,0,76.14,61.26,33.33
01,000,02,011,0386,1069,882 ,2 ,884 ,1448 ,0,3,1,3,0,1,0,76.14,61.05,33.33
01,000,02,011,0386,1070,1082 ,7 ,1089 ,1760 ,0,3,1,3,0,1,0,76.14,61.88,33.33
01,000,02,011,0386,1071,1069 ,3 ,1072 ,1772 ,0,3,1,3,0,1,0,76.14,60.5,33.33
01,000,02,011,0387,1072,1052 ,3 ,1055 ,1672 ,0,3,1,3,0,1,0,76.14,63.1,33.33
01,000,02,011,0387,1073,859 ,3 ,862 ,1513 ,0,3,1,3,0,1,0,76.14,56.97,33.33
01,000,02,011,0387,1074,959 ,5 ,964 ,1540 ,0,3,1,3,0,1,0,76.14,62.6,33.33
01,000,02,011,0388,1075,1011 ,7 ,1018 ,1682 ,0,3,1,3,0,1,0,76.14,60.52,33.33
01,000,02,011,0388,1076,1105 ,2 ,1107 ,1788 ,0,3,1,3,0,1,0,76.14,61.91,33.33
01,000,02,011,0389,1077,1129 ,5 ,1134 ,1781 ,0,3,1,3,0,1,0,76.14,63.67,33.33
01,000,02,011,0389,1078,1093 ,8 ,1101 ,1787 ,0,3,1,3,0,1,0,76.14,61.61,33.33
01,000,02,011,0390,1079,1058 ,4 ,1062 ,1709 ,0,3,1,3,0,1,0,76.14,62.14,33.33
01,000,02,011,0390,1080,1093 ,2 ,1095 ,1784 ,0,3,1,3,0,1,0,76.14,61.38,33.33
01,000,02,011,0391,1081,1067 ,2 ,1069 ,1723 ,0,3,1,3,0,1,0,76.14,62.04,33.33
01,000,02,011,0391,1082,941 ,2 ,943 ,1495 ,0,3,1,3,0,1,0,76.14,63.08,33.33
01,000,02,011,0391,1083,1032 ,10 ,1042 ,1739 ,0,3,1,3,0,1,0,76.14,59.92,33.33
01,000,02,011,0392,1084,909 ,9 ,918 ,1334 ,0,3,1,3,0,1,0,76.14,68.82,33.33
01,000,02,011,0392,1085,1092 ,5 ,1097 ,1597 ,0,3,1,3,0,1,0,76.14,68.69,33.33
01,000,02,011,0392,1086,956 ,1 ,957 ,1388 ,0,3,1,3,0,1,0,76.14,68.95,33.33
01,000,02,011,0392,1087,1086 ,4 ,1090 ,1620 ,0,3,1,3,0,1,0,76.14,67.28,33.33
01,000,02,011,0393,1088,970 ,3 ,973 ,1595 ,0,3,1,3,0,1,0,76.14,61,33.33
01,000,02,011,0393,1089,704 ,4 ,708 ,1127 ,0,3,1,3,0,1,0,76.14,62.82,33.33
01,000,02,011,0394,1090,1074 ,5 ,1079 ,1774 ,0,3,1,3,0,1,0,76.14,60.82,33.33
01,000,02,011,0395,1091,1061 ,6 ,1067 ,1699 ,0,3,1,3,0,1,0,76.14,62.8,33.33
01,000,02,011,0395,1092,1221 ,1 ,1222 ,1849 ,0,3,1,3,0,1,0,76.14,66.09,33.33
01,000,02,011,0395,1093,1063 ,6 ,1069 ,1658 ,0,3,1,3,0,1,0,76.14,64.48,33.33
01,000,02,011,0395,1094,1114 ,3 ,1117 ,1722 ,0,3,1,3,0,1,0,76.14,64.87,33.33
01,000,02,011,0396,1095,1064 ,7 ,1071 ,1724 ,0,3,1,3,0,1,0,76.14,62.12,33.33
01,000,02,011,0396,1096,1004 ,3 ,1007 ,1582 ,0,3,1,3,0,1,0,76.14,63.65,33.33
01,000,02,011,0397,1097,999 ,4 ,1003 ,1589 ,0,3,1,3,0,1,0,76.14,63.12,33.33
01,000,02,011,0397,1098,1019 ,9 ,1028 ,1651 ,0,3,1,3,0,1,0,76.14,62.27,33.33
01,000,02,011,0397,1099,964 ,6 ,970 ,1618 ,0,3,1,3,0,1,0,76.14,59.95,33.33
01,000,02,011,0397,1100,1008 ,2 ,1010 ,1615 ,0,3,1,3,0,1,0,76.14,62.54,33.33
01,000,02,011,0398,1101,1045 ,4 ,1049 ,1602 ,0,3,1,3,0,1,0,76.14,65.48,33.33
01,000,02,011,0398,1102,997 ,9 ,1006 ,1621 ,0,3,1,3,0,1,0,76.14,62.06,33.33
01,000,02,011,0398,1103,1176 ,4 ,1180 ,1848 ,0,3,1,3,0,1,0,76.14,63.85,33.33
01,000,02,011,0399,1104,829 ,5 ,834 ,1369 ,0,3,1,3,0,1,0,76.14,60.92,33.33
01,000,02,011,0399,1105,1083 ,6 ,1089 ,1712 ,0,3,1,3,0,1,0,76.14,63.61,33.33
01,000,02,011,0399,1106,913 ,3 ,916 ,1417 ,0,3,1,3,0,1,0,76.14,64.64,33.33
01,000,02,011,0400,1107,937 ,14 ,951 ,1484 ,0,3,1,3,0,1,0,76.14,64.08,33.33
01,000,02,011,0400,1108,945 ,3 ,948 ,1518 ,0,3,1,3,0,1,0,76.14,62.45,33.33
01,000,02,011,0400,1109,1060 ,6 ,1066 ,1588 ,0,3,1,3,0,1,0,76.14,67.13,33.33
01,000,02,011,0400,1110,1050 ,5 ,1055 ,1639 ,0,3,1,3,0,1,0,76.14,64.37,33.33
01,000,02,011,0401,1111,958 ,6 ,964 ,1655 ,0,3,1,3,0,1,0,76.14,58.25,33.33
01,000,02,011,0401,1112,1203 ,9 ,1212 ,1911 ,0,3,1,3,0,1,0,76.14,63.42,33.33
01,000,02,011,0402,1113,707 ,6 ,713 ,1309 ,0,3,1,3,0,1,0,76.14,54.47,33.33
01,000,02,011,0402,1114,831 ,5 ,836 ,1393 ,0,3,1,3,0,1,0,76.14,60.01,33.33
01,000,02,011,0402,1115,754 ,5 ,759 ,1387 ,0,3,1,3,0,1,0,76.14,54.72,33.33
01,000,02,011,0403,1116,955 ,2 ,957 ,1652 ,0,3,1,3,0,1,0,76.14,57.93,33.33
01,000,02,011,0403,1117,1000 ,5 ,1005 ,1659 ,0,3,1,3,0,1,0,76.14,60.58,33.33
01,000,02,011,0403,1118,843 ,6 ,849 ,1559 ,0,3,1,3,0,1,0,76.14,54.46,33.33
01,000,02,011,0404,1119,1159 ,4 ,1163 ,1908 ,0,3,1,3,0,1,0,76.14,60.95,33.33
01,000,02,011,0404,1120,995 ,6 ,1001 ,1633 ,0,3,1,3,0,1,0,76.14,61.3,33.33
01,000,02,011,0404,1121,869 ,2 ,871 ,1428 ,0,3,1,3,0,1,0,76.14,60.99,33.33
01,000,02,011,0405,1122,695 ,5 ,700 ,1167 ,0,3,1,3,0,1,0,76.14,59.98,33.33
01,000,02,011,0405,1123,796 ,2 ,798 ,1312 ,0,3,1,3,0,1,0,76.14,60.82,33.33
01,000,02,011,0405,1124,834 ,1 ,835 ,1491 ,0,3,1,3,0,1,0,76.14,56,33.33
01,000,02,011,0406,1125,1026 ,7 ,1033 ,1656 ,0,3,1,3,0,1,0,76.14,62.38,33.33
01,000,02,011,0406,1126,969 ,2 ,971 ,1592 ,0,3,1,3,0,1,0,76.14,60.99,33.33
01,000,02,011,0406,1127,930 ,3 ,933 ,1521 ,0,3,1,3,0,1,0,76.14,61.34,33.33
01,000,02,011,0407,1128,1018 ,3 ,1021 ,1720 ,0,3,1,3,0,1,0,76.14,59.36,33.33
01,000,02,011,0407,1129,1073 ,9 ,1082 ,1779 ,0,3,1,3,0,1,0,76.14,60.82,33.33
01,000,02,011,0408,1130,1020 ,4 ,1024 ,1755 ,0,3,1,3,0,1,0,76.14,58.35,33.33
01,000,02,011,0408,1131,1081 ,5 ,1086 ,1799 ,0,3,1,3,0,1,0,76.14,60.37,33.33
01,000,02,011,0408,1132,999 ,2 ,1001 ,1698 ,0,3,1,3,0,1,0,76.14,58.95,33.33
01,000,02,011,0409,1133,973 ,10 ,983 ,1614 ,0,3,1,3,0,1,0,76.14,60.9,33.33
01,000,02,011,0409,1134,1022 ,3 ,1025 ,1634 ,0,3,1,3,0,1,0,76.14,62.73,33.33
01,000,02,011,0409,1135,889 ,4 ,893 ,1519 ,0,3,1,3,0,1,0,76.14,58.79,33.33
01,000,02,011,0409,1136,968 ,3 ,971 ,1518 ,0,3,1,3,0,1,0,76.14,63.97,33.33
01,000,02,011,0410,1137,687 ,1 ,688 ,1077 ,0,3,1,3,0,1,0,76.14,63.88,33.33
01,000,02,011,0410,1138,478 ,3 ,481 ,752 ,0,3,1,3,0,1,0,76.14,63.96,33.33
01,000,02,011,0410,1139,767 ,3 ,770 ,1234 ,0,3,1,3,0,1,0,76.14,62.4,33.33
01,000,02,012,0411,1140,830 ,3 ,833 ,1357 ,0,3,1,3,0,1,0,76.14,61.39,33.33
01,000,02,012,0411,1141,899 ,7 ,906 ,1440 ,0,3,1,3,0,1,0,76.14,62.92,33.33
01,000,02,012,0411,1142,932 ,5 ,937 ,1566 ,0,3,1,3,0,1,0,76.14,59.83,33.33
01,000,02,012,0412,1143,1082 ,4 ,1086 ,1781 ,0,3,1,3,0,1,0,76.14,60.98,33.33
01,000,02,012,0412,1144,1042 ,7 ,1049 ,1710 ,0,3,1,3,0,1,0,76.14,61.35,33.33
01,000,02,012,0412,1145,1070 ,3 ,1073 ,1734 ,0,3,1,3,0,1,0,76.14,61.88,33.33
01,000,02,012,0413,1146,1157 ,2 ,1159 ,1827 ,0,3,1,3,0,1,0,76.14,63.44,33.33
01,000,02,012,0413,1147,1095 ,3 ,1098 ,1693 ,0,3,1,3,0,1,0,76.14,64.86,33.33
01,000,02,012,0414,1148,983 ,11 ,994 ,1586 ,0,3,1,3,0,1,0,76.14,62.67,33.33
01,000,02,012,0414,1149,1013 ,5 ,1018 ,1651 ,0,3,1,3,0,1,0,76.14,61.66,33.33
01,000,02,012,0414,1150,1086 ,4 ,1090 ,1718 ,0,3,1,3,0,1,0,76.14,63.45,33.33
01,000,02,012,0415,1151,1115 ,5 ,1120 ,1734 ,0,3,1,3,0,1,0,76.14,64.59,33.33
01,000,02,012,0415,1152,1187 ,8 ,1195 ,1839 ,0,3,1,3,0,1,0,76.14,64.98,33.33
01,000,02,012,0416,1153,927 ,2 ,929 ,1503 ,0,3,1,3,0,1,0,76.14,61.81,33.33
01,000,02,012,0416,1154,948 ,2 ,950 ,1493 ,0,3,1,3,0,1,0,76.14,63.63,33.33
01,000,02,012,0416,1155,952 ,2 ,954 ,1485 ,0,3,1,3,0,1,0,76.14,64.24,33.33
01,000,02,012,0417,1156,1110 ,4 ,1114 ,1711 ,0,3,1,3,0,1,0,76.14,65.11,33.33
01,000,02,012,0417,1157,1314 ,7 ,1321 ,2026 ,0,3,1,3,0,1,0,76.14,65.2,33.33
01,000,02,012,0418,1158,1119 ,6 ,1125 ,1721 ,0,3,1,3,0,1,0,76.14,65.37,33.33
01,000,02,012,0418,1159,1209 ,7 ,1216 ,1845 ,0,3,1,3,0,1,0,76.14,65.91,33.33
01,000,02,012,0419,1160,1149 ,4 ,1153 ,1835 ,0,3,1,3,0,1,0,76.14,62.83,33.33
01,000,02,012,0419,1161,1154 ,10 ,1164 ,1783 ,0,3,1,3,0,1,0,76.14,65.28,33.33
01,000,02,012,0419,1162,1311 ,7 ,1318 ,2007 ,0,3,1,3,0,1,0,76.14,65.67,33.33
01,000,02,012,0420,1163,926 ,6 ,932 ,1528 ,0,3,1,3,0,1,0,76.14,60.99,33.33
01,000,02,012,0420,1164,883 ,6 ,889 ,1354 ,0,3,1,3,0,1,0,76.14,65.66,33.33
01,000,02,012,0420,1165,847 ,3 ,850 ,1392 ,0,3,1,3,0,1,0,76.14,61.06,33.33
01,000,02,012,0421,1166,974 ,5 ,979 ,1465 ,0,3,1,3,0,1,0,76.14,66.83,33.33
01,000,02,012,0421,1167,894 ,6 ,900 ,1293 ,0,3,1,3,0,1,0,76.14,69.61,33.33
01,000,02,012,0422,1168,1120 ,5 ,1125 ,1824 ,0,3,1,3,0,1,0,76.14,61.68,33.33
01,000,02,012,0422,1169,1281 ,1 ,1282 ,1995 ,0,3,1,3,0,1,0,76.14,64.26,33.33
01,000,02,012,0423,1170,1141 ,4 ,1145 ,1816 ,0,3,1,3,0,1,0,76.14,63.05,33.33
01,000,02,012,0423,1171,988 ,2 ,990 ,1503 ,0,3,1,3,0,1,0,76.14,65.87,33.33
01,000,02,012,0423,1172,1165 ,3 ,1168 ,1804 ,0,3,1,3,0,1,0,76.14,64.75,33.33
01,000,02,012,0423,1173,1097 ,4 ,1101 ,1768 ,0,3,1,3,0,1,0,76.14,62.27,33.33
01,000,02,012,0424,1174,783 ,8 ,791 ,1326 ,0,3,1,3,0,1,0,76.14,59.65,33.33
01,000,02,012,0424,1175,747 ,2 ,749 ,1210 ,0,3,1,3,0,1,0,76.14,61.9,33.33
01,000,02,012,0425,1176,1175 ,8 ,1183 ,1906 ,0,3,1,3,0,1,0,76.14,62.07,33.33
01,000,02,012,0425,1177,1389 ,6 ,1395 ,2112 ,0,3,1,3,0,1,0,76.14,66.05,33.33
01,000,02,012,0425,1178,1131 ,6 ,1137 ,1879 ,0,3,1,3,0,1,0,76.14,60.51,33.33
01,000,02,012,0426,1179,962 ,4 ,966 ,1548 ,0,3,1,3,0,1,0,76.14,62.4,33.33
01,000,02,012,0426,1180,1086 ,3 ,1089 ,1827 ,0,3,1,3,0,1,0,76.14,59.61,33.33
01,000,02,012,0426,1181,984 ,4 ,988 ,1660 ,0,3,1,3,0,1,0,76.14,59.52,33.33
01,000,02,012,0427,1182,1017 ,5 ,1022 ,1965 ,0,3,1,3,0,1,0,76.14,52.01,33.33
01,000,02,012,0427,1183,915 ,5 ,920 ,1450 ,0,3,1,3,0,1,0,76.14,63.45,33.33
01,000,02,012,0427,1184,854 ,3 ,857 ,1409 ,0,3,1,3,0,1,0,76.14,60.82,33.33
01,000,02,012,0428,1185,1023 ,3 ,1026 ,1587 ,0,3,1,3,0,1,0,76.14,64.65,33.33
01,000,02,012,0428,1186,1107 ,2 ,1109 ,1663 ,0,3,1,3,0,1,0,76.14,66.69,33.33
01,000,02,012,0428,1187,1133 ,6 ,1139 ,1731 ,0,3,1,3,0,1,0,76.14,65.8,33.33
01,000,02,012,0429,1188,981 ,2 ,983 ,1473 ,0,3,1,3,0,1,0,76.14,66.73,33.33
01,000,02,012,0429,1189,939 ,2 ,941 ,1469 ,0,3,1,3,0,1,0,76.14,64.06,33.33
01,000,02,012,0429,1190,1065 ,6 ,1071 ,1677 ,0,3,1,3,0,1,0,76.14,63.86,33.33
01,000,02,012,0430,1191,966 ,5 ,971 ,1676 ,0,3,1,3,0,1,0,76.14,57.94,33.33
01,000,02,012,0430,1192,1074 ,11 ,1085 ,1695 ,0,3,1,3,0,1,0,76.14,64.01,33.33
01,000,02,012,0430,1193,1306 ,9 ,1315 ,2162 ,0,3,1,3,0,1,0,76.14,60.82,33.33
01,000,02,012,0431,1194,997 ,7 ,1004 ,1657 ,0,3,1,3,0,1,0,76.14,60.59,33.33
01,000,02,012,0431,1195,869 ,1 ,870 ,1398 ,0,3,1,3,0,1,0,76.14,62.23,33.33
01,000,02,012,0432,1196,1028 ,0 ,1028 ,1685 ,0,3,1,3,0,1,0,76.14,61.01,33.33
01,000,02,012,0432,1197,1094 ,8 ,1102 ,1696 ,0,3,1,3,0,1,0,76.14,64.98,33.33
01,000,02,012,0432,1198,1105 ,4 ,1109 ,1745 ,0,3,1,3,0,1,0,76.14,63.55,33.33
01,000,02,012,0433,1199,1112 ,4 ,1116 ,1682 ,0,3,1,3,0,1,0,76.14,66.35,33.33
01,000,02,012,0433,1200,1094 ,5 ,1099 ,1684 ,0,3,1,3,0,1,0,76.14,65.26,33.33
01,000,02,012,0433,1201,1081 ,5 ,1086 ,1642 ,0,3,1,3,0,1,0,76.14,66.14,33.33
01,000,02,012,0434,1202,1280 ,6 ,1286 ,2010 ,0,3,1,3,0,1,0,76.14,63.98,33.33
01,000,02,012,0434,1203,1282 ,5 ,1287 ,2039 ,0,3,1,3,0,1,0,76.14,63.12,33.33
01,000,02,012,0434,1204,1227 ,8 ,1235 ,1859 ,0,3,1,3,0,1,0,76.14,66.43,33.33
01,000,02,012,0435,1205,1207 ,10 ,1217 ,1997 ,0,3,1,3,0,1,0,76.14,60.94,33.33
01,000,02,012,0435,1206,949 ,24 ,973 ,1853 ,0,3,1,3,0,1,0,76.14,52.51,33.33
01,000,02,012,0436,1207,1199 ,6 ,1205 ,1939 ,0,3,1,3,0,1,0,76.14,62.15,33.33
01,000,02,012,0436,1208,1099 ,5 ,1104 ,1879 ,0,3,1,3,0,1,0,76.14,58.75,33.33
01,000,02,012,0436,1209,1103 ,2 ,1105 ,1741 ,0,3,1,3,0,1,0,76.14,63.47,33.33
01,000,02,012,0437,1210,1140 ,8 ,1148 ,1823 ,0,3,1,3,0,1,0,76.14,62.97,33.33
01,000,02,012,0437,1211,977 ,7 ,984 ,1529 ,0,3,1,3,0,1,0,76.14,64.36,33.33
01,000,02,012,0437,1212,937 ,3 ,940 ,1259 ,0,3,1,3,0,1,0,76.14,74.66,33.33
01,000,02,012,0437,1213,903 ,4 ,907 ,1339 ,0,3,1,3,0,1,0,76.14,67.74,33.33
01,000,02,012,0438,1214,878 ,4 ,882 ,1490 ,0,3,1,3,0,1,0,76.14,59.19,33.33
01,000,02,012,0438,1215,1134 ,5 ,1139 ,1811 ,0,3,1,3,0,1,0,76.14,62.89,33.33
01,000,02,012,0438,1216,1134 ,12 ,1146 ,1894 ,0,3,1,3,0,1,0,76.14,60.51,33.33
01,000,02,012,0438,1217,1049 ,10 ,1059 ,1740 ,0,3,1,3,0,1,0,76.14,60.86,33.33
01,000,02,012,0439,1218,1168 ,8 ,1176 ,1870 ,0,3,1,3,0,1,0,76.14,62.89,33.33
01,000,02,012,0439,1219,1143 ,3 ,1146 ,1777 ,0,3,1,3,0,1,0,76.14,64.49,33.33
01,000,02,012,0439,1220,1122 ,4 ,1126 ,1809 ,0,3,1,3,0,1,0,76.14,62.24,33.33
01,000,02,012,0440,1221,1019 ,6 ,1025 ,1538 ,0,3,1,3,0,1,0,76.14,66.64,33.33
01,000,02,012,0440,1222,944 ,5 ,949 ,1491 ,0,3,1,3,0,1,0,76.14,63.65,33.33
01,000,02,012,0441,1223,963 ,1 ,964 ,1471 ,0,3,1,3,0,1,0,76.14,65.53,33.33
01,000,02,012,0441,1224,1049 ,4 ,1053 ,1670 ,0,3,1,3,0,1,0,76.14,63.05,33.33
01,000,02,012,0441,1225,1166 ,5 ,1171 ,1818 ,0,3,1,3,0,1,0,76.14,64.41,33.33
01,000,02,012,0441,1226,1046 ,5 ,1051 ,1614 ,0,3,1,3,0,1,0,76.14,65.12,33.33
01,000,02,012,0442,1227,988 ,8 ,996 ,1529 ,0,3,1,3,0,1,0,76.14,65.14,33.33
01,000,02,012,0442,1228,1033 ,6 ,1039 ,1691 ,0,3,1,3,0,1,0,76.14,61.44,33.33
01,000,02,012,0442,1229,1231 ,10 ,1241 ,1973 ,0,3,1,3,0,1,0,76.14,62.9,33.33
01,000,02,012,0442,1230,1144 ,5 ,1149 ,1896 ,0,3,1,3,0,1,0,76.14,60.6,33.33
01,000,02,012,0442,1231,1199 ,3 ,1202 ,1888 ,0,3,1,3,0,1,0,76.14,63.67,33.33
01,000,02,012,0443,1232,1286 ,14 ,1300 ,1960 ,0,3,1,3,0,1,0,76.14,66.33,33.33
01,000,02,012,0443,1233,1031 ,10 ,1041 ,1676 ,0,3,1,3,0,1,0,76.14,62.11,33.33
01,000,02,012,0443,1234,1025 ,9 ,1034 ,1618 ,0,3,1,3,0,1,0,76.14,63.91,33.33
01,000,02,012,0443,1235,1180 ,7 ,1187 ,1897 ,0,3,1,3,0,1,0,76.14,62.57,33.33
01,000,02,012,0444,1236,680 ,2 ,682 ,1100 ,0,3,1,3,0,1,0,76.14,62,33.33
01,000,02,012,0444,1237,970 ,2 ,972 ,1495 ,0,3,1,3,0,1,0,76.14,65.02,33.33
01,000,02,012,0444,1238,1039 ,5 ,1044 ,1565 ,0,3,1,3,0,1,0,76.14,66.71,33.33
01,000,02,012,0444,1239,952 ,2 ,954 ,1583 ,0,3,1,3,0,1,0,76.14,60.27,33.33
01,000,02,012,0445,1240,1128 ,7 ,1135 ,1851 ,0,3,1,3,0,1,0,76.14,61.32,33.33
01,000,02,012,0445,1241,1093 ,7 ,1100 ,1816 ,0,3,1,3,0,1,0,76.14,60.57,33.33
01,000,02,012,0445,1242,961 ,9 ,970 ,1578 ,0,3,1,3,0,1,0,76.14,61.47,33.33
01,000,02,012,0446,1243,1139 ,6 ,1145 ,1825 ,0,3,1,3,0,1,0,76.14,62.74,33.33
01,000,02,012,0446,1244,1199 ,10 ,1209 ,1989 ,0,3,1,3,0,1,0,76.14,60.78,33.33
01,000,02,012,0447,1245,1440 ,6 ,1446 ,2356 ,0,3,1,3,0,1,0,76.14,61.38,33.33
01,000,02,012,0447,1246,1292 ,5 ,1297 ,2059 ,0,3,1,3,0,1,0,76.14,62.99,33.33
01,000,02,012,0447,1247,1230 ,12 ,1242 ,2113 ,0,3,1,3,0,1,0,76.14,58.78,33.33
01,000,02,012,0447,1248,1323 ,2 ,1325 ,2102 ,0,3,1,3,0,1,0,76.14,63.04,33.33
01,000,02,012,0448,1249,1027 ,5 ,1032 ,1684 ,0,3,1,3,0,1,0,76.14,61.28,33.33
01,000,02,012,0448,1250,425 ,5 ,430 ,674 ,0,3,1,3,0,1,0,76.14,63.8,33.33
01,000,02,012,0449,1251,404 ,5 ,409 ,704 ,0,3,1,3,0,1,0,76.14,58.1,33.33
02,000,01,001,0001,1,815 ,4 ,819 ,1289 ,0,3,1,3,0,1,0,76.14,63.54 ,33.33
02,000,01,001,0002,2,309 ,1 ,310 ,477 ,0,3,1,3,0,1,0,76.14,64.99 ,33.33
02,000,01,001,0003,3,432 ,2 ,434 ,724 ,0,3,1,3,0,1,0,76.14,59.94 ,33.33
02,000,01,001,0004,4,817 ,6 ,823 ,1329 ,0,3,1,3,0,1,0,76.14,61.93 ,33.33
02,000,01,001,0005,5,704 ,2 ,706 ,1185 ,0,3,1,3,0,1,0,76.14,59.58 ,33.33
02,000,01,001,0006,6,810 ,7 ,817 ,1359 ,0,3,1,3,0,1,0,76.14,60.12 ,33.33
02,000,01,001,0006,7,534 ,4 ,538 ,860 ,0,3,1,3,0,1,0,76.14,62.56 ,33.33
02,000,01,001,0007,8,612 ,5 ,617 ,940 ,0,3,1,3,0,1,0,76.14,65.64 ,33.33
02,000,01,001,0008,9,460 ,0 ,460 ,698 ,0,3,1,3,0,1,0,76.14,65.90 ,33.33
02,000,01,001,0009,10,750 ,5 ,755 ,1227 ,0,3,1,3,0,1,0,76.14,61.53 ,33.33
02,000,01,001,0010,11,493 ,3 ,496 ,829 ,0,3,1,3,0,1,0,76.14,59.83 ,33.33
02,000,01,001,0011,12,1084 ,3 ,1087 ,1860 ,0,3,1,3,0,1,0,76.14,58.44 ,33.33
02,000,01,001,0012,13,637 ,2 ,639 ,1095 ,0,3,1,3,0,1,0,76.14,58.36 ,33.33
02,000,01,001,0013,14,660 ,4 ,664 ,1101 ,0,3,1,3,0,1,0,76.14,60.31 ,33.33
02,000,01,001,0014,15,682 ,3 ,685 ,1175 ,0,3,1,3,0,1,0,76.14,58.30 ,33.33
02,000,01,001,0015,16,740 ,7 ,747 ,1200 ,0,3,1,3,0,1,0,76.14,62.25 ,33.33
02,000,01,001,0016,17,392 ,1 ,393 ,599 ,0,3,1,3,0,1,0,76.14,65.61 ,33.33
02,000,01,001,0017,18,978 ,5 ,983 ,1802 ,0,3,1,3,0,1,0,76.14,54.55 ,33.33
02,000,01,001,0018,19,754 ,8 ,762 ,1245 ,0,3,1,3,0,1,0,76.14,61.20 ,33.33
02,000,01,001,0019,20,449 ,2 ,451 ,718 ,0,3,1,3,0,1,0,76.14,62.81 ,33.33
02,000,01,001,0020,21,451 ,2 ,453 ,705 ,0,3,1,3,0,1,0,76.14,64.26 ,33.33
02,000,01,001,0021,22,571 ,1 ,572 ,935 ,0,3,1,3,0,1,0,76.14,61.18 ,33.33
02,000,01,002,0022,23,644 ,3 ,647 ,1032 ,0,3,1,3,0,1,0,76.14,62.69 ,33.33
02,000,01,002,0022,24,634 ,6 ,640 ,980 ,0,3,1,3,0,1,0,76.14,65.31 ,33.33
02,000,01,002,0023,25,585 ,6 ,591 ,981 ,0,3,1,3,0,1,0,76.14,60.24 ,33.33
02,000,01,002,0023,26,663 ,5 ,668 ,1108 ,0,3,1,3,0,1,0,76.14,60.29 ,33.33
02,000,01,002,0024,27,1079 ,8 ,1087 ,1655 ,0,3,1,3,0,1,0,76.14,65.68 ,33.33
02,000,01,002,0024,28,950 ,5 ,955 ,1425 ,0,3,1,3,0,1,0,76.14,67.02 ,33.33
02,000,01,002,0024,29,776 ,4 ,780 ,1185 ,0,3,1,3,0,1,0,76.14,65.82 ,33.33
02,000,01,002,0025,30,711 ,3 ,714 ,1169 ,0,3,1,3,0,1,0,76.14,61.08 ,33.33
02,000,01,002,0025,31,768 ,3 ,771 ,1360 ,0,3,1,3,0,1,0,76.14,56.69 ,33.33
02,000,01,002,0025,32,869 ,7 ,876 ,1345 ,0,3,1,3,0,1,0,76.14,65.13 ,33.33
02,000,01,002,0026,33,962 ,0 ,962 ,1457 ,0,3,1,3,0,1,0,76.14,66.03 ,33.33
02,000,01,002,0027,34,771 ,6 ,777 ,1194 ,0,3,1,3,0,1,0,76.14,65.08 ,33.33
02,000,01,002,0028,35,690 ,3 ,693 ,1084 ,0,3,1,3,0,1,0,76.14,63.93 ,33.33
02,000,01,002,0028,36,651 ,1 ,652 ,1000 ,0,3,1,3,0,1,0,76.14,65.20 ,33.33
02,000,01,002,0029,37,831 ,3 ,834 ,1406 ,0,3,1,3,0,1,0,76.14,59.32 ,33.33
02,000,01,002,0029,38,773 ,2 ,775 ,1326 ,0,3,1,3,0,1,0,76.14,58.45 ,33.33
02,000,01,002,0029,39,733 ,4 ,737 ,1219 ,0,3,1,3,0,1,0,76.14,60.46 ,33.33
02,000,01,002,0030,40,586 ,3 ,589 ,830 ,0,3,1,3,0,1,0,76.14,70.96 ,33.33
02,000,01,002,0031,41,919 ,10 ,929 ,1480 ,0,3,1,3,0,1,0,76.14,62.77 ,33.33
02,000,01,002,0032,42,1069 ,9 ,1078 ,1839 ,0,3,1,3,0,1,0,76.14,58.62 ,33.33
02,000,01,002,0033,43,1007 ,7 ,1014 ,1668 ,0,3,1,3,0,1,0,76.14,60.79 ,33.33
02,000,01,002,0033,44,938 ,5 ,943 ,1550 ,0,3,1,3,0,1,0,76.14,60.84 ,33.33
02,000,01,002,0034,45,960 ,8 ,968 ,1471 ,0,3,1,3,0,1,0,76.14,65.81 ,33.33
02,000,01,002,0034,46,804 ,5 ,809 ,1329 ,0,3,1,3,0,1,0,76.14,60.87 ,33.33
02,000,01,002,0035,47,1089 ,8 ,1097 ,1805 ,0,3,1,3,0,1,0,76.14,60.78 ,33.33
02,000,01,002,0035,48,505 ,5 ,510 ,805 ,0,3,1,3,0,1,0,76.14,63.35 ,33.33
02,000,01,002,0036,49,1040 ,9 ,1049 ,1777 ,0,3,1,3,0,1,0,76.14,59.03 ,33.33
02,000,01,002,0036,50,1122 ,7 ,1129 ,1975 ,0,3,1,3,0,1,0,76.14,57.16 ,33.33
02,000,01,002,0036,51,919 ,7 ,926 ,1716 ,0,3,1,3,0,1,0,76.14,53.96 ,33.33
02,000,01,002,0037,52,1555 ,3 ,1558 ,2784 ,0,3,1,3,0,1,0,76.14,55.96 ,33.33
02,000,01,002,0038,53,1025 ,3 ,1028 ,1769 ,0,3,1,3,0,1,0,76.14,58.11 ,33.33
02,000,01,002,0038,54,1094 ,4 ,1098 ,1825 ,0,3,1,3,0,1,0,76.14,60.16 ,33.33
02,000,01,002,0038,55,1180 ,3 ,1183 ,2037 ,0,3,1,3,0,1,0,76.14,58.08 ,33.33
02,000,01,002,0038,56,1023 ,7 ,1030 ,1811 ,0,3,1,3,0,1,0,76.14,56.87 ,33.33
02,000,01,002,0038,57,852 ,2 ,854 ,1550 ,0,3,1,3,0,1,0,76.14,55.10 ,33.33
02,000,01,002,0038,58,913 ,4 ,917 ,1624 ,0,3,1,3,0,1,0,76.14,56.47 ,33.33
02,000,01,002,0039,59,1157 ,4 ,1161 ,1826 ,0,3,1,3,0,1,0,76.14,63.58 ,33.33
02,000,01,002,0039,60,1090 ,4 ,1094 ,1800 ,0,3,1,3,0,1,0,76.14,60.78 ,33.33
02,000,01,002,0040,61,851 ,4 ,855 ,1422 ,0,3,1,3,0,1,0,76.14,60.13 ,33.33
02,000,01,002,0040,62,851 ,2 ,853 ,1435 ,0,3,1,3,0,1,0,76.14,59.44 ,33.33
02,000,01,002,0041,63,648 ,1 ,649 ,1048 ,0,3,1,3,0,1,0,76.14,61.93 ,33.33
02,000,01,002,0041,64,760 ,1 ,761 ,1285 ,0,3,1,3,0,1,0,76.14,59.22 ,33.33
02,000,01,002,0042,65,840 ,10 ,850 ,1492 ,0,3,1,3,0,1,0,76.14,56.97 ,33.33
02,000,01,002,0043,66,752 ,14 ,766 ,1176 ,0,3,1,3,0,1,0,76.14,65.14 ,33.33
02,000,01,002,0044,67,607 ,7 ,614 ,1240 ,0,3,1,3,0,1,0,76.14,49.52 ,33.33
02,000,01,002,0045,68,893 ,4 ,897 ,1488 ,0,3,1,3,0,1,0,76.14,60.28 ,33.33
02,000,01,002,0046,69,930 ,12 ,942 ,1524 ,0,3,1,3,0,1,0,76.14,61.81 ,33.33
02,000,01,002,0047,70,775 ,8 ,783 ,1310 ,0,3,1,3,0,1,0,76.14,59.77 ,33.33
02,000,01,002,0048,71,957 ,10 ,967 ,1550 ,0,3,1,3,0,1,0,76.14,62.39 ,33.33
02,000,01,002,0049,72,922 ,6 ,928 ,1560 ,0,3,1,3,0,1,0,76.14,59.49 ,33.33
02,000,01,002,0050,73,504 ,4 ,508 ,804 ,0,3,1,3,0,1,0,76.14,63.18 ,33.33
02,000,01,002,0051,74,586 ,9 ,595 ,1034 ,0,3,1,3,0,1,0,76.14,57.54 ,33.33
02,000,01,002,0052,75,649 ,7 ,656 ,1158 ,0,3,1,3,0,1,0,76.14,56.65 ,33.33
02,000,01,002,0053,76,676 ,7 ,683 ,1150 ,0,3,1,3,0,1,0,76.14,59.39 ,33.33
02,000,01,002,0054,77,580 ,2 ,582 ,912 ,0,3,1,3,0,1,0,76.14,63.82 ,33.33
02,000,01,002,0055,78,843 ,4 ,847 ,1419 ,0,3,1,3,0,1,0,76.14,59.69 ,33.33
02,000,01,002,0056,79,769 ,7 ,776 ,1409 ,0,3,1,3,0,1,0,76.14,55.07 ,33.33
02,000,01,002,0057,80,873 ,7 ,880 ,1568 ,0,3,1,3,0,1,0,76.14,56.12 ,33.33
02,000,01,002,0058,81,694 ,5 ,699 ,1174 ,0,3,1,3,0,1,0,76.14,59.54 ,33.33
02,000,01,002,0059,82,317 ,1 ,318 ,602 ,0,3,1,3,0,1,0,76.14,52.82 ,33.33
02,000,01,003,0060,83,699 ,8 ,707 ,1230 ,0,3,1,3,0,1,0,76.14,57.48 ,33.33
02,000,01,003,0061,84,626 ,6 ,632 ,1077 ,0,3,1,3,0,1,0,76.14,58.68 ,33.33
02,000,01,003,0062,85,910 ,10 ,920 ,1682 ,0,3,1,3,0,1,0,76.14,54.70 ,33.33
02,000,01,003,0063,86,632 ,4 ,636 ,1129 ,0,3,1,3,0,1,0,76.14,56.33 ,33.33
02,000,01,003,0063,87,494 ,2 ,496 ,965 ,0,3,1,3,0,1,0,76.14,51.40 ,33.33
02,000,01,003,0064,88,750 ,9 ,759 ,1416 ,0,3,1,3,0,1,0,76.14,53.60 ,33.33
02,000,01,003,0064,89,695 ,9 ,704 ,1345 ,0,3,1,3,0,1,0,76.14,52.34 ,33.33
02,000,01,003,0065,90,720 ,6 ,726 ,1264 ,0,3,1,3,0,1,0,76.14,57.44 ,33.33
02,000,01,003,0066,91,714 ,13 ,727 ,1292 ,0,3,1,3,0,1,0,76.14,56.27 ,33.33
02,000,01,003,0067,92,643 ,3 ,646 ,1210 ,0,3,1,3,0,1,0,76.14,53.39 ,33.33
02,000,01,003,0067,93,623 ,4 ,627 ,1221 ,0,3,1,3,0,1,0,76.14,51.35 ,33.33
02,000,01,003,0068,94,929 ,7 ,936 ,1670 ,0,3,1,3,0,1,0,76.14,56.05 ,33.33
02,000,01,003,0069,95,669 ,5 ,674 ,1335 ,0,3,1,3,0,1,0,76.14,50.49 ,33.33
02,000,01,003,0069,96,684 ,1 ,685 ,1222 ,0,3,1,3,0,1,0,76.14,56.06 ,33.33
02,000,01,003,0070,97,929 ,6 ,935 ,1624 ,0,3,1,3,0,1,0,76.14,57.57 ,33.33
02,000,01,003,0071,98,475 ,5 ,480 ,926 ,0,3,1,3,0,1,0,76.14,51.84 ,33.33
02,000,01,003,0072,99,644 ,1 ,645 ,1075 ,0,3,1,3,0,1,0,76.14,60.00 ,33.33
02,000,01,003,0072,100,594 ,3 ,597 ,1118 ,0,3,1,3,0,1,0,76.14,53.40 ,33.33
02,000,01,004,0073,101,934 ,10 ,944 ,2016 ,0,3,1,3,0,1,0,76.14,46.83 ,33.33
02,000,01,004,0074,102,779 ,4 ,783 ,1194 ,0,3,1,3,0,1,0,76.14,65.58 ,33.33
02,000,01,004,0075,103,363 ,6 ,369 ,591 ,0,3,1,3,0,1,0,76.14,62.44 ,33.33
02,000,01,004,0076,104,430 ,4 ,434 ,692 ,0,3,1,3,0,1,0,76.14,62.72 ,33.33
02,000,01,004,0077,105,346 ,6 ,352 ,566 ,0,3,1,3,0,1,0,76.14,62.19 ,33.33
02,000,01,004,0078,106,598 ,1 ,599 ,887 ,0,3,1,3,0,1,0,76.14,67.53 ,33.33
02,000,01,004,0079,107,653 ,3 ,656 ,1025 ,0,3,1,3,0,1,0,76.14,64.00 ,33.33
02,000,01,004,0080,108,521 ,1 ,522 ,817 ,0,3,1,3,0,1,0,76.14,63.89 ,33.33
02,000,01,004,0081,109,865 ,7 ,872 ,1365 ,0,3,1,3,0,1,0,76.14,63.88 ,33.33
02,000,01,004,0081,110,937 ,5 ,942 ,1525 ,0,3,1,3,0,1,0,76.14,61.77 ,33.33
02,000,01,004,0082,111,910 ,10 ,920 ,1436 ,0,3,1,3,0,1,0,76.14,64.07 ,33.33
02,000,01,004,0083,112,436 ,1 ,437 ,586 ,0,3,1,3,0,1,0,76.14,74.57 ,33.33
02,000,01,004,0084,113,693 ,3 ,696 ,1019 ,0,3,1,3,0,1,0,76.14,68.30 ,33.33
02,000,01,004,0084,114,567 ,4 ,571 ,927 ,0,3,1,3,0,1,0,76.14,61.60 ,33.33
02,000,01,004,0085,115,824 ,2 ,826 ,1226 ,0,3,1,3,0,1,0,76.14,67.37 ,33.33
02,000,01,004,0086,116,1044 ,5 ,1049 ,1718 ,0,3,1,3,0,1,0,76.14,61.06 ,33.33
02,000,01,004,0087,117,691 ,3 ,694 ,1134 ,0,3,1,3,0,1,0,76.14,61.20 ,33.33
02,000,01,004,0087,118,813 ,6 ,819 ,1357 ,0,3,1,3,0,1,0,76.14,60.35 ,33.33
02,000,01,004,0088,119,920 ,2 ,922 ,1325 ,0,3,1,3,0,1,0,76.14,69.58 ,33.33
02,000,01,004,0089,120,56 ,0 ,56 ,158 ,0,3,1,3,0,1,0,76.14,35.44 ,33.33
02,000,01,004,0090,121,981 ,6 ,987 ,1505 ,0,3,1,3,0,1,0,76.14,65.58 ,33.33
02,000,01,004,0091,122,19 ,0 ,19 ,46 ,0,3,1,3,0,1,0,76.14,41.30 ,33.33
02,000,01,004,0092,123,766 ,3 ,769 ,1152 ,0,3,1,3,0,1,0,76.14,66.75 ,33.33
02,000,01,004,0093,124,598 ,4 ,602 ,914 ,0,3,1,3,0,1,0,76.14,65.86 ,33.33
02,000,01,004,0094,125,236 ,0 ,236 ,368 ,0,3,1,3,0,1,0,76.14,64.13 ,33.33
02,000,01,004,0095,126,344 ,0 ,344 ,583 ,0,3,1,3,0,1,0,76.14,59.01 ,33.33
02,000,01,004,0096,127,370 ,0 ,370 ,568 ,0,3,1,3,0,1,0,76.14,65.14 ,33.33
02,000,01,004,0097,128,480 ,2 ,482 ,768 ,0,3,1,3,0,1,0,76.14,62.76 ,33.33
02,000,01,004,0098,129,330 ,14 ,344 ,535 ,0,3,1,3,0,1,0,76.14,64.30 ,33.33
02,000,01,004,0099,130,458 ,0 ,458 ,713 ,0,3,1,3,0,1,0,76.14,64.24 ,33.33
02,000,01,004,0100,131,709 ,9 ,718 ,1091 ,0,3,1,3,0,1,0,76.14,65.81 ,33.33
02,000,01,004,0101,132,865 ,7 ,872 ,1418 ,0,3,1,3,0,1,0,76.14,61.50 ,33.33
02,000,01,004,0102,133,734 ,4 ,738 ,1184 ,0,3,1,3,0,1,0,76.14,62.33 ,33.33
02,000,01,004,0103,134,953 ,2 ,955 ,1429 ,0,3,1,3,0,1,0,76.14,66.83 ,33.33
02,000,01,004,0103,135,1345 ,11 ,1356 ,2013 ,0,3,1,3,0,1,0,76.14,67.36 ,33.33
02,000,01,004,0103,136,885 ,0 ,885 ,1219 ,0,3,1,3,0,1,0,76.14,72.60 ,33.33
02,000,01,004,0103,137,708 ,0 ,708 ,993 ,0,3,1,3,0,1,0,76.14,71.30 ,33.33
02,000,01,004,0104,138,15 ,0 ,15 ,59 ,0,3,1,3,0,1,0,76.14,25.42 ,33.33
02,000,01,004,0105,139,783 ,3 ,786 ,1113 ,0,3,1,3,0,1,0,76.14,70.62 ,33.33
02,000,01,004,0106,140,921 ,5 ,926 ,1360 ,0,3,1,3,0,1,0,76.14,68.09 ,33.33
02,000,01,004,0106,141,599 ,4 ,603 ,932 ,0,3,1,3,0,1,0,76.14,64.70 ,33.33
02,000,01,004,0107,142,610 ,6 ,616 ,875 ,0,3,1,3,0,1,0,76.14,70.40 ,33.33
02,000,01,004,0107,143,713 ,0 ,713 ,1020 ,0,3,1,3,0,1,0,76.14,69.90 ,33.33
02,000,01,004,0108,144,960 ,4 ,964 ,1541 ,0,3,1,3,0,1,0,76.14,62.56 ,33.33
02,000,01,004,0109,145,1143 ,8 ,1151 ,1705 ,0,3,1,3,0,1,0,76.14,67.51 ,33.33
02,000,01,004,0110,146,993 ,5 ,998 ,1742 ,0,3,1,3,0,1,0,76.14,57.29 ,33.33
02,000,01,004,0110,147,902 ,7 ,909 ,1717 ,0,3,1,3,0,1,0,76.14,52.94 ,33.33
02,000,01,004,0110,148,911 ,12 ,923 ,1658 ,0,3,1,3,0,1,0,76.14,55.67 ,33.33
02,000,01,004,0110,149,883 ,1 ,884 ,1661 ,0,3,1,3,0,1,0,76.14,53.22 ,33.33
02,000,01,004,0110,150,1056 ,4 ,1060 ,1713 ,0,3,1,3,0,1,0,76.14,61.88 ,33.33
02,000,01,004,0110,151,785 ,5 ,790 ,1401 ,0,3,1,3,0,1,0,76.14,56.39 ,33.33
02,000,01,004,0111,152,782 ,2 ,784 ,1301 ,0,3,1,3,0,1,0,76.14,60.26 ,33.33
02,000,01,004,0111,153,879 ,6 ,885 ,1403 ,0,3,1,3,0,1,0,76.14,63.08 ,33.33
02,000,01,004,0111,154,839 ,4 ,843 ,1416 ,0,3,1,3,0,1,0,76.14,59.53 ,33.33
02,000,01,004,0111,155,1044 ,3 ,1047 ,1855 ,0,3,1,3,0,1,0,76.14,56.44 ,33.33
02,000,01,004,0111,156,1069 ,2 ,1071 ,1967 ,0,3,1,3,0,1,0,76.14,54.45 ,33.33
02,000,01,004,0111,157,1004 ,7 ,1011 ,2015 ,0,3,1,3,0,1,0,76.14,50.17 ,33.33
02,000,01,004,0111,158,1026 ,3 ,1029 ,1895 ,0,3,1,3,0,1,0,76.14,54.30 ,33.33
02,000,01,004,0111,159,833 ,5 ,838 ,1540 ,0,3,1,3,0,1,0,76.14,54.42 ,33.33
02,000,01,004,0111,160,1009 ,2 ,1011 ,1963 ,0,3,1,3,0,1,0,76.14,51.50 ,33.33
02,000,01,004,0111,161,1020 ,6 ,1026 ,1938 ,0,3,1,3,0,1,0,76.14,52.94 ,33.33
02,000,01,004,0111,162,971 ,3 ,974 ,1743 ,0,3,1,3,0,1,0,76.14,55.88 ,33.33
02,000,01,004,0112,163,1013 ,6 ,1019 ,1727 ,0,3,1,3,0,1,0,76.14,59.00 ,33.33
02,000,01,004,0112,164,791 ,7 ,798 ,1280 ,0,3,1,3,0,1,0,76.14,62.34 ,33.33
02,000,01,004,0112,165,822 ,5 ,827 ,1511 ,0,3,1,3,0,1,0,76.14,54.73 ,33.33
02,000,01,004,0113,166,1014 ,5 ,1019 ,1730 ,0,3,1,3,0,1,0,76.14,58.90 ,33.33
02,000,01,004,0113,167,944 ,5 ,949 ,1861 ,0,3,1,3,0,1,0,76.14,50.99 ,33.33
02,000,01,004,0113,168,990 ,7 ,997 ,1786 ,0,3,1,3,0,1,0,76.14,55.82 ,33.33
02,000,01,004,0113,169,1114 ,2 ,1116 ,1946 ,0,3,1,3,0,1,0,76.14,57.35 ,33.33
02,000,01,004,0113,170,1072 ,6 ,1078 ,1965 ,0,3,1,3,0,1,0,76.14,54.86 ,33.33
02,000,01,004,0114,171,868 ,5 ,873 ,1644 ,0,3,1,3,0,1,0,76.14,53.10 ,33.33
02,000,01,004,0114,172,849 ,4 ,853 ,1727 ,0,3,1,3,0,1,0,76.14,49.39 ,33.33
02,000,01,004,0114,173,976 ,9 ,985 ,1787 ,0,3,1,3,0,1,0,76.14,55.12 ,33.33
02,000,01,004,0114,174,776 ,3 ,779 ,1503 ,0,3,1,3,0,1,0,76.14,51.83 ,33.33
02,000,01,004,0114,175,864 ,9 ,873 ,1681 ,0,3,1,3,0,1,0,76.14,51.93 ,33.33
02,000,01,004,0114,176,847 ,3 ,850 ,1631 ,0,3,1,3,0,1,0,76.14,52.12 ,33.33
02,000,01,004,0114,177,882 ,5 ,887 ,1769 ,0,3,1,3,0,1,0,76.14,50.14 ,33.33
02,000,01,004,0114,178,985 ,2 ,987 ,1870 ,0,3,1,3,0,1,0,76.14,52.78 ,33.33
02,000,01,004,0114,179,945 ,1 ,946 ,1726 ,0,3,1,3,0,1,0,76.14,54.81 ,33.33
02,000,01,004,0114,180,812 ,4 ,816 ,1512 ,0,3,1,3,0,1,0,76.14,53.97 ,33.33
02,000,01,004,0114,181,707 ,4 ,711 ,1305 ,0,3,1,3,0,1,0,76.14,54.48 ,33.33
02,000,01,004,0115,182,700 ,3 ,703 ,1425 ,0,3,1,3,0,1,0,76.14,49.33 ,33.33
02,000,01,004,0115,183,732 ,5 ,737 ,1557 ,0,3,1,3,0,1,0,76.14,47.33 ,33.33
02,000,01,004,0115,184,896 ,4 ,900 ,1767 ,0,3,1,3,0,1,0,76.14,50.93 ,33.33
02,000,01,004,0115,185,845 ,6 ,851 ,1686 ,0,3,1,3,0,1,0,76.14,50.47 ,33.33
02,000,01,004,0115,186,864 ,3 ,867 ,1676 ,0,3,1,3,0,1,0,76.14,51.73 ,33.33
02,000,01,004,0115,187,875 ,4 ,879 ,1820 ,0,3,1,3,0,1,0,76.14,48.30 ,33.33
02,000,01,004,0115,188,753 ,3 ,756 ,1649 ,0,3,1,3,0,1,0,76.14,45.85 ,33.33
02,000,01,004,0115,189,832 ,4 ,836 ,1659 ,0,3,1,3,0,1,0,76.14,50.39 ,33.33
02,000,01,004,0115,190,661 ,5 ,666 ,1356 ,0,3,1,3,0,1,0,76.14,49.12 ,33.33
02,000,01,004,0115,191,1028 ,9 ,1037 ,1958 ,0,3,1,3,0,1,0,76.14,52.96 ,33.33
02,000,01,004,0115,192,689 ,3 ,692 ,1412 ,0,3,1,3,0,1,0,76.14,49.01 ,33.33
02,000,01,004,0115,193,722 ,5 ,727 ,1406 ,0,3,1,3,0,1,0,76.14,51.71 ,33.33
02,000,01,004,0115,194,793 ,1 ,794 ,1469 ,0,3,1,3,0,1,0,76.14,54.05 ,33.33
02,000,01,005,0116,195,1028 ,9 ,1037 ,1847 ,0,3,1,3,0,1,0,76.14,56.15 ,33.33
02,000,01,005,0116,196,924 ,8 ,932 ,1718 ,0,3,1,3,0,1,0,76.14,54.25 ,33.33
02,000,01,005,0116,197,650 ,3 ,653 ,1220 ,0,3,1,3,0,1,0,76.14,53.52 ,33.33
02,000,01,005,0116,198,719 ,6 ,725 ,1389 ,0,3,1,3,0,1,0,76.14,52.20 ,33.33
02,000,01,005,0116,199,916 ,3 ,919 ,1792 ,0,3,1,3,0,1,0,76.14,51.28 ,33.33
02,000,01,005,0116,200,981 ,4 ,985 ,1771 ,0,3,1,3,0,1,0,76.14,55.62 ,33.33
02,000,01,005,0117,201,658 ,6 ,664 ,1164 ,0,3,1,3,0,1,0,76.14,57.04 ,33.33
02,000,01,005,0117,202,620 ,3 ,623 ,1075 ,0,3,1,3,0,1,0,76.14,57.95 ,33.33
02,000,01,005,0118,203,742 ,2 ,744 ,1302 ,0,3,1,3,0,1,0,76.14,57.14 ,33.33
02,000,01,005,0118,204,739 ,4 ,743 ,1481 ,0,3,1,3,0,1,0,76.14,50.17 ,33.33
02,000,01,005,0118,205,744 ,8 ,752 ,1504 ,0,3,1,3,0,1,0,76.14,50.00 ,33.33
02,000,01,005,0119,206,815 ,6 ,821 ,1274 ,0,3,1,3,0,1,0,76.14,64.44 ,33.33
02,000,01,005,0119,207,691 ,4 ,695 ,1417 ,0,3,1,3,0,1,0,76.14,49.05 ,33.33
02,000,01,005,0120,208,839 ,8 ,847 ,1418 ,0,3,1,3,0,1,0,76.14,59.73 ,33.33
02,000,01,005,0120,209,747 ,3 ,750 ,1208 ,0,3,1,3,0,1,0,76.14,62.09 ,33.33
02,000,01,005,0121,210,591 ,4 ,595 ,1348 ,0,3,1,3,0,1,0,76.14,44.14 ,33.33
02,000,01,005,0121,211,678 ,7 ,685 ,1202 ,0,3,1,3,0,1,0,76.14,56.99 ,33.33
02,000,01,005,0122,212,864 ,7 ,871 ,1567 ,0,3,1,3,0,1,0,76.14,55.58 ,33.33
02,000,01,005,0122,213,975 ,5 ,980 ,1664 ,0,3,1,3,0,1,0,76.14,58.89 ,33.33
02,000,01,005,0123,214,812 ,4 ,816 ,1514 ,0,3,1,3,0,1,0,76.14,53.90 ,33.33
02,000,01,005,0123,215,810 ,5 ,815 ,1537 ,0,3,1,3,0,1,0,76.14,53.03 ,33.33
02,000,01,005,0124,216,990 ,5 ,995 ,1635 ,0,3,1,3,0,1,0,76.14,60.86 ,33.33
02,000,01,005,0124,217,1002 ,5 ,1007 ,1727 ,0,3,1,3,0,1,0,76.14,58.31 ,33.33
02,000,01,005,0125,218,635 ,1 ,636 ,1064 ,0,3,1,3,0,1,0,76.14,59.77 ,33.33
02,000,01,005,0125,219,744 ,3 ,747 ,1232 ,0,3,1,3,0,1,0,76.14,60.63 ,33.33
02,000,01,005,0126,220,960 ,7 ,967 ,1635 ,0,3,1,3,0,1,0,76.14,59.14 ,33.33
02,000,01,005,0126,221,921 ,4 ,925 ,1501 ,0,3,1,3,0,1,0,76.14,61.63 ,33.33
02,000,01,005,0127,222,951 ,7 ,958 ,1591 ,0,3,1,3,0,1,0,76.14,60.21 ,33.33
02,000,01,005,0128,223,880 ,5 ,885 ,1565 ,0,3,1,3,0,1,0,76.14,56.55 ,33.33
02,000,01,005,0128,224,829 ,2 ,831 ,1583 ,0,3,1,3,0,1,0,76.14,52.50 ,33.33
02,000,01,005,0129,225,849 ,2 ,851 ,1542 ,0,3,1,3,0,1,0,76.14,55.19 ,33.33
02,000,01,005,0129,226,840 ,7 ,847 ,1613 ,0,3,1,3,0,1,0,76.14,52.51 ,33.33
02,000,01,005,0129,227,832 ,5 ,837 ,1527 ,0,3,1,3,0,1,0,76.14,54.81 ,33.33
02,000,01,005,0129,228,831 ,3 ,834 ,1556 ,0,3,1,3,0,1,0,76.14,53.60 ,33.33
02,000,01,005,0129,229,829 ,4 ,833 ,1536 ,0,3,1,3,0,1,0,76.14,54.23 ,33.33
02,000,01,005,0129,230,834 ,4 ,838 ,1553 ,0,3,1,3,0,1,0,76.14,53.96 ,33.33
02,000,01,005,0129,231,840 ,4 ,844 ,1628 ,0,3,1,3,0,1,0,76.14,51.84 ,33.33
02,000,01,005,0130,232,1069 ,12 ,1081 ,1654 ,0,3,1,3,0,1,0,76.14,65.36 ,33.33
02,000,01,005,0131,233,936 ,8 ,944 ,1458 ,0,3,1,3,0,1,0,76.14,64.75 ,33.33
02,000,01,005,0131,234,921 ,5 ,926 ,1416 ,0,3,1,3,0,1,0,76.14,65.40 ,33.33
02,000,01,005,0132,235,864 ,2 ,866 ,1258 ,0,3,1,3,0,1,0,76.14,68.84 ,33.33
02,000,01,005,0132,236,591 ,5 ,596 ,902 ,0,3,1,3,0,1,0,76.14,66.08 ,33.33
02,000,01,005,0133,237,874 ,7 ,881 ,1380 ,0,3,1,3,0,1,0,76.14,63.84 ,33.33
02,000,01,005,0133,238,998 ,11 ,1009 ,1625 ,0,3,1,3,0,1,0,76.14,62.09 ,33.33
02,000,01,005,0134,239,582 ,2 ,584 ,1073 ,0,3,1,3,0,1,0,76.14,54.43 ,33.33
02,000,01,005,0134,240,622 ,6 ,628 ,1163 ,0,3,1,3,0,1,0,76.14,54.00 ,33.33
02,000,01,005,0135,241,453 ,3 ,456 ,697 ,0,3,1,3,0,1,0,76.14,65.42 ,33.33
02,000,01,005,0135,242,779 ,6 ,785 ,1295 ,0,3,1,3,0,1,0,76.14,60.62 ,33.33
02,000,01,005,0136,243,1163 ,9 ,1172 ,1796 ,0,3,1,3,0,1,0,76.14,65.26 ,33.33
02,000,01,005,0136,244,869 ,1 ,870 ,1412 ,0,3,1,3,0,1,0,76.14,61.61 ,33.33
02,000,01,005,0137,245,821 ,3 ,824 ,1433 ,0,3,1,3,0,1,0,76.14,57.50 ,33.33
02,000,01,005,0137,246,779 ,2 ,781 ,1347 ,0,3,1,3,0,1,0,76.14,57.98 ,33.33
02,000,01,005,0138,247,926 ,7 ,933 ,1541 ,0,3,1,3,0,1,0,76.14,60.55 ,33.33
02,000,01,005,0139,248,777 ,4 ,781 ,1301 ,0,3,1,3,0,1,0,76.14,60.03 ,33.33
02,000,01,005,0139,249,1000 ,3 ,1003 ,1842 ,0,3,1,3,0,1,0,76.14,54.45 ,33.33
02,000,01,005,0140,250,709 ,3 ,712 ,1251 ,0,3,1,3,0,1,0,76.14,56.91 ,33.33
02,000,01,005,0140,251,674 ,3 ,677 ,1152 ,0,3,1,3,0,1,0,76.14,58.77 ,33.33
02,000,01,005,0141,252,676 ,4 ,680 ,1143 ,0,3,1,3,0,1,0,76.14,59.49 ,33.33
02,000,01,005,0141,253,658 ,6 ,664 ,1211 ,0,3,1,3,0,1,0,76.14,54.83 ,33.33
02,000,01,005,0142,254,628 ,5 ,633 ,1020 ,0,3,1,3,0,1,0,76.14,62.06 ,33.33
02,000,01,005,0142,255,692 ,4 ,696 ,1071 ,0,3,1,3,0,1,0,76.14,64.99 ,33.33
02,000,01,005,0143,256,1061 ,6 ,1067 ,1623 ,0,3,1,3,0,1,0,76.14,65.74 ,33.33
02,000,01,005,0143,257,920 ,6 ,926 ,1483 ,0,3,1,3,0,1,0,76.14,62.44 ,33.33
02,000,01,005,0144,258,995 ,5 ,1000 ,1653 ,0,3,1,3,0,1,0,76.14,60.50 ,33.33
02,000,01,005,0144,259,930 ,3 ,933 ,1588 ,0,3,1,3,0,1,0,76.14,58.75 ,33.33
02,000,01,005,0145,260,538 ,4 ,542 ,1010 ,0,3,1,3,0,1,0,76.14,53.66 ,33.33
02,000,01,005,0145,261,626 ,3 ,629 ,1003 ,0,3,1,3,0,1,0,76.14,62.71 ,33.33
02,000,01,005,0146,262,847 ,5 ,852 ,1385 ,0,3,1,3,0,1,0,76.14,61.52 ,33.33
02,000,01,005,0146,263,890 ,10 ,900 ,1468 ,0,3,1,3,0,1,0,76.14,61.31 ,33.33
02,000,01,005,0147,264,909 ,5 ,914 ,1567 ,0,3,1,3,0,1,0,76.14,58.33 ,33.33
02,000,01,005,0147,265,912 ,7 ,919 ,1585 ,0,3,1,3,0,1,0,76.14,57.98 ,33.33
02,000,01,005,0148,266,679 ,4 ,683 ,1283 ,0,3,1,3,0,1,0,76.14,53.23 ,33.33
02,000,01,005,0148,267,820 ,3 ,823 ,1447 ,0,3,1,3,0,1,0,76.14,56.88 ,33.33
02,000,01,005,0148,268,862 ,3 ,865 ,1508 ,0,3,1,3,0,1,0,76.14,57.36 ,33.33
02,000,01,005,0148,269,874 ,4 ,878 ,1565 ,0,3,1,3,0,1,0,76.14,56.10 ,33.33
02,000,01,005,0149,270,915 ,1 ,916 ,1708 ,0,3,1,3,0,1,0,76.14,53.63 ,33.33
02,000,01,005,0149,271,964 ,8 ,972 ,1760 ,0,3,1,3,0,1,0,76.14,55.23 ,33.33
02,000,01,005,0150,272,591 ,34 ,625 ,1035 ,0,3,1,3,0,1,0,76.14,60.39 ,33.33
02,000,01,005,0151,273,498 ,2 ,500 ,847 ,0,3,1,3,0,1,0,76.14,59.03 ,33.33
02,000,01,005,0152,274,932 ,2 ,934 ,1487 ,0,3,1,3,0,1,0,76.14,62.81 ,33.33
02,000,01,006,0153,275,1001 ,4 ,1005 ,1898 ,0,3,1,3,0,1,0,76.14,52.95 ,33.33
02,000,01,006,0153,276,676 ,5 ,681 ,1208 ,0,3,1,3,0,1,0,76.14,56.37 ,33.33
02,000,01,006,0154,277,734 ,10 ,744 ,1363 ,0,3,1,3,0,1,0,76.14,54.59 ,33.33
02,000,01,006,0154,278,732 ,3 ,735 ,1336 ,0,3,1,3,0,1,0,76.14,55.01 ,33.33
02,000,01,006,0154,279,767 ,9 ,776 ,1522 ,0,3,1,3,0,1,0,76.14,50.99 ,33.33
02,000,01,006,0154,280,905 ,7 ,912 ,1646 ,0,3,1,3,0,1,0,76.14,55.41 ,33.33
02,000,01,006,0155,281,925 ,2 ,927 ,1652 ,0,3,1,3,0,1,0,76.14,56.11 ,33.33
02,000,01,006,0155,282,948 ,2 ,950 ,1785 ,0,3,1,3,0,1,0,76.14,53.22 ,33.33
02,000,01,006,0156,283,913 ,8 ,921 ,1642 ,0,3,1,3,0,1,0,76.14,56.09 ,33.33
02,000,01,006,0156,284,994 ,8 ,1002 ,1772 ,0,3,1,3,0,1,0,76.14,56.55 ,33.33
02,000,01,006,0157,285,1055 ,5 ,1060 ,2070 ,0,3,1,3,0,1,0,76.14,51.21 ,33.33
02,000,01,006,0157,286,1007 ,8 ,1015 ,1763 ,0,3,1,3,0,1,0,76.14,57.57 ,33.33
02,000,01,006,0157,287,881 ,8 ,889 ,1690 ,0,3,1,3,0,1,0,76.14,52.60 ,33.33
02,000,01,006,0158,288,991 ,5 ,996 ,1575 ,0,3,1,3,0,1,0,76.14,63.24 ,33.33
02,000,01,006,0158,289,936 ,7 ,943 ,1541 ,0,3,1,3,0,1,0,76.14,61.19 ,33.33
02,000,01,006,0159,290,958 ,2 ,960 ,1741 ,0,3,1,3,0,1,0,76.14,55.14 ,33.33
02,000,01,006,0159,291,997 ,8 ,1005 ,1826 ,0,3,1,3,0,1,0,76.14,55.04 ,33.33
02,000,01,006,0159,292,993 ,8 ,1001 ,1755 ,0,3,1,3,0,1,0,76.14,57.04 ,33.33
02,000,01,006,0159,293,639 ,2 ,641 ,1378 ,0,3,1,3,0,1,0,76.14,46.52 ,33.33
02,000,01,006,0159,294,1076 ,5 ,1081 ,1970 ,0,3,1,3,0,1,0,76.14,54.87 ,33.33
02,000,01,006,0159,295,1033 ,3 ,1036 ,1842 ,0,3,1,3,0,1,0,76.14,56.24 ,33.33
02,000,01,006,0159,296,927 ,5 ,932 ,1724 ,0,3,1,3,0,1,0,76.14,54.06 ,33.33
02,000,01,006,0159,297,698 ,5 ,703 ,1175 ,0,3,1,3,0,1,0,76.14,59.83 ,33.33
02,000,01,006,0159,298,796 ,2 ,798 ,1416 ,0,3,1,3,0,1,0,76.14,56.36 ,33.33
02,000,01,006,0159,299,880 ,2 ,882 ,1481 ,0,3,1,3,0,1,0,76.14,59.55 ,33.33
02,000,01,006,0160,300,1071 ,5 ,1076 ,1881 ,0,3,1,3,0,1,0,76.14,57.20 ,33.33
02,000,01,006,0160,301,1075 ,14 ,1089 ,1807 ,0,3,1,3,0,1,0,76.14,60.27 ,33.33
02,000,01,006,0160,302,1040 ,4 ,1044 ,1814 ,0,3,1,3,0,1,0,76.14,57.55 ,33.33
02,000,01,006,0160,303,1116 ,6 ,1122 ,1916 ,0,3,1,3,0,1,0,76.14,58.56 ,33.33
02,000,01,006,0161,304,1045 ,6 ,1051 ,1850 ,0,3,1,3,0,1,0,76.14,56.81 ,33.33
02,000,01,006,0161,305,1095 ,6 ,1101 ,1929 ,0,3,1,3,0,1,0,76.14,57.08 ,33.33
02,000,01,006,0161,306,1107 ,10 ,1117 ,2102 ,0,3,1,3,0,1,0,76.14,53.14 ,33.33
02,000,01,006,0162,307,622 ,6 ,628 ,1099 ,0,3,1,3,0,1,0,76.14,57.14 ,33.33
02,000,01,006,0162,308,594 ,3 ,597 ,930 ,0,3,1,3,0,1,0,76.14,64.19 ,33.33
02,000,01,006,0163,309,887 ,6 ,893 ,1508 ,0,3,1,3,0,1,0,76.14,59.22 ,33.33
02,000,01,006,0164,310,856 ,5 ,861 ,1512 ,0,3,1,3,0,1,0,76.14,56.94 ,33.33
02,000,01,006,0164,311,787 ,9 ,796 ,1425 ,0,3,1,3,0,1,0,76.14,55.86 ,33.33
02,000,01,006,0164,312,799 ,2 ,801 ,1469 ,0,3,1,3,0,1,0,76.14,54.53 ,33.33
02,000,01,006,0165,313,615 ,5 ,620 ,1204 ,0,3,1,3,0,1,0,76.14,51.50 ,33.33
02,000,01,006,0165,314,757 ,4 ,761 ,1262 ,0,3,1,3,0,1,0,76.14,60.30 ,33.33
02,000,01,006,0165,315,762 ,4 ,766 ,1323 ,0,3,1,3,0,1,0,76.14,57.90 ,33.33
02,000,01,006,0166,316,775 ,3 ,778 ,1378 ,0,3,1,3,0,1,0,76.14,56.46 ,33.33
02,000,01,006,0166,317,726 ,2 ,728 ,1255 ,0,3,1,3,0,1,0,76.14,58.01 ,33.33
02,000,01,006,0166,318,828 ,6 ,834 ,1476 ,0,3,1,3,0,1,0,76.14,56.50 ,33.33
02,000,01,006,0167,319,941 ,2 ,943 ,1614 ,0,3,1,3,0,1,0,76.14,58.43 ,33.33
02,000,01,006,0167,320,917 ,5 ,922 ,1632 ,0,3,1,3,0,1,0,76.14,56.50 ,33.33
02,000,01,006,0167,321,956 ,8 ,964 ,1706 ,0,3,1,3,0,1,0,76.14,56.51 ,33.33
02,000,01,006,0167,322,835 ,3 ,838 ,1564 ,0,3,1,3,0,1,0,76.14,53.58 ,33.33
02,000,01,006,0168,323,988 ,9 ,997 ,1808 ,0,3,1,3,0,1,0,76.14,55.14 ,33.33
02,000,01,006,0168,324,947 ,3 ,950 ,1626 ,0,3,1,3,0,1,0,76.14,58.43 ,33.33
02,000,01,006,0169,325,752 ,6 ,758 ,1334 ,0,3,1,3,0,1,0,76.14,56.82 ,33.33
02,000,01,006,0169,326,849 ,5 ,854 ,1585 ,0,3,1,3,0,1,0,76.14,53.88 ,33.33
02,000,01,006,0169,327,848 ,6 ,854 ,1549 ,0,3,1,3,0,1,0,76.14,55.13 ,33.33
02,000,01,006,0170,328,787 ,2 ,789 ,1518 ,0,3,1,3,0,1,0,76.14,51.98 ,33.33
02,000,01,006,0170,329,774 ,4 ,778 ,1597 ,0,3,1,3,0,1,0,76.14,48.72 ,33.33
02,000,01,006,0171,330,796 ,5 ,801 ,1321 ,0,3,1,3,0,1,0,76.14,60.64 ,33.33
02,000,01,006,0171,331,754 ,5 ,759 ,1295 ,0,3,1,3,0,1,0,76.14,58.61 ,33.33
02,000,01,006,0171,332,696 ,6 ,702 ,1266 ,0,3,1,3,0,1,0,76.14,55.45 ,33.33
02,000,01,006,0171,333,718 ,3 ,721 ,1383 ,0,3,1,3,0,1,0,76.14,52.13 ,33.33
02,000,01,006,0172,334,789 ,2 ,791 ,1293 ,0,3,1,3,0,1,0,76.14,61.18 ,33.33
02,000,01,006,0172,335,808 ,4 ,812 ,1375 ,0,3,1,3,0,1,0,76.14,59.05 ,33.33
02,000,01,006,0173,336,777 ,1 ,778 ,1351 ,0,3,1,3,0,1,0,76.14,57.59 ,33.33
02,000,01,006,0173,337,860 ,3 ,863 ,1438 ,0,3,1,3,0,1,0,76.14,60.01 ,33.33
02,000,01,006,0174,338,838 ,1 ,839 ,1695 ,0,3,1,3,0,1,0,76.14,49.50 ,33.33
02,000,01,006,0174,339,779 ,6 ,785 ,1505 ,0,3,1,3,0,1,0,76.14,52.16 ,33.33
02,000,01,006,0174,340,958 ,8 ,966 ,1724 ,0,3,1,3,0,1,0,76.14,56.03 ,33.33
02,000,01,006,0174,341,840 ,6 ,846 ,1475 ,0,3,1,3,0,1,0,76.14,57.36 ,33.33
02,000,01,006,0175,342,732 ,6 ,738 ,1285 ,0,3,1,3,0,1,0,76.14,57.43 ,33.33
02,000,01,006,0175,343,745 ,3 ,748 ,1351 ,0,3,1,3,0,1,0,76.14,55.37 ,33.33
02,000,01,006,0176,344,672 ,2 ,674 ,1219 ,0,3,1,3,0,1,0,76.14,55.29 ,33.33
02,000,01,006,0176,345,609 ,3 ,612 ,1214 ,0,3,1,3,0,1,0,76.14,50.41 ,33.33
02,000,01,006,0177,346,757 ,4 ,761 ,1436 ,0,3,1,3,0,1,0,76.14,52.99 ,33.33
02,000,01,006,0177,347,741 ,3 ,744 ,1395 ,0,3,1,3,0,1,0,76.14,53.33 ,33.33
02,000,01,006,0177,348,762 ,3 ,765 ,1346 ,0,3,1,3,0,1,0,76.14,56.84 ,33.33
02,000,01,006,0178,349,757 ,4 ,761 ,1269 ,0,3,1,3,0,1,0,76.14,59.97 ,33.33
02,000,01,006,0178,350,738 ,6 ,744 ,1217 ,0,3,1,3,0,1,0,76.14,61.13 ,33.33
02,000,01,006,0178,351,839 ,3 ,842 ,1464 ,0,3,1,3,0,1,0,76.14,57.51 ,33.33
02,000,01,006,0179,352,1047 ,7 ,1054 ,1943 ,0,3,1,3,0,1,0,76.14,54.25 ,33.33
02,000,01,006,0179,353,1035 ,5 ,1040 ,2034 ,0,3,1,3,0,1,0,76.14,51.13 ,33.33
02,000,01,006,0179,354,1021 ,3 ,1024 ,1923 ,0,3,1,3,0,1,0,76.14,53.25 ,33.33
02,000,01,006,0180,355,768 ,2 ,770 ,1352 ,0,3,1,3,0,1,0,76.14,56.95 ,33.33
02,000,01,006,0180,356,723 ,5 ,728 ,1203 ,0,3,1,3,0,1,0,76.14,60.52 ,33.33
02,000,01,006,0180,357,747 ,1 ,748 ,1366 ,0,3,1,3,0,1,0,76.14,54.76 ,33.33
02,000,01,006,0181,358,868 ,7 ,875 ,2103 ,0,3,1,3,0,1,0,76.14,41.61 ,33.33
02,000,01,006,0181,359,797 ,9 ,806 ,1550 ,0,3,1,3,0,1,0,76.14,52.00 ,33.33
02,000,01,006,0181,360,876 ,1 ,877 ,1577 ,0,3,1,3,0,1,0,76.14,55.61 ,33.33
02,000,01,006,0182,361,923 ,14 ,937 ,1755 ,0,3,1,3,0,1,0,76.14,53.39 ,33.33
02,000,01,006,0182,362,985 ,3 ,988 ,1769 ,0,3,1,3,0,1,0,76.14,55.85 ,33.33
02,000,01,006,0182,363,845 ,9 ,854 ,1723 ,0,3,1,3,0,1,0,76.14,49.56 ,33.33
02,000,01,006,0182,364,930 ,5 ,935 ,1787 ,0,3,1,3,0,1,0,76.14,52.32 ,33.33
02,000,01,006,0183,365,866 ,0 ,866 ,1652 ,0,3,1,3,0,1,0,76.14,52.42 ,33.33
02,000,01,006,0183,366,727 ,4 ,731 ,1377 ,0,3,1,3,0,1,0,76.14,53.09 ,33.33
02,000,01,006,0184,367,782 ,6 ,788 ,1435 ,0,3,1,3,0,1,0,76.14,54.91 ,33.33
02,000,01,006,0184,368,708 ,3 ,711 ,1467 ,0,3,1,3,0,1,0,76.14,48.47 ,33.33
02,000,01,006,0185,369,823 ,3 ,826 ,1413 ,0,3,1,3,0,1,0,76.14,58.46 ,33.33
02,000,01,006,0185,370,644 ,3 ,647 ,1186 ,0,3,1,3,0,1,0,76.14,54.55 ,33.33
02,000,01,006,0185,371,807 ,7 ,814 ,1404 ,0,3,1,3,0,1,0,76.14,57.98 ,33.33
02,000,01,006,0186,372,744 ,5 ,749 ,1375 ,0,3,1,3,0,1,0,76.14,54.47 ,33.33
02,000,01,006,0186,373,704 ,5 ,709 ,1236 ,0,3,1,3,0,1,0,76.14,57.36 ,33.33
02,000,01,006,0187,374,581 ,6 ,587 ,999 ,0,3,1,3,0,1,0,76.14,58.76 ,33.33
02,000,01,006,0187,375,620 ,1 ,621 ,1019 ,0,3,1,3,0,1,0,76.14,60.94 ,33.33
02,000,01,006,0188,376,978 ,9 ,987 ,1700 ,0,3,1,3,0,1,0,76.14,58.06 ,33.33
02,000,01,006,0188,377,941 ,4 ,945 ,1529 ,0,3,1,3,0,1,0,76.14,61.81 ,33.33
02,000,01,006,0189,378,828 ,16 ,844 ,1425 ,0,3,1,3,0,1,0,76.14,59.23 ,33.33
02,000,01,006,0189,379,739 ,4 ,743 ,1526 ,0,3,1,3,0,1,0,76.14,48.69 ,33.33
02,000,01,006,0190,380,793 ,11 ,804 ,1583 ,0,3,1,3,0,1,0,76.14,50.79 ,33.33
02,000,01,006,0190,381,1178 ,12 ,1190 ,2233 ,0,3,1,3,0,1,0,76.14,53.29 ,33.33
02,000,01,006,0190,382,931 ,5 ,936 ,1701 ,0,3,1,3,0,1,0,76.14,55.03 ,33.33
02,000,01,006,0190,383,844 ,0 ,844 ,1588 ,0,3,1,3,0,1,0,76.14,53.15 ,33.33
02,000,01,006,0190,384,921 ,6 ,927 ,1805 ,0,3,1,3,0,1,0,76.14,51.36 ,33.33
02,000,01,006,0191,385,891 ,5 ,896 ,1555 ,0,3,1,3,0,1,0,76.14,57.62 ,33.33
02,000,01,006,0191,386,1035 ,8 ,1043 ,1726 ,0,3,1,3,0,1,0,76.14,60.43 ,33.33
02,000,01,006,0192,387,911 ,4 ,915 ,1506 ,0,3,1,3,0,1,0,76.14,60.76 ,33.33
02,000,01,006,0193,388,1074 ,7 ,1081 ,1980 ,0,3,1,3,0,1,0,76.14,54.60 ,33.33
02,000,01,006,0194,389,771 ,1 ,772 ,1443 ,0,3,1,3,0,1,0,76.14,53.50 ,33.33
02,000,01,006,0194,390,813 ,2 ,815 ,1468 ,0,3,1,3,0,1,0,76.14,55.52 ,33.33
02,000,01,006,0195,391,513 ,2 ,515 ,974 ,0,3,1,3,0,1,0,76.14,52.87 ,33.33
02,000,01,006,0195,392,554 ,8 ,562 ,1042 ,0,3,1,3,0,1,0,76.14,53.93 ,33.33
02,000,01,006,0196,393,625 ,6 ,631 ,1336 ,0,3,1,3,0,1,0,76.14,47.23 ,33.33
02,000,01,006,0196,394,686 ,3 ,689 ,1314 ,0,3,1,3,0,1,0,76.14,52.44 ,33.33
02,000,01,006,0196,395,864 ,2 ,866 ,1574 ,0,3,1,3,0,1,0,76.14,55.02 ,33.33
02,000,01,006,0197,396,742 ,6 ,748 ,1370 ,0,3,1,3,0,1,0,76.14,54.60 ,33.33
02,000,01,006,0197,397,778 ,10 ,788 ,1362 ,0,3,1,3,0,1,0,76.14,57.86 ,33.33
02,000,01,006,0197,398,758 ,5 ,763 ,1401 ,0,3,1,3,0,1,0,76.14,54.46 ,33.33
02,000,01,006,0198,399,945 ,2 ,947 ,1555 ,0,3,1,3,0,1,0,76.14,60.90 ,33.33
02,000,01,006,0198,400,952 ,5 ,957 ,1568 ,0,3,1,3,0,1,0,76.14,61.03 ,33.33
02,000,01,006,0199,401,803 ,3 ,806 ,1297 ,0,3,1,3,0,1,0,76.14,62.14 ,33.33
02,000,01,006,0199,402,811 ,2 ,813 ,1360 ,0,3,1,3,0,1,0,76.14,59.78 ,33.33
02,000,01,006,0200,403,875 ,4 ,879 ,1428 ,0,3,1,3,0,1,0,76.14,61.55 ,33.33
02,000,01,006,0201,404,1034 ,7 ,1041 ,1666 ,0,3,1,3,0,1,0,76.14,62.48 ,33.33
02,000,01,006,0202,405,900 ,6 ,906 ,1443 ,0,3,1,3,0,1,0,76.14,62.79 ,33.33
02,000,01,006,0203,406,616 ,3 ,619 ,1056 ,0,3,1,3,0,1,0,76.14,58.62 ,33.33
02,000,01,006,0204,407,837 ,3 ,840 ,1445 ,0,3,1,3,0,1,0,76.14,58.13 ,33.33
02,000,01,006,0204,408,786 ,6 ,792 ,1307 ,0,3,1,3,0,1,0,76.14,60.60 ,33.33
02,000,01,006,0205,409,709 ,7 ,716 ,1172 ,0,3,1,3,0,1,0,76.14,61.09 ,33.33
02,000,01,006,0205,410,756 ,2 ,758 ,1243 ,0,3,1,3,0,1,0,76.14,60.98 ,33.33
02,000,01,006,0206,411,527 ,3 ,530 ,929 ,0,3,1,3,0,1,0,76.14,57.05 ,33.33
02,000,01,006,0206,412,551 ,1 ,552 ,986 ,0,3,1,3,0,1,0,76.14,55.98 ,33.33
02,000,01,006,0207,413,1035 ,8 ,1043 ,1667 ,0,3,1,3,0,1,0,76.14,62.57 ,33.33
02,000,01,006,0208,414,527 ,6 ,533 ,874 ,0,3,1,3,0,1,0,76.14,60.98 ,33.33
02,000,01,006,0209,415,653 ,0 ,653 ,1102 ,0,3,1,3,0,1,0,76.14,59.26 ,33.33
02,000,01,006,0210,416,994 ,5 ,999 ,1586 ,0,3,1,3,0,1,0,76.14,62.99 ,33.33
02,000,01,006,0211,417,635 ,2 ,637 ,994 ,0,3,1,3,0,1,0,76.14,64.08 ,33.33
02,000,01,006,0211,418,627 ,3 ,630 ,1035 ,0,3,1,3,0,1,0,76.14,60.87 ,33.33
02,000,01,006,0212,419,937 ,6 ,943 ,1580 ,0,3,1,3,0,1,0,76.14,59.68 ,33.33
02,000,01,006,0212,420,941 ,9 ,950 ,1582 ,0,3,1,3,0,1,0,76.14,60.05 ,33.33
02,000,01,006,0213,421,710 ,7 ,717 ,1191 ,0,3,1,3,0,1,0,76.14,60.20 ,33.33
02,000,01,006,0213,422,710 ,9 ,719 ,1242 ,0,3,1,3,0,1,0,76.14,57.89 ,33.33
02,000,01,006,0213,423,797 ,3 ,800 ,1492 ,0,3,1,3,0,1,0,76.14,53.62 ,33.33
02,000,01,006,0214,424,639 ,6 ,645 ,1459 ,0,3,1,3,0,1,0,76.14,44.21 ,33.33
02,000,01,006,0214,425,810 ,2 ,812 ,1298 ,0,3,1,3,0,1,0,76.14,62.56 ,33.33
02,000,01,006,0214,426,692 ,5 ,697 ,1189 ,0,3,1,3,0,1,0,76.14,58.62 ,33.33
02,000,01,006,0215,427,905 ,3 ,908 ,1557 ,0,3,1,3,0,1,0,76.14,58.32 ,33.33
02,000,01,006,0216,428,514 ,3 ,517 ,894 ,0,3,1,3,0,1,0,76.14,57.83 ,33.33
02,000,01,006,0216,429,504 ,4 ,508 ,873 ,0,3,1,3,0,1,0,76.14,58.19 ,33.33
02,000,01,006,0217,430,521 ,2 ,523 ,938 ,0,3,1,3,0,1,0,76.14,55.76 ,33.33
02,000,01,006,0217,431,619 ,2 ,621 ,1101 ,0,3,1,3,0,1,0,76.14,56.40 ,33.33
02,000,01,006,0218,432,581 ,7 ,588 ,918 ,0,3,1,3,0,1,0,76.14,64.05 ,33.33
02,000,01,006,0219,433,666 ,0 ,666 ,1069 ,0,3,1,3,0,1,0,76.14,62.30 ,33.33
02,000,01,006,0220,434,758 ,3 ,761 ,1416 ,0,3,1,3,0,1,0,76.14,53.74 ,33.33
02,000,01,006,0221,435,762 ,1 ,763 ,1393 ,0,3,1,3,0,1,0,76.14,54.77 ,33.33
02,000,01,006,0222,436,460 ,5 ,465 ,827 ,0,3,1,3,0,1,0,76.14,56.23 ,33.33
02,000,01,006,0223,437,277 ,0 ,277 ,403 ,0,3,1,3,0,1,0,76.14,68.73 ,33.33
02,000,01,006,0224,438,656 ,3 ,659 ,1163 ,0,3,1,3,0,1,0,76.14,56.66 ,33.33
02,000,01,006,0225,439,773 ,1 ,774 ,1322 ,0,3,1,3,0,1,0,76.14,58.55 ,33.33
02,000,01,006,0225,440,790 ,5 ,795 ,1357 ,0,3,1,3,0,1,0,76.14,58.59 ,33.33
02,000,01,006,0225,441,747 ,1 ,748 ,1298 ,0,3,1,3,0,1,0,76.14,57.63 ,33.33
02,000,01,006,0226,442,653 ,1 ,654 ,1143 ,0,3,1,3,0,1,0,76.14,57.22 ,33.33
02,000,01,006,0227,443,537 ,5 ,542 ,1109 ,0,3,1,3,0,1,0,76.14,48.87 ,33.33
02,000,01,006,0228,444,925 ,8 ,933 ,1674 ,0,3,1,3,0,1,0,76.14,55.73 ,33.33
02,000,01,006,0229,445,698 ,2 ,700 ,1114 ,0,3,1,3,0,1,0,76.14,62.84 ,33.33
02,000,01,006,0230,446,588 ,2 ,590 ,951 ,0,3,1,3,0,1,0,76.14,62.04 ,33.33
02,000,01,006,0230,447,511 ,4 ,515 ,910 ,0,3,1,3,0,1,0,76.14,56.59 ,33.33
02,000,01,006,0231,448,698 ,7 ,705 ,1209 ,0,3,1,3,0,1,0,76.14,58.31 ,33.33
02,000,01,006,0232,449,255 ,4 ,259 ,398 ,0,3,1,3,0,1,0,76.14,65.08 ,33.33
02,000,01,006,0233,450,828 ,3 ,831 ,1408 ,0,3,1,3,0,1,0,76.14,59.02 ,33.33
02,000,01,006,0233,451,683 ,4 ,687 ,1229 ,0,3,1,3,0,1,0,76.14,55.90 ,33.33
02,000,01,006,0234,452,565 ,4 ,569 ,956 ,0,3,1,3,0,1,0,76.14,59.52 ,33.33
02,000,01,006,0234,453,567 ,6 ,573 ,944 ,0,3,1,3,0,1,0,76.14,60.70 ,33.33
02,000,01,006,0235,454,536 ,6 ,542 ,844 ,0,3,1,3,0,1,0,76.14,64.22 ,33.33
02,000,01,006,0236,455,777 ,5 ,782 ,1139 ,0,3,1,3,0,1,0,76.14,68.66 ,33.33
02,000,01,006,0237,456,718 ,7 ,725 ,1176 ,0,3,1,3,0,1,0,76.14,61.65 ,33.33
02,000,01,006,0238,457,788 ,2 ,790 ,1326 ,0,3,1,3,0,1,0,76.14,59.58 ,33.33
02,000,01,006,0239,458,749 ,7 ,756 ,1275 ,0,3,1,3,0,1,0,76.14,59.29 ,33.33
02,000,01,006,0240,459,698 ,4 ,702 ,1216 ,0,3,1,3,0,1,0,76.14,57.73 ,33.33
02,000,01,006,0240,460,668 ,2 ,670 ,1138 ,0,3,1,3,0,1,0,76.14,58.88 ,33.33
02,000,02,007,0241,461,652 ,5 ,657 ,1088 ,0,3,1,3,0,1,0,76.14,60.39 ,33.33
02,000,02,007,0241,462,474 ,0 ,474 ,840 ,0,3,1,3,0,1,0,76.14,56.43 ,33.33
02,000,02,007,0242,463,668 ,1 ,669 ,1253 ,0,3,1,3,0,1,0,76.14,53.39 ,33.33
02,000,02,007,0243,464,834 ,5 ,839 ,1563 ,0,3,1,3,0,1,0,76.14,53.68 ,33.33
02,000,02,007,0243,465,535 ,1 ,536 ,997 ,0,3,1,3,0,1,0,76.14,53.76 ,33.33
02,000,02,007,0244,466,761 ,6 ,767 ,1294 ,0,3,1,3,0,1,0,76.14,59.27 ,33.33
02,000,02,007,0245,467,988 ,7 ,995 ,1588 ,0,3,1,3,0,1,0,76.14,62.66 ,33.33
02,000,02,007,0246,468,413 ,8 ,421 ,735 ,0,3,1,3,0,1,0,76.14,57.28 ,33.33
02,000,02,007,0247,469,453 ,1 ,454 ,863 ,0,3,1,3,0,1,0,76.14,52.61 ,33.33
02,000,02,007,0248,470,511 ,0 ,511 ,993 ,0,3,1,3,0,1,0,76.14,51.46 ,33.33
02,000,02,007,0248,471,574 ,5 ,579 ,1030 ,0,3,1,3,0,1,0,76.14,56.21 ,33.33
02,000,02,007,0249,472,610 ,6 ,616 ,1028 ,0,3,1,3,0,1,0,76.14,59.92 ,33.33
02,000,02,007,0250,473,489 ,3 ,492 ,798 ,0,3,1,3,0,1,0,76.14,61.65 ,33.33
02,000,02,007,0251,474,780 ,7 ,787 ,1456 ,0,3,1,3,0,1,0,76.14,54.05 ,33.33
02,000,02,007,0252,475,624 ,8 ,632 ,1077 ,0,3,1,3,0,1,0,76.14,58.68 ,33.33
02,000,02,007,0253,476,747 ,3 ,750 ,1137 ,0,3,1,3,0,1,0,76.14,65.96 ,33.33
02,000,02,007,0253,477,539 ,1 ,540 ,940 ,0,3,1,3,0,1,0,76.14,57.45 ,33.33
02,000,02,007,0254,478,868 ,7 ,875 ,1476 ,0,3,1,3,0,1,0,76.14,59.28 ,33.33
02,000,02,007,0254,479,619 ,1 ,620 ,1130 ,0,3,1,3,0,1,0,76.14,54.87 ,33.33
02,000,02,007,0255,480,711 ,5 ,716 ,1223 ,0,3,1,3,0,1,0,76.14,58.54 ,33.33
02,000,02,007,0255,481,698 ,2 ,700 ,1177 ,0,3,1,3,0,1,0,76.14,59.47 ,33.33
02,000,02,007,0256,482,538 ,2 ,540 ,852 ,0,3,1,3,0,1,0,76.14,63.38 ,33.33
02,000,02,007,0256,483,544 ,2 ,546 ,934 ,0,3,1,3,0,1,0,76.14,58.46 ,33.33
02,000,02,007,0257,484,852 ,7 ,859 ,1469 ,0,3,1,3,0,1,0,76.14,58.48 ,33.33
02,000,02,007,0257,485,921 ,6 ,927 ,1526 ,0,3,1,3,0,1,0,76.14,60.75 ,33.33
02,000,02,007,0258,486,698 ,5 ,703 ,1136 ,0,3,1,3,0,1,0,76.14,61.88 ,33.33
02,000,02,007,0259,487,631 ,2 ,633 ,1129 ,0,3,1,3,0,1,0,76.14,56.07 ,33.33
02,000,02,007,0260,488,501 ,3 ,504 ,922 ,0,3,1,3,0,1,0,76.14,54.66 ,33.33
02,000,02,007,0261,489,535 ,4 ,539 ,887 ,0,3,1,3,0,1,0,76.14,60.77 ,33.33
02,000,02,007,0262,490,642 ,2 ,644 ,1073 ,0,3,1,3,0,1,0,76.14,60.02 ,33.33
02,000,02,007,0262,491,705 ,6 ,711 ,1132 ,0,3,1,3,0,1,0,76.14,62.81 ,33.33
02,000,02,007,0263,492,576 ,3 ,579 ,1243 ,0,3,1,3,0,1,0,76.14,46.58 ,33.33
02,000,02,007,0263,493,761 ,7 ,768 ,1450 ,0,3,1,3,0,1,0,76.14,52.97 ,33.33
02,000,02,007,0264,494,486 ,2 ,488 ,826 ,0,3,1,3,0,1,0,76.14,59.08 ,33.33
02,000,02,007,0265,495,676 ,0 ,676 ,1169 ,0,3,1,3,0,1,0,76.14,57.83 ,33.33
02,000,02,007,0266,496,543 ,4 ,547 ,948 ,0,3,1,3,0,1,0,76.14,57.70 ,33.33
02,000,02,007,0267,497,522 ,4 ,526 ,948 ,0,3,1,3,0,1,0,76.14,55.49 ,33.33
02,000,02,007,0268,498,545 ,2 ,547 ,908 ,0,3,1,3,0,1,0,76.14,60.24 ,33.33
02,000,02,007,0269,499,545 ,3 ,548 ,968 ,0,3,1,3,0,1,0,76.14,56.61 ,33.33
02,000,02,007,0270,500,525 ,2 ,527 ,842 ,0,3,1,3,0,1,0,76.14,62.59 ,33.33
02,000,02,007,0271,501,465 ,1 ,466 ,784 ,0,3,1,3,0,1,0,76.14,59.44 ,33.33
02,000,02,007,0272,502,782 ,8 ,790 ,1349 ,0,3,1,3,0,1,0,76.14,58.56 ,33.33
02,000,02,008,0273,503,469 ,2 ,471 ,784 ,0,3,1,3,0,1,0,76.14,60.08 ,33.33
02,000,02,008,0274,504,643 ,5 ,648 ,1151 ,0,3,1,3,0,1,0,76.14,56.30 ,33.33
02,000,02,008,0275,505,811 ,6 ,817 ,1417 ,0,3,1,3,0,1,0,76.14,57.66 ,33.33
02,000,02,008,0276,506,527 ,2 ,529 ,904 ,0,3,1,3,0,1,0,76.14,58.52 ,33.33
02,000,02,008,0277,507,525 ,4 ,529 ,911 ,0,3,1,3,0,1,0,76.14,58.07 ,33.33
02,000,02,008,0278,508,896 ,7 ,903 ,1583 ,0,3,1,3,0,1,0,76.14,57.04 ,33.33
02,000,02,008,0278,509,785 ,4 ,789 ,1446 ,0,3,1,3,0,1,0,76.14,54.56 ,33.33
02,000,02,008,0279,510,548 ,3 ,551 ,926 ,0,3,1,3,0,1,0,76.14,59.50 ,33.33
02,000,02,008,0280,511,613 ,5 ,618 ,1148 ,0,3,1,3,0,1,0,76.14,53.83 ,33.33
02,000,02,008,0281,512,793 ,3 ,796 ,1416 ,0,3,1,3,0,1,0,76.14,56.21 ,33.33
02,000,02,008,0282,513,417 ,2 ,419 ,745 ,0,3,1,3,0,1,0,76.14,56.24 ,33.33
02,000,02,008,0283,514,603 ,3 ,606 ,1044 ,0,3,1,3,0,1,0,76.14,58.05 ,33.33
02,000,02,008,0284,515,684 ,2 ,686 ,1257 ,0,3,1,3,0,1,0,76.14,54.57 ,33.33
02,000,02,008,0285,516,596 ,2 ,598 ,1080 ,0,3,1,3,0,1,0,76.14,55.37 ,33.33
02,000,02,008,0286,517,494 ,4 ,498 ,855 ,0,3,1,3,0,1,0,76.14,58.25 ,33.33
02,000,02,008,0286,518,523 ,1 ,524 ,856 ,0,3,1,3,0,1,0,76.14,61.21 ,33.33
02,000,02,008,0287,519,605 ,5 ,610 ,1163 ,0,3,1,3,0,1,0,76.14,52.45 ,33.33
02,000,02,008,0288,520,507 ,5 ,512 ,949 ,0,3,1,3,0,1,0,76.14,53.95 ,33.33
02,000,02,008,0289,521,825 ,3 ,828 ,1536 ,0,3,1,3,0,1,0,76.14,53.91 ,33.33
02,000,02,008,0290,522,747 ,8 ,755 ,1263 ,0,3,1,3,0,1,0,76.14,59.78 ,33.33
02,000,02,008,0291,523,657 ,2 ,659 ,1085 ,0,3,1,3,0,1,0,76.14,60.74 ,33.33
02,000,02,008,0292,524,775 ,3 ,778 ,1361 ,0,3,1,3,0,1,0,76.14,57.16 ,33.33
02,000,02,009,0293,525,339 ,1 ,340 ,584 ,0,3,1,3,0,1,0,76.14,58.22 ,33.33
02,000,02,009,0294,526,805 ,3 ,808 ,1333 ,0,3,1,3,0,1,0,76.14,60.62 ,33.33
02,000,02,009,0295,527,859 ,6 ,865 ,1423 ,0,3,1,3,0,1,0,76.14,60.79 ,33.33
02,000,02,009,0296,528,966 ,7 ,973 ,1664 ,0,3,1,3,0,1,0,76.14,58.47 ,33.33
02,000,02,009,0297,529,836 ,2 ,838 ,1460 ,0,3,1,3,0,1,0,76.14,57.40 ,33.33
02,000,02,009,0298,530,865 ,8 ,873 ,1530 ,0,3,1,3,0,1,0,76.14,57.06 ,33.33
02,000,02,009,0299,531,821 ,6 ,827 ,1560 ,0,3,1,3,0,1,0,76.14,53.01 ,33.33
02,000,02,009,0300,532,395 ,3 ,398 ,692 ,0,3,1,3,0,1,0,76.14,57.51 ,33.33
02,000,02,009,0301,533,1004 ,6 ,1010 ,1840 ,0,3,1,3,0,1,0,76.14,54.89 ,33.33
02,000,02,009,0302,534,658 ,4 ,662 ,1282 ,0,3,1,3,0,1,0,76.14,51.64 ,33.33
02,000,02,009,0302,535,639 ,5 ,644 ,1425 ,0,3,1,3,0,1,0,76.14,45.19 ,33.33
02,000,02,009,0303,536,691 ,4 ,695 ,1154 ,0,3,1,3,0,1,0,76.14,60.23 ,33.33
02,000,02,009,0304,537,888 ,7 ,895 ,1437 ,0,3,1,3,0,1,0,76.14,62.28 ,33.33
02,000,02,009,0305,538,576 ,2 ,578 ,971 ,0,3,1,3,0,1,0,76.14,59.53 ,33.33
02,000,02,009,0305,539,467 ,0 ,467 ,897 ,0,3,1,3,0,1,0,76.14,52.06 ,33.33
02,000,02,009,0306,540,748 ,7 ,755 ,1415 ,0,3,1,3,0,1,0,76.14,53.36 ,33.33
02,000,02,009,0307,541,1257 ,6 ,1263 ,1971 ,0,3,1,3,0,1,0,76.14,64.08 ,33.33
02,000,02,009,0308,542,744 ,2 ,746 ,1258 ,0,3,1,3,0,1,0,76.14,59.30 ,33.33
02,000,02,009,0309,543,833 ,5 ,838 ,1527 ,0,3,1,3,0,1,0,76.14,54.88 ,33.33
02,000,02,009,0309,544,798 ,2 ,800 ,1504 ,0,3,1,3,0,1,0,76.14,53.19 ,33.33
02,000,02,009,0310,545,674 ,1 ,675 ,1148 ,0,3,1,3,0,1,0,76.14,58.80 ,33.33
02,000,02,009,0310,546,600 ,3 ,603 ,1137 ,0,3,1,3,0,1,0,76.14,53.03 ,33.33
02,000,02,009,0311,547,749 ,5 ,754 ,1278 ,0,3,1,3,0,1,0,76.14,59.00 ,33.33
02,000,02,009,0311,548,779 ,3 ,782 ,1361 ,0,3,1,3,0,1,0,76.14,57.46 ,33.33
02,000,02,009,0312,549,642 ,3 ,645 ,1011 ,0,3,1,3,0,1,0,76.14,63.80 ,33.33
02,000,02,009,0312,550,696 ,2 ,698 ,1142 ,0,3,1,3,0,1,0,76.14,61.12 ,33.33
02,000,02,009,0313,551,706 ,3 ,709 ,1715 ,0,3,1,3,0,1,0,76.14,41.34 ,33.33
02,000,02,009,0314,552,825 ,1 ,826 ,1436 ,0,3,1,3,0,1,0,76.14,57.52 ,33.33
02,000,02,009,0314,553,800 ,3 ,803 ,1395 ,0,3,1,3,0,1,0,76.14,57.56 ,33.33
02,000,02,009,0315,554,1025 ,4 ,1029 ,1797 ,0,3,1,3,0,1,0,76.14,57.26 ,33.33
02,000,02,009,0316,555,534 ,1 ,535 ,1057 ,0,3,1,3,0,1,0,76.14,50.61 ,33.33
02,000,02,009,0316,556,635 ,7 ,642 ,1107 ,0,3,1,3,0,1,0,76.14,57.99 ,33.33
02,000,02,009,0317,557,947 ,6 ,953 ,1556 ,0,3,1,3,0,1,0,76.14,61.25 ,33.33
02,000,02,009,0318,558,472 ,3 ,475 ,780 ,0,3,1,3,0,1,0,76.14,60.90 ,33.33
02,000,02,009,0319,559,810 ,5 ,815 ,1444 ,0,3,1,3,0,1,0,76.14,56.44 ,33.33
02,000,02,009,0320,560,884 ,7 ,891 ,1473 ,0,3,1,3,0,1,0,76.14,60.49 ,33.33
02,000,02,009,0320,561,861 ,4 ,865 ,1540 ,0,3,1,3,0,1,0,76.14,56.17 ,33.33
02,000,02,009,0321,562,970 ,13 ,983 ,1795 ,0,3,1,3,0,1,0,76.14,54.76 ,33.33
02,000,02,009,0322,563,895 ,2 ,897 ,1583 ,0,3,1,3,0,1,0,76.14,56.66 ,33.33
02,000,02,009,0322,564,930 ,8 ,938 ,1679 ,0,3,1,3,0,1,0,76.14,55.87 ,33.33
02,000,02,009,0323,565,1067 ,3 ,1070 ,1832 ,0,3,1,3,0,1,0,76.14,58.41 ,33.33
02,000,02,009,0324,566,862 ,5 ,867 ,1496 ,0,3,1,3,0,1,0,76.14,57.95 ,33.33
02,000,02,009,0324,567,742 ,3 ,745 ,1348 ,0,3,1,3,0,1,0,76.14,55.27 ,33.33
02,000,02,009,0325,568,706 ,3 ,709 ,1257 ,0,3,1,3,0,1,0,76.14,56.40 ,33.33
02,000,02,009,0325,569,707 ,2 ,709 ,1302 ,0,3,1,3,0,1,0,76.14,54.45 ,33.33
02,000,02,009,0326,570,721 ,2 ,723 ,1414 ,0,3,1,3,0,1,0,76.14,51.13 ,33.33
02,000,02,009,0327,571,945 ,6 ,951 ,1547 ,0,3,1,3,0,1,0,76.14,61.47 ,33.33
02,000,02,009,0328,572,1219 ,7 ,1226 ,1902 ,0,3,1,3,0,1,0,76.14,64.46 ,33.33
02,000,02,009,0329,573,566 ,3 ,569 ,1083 ,0,3,1,3,0,1,0,76.14,52.54 ,33.33
02,000,02,009,0329,574,755 ,4 ,759 ,1296 ,0,3,1,3,0,1,0,76.14,58.56 ,33.33
02,000,02,009,0330,575,1006 ,4 ,1010 ,1622 ,0,3,1,3,0,1,0,76.14,62.27 ,33.33
02,000,02,009,0331,576,963 ,5 ,968 ,1535 ,0,3,1,3,0,1,0,76.14,63.06 ,33.33
02,000,02,009,0332,577,735 ,3 ,738 ,1182 ,0,3,1,3,0,1,0,76.14,62.44 ,33.33
02,000,02,009,0332,578,682 ,7 ,689 ,1165 ,0,3,1,3,0,1,0,76.14,59.14 ,33.33
02,000,02,009,0333,579,532 ,0 ,532 ,946 ,0,3,1,3,0,1,0,76.14,56.24 ,33.33
02,000,02,009,0333,580,625 ,2 ,627 ,1033 ,0,3,1,3,0,1,0,76.14,60.70 ,33.33
02,000,02,009,0334,581,741 ,0 ,741 ,1283 ,0,3,1,3,0,1,0,76.14,57.76 ,33.33
02,000,02,009,0334,582,661 ,2 ,663 ,1175 ,0,3,1,3,0,1,0,76.14,56.43 ,33.33
02,000,02,009,0334,583,799 ,6 ,805 ,1416 ,0,3,1,3,0,1,0,76.14,56.85 ,33.33
02,000,02,009,0335,584,509 ,3 ,512 ,892 ,0,3,1,3,0,1,0,76.14,57.40 ,33.33
02,000,02,009,0335,585,471 ,4 ,475 ,795 ,0,3,1,3,0,1,0,76.14,59.75 ,33.33
02,000,02,009,0336,586,800 ,3 ,803 ,1361 ,0,3,1,3,0,1,0,76.14,59.00 ,33.33
02,000,02,009,0337,587,1180 ,4 ,1184 ,1966 ,0,3,1,3,0,1,0,76.14,60.22 ,33.33
02,000,02,009,0337,588,1119 ,6 ,1125 ,1985 ,0,3,1,3,0,1,0,76.14,56.68 ,33.33
02,000,02,009,0338,589,557 ,7 ,564 ,1009 ,0,3,1,3,0,1,0,76.14,55.90 ,33.33
02,000,02,009,0338,590,607 ,1 ,608 ,1027 ,0,3,1,3,0,1,0,76.14,59.20 ,33.33
02,000,02,009,0339,591,913 ,6 ,919 ,1547 ,0,3,1,3,0,1,0,76.14,59.41 ,33.33
02,000,02,009,0340,592,890 ,2 ,892 ,1501 ,0,3,1,3,0,1,0,76.14,59.43 ,33.33
02,000,02,009,0341,593,816 ,4 ,820 ,1454 ,0,3,1,3,0,1,0,76.14,56.40 ,33.33
02,000,02,009,0341,594,748 ,3 ,751 ,1287 ,0,3,1,3,0,1,0,76.14,58.35 ,33.33
02,000,02,009,0342,595,817 ,6 ,823 ,1335 ,0,3,1,3,0,1,0,76.14,61.65 ,33.33
02,000,02,009,0343,596,607 ,9 ,616 ,1019 ,0,3,1,3,0,1,0,76.14,60.45 ,33.33
02,000,02,009,0344,597,535 ,1 ,536 ,918 ,0,3,1,3,0,1,0,76.14,58.39 ,33.33
02,000,02,009,0344,598,619 ,3 ,622 ,1025 ,0,3,1,3,0,1,0,76.14,60.68 ,33.33
02,000,02,009,0345,599,653 ,8 ,661 ,1102 ,0,3,1,3,0,1,0,76.14,59.98 ,33.33
02,000,02,009,0345,600,590 ,3 ,593 ,1073 ,0,3,1,3,0,1,0,76.14,55.27 ,33.33
02,000,02,009,0346,601,888 ,12 ,900 ,1401 ,0,3,1,3,0,1,0,76.14,64.24 ,33.33
02,000,02,009,0346,602,885 ,6 ,891 ,1498 ,0,3,1,3,0,1,0,76.14,59.48 ,33.33
02,000,02,009,0347,603,768 ,10 ,778 ,1341 ,0,3,1,3,0,1,0,76.14,58.02 ,33.33
02,000,02,009,0347,604,891 ,1 ,892 ,1494 ,0,3,1,3,0,1,0,76.14,59.71 ,33.33
02,000,02,009,0348,605,762 ,8 ,770 ,1355 ,0,3,1,3,0,1,0,76.14,56.83 ,33.33
02,000,02,009,0348,606,642 ,2 ,644 ,1200 ,0,3,1,3,0,1,0,76.14,53.67 ,33.33
02,000,02,009,0349,607,686 ,5 ,691 ,1206 ,0,3,1,3,0,1,0,76.14,57.30 ,33.33
02,000,02,009,0349,608,452 ,1 ,453 ,797 ,0,3,1,3,0,1,0,76.14,56.84 ,33.33
02,000,02,009,0350,609,680 ,9 ,689 ,1143 ,0,3,1,3,0,1,0,76.14,60.28 ,33.33
02,000,02,009,0350,610,701 ,2 ,703 ,1211 ,0,3,1,3,0,1,0,76.14,58.05 ,33.33
02,000,02,009,0351,611,954 ,4 ,958 ,1782 ,0,3,1,3,0,1,0,76.14,53.76 ,33.33
02,000,02,009,0352,612,737 ,8 ,745 ,1400 ,0,3,1,3,0,1,0,76.14,53.21 ,33.33
02,000,02,009,0352,613,708 ,7 ,715 ,1321 ,0,3,1,3,0,1,0,76.14,54.13 ,33.33
02,000,02,009,0353,614,725 ,3 ,728 ,1365 ,0,3,1,3,0,1,0,76.14,53.33 ,33.33
02,000,02,009,0353,615,748 ,4 ,752 ,1398 ,0,3,1,3,0,1,0,76.14,53.79 ,33.33
02,000,02,009,0353,616,818 ,8 ,826 ,1832 ,0,3,1,3,0,1,0,76.14,45.09 ,33.33
02,000,02,009,0354,617,732 ,6 ,738 ,1254 ,0,3,1,3,0,1,0,76.14,58.85 ,33.33
02,000,02,009,0354,618,698 ,6 ,704 ,1303 ,0,3,1,3,0,1,0,76.14,54.03 ,33.33
02,000,02,009,0354,619,744 ,3 ,747 ,1342 ,0,3,1,3,0,1,0,76.14,55.66 ,33.33
02,000,02,009,0355,620,1033 ,6 ,1039 ,1854 ,0,3,1,3,0,1,0,76.14,56.04 ,33.33
02,000,02,009,0355,621,984 ,2 ,986 ,1756 ,0,3,1,3,0,1,0,76.14,56.15 ,33.33
02,000,02,009,0356,622,703 ,5 ,708 ,1277 ,0,3,1,3,0,1,0,76.14,55.44 ,33.33
02,000,02,009,0356,623,816 ,5 ,821 ,1446 ,0,3,1,3,0,1,0,76.14,56.78 ,33.33
02,000,02,009,0356,624,785 ,5 ,790 ,1412 ,0,3,1,3,0,1,0,76.14,55.95 ,33.33
02,000,02,009,0357,625,687 ,3 ,690 ,1200 ,0,3,1,3,0,1,0,76.14,57.50 ,33.33
02,000,02,009,0357,626,728 ,6 ,734 ,1149 ,0,3,1,3,0,1,0,76.14,63.88 ,33.33
02,000,02,009,0358,627,653 ,4 ,657 ,1224 ,0,3,1,3,0,1,0,76.14,53.68 ,33.33
02,000,02,009,0358,628,612 ,3 ,615 ,1201 ,0,3,1,3,0,1,0,76.14,51.21 ,33.33
02,000,02,009,0359,629,659 ,3 ,662 ,1064 ,0,3,1,3,0,1,0,76.14,62.22 ,33.33
02,000,02,009,0359,630,955 ,5 ,960 ,1630 ,0,3,1,3,0,1,0,76.14,58.90 ,33.33
02,000,02,009,0359,631,637 ,4 ,641 ,1156 ,0,3,1,3,0,1,0,76.14,55.45 ,33.33
02,000,02,009,0360,632,1208 ,10 ,1218 ,2066 ,0,3,1,3,0,1,0,76.14,58.95 ,33.33
02,000,02,009,0361,633,605 ,8 ,613 ,1075 ,0,3,1,3,0,1,0,76.14,57.02 ,33.33
02,000,02,009,0361,634,620 ,3 ,623 ,1053 ,0,3,1,3,0,1,0,76.14,59.16 ,33.33
02,000,02,010,0362,635,734 ,4 ,738 ,1300 ,0,3,1,3,0,1,0,76.14,56.77 ,33.33
02,000,02,010,0362,636,937 ,9 ,946 ,1677 ,0,3,1,3,0,1,0,76.14,56.41 ,33.33
02,000,02,010,0362,637,919 ,5 ,924 ,1741 ,0,3,1,3,0,1,0,76.14,53.07 ,33.33
02,000,02,010,0362,638,888 ,7 ,895 ,1772 ,0,3,1,3,0,1,0,76.14,50.51 ,33.33
02,000,02,010,0362,639,836 ,3 ,839 ,1582 ,0,3,1,3,0,1,0,76.14,53.03 ,33.33
02,000,02,010,0363,640,897 ,11 ,908 ,1546 ,0,3,1,3,0,1,0,76.14,58.73 ,33.33
02,000,02,010,0363,641,509 ,1 ,510 ,859 ,0,3,1,3,0,1,0,76.14,59.37 ,33.33
02,000,02,010,0364,642,962 ,5 ,967 ,1613 ,0,3,1,3,0,1,0,76.14,59.95 ,33.33
02,000,02,010,0364,643,908 ,4 ,912 ,1558 ,0,3,1,3,0,1,0,76.14,58.54 ,33.33
02,000,02,010,0365,644,590 ,3 ,593 ,964 ,0,3,1,3,0,1,0,76.14,61.51 ,33.33
02,000,02,010,0365,645,524 ,6 ,530 ,852 ,0,3,1,3,0,1,0,76.14,62.21 ,33.33
02,000,02,010,0366,646,864 ,3 ,867 ,1434 ,0,3,1,3,0,1,0,76.14,60.46 ,33.33
02,000,02,010,0367,647,1156 ,7 ,1163 ,1870 ,0,3,1,3,0,1,0,76.14,62.19 ,33.33
02,000,02,010,0368,648,1081 ,5 ,1086 ,2226 ,0,3,1,3,0,1,0,76.14,48.79 ,33.33
02,000,02,010,0369,649,427 ,3 ,430 ,707 ,0,3,1,3,0,1,0,76.14,60.82 ,33.33
02,000,02,010,0370,650,1040 ,8 ,1048 ,1727 ,0,3,1,3,0,1,0,76.14,60.68 ,33.33
02,000,02,010,0371,651,992 ,10 ,1002 ,1554 ,0,3,1,3,0,1,0,76.14,64.48 ,33.33
02,000,02,010,0372,652,657 ,10 ,667 ,1067 ,0,3,1,3,0,1,0,76.14,62.51 ,33.33
02,000,02,010,0372,653,777 ,5 ,782 ,1369 ,0,3,1,3,0,1,0,76.14,57.12 ,33.33
02,000,02,010,0373,654,777 ,7 ,784 ,1274 ,0,3,1,3,0,1,0,76.14,61.54 ,33.33
02,000,02,010,0374,655,481 ,1 ,482 ,766 ,0,3,1,3,0,1,0,76.14,62.92 ,33.33
02,000,02,010,0375,656,497 ,6 ,503 ,875 ,0,3,1,3,0,1,0,76.14,57.49 ,33.33
02,000,02,010,0376,657,882 ,6 ,888 ,1479 ,0,3,1,3,0,1,0,76.14,60.04 ,33.33
02,000,02,010,0377,658,1201 ,10 ,1211 ,1919 ,0,3,1,3,0,1,0,76.14,63.11 ,33.33
02,000,02,010,0378,659,836 ,7 ,843 ,1259 ,0,3,1,3,0,1,0,76.14,66.96 ,33.33
02,000,02,010,0378,660,593 ,1 ,594 ,1037 ,0,3,1,3,0,1,0,76.14,57.28 ,33.33
02,000,02,010,0379,661,538 ,7 ,545 ,833 ,0,3,1,3,0,1,0,76.14,65.43 ,33.33
02,000,02,010,0379,662,744 ,32 ,776 ,1217 ,0,3,1,3,0,1,0,76.14,63.76 ,33.33
02,000,02,010,0380,663,653 ,2 ,655 ,1101 ,0,3,1,3,0,1,0,76.14,59.49 ,33.33
02,000,02,010,0380,664,716 ,2 ,718 ,1288 ,0,3,1,3,0,1,0,76.14,55.75 ,33.33
02,000,02,010,0380,665,882 ,5 ,887 ,1479 ,0,3,1,3,0,1,0,76.14,59.97 ,33.33
02,000,02,010,0381,666,758 ,8 ,766 ,1140 ,0,3,1,3,0,1,0,76.14,67.19 ,33.33
02,000,02,010,0382,667,612 ,5 ,617 ,1040 ,0,3,1,3,0,1,0,76.14,59.33 ,33.33
02,000,02,010,0382,668,560 ,2 ,562 ,970 ,0,3,1,3,0,1,0,76.14,57.94 ,33.33
02,000,02,010,0383,669,553 ,6 ,559 ,856 ,0,3,1,3,0,1,0,76.14,65.30 ,33.33
02,000,02,010,0384,670,706 ,5 ,711 ,1033 ,0,3,1,3,0,1,0,76.14,68.83 ,33.33
02,000,02,010,0385,671,1458 ,6 ,1464 ,2331 ,0,3,1,3,0,1,0,76.14,62.81 ,33.33
02,000,02,010,0385,672,1348 ,11 ,1359 ,2007 ,0,3,1,3,0,1,0,76.14,67.71 ,33.33
02,000,02,010,0386,673,698 ,0 ,698 ,1018 ,0,3,1,3,0,1,0,76.14,68.57 ,33.33
02,000,02,010,0386,674,761 ,4 ,765 ,1048 ,0,3,1,3,0,1,0,76.14,73.00 ,33.33
02,000,02,010,0387,675,974 ,9 ,983 ,1676 ,0,3,1,3,0,1,0,76.14,58.65 ,33.33
02,000,02,010,0387,676,974 ,5 ,979 ,1647 ,0,3,1,3,0,1,0,76.14,59.44 ,33.33
02,000,02,010,0388,677,719 ,7 ,726 ,1198 ,0,3,1,3,0,1,0,76.14,60.60 ,33.33
02,000,02,010,0388,678,858 ,10 ,868 ,1355 ,0,3,1,3,0,1,0,76.14,64.06 ,33.33
02,000,02,010,0388,679,698 ,2 ,700 ,1249 ,0,3,1,3,0,1,0,76.14,56.04 ,33.33
02,000,02,010,0389,680,485 ,0 ,485 ,841 ,0,3,1,3,0,1,0,76.14,57.67 ,33.33
02,000,02,010,0390,681,1073 ,9 ,1082 ,1928 ,0,3,1,3,0,1,0,76.14,56.12 ,33.33
02,000,02,010,0391,682,749 ,8 ,757 ,1285 ,0,3,1,3,0,1,0,76.14,58.91 ,33.33
02,000,02,010,0391,683,746 ,3 ,749 ,1318 ,0,3,1,3,0,1,0,76.14,56.83 ,33.33
02,000,02,010,0392,684,1146 ,51 ,1197 ,1940 ,0,3,1,3,0,1,0,76.14,61.70 ,33.33
02,000,02,010,0393,685,695 ,3 ,698 ,1295 ,0,3,1,3,0,1,0,76.14,53.90 ,33.33
02,000,02,010,0393,686,655 ,6 ,661 ,1217 ,0,3,1,3,0,1,0,76.14,54.31 ,33.33
02,000,02,010,0394,687,825 ,7 ,832 ,1427 ,0,3,1,3,0,1,0,76.14,58.30 ,33.33
02,000,02,010,0394,688,775 ,3 ,778 ,1418 ,0,3,1,3,0,1,0,76.14,54.87 ,33.33
02,000,02,010,0395,689,872 ,6 ,878 ,1515 ,0,3,1,3,0,1,0,76.14,57.95 ,33.33
02,000,02,010,0395,690,809 ,8 ,817 ,1583 ,0,3,1,3,0,1,0,76.14,51.61 ,33.33
02,000,02,010,0396,691,859 ,5 ,864 ,1458 ,0,3,1,3,0,1,0,76.14,59.26 ,33.33
02,000,02,010,0396,692,880 ,3 ,883 ,1553 ,0,3,1,3,0,1,0,76.14,56.86 ,33.33
02,000,02,010,0396,693,877 ,5 ,882 ,1610 ,0,3,1,3,0,1,0,76.14,54.78 ,33.33
02,000,02,010,0397,694,661 ,4 ,665 ,1117 ,0,3,1,3,0,1,0,76.14,59.53 ,33.33
02,000,02,010,0397,695,755 ,10 ,765 ,1230 ,0,3,1,3,0,1,0,76.14,62.20 ,33.33
02,000,02,010,0398,696,801 ,3 ,804 ,1353 ,0,3,1,3,0,1,0,76.14,59.42 ,33.33
02,000,02,010,0398,697,916 ,3 ,919 ,1497 ,0,3,1,3,0,1,0,76.14,61.39 ,33.33
02,000,02,010,0399,698,802 ,5 ,807 ,1234 ,0,3,1,3,0,1,0,76.14,65.40 ,33.33
02,000,02,010,0399,699,820 ,7 ,827 ,1359 ,0,3,1,3,0,1,0,76.14,60.85 ,33.33
02,000,02,010,0400,700,548 ,1 ,549 ,1061 ,0,3,1,3,0,1,0,76.14,51.74 ,33.33
02,000,02,010,0400,701,588 ,6 ,594 ,1054 ,0,3,1,3,0,1,0,76.14,56.36 ,33.33
02,000,02,010,0401,702,736 ,6 ,742 ,1364 ,0,3,1,3,0,1,0,76.14,54.40 ,33.33
02,000,02,010,0401,703,785 ,3 ,788 ,1342 ,0,3,1,3,0,1,0,76.14,58.72 ,33.33
02,000,02,010,0402,704,619 ,4 ,623 ,1119 ,0,3,1,3,0,1,0,76.14,55.67 ,33.33
02,000,02,010,0402,705,504 ,2 ,506 ,893 ,0,3,1,3,0,1,0,76.14,56.66 ,33.33
02,000,02,010,0403,706,735 ,5 ,740 ,1174 ,0,3,1,3,0,1,0,76.14,63.03 ,33.33
02,000,02,010,0403,707,787 ,7 ,794 ,1277 ,0,3,1,3,0,1,0,76.14,62.18 ,33.33
02,000,02,010,0403,708,811 ,7 ,818 ,1369 ,0,3,1,3,0,1,0,76.14,59.75 ,33.33
02,000,02,010,0404,709,816 ,0 ,816 ,1459 ,0,3,1,3,0,1,0,76.14,55.93 ,33.33
02,000,02,010,0404,710,826 ,3 ,829 ,1345 ,0,3,1,3,0,1,0,76.14,61.64 ,33.33
02,000,02,010,0405,711,733 ,6 ,739 ,1278 ,0,3,1,3,0,1,0,76.14,57.82 ,33.33
02,000,02,010,0406,712,883 ,8 ,891 ,1477 ,0,3,1,3,0,1,0,76.14,60.32 ,33.33
02,000,02,010,0406,713,873 ,7 ,880 ,1457 ,0,3,1,3,0,1,0,76.14,60.40 ,33.33
02,000,02,010,0406,714,928 ,5 ,933 ,1616 ,0,3,1,3,0,1,0,76.14,57.74 ,33.33
02,000,02,010,0407,715,801 ,5 ,806 ,1254 ,0,3,1,3,0,1,0,76.14,64.27 ,33.33
02,000,02,010,0407,716,641 ,3 ,644 ,1047 ,0,3,1,3,0,1,0,76.14,61.51 ,33.33
02,000,02,010,0408,717,960 ,1 ,961 ,1675 ,0,3,1,3,0,1,0,76.14,57.37 ,33.33
02,000,02,010,0408,718,986 ,9 ,995 ,1645 ,0,3,1,3,0,1,0,76.14,60.49 ,33.33
02,000,02,010,0408,719,785 ,4 ,789 ,1396 ,0,3,1,3,0,1,0,76.14,56.52 ,33.33
02,000,02,010,0409,720,706 ,5 ,711 ,1181 ,0,3,1,3,0,1,0,76.14,60.20 ,33.33
02,000,02,010,0409,721,741 ,1 ,742 ,1228 ,0,3,1,3,0,1,0,76.14,60.42 ,33.33
02,000,02,010,0410,722,565 ,4 ,569 ,959 ,0,3,1,3,0,1,0,76.14,59.33 ,33.33
02,000,02,010,0410,723,599 ,20 ,619 ,1069 ,0,3,1,3,0,1,0,76.14,57.90 ,33.33
02,000,02,010,0411,724,701 ,2 ,703 ,1129 ,0,3,1,3,0,1,0,76.14,62.27 ,33.33
02,000,02,010,0411,725,763 ,9 ,772 ,1224 ,0,3,1,3,0,1,0,76.14,63.07 ,33.33
02,000,02,010,0411,726,709 ,4 ,713 ,1288 ,0,3,1,3,0,1,0,76.14,55.36 ,33.33
02,000,02,010,0412,727,714 ,4 ,718 ,1244 ,0,3,1,3,0,1,0,76.14,57.72 ,33.33
02,000,02,010,0412,728,587 ,6 ,593 ,1046 ,0,3,1,3,0,1,0,76.14,56.69 ,33.33
02,000,02,010,0412,729,640 ,1 ,641 ,1234 ,0,3,1,3,0,1,0,76.14,51.94 ,33.33
02,000,02,010,0413,730,840 ,6 ,846 ,1436 ,0,3,1,3,0,1,0,76.14,58.91 ,33.33
02,000,02,010,0413,731,787 ,4 ,791 ,1442 ,0,3,1,3,0,1,0,76.14,54.85 ,33.33
02,000,02,010,0414,732,852 ,4 ,856 ,1401 ,0,3,1,3,0,1,0,76.14,61.10 ,33.33
02,000,02,010,0414,733,781 ,2 ,783 ,1198 ,0,3,1,3,0,1,0,76.14,65.36 ,33.33
02,000,02,010,0415,734,781 ,5 ,786 ,1200 ,0,3,1,3,0,1,0,76.14,65.50 ,33.33
02,000,02,010,0415,735,729 ,1 ,730 ,1316 ,0,3,1,3,0,1,0,76.14,55.47 ,33.33
02,000,02,010,0416,736,781 ,7 ,788 ,1359 ,0,3,1,3,0,1,0,76.14,57.98 ,33.33
02,000,02,010,0416,737,695 ,4 ,699 ,1251 ,0,3,1,3,0,1,0,76.14,55.88 ,33.33
02,000,02,010,0417,738,745 ,19 ,764 ,1347 ,0,3,1,3,0,1,0,76.14,56.72 ,33.33
02,000,02,010,0417,739,577 ,3 ,580 ,1074 ,0,3,1,3,0,1,0,76.14,54.00 ,33.33
02,000,02,010,0418,740,608 ,4 ,612 ,1088 ,0,3,1,3,0,1,0,76.14,56.25 ,33.33
02,000,02,010,0418,741,701 ,3 ,704 ,1306 ,0,3,1,3,0,1,0,76.14,53.91 ,33.33
02,000,02,010,0419,742,780 ,29 ,809 ,1425 ,0,3,1,3,0,1,0,76.14,56.77 ,33.33
02,000,02,010,0419,743,844 ,5 ,849 ,1508 ,0,3,1,3,0,1,0,76.14,56.30 ,33.33
02,000,02,010,0419,744,715 ,3 ,718 ,1328 ,0,3,1,3,0,1,0,76.14,54.07 ,33.33
02,000,02,010,0420,745,753 ,4 ,757 ,1356 ,0,3,1,3,0,1,0,76.14,55.83 ,33.33
02,000,02,010,0420,746,759 ,3 ,762 ,1367 ,0,3,1,3,0,1,0,76.14,55.74 ,33.33
02,000,02,011,0421,747,1022 ,5 ,1027 ,1732 ,0,3,1,3,0,1,0,76.14,59.30 ,33.33
02,000,02,011,0422,748,1021 ,4 ,1025 ,1681 ,0,3,1,3,0,1,0,76.14,60.98 ,33.33
02,000,02,011,0422,749,904 ,6 ,910 ,1533 ,0,3,1,3,0,1,0,76.14,59.36 ,33.33
02,000,02,011,0423,750,694 ,7 ,701 ,1196 ,0,3,1,3,0,1,0,76.14,58.61 ,33.33
02,000,02,011,0423,751,697 ,3 ,700 ,1226 ,0,3,1,3,0,1,0,76.14,57.10 ,33.33
02,000,02,011,0424,752,929 ,9 ,938 ,1560 ,0,3,1,3,0,1,0,76.14,60.13 ,33.33
02,000,02,011,0425,753,808 ,6 ,814 ,1427 ,0,3,1,3,0,1,0,76.14,57.04 ,33.33
02,000,02,011,0425,754,786 ,5 ,791 ,1417 ,0,3,1,3,0,1,0,76.14,55.82 ,33.33
02,000,02,011,0426,755,1084 ,5 ,1089 ,1877 ,0,3,1,3,0,1,0,76.14,58.02 ,33.33
02,000,02,011,0427,756,885 ,4 ,889 ,1650 ,0,3,1,3,0,1,0,76.14,53.88 ,33.33
02,000,02,011,0428,757,1237 ,6 ,1243 ,2020 ,0,3,1,3,0,1,0,76.14,61.53 ,33.33
02,000,02,011,0429,758,1027 ,7 ,1034 ,1867 ,0,3,1,3,0,1,0,76.14,55.38 ,33.33
02,000,02,011,0430,759,721 ,6 ,727 ,1381 ,0,3,1,3,0,1,0,76.14,52.64 ,33.33
02,000,02,011,0430,760,894 ,11 ,905 ,1556 ,0,3,1,3,0,1,0,76.14,58.16 ,33.33
02,000,02,011,0430,761,883 ,3 ,886 ,1623 ,0,3,1,3,0,1,0,76.14,54.59 ,33.33
02,000,02,011,0431,762,571 ,3 ,574 ,1027 ,0,3,1,3,0,1,0,76.14,55.89 ,33.33
02,000,02,011,0431,763,727 ,5 ,732 ,1172 ,0,3,1,3,0,1,0,76.14,62.46 ,33.33
02,000,02,011,0432,764,862 ,3 ,865 ,1471 ,0,3,1,3,0,1,0,76.14,58.80 ,33.33
02,000,02,011,0432,765,864 ,4 ,868 ,1560 ,0,3,1,3,0,1,0,76.14,55.64 ,33.33
02,000,02,011,0433,766,681 ,3 ,684 ,1234 ,0,3,1,3,0,1,0,76.14,55.43 ,33.33
02,000,02,011,0433,767,748 ,5 ,753 ,1206 ,0,3,1,3,0,1,0,76.14,62.44 ,33.33
02,000,02,011,0434,768,866 ,1 ,867 ,1625 ,0,3,1,3,0,1,0,76.14,53.35 ,33.33
02,000,02,011,0434,769,898 ,8 ,906 ,1641 ,0,3,1,3,0,1,0,76.14,55.21 ,33.33
02,000,02,011,0435,770,974 ,7 ,981 ,1924 ,0,3,1,3,0,1,0,76.14,50.99 ,33.33
02,000,02,011,0435,771,950 ,4 ,954 ,1629 ,0,3,1,3,0,1,0,76.14,58.56 ,33.33
02,000,02,011,0436,772,936 ,4 ,940 ,1620 ,0,3,1,3,0,1,0,76.14,58.02 ,33.33
02,000,02,011,0437,773,584 ,8 ,592 ,1093 ,0,3,1,3,0,1,0,76.14,54.16 ,33.33
02,000,02,011,0437,774,756 ,6 ,762 ,1430 ,0,3,1,3,0,1,0,76.14,53.29 ,33.33
02,000,02,011,0438,775,565 ,1 ,566 ,936 ,0,3,1,3,0,1,0,76.14,60.47 ,33.33
02,000,02,011,0438,776,726 ,5 ,731 ,1244 ,0,3,1,3,0,1,0,76.14,58.76 ,33.33
02,000,02,011,0439,777,1120 ,2 ,1122 ,1844 ,0,3,1,3,0,1,0,76.14,60.85 ,33.33
02,000,02,011,0440,778,880 ,7 ,887 ,1572 ,0,3,1,3,0,1,0,76.14,56.42 ,33.33
02,000,02,011,0440,779,924 ,4 ,928 ,1529 ,0,3,1,3,0,1,0,76.14,60.69 ,33.33
02,000,02,011,0441,780,628 ,2 ,630 ,1079 ,0,3,1,3,0,1,0,76.14,58.39 ,33.33
02,000,02,011,0441,781,588 ,7 ,595 ,1043 ,0,3,1,3,0,1,0,76.14,57.05 ,33.33
02,000,02,011,0442,782,1130 ,7 ,1137 ,2057 ,0,3,1,3,0,1,0,76.14,55.27 ,33.33
02,000,02,011,0442,783,997 ,6 ,1003 ,1645 ,0,3,1,3,0,1,0,76.14,60.97 ,33.33
02,000,02,011,0442,784,915 ,5 ,920 ,1748 ,0,3,1,3,0,1,0,76.14,52.63 ,33.33
02,000,02,011,0443,785,754 ,5 ,759 ,1465 ,0,3,1,3,0,1,0,76.14,51.81 ,33.33
02,000,02,011,0443,786,951 ,4 ,955 ,1641 ,0,3,1,3,0,1,0,76.14,58.20 ,33.33
02,000,02,011,0444,787,589 ,10 ,599 ,922 ,0,3,1,3,0,1,0,76.14,64.97 ,33.33
02,000,02,011,0444,788,612 ,7 ,619 ,1049 ,0,3,1,3,0,1,0,76.14,59.01 ,33.33
02,000,02,011,0445,789,1069 ,9 ,1078 ,1903 ,0,3,1,3,0,1,0,76.14,56.65 ,33.33
02,000,02,011,0446,790,802 ,9 ,811 ,1302 ,0,3,1,3,0,1,0,76.14,62.29 ,33.33
02,000,02,011,0447,791,787 ,3 ,790 ,1397 ,0,3,1,3,0,1,0,76.14,56.55 ,33.33
02,000,02,011,0448,792,638 ,1 ,639 ,1083 ,0,3,1,3,0,1,0,76.14,59.00 ,33.33
02,000,02,011,0448,793,613 ,5 ,618 ,1119 ,0,3,1,3,0,1,0,76.14,55.23 ,33.33
02,000,02,011,0448,794,457 ,3 ,460 ,905 ,0,3,1,3,0,1,0,76.14,50.83 ,33.33
02,000,02,011,0449,795,1064 ,3 ,1067 ,1813 ,0,3,1,3,0,1,0,76.14,58.85 ,33.33
02,000,02,011,0450,796,659 ,4 ,663 ,1112 ,0,3,1,3,0,1,0,76.14,59.62 ,33.33
02,000,02,011,0450,797,613 ,4 ,617 ,1075 ,0,3,1,3,0,1,0,76.14,57.40 ,33.33
02,000,02,011,0451,798,830 ,6 ,836 ,1479 ,0,3,1,3,0,1,0,76.14,56.52 ,33.33
02,000,02,011,0451,799,883 ,1 ,884 ,1600 ,0,3,1,3,0,1,0,76.14,55.25 ,33.33
02,000,02,011,0451,800,751 ,4 ,755 ,1544 ,0,3,1,3,0,1,0,76.14,48.90 ,33.33
02,000,02,011,0451,801,775 ,6 ,781 ,1488 ,0,3,1,3,0,1,0,76.14,52.49 ,33.33
02,000,02,011,0452,802,652 ,1 ,653 ,1220 ,0,3,1,3,0,1,0,76.14,53.52 ,33.33
02,000,02,011,0452,803,817 ,1 ,818 ,1578 ,0,3,1,3,0,1,0,76.14,51.84 ,33.33
02,000,02,011,0453,804,750 ,3 ,753 ,1141 ,0,3,1,3,0,1,0,76.14,65.99 ,33.33
02,000,02,011,0453,805,650 ,6 ,656 ,1093 ,0,3,1,3,0,1,0,76.14,60.02 ,33.33
02,000,02,011,0454,806,622 ,3 ,625 ,993 ,0,3,1,3,0,1,0,76.14,62.94 ,33.33
02,000,02,011,0454,807,673 ,8 ,681 ,1056 ,0,3,1,3,0,1,0,76.14,64.49 ,33.33
02,000,02,011,0455,808,954 ,7 ,961 ,1470 ,0,3,1,3,0,1,0,76.14,65.37 ,33.33
02,000,02,011,0456,809,601 ,2 ,603 ,990 ,0,3,1,3,0,1,0,76.14,60.91 ,33.33
02,000,02,011,0456,810,597 ,3 ,600 ,1012 ,0,3,1,3,0,1,0,76.14,59.29 ,33.33
02,000,02,011,0457,811,915 ,1 ,916 ,1557 ,0,3,1,3,0,1,0,76.14,58.83 ,33.33
02,000,02,011,0458,812,627 ,8 ,635 ,1021 ,0,3,1,3,0,1,0,76.14,62.19 ,33.33
02,000,02,011,0458,813,671 ,5 ,676 ,1230 ,0,3,1,3,0,1,0,76.14,54.96 ,33.33
02,000,02,011,0459,814,738 ,5 ,743 ,1445 ,0,3,1,3,0,1,0,76.14,51.42 ,33.33
02,000,02,011,0459,815,669 ,3 ,672 ,1339 ,0,3,1,3,0,1,0,76.14,50.19 ,33.33
02,000,02,011,0459,816,746 ,6 ,752 ,1671 ,0,3,1,3,0,1,0,76.14,45.00 ,33.33
02,000,02,011,0460,817,520 ,1 ,521 ,1138 ,0,3,1,3,0,1,0,76.14,45.78 ,33.33
02,000,02,011,0460,818,562 ,3 ,565 ,1149 ,0,3,1,3,0,1,0,76.14,49.17 ,33.33
02,000,02,011,0461,819,644 ,4 ,648 ,1334 ,0,3,1,3,0,1,0,76.14,48.58 ,33.33
02,000,02,011,0461,820,517 ,0 ,517 ,1023 ,0,3,1,3,0,1,0,76.14,50.54 ,33.33
02,000,02,011,0462,821,597 ,6 ,603 ,1299 ,0,3,1,3,0,1,0,76.14,46.42 ,33.33
02,000,02,011,0462,822,664 ,4 ,668 ,1414 ,0,3,1,3,0,1,0,76.14,47.24 ,33.33
02,000,02,011,0463,823,639 ,2 ,641 ,1390 ,0,3,1,3,0,1,0,76.14,46.12 ,33.33
02,000,02,011,0463,824,601 ,6 ,607 ,1374 ,0,3,1,3,0,1,0,76.14,44.18 ,33.33
03,001,01,001,0001,1,682 ,1 ,683 ,1183 ,0,3,1,3,0,1,0,76.14,57.73 ,33.33
03,001,01,001,0002,2,684 ,6 ,690 ,1223 ,0,3,1,3,0,1,0,76.14,56.42 ,33.33
03,001,01,001,0003,3,390 ,1 ,391 ,656 ,0,3,1,3,0,1,0,76.14,59.60 ,33.33
03,001,01,001,0004,4,597 ,6 ,603 ,1028 ,0,3,1,3,0,1,0,76.14,58.66 ,33.33
03,001,01,001,0005,5,473 ,2 ,475 ,792 ,0,3,1,3,0,1,0,76.14,59.97 ,33.33
03,001,01,001,0005,6,373 ,4 ,377 ,653 ,0,3,1,3,0,1,0,76.14,57.73 ,33.33
03,001,01,001,0006,7,530 ,7 ,537 ,939 ,0,3,1,3,0,1,0,76.14,57.19 ,33.33
03,001,01,001,0006,8,479 ,2 ,481 ,909 ,0,3,1,3,0,1,0,76.14,52.92 ,33.33
03,001,01,001,0006,9,438 ,9 ,447 ,770 ,0,3,1,3,0,1,0,76.14,58.05 ,33.33
03,001,01,001,0006,10,669 ,9 ,678 ,1108 ,0,3,1,3,0,1,0,76.14,61.19 ,33.33
03,001,01,001,0007,11,644 ,13 ,657 ,1202 ,0,3,1,3,0,1,0,76.14,54.66 ,33.33
03,001,01,001,0007,12,704 ,3 ,707 ,1346 ,0,3,1,3,0,1,0,76.14,52.53 ,33.33
03,001,01,001,0008,13,699 ,4 ,703 ,1882 ,0,3,1,3,0,1,0,76.14,37.35 ,33.33
03,001,01,001,0008,14,848 ,6 ,854 ,1495 ,0,3,1,3,0,1,0,76.14,57.12 ,33.33
03,001,01,001,0008,15,627 ,4 ,631 ,1033 ,0,3,1,3,0,1,0,76.14,61.08 ,33.33
03,001,01,001,0008,16,616 ,1 ,617 ,1139 ,0,3,1,3,0,1,0,76.14,54.17 ,33.33
03,001,01,001,0009,17,681 ,3 ,684 ,1243 ,0,3,1,3,0,1,0,76.14,55.03 ,33.33
03,001,01,001,0009,18,559 ,3 ,562 ,1057 ,0,3,1,3,0,1,0,76.14,53.17 ,33.33
03,001,01,001,0009,19,754 ,3 ,757 ,1255 ,0,3,1,3,0,1,0,76.14,60.32 ,33.33
03,001,01,001,0010,20,595 ,3 ,598 ,1038 ,0,3,1,3,0,1,0,76.14,57.61,33.33
03,001,01,001,0010,21,642 ,3 ,645 ,1166 ,0,3,1,3,0,1,0,76.14,55.32,33.33
03,001,01,001,0011,22,623 ,6 ,629 ,1142 ,0,3,1,3,0,1,0,76.14,55.08 ,33.33
03,001,01,001,0011,23,649 ,5 ,654 ,1166 ,0,3,1,3,0,1,0,76.14,56.09 ,33.33
03,001,01,001,0011,24,621 ,7 ,628 ,1212 ,0,3,1,3,0,1,0,76.14,51.82 ,33.33
03,001,01,001,0012,25,709 ,8 ,717 ,1130 ,0,3,1,3,0,1,0,76.14,63.45 ,33.33
03,001,01,001,0012,26,723 ,6 ,729 ,1193 ,0,3,1,3,0,1,0,76.14,61.11 ,33.33
03,001,01,001,0012,27,622 ,3 ,625 ,1096 ,0,3,1,3,0,1,0,76.14,57.03 ,33.33
03,001,01,001,0012,28,644 ,4 ,648 ,1046 ,0,3,1,3,0,1,0,76.14,61.95 ,33.33
03,001,01,001,0013,29,819 ,10 ,829 ,1293 ,0,3,1,3,0,1,0,76.14,64.11 ,33.33
03,001,01,001,0013,30,662 ,4 ,666 ,1091 ,0,3,1,3,0,1,0,76.14,61.04 ,33.33
03,001,01,001,0014,31,644 ,7 ,651 ,1171 ,0,3,1,3,0,1,0,76.14,55.59 ,33.33
03,001,01,001,0014,32,706 ,2 ,708 ,1105 ,0,3,1,3,0,1,0,76.14,64.07 ,33.33
03,001,01,001,0015,33,631 ,5 ,636 ,1063 ,0,3,1,3,0,1,0,76.14,59.83,33.33
03,001,01,001,0015,34,618 ,14 ,632 ,1102 ,0,3,1,3,0,1,0,76.14,57.35,33.33
03,001,01,001,0016,35,830 ,11 ,841 ,1234 ,0,3,1,3,0,1,0,76.14,68.15 ,33.33
03,001,01,001,0016,36,697 ,9 ,706 ,1015 ,0,3,1,3,0,1,0,76.14,69.56 ,33.33
03,001,01,001,0016,37,632 ,6 ,638 ,1020 ,0,3,1,3,0,1,0,76.14,62.55 ,33.33
03,001,01,001,0017,38,730 ,4 ,734 ,1256 ,0,3,1,3,0,1,0,76.14,58.44 ,33.33
03,001,01,001,0017,39,577 ,3 ,580 ,885 ,0,3,1,3,0,1,0,76.14,65.54 ,33.33
03,001,01,001,0018,40,640 ,6 ,646 ,1246 ,0,3,1,3,0,1,0,76.14,51.85,33.33
03,001,01,001,0018,41,776 ,7 ,783 ,1342 ,0,3,1,3,0,1,0,76.14,58.35,33.33
03,001,01,001,0018,42,627 ,3 ,630 ,1140 ,0,3,1,3,0,1,0,76.14,55.26,33.33
03,001,01,001,0019,43,592 ,8 ,600 ,1138 ,0,3,1,3,0,1,0,76.14,52.72 ,33.33
03,001,01,001,0019,44,595 ,4 ,599 ,1091 ,0,3,1,3,0,1,0,76.14,54.90 ,33.33
03,001,01,001,0019,45,655 ,4 ,659 ,1153 ,0,3,1,3,0,1,0,76.14,57.16 ,33.33
03,001,01,001,0020,46,561 ,7 ,568 ,1080 ,0,3,1,3,0,1,0,76.14,52.59 ,33.33
03,001,01,001,0020,47,558 ,8 ,566 ,1054 ,0,3,1,3,0,1,0,76.14,53.70 ,33.33
03,001,01,001,0020,48,483 ,6 ,489 ,860 ,0,3,1,3,0,1,0,76.14,56.86 ,33.33
03,001,01,001,0020,49,658 ,4 ,662 ,1162 ,0,3,1,3,0,1,0,76.14,56.97 ,33.33
03,001,01,001,0021,50,718 ,5 ,723 ,1171 ,0,3,1,3,0,1,0,76.14,61.74 ,33.33
03,001,01,001,0021,51,816 ,13 ,829 ,1296 ,0,3,1,3,0,1,0,76.14,63.97 ,33.33
03,001,01,001,0022,52,513 ,2 ,515 ,798 ,0,3,1,3,0,1,0,76.14,64.54,33.33
03,001,01,001,0022,53,607 ,6 ,613 ,970 ,0,3,1,3,0,1,0,76.14,63.2,33.33
03,001,01,001,0023,54,591 ,3 ,594 ,1042 ,0,3,1,3,0,1,0,76.14,57.01 ,33.33
03,001,01,001,0023,55,698 ,3 ,701 ,1121 ,0,3,1,3,0,1,0,76.14,62.53 ,33.33
03,001,01,001,0023,56,628 ,8 ,636 ,978 ,0,3,1,3,0,1,0,76.14,65.03 ,33.33
03,001,01,001,0024,57,722 ,3 ,725 ,1168 ,0,3,1,3,0,1,0,76.14,62.07 ,33.33
03,001,01,001,0024,58,771 ,4 ,775 ,1272 ,0,3,1,3,0,1,0,76.14,60.93 ,33.33
03,001,01,001,0024,59,773 ,3 ,776 ,1285 ,0,3,1,3,0,1,0,76.14,60.39 ,33.33
03,001,01,001,0025,60,626 ,0 ,626 ,1160 ,0,3,1,3,0,1,0,76.14,53.97 ,33.33
03,001,01,001,0025,61,673 ,3 ,676 ,1103 ,0,3,1,3,0,1,0,76.14,61.29 ,33.33
03,001,01,001,0025,62,729 ,5 ,734 ,1330 ,0,3,1,3,0,1,0,76.14,55.19 ,33.33
03,001,01,001,0026,63,659 ,2 ,661 ,1201 ,0,3,1,3,0,1,0,76.14,55.04 ,33.33
03,001,01,001,0026,64,610 ,9 ,619 ,1031 ,0,3,1,3,0,1,0,76.14,60.04 ,33.33
03,001,01,001,0026,65,525 ,7 ,532 ,964 ,0,3,1,3,0,1,0,76.14,55.19 ,33.33
03,001,01,001,0027,66,635 ,2 ,637 ,1167 ,0,3,1,3,0,1,0,76.14,54.58 ,33.33
03,001,01,001,0027,67,649 ,3 ,652 ,1156 ,0,3,1,3,0,1,0,76.14,56.40 ,33.33
03,001,01,001,0027,68,545 ,2 ,547 ,1036 ,0,3,1,3,0,1,0,76.14,52.80 ,33.33
03,001,01,001,0028,69,733 ,4 ,737 ,1334 ,0,3,1,3,0,1,0,76.14,55.25,33.33
03,001,01,001,0028,70,683 ,2 ,685 ,1205 ,0,3,1,3,0,1,0,76.14,56.85,33.33
03,001,01,001,0029,71,799 ,3 ,802 ,1289 ,0,3,1,3,0,1,0,76.14,62.22 ,33.33
03,001,01,001,0029,72,677 ,2 ,679 ,1052 ,0,3,1,3,0,1,0,76.14,64.54 ,33.33
03,001,01,001,0030,73,715 ,3 ,718 ,1225 ,0,3,1,3,0,1,0,76.14,58.61,33.33
03,001,01,001,0030,74,680 ,3 ,683 ,1193 ,0,3,1,3,0,1,0,76.14,57.25,33.33
03,001,01,001,0031,75,688 ,5 ,693 ,1172 ,0,3,1,3,0,1,0,76.14,59.13 ,33.33
03,001,01,001,0031,76,514 ,5 ,519 ,921 ,0,3,1,3,0,1,0,76.14,56.35 ,33.33
03,001,01,001,0032,77,686 ,2 ,688 ,1243 ,0,3,1,3,0,1,0,76.14,55.35 ,33.33
03,001,01,001,0032,78,717 ,6 ,723 ,1289 ,0,3,1,3,0,1,0,76.14,56.09 ,33.33
03,001,01,001,0033,79,486 ,7 ,493 ,903 ,0,3,1,3,0,1,0,76.14,54.60 ,33.33
03,001,01,001,0033,80,634 ,2 ,636 ,1114 ,0,3,1,3,0,1,0,76.14,57.09 ,33.33
03,001,01,001,0034,81,772 ,7 ,779 ,1406 ,0,3,1,3,0,1,0,76.14,55.41 ,33.33
03,001,01,001,0034,82,730 ,8 ,738 ,1317 ,0,3,1,3,0,1,0,76.14,56.04 ,33.33
03,001,01,001,0034,83,771 ,8 ,779 ,1425 ,0,3,1,3,0,1,0,76.14,54.67 ,33.33
03,001,01,001,0035,84,777 ,9 ,786 ,1436 ,0,3,1,3,0,1,0,76.14,54.74 ,33.33
03,001,01,001,0035,85,717 ,4 ,721 ,1290 ,0,3,1,3,0,1,0,76.14,55.89 ,33.33
03,001,01,001,0035,86,673 ,4 ,677 ,1279 ,0,3,1,3,0,1,0,76.14,52.93 ,33.33
03,001,01,001,0036,87,850 ,3 ,853 ,1487 ,0,3,1,3,0,1,0,76.14,57.36 ,33.33
03,001,01,001,0036,88,695 ,2 ,697 ,1365 ,0,3,1,3,0,1,0,76.14,51.06 ,33.33
03,001,01,001,0036,89,703 ,2 ,705 ,1350 ,0,3,1,3,0,1,0,76.14,52.22 ,33.33
03,001,01,001,0037,90,648 ,1 ,649 ,1227 ,0,3,1,3,0,1,0,76.14,52.89 ,33.33
03,001,01,001,0037,91,698 ,4 ,702 ,1409 ,0,3,1,3,0,1,0,76.14,49.82 ,33.33
03,001,01,001,0037,92,580 ,5 ,585 ,1075 ,0,3,1,3,0,1,0,76.14,54.42 ,33.33
03,001,01,001,0037,93,679 ,5 ,684 ,1187 ,0,3,1,3,0,1,0,76.14,57.62 ,33.33
03,001,01,001,0038,94,880 ,4 ,884 ,1677 ,0,3,1,3,0,1,0,76.14,52.71 ,33.33
03,001,01,001,0038,95,866 ,11 ,877 ,1577 ,0,3,1,3,0,1,0,76.14,55.61 ,33.33
03,001,01,001,0039,96,674 ,5 ,679 ,1215 ,0,3,1,3,0,1,0,76.14,55.88,33.33
03,001,01,001,0039,97,810 ,4 ,814 ,1422 ,0,3,1,3,0,1,0,76.14,57.24,33.33
03,001,01,001,0040,98,688 ,2 ,690 ,1212 ,0,3,1,3,0,1,0,76.14,56.93 ,33.33
03,001,01,001,0040,99,779 ,12 ,791 ,1426 ,0,3,1,3,0,1,0,76.14,55.47 ,33.33
03,001,01,001,0041,100,796 ,11 ,807 ,1440 ,0,3,1,3,0,1,0,76.14,56.04 ,33.33
03,001,01,001,0041,101,742 ,4 ,746 ,1304 ,0,3,1,3,0,1,0,76.14,57.21 ,33.33
03,001,01,001,0042,102,815 ,9 ,824 ,1555 ,0,3,1,3,0,1,0,76.14,52.99 ,33.33
03,001,01,001,0042,103,862 ,10 ,872 ,1567 ,0,3,1,3,0,1,0,76.14,55.65 ,33.33
03,001,01,001,0042,104,767 ,4 ,771 ,1448 ,0,3,1,3,0,1,0,76.14,53.25 ,33.33
03,001,01,001,0042,105,865 ,5 ,870 ,1618 ,0,3,1,3,0,1,0,76.14,53.77 ,33.33
03,001,01,001,0043,106,550 ,4 ,554 ,1017 ,0,3,1,3,0,1,0,76.14,54.47,33.33
03,001,01,001,0043,107,456 ,2 ,458 ,830 ,0,3,1,3,0,1,0,76.14,55.18,33.33
03,001,01,001,0043,108,578 ,4 ,582 ,1051 ,0,3,1,3,0,1,0,76.14,55.38,33.33
03,001,01,001,0044,109,612 ,5 ,617 ,1024 ,0,3,1,3,0,1,0,76.14,60.25 ,33.33
03,001,01,001,0044,110,553 ,3 ,556 ,954 ,0,3,1,3,0,1,0,76.14,58.28 ,33.33
03,001,01,001,0044,111,572 ,4 ,576 ,1046 ,0,3,1,3,0,1,0,76.14,55.07 ,33.33
03,001,01,001,0045,112,878 ,9 ,887 ,1584 ,0,3,1,3,0,1,0,76.14,56.00 ,33.33
03,001,01,001,0045,113,722 ,3 ,725 ,1209 ,0,3,1,3,0,1,0,76.14,59.97 ,33.33
03,001,01,001,0045,114,1127 ,9 ,1136 ,2078 ,0,3,1,3,0,1,0,76.14,54.67 ,33.33
03,001,01,001,0046,115,481 ,6 ,487 ,1031 ,0,3,1,3,0,1,0,76.14,47.24,33.33
03,001,01,001,0046,116,503 ,3 ,506 ,935 ,0,3,1,3,0,1,0,76.14,54.12,33.33
03,001,01,001,0046,117,496 ,4 ,500 ,947 ,0,3,1,3,0,1,0,76.14,52.8,33.33
03,001,01,001,0047,118,409 ,0 ,409 ,785 ,0,3,1,3,0,1,0,76.14,52.10 ,33.33
03,001,01,001,0047,119,487 ,1 ,488 ,897 ,0,3,1,3,0,1,0,76.14,54.40 ,33.33
03,001,01,001,0047,120,588 ,4 ,592 ,1010 ,0,3,1,3,0,1,0,76.14,58.61 ,33.33
03,001,01,001,0048,121,427 ,2 ,429 ,805 ,0,3,1,3,0,1,0,76.14,53.29 ,33.33
03,001,01,001,0048,122,573 ,9 ,582 ,1024 ,0,3,1,3,0,1,0,76.14,56.84 ,33.33
03,001,01,001,0048,123,596 ,3 ,599 ,1104 ,0,3,1,3,0,1,0,76.14,54.26 ,33.33
03,001,01,001,0048,124,675 ,9 ,684 ,1151 ,0,3,1,3,0,1,0,76.14,59.43 ,33.33
03,001,01,001,0049,125,749 ,3 ,752 ,1455 ,0,3,1,3,0,1,0,76.14,51.68 ,33.33
03,001,01,001,0049,126,803 ,7 ,810 ,1602 ,0,3,1,3,0,1,0,76.14,50.56 ,33.33
03,001,01,001,0050,127,844 ,5 ,849 ,1544 ,0,3,1,3,0,1,0,76.14,54.99 ,33.33
03,001,01,001,0050,128,800 ,5 ,805 ,1401 ,0,3,1,3,0,1,0,76.14,57.46 ,33.33
03,001,01,001,0051,129,658 ,2 ,660 ,1211 ,0,3,1,3,0,1,0,76.14,54.50 ,33.33
03,001,01,001,0051,130,651 ,3 ,654 ,1241 ,0,3,1,3,0,1,0,76.14,52.70 ,33.33
03,001,01,001,0051,131,702 ,4 ,706 ,1210 ,0,3,1,3,0,1,0,76.14,58.35 ,33.33
03,001,01,001,0052,132,566 ,2 ,568 ,1053 ,0,3,1,3,0,1,0,76.14,53.94,33.33
03,001,01,001,0052,133,452 ,4 ,456 ,786 ,0,3,1,3,0,1,0,76.14,58.02,33.33
03,001,01,001,0053,134,696 ,5 ,701 ,1230 ,0,3,1,3,0,1,0,76.14,56.99 ,33.33
03,001,01,001,0053,135,823 ,3 ,826 ,1436 ,0,3,1,3,0,1,0,76.14,57.52 ,33.33
03,001,01,001,0054,136,744 ,4 ,748 ,1369 ,0,3,1,3,0,1,0,76.14,54.64,33.33
03,001,01,001,0054,137,592 ,6 ,598 ,1148 ,0,3,1,3,0,1,0,76.14,52.09,33.33
03,001,01,001,0055,138,978 ,16 ,994 ,1676 ,0,3,1,3,0,1,0,76.14,59.31 ,33.33
03,001,01,001,0055,139,860 ,8 ,868 ,1451 ,0,3,1,3,0,1,0,76.14,59.82 ,33.33
03,001,01,001,0055,140,928 ,5 ,933 ,1657 ,0,3,1,3,0,1,0,76.14,56.31 ,33.33
03,001,01,001,0055,141,1199 ,7 ,1206 ,2146 ,0,3,1,3,0,1,0,76.14,56.20 ,33.33
03,001,01,001,0056,142,623 ,4 ,627 ,1066 ,0,3,1,3,0,1,0,76.14,58.82 ,33.33
03,001,01,001,0056,143,627 ,8 ,635 ,1095 ,0,3,1,3,0,1,0,76.14,57.99 ,33.33
03,001,01,001,0057,144,905 ,12 ,917 ,1574 ,0,3,1,3,0,1,0,76.14,58.26,33.33
03,001,01,001,0057,145,807 ,3 ,810 ,1427 ,0,3,1,3,0,1,0,76.14,56.76,33.33
03,001,01,001,0057,146,723 ,3 ,726 ,1219 ,0,3,1,3,0,1,0,76.14,59.56,33.33
03,001,01,001,0058,147,595 ,3 ,598 ,1060 ,0,3,1,3,0,1,0,76.14,56.42 ,33.33
03,001,01,001,0058,148,708 ,5 ,713 ,1238 ,0,3,1,3,0,1,0,76.14,57.59 ,33.33
03,001,01,001,0059,149,631 ,4 ,635 ,1252 ,0,3,1,3,0,1,0,76.14,50.72 ,33.33
03,001,01,001,0059,150,651 ,4 ,655 ,1281 ,0,3,1,3,0,1,0,76.14,51.13 ,33.33
03,001,01,001,0060,151,1019 ,8 ,1027 ,1988 ,0,3,1,3,0,1,0,76.14,51.66 ,33.33
03,001,01,001,0060,152,694 ,6 ,700 ,1363 ,0,3,1,3,0,1,0,76.14,51.36 ,33.33
03,001,01,001,0060,153,744 ,6 ,750 ,1423 ,0,3,1,3,0,1,0,76.14,52.71 ,33.33
03,001,01,001,0061,154,350 ,4 ,354 ,623 ,0,3,1,3,0,1,0,76.14,56.82 ,33.33
03,001,01,001,0061,155,477 ,3 ,480 ,851 ,0,3,1,3,0,1,0,76.14,56.40 ,33.33
03,001,01,001,0062,156,756 ,18 ,774 ,1313 ,0,3,1,3,0,1,0,76.14,58.95 ,33.33
03,001,01,001,0062,157,720 ,5 ,725 ,1352 ,0,3,1,3,0,1,0,76.14,53.62 ,33.33
03,001,01,001,0062,158,550 ,6 ,556 ,952 ,0,3,1,3,0,1,0,76.14,58.40 ,33.33
03,001,01,001,0062,159,501 ,3 ,504 ,849 ,0,3,1,3,0,1,0,76.14,59.36 ,33.33
03,001,01,001,0063,160,771 ,10 ,781 ,1288 ,0,3,1,3,0,1,0,76.14,60.64 ,33.33
03,001,01,001,0063,161,789 ,6 ,795 ,1298 ,0,3,1,3,0,1,0,76.14,61.25 ,33.33
03,001,01,001,0063,162,566 ,8 ,574 ,910 ,0,3,1,3,0,1,0,76.14,63.08 ,33.33
03,001,01,001,0064,163,795 ,4 ,799 ,1424 ,0,3,1,3,0,1,0,76.14,56.11 ,33.33
03,001,01,001,0064,164,657 ,6 ,663 ,1130 ,0,3,1,3,0,1,0,76.14,58.67 ,33.33
03,001,01,001,0064,165,542 ,2 ,544 ,914 ,0,3,1,3,0,1,0,76.14,59.52 ,33.33
03,001,01,001,0065,166,773 ,10 ,783 ,1334 ,0,3,1,3,0,1,0,76.14,58.70 ,33.33
03,001,01,001,0065,167,629 ,8 ,637 ,1185 ,0,3,1,3,0,1,0,76.14,53.76 ,33.33
03,001,01,001,0066,168,866 ,8 ,874 ,1509 ,0,3,1,3,0,1,0,76.14,57.92 ,33.33
03,001,01,001,0066,169,795 ,0 ,795 ,1340 ,0,3,1,3,0,1,0,76.14,59.33 ,33.33
03,001,01,001,0066,170,760 ,6 ,766 ,1316 ,0,3,1,3,0,1,0,76.14,58.21 ,33.33
03,001,01,001,0067,171,483 ,4 ,487 ,894 ,0,3,1,3,0,1,0,76.14,54.47,33.33
03,001,01,001,0067,172,602 ,3 ,605 ,984 ,0,3,1,3,0,1,0,76.14,61.48,33.33
03,001,01,001,0068,173,704 ,3 ,707 ,1241 ,0,3,1,3,0,1,0,76.14,56.97 ,33.33
03,001,01,001,0068,174,655 ,5 ,660 ,1162 ,0,3,1,3,0,1,0,76.14,56.80 ,33.33
03,001,01,001,0069,175,754 ,2 ,756 ,1282 ,0,3,1,3,0,1,0,76.14,58.97 ,33.33
03,001,01,001,0069,176,716 ,9 ,725 ,1354 ,0,3,1,3,0,1,0,76.14,53.55 ,33.33
03,001,01,001,0070,177,715 ,3 ,718 ,1260 ,0,3,1,3,0,1,0,76.14,56.98,33.33
03,001,01,001,0070,178,626 ,1 ,627 ,1217 ,0,3,1,3,0,1,0,76.14,51.52,33.33
03,001,01,001,0071,179,842 ,5 ,847 ,1511 ,0,3,1,3,0,1,0,76.14,56.06 ,33.33
03,001,01,001,0071,180,758 ,7 ,765 ,1301 ,0,3,1,3,0,1,0,76.14,58.80 ,33.33
03,001,01,001,0071,181,713 ,6 ,719 ,1311 ,0,3,1,3,0,1,0,76.14,54.84 ,33.33
03,001,01,001,0071,182,719 ,5 ,724 ,1470 ,0,3,1,3,0,1,0,76.14,49.25 ,33.33
03,001,01,001,0072,183,709 ,6 ,715 ,1280 ,0,3,1,3,0,1,0,76.14,55.86 ,33.33
03,001,01,001,0072,184,570 ,8 ,578 ,1064 ,0,3,1,3,0,1,0,76.14,54.32 ,33.33
03,001,01,001,0073,185,773 ,6 ,779 ,1356 ,0,3,1,3,0,1,0,76.14,57.45,33.33
03,001,01,001,0073,186,700 ,4 ,704 ,1086 ,0,3,1,3,0,1,0,76.14,64.83,33.33
03,001,01,001,0074,187,824 ,7 ,831 ,1656 ,0,3,1,3,0,1,0,76.14,50.18 ,33.33
03,001,01,001,0074,188,671 ,5 ,676 ,1253 ,0,3,1,3,0,1,0,76.14,53.95 ,33.33
03,001,01,001,0074,189,643 ,3 ,646 ,1135 ,0,3,1,3,0,1,0,76.14,56.92 ,33.33
03,001,01,001,0075,190,750 ,6 ,756 ,1289 ,0,3,1,3,0,1,0,76.14,58.65 ,33.33
03,001,01,001,0075,191,648 ,8 ,656 ,1120 ,0,3,1,3,0,1,0,76.14,58.57 ,33.33
03,001,01,001,0076,192,892 ,3 ,895 ,1647 ,0,3,1,3,0,1,0,76.14,54.34 ,33.33
03,001,01,001,0076,193,768 ,5 ,773 ,1381 ,0,3,1,3,0,1,0,76.14,55.97 ,33.33
03,001,01,001,0077,194,930 ,3 ,933 ,1617 ,0,3,1,3,0,1,0,76.14,57.7,33.33
03,001,01,001,0077,195,767 ,9 ,776 ,1278 ,0,3,1,3,0,1,0,76.14,60.72,33.33
03,001,01,001,0078,196,716 ,5 ,721 ,1318 ,0,3,1,3,0,1,0,76.14,54.70 ,33.33
03,001,01,001,0078,197,749 ,4 ,753 ,1357 ,0,3,1,3,0,1,0,76.14,55.49 ,33.33
03,001,01,001,0079,198,963 ,12 ,975 ,1658 ,0,3,1,3,0,1,0,76.14,58.81 ,33.33
03,001,01,001,0079,199,742 ,2 ,744 ,1336 ,0,3,1,3,0,1,0,76.14,55.69 ,33.33
03,001,01,001,0080,200,424 ,6 ,430 ,858 ,0,3,1,3,0,1,0,76.14,50.12 ,33.33
03,001,01,001,0080,201,541 ,8 ,549 ,996 ,0,3,1,3,0,1,0,76.14,55.12 ,33.33
03,001,01,001,0080,202,608 ,5 ,613 ,1076 ,0,3,1,3,0,1,0,76.14,56.97 ,33.33
03,001,01,001,0081,203,582 ,4 ,586 ,1028 ,0,3,1,3,0,1,0,76.14,57.00 ,33.33
03,001,01,001,0081,204,846 ,6 ,852 ,1409 ,0,3,1,3,0,1,0,76.14,60.47 ,33.33
03,001,01,001,0081,205,524 ,5 ,529 ,979 ,0,3,1,3,0,1,0,76.14,54.03 ,33.33
03,001,01,001,0081,206,509 ,1 ,510 ,871 ,0,3,1,3,0,1,0,76.14,58.55 ,33.33
03,001,01,001,0082,207,625 ,6 ,631 ,1041 ,0,3,1,3,0,1,0,76.14,60.61 ,33.33
03,001,01,001,0082,208,488 ,3 ,491 ,880 ,0,3,1,3,0,1,0,76.14,55.80 ,33.33
03,001,01,001,0082,209,624 ,3 ,627 ,1111 ,0,3,1,3,0,1,0,76.14,56.44 ,33.33
03,001,01,001,0083,210,674 ,8 ,682 ,1144 ,0,3,1,3,0,1,0,76.14,59.62 ,33.33
03,001,01,001,0083,211,622 ,3 ,625 ,1053 ,0,3,1,3,0,1,0,76.14,59.35 ,33.33
03,001,01,001,0084,212,620 ,2 ,622 ,1099 ,0,3,1,3,0,1,0,76.14,56.60 ,33.33
03,001,01,001,0084,213,666 ,6 ,672 ,1172 ,0,3,1,3,0,1,0,76.14,57.34 ,33.33
03,001,01,001,0084,214,645 ,5 ,650 ,1147 ,0,3,1,3,0,1,0,76.14,56.67 ,33.33
03,001,01,001,0085,215,449 ,1 ,450 ,760 ,0,3,1,3,0,1,0,76.14,59.21,33.33
03,001,01,001,0085,216,473 ,3 ,476 ,839 ,0,3,1,3,0,1,0,76.14,56.73,33.33
03,001,01,001,0086,217,777 ,4 ,781 ,1332 ,0,3,1,3,0,1,0,76.14,58.63 ,33.33
03,001,01,001,0086,218,947 ,10 ,957 ,1663 ,0,3,1,3,0,1,0,76.14,57.55 ,33.33
03,001,01,001,0087,219,579 ,6 ,585 ,961 ,0,3,1,3,0,1,0,76.14,60.87,33.33
03,001,01,001,0087,220,643 ,5 ,648 ,1800 ,0,3,1,3,0,1,0,76.14,36,33.33
03,001,01,001,0088,221,645 ,5 ,650 ,1055 ,0,3,1,3,0,1,0,76.14,61.61 ,33.33
03,001,01,001,0088,222,357 ,3 ,360 ,573 ,0,3,1,3,0,1,0,76.14,62.83 ,33.33
03,001,01,001,0089,223,837 ,6 ,843 ,1620 ,0,3,1,3,0,1,0,76.14,52.04 ,33.33
03,001,01,001,0089,224,791 ,10 ,801 ,1385 ,0,3,1,3,0,1,0,76.14,57.83 ,33.33
03,001,01,001,0090,225,645 ,2 ,647 ,1106 ,0,3,1,3,0,1,0,76.14,58.50 ,33.33
03,001,01,001,0090,226,610 ,5 ,615 ,1045 ,0,3,1,3,0,1,0,76.14,58.85 ,33.33
03,001,01,001,0090,227,512 ,2 ,514 ,891 ,0,3,1,3,0,1,0,76.14,57.69 ,33.33
03,001,01,001,0091,228,677 ,2 ,679 ,1158 ,0,3,1,3,0,1,0,76.14,58.64 ,33.33
03,001,01,001,0091,229,787 ,2 ,789 ,1370 ,0,3,1,3,0,1,0,76.14,57.59 ,33.33
03,001,01,001,0092,230,832 ,9 ,841 ,1365 ,0,3,1,3,0,1,0,76.14,61.61,33.33
03,001,01,001,0092,231,874 ,16 ,890 ,1523 ,0,3,1,3,0,1,0,76.14,58.44,33.33
03,001,01,001,0093,232,727 ,5 ,732 ,1227 ,0,3,1,3,0,1,0,76.14,59.66 ,33.33
03,001,01,001,0093,233,859 ,10 ,869 ,1358 ,0,3,1,3,0,1,0,76.14,63.99 ,33.33
03,001,01,001,0093,234,896 ,6 ,902 ,1569 ,0,3,1,3,0,1,0,76.14,57.49 ,33.33
03,001,01,001,0094,235,799 ,7 ,806 ,1367 ,0,3,1,3,0,1,0,76.14,58.96 ,33.33
03,001,01,001,0094,236,749 ,4 ,753 ,1341 ,0,3,1,3,0,1,0,76.14,56.15 ,33.33
03,001,01,001,0095,237,849 ,10 ,859 ,1437 ,0,3,1,3,0,1,0,76.14,59.78 ,33.33
03,001,01,001,0095,238,793 ,6 ,799 ,1320 ,0,3,1,3,0,1,0,76.14,60.53 ,33.33
03,001,01,001,0096,239,956 ,11 ,967 ,1708 ,0,3,1,3,0,1,0,76.14,56.62 ,33.33
03,001,01,001,0096,240,719 ,7 ,726 ,1204 ,0,3,1,3,0,1,0,76.14,60.30 ,33.33
03,001,01,001,0097,241,621 ,5 ,626 ,1214 ,0,3,1,3,0,1,0,76.14,51.57 ,33.33
03,001,01,001,0097,242,689 ,2 ,691 ,1179 ,0,3,1,3,0,1,0,76.14,58.61 ,33.33
03,001,01,001,0097,243,794 ,10 ,804 ,1318 ,0,3,1,3,0,1,0,76.14,61.00 ,33.33
03,001,01,001,0097,244,631 ,0 ,631 ,1090 ,0,3,1,3,0,1,0,76.14,57.89 ,33.33
03,001,01,001,0098,245,832 ,8 ,840 ,1496 ,0,3,1,3,0,1,0,76.14,56.15 ,33.33
03,001,01,001,0098,246,726 ,2 ,728 ,1180 ,0,3,1,3,0,1,0,76.14,61.69 ,33.33
03,001,01,001,0098,247,662 ,8 ,670 ,1131 ,0,3,1,3,0,1,0,76.14,59.24 ,33.33
03,001,01,001,0099,248,885 ,13 ,898 ,1634 ,0,3,1,3,0,1,0,76.14,54.96 ,33.33
03,001,01,001,0099,249,771 ,12 ,783 ,1535 ,0,3,1,3,0,1,0,76.14,51.01 ,33.33
03,001,01,001,0099,250,738 ,4 ,742 ,1451 ,0,3,1,3,0,1,0,76.14,51.14 ,33.33
03,001,01,001,0099,251,954 ,6 ,960 ,1792 ,0,3,1,3,0,1,0,76.14,53.57 ,33.33
03,001,01,001,0100,252,603 ,4 ,607 ,904 ,0,3,1,3,0,1,0,76.14,67.15 ,33.33
03,001,01,001,0100,253,527 ,2 ,529 ,903 ,0,3,1,3,0,1,0,76.14,58.58 ,33.33
03,001,01,001,0100,254,523 ,7 ,530 ,900 ,0,3,1,3,0,1,0,76.14,58.89 ,33.33
03,001,01,001,0101,255,498 ,5 ,503 ,910 ,0,3,1,3,0,1,0,76.14,55.27 ,33.33
03,001,01,001,0102,256,762 ,11 ,773 ,1337 ,0,3,1,3,0,1,0,76.14,57.82 ,33.33
03,001,01,001,0102,257,685 ,2 ,687 ,1417 ,0,3,1,3,0,1,0,76.14,48.48 ,33.33
03,001,01,001,0103,258,627 ,2 ,629 ,1090 ,0,3,1,3,0,1,0,76.14,57.71,33.33
03,001,01,001,0103,259,689 ,6 ,695 ,1211 ,0,3,1,3,0,1,0,76.14,57.39,33.33
03,001,01,001,0103,260,677 ,8 ,685 ,1279 ,0,3,1,3,0,1,0,76.14,53.56,33.33
03,001,01,001,0104,261,907 ,4 ,911 ,1561 ,0,3,1,3,0,1,0,76.14,58.36 ,33.33
03,001,01,001,0104,262,962 ,12 ,974 ,1711 ,0,3,1,3,0,1,0,76.14,56.93 ,33.33
03,001,01,001,0105,263,694 ,10 ,704 ,1149 ,0,3,1,3,0,1,0,76.14,61.27 ,33.33
03,001,01,001,0105,264,752 ,11 ,763 ,1217 ,0,3,1,3,0,1,0,76.14,62.70 ,33.33
03,001,01,001,0106,265,611 ,4 ,615 ,983 ,0,3,1,3,0,1,0,76.14,62.56,33.33
03,001,01,001,0106,266,487 ,6 ,493 ,797 ,0,3,1,3,0,1,0,76.14,61.86,33.33
03,001,01,001,0107,267,679 ,10 ,689 ,1365 ,0,3,1,3,0,1,0,76.14,50.48 ,33.33
03,001,01,001,0107,268,763 ,9 ,772 ,1452 ,0,3,1,3,0,1,0,76.14,53.17 ,33.33
03,001,01,001,0107,269,643 ,2 ,645 ,1192 ,0,3,1,3,0,1,0,76.14,54.11 ,33.33
03,001,01,001,0107,270,633 ,4 ,637 ,1180 ,0,3,1,3,0,1,0,76.14,53.98 ,33.33
03,001,01,001,0108,271,845 ,7 ,852 ,1399 ,0,3,1,3,0,1,0,76.14,60.90 ,33.33
03,001,01,001,0108,272,966 ,7 ,973 ,1623 ,0,3,1,3,0,1,0,76.14,59.95 ,33.33
03,001,01,001,0108,273,877 ,5 ,882 ,1466 ,0,3,1,3,0,1,0,76.14,60.16,33.33
03,001,01,001,0109,274,591 ,5 ,596 ,1098 ,0,3,1,3,0,1,0,76.14,54.28,33.33
03,001,01,001,0109,275,657 ,5 ,662 ,1093 ,0,3,1,3,0,1,0,76.14,60.57,33.33
03,001,01,001,0109,276,688 ,9 ,697 ,1149 ,0,3,1,3,0,1,0,76.14,60.66,33.33
03,001,01,001,0110,277,672 ,4 ,676 ,1281 ,0,3,1,3,0,1,0,76.14,52.77,33.33
03,001,01,001,0110,278,552 ,4 ,556 ,1059 ,0,3,1,3,0,1,0,76.14,52.5,33.33
03,001,01,001,0110,279,505 ,3 ,508 ,1221 ,0,3,1,3,0,1,0,76.14,41.61,33.33
03,001,01,001,0111,280,662 ,7 ,669 ,1232 ,0,3,1,3,0,1,0,76.14,54.3,33.33
03,001,01,001,0111,281,833 ,4 ,837 ,1513 ,0,3,1,3,0,1,0,76.14,55.32,33.33
03,001,01,001,0111,282,809 ,6 ,815 ,1524 ,0,3,1,3,0,1,0,76.14,53.48,33.33
03,001,01,001,0112,283,533 ,8 ,541 ,1012 ,0,3,1,3,0,1,0,76.14,53.46,33.33
03,001,01,001,0112,284,444 ,2 ,446 ,937 ,0,3,1,3,0,1,0,76.14,47.6,33.33
03,001,01,001,0112,285,623 ,2 ,625 ,1071 ,0,3,1,3,0,1,0,76.14,58.36,33.33
03,001,01,001,0113,286,732 ,5 ,737 ,1285 ,0,3,1,3,0,1,0,76.14,57.35,33.33
03,001,01,001,0113,287,784 ,10 ,794 ,1472 ,0,3,1,3,0,1,0,76.14,53.94,33.33
03,001,01,001,0114,288,610 ,5 ,615 ,1013 ,0,3,1,3,0,1,0,76.14,60.71,33.33
03,001,01,001,0115,289,581 ,3 ,584 ,1048 ,0,3,1,3,0,1,0,76.14,55.73,33.33
03,001,01,001,0115,290,465 ,8 ,473 ,899 ,0,3,1,3,0,1,0,76.14,52.61,33.33
03,001,01,001,0115,291,631 ,4 ,635 ,1144 ,0,3,1,3,0,1,0,76.14,55.51,33.33
03,001,01,001,0115,292,498 ,7 ,505 ,816 ,0,3,1,3,0,1,0,76.14,61.89,33.33
03,001,01,001,0116,293,730 ,36 ,766 ,1186 ,0,3,1,3,0,1,0,76.14,64.59,33.33
03,001,01,001,0116,294,325 ,2 ,327 ,594 ,0,3,1,3,0,1,0,76.14,55.05,33.33
03,001,01,001,0117,295,628 ,5 ,633 ,1150 ,0,3,1,3,0,1,0,76.14,55.04,33.33
03,001,01,001,0117,296,744 ,2 ,746 ,1184 ,0,3,1,3,0,1,0,76.14,63.01,33.33
03,001,01,001,0117,297,623 ,6 ,629 ,1104 ,0,3,1,3,0,1,0,76.14,56.97,33.33
03,001,01,001,0118,298,752 ,14 ,766 ,1140 ,0,3,1,3,0,1,0,76.14,67.19,33.33
03,001,01,001,0118,299,602 ,8 ,610 ,1096 ,0,3,1,3,0,1,0,76.14,55.66,33.33
03,001,01,001,0119,300,471 ,6 ,477 ,884 ,0,3,1,3,0,1,0,76.14,53.96,33.33
03,001,01,001,0119,301,577 ,7 ,584 ,986 ,0,3,1,3,0,1,0,76.14,59.23,33.33
03,001,01,001,0119,302,523 ,3 ,526 ,964 ,0,3,1,3,0,1,0,76.14,54.56,33.33
03,001,01,001,0119,303,675 ,9 ,684 ,1246 ,0,3,1,3,0,1,0,76.14,54.9,33.33
03,001,01,001,0120,304,679 ,4 ,683 ,1165 ,0,3,1,3,0,1,0,76.14,58.63,33.33
03,001,01,001,0120,305,714 ,17 ,731 ,1206 ,0,3,1,3,0,1,0,76.14,60.61,33.33
03,001,01,001,0121,306,856 ,8 ,864 ,1558 ,0,3,1,3,0,1,0,76.14,55.46,33.33
03,001,01,001,0121,307,753 ,4 ,757 ,1426 ,0,3,1,3,0,1,0,76.14,53.09,33.33
03,001,01,001,0121,308,776 ,9 ,785 ,1564 ,0,3,1,3,0,1,0,76.14,50.19,33.33
03,001,01,001,0121,309,752 ,8 ,760 ,1522 ,0,3,1,3,0,1,0,76.14,49.93,33.33
03,001,01,001,0122,310,630 ,4 ,634 ,1266 ,0,3,1,3,0,1,0,76.14,50.08,33.33
03,001,01,001,0122,311,651 ,7 ,658 ,1256 ,0,3,1,3,0,1,0,76.14,52.39,33.33
03,001,01,001,0122,312,531 ,2 ,533 ,1126 ,0,3,1,3,0,1,0,76.14,47.34,33.33
03,001,01,001,0123,313,720 ,5 ,725 ,1297 ,0,3,1,3,0,1,0,76.14,55.9,33.33
03,001,01,001,0123,314,863 ,9 ,872 ,1686 ,0,3,1,3,0,1,0,76.14,51.72,33.33
03,001,01,001,0123,315,716 ,7 ,723 ,1414 ,0,3,1,3,0,1,0,76.14,51.13,33.33
03,001,01,001,0124,316,768 ,7 ,775 ,1478 ,0,3,1,3,0,1,0,76.14,52.44,33.33
03,001,01,001,0124,317,678 ,3 ,681 ,1385 ,0,3,1,3,0,1,0,76.14,49.17,33.33
03,001,01,001,0124,318,622 ,4 ,626 ,1394 ,0,3,1,3,0,1,0,76.14,44.91,33.33
03,001,01,001,0124,319,728 ,5 ,733 ,1453 ,0,3,1,3,0,1,0,76.14,50.45,33.33
03,001,01,001,0124,320,650 ,7 ,657 ,1269 ,0,3,1,3,0,1,0,76.14,51.77,33.33
03,001,01,001,0124,321,674 ,6 ,680 ,1349 ,0,3,1,3,0,1,0,76.14,50.41,33.33
03,001,01,001,0125,322,721 ,6 ,727 ,1291 ,0,3,1,3,0,1,0,76.14,56.31,33.33
03,001,01,001,0125,323,765 ,11 ,776 ,1345 ,0,3,1,3,0,1,0,76.14,57.7,33.33
03,001,01,001,0126,324,730 ,10 ,740 ,1391 ,0,3,1,3,0,1,0,76.14,53.2,33.33
03,001,01,001,0126,325,917 ,5 ,922 ,1594 ,0,3,1,3,0,1,0,76.14,57.84,33.33
03,001,01,002,0127,326,728 ,8 ,736 ,1235 ,0,3,1,3,0,1,0,76.14,59.6,33.33
03,001,01,002,0128,327,359 ,0 ,359 ,623 ,0,3,1,3,0,1,0,76.14,57.62,33.33
03,001,01,002,0129,328,658 ,2 ,660 ,1163 ,0,3,1,3,0,1,0,76.14,56.75,33.33
03,001,01,002,0129,329,564 ,4 ,568 ,1010 ,0,3,1,3,0,1,0,76.14,56.24,33.33
03,001,01,002,0129,330,812 ,9 ,821 ,1295 ,0,3,1,3,0,1,0,76.14,63.4,33.33
03,001,01,002,0130,331,618 ,9 ,627 ,1135 ,0,3,1,3,0,1,0,76.14,55.24,33.33
03,001,01,002,0130,332,727 ,6 ,733 ,1348 ,0,3,1,3,0,1,0,76.14,54.38,33.33
03,001,01,002,0130,333,667 ,6 ,673 ,1193 ,0,3,1,3,0,1,0,76.14,56.41,33.33
03,001,01,002,0131,334,877 ,7 ,884 ,1612 ,0,3,1,3,0,1,0,76.14,54.84,33.33
03,001,01,002,0131,335,649 ,8 ,657 ,1259 ,0,3,1,3,0,1,0,76.14,52.18,33.33
03,001,01,002,0132,336,659 ,8 ,667 ,1359 ,0,3,1,3,0,1,0,76.14,49.08,33.33
03,001,01,002,0132,337,753 ,3 ,756 ,1431 ,0,3,1,3,0,1,0,76.14,52.83,33.33
03,001,01,002,0132,338,648 ,6 ,654 ,1247 ,0,3,1,3,0,1,0,76.14,52.45,33.33
03,001,01,002,0132,339,770 ,5 ,775 ,1395 ,0,3,1,3,0,1,0,76.14,55.56,33.33
03,001,01,002,0133,340,369 ,4 ,373 ,636 ,0,3,1,3,0,1,0,76.14,58.65,33.33
03,001,01,002,0133,341,890 ,5 ,895 ,1584 ,0,3,1,3,0,1,0,76.14,56.5,33.33
03,001,01,002,0133,342,693 ,8 ,701 ,1398 ,0,3,1,3,0,1,0,76.14,50.14,33.33
03,001,01,002,0134,343,788 ,9 ,797 ,1515 ,0,3,1,3,0,1,0,76.14,52.61,33.33
03,001,01,002,0134,344,619 ,4 ,623 ,1158 ,0,3,1,3,0,1,0,76.14,53.8,33.33
03,001,01,002,0134,345,761 ,4 ,765 ,1501 ,0,3,1,3,0,1,0,76.14,50.97,33.33
03,001,01,002,0135,346,858 ,5 ,863 ,2384 ,0,3,1,3,0,1,0,76.14,36.2,33.33
03,001,01,002,0135,347,477 ,5 ,482 ,871 ,0,3,1,3,0,1,0,76.14,55.34,33.33
03,001,01,002,0136,348,496 ,6 ,502 ,828 ,0,3,1,3,0,1,0,76.14,60.63,33.33
03,001,01,002,0136,349,449 ,4 ,453 ,813 ,0,3,1,3,0,1,0,76.14,55.72,33.33
03,001,01,002,0137,350,1078 ,7 ,1085 ,1565 ,0,3,1,3,0,1,0,76.14,69.33,33.33
03,001,01,002,0138,351,909 ,8 ,917 ,1742 ,0,3,1,3,0,1,0,76.14,52.64,33.33
03,001,01,002,0138,352,789 ,3 ,792 ,1464 ,0,3,1,3,0,1,0,76.14,54.1,33.33
03,001,01,002,0139,353,721 ,6 ,727 ,1295 ,0,3,1,3,0,1,0,76.14,56.14,33.33
03,001,01,002,0139,354,893 ,5 ,898 ,1586 ,0,3,1,3,0,1,0,76.14,56.62,33.33
03,001,01,002,0139,355,791 ,9 ,800 ,1412 ,0,3,1,3,0,1,0,76.14,56.66,33.33
03,001,01,002,0140,356,629 ,4 ,633 ,1072 ,0,3,1,3,0,1,0,76.14,59.05,33.33
03,001,01,002,0140,357,848 ,6 ,854 ,1521 ,0,3,1,3,0,1,0,76.14,56.15,33.33
03,001,01,002,0140,358,858 ,5 ,863 ,1553 ,0,3,1,3,0,1,0,76.14,55.57,33.33
03,001,01,002,0141,359,716 ,7 ,723 ,1284 ,0,3,1,3,0,1,0,76.14,56.31,33.33
03,001,01,002,0141,360,902 ,4 ,906 ,1587 ,0,3,1,3,0,1,0,76.14,57.09,33.33
03,001,01,002,0141,361,679 ,3 ,682 ,1272 ,0,3,1,3,0,1,0,76.14,53.62,33.33
03,001,01,002,0142,362,772 ,10 ,782 ,1407 ,0,3,1,3,0,1,0,76.14,55.58,33.33
03,001,01,002,0142,363,632 ,3 ,635 ,1172 ,0,3,1,3,0,1,0,76.14,54.18,33.33
03,001,01,002,0142,364,679 ,7 ,686 ,1162 ,0,3,1,3,0,1,0,76.14,59.04,33.33
03,001,01,002,0143,365,785 ,7 ,792 ,1408 ,0,3,1,3,0,1,0,76.14,56.25,33.33
03,001,01,002,0143,366,718 ,7 ,725 ,1467 ,0,3,1,3,0,1,0,76.14,49.42,33.33
03,001,01,002,0143,367,774 ,5 ,779 ,1556 ,0,3,1,3,0,1,0,76.14,50.06,33.33
03,001,01,002,0144,368,881 ,13 ,894 ,1540 ,0,3,1,3,0,1,0,76.14,58.05,33.33
03,001,01,002,0144,369,897 ,4 ,901 ,1613 ,0,3,1,3,0,1,0,76.14,55.86,33.33
03,001,01,002,0145,370,757 ,5 ,762 ,1336 ,0,3,1,3,0,1,0,76.14,57.04,33.33
03,001,01,002,0145,371,715 ,6 ,721 ,1267 ,0,3,1,3,0,1,0,76.14,56.91,33.33
03,001,01,002,0146,372,640 ,8 ,648 ,1254 ,0,3,1,3,0,1,0,76.14,51.67,33.33
03,001,01,002,0146,373,639 ,6 ,645 ,1193 ,0,3,1,3,0,1,0,76.14,54.07,33.33
03,001,01,002,0146,374,643 ,2 ,645 ,1115 ,0,3,1,3,0,1,0,76.14,57.85,33.33
03,001,01,002,0147,375,829 ,7 ,836 ,1386 ,0,3,1,3,0,1,0,76.14,60.32,33.33
03,001,01,002,0147,376,734 ,5 ,739 ,1268 ,0,3,1,3,0,1,0,76.14,58.28,33.33
03,001,01,002,0147,377,792 ,10 ,802 ,1409 ,0,3,1,3,0,1,0,76.14,56.92,33.33
03,001,01,002,0148,378,805 ,2 ,807 ,1380 ,0,3,1,3,0,1,0,76.14,58.48,33.33
03,001,01,002,0148,379,670 ,6 ,676 ,1160 ,0,3,1,3,0,1,0,76.14,58.28,33.33
03,001,01,002,0149,380,785 ,6 ,791 ,1411 ,0,3,1,3,0,1,0,76.14,56.06,33.33
03,001,01,002,0149,381,622 ,6 ,628 ,1174 ,0,3,1,3,0,1,0,76.14,53.49,33.33
03,001,01,002,0149,382,691 ,3 ,694 ,1133 ,0,3,1,3,0,1,0,76.14,61.25,33.33
03,001,01,002,0149,383,741 ,2 ,743 ,1258 ,0,3,1,3,0,1,0,76.14,59.06,33.33
03,001,01,002,0149,384,615 ,2 ,617 ,972 ,0,3,1,3,0,1,0,76.14,63.48,33.33
03,001,01,002,0150,385,517 ,4 ,521 ,1039 ,0,3,1,3,0,1,0,76.14,50.14,33.33
03,001,01,002,0150,386,822 ,3 ,825 ,1464 ,0,3,1,3,0,1,0,76.14,56.35,33.33
03,001,01,002,0151,387,717 ,10 ,727 ,1359 ,0,3,1,3,0,1,0,76.14,53.5,33.33
03,001,01,002,0151,388,772 ,6 ,778 ,1460 ,0,3,1,3,0,1,0,76.14,53.29,33.33
03,001,01,002,0151,389,680 ,4 ,684 ,1300 ,0,3,1,3,0,1,0,76.14,52.62,33.33
03,001,01,002,0152,390,837 ,5 ,842 ,1550 ,0,3,1,3,0,1,0,76.14,54.32,33.33
03,001,01,002,0152,391,606 ,5 ,611 ,1164 ,0,3,1,3,0,1,0,76.14,52.49,33.33
03,001,01,002,0153,392,575 ,3 ,578 ,1049 ,0,3,1,3,0,1,0,76.14,55.1,33.33
03,001,01,002,0153,393,550 ,2 ,552 ,1106 ,0,3,1,3,0,1,0,76.14,49.91,33.33
03,001,01,002,0153,394,651 ,3 ,654 ,1181 ,0,3,1,3,0,1,0,76.14,55.38,33.33
03,001,01,002,0154,395,1003 ,7 ,1010 ,1751 ,0,3,1,3,0,1,0,76.14,57.68,33.33
03,001,01,002,0154,396,891 ,7 ,898 ,1584 ,0,3,1,3,0,1,0,76.14,56.69,33.33
03,001,01,002,0155,397,1006 ,13 ,1019 ,1858 ,0,3,1,3,0,1,0,76.14,54.84,33.33
03,001,01,002,0155,398,302 ,1 ,303 ,525 ,0,3,1,3,0,1,0,76.14,57.71,33.33
03,001,01,002,0156,399,609 ,4 ,613 ,1101 ,0,3,1,3,0,1,0,76.14,55.68,33.33
03,001,01,002,0156,400,675 ,4 ,679 ,1141 ,0,3,1,3,0,1,0,76.14,59.51,33.33
03,001,01,002,0157,401,702 ,5 ,707 ,1264 ,0,3,1,3,0,1,0,76.14,55.93,33.33
03,001,01,002,0157,402,563 ,5 ,568 ,948 ,0,3,1,3,0,1,0,76.14,59.92,33.33
03,001,01,002,0158,403,822 ,6 ,828 ,1479 ,0,3,1,3,0,1,0,76.14,55.98,33.33
03,001,01,002,0158,404,865 ,8 ,873 ,1772 ,0,3,1,3,0,1,0,76.14,49.27,33.33
03,001,01,002,0158,405,842 ,5 ,847 ,1587 ,0,3,1,3,0,1,0,76.14,53.37,33.33
03,001,01,002,0159,406,739 ,11 ,750 ,1321 ,0,3,1,3,0,1,0,76.14,56.78,33.33
03,001,01,002,0160,407,635 ,4 ,639 ,1137 ,0,3,1,3,0,1,0,76.14,56.2,33.33
03,001,01,002,0160,408,628 ,6 ,634 ,1106 ,0,3,1,3,0,1,0,76.14,57.32,33.33
03,001,01,002,0160,409,808 ,5 ,813 ,1514 ,0,3,1,3,0,1,0,76.14,53.7,33.33
03,001,01,002,0160,410,805 ,4 ,809 ,1481 ,0,3,1,3,0,1,0,76.14,54.63,33.33
03,001,01,002,0161,411,659 ,3 ,662 ,1179 ,0,3,1,3,0,1,0,76.14,56.15,33.33
03,001,01,002,0161,412,669 ,4 ,673 ,1207 ,0,3,1,3,0,1,0,76.14,55.76,33.33
03,001,01,002,0162,413,732 ,6 ,738 ,1347 ,0,3,1,3,0,1,0,76.14,54.79,33.33
03,001,01,002,0162,414,763 ,3 ,766 ,1425 ,0,3,1,3,0,1,0,76.14,53.75,33.33
03,001,01,002,0162,415,749 ,2 ,751 ,1386 ,0,3,1,3,0,1,0,76.14,54.18,33.33
03,001,01,002,0162,416,776 ,9 ,785 ,1443 ,0,3,1,3,0,1,0,76.14,54.4,33.33
03,001,01,002,0163,417,691 ,8 ,699 ,1243 ,0,3,1,3,0,1,0,76.14,56.23,33.33
03,001,01,002,0163,418,593 ,10 ,603 ,1175 ,0,3,1,3,0,1,0,76.14,51.32,33.33
03,001,01,002,0164,419,567 ,4 ,571 ,1176 ,0,3,1,3,0,1,0,76.14,48.55,33.33
03,001,01,002,0164,420,713 ,8 ,721 ,1395 ,0,3,1,3,0,1,0,76.14,51.68,33.33
03,001,01,002,0164,421,714 ,5 ,719 ,1411 ,0,3,1,3,0,1,0,76.14,50.96,33.33
03,001,01,002,0165,422,638 ,5 ,643 ,1171 ,0,3,1,3,0,1,0,76.14,54.91,33.33
03,001,01,002,0165,423,576 ,3 ,579 ,997 ,0,3,1,3,0,1,0,76.14,58.07,33.33
03,001,01,002,0165,424,631 ,7 ,638 ,1208 ,0,3,1,3,0,1,0,76.14,52.81,33.33
03,001,01,002,0166,425,778 ,2 ,780 ,1523 ,0,3,1,3,0,1,0,76.14,51.21,33.33
03,001,01,002,0166,426,618 ,4 ,622 ,1119 ,0,3,1,3,0,1,0,76.14,55.59,33.33
03,001,01,002,0166,427,833 ,4 ,837 ,1509 ,0,3,1,3,0,1,0,76.14,55.47,33.33
03,001,01,002,0167,428,621 ,4 ,625 ,1157 ,0,3,1,3,0,1,0,76.14,54.02,33.33
03,001,01,002,0167,429,713 ,8 ,721 ,1384 ,0,3,1,3,0,1,0,76.14,52.1,33.33
03,001,01,002,0167,430,663 ,4 ,667 ,1373 ,0,3,1,3,0,1,0,76.14,48.58,33.33
03,001,01,002,0167,431,800 ,2 ,802 ,1598 ,0,3,1,3,0,1,0,76.14,50.19,33.33
03,001,01,002,0168,432,783 ,3 ,786 ,1377 ,0,3,1,3,0,1,0,76.14,57.08,33.33
03,001,01,002,0168,433,590 ,5 ,595 ,1084 ,0,3,1,3,0,1,0,76.14,54.89,33.33
03,001,01,002,0168,434,495 ,2 ,497 ,1001 ,0,3,1,3,0,1,0,76.14,49.65,33.33
03,001,01,002,0169,435,511 ,2 ,513 ,1040 ,0,3,1,3,0,1,0,76.14,49.33,33.33
03,001,01,002,0169,436,806 ,6 ,812 ,1396 ,0,3,1,3,0,1,0,76.14,58.17,33.33
03,001,01,002,0169,437,516 ,3 ,519 ,992 ,0,3,1,3,0,1,0,76.14,52.32,33.33
03,001,01,002,0170,438,461 ,5 ,466 ,884 ,0,3,1,3,0,1,0,76.14,52.71,33.33
03,001,01,002,0170,439,617 ,3 ,620 ,1130 ,0,3,1,3,0,1,0,76.14,54.87,33.33
03,001,01,002,0170,440,657 ,5 ,662 ,1215 ,0,3,1,3,0,1,0,76.14,54.49,33.33
03,001,01,002,0171,441,752 ,8 ,760 ,1332 ,0,3,1,3,0,1,0,76.14,57.06,33.33
03,001,01,002,0171,442,780 ,7 ,787 ,1468 ,0,3,1,3,0,1,0,76.14,53.61,33.33
03,001,01,002,0171,443,572 ,6 ,578 ,1063 ,0,3,1,3,0,1,0,76.14,54.37,33.33
03,001,01,002,0171,444,694 ,5 ,699 ,1305 ,0,3,1,3,0,1,0,76.14,53.56,33.33
03,001,01,002,0172,445,653 ,8 ,661 ,1232 ,0,3,1,3,0,1,0,76.14,53.65,33.33
03,001,01,002,0172,446,646 ,6 ,652 ,1247 ,0,3,1,3,0,1,0,76.14,52.29,33.33
03,001,01,002,0172,447,686 ,7 ,693 ,1300 ,0,3,1,3,0,1,0,76.14,53.31,33.33
03,001,01,002,0173,448,716 ,5 ,721 ,1375 ,0,3,1,3,0,1,0,76.14,52.44,33.33
03,001,01,002,0173,449,760 ,12 ,772 ,1525 ,0,3,1,3,0,1,0,76.14,50.62,33.33
03,001,01,002,0173,450,797 ,5 ,802 ,1676 ,0,3,1,3,0,1,0,76.14,47.85,33.33
03,001,01,003,0174,451,549 ,12 ,561 ,1099 ,0,3,1,3,0,1,0,76.14,51.05,33.33
03,001,01,003,0174,452,572 ,4 ,576 ,1099 ,0,3,1,3,0,1,0,76.14,52.41,33.33
03,001,01,003,0174,453,660 ,7 ,667 ,1348 ,0,3,1,3,0,1,0,76.14,49.48,33.33
03,001,01,003,0175,454,588 ,7 ,595 ,1084 ,0,3,1,3,0,1,0,76.14,54.89,33.33
03,001,01,003,0175,455,618 ,4 ,622 ,1116 ,0,3,1,3,0,1,0,76.14,55.73,33.33
03,001,01,003,0175,456,565 ,5 ,570 ,1057 ,0,3,1,3,0,1,0,76.14,53.93,33.33
03,001,01,003,0176,457,718 ,6 ,724 ,1417 ,0,3,1,3,0,1,0,76.14,51.09,33.33
03,001,01,003,0176,458,858 ,12 ,870 ,1531 ,0,3,1,3,0,1,0,76.14,56.83,33.33
03,001,01,003,0177,459,821 ,8 ,829 ,1496 ,0,3,1,3,0,1,0,76.14,55.41,33.33
03,001,01,003,0178,460,609 ,6 ,615 ,1141 ,0,3,1,3,0,1,0,76.14,53.9,33.33
03,001,01,003,0178,461,634 ,6 ,640 ,1267 ,0,3,1,3,0,1,0,76.14,50.51,33.33
03,001,01,003,0178,462,501 ,1 ,502 ,1086 ,0,3,1,3,0,1,0,76.14,46.22,33.33
03,001,01,003,0179,463,672 ,12 ,684 ,1379 ,0,3,1,3,0,1,0,76.14,49.6,33.33
03,001,01,003,0179,464,659 ,2 ,661 ,1378 ,0,3,1,3,0,1,0,76.14,47.97,33.33
03,001,01,003,0180,465,871 ,9 ,880 ,1569 ,0,3,1,3,0,1,0,76.14,56.09,33.33
03,001,01,003,0180,466,635 ,9 ,644 ,1378 ,0,3,1,3,0,1,0,76.14,46.73,33.33
03,001,01,003,0181,467,571 ,1 ,572 ,1327 ,0,3,1,3,0,1,0,76.14,43.1,33.33
03,001,01,003,0181,468,472 ,6 ,478 ,866 ,0,3,1,3,0,1,0,76.14,55.2,33.33
03,001,01,003,0181,469,723 ,6 ,729 ,1361 ,0,3,1,3,0,1,0,76.14,53.56,33.33
03,001,01,003,0182,470,819 ,8 ,827 ,1504 ,0,3,1,3,0,1,0,76.14,54.99,33.33
03,001,01,003,0182,471,562 ,5 ,567 ,1164 ,0,3,1,3,0,1,0,76.14,48.71,33.33
03,001,01,003,0182,472,490 ,6 ,496 ,1057 ,0,3,1,3,0,1,0,76.14,46.93,33.33
03,001,01,003,0183,473,739 ,8 ,747 ,1361 ,0,3,1,3,0,1,0,76.14,54.89,33.33
03,001,01,003,0183,474,776 ,2 ,778 ,1327 ,0,3,1,3,0,1,0,76.14,58.63,33.33
03,001,01,003,0183,475,662 ,11 ,673 ,1159 ,0,3,1,3,0,1,0,76.14,58.07,33.33
03,001,01,003,0183,476,583 ,3 ,586 ,1063 ,0,3,1,3,0,1,0,76.14,55.13,33.33
03,001,01,003,0184,477,561 ,4 ,565 ,1020 ,0,3,1,3,0,1,0,76.14,55.39,33.33
03,001,01,003,0184,478,667 ,5 ,672 ,1515 ,0,3,1,3,0,1,0,76.14,44.36,33.33
03,001,01,003,0185,479,545 ,5 ,550 ,1082 ,0,3,1,3,0,1,0,76.14,50.83,33.33
03,001,01,003,0185,480,558 ,2 ,560 ,974 ,0,3,1,3,0,1,0,76.14,57.49,33.33
03,001,01,003,0185,481,508 ,5 ,513 ,932 ,0,3,1,3,0,1,0,76.14,55.04,33.33
03,001,01,003,0186,482,487 ,6 ,493 ,936 ,0,3,1,3,0,1,0,76.14,52.67,33.33
03,001,01,003,0186,483,491 ,2 ,493 ,1007 ,0,3,1,3,0,1,0,76.14,48.96,33.33
03,001,01,003,0187,484,720 ,4 ,724 ,1275 ,0,3,1,3,0,1,0,76.14,56.78,33.33
03,001,01,003,0188,485,777 ,0 ,777 ,1421 ,0,3,1,3,0,1,0,76.14,54.68,33.33
03,001,01,003,0188,486,923 ,7 ,930 ,1520 ,0,3,1,3,0,1,0,76.14,61.18,33.33
03,001,01,003,0189,487,663 ,10 ,673 ,1130 ,0,3,1,3,0,1,0,76.14,59.56,33.33
03,001,01,003,0189,488,432 ,2 ,434 ,762 ,0,3,1,3,0,1,0,76.14,56.96,33.33
03,001,01,003,0190,489,613 ,3 ,616 ,1049 ,0,3,1,3,0,1,0,76.14,58.72,33.33
03,001,01,003,0190,490,818 ,14 ,832 ,1435 ,0,3,1,3,0,1,0,76.14,57.98,33.33
03,001,01,003,0190,491,943 ,8 ,951 ,1593 ,0,3,1,3,0,1,0,76.14,59.7,33.33
03,001,01,003,0191,492,752 ,7 ,759 ,1460 ,0,3,1,3,0,1,0,76.14,51.99,33.33
03,001,01,003,0191,493,770 ,6 ,776 ,1414 ,0,3,1,3,0,1,0,76.14,54.88,33.33
03,001,01,003,0192,494,710 ,9 ,719 ,1248 ,0,3,1,3,0,1,0,76.14,57.61,33.33
03,001,01,003,0192,495,734 ,7 ,741 ,1246 ,0,3,1,3,0,1,0,76.14,59.47,33.33
03,001,01,003,0193,496,645 ,2 ,647 ,1179 ,0,3,1,3,0,1,0,76.14,54.88,33.33
03,001,01,003,0193,497,728 ,3 ,731 ,1203 ,0,3,1,3,0,1,0,76.14,60.76,33.33
03,001,01,003,0194,498,949 ,14 ,963 ,1665 ,0,3,1,3,0,1,0,76.14,57.84,33.33
03,001,01,003,0194,499,879 ,6 ,885 ,1555 ,0,3,1,3,0,1,0,76.14,56.91,33.33
03,001,01,003,0195,500,676 ,6 ,682 ,1285 ,0,3,1,3,0,1,0,76.14,53.07,33.33
03,001,01,003,0196,501,645 ,6 ,651 ,1064 ,0,3,1,3,0,1,0,76.14,61.18,33.33
03,001,01,003,0197,502,639 ,2 ,641 ,990 ,0,3,1,3,0,1,0,76.14,64.75,33.33
03,001,01,003,0198,503,638 ,6 ,644 ,1310 ,0,3,1,3,0,1,0,76.14,49.16,33.33
03,001,01,003,0198,504,576 ,8 ,584 ,1164 ,0,3,1,3,0,1,0,76.14,50.17,33.33
03,001,01,003,0198,505,620 ,1 ,621 ,1205 ,0,3,1,3,0,1,0,76.14,51.54,33.33
03,001,01,003,0199,506,914 ,14 ,928 ,1615 ,0,3,1,3,0,1,0,76.14,57.46,33.33
03,001,01,003,0199,507,788 ,7 ,795 ,1492 ,0,3,1,3,0,1,0,76.14,53.28,33.33
03,001,01,003,0200,508,663 ,1 ,664 ,1389 ,0,3,1,3,0,1,0,76.14,47.8,33.33
03,001,01,003,0200,509,637 ,8 ,645 ,1381 ,0,3,1,3,0,1,0,76.14,46.71,33.33
03,001,01,003,0200,510,673 ,5 ,678 ,1368 ,0,3,1,3,0,1,0,76.14,49.56,33.33
03,001,01,003,0201,511,621 ,2 ,623 ,1161 ,0,3,1,3,0,1,0,76.14,53.66,33.33
03,001,01,003,0201,512,641 ,6 ,647 ,1276 ,0,3,1,3,0,1,0,76.14,50.71,33.33
03,001,01,003,0201,513,523 ,3 ,526 ,1002 ,0,3,1,3,0,1,0,76.14,52.5,33.33
03,001,01,003,0202,514,755 ,5 ,760 ,1296 ,0,3,1,3,0,1,0,76.14,58.64,33.33
03,001,01,003,0202,515,505 ,6 ,511 ,1023 ,0,3,1,3,0,1,0,76.14,49.95,33.33
03,001,01,003,0203,516,612 ,5 ,617 ,1149 ,0,3,1,3,0,1,0,76.14,53.7,33.33
03,001,01,003,0203,517,493 ,4 ,497 ,1027 ,0,3,1,3,0,1,0,76.14,48.39,33.33
03,001,01,003,0204,518,469 ,2 ,471 ,993 ,0,3,1,3,0,1,0,76.14,47.43,33.33
03,001,01,003,0204,519,496 ,4 ,500 ,1041 ,0,3,1,3,0,1,0,76.14,48.03,33.33
03,001,01,003,0205,520,532 ,5 ,537 ,954 ,0,3,1,3,0,1,0,76.14,56.29,33.33
03,001,01,003,0205,521,625 ,3 ,628 ,1176 ,0,3,1,3,0,1,0,76.14,53.4,33.33
03,001,01,003,0205,522,489 ,2 ,491 ,839 ,0,3,1,3,0,1,0,76.14,58.52,33.33
03,001,01,003,0206,523,782 ,5 ,787 ,1472 ,0,3,1,3,0,1,0,76.14,53.46,33.33
03,001,01,003,0206,524,728 ,7 ,735 ,1414 ,0,3,1,3,0,1,0,76.14,51.98,33.33
03,001,01,003,0206,525,605 ,7 ,612 ,1205 ,0,3,1,3,0,1,0,76.14,50.79,33.33
03,001,01,003,0207,526,874 ,7 ,881 ,1534 ,0,3,1,3,0,1,0,76.14,57.43,33.33
03,001,01,003,0207,527,587 ,8 ,595 ,1086 ,0,3,1,3,0,1,0,76.14,54.79,33.33
03,001,01,003,0208,528,506 ,5 ,511 ,982 ,0,3,1,3,0,1,0,76.14,52.04,33.33
03,001,01,003,0208,529,605 ,5 ,610 ,1176 ,0,3,1,3,0,1,0,76.14,51.87,33.33
03,001,01,003,0208,530,444 ,4 ,448 ,822 ,0,3,1,3,0,1,0,76.14,54.5,33.33
03,001,01,003,0209,531,795 ,4 ,799 ,1456 ,0,3,1,3,0,1,0,76.14,54.88,33.33
03,001,01,003,0209,532,811 ,13 ,824 ,1488 ,0,3,1,3,0,1,0,76.14,55.38,33.33
03,001,01,003,0210,533,707 ,5 ,712 ,1335 ,0,3,1,3,0,1,0,76.14,53.33,33.33
03,001,01,003,0211,534,752 ,12 ,764 ,1268 ,0,3,1,3,0,1,0,76.14,60.25,33.33
03,001,01,003,0212,535,707 ,7 ,714 ,1338 ,0,3,1,3,0,1,0,76.14,53.36,33.33
03,001,01,003,0213,536,414 ,4 ,418 ,647 ,0,3,1,3,0,1,0,76.14,64.61,33.33
03,001,01,003,0214,537,764 ,10 ,774 ,1328 ,0,3,1,3,0,1,0,76.14,58.28,33.33
03,001,01,003,0215,538,911 ,8 ,919 ,1591 ,0,3,1,3,0,1,0,76.14,57.76,33.33
03,001,01,004,0216,539,258 ,1 ,259 ,448 ,0,3,1,3,0,1,0,76.14,57.81,33.33
03,001,01,004,0217,540,529 ,5 ,534 ,892 ,0,3,1,3,0,1,0,76.14,59.87,33.33
03,001,01,004,0218,541,794 ,15 ,809 ,1439 ,0,3,1,3,0,1,0,76.14,56.22,33.33
03,001,01,004,0219,542,640 ,5 ,645 ,978 ,0,3,1,3,0,1,0,76.14,65.95,33.33
03,001,01,004,0219,543,485 ,11 ,496 ,848 ,0,3,1,3,0,1,0,76.14,58.49,33.33
03,001,01,004,0220,544,527 ,4 ,531 ,845 ,0,3,1,3,0,1,0,76.14,62.84,33.33
03,001,01,004,0221,545,872 ,3 ,875 ,1451 ,0,3,1,3,0,1,0,76.14,60.3,33.33
03,001,01,004,0221,546,778 ,3 ,781 ,1353 ,0,3,1,3,0,1,0,76.14,57.72,33.33
03,001,01,004,0221,547,754 ,5 ,759 ,1334 ,0,3,1,3,0,1,0,76.14,56.9,33.33
03,001,01,004,0222,548,812 ,9 ,821 ,1486 ,0,3,1,3,0,1,0,76.14,55.25,33.33
03,001,01,004,0222,549,763 ,5 ,768 ,1471 ,0,3,1,3,0,1,0,76.14,52.21,33.33
03,001,01,004,0222,550,678 ,3 ,681 ,1347 ,0,3,1,3,0,1,0,76.14,50.56,33.33
03,001,01,004,0223,551,493 ,4 ,497 ,762 ,0,3,1,3,0,1,0,76.14,65.22,33.33
03,001,01,004,0224,552,826 ,12 ,838 ,1782 ,0,3,1,3,0,1,0,76.14,47.03,33.33
03,001,01,004,0224,553,930 ,10 ,940 ,1587 ,0,3,1,3,0,1,0,76.14,59.23,33.33
03,001,01,004,0224,554,1020 ,12 ,1032 ,1692 ,0,3,1,3,0,1,0,76.14,60.99,33.33
03,001,01,004,0225,555,753 ,5 ,758 ,1315 ,0,3,1,3,0,1,0,76.14,57.64,33.33
03,001,01,004,0225,556,815 ,3 ,818 ,1471 ,0,3,1,3,0,1,0,76.14,55.61,33.33
03,001,01,004,0225,557,811 ,10 ,821 ,1611 ,0,3,1,3,0,1,0,76.14,50.96,33.33
03,001,01,004,0226,558,677 ,4 ,681 ,1132 ,0,3,1,3,0,1,0,76.14,60.16,33.33
03,001,01,004,0226,559,489 ,2 ,491 ,805 ,0,3,1,3,0,1,0,76.14,60.99,33.33
03,001,01,004,0226,560,398 ,6 ,404 ,715 ,0,3,1,3,0,1,0,76.14,56.5,33.33
03,001,01,004,0227,561,807 ,4 ,811 ,1352 ,0,3,1,3,0,1,0,76.14,59.99,33.33
03,001,01,004,0228,562,649 ,6 ,655 ,1324 ,0,3,1,3,0,1,0,76.14,49.47,33.33
03,001,01,004,0228,563,775 ,7 ,782 ,1407 ,0,3,1,3,0,1,0,76.14,55.58,33.33
03,001,01,004,0228,564,745 ,6 ,751 ,1405 ,0,3,1,3,0,1,0,76.14,53.45,33.33
03,001,01,004,0228,565,688 ,4 ,692 ,1204 ,0,3,1,3,0,1,0,76.14,57.48,33.33
03,001,01,004,0228,566,474 ,5 ,479 ,832 ,0,3,1,3,0,1,0,76.14,57.57,33.33
03,001,01,004,0229,567,741 ,5 ,746 ,1366 ,0,3,1,3,0,1,0,76.14,54.61,33.33
03,001,01,004,0229,568,723 ,3 ,726 ,1249 ,0,3,1,3,0,1,0,76.14,58.13,33.33
03,001,01,004,0229,569,599 ,4 ,603 ,1055 ,0,3,1,3,0,1,0,76.14,57.16,33.33
03,001,01,004,0230,570,726 ,14 ,740 ,1307 ,0,3,1,3,0,1,0,76.14,56.62,33.33
03,001,01,004,0230,571,535 ,3 ,538 ,1132 ,0,3,1,3,0,1,0,76.14,47.53,33.33
03,001,01,004,0230,572,496 ,4 ,500 ,1043 ,0,3,1,3,0,1,0,76.14,47.94,33.33
03,001,01,004,0231,573,593 ,9 ,602 ,1202 ,0,3,1,3,0,1,0,76.14,50.08,33.33
03,001,01,004,0231,574,687 ,15 ,702 ,1257 ,0,3,1,3,0,1,0,76.14,55.85,33.33
03,001,01,004,0231,575,658 ,4 ,662 ,1080 ,0,3,1,3,0,1,0,76.14,61.3,33.33
03,001,01,004,0232,576,657 ,6 ,663 ,1088 ,0,3,1,3,0,1,0,76.14,60.94,33.33
03,001,01,004,0232,577,562 ,5 ,567 ,1078 ,0,3,1,3,0,1,0,76.14,52.6,33.33
03,001,01,004,0232,578,700 ,4 ,704 ,1320 ,0,3,1,3,0,1,0,76.14,53.33,33.33
03,001,01,004,0233,579,731 ,3 ,734 ,1316 ,0,3,1,3,0,1,0,76.14,55.78,33.33
03,001,01,004,0233,580,899 ,5 ,904 ,1515 ,0,3,1,3,0,1,0,76.14,59.67,33.33
03,001,01,004,0233,581,742 ,7 ,749 ,1232 ,0,3,1,3,0,1,0,76.14,60.8,33.33
03,001,01,004,0234,582,809 ,7 ,816 ,1664 ,0,3,1,3,0,1,0,76.14,49.04,33.33
03,001,01,004,0234,583,706 ,9 ,715 ,1262 ,0,3,1,3,0,1,0,76.14,56.66,33.33
03,001,01,004,0234,584,823 ,8 ,831 ,1432 ,0,3,1,3,0,1,0,76.14,58.03,33.33
03,001,01,004,0235,585,140 ,1 ,141 ,205 ,0,3,1,3,0,1,0,76.14,68.78,33.33
03,001,01,005,0236,586,195 ,4 ,199 ,317 ,0,3,1,3,0,1,0,76.14,62.78,33.33
03,001,01,005,0237,587,237 ,4 ,241 ,402 ,0,3,1,3,0,1,0,76.14,59.95,33.33
03,001,01,005,0238,588,737 ,6 ,743 ,1276 ,0,3,1,3,0,1,0,76.14,58.23,33.33
03,001,01,005,0238,589,706 ,6 ,712 ,1300 ,0,3,1,3,0,1,0,76.14,54.77,33.33
03,001,01,005,0239,590,818 ,6 ,824 ,1478 ,0,3,1,3,0,1,0,76.14,55.75,33.33
03,001,01,005,0240,591,495 ,7 ,502 ,926 ,0,3,1,3,0,1,0,76.14,54.21,33.33
03,001,01,005,0241,592,674 ,2 ,676 ,1254 ,0,3,1,3,0,1,0,76.14,53.91,33.33
03,001,01,005,0241,593,717 ,9 ,726 ,1233 ,0,3,1,3,0,1,0,76.14,58.88,33.33
03,001,01,005,0241,594,616 ,2 ,618 ,1126 ,0,3,1,3,0,1,0,76.14,54.88,33.33
03,001,01,005,0241,595,732 ,2 ,734 ,1410 ,0,3,1,3,0,1,0,76.14,52.06,33.33
03,001,01,005,0242,596,598 ,7 ,605 ,1099 ,0,3,1,3,0,1,0,76.14,55.05,33.33
03,001,01,005,0242,597,508 ,4 ,512 ,1037 ,0,3,1,3,0,1,0,76.14,49.37,33.33
03,001,01,005,0242,598,572 ,6 ,578 ,1049 ,0,3,1,3,0,1,0,76.14,55.1,33.33
03,001,01,005,0242,599,567 ,2 ,569 ,1149 ,0,3,1,3,0,1,0,76.14,49.52,33.33
03,001,01,005,0242,600,654 ,4 ,658 ,1398 ,0,3,1,3,0,1,0,76.14,47.07,33.33
03,001,01,005,0243,601,745 ,6 ,751 ,1372 ,0,3,1,3,0,1,0,76.14,54.74,33.33
03,001,01,005,0243,602,786 ,5 ,791 ,1425 ,0,3,1,3,0,1,0,76.14,55.51,33.33
03,001,01,005,0243,603,627 ,7 ,634 ,1218 ,0,3,1,3,0,1,0,76.14,52.05,33.33
03,001,01,005,0243,604,766 ,5 ,771 ,1444 ,0,3,1,3,0,1,0,76.14,53.39,33.33
03,001,01,005,0244,605,632 ,2 ,634 ,1086 ,0,3,1,3,0,1,0,76.14,58.38,33.33
03,001,01,005,0244,606,504 ,1 ,505 ,916 ,0,3,1,3,0,1,0,76.14,55.13,33.33
03,001,01,005,0244,607,567 ,2 ,569 ,1140 ,0,3,1,3,0,1,0,76.14,49.91,33.33
03,001,01,005,0245,608,711 ,2 ,713 ,1284 ,0,3,1,3,0,1,0,76.14,55.53,33.33
03,001,01,005,0245,609,691 ,4 ,695 ,1439 ,0,3,1,3,0,1,0,76.14,48.3,33.33
03,001,01,005,0245,610,709 ,4 ,713 ,1297 ,0,3,1,3,0,1,0,76.14,54.97,33.33
03,001,01,005,0245,611,607 ,1 ,608 ,1099 ,0,3,1,3,0,1,0,76.14,55.32,33.33
03,001,01,005,0246,612,669 ,7 ,676 ,1353 ,0,3,1,3,0,1,0,76.14,49.96,33.33
03,001,01,005,0246,613,651 ,2 ,653 ,1219 ,0,3,1,3,0,1,0,76.14,53.57,33.33
03,001,01,005,0246,614,611 ,5 ,616 ,1250 ,0,3,1,3,0,1,0,76.14,49.28,33.33
03,001,01,005,0247,615,603 ,9 ,612 ,1214 ,0,3,1,3,0,1,0,76.14,50.41,33.33
03,001,01,005,0247,616,626 ,4 ,630 ,1160 ,0,3,1,3,0,1,0,76.14,54.31,33.33
03,001,01,005,0247,617,645 ,3 ,648 ,1136 ,0,3,1,3,0,1,0,76.14,57.04,33.33
03,001,01,005,0248,618,656 ,7 ,663 ,1244 ,0,3,1,3,0,1,0,76.14,53.3,33.33
03,001,01,005,0248,619,561 ,2 ,563 ,1008 ,0,3,1,3,0,1,0,76.14,55.85,33.33
03,001,01,005,0248,620,587 ,4 ,591 ,933 ,0,3,1,3,0,1,0,76.14,63.34,33.33
03,001,01,005,0249,621,690 ,9 ,699 ,1176 ,0,3,1,3,0,1,0,76.14,59.44,33.33
03,001,01,005,0249,622,769 ,15 ,784 ,1335 ,0,3,1,3,0,1,0,76.14,58.73,33.33
03,001,01,005,0250,623,555 ,2 ,557 ,940 ,0,3,1,3,0,1,0,76.14,59.26,33.33
03,001,01,005,0251,624,262 ,4 ,266 ,466 ,0,3,1,3,0,1,0,76.14,57.08,33.33
03,001,01,005,0252,625,549 ,4 ,553 ,873 ,0,3,1,3,0,1,0,76.14,63.34,33.33
03,001,01,005,0253,626,445 ,3 ,448 ,796 ,0,3,1,3,0,1,0,76.14,56.28,33.33
03,001,01,005,0254,627,439 ,2 ,441 ,783 ,0,3,1,3,0,1,0,76.14,56.32,33.33
03,001,01,005,0255,628,579 ,6 ,585 ,1147 ,0,3,1,3,0,1,0,76.14,51,33.33
03,001,01,005,0255,629,659 ,3 ,662 ,1249 ,0,3,1,3,0,1,0,76.14,53,33.33
03,001,01,005,0256,630,733 ,4 ,737 ,1246 ,0,3,1,3,0,1,0,76.14,59.15,33.33
03,001,01,005,0257,631,354 ,1 ,355 ,614 ,0,3,1,3,0,1,0,76.14,57.82,33.33
03,001,01,005,0257,632,774 ,3 ,777 ,1227 ,0,3,1,3,0,1,0,76.14,63.33,33.33
03,001,01,005,0258,633,565 ,10 ,575 ,1036 ,0,3,1,3,0,1,0,76.14,55.5,33.33
03,001,01,005,0258,634,661 ,8 ,669 ,1275 ,0,3,1,3,0,1,0,76.14,52.47,33.33
03,001,01,005,0259,635,544 ,4 ,548 ,842 ,0,3,1,3,0,1,0,76.14,65.08,33.33
03,001,01,005,0260,636,484 ,4 ,488 ,852 ,0,3,1,3,0,1,0,76.14,57.28,33.33
03,001,01,005,0260,637,483 ,8 ,491 ,880 ,0,3,1,3,0,1,0,76.14,55.8,33.33
03,001,01,005,0261,638,691 ,10 ,701 ,1273 ,0,3,1,3,0,1,0,76.14,55.07,33.33
03,001,02,006,0262,639,704 ,5 ,709 ,1261 ,0,3,1,3,0,1,0,76.14,56.23 ,33.33
03,001,02,006,0262,640,606 ,6 ,612 ,1157 ,0,3,1,3,0,1,0,76.14,52.90 ,33.33
03,001,02,006,0262,641,657 ,6 ,663 ,1154 ,0,3,1,3,0,1,0,76.14,57.45 ,33.33
03,001,02,006,0263,642,772 ,5 ,777 ,1270 ,0,3,1,3,0,1,0,76.14,61.18 ,33.33
03,001,02,006,0263,643,853 ,9 ,862 ,1358 ,0,3,1,3,0,1,0,76.14,63.48 ,33.33
03,001,02,006,0263,644,643 ,2 ,645 ,1034 ,0,3,1,3,0,1,0,76.14,62.38 ,33.33
03,001,02,006,0264,645,482 ,1 ,483 ,903 ,0,3,1,3,0,1,0,76.14,53.49 ,33.33
03,001,02,006,0264,646,440 ,0 ,440 ,819 ,0,3,1,3,0,1,0,76.14,53.72 ,33.33
03,001,02,006,0265,647,530 ,7 ,537 ,919 ,0,3,1,3,0,1,0,76.14,58.43 ,33.33
03,001,02,006,0265,648,506 ,6 ,512 ,853 ,0,3,1,3,0,1,0,76.14,60.02 ,33.33
03,001,02,006,0266,649,725 ,2 ,727 ,1098 ,0,3,1,3,0,1,0,76.14,66.21 ,33.33
03,001,02,006,0267,650,716 ,9 ,725 ,1161 ,0,3,1,3,0,1,0,76.14,62.45 ,33.33
03,001,02,006,0267,651,393 ,1 ,394 ,664 ,0,3,1,3,0,1,0,76.14,59.34 ,33.33
03,001,02,006,0268,652,1001 ,16 ,1017 ,1641 ,0,3,1,3,0,1,0,76.14,61.97 ,33.33
03,001,02,006,0268,653,855 ,9 ,864 ,1390 ,0,3,1,3,0,1,0,76.14,62.16 ,33.33
03,001,02,006,0269,654,234 ,6 ,240 ,376 ,0,3,1,3,0,1,0,76.14,63.83 ,33.33
03,001,02,006,0270,655,635 ,3 ,638 ,1079 ,0,3,1,3,0,1,0,76.14,59.13 ,33.33
03,001,02,006,0270,656,779 ,2 ,781 ,1422 ,0,3,1,3,0,1,0,76.14,54.92 ,33.33
03,001,02,006,0270,657,1031 ,6 ,1037 ,1781 ,0,3,1,3,0,1,0,76.14,58.23 ,33.33
03,001,02,006,0271,658,892 ,11 ,903 ,1467 ,0,3,1,3,0,1,0,76.14,61.55 ,33.33
03,001,02,006,0271,659,1000 ,6 ,1006 ,1729 ,0,3,1,3,0,1,0,76.14,58.18 ,33.33
03,001,02,006,0272,660,798 ,4 ,802 ,1429 ,0,3,1,3,0,1,0,76.14,56.12 ,33.33
03,001,02,006,0272,661,892 ,8 ,900 ,1685 ,0,3,1,3,0,1,0,76.14,53.41 ,33.33
03,001,02,006,0273,662,788 ,9 ,797 ,1319 ,0,3,1,3,0,1,0,76.14,60.42 ,33.33
03,001,02,006,0273,663,776 ,10 ,786 ,1338 ,0,3,1,3,0,1,0,76.14,58.74 ,33.33
03,001,02,006,0274,664,827 ,6 ,833 ,1978 ,0,3,1,3,0,1,0,76.14,42.11 ,33.33
03,001,02,006,0274,665,932 ,5 ,937 ,1529 ,0,3,1,3,0,1,0,76.14,61.28 ,33.33
03,001,02,006,0274,666,749 ,5 ,754 ,1426 ,0,3,1,3,0,1,0,76.14,52.88 ,33.33
03,001,02,006,0275,667,472 ,6 ,478 ,787 ,0,3,1,3,0,1,0,76.14,60.74 ,33.33
03,001,02,006,0275,668,553 ,4 ,557 ,956 ,0,3,1,3,0,1,0,76.14,58.26 ,33.33
03,001,02,006,0276,669,834 ,3 ,837 ,1180 ,0,3,1,3,0,1,0,76.14,70.93 ,33.33
03,001,02,006,0276,670,921 ,7 ,928 ,1387 ,0,3,1,3,0,1,0,76.14,66.91 ,33.33
03,001,02,006,0277,671,599 ,5 ,604 ,1048 ,0,3,1,3,0,1,0,76.14,57.63 ,33.33
03,001,02,006,0277,672,769 ,5 ,774 ,1293 ,0,3,1,3,0,1,0,76.14,59.86 ,33.33
03,001,02,006,0277,673,727 ,2 ,729 ,1165 ,0,3,1,3,0,1,0,76.14,62.58 ,33.33
03,001,02,006,0278,674,960 ,3 ,963 ,1661 ,0,3,1,3,0,1,0,76.14,57.98 ,33.33
03,001,02,006,0278,675,1035 ,4 ,1039 ,1697 ,0,3,1,3,0,1,0,76.14,61.23 ,33.33
03,001,02,006,0278,676,1027 ,9 ,1036 ,1644 ,0,3,1,3,0,1,0,76.14,63.02 ,33.33
03,001,02,006,0279,677,706 ,9 ,715 ,1197 ,0,3,1,3,0,1,0,76.14,59.73 ,33.33
03,001,02,006,0279,678,693 ,4 ,697 ,1086 ,0,3,1,3,0,1,0,76.14,64.18 ,33.33
03,001,02,006,0279,679,649 ,6 ,655 ,1090 ,0,3,1,3,0,1,0,76.14,60.09 ,33.33
03,001,02,006,0280,680,791 ,8 ,799 ,1374 ,0,3,1,3,0,1,0,76.14,58.15 ,33.33
03,001,02,006,0280,681,835 ,3 ,838 ,1436 ,0,3,1,3,0,1,0,76.14,58.36 ,33.33
03,001,02,006,0281,682,913 ,5 ,918 ,1518 ,0,3,1,3,0,1,0,76.14,60.47 ,33.33
03,001,02,006,0281,683,962 ,7 ,969 ,1562 ,0,3,1,3,0,1,0,76.14,62.04 ,33.33
03,001,02,006,0281,684,919 ,6 ,925 ,1523 ,0,3,1,3,0,1,0,76.14,60.74 ,33.33
03,001,02,006,0282,685,977 ,8 ,985 ,1644 ,0,3,1,3,0,1,0,76.14,59.91 ,33.33
03,001,02,006,0282,686,973 ,6 ,979 ,1666 ,0,3,1,3,0,1,0,76.14,58.76 ,33.33
03,001,02,006,0282,687,914 ,5 ,919 ,1591 ,0,3,1,3,0,1,0,76.14,57.76 ,33.33
03,001,02,006,0283,688,866 ,3 ,869 ,1536 ,0,3,1,3,0,1,0,76.14,56.58 ,33.33
03,001,02,006,0283,689,607 ,1 ,608 ,1043 ,0,3,1,3,0,1,0,76.14,58.29 ,33.33
03,001,02,006,0284,690,713 ,4 ,717 ,1254 ,0,3,1,3,0,1,0,76.14,57.18 ,33.33
03,001,02,006,0284,691,714 ,6 ,720 ,1314 ,0,3,1,3,0,1,0,76.14,54.79 ,33.33
03,001,02,006,0284,692,640 ,1 ,641 ,1214 ,0,3,1,3,0,1,0,76.14,52.80 ,33.33
03,001,02,006,0284,693,678 ,5 ,683 ,1278 ,0,3,1,3,0,1,0,76.14,53.44 ,33.33
03,001,02,006,0285,694,848 ,10 ,858 ,1528 ,0,3,1,3,0,1,0,76.14,56.15 ,33.33
03,001,02,006,0286,695,801 ,6 ,807 ,1481 ,0,3,1,3,0,1,0,76.14,54.49 ,33.33
03,001,02,006,0287,696,858 ,10 ,868 ,1437 ,0,3,1,3,0,1,0,76.14,60.40 ,33.33
03,001,02,006,0288,697,583 ,6 ,589 ,1009 ,0,3,1,3,0,1,0,76.14,58.37 ,33.33
03,001,02,006,0288,698,425 ,3 ,428 ,739 ,0,3,1,3,0,1,0,76.14,57.92 ,33.33
03,001,02,006,0289,699,888 ,8 ,896 ,1489 ,0,3,1,3,0,1,0,76.14,60.17 ,33.33
03,001,02,006,0290,700,741 ,11 ,752 ,1189 ,0,3,1,3,0,1,0,76.14,63.25 ,33.33
03,001,02,006,0291,701,723 ,13 ,736 ,1246 ,0,3,1,3,0,1,0,76.14,59.07 ,33.33
03,001,02,006,0292,702,845 ,8 ,853 ,1557 ,0,3,1,3,0,1,0,76.14,54.78 ,33.33
03,001,02,006,0293,703,700 ,10 ,710 ,1151 ,0,3,1,3,0,1,0,76.14,61.69 ,33.33
03,001,02,006,0294,704,847 ,7 ,854 ,1431 ,0,3,1,3,0,1,0,76.14,59.68 ,33.33
03,001,02,006,0295,705,833 ,8 ,841 ,1427 ,0,3,1,3,0,1,0,76.14,58.93 ,33.33
03,001,02,006,0296,706,464 ,8 ,472 ,795 ,0,3,1,3,0,1,0,76.14,59.37 ,33.33
03,001,02,006,0296,707,609 ,7 ,616 ,1065 ,0,3,1,3,0,1,0,76.14,57.84 ,33.33
03,001,02,006,0297,708,943 ,10 ,953 ,1590 ,0,3,1,3,0,1,0,76.14,59.94 ,33.33
03,001,02,006,0298,709,670 ,6 ,676 ,1090 ,0,3,1,3,0,1,0,76.14,62.02 ,33.33
03,001,02,006,0299,710,657 ,7 ,664 ,1091 ,0,3,1,3,0,1,0,76.14,60.86 ,33.33
03,001,02,006,0300,711,1004 ,9 ,1013 ,1545 ,0,3,1,3,0,1,0,76.14,65.57 ,33.33
03,001,02,006,0301,712,529 ,9 ,538 ,769 ,0,3,1,3,0,1,0,76.14,69.96 ,33.33
03,001,02,006,0302,713,862 ,11 ,873 ,1596 ,0,3,1,3,0,1,0,76.14,54.70 ,33.33
03,001,02,006,0303,714,1031 ,6 ,1037 ,1865 ,0,3,1,3,0,1,0,76.14,55.60 ,33.33
03,001,02,006,0303,715,720 ,7 ,727 ,1220 ,0,3,1,3,0,1,0,76.14,59.59 ,33.33
03,001,02,006,0304,716,667 ,9 ,676 ,1194 ,0,3,1,3,0,1,0,76.14,56.62 ,33.33
03,001,02,006,0305,717,565 ,7 ,572 ,982 ,0,3,1,3,0,1,0,76.14,58.25 ,33.33
03,001,02,006,0305,718,654 ,7 ,661 ,1108 ,0,3,1,3,0,1,0,76.14,59.66 ,33.33
03,001,02,006,0306,719,584 ,4 ,588 ,994 ,0,3,1,3,0,1,0,76.14,59.15 ,33.33
03,001,02,006,0306,720,615 ,6 ,621 ,1116 ,0,3,1,3,0,1,0,76.14,55.65 ,33.33
03,001,02,006,0307,721,632 ,4 ,636 ,1019 ,0,3,1,3,0,1,0,76.14,62.41 ,33.33
03,001,02,006,0307,722,690 ,8 ,698 ,1129 ,0,3,1,3,0,1,0,76.14,61.82 ,33.33
03,001,02,006,0308,723,887 ,5 ,892 ,1505 ,0,3,1,3,0,1,0,76.14,59.27 ,33.33
03,001,02,006,0308,724,795 ,5 ,800 ,1403 ,0,3,1,3,0,1,0,76.14,57.02 ,33.33
03,001,02,006,0309,725,676 ,3 ,679 ,1202 ,0,3,1,3,0,1,0,76.14,56.49 ,33.33
03,001,02,006,0309,726,771 ,6 ,777 ,1290 ,0,3,1,3,0,1,0,76.14,60.23 ,33.33
03,001,02,006,0309,727,663 ,5 ,668 ,1161 ,0,3,1,3,0,1,0,76.14,57.54 ,33.33
03,001,02,006,0310,728,824 ,8 ,832 ,1317 ,0,3,1,3,0,1,0,76.14,63.17 ,33.33
03,001,02,006,0311,729,658 ,5 ,663 ,1019 ,0,3,1,3,0,1,0,76.14,65.06 ,33.33
03,001,02,006,0312,730,899 ,5 ,904 ,1498 ,0,3,1,3,0,1,0,76.14,60.35 ,33.33
03,001,02,006,0313,731,1019 ,13 ,1032 ,1676 ,0,3,1,3,0,1,0,76.14,61.58 ,33.33
03,001,02,006,0314,732,967 ,8 ,975 ,1615 ,0,3,1,3,0,1,0,76.14,60.37 ,33.33
03,001,02,006,0315,733,677 ,4 ,681 ,1089 ,0,3,1,3,0,1,0,76.14,62.53 ,33.33
03,001,02,006,0315,734,618 ,4 ,622 ,1021 ,0,3,1,3,0,1,0,76.14,60.92 ,33.33
03,001,02,006,0316,735,907 ,10 ,917 ,1513 ,0,3,1,3,0,1,0,76.14,60.61 ,33.33
03,001,02,006,0317,736,514 ,2 ,516 ,836 ,0,3,1,3,0,1,0,76.14,61.72 ,33.33
03,001,02,006,0318,737,890 ,10 ,900 ,1451 ,0,3,1,3,0,1,0,76.14,62.03 ,33.33
03,001,02,006,0319,738,548 ,3 ,551 ,909 ,0,3,1,3,0,1,0,76.14,60.62 ,33.33
03,001,02,006,0319,739,523 ,6 ,529 ,815 ,0,3,1,3,0,1,0,76.14,64.91 ,33.33
03,001,02,006,0320,740,543 ,3 ,546 ,957 ,0,3,1,3,0,1,0,76.14,57.05 ,33.33
03,001,02,006,0320,741,596 ,6 ,602 ,999 ,0,3,1,3,0,1,0,76.14,60.26 ,33.33
03,001,02,006,0321,742,912 ,5 ,917 ,1671 ,0,3,1,3,0,1,0,76.14,54.88 ,33.33
03,001,02,006,0322,743,404 ,1 ,405 ,752 ,0,3,1,3,0,1,0,76.14,53.86 ,33.33
03,001,02,006,0323,744,852 ,15 ,867 ,1317 ,0,3,1,3,0,1,0,76.14,65.83 ,33.33
03,001,02,006,0324,745,388 ,1 ,389 ,659 ,0,3,1,3,0,1,0,76.14,59.03 ,33.33
03,001,02,006,0325,746,562 ,4 ,566 ,958 ,0,3,1,3,0,1,0,76.14,59.08 ,33.33
03,001,02,006,0325,747,671 ,12 ,683 ,1160 ,0,3,1,3,0,1,0,76.14,58.88 ,33.33
03,001,02,006,0326,748,980 ,8 ,988 ,1701 ,0,3,1,3,0,1,0,76.14,58.08 ,33.33
03,001,02,006,0327,749,633 ,1 ,634 ,1147 ,0,3,1,3,0,1,0,76.14,55.27 ,33.33
03,001,02,006,0327,750,500 ,3 ,503 ,912 ,0,3,1,3,0,1,0,76.14,55.15 ,33.33
03,001,02,006,0328,751,838 ,6 ,844 ,1405 ,0,3,1,3,0,1,0,76.14,60.07 ,33.33
03,001,02,006,0329,752,615 ,28 ,643 ,1084 ,0,3,1,3,0,1,0,76.14,59.32 ,33.33
03,001,02,006,0330,753,439 ,8 ,447 ,769 ,0,3,1,3,0,1,0,76.14,58.13 ,33.33
03,001,02,006,0330,754,568 ,2 ,570 ,943 ,0,3,1,3,0,1,0,76.14,60.45 ,33.33
03,001,02,006,0331,755,541 ,6 ,547 ,1022 ,0,3,1,3,0,1,0,76.14,53.52 ,33.33
03,001,02,006,0331,756,555 ,3 ,558 ,1034 ,0,3,1,3,0,1,0,76.14,53.97 ,33.33
03,001,02,006,0332,757,715 ,7 ,722 ,1184 ,0,3,1,3,0,1,0,76.14,60.98 ,33.33
03,001,02,006,0332,758,815 ,10 ,825 ,1404 ,0,3,1,3,0,1,0,76.14,58.76 ,33.33
03,001,02,006,0333,759,920 ,8 ,928 ,1656 ,0,3,1,3,0,1,0,76.14,56.04 ,33.33
03,001,02,006,0334,760,710 ,8 ,718 ,1154 ,0,3,1,3,0,1,0,76.14,62.22 ,33.33
03,001,02,006,0335,761,755 ,8 ,763 ,1303 ,0,3,1,3,0,1,0,76.14,58.56 ,33.33
03,001,02,006,0336,762,587 ,4 ,591 ,1048 ,0,3,1,3,0,1,0,76.14,56.39 ,33.33
03,001,02,006,0336,763,704 ,7 ,711 ,1202 ,0,3,1,3,0,1,0,76.14,59.15 ,33.33
03,001,02,006,0337,764,713 ,7 ,720 ,1204 ,0,3,1,3,0,1,0,76.14,59.80 ,33.33
03,001,02,006,0337,765,808 ,13 ,821 ,1367 ,0,3,1,3,0,1,0,76.14,60.06 ,33.33
03,001,02,006,0338,766,926 ,15 ,941 ,1582 ,0,3,1,3,0,1,0,76.14,59.48 ,33.33
03,001,02,006,0339,767,512 ,3 ,515 ,861 ,0,3,1,3,0,1,0,76.14,59.81 ,33.33
03,001,02,006,0339,768,583 ,2 ,585 ,972 ,0,3,1,3,0,1,0,76.14,60.19 ,33.33
03,001,02,006,0340,769,751 ,7 ,758 ,1335 ,0,3,1,3,0,1,0,76.14,56.78 ,33.33
03,001,02,006,0340,770,702 ,6 ,708 ,1191 ,0,3,1,3,0,1,0,76.14,59.45 ,33.33
03,001,02,006,0340,771,729 ,6 ,735 ,1227 ,0,3,1,3,0,1,0,76.14,59.90 ,33.33
03,001,02,006,0341,772,990 ,14 ,1004 ,1691 ,0,3,1,3,0,1,0,76.14,59.37 ,33.33
03,001,02,006,0341,773,833 ,7 ,840 ,1452 ,0,3,1,3,0,1,0,76.14,57.85 ,33.33
03,001,02,006,0342,774,721 ,4 ,725 ,1322 ,0,3,1,3,0,1,0,76.14,54.84 ,33.33
03,001,02,006,0342,775,872 ,8 ,880 ,1501 ,0,3,1,3,0,1,0,76.14,58.63 ,33.33
03,001,02,006,0342,776,758 ,12 ,770 ,1447 ,0,3,1,3,0,1,0,76.14,53.21 ,33.33
03,001,02,006,0343,777,607 ,9 ,616 ,998 ,0,3,1,3,0,1,0,76.14,61.72 ,33.33
03,001,02,006,0343,778,495 ,13 ,508 ,874 ,0,3,1,3,0,1,0,76.14,58.12 ,33.33
03,001,02,006,0344,779,1011 ,14 ,1025 ,1633 ,0,3,1,3,0,1,0,76.14,62.77 ,33.33
03,001,02,006,0345,780,582 ,4 ,586 ,962 ,0,3,1,3,0,1,0,76.14,60.91 ,33.33
03,001,02,006,0345,781,687 ,8 ,695 ,1112 ,0,3,1,3,0,1,0,76.14,62.50 ,33.33
03,001,02,006,0346,782,678 ,5 ,683 ,1190 ,0,3,1,3,0,1,0,76.14,57.39 ,33.33
03,001,02,006,0346,783,469 ,6 ,475 ,810 ,0,3,1,3,0,1,0,76.14,58.64 ,33.33
03,001,02,006,0346,784,829 ,8 ,837 ,1391 ,0,3,1,3,0,1,0,76.14,60.17 ,33.33
03,001,02,006,0347,785,842 ,8 ,850 ,1299 ,0,3,1,3,0,1,0,76.14,65.43 ,33.33
03,001,02,006,0347,786,925 ,7 ,932 ,1539 ,0,3,1,3,0,1,0,76.14,60.56 ,33.33
03,001,02,006,0348,787,845 ,9 ,854 ,1388 ,0,3,1,3,0,1,0,76.14,61.53 ,33.33
03,001,02,006,0348,788,622 ,6 ,628 ,1035 ,0,3,1,3,0,1,0,76.14,60.68 ,33.33
03,001,02,006,0349,789,906 ,12 ,918 ,1609 ,0,3,1,3,0,1,0,76.14,57.05 ,33.33
03,001,02,006,0349,790,680 ,5 ,685 ,1126 ,0,3,1,3,0,1,0,76.14,60.83 ,33.33
03,001,02,006,0350,791,898 ,9 ,907 ,1423 ,0,3,1,3,0,1,0,76.14,63.74 ,33.33
03,001,02,006,0350,792,784 ,4 ,788 ,1382 ,0,3,1,3,0,1,0,76.14,57.02 ,33.33
03,001,02,006,0351,793,858 ,5 ,863 ,1420 ,0,3,1,3,0,1,0,76.14,60.77 ,33.33
03,001,02,006,0351,794,774 ,7 ,781 ,1325 ,0,3,1,3,0,1,0,76.14,58.94 ,33.33
03,001,02,006,0352,795,939 ,7 ,946 ,1533 ,0,3,1,3,0,1,0,76.14,61.71 ,33.33
03,001,02,006,0352,796,723 ,12 ,735 ,1157 ,0,3,1,3,0,1,0,76.14,63.53 ,33.33
03,001,02,006,0352,797,791 ,11 ,802 ,1380 ,0,3,1,3,0,1,0,76.14,58.12 ,33.33
03,001,02,006,0353,798,739 ,6 ,745 ,1214 ,0,3,1,3,0,1,0,76.14,61.37 ,33.33
03,001,02,006,0353,799,543 ,2 ,545 ,964 ,0,3,1,3,0,1,0,76.14,56.54 ,33.33
03,001,02,006,0354,800,652 ,3 ,655 ,1094 ,0,3,1,3,0,1,0,76.14,59.87 ,33.33
03,001,02,006,0354,801,676 ,7 ,683 ,1168 ,0,3,1,3,0,1,0,76.14,58.48 ,33.33
03,001,02,006,0354,802,815 ,7 ,822 ,1346 ,0,3,1,3,0,1,0,76.14,61.07 ,33.33
03,001,02,006,0355,803,796 ,11 ,807 ,1380 ,0,3,1,3,0,1,0,76.14,58.48 ,33.33
03,001,02,006,0355,804,822 ,7 ,829 ,1477 ,0,3,1,3,0,1,0,76.14,56.13 ,33.33
03,001,02,006,0356,805,672 ,4 ,676 ,1268 ,0,3,1,3,0,1,0,76.14,53.31 ,33.33
03,001,02,006,0356,806,611 ,6 ,617 ,1149 ,0,3,1,3,0,1,0,76.14,53.70 ,33.33
03,001,02,006,0357,807,815 ,5 ,820 ,1456 ,0,3,1,3,0,1,0,76.14,56.32 ,33.33
03,001,02,006,0357,808,671 ,3 ,674 ,1288 ,0,3,1,3,0,1,0,76.14,52.33 ,33.33
03,001,02,006,0358,809,761 ,8 ,769 ,1356 ,0,3,1,3,0,1,0,76.14,56.71 ,33.33
03,001,02,006,0358,810,567 ,6 ,573 ,1026 ,0,3,1,3,0,1,0,76.14,55.85 ,33.33
03,001,02,006,0358,811,862 ,9 ,871 ,1592 ,0,3,1,3,0,1,0,76.14,54.71 ,33.33
03,001,02,006,0359,812,745 ,5 ,750 ,1335 ,0,3,1,3,0,1,0,76.14,56.18 ,33.33
03,001,02,006,0359,813,623 ,6 ,629 ,1174 ,0,3,1,3,0,1,0,76.14,53.58 ,33.33
03,001,02,006,0359,814,911 ,4 ,915 ,1624 ,0,3,1,3,0,1,0,76.14,56.34 ,33.33
03,001,02,006,0360,815,818 ,6 ,824 ,1516 ,0,3,1,3,0,1,0,76.14,54.35 ,33.33
03,001,02,006,0360,816,826 ,8 ,834 ,1553 ,0,3,1,3,0,1,0,76.14,53.70 ,33.33
03,001,02,006,0360,817,743 ,7 ,750 ,1415 ,0,3,1,3,0,1,0,76.14,53.00 ,33.33
03,001,02,006,0361,818,697 ,1 ,698 ,1358 ,0,3,1,3,0,1,0,76.14,51.40 ,33.33
03,001,02,006,0361,819,715 ,6 ,721 ,1408 ,0,3,1,3,0,1,0,76.14,51.21 ,33.33
03,001,02,006,0361,820,558 ,2 ,560 ,990 ,0,3,1,3,0,1,0,76.14,56.57 ,33.33
03,001,02,006,0362,821,936 ,6 ,942 ,1590 ,0,3,1,3,0,1,0,76.14,59.25 ,33.33
03,001,02,006,0362,822,650 ,4 ,654 ,1582 ,0,3,1,3,0,1,0,76.14,41.34 ,33.33
03,001,02,006,0362,823,902 ,5 ,907 ,1569 ,0,3,1,3,0,1,0,76.14,57.81 ,33.33
03,001,02,006,0362,824,660 ,8 ,668 ,1190 ,0,3,1,3,0,1,0,76.14,56.13 ,33.33
03,001,02,006,0363,825,800 ,4 ,804 ,1611 ,0,3,1,3,0,1,0,76.14,49.91 ,33.33
03,001,02,006,0363,826,760 ,6 ,766 ,1498 ,0,3,1,3,0,1,0,76.14,51.13 ,33.33
03,001,02,006,0364,827,665 ,7 ,672 ,1060 ,0,3,1,3,0,1,0,76.14,63.40 ,33.33
03,001,02,006,0364,828,640 ,5 ,645 ,1104 ,0,3,1,3,0,1,0,76.14,58.42 ,33.33
03,001,02,006,0364,829,668 ,6 ,674 ,1161 ,0,3,1,3,0,1,0,76.14,58.05 ,33.33
03,001,02,006,0365,830,602 ,5 ,607 ,1095 ,0,3,1,3,0,1,0,76.14,55.43 ,33.33
03,001,02,006,0365,831,591 ,4 ,595 ,1173 ,0,3,1,3,0,1,0,76.14,50.72 ,33.33
03,001,02,006,0366,832,760 ,8 ,768 ,1490 ,0,3,1,3,0,1,0,76.14,51.54 ,33.33
03,001,02,006,0366,833,685 ,5 ,690 ,1177 ,0,3,1,3,0,1,0,76.14,58.62 ,33.33
03,001,02,006,0367,834,486 ,7 ,493 ,885 ,0,3,1,3,0,1,0,76.14,55.71 ,33.33
03,001,02,006,0367,835,639 ,8 ,647 ,1094 ,0,3,1,3,0,1,0,76.14,59.14 ,33.33
03,001,02,006,0368,836,521 ,5 ,526 ,866 ,0,3,1,3,0,1,0,76.14,60.74 ,33.33
03,001,02,006,0368,837,683 ,5 ,688 ,1141 ,0,3,1,3,0,1,0,76.14,60.30 ,33.33
03,001,02,006,0369,838,638 ,6 ,644 ,1051 ,0,3,1,3,0,1,0,76.14,61.27 ,33.33
03,001,02,006,0369,839,553 ,10 ,563 ,936 ,0,3,1,3,0,1,0,76.14,60.15 ,33.33
03,001,02,006,0370,840,941 ,14 ,955 ,1590 ,0,3,1,3,0,1,0,76.14,60.06 ,33.33
03,001,02,006,0370,841,905 ,14 ,919 ,1571 ,0,3,1,3,0,1,0,76.14,58.50 ,33.33
03,001,02,006,0371,842,561 ,13 ,574 ,1031 ,0,3,1,3,0,1,0,76.14,55.67 ,33.33
03,001,02,006,0371,843,565 ,6 ,571 ,1027 ,0,3,1,3,0,1,0,76.14,55.60 ,33.33
03,001,02,006,0372,844,677 ,10 ,687 ,1206 ,0,3,1,3,0,1,0,76.14,56.97 ,33.33
03,001,02,006,0372,845,647 ,4 ,651 ,1204 ,0,3,1,3,0,1,0,76.14,54.07 ,33.33
03,001,02,006,0372,846,683 ,7 ,690 ,1257 ,0,3,1,3,0,1,0,76.14,54.89 ,33.33
03,001,02,006,0373,847,591 ,5 ,596 ,1065 ,0,3,1,3,0,1,0,76.14,55.96 ,33.33
03,001,02,006,0373,848,613 ,7 ,620 ,1163 ,0,3,1,3,0,1,0,76.14,53.31 ,33.33
03,001,02,006,0374,849,742 ,8 ,750 ,1436 ,0,3,1,3,0,1,0,76.14,52.23 ,33.33
03,001,02,006,0374,850,704 ,6 ,710 ,1232 ,0,3,1,3,0,1,0,76.14,57.63 ,33.33
03,001,02,006,0375,851,398 ,6 ,404 ,739 ,0,3,1,3,0,1,0,76.14,54.67 ,33.33
03,001,02,006,0375,852,568 ,7 ,575 ,1039 ,0,3,1,3,0,1,0,76.14,55.34 ,33.33
03,001,02,006,0376,853,903 ,4 ,907 ,1580 ,0,3,1,3,0,1,0,76.14,57.41 ,33.33
03,001,02,006,0376,854,766 ,5 ,771 ,1321 ,0,3,1,3,0,1,0,76.14,58.36 ,33.33
03,001,02,006,0377,855,612 ,4 ,616 ,1035 ,0,3,1,3,0,1,0,76.14,59.52 ,33.33
03,001,02,006,0377,856,616 ,8 ,624 ,1130 ,0,3,1,3,0,1,0,76.14,55.22 ,33.33
03,001,02,006,0378,857,909 ,5 ,914 ,1495 ,0,3,1,3,0,1,0,76.14,61.14 ,33.33
03,001,02,006,0378,858,882 ,7 ,889 ,1506 ,0,3,1,3,0,1,0,76.14,59.03 ,33.33
03,001,02,006,0379,859,973 ,8 ,981 ,1684 ,0,3,1,3,0,1,0,76.14,58.25 ,33.33
03,001,02,006,0379,860,827 ,9 ,836 ,1507 ,0,3,1,3,0,1,0,76.14,55.47 ,33.33
03,001,02,006,0380,861,877 ,9 ,886 ,1543 ,0,3,1,3,0,1,0,76.14,57.42 ,33.33
03,001,02,006,0380,862,815 ,10 ,825 ,1542 ,0,3,1,3,0,1,0,76.14,53.50 ,33.33
03,001,02,007,0381,863,816 ,9 ,825 ,1386 ,0,3,1,3,0,1,0,76.14,59.52,33.33
03,001,02,007,0381,864,719 ,2 ,721 ,1368 ,0,3,1,3,0,1,0,76.14,52.7,33.33
03,001,02,007,0381,865,631 ,6 ,637 ,1145 ,0,3,1,3,0,1,0,76.14,55.63,33.33
03,001,02,007,0382,866,775 ,8 ,783 ,1470 ,0,3,1,3,0,1,0,76.14,53.27,33.33
03,001,02,007,0382,867,993 ,4 ,997 ,1870 ,0,3,1,3,0,1,0,76.14,53.32,33.33
03,001,02,007,0383,868,737 ,4 ,741 ,1259 ,0,3,1,3,0,1,0,76.14,58.86,33.33
03,001,02,007,0383,869,813 ,10 ,823 ,1429 ,0,3,1,3,0,1,0,76.14,57.59,33.33
03,001,02,007,0384,870,922 ,11 ,933 ,1732 ,0,3,1,3,0,1,0,76.14,53.87,33.33
03,001,02,007,0384,871,919 ,10 ,929 ,1536 ,0,3,1,3,0,1,0,76.14,60.48,33.33
03,001,02,007,0385,872,748 ,6 ,754 ,1337 ,0,3,1,3,0,1,0,76.14,56.39,33.33
03,001,02,007,0385,873,552 ,4 ,556 ,1005 ,0,3,1,3,0,1,0,76.14,55.32,33.33
03,001,02,007,0385,874,746 ,7 ,753 ,1337 ,0,3,1,3,0,1,0,76.14,56.32,33.33
03,001,02,007,0386,875,808 ,9 ,817 ,1510 ,0,3,1,3,0,1,0,76.14,54.11,33.33
03,001,02,007,0386,876,755 ,3 ,758 ,1312 ,0,3,1,3,0,1,0,76.14,57.77,33.33
03,001,02,007,0387,877,771 ,5 ,776 ,1356 ,0,3,1,3,0,1,0,76.14,57.23,33.33
03,001,02,007,0387,878,647 ,1 ,648 ,1090 ,0,3,1,3,0,1,0,76.14,59.45,33.33
03,001,02,007,0388,879,750 ,9 ,759 ,1431 ,0,3,1,3,0,1,0,76.14,53.04,33.33
03,001,02,007,0388,880,927 ,6 ,933 ,1732 ,0,3,1,3,0,1,0,76.14,53.87,33.33
03,001,02,007,0389,881,884 ,2 ,886 ,1768 ,0,3,1,3,0,1,0,76.14,50.11,33.33
03,001,02,007,0389,882,884 ,7 ,891 ,1813 ,0,3,1,3,0,1,0,76.14,49.15,33.33
03,001,02,007,0390,883,952 ,16 ,968 ,1766 ,0,3,1,3,0,1,0,76.14,54.81,33.33
03,001,02,007,0391,884,595 ,5 ,600 ,1151 ,0,3,1,3,0,1,0,76.14,52.13,33.33
03,001,02,007,0392,885,800 ,4 ,804 ,1616 ,0,3,1,3,0,1,0,76.14,49.75,33.33
03,001,02,007,0392,886,652 ,6 ,658 ,1197 ,0,3,1,3,0,1,0,76.14,54.97,33.33
03,001,02,007,0392,887,695 ,5 ,700 ,1323 ,0,3,1,3,0,1,0,76.14,52.91,33.33
03,001,02,007,0393,888,720 ,7 ,727 ,1451 ,0,3,1,3,0,1,0,76.14,50.1,33.33
03,001,02,007,0393,889,697 ,6 ,703 ,1385 ,0,3,1,3,0,1,0,76.14,50.76,33.33
03,001,02,007,0393,890,789 ,5 ,794 ,1532 ,0,3,1,3,0,1,0,76.14,51.83,33.33
03,001,02,007,0394,891,729 ,3 ,732 ,1491 ,0,3,1,3,0,1,0,76.14,49.09,33.33
03,001,02,007,0394,892,756 ,8 ,764 ,1487 ,0,3,1,3,0,1,0,76.14,51.38,33.33
03,001,02,007,0394,893,830 ,4 ,834 ,1596 ,0,3,1,3,0,1,0,76.14,52.26,33.33
03,001,02,007,0395,894,648 ,17 ,665 ,1228 ,0,3,1,3,0,1,0,76.14,54.15,33.33
03,001,02,007,0395,895,636 ,4 ,640 ,1234 ,0,3,1,3,0,1,0,76.14,51.86,33.33
03,001,02,007,0395,896,844 ,10 ,854 ,1841 ,0,3,1,3,0,1,0,76.14,46.39,33.33
03,001,02,007,0396,897,703 ,4 ,707 ,1469 ,0,3,1,3,0,1,0,76.14,48.13,33.33
03,001,02,007,0396,898,796 ,4 ,800 ,1574 ,0,3,1,3,0,1,0,76.14,50.83,33.33
03,001,02,007,0397,899,923 ,5 ,928 ,1695 ,0,3,1,3,0,1,0,76.14,54.75,33.33
03,001,02,007,0397,900,715 ,6 ,721 ,1371 ,0,3,1,3,0,1,0,76.14,52.59,33.33
03,001,02,007,0397,901,648 ,4 ,652 ,1147 ,0,3,1,3,0,1,0,76.14,56.84,33.33
03,001,02,007,0398,902,900 ,6 ,906 ,1553 ,0,3,1,3,0,1,0,76.14,58.34,33.33
03,001,02,007,0398,903,881 ,7 ,888 ,1551 ,0,3,1,3,0,1,0,76.14,57.25,33.33
03,001,02,007,0399,904,963 ,21 ,984 ,1869 ,0,3,1,3,0,1,0,76.14,52.65,33.33
03,001,02,007,0399,905,1019 ,8 ,1027 ,1856 ,0,3,1,3,0,1,0,76.14,55.33,33.33
03,001,02,007,0400,906,796 ,7 ,803 ,1288 ,0,3,1,3,0,1,0,76.14,62.34,33.33
03,001,02,007,0400,907,795 ,9 ,804 ,1429 ,0,3,1,3,0,1,0,76.14,56.26,33.33
03,001,02,007,0401,908,618 ,7 ,625 ,1162 ,0,3,1,3,0,1,0,76.14,53.79,33.33
03,001,02,007,0401,909,651 ,11 ,662 ,1151 ,0,3,1,3,0,1,0,76.14,57.52,33.33
03,001,02,007,0402,910,901 ,9 ,910 ,1695 ,0,3,1,3,0,1,0,76.14,53.69,33.33
03,001,02,007,0402,911,634 ,4 ,638 ,1180 ,0,3,1,3,0,1,0,76.14,54.07,33.33
03,001,02,007,0402,912,643 ,2 ,645 ,1184 ,0,3,1,3,0,1,0,76.14,54.48,33.33
03,001,02,007,0403,913,881 ,6 ,887 ,1722 ,0,3,1,3,0,1,0,76.14,51.51,33.33
03,001,02,007,0403,914,798 ,3 ,801 ,1485 ,0,3,1,3,0,1,0,76.14,53.94,33.33
03,001,02,007,0403,915,762 ,3 ,765 ,1494 ,0,3,1,3,0,1,0,76.14,51.2,33.33
03,001,02,007,0404,916,635 ,8 ,643 ,1170 ,0,3,1,3,0,1,0,76.14,54.96,33.33
03,001,02,007,0404,917,836 ,8 ,844 ,1445 ,0,3,1,3,0,1,0,76.14,58.41,33.33
03,001,02,007,0405,918,976 ,7 ,983 ,1728 ,0,3,1,3,0,1,0,76.14,56.89,33.33
03,001,02,007,0406,919,679 ,2 ,681 ,1315 ,0,3,1,3,0,1,0,76.14,51.79,33.33
03,001,02,007,0406,920,772 ,1 ,773 ,1319 ,0,3,1,3,0,1,0,76.14,58.61,33.33
03,001,02,007,0406,921,687 ,1 ,688 ,1362 ,0,3,1,3,0,1,0,76.14,50.51,33.33
03,001,02,007,0407,922,578 ,4 ,582 ,1626 ,0,3,1,3,0,1,0,76.14,35.79,33.33
03,001,02,007,0407,923,600 ,11 ,611 ,1142 ,0,3,1,3,0,1,0,76.14,53.5,33.33
03,001,02,007,0408,924,801 ,1 ,802 ,1234 ,0,3,1,3,0,1,0,76.14,64.99,33.33
03,001,02,007,0408,925,876 ,11 ,887 ,1532 ,0,3,1,3,0,1,0,76.14,57.9,33.33
03,001,02,007,0409,926,626 ,4 ,630 ,1086 ,0,3,1,3,0,1,0,76.14,58.01,33.33
03,001,02,007,0409,927,625 ,7 ,632 ,1113 ,0,3,1,3,0,1,0,76.14,56.78,33.33
03,001,02,007,0410,928,567 ,3 ,570 ,989 ,0,3,1,3,0,1,0,76.14,57.63,33.33
03,001,02,007,0410,929,622 ,9 ,631 ,1081 ,0,3,1,3,0,1,0,76.14,58.37,33.33
03,001,02,007,0411,930,753 ,4 ,757 ,1341 ,0,3,1,3,0,1,0,76.14,56.45,33.33
03,001,02,007,0411,931,687 ,3 ,690 ,1261 ,0,3,1,3,0,1,0,76.14,54.72,33.33
03,001,02,007,0412,932,741 ,13 ,754 ,1294 ,0,3,1,3,0,1,0,76.14,58.27,33.33
03,001,02,007,0412,933,661 ,8 ,669 ,1063 ,0,3,1,3,0,1,0,76.14,62.94,33.33
03,001,02,007,0413,934,835 ,4 ,839 ,1590 ,0,3,1,3,0,1,0,76.14,52.77,33.33
03,001,02,007,0413,935,645 ,5 ,650 ,1308 ,0,3,1,3,0,1,0,76.14,49.69,33.33
03,001,02,007,0413,936,1066 ,3 ,1069 ,1933 ,0,3,1,3,0,1,0,76.14,55.3,33.33
03,001,02,007,0413,937,822 ,4 ,826 ,1606 ,0,3,1,3,0,1,0,76.14,51.43,33.33
03,001,02,007,0414,938,853 ,3 ,856 ,1605 ,0,3,1,3,0,1,0,76.14,53.33,33.33
03,001,02,007,0414,939,879 ,7 ,886 ,1729 ,0,3,1,3,0,1,0,76.14,51.24,33.33
03,001,02,007,0414,940,635 ,2 ,637 ,1287 ,0,3,1,3,0,1,0,76.14,49.49,33.33
03,001,02,007,0414,941,833 ,10 ,843 ,1639 ,0,3,1,3,0,1,0,76.14,51.43,33.33
03,001,02,007,0415,942,805 ,8 ,813 ,1498 ,0,3,1,3,0,1,0,76.14,54.27,33.33
03,001,02,007,0415,943,617 ,5 ,622 ,1243 ,0,3,1,3,0,1,0,76.14,50.04,33.33
03,001,02,007,0415,944,599 ,5 ,604 ,1165 ,0,3,1,3,0,1,0,76.14,51.85,33.33
03,001,02,007,0416,945,475 ,3 ,478 ,922 ,0,3,1,3,0,1,0,76.14,51.84,33.33
03,001,02,007,0416,946,434 ,7 ,441 ,818 ,0,3,1,3,0,1,0,76.14,53.91,33.33
03,001,02,007,0417,947,889 ,4 ,893 ,1672 ,0,3,1,3,0,1,0,76.14,53.41,33.33
03,001,02,007,0417,948,687 ,6 ,693 ,1303 ,0,3,1,3,0,1,0,76.14,53.18,33.33
03,001,02,007,0418,949,569 ,2 ,571 ,1012 ,0,3,1,3,0,1,0,76.14,56.42,33.33
03,001,02,007,0418,950,690 ,5 ,695 ,1081 ,0,3,1,3,0,1,0,76.14,64.29,33.33
03,001,02,008,0419,951,701 ,2 ,703 ,1191 ,0,3,1,3,0,1,0,76.14,59.03 ,33.33
03,001,02,008,0419,952,859 ,10 ,869 ,1516 ,0,3,1,3,0,1,0,76.14,57.32,33.33
03,001,02,008,0419,953,1036 ,18 ,1054 ,1736 ,0,3,1,3,0,1,0,76.14,60.71,33.33
03,001,02,008,0420,954,761 ,6 ,767 ,1172 ,0,3,1,3,0,1,0,76.14,65.44,33.33
03,001,02,008,0420,955,733 ,3 ,736 ,1344 ,0,3,1,3,0,1,0,76.14,54.76,33.33
03,001,02,008,0420,956,566 ,5 ,571 ,904 ,0,3,1,3,0,1,0,76.14,63.16,33.33
03,001,02,008,0421,957,889 ,7 ,896 ,1475 ,0,3,1,3,0,1,0,76.14,60.75,33.33
03,001,02,008,0421,958,946 ,5 ,951 ,1528 ,0,3,1,3,0,1,0,76.14,62.24,33.33
03,001,02,008,0421,959,829 ,3 ,832 ,1275 ,0,3,1,3,0,1,0,76.14,65.25,33.33
03,001,02,008,0422,960,672 ,6 ,678 ,1146 ,0,3,1,3,0,1,0,76.14,59.16,33.33
03,001,02,008,0422,961,782 ,3 ,785 ,1221 ,0,3,1,3,0,1,0,76.14,64.29,33.33
03,001,02,008,0422,962,785 ,10 ,795 ,1322 ,0,3,1,3,0,1,0,76.14,60.14,33.33
03,001,02,008,0423,963,1098 ,10 ,1108 ,1738 ,0,3,1,3,0,1,0,76.14,63.75,33.33
03,001,02,008,0424,964,1008 ,14 ,1022 ,1618 ,0,3,1,3,0,1,0,76.14,63.16,33.33
03,001,02,008,0424,965,847 ,5 ,852 ,1428 ,0,3,1,3,0,1,0,76.14,59.66,33.33
03,001,02,008,0425,966,413 ,5 ,418 ,692 ,0,3,1,3,0,1,0,76.14,60.4,33.33
03,001,02,008,0425,967,719 ,4 ,723 ,1158 ,0,3,1,3,0,1,0,76.14,62.44,33.33
03,001,02,008,0425,968,714 ,8 ,722 ,1226 ,0,3,1,3,0,1,0,76.14,58.89,33.33
03,001,02,008,0426,969,665 ,9 ,674 ,1087 ,0,3,1,3,0,1,0,76.14,62.01,33.33
03,001,02,008,0426,970,853 ,5 ,858 ,2249 ,0,3,1,3,0,1,0,76.14,38.15,33.33
03,001,02,008,0427,971,893 ,2 ,895 ,1438 ,0,3,1,3,0,1,0,76.14,62.24,33.33
03,001,02,008,0428,972,992 ,9 ,1001 ,1574 ,0,3,1,3,0,1,0,76.14,63.6,33.33
03,001,02,008,0429,973,683 ,2 ,685 ,1184 ,0,3,1,3,0,1,0,76.14,57.85,33.33
03,001,02,008,0429,974,619 ,6 ,625 ,1020 ,0,3,1,3,0,1,0,76.14,61.27,33.33
03,001,02,008,0430,975,878 ,8 ,886 ,1513 ,0,3,1,3,0,1,0,76.14,58.56,33.33
03,001,02,008,0430,976,982 ,9 ,991 ,1719 ,0,3,1,3,0,1,0,76.14,57.65,33.33
03,001,02,008,0431,977,732 ,5 ,737 ,1211 ,0,3,1,3,0,1,0,76.14,60.86,33.33
03,001,02,008,0431,978,521 ,4 ,525 ,891 ,0,3,1,3,0,1,0,76.14,58.92,33.33
03,001,02,008,0432,979,845 ,5 ,850 ,1660 ,0,3,1,3,0,1,0,76.14,51.2,33.33
03,001,02,008,0432,980,812 ,2 ,814 ,1465 ,0,3,1,3,0,1,0,76.14,55.56,33.33
03,001,02,008,0433,981,779 ,8 ,787 ,1478 ,0,3,1,3,0,1,0,76.14,53.25,33.33
03,001,02,008,0433,982,634 ,5 ,639 ,1302 ,0,3,1,3,0,1,0,76.14,49.08,33.33
03,001,02,008,0434,983,692 ,4 ,696 ,1320 ,0,3,1,3,0,1,0,76.14,52.73,33.33
03,001,02,008,0434,984,742 ,9 ,751 ,1290 ,0,3,1,3,0,1,0,76.14,58.22,33.33
03,001,02,008,0434,985,754 ,4 ,758 ,1334 ,0,3,1,3,0,1,0,76.14,56.82,33.33
03,001,02,008,0435,986,623 ,2 ,625 ,1158 ,0,3,1,3,0,1,0,76.14,53.97,33.33
03,001,02,008,0435,987,666 ,6 ,672 ,1199 ,0,3,1,3,0,1,0,76.14,56.05,33.33
03,001,02,008,0435,988,724 ,9 ,733 ,1303 ,0,3,1,3,0,1,0,76.14,56.25,33.33
03,001,02,008,0436,989,768 ,2 ,770 ,1405 ,0,3,1,3,0,1,0,76.14,54.8,33.33
03,001,02,008,0436,990,749 ,7 ,756 ,1434 ,0,3,1,3,0,1,0,76.14,52.72,33.33
03,001,02,008,0437,991,787 ,12 ,799 ,1427 ,0,3,1,3,0,1,0,76.14,55.99,33.33
03,001,02,008,0437,992,751 ,5 ,756 ,1353 ,0,3,1,3,0,1,0,76.14,55.88,33.33
03,001,02,008,0437,993,790 ,9 ,799 ,1530 ,0,3,1,3,0,1,0,76.14,52.22,33.33
03,001,02,008,0438,994,664 ,4 ,668 ,1183 ,0,3,1,3,0,1,0,76.14,56.47,33.33
03,001,02,008,0438,995,618 ,4 ,622 ,1161 ,0,3,1,3,0,1,0,76.14,53.57,33.33
03,001,02,008,0439,996,914 ,5 ,919 ,1525 ,0,3,1,3,0,1,0,76.14,60.26,33.33
03,001,02,008,0439,997,680 ,3 ,683 ,1193 ,0,3,1,3,0,1,0,76.14,57.25,33.33
03,001,02,008,0440,998,758 ,7 ,765 ,1428 ,0,3,1,3,0,1,0,76.14,53.57,33.33
03,001,02,008,0440,999,806 ,8 ,814 ,1437 ,0,3,1,3,0,1,0,76.14,56.65,33.33
03,001,02,008,0441,1000,670 ,1 ,671 ,1203 ,0,3,1,3,0,1,0,76.14,55.78,33.33
03,001,02,008,0441,1001,710 ,6 ,716 ,1152 ,0,3,1,3,0,1,0,76.14,62.15,33.33
03,001,02,008,0442,1002,534 ,5 ,539 ,953 ,0,3,1,3,0,1,0,76.14,56.56,33.33
03,001,02,008,0442,1003,602 ,5 ,607 ,1104 ,0,3,1,3,0,1,0,76.14,54.98,33.33
03,001,02,008,0443,1004,809 ,12 ,821 ,1415 ,0,3,1,3,0,1,0,76.14,58.02,33.33
03,001,02,008,0443,1005,703 ,9 ,712 ,1248 ,0,3,1,3,0,1,0,76.14,57.05,33.33
03,001,02,008,0443,1006,787 ,11 ,798 ,1305 ,0,3,1,3,0,1,0,76.14,61.15,33.33
03,001,02,008,0444,1007,686 ,9 ,695 ,1263 ,0,3,1,3,0,1,0,76.14,55.03,33.33
03,001,02,008,0444,1008,643 ,18 ,661 ,1137 ,0,3,1,3,0,1,0,76.14,58.14,33.33
03,001,02,008,0445,1009,785 ,3 ,788 ,1446 ,0,3,1,3,0,1,0,76.14,54.5,33.33
03,001,02,008,0445,1010,853 ,3 ,856 ,1573 ,0,3,1,3,0,1,0,76.14,54.42,33.33
03,001,02,008,0445,1011,736 ,3 ,739 ,1313 ,0,3,1,3,0,1,0,76.14,56.28,33.33
03,001,02,008,0446,1012,986 ,6 ,992 ,1714 ,0,3,1,3,0,1,0,76.14,57.88,33.33
03,001,02,008,0446,1013,878 ,11 ,889 ,1506 ,0,3,1,3,0,1,0,76.14,59.03,33.33
03,001,02,008,0447,1014,903 ,6 ,909 ,1585 ,0,3,1,3,0,1,0,76.14,57.35,33.33
03,001,02,008,0448,1015,921 ,4 ,925 ,1561 ,0,3,1,3,0,1,0,76.14,59.26,33.33
03,001,02,008,0448,1016,950 ,8 ,958 ,1694 ,0,3,1,3,0,1,0,76.14,56.55,33.33
03,001,02,008,0448,1017,866 ,8 ,874 ,1445 ,0,3,1,3,0,1,0,76.14,60.48,33.33
03,001,02,008,0449,1018,772 ,4 ,776 ,1280 ,0,3,1,3,0,1,0,76.14,60.62,33.33
03,001,02,008,0449,1019,741 ,4 ,745 ,1269 ,0,3,1,3,0,1,0,76.14,58.71,33.33
03,001,02,008,0449,1020,646 ,3 ,649 ,1143 ,0,3,1,3,0,1,0,76.14,56.78,33.33
03,001,02,008,0450,1021,1074 ,9 ,1083 ,1754 ,0,3,1,3,0,1,0,76.14,61.74,33.33
03,001,02,008,0451,1022,669 ,1 ,670 ,1122 ,0,3,1,3,0,1,0,76.14,59.71,33.33
03,001,02,008,0451,1023,644 ,3 ,647 ,1106 ,0,3,1,3,0,1,0,76.14,58.5,33.33
03,001,02,008,0452,1024,623 ,5 ,628 ,1192 ,0,3,1,3,0,1,0,76.14,52.68,33.33
03,001,02,008,0452,1025,792 ,6 ,798 ,1322 ,0,3,1,3,0,1,0,76.14,60.36,33.33
03,001,02,008,0452,1026,723 ,7 ,730 ,1223 ,0,3,1,3,0,1,0,76.14,59.69,33.33
03,001,02,008,0453,1027,764 ,3 ,767 ,1300 ,0,3,1,3,0,1,0,76.14,59,33.33
03,001,02,008,0453,1028,741 ,6 ,747 ,1278 ,0,3,1,3,0,1,0,76.14,58.45,33.33
03,001,02,008,0453,1029,729 ,7 ,736 ,1294 ,0,3,1,3,0,1,0,76.14,56.88,33.33
03,001,02,008,0454,1030,729 ,8 ,737 ,1268 ,0,3,1,3,0,1,0,76.14,58.12,33.33
03,001,02,008,0454,1031,875 ,6 ,881 ,1436 ,0,3,1,3,0,1,0,76.14,61.35,33.33
03,001,02,008,0455,1032,790 ,8 ,798 ,1471 ,0,3,1,3,0,1,0,76.14,54.25,33.33
03,001,02,008,0455,1033,754 ,8 ,762 ,1410 ,0,3,1,3,0,1,0,76.14,54.04,33.33
03,001,02,008,0456,1034,802 ,4 ,806 ,1461 ,0,3,1,3,0,1,0,76.14,55.17,33.33
03,001,02,008,0456,1035,932 ,8 ,940 ,1600 ,0,3,1,3,0,1,0,76.14,58.75,33.33
03,001,02,008,0457,1036,674 ,1 ,675 ,1207 ,0,3,1,3,0,1,0,76.14,55.92,33.33
03,001,02,008,0457,1037,764 ,4 ,768 ,1564 ,0,3,1,3,0,1,0,76.14,49.1,33.33
03,001,02,008,0458,1038,1013 ,3 ,1016 ,1793 ,0,3,1,3,0,1,0,76.14,56.66,33.33
03,001,02,008,0458,1039,789 ,5 ,794 ,1379 ,0,3,1,3,0,1,0,76.14,57.58,33.33
03,001,02,008,0458,1040,806 ,10 ,816 ,1406 ,0,3,1,3,0,1,0,76.14,58.04,33.33
03,001,02,008,0459,1041,944 ,8 ,952 ,1755 ,0,3,1,3,0,1,0,76.14,54.25,33.33
03,001,02,008,0460,1042,861 ,5 ,866 ,1589 ,0,3,1,3,0,1,0,76.14,54.5,33.33
03,001,02,008,0460,1043,854 ,2 ,856 ,1537 ,0,3,1,3,0,1,0,76.14,55.69,33.33
03,001,02,008,0460,1044,896 ,3 ,899 ,1560 ,0,3,1,3,0,1,0,76.14,57.63,33.33
03,001,02,008,0461,1045,824 ,4 ,828 ,1448 ,0,3,1,3,0,1,0,76.14,57.18,33.33
03,001,02,008,0461,1046,748 ,6 ,754 ,1403 ,0,3,1,3,0,1,0,76.14,53.74,33.33
03,001,02,008,0461,1047,914 ,3 ,917 ,1714 ,0,3,1,3,0,1,0,76.14,53.5,33.33
03,001,02,008,0461,1048,764 ,6 ,770 ,1489 ,0,3,1,3,0,1,0,76.14,51.71,33.33
03,001,02,008,0462,1049,751 ,3 ,754 ,1346 ,0,3,1,3,0,1,0,76.14,56.02,33.33
03,001,02,008,0462,1050,752 ,8 ,760 ,1532 ,0,3,1,3,0,1,0,76.14,49.61,33.33
03,001,02,008,0462,1051,749 ,2 ,751 ,1488 ,0,3,1,3,0,1,0,76.14,50.47,33.33
03,001,02,008,0462,1052,655 ,3 ,658 ,1241 ,0,3,1,3,0,1,0,76.14,53.02,33.33
03,001,02,008,0463,1053,797 ,9 ,806 ,1413 ,0,3,1,3,0,1,0,76.14,57.04,33.33
03,001,02,008,0463,1054,804 ,5 ,809 ,1561 ,0,3,1,3,0,1,0,76.14,51.83,33.33
03,001,02,008,0463,1055,817 ,6 ,823 ,1484 ,0,3,1,3,0,1,0,76.14,55.46,33.33
03,001,02,008,0463,1056,729 ,4 ,733 ,1359 ,0,3,1,3,0,1,0,76.14,53.94,33.33
03,001,02,008,0464,1057,1005 ,10 ,1015 ,1713 ,0,3,1,3,0,1,0,76.14,59.25,33.33
03,001,02,008,0464,1058,534 ,4 ,538 ,997 ,0,3,1,3,0,1,0,76.14,53.96,33.33
03,001,02,008,0465,1059,848 ,8 ,856 ,1527 ,0,3,1,3,0,1,0,76.14,56.06,33.33
03,001,02,008,0465,1060,848 ,4 ,852 ,1592 ,0,3,1,3,0,1,0,76.14,53.52,33.33
03,001,02,008,0466,1061,751 ,2 ,753 ,1348 ,0,3,1,3,0,1,0,76.14,55.86,33.33
03,001,02,008,0466,1062,629 ,4 ,633 ,1134 ,0,3,1,3,0,1,0,76.14,55.82,33.33
03,001,02,008,0466,1063,697 ,8 ,705 ,1314 ,0,3,1,3,0,1,0,76.14,53.65,33.33
03,001,02,008,0467,1064,751 ,5 ,756 ,1299 ,0,3,1,3,0,1,0,76.14,58.2,33.33
03,001,02,008,0467,1065,714 ,4 ,718 ,1208 ,0,3,1,3,0,1,0,76.14,59.44,33.33
03,001,02,008,0467,1066,780 ,3 ,783 ,1445 ,0,3,1,3,0,1,0,76.14,54.19,33.33
03,001,02,008,0468,1067,839 ,9 ,848 ,1606 ,0,3,1,3,0,1,0,76.14,52.8,33.33
03,001,02,008,0468,1068,820 ,2 ,822 ,1442 ,0,3,1,3,0,1,0,76.14,57,33.33
03,001,02,008,0469,1069,923 ,9 ,932 ,1429 ,0,3,1,3,0,1,0,76.14,65.22,33.33
03,001,02,008,0470,1070,704 ,4 ,708 ,1150 ,0,3,1,3,0,1,0,76.14,61.57,33.33
03,001,02,008,0470,1071,486 ,7 ,493 ,850 ,0,3,1,3,0,1,0,76.14,58,33.33
03,001,02,008,0471,1072,1021 ,4 ,1025 ,1698 ,0,3,1,3,0,1,0,76.14,60.37,33.33
03,001,02,008,0471,1073,803 ,7 ,810 ,1451 ,0,3,1,3,0,1,0,76.14,55.82,33.33
03,001,02,008,0471,1074,834 ,10 ,844 ,1458 ,0,3,1,3,0,1,0,76.14,57.89,33.33
03,001,02,008,0472,1075,623 ,5 ,628 ,1021 ,0,3,1,3,0,1,0,76.14,61.51,33.33
03,001,02,008,0472,1076,618 ,8 ,626 ,952 ,0,3,1,3,0,1,0,76.14,65.76,33.33
03,001,02,008,0473,1077,558 ,4 ,562 ,942 ,0,3,1,3,0,1,0,76.14,59.66,33.33
03,001,02,008,0473,1078,598 ,4 ,602 ,995 ,0,3,1,3,0,1,0,76.14,60.5,33.33
03,001,02,008,0474,1079,737 ,2 ,739 ,1275 ,0,3,1,3,0,1,0,76.14,57.96,33.33
03,001,02,008,0474,1080,689 ,3 ,692 ,1295 ,0,3,1,3,0,1,0,76.14,53.44,33.33
03,001,02,008,0474,1081,599 ,5 ,604 ,1139 ,0,3,1,3,0,1,0,76.14,53.03,33.33
03,001,02,008,0474,1082,748 ,4 ,752 ,1650 ,0,3,1,3,0,1,0,76.14,45.58,33.33
03,001,02,008,0475,1083,571 ,8 ,579 ,1101 ,0,3,1,3,0,1,0,76.14,52.59,33.33
03,001,02,008,0475,1084,581 ,1 ,582 ,1209 ,0,3,1,3,0,1,0,76.14,48.14,33.33
03,001,02,008,0475,1085,667 ,4 ,671 ,1297 ,0,3,1,3,0,1,0,76.14,51.73,33.33
03,001,02,008,0476,1086,964 ,3 ,967 ,1759 ,0,3,1,3,0,1,0,76.14,54.97,33.33
03,001,02,008,0477,1087,608 ,7 ,615 ,1289 ,0,3,1,3,0,1,0,76.14,47.71,33.33
03,001,02,008,0477,1088,857 ,6 ,863 ,1734 ,0,3,1,3,0,1,0,76.14,49.77,33.33
03,001,02,008,0477,1089,742 ,5 ,747 ,1317 ,0,3,1,3,0,1,0,76.14,56.72,33.33
03,001,02,008,0477,1090,232 ,0 ,232 ,350 ,0,3,1,3,0,1,0,76.14,66.29,33.33
03,001,02,008,0478,1091,790 ,12 ,802 ,1516 ,0,3,1,3,0,1,0,76.14,52.9,33.33
03,001,02,008,0479,1092,760 ,4 ,764 ,1582 ,0,3,1,3,0,1,0,76.14,48.29,33.33
03,001,02,008,0479,1093,665 ,5 ,670 ,1303 ,0,3,1,3,0,1,0,76.14,51.42,33.33
03,001,02,008,0479,1094,833 ,5 ,838 ,1514 ,0,3,1,3,0,1,0,76.14,55.35,33.33
03,001,02,008,0480,1095,735 ,5 ,740 ,1302 ,0,3,1,3,0,1,0,76.14,56.84,33.33
03,001,02,008,0480,1096,698 ,4 ,702 ,1314 ,0,3,1,3,0,1,0,76.14,53.42,33.33
03,001,02,008,0480,1097,733 ,4 ,737 ,1334 ,0,3,1,3,0,1,0,76.14,55.25,33.33
03,001,02,008,0480,1098,587 ,2 ,589 ,1054 ,0,3,1,3,0,1,0,76.14,55.88,33.33
03,001,02,008,0481,1099,497 ,7 ,504 ,931 ,0,3,1,3,0,1,0,76.14,54.14,33.33
03,001,02,008,0481,1100,548 ,7 ,555 ,1024 ,0,3,1,3,0,1,0,76.14,54.2,33.33
03,001,02,008,0482,1101,543 ,4 ,547 ,985 ,0,3,1,3,0,1,0,76.14,55.53,33.33
03,001,02,008,0482,1102,615 ,4 ,619 ,1070 ,0,3,1,3,0,1,0,76.14,57.85,33.33
03,001,02,008,0483,1103,736 ,5 ,741 ,1369 ,0,3,1,3,0,1,0,76.14,54.13,33.33
03,001,02,008,0483,1104,726 ,8 ,734 ,1320 ,0,3,1,3,0,1,0,76.14,55.61,33.33
03,001,02,008,0484,1105,607 ,3 ,610 ,1046 ,0,3,1,3,0,1,0,76.14,58.32,33.33
03,001,02,008,0484,1106,658 ,1 ,659 ,1170 ,0,3,1,3,0,1,0,76.14,56.32,33.33
03,001,02,008,0485,1107,620 ,6 ,626 ,1172 ,0,3,1,3,0,1,0,76.14,53.41,33.33
03,001,02,008,0485,1108,805 ,5 ,810 ,1478 ,0,3,1,3,0,1,0,76.14,54.8,33.33
03,001,02,008,0486,1109,525 ,2 ,527 ,940 ,0,3,1,3,0,1,0,76.14,56.06,33.33
03,001,02,008,0486,1110,572 ,7 ,579 ,1069 ,0,3,1,3,0,1,0,76.14,54.16,33.33
03,001,02,008,0487,1111,697 ,3 ,700 ,1284 ,0,3,1,3,0,1,0,76.14,54.52,33.33
03,001,02,008,0487,1112,743 ,3 ,746 ,1303 ,0,3,1,3,0,1,0,76.14,57.25,33.33
03,001,02,008,0487,1113,696 ,7 ,703 ,1281 ,0,3,1,3,0,1,0,76.14,54.88,33.33
03,001,02,008,0487,1114,685 ,2 ,687 ,1180 ,0,3,1,3,0,1,0,76.14,58.22,33.33
03,001,02,008,0488,1115,616 ,5 ,621 ,1222 ,0,3,1,3,0,1,0,76.14,50.82,33.33
03,001,02,008,0488,1116,663 ,1 ,664 ,1295 ,0,3,1,3,0,1,0,76.14,51.27,33.33
03,001,02,008,0488,1117,681 ,9 ,690 ,1308 ,0,3,1,3,0,1,0,76.14,52.75,33.33
03,001,02,008,0489,1118,674 ,4 ,678 ,1279 ,0,3,1,3,0,1,0,76.14,53.01,33.33
03,001,02,008,0489,1119,660 ,1 ,661 ,1240 ,0,3,1,3,0,1,0,76.14,53.31,33.33
03,001,02,008,0489,1120,656 ,3 ,659 ,1343 ,0,3,1,3,0,1,0,76.14,49.07,33.33
03,001,02,008,0490,1121,792 ,7 ,799 ,1495 ,0,3,1,3,0,1,0,76.14,53.44,33.33
03,001,02,008,0490,1122,745 ,2 ,747 ,1524 ,0,3,1,3,0,1,0,76.14,49.02,33.33
03,001,02,008,0490,1123,747 ,5 ,752 ,1431 ,0,3,1,3,0,1,0,76.14,52.55,33.33
03,001,02,008,0491,1124,638 ,3 ,641 ,1174 ,0,3,1,3,0,1,0,76.14,54.6,33.33
03,001,02,008,0491,1125,664 ,3 ,667 ,1213 ,0,3,1,3,0,1,0,76.14,54.99,33.33
03,001,02,008,0492,1126,688 ,6 ,694 ,1264 ,0,3,1,3,0,1,0,76.14,54.91,33.33
03,001,02,008,0492,1127,638 ,6 ,644 ,1227 ,0,3,1,3,0,1,0,76.14,52.49,33.33
03,001,02,008,0493,1128,663 ,5 ,668 ,1317 ,0,3,1,3,0,1,0,76.14,50.72,33.33
03,001,02,008,0493,1129,591 ,7 ,598 ,1191 ,0,3,1,3,0,1,0,76.14,50.21,33.33
03,001,02,008,0494,1130,711 ,11 ,722 ,1374 ,0,3,1,3,0,1,0,76.14,52.55,33.33
03,001,02,008,0494,1131,661 ,7 ,668 ,1225 ,0,3,1,3,0,1,0,76.14,54.53,33.33
03,001,02,008,0494,1132,595 ,5 ,600 ,1173 ,0,3,1,3,0,1,0,76.14,51.15,33.33
03,001,02,008,0495,1133,733 ,2 ,735 ,1543 ,0,3,1,3,0,1,0,76.14,47.63,33.33
03,001,02,008,0495,1134,989 ,8 ,997 ,2075 ,0,3,1,3,0,1,0,76.14,48.05,33.33
03,001,02,008,0496,1135,741 ,6 ,747 ,1450 ,0,3,1,3,0,1,0,76.14,51.52,33.33
03,001,02,008,0496,1136,729 ,6 ,735 ,1434 ,0,3,1,3,0,1,0,76.14,51.26,33.33
03,001,02,008,0497,1137,699 ,5 ,704 ,1445 ,0,3,1,3,0,1,0,76.14,48.72,33.33
03,001,02,008,0497,1138,697 ,4 ,701 ,1471 ,0,3,1,3,0,1,0,76.14,47.65,33.33
03,001,02,008,0497,1139,752 ,6 ,758 ,1567 ,0,3,1,3,0,1,0,76.14,48.37,33.33
03,001,02,008,0498,1140,786 ,7 ,793 ,1485 ,0,3,1,3,0,1,0,76.14,53.4,33.33
03,001,02,008,0498,1141,736 ,6 ,742 ,1441 ,0,3,1,3,0,1,0,76.14,51.49,33.33
03,001,02,008,0499,1142,780 ,10 ,790 ,1490 ,0,3,1,3,0,1,0,76.14,53.02,33.33
03,001,02,008,0499,1143,713 ,7 ,720 ,1263 ,0,3,1,3,0,1,0,76.14,57.01,33.33
03,001,02,008,0500,1144,511 ,3 ,514 ,991 ,0,3,1,3,0,1,0,76.14,51.87,33.33
03,001,02,008,0500,1145,476 ,2 ,478 ,982 ,0,3,1,3,0,1,0,76.14,48.68,33.33
03,001,02,008,0501,1146,747 ,6 ,753 ,1337 ,0,3,1,3,0,1,0,76.14,56.32,33.33
03,001,02,008,0501,1147,738 ,7 ,745 ,1441 ,0,3,1,3,0,1,0,76.14,51.7,33.33
03,001,02,008,0502,1148,697 ,10 ,707 ,1248 ,0,3,1,3,0,1,0,76.14,56.65,33.33
03,001,02,008,0502,1149,844 ,16 ,860 ,1692 ,0,3,1,3,0,1,0,76.14,50.83,33.33
03,001,02,008,0502,1150,697 ,5 ,702 ,1331 ,0,3,1,3,0,1,0,76.14,52.74,33.33
03,001,02,009,0503,1151,711 ,4 ,715 ,1262 ,0,3,1,3,0,1,0,76.14,56.66,33.33
03,001,02,009,0503,1152,765 ,8 ,773 ,1355 ,0,3,1,3,0,1,0,76.14,57.05,33.33
03,001,02,009,0503,1153,729 ,6 ,735 ,1184 ,0,3,1,3,0,1,0,76.14,62.08,33.33
03,001,02,009,0504,1154,667 ,3 ,670 ,1116 ,0,3,1,3,0,1,0,76.14,60.04,33.33
03,001,02,009,0505,1155,659 ,4 ,663 ,1247 ,0,3,1,3,0,1,0,76.14,53.17,33.33
03,001,02,009,0505,1156,447 ,7 ,454 ,790 ,0,3,1,3,0,1,0,76.14,57.47,33.33
03,001,02,009,0505,1157,304 ,4 ,308 ,471 ,0,3,1,3,0,1,0,76.14,65.39,33.33
03,001,02,009,0506,1158,802 ,8 ,810 ,1469 ,0,3,1,3,0,1,0,76.14,55.14,33.33
03,001,02,009,0506,1159,704 ,10 ,714 ,1277 ,0,3,1,3,0,1,0,76.14,55.91,33.33
03,001,02,009,0507,1160,750 ,6 ,756 ,1270 ,0,3,1,3,0,1,0,76.14,59.53,33.33
03,001,02,009,0508,1161,851 ,4 ,855 ,1464 ,0,3,1,3,0,1,0,76.14,58.4,33.33
03,001,02,009,0508,1162,766 ,8 ,774 ,1342 ,0,3,1,3,0,1,0,76.14,57.68,33.33
03,001,02,009,0508,1163,693 ,7 ,700 ,1371 ,0,3,1,3,0,1,0,76.14,51.06,33.33
03,001,02,009,0509,1164,624 ,5 ,629 ,1166 ,0,3,1,3,0,1,0,76.14,53.95,33.33
03,001,02,009,0509,1165,563 ,6 ,569 ,1091 ,0,3,1,3,0,1,0,76.14,52.15,33.33
03,001,02,009,0510,1166,800 ,10 ,810 ,1507 ,0,3,1,3,0,1,0,76.14,53.75,33.33
03,001,02,009,0510,1167,748 ,5 ,753 ,1544 ,0,3,1,3,0,1,0,76.14,48.77,33.33
03,001,02,009,0511,1168,783 ,7 ,790 ,1419 ,0,3,1,3,0,1,0,76.14,55.67,33.33
03,001,02,009,0511,1169,767 ,8 ,775 ,1274 ,0,3,1,3,0,1,0,76.14,60.83,33.33
03,001,02,009,0512,1170,735 ,5 ,740 ,1168 ,0,3,1,3,0,1,0,76.14,63.36,33.33
03,001,02,009,0513,1171,800 ,7 ,807 ,1344 ,0,3,1,3,0,1,0,76.14,60.04,33.33
03,001,02,009,0513,1172,892 ,4 ,896 ,1486 ,0,3,1,3,0,1,0,76.14,60.3,33.33
03,001,02,009,0514,1173,741 ,3 ,744 ,1282 ,0,3,1,3,0,1,0,76.14,58.03,33.33
03,001,02,009,0514,1174,753 ,4 ,757 ,1318 ,0,3,1,3,0,1,0,76.14,57.44,33.33
03,001,02,009,0515,1175,805 ,7 ,812 ,1599 ,0,3,1,3,0,1,0,76.14,50.78,33.33
03,001,02,009,0515,1176,931 ,7 ,938 ,1619 ,0,3,1,3,0,1,0,76.14,57.94,33.33
03,001,02,009,0516,1177,789 ,4 ,793 ,1309 ,0,3,1,3,0,1,0,76.14,60.58,33.33
03,001,02,009,0516,1178,775 ,4 ,779 ,1254 ,0,3,1,3,0,1,0,76.14,62.12,33.33
03,001,02,009,0517,1179,689 ,5 ,694 ,1203 ,0,3,1,3,0,1,0,76.14,57.69,33.33
03,001,02,009,0517,1180,691 ,3 ,694 ,1185 ,0,3,1,3,0,1,0,76.14,58.57,33.33
03,001,02,009,0517,1181,714 ,6 ,720 ,1233 ,0,3,1,3,0,1,0,76.14,58.39,33.33
03,001,02,009,0518,1182,703 ,5 ,708 ,1220 ,0,3,1,3,0,1,0,76.14,58.03,33.33
03,001,02,009,0518,1183,660 ,6 ,666 ,1332 ,0,3,1,3,0,1,0,76.14,50,33.33
03,001,02,009,0518,1184,711 ,4 ,715 ,1270 ,0,3,1,3,0,1,0,76.14,56.3,33.33
03,001,02,009,0518,1185,685 ,8 ,693 ,1306 ,0,3,1,3,0,1,0,76.14,53.06,33.33
03,001,02,009,0519,1186,704 ,3 ,707 ,1358 ,0,3,1,3,0,1,0,76.14,52.06,33.33
03,001,02,009,0519,1187,837 ,4 ,841 ,1645 ,0,3,1,3,0,1,0,76.14,51.12,33.33
03,001,02,009,0519,1188,801 ,5 ,806 ,1751 ,0,3,1,3,0,1,0,76.14,46.03,33.33
03,001,02,009,0520,1189,1292 ,8 ,1300 ,1847 ,0,3,1,3,0,1,0,76.14,70.38,33.33
03,001,02,010,0521,1190,384 ,6 ,390 ,606 ,0,3,1,3,0,1,0,76.14,64.36,33.33
03,001,02,010,0521,1191,163 ,1 ,164 ,260 ,0,3,1,3,0,1,0,76.14,63.08,33.33
03,001,02,010,0522,1192,749 ,11 ,760 ,1297 ,0,3,1,3,0,1,0,76.14,58.6,33.33
03,001,02,010,0522,1193,533 ,2 ,535 ,1057 ,0,3,1,3,0,1,0,76.14,50.61,33.33
03,001,02,010,0522,1194,333 ,2 ,335 ,475 ,0,3,1,3,0,1,0,76.14,70.53,33.33
03,001,02,010,0523,1195,667 ,3 ,670 ,1228 ,0,3,1,3,0,1,0,76.14,54.56,33.33
03,001,02,010,0523,1196,685 ,4 ,689 ,1253 ,0,3,1,3,0,1,0,76.14,54.99,33.33
03,001,02,010,0523,1197,489 ,2 ,491 ,937 ,0,3,1,3,0,1,0,76.14,52.4,33.33
03,001,02,010,0523,1198,586 ,10 ,596 ,980 ,0,3,1,3,0,1,0,76.14,60.82,33.33
03,001,02,010,0524,1199,571 ,3 ,574 ,994 ,0,3,1,3,0,1,0,76.14,57.75,33.33
03,001,02,010,0524,1200,639 ,4 ,643 ,1032 ,0,3,1,3,0,1,0,76.14,62.31,33.33
03,001,02,010,0524,1201,702 ,4 ,706 ,1259 ,0,3,1,3,0,1,0,76.14,56.08,33.33
03,001,02,010,0524,1202,748 ,3 ,751 ,1360 ,0,3,1,3,0,1,0,76.14,55.22,33.33
03,001,02,010,0525,1203,578 ,3 ,581 ,958 ,0,3,1,3,0,1,0,76.14,60.65,33.33
03,001,02,010,0525,1204,455 ,2 ,457 ,777 ,0,3,1,3,0,1,0,76.14,58.82,33.33
03,001,02,010,0525,1205,582 ,3 ,585 ,917 ,0,3,1,3,0,1,0,76.14,63.79,33.33
03,001,02,010,0526,1206,754 ,13 ,767 ,1192 ,0,3,1,3,0,1,0,76.14,64.35,33.33
03,001,02,010,0526,1207,667 ,4 ,671 ,1133 ,0,3,1,3,0,1,0,76.14,59.22,33.33
03,001,02,010,0526,1208,470 ,7 ,477 ,821 ,0,3,1,3,0,1,0,76.14,58.1,33.33
03,001,02,010,0527,1209,658 ,8 ,666 ,1226 ,0,3,1,3,0,1,0,76.14,54.32,33.33
03,001,02,010,0527,1210,775 ,4 ,779 ,1376 ,0,3,1,3,0,1,0,76.14,56.61,33.33
03,001,02,010,0527,1211,719 ,4 ,723 ,1529 ,0,3,1,3,0,1,0,76.14,47.29,33.33
03,001,02,010,0528,1212,554 ,9 ,563 ,986 ,0,3,1,3,0,1,0,76.14,57.1,33.33
03,001,02,010,0528,1213,523 ,6 ,529 ,969 ,0,3,1,3,0,1,0,76.14,54.59,33.33
03,001,02,010,0528,1214,750 ,4 ,754 ,1250 ,0,3,1,3,0,1,0,76.14,60.32,33.33
03,001,02,010,0529,1215,822 ,6 ,828 ,1442 ,0,3,1,3,0,1,0,76.14,57.42,33.33
03,001,02,010,0529,1216,796 ,4 ,800 ,1436 ,0,3,1,3,0,1,0,76.14,55.71,33.33
03,001,02,010,0529,1217,741 ,7 ,748 ,1303 ,0,3,1,3,0,1,0,76.14,57.41,33.33
03,001,02,010,0530,1218,610 ,8 ,618 ,1055 ,0,3,1,3,0,1,0,76.14,58.58,33.33
03,001,02,010,0530,1219,532 ,5 ,537 ,919 ,0,3,1,3,0,1,0,76.14,58.43,33.33
03,001,02,010,0530,1220,599 ,2 ,601 ,975 ,0,3,1,3,0,1,0,76.14,61.64,33.33
03,001,02,010,0531,1221,563 ,7 ,570 ,935 ,0,3,1,3,0,1,0,76.14,60.96,33.33
03,001,02,010,0531,1222,516 ,5 ,521 ,877 ,0,3,1,3,0,1,0,76.14,59.41,33.33
03,001,02,010,0532,1223,811 ,5 ,816 ,1367 ,0,3,1,3,0,1,0,76.14,59.69,33.33
03,001,02,010,0532,1224,781 ,11 ,792 ,1345 ,0,3,1,3,0,1,0,76.14,58.88,33.33
03,001,02,010,0533,1225,591 ,4 ,595 ,1038 ,0,3,1,3,0,1,0,76.14,57.32,33.33
03,001,02,010,0533,1226,620 ,4 ,624 ,1041 ,0,3,1,3,0,1,0,76.14,59.94,33.33
03,001,02,010,0533,1227,587 ,5 ,592 ,1018 ,0,3,1,3,0,1,0,76.14,58.15,33.33
03,001,02,010,0534,1228,947 ,9 ,956 ,1474 ,0,3,1,3,0,1,0,76.14,64.86,33.33
03,001,02,010,0534,1229,911 ,5 ,916 ,1560 ,0,3,1,3,0,1,0,76.14,58.72,33.33
03,001,02,010,0535,1230,777 ,8 ,785 ,1344 ,0,3,1,3,0,1,0,76.14,58.41,33.33
03,001,02,010,0535,1231,767 ,2 ,769 ,1343 ,0,3,1,3,0,1,0,76.14,57.26,33.33
03,001,02,010,0535,1232,652 ,7 ,659 ,1188 ,0,3,1,3,0,1,0,76.14,55.47,33.33
03,001,02,011,0536,1233,639 ,6 ,645 ,1092 ,0,3,1,3,0,1,0,76.14,59.07,33.33
03,001,02,011,0536,1234,565 ,5 ,570 ,1027 ,0,3,1,3,0,1,0,76.14,55.5,33.33
03,001,02,011,0536,1235,713 ,8 ,721 ,1307 ,0,3,1,3,0,1,0,76.14,55.16,33.33
03,001,02,011,0537,1236,508 ,5 ,513 ,1092 ,0,3,1,3,0,1,0,76.14,46.98,33.33
03,001,02,011,0537,1237,696 ,9 ,705 ,1294 ,0,3,1,3,0,1,0,76.14,54.48,33.33
03,001,02,011,0537,1238,673 ,7 ,680 ,1094 ,0,3,1,3,0,1,0,76.14,62.16,33.33
03,001,02,011,0538,1239,625 ,2 ,627 ,1060 ,0,3,1,3,0,1,0,76.14,59.15,33.33
03,001,02,011,0538,1240,789 ,5 ,794 ,1405 ,0,3,1,3,0,1,0,76.14,56.51,33.33
03,001,02,011,0538,1241,499 ,3 ,502 ,843 ,0,3,1,3,0,1,0,76.14,59.55,33.33
03,001,02,011,0539,1242,1009 ,6 ,1015 ,1683 ,0,3,1,3,0,1,0,76.14,60.31,33.33
03,001,02,011,0539,1243,939 ,9 ,948 ,1578 ,0,3,1,3,0,1,0,76.14,60.08,33.33
03,001,02,011,0540,1244,759 ,6 ,765 ,1342 ,0,3,1,3,0,1,0,76.14,57,33.33
03,001,02,011,0540,1245,592 ,4 ,596 ,990 ,0,3,1,3,0,1,0,76.14,60.2,33.33
03,001,02,011,0541,1246,697 ,16 ,713 ,1101 ,0,3,1,3,0,1,0,76.14,64.76,33.33
03,001,02,011,0542,1247,749 ,11 ,760 ,1267 ,0,3,1,3,0,1,0,76.14,59.98,33.33
03,001,02,011,0543,1248,469 ,6 ,475 ,746 ,0,3,1,3,0,1,0,76.14,63.67,33.33
03,001,02,011,0544,1249,682 ,6 ,688 ,1345 ,0,3,1,3,0,1,0,76.14,51.15,33.33
03,001,02,011,0544,1250,540 ,6 ,546 ,1061 ,0,3,1,3,0,1,0,76.14,51.46,33.33
03,001,02,011,0544,1251,529 ,0 ,529 ,955 ,0,3,1,3,0,1,0,76.14,55.39,33.33
03,001,02,011,0545,1252,626 ,2 ,628 ,1269 ,0,3,1,3,0,1,0,76.14,49.49,33.33
03,001,02,011,0545,1253,776 ,6 ,782 ,1557 ,0,3,1,3,0,1,0,76.14,50.22,33.33
03,001,02,011,0545,1254,642 ,3 ,645 ,1189 ,0,3,1,3,0,1,0,76.14,54.25,33.33
03,001,02,011,0546,1255,674 ,9 ,683 ,1264 ,0,3,1,3,0,1,0,76.14,54.03,33.33
03,001,02,011,0546,1256,717 ,2 ,719 ,1247 ,0,3,1,3,0,1,0,76.14,57.66,33.33
03,001,02,011,0546,1257,782 ,4 ,786 ,1449 ,0,3,1,3,0,1,0,76.14,54.24,33.33
03,001,02,011,0547,1258,674 ,8 ,682 ,1314 ,0,3,1,3,0,1,0,76.14,51.9,33.33
03,001,02,011,0547,1259,765 ,7 ,772 ,1446 ,0,3,1,3,0,1,0,76.14,53.39,33.33
03,001,02,011,0548,1260,579 ,7 ,586 ,949 ,0,3,1,3,0,1,0,76.14,61.75,33.33
03,001,02,011,0549,1261,594 ,4 ,598 ,933 ,0,3,1,3,0,1,0,76.14,64.09,33.33
03,001,02,011,0550,1262,452 ,1 ,453 ,637 ,0,3,1,3,0,1,0,76.14,71.11,33.33
03,001,02,011,0551,1263,283 ,2 ,285 ,446 ,0,3,1,3,0,1,0,76.14,63.9,33.33
03,001,02,011,0552,1264,480 ,6 ,486 ,875 ,0,3,1,3,0,1,0,76.14,55.54,33.33
03,001,02,012,0553,1265,345 ,5 ,350 ,571 ,0,3,1,3,0,1,0,76.14,61.3,33.33
03,001,02,012,0554,1266,612 ,4 ,616 ,946 ,0,3,1,3,0,1,0,76.14,65.12,33.33
03,001,02,012,0555,1267,760 ,9 ,769 ,1339 ,0,3,1,3,0,1,0,76.14,57.43,33.33
03,001,02,012,0556,1268,848 ,9 ,857 ,1373 ,0,3,1,3,0,1,0,76.14,62.42,33.33
03,001,02,012,0557,1269,401 ,0 ,401 ,786 ,0,3,1,3,0,1,0,76.14,51.02,33.33
03,001,02,012,0558,1270,485 ,5 ,490 ,811 ,0,3,1,3,0,1,0,76.14,60.42,33.33
03,001,02,012,0559,1271,585 ,5 ,590 ,1061 ,0,3,1,3,0,1,0,76.14,55.61,33.33
03,001,02,012,0559,1272,576 ,5 ,581 ,1091 ,0,3,1,3,0,1,0,76.14,53.25,33.33
03,001,02,012,0560,1273,521 ,8 ,529 ,947 ,0,3,1,3,0,1,0,76.14,55.86,33.33
03,001,02,012,0560,1274,479 ,10 ,489 ,876 ,0,3,1,3,0,1,0,76.14,55.82,33.33
03,001,02,012,0561,1275,604 ,3 ,607 ,1008 ,0,3,1,3,0,1,0,76.14,60.22,33.33
03,001,02,012,0562,1276,480 ,2 ,482 ,781 ,0,3,1,3,0,1,0,76.14,61.72,33.33
03,001,02,012,0563,1277,575 ,9 ,584 ,1053 ,0,3,1,3,0,1,0,76.14,55.46,33.33
03,001,02,012,0564,1278,1104 ,3 ,1107 ,1950 ,0,3,1,3,0,1,0,76.14,56.77,33.33
03,001,02,012,0564,1279,747 ,6 ,753 ,1371 ,0,3,1,3,0,1,0,76.14,54.92,33.33
03,001,02,012,0564,1280,823 ,9 ,832 ,1406 ,0,3,1,3,0,1,0,76.14,59.17,33.33
03,001,02,012,0565,1281,927 ,5 ,932 ,1666 ,0,3,1,3,0,1,0,76.14,55.94,33.33
03,001,02,012,0565,1282,958 ,7 ,965 ,1693 ,0,3,1,3,0,1,0,76.14,57,33.33
03,001,02,012,0565,1283,849 ,7 ,856 ,1700 ,0,3,1,3,0,1,0,76.14,50.35,33.33
03,001,02,012,0565,1284,955 ,8 ,963 ,1691 ,0,3,1,3,0,1,0,76.14,56.95,33.33
03,001,02,012,0566,1285,751 ,6 ,757 ,1517 ,0,3,1,3,0,1,0,76.14,49.9,33.33
03,001,02,012,0566,1286,734 ,3 ,737 ,1414 ,0,3,1,3,0,1,0,76.14,52.12,33.33
03,001,02,012,0566,1287,708 ,5 ,713 ,1300 ,0,3,1,3,0,1,0,76.14,54.85,33.33
03,001,02,012,0567,1288,1126 ,11 ,1137 ,2119 ,0,3,1,3,0,1,0,76.14,53.66,33.33
03,001,02,012,0568,1289,784 ,3 ,787 ,1715 ,0,3,1,3,0,1,0,76.14,45.89,33.33
03,001,02,012,0568,1290,904 ,7 ,911 ,1730 ,0,3,1,3,0,1,0,76.14,52.66,33.33
03,001,02,012,0569,1291,758 ,6 ,764 ,1290 ,0,3,1,3,0,1,0,76.14,59.22,33.33
03,001,02,012,0570,1292,643 ,2 ,645 ,1060 ,0,3,1,3,0,1,0,76.14,60.85,33.33
03,001,02,012,0571,1293,794 ,8 ,802 ,1427 ,0,3,1,3,0,1,0,76.14,56.2,33.33
03,001,02,012,0571,1294,787 ,5 ,792 ,1487 ,0,3,1,3,0,1,0,76.14,53.26,33.33
03,001,02,012,0571,1295,692 ,5 ,697 ,1368 ,0,3,1,3,0,1,0,76.14,50.95,33.33
03,001,02,012,0571,1296,800 ,1 ,801 ,1590 ,0,3,1,3,0,1,0,76.14,50.38,33.33
03,001,02,012,0571,1297,821 ,5 ,826 ,1679 ,0,3,1,3,0,1,0,76.14,49.2,33.33
03,001,02,012,0571,1298,804 ,2 ,806 ,1532 ,0,3,1,3,0,1,0,76.14,52.61,33.33
03,001,02,012,0572,1299,865 ,5 ,870 ,1642 ,0,3,1,3,0,1,0,76.14,52.98,33.33
03,001,02,012,0572,1300,926 ,11 ,937 ,1772 ,0,3,1,3,0,1,0,76.14,52.88,33.33
03,001,02,012,0572,1301,780 ,5 ,785 ,1570 ,0,3,1,3,0,1,0,76.14,50,33.33
03,001,02,012,0572,1302,719 ,2 ,721 ,1503 ,0,3,1,3,0,1,0,76.14,47.97,33.33
03,001,02,012,0572,1303,812 ,5 ,817 ,1743 ,0,3,1,3,0,1,0,76.14,46.87,33.33
03,001,02,012,0572,1304,751 ,7 ,758 ,1500 ,0,3,1,3,0,1,0,76.14,50.53,33.33
03,001,02,012,0572,1305,732 ,4 ,736 ,1424 ,0,3,1,3,0,1,0,76.14,51.69,33.33
03,001,02,012,0572,1306,783 ,6 ,789 ,1498 ,0,3,1,3,0,1,0,76.14,52.67,33.33
03,001,02,012,0572,1307,904 ,3 ,907 ,1625 ,0,3,1,3,0,1,0,76.14,55.82,33.33
03,001,02,012,0573,1308,902 ,9 ,911 ,1679 ,0,3,1,3,0,1,0,76.14,54.26,33.33
03,001,02,012,0574,1309,880 ,9 ,889 ,1654 ,0,3,1,3,0,1,0,76.14,53.75,33.33
03,001,02,012,0574,1310,1002 ,8 ,1010 ,1892 ,0,3,1,3,0,1,0,76.14,53.38,33.33
03,001,02,012,0574,1311,951 ,4 ,955 ,1671 ,0,3,1,3,0,1,0,76.14,57.15,33.33
03,001,02,012,0574,1312,795 ,14 ,809 ,1707 ,0,3,1,3,0,1,0,76.14,47.39,33.33
03,001,02,012,0574,1313,901 ,12 ,913 ,1645 ,0,3,1,3,0,1,0,76.14,55.5,33.33
03,001,02,012,0574,1314,940 ,10 ,950 ,1738 ,0,3,1,3,0,1,0,76.14,54.66,33.33
03,001,02,012,0575,1315,601 ,3 ,604 ,1091 ,0,3,1,3,0,1,0,76.14,55.36,33.33
03,001,02,012,0575,1316,733 ,8 ,741 ,1306 ,0,3,1,3,0,1,0,76.14,56.74,33.33
03,001,02,012,0575,1317,663 ,15 ,678 ,1143 ,0,3,1,3,0,1,0,76.14,59.32,33.33
03,001,02,012,0576,1318,840 ,8 ,848 ,1472 ,0,3,1,3,0,1,0,76.14,57.61,33.33
03,001,02,012,0577,1319,583 ,11 ,594 ,1038 ,0,3,1,3,0,1,0,76.14,57.23,33.33
03,001,02,012,0578,1320,522 ,6 ,528 ,798 ,0,3,1,3,0,1,0,76.14,66.17,33.33
03,001,02,012,0579,1321,744 ,8 ,752 ,1341 ,0,3,1,3,0,1,0,76.14,56.08,33.33
03,001,02,012,0580,1322,482 ,6 ,488 ,733 ,0,3,1,3,0,1,0,76.14,66.58,33.33
03,001,02,012,0581,1323,458 ,3 ,461 ,728 ,0,3,1,3,0,1,0,76.14,63.32,33.33
03,001,02,012,0582,1324,289 ,3 ,292 ,674 ,0,3,1,3,0,1,0,76.14,43.32,33.33
03,001,02,012,0583,1325,861 ,9 ,870 ,1477 ,0,3,1,3,0,1,0,76.14,58.9,33.33
03,001,02,012,0584,1326,712 ,12 ,724 ,1194 ,0,3,1,3,0,1,0,76.14,60.64,33.33
03,001,02,012,0584,1327,701 ,2 ,703 ,1316 ,0,3,1,3,0,1,0,76.14,53.42,33.33
03,001,02,012,0584,1328,752 ,5 ,757 ,1245 ,0,3,1,3,0,1,0,76.14,60.8,33.33
03,001,02,012,0585,1329,926 ,7 ,933 ,1666 ,0,3,1,3,0,1,0,76.14,56,33.33
03,001,02,012,0585,1330,921 ,10 ,931 ,1647 ,0,3,1,3,0,1,0,76.14,56.53,33.33
03,001,02,012,0585,1331,876 ,10 ,886 ,1584 ,0,3,1,3,0,1,0,76.14,55.93,33.33
03,001,02,013,0586,1332,871 ,5 ,876 ,1621 ,0,3,1,3,0,1,0,76.14,54.04,33.33
03,001,02,013,0586,1333,819 ,5 ,824 ,1519 ,0,3,1,3,0,1,0,76.14,54.25,33.33
03,001,02,013,0586,1334,748 ,8 ,756 ,1280 ,0,3,1,3,0,1,0,76.14,59.06,33.33
03,001,02,013,0587,1335,628 ,7 ,635 ,1252 ,0,3,1,3,0,1,0,76.14,50.72,33.33
03,001,02,013,0587,1336,634 ,7 ,641 ,1017 ,0,3,1,3,0,1,0,76.14,63.03,33.33
03,001,02,013,0588,1337,901 ,10 ,911 ,1511 ,0,3,1,3,0,1,0,76.14,60.29,33.33
03,001,02,013,0589,1338,574 ,3 ,577 ,1144 ,0,3,1,3,0,1,0,76.14,50.44,33.33
03,001,02,013,0589,1339,772 ,8 ,780 ,1325 ,0,3,1,3,0,1,0,76.14,58.87,33.33
03,001,02,013,0590,1340,653 ,6 ,659 ,1133 ,0,3,1,3,0,1,0,76.14,58.16,33.33
03,001,02,013,0591,1341,723 ,9 ,732 ,1441 ,0,3,1,3,0,1,0,76.14,50.8,33.33
03,001,02,013,0591,1342,823 ,8 ,831 ,1588 ,0,3,1,3,0,1,0,76.14,52.33,33.33
03,001,02,013,0591,1343,724 ,6 ,730 ,1416 ,0,3,1,3,0,1,0,76.14,51.55,33.33
03,001,02,013,0592,1344,751 ,5 ,756 ,1340 ,0,3,1,3,0,1,0,76.14,56.42,33.33
03,001,02,013,0592,1345,655 ,4 ,659 ,1201 ,0,3,1,3,0,1,0,76.14,54.87,33.33
03,001,02,013,0593,1346,741 ,8 ,749 ,1296 ,0,3,1,3,0,1,0,76.14,57.79,33.33
03,001,02,013,0594,1347,761 ,3 ,764 ,1109 ,0,3,1,3,0,1,0,76.14,68.89,33.33
03,001,02,013,0595,1348,712 ,13 ,725 ,1065 ,0,3,1,3,0,1,0,76.14,68.08,33.33
03,001,02,014,0596,1349,217 ,1 ,218 ,353 ,0,3,1,3,0,1,0,76.14,61.76,33.33
03,001,02,014,0597,1350,712 ,3 ,715 ,1240 ,0,3,1,3,0,1,0,76.14,57.66,33.33
03,001,02,014,0597,1351,747 ,3 ,750 ,1286 ,0,3,1,3,0,1,0,76.14,58.32,33.33
03,001,02,014,0597,1352,616 ,4 ,620 ,1152 ,0,3,1,3,0,1,0,76.14,53.82,33.33
03,001,02,014,0598,1353,468 ,4 ,472 ,884 ,0,3,1,3,0,1,0,76.14,53.39,33.33
03,001,02,014,0599,1354,487 ,4 ,491 ,800 ,0,3,1,3,0,1,0,76.14,61.38,33.33
03,001,02,014,0600,1355,904 ,10 ,914 ,1766 ,0,3,1,3,0,1,0,76.14,51.76,33.33
03,001,02,014,0600,1356,869 ,4 ,873 ,1608 ,0,3,1,3,0,1,0,76.14,54.29,33.33
03,001,02,014,0600,1357,864 ,6 ,870 ,1702 ,0,3,1,3,0,1,0,76.14,51.12,33.33
03,001,02,014,0601,1358,261 ,4 ,265 ,459 ,0,3,1,3,0,1,0,76.14,57.73,33.33
03,001,02,014,0602,1359,354 ,4 ,358 ,529 ,0,3,1,3,0,1,0,76.14,67.67,33.33
03,001,02,014,0603,1360,466 ,4 ,470 ,764 ,0,3,1,3,0,1,0,76.14,61.52,33.33
03,001,02,014,0604,1361,851 ,7 ,858 ,1599 ,0,3,1,3,0,1,0,76.14,53.66,33.33
03,001,02,014,0605,1362,367 ,2 ,369 ,648 ,0,3,1,3,0,1,0,76.14,56.94,33.33
03,001,02,014,0606,1363,313 ,2 ,315 ,492 ,0,3,1,3,0,1,0,76.14,64.02,33.33
03,001,02,014,0607,1364,390 ,3 ,393 ,620 ,0,3,1,3,0,1,0,76.14,63.39,33.33
03,001,02,014,0608,1365,613 ,2 ,615 ,1109 ,0,3,1,3,0,1,0,76.14,55.46,33.33
03,001,02,015,0609,1366,524 ,4 ,528 ,895 ,0,3,1,3,0,1,0,76.14,58.99,33.33
03,001,02,015,0610,1367,682 ,6 ,688 ,1085 ,0,3,1,3,0,1,0,76.14,63.41,33.33
03,001,02,015,0611,1368,985 ,10 ,995 ,1790 ,0,3,1,3,0,1,0,76.14,55.59,33.33
03,001,02,015,0612,1369,411 ,2 ,413 ,726 ,0,3,1,3,0,1,0,76.14,56.89,33.33
03,001,02,015,0613,1370,729 ,9 ,738 ,1213 ,0,3,1,3,0,1,0,76.14,60.84,33.33
03,001,02,015,0614,1371,675 ,7 ,682 ,1240 ,0,3,1,3,0,1,0,76.14,55,33.33
03,001,02,015,0615,1372,155 ,1 ,156 ,300 ,0,3,1,3,0,1,0,76.14,52,33.33
03,001,02,015,0616,1373,301 ,3 ,304 ,499 ,0,3,1,3,0,1,0,76.14,60.92,33.33
03,001,02,015,0617,1374,464 ,8 ,472 ,763 ,0,3,1,3,0,1,0,76.14,61.86,33.33
03,001,02,016,0618,1375,304 ,0 ,304 ,443 ,0,3,1,3,0,1,0,76.14,68.62,33.33
03,001,02,016,0619,1376,406 ,6 ,412 ,635 ,0,3,1,3,0,1,0,76.14,64.88,33.33
03,001,02,016,0620,1377,292 ,0 ,292 ,470 ,0,3,1,3,0,1,0,76.14,62.13,33.33
03,001,02,016,0621,1378,915 ,3 ,918 ,1594 ,0,3,1,3,0,1,0,76.14,57.59,33.33
03,001,02,016,0622,1379,1100 ,9 ,1109 ,1848 ,0,3,1,3,0,1,0,76.14,60.01,33.33
03,001,02,016,0622,1380,962 ,8 ,970 ,1658 ,0,3,1,3,0,1,0,76.14,58.5,33.33
03,001,02,016,0622,1381,1024 ,8 ,1032 ,1810 ,0,3,1,3,0,1,0,76.14,57.02,33.33
03,001,02,016,0622,1382,946 ,6 ,952 ,1600 ,0,3,1,3,0,1,0,76.14,59.5,33.33
03,001,02,016,0623,1383,430 ,2 ,432 ,687 ,0,3,1,3,0,1,0,76.14,62.88,33.33
03,001,02,016,0623,1384,456 ,10 ,466 ,741 ,0,3,1,3,0,1,0,76.14,62.89,33.33
03,001,02,016,0624,1385,570 ,6 ,576 ,995 ,0,3,1,3,0,1,0,76.14,57.89,33.33
03,001,02,016,0625,1386,233 ,3 ,236 ,377 ,0,3,1,3,0,1,0,76.14,62.6,33.33
03,001,02,016,0626,1387,353 ,4 ,357 ,544 ,0,3,1,3,0,1,0,76.14,65.63,33.33
03,001,02,016,0627,1388,367 ,5 ,372 ,601 ,0,3,1,3,0,1,0,76.14,61.9,33.33
03,001,02,016,0628,1389,512 ,5 ,517 ,835 ,0,3,1,3,0,1,0,76.14,61.92,33.33
03,001,02,016,0629,1390,120 ,1 ,121 ,191 ,0,3,1,3,0,1,0,76.14,63.35,33.33
03,001,02,016,0630,1391,294 ,1 ,295 ,467 ,0,3,1,3,0,1,0,76.14,63.17,33.33
03,001,02,016,0631,1392,358 ,0 ,358 ,583 ,0,3,1,3,0,1,0,76.14,61.41,33.33
03,001,02,017,0632,1393,1024 ,3 ,1027 ,1663 ,0,3,1,3,0,1,0,76.14,61.76,33.33
03,001,02,017,0632,1394,840 ,7 ,847 ,1474 ,0,3,1,3,0,1,0,76.14,57.46,33.33
03,001,02,017,0633,1395,553 ,6 ,559 ,1020 ,0,3,1,3,0,1,0,76.14,54.8,33.33
03,001,02,017,0633,1396,480 ,9 ,489 ,929 ,0,3,1,3,0,1,0,76.14,52.64,33.33
03,001,02,017,0634,1397,272 ,5 ,277 ,581 ,0,3,1,3,0,1,0,76.14,47.68,33.33
03,001,02,017,0634,1398,626 ,13 ,639 ,1140 ,0,3,1,3,0,1,0,76.14,56.05,33.33
03,001,02,017,0635,1399,706 ,5 ,711 ,1266 ,0,3,1,3,0,1,0,76.14,56.16,33.33
03,001,02,017,0635,1400,658 ,3 ,661 ,1137 ,0,3,1,3,0,1,0,76.14,58.14,33.33
03,001,02,017,0636,1401,434 ,5 ,439 ,706 ,0,3,1,3,0,1,0,76.14,62.18,33.33
03,001,02,017,0636,1402,913 ,9 ,922 ,1489 ,0,3,1,3,0,1,0,76.14,61.92,33.33
03,001,02,017,0637,1403,307 ,4 ,311 ,469 ,0,3,1,3,0,1,0,76.14,66.31,33.33
03,001,02,017,0638,1404,464 ,5 ,469 ,779 ,0,3,1,3,0,1,0,76.14,60.21,33.33
03,001,02,017,0639,1405,301 ,1 ,302 ,528 ,0,3,1,3,0,1,0,76.14,57.2,33.33
03,001,02,017,0640,1406,298 ,4 ,302 ,554 ,0,3,1,3,0,1,0,76.14,54.51,33.33
03,001,02,017,0641,1407,463 ,4 ,467 ,807 ,0,3,1,3,0,1,0,76.14,57.87,33.33
03,001,03,018,0642,1408,888 ,8 ,896 ,1619 ,0,3,1,3,0,1,0,76.14,55.34 ,33.33
03,001,03,018,0642,1409,419 ,3 ,422 ,745 ,0,3,1,3,0,1,0,76.14,56.64 ,33.33
03,001,03,018,0642,1410,757 ,10 ,767 ,1503 ,0,3,1,3,0,1,0,76.14,51.03 ,33.33
03,001,03,018,0643,1411,446 ,3 ,449 ,815 ,0,3,1,3,0,1,0,76.14,55.09 ,33.33
03,001,03,018,0643,1412,225 ,0 ,225 ,339 ,0,3,1,3,0,1,0,76.14,66.37 ,33.33
03,001,03,018,0644,1413,1073 ,4 ,1077 ,1805 ,0,3,1,3,0,1,0,76.14,59.67 ,33.33
03,001,03,018,0644,1414,929 ,6 ,935 ,1401 ,0,3,1,3,0,1,0,76.14,66.74 ,33.33
03,001,03,018,0644,1415,1006 ,5 ,1011 ,1816 ,0,3,1,3,0,1,0,76.14,55.67 ,33.33
03,001,03,018,0645,1416,1033 ,2 ,1035 ,1728 ,0,3,1,3,0,1,0,76.14,59.90 ,33.33
03,001,03,018,0645,1417,895 ,3 ,898 ,1469 ,0,3,1,3,0,1,0,76.14,61.13 ,33.33
03,001,03,018,0645,1418,713 ,8 ,721 ,1151 ,0,3,1,3,0,1,0,76.14,62.64 ,33.33
03,001,03,018,0646,1419,548 ,4 ,552 ,940 ,0,3,1,3,0,1,0,76.14,58.72 ,33.33
03,001,03,018,0646,1420,728 ,5 ,733 ,1271 ,0,3,1,3,0,1,0,76.14,57.67 ,33.33
03,001,03,018,0647,1421,1219 ,6 ,1225 ,2008 ,0,3,1,3,0,1,0,76.14,61.01 ,33.33
03,001,03,018,0647,1422,960 ,6 ,966 ,1759 ,0,3,1,3,0,1,0,76.14,54.92 ,33.33
03,001,03,018,0648,1423,860 ,4 ,864 ,1434 ,0,3,1,3,0,1,0,76.14,60.25 ,33.33
03,001,03,018,0648,1424,927 ,8 ,935 ,1593 ,0,3,1,3,0,1,0,76.14,58.69 ,33.33
03,001,03,018,0649,1425,823 ,1 ,824 ,1324 ,0,3,1,3,0,1,0,76.14,62.24 ,33.33
03,001,03,018,0649,1426,895 ,3 ,898 ,1475 ,0,3,1,3,0,1,0,76.14,60.88 ,33.33
03,001,03,018,0650,1427,686 ,4 ,690 ,1155 ,0,3,1,3,0,1,0,76.14,59.74 ,33.33
03,001,03,018,0650,1428,680 ,6 ,686 ,1195 ,0,3,1,3,0,1,0,76.14,57.41 ,33.33
03,001,03,018,0650,1429,822 ,15 ,837 ,1493 ,0,3,1,3,0,1,0,76.14,56.06 ,33.33
03,001,03,018,0651,1430,892 ,6 ,898 ,1634 ,0,3,1,3,0,1,0,76.14,54.96 ,33.33
03,001,03,018,0651,1431,1023 ,10 ,1033 ,1748 ,0,3,1,3,0,1,0,76.14,59.10 ,33.33
03,001,03,018,0652,1432,965 ,11 ,976 ,1626 ,0,3,1,3,0,1,0,76.14,60.02 ,33.33
03,001,03,018,0652,1433,596 ,2 ,598 ,1043 ,0,3,1,3,0,1,0,76.14,57.33 ,33.33
03,001,03,018,0652,1434,535 ,7 ,542 ,886 ,0,3,1,3,0,1,0,76.14,61.17 ,33.33
03,001,03,018,0653,1435,987 ,7 ,994 ,1512 ,0,3,1,3,0,1,0,76.14,65.74 ,33.33
03,001,03,018,0653,1436,764 ,4 ,768 ,1304 ,0,3,1,3,0,1,0,76.14,58.90 ,33.33
03,001,03,018,0653,1437,669 ,8 ,677 ,1098 ,0,3,1,3,0,1,0,76.14,61.66 ,33.33
03,001,03,018,0654,1438,767 ,4 ,771 ,1257 ,0,3,1,3,0,1,0,76.14,61.34 ,33.33
03,001,03,018,0654,1439,609 ,3 ,612 ,1039 ,0,3,1,3,0,1,0,76.14,58.90 ,33.33
03,001,03,018,0654,1440,921 ,9 ,930 ,1605 ,0,3,1,3,0,1,0,76.14,57.94 ,33.33
03,001,03,018,0655,1441,517 ,10 ,527 ,971 ,0,3,1,3,0,1,0,76.14,54.27 ,33.33
03,001,03,018,0655,1442,834 ,7 ,841 ,1450 ,0,3,1,3,0,1,0,76.14,58.00 ,33.33
03,001,03,018,0655,1443,1028 ,6 ,1034 ,1769 ,0,3,1,3,0,1,0,76.14,58.45 ,33.33
03,001,03,018,0656,1444,895 ,6 ,901 ,1492 ,0,3,1,3,0,1,0,76.14,60.39 ,33.33
03,001,03,018,0656,1445,1017 ,6 ,1023 ,1750 ,0,3,1,3,0,1,0,76.14,58.46 ,33.33
03,001,03,018,0657,1446,944 ,7 ,951 ,1581 ,0,3,1,3,0,1,0,76.14,60.15 ,33.33
03,001,03,018,0657,1447,859 ,11 ,870 ,1428 ,0,3,1,3,0,1,0,76.14,60.92 ,33.33
03,001,03,018,0657,1448,616 ,4 ,620 ,1082 ,0,3,1,3,0,1,0,76.14,57.30 ,33.33
03,001,03,018,0658,1449,976 ,5 ,981 ,1706 ,0,3,1,3,0,1,0,76.14,57.50 ,33.33
03,001,03,018,0658,1450,848 ,5 ,853 ,1423 ,0,3,1,3,0,1,0,76.14,59.94 ,33.33
03,001,03,018,0658,1451,948 ,6 ,954 ,1538 ,0,3,1,3,0,1,0,76.14,62.03 ,33.33
03,001,03,018,0658,1452,929 ,2 ,931 ,1730 ,0,3,1,3,0,1,0,76.14,53.82 ,33.33
03,001,03,018,0659,1453,843 ,7 ,850 ,1415 ,0,3,1,3,0,1,0,76.14,60.07 ,33.33
03,001,03,018,0659,1454,778 ,6 ,784 ,1304 ,0,3,1,3,0,1,0,76.14,60.12 ,33.33
03,001,03,018,0659,1455,766 ,3 ,769 ,1386 ,0,3,1,3,0,1,0,76.14,55.48 ,33.33
03,001,03,018,0660,1456,1017 ,4 ,1021 ,1849 ,0,3,1,3,0,1,0,76.14,55.22 ,33.33
03,001,03,018,0660,1457,852 ,4 ,856 ,1478 ,0,3,1,3,0,1,0,76.14,57.92 ,33.33
03,001,03,018,0660,1458,841 ,4 ,845 ,1478 ,0,3,1,3,0,1,0,76.14,57.17 ,33.33
03,001,03,018,0660,1459,566 ,3 ,569 ,967 ,0,3,1,3,0,1,0,76.14,58.84 ,33.33
03,001,03,018,0660,1460,528 ,8 ,536 ,941 ,0,3,1,3,0,1,0,76.14,56.96 ,33.33
03,001,03,018,0661,1461,614 ,5 ,619 ,1067 ,0,3,1,3,0,1,0,76.14,58.01 ,33.33
03,001,03,018,0661,1462,770 ,7 ,777 ,1277 ,0,3,1,3,0,1,0,76.14,60.85 ,33.33
03,001,03,018,0661,1463,817 ,5 ,822 ,1258 ,0,3,1,3,0,1,0,76.14,65.34 ,33.33
03,001,03,018,0662,1464,785 ,4 ,789 ,1372 ,0,3,1,3,0,1,0,76.14,57.51 ,33.33
03,001,03,018,0662,1465,561 ,7 ,568 ,940 ,0,3,1,3,0,1,0,76.14,60.43 ,33.33
03,001,03,018,0662,1466,683 ,9 ,692 ,1226 ,0,3,1,3,0,1,0,76.14,56.44 ,33.33
03,001,03,018,0663,1467,1017 ,7 ,1024 ,1665 ,0,3,1,3,0,1,0,76.14,61.50 ,33.33
03,001,03,018,0663,1468,993 ,7 ,1000 ,1718 ,0,3,1,3,0,1,0,76.14,58.21 ,33.33
03,001,03,018,0664,1469,632 ,4 ,636 ,1015 ,0,3,1,3,0,1,0,76.14,62.66 ,33.33
03,001,03,018,0664,1470,683 ,9 ,692 ,1146 ,0,3,1,3,0,1,0,76.14,60.38 ,33.33
03,001,03,018,0665,1471,941 ,1 ,942 ,1367 ,0,3,1,3,0,1,0,76.14,68.91 ,33.33
03,001,03,018,0665,1472,1158 ,9 ,1167 ,1906 ,0,3,1,3,0,1,0,76.14,61.23 ,33.33
03,001,03,018,0666,1473,774 ,9 ,783 ,1366 ,0,3,1,3,0,1,0,76.14,57.32 ,33.33
03,001,03,018,0666,1474,771 ,13 ,784 ,1313 ,0,3,1,3,0,1,0,76.14,59.71 ,33.33
03,001,03,018,0667,1475,1026 ,6 ,1032 ,1570 ,0,3,1,3,0,1,0,76.14,65.73 ,33.33
03,001,03,018,0668,1476,855 ,8 ,863 ,1414 ,0,3,1,3,0,1,0,76.14,61.03 ,33.33
03,001,03,018,0668,1477,1102 ,5 ,1107 ,1687 ,0,3,1,3,0,1,0,76.14,65.62 ,33.33
03,001,03,018,0669,1478,841 ,6 ,847 ,1323 ,0,3,1,3,0,1,0,76.14,64.02 ,33.33
03,001,03,018,0669,1479,707 ,3 ,710 ,1187 ,0,3,1,3,0,1,0,76.14,59.81 ,33.33
03,001,03,018,0670,1480,733 ,3 ,736 ,1087 ,0,3,1,3,0,1,0,76.14,67.71 ,33.33
03,001,03,018,0670,1481,566 ,3 ,569 ,898 ,0,3,1,3,0,1,0,76.14,63.36 ,33.33
03,001,03,018,0670,1482,950 ,6 ,956 ,1524 ,0,3,1,3,0,1,0,76.14,62.73 ,33.33
03,001,03,018,0671,1483,704 ,9 ,713 ,1122 ,0,3,1,3,0,1,0,76.14,63.55 ,33.33
03,001,03,018,0671,1484,830 ,4 ,834 ,1249 ,0,3,1,3,0,1,0,76.14,66.77 ,33.33
03,001,03,018,0671,1485,1047 ,6 ,1053 ,1651 ,0,3,1,3,0,1,0,76.14,63.78 ,33.33
03,001,03,018,0672,1486,1084 ,1 ,1085 ,1637 ,0,3,1,3,0,1,0,76.14,66.28 ,33.33
03,001,03,018,0672,1487,1163 ,4 ,1167 ,1820 ,0,3,1,3,0,1,0,76.14,64.12 ,33.33
03,001,03,018,0673,1488,695 ,6 ,701 ,1127 ,0,3,1,3,0,1,0,76.14,62.20 ,33.33
03,001,03,018,0673,1489,560 ,5 ,565 ,939 ,0,3,1,3,0,1,0,76.14,60.17 ,33.33
03,001,03,018,0673,1490,762 ,4 ,766 ,1201 ,0,3,1,3,0,1,0,76.14,63.78 ,33.33
03,001,03,018,0674,1491,1082 ,9 ,1091 ,1873 ,0,3,1,3,0,1,0,76.14,58.25 ,33.33
03,001,03,018,0674,1492,1094 ,7 ,1101 ,1827 ,0,3,1,3,0,1,0,76.14,60.26 ,33.33
03,001,03,018,0675,1493,847 ,5 ,852 ,1430 ,0,3,1,3,0,1,0,76.14,59.58 ,33.33
03,001,03,018,0675,1494,899 ,6 ,905 ,1514 ,0,3,1,3,0,1,0,76.14,59.78 ,33.33
03,001,03,018,0676,1495,766 ,6 ,772 ,1247 ,0,3,1,3,0,1,0,76.14,61.91 ,33.33
03,001,03,018,0676,1496,738 ,7 ,745 ,1093 ,0,3,1,3,0,1,0,76.14,68.16 ,33.33
03,001,03,018,0677,1497,1138 ,7 ,1145 ,1809 ,0,3,1,3,0,1,0,76.14,63.29 ,33.33
03,001,03,018,0677,1498,627 ,10 ,637 ,985 ,0,3,1,3,0,1,0,76.14,64.67 ,33.33
03,001,03,018,0677,1499,824 ,6 ,830 ,1281 ,0,3,1,3,0,1,0,76.14,64.79 ,33.33
03,001,03,018,0678,1500,981 ,6 ,987 ,1717 ,0,3,1,3,0,1,0,76.14,57.48 ,33.33
03,001,03,018,0678,1501,954 ,8 ,962 ,1645 ,0,3,1,3,0,1,0,76.14,58.48 ,33.33
03,001,03,018,0678,1502,482 ,6 ,488 ,811 ,0,3,1,3,0,1,0,76.14,60.17 ,33.33
03,001,03,018,0678,1503,749 ,4 ,753 ,1131 ,0,3,1,3,0,1,0,76.14,66.58 ,33.33
03,001,03,018,0679,1504,742 ,2 ,744 ,1234 ,0,3,1,3,0,1,0,76.14,60.29 ,33.33
03,001,03,018,0679,1505,1204 ,11 ,1215 ,1946 ,0,3,1,3,0,1,0,76.14,62.44 ,33.33
03,001,03,018,0679,1506,453 ,1 ,454 ,905 ,0,3,1,3,0,1,0,76.14,50.17 ,33.33
03,001,03,018,0680,1507,854 ,4 ,858 ,1349 ,0,3,1,3,0,1,0,76.14,63.60 ,33.33
03,001,03,018,0680,1508,614 ,5 ,619 ,1023 ,0,3,1,3,0,1,0,76.14,60.51 ,33.33
03,001,03,018,0680,1509,600 ,6 ,606 ,1031 ,0,3,1,3,0,1,0,76.14,58.78 ,33.33
03,001,03,018,0681,1510,591 ,6 ,597 ,999 ,0,3,1,3,0,1,0,76.14,59.76 ,33.33
03,001,03,018,0681,1511,720 ,7 ,727 ,1176 ,0,3,1,3,0,1,0,76.14,61.82 ,33.33
03,001,03,018,0682,1512,669 ,7 ,676 ,1140 ,0,3,1,3,0,1,0,76.14,59.30 ,33.33
03,001,03,018,0682,1513,661 ,6 ,667 ,1122 ,0,3,1,3,0,1,0,76.14,59.45 ,33.33
03,001,03,018,0682,1514,754 ,2 ,756 ,1168 ,0,3,1,3,0,1,0,76.14,64.73 ,33.33
03,001,03,018,0683,1515,729 ,10 ,739 ,1219 ,0,3,1,3,0,1,0,76.14,60.62 ,33.33
03,001,03,018,0683,1516,685 ,4 ,689 ,1154 ,0,3,1,3,0,1,0,76.14,59.71 ,33.33
03,001,03,018,0684,1517,670 ,8 ,678 ,1172 ,0,3,1,3,0,1,0,76.14,57.85 ,33.33
03,001,03,018,0684,1518,559 ,6 ,565 ,925 ,0,3,1,3,0,1,0,76.14,61.08 ,33.33
03,001,03,018,0684,1519,641 ,5 ,646 ,1099 ,0,3,1,3,0,1,0,76.14,58.78 ,33.33
03,001,03,018,0685,1520,738 ,4 ,742 ,1185 ,0,3,1,3,0,1,0,76.14,62.62 ,33.33
03,001,03,018,0685,1521,885 ,5 ,890 ,1432 ,0,3,1,3,0,1,0,76.14,62.15 ,33.33
03,001,03,018,0686,1522,738 ,8 ,746 ,1451 ,0,3,1,3,0,1,0,76.14,51.41 ,33.33
03,001,03,018,0686,1523,760 ,3 ,763 ,1438 ,0,3,1,3,0,1,0,76.14,53.06 ,33.33
03,001,03,018,0686,1524,778 ,8 ,786 ,1356 ,0,3,1,3,0,1,0,76.14,57.96 ,33.33
03,001,03,018,0686,1525,718 ,4 ,722 ,1370 ,0,3,1,3,0,1,0,76.14,52.70 ,33.33
03,001,03,018,0687,1526,702 ,3 ,705 ,1039 ,0,3,1,3,0,1,0,76.14,67.85 ,33.33
03,001,03,018,0687,1527,881 ,4 ,885 ,1401 ,0,3,1,3,0,1,0,76.14,63.17 ,33.33
03,001,03,018,0687,1528,958 ,5 ,963 ,1447 ,0,3,1,3,0,1,0,76.14,66.55 ,33.33
03,001,03,018,0688,1529,1124 ,13 ,1137 ,1822 ,0,3,1,3,0,1,0,76.14,62.40 ,33.33
03,001,03,018,0688,1530,949 ,8 ,957 ,1545 ,0,3,1,3,0,1,0,76.14,61.94 ,33.33
03,001,03,018,0689,1531,509 ,6 ,515 ,891 ,0,3,1,3,0,1,0,76.14,57.80 ,33.33
03,001,03,018,0689,1532,536 ,5 ,541 ,877 ,0,3,1,3,0,1,0,76.14,61.69 ,33.33
03,001,03,018,0689,1533,810 ,8 ,818 ,1291 ,0,3,1,3,0,1,0,76.14,63.36 ,33.33
03,001,03,018,0689,1534,744 ,8 ,752 ,1344 ,0,3,1,3,0,1,0,76.14,55.95 ,33.33
03,001,03,018,0690,1535,904 ,0 ,904 ,1488 ,0,3,1,3,0,1,0,76.14,60.75 ,33.33
03,001,03,018,0690,1536,991 ,8 ,999 ,1596 ,0,3,1,3,0,1,0,76.14,62.59 ,33.33
03,001,03,018,0691,1537,871 ,8 ,879 ,1420 ,0,3,1,3,0,1,0,76.14,61.90 ,33.33
03,001,03,018,0691,1538,857 ,7 ,864 ,1429 ,0,3,1,3,0,1,0,76.14,60.46 ,33.33
03,001,03,018,0692,1539,706 ,3 ,709 ,1111 ,0,3,1,3,0,1,0,76.14,63.82 ,33.33
03,001,03,018,0692,1540,973 ,4 ,977 ,1627 ,0,3,1,3,0,1,0,76.14,60.05 ,33.33
03,001,03,018,0693,1541,557 ,2 ,559 ,875 ,0,3,1,3,0,1,0,76.14,63.89 ,33.33
03,001,03,018,0693,1542,694 ,4 ,698 ,1069 ,0,3,1,3,0,1,0,76.14,65.29 ,33.33
03,001,03,018,0694,1543,214 ,3 ,217 ,329 ,0,3,1,3,0,1,0,76.14,65.96 ,33.33
03,001,03,018,0695,1544,785 ,9 ,794 ,1324 ,0,3,1,3,0,1,0,76.14,59.97 ,33.33
03,001,03,018,0695,1545,781 ,4 ,785 ,1333 ,0,3,1,3,0,1,0,76.14,58.89 ,33.33
03,001,03,018,0695,1546,856 ,8 ,864 ,1510 ,0,3,1,3,0,1,0,76.14,57.22 ,33.33
03,001,03,018,0696,1547,909 ,7 ,916 ,1365 ,0,3,1,3,0,1,0,76.14,67.11 ,33.33
03,001,03,018,0696,1548,470 ,3 ,473 ,798 ,0,3,1,3,0,1,0,76.14,59.27 ,33.33
03,001,03,018,0697,1549,1005 ,10 ,1015 ,1622 ,0,3,1,3,0,1,0,76.14,62.58 ,33.33
03,001,03,018,0697,1550,934 ,8 ,942 ,1565 ,0,3,1,3,0,1,0,76.14,60.19 ,33.33
03,001,03,018,0698,1551,869 ,7 ,876 ,2205 ,0,3,1,3,0,1,0,76.14,39.73 ,33.33
03,001,03,018,0698,1552,1035 ,7 ,1042 ,1849 ,0,3,1,3,0,1,0,76.14,56.35 ,33.33
03,001,03,018,0699,1553,835 ,3 ,838 ,1445 ,0,3,1,3,0,1,0,76.14,57.99 ,33.33
03,001,03,018,0699,1554,649 ,5 ,654 ,1280 ,0,3,1,3,0,1,0,76.14,51.09 ,33.33
03,001,03,018,0699,1555,729 ,6 ,735 ,1172 ,0,3,1,3,0,1,0,76.14,62.71 ,33.33
03,001,03,018,0700,1556,660 ,10 ,670 ,1044 ,0,3,1,3,0,1,0,76.14,64.18 ,33.33
03,001,03,018,0700,1557,568 ,3 ,571 ,976 ,0,3,1,3,0,1,0,76.14,58.50 ,33.33
03,001,03,018,0701,1558,980 ,8 ,988 ,1658 ,0,3,1,3,0,1,0,76.14,59.59 ,33.33
03,001,03,018,0701,1559,863 ,6 ,869 ,1551 ,0,3,1,3,0,1,0,76.14,56.03 ,33.33
03,001,03,018,0701,1560,841 ,5 ,846 ,1393 ,0,3,1,3,0,1,0,76.14,60.73 ,33.33
03,001,03,018,0702,1561,1202 ,8 ,1210 ,1993 ,0,3,1,3,0,1,0,76.14,60.71 ,33.33
03,001,03,018,0702,1562,1051 ,12 ,1063 ,1737 ,0,3,1,3,0,1,0,76.14,61.20 ,33.33
03,001,03,018,0703,1563,1074 ,9 ,1083 ,1788 ,0,3,1,3,0,1,0,76.14,60.57 ,33.33
03,001,03,018,0703,1564,712 ,12 ,724 ,1230 ,0,3,1,3,0,1,0,76.14,58.86 ,33.33
03,001,03,018,0703,1565,572 ,4 ,576 ,943 ,0,3,1,3,0,1,0,76.14,61.08 ,33.33
03,001,03,018,0704,1566,941 ,5 ,946 ,1582 ,0,3,1,3,0,1,0,76.14,59.80 ,33.33
03,001,03,018,0704,1567,1001 ,10 ,1011 ,1583 ,0,3,1,3,0,1,0,76.14,63.87 ,33.33
03,001,03,018,0705,1568,915 ,15 ,930 ,1552 ,0,3,1,3,0,1,0,76.14,59.92 ,33.33
03,001,03,018,0705,1569,736 ,4 ,740 ,1204 ,0,3,1,3,0,1,0,76.14,61.46 ,33.33
03,001,03,018,0705,1570,908 ,12 ,920 ,1480 ,0,3,1,3,0,1,0,76.14,62.16 ,33.33
03,001,03,018,0706,1571,480 ,2 ,482 ,774 ,0,3,1,3,0,1,0,76.14,62.27 ,33.33
03,001,03,018,0706,1572,710 ,2 ,712 ,1170 ,0,3,1,3,0,1,0,76.14,60.85 ,33.33
03,001,03,018,0706,1573,811 ,8 ,819 ,1303 ,0,3,1,3,0,1,0,76.14,62.85 ,33.33
03,001,03,018,0706,1574,595 ,1 ,596 ,941 ,0,3,1,3,0,1,0,76.14,63.34 ,33.33
03,001,03,018,0707,1575,944 ,3 ,947 ,1543 ,0,3,1,3,0,1,0,76.14,61.37 ,33.33
03,001,03,018,0707,1576,664 ,7 ,671 ,1111 ,0,3,1,3,0,1,0,76.14,60.40 ,33.33
03,001,03,018,0708,1577,880 ,3 ,883 ,1427 ,0,3,1,3,0,1,0,76.14,61.88 ,33.33
03,001,03,018,0708,1578,766 ,5 ,771 ,1388 ,0,3,1,3,0,1,0,76.14,55.55 ,33.33
03,001,03,018,0709,1579,607 ,6 ,613 ,1166 ,0,3,1,3,0,1,0,76.14,52.57 ,33.33
03,001,03,018,0709,1580,1003 ,4 ,1007 ,1776 ,0,3,1,3,0,1,0,76.14,56.70 ,33.33
03,001,03,018,0709,1581,750 ,6 ,756 ,1296 ,0,3,1,3,0,1,0,76.14,58.33 ,33.33
03,001,03,018,0710,1582,840 ,11 ,851 ,1423 ,0,3,1,3,0,1,0,76.14,59.80 ,33.33
03,001,03,018,0711,1583,1099 ,9 ,1108 ,1854 ,0,3,1,3,0,1,0,76.14,59.76 ,33.33
03,001,03,018,0711,1584,790 ,6 ,796 ,1347 ,0,3,1,3,0,1,0,76.14,59.09 ,33.33
03,001,03,018,0712,1585,322 ,1 ,323 ,518 ,0,3,1,3,0,1,0,76.14,62.36 ,33.33
03,001,03,018,0713,1586,863 ,5 ,868 ,1469 ,0,3,1,3,0,1,0,76.14,59.09 ,33.33
03,001,03,018,0713,1587,893 ,14 ,907 ,1462 ,0,3,1,3,0,1,0,76.14,62.04 ,33.33
03,001,03,018,0713,1588,577 ,6 ,583 ,1048 ,0,3,1,3,0,1,0,76.14,55.63 ,33.33
03,001,03,018,0713,1589,352 ,1 ,353 ,584 ,0,3,1,3,0,1,0,76.14,60.45 ,33.33
03,001,03,018,0714,1590,724 ,6 ,730 ,1063 ,0,3,1,3,0,1,0,76.14,68.67 ,33.33
03,001,03,018,0714,1591,780 ,3 ,783 ,1177 ,0,3,1,3,0,1,0,76.14,66.53 ,33.33
03,001,03,018,0715,1592,814 ,5 ,819 ,1374 ,0,3,1,3,0,1,0,76.14,59.61 ,33.33
03,001,03,018,0715,1593,692 ,5 ,697 ,1184 ,0,3,1,3,0,1,0,76.14,58.87 ,33.33
03,001,03,018,0716,1594,738 ,11 ,749 ,1269 ,0,3,1,3,0,1,0,76.14,59.02 ,33.33
03,001,03,018,0716,1595,864 ,5 ,869 ,1552 ,0,3,1,3,0,1,0,76.14,55.99 ,33.33
03,001,03,018,0716,1596,437 ,2 ,439 ,781 ,0,3,1,3,0,1,0,76.14,56.21 ,33.33
03,001,03,018,0717,1597,357 ,10 ,367 ,1122 ,0,3,1,3,0,1,0,76.14,32.71 ,33.33
03,001,03,018,0717,1598,731 ,14 ,745 ,1435 ,0,3,1,3,0,1,0,76.14,51.92 ,33.33
03,001,03,018,0718,1599,756 ,8 ,764 ,1217 ,0,3,1,3,0,1,0,76.14,62.78 ,33.33
03,001,03,018,0718,1600,546 ,2 ,548 ,982 ,0,3,1,3,0,1,0,76.14,55.80 ,33.33
03,001,03,018,0719,1601,858 ,6 ,864 ,1565 ,0,3,1,3,0,1,0,76.14,55.21 ,33.33
03,001,03,018,0719,1602,891 ,6 ,897 ,1758 ,0,3,1,3,0,1,0,76.14,51.02 ,33.33
03,001,03,018,0720,1603,654 ,6 ,660 ,1235 ,0,3,1,3,0,1,0,76.14,53.44 ,33.33
03,001,03,018,0720,1604,919 ,4 ,923 ,1633 ,0,3,1,3,0,1,0,76.14,56.52 ,33.33
03,001,03,018,0720,1605,1053 ,2 ,1055 ,1765 ,0,3,1,3,0,1,0,76.14,59.77 ,33.33
03,001,03,018,0721,1606,806 ,10 ,816 ,1446 ,0,3,1,3,0,1,0,76.14,56.43 ,33.33
03,001,03,018,0721,1607,949 ,7 ,956 ,1664 ,0,3,1,3,0,1,0,76.14,57.45 ,33.33
03,001,03,018,0722,1608,820 ,7 ,827 ,1351 ,0,3,1,3,0,1,0,76.14,61.21 ,33.33
03,001,03,018,0722,1609,653 ,7 ,660 ,1137 ,0,3,1,3,0,1,0,76.14,58.05 ,33.33
03,001,03,018,0722,1610,772 ,9 ,781 ,1409 ,0,3,1,3,0,1,0,76.14,55.43 ,33.33
03,001,03,018,0723,1611,826 ,10 ,836 ,1370 ,0,3,1,3,0,1,0,76.14,61.02 ,33.33
03,001,03,018,0723,1612,1020 ,9 ,1029 ,1654 ,0,3,1,3,0,1,0,76.14,62.21 ,33.33
03,001,03,018,0724,1613,530 ,2 ,532 ,883 ,0,3,1,3,0,1,0,76.14,60.25 ,33.33
03,001,03,018,0724,1614,596 ,3 ,599 ,944 ,0,3,1,3,0,1,0,76.14,63.45 ,33.33
03,001,03,018,0725,1615,919 ,8 ,927 ,1621 ,0,3,1,3,0,1,0,76.14,57.19 ,33.33
03,001,03,018,0725,1616,853 ,8 ,861 ,1336 ,0,3,1,3,0,1,0,76.14,64.45 ,33.33
03,001,03,018,0726,1617,979 ,6 ,985 ,1625 ,0,3,1,3,0,1,0,76.14,60.62 ,33.33
03,001,03,018,0726,1618,1024 ,8 ,1032 ,1716 ,0,3,1,3,0,1,0,76.14,60.14 ,33.33
03,001,03,018,0727,1619,803 ,10 ,813 ,1394 ,0,3,1,3,0,1,0,76.14,58.32 ,33.33
03,001,03,018,0727,1620,762 ,7 ,769 ,1383 ,0,3,1,3,0,1,0,76.14,55.60 ,33.33
03,001,03,018,0728,1621,586 ,8 ,594 ,1110 ,0,3,1,3,0,1,0,76.14,53.51 ,33.33
03,001,03,018,0728,1622,821 ,9 ,830 ,1548 ,0,3,1,3,0,1,0,76.14,53.62 ,33.33
03,001,03,018,0728,1623,739 ,7 ,746 ,1339 ,0,3,1,3,0,1,0,76.14,55.71 ,33.33
03,001,03,018,0729,1624,865 ,6 ,871 ,1418 ,0,3,1,3,0,1,0,76.14,61.42 ,33.33
03,001,03,018,0729,1625,608 ,4 ,612 ,1160 ,0,3,1,3,0,1,0,76.14,52.76 ,33.33
03,001,03,018,0729,1626,613 ,2 ,615 ,1116 ,0,3,1,3,0,1,0,76.14,55.11 ,33.33
03,001,03,018,0730,1627,967 ,7 ,974 ,1641 ,0,3,1,3,0,1,0,76.14,59.35 ,33.33
03,001,03,018,0730,1628,1074 ,9 ,1083 ,1905 ,0,3,1,3,0,1,0,76.14,56.85 ,33.33
03,001,03,018,0731,1629,808 ,10 ,818 ,1477 ,0,3,1,3,0,1,0,76.14,55.38 ,33.33
03,001,03,018,0731,1630,993 ,7 ,1000 ,1681 ,0,3,1,3,0,1,0,76.14,59.49 ,33.33
03,001,03,018,0732,1631,614 ,7 ,621 ,1081 ,0,3,1,3,0,1,0,76.14,57.45 ,33.33
03,001,03,018,0732,1632,807 ,7 ,814 ,1518 ,0,3,1,3,0,1,0,76.14,53.62 ,33.33
03,001,03,018,0733,1633,496 ,1 ,497 ,856 ,0,3,1,3,0,1,0,76.14,58.06 ,33.33
03,001,03,018,0733,1634,901 ,2 ,903 ,1362 ,0,3,1,3,0,1,0,76.14,66.30 ,33.33
03,001,03,018,0733,1635,838 ,5 ,843 ,1253 ,0,3,1,3,0,1,0,76.14,67.28 ,33.33
03,001,03,018,0734,1636,1026 ,12 ,1038 ,1886 ,0,3,1,3,0,1,0,76.14,55.04 ,33.33
03,001,03,018,0734,1637,881 ,12 ,893 ,1463 ,0,3,1,3,0,1,0,76.14,61.04 ,33.33
03,001,03,019,0735,1638,910 ,3 ,913 ,1472 ,0,3,1,3,0,1,0,76.14,62.02 ,33.33
03,001,03,019,0736,1639,636 ,9 ,645 ,1054 ,0,3,1,3,0,1,0,76.14,61.20 ,33.33
03,001,03,019,0737,1640,546 ,6 ,552 ,892 ,0,3,1,3,0,1,0,76.14,61.88 ,33.33
03,001,03,019,0737,1641,747 ,4 ,751 ,1258 ,0,3,1,3,0,1,0,76.14,59.70 ,33.33
03,001,03,019,0738,1642,1023 ,9 ,1032 ,1678 ,0,3,1,3,0,1,0,76.14,61.50 ,33.33
03,001,03,019,0738,1643,1003 ,8 ,1011 ,1687 ,0,3,1,3,0,1,0,76.14,59.93 ,33.33
03,001,03,019,0739,1644,996 ,5 ,1001 ,1654 ,0,3,1,3,0,1,0,76.14,60.52 ,33.33
03,001,03,019,0739,1645,880 ,9 ,889 ,1527 ,0,3,1,3,0,1,0,76.14,58.22 ,33.33
03,001,03,019,0740,1646,982 ,6 ,988 ,1575 ,0,3,1,3,0,1,0,76.14,62.73 ,33.33
03,001,03,019,0740,1647,974 ,7 ,981 ,1588 ,0,3,1,3,0,1,0,76.14,61.78 ,33.33
03,001,03,019,0741,1648,959 ,6 ,965 ,1544 ,0,3,1,3,0,1,0,76.14,62.50 ,33.33
03,001,03,019,0741,1649,895 ,5 ,900 ,1519 ,0,3,1,3,0,1,0,76.14,59.25 ,33.33
03,001,03,019,0742,1650,688 ,7 ,695 ,1079 ,0,3,1,3,0,1,0,76.14,64.41 ,33.33
03,001,03,019,0743,1651,705 ,1 ,706 ,1078 ,0,3,1,3,0,1,0,76.14,65.49 ,33.33
03,001,03,019,0743,1652,860 ,2 ,862 ,1482 ,0,3,1,3,0,1,0,76.14,58.16 ,33.33
03,001,03,019,0744,1653,873 ,4 ,877 ,1469 ,0,3,1,3,0,1,0,76.14,59.70 ,33.33
03,001,03,019,0744,1654,856 ,4 ,860 ,1467 ,0,3,1,3,0,1,0,76.14,58.62 ,33.33
03,001,03,019,0745,1655,650 ,5 ,655 ,1096 ,0,3,1,3,0,1,0,76.14,59.76 ,33.33
03,001,03,019,0745,1656,564 ,7 ,571 ,946 ,0,3,1,3,0,1,0,76.14,60.36 ,33.33
03,001,03,019,0746,1657,941 ,6 ,947 ,1619 ,0,3,1,3,0,1,0,76.14,58.49 ,33.33
03,001,03,019,0746,1658,893 ,6 ,899 ,2285 ,0,3,1,3,0,1,0,76.14,39.34 ,33.33
03,001,03,019,0747,1659,826 ,3 ,829 ,1262 ,0,3,1,3,0,1,0,76.14,65.69 ,33.33
03,001,03,019,0747,1660,866 ,0 ,866 ,1413 ,0,3,1,3,0,1,0,76.14,61.29 ,33.33
03,001,03,019,0748,1661,730 ,7 ,737 ,1253 ,0,3,1,3,0,1,0,76.14,58.82 ,33.33
03,001,03,019,0748,1662,908 ,2 ,910 ,1596 ,0,3,1,3,0,1,0,76.14,57.02 ,33.33
03,001,03,019,0748,1663,700 ,3 ,703 ,1210 ,0,3,1,3,0,1,0,76.14,58.10 ,33.33
03,001,03,019,0749,1664,868 ,2 ,870 ,1386 ,0,3,1,3,0,1,0,76.14,62.77 ,33.33
03,001,03,019,0749,1665,787 ,8 ,795 ,1243 ,0,3,1,3,0,1,0,76.14,63.96 ,33.33
03,001,03,019,0749,1666,692 ,8 ,700 ,1135 ,0,3,1,3,0,1,0,76.14,61.67 ,33.33
03,001,03,019,0750,1667,946 ,6 ,952 ,1623 ,0,3,1,3,0,1,0,76.14,58.66 ,33.33
03,001,03,019,0750,1668,865 ,10 ,875 ,1473 ,0,3,1,3,0,1,0,76.14,59.40 ,33.33
03,001,03,019,0751,1669,799 ,7 ,806 ,1308 ,0,3,1,3,0,1,0,76.14,61.62 ,33.33
03,001,03,019,0751,1670,780 ,5 ,785 ,1260 ,0,3,1,3,0,1,0,76.14,62.30 ,33.33
03,001,03,019,0752,1671,851 ,2 ,853 ,1372 ,0,3,1,3,0,1,0,76.14,62.17 ,33.33
03,001,03,019,0752,1672,713 ,4 ,717 ,1176 ,0,3,1,3,0,1,0,76.14,60.97 ,33.33
03,001,03,019,0753,1673,1030 ,6 ,1036 ,1642 ,0,3,1,3,0,1,0,76.14,63.09 ,33.33
03,001,03,019,0753,1674,690 ,6 ,696 ,1169 ,0,3,1,3,0,1,0,76.14,59.54 ,33.33
03,001,03,019,0753,1675,665 ,3 ,668 ,1156 ,0,3,1,3,0,1,0,76.14,57.79 ,33.33
03,001,03,019,0754,1676,823 ,5 ,828 ,1359 ,0,3,1,3,0,1,0,76.14,60.93 ,33.33
03,001,03,019,0754,1677,740 ,7 ,747 ,1226 ,0,3,1,3,0,1,0,76.14,60.93 ,33.33
03,001,03,019,0754,1678,880 ,7 ,887 ,1463 ,0,3,1,3,0,1,0,76.14,60.63 ,33.33
03,001,03,019,0755,1679,774 ,6 ,780 ,1340 ,0,3,1,3,0,1,0,76.14,58.21 ,33.33
03,001,03,019,0755,1680,824 ,9 ,833 ,1403 ,0,3,1,3,0,1,0,76.14,59.37 ,33.33
03,001,03,019,0755,1681,670 ,2 ,672 ,1120 ,0,3,1,3,0,1,0,76.14,60.00 ,33.33
03,001,03,019,0756,1682,698 ,4 ,702 ,1169 ,0,3,1,3,0,1,0,76.14,60.05 ,33.33
03,001,03,019,0756,1683,893 ,3 ,896 ,1431 ,0,3,1,3,0,1,0,76.14,62.61 ,33.33
03,001,03,019,0756,1684,736 ,4 ,740 ,1181 ,0,3,1,3,0,1,0,76.14,62.66 ,33.33
03,001,03,019,0757,1685,994 ,10 ,1004 ,1678 ,0,3,1,3,0,1,0,76.14,59.83 ,33.33
03,001,03,019,0757,1686,928 ,10 ,938 ,1655 ,0,3,1,3,0,1,0,76.14,56.68 ,33.33
03,001,03,019,0758,1687,754 ,2 ,756 ,1274 ,0,3,1,3,0,1,0,76.14,59.34 ,33.33
03,001,03,019,0758,1688,762 ,8 ,770 ,1239 ,0,3,1,3,0,1,0,76.14,62.15 ,33.33
03,001,03,019,0759,1689,1039 ,8 ,1047 ,1690 ,0,3,1,3,0,1,0,76.14,61.95 ,33.33
03,001,03,019,0759,1690,808 ,4 ,812 ,1263 ,0,3,1,3,0,1,0,76.14,64.29 ,33.33
03,001,03,019,0760,1691,693 ,0 ,693 ,1150 ,0,3,1,3,0,1,0,76.14,60.26 ,33.33
03,001,03,019,0760,1692,662 ,6 ,668 ,1143 ,0,3,1,3,0,1,0,76.14,58.44 ,33.33
03,001,03,019,0761,1693,854 ,1 ,855 ,1387 ,0,3,1,3,0,1,0,76.14,61.64 ,33.33
03,001,03,019,0761,1694,804 ,2 ,806 ,1339 ,0,3,1,3,0,1,0,76.14,60.19 ,33.33
03,001,03,019,0762,1695,670 ,3 ,673 ,1079 ,0,3,1,3,0,1,0,76.14,62.37 ,33.33
03,001,03,019,0762,1696,695 ,3 ,698 ,1161 ,0,3,1,3,0,1,0,76.14,60.12 ,33.33
03,001,03,019,0762,1697,743 ,7 ,750 ,1181 ,0,3,1,3,0,1,0,76.14,63.51 ,33.33
03,001,03,019,0763,1698,708 ,4 ,712 ,1210 ,0,3,1,3,0,1,0,76.14,58.84 ,33.33
03,001,03,019,0763,1699,714 ,3 ,717 ,1316 ,0,3,1,3,0,1,0,76.14,54.48 ,33.33
03,001,03,019,0764,1700,810 ,3 ,813 ,1341 ,0,3,1,3,0,1,0,76.14,60.63 ,33.33
03,001,03,019,0764,1701,714 ,4 ,718 ,1164 ,0,3,1,3,0,1,0,76.14,61.68 ,33.33
03,001,03,019,0765,1702,1286 ,12 ,1298 ,2050 ,0,3,1,3,0,1,0,76.14,63.32 ,33.33
03,001,03,019,0765,1703,1076 ,5 ,1081 ,1787 ,0,3,1,3,0,1,0,76.14,60.49 ,33.33
03,001,03,019,0766,1704,760 ,10 ,770 ,1294 ,0,3,1,3,0,1,0,76.14,59.51 ,33.33
03,001,03,019,0766,1705,753 ,3 ,756 ,1329 ,0,3,1,3,0,1,0,76.14,56.88 ,33.33
03,001,03,019,0767,1706,885 ,6 ,891 ,1462 ,0,3,1,3,0,1,0,76.14,60.94 ,33.33
03,001,03,019,0767,1707,878 ,5 ,883 ,1474 ,0,3,1,3,0,1,0,76.14,59.91 ,33.33
03,001,03,019,0768,1708,1081 ,11 ,1092 ,1760 ,0,3,1,3,0,1,0,76.14,62.05 ,33.33
03,001,03,019,0768,1709,715 ,1 ,716 ,1180 ,0,3,1,3,0,1,0,76.14,60.68 ,33.33
03,001,03,019,0768,1710,648 ,5 ,653 ,1083 ,0,3,1,3,0,1,0,76.14,60.30 ,33.33
03,001,03,019,0769,1711,725 ,6 ,731 ,1179 ,0,3,1,3,0,1,0,76.14,62.00 ,33.33
03,001,03,019,0769,1712,759 ,3 ,762 ,1265 ,0,3,1,3,0,1,0,76.14,60.24 ,33.33
03,001,03,019,0769,1713,630 ,2 ,632 ,1101 ,0,3,1,3,0,1,0,76.14,57.40 ,33.33
03,001,03,019,0770,1714,905 ,5 ,910 ,1493 ,0,3,1,3,0,1,0,76.14,60.95 ,33.33
03,001,03,019,0770,1715,966 ,4 ,970 ,1707 ,0,3,1,3,0,1,0,76.14,56.82 ,33.33
03,001,03,019,0771,1716,662 ,0 ,662 ,1065 ,0,3,1,3,0,1,0,76.14,62.16 ,33.33
03,001,03,019,0771,1717,675 ,6 ,681 ,1100 ,0,3,1,3,0,1,0,76.14,61.91 ,33.33
03,001,03,019,0772,1718,1064 ,5 ,1069 ,1784 ,0,3,1,3,0,1,0,76.14,59.92 ,33.33
03,001,03,019,0772,1719,1047 ,6 ,1053 ,1747 ,0,3,1,3,0,1,0,76.14,60.27 ,33.33
03,001,03,019,0773,1720,624 ,2 ,626 ,1034 ,0,3,1,3,0,1,0,76.14,60.54 ,33.33
03,001,03,019,0773,1721,622 ,5 ,627 ,1044 ,0,3,1,3,0,1,0,76.14,60.06 ,33.33
03,001,03,019,0774,1722,1085 ,7 ,1092 ,1800 ,0,3,1,3,0,1,0,76.14,60.67 ,33.33
03,001,03,019,0774,1723,1044 ,11 ,1055 ,1664 ,0,3,1,3,0,1,0,76.14,63.40 ,33.33
03,001,03,019,0775,1724,716 ,5 ,721 ,1254 ,0,3,1,3,0,1,0,76.14,57.50 ,33.33
03,001,03,019,0775,1725,846 ,9 ,855 ,1349 ,0,3,1,3,0,1,0,76.14,63.38 ,33.33
03,001,03,019,0776,1726,994 ,8 ,1002 ,1715 ,0,3,1,3,0,1,0,76.14,58.43 ,33.33
03,001,03,019,0776,1727,1018 ,2 ,1020 ,1575 ,0,3,1,3,0,1,0,76.14,64.76 ,33.33
03,001,03,019,0777,1728,955 ,11 ,966 ,1602 ,0,3,1,3,0,1,0,76.14,60.30 ,33.33
03,001,03,019,0777,1729,977 ,5 ,982 ,1521 ,0,3,1,3,0,1,0,76.14,64.56 ,33.33
03,001,03,019,0778,1730,1066 ,7 ,1073 ,1750 ,0,3,1,3,0,1,0,76.14,61.31 ,33.33
03,001,03,019,0779,1731,1111 ,8 ,1119 ,1812 ,0,3,1,3,0,1,0,76.14,61.75 ,33.33
03,001,03,019,0779,1732,1141 ,6 ,1147 ,1866 ,0,3,1,3,0,1,0,76.14,61.47 ,33.33
03,001,03,019,0780,1733,628 ,7 ,635 ,1053 ,0,3,1,3,0,1,0,76.14,60.30 ,33.33
03,001,03,019,0780,1734,913 ,6 ,919 ,1497 ,0,3,1,3,0,1,0,76.14,61.39 ,33.33
03,001,03,019,0780,1735,815 ,7 ,822 ,1356 ,0,3,1,3,0,1,0,76.14,60.62 ,33.33
03,001,03,019,0781,1736,854 ,7 ,861 ,1428 ,0,3,1,3,0,1,0,76.14,60.29 ,33.33
03,001,03,019,0781,1737,783 ,7 ,790 ,1250 ,0,3,1,3,0,1,0,76.14,63.20 ,33.33
03,001,03,019,0781,1738,934 ,11 ,945 ,1517 ,0,3,1,3,0,1,0,76.14,62.29 ,33.33
03,001,03,019,0782,1739,1045 ,8 ,1053 ,1809 ,0,3,1,3,0,1,0,76.14,58.21 ,33.33
03,001,03,019,0782,1740,708 ,5 ,713 ,1128 ,0,3,1,3,0,1,0,76.14,63.21 ,33.33
03,001,03,019,0782,1741,747 ,3 ,750 ,1178 ,0,3,1,3,0,1,0,76.14,63.67 ,33.33
03,001,03,019,0782,1742,805 ,1 ,806 ,1315 ,0,3,1,3,0,1,0,76.14,61.29 ,33.33
03,001,03,019,0783,1743,967 ,7 ,974 ,1763 ,0,3,1,3,0,1,0,76.14,55.25 ,33.33
03,001,03,019,0783,1744,954 ,1 ,955 ,1635 ,0,3,1,3,0,1,0,76.14,58.41 ,33.33
03,001,03,019,0783,1745,1026 ,4 ,1030 ,1950 ,0,3,1,3,0,1,0,76.14,52.82 ,33.33
03,001,03,019,0784,1746,969 ,7 ,976 ,1550 ,0,3,1,3,0,1,0,76.14,62.97 ,33.33
03,001,03,019,0784,1747,1020 ,7 ,1027 ,1737 ,0,3,1,3,0,1,0,76.14,59.12 ,33.33
03,001,03,019,0785,1748,603 ,7 ,610 ,891 ,0,3,1,3,0,1,0,76.14,68.46 ,33.33
03,001,03,019,0786,1749,467 ,6 ,473 ,766 ,0,3,1,3,0,1,0,76.14,61.75 ,33.33
03,001,03,019,0787,1750,582 ,8 ,590 ,923 ,0,3,1,3,0,1,0,76.14,63.92 ,33.33
03,001,03,019,0788,1751,460 ,3 ,463 ,696 ,0,3,1,3,0,1,0,76.14,66.52 ,33.33
03,001,03,019,0789,1752,623 ,8 ,631 ,1047 ,0,3,1,3,0,1,0,76.14,60.27 ,33.33
03,001,03,019,0789,1753,851 ,6 ,857 ,1330 ,0,3,1,3,0,1,0,76.14,64.44 ,33.33
03,001,03,019,0790,1754,600 ,7 ,607 ,1003 ,0,3,1,3,0,1,0,76.14,60.52 ,33.33
03,001,03,019,0790,1755,696 ,4 ,700 ,1199 ,0,3,1,3,0,1,0,76.14,58.38 ,33.33
03,001,03,019,0791,1756,701 ,5 ,706 ,1134 ,0,3,1,3,0,1,0,76.14,62.26 ,33.33
03,001,03,019,0791,1757,632 ,6 ,638 ,1002 ,0,3,1,3,0,1,0,76.14,63.67 ,33.33
03,001,03,019,0792,1758,936 ,11 ,947 ,1606 ,0,3,1,3,0,1,0,76.14,58.97 ,33.33
03,001,03,019,0793,1759,398 ,5 ,403 ,692 ,0,3,1,3,0,1,0,76.14,58.24 ,33.33
03,001,03,019,0793,1760,613 ,2 ,615 ,1058 ,0,3,1,3,0,1,0,76.14,58.13 ,33.33
03,001,03,019,0794,1761,722 ,7 ,729 ,1171 ,0,3,1,3,0,1,0,76.14,62.25 ,33.33
03,001,03,019,0794,1762,642 ,3 ,645 ,1002 ,0,3,1,3,0,1,0,76.14,64.37 ,33.33
03,001,03,019,0795,1763,605 ,6 ,611 ,971 ,0,3,1,3,0,1,0,76.14,62.92 ,33.33
03,001,03,019,0795,1764,724 ,2 ,726 ,1221 ,0,3,1,3,0,1,0,76.14,59.46 ,33.33
03,001,03,019,0796,1765,575 ,8 ,583 ,947 ,0,3,1,3,0,1,0,76.14,61.56 ,33.33
03,001,03,019,0796,1766,755 ,3 ,758 ,1180 ,0,3,1,3,0,1,0,76.14,64.24 ,33.33
03,001,03,020,0797,1767,852 ,7 ,859 ,1465 ,0,3,1,3,0,1,0,76.14,58.63 ,33.33
03,001,03,020,0798,1768,659 ,3 ,662 ,1126 ,0,3,1,3,0,1,0,76.14,58.79 ,33.33
03,001,03,020,0799,1769,738 ,7 ,745 ,1337 ,0,3,1,3,0,1,0,76.14,55.72 ,33.33
03,001,03,020,0799,1770,511 ,4 ,515 ,907 ,0,3,1,3,0,1,0,76.14,56.78 ,33.33
03,001,03,020,0800,1771,839 ,9 ,848 ,1392 ,0,3,1,3,0,1,0,76.14,60.92 ,33.33
03,001,03,020,0801,1772,450 ,5 ,455 ,691 ,0,3,1,3,0,1,0,76.14,65.85 ,33.33
03,001,03,020,0802,1773,680 ,2 ,682 ,1038 ,0,3,1,3,0,1,0,76.14,65.70 ,33.33
03,001,03,020,0802,1774,717 ,2 ,719 ,1053 ,0,3,1,3,0,1,0,76.14,68.28 ,33.33
03,001,03,020,0803,1775,916 ,5 ,921 ,1385 ,0,3,1,3,0,1,0,76.14,66.50 ,33.33
03,001,03,020,0803,1776,354 ,2 ,356 ,1649 ,0,3,1,3,0,1,0,76.14,21.59 ,33.33
03,001,03,020,0803,1777,803 ,2 ,805 ,1276 ,0,3,1,3,0,1,0,76.14,63.09 ,33.33
03,001,03,020,0803,1778,748 ,2 ,750 ,1290 ,0,3,1,3,0,1,0,76.14,58.14 ,33.33
03,001,03,020,0804,1779,1102 ,2 ,1104 ,1652 ,0,3,1,3,0,1,0,76.14,66.83 ,33.33
03,001,03,020,0804,1780,978 ,3 ,981 ,1596 ,0,3,1,3,0,1,0,76.14,61.47 ,33.33
03,001,03,020,0804,1781,1038 ,6 ,1044 ,1647 ,0,3,1,3,0,1,0,76.14,63.39 ,33.33
03,001,03,020,0805,1782,684 ,5 ,689 ,1130 ,0,3,1,3,0,1,0,76.14,60.97 ,33.33
03,001,03,020,0805,1783,688 ,9 ,697 ,1146 ,0,3,1,3,0,1,0,76.14,60.82 ,33.33
03,001,03,020,0806,1784,749 ,9 ,758 ,1385 ,0,3,1,3,0,1,0,76.14,54.73 ,33.33
03,001,03,020,0806,1785,878 ,5 ,883 ,1450 ,0,3,1,3,0,1,0,76.14,60.90 ,33.33
03,001,03,020,0806,1786,817 ,2 ,819 ,1415 ,0,3,1,3,0,1,0,76.14,57.88 ,33.33
03,001,03,020,0806,1787,748 ,3 ,751 ,1233 ,0,3,1,3,0,1,0,76.14,60.91 ,33.33
03,001,03,020,0807,1788,868 ,6 ,874 ,1371 ,0,3,1,3,0,1,0,76.14,63.75 ,33.33
03,001,03,020,0807,1789,897 ,11 ,908 ,1557 ,0,3,1,3,0,1,0,76.14,58.32 ,33.33
03,001,03,020,0807,1790,922 ,5 ,927 ,1502 ,0,3,1,3,0,1,0,76.14,61.72 ,33.33
03,001,03,020,0807,1791,762 ,3 ,765 ,1364 ,0,3,1,3,0,1,0,76.14,56.09 ,33.33
03,001,03,020,0808,1792,655 ,2 ,657 ,1048 ,0,3,1,3,0,1,0,76.14,62.69 ,33.33
03,001,03,020,0808,1793,528 ,13 ,541 ,924 ,0,3,1,3,0,1,0,76.14,58.55 ,33.33
03,001,03,020,0809,1794,867 ,12 ,879 ,1417 ,0,3,1,3,0,1,0,76.14,62.03 ,33.33
03,001,03,020,0809,1795,912 ,2 ,914 ,1572 ,0,3,1,3,0,1,0,76.14,58.14 ,33.33
03,001,03,020,0810,1796,691 ,8 ,699 ,1129 ,0,3,1,3,0,1,0,76.14,61.91 ,33.33
03,001,03,020,0810,1797,670 ,1 ,671 ,1080 ,0,3,1,3,0,1,0,76.14,62.13 ,33.33
03,001,03,020,0811,1798,824 ,1 ,825 ,1308 ,0,3,1,3,0,1,0,76.14,63.07 ,33.33
03,001,03,020,0811,1799,893 ,3 ,896 ,1541 ,0,3,1,3,0,1,0,76.14,58.14 ,33.33
03,001,03,020,0811,1800,846 ,4 ,850 ,1397 ,0,3,1,3,0,1,0,76.14,60.84 ,33.33
03,001,03,020,0811,1801,704 ,7 ,711 ,1303 ,0,3,1,3,0,1,0,76.14,54.57 ,33.33
03,001,03,020,0812,1802,610 ,1 ,611 ,1045 ,0,3,1,3,0,1,0,76.14,58.47 ,33.33
03,001,03,020,0812,1803,707 ,3 ,710 ,1122 ,0,3,1,3,0,1,0,76.14,63.28 ,33.33
03,001,03,020,0812,1804,572 ,7 ,579 ,991 ,0,3,1,3,0,1,0,76.14,58.43 ,33.33
03,001,03,020,0813,1805,669 ,3 ,672 ,1120 ,0,3,1,3,0,1,0,76.14,60.00 ,33.33
03,001,03,020,0813,1806,575 ,5 ,580 ,938 ,0,3,1,3,0,1,0,76.14,61.83 ,33.33
03,001,03,020,0814,1807,640 ,4 ,644 ,1018 ,0,3,1,3,0,1,0,76.14,63.26 ,33.33
03,001,03,020,0814,1808,909 ,7 ,916 ,1494 ,0,3,1,3,0,1,0,76.14,61.31 ,33.33
03,001,03,020,0815,1809,615 ,1 ,616 ,953 ,0,3,1,3,0,1,0,76.14,64.64 ,33.33
03,001,03,020,0815,1810,703 ,1 ,704 ,1115 ,0,3,1,3,0,1,0,76.14,63.14 ,33.33
03,001,03,020,0815,1811,796 ,5 ,801 ,1281 ,0,3,1,3,0,1,0,76.14,62.53 ,33.33
03,001,03,020,0816,1812,795 ,1 ,796 ,1275 ,0,3,1,3,0,1,0,76.14,62.43 ,33.33
03,001,03,020,0816,1813,925 ,6 ,931 ,1554 ,0,3,1,3,0,1,0,76.14,59.91 ,33.33
03,001,03,020,0817,1814,832 ,9 ,841 ,1378 ,0,3,1,3,0,1,0,76.14,61.03 ,33.33
03,001,03,020,0817,1815,528 ,4 ,532 ,933 ,0,3,1,3,0,1,0,76.14,57.02 ,33.33
03,001,03,020,0817,1816,606 ,3 ,609 ,1023 ,0,3,1,3,0,1,0,76.14,59.53 ,33.33
03,001,03,020,0818,1817,749 ,5 ,754 ,1179 ,0,3,1,3,0,1,0,76.14,63.95 ,33.33
03,001,03,020,0818,1818,799 ,2 ,801 ,1317 ,0,3,1,3,0,1,0,76.14,60.82 ,33.33
03,001,03,020,0819,1819,1096 ,1 ,1097 ,1729 ,0,3,1,3,0,1,0,76.14,63.45 ,33.33
03,001,03,020,0819,1820,997 ,7 ,1004 ,1685 ,0,3,1,3,0,1,0,76.14,59.58 ,33.33
03,001,03,020,0820,1821,862 ,2 ,864 ,1413 ,0,3,1,3,0,1,0,76.14,61.15 ,33.33
03,001,03,020,0820,1822,1034 ,4 ,1038 ,1923 ,0,3,1,3,0,1,0,76.14,53.98 ,33.33
03,001,03,020,0821,1823,523 ,2 ,525 ,802 ,0,3,1,3,0,1,0,76.14,65.46 ,33.33
03,001,03,020,0822,1824,1122 ,4 ,1126 ,1806 ,0,3,1,3,0,1,0,76.14,62.35 ,33.33
03,001,03,020,0822,1825,1136 ,2 ,1138 ,1812 ,0,3,1,3,0,1,0,76.14,62.80 ,33.33
03,001,03,020,0823,1826,659 ,1 ,660 ,1016 ,0,3,1,3,0,1,0,76.14,64.96 ,33.33
03,001,03,020,0823,1827,543 ,2 ,545 ,936 ,0,3,1,3,0,1,0,76.14,58.23 ,33.33
03,001,03,020,0823,1828,623 ,2 ,625 ,1016 ,0,3,1,3,0,1,0,76.14,61.52 ,33.33
03,001,03,020,0824,1829,760 ,6 ,766 ,1219 ,0,3,1,3,0,1,0,76.14,62.84 ,33.33
03,001,03,020,0824,1830,637 ,3 ,640 ,1060 ,0,3,1,3,0,1,0,76.14,60.38 ,33.33
03,001,03,020,0824,1831,781 ,6 ,787 ,1291 ,0,3,1,3,0,1,0,76.14,60.96 ,33.33
03,001,03,020,0825,1832,953 ,4 ,957 ,1628 ,0,3,1,3,0,1,0,76.14,58.78 ,33.33
03,001,03,020,0825,1833,947 ,3 ,950 ,1555 ,0,3,1,3,0,1,0,76.14,61.09 ,33.33
03,001,03,020,0826,1834,1067 ,9 ,1076 ,1695 ,0,3,1,3,0,1,0,76.14,63.48 ,33.33
03,001,03,020,0826,1835,1054 ,2 ,1056 ,1623 ,0,3,1,3,0,1,0,76.14,65.06 ,33.33
03,001,03,020,0827,1836,782 ,0 ,782 ,1245 ,0,3,1,3,0,1,0,76.14,62.81 ,33.33
03,001,03,020,0827,1837,732 ,4 ,736 ,1174 ,0,3,1,3,0,1,0,76.14,62.69 ,33.33
03,001,03,020,0827,1838,855 ,2 ,857 ,1396 ,0,3,1,3,0,1,0,76.14,61.39 ,33.33
03,001,03,020,0828,1839,788 ,4 ,792 ,1448 ,0,3,1,3,0,1,0,76.14,54.70 ,33.33
03,001,03,020,0828,1840,881 ,5 ,886 ,1589 ,0,3,1,3,0,1,0,76.14,55.76 ,33.33
03,001,03,020,0829,1841,701 ,3 ,704 ,1150 ,0,3,1,3,0,1,0,76.14,61.22 ,33.33
03,001,03,020,0829,1842,813 ,3 ,816 ,1398 ,0,3,1,3,0,1,0,76.14,58.37 ,33.33
03,001,03,020,0829,1843,728 ,8 ,736 ,1246 ,0,3,1,3,0,1,0,76.14,59.07 ,33.33
03,001,03,020,0830,1844,664 ,5 ,669 ,1222 ,0,3,1,3,0,1,0,76.14,54.75 ,33.33
03,001,03,020,0830,1845,1043 ,5 ,1048 ,1772 ,0,3,1,3,0,1,0,76.14,59.14 ,33.33
03,001,03,020,0830,1846,931 ,5 ,936 ,1486 ,0,3,1,3,0,1,0,76.14,62.99 ,33.33
03,001,03,020,0831,1847,705 ,4 ,709 ,1144 ,0,3,1,3,0,1,0,76.14,61.98 ,33.33
03,001,03,020,0831,1848,1038 ,3 ,1041 ,1695 ,0,3,1,3,0,1,0,76.14,61.42 ,33.33
03,001,03,020,0831,1849,1045 ,6 ,1051 ,1716 ,0,3,1,3,0,1,0,76.14,61.25 ,33.33
03,001,03,020,0832,1850,764 ,4 ,768 ,1290 ,0,3,1,3,0,1,0,76.14,59.53 ,33.33
03,001,03,020,0832,1851,701 ,8 ,709 ,1158 ,0,3,1,3,0,1,0,76.14,61.23 ,33.33
03,001,03,020,0832,1852,961 ,4 ,965 ,1607 ,0,3,1,3,0,1,0,76.14,60.05 ,33.33
03,001,03,020,0832,1853,838 ,5 ,843 ,1434 ,0,3,1,3,0,1,0,76.14,58.79 ,33.33
03,001,03,020,0833,1854,1065 ,8 ,1073 ,1706 ,0,3,1,3,0,1,0,76.14,62.90 ,33.33
03,001,03,020,0833,1855,528 ,3 ,531 ,923 ,0,3,1,3,0,1,0,76.14,57.53 ,33.33
03,001,03,020,0834,1856,1296 ,4 ,1300 ,1906 ,0,3,1,3,0,1,0,76.14,68.21 ,33.33
03,001,03,020,0835,1857,797 ,16 ,813 ,1417 ,0,3,1,3,0,1,0,76.14,57.37 ,33.33
03,001,03,020,0835,1858,655 ,3 ,658 ,1108 ,0,3,1,3,0,1,0,76.14,59.39 ,33.33
03,001,03,020,0836,1859,675 ,3 ,678 ,1063 ,0,3,1,3,0,1,0,76.14,63.78 ,33.33
03,001,03,020,0836,1860,664 ,7 ,671 ,1046 ,0,3,1,3,0,1,0,76.14,64.15 ,33.33
03,001,03,020,0837,1861,727 ,4 ,731 ,1301 ,0,3,1,3,0,1,0,76.14,56.19 ,33.33
03,001,03,020,0838,1862,1074 ,10 ,1084 ,1803 ,0,3,1,3,0,1,0,76.14,60.12 ,33.33
03,001,03,020,0839,1863,783 ,7 ,790 ,1308 ,0,3,1,3,0,1,0,76.14,60.40 ,33.33
03,001,03,020,0839,1864,819 ,7 ,826 ,1410 ,0,3,1,3,0,1,0,76.14,58.58 ,33.33
03,001,03,020,0839,1865,908 ,5 ,913 ,1704 ,0,3,1,3,0,1,0,76.14,53.58 ,33.33
03,001,03,020,0839,1866,910 ,3 ,913 ,1603 ,0,3,1,3,0,1,0,76.14,56.96 ,33.33
03,001,03,020,0840,1867,880 ,9 ,889 ,1560 ,0,3,1,3,0,1,0,76.14,56.99 ,33.33
03,001,03,020,0840,1868,893 ,5 ,898 ,1531 ,0,3,1,3,0,1,0,76.14,58.65 ,33.33
03,001,03,020,0840,1869,768 ,6 ,774 ,1302 ,0,3,1,3,0,1,0,76.14,59.45 ,33.33
03,001,03,020,0841,1870,824 ,3 ,827 ,1453 ,0,3,1,3,0,1,0,76.14,56.92 ,33.33
03,001,03,020,0841,1871,779 ,7 ,786 ,1375 ,0,3,1,3,0,1,0,76.14,57.16 ,33.33
03,001,03,020,0841,1872,735 ,3 ,738 ,1230 ,0,3,1,3,0,1,0,76.14,60.00 ,33.33
03,001,03,020,0842,1873,952 ,4 ,956 ,1593 ,0,3,1,3,0,1,0,76.14,60.01 ,33.33
03,001,03,020,0842,1874,906 ,12 ,918 ,1525 ,0,3,1,3,0,1,0,76.14,60.20 ,33.33
03,001,03,020,0843,1875,595 ,3 ,598 ,1055 ,0,3,1,3,0,1,0,76.14,56.68 ,33.33
03,001,03,020,0843,1876,814 ,5 ,819 ,1304 ,0,3,1,3,0,1,0,76.14,62.81 ,33.33
03,001,03,020,0843,1877,936 ,4 ,940 ,1623 ,0,3,1,3,0,1,0,76.14,57.92 ,33.33
03,001,03,020,0844,1878,982 ,4 ,986 ,1735 ,0,3,1,3,0,1,0,76.14,56.83 ,33.33
03,001,03,020,0844,1879,940 ,0 ,940 ,1612 ,0,3,1,3,0,1,0,76.14,58.31 ,33.33
03,001,03,020,0844,1880,1014 ,6 ,1020 ,2019 ,0,3,1,3,0,1,0,76.14,50.52 ,33.33
03,001,03,020,0844,1881,882 ,9 ,891 ,1588 ,0,3,1,3,0,1,0,76.14,56.11 ,33.33
03,001,03,020,0845,1882,917 ,3 ,920 ,1528 ,0,3,1,3,0,1,0,76.14,60.21 ,33.33
03,001,03,020,0845,1883,935 ,4 ,939 ,1581 ,0,3,1,3,0,1,0,76.14,59.39 ,33.33
03,001,03,020,0846,1884,864 ,7 ,871 ,1438 ,0,3,1,3,0,1,0,76.14,60.57 ,33.33
03,001,03,020,0846,1885,891 ,5 ,896 ,1637 ,0,3,1,3,0,1,0,76.14,54.73 ,33.33
03,001,03,020,0846,1886,946 ,11 ,957 ,1667 ,0,3,1,3,0,1,0,76.14,57.41 ,33.33
03,001,03,020,0847,1887,773 ,1 ,774 ,1456 ,0,3,1,3,0,1,0,76.14,53.16 ,33.33
03,001,03,020,0847,1888,679 ,3 ,682 ,1226 ,0,3,1,3,0,1,0,76.14,55.63 ,33.33
03,001,03,020,0848,1889,854 ,1 ,855 ,1395 ,0,3,1,3,0,1,0,76.14,61.29 ,33.33
03,001,03,020,0848,1890,657 ,4 ,661 ,1149 ,0,3,1,3,0,1,0,76.14,57.53 ,33.33
03,001,03,020,0849,1891,747 ,5 ,752 ,1146 ,0,3,1,3,0,1,0,76.14,65.62 ,33.33
03,001,03,020,0849,1892,1046 ,4 ,1050 ,1621 ,0,3,1,3,0,1,0,76.14,64.77 ,33.33
03,001,03,020,0850,1893,558 ,1 ,559 ,1037 ,0,3,1,3,0,1,0,76.14,53.91 ,33.33
03,001,03,020,0850,1894,505 ,5 ,510 ,842 ,0,3,1,3,0,1,0,76.14,60.57 ,33.33
03,001,03,020,0850,1895,894 ,8 ,902 ,1570 ,0,3,1,3,0,1,0,76.14,57.45 ,33.33
03,001,03,020,0850,1896,665 ,5 ,670 ,1186 ,0,3,1,3,0,1,0,76.14,56.49 ,33.33
03,001,03,020,0851,1897,1016 ,5 ,1021 ,1841 ,0,3,1,3,0,1,0,76.14,55.46 ,33.33
03,001,03,020,0851,1898,693 ,1 ,694 ,1377 ,0,3,1,3,0,1,0,76.14,50.40 ,33.33
03,001,03,020,0851,1899,697 ,1 ,698 ,1376 ,0,3,1,3,0,1,0,76.14,50.73 ,33.33
03,001,03,020,0852,1900,912 ,10 ,922 ,1655 ,0,3,1,3,0,1,0,76.14,55.71 ,33.33
03,001,03,020,0852,1901,733 ,7 ,740 ,1298 ,0,3,1,3,0,1,0,76.14,57.01 ,33.33
03,001,03,020,0852,1902,762 ,8 ,770 ,1318 ,0,3,1,3,0,1,0,76.14,58.42 ,33.33
03,001,03,020,0853,1903,967 ,7 ,974 ,1626 ,0,3,1,3,0,1,0,76.14,59.90 ,33.33
03,001,03,020,0853,1904,876 ,8 ,884 ,1481 ,0,3,1,3,0,1,0,76.14,59.69 ,33.33
03,001,03,020,0853,1905,794 ,1 ,795 ,1338 ,0,3,1,3,0,1,0,76.14,59.42 ,33.33
03,001,03,020,0854,1906,587 ,2 ,589 ,997 ,0,3,1,3,0,1,0,76.14,59.08 ,33.33
03,001,03,020,0854,1907,711 ,1 ,712 ,1133 ,0,3,1,3,0,1,0,76.14,62.84 ,33.33
03,001,03,020,0854,1908,811 ,4 ,815 ,1345 ,0,3,1,3,0,1,0,76.14,60.59 ,33.33
03,001,03,020,0855,1909,457 ,3 ,460 ,730 ,0,3,1,3,0,1,0,76.14,63.01 ,33.33
03,001,03,020,0856,1910,896 ,4 ,900 ,1520 ,0,3,1,3,0,1,0,76.14,59.21 ,33.33
03,001,03,020,0857,1911,933 ,10 ,943 ,1626 ,0,3,1,3,0,1,0,76.14,58.00 ,33.33
03,001,03,020,0857,1912,652 ,1 ,653 ,1103 ,0,3,1,3,0,1,0,76.14,59.20 ,33.33
03,001,03,020,0857,1913,660 ,2 ,662 ,1233 ,0,3,1,3,0,1,0,76.14,53.69 ,33.33
03,001,03,020,0858,1914,801 ,6 ,807 ,1366 ,0,3,1,3,0,1,0,76.14,59.08 ,33.33
03,001,03,020,0858,1915,901 ,7 ,908 ,1634 ,0,3,1,3,0,1,0,76.14,55.57 ,33.33
03,001,03,020,0858,1916,664 ,5 ,669 ,1036 ,0,3,1,3,0,1,0,76.14,64.58 ,33.33
03,001,03,020,0859,1917,904 ,4 ,908 ,1580 ,0,3,1,3,0,1,0,76.14,57.47 ,33.33
03,001,03,020,0859,1918,901 ,6 ,907 ,1597 ,0,3,1,3,0,1,0,76.14,56.79 ,33.33
03,001,03,020,0860,1919,426 ,3 ,429 ,754 ,0,3,1,3,0,1,0,76.14,56.90 ,33.33
03,001,03,020,0861,1920,253 ,2 ,255 ,385 ,0,3,1,3,0,1,0,76.14,66.23 ,33.33
03,001,03,020,0861,1921,1027 ,7 ,1034 ,1730 ,0,3,1,3,0,1,0,76.14,59.77 ,33.33
03,001,03,020,0862,1922,630 ,3 ,633 ,1020 ,0,3,1,3,0,1,0,76.14,62.06 ,33.33
03,001,03,020,0862,1923,677 ,15 ,692 ,1218 ,0,3,1,3,0,1,0,76.14,56.81 ,33.33
03,001,03,020,0863,1924,768 ,7 ,775 ,1346 ,0,3,1,3,0,1,0,76.14,57.58 ,33.33
03,001,03,020,0864,1925,644 ,6 ,650 ,1090 ,0,3,1,3,0,1,0,76.14,59.63 ,33.33
03,001,03,020,0865,1926,241 ,1 ,242 ,410 ,0,3,1,3,0,1,0,76.14,59.02 ,33.33
03,001,03,020,0865,1927,224 ,1 ,225 ,350 ,0,3,1,3,0,1,0,76.14,64.29 ,33.33
03,001,03,021,0866,1928,485 ,1 ,486 ,923 ,0,3,1,3,0,1,0,76.14,52.65 ,33.33
03,001,03,021,0866,1929,545 ,7 ,552 ,958 ,0,3,1,3,0,1,0,76.14,57.62 ,33.33
03,001,03,021,0867,1930,564 ,5 ,569 ,998 ,0,3,1,3,0,1,0,76.14,57.01 ,33.33
03,001,03,021,0867,1931,422 ,4 ,426 ,857 ,0,3,1,3,0,1,0,76.14,49.71 ,33.33
03,001,03,021,0868,1932,571 ,10 ,581 ,1063 ,0,3,1,3,0,1,0,76.14,54.66 ,33.33
03,001,03,021,0868,1933,567 ,4 ,571 ,1031 ,0,3,1,3,0,1,0,76.14,55.38 ,33.33
03,001,03,021,0869,1934,787 ,3 ,790 ,1547 ,0,3,1,3,0,1,0,76.14,51.07 ,33.33
03,001,03,021,0870,1935,696 ,2 ,698 ,1238 ,0,3,1,3,0,1,0,76.14,56.38 ,33.33
03,001,03,021,0870,1936,672 ,7 ,679 ,1229 ,0,3,1,3,0,1,0,76.14,55.25 ,33.33
03,001,03,021,0871,1937,633 ,2 ,635 ,1233 ,0,3,1,3,0,1,0,76.14,51.50 ,33.33
03,001,03,021,0871,1938,591 ,2 ,593 ,1165 ,0,3,1,3,0,1,0,76.14,50.90 ,33.33
03,001,03,021,0871,1939,677 ,7 ,684 ,1296 ,0,3,1,3,0,1,0,76.14,52.78 ,33.33
03,001,03,021,0872,1940,833 ,9 ,842 ,1563 ,0,3,1,3,0,1,0,76.14,53.87 ,33.33
03,001,03,021,0873,1941,311 ,4 ,315 ,488 ,0,3,1,3,0,1,0,76.14,64.55 ,33.33
03,001,03,022,0874,1942,263 ,1 ,264 ,395 ,0,3,1,3,0,1,0,76.14,66.84 ,33.33
03,001,03,022,0875,1943,394 ,4 ,398 ,670 ,0,3,1,3,0,1,0,76.14,59.40 ,33.33
03,001,03,022,0876,1944,385 ,5 ,390 ,600 ,0,3,1,3,0,1,0,76.14,65.00 ,33.33
03,001,03,022,0877,1945,162 ,2 ,164 ,294 ,0,3,1,3,0,1,0,76.14,55.78 ,33.33
03,001,03,022,0878,1946,184 ,3 ,187 ,313 ,0,3,1,3,0,1,0,76.14,59.74 ,33.33
03,001,03,022,0878,1947,81 ,1 ,82 ,124 ,0,3,1,3,0,1,0,76.14,66.13 ,33.33
03,001,03,022,0879,1948,381 ,3 ,384 ,697 ,0,3,1,3,0,1,0,76.14,55.09 ,33.33
03,001,03,022,0880,1949,118 ,1 ,119 ,231 ,0,3,1,3,0,1,0,76.14,51.52 ,33.33
03,001,03,022,0881,1950,410 ,5 ,415 ,756 ,0,3,1,3,0,1,0,76.14,54.89 ,33.33
03,001,03,022,0882,1951,266 ,1 ,267 ,567 ,0,3,1,3,0,1,0,76.14,47.09 ,33.33
03,001,03,022,0883,1952,139 ,1 ,140 ,241 ,0,3,1,3,0,1,0,76.14,58.09 ,33.33
03,001,03,022,0884,1953,274 ,0 ,274 ,432 ,0,3,1,3,0,1,0,76.14,63.43 ,33.33
03,001,03,022,0885,1954,418 ,3 ,421 ,680 ,0,3,1,3,0,1,0,76.14,61.91 ,33.33
03,001,03,023,0886,1955,637 ,3 ,640 ,1024 ,0,3,1,3,0,1,0,76.14,62.50 ,33.33
03,001,03,023,0887,1956,346 ,6 ,352 ,564 ,0,3,1,3,0,1,0,76.14,62.41 ,33.33
03,001,03,023,0888,1957,530 ,3 ,533 ,964 ,0,3,1,3,0,1,0,76.14,55.29 ,33.33
03,001,03,023,0889,1958,210 ,1 ,211 ,381 ,0,3,1,3,0,1,0,76.14,55.38 ,33.33
03,001,03,023,0890,1959,277 ,5 ,282 ,499 ,0,3,1,3,0,1,0,76.14,56.51 ,33.33
03,001,03,023,0890,1960,131 ,0 ,131 ,212 ,0,3,1,3,0,1,0,76.14,61.79 ,33.33
03,001,03,023,0891,1961,191 ,0 ,191 ,312 ,0,3,1,3,0,1,0,76.14,61.22 ,33.33
03,001,03,023,0891,1962,237 ,2 ,239 ,401 ,0,3,1,3,0,1,0,76.14,59.60 ,33.33
03,001,03,023,0892,1963,191 ,0 ,191 ,365 ,0,3,1,3,0,1,0,76.14,52.33 ,33.33
03,001,03,023,0892,1964,220 ,2 ,222 ,411 ,0,3,1,3,0,1,0,76.14,54.01 ,33.33
03,001,03,024,0893,1965,368 ,2 ,370 ,626 ,0,3,1,3,0,1,0,76.14,59.11 ,33.33
03,001,03,024,0894,1966,603 ,7 ,610 ,1075 ,0,3,1,3,0,1,0,76.14,56.74 ,33.33
03,001,03,024,0895,1967,95 ,0 ,95 ,147 ,0,3,1,3,0,1,0,76.14,64.63 ,33.33
03,001,03,024,0896,1968,135 ,0 ,135 ,215 ,0,3,1,3,0,1,0,76.14,62.79 ,33.33
03,001,03,024,0897,1969,52 ,0 ,52 ,90 ,0,3,1,3,0,1,0,76.14,57.78 ,33.33
03,001,03,025,0898,1970,852 ,9 ,861 ,1527 ,0,3,1,3,0,1,0,76.14,56.39 ,33.33
03,001,03,025,0899,1971,672 ,6 ,678 ,1207 ,0,3,1,3,0,1,0,76.14,56.17 ,33.33
03,001,03,025,0900,1972,513 ,1 ,514 ,928 ,0,3,1,3,0,1,0,76.14,55.39 ,33.33
03,001,03,025,0901,1973,749 ,6 ,755 ,1442 ,0,3,1,3,0,1,0,76.14,52.36 ,33.33
03,001,03,025,0901,1974,757 ,2 ,759 ,1368 ,0,3,1,3,0,1,0,76.14,55.48 ,33.33
03,001,03,025,0902,1975,530 ,1 ,531 ,937 ,0,3,1,3,0,1,0,76.14,56.67 ,33.33
03,001,03,025,0902,1976,517 ,2 ,519 ,990 ,0,3,1,3,0,1,0,76.14,52.42 ,33.33
03,001,03,025,0903,1977,212 ,2 ,214 ,370 ,0,3,1,3,0,1,0,76.14,57.84 ,33.33
03,001,03,025,0904,1978,722 ,8 ,730 ,1357 ,0,3,1,3,0,1,0,76.14,53.80 ,33.33
03,001,03,025,0904,1979,800 ,1 ,801 ,1409 ,0,3,1,3,0,1,0,76.14,56.85 ,33.33
03,001,03,025,0904,1980,835 ,6 ,841 ,1551 ,0,3,1,3,0,1,0,76.14,54.22 ,33.33
03,001,03,025,0905,1981,618 ,6 ,624 ,1149 ,0,3,1,3,0,1,0,76.14,54.31 ,33.33
03,001,03,025,0905,1982,602 ,21 ,623 ,1222 ,0,3,1,3,0,1,0,76.14,50.98 ,33.33
03,001,03,025,0906,1983,463 ,3 ,466 ,869 ,0,3,1,3,0,1,0,76.14,53.62 ,33.33
03,001,03,025,0906,1984,519 ,3 ,522 ,977 ,0,3,1,3,0,1,0,76.14,53.43 ,33.33
03,001,03,025,0906,1985,631 ,3 ,634 ,1164 ,0,3,1,3,0,1,0,76.14,54.47 ,33.33
03,001,03,025,0907,1986,766 ,3 ,769 ,1350 ,0,3,1,3,0,1,0,76.14,56.96 ,33.33
03,001,03,025,0907,1987,808 ,8 ,816 ,1494 ,0,3,1,3,0,1,0,76.14,54.62 ,33.33
03,001,03,025,0908,1988,735 ,5 ,740 ,1731 ,0,3,1,3,0,1,0,76.14,42.75 ,33.33
03,001,03,025,0908,1989,960 ,7 ,967 ,1739 ,0,3,1,3,0,1,0,76.14,55.61 ,33.33
03,001,03,025,0908,1990,994 ,6 ,1000 ,1773 ,0,3,1,3,0,1,0,76.14,56.40 ,33.33
03,001,03,025,0909,1991,853 ,11 ,864 ,1629 ,0,3,1,3,0,1,0,76.14,53.04 ,33.33
03,001,03,025,0909,1992,890 ,5 ,895 ,1766 ,0,3,1,3,0,1,0,76.14,50.68 ,33.33
03,001,03,025,0910,1993,537 ,8 ,545 ,1059 ,0,3,1,3,0,1,0,76.14,51.46 ,33.33
03,001,03,025,0910,1994,909 ,9 ,918 ,1611 ,0,3,1,3,0,1,0,76.14,56.98 ,33.33
03,001,03,025,0911,1995,849 ,5 ,854 ,1525 ,0,3,1,3,0,1,0,76.14,56.00 ,33.33
03,001,03,025,0911,1996,863 ,6 ,869 ,1601 ,0,3,1,3,0,1,0,76.14,54.28 ,33.33
03,001,03,025,0912,1997,853 ,8 ,861 ,1642 ,0,3,1,3,0,1,0,76.14,52.44 ,33.33
03,001,03,025,0912,1998,763 ,9 ,772 ,1444 ,0,3,1,3,0,1,0,76.14,53.46 ,33.33
03,001,03,025,0913,1999,886 ,6 ,892 ,1611 ,0,3,1,3,0,1,0,76.14,55.37 ,33.33
03,001,03,025,0913,2000,798 ,6 ,804 ,1655 ,0,3,1,3,0,1,0,76.14,48.58 ,33.33
03,001,03,025,0914,2001,658 ,4 ,662 ,1233 ,0,3,1,3,0,1,0,76.14,53.69 ,33.33
03,001,03,025,0914,2002,529 ,3 ,532 ,946 ,0,3,1,3,0,1,0,76.14,56.24 ,33.33
03,001,03,025,0914,2003,915 ,6 ,921 ,1688 ,0,3,1,3,0,1,0,76.14,54.56 ,33.33
03,001,03,025,0914,2004,728 ,4 ,732 ,1302 ,0,3,1,3,0,1,0,76.14,56.22 ,33.33
03,001,03,025,0914,2005,907 ,6 ,913 ,1641 ,0,3,1,3,0,1,0,76.14,55.64 ,33.33
03,001,03,025,0914,2006,788 ,4 ,792 ,1493 ,0,3,1,3,0,1,0,76.14,53.05 ,33.33
03,001,03,025,0915,2007,757 ,6 ,763 ,1376 ,0,3,1,3,0,1,0,76.14,55.45 ,33.33
03,001,03,025,0916,2008,664 ,3 ,667 ,1245 ,0,3,1,3,0,1,0,76.14,53.57 ,33.33
03,001,03,025,0917,2009,280 ,0 ,280 ,490 ,0,3,1,3,0,1,0,76.14,57.14 ,33.33
03,001,03,025,0918,2010,585 ,6 ,591 ,1147 ,0,3,1,3,0,1,0,76.14,51.53 ,33.33
03,001,03,025,0918,2011,595 ,9 ,604 ,1144 ,0,3,1,3,0,1,0,76.14,52.80 ,33.33
03,001,03,025,0918,2012,705 ,10 ,715 ,1441 ,0,3,1,3,0,1,0,76.14,49.62 ,33.33
03,001,03,025,0919,2013,1014 ,16 ,1030 ,1663 ,0,3,1,3,0,1,0,76.14,61.94 ,33.33
03,001,03,025,0920,2014,643 ,133 ,776 ,1370 ,0,3,1,3,0,1,0,76.14,56.64 ,33.33
03,001,03,025,0920,2015,646 ,4 ,650 ,1158 ,0,3,1,3,0,1,0,76.14,56.13 ,33.33
03,001,03,025,0920,2016,803 ,5 ,808 ,1631 ,0,3,1,3,0,1,0,76.14,49.54 ,33.33
03,001,03,025,0921,2017,609 ,4 ,613 ,1258 ,0,3,1,3,0,1,0,76.14,48.73 ,33.33
03,001,03,025,0921,2018,474 ,0 ,474 ,1075 ,0,3,1,3,0,1,0,76.14,44.09 ,33.33
03,001,03,025,0921,2019,614 ,2 ,616 ,1159 ,0,3,1,3,0,1,0,76.14,53.15 ,33.33
03,001,03,025,0922,2020,670 ,6 ,676 ,1164 ,0,3,1,3,0,1,0,76.14,58.08 ,33.33
03,001,03,025,0923,2021,471 ,2 ,473 ,781 ,0,3,1,3,0,1,0,76.14,60.56 ,33.33
03,001,03,025,0924,2022,516 ,8 ,524 ,866 ,0,3,1,3,0,1,0,76.14,60.51 ,33.33
03,001,03,025,0925,2023,792 ,4 ,796 ,1542 ,0,3,1,3,0,1,0,76.14,51.62 ,33.33
03,001,03,025,0925,2024,857 ,8 ,865 ,1686 ,0,3,1,3,0,1,0,76.14,51.30 ,33.33
03,001,03,025,0926,2025,635 ,2 ,637 ,1311 ,0,3,1,3,0,1,0,76.14,48.59 ,33.33
03,001,03,025,0926,2026,532 ,6 ,538 ,1174 ,0,3,1,3,0,1,0,76.14,45.83 ,33.33
03,001,03,025,0926,2027,646 ,4 ,650 ,1268 ,0,3,1,3,0,1,0,76.14,51.26 ,33.33
03,001,03,025,0927,2028,833 ,8 ,841 ,1628 ,0,3,1,3,0,1,0,76.14,51.66 ,33.33
03,001,03,025,0928,2029,647 ,13 ,660 ,1253 ,0,3,1,3,0,1,0,76.14,52.67 ,33.33
03,001,03,025,0928,2030,719 ,10 ,729 ,1346 ,0,3,1,3,0,1,0,76.14,54.16 ,33.33
03,001,03,025,0928,2031,524 ,5 ,529 ,1182 ,0,3,1,3,0,1,0,76.14,44.75 ,33.33
03,001,03,025,0928,2032,666 ,3 ,669 ,1283 ,0,3,1,3,0,1,0,76.14,52.14 ,33.33
03,001,03,025,0929,2033,683 ,6 ,689 ,1403 ,0,3,1,3,0,1,0,76.14,49.11 ,33.33
03,001,03,025,0929,2034,681 ,2 ,683 ,1457 ,0,3,1,3,0,1,0,76.14,46.88 ,33.33
03,001,03,025,0929,2035,623 ,4 ,627 ,1288 ,0,3,1,3,0,1,0,76.14,48.68 ,33.33
03,001,03,025,0930,2036,349 ,4 ,353 ,815 ,0,3,1,3,0,1,0,76.14,43.31 ,33.33
03,001,03,025,0930,2037,364 ,1 ,365 ,754 ,0,3,1,3,0,1,0,76.14,48.41 ,33.33
03,001,03,025,0931,2038,799 ,6 ,805 ,1741 ,0,3,1,3,0,1,0,76.14,46.24 ,33.33
03,001,03,025,0931,2039,906 ,9 ,915 ,1803 ,0,3,1,3,0,1,0,76.14,50.75 ,33.33
03,001,03,025,0931,2040,765 ,4 ,769 ,1510 ,0,3,1,3,0,1,0,76.14,50.93 ,33.33
03,001,03,025,0932,2041,562 ,3 ,565 ,1099 ,0,3,1,3,0,1,0,76.14,51.41 ,33.33
03,001,03,025,0932,2042,522 ,1 ,523 ,1124 ,0,3,1,3,0,1,0,76.14,46.53 ,33.33
03,001,03,025,0933,2043,551 ,18 ,569 ,1051 ,0,3,1,3,0,1,0,76.14,54.14 ,33.33
03,001,03,025,0933,2044,535 ,4 ,539 ,1050 ,0,3,1,3,0,1,0,76.14,51.33 ,33.33
03,001,03,025,0934,2045,598 ,4 ,602 ,1202 ,0,3,1,3,0,1,0,76.14,50.08 ,33.33
03,001,03,025,0934,2046,534 ,2 ,536 ,1165 ,0,3,1,3,0,1,0,76.14,46.01 ,33.33
03,001,03,025,0935,2047,890 ,10 ,900 ,1786 ,0,3,1,3,0,1,0,76.14,50.39 ,33.33
03,001,03,025,0935,2048,874 ,4 ,878 ,1704 ,0,3,1,3,0,1,0,76.14,51.53 ,33.33
03,001,03,025,0935,2049,556 ,1 ,557 ,1105 ,0,3,1,3,0,1,0,76.14,50.41 ,33.33
03,001,03,025,0936,2050,798 ,3 ,801 ,1437 ,0,3,1,3,0,1,0,76.14,55.74 ,33.33
03,001,03,025,0936,2051,564 ,5 ,569 ,1014 ,0,3,1,3,0,1,0,76.14,56.11 ,33.33
03,001,03,025,0936,2052,789 ,2 ,791 ,1597 ,0,3,1,3,0,1,0,76.14,49.53 ,33.33
03,001,03,025,0937,2053,505 ,1 ,506 ,949 ,0,3,1,3,0,1,0,76.14,53.32 ,33.33
03,001,03,025,0937,2054,610 ,3 ,613 ,1215 ,0,3,1,3,0,1,0,76.14,50.45 ,33.33
03,001,03,025,0937,2055,1066 ,10 ,1076 ,1879 ,0,3,1,3,0,1,0,76.14,57.26 ,33.33
03,001,03,025,0938,2056,773 ,1 ,774 ,1376 ,0,3,1,3,0,1,0,76.14,56.25 ,33.33
03,001,03,025,0938,2057,740 ,5 ,745 ,1202 ,0,3,1,3,0,1,0,76.14,61.98 ,33.33
03,001,03,025,0939,2058,548 ,5 ,553 ,955 ,0,3,1,3,0,1,0,76.14,57.91 ,33.33
03,001,03,025,0940,2059,900 ,5 ,905 ,1560 ,0,3,1,3,0,1,0,76.14,58.01 ,33.33
03,001,03,025,0940,2060,756 ,7 ,763 ,1264 ,0,3,1,3,0,1,0,76.14,60.36 ,33.33
03,001,03,025,0940,2061,570 ,8 ,578 ,1069 ,0,3,1,3,0,1,0,76.14,54.07 ,33.33
03,001,03,025,0941,2062,723 ,1 ,724 ,1400 ,0,3,1,3,0,1,0,76.14,51.71 ,33.33
03,001,03,025,0941,2063,792 ,5 ,797 ,1440 ,0,3,1,3,0,1,0,76.14,55.35 ,33.33
03,001,03,025,0942,2064,750 ,7 ,757 ,1286 ,0,3,1,3,0,1,0,76.14,58.86 ,33.33
03,001,03,025,0942,2065,674 ,5 ,679 ,1096 ,0,3,1,3,0,1,0,76.14,61.95 ,33.33
03,001,03,025,0943,2066,584 ,5 ,589 ,1001 ,0,3,1,3,0,1,0,76.14,58.84 ,33.33
03,001,03,025,0943,2067,935 ,7 ,942 ,1641 ,0,3,1,3,0,1,0,76.14,57.40 ,33.33
03,001,03,026,0944,2068,457 ,3 ,460 ,777 ,0,3,1,3,0,1,0,76.14,59.20 ,33.33
03,001,03,026,0945,2069,559 ,2 ,561 ,918 ,0,3,1,3,0,1,0,76.14,61.11 ,33.33
03,001,03,026,0945,2070,463 ,4 ,467 ,754 ,0,3,1,3,0,1,0,76.14,61.94 ,33.33
03,001,03,026,0946,2071,764 ,2 ,766 ,1277 ,0,3,1,3,0,1,0,76.14,59.98 ,33.33
03,001,03,026,0947,2072,375 ,5 ,380 ,596 ,0,3,1,3,0,1,0,76.14,63.76 ,33.33
03,001,03,026,0948,2073,486 ,4 ,490 ,817 ,0,3,1,3,0,1,0,76.14,59.98 ,33.33
03,001,03,026,0948,2074,415 ,5 ,420 ,745 ,0,3,1,3,0,1,0,76.14,56.38 ,33.33
03,001,03,026,0949,2075,685 ,7 ,692 ,1264 ,0,3,1,3,0,1,0,76.14,54.75 ,33.33
03,001,03,026,0950,2076,835 ,6 ,841 ,1529 ,0,3,1,3,0,1,0,76.14,55.00 ,33.33
03,001,03,026,0950,2077,590 ,2 ,592 ,1048 ,0,3,1,3,0,1,0,76.14,56.49 ,33.33
03,001,03,026,0950,2078,574 ,3 ,577 ,961 ,0,3,1,3,0,1,0,76.14,60.04 ,33.33
03,001,03,026,0951,2079,671 ,5 ,676 ,1268 ,0,3,1,3,0,1,0,76.14,53.31 ,33.33
03,001,03,026,0951,2080,485 ,1 ,486 ,1093 ,0,3,1,3,0,1,0,76.14,44.46 ,33.33
03,001,03,026,0952,2081,603 ,5 ,608 ,1055 ,0,3,1,3,0,1,0,76.14,57.63 ,33.33
03,001,03,026,0952,2082,376 ,3 ,379 ,707 ,0,3,1,3,0,1,0,76.14,53.61 ,33.33
03,001,03,026,0953,2083,580 ,6 ,586 ,1064 ,0,3,1,3,0,1,0,76.14,55.08 ,33.33
03,001,03,026,0954,2084,160 ,2 ,162 ,288 ,0,3,1,3,0,1,0,76.14,56.25 ,33.33
03,001,03,026,0955,2085,296 ,4 ,300 ,484 ,0,3,1,3,0,1,0,76.14,61.98 ,33.33
03,001,03,026,0956,2086,225 ,1 ,226 ,340 ,0,3,1,3,0,1,0,76.14,66.47 ,33.33
03,001,03,026,0957,2087,83 ,0 ,83 ,109 ,0,3,1,3,0,1,0,76.14,76.15 ,33.33
03,001,03,026,0958,2088,449 ,4 ,453 ,832 ,0,3,1,3,0,1,0,76.14,54.45 ,33.33
03,001,03,026,0958,2089,384 ,4 ,388 ,781 ,0,3,1,3,0,1,0,76.14,49.68 ,33.33
03,001,03,026,0959,2090,541 ,6 ,547 ,927 ,0,3,1,3,0,1,0,76.14,59.01 ,33.33
03,001,03,026,0959,2091,408 ,2 ,410 ,838 ,0,3,1,3,0,1,0,76.14,48.93 ,33.33
03,001,03,026,0959,2092,579 ,4 ,583 ,1017 ,0,3,1,3,0,1,0,76.14,57.33 ,33.33
03,001,03,026,0960,2093,381 ,1 ,382 ,639 ,0,3,1,3,0,1,0,76.14,59.78 ,33.33
03,001,03,026,0960,2094,314 ,0 ,314 ,634 ,0,3,1,3,0,1,0,76.14,49.53 ,33.33
03,001,03,026,0961,2095,489 ,6 ,495 ,968 ,0,3,1,3,0,1,0,76.14,51.14 ,33.33
03,001,03,026,0961,2096,419 ,1 ,420 ,862 ,0,3,1,3,0,1,0,76.14,48.72 ,33.33
03,001,03,026,0962,2097,282 ,1 ,283 ,540 ,0,3,1,3,0,1,0,76.14,52.41 ,33.33
03,001,03,026,0963,2098,304 ,2 ,306 ,559 ,0,3,1,3,0,1,0,76.14,54.74 ,33.33
03,001,03,026,0964,2099,197 ,0 ,197 ,403 ,0,3,1,3,0,1,0,76.14,48.88 ,33.33
03,001,03,026,0965,2100,137 ,0 ,137 ,240 ,0,3,1,3,0,1,0,76.14,57.08 ,33.33
03,001,03,026,0966,2101,204 ,3 ,207 ,376 ,0,3,1,3,0,1,0,76.14,55.05 ,33.33
03,001,03,026,0967,2102,146 ,0 ,146 ,255 ,0,3,1,3,0,1,0,76.14,57.25 ,33.33
03,001,03,026,0968,2103,161 ,2 ,163 ,267 ,0,3,1,3,0,1,0,76.14,61.05 ,33.33
03,001,03,026,0969,2104,245 ,5 ,250 ,430 ,0,3,1,3,0,1,0,76.14,58.14 ,33.33
03,001,03,026,0970,2105,232 ,3 ,235 ,417 ,0,3,1,3,0,1,0,76.14,56.35 ,33.33
03,001,03,026,0971,2106,382 ,4 ,386 ,579 ,0,3,1,3,0,1,0,76.14,66.67 ,33.33
03,001,03,026,0972,2107,193 ,0 ,193 ,318 ,0,3,1,3,0,1,0,76.14,60.69 ,33.33
03,001,03,026,0973,2108,175 ,1 ,176 ,254 ,0,3,1,3,0,1,0,76.14,69.29 ,33.33
03,001,03,026,0974,2109,394 ,7 ,401 ,753 ,0,3,1,3,0,1,0,76.14,53.25 ,33.33
03,001,03,026,0975,2110,589 ,5 ,594 ,960 ,0,3,1,3,0,1,0,76.14,61.88 ,33.33
03,001,03,026,0976,2111,481 ,3 ,484 ,832 ,0,3,1,3,0,1,0,76.14,58.17 ,33.33
03,001,03,026,0976,2112,514 ,7 ,521 ,862 ,0,3,1,3,0,1,0,76.14,60.44 ,33.33
03,001,03,026,0977,2113,682 ,4 ,686 ,1109 ,0,3,1,3,0,1,0,76.14,61.86 ,33.33
03,001,03,027,0978,2114,262 ,3 ,265 ,436 ,0,3,1,3,0,1,0,76.14,60.78 ,33.33
03,001,03,027,0979,2115,179 ,3 ,182 ,305 ,0,3,1,3,0,1,0,76.14,59.67 ,33.33
03,001,03,027,0980,2116,181 ,1 ,182 ,272 ,0,3,1,3,0,1,0,76.14,66.91 ,33.33
03,001,03,027,0981,2117,355 ,8 ,363 ,555 ,0,3,1,3,0,1,0,76.14,65.41 ,33.33
03,001,03,027,0982,2118,177 ,3 ,180 ,271 ,0,3,1,3,0,1,0,76.14,66.42 ,33.33
03,001,03,027,0983,2119,423 ,1 ,424 ,677 ,0,3,1,3,0,1,0,76.14,62.63 ,33.33
03,001,03,027,0984,2120,280 ,2 ,282 ,421 ,0,3,1,3,0,1,0,76.14,66.98 ,33.33
03,001,03,027,0985,2121,601 ,5 ,606 ,988 ,0,3,1,3,0,1,0,76.14,61.34 ,33.33
03,001,03,027,0986,2122,73 ,0 ,73 ,147 ,0,3,1,3,0,1,0,76.14,49.66 ,33.33
03,001,03,027,0987,2123,254 ,0 ,254 ,479 ,0,3,1,3,0,1,0,76.14,53.03 ,33.33
03,001,03,027,0988,2124,105 ,0 ,105 ,183 ,0,3,1,3,0,1,0,76.14,57.38 ,33.33
03,001,03,027,0989,2125,89 ,0 ,89 ,160 ,0,3,1,3,0,1,0,76.14,55.63 ,33.33
03,001,03,028,0990,2126,313 ,4 ,317 ,544 ,0,3,1,3,0,1,0,76.14,58.27 ,33.33
03,001,03,028,0991,2127,175 ,1 ,176 ,308 ,0,3,1,3,0,1,0,76.14,57.14 ,33.33
03,001,03,028,0991,2128,361 ,6 ,367 ,588 ,0,3,1,3,0,1,0,76.14,62.41 ,33.33
03,001,03,028,0992,2129,252 ,2 ,254 ,466 ,0,3,1,3,0,1,0,76.14,54.51 ,33.33
03,001,03,028,0993,2130,550 ,6 ,556 ,1034 ,0,3,1,3,0,1,0,76.14,53.77 ,33.33
03,001,03,028,0993,2131,445 ,3 ,448 ,773 ,0,3,1,3,0,1,0,76.14,57.96 ,33.33
03,001,03,028,0994,2132,201 ,1 ,202 ,343 ,0,3,1,3,0,1,0,76.14,58.89 ,33.33
03,001,03,028,0995,2133,415 ,3 ,418 ,659 ,0,3,1,3,0,1,0,76.14,63.43 ,33.33
03,001,03,028,0995,2134,154 ,1 ,155 ,288 ,0,3,1,3,0,1,0,76.14,53.82 ,33.33
03,001,03,028,0996,2135,385 ,4 ,389 ,710 ,0,3,1,3,0,1,0,76.14,54.79 ,33.33
03,001,03,028,0997,2136,279 ,1 ,280 ,486 ,0,3,1,3,0,1,0,76.14,57.61 ,33.33
03,001,03,028,0998,2137,257 ,5 ,262 ,406 ,0,3,1,3,0,1,0,76.14,64.53 ,33.33
03,001,03,028,0999,2138,99 ,1 ,100 ,147 ,0,3,1,3,0,1,0,76.14,68.03 ,33.33
03,001,03,028,0999,2139,173 ,2 ,175 ,323 ,0,3,1,3,0,1,0,76.14,54.18 ,33.33
03,001,03,028,1000,2140,192 ,2 ,194 ,335 ,0,3,1,3,0,1,0,76.14,57.91 ,33.33
03,001,03,028,1000,2141,179 ,1 ,180 ,306 ,0,3,1,3,0,1,0,76.14,58.82 ,33.33
03,001,03,028,1001,2142,194 ,0 ,194 ,391 ,0,3,1,3,0,1,0,76.14,49.62 ,33.33
03,001,03,028,1001,2143,85 ,0 ,85 ,147 ,0,3,1,3,0,1,0,76.14,57.82 ,33.33
03,001,03,029,1002,2144,555 ,8 ,563 ,919 ,0,3,1,3,0,1,0,76.14,61.26 ,33.33
03,001,03,029,1003,2145,256 ,4 ,260 ,439 ,0,3,1,3,0,1,0,76.14,59.23 ,33.33
03,001,03,029,1004,2146,272 ,3 ,275 ,494 ,0,3,1,3,0,1,0,76.14,55.67 ,33.33
03,001,03,029,1005,2147,193 ,0 ,193 ,415 ,0,3,1,3,0,1,0,76.14,46.51 ,33.33
03,001,03,029,1005,2148,211 ,0 ,211 ,340 ,0,3,1,3,0,1,0,76.14,62.06 ,33.33
03,001,03,029,1006,2149,551 ,4 ,555 ,1016 ,0,3,1,3,0,1,0,76.14,54.63 ,33.33
03,001,03,029,1006,2150,351 ,1 ,352 ,620 ,0,3,1,3,0,1,0,76.14,56.77 ,33.33
03,001,03,029,1007,2151,435 ,5 ,440 ,884 ,0,3,1,3,0,1,0,76.14,49.77 ,33.33
03,001,03,029,1008,2152,397 ,3 ,400 ,679 ,0,3,1,3,0,1,0,76.14,58.91 ,33.33
03,001,03,029,1009,2153,960 ,13 ,973 ,1613 ,0,3,1,3,0,1,0,76.14,60.32 ,33.33
03,001,03,029,1010,2154,611 ,2 ,613 ,1157 ,0,3,1,3,0,1,0,76.14,52.98 ,33.33
03,001,03,029,1010,2155,432 ,2 ,434 ,820 ,0,3,1,3,0,1,0,76.14,52.93 ,33.33
03,001,03,029,1011,2156,235 ,3 ,238 ,398 ,0,3,1,3,0,1,0,76.14,59.80 ,33.33
03,001,03,029,1011,2157,220 ,3 ,223 ,412 ,0,3,1,3,0,1,0,76.14,54.13 ,33.33
03,001,03,029,1012,2158,283 ,3 ,286 ,478 ,0,3,1,3,0,1,0,76.14,59.83 ,33.33
03,001,03,029,1012,2159,283 ,1 ,284 ,452 ,0,3,1,3,0,1,0,76.14,62.83 ,33.33
03,002,01,001,0001,1,370 ,4 ,374 ,629 ,0,3,1,3,0,1,0,76.14,59.46 ,33.33
03,002,01,001,0002,2,348 ,1 ,349 ,595 ,0,3,1,3,0,1,0,76.14,58.66 ,33.33
03,002,01,001,0002,3,522 ,5 ,527 ,1033 ,0,3,1,3,0,1,0,76.14,51.02 ,33.33
03,002,01,001,0003,4,260 ,1 ,261 ,429 ,0,3,1,3,0,1,0,76.14,60.84 ,33.33
03,002,01,001,0003,5,454 ,2 ,456 ,699 ,0,3,1,3,0,1,0,76.14,65.24 ,33.33
03,002,01,001,0004,6,309 ,3 ,312 ,554 ,0,3,1,3,0,1,0,76.14,56.32 ,33.33
03,002,01,001,0004,7,370 ,1 ,371 ,613 ,0,3,1,3,0,1,0,76.14,60.52 ,33.33
03,002,01,001,0005,8,416 ,5 ,421 ,698 ,0,3,1,3,0,1,0,76.14,60.32 ,33.33
03,002,01,001,0005,9,717 ,6 ,723 ,1350 ,0,3,1,3,0,1,0,76.14,53.56 ,33.33
03,002,01,001,0005,10,711 ,6 ,717 ,1298 ,0,3,1,3,0,1,0,76.14,55.24 ,33.33
03,002,01,001,0006,11,796 ,3 ,799 ,1431 ,0,3,1,3,0,1,0,76.14,55.84 ,33.33
03,002,01,001,0006,12,369 ,2 ,371 ,650 ,0,3,1,3,0,1,0,76.14,57.08 ,33.33
03,002,01,001,0006,13,796 ,4 ,800 ,1359 ,0,3,1,3,0,1,0,76.14,58.87 ,33.33
03,002,01,001,0006,14,367 ,4 ,371 ,680 ,0,3,1,3,0,1,0,76.14,54.56 ,33.33
03,002,01,001,0007,15,598 ,6 ,604 ,1063 ,0,3,1,3,0,1,0,76.14,56.82 ,33.33
03,002,01,001,0007,16,446 ,2 ,448 ,792 ,0,3,1,3,0,1,0,76.14,56.57 ,33.33
03,002,01,001,0008,17,594 ,7 ,601 ,1073 ,0,3,1,3,0,1,0,76.14,56.01 ,33.33
03,002,01,001,0009,18,778 ,8 ,786 ,1291 ,0,3,1,3,0,1,0,76.14,60.88 ,33.33
03,002,01,001,0010,19,567 ,2 ,569 ,951 ,0,3,1,3,0,1,0,76.14,59.83 ,33.33
03,002,01,001,0011,20,664 ,0 ,664 ,1254 ,0,3,1,3,0,1,0,76.14,52.95 ,33.33
03,002,01,001,0012,21,815 ,4 ,819 ,1508 ,0,3,1,3,0,1,0,76.14,54.31 ,33.33
03,002,01,001,0013,22,588 ,3 ,591 ,997 ,0,3,1,3,0,1,0,76.14,59.28 ,33.33
03,002,01,001,0013,23,938 ,5 ,943 ,1732 ,0,3,1,3,0,1,0,76.14,54.45 ,33.33
03,002,01,001,0014,24,650 ,11 ,661 ,1179 ,0,3,1,3,0,1,0,76.14,56.06 ,33.33
03,002,01,001,0014,25,641 ,11 ,652 ,1182 ,0,3,1,3,0,1,0,76.14,55.16 ,33.33
03,002,01,001,0015,26,649 ,7 ,656 ,1227 ,0,3,1,3,0,1,0,76.14,53.46 ,33.33
03,002,01,001,0015,27,718 ,7 ,725 ,1327 ,0,3,1,3,0,1,0,76.14,54.63 ,33.33
03,002,01,001,0015,28,750 ,4 ,754 ,1491 ,0,3,1,3,0,1,0,76.14,50.57 ,33.33
03,002,01,001,0015,29,412 ,2 ,414 ,650 ,0,3,1,3,0,1,0,76.14,63.69 ,33.33
03,002,01,001,0016,30,309 ,0 ,309 ,534 ,0,3,1,3,0,1,0,76.14,57.87 ,33.33
03,002,01,001,0017,31,360 ,2 ,362 ,596 ,0,3,1,3,0,1,0,76.14,60.74 ,33.33
03,002,01,001,0018,32,761 ,3 ,764 ,1276 ,0,3,1,3,0,1,0,76.14,59.87 ,33.33
03,002,01,001,0019,33,790 ,5 ,795 ,1340 ,0,3,1,3,0,1,0,76.14,59.33 ,33.33
03,002,01,001,0020,34,583 ,2 ,585 ,995 ,0,3,1,3,0,1,0,76.14,58.79 ,33.33
03,002,01,001,0021,35,736 ,3 ,739 ,1380 ,0,3,1,3,0,1,0,76.14,53.55 ,33.33
03,002,01,001,0021,36,496 ,5 ,501 ,847 ,0,3,1,3,0,1,0,76.14,59.15 ,33.33
03,002,01,001,0021,37,429 ,0 ,429 ,813 ,0,3,1,3,0,1,0,76.14,52.77 ,33.33
03,002,01,001,0022,38,554 ,4 ,558 ,1000 ,0,3,1,3,0,1,0,76.14,55.80 ,33.33
03,002,01,001,0022,39,843 ,8 ,851 ,1528 ,0,3,1,3,0,1,0,76.14,55.69 ,33.33
03,002,01,001,0022,40,774 ,5 ,779 ,1391 ,0,3,1,3,0,1,0,76.14,56.00 ,33.33
03,002,01,001,0023,41,687 ,1 ,688 ,1143 ,0,3,1,3,0,1,0,76.14,60.19 ,33.33
03,002,01,001,0024,42,526 ,2 ,528 ,894 ,0,3,1,3,0,1,0,76.14,59.06 ,33.33
03,002,01,001,0024,43,397 ,5 ,402 ,720 ,0,3,1,3,0,1,0,76.14,55.83 ,33.33
03,002,01,001,0024,44,439 ,1 ,440 ,765 ,0,3,1,3,0,1,0,76.14,57.52 ,33.33
03,002,01,001,0025,45,412 ,3 ,415 ,768 ,0,3,1,3,0,1,0,76.14,54.04 ,33.33
03,002,01,001,0026,46,717 ,6 ,723 ,1207 ,0,3,1,3,0,1,0,76.14,59.90 ,33.33
03,002,01,001,0027,47,757 ,5 ,762 ,1373 ,0,3,1,3,0,1,0,76.14,55.50 ,33.33
03,002,01,001,0028,48,336 ,1 ,337 ,590 ,0,3,1,3,0,1,0,76.14,57.12 ,33.33
03,002,01,001,0029,49,460 ,6 ,466 ,781 ,0,3,1,3,0,1,0,76.14,59.67 ,33.33
03,002,01,001,0030,50,812 ,8 ,820 ,1453 ,0,3,1,3,0,1,0,76.14,56.43 ,33.33
03,002,01,001,0031,51,677 ,1 ,678 ,1166 ,0,3,1,3,0,1,0,76.14,58.15 ,33.33
03,002,01,001,0031,52,660 ,4 ,664 ,1112 ,0,3,1,3,0,1,0,76.14,59.71 ,33.33
03,002,01,001,0032,53,719 ,3 ,722 ,1342 ,0,3,1,3,0,1,0,76.14,53.80 ,33.33
03,002,01,001,0032,54,644 ,6 ,650 ,1211 ,0,3,1,3,0,1,0,76.14,53.67 ,33.33
03,002,01,001,0033,55,700 ,5 ,705 ,1216 ,0,3,1,3,0,1,0,76.14,57.98 ,33.33
03,002,01,001,0034,56,772 ,7 ,779 ,1424 ,0,3,1,3,0,1,0,76.14,54.71 ,33.33
03,002,01,001,0034,57,689 ,5 ,694 ,1140 ,0,3,1,3,0,1,0,76.14,60.88 ,33.33
03,002,01,001,0035,58,475 ,3 ,478 ,925 ,0,3,1,3,0,1,0,76.14,51.68 ,33.33
03,002,01,001,0036,59,808 ,5 ,813 ,1438 ,0,3,1,3,0,1,0,76.14,56.54 ,33.33
03,002,01,001,0037,60,801 ,3 ,804 ,1444 ,0,3,1,3,0,1,0,76.14,55.68 ,33.33
03,002,01,001,0038,61,617 ,1 ,618 ,1019 ,0,3,1,3,0,1,0,76.14,60.65 ,33.33
03,002,01,001,0039,62,467 ,4 ,471 ,795 ,0,3,1,3,0,1,0,76.14,59.25 ,33.33
03,002,01,001,0040,63,589 ,5 ,594 ,1026 ,0,3,1,3,0,1,0,76.14,57.89 ,33.33
03,002,01,002,0041,64,280 ,2 ,282 ,491 ,0,3,1,3,0,1,0,76.14,57.43 ,33.33
03,002,01,002,0042,65,329 ,3 ,332 ,535 ,0,3,1,3,0,1,0,76.14,62.06 ,33.33
03,002,01,002,0043,66,257 ,2 ,259 ,494 ,0,3,1,3,0,1,0,76.14,52.43 ,33.33
03,002,01,002,0044,67,704 ,7 ,711 ,1273 ,0,3,1,3,0,1,0,76.14,55.85 ,33.33
03,002,01,002,0045,68,503 ,6 ,509 ,816 ,0,3,1,3,0,1,0,76.14,62.38 ,33.33
03,002,01,002,0045,69,806 ,6 ,812 ,1653 ,0,3,1,3,0,1,0,76.14,49.12 ,33.33
03,002,01,002,0046,70,627 ,2 ,629 ,1084 ,0,3,1,3,0,1,0,76.14,58.03 ,33.33
03,002,01,002,0046,71,486 ,6 ,492 ,996 ,0,3,1,3,0,1,0,76.14,49.40 ,33.33
03,002,01,002,0047,72,559 ,6 ,565 ,1095 ,0,3,1,3,0,1,0,76.14,51.60 ,33.33
03,002,01,002,0047,73,483 ,1 ,484 ,982 ,0,3,1,3,0,1,0,76.14,49.29 ,33.33
03,002,01,002,0048,74,780 ,4 ,784 ,1404 ,0,3,1,3,0,1,0,76.14,55.84 ,33.33
03,002,01,002,0048,75,501 ,2 ,503 ,844 ,0,3,1,3,0,1,0,76.14,59.60 ,33.33
03,002,01,002,0049,76,754 ,18 ,772 ,1335 ,0,3,1,3,0,1,0,76.14,57.83 ,33.33
03,002,01,002,0050,77,820 ,2 ,822 ,1320 ,0,3,1,3,0,1,0,76.14,62.27 ,33.33
03,002,01,002,0051,78,476 ,5 ,481 ,829 ,0,3,1,3,0,1,0,76.14,58.02 ,33.33
03,002,01,002,0052,79,375 ,4 ,379 ,710 ,0,3,1,3,0,1,0,76.14,53.38 ,33.33
03,002,01,002,0053,80,471 ,1 ,472 ,829 ,0,3,1,3,0,1,0,76.14,56.94 ,33.33
03,002,01,002,0054,81,379 ,0 ,379 ,604 ,0,3,1,3,0,1,0,76.14,62.75 ,33.33
03,002,01,002,0055,82,412 ,1 ,413 ,702 ,0,3,1,3,0,1,0,76.14,58.83 ,33.33
03,002,01,002,0056,83,627 ,7 ,634 ,1085 ,0,3,1,3,0,1,0,76.14,58.43 ,33.33
03,002,01,002,0056,84,809 ,7 ,816 ,1451 ,0,3,1,3,0,1,0,76.14,56.24 ,33.33
03,002,01,002,0056,85,521 ,5 ,526 ,990 ,0,3,1,3,0,1,0,76.14,53.13 ,33.33
03,002,01,002,0057,86,514 ,6 ,520 ,958 ,0,3,1,3,0,1,0,76.14,54.28 ,33.33
03,002,01,002,0057,87,811 ,2 ,813 ,1489 ,0,3,1,3,0,1,0,76.14,54.60 ,33.33
03,002,01,002,0057,88,567 ,5 ,572 ,1069 ,0,3,1,3,0,1,0,76.14,53.51 ,33.33
03,002,01,002,0057,89,750 ,2 ,752 ,1380 ,0,3,1,3,0,1,0,76.14,54.49 ,33.33
03,002,01,002,0058,90,771 ,4 ,775 ,1387 ,0,3,1,3,0,1,0,76.14,55.88 ,33.33
03,002,01,002,0058,91,716 ,3 ,719 ,1335 ,0,3,1,3,0,1,0,76.14,53.86 ,33.33
03,002,01,002,0058,92,748 ,5 ,753 ,1416 ,0,3,1,3,0,1,0,76.14,53.18 ,33.33
03,002,01,002,0058,93,746 ,6 ,752 ,1424 ,0,3,1,3,0,1,0,76.14,52.81 ,33.33
03,002,01,002,0059,94,715 ,4 ,719 ,1363 ,0,3,1,3,0,1,0,76.14,52.75 ,33.33
03,002,01,002,0059,95,568 ,5 ,573 ,1028 ,0,3,1,3,0,1,0,76.14,55.74 ,33.33
03,002,01,002,0059,96,591 ,6 ,597 ,1037 ,0,3,1,3,0,1,0,76.14,57.57 ,33.33
03,002,01,002,0060,97,557 ,2 ,559 ,1005 ,0,3,1,3,0,1,0,76.14,55.62 ,33.33
03,002,01,002,0060,98,496 ,3 ,499 ,873 ,0,3,1,3,0,1,0,76.14,57.16 ,33.33
03,002,01,002,0061,99,517 ,5 ,522 ,1074 ,0,3,1,3,0,1,0,76.14,48.60 ,33.33
03,002,01,002,0062,100,769 ,3 ,772 ,1494 ,0,3,1,3,0,1,0,76.14,51.67 ,33.33
03,002,01,002,0062,101,792 ,4 ,796 ,1498 ,0,3,1,3,0,1,0,76.14,53.14 ,33.33
03,002,01,002,0063,102,768 ,6 ,774 ,1416 ,0,3,1,3,0,1,0,76.14,54.66 ,33.33
03,002,01,002,0063,103,648 ,3 ,651 ,1223 ,0,3,1,3,0,1,0,76.14,53.23 ,33.33
03,002,01,002,0063,104,796 ,8 ,804 ,1444 ,0,3,1,3,0,1,0,76.14,55.68 ,33.33
03,002,01,002,0064,105,679 ,8 ,687 ,1218 ,0,3,1,3,0,1,0,76.14,56.40 ,33.33
03,002,01,002,0064,106,639 ,3 ,642 ,1162 ,0,3,1,3,0,1,0,76.14,55.25 ,33.33
03,002,01,002,0065,107,628 ,5 ,633 ,1191 ,0,3,1,3,0,1,0,76.14,53.15 ,33.33
03,002,01,002,0065,108,623 ,4 ,627 ,1146 ,0,3,1,3,0,1,0,76.14,54.71 ,33.33
03,002,01,003,0066,109,371 ,5 ,376 ,658 ,0,3,1,3,0,1,0,76.14,57.14 ,33.33
03,002,01,003,0066,110,659 ,3 ,662 ,1210 ,0,3,1,3,0,1,0,76.14,54.71 ,33.33
03,002,01,003,0066,111,641 ,4 ,645 ,1138 ,0,3,1,3,0,1,0,76.14,56.68 ,33.33
03,002,01,003,0067,112,462 ,6 ,468 ,778 ,0,3,1,3,0,1,0,76.14,60.15 ,33.33
03,002,01,003,0068,113,549 ,1 ,550 ,1077 ,0,3,1,3,0,1,0,76.14,51.07 ,33.33
03,002,01,003,0068,114,542 ,2 ,544 ,973 ,0,3,1,3,0,1,0,76.14,55.91 ,33.33
03,002,01,003,0068,115,482 ,3 ,485 ,898 ,0,3,1,3,0,1,0,76.14,54.01 ,33.33
03,002,01,003,0069,116,368 ,1 ,369 ,599 ,0,3,1,3,0,1,0,76.14,61.60 ,33.33
03,002,01,003,0069,117,232 ,1 ,233 ,349 ,0,3,1,3,0,1,0,76.14,66.76 ,33.33
03,002,01,003,0070,118,400 ,6 ,406 ,757 ,0,3,1,3,0,1,0,76.14,53.63 ,33.33
03,002,01,003,0070,119,231 ,1 ,232 ,432 ,0,3,1,3,0,1,0,76.14,53.70 ,33.33
03,002,01,003,0071,120,115 ,3 ,118 ,237 ,0,3,1,3,0,1,0,76.14,49.79 ,33.33
03,002,01,003,0072,121,562 ,5 ,567 ,1042 ,0,3,1,3,0,1,0,76.14,54.41 ,33.33
03,002,01,003,0072,122,517 ,5 ,522 ,1079 ,0,3,1,3,0,1,0,76.14,48.38 ,33.33
03,002,01,003,0073,123,623 ,7 ,630 ,1084 ,0,3,1,3,0,1,0,76.14,58.12 ,33.33
03,002,01,003,0074,124,632 ,7 ,639 ,1343 ,0,3,1,3,0,1,0,76.14,47.58 ,33.33
03,002,01,003,0074,125,522 ,2 ,524 ,1013 ,0,3,1,3,0,1,0,76.14,51.73 ,33.33
03,002,01,003,0074,126,683 ,4 ,687 ,1309 ,0,3,1,3,0,1,0,76.14,52.48 ,33.33
03,002,01,003,0074,127,671 ,1 ,672 ,1296 ,0,3,1,3,0,1,0,76.14,51.85 ,33.33
03,002,01,003,0075,128,656 ,8 ,664 ,1131 ,0,3,1,3,0,1,0,76.14,58.71 ,33.33
03,002,01,003,0075,129,655 ,4 ,659 ,1199 ,0,3,1,3,0,1,0,76.14,54.96 ,33.33
03,002,01,003,0076,130,711 ,4 ,715 ,1193 ,0,3,1,3,0,1,0,76.14,59.93 ,33.33
03,002,01,003,0077,131,334 ,2 ,336 ,566 ,0,3,1,3,0,1,0,76.14,59.36 ,33.33
03,002,01,003,0078,132,266 ,1 ,267 ,524 ,0,3,1,3,0,1,0,76.14,50.95 ,33.33
03,002,01,003,0079,133,334 ,0 ,334 ,609 ,0,3,1,3,0,1,0,76.14,54.84 ,33.33
03,002,01,003,0080,134,286 ,1 ,287 ,464 ,0,3,1,3,0,1,0,76.14,61.85 ,33.33
03,002,01,003,0081,135,347 ,6 ,353 ,633 ,0,3,1,3,0,1,0,76.14,55.77 ,33.33
03,002,01,003,0082,136,322 ,0 ,322 ,502 ,0,3,1,3,0,1,0,76.14,64.14 ,33.33
03,002,01,003,0083,137,635 ,3 ,638 ,1055 ,0,3,1,3,0,1,0,76.14,60.47 ,33.33
03,002,01,003,0084,138,572 ,3 ,575 ,1045 ,0,3,1,3,0,1,0,76.14,55.02 ,33.33
03,002,01,003,0085,139,673 ,4 ,677 ,1189 ,0,3,1,3,0,1,0,76.14,56.94 ,33.33
03,002,01,003,0086,140,429 ,1 ,430 ,843 ,0,3,1,3,0,1,0,76.14,51.01 ,33.33
03,002,01,003,0086,141,372 ,4 ,376 ,768 ,0,3,1,3,0,1,0,76.14,48.96 ,33.33
03,002,01,003,0087,142,635 ,4 ,639 ,1148 ,0,3,1,3,0,1,0,76.14,55.66 ,33.33
03,002,01,003,0088,143,698 ,3 ,701 ,1313 ,0,3,1,3,0,1,0,76.14,53.39 ,33.33
03,002,01,003,0089,144,161 ,5 ,166 ,301 ,0,3,1,3,0,1,0,76.14,55.15 ,33.33
03,002,01,003,0090,145,408 ,4 ,412 ,785 ,0,3,1,3,0,1,0,76.14,52.48 ,33.33
03,002,01,003,0091,146,234 ,6 ,240 ,469 ,0,3,1,3,0,1,0,76.14,51.17 ,33.33
03,002,01,003,0091,147,141 ,3 ,144 ,252 ,0,3,1,3,0,1,0,76.14,57.14 ,33.33
03,002,01,004,0092,148,190 ,0 ,190 ,366 ,0,3,1,3,0,1,0,76.14,51.91 ,33.33
03,002,01,004,0093,149,394 ,2 ,396 ,735 ,0,3,1,3,0,1,0,76.14,53.88 ,33.33
03,002,01,004,0094,150,495 ,3 ,498 ,910 ,0,3,1,3,0,1,0,76.14,54.73 ,33.33
03,002,01,004,0095,151,223 ,0 ,223 ,391 ,0,3,1,3,0,1,0,76.14,57.03 ,33.33
03,002,01,004,0096,152,939 ,5 ,944 ,1400 ,0,3,1,3,0,1,0,76.14,67.43 ,33.33
03,002,01,004,0097,153,506 ,4 ,510 ,932 ,0,3,1,3,0,1,0,76.14,54.72 ,33.33
03,002,01,004,0098,154,360 ,4 ,364 ,625 ,0,3,1,3,0,1,0,76.14,58.24 ,33.33
03,002,01,004,0099,155,771 ,7 ,778 ,1431 ,0,3,1,3,0,1,0,76.14,54.37 ,33.33
03,002,01,004,0100,156,711 ,6 ,717 ,1223 ,0,3,1,3,0,1,0,76.14,58.63 ,33.33
03,002,01,004,0101,157,505 ,3 ,508 ,751 ,0,3,1,3,0,1,0,76.14,67.64 ,33.33
03,002,01,004,0102,158,343 ,0 ,343 ,543 ,0,3,1,3,0,1,0,76.14,63.17 ,33.33
03,002,01,004,0103,159,401 ,3 ,404 ,622 ,0,3,1,3,0,1,0,76.14,64.95 ,33.33
03,002,01,004,0104,160,376 ,6 ,382 ,622 ,0,3,1,3,0,1,0,76.14,61.41 ,33.33
03,002,01,004,0105,161,538 ,3 ,541 ,993 ,0,3,1,3,0,1,0,76.14,54.48 ,33.33
03,002,01,004,0106,162,580 ,2 ,582 ,1020 ,0,3,1,3,0,1,0,76.14,57.06 ,33.33
03,002,01,004,0106,163,507 ,3 ,510 ,783 ,0,3,1,3,0,1,0,76.14,65.13 ,33.33
03,002,01,004,0107,164,547 ,4 ,551 ,1026 ,0,3,1,3,0,1,0,76.14,53.70 ,33.33
03,002,01,004,0107,165,765 ,4 ,769 ,1384 ,0,3,1,3,0,1,0,76.14,55.56 ,33.33
03,002,01,004,0108,166,512 ,7 ,519 ,999 ,0,3,1,3,0,1,0,76.14,51.95 ,33.33
03,002,01,004,0109,167,873 ,5 ,878 ,1666 ,0,3,1,3,0,1,0,76.14,52.70 ,33.33
03,002,01,004,0110,168,384 ,2 ,386 ,693 ,0,3,1,3,0,1,0,76.14,55.70 ,33.33
03,002,01,004,0111,169,754 ,8 ,762 ,1277 ,0,3,1,3,0,1,0,76.14,59.67 ,33.33
03,002,01,004,0112,170,585 ,5 ,590 ,942 ,0,3,1,3,0,1,0,76.14,62.63 ,33.33
03,002,01,004,0113,171,596 ,5 ,601 ,974 ,0,3,1,3,0,1,0,76.14,61.70 ,33.33
03,002,01,004,0114,172,626 ,7 ,633 ,1085 ,0,3,1,3,0,1,0,76.14,58.34 ,33.33
03,002,01,004,0115,173,364 ,2 ,366 ,637 ,0,3,1,3,0,1,0,76.14,57.46 ,33.33
03,002,01,005,0116,174,810 ,9 ,819 ,1402 ,0,3,1,3,0,1,0,76.14,58.42 ,33.33
03,002,01,005,0117,175,979 ,7 ,986 ,1643 ,0,3,1,3,0,1,0,76.14,60.01 ,33.33
03,002,01,005,0118,176,903 ,9 ,912 ,1674 ,0,3,1,3,0,1,0,76.14,54.48 ,33.33
03,002,01,005,0118,177,968 ,8 ,976 ,1777 ,0,3,1,3,0,1,0,76.14,54.92 ,33.33
03,002,01,005,0119,178,750 ,4 ,754 ,1371 ,0,3,1,3,0,1,0,76.14,55.00 ,33.33
03,002,01,005,0119,179,485 ,3 ,488 ,792 ,0,3,1,3,0,1,0,76.14,61.62 ,33.33
03,002,01,005,0120,180,416 ,3 ,419 ,681 ,0,3,1,3,0,1,0,76.14,61.53 ,33.33
03,002,01,005,0121,181,851 ,1 ,852 ,1407 ,0,3,1,3,0,1,0,76.14,60.55 ,33.33
03,002,01,005,0122,182,670 ,7 ,677 ,1095 ,0,3,1,3,0,1,0,76.14,61.83 ,33.33
03,002,01,005,0123,183,840 ,10 ,850 ,1377 ,0,3,1,3,0,1,0,76.14,61.73 ,33.33
03,002,01,005,0124,184,453 ,6 ,459 ,829 ,0,3,1,3,0,1,0,76.14,55.37 ,33.33
03,002,01,005,0124,185,612 ,4 ,616 ,1043 ,0,3,1,3,0,1,0,76.14,59.06 ,33.33
03,002,01,005,0125,186,808 ,9 ,817 ,1381 ,0,3,1,3,0,1,0,76.14,59.16 ,33.33
03,002,01,005,0125,187,507 ,2 ,509 ,908 ,0,3,1,3,0,1,0,76.14,56.06 ,33.33
03,002,01,005,0126,188,640 ,7 ,647 ,1071 ,0,3,1,3,0,1,0,76.14,60.41 ,33.33
03,002,01,005,0127,189,437 ,2 ,439 ,726 ,0,3,1,3,0,1,0,76.14,60.47 ,33.33
03,002,01,005,0128,190,537 ,3 ,540 ,908 ,0,3,1,3,0,1,0,76.14,59.47 ,33.33
03,002,01,005,0129,191,655 ,4 ,659 ,1113 ,0,3,1,3,0,1,0,76.14,59.21 ,33.33
03,002,01,005,0130,192,640 ,4 ,644 ,1051 ,0,3,1,3,0,1,0,76.14,61.27 ,33.33
03,002,01,005,0130,193,699 ,1 ,700 ,1162 ,0,3,1,3,0,1,0,76.14,60.24 ,33.33
03,002,01,005,0131,194,829 ,8 ,837 ,1458 ,0,3,1,3,0,1,0,76.14,57.41 ,33.33
03,002,01,005,0131,195,715 ,11 ,726 ,1305 ,0,3,1,3,0,1,0,76.14,55.63 ,33.33
03,002,01,005,0132,196,510 ,1 ,511 ,931 ,0,3,1,3,0,1,0,76.14,54.89 ,33.33
03,002,01,005,0133,197,252 ,3 ,255 ,408 ,0,3,1,3,0,1,0,76.14,62.50 ,33.33
03,002,01,006,0134,198,543 ,10 ,553 ,949 ,0,3,1,3,0,1,0,76.14,58.27 ,33.33
03,002,01,006,0134,199,532 ,3 ,535 ,900 ,0,3,1,3,0,1,0,76.14,59.44 ,33.33
03,002,01,006,0135,200,450 ,1 ,451 ,815 ,0,3,1,3,0,1,0,76.14,55.34 ,33.33
03,002,01,006,0136,201,467 ,3 ,470 ,789 ,0,3,1,3,0,1,0,76.14,59.57 ,33.33
03,002,01,006,0136,202,536 ,4 ,540 ,877 ,0,3,1,3,0,1,0,76.14,61.57 ,33.33
03,002,01,006,0137,203,508 ,5 ,513 ,975 ,0,3,1,3,0,1,0,76.14,52.62 ,33.33
03,002,01,006,0138,204,448 ,3 ,451 ,798 ,0,3,1,3,0,1,0,76.14,56.52 ,33.33
03,002,01,006,0139,205,431 ,1 ,432 ,815 ,0,3,1,3,0,1,0,76.14,53.01 ,33.33
03,002,01,006,0139,206,484 ,3 ,487 ,896 ,0,3,1,3,0,1,0,76.14,54.35 ,33.33
03,002,01,006,0140,207,355 ,1 ,356 ,690 ,0,3,1,3,0,1,0,76.14,51.59 ,33.33
03,002,01,006,0140,208,480 ,2 ,482 ,852 ,0,3,1,3,0,1,0,76.14,56.57 ,33.33
03,002,01,006,0141,209,489 ,1 ,490 ,820 ,0,3,1,3,0,1,0,76.14,59.76 ,33.33
03,002,01,006,0142,210,697 ,4 ,701 ,1269 ,0,3,1,3,0,1,0,76.14,55.24 ,33.33
03,002,01,006,0142,211,747 ,2 ,749 ,1275 ,0,3,1,3,0,1,0,76.14,58.75 ,33.33
03,002,01,006,0143,212,567 ,2 ,569 ,973 ,0,3,1,3,0,1,0,76.14,58.48 ,33.33
03,002,01,006,0144,213,542 ,4 ,546 ,937 ,0,3,1,3,0,1,0,76.14,58.27 ,33.33
03,002,01,006,0145,214,603 ,4 ,607 ,998 ,0,3,1,3,0,1,0,76.14,60.82 ,33.33
03,002,01,006,0145,215,656 ,2 ,658 ,1056 ,0,3,1,3,0,1,0,76.14,62.31 ,33.33
03,002,01,006,0146,216,488 ,2 ,490 ,882 ,0,3,1,3,0,1,0,76.14,55.56 ,33.33
03,002,01,006,0147,217,441 ,2 ,443 ,738 ,0,3,1,3,0,1,0,76.14,60.03 ,33.33
03,002,01,006,0147,218,557 ,3 ,560 ,954 ,0,3,1,3,0,1,0,76.14,58.70 ,33.33
03,002,01,007,0148,219,769 ,5 ,774 ,1506 ,0,3,1,3,0,1,0,76.14,51.39 ,33.33
03,002,01,007,0148,220,726 ,2 ,728 ,1321 ,0,3,1,3,0,1,0,76.14,55.11 ,33.33
03,002,01,007,0148,221,760 ,4 ,764 ,1428 ,0,3,1,3,0,1,0,76.14,53.50 ,33.33
03,002,01,007,0149,222,477 ,2 ,479 ,948 ,0,3,1,3,0,1,0,76.14,50.53 ,33.33
03,002,01,007,0149,223,464 ,6 ,470 ,881 ,0,3,1,3,0,1,0,76.14,53.35 ,33.33
03,002,01,007,0150,224,729 ,4 ,733 ,1222 ,0,3,1,3,0,1,0,76.14,59.98 ,33.33
03,002,01,007,0151,225,543 ,1 ,544 ,969 ,0,3,1,3,0,1,0,76.14,56.14 ,33.33
03,002,01,007,0152,226,783 ,9 ,792 ,1449 ,0,3,1,3,0,1,0,76.14,54.66 ,33.33
03,002,01,007,0153,227,621 ,8 ,629 ,1198 ,0,3,1,3,0,1,0,76.14,52.50 ,33.33
03,002,01,007,0154,228,544 ,6 ,550 ,961 ,0,3,1,3,0,1,0,76.14,57.23 ,33.33
03,002,01,007,0154,229,250 ,1 ,251 ,439 ,0,3,1,3,0,1,0,76.14,57.18 ,33.33
03,002,01,007,0155,230,239 ,1 ,240 ,443 ,0,3,1,3,0,1,0,76.14,54.18 ,33.33
03,002,01,007,0155,231,137 ,1 ,138 ,268 ,0,3,1,3,0,1,0,76.14,51.49 ,33.33
03,002,01,007,0156,232,885 ,2 ,887 ,1601 ,0,3,1,3,0,1,0,76.14,55.40 ,33.33
03,002,01,007,0157,233,624 ,5 ,629 ,1093 ,0,3,1,3,0,1,0,76.14,57.55 ,33.33
03,002,01,007,0158,234,920 ,1 ,921 ,1586 ,0,3,1,3,0,1,0,76.14,58.07 ,33.33
03,002,01,007,0158,235,282 ,3 ,285 ,512 ,0,3,1,3,0,1,0,76.14,55.66 ,33.33
03,002,01,007,0159,236,715 ,10 ,725 ,1228 ,0,3,1,3,0,1,0,76.14,59.04 ,33.33
03,002,01,007,0159,237,651 ,3 ,654 ,1238 ,0,3,1,3,0,1,0,76.14,52.83 ,33.33
03,002,01,007,0160,238,475 ,2 ,477 ,840 ,0,3,1,3,0,1,0,76.14,56.79 ,33.33
03,002,01,007,0161,239,460 ,1 ,461 ,815 ,0,3,1,3,0,1,0,76.14,56.56 ,33.33
03,002,01,007,0162,240,553 ,14 ,567 ,972 ,0,3,1,3,0,1,0,76.14,58.33 ,33.33
03,002,01,007,0163,241,828 ,8 ,836 ,1460 ,0,3,1,3,0,1,0,76.14,57.26 ,33.33
03,002,01,008,0164,242,636 ,6 ,642 ,1050 ,0,3,1,3,0,1,0,76.14,61.14 ,33.33
03,002,01,008,0165,243,787 ,7 ,794 ,1344 ,0,3,1,3,0,1,0,76.14,59.08 ,33.33
03,002,01,008,0166,244,574 ,3 ,577 ,1000 ,0,3,1,3,0,1,0,76.14,57.70 ,33.33
03,002,01,008,0167,245,481 ,3 ,484 ,812 ,0,3,1,3,0,1,0,76.14,59.61 ,33.33
03,002,01,008,0168,246,562 ,3 ,565 ,924 ,0,3,1,3,0,1,0,76.14,61.15 ,33.33
03,002,01,008,0169,247,681 ,4 ,685 ,1185 ,0,3,1,3,0,1,0,76.14,57.81 ,33.33
03,002,01,008,0169,248,562 ,3 ,565 ,980 ,0,3,1,3,0,1,0,76.14,57.65 ,33.33
03,002,01,008,0170,249,607 ,7 ,614 ,1056 ,0,3,1,3,0,1,0,76.14,58.14 ,33.33
03,002,01,008,0170,250,505 ,3 ,508 ,841 ,0,3,1,3,0,1,0,76.14,60.40 ,33.33
03,002,01,008,0171,251,607 ,7 ,614 ,1109 ,0,3,1,3,0,1,0,76.14,55.37 ,33.33
03,002,01,008,0172,252,496 ,3 ,499 ,821 ,0,3,1,3,0,1,0,76.14,60.78 ,33.33
03,002,01,008,0173,253,387 ,3 ,390 ,694 ,0,3,1,3,0,1,0,76.14,56.20 ,33.33
03,002,01,008,0174,254,840 ,9 ,849 ,1331 ,0,3,1,3,0,1,0,76.14,63.79 ,33.33
03,002,01,008,0175,255,475 ,3 ,478 ,799 ,0,3,1,3,0,1,0,76.14,59.82 ,33.33
03,002,01,008,0176,256,707 ,6 ,713 ,1232 ,0,3,1,3,0,1,0,76.14,57.87 ,33.33
03,002,01,008,0177,257,271 ,1 ,272 ,447 ,0,3,1,3,0,1,0,76.14,60.85 ,33.33
03,002,01,008,0177,258,610 ,3 ,613 ,1207 ,0,3,1,3,0,1,0,76.14,50.79 ,33.33
03,002,01,008,0177,259,805 ,5 ,810 ,1633 ,0,3,1,3,0,1,0,76.14,49.60 ,33.33
03,002,01,008,0178,260,794 ,2 ,796 ,1512 ,0,3,1,3,0,1,0,76.14,52.65 ,33.33
03,002,01,008,0178,261,505 ,2 ,507 ,873 ,0,3,1,3,0,1,0,76.14,58.08 ,33.33
03,002,01,008,0179,262,646 ,7 ,653 ,1197 ,0,3,1,3,0,1,0,76.14,54.55 ,33.33
03,002,01,008,0180,263,678 ,6 ,684 ,1221 ,0,3,1,3,0,1,0,76.14,56.02 ,33.33
03,002,01,008,0180,264,610 ,3 ,613 ,1073 ,0,3,1,3,0,1,0,76.14,57.13 ,33.33
03,002,01,008,0180,265,718 ,5 ,723 ,1249 ,0,3,1,3,0,1,0,76.14,57.89 ,33.33
03,002,01,008,0180,266,534 ,4 ,538 ,944 ,0,3,1,3,0,1,0,76.14,56.99 ,33.33
03,002,01,008,0181,267,744 ,7 ,751 ,1291 ,0,3,1,3,0,1,0,76.14,58.17 ,33.33
03,002,01,008,0181,268,737 ,4 ,741 ,1406 ,0,3,1,3,0,1,0,76.14,52.70 ,33.33
03,002,01,008,0182,269,611 ,1 ,612 ,1093 ,0,3,1,3,0,1,0,76.14,55.99 ,33.33
03,002,01,008,0182,270,585 ,5 ,590 ,1101 ,0,3,1,3,0,1,0,76.14,53.59 ,33.33
03,002,01,008,0183,271,533 ,6 ,539 ,1062 ,0,3,1,3,0,1,0,76.14,50.75 ,33.33
03,002,01,008,0184,272,629 ,2 ,631 ,1125 ,0,3,1,3,0,1,0,76.14,56.09 ,33.33
03,002,01,008,0184,273,557 ,5 ,562 ,1119 ,0,3,1,3,0,1,0,76.14,50.22 ,33.33
03,002,01,008,0185,274,697 ,4 ,701 ,1347 ,0,3,1,3,0,1,0,76.14,52.04 ,33.33
03,002,01,008,0186,275,615 ,7 ,622 ,1121 ,0,3,1,3,0,1,0,76.14,55.49 ,33.33
03,002,01,008,0187,276,479 ,4 ,483 ,838 ,0,3,1,3,0,1,0,76.14,57.64 ,33.33
03,002,01,009,0188,277,935 ,6 ,941 ,1563 ,0,3,1,3,0,1,0,76.14,60.20 ,33.33
03,002,01,009,0189,278,893 ,9 ,902 ,1465 ,0,3,1,3,0,1,0,76.14,61.57 ,33.33
03,002,01,009,0190,279,597 ,6 ,603 ,1036 ,0,3,1,3,0,1,0,76.14,58.20 ,33.33
03,002,01,009,0190,280,582 ,11 ,593 ,1051 ,0,3,1,3,0,1,0,76.14,56.42 ,33.33
03,002,01,009,0191,281,829 ,0 ,829 ,1470 ,0,3,1,3,0,1,0,76.14,56.39 ,33.33
03,002,01,009,0192,282,521 ,7 ,528 ,1027 ,0,3,1,3,0,1,0,76.14,51.41 ,33.33
03,002,01,009,0193,283,498 ,3 ,501 ,908 ,0,3,1,3,0,1,0,76.14,55.18 ,33.33
03,002,01,009,0193,284,666 ,5 ,671 ,1187 ,0,3,1,3,0,1,0,76.14,56.53 ,33.33
03,002,01,009,0194,285,859 ,6 ,865 ,1480 ,0,3,1,3,0,1,0,76.14,58.45 ,33.33
03,002,01,009,0195,286,842 ,4 ,846 ,1364 ,0,3,1,3,0,1,0,76.14,62.02 ,33.33
03,002,01,009,0195,287,742 ,4 ,746 ,1398 ,0,3,1,3,0,1,0,76.14,53.36 ,33.33
03,002,01,009,0196,288,954 ,10 ,964 ,1653 ,0,3,1,3,0,1,0,76.14,58.32 ,33.33
03,002,01,009,0196,289,635 ,7 ,642 ,1105 ,0,3,1,3,0,1,0,76.14,58.10 ,33.33
03,002,01,009,0197,290,807 ,4 ,811 ,1478 ,0,3,1,3,0,1,0,76.14,54.87 ,33.33
03,002,01,009,0197,291,491 ,5 ,496 ,919 ,0,3,1,3,0,1,0,76.14,53.97 ,33.33
03,002,01,009,0198,292,733 ,2 ,735 ,1352 ,0,3,1,3,0,1,0,76.14,54.36 ,33.33
03,002,01,009,0199,293,787 ,9 ,796 ,1449 ,0,3,1,3,0,1,0,76.14,54.93 ,33.33
03,002,01,009,0200,294,537 ,6 ,543 ,986 ,0,3,1,3,0,1,0,76.14,55.07 ,33.33
03,002,01,009,0200,295,557 ,5 ,562 ,951 ,0,3,1,3,0,1,0,76.14,59.10 ,33.33
03,002,01,009,0201,296,899 ,8 ,907 ,1594 ,0,3,1,3,0,1,0,76.14,56.90 ,33.33
03,002,01,009,0201,297,396 ,5 ,401 ,738 ,0,3,1,3,0,1,0,76.14,54.34 ,33.33
03,002,01,009,0202,298,913 ,6 ,919 ,1710 ,0,3,1,3,0,1,0,76.14,53.74 ,33.33
03,002,01,009,0202,299,414 ,2 ,416 ,752 ,0,3,1,3,0,1,0,76.14,55.32 ,33.33
03,002,01,010,0203,300,140 ,1 ,141 ,236 ,0,3,1,3,0,1,0,76.14,59.75 ,33.33
03,002,01,010,0204,301,309 ,5 ,314 ,562 ,0,3,1,3,0,1,0,76.14,55.87 ,33.33
03,002,01,010,0205,302,402 ,5 ,407 ,782 ,0,3,1,3,0,1,0,76.14,52.05 ,33.33
03,002,01,010,0206,303,375 ,9 ,384 ,653 ,0,3,1,3,0,1,0,76.14,58.81 ,33.33
03,002,01,010,0207,304,254 ,4 ,258 ,456 ,0,3,1,3,0,1,0,76.14,56.58 ,33.33
03,002,01,010,0208,305,644 ,5 ,649 ,1097 ,0,3,1,3,0,1,0,76.14,59.16 ,33.33
03,002,01,010,0209,306,632 ,2 ,634 ,1142 ,0,3,1,3,0,1,0,76.14,55.52 ,33.33
03,002,01,010,0210,307,479 ,5 ,484 ,789 ,0,3,1,3,0,1,0,76.14,61.34 ,33.33
03,002,01,010,0211,308,550 ,3 ,553 ,992 ,0,3,1,3,0,1,0,76.14,55.75 ,33.33
03,002,01,010,0212,309,909 ,5 ,914 ,1704 ,0,3,1,3,0,1,0,76.14,53.64 ,33.33
03,002,01,010,0212,310,747 ,10 ,757 ,1444 ,0,3,1,3,0,1,0,76.14,52.42 ,33.33
03,002,01,010,0213,311,393 ,1 ,394 ,679 ,0,3,1,3,0,1,0,76.14,58.03 ,33.33
03,002,01,010,0214,312,271 ,2 ,273 ,559 ,0,3,1,3,0,1,0,76.14,48.84 ,33.33
03,002,01,010,0215,313,238 ,1 ,239 ,470 ,0,3,1,3,0,1,0,76.14,50.85 ,33.33
03,002,01,010,0216,314,409 ,5 ,414 ,670 ,0,3,1,3,0,1,0,76.14,61.79 ,33.33
03,002,01,010,0217,315,623 ,7 ,630 ,1095 ,0,3,1,3,0,1,0,76.14,57.53 ,33.33
03,002,01,010,0218,316,471 ,5 ,476 ,778 ,0,3,1,3,0,1,0,76.14,61.18 ,33.33
03,002,01,010,0219,317,774 ,5 ,779 ,1258 ,0,3,1,3,0,1,0,76.14,61.92 ,33.33
03,002,01,010,0220,318,692 ,6 ,698 ,1140 ,0,3,1,3,0,1,0,76.14,61.23 ,33.33
03,002,01,011,0221,319,49 ,1 ,50 ,109 ,0,3,1,3,0,1,0,76.14,45.87 ,33.33
03,002,01,011,0222,320,49 ,2 ,51 ,93 ,0,3,1,3,0,1,0,76.14,54.84 ,33.33
03,002,01,011,0223,321,128 ,0 ,128 ,247 ,0,3,1,3,0,1,0,76.14,51.82 ,33.33
03,002,01,011,0224,322,130 ,1 ,131 ,232 ,0,3,1,3,0,1,0,76.14,56.47 ,33.33
03,002,01,011,0225,323,39 ,0 ,39 ,80 ,0,3,1,3,0,1,0,76.14,48.75 ,33.33
03,002,01,011,0226,324,26 ,0 ,26 ,45 ,0,3,1,3,0,1,0,76.14,57.78 ,33.33
03,002,01,011,0227,325,32 ,1 ,33 ,64 ,0,3,1,3,0,1,0,76.14,51.56 ,33.33
03,002,01,011,0228,326,18 ,0 ,18 ,49 ,0,3,1,3,0,1,0,76.14,36.73 ,33.33
03,002,01,011,0229,327,34 ,0 ,34 ,73 ,0,3,1,3,0,1,0,76.14,46.58 ,33.33
03,002,01,011,0230,328,11 ,0 ,11 ,16 ,0,3,1,3,0,1,0,76.14,68.75 ,33.33
03,002,01,012,0231,329,93 ,0 ,93 ,210 ,0,3,1,3,0,1,0,76.14,44.29 ,33.33
03,002,01,012,0232,330,33 ,0 ,33 ,81 ,0,3,1,3,0,1,0,76.14,40.74 ,33.33
03,002,01,012,0233,331,34 ,0 ,34 ,62 ,0,3,1,3,0,1,0,76.14,54.84 ,33.33
03,002,01,012,0234,332,32 ,1 ,33 ,60 ,0,3,1,3,0,1,0,76.14,55.00 ,33.33
03,002,01,012,0235,333,39 ,1 ,40 ,110 ,0,3,1,3,0,1,0,76.14,36.36 ,33.33
03,002,01,012,0236,334,11 ,0 ,11 ,30 ,0,3,1,3,0,1,0,76.14,36.67 ,33.33
03,002,01,012,0237,335,64 ,1 ,65 ,138 ,0,3,1,3,0,1,0,76.14,47.10 ,33.33
03,003,01,001,0001,1,684 ,2 ,686 ,1108 ,0,3,1,3,0,1,0,76.14,61.91 ,33.33
03,003,01,001,0001,2,905 ,6 ,911 ,1440 ,0,3,1,3,0,1,0,76.14,63.26 ,33.33
03,003,01,001,0001,3,922 ,12 ,934 ,1622 ,0,3,1,3,0,1,0,76.14,57.58 ,33.33
03,003,01,001,0001,4,657 ,4 ,661 ,1148 ,0,3,1,3,0,1,0,76.14,57.58 ,33.33
03,003,01,001,0002,5,1010 ,6 ,1016 ,1734 ,0,3,1,3,0,1,0,76.14,58.59 ,33.33
03,003,01,001,0002,6,761 ,7 ,768 ,1423 ,0,3,1,3,0,1,0,76.14,53.97 ,33.33
03,003,01,001,0002,7,969 ,11 ,980 ,1664 ,0,3,1,3,0,1,0,76.14,58.89 ,33.33
03,003,01,001,0003,8,698 ,11 ,709 ,1211 ,0,3,1,3,0,1,0,76.14,58.55 ,33.33
03,003,01,001,0003,9,973 ,7 ,980 ,1606 ,0,3,1,3,0,1,0,76.14,61.02 ,33.33
03,003,01,001,0003,10,760 ,11 ,771 ,1390 ,0,3,1,3,0,1,0,76.14,55.47 ,33.33
03,003,01,001,0004,11,971 ,4 ,975 ,1494 ,0,3,1,3,0,1,0,76.14,65.26 ,33.33
03,003,01,001,0004,12,944 ,3 ,947 ,1563 ,0,3,1,3,0,1,0,76.14,60.59 ,33.33
03,003,01,001,0004,13,737 ,3 ,740 ,1348 ,0,3,1,3,0,1,0,76.14,54.90 ,33.33
03,003,01,001,0005,14,996 ,3 ,999 ,1851 ,0,3,1,3,0,1,0,76.14,53.97 ,33.33
03,003,01,001,0005,15,939 ,2 ,941 ,1535 ,0,3,1,3,0,1,0,76.14,61.30 ,33.33
03,003,01,001,0006,16,963 ,8 ,971 ,1612 ,0,3,1,3,0,1,0,76.14,60.24 ,33.33
03,003,01,001,0006,17,1159 ,4 ,1163 ,1937 ,0,3,1,3,0,1,0,76.14,60.04 ,33.33
03,003,01,001,0006,18,1047 ,9 ,1056 ,1731 ,0,3,1,3,0,1,0,76.14,61.01 ,33.33
03,003,01,001,0007,19,852 ,6 ,858 ,1449 ,0,3,1,3,0,1,0,76.14,59.21 ,33.33
03,003,01,001,0007,20,939 ,5 ,944 ,1706 ,0,3,1,3,0,1,0,76.14,55.33 ,33.33
03,003,01,001,0007,21,693 ,7 ,700 ,1199 ,0,3,1,3,0,1,0,76.14,58.38 ,33.33
03,003,01,001,0008,22,696 ,4 ,700 ,1267 ,0,3,1,3,0,1,0,76.14,55.25 ,33.33
03,003,01,001,0008,23,749 ,4 ,753 ,1337 ,0,3,1,3,0,1,0,76.14,56.32 ,33.33
03,003,01,001,0009,24,1066 ,6 ,1072 ,1800 ,0,3,1,3,0,1,0,76.14,59.56 ,33.33
03,003,01,001,0010,25,570 ,5 ,575 ,900 ,0,3,1,3,0,1,0,76.14,63.89 ,33.33
03,003,01,001,0011,26,826 ,3 ,829 ,1500 ,0,3,1,3,0,1,0,76.14,55.27 ,33.33
03,003,01,001,0012,27,880 ,7 ,887 ,1387 ,0,3,1,3,0,1,0,76.14,63.95 ,33.33
03,003,01,001,0013,28,454 ,0 ,454 ,747 ,0,3,1,3,0,1,0,76.14,60.78 ,33.33
03,003,01,001,0014,29,822 ,9 ,831 ,1384 ,0,3,1,3,0,1,0,76.14,60.04 ,33.33
03,003,01,001,0015,30,591 ,7 ,598 ,928 ,0,3,1,3,0,1,0,76.14,64.44 ,33.33
03,003,01,001,0016,31,648 ,6 ,654 ,1122 ,0,3,1,3,0,1,0,76.14,58.29 ,33.33
03,003,01,001,0016,32,801 ,2 ,803 ,1501 ,0,3,1,3,0,1,0,76.14,53.50 ,33.33
03,003,01,001,0016,33,686 ,4 ,690 ,1102 ,0,3,1,3,0,1,0,76.14,62.61 ,33.33
03,003,01,001,0016,34,591 ,3 ,594 ,1057 ,0,3,1,3,0,1,0,76.14,56.20 ,33.33
03,003,01,001,0017,35,868 ,9 ,877 ,1349 ,0,3,1,3,0,1,0,76.14,65.01 ,33.33
03,003,01,001,0018,36,807 ,9 ,816 ,1344 ,0,3,1,3,0,1,0,76.14,60.71 ,33.33
03,003,01,001,0019,37,758 ,9 ,767 ,1297 ,0,3,1,3,0,1,0,76.14,59.14 ,33.33
03,003,01,001,0020,38,577 ,3 ,580 ,909 ,0,3,1,3,0,1,0,76.14,63.81 ,33.33
03,003,01,001,0021,39,1033 ,3 ,1036 ,1695 ,0,3,1,3,0,1,0,76.14,61.12 ,33.33
03,003,01,001,0022,40,999 ,8 ,1007 ,1704 ,0,3,1,3,0,1,0,76.14,59.10 ,33.33
03,003,01,001,0022,41,825 ,5 ,830 ,1339 ,0,3,1,3,0,1,0,76.14,61.99 ,33.33
03,003,01,001,0022,42,982 ,7 ,989 ,1710 ,0,3,1,3,0,1,0,76.14,57.84 ,33.33
03,003,01,001,0023,43,855 ,6 ,861 ,1439 ,0,3,1,3,0,1,0,76.14,59.83 ,33.33
03,003,01,001,0023,44,937 ,3 ,940 ,1462 ,0,3,1,3,0,1,0,76.14,64.30 ,33.33
03,003,01,001,0023,45,862 ,2 ,864 ,1964 ,0,3,1,3,0,1,0,76.14,43.99 ,33.33
03,003,01,001,0024,46,745 ,4 ,749 ,1357 ,0,3,1,3,0,1,0,76.14,55.20 ,33.33
03,003,01,001,0024,47,890 ,8 ,898 ,1649 ,0,3,1,3,0,1,0,76.14,54.46 ,33.33
03,003,01,001,0025,48,682 ,4 ,686 ,1189 ,0,3,1,3,0,1,0,76.14,57.70 ,33.33
03,003,01,001,0025,49,737 ,3 ,740 ,1361 ,0,3,1,3,0,1,0,76.14,54.37 ,33.33
03,003,01,001,0025,50,597 ,8 ,605 ,1118 ,0,3,1,3,0,1,0,76.14,54.11 ,33.33
03,003,01,001,0026,51,920 ,5 ,925 ,1611 ,0,3,1,3,0,1,0,76.14,57.42 ,33.33
03,003,01,001,0026,52,760 ,6 ,766 ,1506 ,0,3,1,3,0,1,0,76.14,50.86 ,33.33
03,003,01,001,0026,53,738 ,5 ,743 ,1322 ,0,3,1,3,0,1,0,76.14,56.20 ,33.33
03,003,01,001,0027,54,938 ,9 ,947 ,1772 ,0,3,1,3,0,1,0,76.14,53.44 ,33.33
03,003,01,001,0027,55,958 ,8 ,966 ,1693 ,0,3,1,3,0,1,0,76.14,57.06 ,33.33
03,003,01,001,0028,56,795 ,8 ,803 ,1385 ,0,3,1,3,0,1,0,76.14,57.98 ,33.33
03,003,01,001,0028,57,800 ,6 ,806 ,1399 ,0,3,1,3,0,1,0,76.14,57.61 ,33.33
03,003,01,001,0029,58,797 ,8 ,805 ,1547 ,0,3,1,3,0,1,0,76.14,52.04 ,33.33
03,003,01,001,0029,59,832 ,2 ,834 ,1567 ,0,3,1,3,0,1,0,76.14,53.22 ,33.33
03,003,01,001,0029,60,747 ,3 ,750 ,1384 ,0,3,1,3,0,1,0,76.14,54.19 ,33.33
03,003,01,001,0029,61,739 ,2 ,741 ,1588 ,0,3,1,3,0,1,0,76.14,46.66 ,33.33
03,003,01,001,0030,62,824 ,3 ,827 ,1547 ,0,3,1,3,0,1,0,76.14,53.46 ,33.33
03,003,01,001,0030,63,726 ,10 ,736 ,1284 ,0,3,1,3,0,1,0,76.14,57.32 ,33.33
03,003,01,001,0030,64,947 ,7 ,954 ,1543 ,0,3,1,3,0,1,0,76.14,61.83 ,33.33
03,003,01,001,0031,65,876 ,5 ,881 ,1378 ,0,3,1,3,0,1,0,76.14,63.93 ,33.33
03,003,01,001,0031,66,662 ,4 ,666 ,1157 ,0,3,1,3,0,1,0,76.14,57.56 ,33.33
03,003,01,001,0031,67,1067 ,7 ,1074 ,1852 ,0,3,1,3,0,1,0,76.14,57.99 ,33.33
03,003,01,001,0032,68,769 ,4 ,773 ,1240 ,0,3,1,3,0,1,0,76.14,62.34 ,33.33
03,003,01,001,0032,69,790 ,6 ,796 ,1223 ,0,3,1,3,0,1,0,76.14,65.09 ,33.33
03,003,01,001,0033,70,629 ,6 ,635 ,1008 ,0,3,1,3,0,1,0,76.14,63.00 ,33.33
03,003,01,001,0033,71,888 ,8 ,896 ,1500 ,0,3,1,3,0,1,0,76.14,59.73 ,33.33
03,003,01,001,0033,72,737 ,2 ,739 ,1304 ,0,3,1,3,0,1,0,76.14,56.67 ,33.33
03,003,01,001,0034,73,811 ,3 ,814 ,1346 ,0,3,1,3,0,1,0,76.14,60.48 ,33.33
03,003,01,001,0034,74,766 ,6 ,772 ,1340 ,0,3,1,3,0,1,0,76.14,57.61 ,33.33
03,003,01,001,0034,75,826 ,5 ,831 ,1540 ,0,3,1,3,0,1,0,76.14,53.96 ,33.33
03,003,01,001,0035,76,779 ,6 ,785 ,1292 ,0,3,1,3,0,1,0,76.14,60.76 ,33.33
03,003,01,001,0035,77,1011 ,16 ,1027 ,1724 ,0,3,1,3,0,1,0,76.14,59.57 ,33.33
03,003,01,001,0036,78,699 ,4 ,703 ,1228 ,0,3,1,3,0,1,0,76.14,57.25 ,33.33
03,003,01,001,0036,79,698 ,19 ,717 ,1258 ,0,3,1,3,0,1,0,76.14,57.00 ,33.33
03,003,01,001,0036,80,684 ,6 ,690 ,1298 ,0,3,1,3,0,1,0,76.14,53.16 ,33.33
03,003,01,001,0037,81,771 ,6 ,777 ,1533 ,0,3,1,3,0,1,0,76.14,50.68 ,33.33
03,003,01,001,0037,82,828 ,9 ,837 ,1569 ,0,3,1,3,0,1,0,76.14,53.35 ,33.33
03,003,01,001,0038,83,803 ,4 ,807 ,1582 ,0,3,1,3,0,1,0,76.14,51.01 ,33.33
03,003,01,001,0038,84,760 ,4 ,764 ,1422 ,0,3,1,3,0,1,0,76.14,53.73 ,33.33
03,003,01,001,0038,85,745 ,9 ,754 ,1437 ,0,3,1,3,0,1,0,76.14,52.47 ,33.33
03,003,01,001,0039,86,742 ,4 ,746 ,1353 ,0,3,1,3,0,1,0,76.14,55.14 ,33.33
03,003,01,001,0039,87,863 ,7 ,870 ,1421 ,0,3,1,3,0,1,0,76.14,61.22 ,33.33
03,003,01,001,0039,88,676 ,4 ,680 ,1523 ,0,3,1,3,0,1,0,76.14,44.65 ,33.33
03,003,01,001,0039,89,805 ,1 ,806 ,1539 ,0,3,1,3,0,1,0,76.14,52.37 ,33.33
03,003,01,001,0040,90,606 ,5 ,611 ,1025 ,0,3,1,3,0,1,0,76.14,59.61 ,33.33
03,003,01,001,0040,91,652 ,7 ,659 ,1158 ,0,3,1,3,0,1,0,76.14,56.91 ,33.33
03,003,01,001,0040,92,635 ,7 ,642 ,1113 ,0,3,1,3,0,1,0,76.14,57.68 ,33.33
03,003,01,001,0041,93,840 ,6 ,846 ,1400 ,0,3,1,3,0,1,0,76.14,60.43 ,33.33
03,003,01,001,0041,94,834 ,9 ,843 ,1341 ,0,3,1,3,0,1,0,76.14,62.86 ,33.33
03,003,01,001,0041,95,723 ,6 ,729 ,1268 ,0,3,1,3,0,1,0,76.14,57.49 ,33.33
03,003,01,001,0042,96,752 ,5 ,757 ,1322 ,0,3,1,3,0,1,0,76.14,57.26 ,33.33
03,003,01,001,0042,97,843 ,3 ,846 ,1434 ,0,3,1,3,0,1,0,76.14,59.00 ,33.33
03,003,01,001,0042,98,737 ,5 ,742 ,1399 ,0,3,1,3,0,1,0,76.14,53.04 ,33.33
03,003,01,001,0043,99,823 ,4 ,827 ,1381 ,0,3,1,3,0,1,0,76.14,59.88 ,33.33
03,003,01,001,0043,100,741 ,6 ,747 ,1225 ,0,3,1,3,0,1,0,76.14,60.98 ,33.33
03,003,01,001,0043,101,750 ,3 ,753 ,1223 ,0,3,1,3,0,1,0,76.14,61.57 ,33.33
03,003,01,001,0044,102,924 ,3 ,927 ,1714 ,0,3,1,3,0,1,0,76.14,54.08 ,33.33
03,003,01,001,0044,103,758 ,3 ,761 ,1551 ,0,3,1,3,0,1,0,76.14,49.07 ,33.33
03,003,01,001,0044,104,744 ,8 ,752 ,1529 ,0,3,1,3,0,1,0,76.14,49.18 ,33.33
03,003,01,001,0044,105,683 ,1 ,684 ,1331 ,0,3,1,3,0,1,0,76.14,51.39 ,33.33
03,003,01,001,0044,106,851 ,5 ,856 ,1664 ,0,3,1,3,0,1,0,76.14,51.44 ,33.33
03,003,01,001,0045,107,597 ,9 ,606 ,1015 ,0,3,1,3,0,1,0,76.14,59.70 ,33.33
03,003,01,001,0045,108,590 ,3 ,593 ,916 ,0,3,1,3,0,1,0,76.14,64.74 ,33.33
03,003,01,001,0046,109,778 ,5 ,783 ,1447 ,0,3,1,3,0,1,0,76.14,54.11 ,33.33
03,003,01,001,0046,110,880 ,7 ,887 ,1501 ,0,3,1,3,0,1,0,76.14,59.09 ,33.33
03,003,01,001,0047,111,713 ,2 ,715 ,1586 ,0,3,1,3,0,1,0,76.14,45.08 ,33.33
03,003,01,001,0047,112,830 ,5 ,835 ,1630 ,0,3,1,3,0,1,0,76.14,51.23 ,33.33
03,003,01,001,0047,113,714 ,4 ,718 ,1452 ,0,3,1,3,0,1,0,76.14,49.45 ,33.33
03,003,01,001,0047,114,753 ,6 ,759 ,1563 ,0,3,1,3,0,1,0,76.14,48.56 ,33.33
03,003,01,001,0048,115,690 ,1 ,691 ,1568 ,0,3,1,3,0,1,0,76.14,44.07 ,33.33
03,003,01,001,0048,116,708 ,7 ,715 ,1338 ,0,3,1,3,0,1,0,76.14,53.44 ,33.33
03,003,01,001,0048,117,634 ,2 ,636 ,1315 ,0,3,1,3,0,1,0,76.14,48.37 ,33.33
03,003,01,001,0048,118,729 ,3 ,732 ,1412 ,0,3,1,3,0,1,0,76.14,51.84 ,33.33
03,003,01,001,0048,119,657 ,1 ,658 ,1358 ,0,3,1,3,0,1,0,76.14,48.45 ,33.33
03,003,01,001,0049,120,864 ,11 ,875 ,1353 ,0,3,1,3,0,1,0,76.14,64.67 ,33.33
03,003,01,001,0049,121,707 ,14 ,721 ,1078 ,0,3,1,3,0,1,0,76.14,66.88 ,33.33
03,003,01,001,0050,122,782 ,16 ,798 ,1427 ,0,3,1,3,0,1,0,76.14,55.92 ,33.33
03,003,01,001,0050,123,908 ,7 ,915 ,1550 ,0,3,1,3,0,1,0,76.14,59.03 ,33.33
03,003,01,001,0050,124,776 ,3 ,779 ,1469 ,0,3,1,3,0,1,0,76.14,53.03 ,33.33
03,003,01,001,0051,125,809 ,8 ,817 ,1404 ,0,3,1,3,0,1,0,76.14,58.19 ,33.33
03,003,01,001,0051,126,729 ,4 ,733 ,1249 ,0,3,1,3,0,1,0,76.14,58.69 ,33.33
03,003,01,001,0051,127,637 ,8 ,645 ,1198 ,0,3,1,3,0,1,0,76.14,53.84 ,33.33
03,003,01,001,0051,128,1127 ,16 ,1143 ,1707 ,0,3,1,3,0,1,0,76.14,66.96 ,33.33
03,003,01,001,0052,129,635 ,9 ,644 ,1246 ,0,3,1,3,0,1,0,76.14,51.69 ,33.33
03,003,01,001,0052,130,807 ,8 ,815 ,1453 ,0,3,1,3,0,1,0,76.14,56.09 ,33.33
03,003,01,001,0052,131,769 ,0 ,769 ,1252 ,0,3,1,3,0,1,0,76.14,61.42 ,33.33
03,003,01,001,0052,132,662 ,2 ,664 ,1220 ,0,3,1,3,0,1,0,76.14,54.43 ,33.33
03,003,01,001,0053,133,710 ,6 ,716 ,1418 ,0,3,1,3,0,1,0,76.14,50.49 ,33.33
03,003,01,001,0053,134,653 ,2 ,655 ,1422 ,0,3,1,3,0,1,0,76.14,46.06 ,33.33
03,003,01,001,0053,135,664 ,3 ,667 ,1249 ,0,3,1,3,0,1,0,76.14,53.40 ,33.33
03,003,01,001,0053,136,523 ,3 ,526 ,1126 ,0,3,1,3,0,1,0,76.14,46.71 ,33.33
03,003,01,001,0054,137,591 ,4 ,595 ,1005 ,0,3,1,3,0,1,0,76.14,59.20 ,33.33
03,003,01,001,0054,138,794 ,5 ,799 ,1328 ,0,3,1,3,0,1,0,76.14,60.17 ,33.33
03,003,01,001,0054,139,660 ,5 ,665 ,1174 ,0,3,1,3,0,1,0,76.14,56.64 ,33.33
03,003,01,001,0054,140,615 ,2 ,617 ,1214 ,0,3,1,3,0,1,0,76.14,50.82 ,33.33
03,003,01,001,0055,141,763 ,6 ,769 ,1392 ,0,3,1,3,0,1,0,76.14,55.24 ,33.33
03,003,01,001,0055,142,810 ,6 ,816 ,1470 ,0,3,1,3,0,1,0,76.14,55.51 ,33.33
03,003,01,001,0056,143,913 ,4 ,917 ,1643 ,0,3,1,3,0,1,0,76.14,55.81 ,33.33
03,003,01,001,0056,144,986 ,7 ,993 ,1648 ,0,3,1,3,0,1,0,76.14,60.25 ,33.33
03,003,01,001,0057,145,928 ,6 ,934 ,1393 ,0,3,1,3,0,1,0,76.14,67.05 ,33.33
03,003,01,001,0058,146,939 ,13 ,952 ,1572 ,0,3,1,3,0,1,0,76.14,60.56 ,33.33
03,003,01,001,0059,147,1080 ,12 ,1092 ,1840 ,0,3,1,3,0,1,0,76.14,59.35 ,33.33
03,003,01,001,0060,148,866 ,10 ,876 ,1474 ,0,3,1,3,0,1,0,76.14,59.43 ,33.33
03,003,01,001,0060,149,703 ,5 ,708 ,1137 ,0,3,1,3,0,1,0,76.14,62.27 ,33.33
03,003,01,001,0060,150,940 ,5 ,945 ,1635 ,0,3,1,3,0,1,0,76.14,57.80 ,33.33
03,003,01,001,0061,151,921 ,8 ,929 ,1503 ,0,3,1,3,0,1,0,76.14,61.81 ,33.33
03,003,01,001,0061,152,1092 ,4 ,1096 ,1867 ,0,3,1,3,0,1,0,76.14,58.70 ,33.33
03,003,01,001,0062,153,1082 ,4 ,1086 ,1726 ,0,3,1,3,0,1,0,76.14,62.92 ,33.33
03,003,01,001,0062,154,1039 ,6 ,1045 ,1829 ,0,3,1,3,0,1,0,76.14,57.14 ,33.33
03,003,01,001,0063,155,915 ,8 ,923 ,1623 ,0,3,1,3,0,1,0,76.14,56.87 ,33.33
03,003,01,001,0063,156,675 ,6 ,681 ,1253 ,0,3,1,3,0,1,0,76.14,54.35 ,33.33
03,003,01,001,0063,157,760 ,4 ,764 ,1522 ,0,3,1,3,0,1,0,76.14,50.20 ,33.33
03,003,01,001,0063,158,620 ,7 ,627 ,1219 ,0,3,1,3,0,1,0,76.14,51.44 ,33.33
03,003,01,001,0063,159,617 ,2 ,619 ,1200 ,0,3,1,3,0,1,0,76.14,51.58 ,33.33
03,003,01,001,0064,160,651 ,8 ,659 ,1162 ,0,3,1,3,0,1,0,76.14,56.71 ,33.33
03,003,01,001,0064,161,611 ,3 ,614 ,1206 ,0,3,1,3,0,1,0,76.14,50.91 ,33.33
03,003,01,001,0064,162,753 ,10 ,763 ,1305 ,0,3,1,3,0,1,0,76.14,58.47 ,33.33
03,003,01,001,0064,163,670 ,3 ,673 ,1268 ,0,3,1,3,0,1,0,76.14,53.08 ,33.33
03,003,01,001,0064,164,482 ,3 ,485 ,1032 ,0,3,1,3,0,1,0,76.14,47.00 ,33.33
03,003,01,001,0065,165,849 ,12 ,861 ,1711 ,0,3,1,3,0,1,0,76.14,50.32 ,33.33
03,003,01,001,0065,166,802 ,9 ,811 ,1573 ,0,3,1,3,0,1,0,76.14,51.56 ,33.33
03,003,01,001,0065,167,698 ,4 ,702 ,1648 ,0,3,1,3,0,1,0,76.14,42.60 ,33.33
03,003,01,001,0066,168,695 ,4 ,699 ,1309 ,0,3,1,3,0,1,0,76.14,53.40 ,33.33
03,003,01,001,0066,169,557 ,10 ,567 ,1291 ,0,3,1,3,0,1,0,76.14,43.92 ,33.33
03,003,01,001,0067,170,772 ,5 ,777 ,1509 ,0,3,1,3,0,1,0,76.14,51.49 ,33.33
03,003,01,001,0067,171,815 ,10 ,825 ,1919 ,0,3,1,3,0,1,0,76.14,42.99 ,33.33
03,003,01,001,0067,172,647 ,4 ,651 ,1256 ,0,3,1,3,0,1,0,76.14,51.83 ,33.33
03,003,01,001,0068,173,697 ,8 ,705 ,1478 ,0,3,1,3,0,1,0,76.14,47.70 ,33.33
03,003,01,001,0068,174,859 ,9 ,868 ,1550 ,0,3,1,3,0,1,0,76.14,56.00 ,33.33
03,003,01,001,0068,175,685 ,10 ,695 ,1445 ,0,3,1,3,0,1,0,76.14,48.10 ,33.33
03,003,01,001,0069,176,1061 ,7 ,1068 ,1675 ,0,3,1,3,0,1,0,76.14,63.76 ,33.33
03,003,01,001,0069,177,990 ,10 ,1000 ,1697 ,0,3,1,3,0,1,0,76.14,58.93 ,33.33
03,003,01,002,0070,178,864 ,10 ,874 ,1308 ,0,3,1,3,0,1,0,76.14,66.82 ,33.33
03,003,01,002,0070,179,934 ,11 ,945 ,1544 ,0,3,1,3,0,1,0,76.14,61.20 ,33.33
03,003,01,002,0070,180,1056 ,7 ,1063 ,1762 ,0,3,1,3,0,1,0,76.14,60.33 ,33.33
03,003,01,002,0071,181,1003 ,7 ,1010 ,1497 ,0,3,1,3,0,1,0,76.14,67.47 ,33.33
03,003,01,002,0071,182,666 ,5 ,671 ,1060 ,0,3,1,3,0,1,0,76.14,63.30 ,33.33
03,003,01,002,0071,183,807 ,8 ,815 ,1350 ,0,3,1,3,0,1,0,76.14,60.37 ,33.33
03,003,01,002,0071,184,829 ,7 ,836 ,1244 ,0,3,1,3,0,1,0,76.14,67.20 ,33.33
03,003,01,002,0072,185,904 ,6 ,910 ,1520 ,0,3,1,3,0,1,0,76.14,59.87 ,33.33
03,003,01,002,0072,186,817 ,8 ,825 ,1433 ,0,3,1,3,0,1,0,76.14,57.57 ,33.33
03,003,01,002,0072,187,869 ,1 ,870 ,1394 ,0,3,1,3,0,1,0,76.14,62.41 ,33.33
03,003,01,002,0073,188,1123 ,4 ,1127 ,1874 ,0,3,1,3,0,1,0,76.14,60.14 ,33.33
03,003,01,002,0073,189,1191 ,8 ,1199 ,1929 ,0,3,1,3,0,1,0,76.14,62.16 ,33.33
03,003,01,002,0074,190,1060 ,7 ,1067 ,1904 ,0,3,1,3,0,1,0,76.14,56.04 ,33.33
03,003,01,002,0075,191,426 ,0 ,426 ,641 ,0,3,1,3,0,1,0,76.14,66.46 ,33.33
03,003,01,002,0076,192,498 ,1 ,499 ,738 ,0,3,1,3,0,1,0,76.14,67.62 ,33.33
03,003,01,002,0076,193,1300 ,13 ,1313 ,1789 ,0,3,1,3,0,1,0,76.14,73.39 ,33.33
03,003,01,002,0077,194,1069 ,16 ,1085 ,1754 ,0,3,1,3,0,1,0,76.14,61.86 ,33.33
03,003,01,002,0078,195,686 ,8 ,694 ,1175 ,0,3,1,3,0,1,0,76.14,59.06 ,33.33
03,003,01,002,0078,196,675 ,4 ,679 ,1434 ,0,3,1,3,0,1,0,76.14,47.35 ,33.33
03,003,01,002,0079,197,885 ,21 ,906 ,1590 ,0,3,1,3,0,1,0,76.14,56.98 ,33.33
03,003,01,002,0079,198,703 ,7 ,710 ,1343 ,0,3,1,3,0,1,0,76.14,52.87 ,33.33
03,003,01,002,0079,199,705 ,12 ,717 ,1426 ,0,3,1,3,0,1,0,76.14,50.28 ,33.33
03,003,01,002,0080,200,668 ,10 ,678 ,1264 ,0,3,1,3,0,1,0,76.14,53.64 ,33.33
03,003,01,002,0080,201,706 ,8 ,714 ,1380 ,0,3,1,3,0,1,0,76.14,51.74 ,33.33
03,003,01,002,0081,202,268 ,4 ,272 ,567 ,0,3,1,3,0,1,0,76.14,47.97 ,33.33
03,003,01,002,0081,203,609 ,6 ,615 ,938 ,0,3,1,3,0,1,0,76.14,65.57 ,33.33
03,003,01,002,0082,204,576 ,9 ,585 ,954 ,0,3,1,3,0,1,0,76.14,61.32 ,33.33
03,003,01,002,0082,205,661 ,5 ,666 ,1095 ,0,3,1,3,0,1,0,76.14,60.82 ,33.33
03,003,01,002,0082,206,543 ,5 ,548 ,1101 ,0,3,1,3,0,1,0,76.14,49.77 ,33.33
03,003,01,002,0083,207,767 ,7 ,774 ,1390 ,0,3,1,3,0,1,0,76.14,55.68 ,33.33
03,003,01,002,0083,208,892 ,10 ,902 ,1570 ,0,3,1,3,0,1,0,76.14,57.45 ,33.33
03,003,01,002,0084,209,665 ,9 ,674 ,1042 ,0,3,1,3,0,1,0,76.14,64.68 ,33.33
03,003,01,002,0084,210,584 ,2 ,586 ,921 ,0,3,1,3,0,1,0,76.14,63.63 ,33.33
03,003,01,002,0085,211,895 ,9 ,904 ,1576 ,0,3,1,3,0,1,0,76.14,57.36 ,33.33
03,003,01,002,0085,212,861 ,9 ,870 ,1437 ,0,3,1,3,0,1,0,76.14,60.54 ,33.33
03,003,01,002,0085,213,1030 ,7 ,1037 ,1706 ,0,3,1,3,0,1,0,76.14,60.79 ,33.33
03,003,01,002,0086,214,970 ,10 ,980 ,1738 ,0,3,1,3,0,1,0,76.14,56.39 ,33.33
03,003,01,002,0086,215,1144 ,9 ,1153 ,2227 ,0,3,1,3,0,1,0,76.14,51.77 ,33.33
03,003,01,002,0087,216,862 ,10 ,872 ,1478 ,0,3,1,3,0,1,0,76.14,59.00 ,33.33
03,003,01,002,0087,217,807 ,6 ,813 ,1356 ,0,3,1,3,0,1,0,76.14,59.96 ,33.33
03,003,01,002,0088,218,769 ,6 ,775 ,1381 ,0,3,1,3,0,1,0,76.14,56.12 ,33.33
03,003,01,002,0088,219,730 ,14 ,744 ,1431 ,0,3,1,3,0,1,0,76.14,51.99 ,33.33
03,003,01,002,0088,220,670 ,11 ,681 ,1310 ,0,3,1,3,0,1,0,76.14,51.98 ,33.33
03,003,01,002,0089,221,610 ,5 ,615 ,1420 ,0,3,1,3,0,1,0,76.14,43.31 ,33.33
03,003,01,002,0089,222,567 ,3 ,570 ,1117 ,0,3,1,3,0,1,0,76.14,51.03 ,33.33
03,003,01,002,0090,223,754 ,3 ,757 ,1476 ,0,3,1,3,0,1,0,76.14,51.29 ,33.33
03,003,01,002,0090,224,918 ,8 ,926 ,1803 ,0,3,1,3,0,1,0,76.14,51.36 ,33.33
03,003,01,002,0091,225,943 ,11 ,954 ,1410 ,0,3,1,3,0,1,0,76.14,67.66 ,33.33
03,003,01,002,0091,226,902 ,4 ,906 ,1493 ,0,3,1,3,0,1,0,76.14,60.68 ,33.33
03,003,01,002,0092,227,742 ,6 ,748 ,1141 ,0,3,1,3,0,1,0,76.14,65.56 ,33.33
03,003,01,002,0093,228,710 ,4 ,714 ,1335 ,0,3,1,3,0,1,0,76.14,53.48 ,33.33
03,003,01,002,0093,229,708 ,2 ,710 ,1516 ,0,3,1,3,0,1,0,76.14,46.83 ,33.33
03,003,01,002,0094,230,710 ,58 ,768 ,1478 ,0,3,1,3,0,1,0,76.14,51.96 ,33.33
03,003,01,002,0094,231,588 ,8 ,596 ,1277 ,0,3,1,3,0,1,0,76.14,46.67 ,33.33
03,003,01,002,0095,232,546 ,6 ,552 ,1251 ,0,3,1,3,0,1,0,76.14,44.12 ,33.33
03,003,01,002,0095,233,618 ,7 ,625 ,1391 ,0,3,1,3,0,1,0,76.14,44.93 ,33.33
03,003,01,002,0096,234,818 ,13 ,831 ,1333 ,0,3,1,3,0,1,0,76.14,62.34 ,33.33
03,003,01,002,0097,235,797 ,5 ,802 ,1307 ,0,3,1,3,0,1,0,76.14,61.36 ,33.33
03,003,01,002,0098,236,810 ,8 ,818 ,1399 ,0,3,1,3,0,1,0,76.14,58.47 ,33.33
03,003,01,002,0099,237,938 ,4 ,942 ,1521 ,0,3,1,3,0,1,0,76.14,61.93 ,33.33
03,003,01,002,0099,238,1062 ,6 ,1068 ,1728 ,0,3,1,3,0,1,0,76.14,61.81 ,33.33
03,003,01,003,0100,239,868 ,8 ,876 ,1557 ,0,3,1,3,0,1,0,76.14,56.26 ,33.33
03,003,01,003,0100,240,876 ,3 ,879 ,2004 ,0,3,1,3,0,1,0,76.14,43.86 ,33.33
03,003,01,003,0101,241,896 ,8 ,904 ,1561 ,0,3,1,3,0,1,0,76.14,57.91 ,33.33
03,003,01,003,0101,242,781 ,8 ,789 ,1344 ,0,3,1,3,0,1,0,76.14,58.71 ,33.33
03,003,01,003,0102,243,812 ,11 ,823 ,1335 ,0,3,1,3,0,1,0,76.14,61.65 ,33.33
03,003,01,003,0103,244,1261 ,11 ,1272 ,2160 ,0,3,1,3,0,1,0,76.14,58.89 ,33.33
03,003,01,003,0104,245,866 ,11 ,877 ,1538 ,0,3,1,3,0,1,0,76.14,57.02 ,33.33
03,003,01,003,0104,246,832 ,10 ,842 ,1517 ,0,3,1,3,0,1,0,76.14,55.50 ,33.33
03,003,01,003,0105,247,862 ,12 ,874 ,1501 ,0,3,1,3,0,1,0,76.14,58.23 ,33.33
03,003,01,003,0105,248,901 ,15 ,916 ,1604 ,0,3,1,3,0,1,0,76.14,57.11 ,33.33
03,003,01,003,0106,249,964 ,6 ,970 ,1522 ,0,3,1,3,0,1,0,76.14,63.73 ,33.33
03,003,01,003,0106,250,884 ,8 ,892 ,1433 ,0,3,1,3,0,1,0,76.14,62.25 ,33.33
03,003,01,003,0107,251,855 ,16 ,871 ,1401 ,0,3,1,3,0,1,0,76.14,62.17 ,33.33
03,003,01,003,0107,252,855 ,11 ,866 ,1417 ,0,3,1,3,0,1,0,76.14,61.12 ,33.33
03,003,01,003,0108,253,1063 ,19 ,1082 ,1992 ,0,3,1,3,0,1,0,76.14,54.32 ,33.33
03,003,01,003,0108,254,996 ,17 ,1013 ,1713 ,0,3,1,3,0,1,0,76.14,59.14 ,33.33
03,003,01,003,0108,255,781 ,13 ,794 ,1265 ,0,3,1,3,0,1,0,76.14,62.77 ,33.33
03,003,01,003,0109,256,1254 ,12 ,1266 ,2034 ,0,3,1,3,0,1,0,76.14,62.24 ,33.33
03,003,01,003,0109,257,637 ,6 ,643 ,1016 ,0,3,1,3,0,1,0,76.14,63.29 ,33.33
03,003,01,003,0110,258,871 ,9 ,880 ,1496 ,0,3,1,3,0,1,0,76.14,58.82 ,33.33
03,003,01,003,0110,259,822 ,8 ,830 ,1417 ,0,3,1,3,0,1,0,76.14,58.57 ,33.33
03,003,01,003,0111,260,976 ,13 ,989 ,1661 ,0,3,1,3,0,1,0,76.14,59.54 ,33.33
03,003,01,003,0111,261,714 ,7 ,721 ,1102 ,0,3,1,3,0,1,0,76.14,65.43 ,33.33
03,003,01,003,0111,262,783 ,8 ,791 ,1176 ,0,3,1,3,0,1,0,76.14,67.26 ,33.33
03,003,01,003,0112,263,676 ,10 ,686 ,1471 ,0,3,1,3,0,1,0,76.14,46.63 ,33.33
03,003,01,003,0112,264,847 ,7 ,854 ,1553 ,0,3,1,3,0,1,0,76.14,54.99 ,33.33
03,003,01,003,0113,265,927 ,5 ,932 ,1628 ,0,3,1,3,0,1,0,76.14,57.25 ,33.33
03,003,01,003,0113,266,696 ,10 ,706 ,1300 ,0,3,1,3,0,1,0,76.14,54.31 ,33.33
03,003,01,003,0113,267,764 ,14 ,778 ,1248 ,0,3,1,3,0,1,0,76.14,62.34 ,33.33
03,003,01,003,0114,268,930 ,15 ,945 ,1771 ,0,3,1,3,0,1,0,76.14,53.36 ,33.33
03,003,01,003,0114,269,710 ,14 ,724 ,1313 ,0,3,1,3,0,1,0,76.14,55.14 ,33.33
03,003,01,003,0115,270,1221 ,12 ,1233 ,2059 ,0,3,1,3,0,1,0,76.14,59.88 ,33.33
03,003,01,003,0116,271,1038 ,9 ,1047 ,1742 ,0,3,1,3,0,1,0,76.14,60.10 ,33.33
03,003,01,003,0116,272,420 ,4 ,424 ,686 ,0,3,1,3,0,1,0,76.14,61.81 ,33.33
03,003,01,003,0117,273,658 ,6 ,664 ,1189 ,0,3,1,3,0,1,0,76.14,55.85 ,33.33
03,003,01,003,0117,274,797 ,15 ,812 ,1519 ,0,3,1,3,0,1,0,76.14,53.46 ,33.33
03,003,01,003,0118,275,959 ,13 ,972 ,1722 ,0,3,1,3,0,1,0,76.14,56.45 ,33.33
03,003,01,003,0119,276,1044 ,8 ,1052 ,1807 ,0,3,1,3,0,1,0,76.14,58.22 ,33.33
03,003,01,003,0119,277,763 ,5 ,768 ,1356 ,0,3,1,3,0,1,0,76.14,56.64 ,33.33
03,003,01,003,0120,278,830 ,6 ,836 ,1558 ,0,3,1,3,0,1,0,76.14,53.66 ,33.33
03,003,01,003,0120,279,375 ,1 ,376 ,695 ,0,3,1,3,0,1,0,76.14,54.10 ,33.33
03,003,01,003,0121,280,650 ,7 ,657 ,1161 ,0,3,1,3,0,1,0,76.14,56.59 ,33.33
03,003,01,003,0121,281,837 ,10 ,847 ,1380 ,0,3,1,3,0,1,0,76.14,61.38 ,33.33
03,003,01,003,0122,282,824 ,5 ,829 ,1451 ,0,3,1,3,0,1,0,76.14,57.13 ,33.33
03,003,01,003,0123,283,623 ,8 ,631 ,1101 ,0,3,1,3,0,1,0,76.14,57.31 ,33.33
03,003,01,003,0123,284,694 ,10 ,704 ,1101 ,0,3,1,3,0,1,0,76.14,63.94 ,33.33
03,003,01,003,0124,285,526 ,12 ,538 ,930 ,0,3,1,3,0,1,0,76.14,57.85 ,33.33
03,003,01,003,0124,286,516 ,6 ,522 ,891 ,0,3,1,3,0,1,0,76.14,58.59 ,33.33
03,003,01,003,0125,287,832 ,5 ,837 ,1521 ,0,3,1,3,0,1,0,76.14,55.03 ,33.33
03,003,01,003,0125,288,576 ,1 ,577 ,1179 ,0,3,1,3,0,1,0,76.14,48.94 ,33.33
03,003,01,003,0125,289,744 ,6 ,750 ,1267 ,0,3,1,3,0,1,0,76.14,59.19 ,33.33
03,003,01,003,0126,290,1161 ,13 ,1174 ,2131 ,0,3,1,3,0,1,0,76.14,55.09 ,33.33
03,003,01,003,0126,291,653 ,4 ,657 ,1189 ,0,3,1,3,0,1,0,76.14,55.26 ,33.33
03,003,01,003,0127,292,592 ,5 ,597 ,945 ,0,3,1,3,0,1,0,76.14,63.17 ,33.33
03,003,01,003,0127,293,970 ,7 ,977 ,1656 ,0,3,1,3,0,1,0,76.14,59.00 ,33.33
03,003,01,003,0128,294,852 ,8 ,860 ,1693 ,0,3,1,3,0,1,0,76.14,50.80 ,33.33
03,003,01,003,0128,295,805 ,7 ,812 ,1134 ,0,3,1,3,0,1,0,76.14,71.60 ,33.33
03,003,01,003,0128,296,775 ,18 ,793 ,1703 ,0,3,1,3,0,1,0,76.14,46.56 ,33.33
03,003,01,003,0129,297,1331 ,17 ,1348 ,1879 ,0,3,1,3,0,1,0,76.14,71.74 ,33.33
03,003,01,003,0129,298,1185 ,14 ,1199 ,1828 ,0,3,1,3,0,1,0,76.14,65.59 ,33.33
03,003,01,003,0130,299,777 ,11 ,788 ,1370 ,0,3,1,3,0,1,0,76.14,57.52 ,33.33
03,003,01,003,0131,300,1048 ,12 ,1060 ,1669 ,0,3,1,3,0,1,0,76.14,63.51 ,33.33
03,003,01,003,0131,301,1018 ,12 ,1030 ,1703 ,0,3,1,3,0,1,0,76.14,60.48 ,33.33
03,003,01,003,0132,302,869 ,12 ,881 ,1552 ,0,3,1,3,0,1,0,76.14,56.77 ,33.33
03,003,01,003,0132,303,939 ,9 ,948 ,1586 ,0,3,1,3,0,1,0,76.14,59.77 ,33.33
03,003,01,003,0133,304,603 ,4 ,607 ,987 ,0,3,1,3,0,1,0,76.14,61.50 ,33.33
03,003,01,003,0133,305,469 ,7 ,476 ,827 ,0,3,1,3,0,1,0,76.14,57.56 ,33.33
03,003,01,003,0134,306,829 ,7 ,836 ,1323 ,0,3,1,3,0,1,0,76.14,63.19 ,33.33
03,003,01,003,0134,307,650 ,6 ,656 ,1050 ,0,3,1,3,0,1,0,76.14,62.48 ,33.33
03,003,01,003,0135,308,1228 ,16 ,1244 ,2070 ,0,3,1,3,0,1,0,76.14,60.10 ,33.33
03,003,01,003,0136,309,655 ,12 ,667 ,1056 ,0,3,1,3,0,1,0,76.14,63.16 ,33.33
03,003,01,003,0136,310,607 ,3 ,610 ,1060 ,0,3,1,3,0,1,0,76.14,57.55 ,33.33
03,003,01,003,0137,311,588 ,3 ,591 ,967 ,0,3,1,3,0,1,0,76.14,61.12 ,33.33
03,003,01,003,0137,312,834 ,3 ,837 ,1496 ,0,3,1,3,0,1,0,76.14,55.95 ,33.33
03,003,01,003,0137,313,601 ,5 ,606 ,1042 ,0,3,1,3,0,1,0,76.14,58.16 ,33.33
03,003,01,003,0138,314,740 ,15 ,755 ,1270 ,0,3,1,3,0,1,0,76.14,59.45 ,33.33
03,003,01,003,0138,315,755 ,8 ,763 ,1344 ,0,3,1,3,0,1,0,76.14,56.77 ,33.33
03,003,01,003,0139,316,681 ,6 ,687 ,1181 ,0,3,1,3,0,1,0,76.14,58.17 ,33.33
03,003,01,003,0139,317,559 ,7 ,566 ,1020 ,0,3,1,3,0,1,0,76.14,55.49 ,33.33
03,003,01,003,0140,318,818 ,11 ,829 ,1520 ,0,3,1,3,0,1,0,76.14,54.54 ,33.33
03,003,01,003,0141,319,864 ,6 ,870 ,1556 ,0,3,1,3,0,1,0,76.14,55.91 ,33.33
03,003,01,003,0142,320,701 ,6 ,707 ,1306 ,0,3,1,3,0,1,0,76.14,54.13 ,33.33
03,003,01,003,0142,321,628 ,10 ,638 ,1164 ,0,3,1,3,0,1,0,76.14,54.81 ,33.33
03,003,01,004,0143,322,743 ,8 ,751 ,1230 ,0,3,1,3,0,1,0,76.14,61.06 ,33.33
03,003,01,004,0143,323,643 ,11 ,654 ,999 ,0,3,1,3,0,1,0,76.14,65.47 ,33.33
03,003,01,004,0143,324,600 ,3 ,603 ,1093 ,0,3,1,3,0,1,0,76.14,55.17 ,33.33
03,003,01,004,0144,325,1001 ,12 ,1013 ,1804 ,0,3,1,3,0,1,0,76.14,56.15 ,33.33
03,003,01,004,0144,326,1067 ,12 ,1079 ,1685 ,0,3,1,3,0,1,0,76.14,64.04 ,33.33
03,003,01,004,0145,327,1003 ,48 ,1051 ,1847 ,0,3,1,3,0,1,0,76.14,56.90 ,33.33
03,003,01,004,0145,328,741 ,13 ,754 ,1252 ,0,3,1,3,0,1,0,76.14,60.22 ,33.33
03,003,01,004,0146,329,714 ,6 ,720 ,1214 ,0,3,1,3,0,1,0,76.14,59.31 ,33.33
03,003,01,004,0146,330,568 ,5 ,573 ,971 ,0,3,1,3,0,1,0,76.14,59.01 ,33.33
03,003,01,004,0147,331,683 ,3 ,686 ,1064 ,0,3,1,3,0,1,0,76.14,64.47 ,33.33
03,003,01,004,0147,332,707 ,8 ,715 ,1172 ,0,3,1,3,0,1,0,76.14,61.01 ,33.33
03,003,01,004,0148,333,843 ,9 ,852 ,1554 ,0,3,1,3,0,1,0,76.14,54.83 ,33.33
03,003,01,004,0148,334,853 ,3 ,856 ,1408 ,0,3,1,3,0,1,0,76.14,60.80 ,33.33
03,003,01,004,0149,335,745 ,6 ,751 ,1164 ,0,3,1,3,0,1,0,76.14,64.52 ,33.33
03,003,01,004,0150,336,886 ,5 ,891 ,1348 ,0,3,1,3,0,1,0,76.14,66.10 ,33.33
03,003,01,004,0151,337,620 ,10 ,630 ,1002 ,0,3,1,3,0,1,0,76.14,62.87 ,33.33
03,003,01,004,0151,338,668 ,5 ,673 ,978 ,0,3,1,3,0,1,0,76.14,68.81 ,33.33
03,003,01,004,0151,339,641 ,2 ,643 ,958 ,0,3,1,3,0,1,0,76.14,67.12 ,33.33
03,003,01,004,0152,340,807 ,5 ,812 ,1269 ,0,3,1,3,0,1,0,76.14,63.99 ,33.33
03,003,01,004,0152,341,1101 ,7 ,1108 ,2296 ,0,3,1,3,0,1,0,76.14,48.26 ,33.33
03,003,01,004,0152,342,697 ,6 ,703 ,1422 ,0,3,1,3,0,1,0,76.14,49.44 ,33.33
03,003,01,004,0152,343,1169 ,15 ,1184 ,2555 ,0,3,1,3,0,1,0,76.14,46.34 ,33.33
03,003,01,004,0152,344,687 ,4 ,691 ,1622 ,0,3,1,3,0,1,0,76.14,42.60 ,33.33
03,003,01,004,0152,345,596 ,5 ,601 ,1361 ,0,3,1,3,0,1,0,76.14,44.16 ,33.33
03,003,01,004,0153,346,745 ,2 ,747 ,1474 ,0,3,1,3,0,1,0,76.14,50.68 ,33.33
03,003,01,004,0153,347,825 ,7 ,832 ,1531 ,0,3,1,3,0,1,0,76.14,54.34 ,33.33
03,003,01,004,0154,348,704 ,2 ,706 ,1137 ,0,3,1,3,0,1,0,76.14,62.09 ,33.33
03,003,01,004,0154,349,776 ,12 ,788 ,1614 ,0,3,1,3,0,1,0,76.14,48.82 ,33.33
03,003,01,004,0155,350,929 ,5 ,934 ,1629 ,0,3,1,3,0,1,0,76.14,57.34 ,33.33
03,003,01,004,0155,351,873 ,8 ,881 ,1583 ,0,3,1,3,0,1,0,76.14,55.65 ,33.33
03,003,01,004,0156,352,562 ,5 ,567 ,892 ,0,3,1,3,0,1,0,76.14,63.57 ,33.33
03,003,01,004,0156,353,571 ,2 ,573 ,928 ,0,3,1,3,0,1,0,76.14,61.75 ,33.33
03,003,01,004,0157,354,942 ,15 ,957 ,1776 ,0,3,1,3,0,1,0,76.14,53.89 ,33.33
03,003,01,004,0158,355,851 ,6 ,857 ,1648 ,0,3,1,3,0,1,0,76.14,52.00 ,33.33
03,003,01,004,0158,356,719 ,5 ,724 ,1558 ,0,3,1,3,0,1,0,76.14,46.47 ,33.33
03,003,01,004,0158,357,605 ,2 ,607 ,1371 ,0,3,1,3,0,1,0,76.14,44.27 ,33.33
03,003,01,004,0159,358,715 ,8 ,723 ,1296 ,0,3,1,3,0,1,0,76.14,55.79 ,33.33
03,003,01,004,0159,359,737 ,4 ,741 ,1389 ,0,3,1,3,0,1,0,76.14,53.35 ,33.33
03,003,01,004,0159,360,797 ,3 ,800 ,1583 ,0,3,1,3,0,1,0,76.14,50.54 ,33.33
03,003,01,004,0159,361,929 ,7 ,936 ,1855 ,0,3,1,3,0,1,0,76.14,50.46 ,33.33
03,003,01,004,0160,362,554 ,4 ,558 ,1160 ,0,3,1,3,0,1,0,76.14,48.10 ,33.33
03,003,01,004,0160,363,641 ,7 ,648 ,1186 ,0,3,1,3,0,1,0,76.14,54.64 ,33.33
03,003,01,004,0160,364,761 ,7 ,768 ,1483 ,0,3,1,3,0,1,0,76.14,51.79 ,33.33
03,003,01,004,0161,365,865 ,11 ,876 ,1832 ,0,3,1,3,0,1,0,76.14,47.82 ,33.33
03,003,01,004,0162,366,545 ,5 ,550 ,868 ,0,3,1,3,0,1,0,76.14,63.36 ,33.33
03,003,01,004,0162,367,674 ,9 ,683 ,1022 ,0,3,1,3,0,1,0,76.14,66.83 ,33.33
03,003,01,004,0163,368,842 ,9 ,851 ,1455 ,0,3,1,3,0,1,0,76.14,58.49 ,33.33
03,003,01,004,0164,369,657 ,4 ,661 ,1108 ,0,3,1,3,0,1,0,76.14,59.66 ,33.33
03,003,01,004,0164,370,624 ,5 ,629 ,1092 ,0,3,1,3,0,1,0,76.14,57.60 ,33.33
03,003,01,004,0164,371,688 ,5 ,693 ,1000 ,0,3,1,3,0,1,0,76.14,69.30 ,33.33
03,003,01,004,0165,372,831 ,7 ,838 ,1242 ,0,3,1,3,0,1,0,76.14,67.47 ,33.33
03,003,01,004,0166,373,1026 ,11 ,1037 ,1552 ,0,3,1,3,0,1,0,76.14,66.82 ,33.33
03,003,01,004,0167,374,555 ,9 ,564 ,882 ,0,3,1,3,0,1,0,76.14,63.95 ,33.33
03,003,01,004,0167,375,867 ,13 ,880 ,1313 ,0,3,1,3,0,1,0,76.14,67.02 ,33.33
03,003,01,004,0168,376,777 ,14 ,791 ,1456 ,0,3,1,3,0,1,0,76.14,54.33 ,33.33
03,003,01,004,0168,377,744 ,7 ,751 ,1268 ,0,3,1,3,0,1,0,76.14,59.23 ,33.33
03,003,01,004,0168,378,639 ,6 ,645 ,1182 ,0,3,1,3,0,1,0,76.14,54.57 ,33.33
03,003,01,005,0169,379,815 ,6 ,821 ,1276 ,0,3,1,3,0,1,0,76.14,64.34 ,33.33
03,003,01,005,0169,380,918 ,5 ,923 ,1331 ,0,3,1,3,0,1,0,76.14,69.35 ,33.33
03,003,01,005,0169,381,876 ,5 ,881 ,1397 ,0,3,1,3,0,1,0,76.14,63.06 ,33.33
03,003,01,005,0169,382,796 ,7 ,803 ,1208 ,0,3,1,3,0,1,0,76.14,66.47 ,33.33
03,003,01,005,0170,383,911 ,4 ,915 ,1435 ,0,3,1,3,0,1,0,76.14,63.76 ,33.33
03,003,01,005,0170,384,893 ,4 ,897 ,1458 ,0,3,1,3,0,1,0,76.14,61.52 ,33.33
03,003,01,005,0170,385,912 ,10 ,922 ,1505 ,0,3,1,3,0,1,0,76.14,61.26 ,33.33
03,003,01,005,0171,386,935 ,11 ,946 ,1642 ,0,3,1,3,0,1,0,76.14,57.61 ,33.33
03,003,01,005,0171,387,913 ,12 ,925 ,1639 ,0,3,1,3,0,1,0,76.14,56.44 ,33.33
03,003,01,005,0172,388,894 ,10 ,904 ,1442 ,0,3,1,3,0,1,0,76.14,62.69 ,33.33
03,003,01,005,0173,389,716 ,10 ,726 ,1235 ,0,3,1,3,0,1,0,76.14,58.79 ,33.33
03,003,01,005,0173,390,664 ,11 ,675 ,1193 ,0,3,1,3,0,1,0,76.14,56.58 ,33.33
03,003,01,005,0173,391,724 ,13 ,737 ,1242 ,0,3,1,3,0,1,0,76.14,59.34 ,33.33
03,003,01,005,0173,392,885 ,8 ,893 ,1432 ,0,3,1,3,0,1,0,76.14,62.36 ,33.33
03,003,01,005,0174,393,726 ,7 ,733 ,1099 ,0,3,1,3,0,1,0,76.14,66.70 ,33.33
03,003,01,005,0174,394,910 ,7 ,917 ,1384 ,0,3,1,3,0,1,0,76.14,66.26 ,33.33
03,003,01,005,0174,395,791 ,9 ,800 ,1286 ,0,3,1,3,0,1,0,76.14,62.21 ,33.33
03,003,01,005,0175,396,1038 ,11 ,1049 ,1598 ,0,3,1,3,0,1,0,76.14,65.64 ,33.33
03,003,01,005,0175,397,790 ,6 ,796 ,1311 ,0,3,1,3,0,1,0,76.14,60.72 ,33.33
03,003,01,005,0175,398,912 ,13 ,925 ,1496 ,0,3,1,3,0,1,0,76.14,61.83 ,33.33
03,003,01,005,0176,399,929 ,13 ,942 ,1341 ,0,3,1,3,0,1,0,76.14,70.25 ,33.33
03,003,01,005,0177,400,477 ,4 ,481 ,694 ,0,3,1,3,0,1,0,76.14,69.31 ,33.33
03,003,01,005,0178,401,717 ,7 ,724 ,1089 ,0,3,1,3,0,1,0,76.14,66.48 ,33.33
03,003,01,005,0178,402,963 ,17 ,980 ,1446 ,0,3,1,3,0,1,0,76.14,67.77 ,33.33
03,003,01,005,0179,403,848 ,7 ,855 ,1470 ,0,3,1,3,0,1,0,76.14,58.16 ,33.33
03,003,01,005,0179,404,802 ,3 ,805 ,1412 ,0,3,1,3,0,1,0,76.14,57.01 ,33.33
03,003,01,005,0179,405,825 ,14 ,839 ,1620 ,0,3,1,3,0,1,0,76.14,51.79 ,33.33
03,003,01,005,0180,406,796 ,3 ,799 ,1238 ,0,3,1,3,0,1,0,76.14,64.54 ,33.33
03,003,01,005,0180,407,682 ,8 ,690 ,1114 ,0,3,1,3,0,1,0,76.14,61.94 ,33.33
03,003,01,005,0181,408,823 ,4 ,827 ,1414 ,0,3,1,3,0,1,0,76.14,58.49 ,33.33
03,003,01,005,0182,409,704 ,5 ,709 ,1200 ,0,3,1,3,0,1,0,76.14,59.08 ,33.33
03,003,01,005,0182,410,778 ,12 ,790 ,1339 ,0,3,1,3,0,1,0,76.14,59.00 ,33.33
03,003,01,005,0183,411,1102 ,8 ,1110 ,1764 ,0,3,1,3,0,1,0,76.14,62.93 ,33.33
03,003,01,005,0184,412,562 ,5 ,567 ,892 ,0,3,1,3,0,1,0,76.14,63.57 ,33.33
03,003,01,005,0184,413,692 ,5 ,697 ,1125 ,0,3,1,3,0,1,0,76.14,61.96 ,33.33
03,003,01,005,0185,414,1062 ,12 ,1074 ,1738 ,0,3,1,3,0,1,0,76.14,61.80 ,33.33
03,003,01,005,0186,415,747 ,4 ,751 ,1222 ,0,3,1,3,0,1,0,76.14,61.46 ,33.33
03,003,01,005,0186,416,623 ,6 ,629 ,1132 ,0,3,1,3,0,1,0,76.14,55.57 ,33.33
03,003,01,005,0187,417,700 ,12 ,712 ,1330 ,0,3,1,3,0,1,0,76.14,53.53 ,33.33
03,003,01,005,0187,418,557 ,4 ,561 ,1216 ,0,3,1,3,0,1,0,76.14,46.13 ,33.33
03,003,01,006,0188,419,540 ,2 ,542 ,790 ,0,3,1,3,0,1,0,76.14,68.61 ,33.33
03,003,01,006,0188,420,521 ,10 ,531 ,834 ,0,3,1,3,0,1,0,76.14,63.67 ,33.33
03,003,01,006,0189,421,675 ,5 ,680 ,1039 ,0,3,1,3,0,1,0,76.14,65.45 ,33.33
03,003,01,006,0190,422,845 ,5 ,850 ,1424 ,0,3,1,3,0,1,0,76.14,59.69 ,33.33
03,003,01,006,0190,423,670 ,4 ,674 ,1123 ,0,3,1,3,0,1,0,76.14,60.02 ,33.33
03,003,01,006,0190,424,717 ,3 ,720 ,1222 ,0,3,1,3,0,1,0,76.14,58.92 ,33.33
03,003,01,006,0191,425,644 ,7 ,651 ,1110 ,0,3,1,3,0,1,0,76.14,58.65 ,33.33
03,003,01,006,0191,426,730 ,9 ,739 ,1209 ,0,3,1,3,0,1,0,76.14,61.12 ,33.33
03,003,01,006,0191,427,646 ,7 ,653 ,1052 ,0,3,1,3,0,1,0,76.14,62.07 ,33.33
03,003,01,006,0192,428,890 ,8 ,898 ,1528 ,0,3,1,3,0,1,0,76.14,58.77 ,33.33
03,003,01,006,0192,429,728 ,4 ,732 ,1164 ,0,3,1,3,0,1,0,76.14,62.89 ,33.33
03,003,01,006,0192,430,748 ,7 ,755 ,1305 ,0,3,1,3,0,1,0,76.14,57.85 ,33.33
03,003,01,006,0193,431,670 ,8 ,678 ,1078 ,0,3,1,3,0,1,0,76.14,62.89 ,33.33
03,003,01,006,0194,432,588 ,2 ,590 ,944 ,0,3,1,3,0,1,0,76.14,62.50 ,33.33
03,003,01,006,0195,433,723 ,9 ,732 ,1063 ,0,3,1,3,0,1,0,76.14,68.86 ,33.33
03,003,01,006,0196,434,597 ,9 ,606 ,960 ,0,3,1,3,0,1,0,76.14,63.13 ,33.33
03,003,01,006,0196,435,352 ,4 ,356 ,576 ,0,3,1,3,0,1,0,76.14,61.81 ,33.33
03,003,01,006,0197,436,609 ,2 ,611 ,1033 ,0,3,1,3,0,1,0,76.14,59.15 ,33.33
03,003,01,006,0197,437,624 ,14 ,638 ,990 ,0,3,1,3,0,1,0,76.14,64.44 ,33.33
03,003,01,006,0197,438,474 ,3 ,477 ,721 ,0,3,1,3,0,1,0,76.14,66.16 ,33.33
03,003,01,006,0198,439,699 ,6 ,705 ,1214 ,0,3,1,3,0,1,0,76.14,58.07 ,33.33
03,003,01,006,0198,440,575 ,7 ,582 ,932 ,0,3,1,3,0,1,0,76.14,62.45 ,33.33
03,003,01,006,0199,441,592 ,6 ,598 ,951 ,0,3,1,3,0,1,0,76.14,62.88 ,33.33
03,003,01,006,0200,442,379 ,2 ,381 ,614 ,0,3,1,3,0,1,0,76.14,62.05 ,33.33
03,003,01,006,0200,443,140 ,1 ,141 ,262 ,0,3,1,3,0,1,0,76.14,53.82 ,33.33
03,003,01,006,0201,444,554 ,8 ,562 ,812 ,0,3,1,3,0,1,0,76.14,69.21 ,33.33
03,003,01,006,0201,445,466 ,6 ,472 ,734 ,0,3,1,3,0,1,0,76.14,64.31 ,33.33
03,003,01,006,0202,446,854 ,14 ,868 ,1372 ,0,3,1,3,0,1,0,76.14,63.27 ,33.33
03,003,01,006,0202,447,416 ,3 ,419 ,675 ,0,3,1,3,0,1,0,76.14,62.07 ,33.33
03,003,01,006,0203,448,666 ,9 ,675 ,1242 ,0,3,1,3,0,1,0,76.14,54.35 ,33.33
03,003,01,006,0203,449,484 ,6 ,490 ,879 ,0,3,1,3,0,1,0,76.14,55.75 ,33.33
03,003,01,006,0203,450,541 ,5 ,546 ,904 ,0,3,1,3,0,1,0,76.14,60.40 ,33.33
03,003,01,006,0204,451,1240 ,15 ,1255 ,1794 ,0,3,1,3,0,1,0,76.14,69.96 ,33.33
03,003,01,006,0205,452,628 ,7 ,635 ,1015 ,0,3,1,3,0,1,0,76.14,62.56 ,33.33
03,003,01,006,0205,453,513 ,10 ,523 ,776 ,0,3,1,3,0,1,0,76.14,67.40 ,33.33
03,003,01,006,0205,454,537 ,2 ,539 ,797 ,0,3,1,3,0,1,0,76.14,67.63 ,33.33
03,003,01,006,0206,455,508 ,4 ,512 ,896 ,0,3,1,3,0,1,0,76.14,57.14 ,33.33
03,003,01,006,0206,456,818 ,7 ,825 ,1457 ,0,3,1,3,0,1,0,76.14,56.62 ,33.33
03,003,01,006,0207,457,868 ,5 ,873 ,1351 ,0,3,1,3,0,1,0,76.14,64.62 ,33.33
03,003,01,006,0207,458,368 ,5 ,373 ,723 ,0,3,1,3,0,1,0,76.14,51.59 ,33.33
03,003,01,006,0208,459,539 ,5 ,544 ,914 ,0,3,1,3,0,1,0,76.14,59.52 ,33.33
03,003,01,006,0208,460,696 ,7 ,703 ,1171 ,0,3,1,3,0,1,0,76.14,60.03 ,33.33
03,003,01,006,0209,461,671 ,12 ,683 ,1197 ,0,3,1,3,0,1,0,76.14,57.06 ,33.33
03,003,01,006,0209,462,503 ,5 ,508 ,882 ,0,3,1,3,0,1,0,76.14,57.60 ,33.33
03,003,01,006,0209,463,494 ,11 ,505 ,810 ,0,3,1,3,0,1,0,76.14,62.35 ,33.33
03,003,01,006,0210,464,768 ,3 ,771 ,1194 ,0,3,1,3,0,1,0,76.14,64.57 ,33.33
03,003,01,006,0210,465,904 ,9 ,913 ,1486 ,0,3,1,3,0,1,0,76.14,61.44 ,33.33
03,003,01,006,0210,466,710 ,7 ,717 ,1235 ,0,3,1,3,0,1,0,76.14,58.06 ,33.33
03,003,01,006,0211,467,692 ,5 ,697 ,1129 ,0,3,1,3,0,1,0,76.14,61.74 ,33.33
03,003,01,006,0212,468,452 ,5 ,457 ,829 ,0,3,1,3,0,1,0,76.14,55.13 ,33.33
03,003,01,006,0212,469,633 ,10 ,643 ,1027 ,0,3,1,3,0,1,0,76.14,62.61 ,33.33
03,003,01,006,0213,470,507 ,2 ,509 ,827 ,0,3,1,3,0,1,0,76.14,61.55 ,33.33
03,003,01,006,0213,471,608 ,3 ,611 ,1015 ,0,3,1,3,0,1,0,76.14,60.20 ,33.33
03,003,01,006,0213,472,669 ,5 ,674 ,1134 ,0,3,1,3,0,1,0,76.14,59.44 ,33.33
03,003,01,006,0214,473,606 ,4 ,610 ,1013 ,0,3,1,3,0,1,0,76.14,60.22 ,33.33
03,003,01,006,0214,474,607 ,9 ,616 ,1026 ,0,3,1,3,0,1,0,76.14,60.04 ,33.33
03,003,01,006,0214,475,269 ,2 ,271 ,419 ,0,3,1,3,0,1,0,76.14,64.68 ,33.33
03,003,01,007,0215,476,714 ,7 ,721 ,1205 ,0,3,1,3,0,1,0,76.14,59.83 ,33.33
03,003,01,007,0216,477,373 ,1 ,374 ,618 ,0,3,1,3,0,1,0,76.14,60.52 ,33.33
03,003,01,007,0217,478,29 ,0 ,29 ,49 ,0,3,1,3,0,1,0,76.14,59.18 ,33.33
03,003,01,007,0218,479,15 ,1 ,16 ,38 ,0,3,1,3,0,1,0,76.14,42.11 ,33.33
03,003,01,007,0219,480,156 ,2 ,158 ,290 ,0,3,1,3,0,1,0,76.14,54.48 ,33.33
03,003,01,007,0220,481,68 ,0 ,68 ,103 ,0,3,1,3,0,1,0,76.14,66.02 ,33.33
03,003,01,007,0221,482,14 ,0 ,14 ,40 ,0,3,1,3,0,1,0,76.14,35.00 ,33.33
03,003,01,007,0222,483,16 ,0 ,16 ,51 ,0,3,1,3,0,1,0,76.14,31.37 ,33.33
03,003,01,007,0223,484,13 ,0 ,13 ,37 ,0,3,1,3,0,1,0,76.14,35.14 ,33.33
03,003,01,007,0224,485,138 ,2 ,140 ,326 ,0,3,1,3,0,1,0,76.14,42.94 ,33.33
03,003,01,008,0225,486,838 ,8 ,846 ,1604 ,0,3,1,3,0,1,0,76.14,52.74 ,33.33
03,003,01,008,0225,487,920 ,9 ,929 ,1794 ,0,3,1,3,0,1,0,76.14,51.78 ,33.33
03,003,01,008,0226,488,942 ,9 ,951 ,1733 ,0,3,1,3,0,1,0,76.14,54.88 ,33.33
03,003,01,008,0226,489,1078 ,4 ,1082 ,1782 ,0,3,1,3,0,1,0,76.14,60.72 ,33.33
03,003,01,008,0227,490,873 ,6 ,879 ,1724 ,0,3,1,3,0,1,0,76.14,50.99 ,33.33
03,003,01,008,0227,491,1029 ,4 ,1033 ,1742 ,0,3,1,3,0,1,0,76.14,59.30 ,33.33
03,003,01,008,0227,492,1043 ,8 ,1051 ,2060 ,0,3,1,3,0,1,0,76.14,51.02 ,33.33
03,003,01,008,0228,493,817 ,6 ,823 ,1304 ,0,3,1,3,0,1,0,76.14,63.11 ,33.33
03,003,01,008,0228,494,557 ,4 ,561 ,989 ,0,3,1,3,0,1,0,76.14,56.72 ,33.33
03,003,01,008,0228,495,701 ,4 ,705 ,1152 ,0,3,1,3,0,1,0,76.14,61.20 ,33.33
03,003,01,008,0229,496,824 ,7 ,831 ,1379 ,0,3,1,3,0,1,0,76.14,60.26 ,33.33
03,003,01,008,0229,497,701 ,6 ,707 ,1101 ,0,3,1,3,0,1,0,76.14,64.21 ,33.33
03,003,01,008,0230,498,791 ,11 ,802 ,1328 ,0,3,1,3,0,1,0,76.14,60.39 ,33.33
03,003,01,008,0230,499,786 ,13 ,799 ,1192 ,0,3,1,3,0,1,0,76.14,67.03 ,33.33
03,003,01,008,0230,500,855 ,7 ,862 ,1332 ,0,3,1,3,0,1,0,76.14,64.71 ,33.33
03,003,01,008,0231,501,871 ,5 ,876 ,1349 ,0,3,1,3,0,1,0,76.14,64.94 ,33.33
03,003,01,008,0231,502,935 ,15 ,950 ,1441 ,0,3,1,3,0,1,0,76.14,65.93 ,33.33
03,003,01,008,0231,503,875 ,8 ,883 ,1349 ,0,3,1,3,0,1,0,76.14,65.46 ,33.33
03,003,01,008,0232,504,928 ,16 ,944 ,1609 ,0,3,1,3,0,1,0,76.14,58.67 ,33.33
03,003,01,008,0232,505,904 ,5 ,909 ,1413 ,0,3,1,3,0,1,0,76.14,64.33 ,33.33
03,003,01,008,0232,506,976 ,10 ,986 ,1505 ,0,3,1,3,0,1,0,76.14,65.51 ,33.33
03,003,01,008,0233,507,936 ,6 ,942 ,1339 ,0,3,1,3,0,1,0,76.14,70.35 ,33.33
03,003,01,008,0233,508,993 ,11 ,1004 ,1500 ,0,3,1,3,0,1,0,76.14,66.93 ,33.33
03,003,01,008,0234,509,464 ,5 ,469 ,673 ,0,3,1,3,0,1,0,76.14,69.69 ,33.33
03,003,01,008,0234,510,908 ,6 ,914 ,1342 ,0,3,1,3,0,1,0,76.14,68.11 ,33.33
03,003,01,008,0235,511,828 ,7 ,835 ,1424 ,0,3,1,3,0,1,0,76.14,58.64 ,33.33
03,003,01,008,0235,512,804 ,2 ,806 ,1395 ,0,3,1,3,0,1,0,76.14,57.78 ,33.33
03,003,01,008,0235,513,499 ,7 ,506 ,809 ,0,3,1,3,0,1,0,76.14,62.55 ,33.33
03,003,01,008,0236,514,732 ,7 ,739 ,1246 ,0,3,1,3,0,1,0,76.14,59.31 ,33.33
03,003,01,008,0236,515,588 ,3 ,591 ,993 ,0,3,1,3,0,1,0,76.14,59.52 ,33.33
03,003,01,008,0236,516,661 ,4 ,665 ,1296 ,0,3,1,3,0,1,0,76.14,51.31 ,33.33
03,003,01,008,0237,517,537 ,7 ,544 ,852 ,0,3,1,3,0,1,0,76.14,63.85 ,33.33
03,003,01,008,0237,518,728 ,4 ,732 ,1238 ,0,3,1,3,0,1,0,76.14,59.13 ,33.33
03,003,01,008,0238,519,619 ,12 ,631 ,1081 ,0,3,1,3,0,1,0,76.14,58.37 ,33.33
03,003,01,008,0238,520,653 ,6 ,659 ,1108 ,0,3,1,3,0,1,0,76.14,59.48 ,33.33
03,003,01,008,0239,521,761 ,10 ,771 ,1155 ,0,3,1,3,0,1,0,76.14,66.75 ,33.33
03,003,01,008,0239,522,771 ,13 ,784 ,1254 ,0,3,1,3,0,1,0,76.14,62.52 ,33.33
03,003,01,008,0240,523,687 ,9 ,696 ,1254 ,0,3,1,3,0,1,0,76.14,55.50 ,33.33
03,003,01,008,0240,524,618 ,5 ,623 ,1080 ,0,3,1,3,0,1,0,76.14,57.69 ,33.33
03,003,01,008,0241,525,748 ,8 ,756 ,1293 ,0,3,1,3,0,1,0,76.14,58.47 ,33.33
03,003,01,008,0241,526,852 ,6 ,858 ,1309 ,0,3,1,3,0,1,0,76.14,65.55 ,33.33
03,003,01,008,0242,527,955 ,11 ,966 ,1459 ,0,3,1,3,0,1,0,76.14,66.21 ,33.33
03,003,01,008,0242,528,839 ,10 ,849 ,1336 ,0,3,1,3,0,1,0,76.14,63.55 ,33.33
03,003,01,008,0243,529,444 ,6 ,450 ,804 ,0,3,1,3,0,1,0,76.14,55.97 ,33.33
03,003,01,008,0243,530,463 ,8 ,471 ,840 ,0,3,1,3,0,1,0,76.14,56.07 ,33.33
03,003,01,008,0243,531,394 ,3 ,397 ,611 ,0,3,1,3,0,1,0,76.14,64.98 ,33.33
03,003,01,008,0244,532,629 ,3 ,632 ,1083 ,0,3,1,3,0,1,0,76.14,58.36 ,33.33
03,003,01,008,0244,533,626 ,10 ,636 ,1124 ,0,3,1,3,0,1,0,76.14,56.58 ,33.33
03,003,01,008,0244,534,669 ,5 ,674 ,1217 ,0,3,1,3,0,1,0,76.14,55.38 ,33.33
03,003,01,008,0245,535,778 ,7 ,785 ,1322 ,0,3,1,3,0,1,0,76.14,59.38 ,33.33
03,003,01,008,0245,536,662 ,3 ,665 ,1205 ,0,3,1,3,0,1,0,76.14,55.19 ,33.33
03,003,01,008,0246,537,900 ,7 ,907 ,1409 ,0,3,1,3,0,1,0,76.14,64.37 ,33.33
03,003,01,008,0246,538,894 ,4 ,898 ,1493 ,0,3,1,3,0,1,0,76.14,60.15 ,33.33
03,003,01,008,0247,539,997 ,2 ,999 ,1556 ,0,3,1,3,0,1,0,76.14,64.20 ,33.33
03,003,01,008,0247,540,981 ,12 ,993 ,1700 ,0,3,1,3,0,1,0,76.14,58.41 ,33.33
03,003,01,008,0248,541,1059 ,9 ,1068 ,1925 ,0,3,1,3,0,1,0,76.14,55.48 ,33.33
03,003,01,008,0248,542,948 ,4 ,952 ,1524 ,0,3,1,3,0,1,0,76.14,62.47 ,33.33
03,003,01,008,0249,543,665 ,4 ,669 ,1093 ,0,3,1,3,0,1,0,76.14,61.21 ,33.33
03,003,01,008,0249,544,796 ,6 ,802 ,1226 ,0,3,1,3,0,1,0,76.14,65.42 ,33.33
03,003,01,008,0250,545,598 ,6 ,604 ,980 ,0,3,1,3,0,1,0,76.14,61.63 ,33.33
03,003,01,008,0250,546,530 ,6 ,536 ,878 ,0,3,1,3,0,1,0,76.14,61.05 ,33.33
03,003,01,008,0251,547,622 ,1 ,623 ,981 ,0,3,1,3,0,1,0,76.14,63.51 ,33.33
03,003,01,008,0251,548,746 ,4 ,750 ,1295 ,0,3,1,3,0,1,0,76.14,57.92 ,33.33
03,003,01,008,0252,549,853 ,10 ,863 ,1451 ,0,3,1,3,0,1,0,76.14,59.48 ,33.33
03,003,01,008,0252,550,573 ,6 ,579 ,995 ,0,3,1,3,0,1,0,76.14,58.19 ,33.33
03,003,01,008,0253,551,912 ,11 ,923 ,1511 ,0,3,1,3,0,1,0,76.14,61.09 ,33.33
03,003,01,008,0254,552,742 ,2 ,744 ,1308 ,0,3,1,3,0,1,0,76.14,56.88 ,33.33
03,003,01,008,0254,553,906 ,4 ,910 ,1502 ,0,3,1,3,0,1,0,76.14,60.59 ,33.33
03,003,01,008,0255,554,946 ,10 ,956 ,1649 ,0,3,1,3,0,1,0,76.14,57.97 ,33.33
03,003,01,008,0255,555,1023 ,11 ,1034 ,1805 ,0,3,1,3,0,1,0,76.14,57.29 ,33.33
03,003,01,008,0256,556,884 ,6 ,890 ,1642 ,0,3,1,3,0,1,0,76.14,54.20 ,33.33
03,003,01,008,0256,557,919 ,6 ,925 ,1772 ,0,3,1,3,0,1,0,76.14,52.20 ,33.33
03,003,01,008,0256,558,1006 ,8 ,1014 ,1974 ,0,3,1,3,0,1,0,76.14,51.37 ,33.33
03,003,01,008,0257,559,594 ,3 ,597 ,1094 ,0,3,1,3,0,1,0,76.14,54.57 ,33.33
03,003,01,008,0258,560,995 ,7 ,1002 ,1320 ,0,3,1,3,0,1,0,76.14,75.91 ,33.33
03,003,01,008,0258,561,1224 ,15 ,1239 ,1728 ,0,3,1,3,0,1,0,76.14,71.70 ,33.33
03,003,01,008,0258,562,803 ,6 ,809 ,1434 ,0,3,1,3,0,1,0,76.14,56.42 ,33.33
03,003,01,008,0258,563,730 ,5 ,735 ,1415 ,0,3,1,3,0,1,0,76.14,51.94 ,33.33
03,003,01,008,0259,564,800 ,4 ,804 ,1307 ,0,3,1,3,0,1,0,76.14,61.51 ,33.33
03,003,01,008,0259,565,820 ,2 ,822 ,1408 ,0,3,1,3,0,1,0,76.14,58.38 ,33.33
03,003,01,008,0260,566,898 ,10 ,908 ,1362 ,0,3,1,3,0,1,0,76.14,66.67 ,33.33
03,003,01,008,0260,567,877 ,7 ,884 ,1350 ,0,3,1,3,0,1,0,76.14,65.48 ,33.33
03,003,01,008,0261,568,1379 ,15 ,1394 ,2042 ,0,3,1,3,0,1,0,76.14,68.27 ,33.33
03,003,01,008,0261,569,912 ,7 ,919 ,1391 ,0,3,1,3,0,1,0,76.14,66.07 ,33.33
03,003,01,008,0262,570,719 ,10 ,729 ,1167 ,0,3,1,3,0,1,0,76.14,62.47 ,33.33
03,003,01,008,0262,571,646 ,13 ,659 ,1134 ,0,3,1,3,0,1,0,76.14,58.11 ,33.33
03,003,01,008,0263,572,762 ,9 ,771 ,1291 ,0,3,1,3,0,1,0,76.14,59.72 ,33.33
03,003,01,008,0263,573,973 ,7 ,980 ,1719 ,0,3,1,3,0,1,0,76.14,57.01 ,33.33
03,003,01,008,0264,574,739 ,4 ,743 ,1227 ,0,3,1,3,0,1,0,76.14,60.55 ,33.33
03,003,01,008,0264,575,721 ,12 ,733 ,1188 ,0,3,1,3,0,1,0,76.14,61.70 ,33.33
03,003,01,008,0265,576,674 ,1 ,675 ,1005 ,0,3,1,3,0,1,0,76.14,67.16 ,33.33
03,003,01,008,0265,577,727 ,5 ,732 ,1126 ,0,3,1,3,0,1,0,76.14,65.01 ,33.33
03,003,01,008,0265,578,745 ,9 ,754 ,1343 ,0,3,1,3,0,1,0,76.14,56.14 ,33.33
03,003,01,008,0266,579,721 ,9 ,730 ,1232 ,0,3,1,3,0,1,0,76.14,59.25 ,33.33
03,003,01,008,0266,580,661 ,9 ,670 ,1185 ,0,3,1,3,0,1,0,76.14,56.54 ,33.33
03,003,01,008,0267,581,712 ,6 ,718 ,1253 ,0,3,1,3,0,1,0,76.14,57.30 ,33.33
03,003,01,008,0267,582,887 ,10 ,897 ,1533 ,0,3,1,3,0,1,0,76.14,58.51 ,33.33
03,003,01,008,0267,583,888 ,9 ,897 ,1679 ,0,3,1,3,0,1,0,76.14,53.42 ,33.33
03,003,01,008,0268,584,1054 ,7 ,1061 ,1721 ,0,3,1,3,0,1,0,76.14,61.65 ,33.33
03,003,01,008,0268,585,1049 ,10 ,1059 ,1658 ,0,3,1,3,0,1,0,76.14,63.87 ,33.33
03,003,01,008,0269,586,1194 ,8 ,1202 ,1959 ,0,3,1,3,0,1,0,76.14,61.36 ,33.33
03,003,01,008,0269,587,1050 ,10 ,1060 ,1823 ,0,3,1,3,0,1,0,76.14,58.15 ,33.33
03,003,01,008,0269,588,968 ,9 ,977 ,1641 ,0,3,1,3,0,1,0,76.14,59.54 ,33.33
03,003,01,008,0270,589,617 ,7 ,624 ,963 ,0,3,1,3,0,1,0,76.14,64.80 ,33.33
03,003,01,008,0270,590,667 ,6 ,673 ,1057 ,0,3,1,3,0,1,0,76.14,63.67 ,33.33
03,003,01,008,0271,591,1157 ,13 ,1170 ,1949 ,0,3,1,3,0,1,0,76.14,60.03 ,33.33
03,003,01,008,0271,592,1065 ,9 ,1074 ,1774 ,0,3,1,3,0,1,0,76.14,60.54 ,33.33
03,003,01,008,0272,593,561 ,4 ,565 ,1005 ,0,3,1,3,0,1,0,76.14,56.22 ,33.33
03,003,01,008,0272,594,475 ,3 ,478 ,1406 ,0,3,1,3,0,1,0,76.14,34.00 ,33.33
03,003,01,008,0273,595,748 ,4 ,752 ,1146 ,0,3,1,3,0,1,0,76.14,65.62 ,33.33
03,003,01,008,0273,596,600 ,3 ,603 ,999 ,0,3,1,3,0,1,0,76.14,60.36 ,33.33
03,003,01,008,0273,597,643 ,7 ,650 ,1035 ,0,3,1,3,0,1,0,76.14,62.80 ,33.33
03,003,01,008,0274,598,960 ,9 ,969 ,1659 ,0,3,1,3,0,1,0,76.14,58.41 ,33.33
03,003,01,008,0274,599,839 ,6 ,845 ,1490 ,0,3,1,3,0,1,0,76.14,56.71 ,33.33
03,003,01,008,0274,600,816 ,9 ,825 ,1515 ,0,3,1,3,0,1,0,76.14,54.46 ,33.33
03,003,01,008,0274,601,825 ,12 ,837 ,1461 ,0,3,1,3,0,1,0,76.14,57.29 ,33.33
03,003,01,008,0275,602,671 ,2 ,673 ,1067 ,0,3,1,3,0,1,0,76.14,63.07 ,33.33
03,003,01,008,0275,603,858 ,8 ,866 ,1462 ,0,3,1,3,0,1,0,76.14,59.23 ,33.33
03,003,01,008,0275,604,935 ,5 ,940 ,1549 ,0,3,1,3,0,1,0,76.14,60.68 ,33.33
03,003,01,008,0276,605,768 ,4 ,772 ,1357 ,0,3,1,3,0,1,0,76.14,56.89 ,33.33
03,003,01,008,0276,606,744 ,10 ,754 ,1247 ,0,3,1,3,0,1,0,76.14,60.47 ,33.33
03,003,01,008,0277,607,1057 ,7 ,1064 ,1768 ,0,3,1,3,0,1,0,76.14,60.18 ,33.33
03,003,01,008,0277,608,1022 ,4 ,1026 ,1858 ,0,3,1,3,0,1,0,76.14,55.22 ,33.33
03,003,01,008,0278,609,821 ,5 ,826 ,1328 ,0,3,1,3,0,1,0,76.14,62.20 ,33.33
03,003,01,008,0278,610,1013 ,11 ,1024 ,1692 ,0,3,1,3,0,1,0,76.14,60.52 ,33.33
03,003,01,008,0278,611,589 ,1 ,590 ,982 ,0,3,1,3,0,1,0,76.14,60.08 ,33.33
03,003,01,008,0278,612,666 ,3 ,669 ,1086 ,0,3,1,3,0,1,0,76.14,61.60 ,33.33
03,003,01,008,0279,613,747 ,3 ,750 ,1163 ,0,3,1,3,0,1,0,76.14,64.49 ,33.33
03,003,01,008,0279,614,799 ,4 ,803 ,1170 ,0,3,1,3,0,1,0,76.14,68.63 ,33.33
03,003,01,008,0279,615,800 ,8 ,808 ,1363 ,0,3,1,3,0,1,0,76.14,59.28 ,33.33
03,003,01,008,0279,616,949 ,6 ,955 ,1748 ,0,3,1,3,0,1,0,76.14,54.63 ,33.33
03,003,01,008,0280,617,808 ,2 ,810 ,1318 ,0,3,1,3,0,1,0,76.14,61.46 ,33.33
03,003,01,008,0280,618,762 ,9 ,771 ,1432 ,0,3,1,3,0,1,0,76.14,53.84 ,33.33
03,003,01,008,0280,619,807 ,6 ,813 ,1512 ,0,3,1,3,0,1,0,76.14,53.77 ,33.33
03,003,01,008,0281,620,485 ,3 ,488 ,829 ,0,3,1,3,0,1,0,76.14,58.87 ,33.33
03,003,01,008,0281,621,1050 ,7 ,1057 ,1769 ,0,3,1,3,0,1,0,76.14,59.75 ,33.33
03,003,01,008,0281,622,1002 ,6 ,1008 ,1655 ,0,3,1,3,0,1,0,76.14,60.91 ,33.33
03,003,01,008,0282,623,696 ,6 ,702 ,1080 ,0,3,1,3,0,1,0,76.14,65.00 ,33.33
03,003,01,008,0283,624,1055 ,5 ,1060 ,1898 ,0,3,1,3,0,1,0,76.14,55.85 ,33.33
03,003,01,008,0284,625,792 ,8 ,800 ,1386 ,0,3,1,3,0,1,0,76.14,57.72 ,33.33
03,003,01,008,0284,626,401 ,3 ,404 ,748 ,0,3,1,3,0,1,0,76.14,54.01 ,33.33
03,003,01,008,0285,627,773 ,6 ,779 ,1307 ,0,3,1,3,0,1,0,76.14,59.60 ,33.33
03,003,01,008,0285,628,880 ,9 ,889 ,1456 ,0,3,1,3,0,1,0,76.14,61.06 ,33.33
03,003,01,008,0285,629,1003 ,9 ,1012 ,1691 ,0,3,1,3,0,1,0,76.14,59.85 ,33.33
03,003,01,008,0286,630,713 ,5 ,718 ,1102 ,0,3,1,3,0,1,0,76.14,65.15 ,33.33
03,003,01,008,0286,631,864 ,9 ,873 ,1417 ,0,3,1,3,0,1,0,76.14,61.61 ,33.33
03,003,01,008,0287,632,607 ,3 ,610 ,1022 ,0,3,1,3,0,1,0,76.14,59.69 ,33.33
03,003,01,008,0288,633,516 ,3 ,519 ,830 ,0,3,1,3,0,1,0,76.14,62.53 ,33.33
03,003,01,008,0289,634,592 ,6 ,598 ,972 ,0,3,1,3,0,1,0,76.14,61.52 ,33.33
03,003,01,008,0290,635,643 ,3 ,646 ,1052 ,0,3,1,3,0,1,0,76.14,61.41 ,33.33
03,003,01,008,0291,636,658 ,9 ,667 ,1011 ,0,3,1,3,0,1,0,76.14,65.97 ,33.33
03,003,01,008,0291,637,669 ,6 ,675 ,1054 ,0,3,1,3,0,1,0,76.14,64.04 ,33.33
03,003,01,008,0292,638,640 ,9 ,649 ,1007 ,0,3,1,3,0,1,0,76.14,64.45 ,33.33
03,003,01,008,0292,639,680 ,6 ,686 ,1095 ,0,3,1,3,0,1,0,76.14,62.65 ,33.33
03,003,01,008,0292,640,883 ,8 ,891 ,1449 ,0,3,1,3,0,1,0,76.14,61.49 ,33.33
03,003,01,008,0293,641,718 ,7 ,725 ,1314 ,0,3,1,3,0,1,0,76.14,55.18 ,33.33
03,003,01,008,0293,642,848 ,5 ,853 ,1441 ,0,3,1,3,0,1,0,76.14,59.20 ,33.33
03,003,01,008,0293,643,958 ,6 ,964 ,1637 ,0,3,1,3,0,1,0,76.14,58.89 ,33.33
03,003,01,008,0294,644,845 ,7 ,852 ,1366 ,0,3,1,3,0,1,0,76.14,62.37 ,33.33
03,003,01,008,0294,645,1114 ,4 ,1118 ,1899 ,0,3,1,3,0,1,0,76.14,58.87 ,33.33
03,003,01,008,0295,646,848 ,8 ,856 ,1376 ,0,3,1,3,0,1,0,76.14,62.21 ,33.33
03,003,01,008,0295,647,754 ,5 ,759 ,1280 ,0,3,1,3,0,1,0,76.14,59.30 ,33.33
03,003,01,008,0296,648,665 ,6 ,671 ,1215 ,0,3,1,3,0,1,0,76.14,55.23 ,33.33
03,003,01,008,0296,649,748 ,1 ,749 ,1295 ,0,3,1,3,0,1,0,76.14,57.84 ,33.33
03,003,01,008,0296,650,982 ,10 ,992 ,1624 ,0,3,1,3,0,1,0,76.14,61.08 ,33.33
03,003,01,008,0297,651,1090 ,6 ,1096 ,1829 ,0,3,1,3,0,1,0,76.14,59.92 ,33.33
03,003,01,008,0297,652,858 ,6 ,864 ,1475 ,0,3,1,3,0,1,0,76.14,58.58 ,33.33
03,003,01,008,0298,653,542 ,6 ,548 ,844 ,0,3,1,3,0,1,0,76.14,64.93 ,33.33
03,003,01,008,0298,654,719 ,5 ,724 ,1167 ,0,3,1,3,0,1,0,76.14,62.04 ,33.33
03,003,01,008,0299,655,779 ,7 ,786 ,1260 ,0,3,1,3,0,1,0,76.14,62.38 ,33.33
03,003,01,008,0300,656,1108 ,11 ,1119 ,1845 ,0,3,1,3,0,1,0,76.14,60.65 ,33.33
03,003,01,008,0300,657,1062 ,2 ,1064 ,1664 ,0,3,1,3,0,1,0,76.14,63.94 ,33.33
03,003,01,008,0301,658,941 ,4 ,945 ,1550 ,0,3,1,3,0,1,0,76.14,60.97 ,33.33
03,003,01,008,0301,659,1080 ,10 ,1090 ,1614 ,0,3,1,3,0,1,0,76.14,67.53 ,33.33
03,003,01,008,0302,660,867 ,7 ,874 ,1353 ,0,3,1,3,0,1,0,76.14,64.60 ,33.33
03,003,01,008,0302,661,1035 ,8 ,1043 ,1515 ,0,3,1,3,0,1,0,76.14,68.84 ,33.33
03,003,01,008,0303,662,863 ,11 ,874 ,1331 ,0,3,1,3,0,1,0,76.14,65.66 ,33.33
03,003,01,008,0303,663,724 ,6 ,730 ,1216 ,0,3,1,3,0,1,0,76.14,60.03 ,33.33
03,003,01,009,0304,664,522 ,8 ,530 ,977 ,0,3,1,3,0,1,0,76.14,54.25 ,33.33
03,003,01,009,0304,665,753 ,11 ,764 ,1257 ,0,3,1,3,0,1,0,76.14,60.78 ,33.33
03,003,01,009,0304,666,594 ,2 ,596 ,984 ,0,3,1,3,0,1,0,76.14,60.57 ,33.33
03,003,01,009,0305,667,728 ,10 ,738 ,1212 ,0,3,1,3,0,1,0,76.14,60.89 ,33.33
03,003,01,009,0305,668,836 ,15 ,851 ,1392 ,0,3,1,3,0,1,0,76.14,61.14 ,33.33
03,003,01,009,0306,669,719 ,5 ,724 ,1275 ,0,3,1,3,0,1,0,76.14,56.78 ,33.33
03,003,01,009,0306,670,725 ,7 ,732 ,1271 ,0,3,1,3,0,1,0,76.14,57.59 ,33.33
03,003,01,009,0306,671,709 ,5 ,714 ,1299 ,0,3,1,3,0,1,0,76.14,54.97 ,33.33
03,003,01,009,0307,672,640 ,6 ,646 ,1182 ,0,3,1,3,0,1,0,76.14,54.65 ,33.33
03,003,01,009,0307,673,598 ,12 ,610 ,1167 ,0,3,1,3,0,1,0,76.14,52.27 ,33.33
03,003,01,009,0308,674,593 ,5 ,598 ,1008 ,0,3,1,3,0,1,0,76.14,59.33 ,33.33
03,003,01,009,0308,675,675 ,6 ,681 ,1087 ,0,3,1,3,0,1,0,76.14,62.65 ,33.33
03,003,01,009,0308,676,567 ,4 ,571 ,1005 ,0,3,1,3,0,1,0,76.14,56.82 ,33.33
03,003,01,009,0309,677,608 ,1 ,609 ,1095 ,0,3,1,3,0,1,0,76.14,55.62 ,33.33
03,003,01,009,0309,678,625 ,6 ,631 ,1177 ,0,3,1,3,0,1,0,76.14,53.61 ,33.33
03,003,01,009,0309,679,683 ,4 ,687 ,1173 ,0,3,1,3,0,1,0,76.14,58.57 ,33.33
03,003,01,009,0310,680,625 ,9 ,634 ,1101 ,0,3,1,3,0,1,0,76.14,57.58 ,33.33
03,003,01,009,0310,681,725 ,11 ,736 ,1136 ,0,3,1,3,0,1,0,76.14,64.79 ,33.33
03,003,01,009,0311,682,512 ,5 ,517 ,797 ,0,3,1,3,0,1,0,76.14,64.87 ,33.33
03,003,01,009,0311,683,820 ,9 ,829 ,1329 ,0,3,1,3,0,1,0,76.14,62.38 ,33.33
03,003,01,009,0312,684,781 ,13 ,794 ,1308 ,0,3,1,3,0,1,0,76.14,60.70 ,33.33
03,003,01,009,0312,685,770 ,2 ,772 ,1270 ,0,3,1,3,0,1,0,76.14,60.79 ,33.33
03,003,01,009,0312,686,901 ,6 ,907 ,1522 ,0,3,1,3,0,1,0,76.14,59.59 ,33.33
03,003,01,009,0313,687,609 ,10 ,619 ,967 ,0,3,1,3,0,1,0,76.14,64.01 ,33.33
03,003,01,009,0313,688,616 ,4 ,620 ,1018 ,0,3,1,3,0,1,0,76.14,60.90 ,33.33
03,003,01,009,0313,689,607 ,1 ,608 ,921 ,0,3,1,3,0,1,0,76.14,66.02 ,33.33
03,003,01,009,0313,690,612 ,3 ,615 ,954 ,0,3,1,3,0,1,0,76.14,64.47 ,33.33
03,003,01,009,0314,691,908 ,13 ,921 ,1508 ,0,3,1,3,0,1,0,76.14,61.07 ,33.33
03,003,01,009,0315,692,473 ,8 ,481 ,834 ,0,3,1,3,0,1,0,76.14,57.67 ,33.33
03,003,01,009,0315,693,609 ,3 ,612 ,1038 ,0,3,1,3,0,1,0,76.14,58.96 ,33.33
03,003,01,009,0315,694,573 ,6 ,579 ,1041 ,0,3,1,3,0,1,0,76.14,55.62 ,33.33
03,003,01,009,0316,695,729 ,4 ,733 ,1402 ,0,3,1,3,0,1,0,76.14,52.28 ,33.33
03,003,01,009,0316,696,855 ,5 ,860 ,1567 ,0,3,1,3,0,1,0,76.14,54.88 ,33.33
03,003,01,009,0317,697,675 ,6 ,681 ,1284 ,0,3,1,3,0,1,0,76.14,53.04 ,33.33
03,003,01,009,0317,698,700 ,8 ,708 ,1433 ,0,3,1,3,0,1,0,76.14,49.41 ,33.33
03,003,01,009,0318,699,776 ,7 ,783 ,1293 ,0,3,1,3,0,1,0,76.14,60.56 ,33.33
03,003,01,009,0318,700,790 ,4 ,794 ,1340 ,0,3,1,3,0,1,0,76.14,59.25 ,33.33
03,003,01,009,0318,701,841 ,6 ,847 ,1579 ,0,3,1,3,0,1,0,76.14,53.64 ,33.33
03,003,01,009,0319,702,578 ,6 ,584 ,976 ,0,3,1,3,0,1,0,76.14,59.84 ,33.33
03,003,01,009,0319,703,621 ,6 ,627 ,1044 ,0,3,1,3,0,1,0,76.14,60.06 ,33.33
03,003,01,009,0319,704,648 ,8 ,656 ,1066 ,0,3,1,3,0,1,0,76.14,61.54 ,33.33
03,003,01,009,0320,705,637 ,8 ,645 ,1135 ,0,3,1,3,0,1,0,76.14,56.83 ,33.33
03,003,01,009,0320,706,566 ,8 ,574 ,1104 ,0,3,1,3,0,1,0,76.14,51.99 ,33.33
03,003,01,009,0320,707,637 ,7 ,644 ,1271 ,0,3,1,3,0,1,0,76.14,50.67 ,33.33
03,003,01,009,0321,708,665 ,4 ,669 ,1221 ,0,3,1,3,0,1,0,76.14,54.79 ,33.33
03,003,01,009,0321,709,594 ,1 ,595 ,1146 ,0,3,1,3,0,1,0,76.14,51.92 ,33.33
03,003,01,009,0321,710,587 ,6 ,593 ,1108 ,0,3,1,3,0,1,0,76.14,53.52 ,33.33
03,003,01,009,0322,711,762 ,5 ,767 ,1309 ,0,3,1,3,0,1,0,76.14,58.59 ,33.33
03,003,01,009,0322,712,479 ,4 ,483 ,911 ,0,3,1,3,0,1,0,76.14,53.02 ,33.33
03,003,01,009,0322,713,868 ,8 ,876 ,1366 ,0,3,1,3,0,1,0,76.14,64.13 ,33.33
03,003,01,009,0323,714,658 ,7 ,665 ,1139 ,0,3,1,3,0,1,0,76.14,58.38 ,33.33
03,003,01,009,0323,715,705 ,6 ,711 ,1145 ,0,3,1,3,0,1,0,76.14,62.10 ,33.33
03,003,01,009,0323,716,622 ,3 ,625 ,1188 ,0,3,1,3,0,1,0,76.14,52.61 ,33.33
03,003,01,009,0324,717,846 ,8 ,854 ,1310 ,0,3,1,3,0,1,0,76.14,65.19 ,33.33
03,003,01,009,0324,718,719 ,5 ,724 ,1165 ,0,3,1,3,0,1,0,76.14,62.15 ,33.33
03,003,01,009,0324,719,627 ,11 ,638 ,1097 ,0,3,1,3,0,1,0,76.14,58.16 ,33.33
03,003,01,009,0324,720,767 ,3 ,770 ,1371 ,0,3,1,3,0,1,0,76.14,56.16 ,33.33
03,003,01,009,0325,721,901 ,7 ,908 ,1407 ,0,3,1,3,0,1,0,76.14,64.53 ,33.33
03,003,01,009,0325,722,758 ,6 ,764 ,1235 ,0,3,1,3,0,1,0,76.14,61.86 ,33.33
03,003,01,009,0325,723,649 ,9 ,658 ,1105 ,0,3,1,3,0,1,0,76.14,59.55 ,33.33
03,003,01,009,0326,724,822 ,8 ,830 ,1315 ,0,3,1,3,0,1,0,76.14,63.12 ,33.33
03,003,01,009,0326,725,956 ,6 ,962 ,1600 ,0,3,1,3,0,1,0,76.14,60.12 ,33.33
03,003,01,009,0327,726,689 ,7 ,696 ,1090 ,0,3,1,3,0,1,0,76.14,63.85 ,33.33
03,003,01,009,0327,727,734 ,5 ,739 ,1185 ,0,3,1,3,0,1,0,76.14,62.36 ,33.33
03,003,01,009,0328,728,821 ,7 ,828 ,1381 ,0,3,1,3,0,1,0,76.14,59.96 ,33.33
03,003,01,009,0328,729,638 ,5 ,643 ,1066 ,0,3,1,3,0,1,0,76.14,60.32 ,33.33
03,003,01,009,0329,730,663 ,6 ,669 ,1111 ,0,3,1,3,0,1,0,76.14,60.22 ,33.33
03,003,01,009,0329,731,719 ,1 ,720 ,1202 ,0,3,1,3,0,1,0,76.14,59.90 ,33.33
03,003,01,009,0329,732,711 ,9 ,720 ,1182 ,0,3,1,3,0,1,0,76.14,60.91 ,33.33
03,003,01,009,0330,733,458 ,4 ,462 ,734 ,0,3,1,3,0,1,0,76.14,62.94 ,33.33
03,003,01,009,0330,734,506 ,7 ,513 ,820 ,0,3,1,3,0,1,0,76.14,62.56 ,33.33
03,003,01,009,0331,735,852 ,6 ,858 ,1439 ,0,3,1,3,0,1,0,76.14,59.62 ,33.33
03,003,01,009,0331,736,573 ,4 ,577 ,1162 ,0,3,1,3,0,1,0,76.14,49.66 ,33.33
03,003,01,009,0331,737,835 ,12 ,847 ,1375 ,0,3,1,3,0,1,0,76.14,61.60 ,33.33
03,003,01,009,0332,738,761 ,3 ,764 ,1537 ,0,3,1,3,0,1,0,76.14,49.71 ,33.33
03,003,01,009,0332,739,675 ,6 ,681 ,1090 ,0,3,1,3,0,1,0,76.14,62.48 ,33.33
03,003,01,009,0332,740,386 ,0 ,386 ,695 ,0,3,1,3,0,1,0,76.14,55.54 ,33.33
03,003,01,009,0333,741,665 ,7 ,672 ,1193 ,0,3,1,3,0,1,0,76.14,56.33 ,33.33
03,003,01,009,0333,742,512 ,3 ,515 ,955 ,0,3,1,3,0,1,0,76.14,53.93 ,33.33
03,003,01,009,0334,743,702 ,11 ,713 ,1159 ,0,3,1,3,0,1,0,76.14,61.52 ,33.33
03,003,01,009,0334,744,774 ,5 ,779 ,1404 ,0,3,1,3,0,1,0,76.14,55.48 ,33.33
03,003,01,009,0334,745,597 ,2 ,599 ,948 ,0,3,1,3,0,1,0,76.14,63.19 ,33.33
03,003,01,009,0335,746,598 ,8 ,606 ,942 ,0,3,1,3,0,1,0,76.14,64.33 ,33.33
03,003,01,009,0335,747,581 ,5 ,586 ,870 ,0,3,1,3,0,1,0,76.14,67.36 ,33.33
03,003,01,009,0336,748,845 ,16 ,861 ,1409 ,0,3,1,3,0,1,0,76.14,61.11 ,33.33
03,003,01,009,0336,749,827 ,8 ,835 ,1282 ,0,3,1,3,0,1,0,76.14,65.13 ,33.33
03,003,01,009,0337,750,753 ,4 ,757 ,1289 ,0,3,1,3,0,1,0,76.14,58.73 ,33.33
03,003,01,009,0337,751,673 ,11 ,684 ,1157 ,0,3,1,3,0,1,0,76.14,59.12 ,33.33
03,003,01,009,0337,752,656 ,5 ,661 ,1053 ,0,3,1,3,0,1,0,76.14,62.77 ,33.33
03,003,01,009,0338,753,671 ,8 ,679 ,1151 ,0,3,1,3,0,1,0,76.14,58.99 ,33.33
03,003,01,009,0338,754,663 ,2 ,665 ,1070 ,0,3,1,3,0,1,0,76.14,62.15 ,33.33
03,003,01,009,0338,755,584 ,6 ,590 ,1065 ,0,3,1,3,0,1,0,76.14,55.40 ,33.33
03,003,01,009,0339,756,695 ,6 ,701 ,1096 ,0,3,1,3,0,1,0,76.14,63.96 ,33.33
03,003,01,009,0339,757,647 ,6 ,653 ,1114 ,0,3,1,3,0,1,0,76.14,58.62 ,33.33
03,003,01,009,0340,758,820 ,7 ,827 ,1507 ,0,3,1,3,0,1,0,76.14,54.88 ,33.33
03,003,01,009,0340,759,891 ,12 ,903 ,1482 ,0,3,1,3,0,1,0,76.14,60.93 ,33.33
03,003,01,009,0341,760,535 ,3 ,538 ,826 ,0,3,1,3,0,1,0,76.14,65.13 ,33.33
03,003,01,009,0341,761,618 ,2 ,620 ,1000 ,0,3,1,3,0,1,0,76.14,62.00 ,33.33
03,003,01,009,0341,762,680 ,9 ,689 ,1126 ,0,3,1,3,0,1,0,76.14,61.19 ,33.33
03,003,01,009,0341,763,589 ,8 ,597 ,1062 ,0,3,1,3,0,1,0,76.14,56.21 ,33.33
03,003,01,009,0342,764,846 ,7 ,853 ,1462 ,0,3,1,3,0,1,0,76.14,58.34 ,33.33
03,003,01,009,0342,765,936 ,5 ,941 ,1681 ,0,3,1,3,0,1,0,76.14,55.98 ,33.33
03,003,01,009,0343,766,497 ,8 ,505 ,919 ,0,3,1,3,0,1,0,76.14,54.95 ,33.33
03,003,01,009,0343,767,695 ,6 ,701 ,1121 ,0,3,1,3,0,1,0,76.14,62.53 ,33.33
03,003,01,009,0343,768,700 ,4 ,704 ,1173 ,0,3,1,3,0,1,0,76.14,60.02 ,33.33
03,003,01,009,0344,769,913 ,17 ,930 ,1488 ,0,3,1,3,0,1,0,76.14,62.50 ,33.33
03,003,01,009,0344,770,627 ,9 ,636 ,1073 ,0,3,1,3,0,1,0,76.14,59.27 ,33.33
03,003,01,009,0345,771,948 ,8 ,956 ,1455 ,0,3,1,3,0,1,0,76.14,65.70 ,33.33
03,003,01,009,0345,772,898 ,8 ,906 ,1559 ,0,3,1,3,0,1,0,76.14,58.11 ,33.33
03,003,01,009,0346,773,527 ,8 ,535 ,881 ,0,3,1,3,0,1,0,76.14,60.73 ,33.33
03,003,01,009,0347,774,536 ,5 ,541 ,802 ,0,3,1,3,0,1,0,76.14,67.46 ,33.33
03,003,01,009,0347,775,447 ,11 ,458 ,696 ,0,3,1,3,0,1,0,76.14,65.80 ,33.33
03,003,01,009,0348,776,658 ,8 ,666 ,1073 ,0,3,1,3,0,1,0,76.14,62.07 ,33.33
03,003,01,009,0348,777,737 ,4 ,741 ,1148 ,0,3,1,3,0,1,0,76.14,64.55 ,33.33
03,003,01,009,0349,778,636 ,6 ,642 ,1045 ,0,3,1,3,0,1,0,76.14,61.44 ,33.33
03,003,01,010,0350,779,639 ,10 ,649 ,1124 ,0,3,1,3,0,1,0,76.14,57.74 ,33.33
03,003,01,010,0350,780,903 ,9 ,912 ,1546 ,0,3,1,3,0,1,0,76.14,58.99 ,33.33
03,003,01,010,0350,781,722 ,9 ,731 ,1156 ,0,3,1,3,0,1,0,76.14,63.24 ,33.33
03,003,01,010,0351,782,951 ,6 ,957 ,1496 ,0,3,1,3,0,1,0,76.14,63.97 ,33.33
03,003,01,010,0352,783,1079 ,9 ,1088 ,1566 ,0,3,1,3,0,1,0,76.14,69.48 ,33.33
03,003,01,010,0352,784,903 ,7 ,910 ,1459 ,0,3,1,3,0,1,0,76.14,62.37 ,33.33
03,003,01,010,0353,785,449 ,5 ,454 ,685 ,0,3,1,3,0,1,0,76.14,66.28 ,33.33
03,003,01,010,0354,786,657 ,5 ,662 ,1111 ,0,3,1,3,0,1,0,76.14,59.59 ,33.33
03,003,01,010,0355,787,796 ,14 ,810 ,1387 ,0,3,1,3,0,1,0,76.14,58.40 ,33.33
03,003,01,010,0356,788,718 ,9 ,727 ,1216 ,0,3,1,3,0,1,0,76.14,59.79 ,33.33
03,003,01,010,0356,789,591 ,9 ,600 ,1138 ,0,3,1,3,0,1,0,76.14,52.72 ,33.33
03,003,01,010,0356,790,863 ,7 ,870 ,1555 ,0,3,1,3,0,1,0,76.14,55.95 ,33.33
03,003,01,010,0357,791,676 ,9 ,685 ,1166 ,0,3,1,3,0,1,0,76.14,58.75 ,33.33
03,003,01,010,0357,792,751 ,5 ,756 ,1384 ,0,3,1,3,0,1,0,76.14,54.62 ,33.33
03,003,01,010,0358,793,875 ,12 ,887 ,1653 ,0,3,1,3,0,1,0,76.14,53.66 ,33.33
03,003,01,010,0358,794,787 ,11 ,798 ,1570 ,0,3,1,3,0,1,0,76.14,50.83 ,33.33
03,003,01,010,0359,795,713 ,7 ,720 ,1371 ,0,3,1,3,0,1,0,76.14,52.52 ,33.33
03,003,01,010,0359,796,447 ,2 ,449 ,1006 ,0,3,1,3,0,1,0,76.14,44.63 ,33.33
03,003,01,010,0359,797,771 ,2 ,773 ,1396 ,0,3,1,3,0,1,0,76.14,55.37 ,33.33
03,003,01,010,0360,798,662 ,8 ,670 ,1187 ,0,3,1,3,0,1,0,76.14,56.44 ,33.33
03,003,01,010,0360,799,845 ,4 ,849 ,1482 ,0,3,1,3,0,1,0,76.14,57.29 ,33.33
03,003,01,010,0361,800,608 ,1 ,609 ,1067 ,0,3,1,3,0,1,0,76.14,57.08 ,33.33
03,003,01,010,0361,801,589 ,5 ,594 ,1171 ,0,3,1,3,0,1,0,76.14,50.73 ,33.33
03,003,01,010,0361,802,623 ,10 ,633 ,1445 ,0,3,1,3,0,1,0,76.14,43.81 ,33.33
03,003,01,010,0362,803,871 ,2 ,873 ,1335 ,0,3,1,3,0,1,0,76.14,65.39 ,33.33
03,003,01,010,0362,804,986 ,9 ,995 ,1522 ,0,3,1,3,0,1,0,76.14,65.37 ,33.33
03,003,01,010,0363,805,601 ,7 ,608 ,1046 ,0,3,1,3,0,1,0,76.14,58.13 ,33.33
03,003,01,010,0363,806,645 ,5 ,650 ,1143 ,0,3,1,3,0,1,0,76.14,56.87 ,33.33
03,003,01,010,0364,807,1056 ,6 ,1062 ,1696 ,0,3,1,3,0,1,0,76.14,62.62 ,33.33
03,003,01,010,0364,808,823 ,9 ,832 ,1277 ,0,3,1,3,0,1,0,76.14,65.15 ,33.33
03,003,01,010,0365,809,755 ,9 ,764 ,1164 ,0,3,1,3,0,1,0,76.14,65.64 ,33.33
03,003,01,010,0366,810,937 ,12 ,949 ,1574 ,0,3,1,3,0,1,0,76.14,60.29 ,33.33
03,003,01,010,0367,811,522 ,3 ,525 ,884 ,0,3,1,3,0,1,0,76.14,59.39 ,33.33
03,003,01,010,0367,812,737 ,3 ,740 ,1133 ,0,3,1,3,0,1,0,76.14,65.31 ,33.33
03,003,01,010,0368,813,1062 ,8 ,1070 ,1885 ,0,3,1,3,0,1,0,76.14,56.76 ,33.33
03,003,01,010,0368,814,1155 ,15 ,1170 ,2027 ,0,3,1,3,0,1,0,76.14,57.72 ,33.33
03,003,01,010,0369,815,821 ,12 ,833 ,1384 ,0,3,1,3,0,1,0,76.14,60.19 ,33.33
03,003,01,010,0369,816,962 ,10 ,972 ,1551 ,0,3,1,3,0,1,0,76.14,62.67 ,33.33
03,003,01,010,0370,817,886 ,13 ,899 ,1378 ,0,3,1,3,0,1,0,76.14,65.24 ,33.33
03,003,01,010,0370,818,848 ,6 ,854 ,1398 ,0,3,1,3,0,1,0,76.14,61.09 ,33.33
03,003,01,010,0371,819,889 ,7 ,896 ,1489 ,0,3,1,3,0,1,0,76.14,60.17 ,33.33
03,003,01,010,0371,820,446 ,11 ,457 ,772 ,0,3,1,3,0,1,0,76.14,59.20 ,33.33
03,003,01,010,0372,821,1039 ,16 ,1055 ,1714 ,0,3,1,3,0,1,0,76.14,61.55 ,33.33
03,003,01,010,0372,822,821 ,7 ,828 ,1327 ,0,3,1,3,0,1,0,76.14,62.40 ,33.33
03,003,01,010,0373,823,885 ,10 ,895 ,1351 ,0,3,1,3,0,1,0,76.14,66.25 ,33.33
03,003,01,010,0373,824,767 ,10 ,777 ,1210 ,0,3,1,3,0,1,0,76.14,64.21 ,33.33
03,003,01,010,0373,825,868 ,8 ,876 ,1507 ,0,3,1,3,0,1,0,76.14,58.13 ,33.33
03,003,01,010,0374,826,599 ,8 ,607 ,1014 ,0,3,1,3,0,1,0,76.14,59.86 ,33.33
03,003,01,010,0374,827,555 ,8 ,563 ,868 ,0,3,1,3,0,1,0,76.14,64.86 ,33.33
03,003,01,010,0375,828,827 ,11 ,838 ,1374 ,0,3,1,3,0,1,0,76.14,60.99 ,33.33
03,003,01,010,0375,829,900 ,9 ,909 ,1908 ,0,3,1,3,0,1,0,76.14,47.64 ,33.33
03,003,01,010,0376,830,899 ,36 ,935 ,1732 ,0,3,1,3,0,1,0,76.14,53.98 ,33.33
03,003,01,010,0376,831,836 ,5 ,841 ,1557 ,0,3,1,3,0,1,0,76.14,54.01 ,33.33
03,003,01,010,0377,832,723 ,4 ,727 ,1131 ,0,3,1,3,0,1,0,76.14,64.28 ,33.33
03,003,01,010,0377,833,696 ,4 ,700 ,1154 ,0,3,1,3,0,1,0,76.14,60.66 ,33.33
03,003,01,010,0378,834,701 ,14 ,715 ,1246 ,0,3,1,3,0,1,0,76.14,57.38 ,33.33
03,003,01,010,0378,835,893 ,13 ,906 ,1693 ,0,3,1,3,0,1,0,76.14,53.51 ,33.33
03,003,01,010,0378,836,770 ,17 ,787 ,1259 ,0,3,1,3,0,1,0,76.14,62.51 ,33.33
03,003,01,010,0379,837,847 ,10 ,857 ,1787 ,0,3,1,3,0,1,0,76.14,47.96 ,33.33
03,003,01,010,0380,838,825 ,12 ,837 ,1238 ,0,3,1,3,0,1,0,76.14,67.61 ,33.33
03,003,01,010,0380,839,481 ,9 ,490 ,850 ,0,3,1,3,0,1,0,76.14,57.65 ,33.33
03,003,01,010,0381,840,1140 ,8 ,1148 ,1863 ,0,3,1,3,0,1,0,76.14,61.62 ,33.33
03,003,01,010,0382,841,704 ,7 ,711 ,1191 ,0,3,1,3,0,1,0,76.14,59.70 ,33.33
03,003,01,010,0382,842,657 ,8 ,665 ,1206 ,0,3,1,3,0,1,0,76.14,55.14 ,33.33
03,003,01,010,0383,843,632 ,5 ,637 ,997 ,0,3,1,3,0,1,0,76.14,63.89 ,33.33
03,003,01,010,0383,844,699 ,10 ,709 ,1069 ,0,3,1,3,0,1,0,76.14,66.32 ,33.33
03,003,01,010,0383,845,690 ,1 ,691 ,1119 ,0,3,1,3,0,1,0,76.14,61.75 ,33.33
03,003,01,010,0384,846,911 ,8 ,919 ,1444 ,0,3,1,3,0,1,0,76.14,63.64 ,33.33
03,003,01,010,0384,847,915 ,11 ,926 ,1684 ,0,3,1,3,0,1,0,76.14,54.99 ,33.33
03,003,01,011,0385,848,702 ,5 ,707 ,1250 ,0,3,1,3,0,1,0,76.14,56.56 ,33.33
03,003,01,011,0385,849,668 ,9 ,677 ,1199 ,0,3,1,3,0,1,0,76.14,56.46 ,33.33
03,003,01,011,0385,850,609 ,3 ,612 ,1085 ,0,3,1,3,0,1,0,76.14,56.41 ,33.33
03,003,01,011,0386,851,794 ,6 ,800 ,1328 ,0,3,1,3,0,1,0,76.14,60.24 ,33.33
03,003,01,011,0386,852,679 ,12 ,691 ,1153 ,0,3,1,3,0,1,0,76.14,59.93 ,33.33
03,003,01,011,0387,853,773 ,3 ,776 ,1189 ,0,3,1,3,0,1,0,76.14,65.26 ,33.33
03,003,01,011,0387,854,930 ,5 ,935 ,1513 ,0,3,1,3,0,1,0,76.14,61.80 ,33.33
03,003,01,011,0387,855,730 ,4 ,734 ,1174 ,0,3,1,3,0,1,0,76.14,62.52 ,33.33
03,003,01,011,0388,856,492 ,3 ,495 ,974 ,0,3,1,3,0,1,0,76.14,50.82 ,33.33
03,003,01,011,0388,857,569 ,8 ,577 ,978 ,0,3,1,3,0,1,0,76.14,59.00 ,33.33
03,003,01,011,0389,858,827 ,13 ,840 ,1551 ,0,3,1,3,0,1,0,76.14,54.16 ,33.33
03,003,01,011,0389,859,952 ,19 ,971 ,1654 ,0,3,1,3,0,1,0,76.14,58.71 ,33.33
03,003,01,011,0390,860,758 ,3 ,761 ,1309 ,0,3,1,3,0,1,0,76.14,58.14 ,33.33
03,003,01,011,0390,861,611 ,3 ,614 ,1141 ,0,3,1,3,0,1,0,76.14,53.81 ,33.33
03,003,01,011,0391,862,776 ,2 ,778 ,1355 ,0,3,1,3,0,1,0,76.14,57.42 ,33.33
03,003,01,011,0391,863,892 ,11 ,903 ,1532 ,0,3,1,3,0,1,0,76.14,58.94 ,33.33
03,003,01,011,0392,864,704 ,14 ,718 ,1196 ,0,3,1,3,0,1,0,76.14,60.03 ,33.33
03,003,01,011,0392,865,733 ,10 ,743 ,1241 ,0,3,1,3,0,1,0,76.14,59.87 ,33.33
03,003,01,011,0393,866,704 ,6 ,710 ,1179 ,0,3,1,3,0,1,0,76.14,60.22 ,33.33
03,003,01,011,0393,867,514 ,8 ,522 ,907 ,0,3,1,3,0,1,0,76.14,57.55 ,33.33
03,003,01,011,0393,868,602 ,2 ,604 ,1024 ,0,3,1,3,0,1,0,76.14,58.98 ,33.33
03,003,01,011,0394,869,643 ,5 ,648 ,1144 ,0,3,1,3,0,1,0,76.14,56.64 ,33.33
03,003,01,011,0394,870,606 ,3 ,609 ,1111 ,0,3,1,3,0,1,0,76.14,54.82 ,33.33
03,003,01,011,0395,871,662 ,7 ,669 ,1229 ,0,3,1,3,0,1,0,76.14,54.43 ,33.33
03,003,01,011,0395,872,972 ,12 ,984 ,1739 ,0,3,1,3,0,1,0,76.14,56.58 ,33.33
03,003,01,011,0396,873,667 ,3 ,670 ,1046 ,0,3,1,3,0,1,0,76.14,64.05 ,33.33
03,003,01,011,0396,874,575 ,4 ,579 ,888 ,0,3,1,3,0,1,0,76.14,65.20 ,33.33
03,003,01,011,0397,875,847 ,6 ,853 ,1350 ,0,3,1,3,0,1,0,76.14,63.19 ,33.33
03,003,01,011,0397,876,848 ,7 ,855 ,1559 ,0,3,1,3,0,1,0,76.14,54.84 ,33.33
03,003,01,011,0398,877,803 ,7 ,810 ,1411 ,0,3,1,3,0,1,0,76.14,57.41 ,33.33
03,003,01,011,0398,878,818 ,4 ,822 ,1429 ,0,3,1,3,0,1,0,76.14,57.52 ,33.33
03,003,01,011,0399,879,621 ,6 ,627 ,1117 ,0,3,1,3,0,1,0,76.14,56.13 ,33.33
03,003,01,011,0399,880,644 ,10 ,654 ,1080 ,0,3,1,3,0,1,0,76.14,60.56 ,33.33
03,003,01,011,0400,881,666 ,11 ,677 ,1180 ,0,3,1,3,0,1,0,76.14,57.37 ,33.33
03,003,01,011,0400,882,886 ,8 ,894 ,1644 ,0,3,1,3,0,1,0,76.14,54.38 ,33.33
03,003,01,011,0401,883,616 ,5 ,621 ,1057 ,0,3,1,3,0,1,0,76.14,58.75 ,33.33
03,003,01,011,0401,884,435 ,0 ,435 ,876 ,0,3,1,3,0,1,0,76.14,49.66 ,33.33
03,003,01,011,0402,885,1020 ,11 ,1031 ,1673 ,0,3,1,3,0,1,0,76.14,61.63 ,33.33
03,003,01,011,0402,886,1030 ,10 ,1040 ,1617 ,0,3,1,3,0,1,0,76.14,64.32 ,33.33
03,003,01,011,0403,887,925 ,14 ,939 ,1650 ,0,3,1,3,0,1,0,76.14,56.91 ,33.33
03,003,01,011,0403,888,941 ,7 ,948 ,1651 ,0,3,1,3,0,1,0,76.14,57.42 ,33.33
03,003,01,011,0404,889,606 ,9 ,615 ,1067 ,0,3,1,3,0,1,0,76.14,57.64 ,33.33
03,003,01,011,0404,890,475 ,8 ,483 ,838 ,0,3,1,3,0,1,0,76.14,57.64 ,33.33
03,003,01,011,0405,891,638 ,12 ,650 ,1056 ,0,3,1,3,0,1,0,76.14,61.55 ,33.33
03,003,01,011,0405,892,665 ,3 ,668 ,1116 ,0,3,1,3,0,1,0,76.14,59.86 ,33.33
03,003,01,011,0405,893,660 ,3 ,663 ,941 ,0,3,1,3,0,1,0,76.14,70.46 ,33.33
03,003,01,011,0406,894,748 ,10 ,758 ,1295 ,0,3,1,3,0,1,0,76.14,58.53 ,33.33
03,003,01,011,0407,895,631 ,4 ,635 ,1144 ,0,3,1,3,0,1,0,76.14,55.51 ,33.33
03,003,01,011,0408,896,602 ,2 ,604 ,1035 ,0,3,1,3,0,1,0,76.14,58.36 ,33.33
03,003,01,011,0408,897,699 ,3 ,702 ,1107 ,0,3,1,3,0,1,0,76.14,63.41 ,33.33
03,003,01,011,0409,898,905 ,4 ,909 ,1470 ,0,3,1,3,0,1,0,76.14,61.84 ,33.33
03,003,01,011,0409,899,1036 ,4 ,1040 ,1624 ,0,3,1,3,0,1,0,76.14,64.04 ,33.33
03,003,01,011,0410,900,978 ,7 ,985 ,1583 ,0,3,1,3,0,1,0,76.14,62.22 ,33.33
03,003,01,011,0410,901,747 ,5 ,752 ,1197 ,0,3,1,3,0,1,0,76.14,62.82 ,33.33
03,003,01,011,0411,902,668 ,5 ,673 ,1224 ,0,3,1,3,0,1,0,76.14,54.98 ,33.33
03,003,01,011,0411,903,746 ,9 ,755 ,1338 ,0,3,1,3,0,1,0,76.14,56.43 ,33.33
03,003,01,011,0412,904,772 ,10 ,782 ,1418 ,0,3,1,3,0,1,0,76.14,55.15 ,33.33
03,003,01,011,0412,905,769 ,9 ,778 ,1471 ,0,3,1,3,0,1,0,76.14,52.89 ,33.33
03,003,01,011,0413,906,763 ,2 ,765 ,1340 ,0,3,1,3,0,1,0,76.14,57.09 ,33.33
03,003,01,011,0414,907,451 ,3 ,454 ,681 ,0,3,1,3,0,1,0,76.14,66.67 ,33.33
03,003,01,012,0415,908,813 ,5 ,818 ,1183 ,0,3,1,3,0,1,0,76.14,69.15 ,33.33
03,003,01,012,0415,909,813 ,1 ,814 ,1233 ,0,3,1,3,0,1,0,76.14,66.02 ,33.33
03,003,01,012,0416,910,990 ,9 ,999 ,1455 ,0,3,1,3,0,1,0,76.14,68.66 ,33.33
03,003,01,012,0416,911,1024 ,7 ,1031 ,1578 ,0,3,1,3,0,1,0,76.14,65.34 ,33.33
03,003,01,012,0417,912,814 ,7 ,821 ,1246 ,0,3,1,3,0,1,0,76.14,65.89 ,33.33
03,003,01,012,0418,913,990 ,10 ,1000 ,1570 ,0,3,1,3,0,1,0,76.14,63.69 ,33.33
03,003,01,012,0418,914,888 ,4 ,892 ,1446 ,0,3,1,3,0,1,0,76.14,61.69 ,33.33
03,003,01,012,0419,915,1122 ,15 ,1137 ,1689 ,0,3,1,3,0,1,0,76.14,67.32 ,33.33
03,003,01,012,0420,916,765 ,2 ,767 ,1193 ,0,3,1,3,0,1,0,76.14,64.29 ,33.33
03,003,01,012,0421,917,958 ,5 ,963 ,1326 ,0,3,1,3,0,1,0,76.14,72.62 ,33.33
03,003,01,012,0422,918,667 ,2 ,669 ,1032 ,0,3,1,3,0,1,0,76.14,64.83 ,33.33
03,003,01,012,0422,919,692 ,10 ,702 ,1067 ,0,3,1,3,0,1,0,76.14,65.79 ,33.33
03,003,01,012,0423,920,1188 ,11 ,1199 ,1835 ,0,3,1,3,0,1,0,76.14,65.34 ,33.33
03,003,01,012,0424,921,896 ,5 ,901 ,1434 ,0,3,1,3,0,1,0,76.14,62.83 ,33.33
03,003,01,012,0424,922,858 ,7 ,865 ,1482 ,0,3,1,3,0,1,0,76.14,58.37 ,33.33
03,003,01,012,0425,923,847 ,6 ,853 ,1318 ,0,3,1,3,0,1,0,76.14,64.72 ,33.33
03,003,01,012,0426,924,999 ,7 ,1006 ,1446 ,0,3,1,3,0,1,0,76.14,69.57 ,33.33
03,003,01,012,0427,925,704 ,8 ,712 ,1087 ,0,3,1,3,0,1,0,76.14,65.50 ,33.33
03,003,01,012,0428,926,507 ,4 ,511 ,858 ,0,3,1,3,0,1,0,76.14,59.56 ,33.33
03,003,01,012,0429,927,434 ,2 ,436 ,653 ,0,3,1,3,0,1,0,76.14,66.77 ,33.33
03,003,01,012,0430,928,700 ,5 ,705 ,1042 ,0,3,1,3,0,1,0,76.14,67.66 ,33.33
03,003,01,012,0431,929,676 ,7 ,683 ,1017 ,0,3,1,3,0,1,0,76.14,67.16 ,33.33
03,003,01,012,0432,930,670 ,4 ,674 ,894 ,0,3,1,3,0,1,0,76.14,75.39 ,33.33
03,003,01,012,0432,931,874 ,10 ,884 ,1331 ,0,3,1,3,0,1,0,76.14,66.42 ,33.33
03,003,01,012,0433,932,619 ,3 ,622 ,937 ,0,3,1,3,0,1,0,76.14,66.38 ,33.33
03,003,01,012,0434,933,435 ,5 ,440 ,690 ,0,3,1,3,0,1,0,76.14,63.77 ,33.33
03,003,01,012,0435,934,574 ,2 ,576 ,799 ,0,3,1,3,0,1,0,76.14,72.09 ,33.33
03,003,01,012,0436,935,1017 ,8 ,1025 ,1556 ,0,3,1,3,0,1,0,76.14,65.87 ,33.33
03,003,01,012,0437,936,705 ,10 ,715 ,1073 ,0,3,1,3,0,1,0,76.14,66.64 ,33.33
03,003,01,013,0438,937,743 ,4 ,747 ,1189 ,0,3,1,3,0,1,0,76.14,62.83 ,33.33
03,003,01,013,0438,938,762 ,5 ,767 ,1165 ,0,3,1,3,0,1,0,76.14,65.84 ,33.33
03,003,01,013,0439,939,769 ,14 ,783 ,1094 ,0,3,1,3,0,1,0,76.14,71.57 ,33.33
03,003,01,013,0440,940,816 ,8 ,824 ,1292 ,0,3,1,3,0,1,0,76.14,63.78 ,33.33
03,003,01,013,0441,941,769 ,5 ,774 ,1179 ,0,3,1,3,0,1,0,76.14,65.65 ,33.33
03,003,01,013,0442,942,1055 ,5 ,1060 ,1570 ,0,3,1,3,0,1,0,76.14,67.52 ,33.33
03,003,01,013,0443,943,499 ,4 ,503 ,688 ,0,3,1,3,0,1,0,76.14,73.11 ,33.33
03,003,01,013,0444,944,520 ,9 ,529 ,746 ,0,3,1,3,0,1,0,76.14,70.91 ,33.33
03,003,01,013,0445,945,443 ,4 ,447 ,660 ,0,3,1,3,0,1,0,76.14,67.73 ,33.33
03,003,01,013,0446,946,738 ,9 ,747 ,1228 ,0,3,1,3,0,1,0,76.14,60.83 ,33.33
03,003,01,013,0447,947,1134 ,3 ,1137 ,1905 ,0,3,1,3,0,1,0,76.14,59.69 ,33.33
03,003,01,013,0448,948,1261 ,8 ,1269 ,1947 ,0,3,1,3,0,1,0,76.14,65.18 ,33.33
03,003,01,013,0449,949,1123 ,13 ,1136 ,1796 ,0,3,1,3,0,1,0,76.14,63.25 ,33.33
03,003,01,013,0450,950,702 ,13 ,715 ,1075 ,0,3,1,3,0,1,0,76.14,66.51 ,33.33
03,003,01,013,0451,951,1045 ,9 ,1054 ,1767 ,0,3,1,3,0,1,0,76.14,59.65 ,33.33
03,003,01,013,0451,952,1186 ,17 ,1203 ,1864 ,0,3,1,3,0,1,0,76.14,64.54 ,33.33
03,003,01,013,0452,953,1152 ,14 ,1166 ,1960 ,0,3,1,3,0,1,0,76.14,59.49 ,33.33
03,003,01,013,0453,954,1046 ,11 ,1057 ,1731 ,0,3,1,3,0,1,0,76.14,61.06 ,33.33
03,003,01,013,0454,955,832 ,6 ,838 ,1287 ,0,3,1,3,0,1,0,76.14,65.11 ,33.33
03,003,01,013,0454,956,800 ,5 ,805 ,1287 ,0,3,1,3,0,1,0,76.14,62.55 ,33.33
03,003,01,013,0455,957,1196 ,6 ,1202 ,1831 ,0,3,1,3,0,1,0,76.14,65.65 ,33.33
03,003,01,013,0456,958,636 ,3 ,639 ,967 ,0,3,1,3,0,1,0,76.14,66.08 ,33.33
03,003,01,013,0457,959,1161 ,27 ,1188 ,1871 ,0,3,1,3,0,1,0,76.14,63.50 ,33.33
03,003,01,013,0458,960,1032 ,10 ,1042 ,1564 ,0,3,1,3,0,1,0,76.14,66.62 ,33.33
03,003,01,013,0458,961,1126 ,13 ,1139 ,1993 ,0,3,1,3,0,1,0,76.14,57.15 ,33.33
03,003,01,013,0459,962,996 ,6 ,1002 ,1682 ,0,3,1,3,0,1,0,76.14,59.57 ,33.33
03,003,01,013,0460,963,881 ,14 ,895 ,1394 ,0,3,1,3,0,1,0,76.14,64.20 ,33.33
03,004,01,001,0001,1,371 ,1 ,372 ,669 ,0,3,1,3,0,1,0,76.14,55.61 ,33.33
03,004,01,001,0001,2,535 ,5 ,540 ,816 ,0,3,1,3,0,1,0,76.14,66.18 ,33.33
03,004,01,001,0002,3,183 ,0 ,183 ,254 ,0,3,1,3,0,1,0,76.14,72.05 ,33.33
03,004,01,001,0003,4,479 ,4 ,483 ,857 ,0,3,1,3,0,1,0,76.14,56.36 ,33.33
03,004,01,001,0003,5,476 ,13 ,489 ,823 ,0,3,1,3,0,1,0,76.14,59.42 ,33.33
03,004,01,001,0004,6,398 ,4 ,402 ,571 ,0,3,1,3,0,1,0,76.14,70.40 ,33.33
03,004,01,001,0005,7,785 ,8 ,793 ,1277 ,0,3,1,3,0,1,0,76.14,62.10 ,33.33
03,004,01,001,0005,8,811 ,7 ,818 ,1246 ,0,3,1,3,0,1,0,76.14,65.65 ,33.33
03,004,01,001,0006,9,547 ,5 ,552 ,1002 ,0,3,1,3,0,1,0,76.14,55.09 ,33.33
03,004,01,001,0006,10,779 ,11 ,790 ,1288 ,0,3,1,3,0,1,0,76.14,61.34 ,33.33
03,004,01,001,0006,11,662 ,10 ,672 ,1234 ,0,3,1,3,0,1,0,76.14,54.46 ,33.33
03,004,01,001,0006,12,762 ,4 ,766 ,1419 ,0,3,1,3,0,1,0,76.14,53.98 ,33.33
03,004,01,001,0006,13,857 ,5 ,862 ,1442 ,0,3,1,3,0,1,0,76.14,59.78 ,33.33
03,004,01,001,0007,14,685 ,10 ,695 ,1106 ,0,3,1,3,0,1,0,76.14,62.84 ,33.33
03,004,01,001,0007,15,622 ,1 ,623 ,1249 ,0,3,1,3,0,1,0,76.14,49.88 ,33.33
03,004,01,001,0007,16,674 ,4 ,678 ,1211 ,0,3,1,3,0,1,0,76.14,55.99 ,33.33
03,004,01,001,0007,17,836 ,7 ,843 ,1483 ,0,3,1,3,0,1,0,76.14,56.84 ,33.33
03,004,01,001,0008,18,758 ,4 ,762 ,1275 ,0,3,1,3,0,1,0,76.14,59.76 ,33.33
03,004,01,001,0008,19,795 ,1 ,796 ,1337 ,0,3,1,3,0,1,0,76.14,59.54 ,33.33
03,004,01,001,0009,20,624 ,4 ,628 ,1039 ,0,3,1,3,0,1,0,76.14,60.44 ,33.33
03,004,01,001,0009,21,816 ,4 ,820 ,1385 ,0,3,1,3,0,1,0,76.14,59.21 ,33.33
03,004,01,001,0009,22,733 ,4 ,737 ,1243 ,0,3,1,3,0,1,0,76.14,59.29 ,33.33
03,004,01,001,0010,23,634 ,2 ,636 ,1159 ,0,3,1,3,0,1,0,76.14,54.87 ,33.33
03,004,01,001,0010,24,700 ,3 ,703 ,1210 ,0,3,1,3,0,1,0,76.14,58.10 ,33.33
03,004,01,001,0010,25,657 ,5 ,662 ,1183 ,0,3,1,3,0,1,0,76.14,55.96 ,33.33
03,004,01,001,0011,26,561 ,3 ,564 ,1021 ,0,3,1,3,0,1,0,76.14,55.24 ,33.33
03,004,01,001,0011,27,613 ,2 ,615 ,1057 ,0,3,1,3,0,1,0,76.14,58.18 ,33.33
03,004,01,001,0011,28,617 ,8 ,625 ,1141 ,0,3,1,3,0,1,0,76.14,54.78 ,33.33
03,004,01,001,0011,29,642 ,5 ,647 ,1148 ,0,3,1,3,0,1,0,76.14,56.36 ,33.33
03,004,01,001,0011,30,746 ,6 ,752 ,1352 ,0,3,1,3,0,1,0,76.14,55.62 ,33.33
03,004,01,001,0011,31,727 ,8 ,735 ,1123 ,0,3,1,3,0,1,0,76.14,65.45 ,33.33
03,004,01,001,0012,32,489 ,5 ,494 ,808 ,0,3,1,3,0,1,0,76.14,61.14 ,33.33
03,004,01,001,0012,33,680 ,6 ,686 ,1060 ,0,3,1,3,0,1,0,76.14,64.72 ,33.33
03,004,01,001,0012,34,551 ,5 ,556 ,1014 ,0,3,1,3,0,1,0,76.14,54.83 ,33.33
03,004,01,001,0013,35,452 ,8 ,460 ,753 ,0,3,1,3,0,1,0,76.14,61.09 ,33.33
03,004,01,001,0013,36,436 ,2 ,438 ,740 ,0,3,1,3,0,1,0,76.14,59.19 ,33.33
03,004,01,001,0013,37,668 ,5 ,673 ,1184 ,0,3,1,3,0,1,0,76.14,56.84 ,33.33
03,004,01,001,0013,38,649 ,6 ,655 ,1217 ,0,3,1,3,0,1,0,76.14,53.82 ,33.33
03,004,01,001,0014,39,886 ,18 ,904 ,1505 ,0,3,1,3,0,1,0,76.14,60.07 ,33.33
03,004,01,001,0014,40,631 ,7 ,638 ,1181 ,0,3,1,3,0,1,0,76.14,54.02 ,33.33
03,004,01,001,0014,41,590 ,6 ,596 ,1060 ,0,3,1,3,0,1,0,76.14,56.23 ,33.33
03,004,01,001,0015,42,643 ,6 ,649 ,1106 ,0,3,1,3,0,1,0,76.14,58.68 ,33.33
03,004,01,001,0015,43,532 ,2 ,534 ,977 ,0,3,1,3,0,1,0,76.14,54.66 ,33.33
03,004,01,001,0015,44,583 ,7 ,590 ,1089 ,0,3,1,3,0,1,0,76.14,54.18 ,33.33
03,004,01,001,0015,45,648 ,6 ,654 ,1111 ,0,3,1,3,0,1,0,76.14,58.87 ,33.33
03,004,01,001,0015,46,612 ,4 ,616 ,1050 ,0,3,1,3,0,1,0,76.14,58.67 ,33.33
03,004,01,001,0016,47,700 ,6 ,706 ,1200 ,0,3,1,3,0,1,0,76.14,58.83 ,33.33
03,004,01,001,0016,48,790 ,10 ,800 ,1417 ,0,3,1,3,0,1,0,76.14,56.46 ,33.33
03,004,01,001,0016,49,613 ,7 ,620 ,1018 ,0,3,1,3,0,1,0,76.14,60.90 ,33.33
03,004,01,001,0017,50,746 ,12 ,758 ,1268 ,0,3,1,3,0,1,0,76.14,59.78 ,33.33
03,004,01,001,0017,51,628 ,5 ,633 ,1021 ,0,3,1,3,0,1,0,76.14,62.00 ,33.33
03,004,01,001,0017,52,623 ,10 ,633 ,1055 ,0,3,1,3,0,1,0,76.14,60.00 ,33.33
03,004,01,001,0018,53,812 ,6 ,818 ,1229 ,0,3,1,3,0,1,0,76.14,66.56 ,33.33
03,004,01,001,0019,54,540 ,4 ,544 ,859 ,0,3,1,3,0,1,0,76.14,63.33 ,33.33
03,004,01,001,0019,55,640 ,8 ,648 ,977 ,0,3,1,3,0,1,0,76.14,66.33 ,33.33
03,004,01,001,0020,56,620 ,3 ,623 ,919 ,0,3,1,3,0,1,0,76.14,67.79 ,33.33
03,004,01,001,0021,57,494 ,4 ,498 ,732 ,0,3,1,3,0,1,0,76.14,68.03 ,33.33
03,004,01,001,0021,58,633 ,6 ,639 ,994 ,0,3,1,3,0,1,0,76.14,64.29 ,33.33
03,004,01,001,0022,59,710 ,7 ,717 ,1094 ,0,3,1,3,0,1,0,76.14,65.54 ,33.33
03,004,01,001,0023,60,780 ,6 ,786 ,1425 ,0,3,1,3,0,1,0,76.14,55.16 ,33.33
03,004,01,001,0024,61,547 ,2 ,549 ,852 ,0,3,1,3,0,1,0,76.14,64.44 ,33.33
03,004,01,001,0024,62,361 ,4 ,365 ,583 ,0,3,1,3,0,1,0,76.14,62.61 ,33.33
03,004,01,001,0025,63,474 ,1 ,475 ,660 ,0,3,1,3,0,1,0,76.14,71.97 ,33.33
03,004,01,001,0025,64,418 ,3 ,421 ,654 ,0,3,1,3,0,1,0,76.14,64.37 ,33.33
03,004,01,001,0026,65,613 ,6 ,619 ,899 ,0,3,1,3,0,1,0,76.14,68.85 ,33.33
03,004,01,001,0026,66,533 ,5 ,538 ,809 ,0,3,1,3,0,1,0,76.14,66.50 ,33.33
03,004,01,002,0027,67,221 ,2 ,223 ,379 ,0,3,1,3,0,1,0,76.14,58.84 ,33.33
03,004,01,002,0028,68,217 ,1 ,218 ,344 ,0,3,1,3,0,1,0,76.14,63.37 ,33.33
03,004,01,002,0029,69,216 ,5 ,221 ,368 ,0,3,1,3,0,1,0,76.14,60.05 ,33.33
03,004,01,002,0030,70,459 ,9 ,468 ,812 ,0,3,1,3,0,1,0,76.14,57.64 ,33.33
03,004,01,002,0030,71,602 ,6 ,608 ,1054 ,0,3,1,3,0,1,0,76.14,57.69 ,33.33
03,004,01,002,0031,72,695 ,6 ,701 ,1307 ,0,3,1,3,0,1,0,76.14,53.63 ,33.33
03,004,01,002,0031,73,762 ,12 ,774 ,1475 ,0,3,1,3,0,1,0,76.14,52.47 ,33.33
03,004,01,002,0031,74,720 ,8 ,728 ,1392 ,0,3,1,3,0,1,0,76.14,52.30 ,33.33
03,004,01,002,0031,75,748 ,3 ,751 ,1301 ,0,3,1,3,0,1,0,76.14,57.72 ,33.33
03,004,01,002,0031,76,693 ,6 ,699 ,1155 ,0,3,1,3,0,1,0,76.14,60.52 ,33.33
03,004,01,002,0032,77,573 ,7 ,580 ,959 ,0,3,1,3,0,1,0,76.14,60.48 ,33.33
03,004,01,002,0032,78,546 ,6 ,552 ,885 ,0,3,1,3,0,1,0,76.14,62.37 ,33.33
03,004,01,002,0032,79,561 ,7 ,568 ,966 ,0,3,1,3,0,1,0,76.14,58.80 ,33.33
03,004,01,002,0033,80,413 ,8 ,421 ,718 ,0,3,1,3,0,1,0,76.14,58.64 ,33.33
03,004,01,002,0033,81,493 ,7 ,500 ,836 ,0,3,1,3,0,1,0,76.14,59.81 ,33.33
03,004,01,002,0034,82,636 ,11 ,647 ,1230 ,0,3,1,3,0,1,0,76.14,52.60 ,33.33
03,004,01,002,0034,83,599 ,5 ,604 ,1085 ,0,3,1,3,0,1,0,76.14,55.67 ,33.33
03,004,01,002,0034,84,805 ,4 ,809 ,1366 ,0,3,1,3,0,1,0,76.14,59.22 ,33.33
03,004,01,002,0035,85,556 ,1 ,557 ,891 ,0,3,1,3,0,1,0,76.14,62.51 ,33.33
03,004,01,002,0035,86,567 ,2 ,569 ,867 ,0,3,1,3,0,1,0,76.14,65.63 ,33.33
03,004,01,002,0036,87,752 ,9 ,761 ,1132 ,0,3,1,3,0,1,0,76.14,67.23 ,33.33
03,004,01,002,0037,88,516 ,5 ,521 ,785 ,0,3,1,3,0,1,0,76.14,66.37 ,33.33
03,004,01,002,0038,89,733 ,5 ,738 ,1354 ,0,3,1,3,0,1,0,76.14,54.51 ,33.33
03,004,01,002,0038,90,628 ,2 ,630 ,1054 ,0,3,1,3,0,1,0,76.14,59.77 ,33.33
03,004,01,002,0039,91,546 ,6 ,552 ,947 ,0,3,1,3,0,1,0,76.14,58.29 ,33.33
03,004,01,002,0039,92,731 ,9 ,740 ,1239 ,0,3,1,3,0,1,0,76.14,59.73 ,33.33
03,004,01,002,0039,93,599 ,6 ,605 ,1029 ,0,3,1,3,0,1,0,76.14,58.79 ,33.33
03,004,01,002,0040,94,746 ,11 ,757 ,1332 ,0,3,1,3,0,1,0,76.14,56.83 ,33.33
03,004,01,002,0040,95,903 ,6 ,909 ,1468 ,0,3,1,3,0,1,0,76.14,61.92 ,33.33
03,004,01,002,0041,96,449 ,6 ,455 ,631 ,0,3,1,3,0,1,0,76.14,72.11 ,33.33
03,004,01,002,0041,97,492 ,4 ,496 ,786 ,0,3,1,3,0,1,0,76.14,63.10 ,33.33
03,004,01,002,0042,98,808 ,7 ,815 ,1416 ,0,3,1,3,0,1,0,76.14,57.56 ,33.33
03,004,01,002,0043,99,431 ,5 ,436 ,715 ,0,3,1,3,0,1,0,76.14,60.98 ,33.33
03,004,01,002,0043,100,469 ,3 ,472 ,686 ,0,3,1,3,0,1,0,76.14,68.80 ,33.33
03,004,01,002,0044,101,723 ,5 ,728 ,1153 ,0,3,1,3,0,1,0,76.14,63.14 ,33.33
03,004,01,002,0044,102,668 ,8 ,676 ,1057 ,0,3,1,3,0,1,0,76.14,63.95 ,33.33
03,004,01,002,0044,103,539 ,7 ,546 ,903 ,0,3,1,3,0,1,0,76.14,60.47 ,33.33
03,004,01,002,0044,104,797 ,8 ,805 ,1386 ,0,3,1,3,0,1,0,76.14,58.08 ,33.33
03,004,01,002,0044,105,569 ,8 ,577 ,1010 ,0,3,1,3,0,1,0,76.14,57.13 ,33.33
03,004,01,002,0045,106,252 ,1 ,253 ,432 ,0,3,1,3,0,1,0,76.14,58.56 ,33.33
03,004,01,002,0045,107,694 ,6 ,700 ,1453 ,0,3,1,3,0,1,0,76.14,48.18 ,33.33
03,004,01,002,0045,108,605 ,13 ,618 ,1076 ,0,3,1,3,0,1,0,76.14,57.43 ,33.33
03,004,01,002,0045,109,419 ,4 ,423 ,662 ,0,3,1,3,0,1,0,76.14,63.90 ,33.33
03,004,01,002,0045,110,602 ,4 ,606 ,1123 ,0,3,1,3,0,1,0,76.14,53.96 ,33.33
03,004,01,002,0045,111,496 ,10 ,506 ,943 ,0,3,1,3,0,1,0,76.14,53.66 ,33.33
03,004,01,002,0046,112,311 ,1 ,312 ,511 ,0,3,1,3,0,1,0,76.14,61.06 ,33.33
03,004,01,002,0047,113,652 ,3 ,655 ,1210 ,0,3,1,3,0,1,0,76.14,54.13 ,33.33
03,004,01,002,0047,114,581 ,6 ,587 ,1098 ,0,3,1,3,0,1,0,76.14,53.46 ,33.33
03,004,01,002,0047,115,548 ,6 ,554 ,926 ,0,3,1,3,0,1,0,76.14,59.83 ,33.33
03,004,01,002,0047,116,334 ,12 ,346 ,572 ,0,3,1,3,0,1,0,76.14,60.49 ,33.33
03,004,01,002,0047,117,654 ,8 ,662 ,1161 ,0,3,1,3,0,1,0,76.14,57.02 ,33.33
03,004,01,002,0048,118,663 ,7 ,670 ,1075 ,0,3,1,3,0,1,0,76.14,62.33 ,33.33
03,004,01,002,0048,119,768 ,8 ,776 ,1357 ,0,3,1,3,0,1,0,76.14,57.18 ,33.33
03,004,01,002,0048,120,646 ,8 ,654 ,1158 ,0,3,1,3,0,1,0,76.14,56.48 ,33.33
03,004,01,002,0048,121,322 ,2 ,324 ,857 ,0,3,1,3,0,1,0,76.14,37.81 ,33.33
03,004,01,002,0048,122,743 ,8 ,751 ,1442 ,0,3,1,3,0,1,0,76.14,52.08 ,33.33
03,004,01,002,0048,123,594 ,6 ,600 ,1008 ,0,3,1,3,0,1,0,76.14,59.52 ,33.33
03,004,01,002,0049,124,629 ,3 ,632 ,1187 ,0,3,1,3,0,1,0,76.14,53.24 ,33.33
03,004,01,002,0049,125,619 ,5 ,624 ,1108 ,0,3,1,3,0,1,0,76.14,56.32 ,33.33
03,004,01,002,0049,126,728 ,2 ,730 ,1287 ,0,3,1,3,0,1,0,76.14,56.72 ,33.33
03,004,01,002,0050,127,863 ,7 ,870 ,1508 ,0,3,1,3,0,1,0,76.14,57.69 ,33.33
03,004,01,002,0051,128,366 ,4 ,370 ,651 ,0,3,1,3,0,1,0,76.14,56.84 ,33.33
03,004,01,003,0052,129,709 ,5 ,714 ,1033 ,0,3,1,3,0,1,0,76.14,69.12 ,33.33
03,004,01,003,0053,130,425 ,6 ,431 ,679 ,0,3,1,3,0,1,0,76.14,63.48 ,33.33
03,004,01,003,0054,131,673 ,18 ,691 ,1059 ,0,3,1,3,0,1,0,76.14,65.25 ,33.33
03,004,01,003,0055,132,550 ,7 ,557 ,864 ,0,3,1,3,0,1,0,76.14,64.47 ,33.33
03,004,01,003,0055,133,433 ,6 ,439 ,737 ,0,3,1,3,0,1,0,76.14,59.57 ,33.33
03,004,01,003,0055,134,544 ,5 ,549 ,772 ,0,3,1,3,0,1,0,76.14,71.11 ,33.33
03,004,01,003,0056,135,518 ,5 ,523 ,928 ,0,3,1,3,0,1,0,76.14,56.36 ,33.33
03,004,01,003,0056,136,454 ,4 ,458 ,818 ,0,3,1,3,0,1,0,76.14,55.99 ,33.33
03,004,01,003,0057,137,578 ,8 ,586 ,882 ,0,3,1,3,0,1,0,76.14,66.44 ,33.33
03,004,01,003,0057,138,580 ,4 ,584 ,975 ,0,3,1,3,0,1,0,76.14,59.90 ,33.33
03,004,01,003,0058,139,599 ,9 ,608 ,950 ,0,3,1,3,0,1,0,76.14,64.00 ,33.33
03,004,01,003,0058,140,597 ,6 ,603 ,973 ,0,3,1,3,0,1,0,76.14,61.97 ,33.33
03,004,01,003,0058,141,639 ,7 ,646 ,998 ,0,3,1,3,0,1,0,76.14,64.73 ,33.33
03,004,01,003,0059,142,893 ,13 ,906 ,1374 ,0,3,1,3,0,1,0,76.14,65.94 ,33.33
03,004,01,003,0060,143,314 ,0 ,314 ,451 ,0,3,1,3,0,1,0,76.14,69.62 ,33.33
03,004,01,003,0061,144,469 ,6 ,475 ,716 ,0,3,1,3,0,1,0,76.14,66.34 ,33.33
03,004,01,003,0062,145,394 ,1 ,395 ,605 ,0,3,1,3,0,1,0,76.14,65.29 ,33.33
03,004,01,003,0063,146,777 ,10 ,787 ,1083 ,0,3,1,3,0,1,0,76.14,72.67 ,33.33
03,004,01,003,0064,147,728 ,8 ,736 ,1112 ,0,3,1,3,0,1,0,76.14,66.19 ,33.33
03,004,01,003,0065,148,567 ,3 ,570 ,801 ,0,3,1,3,0,1,0,76.14,71.16 ,33.33
03,004,01,003,0066,149,804 ,8 ,812 ,1394 ,0,3,1,3,0,1,0,76.14,58.25 ,33.33
03,004,01,003,0066,150,675 ,4 ,679 ,1144 ,0,3,1,3,0,1,0,76.14,59.35 ,33.33
03,004,01,003,0066,151,789 ,12 ,801 ,1384 ,0,3,1,3,0,1,0,76.14,57.88 ,33.33
03,004,01,003,0067,152,534 ,15 ,549 ,868 ,0,3,1,3,0,1,0,76.14,63.25 ,33.33
03,004,01,003,0067,153,529 ,14 ,543 ,846 ,0,3,1,3,0,1,0,76.14,64.18 ,33.33
03,004,01,003,0068,154,625 ,7 ,632 ,938 ,0,3,1,3,0,1,0,76.14,67.38 ,33.33
03,004,01,003,0068,155,509 ,6 ,515 ,869 ,0,3,1,3,0,1,0,76.14,59.26 ,33.33
03,004,01,003,0069,156,652 ,5 ,657 ,1012 ,0,3,1,3,0,1,0,76.14,64.92 ,33.33
03,004,01,003,0070,157,460 ,2 ,462 ,666 ,0,3,1,3,0,1,0,76.14,69.37 ,33.33
03,004,01,004,0071,158,386 ,5 ,391 ,544 ,0,3,1,3,0,1,0,76.14,71.88 ,33.33
03,004,01,004,0072,159,441 ,3 ,444 ,701 ,0,3,1,3,0,1,0,76.14,63.34 ,33.33
03,004,01,004,0072,160,604 ,8 ,612 ,1049 ,0,3,1,3,0,1,0,76.14,58.34 ,33.33
03,004,01,004,0073,161,519 ,7 ,526 ,750 ,0,3,1,3,0,1,0,76.14,70.13 ,33.33
03,004,01,004,0074,162,673 ,7 ,680 ,1126 ,0,3,1,3,0,1,0,76.14,60.39 ,33.33
03,004,01,004,0074,163,698 ,5 ,703 ,1127 ,0,3,1,3,0,1,0,76.14,62.38 ,33.33
03,004,01,004,0074,164,818 ,7 ,825 ,1363 ,0,3,1,3,0,1,0,76.14,60.53 ,33.33
03,004,01,004,0075,165,481 ,5 ,486 ,740 ,0,3,1,3,0,1,0,76.14,65.68 ,33.33
03,004,01,004,0076,166,674 ,9 ,683 ,1080 ,0,3,1,3,0,1,0,76.14,63.24 ,33.33
03,004,01,004,0077,167,633 ,12 ,645 ,1029 ,0,3,1,3,0,1,0,76.14,62.68 ,33.33
03,004,01,004,0078,168,563 ,4 ,567 ,945 ,0,3,1,3,0,1,0,76.14,60.00 ,33.33
03,004,01,004,0078,169,556 ,11 ,567 ,970 ,0,3,1,3,0,1,0,76.14,58.45 ,33.33
03,004,01,004,0078,170,629 ,5 ,634 ,1034 ,0,3,1,3,0,1,0,76.14,61.32 ,33.33
03,004,01,004,0079,171,485 ,3 ,488 ,775 ,0,3,1,3,0,1,0,76.14,62.97 ,33.33
03,004,01,004,0080,172,741 ,18 ,759 ,1212 ,0,3,1,3,0,1,0,76.14,62.62 ,33.33
03,004,01,004,0081,173,600 ,8 ,608 ,974 ,0,3,1,3,0,1,0,76.14,62.42 ,33.33
03,004,01,004,0082,174,410 ,5 ,415 ,602 ,0,3,1,3,0,1,0,76.14,68.94 ,33.33
03,004,01,004,0083,175,330 ,4 ,334 ,530 ,0,3,1,3,0,1,0,76.14,63.02 ,33.33
03,004,01,004,0084,176,380 ,4 ,384 ,638 ,0,3,1,3,0,1,0,76.14,60.19 ,33.33
03,004,01,004,0085,177,514 ,7 ,521 ,890 ,0,3,1,3,0,1,0,76.14,58.54 ,33.33
03,004,01,004,0086,178,495 ,3 ,498 ,735 ,0,3,1,3,0,1,0,76.14,67.76 ,33.33
03,004,01,004,0087,179,590 ,8 ,598 ,889 ,0,3,1,3,0,1,0,76.14,67.27 ,33.33
03,004,01,004,0087,180,581 ,11 ,592 ,941 ,0,3,1,3,0,1,0,76.14,62.91 ,33.33
03,004,01,004,0088,181,657 ,14 ,671 ,968 ,0,3,1,3,0,1,0,76.14,69.32 ,33.33
03,004,01,004,0089,182,576 ,5 ,581 ,843 ,0,3,1,3,0,1,0,76.14,68.92 ,33.33
03,004,01,004,0090,183,424 ,4 ,428 ,607 ,0,3,1,3,0,1,0,76.14,70.51 ,33.33
03,004,01,004,0091,184,546 ,8 ,554 ,796 ,0,3,1,3,0,1,0,76.14,69.60 ,33.33
03,004,01,005,0092,185,828 ,8 ,836 ,1233 ,0,3,1,3,0,1,0,76.14,67.80 ,33.33
03,004,01,005,0092,186,721 ,8 ,729 ,1171 ,0,3,1,3,0,1,0,76.14,62.25 ,33.33
03,004,01,005,0093,187,726 ,10 ,736 ,1298 ,0,3,1,3,0,1,0,76.14,56.70 ,33.33
03,004,01,005,0093,188,942 ,11 ,953 ,1754 ,0,3,1,3,0,1,0,76.14,54.33 ,33.33
03,004,01,005,0094,189,729 ,10 ,739 ,1122 ,0,3,1,3,0,1,0,76.14,65.86 ,33.33
03,004,01,005,0094,190,735 ,4 ,739 ,1244 ,0,3,1,3,0,1,0,76.14,59.41 ,33.33
03,004,01,005,0094,191,636 ,15 ,651 ,1195 ,0,3,1,3,0,1,0,76.14,54.48 ,33.33
03,004,01,005,0095,192,728 ,11 ,739 ,1110 ,0,3,1,3,0,1,0,76.14,66.58 ,33.33
03,004,01,005,0095,193,764 ,10 ,774 ,1317 ,0,3,1,3,0,1,0,76.14,58.77 ,33.33
03,004,01,005,0095,194,766 ,11 ,777 ,1434 ,0,3,1,3,0,1,0,76.14,54.18 ,33.33
03,004,01,005,0096,195,552 ,5 ,557 ,827 ,0,3,1,3,0,1,0,76.14,67.35 ,33.33
03,004,01,005,0097,196,775 ,10 ,785 ,1323 ,0,3,1,3,0,1,0,76.14,59.33 ,33.33
03,004,01,005,0098,197,636 ,11 ,647 ,1046 ,0,3,1,3,0,1,0,76.14,61.85 ,33.33
03,004,01,005,0098,198,840 ,5 ,845 ,1330 ,0,3,1,3,0,1,0,76.14,63.53 ,33.33
03,004,01,005,0099,199,741 ,7 ,748 ,1128 ,0,3,1,3,0,1,0,76.14,66.31 ,33.33
03,004,01,005,0099,200,656 ,2 ,658 ,1015 ,0,3,1,3,0,1,0,76.14,64.83 ,33.33
03,004,01,005,0100,201,657 ,7 ,664 ,1022 ,0,3,1,3,0,1,0,76.14,64.97 ,33.33
03,004,01,005,0100,202,638 ,5 ,643 ,1073 ,0,3,1,3,0,1,0,76.14,59.93 ,33.33
03,004,01,005,0100,203,811 ,12 ,823 ,1418 ,0,3,1,3,0,1,0,76.14,58.04 ,33.33
03,004,01,005,0101,204,659 ,6 ,665 ,1115 ,0,3,1,3,0,1,0,76.14,59.64 ,33.33
03,004,01,005,0101,205,656 ,8 ,664 ,1072 ,0,3,1,3,0,1,0,76.14,61.94 ,33.33
03,004,01,005,0102,206,899 ,12 ,911 ,1787 ,0,3,1,3,0,1,0,76.14,50.98 ,33.33
03,004,01,005,0103,207,719 ,10 ,729 ,1166 ,0,3,1,3,0,1,0,76.14,62.52 ,33.33
03,004,01,005,0103,208,824 ,10 ,834 ,1416 ,0,3,1,3,0,1,0,76.14,58.90 ,33.33
03,004,01,005,0104,209,648 ,7 ,655 ,1017 ,0,3,1,3,0,1,0,76.14,64.41 ,33.33
03,004,01,005,0105,210,772 ,9 ,781 ,1321 ,0,3,1,3,0,1,0,76.14,59.12 ,33.33
03,004,01,005,0105,211,605 ,3 ,608 ,1025 ,0,3,1,3,0,1,0,76.14,59.32 ,33.33
03,004,01,005,0106,212,694 ,6 ,700 ,1188 ,0,3,1,3,0,1,0,76.14,58.92 ,33.33
03,004,01,005,0106,213,610 ,6 ,616 ,983 ,0,3,1,3,0,1,0,76.14,62.67 ,33.33
03,004,01,005,0107,214,758 ,12 ,770 ,1342 ,0,3,1,3,0,1,0,76.14,57.38 ,33.33
03,004,01,005,0108,215,703 ,11 ,714 ,1154 ,0,3,1,3,0,1,0,76.14,61.87 ,33.33
03,004,01,005,0108,216,682 ,12 ,694 ,1073 ,0,3,1,3,0,1,0,76.14,64.68 ,33.33
03,004,01,005,0108,217,694 ,14 ,708 ,1516 ,0,3,1,3,0,1,0,76.14,46.70 ,33.33
03,004,01,005,0109,218,567 ,8 ,575 ,1032 ,0,3,1,3,0,1,0,76.14,55.72 ,33.33
03,004,01,005,0109,219,720 ,8 ,728 ,1339 ,0,3,1,3,0,1,0,76.14,54.37 ,33.33
03,004,01,005,0109,220,566 ,8 ,574 ,1070 ,0,3,1,3,0,1,0,76.14,53.64 ,33.33
03,004,01,005,0110,221,716 ,14 ,730 ,1422 ,0,3,1,3,0,1,0,76.14,51.34 ,33.33
03,004,01,005,0110,222,696 ,4 ,700 ,1044 ,0,3,1,3,0,1,0,76.14,67.05 ,33.33
03,004,01,005,0111,223,774 ,12 ,786 ,1482 ,0,3,1,3,0,1,0,76.14,53.04 ,33.33
03,004,01,005,0111,224,682 ,18 ,700 ,1157 ,0,3,1,3,0,1,0,76.14,60.50 ,33.33
03,004,01,006,0112,225,611 ,6 ,617 ,885 ,0,3,1,3,0,1,0,76.14,69.72 ,33.33
03,004,01,006,0113,226,513 ,8 ,521 ,806 ,0,3,1,3,0,1,0,76.14,64.64 ,33.33
03,004,01,006,0113,227,521 ,8 ,529 ,881 ,0,3,1,3,0,1,0,76.14,60.05 ,33.33
03,004,01,006,0114,228,884 ,6 ,890 ,1375 ,0,3,1,3,0,1,0,76.14,64.73 ,33.33
03,004,01,006,0115,229,750 ,8 ,758 ,1265 ,0,3,1,3,0,1,0,76.14,59.92 ,33.33
03,004,01,006,0115,230,553 ,6 ,559 ,994 ,0,3,1,3,0,1,0,76.14,56.24 ,33.33
03,004,01,006,0116,231,487 ,7 ,494 ,786 ,0,3,1,3,0,1,0,76.14,62.85 ,33.33
03,004,01,006,0117,232,643 ,10 ,653 ,1049 ,0,3,1,3,0,1,0,76.14,62.25 ,33.33
03,004,01,006,0117,233,636 ,12 ,648 ,1017 ,0,3,1,3,0,1,0,76.14,63.72 ,33.33
03,004,01,006,0118,234,819 ,12 ,831 ,1370 ,0,3,1,3,0,1,0,76.14,60.66 ,33.33
03,004,01,006,0119,235,815 ,7 ,822 ,1288 ,0,3,1,3,0,1,0,76.14,63.82 ,33.33
03,004,01,006,0119,236,578 ,8 ,586 ,1093 ,0,3,1,3,0,1,0,76.14,53.61 ,33.33
03,004,01,006,0120,237,560 ,6 ,566 ,983 ,0,3,1,3,0,1,0,76.14,57.58 ,33.33
03,004,01,006,0120,238,532 ,2 ,534 ,1036 ,0,3,1,3,0,1,0,76.14,51.54 ,33.33
03,004,01,006,0120,239,483 ,2 ,485 ,822 ,0,3,1,3,0,1,0,76.14,59.00 ,33.33
03,004,01,006,0120,240,643 ,4 ,647 ,1126 ,0,3,1,3,0,1,0,76.14,57.46 ,33.33
03,004,01,006,0120,241,409 ,3 ,412 ,774 ,0,3,1,3,0,1,0,76.14,53.23 ,33.33
03,004,01,006,0120,242,620 ,7 ,627 ,1119 ,0,3,1,3,0,1,0,76.14,56.03 ,33.33
03,004,01,006,0121,243,800 ,9 ,809 ,1492 ,0,3,1,3,0,1,0,76.14,54.22 ,33.33
03,004,01,006,0122,244,612 ,9 ,621 ,972 ,0,3,1,3,0,1,0,76.14,63.89 ,33.33
03,004,01,006,0123,245,647 ,9 ,656 ,1100 ,0,3,1,3,0,1,0,76.14,59.64 ,33.33
03,004,01,006,0123,246,564 ,3 ,567 ,916 ,0,3,1,3,0,1,0,76.14,61.90 ,33.33
03,004,01,006,0123,247,610 ,4 ,614 ,1111 ,0,3,1,3,0,1,0,76.14,55.27 ,33.33
03,004,01,006,0123,248,530 ,6 ,536 ,1053 ,0,3,1,3,0,1,0,76.14,50.90 ,33.33
03,004,01,006,0123,249,546 ,4 ,550 ,970 ,0,3,1,3,0,1,0,76.14,56.70 ,33.33
03,004,01,006,0123,250,581 ,3 ,584 ,1072 ,0,3,1,3,0,1,0,76.14,54.48 ,33.33
03,004,01,006,0123,251,619 ,2 ,621 ,1102 ,0,3,1,3,0,1,0,76.14,56.35 ,33.33
03,004,01,006,0124,252,529 ,2 ,531 ,1019 ,0,3,1,3,0,1,0,76.14,52.11 ,33.33
03,004,01,006,0124,253,515 ,7 ,522 ,990 ,0,3,1,3,0,1,0,76.14,52.73 ,33.33
03,004,01,006,0124,254,550 ,3 ,553 ,1014 ,0,3,1,3,0,1,0,76.14,54.54 ,33.33
03,004,01,006,0124,255,470 ,8 ,478 ,846 ,0,3,1,3,0,1,0,76.14,56.50 ,33.33
03,004,01,006,0124,256,439 ,2 ,441 ,763 ,0,3,1,3,0,1,0,76.14,57.80 ,33.33
03,004,01,007,0125,257,279 ,3 ,282 ,429 ,0,3,1,3,0,1,0,76.14,65.73 ,33.33
03,004,01,007,0126,258,323 ,4 ,327 ,486 ,0,3,1,3,0,1,0,76.14,67.28 ,33.33
03,004,01,007,0127,259,548 ,7 ,555 ,858 ,0,3,1,3,0,1,0,76.14,64.69 ,33.33
03,004,01,007,0128,260,249 ,1 ,250 ,390 ,0,3,1,3,0,1,0,76.14,64.10 ,33.33
03,004,01,007,0129,261,587 ,5 ,592 ,923 ,0,3,1,3,0,1,0,76.14,64.14 ,33.33
03,004,01,007,0129,262,871 ,12 ,883 ,1406 ,0,3,1,3,0,1,0,76.14,62.80 ,33.33
03,004,01,007,0130,263,929 ,9 ,938 ,1428 ,0,3,1,3,0,1,0,76.14,65.69 ,33.33
03,004,01,007,0131,264,357 ,0 ,357 ,535 ,0,3,1,3,0,1,0,76.14,66.73 ,33.33
03,004,01,007,0132,265,380 ,4 ,384 ,647 ,0,3,1,3,0,1,0,76.14,59.35 ,33.33
03,004,01,007,0133,266,632 ,9 ,641 ,1061 ,0,3,1,3,0,1,0,76.14,60.41 ,33.33
03,004,01,007,0133,267,676 ,7 ,683 ,1060 ,0,3,1,3,0,1,0,76.14,64.43 ,33.33
03,004,01,007,0134,268,938 ,12 ,950 ,1468 ,0,3,1,3,0,1,0,76.14,64.71 ,33.33
03,004,01,007,0135,269,825 ,7 ,832 ,1383 ,0,3,1,3,0,1,0,76.14,60.16 ,33.33
03,004,01,007,0135,270,436 ,4 ,440 ,772 ,0,3,1,3,0,1,0,76.14,56.99 ,33.33
03,004,01,007,0135,271,522 ,10 ,532 ,911 ,0,3,1,3,0,1,0,76.14,58.40 ,33.33
03,004,01,007,0136,272,696 ,9 ,705 ,1066 ,0,3,1,3,0,1,0,76.14,66.14 ,33.33
03,004,01,008,0137,273,730 ,5 ,735 ,1166 ,0,3,1,3,0,1,0,76.14,63.04 ,33.33
03,004,01,008,0137,274,574 ,4 ,578 ,966 ,0,3,1,3,0,1,0,76.14,59.83 ,33.33
03,004,01,008,0137,275,653 ,5 ,658 ,1079 ,0,3,1,3,0,1,0,76.14,60.98 ,33.33
03,004,01,008,0138,276,560 ,4 ,564 ,843 ,0,3,1,3,0,1,0,76.14,66.90 ,33.33
03,004,01,008,0139,277,108 ,2 ,110 ,157 ,0,3,1,3,0,1,0,76.14,70.06 ,33.33
03,004,01,008,0140,278,110 ,1 ,111 ,165 ,0,3,1,3,0,1,0,76.14,67.27 ,33.33
03,004,01,008,0141,279,217 ,3 ,220 ,333 ,0,3,1,3,0,1,0,76.14,66.07 ,33.33
03,004,01,008,0142,280,639 ,11 ,650 ,1048 ,0,3,1,3,0,1,0,76.14,62.02 ,33.33
03,004,01,008,0143,281,374 ,5 ,379 ,586 ,0,3,1,3,0,1,0,76.14,64.68 ,33.33
03,004,01,008,0143,282,178 ,2 ,180 ,260 ,0,3,1,3,0,1,0,76.14,69.23 ,33.33
03,004,01,008,0144,283,301 ,6 ,307 ,467 ,0,3,1,3,0,1,0,76.14,65.74 ,33.33
03,004,01,008,0145,284,485 ,6 ,491 ,742 ,0,3,1,3,0,1,0,76.14,66.17 ,33.33
03,004,01,008,0145,285,251 ,0 ,251 ,335 ,0,3,1,3,0,1,0,76.14,74.93 ,33.33
03,004,01,008,0146,286,465 ,5 ,470 ,729 ,0,3,1,3,0,1,0,76.14,64.47 ,33.33
03,004,01,008,0146,287,548 ,2 ,550 ,803 ,0,3,1,3,0,1,0,76.14,68.49 ,33.33
03,004,01,008,0147,288,877 ,12 ,889 ,1338 ,0,3,1,3,0,1,0,76.14,66.44 ,33.33
03,004,01,009,0148,289,734 ,8 ,742 ,1143 ,0,3,1,3,0,1,0,76.14,64.92 ,33.33
03,004,01,009,0149,290,799 ,16 ,815 ,1249 ,0,3,1,3,0,1,0,76.14,65.25 ,33.33
03,004,01,009,0150,291,313 ,3 ,316 ,508 ,0,3,1,3,0,1,0,76.14,62.20 ,33.33
03,004,01,009,0151,292,600 ,6 ,606 ,898 ,0,3,1,3,0,1,0,76.14,67.48 ,33.33
03,004,01,009,0151,293,890 ,17 ,907 ,1462 ,0,3,1,3,0,1,0,76.14,62.04 ,33.33
03,004,01,009,0152,294,452 ,2 ,454 ,780 ,0,3,1,3,0,1,0,76.14,58.21 ,33.33
03,004,01,009,0153,295,250 ,2 ,252 ,387 ,0,3,1,3,0,1,0,76.14,65.12 ,33.33
03,004,01,009,0154,296,453 ,6 ,459 ,664 ,0,3,1,3,0,1,0,76.14,69.13 ,33.33
03,004,01,009,0155,297,205 ,4 ,209 ,362 ,0,3,1,3,0,1,0,76.14,57.73 ,33.33
03,004,01,009,0156,298,187 ,3 ,190 ,301 ,0,3,1,3,0,1,0,76.14,63.12 ,33.33
03,004,01,010,0157,299,714 ,3 ,717 ,1231 ,0,3,1,3,0,1,0,76.14,58.25 ,33.33
03,004,01,010,0157,300,635 ,9 ,644 ,1232 ,0,3,1,3,0,1,0,76.14,52.27 ,33.33
03,004,01,010,0157,301,672 ,4 ,676 ,1240 ,0,3,1,3,0,1,0,76.14,54.52 ,33.33
03,004,01,010,0158,302,597 ,4 ,601 ,1013 ,0,3,1,3,0,1,0,76.14,59.33 ,33.33
03,004,01,010,0159,303,504 ,4 ,508 ,756 ,0,3,1,3,0,1,0,76.14,67.20 ,33.33
03,004,01,010,0160,304,696 ,4 ,700 ,1069 ,0,3,1,3,0,1,0,76.14,65.48 ,33.33
03,004,01,010,0161,305,425 ,6 ,431 ,638 ,0,3,1,3,0,1,0,76.14,67.55 ,33.33
03,004,01,010,0162,306,499 ,7 ,506 ,707 ,0,3,1,3,0,1,0,76.14,71.57 ,33.33
03,004,01,010,0163,307,415 ,6 ,421 ,632 ,0,3,1,3,0,1,0,76.14,66.61 ,33.33
03,004,01,010,0164,308,361 ,1 ,362 ,557 ,0,3,1,3,0,1,0,76.14,64.99 ,33.33
03,004,01,010,0165,309,268 ,2 ,270 ,448 ,0,3,1,3,0,1,0,76.14,60.27 ,33.33
03,004,01,011,0166,310,606 ,9 ,615 ,865 ,0,3,1,3,0,1,0,76.14,71.10 ,33.33
03,004,01,011,0167,311,494 ,1 ,495 ,708 ,0,3,1,3,0,1,0,76.14,69.92 ,33.33
03,004,01,011,0168,312,437 ,3 ,440 ,615 ,0,3,1,3,0,1,0,76.14,71.54 ,33.33
03,004,01,011,0169,313,246 ,6 ,252 ,339 ,0,3,1,3,0,1,0,76.14,74.34 ,33.33
03,004,01,011,0169,314,184 ,0 ,184 ,270 ,0,3,1,3,0,1,0,76.14,68.15 ,33.33
03,004,01,011,0170,315,765 ,10 ,775 ,1209 ,0,3,1,3,0,1,0,76.14,64.10 ,33.33
03,004,01,011,0171,316,309 ,4 ,313 ,499 ,0,3,1,3,0,1,0,76.14,62.73 ,33.33
03,004,01,011,0171,317,270 ,12 ,282 ,401 ,0,3,1,3,0,1,0,76.14,70.32 ,33.33
03,004,01,012,0172,318,234 ,8 ,242 ,406 ,0,3,1,3,0,1,0,76.14,59.61 ,33.33
03,004,01,012,0172,319,10 ,1 ,11 ,39 ,0,3,1,3,0,1,0,76.14,28.21 ,33.33
03,004,01,012,0173,320,67 ,0 ,67 ,122 ,0,3,1,3,0,1,0,76.14,54.92 ,33.33
03,004,01,012,0174,321,76 ,1 ,77 ,165 ,0,3,1,3,0,1,0,76.14,46.67 ,33.33
03,004,01,012,0175,322,32 ,0 ,32 ,58 ,0,3,1,3,0,1,0,76.14,55.17 ,33.33
03,004,01,012,0175,323,30 ,0 ,30 ,70 ,0,3,1,3,0,1,0,76.14,42.86 ,33.33
03,004,01,012,0176,324,27 ,0 ,27 ,40 ,0,3,1,3,0,1,0,76.14,67.50 ,33.33
03,004,01,012,0177,325,7 ,0 ,7 ,21 ,0,3,1,3,0,1,0,76.14,33.33 ,33.33
03,004,01,012,0177,326,1 ,0 ,1 ,4 ,0,3,1,3,0,1,0,76.14,25.00 ,33.33
03,004,01,012,0178,327,7 ,0 ,7 ,10 ,0,3,1,3,0,1,0,76.14,70.00 ,33.33
03,004,01,012,0178,328,14 ,0 ,14 ,37 ,0,3,1,3,0,1,0,76.14,37.84 ,33.33
03,004,01,012,0178,329,3 ,0 ,3 ,8 ,0,3,1,3,0,1,0,76.14,37.50 ,33.33
03,004,01,012,0179,330,2 ,0 ,2 ,2 ,0,3,1,3,0,1,0,76.14,100.00 ,33.33
03,004,01,013,0180,331,70 ,1 ,71 ,111 ,0,3,1,3,0,1,0,76.14,63.96 ,33.33
03,004,01,013,0180,332,10 ,0 ,10 ,32 ,0,3,1,3,0,1,0,76.14,31.25 ,33.33
03,004,01,013,0181,333,31 ,0 ,31 ,59 ,0,3,1,3,0,1,0,76.14,52.54 ,33.33
03,004,01,013,0182,334,10 ,0 ,10 ,21 ,0,3,1,3,0,1,0,76.14,47.62 ,33.33
03,004,01,013,0183,335,20 ,0 ,20 ,45 ,0,3,1,3,0,1,0,76.14,44.44 ,33.33
03,004,01,013,0183,336,42 ,0 ,42 ,120 ,0,3,1,3,0,1,0,76.14,35.00 ,33.33
03,005,01,001,0001,1,596 ,4 ,600 ,1015 ,0,3,1,3,0,1,0,76.14,59.11 ,33.33
03,005,01,001,0002,2,602 ,5 ,607 ,1051 ,0,3,1,3,0,1,0,76.14,57.75 ,33.33
03,005,01,001,0003,3,560 ,5 ,565 ,1013 ,0,3,1,3,0,1,0,76.14,55.77 ,33.33
03,005,01,001,0003,4,643 ,6 ,649 ,1055 ,0,3,1,3,0,1,0,76.14,61.52 ,33.33
03,005,01,001,0003,5,627 ,7 ,634 ,1033 ,0,3,1,3,0,1,0,76.14,61.37 ,33.33
03,005,01,001,0004,6,721 ,9 ,730 ,1248 ,0,3,1,3,0,1,0,76.14,58.49 ,33.33
03,005,01,001,0004,7,825 ,9 ,834 ,1344 ,0,3,1,3,0,1,0,76.14,62.05 ,33.33
03,005,01,001,0004,8,677 ,4 ,681 ,1198 ,0,3,1,3,0,1,0,76.14,56.84 ,33.33
03,005,01,001,0005,9,675 ,0 ,675 ,1145 ,0,3,1,3,0,1,0,76.14,58.95 ,33.33
03,005,01,001,0005,10,670 ,12 ,682 ,1158 ,0,3,1,3,0,1,0,76.14,58.89 ,33.33
03,005,01,001,0006,11,593 ,10 ,603 ,1051 ,0,3,1,3,0,1,0,76.14,57.37 ,33.33
03,005,01,001,0006,12,714 ,0 ,714 ,1248 ,0,3,1,3,0,1,0,76.14,57.21 ,33.33
03,005,01,001,0006,13,666 ,7 ,673 ,1040 ,0,3,1,3,0,1,0,76.14,64.71 ,33.33
03,005,01,001,0007,14,524 ,6 ,530 ,894 ,0,3,1,3,0,1,0,76.14,59.28 ,33.33
03,005,01,001,0008,15,731 ,5 ,736 ,1314 ,0,3,1,3,0,1,0,76.14,56.01 ,33.33
03,005,01,001,0008,16,728 ,8 ,736 ,1413 ,0,3,1,3,0,1,0,76.14,52.09 ,33.33
03,005,01,001,0009,17,594 ,10 ,604 ,960 ,0,3,1,3,0,1,0,76.14,62.92 ,33.33
03,005,01,001,0010,18,599 ,4 ,603 ,983 ,0,3,1,3,0,1,0,76.14,61.34 ,33.33
03,005,01,001,0011,19,383 ,7 ,390 ,647 ,0,3,1,3,0,1,0,76.14,60.28 ,33.33
03,005,01,001,0012,20,874 ,11 ,885 ,1475 ,0,3,1,3,0,1,0,76.14,60,33.33
03,005,01,001,0013,21,777 ,9 ,786 ,1390 ,0,3,1,3,0,1,0,76.14,56.55,33.33
03,005,01,001,0013,22,593 ,6 ,599 ,932 ,0,3,1,3,0,1,0,76.14,64.27 ,33.33
03,005,01,001,0014,23,760 ,5 ,765 ,1281 ,0,3,1,3,0,1,0,76.14,59.72 ,33.33
03,005,01,001,0014,24,835 ,4 ,839 ,1457 ,0,3,1,3,0,1,0,76.14,57.58 ,33.33
03,005,01,001,0014,25,491 ,0 ,491 ,828 ,0,3,1,3,0,1,0,76.14,59.30 ,33.33
03,005,01,001,0015,26,528 ,4 ,532 ,893 ,0,3,1,3,0,1,0,76.14,59.57 ,33.33
03,005,01,001,0015,27,712 ,5 ,717 ,1192 ,0,3,1,3,0,1,0,76.14,60.15 ,33.33
03,005,01,001,0015,28,573 ,6 ,579 ,925 ,0,3,1,3,0,1,0,76.14,62.59 ,33.33
03,005,01,001,0016,29,504 ,2 ,506 ,789 ,0,3,1,3,0,1,0,76.14,64.13 ,33.33
03,005,01,001,0016,30,582 ,3 ,585 ,975 ,0,3,1,3,0,1,0,76.14,60.00 ,33.33
03,005,01,001,0017,31,778 ,8 ,786 ,1254 ,0,3,1,3,0,1,0,76.14,62.68 ,33.33
03,005,01,001,0017,32,589 ,4 ,593 ,1015 ,0,3,1,3,0,1,0,76.14,58.42 ,33.33
03,005,01,001,0017,33,573 ,2 ,575 ,1008 ,0,3,1,3,0,1,0,76.14,57.04,33.33
03,005,01,001,0017,34,647 ,7 ,654 ,1079 ,0,3,1,3,0,1,0,76.14,60.61,33.33
03,005,01,001,0018,35,952 ,10 ,962 ,1612 ,0,3,1,3,0,1,0,76.14,59.68 ,33.33
03,005,01,001,0018,36,858 ,8 ,866 ,1519 ,0,3,1,3,0,1,0,76.14,57.01 ,33.33
03,005,01,001,0019,37,850 ,7 ,857 ,1355 ,0,3,1,3,0,1,0,76.14,63.25 ,33.33
03,005,01,001,0019,38,780 ,6 ,786 ,1213 ,0,3,1,3,0,1,0,76.14,64.80 ,33.33
03,005,01,001,0020,39,882 ,8 ,890 ,1588 ,0,3,1,3,0,1,0,76.14,56.05 ,33.33
03,005,01,001,0020,40,968 ,4 ,972 ,1722 ,0,3,1,3,0,1,0,76.14,56.45,33.33
03,005,01,001,0021,41,725 ,7 ,732 ,1222 ,0,3,1,3,0,1,0,76.14,59.9,33.33
03,005,01,001,0021,42,776 ,10 ,786 ,1419 ,0,3,1,3,0,1,0,76.14,55.39,33.33
03,005,01,001,0022,43,503 ,6 ,509 ,824 ,0,3,1,3,0,1,0,76.14,61.77 ,33.33
03,005,01,001,0022,44,753 ,8 ,761 ,1248 ,0,3,1,3,0,1,0,76.14,60.98 ,33.33
03,005,01,001,0022,45,816 ,2 ,818 ,1471 ,0,3,1,3,0,1,0,76.14,55.61 ,33.33
03,005,01,001,0023,46,793 ,5 ,798 ,1369 ,0,3,1,3,0,1,0,76.14,58.29 ,33.33
03,005,01,001,0023,47,849 ,7 ,856 ,1529 ,0,3,1,3,0,1,0,76.14,55.98 ,33.33
03,005,01,001,0023,48,737 ,7 ,744 ,1374 ,0,3,1,3,0,1,0,76.14,54.15 ,33.33
03,005,01,001,0024,49,742 ,8 ,750 ,1267 ,0,3,1,3,0,1,0,76.14,59.19 ,33.33
03,005,01,001,0024,50,602 ,7 ,609 ,1101 ,0,3,1,3,0,1,0,76.14,55.31 ,33.33
03,005,01,001,0024,51,691 ,6 ,697 ,1275 ,0,3,1,3,0,1,0,76.14,54.67 ,33.33
03,005,01,001,0024,52,733 ,7 ,740 ,1326 ,0,3,1,3,0,1,0,76.14,55.81,33.33
03,005,01,001,0025,53,615 ,6 ,621 ,1087 ,0,3,1,3,0,1,0,76.14,57.13,33.33
03,005,01,001,0026,54,825 ,4 ,829 ,1504 ,0,3,1,3,0,1,0,76.14,55.12 ,33.33
03,005,01,001,0027,55,487 ,9 ,496 ,821 ,0,3,1,3,0,1,0,76.14,60.41 ,33.33
03,005,01,001,0027,56,566 ,4 ,570 ,970 ,0,3,1,3,0,1,0,76.14,58.76 ,33.33
03,005,01,002,0028,57,411 ,2 ,413 ,671 ,0,3,1,3,0,1,0,76.14,61.55 ,33.33
03,005,01,002,0028,58,645 ,6 ,651 ,1096 ,0,3,1,3,0,1,0,76.14,59.40 ,33.33
03,005,01,002,0029,59,621 ,1 ,622 ,968 ,0,3,1,3,0,1,0,76.14,64.26 ,33.33
03,005,01,002,0029,60,375 ,1 ,376 ,695 ,0,3,1,3,0,1,0,76.14,54.10 ,33.33
03,005,01,002,0030,61,512 ,7 ,519 ,896 ,0,3,1,3,0,1,0,76.14,57.92 ,33.33
03,005,01,002,0031,62,833 ,9 ,842 ,1328 ,0,3,1,3,0,1,0,76.14,63.40 ,33.33
03,005,01,002,0032,63,709 ,9 ,718 ,1124 ,0,3,1,3,0,1,0,76.14,63.88 ,33.33
03,005,01,002,0033,64,527 ,6 ,533 ,923 ,0,3,1,3,0,1,0,76.14,57.75 ,33.33
03,005,01,002,0033,65,467 ,3 ,470 ,767 ,0,3,1,3,0,1,0,76.14,61.28 ,33.33
03,005,01,002,0034,66,587 ,4 ,591 ,1029 ,0,3,1,3,0,1,0,76.14,57.43 ,33.33
03,005,01,002,0035,67,651 ,3 ,654 ,1066 ,0,3,1,3,0,1,0,76.14,61.35 ,33.33
03,005,01,002,0035,68,617 ,4 ,621 ,1098 ,0,3,1,3,0,1,0,76.14,56.56 ,33.33
03,005,01,002,0036,69,664 ,8 ,672 ,1099 ,0,3,1,3,0,1,0,76.14,61.15,33.33
03,005,01,002,0036,70,694 ,10 ,704 ,1147 ,0,3,1,3,0,1,0,76.14,61.38,33.33
03,005,01,002,0036,71,681 ,2 ,683 ,1134 ,0,3,1,3,0,1,0,76.14,60.23 ,33.33
03,005,01,002,0037,72,588 ,3 ,591 ,905 ,0,3,1,3,0,1,0,76.14,65.30 ,33.33
03,005,01,002,0037,73,564 ,6 ,570 ,903 ,0,3,1,3,0,1,0,76.14,63.12,33.33
03,005,01,002,0038,74,602 ,7 ,609 ,1002 ,0,3,1,3,0,1,0,76.14,60.78,33.33
03,005,01,002,0039,75,390 ,2 ,392 ,602 ,0,3,1,3,0,1,0,76.14,65.12 ,33.33
03,005,01,002,0040,76,683 ,3 ,686 ,1117 ,0,3,1,3,0,1,0,76.14,61.41 ,33.33
03,005,01,002,0041,77,488 ,2 ,490 ,796 ,0,3,1,3,0,1,0,76.14,61.56 ,33.33
03,005,01,002,0041,78,433 ,3 ,436 ,689 ,0,3,1,3,0,1,0,76.14,63.28 ,33.33
03,005,01,002,0042,79,571 ,7 ,578 ,975 ,0,3,1,3,0,1,0,76.14,59.28 ,33.33
03,005,01,002,0042,80,454 ,2 ,456 ,737 ,0,3,1,3,0,1,0,76.14,61.87 ,33.33
03,005,01,002,0043,81,731 ,7 ,738 ,1236 ,0,3,1,3,0,1,0,76.14,59.71 ,33.33
03,005,01,002,0044,82,430 ,4 ,434 ,607 ,0,3,1,3,0,1,0,76.14,71.50 ,33.33
03,005,01,002,0045,83,575 ,3 ,578 ,882 ,0,3,1,3,0,1,0,76.14,65.53 ,33.33
03,005,01,002,0046,84,428 ,9 ,437 ,713 ,0,3,1,3,0,1,0,76.14,61.29 ,33.33
03,005,01,002,0047,85,471 ,3 ,474 ,789 ,0,3,1,3,0,1,0,76.14,60.08 ,33.33
03,005,01,002,0047,86,390 ,4 ,394 ,680 ,0,3,1,3,0,1,0,76.14,57.94 ,33.33
03,005,01,002,0048,87,475 ,10 ,485 ,804 ,0,3,1,3,0,1,0,76.14,60.32 ,33.33
03,005,01,002,0048,88,427 ,10 ,437 ,738 ,0,3,1,3,0,1,0,76.14,59.21 ,33.33
03,005,01,002,0049,89,459 ,6 ,465 ,780 ,0,3,1,3,0,1,0,76.14,59.62 ,33.33
03,005,01,002,0049,90,453 ,7 ,460 ,853 ,0,3,1,3,0,1,0,76.14,53.93 ,33.33
03,005,01,002,0050,91,624 ,7 ,631 ,1019 ,0,3,1,3,0,1,0,76.14,61.92 ,33.33
03,005,01,002,0050,92,592 ,7 ,599 ,1014 ,0,3,1,3,0,1,0,76.14,59.07 ,33.33
03,005,01,002,0051,93,772 ,4 ,776 ,1216 ,0,3,1,3,0,1,0,76.14,63.82 ,33.33
03,005,01,002,0052,94,804 ,6 ,810 ,1372 ,0,3,1,3,0,1,0,76.14,59.04 ,33.33
03,005,01,003,0053,95,768 ,2 ,770 ,1251 ,0,3,1,3,0,1,0,76.14,61.55 ,33.33
03,005,01,003,0054,96,621 ,8 ,629 ,943 ,0,3,1,3,0,1,0,76.14,66.7,33.33
03,005,01,003,0054,97,744 ,10 ,754 ,1194 ,0,3,1,3,0,1,0,76.14,63.15,33.33
03,005,01,003,0055,98,778 ,4 ,782 ,1179 ,0,3,1,3,0,1,0,76.14,66.33 ,33.33
03,005,01,003,0055,99,809 ,5 ,814 ,1401 ,0,3,1,3,0,1,0,76.14,58.10 ,33.33
03,005,01,003,0055,100,641 ,2 ,643 ,1206 ,0,3,1,3,0,1,0,76.14,53.32 ,33.33
03,005,01,003,0056,101,521 ,1 ,522 ,752 ,0,3,1,3,0,1,0,76.14,69.41 ,33.33
03,005,01,003,0057,102,535 ,2 ,537 ,839 ,0,3,1,3,0,1,0,76.14,64.00 ,33.33
03,005,01,003,0057,103,398 ,4 ,402 ,666 ,0,3,1,3,0,1,0,76.14,60.36 ,33.33
03,005,01,003,0058,104,715 ,5 ,720 ,1213 ,0,3,1,3,0,1,0,76.14,59.36 ,33.33
03,005,01,003,0058,105,764 ,15 ,779 ,1360 ,0,3,1,3,0,1,0,76.14,57.28 ,33.33
03,005,01,003,0059,106,487 ,2 ,489 ,747 ,0,3,1,3,0,1,0,76.14,65.46,33.33
03,005,01,003,0059,107,637 ,4 ,641 ,1018 ,0,3,1,3,0,1,0,76.14,62.97,33.33
03,005,01,003,0060,108,353 ,1 ,354 ,535 ,0,3,1,3,0,1,0,76.14,66.17,33.33
03,005,01,003,0061,109,624 ,5 ,629 ,943 ,0,3,1,3,0,1,0,76.14,66.70 ,33.33
03,005,01,003,0062,110,297 ,2 ,299 ,468 ,0,3,1,3,0,1,0,76.14,63.89 ,33.33
03,005,01,003,0063,111,515 ,7 ,522 ,789 ,0,3,1,3,0,1,0,76.14,66.16 ,33.33
03,005,01,003,0064,112,419 ,3 ,422 ,689 ,0,3,1,3,0,1,0,76.14,61.25 ,33.33
03,005,01,003,0065,113,625 ,2 ,627 ,988 ,0,3,1,3,0,1,0,76.14,63.46 ,33.33
03,005,01,003,0066,114,535 ,5 ,540 ,825 ,0,3,1,3,0,1,0,76.14,65.45 ,33.33
03,005,01,003,0067,115,411 ,3 ,414 ,643 ,0,3,1,3,0,1,0,76.14,64.39,33.33
03,005,01,003,0068,116,766 ,9 ,775 ,1170 ,0,3,1,3,0,1,0,76.14,66.24,33.33
03,005,01,003,0069,117,797 ,7 ,804 ,1330 ,0,3,1,3,0,1,0,76.14,60.45,33.33
03,005,01,003,0070,118,420 ,5 ,425 ,693 ,0,3,1,3,0,1,0,76.14,61.33 ,33.33
03,005,01,003,0070,119,523 ,2 ,525 ,777 ,0,3,1,3,0,1,0,76.14,67.57 ,33.33
03,005,01,003,0071,120,709 ,5 ,714 ,1146 ,0,3,1,3,0,1,0,76.14,62.30 ,33.33
03,005,01,003,0071,121,662 ,10 ,672 ,1067 ,0,3,1,3,0,1,0,76.14,62.98 ,33.33
03,005,01,003,0072,122,747 ,8 ,755 ,1249 ,0,3,1,3,0,1,0,76.14,60.45 ,33.33
03,005,01,003,0073,123,439 ,7 ,446 ,747 ,0,3,1,3,0,1,0,76.14,59.71 ,33.33
03,005,01,003,0074,124,379 ,6 ,385 ,669 ,0,3,1,3,0,1,0,76.14,57.55 ,33.33
03,005,01,003,0074,125,416 ,2 ,418 ,709 ,0,3,1,3,0,1,0,76.14,58.96 ,33.33
03,005,01,003,0075,126,456 ,5 ,461 ,796 ,0,3,1,3,0,1,0,76.14,57.91 ,33.33
03,005,01,004,0076,127,645 ,3 ,648 ,1046 ,0,3,1,3,0,1,0,76.14,61.95 ,33.33
03,005,01,004,0076,128,531 ,3 ,534 ,863 ,0,3,1,3,0,1,0,76.14,61.88 ,33.33
03,005,01,004,0077,129,798 ,9 ,807 ,1319 ,0,3,1,3,0,1,0,76.14,61.18 ,33.33
03,005,01,004,0077,130,680 ,3 ,683 ,1064 ,0,3,1,3,0,1,0,76.14,64.19 ,33.33
03,005,01,004,0078,131,748 ,5 ,753 ,1227 ,0,3,1,3,0,1,0,76.14,61.37 ,33.33
03,005,01,004,0078,132,617 ,7 ,624 ,1086 ,0,3,1,3,0,1,0,76.14,57.46,33.33
03,005,01,004,0079,133,486 ,6 ,492 ,837 ,0,3,1,3,0,1,0,76.14,58.78,33.33
03,005,01,004,0079,134,507 ,1 ,508 ,863 ,0,3,1,3,0,1,0,76.14,58.86 ,33.33
03,005,01,004,0079,135,696 ,0 ,696 ,1169 ,0,3,1,3,0,1,0,76.14,59.54 ,33.33
03,005,01,004,0080,136,731 ,9 ,740 ,1201 ,0,3,1,3,0,1,0,76.14,61.62,33.33
03,005,01,004,0080,137,617 ,9 ,626 ,1082 ,0,3,1,3,0,1,0,76.14,57.86,33.33
03,005,01,004,0080,138,534 ,4 ,538 ,857 ,0,3,1,3,0,1,0,76.14,62.78 ,33.33
03,005,01,004,0081,139,735 ,11 ,746 ,1318 ,0,3,1,3,0,1,0,76.14,56.60 ,33.33
03,005,01,004,0081,140,840 ,8 ,848 ,1393 ,0,3,1,3,0,1,0,76.14,60.88 ,33.33
03,005,01,004,0082,141,598 ,5 ,603 ,1021 ,0,3,1,3,0,1,0,76.14,59.06 ,33.33
03,005,01,004,0082,142,710 ,5 ,715 ,1278 ,0,3,1,3,0,1,0,76.14,55.95 ,33.33
03,005,01,004,0083,143,483 ,2 ,485 ,903 ,0,3,1,3,0,1,0,76.14,53.71 ,33.33
03,005,01,004,0083,144,556 ,8 ,564 ,979 ,0,3,1,3,0,1,0,76.14,57.61,33.33
03,005,01,004,0083,145,544 ,6 ,550 ,956 ,0,3,1,3,0,1,0,76.14,57.53,33.33
03,005,01,004,0084,146,582 ,1 ,583 ,918 ,0,3,1,3,0,1,0,76.14,63.51,33.33
03,005,01,004,0084,147,524 ,8 ,532 ,854 ,0,3,1,3,0,1,0,76.14,62.30 ,33.33
03,005,01,004,0084,148,899 ,1 ,900 ,1442 ,0,3,1,3,0,1,0,76.14,62.41 ,33.33
03,005,01,004,0084,149,794 ,5 ,799 ,1304 ,0,3,1,3,0,1,0,76.14,61.27 ,33.33
03,005,01,004,0085,150,832 ,11 ,843 ,1448 ,0,3,1,3,0,1,0,76.14,58.22 ,33.33
03,005,01,004,0085,151,737 ,3 ,740 ,1595 ,0,3,1,3,0,1,0,76.14,46.39 ,33.33
03,005,01,004,0086,152,648 ,6 ,654 ,1118 ,0,3,1,3,0,1,0,76.14,58.50 ,33.33
03,005,01,004,0086,153,606 ,5 ,611 ,1032 ,0,3,1,3,0,1,0,76.14,59.21 ,33.33
03,005,01,004,0087,154,565 ,7 ,572 ,968 ,0,3,1,3,0,1,0,76.14,59.09 ,33.33
03,005,01,004,0088,155,520 ,5 ,525 ,824 ,0,3,1,3,0,1,0,76.14,63.71 ,33.33
03,005,01,004,0088,156,820 ,7 ,827 ,1474 ,0,3,1,3,0,1,0,76.14,56.11 ,33.33
03,005,01,004,0089,157,688 ,7 ,695 ,1257 ,0,3,1,3,0,1,0,76.14,55.29 ,33.33
03,005,01,004,0090,158,956 ,9 ,965 ,1673 ,0,3,1,3,0,1,0,76.14,57.68 ,33.33
03,005,01,004,0091,159,331 ,3 ,334 ,544 ,0,3,1,3,0,1,0,76.14,61.40 ,33.33
03,005,01,004,0092,160,698 ,2 ,700 ,1222 ,0,3,1,3,0,1,0,76.14,57.28 ,33.33
03,005,01,004,0092,161,620 ,6 ,626 ,1107 ,0,3,1,3,0,1,0,76.14,56.55 ,33.33
03,005,01,004,0093,162,953 ,17 ,970 ,1472 ,0,3,1,3,0,1,0,76.14,65.90 ,33.33
03,005,01,004,0094,163,622 ,8 ,630 ,1125 ,0,3,1,3,0,1,0,76.14,56.00 ,33.33
03,005,01,004,0095,164,510 ,4 ,514 ,822 ,0,3,1,3,0,1,0,76.14,62.53 ,33.33
03,005,01,004,0095,165,637 ,6 ,643 ,1274 ,0,3,1,3,0,1,0,76.14,50.47 ,33.33
03,005,01,004,0095,166,597 ,9 ,606 ,1046 ,0,3,1,3,0,1,0,76.14,57.93 ,33.33
03,005,01,004,0096,167,602 ,4 ,606 ,1127 ,0,3,1,3,0,1,0,76.14,53.77 ,33.33
03,005,01,004,0096,168,563 ,2 ,565 ,1013 ,0,3,1,3,0,1,0,76.14,55.77 ,33.33
03,005,01,004,0097,169,811 ,9 ,820 ,1514 ,0,3,1,3,0,1,0,76.14,54.16 ,33.33
03,005,01,004,0097,170,670 ,5 ,675 ,1179 ,0,3,1,3,0,1,0,76.14,57.25 ,33.33
03,005,01,004,0098,171,529 ,2 ,531 ,933 ,0,3,1,3,0,1,0,76.14,56.91,33.33
03,005,01,005,0099,172,491 ,2 ,493 ,726 ,0,3,1,3,0,1,0,76.14,67.91,33.33
03,005,01,005,0099,173,768 ,6 ,774 ,1347 ,0,3,1,3,0,1,0,76.14,57.46 ,33.33
03,005,01,005,0100,174,575 ,3 ,578 ,916 ,0,3,1,3,0,1,0,76.14,63.10 ,33.33
03,005,01,005,0100,175,571 ,5 ,576 ,860 ,0,3,1,3,0,1,0,76.14,66.98 ,33.33
03,005,01,005,0101,176,591 ,4 ,595 ,1002 ,0,3,1,3,0,1,0,76.14,59.38 ,33.33
03,005,01,005,0101,177,535 ,6 ,541 ,849 ,0,3,1,3,0,1,0,76.14,63.72,33.33
03,005,01,005,0101,178,536 ,3 ,539 ,954 ,0,3,1,3,0,1,0,76.14,56.5,33.33
03,005,01,005,0102,179,654 ,6 ,660 ,1022 ,0,3,1,3,0,1,0,76.14,64.58 ,33.33
03,005,01,005,0102,180,651 ,1 ,652 ,1157 ,0,3,1,3,0,1,0,76.14,56.35 ,33.33
03,005,01,005,0102,181,762 ,7 ,769 ,1296 ,0,3,1,3,0,1,0,76.14,59.34 ,33.33
03,005,01,005,0103,182,532 ,3 ,535 ,793 ,0,3,1,3,0,1,0,76.14,67.47 ,33.33
03,005,01,005,0103,183,549 ,3 ,552 ,1008 ,0,3,1,3,0,1,0,76.14,54.76 ,33.33
03,005,01,005,0103,184,639 ,7 ,646 ,1111 ,0,3,1,3,0,1,0,76.14,58.15 ,33.33
03,005,01,005,0104,185,827 ,8 ,835 ,1367 ,0,3,1,3,0,1,0,76.14,61.08,33.33
03,005,01,005,0104,186,577 ,2 ,579 ,1026 ,0,3,1,3,0,1,0,76.14,56.43,33.33
03,005,01,005,0105,187,486 ,5 ,491 ,788 ,0,3,1,3,0,1,0,76.14,62.31 ,33.33
03,005,01,005,0106,188,769 ,5 ,774 ,1412 ,0,3,1,3,0,1,0,76.14,54.82 ,33.33
03,005,01,005,0106,189,777 ,10 ,787 ,1362 ,0,3,1,3,0,1,0,76.14,57.78 ,33.33
03,005,01,005,0107,190,573 ,3 ,576 ,1006 ,0,3,1,3,0,1,0,76.14,57.26 ,33.33
03,005,01,005,0107,191,668 ,4 ,672 ,1154 ,0,3,1,3,0,1,0,76.14,58.23 ,33.33
03,005,01,005,0107,192,640 ,7 ,647 ,1050 ,0,3,1,3,0,1,0,76.14,61.62 ,33.33
03,005,01,005,0107,193,651 ,2 ,653 ,1143 ,0,3,1,3,0,1,0,76.14,57.13 ,33.33
03,005,01,005,0108,194,510 ,2 ,512 ,838 ,0,3,1,3,0,1,0,76.14,61.1,33.33
03,005,01,005,0108,195,424 ,3 ,427 ,690 ,0,3,1,3,0,1,0,76.14,61.88,33.33
03,005,01,005,0109,196,506 ,3 ,509 ,798 ,0,3,1,3,0,1,0,76.14,63.78 ,33.33
03,005,01,005,0110,197,614 ,6 ,620 ,976 ,0,3,1,3,0,1,0,76.14,63.52 ,33.33
03,005,01,005,0111,198,722 ,9 ,731 ,1237 ,0,3,1,3,0,1,0,76.14,59.09 ,33.33
03,005,01,005,0112,199,579 ,6 ,585 ,1063 ,0,3,1,3,0,1,0,76.14,55.03 ,33.33
03,005,01,005,0112,200,606 ,2 ,608 ,1042 ,0,3,1,3,0,1,0,76.14,58.35 ,33.33
03,005,01,005,0113,201,814 ,6 ,820 ,1460 ,0,3,1,3,0,1,0,76.14,56.16 ,33.33
03,005,01,005,0113,202,614 ,6 ,620 ,1079 ,0,3,1,3,0,1,0,76.14,57.46 ,33.33
03,005,01,005,0114,203,842 ,8 ,850 ,1430 ,0,3,1,3,0,1,0,76.14,59.44 ,33.33
03,005,01,005,0114,204,668 ,5 ,673 ,1290 ,0,3,1,3,0,1,0,76.14,52.17 ,33.33
03,005,01,005,0114,205,746 ,4 ,750 ,1350 ,0,3,1,3,0,1,0,76.14,55.56 ,33.33
03,005,01,005,0114,206,823 ,8 ,831 ,1431 ,0,3,1,3,0,1,0,76.14,58.07 ,33.33
03,005,01,005,0115,207,710 ,6 ,716 ,1288 ,0,3,1,3,0,1,0,76.14,55.59 ,33.33
03,005,01,005,0115,208,777 ,8 ,785 ,1467 ,0,3,1,3,0,1,0,76.14,53.51 ,33.33
03,005,01,005,0116,209,572 ,6 ,578 ,988 ,0,3,1,3,0,1,0,76.14,58.50 ,33.33
03,005,01,005,0116,210,520 ,6 ,526 ,950 ,0,3,1,3,0,1,0,76.14,55.37 ,33.33
03,005,01,005,0116,211,464 ,6 ,470 ,898 ,0,3,1,3,0,1,0,76.14,52.34 ,33.33
03,005,01,005,0117,212,687 ,4 ,691 ,1224 ,0,3,1,3,0,1,0,76.14,56.45 ,33.33
03,005,01,005,0117,213,708 ,9 ,717 ,1385 ,0,3,1,3,0,1,0,76.14,51.77 ,33.33
03,005,01,005,0118,214,622 ,4 ,626 ,1091 ,0,3,1,3,0,1,0,76.14,57.38 ,33.33
03,005,01,005,0118,215,675 ,7 ,682 ,1294 ,0,3,1,3,0,1,0,76.14,52.7,33.33
03,005,01,005,0119,216,466 ,6 ,472 ,867 ,0,3,1,3,0,1,0,76.14,54.44,33.33
03,005,01,005,0119,217,458 ,4 ,462 ,764 ,0,3,1,3,0,1,0,76.14,60.47 ,33.33
03,005,01,005,0120,218,471 ,3 ,474 ,786 ,0,3,1,3,0,1,0,76.14,60.31 ,33.33
03,005,01,005,0120,219,479 ,7 ,486 ,860 ,0,3,1,3,0,1,0,76.14,56.51,33.33
03,005,01,005,0121,220,488 ,5 ,493 ,917 ,0,3,1,3,0,1,0,76.14,53.76,33.33
03,005,01,005,0121,221,512 ,6 ,518 ,1007 ,0,3,1,3,0,1,0,76.14,51.44 ,33.33
03,005,01,005,0122,222,863 ,8 ,871 ,1441 ,0,3,1,3,0,1,0,76.14,60.44 ,33.33
03,005,01,005,0122,223,719 ,9 ,728 ,1313 ,0,3,1,3,0,1,0,76.14,55.45 ,33.33
03,005,01,005,0123,224,857 ,7 ,864 ,1319 ,0,3,1,3,0,1,0,76.14,65.50 ,33.33
03,005,01,005,0124,225,827 ,11 ,838 ,1316 ,0,3,1,3,0,1,0,76.14,63.68 ,33.33
03,005,01,005,0125,226,586 ,5 ,591 ,867 ,0,3,1,3,0,1,0,76.14,68.17 ,33.33
03,005,01,005,0126,227,648 ,5 ,653 ,1086 ,0,3,1,3,0,1,0,76.14,60.13 ,33.33
03,005,01,005,0126,228,811 ,11 ,822 ,1374 ,0,3,1,3,0,1,0,76.14,59.83 ,33.33
03,005,01,005,0127,229,519 ,6 ,525 ,927 ,0,3,1,3,0,1,0,76.14,56.63 ,33.33
03,005,01,005,0127,230,635 ,2 ,637 ,1034 ,0,3,1,3,0,1,0,76.14,61.61,33.33
03,005,01,006,0128,231,398 ,1 ,399 ,619 ,0,3,1,3,0,1,0,76.14,64.46,33.33
03,005,01,006,0128,232,496 ,3 ,499 ,758 ,0,3,1,3,0,1,0,76.14,65.83 ,33.33
03,005,01,006,0129,233,660 ,4 ,664 ,956 ,0,3,1,3,0,1,0,76.14,69.46 ,33.33
03,005,01,006,0130,234,881 ,5 ,886 ,1422 ,0,3,1,3,0,1,0,76.14,62.31 ,33.33
03,005,01,006,0131,235,802 ,6 ,808 ,1278 ,0,3,1,3,0,1,0,76.14,63.22 ,33.33
03,005,01,006,0131,236,729 ,8 ,737 ,1211 ,0,3,1,3,0,1,0,76.14,60.86 ,33.33
03,005,01,006,0131,237,589 ,2 ,591 ,973 ,0,3,1,3,0,1,0,76.14,60.74 ,33.33
03,005,01,006,0132,238,659 ,4 ,663 ,1072 ,0,3,1,3,0,1,0,76.14,61.85 ,33.33
03,005,01,006,0132,239,690 ,4 ,694 ,1150 ,0,3,1,3,0,1,0,76.14,60.35 ,33.33
03,005,01,006,0133,240,832 ,1 ,833 ,1272 ,0,3,1,3,0,1,0,76.14,65.49 ,33.33
03,005,01,006,0134,241,796 ,5 ,801 ,1220 ,0,3,1,3,0,1,0,76.14,65.66 ,33.33
03,005,01,006,0135,242,718 ,5 ,723 ,1098 ,0,3,1,3,0,1,0,76.14,65.85 ,33.33
03,005,01,006,0135,243,753 ,7 ,760 ,1316 ,0,3,1,3,0,1,0,76.14,57.75 ,33.33
03,005,01,006,0136,244,921 ,9 ,930 ,1321 ,0,3,1,3,0,1,0,76.14,70.40 ,33.33
03,005,01,006,0137,245,420 ,4 ,424 ,641 ,0,3,1,3,0,1,0,76.14,66.15 ,33.33
03,005,01,006,0138,246,829 ,4 ,833 ,1381 ,0,3,1,3,0,1,0,76.14,60.32 ,33.33
03,005,01,006,0139,247,445 ,3 ,448 ,763 ,0,3,1,3,0,1,0,76.14,58.72 ,33.33
03,005,01,006,0139,248,467 ,2 ,469 ,800 ,0,3,1,3,0,1,0,76.14,58.63 ,33.33
03,005,01,006,0140,249,750 ,5 ,755 ,1302 ,0,3,1,3,0,1,0,76.14,57.99 ,33.33
03,005,01,006,0141,250,557 ,6 ,563 ,1010 ,0,3,1,3,0,1,0,76.14,55.74 ,33.33
03,005,01,006,0142,251,619 ,10 ,629 ,1134 ,0,3,1,3,0,1,0,76.14,55.47 ,33.33
03,005,01,006,0143,252,544 ,5 ,549 ,993 ,0,3,1,3,0,1,0,76.14,55.29 ,33.33
03,005,01,006,0144,253,470 ,2 ,472 ,721 ,0,3,1,3,0,1,0,76.14,65.46 ,33.33
03,005,01,006,0145,254,653 ,5 ,658 ,1097 ,0,3,1,3,0,1,0,76.14,59.98 ,33.33
03,005,01,006,0146,255,409 ,4 ,413 ,644 ,0,3,1,3,0,1,0,76.14,64.13 ,33.33
03,005,01,006,0147,256,797 ,11 ,808 ,1311 ,0,3,1,3,0,1,0,76.14,61.63 ,33.33
03,005,01,006,0148,257,488 ,4 ,492 ,813 ,0,3,1,3,0,1,0,76.14,60.52 ,33.33
03,005,01,006,0149,258,651 ,5 ,656 ,1221 ,0,3,1,3,0,1,0,76.14,53.73,33.33
03,005,01,006,0150,259,744 ,5 ,749 ,1285 ,0,3,1,3,0,1,0,76.14,58.29,33.33
03,005,01,007,0151,260,690 ,6 ,696 ,1053 ,0,3,1,3,0,1,0,76.14,66.1,33.33
03,005,01,007,0151,261,734 ,9 ,743 ,1107 ,0,3,1,3,0,1,0,76.14,67.12 ,33.33
03,005,01,007,0152,262,776 ,3 ,779 ,1168 ,0,3,1,3,0,1,0,76.14,66.70 ,33.33
03,005,01,007,0153,263,544 ,2 ,546 ,814 ,0,3,1,3,0,1,0,76.14,67.08 ,33.33
03,005,01,007,0154,264,506 ,3 ,509 ,829 ,0,3,1,3,0,1,0,76.14,61.40 ,33.33
03,005,01,007,0154,265,477 ,2 ,479 ,775 ,0,3,1,3,0,1,0,76.14,61.81,33.33
03,005,01,007,0155,266,656 ,11 ,667 ,1033 ,0,3,1,3,0,1,0,76.14,64.57,33.33
03,005,01,007,0156,267,351 ,7 ,358 ,555 ,0,3,1,3,0,1,0,76.14,64.50 ,33.33
03,005,01,007,0157,268,471 ,17 ,488 ,756 ,0,3,1,3,0,1,0,76.14,64.55 ,33.33
03,005,01,007,0158,269,436 ,4 ,440 ,795 ,0,3,1,3,0,1,0,76.14,55.35 ,33.33
03,005,01,007,0158,270,483 ,5 ,488 ,835 ,0,3,1,3,0,1,0,76.14,58.44 ,33.33
03,005,01,007,0158,271,306 ,1 ,307 ,443 ,0,3,1,3,0,1,0,76.14,69.30 ,33.33
03,005,01,007,0159,272,396 ,6 ,402 ,677 ,0,3,1,3,0,1,0,76.14,59.38 ,33.33
03,005,01,007,0159,273,454 ,5 ,459 ,738 ,0,3,1,3,0,1,0,76.14,62.2,33.33
03,005,01,007,0159,274,446 ,5 ,451 ,727 ,0,3,1,3,0,1,0,76.14,62.04,33.33
03,005,01,007,0160,275,587 ,4 ,591 ,935 ,0,3,1,3,0,1,0,76.14,63.21,33.33
03,005,01,007,0160,276,335 ,5 ,340 ,488 ,0,3,1,3,0,1,0,76.14,69.67,33.33
03,005,01,007,0161,277,424 ,4 ,428 ,701 ,0,3,1,3,0,1,0,76.14,61.06,33.33
03,005,01,008,0162,278,486 ,1 ,487 ,771 ,0,3,1,3,0,1,0,76.14,63.16,33.33
03,005,01,008,0162,279,568 ,4 ,572 ,922 ,0,3,1,3,0,1,0,76.14,62.04,33.33
03,005,01,008,0163,280,484 ,5 ,489 ,666 ,0,3,1,3,0,1,0,76.14,73.42,33.33
03,005,01,008,0164,281,728 ,5 ,733 ,1255 ,0,3,1,3,0,1,0,76.14,58.41,33.33
03,005,01,008,0165,282,485 ,3 ,488 ,853 ,0,3,1,3,0,1,0,76.14,57.21,33.33
03,005,01,008,0165,283,520 ,2 ,522 ,831 ,0,3,1,3,0,1,0,76.14,62.82,33.33
03,005,01,008,0166,284,761 ,7 ,768 ,1365 ,0,3,1,3,0,1,0,76.14,56.26,33.33
03,005,01,008,0167,285,351 ,7 ,358 ,623 ,0,3,1,3,0,1,0,76.14,57.46,33.33
03,005,01,008,0168,286,453 ,8 ,461 ,733 ,0,3,1,3,0,1,0,76.14,62.89,33.33
03,005,01,008,0169,287,458 ,1 ,459 ,720 ,0,3,1,3,0,1,0,76.14,63.75,33.33
03,005,01,008,0170,288,330 ,4 ,334 ,512 ,0,3,1,3,0,1,0,76.14,65.23,33.33
03,005,01,008,0171,289,400 ,2 ,402 ,715 ,0,3,1,3,0,1,0,76.14,56.22,33.33
03,005,01,008,0171,290,492 ,4 ,496 ,873 ,0,3,1,3,0,1,0,76.14,56.82,33.33
03,005,01,008,0172,291,555 ,9 ,564 ,920 ,0,3,1,3,0,1,0,76.14,61.3,33.33
03,005,01,008,0173,292,520 ,6 ,526 ,844 ,0,3,1,3,0,1,0,76.14,62.32,33.33
03,005,01,009,0174,293,524 ,8 ,532 ,819 ,0,3,1,3,0,1,0,76.14,64.96,33.33
03,005,01,009,0174,294,459 ,4 ,463 ,758 ,0,3,1,3,0,1,0,76.14,61.08,33.33
03,005,01,009,0175,295,619 ,5 ,624 ,1028 ,0,3,1,3,0,1,0,76.14,60.7,33.33
03,005,01,009,0175,296,673 ,6 ,679 ,1140 ,0,3,1,3,0,1,0,76.14,59.56,33.33
03,005,01,009,0176,297,740 ,6 ,746 ,1324 ,0,3,1,3,0,1,0,76.14,56.34,33.33
03,005,01,009,0176,298,834 ,6 ,840 ,1513 ,0,3,1,3,0,1,0,76.14,55.52,33.33
03,005,01,009,0177,299,586 ,5 ,591 ,1039 ,0,3,1,3,0,1,0,76.14,56.88,33.33
03,005,01,009,0177,300,547 ,3 ,550 ,946 ,0,3,1,3,0,1,0,76.14,58.14,33.33
03,005,01,009,0178,301,617 ,5 ,622 ,1060 ,0,3,1,3,0,1,0,76.14,58.68,33.33
03,005,01,009,0178,302,359 ,5 ,364 ,683 ,0,3,1,3,0,1,0,76.14,53.29,33.33
03,005,01,009,0179,303,560 ,10 ,570 ,983 ,0,3,1,3,0,1,0,76.14,57.99,33.33
03,005,01,009,0180,304,664 ,6 ,670 ,1069 ,0,3,1,3,0,1,0,76.14,62.68,33.33
03,005,01,009,0181,305,269 ,2 ,271 ,396 ,0,3,1,3,0,1,0,76.14,68.43,33.33
03,005,01,009,0182,306,430 ,3 ,433 ,731 ,0,3,1,3,0,1,0,76.14,59.23,33.33
03,005,01,009,0182,307,544 ,5 ,549 ,959 ,0,3,1,3,0,1,0,76.14,57.25,33.33
03,005,01,009,0183,308,434 ,5 ,439 ,734 ,0,3,1,3,0,1,0,76.14,59.81,33.33
03,005,01,009,0183,309,373 ,8 ,381 ,710 ,0,3,1,3,0,1,0,76.14,53.66,33.33
03,005,01,009,0184,310,218 ,1 ,219 ,308 ,0,3,1,3,0,1,0,76.14,71.1,33.33
03,005,01,009,0185,311,545 ,1 ,546 ,939 ,0,3,1,3,0,1,0,76.14,58.15,33.33
03,005,01,009,0185,312,527 ,8 ,535 ,871 ,0,3,1,3,0,1,0,76.14,61.42,33.33
03,005,01,009,0186,313,671 ,12 ,683 ,1139 ,0,3,1,3,0,1,0,76.14,59.96,33.33
03,005,01,009,0187,314,816 ,7 ,823 ,1359 ,0,3,1,3,0,1,0,76.14,60.56,33.33
03,005,01,009,0188,315,809 ,7 ,816 ,1375 ,0,3,1,3,0,1,0,76.14,59.35,33.33
03,005,01,009,0189,316,781 ,8 ,789 ,1381 ,0,3,1,3,0,1,0,76.14,57.13,33.33
03,005,01,009,0190,317,699 ,4 ,703 ,1180 ,0,3,1,3,0,1,0,76.14,59.58,33.33
03,005,01,009,0191,318,147 ,3 ,150 ,252 ,0,3,1,3,0,1,0,76.14,59.52,33.33
03,005,01,009,0192,319,200 ,1 ,201 ,313 ,0,3,1,3,0,1,0,76.14,64.22,33.33
03,005,01,010,0193,320,579 ,4 ,583 ,870 ,0,3,1,3,0,1,0,76.14,67.01,33.33
03,005,01,010,0193,321,676 ,5 ,681 ,1022 ,0,3,1,3,0,1,0,76.14,66.63,33.33
03,005,01,010,0193,322,763 ,8 ,771 ,1287 ,0,3,1,3,0,1,0,76.14,59.91,33.33
03,005,01,010,0193,323,547 ,3 ,550 ,1008 ,0,3,1,3,0,1,0,76.14,54.56,33.33
03,005,01,010,0194,324,769 ,8 ,777 ,1268 ,0,3,1,3,0,1,0,76.14,61.28,33.33
03,005,01,010,0195,325,757 ,5 ,762 ,1241 ,0,3,1,3,0,1,0,76.14,61.4,33.33
03,005,01,010,0196,326,584 ,6 ,590 ,939 ,0,3,1,3,0,1,0,76.14,62.83,33.33
03,005,01,010,0196,327,480 ,7 ,487 ,794 ,0,3,1,3,0,1,0,76.14,61.34,33.33
03,005,01,010,0197,328,642 ,5 ,647 ,1099 ,0,3,1,3,0,1,0,76.14,58.87,33.33
03,005,01,010,0198,329,658 ,4 ,662 ,1059 ,0,3,1,3,0,1,0,76.14,62.51,33.33
03,005,01,010,0199,330,628 ,5 ,633 ,1042 ,0,3,1,3,0,1,0,76.14,60.75,33.33
03,005,01,010,0199,331,476 ,1 ,477 ,830 ,0,3,1,3,0,1,0,76.14,57.47,33.33
03,005,01,010,0199,332,500 ,3 ,503 ,952 ,0,3,1,3,0,1,0,76.14,52.84,33.33
03,005,01,010,0200,333,416 ,3 ,419 ,628 ,0,3,1,3,0,1,0,76.14,66.72,33.33
03,005,01,010,0201,334,275 ,5 ,280 ,494 ,0,3,1,3,0,1,0,76.14,56.68,33.33
03,005,01,010,0202,335,327 ,2 ,329 ,539 ,0,3,1,3,0,1,0,76.14,61.04,33.33
03,005,01,011,0203,336,294 ,5 ,299 ,499 ,0,3,1,3,0,1,0,76.14,59.92,33.33
03,005,01,011,0203,337,411 ,3 ,414 ,697 ,0,3,1,3,0,1,0,76.14,59.4,33.33
03,005,01,011,0204,338,399 ,9 ,408 ,651 ,0,3,1,3,0,1,0,76.14,62.67,33.33
03,005,01,011,0205,339,321 ,2 ,323 ,543 ,0,3,1,3,0,1,0,76.14,59.48,33.33
03,005,01,011,0205,340,279 ,1 ,280 ,490 ,0,3,1,3,0,1,0,76.14,57.14,33.33
03,005,01,011,0206,341,505 ,5 ,510 ,851 ,0,3,1,3,0,1,0,76.14,59.93,33.33
03,005,01,011,0207,342,514 ,2 ,516 ,961 ,0,3,1,3,0,1,0,76.14,53.69,33.33
03,005,01,011,0208,343,670 ,5 ,675 ,1054 ,0,3,1,3,0,1,0,76.14,64.04,33.33
03,005,01,011,0209,344,612 ,9 ,621 ,1031 ,0,3,1,3,0,1,0,76.14,60.23,33.33
03,005,01,011,0210,345,234 ,1 ,235 ,473 ,0,3,1,3,0,1,0,76.14,49.68,33.33
03,005,01,011,0211,346,148 ,0 ,148 ,281 ,0,3,1,3,0,1,0,76.14,52.67,33.33
03,005,01,012,0212,347,829 ,6 ,835 ,1321 ,0,3,1,3,0,1,0,76.14,63.21,33.33
03,005,01,012,0212,348,733 ,4 ,737 ,1098 ,0,3,1,3,0,1,0,76.14,67.12,33.33
03,005,01,012,0213,349,472 ,6 ,478 ,786 ,0,3,1,3,0,1,0,76.14,60.81,33.33
03,005,01,012,0213,350,533 ,7 ,540 ,795 ,0,3,1,3,0,1,0,76.14,67.92,33.33
03,005,01,012,0214,351,426 ,4 ,430 ,683 ,0,3,1,3,0,1,0,76.14,62.96,33.33
03,005,01,012,0215,352,588 ,8 ,596 ,866 ,0,3,1,3,0,1,0,76.14,68.82,33.33
03,005,01,012,0216,353,234 ,4 ,238 ,353 ,0,3,1,3,0,1,0,76.14,67.42,33.33
03,005,01,012,0217,354,509 ,5 ,514 ,881 ,0,3,1,3,0,1,0,76.14,58.34,33.33
03,005,01,012,0217,355,579 ,9 ,588 ,987 ,0,3,1,3,0,1,0,76.14,59.57,33.33
03,005,01,012,0218,356,583 ,2 ,585 ,890 ,0,3,1,3,0,1,0,76.14,65.73,33.33
03,005,01,012,0218,357,136 ,2 ,138 ,202 ,0,3,1,3,0,1,0,76.14,68.32,33.33
03,005,01,012,0219,358,222 ,2 ,224 ,346 ,0,3,1,3,0,1,0,76.14,64.74,33.33
03,005,01,013,0220,359,826 ,3 ,829 ,1241 ,0,3,1,3,0,1,0,76.14,66.8,33.33
03,005,01,013,0220,360,1018 ,6 ,1024 ,1610 ,0,3,1,3,0,1,0,76.14,63.6,33.33
03,005,01,013,0220,361,659 ,8 ,667 ,1117 ,0,3,1,3,0,1,0,76.14,59.71,33.33
03,005,01,013,0221,362,568 ,9 ,577 ,949 ,0,3,1,3,0,1,0,76.14,60.8,33.33
03,005,01,013,0221,363,576 ,7 ,583 ,1063 ,0,3,1,3,0,1,0,76.14,54.84,33.33
03,005,01,013,0221,364,556 ,11 ,567 ,1014 ,0,3,1,3,0,1,0,76.14,55.92,33.33
03,005,01,013,0222,365,1044 ,13 ,1057 ,1650 ,0,3,1,3,0,1,0,76.14,64.06,33.33
03,005,01,013,0223,366,904 ,8 ,912 ,1366 ,0,3,1,3,0,1,0,76.14,66.76,33.33
03,005,01,013,0224,367,842 ,5 ,847 ,1339 ,0,3,1,3,0,1,0,76.14,63.26,33.33
03,005,01,013,0225,368,274 ,5 ,279 ,399 ,0,3,1,3,0,1,0,76.14,69.92,33.33
03,005,01,013,0226,369,786 ,10 ,796 ,1172 ,0,3,1,3,0,1,0,76.14,67.92,33.33
03,005,01,014,0227,370,372 ,7 ,379 ,603 ,0,3,1,3,0,1,0,76.14,62.85,33.33
03,005,01,014,0228,371,364 ,7 ,371 ,565 ,0,3,1,3,0,1,0,76.14,65.66,33.33
03,005,01,014,0229,372,521 ,6 ,527 ,883 ,0,3,1,3,0,1,0,76.14,59.68,33.33
03,005,01,014,0230,373,393 ,1 ,394 ,647 ,0,3,1,3,0,1,0,76.14,60.9,33.33
03,005,01,014,0231,374,537 ,7 ,544 ,945 ,0,3,1,3,0,1,0,76.14,57.57,33.33
03,005,01,014,0232,375,309 ,2 ,311 ,511 ,0,3,1,3,0,1,0,76.14,60.86,33.33
03,005,01,014,0233,376,325 ,3 ,328 ,525 ,0,3,1,3,0,1,0,76.14,62.48,33.33
03,005,01,014,0234,377,652 ,4 ,656 ,1127 ,0,3,1,3,0,1,0,76.14,58.21,33.33
03,005,01,014,0235,378,426 ,5 ,431 ,686 ,0,3,1,3,0,1,0,76.14,62.83,33.33
03,005,01,015,0236,379,591 ,3 ,594 ,986 ,0,3,1,3,0,1,0,76.14,60.24,33.33
03,005,01,015,0236,380,466 ,4 ,470 ,801 ,0,3,1,3,0,1,0,76.14,58.68,33.33
03,005,01,015,0237,381,310 ,2 ,312 ,478 ,0,3,1,3,0,1,0,76.14,65.27,33.33
03,005,01,015,0238,382,577 ,0 ,577 ,960 ,0,3,1,3,0,1,0,76.14,60.1,33.33
03,005,01,015,0239,383,958 ,8 ,966 ,1689 ,0,3,1,3,0,1,0,76.14,57.19,33.33
03,005,01,015,0239,384,930 ,8 ,938 ,1417 ,0,3,1,3,0,1,0,76.14,66.2,33.33
03,005,01,015,0240,385,338 ,4 ,342 ,539 ,0,3,1,3,0,1,0,76.14,63.45,33.33
03,005,01,015,0241,386,298 ,1 ,299 ,496 ,0,3,1,3,0,1,0,76.14,60.28,33.33
03,005,01,015,0242,387,804 ,13 ,817 ,1356 ,0,3,1,3,0,1,0,76.14,60.25,33.33
03,005,01,015,0243,388,461 ,3 ,464 ,712 ,0,3,1,3,0,1,0,76.14,65.17,33.33
03,005,01,015,0244,389,614 ,9 ,623 ,1003 ,0,3,1,3,0,1,0,76.14,62.11,33.33
03,005,01,016,0245,390,698 ,4 ,702 ,1017 ,0,3,1,3,0,1,0,76.14,69.03,33.33
03,005,01,016,0245,391,684 ,9 ,693 ,1110 ,0,3,1,3,0,1,0,76.14,62.43,33.33
03,005,01,016,0246,392,365 ,5 ,370 ,580 ,0,3,1,3,0,1,0,76.14,63.79,33.33
03,005,01,016,0247,393,510 ,8 ,518 ,849 ,0,3,1,3,0,1,0,76.14,61.01,33.33
03,005,01,016,0248,394,148 ,2 ,150 ,230 ,0,3,1,3,0,1,0,76.14,65.22,33.33
03,005,01,016,0249,395,320 ,6 ,326 ,519 ,0,3,1,3,0,1,0,76.14,62.81,33.33
03,005,01,016,0250,396,380 ,6 ,386 ,604 ,0,3,1,3,0,1,0,76.14,63.91,33.33
03,005,01,016,0251,397,278 ,2 ,280 ,462 ,0,3,1,3,0,1,0,76.14,60.61,33.33
03,005,01,016,0252,398,226 ,5 ,231 ,366 ,0,3,1,3,0,1,0,76.14,63.11,33.33
03,005,01,017,0253,399,448 ,5 ,453 ,755 ,0,3,1,3,0,1,0,76.14,60,33.33
03,005,01,017,0254,400,246 ,1 ,247 ,358 ,0,3,1,3,0,1,0,76.14,68.99,33.33
03,005,01,017,0255,401,387 ,3 ,390 ,629 ,0,3,1,3,0,1,0,76.14,62,33.33
03,005,01,017,0256,402,357 ,6 ,363 ,592 ,0,3,1,3,0,1,0,76.14,61.32,33.33
03,005,01,017,0257,403,555 ,10 ,565 ,928 ,0,3,1,3,0,1,0,76.14,60.88,33.33
03,005,01,017,0258,404,363 ,2 ,365 ,627 ,0,3,1,3,0,1,0,76.14,58.21,33.33
03,005,01,017,0259,405,177 ,2 ,179 ,271 ,0,3,1,3,0,1,0,76.14,66.05,33.33
03,005,01,018,0260,406,91 ,2 ,93 ,139 ,0,3,1,3,0,1,0,76.14,66.91,33.33
03,005,01,018,0261,407,216 ,0 ,216 ,358 ,0,3,1,3,0,1,0,76.14,60.34,33.33
03,005,01,018,0262,408,181 ,2 ,183 ,278 ,0,3,1,3,0,1,0,76.14,65.83,33.33
03,005,01,018,0262,409,229 ,3 ,232 ,343 ,0,3,1,3,0,1,0,76.14,67.64,33.33
03,005,01,018,0263,410,50 ,0 ,50 ,91 ,0,3,1,3,0,1,0,76.14,54.95,33.33
03,005,01,018,0264,411,74 ,0 ,74 ,123 ,0,3,1,3,0,1,0,76.14,60.16,33.33
03,005,01,018,0265,412,18 ,0 ,18 ,27 ,0,3,1,3,0,1,0,76.14,66.67,33.33
03,005,01,018,0266,413,20 ,0 ,20 ,51 ,0,3,1,3,0,1,0,76.14,39.22,33.33
03,005,01,018,0267,414,14 ,0 ,14 ,27 ,0,3,1,3,0,1,0,76.14,51.85,33.33
03,006,01,001,0001,1,504 ,11 ,515 ,885 ,0,3,1,3,0,1,0,76.14,58.19 ,33.33
03,006,01,001,0001,2,669 ,8 ,677 ,1096 ,0,3,1,3,0,1,0,76.14,61.77 ,33.33
03,006,01,001,0002,3,590 ,5 ,595 ,1025 ,0,3,1,3,0,1,0,76.14,58.05 ,33.33
03,006,01,001,0003,4,541 ,5 ,546 ,885 ,0,3,1,3,0,1,0,76.14,61.69 ,33.33
03,006,01,001,0004,5,609 ,3 ,612 ,916 ,0,3,1,3,0,1,0,76.14,66.81 ,33.33
03,006,01,001,0005,6,491 ,4 ,495 ,795 ,0,3,1,3,0,1,0,76.14,62.26 ,33.33
03,006,01,001,0006,7,878 ,9 ,887 ,1460 ,0,3,1,3,0,1,0,76.14,60.75 ,33.33
03,006,01,001,0006,8,780 ,9 ,789 ,1337 ,0,3,1,3,0,1,0,76.14,59.01 ,33.33
03,006,01,001,0006,9,1062 ,13 ,1075 ,1730 ,0,3,1,3,0,1,0,76.14,62.14 ,33.33
03,006,01,001,0007,10,660 ,11 ,671 ,1110 ,0,3,1,3,0,1,0,76.14,60.45 ,33.33
03,006,01,001,0007,11,649 ,4 ,653 ,1154 ,0,3,1,3,0,1,0,76.14,56.59 ,33.33
03,006,01,001,0008,12,691 ,12 ,703 ,1314 ,0,3,1,3,0,1,0,76.14,53.50 ,33.33
03,006,01,001,0008,13,648 ,13 ,661 ,1188 ,0,3,1,3,0,1,0,76.14,55.64 ,33.33
03,006,01,001,0009,14,755 ,9 ,764 ,1268 ,0,3,1,3,0,1,0,76.14,60.25 ,33.33
03,006,01,001,0009,15,740 ,10 ,750 ,1357 ,0,3,1,3,0,1,0,76.14,55.27 ,33.33
03,006,01,001,0009,16,761 ,12 ,773 ,1104 ,0,3,1,3,0,1,0,76.14,70.02 ,33.33
03,006,01,001,0010,17,789 ,10 ,799 ,1408 ,0,3,1,3,0,1,0,76.14,56.75 ,33.33
03,006,01,001,0010,18,777 ,8 ,785 ,1443 ,0,3,1,3,0,1,0,76.14,54.40 ,33.33
03,006,01,001,0010,19,650 ,8 ,658 ,1198 ,0,3,1,3,0,1,0,76.14,54.92 ,33.33
03,006,01,001,0010,20,646 ,5 ,651 ,1214 ,0,3,1,3,0,1,0,76.14,53.62 ,33.33
03,006,01,001,0010,21,826 ,10 ,836 ,1438 ,0,3,1,3,0,1,0,76.14,58.14 ,33.33
03,006,01,001,0011,22,1070 ,6 ,1076 ,1728 ,0,3,1,3,0,1,0,76.14,62.27 ,33.33
03,006,01,001,0012,23,733 ,2 ,735 ,1138 ,0,3,1,3,0,1,0,76.14,64.59 ,33.33
03,006,01,001,0013,24,769 ,0 ,769 ,1269 ,0,3,1,3,0,1,0,76.14,60.60 ,33.33
03,006,01,001,0013,25,893 ,12 ,905 ,1510 ,0,3,1,3,0,1,0,76.14,59.93 ,33.33
03,006,01,001,0014,26,563 ,7 ,570 ,833 ,0,3,1,3,0,1,0,76.14,68.43 ,33.33
03,006,01,001,0015,27,493 ,5 ,498 ,792 ,0,3,1,3,0,1,0,76.14,62.88 ,33.33
03,006,01,001,0016,28,979 ,6 ,985 ,1504 ,0,3,1,3,0,1,0,76.14,65.49 ,33.33
03,006,01,001,0016,29,963 ,6 ,969 ,1729 ,0,3,1,3,0,1,0,76.14,56.04 ,33.33
03,006,01,001,0016,30,880 ,7 ,887 ,1601 ,0,3,1,3,0,1,0,76.14,55.40 ,33.33
03,006,01,001,0017,31,695 ,4 ,699 ,1295 ,0,3,1,3,0,1,0,76.14,53.98 ,33.33
03,006,01,001,0017,32,596 ,3 ,599 ,983 ,0,3,1,3,0,1,0,76.14,60.94 ,33.33
03,006,01,001,0018,33,738 ,6 ,744 ,1239 ,0,3,1,3,0,1,0,76.14,60.05 ,33.33
03,006,01,001,0018,34,876 ,13 ,889 ,1512 ,0,3,1,3,0,1,0,76.14,58.80 ,33.33
03,006,01,001,0019,35,823 ,7 ,830 ,1516 ,0,3,1,3,0,1,0,76.14,54.75 ,33.33
03,006,01,001,0019,36,730 ,13 ,743 ,1361 ,0,3,1,3,0,1,0,76.14,54.59 ,33.33
03,006,01,001,0019,37,775 ,9 ,784 ,1541 ,0,3,1,3,0,1,0,76.14,50.88 ,33.33
03,006,01,001,0019,38,697 ,4 ,701 ,1402 ,0,3,1,3,0,1,0,76.14,50.00 ,33.33
03,006,01,001,0019,39,954 ,6 ,960 ,1839 ,0,3,1,3,0,1,0,76.14,52.20 ,33.33
03,006,01,001,0020,40,868 ,9 ,877 ,1628 ,0,3,1,3,0,1,0,76.14,53.87 ,33.33
03,006,01,001,0020,41,828 ,4 ,832 ,1512 ,0,3,1,3,0,1,0,76.14,55.03 ,33.33
03,006,01,001,0020,42,1027 ,11 ,1038 ,1855 ,0,3,1,3,0,1,0,76.14,55.96 ,33.33
03,006,01,001,0021,43,802 ,4 ,806 ,1362 ,0,3,1,3,0,1,0,76.14,59.18 ,33.33
03,006,01,001,0022,44,589 ,5 ,594 ,1037 ,0,3,1,3,0,1,0,76.14,57.28 ,33.33
03,006,01,001,0023,45,1048 ,10 ,1058 ,1843 ,0,3,1,3,0,1,0,76.14,57.41 ,33.33
03,006,01,001,0023,46,838 ,4 ,842 ,1457 ,0,3,1,3,0,1,0,76.14,57.79 ,33.33
03,006,01,001,0023,47,764 ,18 ,782 ,1401 ,0,3,1,3,0,1,0,76.14,55.82 ,33.33
03,006,01,001,0024,48,947 ,17 ,964 ,1770 ,0,3,1,3,0,1,0,76.14,54.46 ,33.33
03,006,01,001,0024,49,934 ,12 ,946 ,1700 ,0,3,1,3,0,1,0,76.14,55.65 ,33.33
03,006,01,001,0024,50,987 ,11 ,998 ,1732 ,0,3,1,3,0,1,0,76.14,57.62 ,33.33
03,006,01,001,0024,51,946 ,15 ,961 ,1744 ,0,3,1,3,0,1,0,76.14,55.10 ,33.33
03,006,01,001,0024,52,1033 ,6 ,1039 ,1851 ,0,3,1,3,0,1,0,76.14,56.13 ,33.33
03,006,01,001,0025,53,713 ,13 ,726 ,1214 ,0,3,1,3,0,1,0,76.14,59.80 ,33.33
03,006,01,001,0025,54,680 ,7 ,687 ,1169 ,0,3,1,3,0,1,0,76.14,58.77 ,33.33
03,006,01,001,0025,55,721 ,7 ,728 ,1176 ,0,3,1,3,0,1,0,76.14,61.90 ,33.33
03,006,01,001,0026,56,710 ,9 ,719 ,1224 ,0,3,1,3,0,1,0,76.14,58.74 ,33.33
03,006,01,001,0026,57,719 ,9 ,728 ,1226 ,0,3,1,3,0,1,0,76.14,59.38 ,33.33
03,006,01,001,0027,58,842 ,9 ,851 ,1506 ,0,3,1,3,0,1,0,76.14,56.51 ,33.33
03,006,01,001,0027,59,966 ,6 ,972 ,1808 ,0,3,1,3,0,1,0,76.14,53.76 ,33.33
03,006,01,001,0027,60,736 ,5 ,741 ,1356 ,0,3,1,3,0,1,0,76.14,54.65 ,33.33
03,006,01,001,0027,61,866 ,3 ,869 ,1451 ,0,3,1,3,0,1,0,76.14,59.89 ,33.33
03,006,01,001,0027,62,717 ,14 ,731 ,1409 ,0,3,1,3,0,1,0,76.14,51.88 ,33.33
03,006,01,001,0028,63,835 ,5 ,840 ,1556 ,0,3,1,3,0,1,0,76.14,53.98 ,33.33
03,006,01,001,0028,64,945 ,7 ,952 ,1637 ,0,3,1,3,0,1,0,76.14,58.16 ,33.33
03,006,01,001,0028,65,1041 ,18 ,1059 ,1995 ,0,3,1,3,0,1,0,76.14,53.08 ,33.33
03,006,01,001,0028,66,924 ,7 ,931 ,1667 ,0,3,1,3,0,1,0,76.14,55.85 ,33.33
03,006,01,001,0028,67,836 ,14 ,850 ,1530 ,0,3,1,3,0,1,0,76.14,55.56 ,33.33
03,006,01,001,0028,68,956 ,11 ,967 ,1668 ,0,3,1,3,0,1,0,76.14,57.97 ,33.33
03,006,01,001,0029,69,958 ,6 ,964 ,1495 ,0,3,1,3,0,1,0,76.14,64.48 ,33.33
03,006,01,001,0030,70,724 ,12 ,736 ,1221 ,0,3,1,3,0,1,0,76.14,60.28 ,33.33
03,006,01,001,0030,71,719 ,2 ,721 ,1323 ,0,3,1,3,0,1,0,76.14,54.50 ,33.33
03,006,01,001,0030,72,892 ,6 ,898 ,1528 ,0,3,1,3,0,1,0,76.14,58.77 ,33.33
03,006,01,001,0031,73,859 ,10 ,869 ,1578 ,0,3,1,3,0,1,0,76.14,55.07 ,33.33
03,006,01,001,0031,74,883 ,10 ,893 ,1394 ,0,3,1,3,0,1,0,76.14,64.06 ,33.33
03,006,01,001,0032,75,886 ,17 ,903 ,1525 ,0,3,1,3,0,1,0,76.14,59.21 ,33.33
03,006,01,001,0032,76,794 ,10 ,804 ,1323 ,0,3,1,3,0,1,0,76.14,60.77 ,33.33
03,006,01,001,0033,77,1048 ,14 ,1062 ,1728 ,0,3,1,3,0,1,0,76.14,61.46 ,33.33
03,006,01,001,0034,78,692 ,4 ,696 ,1220 ,0,3,1,3,0,1,0,76.14,57.05 ,33.33
03,006,01,001,0034,79,716 ,12 ,728 ,1164 ,0,3,1,3,0,1,0,76.14,62.54 ,33.33
03,006,01,001,0035,80,486 ,5 ,491 ,761 ,0,3,1,3,0,1,0,76.14,64.52 ,33.33
03,006,01,001,0035,81,636 ,16 ,652 ,1080 ,0,3,1,3,0,1,0,76.14,60.37 ,33.33
03,006,01,001,0036,82,575 ,17 ,592 ,987 ,0,3,1,3,0,1,0,76.14,59.98 ,33.33
03,006,01,001,0036,83,622 ,7 ,629 ,1018 ,0,3,1,3,0,1,0,76.14,61.79 ,33.33
03,006,01,001,0036,84,553 ,4 ,557 ,932 ,0,3,1,3,0,1,0,76.14,59.76 ,33.33
03,006,01,002,0037,85,988 ,8 ,996 ,1576 ,0,3,1,3,0,1,0,76.14,63.20 ,33.33
03,006,01,002,0037,86,862 ,10 ,872 ,1421 ,0,3,1,3,0,1,0,76.14,61.37 ,33.33
03,006,01,002,0038,87,872 ,8 ,880 ,1526 ,0,3,1,3,0,1,0,76.14,57.67 ,33.33
03,006,01,002,0038,88,1018 ,14 ,1032 ,2219 ,0,3,1,3,0,1,0,76.14,46.51 ,33.33
03,006,01,002,0038,89,923 ,2 ,925 ,1644 ,0,3,1,3,0,1,0,76.14,56.27 ,33.33
03,006,01,002,0038,90,781 ,7 ,788 ,1446 ,0,3,1,3,0,1,0,76.14,54.50 ,33.33
03,006,01,002,0039,91,1136 ,11 ,1147 ,1899 ,0,3,1,3,0,1,0,76.14,60.40 ,33.33
03,006,01,002,0039,92,1115 ,13 ,1128 ,1917 ,0,3,1,3,0,1,0,76.14,58.84 ,33.33
03,006,01,002,0040,93,831 ,21 ,852 ,1443 ,0,3,1,3,0,1,0,76.14,59.04 ,33.33
03,006,01,002,0040,94,897 ,11 ,908 ,1386 ,0,3,1,3,0,1,0,76.14,65.51 ,33.33
03,006,01,002,0041,95,532 ,6 ,538 ,969 ,0,3,1,3,0,1,0,76.14,55.52 ,33.33
03,006,01,002,0041,96,620 ,4 ,624 ,1146 ,0,3,1,3,0,1,0,76.14,54.45 ,33.33
03,006,01,002,0041,97,624 ,4 ,628 ,1245 ,0,3,1,3,0,1,0,76.14,50.44 ,33.33
03,006,01,002,0041,98,630 ,11 ,641 ,1244 ,0,3,1,3,0,1,0,76.14,51.53 ,33.33
03,006,01,002,0041,99,516 ,4 ,520 ,919 ,0,3,1,3,0,1,0,76.14,56.58 ,33.33
03,006,01,002,0042,100,868 ,6 ,874 ,1656 ,0,3,1,3,0,1,0,76.14,52.78 ,33.33
03,006,01,002,0042,101,611 ,5 ,616 ,1047 ,0,3,1,3,0,1,0,76.14,58.83 ,33.33
03,006,01,002,0042,102,774 ,6 ,780 ,1426 ,0,3,1,3,0,1,0,76.14,54.70 ,33.33
03,006,01,002,0042,103,715 ,2 ,717 ,1341 ,0,3,1,3,0,1,0,76.14,53.47 ,33.33
03,006,01,002,0043,104,624 ,8 ,632 ,1075 ,0,3,1,3,0,1,0,76.14,58.79 ,33.33
03,006,01,002,0043,105,617 ,6 ,623 ,1075 ,0,3,1,3,0,1,0,76.14,57.95 ,33.33
03,006,01,002,0043,106,736 ,4 ,740 ,1398 ,0,3,1,3,0,1,0,76.14,52.93 ,33.33
03,006,01,002,0044,107,695 ,14 ,709 ,1163 ,0,3,1,3,0,1,0,76.14,60.96 ,33.33
03,006,01,002,0044,108,860 ,8 ,868 ,1451 ,0,3,1,3,0,1,0,76.14,59.82 ,33.33
03,006,01,002,0045,109,578 ,10 ,588 ,923 ,0,3,1,3,0,1,0,76.14,63.71 ,33.33
03,006,01,002,0045,110,904 ,4 ,908 ,1462 ,0,3,1,3,0,1,0,76.14,62.11 ,33.33
03,006,01,002,0045,111,589 ,18 ,607 ,1030 ,0,3,1,3,0,1,0,76.14,58.93 ,33.33
03,006,01,002,0046,112,705 ,0 ,705 ,1095 ,0,3,1,3,0,1,0,76.14,64.38 ,33.33
03,006,01,002,0046,113,676 ,3 ,679 ,1063 ,0,3,1,3,0,1,0,76.14,63.88 ,33.33
03,006,01,002,0047,114,622 ,9 ,631 ,940 ,0,3,1,3,0,1,0,76.14,67.13 ,33.33
03,006,01,002,0048,115,871 ,3 ,874 ,1792 ,0,3,1,3,0,1,0,76.14,48.77 ,33.33
03,006,01,002,0048,116,1061 ,9 ,1070 ,1928 ,0,3,1,3,0,1,0,76.14,55.50 ,33.33
03,006,01,002,0048,117,1022 ,6 ,1028 ,1823 ,0,3,1,3,0,1,0,76.14,56.39 ,33.33
03,006,01,002,0049,118,857 ,8 ,865 ,1574 ,0,3,1,3,0,1,0,76.14,54.96 ,33.33
03,006,01,002,0049,119,962 ,5 ,967 ,1692 ,0,3,1,3,0,1,0,76.14,57.15 ,33.33
03,006,01,002,0049,120,803 ,13 ,816 ,1537 ,0,3,1,3,0,1,0,76.14,53.09 ,33.33
03,006,01,002,0050,121,888 ,5 ,893 ,1521 ,0,3,1,3,0,1,0,76.14,58.71 ,33.33
03,006,01,002,0050,122,891 ,7 ,898 ,1417 ,0,3,1,3,0,1,0,76.14,63.37 ,33.33
03,006,01,002,0050,123,712 ,12 ,724 ,1337 ,0,3,1,3,0,1,0,76.14,54.15 ,33.33
03,006,01,002,0051,124,966 ,8 ,974 ,1794 ,0,3,1,3,0,1,0,76.14,54.29 ,33.33
03,006,01,002,0051,125,912 ,5 ,917 ,1545 ,0,3,1,3,0,1,0,76.14,59.35 ,33.33
03,006,01,002,0051,126,877 ,9 ,886 ,1661 ,0,3,1,3,0,1,0,76.14,53.34 ,33.33
03,006,01,002,0051,127,893 ,9 ,902 ,1746 ,0,3,1,3,0,1,0,76.14,51.66 ,33.33
03,006,01,002,0052,128,792 ,6 ,798 ,1477 ,0,3,1,3,0,1,0,76.14,54.03 ,33.33
03,006,01,002,0052,129,710 ,6 ,716 ,1372 ,0,3,1,3,0,1,0,76.14,52.19 ,33.33
03,006,01,002,0052,130,658 ,4 ,662 ,1219 ,0,3,1,3,0,1,0,76.14,54.31 ,33.33
03,006,01,002,0052,131,618 ,12 ,630 ,1066 ,0,3,1,3,0,1,0,76.14,59.10 ,33.33
03,006,01,002,0052,132,693 ,5 ,698 ,1231 ,0,3,1,3,0,1,0,76.14,56.70 ,33.33
03,006,01,002,0053,133,799 ,4 ,803 ,1452 ,0,3,1,3,0,1,0,76.14,55.30 ,33.33
03,006,01,002,0053,134,697 ,2 ,699 ,1287 ,0,3,1,3,0,1,0,76.14,54.31 ,33.33
03,006,01,002,0053,135,988 ,12 ,1000 ,1646 ,0,3,1,3,0,1,0,76.14,60.75 ,33.33
03,006,01,002,0053,136,743 ,6 ,749 ,1311 ,0,3,1,3,0,1,0,76.14,57.13 ,33.33
03,006,01,002,0054,137,574 ,13 ,587 ,1113 ,0,3,1,3,0,1,0,76.14,52.74 ,33.33
03,006,01,002,0054,138,646 ,5 ,651 ,1016 ,0,3,1,3,0,1,0,76.14,64.07 ,33.33
03,006,01,002,0054,139,620 ,6 ,626 ,1170 ,0,3,1,3,0,1,0,76.14,53.50 ,33.33
03,006,01,002,0055,140,1271 ,10 ,1281 ,2369 ,0,3,1,3,0,1,0,76.14,54.07 ,33.33
03,006,01,002,0055,141,1219 ,4 ,1223 ,2029 ,0,3,1,3,0,1,0,76.14,60.28 ,33.33
03,006,01,002,0056,142,1065 ,10 ,1075 ,1758 ,0,3,1,3,0,1,0,76.14,61.15 ,33.33
03,006,01,002,0056,143,893 ,9 ,902 ,1484 ,0,3,1,3,0,1,0,76.14,60.78 ,33.33
03,006,01,002,0057,144,842 ,8 ,850 ,1650 ,0,3,1,3,0,1,0,76.14,51.52 ,33.33
03,006,01,002,0057,145,831 ,7 ,838 ,1466 ,0,3,1,3,0,1,0,76.14,57.16 ,33.33
03,006,01,002,0057,146,867 ,8 ,875 ,1468 ,0,3,1,3,0,1,0,76.14,59.60 ,33.33
03,006,01,002,0058,147,796 ,4 ,800 ,1408 ,0,3,1,3,0,1,0,76.14,56.82 ,33.33
03,006,01,002,0058,148,818 ,3 ,821 ,1593 ,0,3,1,3,0,1,0,76.14,51.54 ,33.33
03,006,01,002,0058,149,964 ,4 ,968 ,1615 ,0,3,1,3,0,1,0,76.14,59.94 ,33.33
03,006,01,002,0058,150,753 ,14 ,767 ,1300 ,0,3,1,3,0,1,0,76.14,59.00 ,33.33
03,006,01,002,0059,151,880 ,4 ,884 ,1667 ,0,3,1,3,0,1,0,76.14,53.03 ,33.33
03,006,01,002,0059,152,786 ,7 ,793 ,1453 ,0,3,1,3,0,1,0,76.14,54.58 ,33.33
03,006,01,002,0059,153,987 ,7 ,994 ,1644 ,0,3,1,3,0,1,0,76.14,60.46 ,33.33
03,006,01,002,0059,154,853 ,6 ,859 ,1588 ,0,3,1,3,0,1,0,76.14,54.09 ,33.33
03,006,01,002,0059,155,789 ,5 ,794 ,1511 ,0,3,1,3,0,1,0,76.14,52.55 ,33.33
03,006,01,002,0060,156,663 ,4 ,667 ,1177 ,0,3,1,3,0,1,0,76.14,56.67 ,33.33
03,006,01,002,0060,157,708 ,7 ,715 ,1307 ,0,3,1,3,0,1,0,76.14,54.71 ,33.33
03,006,01,002,0060,158,704 ,6 ,710 ,1451 ,0,3,1,3,0,1,0,76.14,48.93 ,33.33
03,006,01,002,0061,159,841 ,8 ,849 ,1460 ,0,3,1,3,0,1,0,76.14,58.15 ,33.33
03,006,01,002,0061,160,741 ,5 ,746 ,1291 ,0,3,1,3,0,1,0,76.14,57.78 ,33.33
03,006,01,002,0061,161,720 ,10 ,730 ,1388 ,0,3,1,3,0,1,0,76.14,52.59 ,33.33
03,006,01,002,0062,162,845 ,11 ,856 ,1462 ,0,3,1,3,0,1,0,76.14,58.55 ,33.33
03,006,01,002,0062,163,944 ,13 ,957 ,1675 ,0,3,1,3,0,1,0,76.14,57.13 ,33.33
03,006,01,002,0062,164,932 ,5 ,937 ,1564 ,0,3,1,3,0,1,0,76.14,59.91 ,33.33
03,006,01,002,0062,165,800 ,5 ,805 ,1416 ,0,3,1,3,0,1,0,76.14,56.85 ,33.33
03,006,01,002,0063,166,795 ,7 ,802 ,1386 ,0,3,1,3,0,1,0,76.14,57.86 ,33.33
03,006,01,002,0063,167,686 ,8 ,694 ,1247 ,0,3,1,3,0,1,0,76.14,55.65 ,33.33
03,006,01,002,0063,168,718 ,4 ,722 ,1239 ,0,3,1,3,0,1,0,76.14,58.27 ,33.33
03,006,01,002,0063,169,727 ,7 ,734 ,1299 ,0,3,1,3,0,1,0,76.14,56.51 ,33.33
03,006,01,002,0063,170,766 ,4 ,770 ,1329 ,0,3,1,3,0,1,0,76.14,57.94 ,33.33
03,006,01,002,0063,171,688 ,2 ,690 ,1348 ,0,3,1,3,0,1,0,76.14,51.19 ,33.33
03,006,01,002,0063,172,620 ,7 ,627 ,1144 ,0,3,1,3,0,1,0,76.14,54.81 ,33.33
03,006,01,003,0064,173,1267 ,7 ,1274 ,1964 ,0,3,1,3,0,1,0,76.14,64.87 ,33.33
03,006,01,003,0064,174,1026 ,14 ,1040 ,1590 ,0,3,1,3,0,1,0,76.14,65.41 ,33.33
03,006,01,003,0064,175,1016 ,9 ,1025 ,1683 ,0,3,1,3,0,1,0,76.14,60.90 ,33.33
03,006,01,003,0065,176,936 ,5 ,941 ,1656 ,0,3,1,3,0,1,0,76.14,56.82 ,33.33
03,006,01,003,0065,177,829 ,7 ,836 ,1420 ,0,3,1,3,0,1,0,76.14,58.87 ,33.33
03,006,01,003,0065,178,636 ,4 ,640 ,1146 ,0,3,1,3,0,1,0,76.14,55.85 ,33.33
03,006,01,003,0065,179,1135 ,18 ,1153 ,1974 ,0,3,1,3,0,1,0,76.14,58.41 ,33.33
03,006,01,003,0065,180,956 ,11 ,967 ,1754 ,0,3,1,3,0,1,0,76.14,55.13 ,33.33
03,006,01,003,0066,181,871 ,4 ,875 ,1509 ,0,3,1,3,0,1,0,76.14,57.99 ,33.33
03,006,01,003,0066,182,843 ,7 ,850 ,1441 ,0,3,1,3,0,1,0,76.14,58.99 ,33.33
03,006,01,003,0066,183,928 ,7 ,935 ,1655 ,0,3,1,3,0,1,0,76.14,56.50 ,33.33
03,006,01,003,0066,184,923 ,10 ,933 ,1586 ,0,3,1,3,0,1,0,76.14,58.83 ,33.33
03,006,01,003,0067,185,686 ,7 ,693 ,1258 ,0,3,1,3,0,1,0,76.14,55.09 ,33.33
03,006,01,003,0067,186,875 ,9 ,884 ,1546 ,0,3,1,3,0,1,0,76.14,57.18 ,33.33
03,006,01,003,0067,187,731 ,3 ,734 ,1339 ,0,3,1,3,0,1,0,76.14,54.82 ,33.33
03,006,01,003,0067,188,748 ,5 ,753 ,1259 ,0,3,1,3,0,1,0,76.14,59.81 ,33.33
03,006,01,003,0067,189,858 ,11 ,869 ,1402 ,0,3,1,3,0,1,0,76.14,61.98 ,33.33
03,006,01,003,0068,190,1176 ,15 ,1191 ,1864 ,0,3,1,3,0,1,0,76.14,63.89 ,33.33
03,006,01,003,0068,191,1189 ,8 ,1197 ,1852 ,0,3,1,3,0,1,0,76.14,64.63 ,33.33
03,006,01,003,0068,192,1055 ,14 ,1069 ,1748 ,0,3,1,3,0,1,0,76.14,61.16 ,33.33
03,006,01,003,0068,193,1028 ,7 ,1035 ,1781 ,0,3,1,3,0,1,0,76.14,58.11 ,33.33
03,006,01,003,0068,194,1204 ,8 ,1212 ,2065 ,0,3,1,3,0,1,0,76.14,58.69 ,33.33
03,006,01,003,0069,195,891 ,12 ,903 ,1591 ,0,3,1,3,0,1,0,76.14,56.76 ,33.33
03,006,01,003,0069,196,886 ,13 ,899 ,1448 ,0,3,1,3,0,1,0,76.14,62.09 ,33.33
03,006,01,003,0069,197,1212 ,10 ,1222 ,1979 ,0,3,1,3,0,1,0,76.14,61.75 ,33.33
03,006,01,003,0070,198,753 ,5 ,758 ,1135 ,0,3,1,3,0,1,0,76.14,66.78 ,33.33
03,006,01,003,0070,199,597 ,6 ,603 ,1039 ,0,3,1,3,0,1,0,76.14,58.04 ,33.33
03,006,01,003,0070,200,789 ,7 ,796 ,1262 ,0,3,1,3,0,1,0,76.14,63.07 ,33.33
03,006,01,003,0070,201,894 ,7 ,901 ,1333 ,0,3,1,3,0,1,0,76.14,67.59 ,33.33
03,006,01,003,0070,202,617 ,6 ,623 ,959 ,0,3,1,3,0,1,0,76.14,64.96 ,33.33
03,006,01,003,0070,203,765 ,7 ,772 ,1275 ,0,3,1,3,0,1,0,76.14,60.55 ,33.33
03,006,01,003,0071,204,594 ,5 ,599 ,1026 ,0,3,1,3,0,1,0,76.14,58.38 ,33.33
03,006,01,003,0071,205,1280 ,20 ,1300 ,2129 ,0,3,1,3,0,1,0,76.14,61.06 ,33.33
03,006,01,003,0071,206,1160 ,12 ,1172 ,1862 ,0,3,1,3,0,1,0,76.14,62.94 ,33.33
03,006,01,003,0071,207,1198 ,11 ,1209 ,1970 ,0,3,1,3,0,1,0,76.14,61.37 ,33.33
03,006,01,003,0072,208,970 ,8 ,978 ,1589 ,0,3,1,3,0,1,0,76.14,61.55 ,33.33
03,006,01,003,0072,209,756 ,9 ,765 ,1198 ,0,3,1,3,0,1,0,76.14,63.86 ,33.33
03,006,01,003,0072,210,1015 ,8 ,1023 ,1641 ,0,3,1,3,0,1,0,76.14,62.34 ,33.33
03,006,01,003,0072,211,1189 ,11 ,1200 ,2453 ,0,3,1,3,0,1,0,76.14,48.92 ,33.33
03,006,01,003,0073,212,832 ,7 ,839 ,1489 ,0,3,1,3,0,1,0,76.14,56.35 ,33.33
03,006,01,003,0073,213,1026 ,7 ,1033 ,1811 ,0,3,1,3,0,1,0,76.14,57.04 ,33.33
03,006,01,003,0073,214,1143 ,7 ,1150 ,2236 ,0,3,1,3,0,1,0,76.14,51.43 ,33.33
03,006,01,003,0073,215,1034 ,10 ,1044 ,1903 ,0,3,1,3,0,1,0,76.14,54.86 ,33.33
03,006,01,003,0073,216,897 ,11 ,908 ,1700 ,0,3,1,3,0,1,0,76.14,53.41 ,33.33
03,006,01,003,0073,217,1167 ,22 ,1189 ,1907 ,0,3,1,3,0,1,0,76.14,62.35 ,33.33
03,006,01,003,0073,218,903 ,11 ,914 ,1528 ,0,3,1,3,0,1,0,76.14,59.82 ,33.33
03,006,01,003,0074,219,709 ,8 ,717 ,1214 ,0,3,1,3,0,1,0,76.14,59.06 ,33.33
03,006,01,003,0074,220,862 ,6 ,868 ,1506 ,0,3,1,3,0,1,0,76.14,57.64 ,33.33
03,006,01,003,0074,221,740 ,6 ,746 ,1289 ,0,3,1,3,0,1,0,76.14,57.87 ,33.33
03,006,01,003,0074,222,609 ,6 ,615 ,1069 ,0,3,1,3,0,1,0,76.14,57.53 ,33.33
03,006,01,003,0074,223,803 ,9 ,812 ,1603 ,0,3,1,3,0,1,0,76.14,50.66 ,33.33
03,006,01,003,0074,224,513 ,11 ,524 ,1107 ,0,3,1,3,0,1,0,76.14,47.34 ,33.33
03,006,01,003,0074,225,525 ,4 ,529 ,1218 ,0,3,1,3,0,1,0,76.14,43.43 ,33.33
03,006,01,003,0074,226,633 ,7 ,640 ,1339 ,0,3,1,3,0,1,0,76.14,47.80 ,33.33
03,006,01,003,0074,227,724 ,3 ,727 ,1388 ,0,3,1,3,0,1,0,76.14,52.38 ,33.33
03,006,01,003,0075,228,1238 ,6 ,1244 ,2014 ,0,3,1,3,0,1,0,76.14,61.77 ,33.33
03,006,01,003,0075,229,1085 ,10 ,1095 ,1950 ,0,3,1,3,0,1,0,76.14,56.15 ,33.33
03,006,01,003,0075,230,1109 ,11 ,1120 ,1963 ,0,3,1,3,0,1,0,76.14,57.06 ,33.33
03,006,01,003,0075,231,1040 ,20 ,1060 ,1811 ,0,3,1,3,0,1,0,76.14,58.53 ,33.33
03,006,01,003,0075,232,869 ,8 ,877 ,1591 ,0,3,1,3,0,1,0,76.14,55.12 ,33.33
03,006,01,003,0076,233,1108 ,10 ,1118 ,1773 ,0,3,1,3,0,1,0,76.14,63.06 ,33.33
03,006,01,003,0076,234,587 ,10 ,597 ,1032 ,0,3,1,3,0,1,0,76.14,57.85 ,33.33
03,006,01,003,0076,235,834 ,6 ,840 ,1441 ,0,3,1,3,0,1,0,76.14,58.29 ,33.33
03,006,01,003,0077,236,706 ,12 ,718 ,1113 ,0,3,1,3,0,1,0,76.14,64.51 ,33.33
03,006,01,003,0077,237,713 ,8 ,721 ,1102 ,0,3,1,3,0,1,0,76.14,65.43 ,33.33
03,006,01,003,0077,238,674 ,9 ,683 ,1056 ,0,3,1,3,0,1,0,76.14,64.68 ,33.33
03,006,01,003,0078,239,776 ,4 ,780 ,1176 ,0,3,1,3,0,1,0,76.14,66.33 ,33.33
03,006,01,003,0079,240,1018 ,6 ,1024 ,1602 ,0,3,1,3,0,1,0,76.14,63.92 ,33.33
03,006,01,003,0079,241,976 ,4 ,980 ,1573 ,0,3,1,3,0,1,0,76.14,62.30 ,33.33
03,006,01,003,0079,242,892 ,3 ,895 ,1464 ,0,3,1,3,0,1,0,76.14,61.13 ,33.33
03,006,01,003,0079,243,713 ,6 ,719 ,1123 ,0,3,1,3,0,1,0,76.14,64.02 ,33.33
03,006,01,003,0080,244,586 ,4 ,590 ,810 ,0,3,1,3,0,1,0,76.14,72.84 ,33.33
03,006,01,003,0081,245,968 ,13 ,981 ,1540 ,0,3,1,3,0,1,0,76.14,63.70 ,33.33
03,006,01,003,0081,246,1052 ,8 ,1060 ,1818 ,0,3,1,3,0,1,0,76.14,58.31 ,33.33
03,006,01,003,0081,247,770 ,3 ,773 ,1302 ,0,3,1,3,0,1,0,76.14,59.37 ,33.33
03,006,01,003,0082,248,1167 ,9 ,1176 ,1856 ,0,3,1,3,0,1,0,76.14,63.36 ,33.33
03,006,01,003,0082,249,959 ,13 ,972 ,1726 ,0,3,1,3,0,1,0,76.14,56.32 ,33.33
03,006,01,004,0083,250,762 ,10 ,772 ,1229 ,0,3,1,3,0,1,0,76.14,62.82 ,33.33
03,006,01,004,0084,251,505 ,5 ,510 ,810 ,0,3,1,3,0,1,0,76.14,62.96 ,33.33
03,006,01,004,0085,252,741 ,10 ,751 ,1268 ,0,3,1,3,0,1,0,76.14,59.23 ,33.33
03,006,01,004,0086,253,499 ,7 ,506 ,792 ,0,3,1,3,0,1,0,76.14,63.89 ,33.33
03,006,01,004,0086,254,652 ,9 ,661 ,1097 ,0,3,1,3,0,1,0,76.14,60.26 ,33.33
03,006,01,004,0087,255,662 ,5 ,667 ,1123 ,0,3,1,3,0,1,0,76.14,59.39 ,33.33
03,006,01,004,0087,256,653 ,5 ,658 ,1065 ,0,3,1,3,0,1,0,76.14,61.78 ,33.33
03,006,01,004,0088,257,623 ,4 ,627 ,954 ,0,3,1,3,0,1,0,76.14,65.72 ,33.33
03,006,01,004,0089,258,868 ,5 ,873 ,1460 ,0,3,1,3,0,1,0,76.14,59.79 ,33.33
03,006,01,004,0090,259,822 ,7 ,829 ,1415 ,0,3,1,3,0,1,0,76.14,58.59 ,33.33
03,006,01,004,0090,260,624 ,4 ,628 ,1018 ,0,3,1,3,0,1,0,76.14,61.69 ,33.33
03,006,01,004,0090,261,458 ,7 ,465 ,799 ,0,3,1,3,0,1,0,76.14,58.20 ,33.33
03,006,01,004,0091,262,547 ,6 ,553 ,924 ,0,3,1,3,0,1,0,76.14,59.85 ,33.33
03,006,01,004,0091,263,512 ,4 ,516 ,918 ,0,3,1,3,0,1,0,76.14,56.21 ,33.33
03,006,01,004,0092,264,695 ,12 ,707 ,1272 ,0,3,1,3,0,1,0,76.14,55.58 ,33.33
03,006,01,004,0092,265,1107 ,19 ,1126 ,1876 ,0,3,1,3,0,1,0,76.14,60.02 ,33.33
03,006,01,004,0093,266,777 ,9 ,786 ,1422 ,0,3,1,3,0,1,0,76.14,55.27 ,33.33
03,006,01,004,0094,267,786 ,18 ,804 ,1347 ,0,3,1,3,0,1,0,76.14,59.69 ,33.33
03,006,01,004,0094,268,941 ,16 ,957 ,1637 ,0,3,1,3,0,1,0,76.14,58.46 ,33.33
03,006,01,004,0094,269,948 ,14 ,962 ,1607 ,0,3,1,3,0,1,0,76.14,59.86 ,33.33
03,006,01,004,0095,270,880 ,12 ,892 ,1468 ,0,3,1,3,0,1,0,76.14,60.76 ,33.33
03,006,01,004,0096,271,629 ,6 ,635 ,965 ,0,3,1,3,0,1,0,76.14,65.80 ,33.33
03,006,01,004,0097,272,578 ,3 ,581 ,888 ,0,3,1,3,0,1,0,76.14,65.43 ,33.33
03,006,01,004,0098,273,651 ,7 ,658 ,1035 ,0,3,1,3,0,1,0,76.14,63.57 ,33.33
03,006,01,004,0098,274,553 ,2 ,555 ,875 ,0,3,1,3,0,1,0,76.14,63.43 ,33.33
03,006,01,004,0099,275,728 ,10 ,738 ,1397 ,0,3,1,3,0,1,0,76.14,52.83 ,33.33
03,006,01,004,0100,276,501 ,7 ,508 ,871 ,0,3,1,3,0,1,0,76.14,58.32 ,33.33
03,006,01,004,0100,277,590 ,7 ,597 ,1028 ,0,3,1,3,0,1,0,76.14,58.07 ,33.33
03,006,01,004,0101,278,655 ,7 ,662 ,1110 ,0,3,1,3,0,1,0,76.14,59.64 ,33.33
03,006,01,004,0101,279,363 ,5 ,368 ,636 ,0,3,1,3,0,1,0,76.14,57.86 ,33.33
03,006,01,004,0102,280,969 ,15 ,984 ,1647 ,0,3,1,3,0,1,0,76.14,59.74 ,33.33
03,006,01,004,0103,281,691 ,5 ,696 ,1218 ,0,3,1,3,0,1,0,76.14,57.14 ,33.33
03,006,01,004,0104,282,950 ,17 ,967 ,1757 ,0,3,1,3,0,1,0,76.14,55.04 ,33.33
03,006,01,004,0105,283,433 ,4 ,437 ,746 ,0,3,1,3,0,1,0,76.14,58.58 ,33.33
03,006,01,004,0106,284,439 ,3 ,442 ,653 ,0,3,1,3,0,1,0,76.14,67.69 ,33.33
03,006,01,004,0107,285,758 ,8 ,766 ,1399 ,0,3,1,3,0,1,0,76.14,54.75 ,33.33
03,006,01,005,0108,286,811 ,8 ,819 ,1287 ,0,3,1,3,0,1,0,76.14,63.64 ,33.33
03,006,01,005,0109,287,713 ,6 ,719 ,1203 ,0,3,1,3,0,1,0,76.14,59.77 ,33.33
03,006,01,005,0110,288,479 ,5 ,484 ,775 ,0,3,1,3,0,1,0,76.14,62.45 ,33.33
03,006,01,005,0110,289,506 ,7 ,513 ,871 ,0,3,1,3,0,1,0,76.14,58.90 ,33.33
03,006,01,005,0111,290,497 ,6 ,503 ,779 ,0,3,1,3,0,1,0,76.14,64.57 ,33.33
03,006,01,005,0112,291,581 ,7 ,588 ,911 ,0,3,1,3,0,1,0,76.14,64.54 ,33.33
03,006,01,005,0112,292,658 ,3 ,661 ,1077 ,0,3,1,3,0,1,0,76.14,61.37 ,33.33
03,006,01,005,0113,293,602 ,7 ,609 ,933 ,0,3,1,3,0,1,0,76.14,65.27 ,33.33
03,006,01,005,0113,294,635 ,6 ,641 ,1053 ,0,3,1,3,0,1,0,76.14,60.87 ,33.33
03,006,01,005,0114,295,587 ,7 ,594 ,1020 ,0,3,1,3,0,1,0,76.14,58.24 ,33.33
03,006,01,005,0114,296,685 ,10 ,695 ,1078 ,0,3,1,3,0,1,0,76.14,64.47 ,33.33
03,006,01,005,0114,297,659 ,6 ,665 ,1033 ,0,3,1,3,0,1,0,76.14,64.38 ,33.33
03,006,01,005,0115,298,548 ,3 ,551 ,890 ,0,3,1,3,0,1,0,76.14,61.91 ,33.33
03,006,01,005,0115,299,617 ,1 ,618 ,972 ,0,3,1,3,0,1,0,76.14,63.58 ,33.33
03,006,01,005,0116,300,596 ,11 ,607 ,1082 ,0,3,1,3,0,1,0,76.14,56.10 ,33.33
03,006,01,005,0116,301,755 ,8 ,763 ,1212 ,0,3,1,3,0,1,0,76.14,62.95 ,33.33
03,006,01,005,0116,302,658 ,9 ,667 ,1183 ,0,3,1,3,0,1,0,76.14,56.38 ,33.33
03,006,01,005,0117,303,544 ,9 ,553 ,863 ,0,3,1,3,0,1,0,76.14,64.08 ,33.33
03,006,01,005,0118,304,585 ,2 ,587 ,936 ,0,3,1,3,0,1,0,76.14,62.71 ,33.33
03,006,01,005,0119,305,767 ,10 ,777 ,1278 ,0,3,1,3,0,1,0,76.14,60.80 ,33.33
03,006,01,005,0119,306,768 ,13 ,781 ,1373 ,0,3,1,3,0,1,0,76.14,56.88 ,33.33
03,006,01,005,0120,307,838 ,9 ,847 ,1110 ,0,3,1,3,0,1,0,76.14,76.31 ,33.33
03,006,01,005,0121,308,715 ,4 ,719 ,1096 ,0,3,1,3,0,1,0,76.14,65.60 ,33.33
03,006,01,005,0122,309,561 ,9 ,570 ,826 ,0,3,1,3,0,1,0,76.14,69.01 ,33.33
03,006,01,005,0122,310,463 ,6 ,469 ,763 ,0,3,1,3,0,1,0,76.14,61.47 ,33.33
03,006,01,005,0123,311,724 ,10 ,734 ,1191 ,0,3,1,3,0,1,0,76.14,61.63 ,33.33
03,006,01,005,0123,312,693 ,5 ,698 ,1103 ,0,3,1,3,0,1,0,76.14,63.28 ,33.33
03,006,01,005,0123,313,681 ,9 ,690 ,1142 ,0,3,1,3,0,1,0,76.14,60.42 ,33.33
03,006,01,005,0123,314,672 ,7 ,679 ,1191 ,0,3,1,3,0,1,0,76.14,57.01 ,33.33
03,006,01,005,0124,315,871 ,11 ,882 ,1469 ,0,3,1,3,0,1,0,76.14,60.04 ,33.33
03,006,01,005,0125,316,485 ,3 ,488 ,783 ,0,3,1,3,0,1,0,76.14,62.32 ,33.33
03,006,01,005,0125,317,433 ,3 ,436 ,803 ,0,3,1,3,0,1,0,76.14,54.30 ,33.33
03,006,01,005,0126,318,619 ,13 ,632 ,1066 ,0,3,1,3,0,1,0,76.14,59.29 ,33.33
03,006,01,005,0127,319,624 ,7 ,631 ,1033 ,0,3,1,3,0,1,0,76.14,61.08 ,33.33
03,006,01,005,0127,320,674 ,8 ,682 ,1068 ,0,3,1,3,0,1,0,76.14,63.86 ,33.33
03,006,01,005,0127,321,780 ,7 ,787 ,1319 ,0,3,1,3,0,1,0,76.14,59.67 ,33.33
03,006,01,005,0128,322,716 ,5 ,721 ,1231 ,0,3,1,3,0,1,0,76.14,58.57 ,33.33
03,006,01,005,0129,323,742 ,4 ,746 ,1160 ,0,3,1,3,0,1,0,76.14,64.31 ,33.33
03,006,01,005,0129,324,662 ,12 ,674 ,1071 ,0,3,1,3,0,1,0,76.14,62.93 ,33.33
03,006,01,005,0129,325,564 ,11 ,575 ,1024 ,0,3,1,3,0,1,0,76.14,56.15 ,33.33
03,006,01,005,0130,326,695 ,11 ,706 ,1118 ,0,3,1,3,0,1,0,76.14,63.15 ,33.33
03,006,01,005,0130,327,736 ,14 ,750 ,1258 ,0,3,1,3,0,1,0,76.14,59.62 ,33.33
03,006,01,005,0131,328,556 ,8 ,564 ,1020 ,0,3,1,3,0,1,0,76.14,55.29 ,33.33
03,006,01,005,0131,329,497 ,9 ,506 ,946 ,0,3,1,3,0,1,0,76.14,53.49 ,33.33
03,006,01,005,0131,330,544 ,4 ,548 ,1021 ,0,3,1,3,0,1,0,76.14,53.67 ,33.33
03,006,01,005,0131,331,605 ,9 ,614 ,1135 ,0,3,1,3,0,1,0,76.14,54.10 ,33.33
03,006,01,005,0132,332,383 ,5 ,388 ,602 ,0,3,1,3,0,1,0,76.14,64.45 ,33.33
03,006,01,005,0132,333,506 ,8 ,514 ,784 ,0,3,1,3,0,1,0,76.14,65.56 ,33.33
03,006,01,005,0133,334,465 ,5 ,470 ,788 ,0,3,1,3,0,1,0,76.14,59.64 ,33.33
03,006,01,005,0133,335,463 ,4 ,467 ,707 ,0,3,1,3,0,1,0,76.14,66.05 ,33.33
03,006,01,005,0134,336,720 ,6 ,726 ,1244 ,0,3,1,3,0,1,0,76.14,58.36 ,33.33
03,006,01,005,0135,337,722 ,10 ,732 ,1081 ,0,3,1,3,0,1,0,76.14,67.72 ,33.33
03,006,01,005,0136,338,856 ,8 ,864 ,1320 ,0,3,1,3,0,1,0,76.14,65.45 ,33.33
03,006,01,006,0137,339,810 ,10 ,820 ,1202 ,0,3,1,3,0,1,0,76.14,68.22 ,33.33
03,006,01,006,0138,340,707 ,4 ,711 ,1075 ,0,3,1,3,0,1,0,76.14,66.14 ,33.33
03,006,01,006,0139,341,579 ,6 ,585 ,961 ,0,3,1,3,0,1,0,76.14,60.87 ,33.33
03,006,01,006,0139,342,670 ,4 ,674 ,1081 ,0,3,1,3,0,1,0,76.14,62.35 ,33.33
03,006,01,006,0140,343,465 ,5 ,470 ,730 ,0,3,1,3,0,1,0,76.14,64.38 ,33.33
03,006,01,006,0141,344,565 ,4 ,569 ,850 ,0,3,1,3,0,1,0,76.14,66.94 ,33.33
03,006,01,006,0141,345,616 ,3 ,619 ,934 ,0,3,1,3,0,1,0,76.14,66.27 ,33.33
03,006,01,006,0142,346,945 ,6 ,951 ,1478 ,0,3,1,3,0,1,0,76.14,64.34 ,33.33
03,006,01,006,0143,347,508 ,4 ,512 ,724 ,0,3,1,3,0,1,0,76.14,70.72 ,33.33
03,006,01,006,0144,348,329 ,2 ,331 ,449 ,0,3,1,3,0,1,0,76.14,73.72 ,33.33
03,006,01,006,0145,349,906 ,17 ,923 ,1429 ,0,3,1,3,0,1,0,76.14,64.59 ,33.33
03,006,01,006,0145,350,633 ,7 ,640 ,981 ,0,3,1,3,0,1,0,76.14,65.24 ,33.33
03,006,01,006,0146,351,712 ,8 ,720 ,1179 ,0,3,1,3,0,1,0,76.14,61.07 ,33.33
03,006,01,006,0146,352,907 ,5 ,912 ,1477 ,0,3,1,3,0,1,0,76.14,61.75 ,33.33
03,006,01,006,0146,353,878 ,8 ,886 ,1359 ,0,3,1,3,0,1,0,76.14,65.19 ,33.33
03,006,01,006,0146,354,859 ,7 ,866 ,1449 ,0,3,1,3,0,1,0,76.14,59.77 ,33.33
03,006,01,006,0147,355,755 ,12 ,767 ,1296 ,0,3,1,3,0,1,0,76.14,59.18 ,33.33
03,006,01,006,0148,356,946 ,9 ,955 ,1488 ,0,3,1,3,0,1,0,76.14,64.18 ,33.33
03,006,01,006,0149,357,729 ,6 ,735 ,1252 ,0,3,1,3,0,1,0,76.14,58.71 ,33.33
03,006,01,006,0149,358,667 ,10 ,677 ,1211 ,0,3,1,3,0,1,0,76.14,55.90 ,33.33
03,006,01,006,0149,359,663 ,5 ,668 ,1159 ,0,3,1,3,0,1,0,76.14,57.64 ,33.33
03,006,01,006,0150,360,845 ,8 ,853 ,1374 ,0,3,1,3,0,1,0,76.14,62.08 ,33.33
03,006,01,006,0150,361,870 ,10 ,880 ,1396 ,0,3,1,3,0,1,0,76.14,63.04 ,33.33
03,006,01,006,0151,362,703 ,12 ,715 ,1078 ,0,3,1,3,0,1,0,76.14,66.33 ,33.33
03,006,01,006,0151,363,474 ,6 ,480 ,783 ,0,3,1,3,0,1,0,76.14,61.30 ,33.33
03,006,01,006,0152,364,794 ,7 ,801 ,1347 ,0,3,1,3,0,1,0,76.14,59.47 ,33.33
03,006,01,006,0152,365,605 ,9 ,614 ,1032 ,0,3,1,3,0,1,0,76.14,59.50 ,33.33
03,006,01,006,0152,366,710 ,10 ,720 ,1286 ,0,3,1,3,0,1,0,76.14,55.99 ,33.33
03,006,01,006,0153,367,436 ,6 ,442 ,697 ,0,3,1,3,0,1,0,76.14,63.41 ,33.33
03,006,01,006,0153,368,541 ,3 ,544 ,821 ,0,3,1,3,0,1,0,76.14,66.26 ,33.33
03,006,01,006,0154,369,800 ,15 ,815 ,1312 ,0,3,1,3,0,1,0,76.14,62.12 ,33.33
03,006,01,006,0155,370,894 ,8 ,902 ,1317 ,0,3,1,3,0,1,0,76.14,68.49 ,33.33
03,006,01,006,0156,371,728 ,12 ,740 ,1275 ,0,3,1,3,0,1,0,76.14,58.04 ,33.33
03,006,01,006,0157,372,691 ,12 ,703 ,1117 ,0,3,1,3,0,1,0,76.14,62.94 ,33.33
03,006,01,006,0158,373,853 ,5 ,858 ,1285 ,0,3,1,3,0,1,0,76.14,66.77 ,33.33
03,006,01,006,0159,374,574 ,3 ,577 ,1088 ,0,3,1,3,0,1,0,76.14,53.03 ,33.33
03,006,01,006,0159,375,513 ,4 ,517 ,905 ,0,3,1,3,0,1,0,76.14,57.13 ,33.33
03,006,01,006,0160,376,646 ,5 ,651 ,1050 ,0,3,1,3,0,1,0,76.14,62.00 ,33.33
03,006,01,006,0160,377,638 ,3 ,641 ,1136 ,0,3,1,3,0,1,0,76.14,56.43 ,33.33
03,006,01,006,0161,378,529 ,5 ,534 ,827 ,0,3,1,3,0,1,0,76.14,64.57 ,33.33
03,006,01,006,0161,379,526 ,7 ,533 ,915 ,0,3,1,3,0,1,0,76.14,58.25 ,33.33
03,006,01,006,0162,380,664 ,13 ,677 ,1157 ,0,3,1,3,0,1,0,76.14,58.51 ,33.33
03,006,01,006,0162,381,518 ,5 ,523 ,998 ,0,3,1,3,0,1,0,76.14,52.40 ,33.33
03,006,01,006,0163,382,895 ,7 ,902 ,1420 ,0,3,1,3,0,1,0,76.14,63.52 ,33.33
03,006,01,006,0163,383,909 ,9 ,918 ,1448 ,0,3,1,3,0,1,0,76.14,63.40 ,33.33
03,006,01,006,0163,384,792 ,10 ,802 ,1283 ,0,3,1,3,0,1,0,76.14,62.51 ,33.33
03,006,01,006,0163,385,963 ,9 ,972 ,1694 ,0,3,1,3,0,1,0,76.14,57.38 ,33.33
03,006,01,006,0164,386,505 ,6 ,511 ,804 ,0,3,1,3,0,1,0,76.14,63.56 ,33.33
03,006,01,006,0164,387,456 ,3 ,459 ,801 ,0,3,1,3,0,1,0,76.14,57.30 ,33.33
03,006,01,006,0164,388,792 ,13 ,805 ,1266 ,0,3,1,3,0,1,0,76.14,63.59 ,33.33
03,006,01,006,0165,389,806 ,12 ,818 ,1103 ,0,3,1,3,0,1,0,76.14,74.16 ,33.33
03,006,01,006,0166,390,1024 ,14 ,1038 ,1328 ,0,3,1,3,0,1,0,76.14,78.16 ,33.33
03,006,01,006,0167,391,669 ,11 ,680 ,1031 ,0,3,1,3,0,1,0,76.14,65.96 ,33.33
03,006,01,006,0168,392,750 ,7 ,757 ,1219 ,0,3,1,3,0,1,0,76.14,62.10 ,33.33
03,006,01,007,0169,393,806 ,10 ,816 ,1361 ,0,3,1,3,0,1,0,76.14,59.96 ,33.33
03,006,01,007,0170,394,630 ,3 ,633 ,955 ,0,3,1,3,0,1,0,76.14,66.28 ,33.33
03,006,01,007,0170,395,840 ,9 ,849 ,1223 ,0,3,1,3,0,1,0,76.14,69.42 ,33.33
03,006,01,007,0171,396,706 ,7 ,713 ,1160 ,0,3,1,3,0,1,0,76.14,61.47 ,33.33
03,006,01,007,0172,397,382 ,2 ,384 ,540 ,0,3,1,3,0,1,0,76.14,71.11 ,33.33
03,006,01,007,0173,398,688 ,17 ,705 ,1198 ,0,3,1,3,0,1,0,76.14,58.85 ,33.33
03,006,01,007,0173,399,700 ,8 ,708 ,1192 ,0,3,1,3,0,1,0,76.14,59.40 ,33.33
03,006,01,007,0174,400,680 ,12 ,692 ,1108 ,0,3,1,3,0,1,0,76.14,62.45 ,33.33
03,006,01,007,0174,401,930 ,5 ,935 ,1535 ,0,3,1,3,0,1,0,76.14,60.91 ,33.33
03,006,01,007,0175,402,640 ,8 ,648 ,1015 ,0,3,1,3,0,1,0,76.14,63.84 ,33.33
03,006,01,007,0175,403,728 ,5 ,733 ,1260 ,0,3,1,3,0,1,0,76.14,58.17 ,33.33
03,006,01,007,0175,404,872 ,5 ,877 ,1377 ,0,3,1,3,0,1,0,76.14,63.69 ,33.33
03,006,01,007,0176,405,713 ,5 ,718 ,1232 ,0,3,1,3,0,1,0,76.14,58.28 ,33.33
03,006,01,007,0176,406,727 ,8 ,735 ,1270 ,0,3,1,3,0,1,0,76.14,57.87 ,33.33
03,006,01,007,0176,407,789 ,6 ,795 ,1369 ,0,3,1,3,0,1,0,76.14,58.07 ,33.33
03,006,01,007,0177,408,980 ,10 ,990 ,1632 ,0,3,1,3,0,1,0,76.14,60.66 ,33.33
03,006,01,007,0177,409,657 ,4 ,661 ,1078 ,0,3,1,3,0,1,0,76.14,61.32 ,33.33
03,006,01,007,0177,410,613 ,4 ,617 ,1045 ,0,3,1,3,0,1,0,76.14,59.04 ,33.33
03,006,01,007,0177,411,844 ,16 ,860 ,1373 ,0,3,1,3,0,1,0,76.14,62.64 ,33.33
03,006,01,007,0178,412,834 ,15 ,849 ,1296 ,0,3,1,3,0,1,0,76.14,65.51 ,33.33
03,006,01,007,0178,413,846 ,10 ,856 ,1407 ,0,3,1,3,0,1,0,76.14,60.84 ,33.33
03,006,01,007,0178,414,851 ,17 ,868 ,1449 ,0,3,1,3,0,1,0,76.14,59.90 ,33.33
03,006,01,007,0178,415,845 ,4 ,849 ,1393 ,0,3,1,3,0,1,0,76.14,60.95 ,33.33
03,006,01,007,0179,416,543 ,5 ,548 ,844 ,0,3,1,3,0,1,0,76.14,64.93 ,33.33
03,006,01,007,0180,417,827 ,7 ,834 ,1436 ,0,3,1,3,0,1,0,76.14,58.08 ,33.33
03,006,01,007,0180,418,517 ,1 ,518 ,864 ,0,3,1,3,0,1,0,76.14,59.95 ,33.33
03,006,01,007,0181,419,639 ,2 ,641 ,1085 ,0,3,1,3,0,1,0,76.14,59.08 ,33.33
03,006,01,007,0181,420,590 ,5 ,595 ,1054 ,0,3,1,3,0,1,0,76.14,56.45 ,33.33
03,006,01,007,0181,421,709 ,12 ,721 ,1246 ,0,3,1,3,0,1,0,76.14,57.87 ,33.33
03,006,01,007,0182,422,809 ,8 ,817 ,1244 ,0,3,1,3,0,1,0,76.14,65.68 ,33.33
03,006,01,007,0183,423,686 ,2 ,688 ,1143 ,0,3,1,3,0,1,0,76.14,60.19 ,33.33
03,006,01,007,0183,424,700 ,12 ,712 ,1238 ,0,3,1,3,0,1,0,76.14,57.51 ,33.33
03,006,01,007,0184,425,631 ,11 ,642 ,962 ,0,3,1,3,0,1,0,76.14,66.74 ,33.33
03,006,01,007,0184,426,554 ,11 ,565 ,908 ,0,3,1,3,0,1,0,76.14,62.22 ,33.33
03,006,01,007,0185,427,1426 ,16 ,1442 ,2171 ,0,3,1,3,0,1,0,76.14,66.42 ,33.33
03,006,01,007,0186,428,758 ,11 ,769 ,1153 ,0,3,1,3,0,1,0,76.14,66.70 ,33.33
03,006,01,007,0186,429,848 ,5 ,853 ,1275 ,0,3,1,3,0,1,0,76.14,66.90 ,33.33
03,006,01,007,0187,430,770 ,4 ,774 ,1301 ,0,3,1,3,0,1,0,76.14,59.49 ,33.33
03,006,01,007,0187,431,513 ,7 ,520 ,821 ,0,3,1,3,0,1,0,76.14,63.34 ,33.33
03,006,01,007,0187,432,834 ,8 ,842 ,1295 ,0,3,1,3,0,1,0,76.14,65.02 ,33.33
03,006,01,007,0188,433,652 ,7 ,659 ,1084 ,0,3,1,3,0,1,0,76.14,60.79 ,33.33
03,006,01,007,0188,434,447 ,6 ,453 ,761 ,0,3,1,3,0,1,0,76.14,59.53 ,33.33
03,006,01,007,0189,435,654 ,15 ,669 ,1049 ,0,3,1,3,0,1,0,76.14,63.78 ,33.33
03,006,01,007,0189,436,536 ,9 ,545 ,941 ,0,3,1,3,0,1,0,76.14,57.92 ,33.33
03,006,01,008,0190,437,642 ,21 ,663 ,1069 ,0,3,1,3,0,1,0,76.14,62.02 ,33.33
03,006,01,008,0190,438,830 ,2 ,832 ,1546 ,0,3,1,3,0,1,0,76.14,53.82 ,33.33
03,006,01,008,0191,439,555 ,26 ,581 ,888 ,0,3,1,3,0,1,0,76.14,65.43 ,33.33
03,006,01,008,0191,440,664 ,5 ,669 ,1095 ,0,3,1,3,0,1,0,76.14,61.10 ,33.33
03,006,01,008,0192,441,592 ,8 ,600 ,1051 ,0,3,1,3,0,1,0,76.14,57.09 ,33.33
03,006,01,008,0192,442,631 ,6 ,637 ,1123 ,0,3,1,3,0,1,0,76.14,56.72 ,33.33
03,006,01,008,0192,443,636 ,8 ,644 ,1156 ,0,3,1,3,0,1,0,76.14,55.71 ,33.33
03,006,01,008,0193,444,330 ,4 ,334 ,552 ,0,3,1,3,0,1,0,76.14,60.51 ,33.33
03,006,01,008,0194,445,694 ,7 ,701 ,1120 ,0,3,1,3,0,1,0,76.14,62.59 ,33.33
03,006,01,008,0195,446,442 ,4 ,446 ,728 ,0,3,1,3,0,1,0,76.14,61.26 ,33.33
03,006,01,008,0196,447,642 ,15 ,657 ,1080 ,0,3,1,3,0,1,0,76.14,60.83 ,33.33
03,006,01,008,0196,448,844 ,16 ,860 ,1440 ,0,3,1,3,0,1,0,76.14,59.72 ,33.33
03,006,01,008,0196,449,742 ,7 ,749 ,1286 ,0,3,1,3,0,1,0,76.14,58.24 ,33.33
03,006,01,008,0196,450,893 ,17 ,910 ,1420 ,0,3,1,3,0,1,0,76.14,64.08 ,33.33
03,006,01,008,0197,451,718 ,6 ,724 ,1224 ,0,3,1,3,0,1,0,76.14,59.15 ,33.33
03,006,01,008,0197,452,775 ,6 ,781 ,1474 ,0,3,1,3,0,1,0,76.14,52.99 ,33.33
03,006,01,008,0198,453,827 ,10 ,837 ,1419 ,0,3,1,3,0,1,0,76.14,58.99 ,33.33
03,006,01,008,0198,454,809 ,8 ,817 ,1495 ,0,3,1,3,0,1,0,76.14,54.65 ,33.33
03,006,01,008,0199,455,604 ,11 ,615 ,1090 ,0,3,1,3,0,1,0,76.14,56.42 ,33.33
03,006,01,008,0199,456,577 ,5 ,582 ,1086 ,0,3,1,3,0,1,0,76.14,53.59 ,33.33
03,006,01,008,0199,457,820 ,6 ,826 ,1393 ,0,3,1,3,0,1,0,76.14,59.30 ,33.33
03,006,01,008,0199,458,442 ,7 ,449 ,767 ,0,3,1,3,0,1,0,76.14,58.54 ,33.33
03,006,01,008,0199,459,451 ,4 ,455 ,794 ,0,3,1,3,0,1,0,76.14,57.30 ,33.33
03,006,01,008,0200,460,739 ,9 ,748 ,1366 ,0,3,1,3,0,1,0,76.14,54.76 ,33.33
03,006,01,008,0200,461,749 ,7 ,756 ,1414 ,0,3,1,3,0,1,0,76.14,53.47 ,33.33
03,006,01,008,0200,462,585 ,6 ,591 ,1053 ,0,3,1,3,0,1,0,76.14,56.13 ,33.33
03,006,01,008,0201,463,583 ,8 ,591 ,1011 ,0,3,1,3,0,1,0,76.14,58.46 ,33.33
03,006,01,008,0201,464,489 ,5 ,494 ,782 ,0,3,1,3,0,1,0,76.14,63.17 ,33.33
03,006,01,008,0202,465,590 ,2 ,592 ,1013 ,0,3,1,3,0,1,0,76.14,58.44 ,33.33
03,006,01,008,0202,466,642 ,5 ,647 ,1168 ,0,3,1,3,0,1,0,76.14,55.39 ,33.33
03,006,01,008,0203,467,708 ,14 ,722 ,1154 ,0,3,1,3,0,1,0,76.14,62.56 ,33.33
03,006,01,008,0203,468,650 ,3 ,653 ,1120 ,0,3,1,3,0,1,0,76.14,58.30 ,33.33
03,006,01,009,0204,469,560 ,9 ,569 ,810 ,0,3,1,3,0,1,0,76.14,70.25 ,33.33
03,006,01,009,0204,470,656 ,15 ,671 ,1037 ,0,3,1,3,0,1,0,76.14,64.71 ,33.33
03,006,01,009,0205,471,569 ,9 ,578 ,934 ,0,3,1,3,0,1,0,76.14,61.88 ,33.33
03,006,01,009,0205,472,308 ,2 ,310 ,521 ,0,3,1,3,0,1,0,76.14,59.50 ,33.33
03,006,01,009,0206,473,839 ,8 ,847 ,1319 ,0,3,1,3,0,1,0,76.14,64.22 ,33.33
03,006,01,009,0206,474,892 ,8 ,900 ,1380 ,0,3,1,3,0,1,0,76.14,65.22 ,33.33
03,006,01,009,0207,475,795 ,12 ,807 ,1289 ,0,3,1,3,0,1,0,76.14,62.61 ,33.33
03,006,01,009,0207,476,763 ,12 ,775 ,1251 ,0,3,1,3,0,1,0,76.14,61.95 ,33.33
03,006,01,009,0208,477,752 ,11 ,763 ,1228 ,0,3,1,3,0,1,0,76.14,62.13 ,33.33
03,006,01,009,0208,478,815 ,6 ,821 ,1209 ,0,3,1,3,0,1,0,76.14,67.91 ,33.33
03,006,01,009,0208,479,562 ,8 ,570 ,893 ,0,3,1,3,0,1,0,76.14,63.83 ,33.33
03,006,01,009,0209,480,588 ,2 ,590 ,899 ,0,3,1,3,0,1,0,76.14,65.63 ,33.33
03,006,01,009,0209,481,677 ,13 ,690 ,1027 ,0,3,1,3,0,1,0,76.14,67.19 ,33.33
03,006,01,009,0210,482,941 ,7 ,948 ,1539 ,0,3,1,3,0,1,0,76.14,61.60 ,33.33
03,006,01,009,0210,483,792 ,13 ,805 ,1327 ,0,3,1,3,0,1,0,76.14,60.66 ,33.33
03,006,01,009,0210,484,843 ,8 ,851 ,1229 ,0,3,1,3,0,1,0,76.14,69.24 ,33.33
03,006,01,009,0211,485,568 ,2 ,570 ,872 ,0,3,1,3,0,1,0,76.14,65.37 ,33.33
03,006,01,009,0211,486,596 ,24 ,620 ,947 ,0,3,1,3,0,1,0,76.14,65.47 ,33.33
03,006,01,009,0212,487,805 ,4 ,809 ,1232 ,0,3,1,3,0,1,0,76.14,65.67 ,33.33
03,006,01,009,0212,488,920 ,10 ,930 ,1409 ,0,3,1,3,0,1,0,76.14,66.00 ,33.33
03,006,01,009,0213,489,819 ,4 ,823 ,1264 ,0,3,1,3,0,1,0,76.14,65.11 ,33.33
03,006,01,009,0213,490,986 ,17 ,1003 ,1577 ,0,3,1,3,0,1,0,76.14,63.60 ,33.33
03,006,01,009,0214,491,621 ,7 ,628 ,961 ,0,3,1,3,0,1,0,76.14,65.35 ,33.33
03,006,01,009,0214,492,698 ,7 ,705 ,1102 ,0,3,1,3,0,1,0,76.14,63.97 ,33.33
03,006,01,009,0215,493,877 ,17 ,894 ,1370 ,0,3,1,3,0,1,0,76.14,65.26 ,33.33
03,006,01,009,0216,494,950 ,12 ,962 ,1515 ,0,3,1,3,0,1,0,76.14,63.50 ,33.33
03,006,01,009,0217,495,580 ,12 ,592 ,904 ,0,3,1,3,0,1,0,76.14,65.49 ,33.33
03,006,01,009,0217,496,736 ,10 ,746 ,1114 ,0,3,1,3,0,1,0,76.14,66.97 ,33.33
03,006,01,009,0218,497,919 ,7 ,926 ,1457 ,0,3,1,3,0,1,0,76.14,63.56 ,33.33
03,006,01,009,0218,498,825 ,10 ,835 ,1378 ,0,3,1,3,0,1,0,76.14,60.60 ,33.33
03,006,01,009,0219,499,1002 ,11 ,1013 ,1546 ,0,3,1,3,0,1,0,76.14,65.52 ,33.33
03,006,01,009,0220,500,1143 ,17 ,1160 ,1788 ,0,3,1,3,0,1,0,76.14,64.88 ,33.33
03,006,01,009,0221,501,826 ,12 ,838 ,1274 ,0,3,1,3,0,1,0,76.14,65.78 ,33.33
03,006,01,010,0222,502,800 ,14 ,814 ,1284 ,0,3,1,3,0,1,0,76.14,63.40 ,33.33
03,006,01,010,0222,503,783 ,6 ,789 ,1272 ,0,3,1,3,0,1,0,76.14,62.03 ,33.33
03,006,01,010,0223,504,966 ,4 ,970 ,1604 ,0,3,1,3,0,1,0,76.14,60.47 ,33.33
03,006,01,010,0224,505,600 ,3 ,603 ,950 ,0,3,1,3,0,1,0,76.14,63.47 ,33.33
03,006,01,010,0224,506,750 ,16 ,766 ,1206 ,0,3,1,3,0,1,0,76.14,63.52 ,33.33
03,006,01,010,0225,507,734 ,9 ,743 ,1148 ,0,3,1,3,0,1,0,76.14,64.72 ,33.33
03,006,01,010,0225,508,558 ,2 ,560 ,848 ,0,3,1,3,0,1,0,76.14,66.04 ,33.33
03,006,01,010,0226,509,773 ,8 ,781 ,1164 ,0,3,1,3,0,1,0,76.14,67.10 ,33.33
03,006,01,010,0226,510,573 ,9 ,582 ,944 ,0,3,1,3,0,1,0,76.14,61.65 ,33.33
03,006,01,010,0227,511,541 ,8 ,549 ,798 ,0,3,1,3,0,1,0,76.14,68.80 ,33.33
03,006,01,010,0227,512,670 ,12 ,682 ,1094 ,0,3,1,3,0,1,0,76.14,62.34 ,33.33
03,006,01,010,0228,513,808 ,13 ,821 ,1198 ,0,3,1,3,0,1,0,76.14,68.53 ,33.33
03,006,01,010,0228,514,721 ,7 ,728 ,1193 ,0,3,1,3,0,1,0,76.14,61.02 ,33.33
03,006,01,010,0228,515,652 ,8 ,660 ,1146 ,0,3,1,3,0,1,0,76.14,57.59 ,33.33
03,006,01,010,0229,516,603 ,9 ,612 ,919 ,0,3,1,3,0,1,0,76.14,66.59 ,33.33
03,006,01,010,0230,517,863 ,5 ,868 ,1423 ,0,3,1,3,0,1,0,76.14,61.00 ,33.33
03,006,01,010,0230,518,724 ,6 ,730 ,1347 ,0,3,1,3,0,1,0,76.14,54.19 ,33.33
03,006,01,010,0230,519,764 ,10 ,774 ,1334 ,0,3,1,3,0,1,0,76.14,58.02 ,33.33
03,006,01,010,0230,520,799 ,7 ,806 ,1339 ,0,3,1,3,0,1,0,76.14,60.19 ,33.33
03,006,01,010,0231,521,790 ,16 ,806 ,1424 ,0,3,1,3,0,1,0,76.14,56.60 ,33.33
03,006,01,010,0231,522,798 ,10 ,808 ,1315 ,0,3,1,3,0,1,0,76.14,61.44 ,33.33
03,006,01,010,0231,523,765 ,10 ,775 ,1373 ,0,3,1,3,0,1,0,76.14,56.45 ,33.33
03,006,01,010,0232,524,809 ,7 ,816 ,1310 ,0,3,1,3,0,1,0,76.14,62.29 ,33.33
03,006,01,010,0232,525,514 ,6 ,520 ,801 ,0,3,1,3,0,1,0,76.14,64.92 ,33.33
03,006,01,010,0233,526,753 ,11 ,764 ,1259 ,0,3,1,3,0,1,0,76.14,60.68 ,33.33
03,006,01,010,0233,527,639 ,12 ,651 ,1192 ,0,3,1,3,0,1,0,76.14,54.61 ,33.33
03,006,01,010,0233,528,385 ,2 ,387 ,815 ,0,3,1,3,0,1,0,76.14,47.48 ,33.33
03,006,01,010,0234,529,761 ,10 ,771 ,1286 ,0,3,1,3,0,1,0,76.14,59.95 ,33.33
03,006,01,010,0234,530,773 ,7 ,780 ,1295 ,0,3,1,3,0,1,0,76.14,60.23 ,33.33
03,006,01,010,0235,531,877 ,15 ,892 ,1552 ,0,3,1,3,0,1,0,76.14,57.47 ,33.33
03,006,01,010,0235,532,951 ,12 ,963 ,1658 ,0,3,1,3,0,1,0,76.14,58.08 ,33.33
03,006,01,010,0235,533,850 ,11 ,861 ,1557 ,0,3,1,3,0,1,0,76.14,55.30 ,33.33
03,006,01,010,0235,534,815 ,8 ,823 ,1446 ,0,3,1,3,0,1,0,76.14,56.92 ,33.33
03,006,01,010,0236,535,703 ,10 ,713 ,1102 ,0,3,1,3,0,1,0,76.14,64.70 ,33.33
03,006,01,010,0236,536,705 ,8 ,713 ,1158 ,0,3,1,3,0,1,0,76.14,61.57 ,33.33
03,006,01,010,0237,537,858 ,23 ,881 ,1277 ,0,3,1,3,0,1,0,76.14,68.99 ,33.33
03,006,01,010,0237,538,803 ,17 ,820 ,1206 ,0,3,1,3,0,1,0,76.14,67.99 ,33.33
03,006,01,011,0238,539,849 ,8 ,857 ,1377 ,0,3,1,3,0,1,0,76.14,62.24 ,33.33
03,006,01,011,0239,540,1221 ,16 ,1237 ,2066 ,0,3,1,3,0,1,0,76.14,59.87 ,33.33
03,006,01,011,0240,541,840 ,3 ,843 ,1531 ,0,3,1,3,0,1,0,76.14,55.06 ,33.33
03,006,01,011,0240,542,1153 ,15 ,1168 ,2005 ,0,3,1,3,0,1,0,76.14,58.25 ,33.33
03,006,01,011,0240,543,931 ,7 ,938 ,1979 ,0,3,1,3,0,1,0,76.14,47.40 ,33.33
03,006,01,011,0240,544,1087 ,11 ,1098 ,1951 ,0,3,1,3,0,1,0,76.14,56.28 ,33.33
03,006,01,011,0240,545,799 ,5 ,804 ,1292 ,0,3,1,3,0,1,0,76.14,62.23 ,33.33
03,006,01,011,0241,546,1091 ,9 ,1100 ,1859 ,0,3,1,3,0,1,0,76.14,59.17 ,33.33
03,006,01,011,0241,547,997 ,11 ,1008 ,2016 ,0,3,1,3,0,1,0,76.14,50.00 ,33.33
03,006,01,011,0241,548,858 ,5 ,863 ,1598 ,0,3,1,3,0,1,0,76.14,54.01 ,33.33
03,006,01,011,0241,549,1113 ,7 ,1120 ,1871 ,0,3,1,3,0,1,0,76.14,59.86 ,33.33
03,006,01,011,0242,550,614 ,11 ,625 ,1013 ,0,3,1,3,0,1,0,76.14,61.70 ,33.33
03,006,01,011,0242,551,837 ,5 ,842 ,1648 ,0,3,1,3,0,1,0,76.14,51.09 ,33.33
03,006,01,011,0242,552,480 ,2 ,482 ,861 ,0,3,1,3,0,1,0,76.14,55.98 ,33.33
03,006,01,011,0243,553,1012 ,10 ,1022 ,1746 ,0,3,1,3,0,1,0,76.14,58.53 ,33.33
03,006,01,011,0243,554,727 ,6 ,733 ,1275 ,0,3,1,3,0,1,0,76.14,57.49 ,33.33
03,006,01,011,0244,555,915 ,11 ,926 ,1940 ,0,3,1,3,0,1,0,76.14,47.73 ,33.33
03,006,01,011,0244,556,1016 ,7 ,1023 ,1892 ,0,3,1,3,0,1,0,76.14,54.07 ,33.33
03,006,01,011,0245,557,872 ,5 ,877 ,1527 ,0,3,1,3,0,1,0,76.14,57.43 ,33.33
03,006,01,011,0245,558,792 ,12 ,804 ,1317 ,0,3,1,3,0,1,0,76.14,61.05 ,33.33
03,006,01,011,0246,559,1289 ,11 ,1300 ,2289 ,0,3,1,3,0,1,0,76.14,56.79 ,33.33
03,006,01,011,0246,560,1184 ,14 ,1198 ,2049 ,0,3,1,3,0,1,0,76.14,58.47 ,33.33
03,006,01,011,0246,561,1172 ,8 ,1180 ,2253 ,0,3,1,3,0,1,0,76.14,52.37 ,33.33
03,006,01,011,0247,562,714 ,8 ,722 ,1178 ,0,3,1,3,0,1,0,76.14,61.29 ,33.33
03,006,01,011,0247,563,701 ,7 ,708 ,1127 ,0,3,1,3,0,1,0,76.14,62.82 ,33.33
03,006,01,011,0247,564,636 ,11 ,647 ,1214 ,0,3,1,3,0,1,0,76.14,53.29 ,33.33
03,006,01,011,0247,565,1029 ,14 ,1043 ,1764 ,0,3,1,3,0,1,0,76.14,59.13 ,33.33
03,006,01,011,0247,566,1309 ,15 ,1324 ,2185 ,0,3,1,3,0,1,0,76.14,60.59 ,33.33
03,006,01,011,0247,567,845 ,6 ,851 ,1429 ,0,3,1,3,0,1,0,76.14,59.55 ,33.33
03,006,01,011,0248,568,1022 ,10 ,1032 ,1783 ,0,3,1,3,0,1,0,76.14,57.88 ,33.33
03,006,01,011,0249,569,1030 ,9 ,1039 ,1858 ,0,3,1,3,0,1,0,76.14,55.92 ,33.33
03,006,01,011,0249,570,921 ,12 ,933 ,1669 ,0,3,1,3,0,1,0,76.14,55.90 ,33.33
03,006,01,011,0250,571,992 ,8 ,1000 ,1644 ,0,3,1,3,0,1,0,76.14,60.83 ,33.33
03,006,01,011,0250,572,746 ,10 ,756 ,1247 ,0,3,1,3,0,1,0,76.14,60.63 ,33.33
03,006,01,011,0250,573,721 ,8 ,729 ,1168 ,0,3,1,3,0,1,0,76.14,62.41 ,33.33
03,006,01,011,0251,574,1029 ,14 ,1043 ,1720 ,0,3,1,3,0,1,0,76.14,60.64 ,33.33
03,006,01,011,0251,575,889 ,9 ,898 ,1496 ,0,3,1,3,0,1,0,76.14,60.03 ,33.33
03,006,01,011,0252,576,856 ,7 ,863 ,1422 ,0,3,1,3,0,1,0,76.14,60.69 ,33.33
03,006,01,011,0253,577,835 ,9 ,844 ,1416 ,0,3,1,3,0,1,0,76.14,59.60 ,33.33
03,006,01,011,0253,578,814 ,8 ,822 ,1411 ,0,3,1,3,0,1,0,76.14,58.26 ,33.33
03,006,01,012,0254,579,1087 ,17 ,1104 ,1913 ,0,3,1,3,0,1,0,76.14,57.71 ,33.33
03,006,01,012,0254,580,1001 ,24 ,1025 ,1847 ,0,3,1,3,0,1,0,76.14,55.50 ,33.33
03,006,01,012,0255,581,1017 ,15 ,1032 ,1844 ,0,3,1,3,0,1,0,76.14,55.97 ,33.33
03,006,01,012,0255,582,1065 ,8 ,1073 ,1925 ,0,3,1,3,0,1,0,76.14,55.74 ,33.33
03,006,01,012,0256,583,847 ,3 ,850 ,1647 ,0,3,1,3,0,1,0,76.14,51.61 ,33.33
03,006,01,012,0256,584,878 ,5 ,883 ,1515 ,0,3,1,3,0,1,0,76.14,58.28 ,33.33
03,006,01,012,0256,585,672 ,7 ,679 ,1242 ,0,3,1,3,0,1,0,76.14,54.67 ,33.33
03,006,01,012,0257,586,684 ,9 ,693 ,1281 ,0,3,1,3,0,1,0,76.14,54.10 ,33.33
03,006,01,012,0257,587,686 ,4 ,690 ,1239 ,0,3,1,3,0,1,0,76.14,55.69 ,33.33
03,006,01,012,0257,588,704 ,6 ,710 ,1281 ,0,3,1,3,0,1,0,76.14,55.43 ,33.33
03,006,01,012,0258,589,991 ,11 ,1002 ,1850 ,0,3,1,3,0,1,0,76.14,54.16 ,33.33
03,006,01,012,0258,590,1068 ,6 ,1074 ,1932 ,0,3,1,3,0,1,0,76.14,55.59 ,33.33
03,006,01,012,0259,591,700 ,3 ,703 ,1339 ,0,3,1,3,0,1,0,76.14,52.50 ,33.33
03,006,01,012,0259,592,996 ,11 ,1007 ,1843 ,0,3,1,3,0,1,0,76.14,54.64 ,33.33
03,006,01,012,0260,593,863 ,9 ,872 ,1496 ,0,3,1,3,0,1,0,76.14,58.29 ,33.33
03,006,01,012,0260,594,849 ,18 ,867 ,1594 ,0,3,1,3,0,1,0,76.14,54.39 ,33.33
03,006,01,012,0261,595,997 ,16 ,1013 ,1772 ,0,3,1,3,0,1,0,76.14,57.17 ,33.33
03,006,01,012,0261,596,935 ,10 ,945 ,1809 ,0,3,1,3,0,1,0,76.14,52.24 ,33.33
03,006,01,012,0261,597,651 ,10 ,661 ,1309 ,0,3,1,3,0,1,0,76.14,50.50 ,33.33
03,006,01,012,0261,598,888 ,11 ,899 ,1548 ,0,3,1,3,0,1,0,76.14,58.07 ,33.33
03,006,01,012,0261,599,829 ,14 ,843 ,1368 ,0,3,1,3,0,1,0,76.14,61.62 ,33.33
03,006,01,012,0261,600,698 ,14 ,712 ,1222 ,0,3,1,3,0,1,0,76.14,58.27 ,33.33
03,006,01,012,0261,601,549 ,4 ,553 ,1185 ,0,3,1,3,0,1,0,76.14,46.67 ,33.33
03,006,01,012,0262,602,877 ,14 ,891 ,1440 ,0,3,1,3,0,1,0,76.14,61.88 ,33.33
03,006,01,012,0262,603,956 ,11 ,967 ,1637 ,0,3,1,3,0,1,0,76.14,59.07 ,33.33
03,006,01,012,0262,604,795 ,3 ,798 ,1414 ,0,3,1,3,0,1,0,76.14,56.44 ,33.33
03,006,01,012,0262,605,928 ,9 ,937 ,1635 ,0,3,1,3,0,1,0,76.14,57.31 ,33.33
03,006,01,012,0263,606,853 ,11 ,864 ,1374 ,0,3,1,3,0,1,0,76.14,62.88 ,33.33
03,006,01,012,0263,607,839 ,18 ,857 ,1407 ,0,3,1,3,0,1,0,76.14,60.91 ,33.33
03,006,01,012,0263,608,615 ,6 ,621 ,1103 ,0,3,1,3,0,1,0,76.14,56.30 ,33.33
03,006,01,012,0263,609,782 ,14 ,796 ,1353 ,0,3,1,3,0,1,0,76.14,58.83 ,33.33
03,006,01,012,0264,610,1078 ,13 ,1091 ,1656 ,0,3,1,3,0,1,0,76.14,65.88 ,33.33
03,006,01,012,0264,611,708 ,7 ,715 ,1059 ,0,3,1,3,0,1,0,76.14,67.52 ,33.33
03,006,01,012,0265,612,1158 ,23 ,1181 ,1803 ,0,3,1,3,0,1,0,76.14,65.50 ,33.33
03,006,01,012,0265,613,978 ,15 ,993 ,1546 ,0,3,1,3,0,1,0,76.14,64.23 ,33.33
03,006,01,012,0266,614,1024 ,3 ,1027 ,1559 ,0,3,1,3,0,1,0,76.14,65.88 ,33.33
03,006,01,012,0266,615,961 ,10 ,971 ,1591 ,0,3,1,3,0,1,0,76.14,61.03 ,33.33
03,006,01,013,0267,616,814 ,3 ,817 ,1326 ,0,3,1,3,0,1,0,76.14,61.61 ,33.33
03,006,01,013,0267,617,912 ,9 ,921 ,1500 ,0,3,1,3,0,1,0,76.14,61.40 ,33.33
03,006,01,013,0268,618,1017 ,12 ,1029 ,1701 ,0,3,1,3,0,1,0,76.14,60.49 ,33.33
03,006,01,013,0269,619,821 ,7 ,828 ,1261 ,0,3,1,3,0,1,0,76.14,65.66 ,33.33
03,006,01,013,0270,620,552 ,4 ,556 ,909 ,0,3,1,3,0,1,0,76.14,61.17 ,33.33
03,006,01,013,0271,621,724 ,11 ,735 ,1185 ,0,3,1,3,0,1,0,76.14,62.03 ,33.33
03,006,01,013,0272,622,1192 ,9 ,1201 ,1922 ,0,3,1,3,0,1,0,76.14,62.49 ,33.33
03,006,01,013,0273,623,1220 ,16 ,1236 ,1924 ,0,3,1,3,0,1,0,76.14,64.24 ,33.33
03,006,01,013,0273,624,485 ,10 ,495 ,701 ,0,3,1,3,0,1,0,76.14,70.61 ,33.33
03,006,01,013,0274,625,442 ,4 ,446 ,693 ,0,3,1,3,0,1,0,76.14,64.36 ,33.33
03,006,01,013,0275,626,788 ,7 ,795 ,1200 ,0,3,1,3,0,1,0,76.14,66.25 ,33.33
03,006,01,013,0275,627,863 ,7 ,870 ,1372 ,0,3,1,3,0,1,0,76.14,63.41 ,33.33
03,006,01,013,0276,628,791 ,3 ,794 ,1265 ,0,3,1,3,0,1,0,76.14,62.77 ,33.33
03,006,01,013,0277,629,176 ,1 ,177 ,249 ,0,3,1,3,0,1,0,76.14,71.08 ,33.33
03,006,01,013,0277,630,374 ,3 ,377 ,641 ,0,3,1,3,0,1,0,76.14,58.81 ,33.33
03,006,01,013,0278,631,363 ,2 ,365 ,586 ,0,3,1,3,0,1,0,76.14,62.29 ,33.33
03,006,01,013,0279,632,629 ,3 ,632 ,1018 ,0,3,1,3,0,1,0,76.14,62.08 ,33.33
03,006,01,013,0279,633,153 ,2 ,155 ,256 ,0,3,1,3,0,1,0,76.14,60.55 ,33.33
03,006,01,014,0280,634,645 ,12 ,657 ,1052 ,0,3,1,3,0,1,0,76.14,62.45 ,33.33
03,006,01,014,0281,635,729 ,8 ,737 ,1171 ,0,3,1,3,0,1,0,76.14,62.94 ,33.33
03,006,01,014,0282,636,655 ,16 ,671 ,1056 ,0,3,1,3,0,1,0,76.14,63.54 ,33.33
03,006,01,014,0283,637,733 ,15 ,748 ,1219 ,0,3,1,3,0,1,0,76.14,61.36 ,33.33
03,006,01,014,0284,638,436 ,11 ,447 ,684 ,0,3,1,3,0,1,0,76.14,65.35 ,33.33
03,006,01,014,0285,639,858 ,26 ,884 ,1386 ,0,3,1,3,0,1,0,76.14,63.78 ,33.33
03,006,01,014,0286,640,1065 ,11 ,1076 ,1720 ,0,3,1,3,0,1,0,76.14,62.56 ,33.33
03,006,01,014,0287,641,558 ,5 ,563 ,945 ,0,3,1,3,0,1,0,76.14,59.58 ,33.33
03,006,01,014,0288,642,768 ,9 ,777 ,1274 ,0,3,1,3,0,1,0,76.14,60.99 ,33.33
03,006,01,014,0289,643,779 ,1 ,780 ,1224 ,0,3,1,3,0,1,0,76.14,63.73 ,33.33
03,006,01,015,0290,644,632 ,13 ,645 ,991 ,0,3,1,3,0,1,0,76.14,65.09 ,33.33
03,006,01,015,0291,645,942 ,12 ,954 ,1544 ,0,3,1,3,0,1,0,76.14,61.79 ,33.33
03,006,01,015,0292,646,730 ,5 ,735 ,1184 ,0,3,1,3,0,1,0,76.14,62.08 ,33.33
03,006,01,015,0292,647,678 ,1 ,679 ,1146 ,0,3,1,3,0,1,0,76.14,59.25 ,33.33
03,006,01,015,0292,648,711 ,4 ,715 ,1219 ,0,3,1,3,0,1,0,76.14,58.65 ,33.33
03,006,01,015,0293,649,863 ,9 ,872 ,1389 ,0,3,1,3,0,1,0,76.14,62.78 ,33.33
03,006,01,015,0293,650,959 ,36 ,995 ,1644 ,0,3,1,3,0,1,0,76.14,60.52 ,33.33
03,006,01,015,0293,651,917 ,9 ,926 ,1675 ,0,3,1,3,0,1,0,76.14,55.28 ,33.33
03,006,01,015,0294,652,983 ,12 ,995 ,1703 ,0,3,1,3,0,1,0,76.14,58.43 ,33.33
03,006,01,015,0295,653,943 ,11 ,954 ,1689 ,0,3,1,3,0,1,0,76.14,56.48 ,33.33
03,006,01,015,0295,654,737 ,9 ,746 ,1193 ,0,3,1,3,0,1,0,76.14,62.53 ,33.33
03,006,01,015,0296,655,616 ,8 ,624 ,964 ,0,3,1,3,0,1,0,76.14,64.73 ,33.33
03,006,01,015,0296,656,658 ,14 ,672 ,1105 ,0,3,1,3,0,1,0,76.14,60.81 ,33.33
03,006,01,015,0297,657,649 ,9 ,658 ,1050 ,0,3,1,3,0,1,0,76.14,62.67 ,33.33
03,006,01,015,0298,658,875 ,8 ,883 ,1342 ,0,3,1,3,0,1,0,76.14,65.80 ,33.33
03,006,01,015,0299,659,1014 ,13 ,1027 ,1543 ,0,3,1,3,0,1,0,76.14,66.56 ,33.33
03,006,01,015,0300,660,738 ,19 ,757 ,1176 ,0,3,1,3,0,1,0,76.14,64.37 ,33.33
03,006,01,016,0301,661,662 ,6 ,668 ,1067 ,0,3,1,3,0,1,0,76.14,62.61 ,33.33
03,006,01,016,0302,662,697 ,13 ,710 ,1106 ,0,3,1,3,0,1,0,76.14,64.20 ,33.33
03,006,01,016,0303,663,668 ,9 ,677 ,1145 ,0,3,1,3,0,1,0,76.14,59.13 ,33.33
03,006,01,016,0303,664,680 ,8 ,688 ,1263 ,0,3,1,3,0,1,0,76.14,54.47 ,33.33
03,006,01,016,0304,665,763 ,6 ,769 ,1196 ,0,3,1,3,0,1,0,76.14,64.30 ,33.33
03,006,01,016,0305,666,723 ,12 ,735 ,1144 ,0,3,1,3,0,1,0,76.14,64.25 ,33.33
03,006,01,016,0306,667,635 ,6 ,641 ,846 ,0,3,1,3,0,1,0,76.14,75.77 ,33.33
03,006,01,016,0306,668,478 ,6 ,484 ,731 ,0,3,1,3,0,1,0,76.14,66.21 ,33.33
03,006,01,016,0307,669,531 ,4 ,535 ,877 ,0,3,1,3,0,1,0,76.14,61.00 ,33.33
03,006,01,016,0308,670,666 ,10 ,676 ,1113 ,0,3,1,3,0,1,0,76.14,60.74 ,33.33
03,006,01,016,0308,671,352 ,0 ,352 ,518 ,0,3,1,3,0,1,0,76.14,67.95 ,33.33
03,006,01,016,0309,672,538 ,5 ,543 ,981 ,0,3,1,3,0,1,0,76.14,55.35 ,33.33
03,006,01,016,0310,673,852 ,14 ,866 ,1370 ,0,3,1,3,0,1,0,76.14,63.21 ,33.33
03,006,01,016,0311,674,826 ,8 ,834 ,1379 ,0,3,1,3,0,1,0,76.14,60.48 ,33.33
03,006,01,016,0312,675,565 ,5 ,570 ,778 ,0,3,1,3,0,1,0,76.14,73.26 ,33.33
03,006,01,017,0313,676,866 ,7 ,873 ,1392 ,0,3,1,3,0,1,0,76.14,62.72 ,33.33
03,006,01,017,0313,677,926 ,4 ,930 ,1587 ,0,3,1,3,0,1,0,76.14,58.60 ,33.33
03,006,01,017,0313,678,845 ,8 ,853 ,1386 ,0,3,1,3,0,1,0,76.14,61.54 ,33.33
03,006,01,017,0313,679,1017 ,9 ,1026 ,1571 ,0,3,1,3,0,1,0,76.14,65.31 ,33.33
03,006,01,017,0314,680,734 ,8 ,742 ,1156 ,0,3,1,3,0,1,0,76.14,64.19 ,33.33
03,006,01,017,0314,681,519 ,4 ,523 ,955 ,0,3,1,3,0,1,0,76.14,54.76 ,33.33
03,006,01,017,0315,682,1028 ,10 ,1038 ,1644 ,0,3,1,3,0,1,0,76.14,63.14 ,33.33
03,006,01,017,0315,683,1082 ,23 ,1105 ,1670 ,0,3,1,3,0,1,0,76.14,66.17 ,33.33
03,006,01,017,0316,684,1040 ,13 ,1053 ,1476 ,0,3,1,3,0,1,0,76.14,71.34 ,33.33
03,006,01,017,0316,685,644 ,9 ,653 ,1065 ,0,3,1,3,0,1,0,76.14,61.31 ,33.33
03,006,01,017,0317,686,607 ,6 ,613 ,1006 ,0,3,1,3,0,1,0,76.14,60.93 ,33.33
03,006,01,017,0317,687,571 ,7 ,578 ,932 ,0,3,1,3,0,1,0,76.14,62.02 ,33.33
03,006,01,017,0318,688,993 ,8 ,1001 ,1776 ,0,3,1,3,0,1,0,76.14,56.36 ,33.33
03,006,01,017,0318,689,1039 ,9 ,1048 ,1719 ,0,3,1,3,0,1,0,76.14,60.97 ,33.33
03,006,01,017,0318,690,851 ,10 ,861 ,1556 ,0,3,1,3,0,1,0,76.14,55.33 ,33.33
03,006,01,017,0318,691,863 ,7 ,870 ,1534 ,0,3,1,3,0,1,0,76.14,56.71 ,33.33
03,006,01,017,0318,692,930 ,4 ,934 ,1517 ,0,3,1,3,0,1,0,76.14,61.57 ,33.33
03,006,01,017,0318,693,788 ,10 ,798 ,1477 ,0,3,1,3,0,1,0,76.14,54.03 ,33.33
03,006,01,017,0319,694,1017 ,10 ,1027 ,1720 ,0,3,1,3,0,1,0,76.14,59.71 ,33.33
03,006,01,017,0319,695,962 ,8 ,970 ,1720 ,0,3,1,3,0,1,0,76.14,56.40 ,33.33
03,006,01,017,0319,696,1110 ,12 ,1122 ,1957 ,0,3,1,3,0,1,0,76.14,57.33 ,33.33
03,006,01,017,0320,697,658 ,10 ,668 ,1014 ,0,3,1,3,0,1,0,76.14,65.88 ,33.33
03,006,01,017,0320,698,717 ,10 ,727 ,1059 ,0,3,1,3,0,1,0,76.14,68.65 ,33.33
03,006,01,017,0321,699,988 ,9 ,997 ,1464 ,0,3,1,3,0,1,0,76.14,68.10 ,33.33
03,006,01,017,0322,700,568 ,6 ,574 ,887 ,0,3,1,3,0,1,0,76.14,64.71 ,33.33
03,006,01,017,0322,701,737 ,4 ,741 ,1112 ,0,3,1,3,0,1,0,76.14,66.64 ,33.33
03,006,01,017,0323,702,1113 ,11 ,1124 ,1635 ,0,3,1,3,0,1,0,76.14,68.75 ,33.33
03,006,01,017,0324,703,1162 ,19 ,1181 ,1798 ,0,3,1,3,0,1,0,76.14,65.68 ,33.33
03,006,01,017,0324,704,1059 ,18 ,1077 ,1854 ,0,3,1,3,0,1,0,76.14,58.09 ,33.33
03,006,01,017,0325,705,950 ,20 ,970 ,1495 ,0,3,1,3,0,1,0,76.14,64.88 ,33.33
03,006,01,017,0326,706,864 ,12 ,876 ,1412 ,0,3,1,3,0,1,0,76.14,62.04 ,33.33
03,006,01,017,0327,707,693 ,8 ,701 ,1093 ,0,3,1,3,0,1,0,76.14,64.14 ,33.33
03,006,01,017,0328,708,496 ,6 ,502 ,807 ,0,3,1,3,0,1,0,76.14,62.21 ,33.33
03,006,01,018,0329,709,998 ,3 ,1001 ,1571 ,0,3,1,3,0,1,0,76.14,63.72 ,33.33
03,006,01,018,0329,710,721 ,14 ,735 ,1135 ,0,3,1,3,0,1,0,76.14,64.76 ,33.33
03,006,01,018,0329,711,652 ,6 ,658 ,994 ,0,3,1,3,0,1,0,76.14,66.20 ,33.33
03,006,01,018,0330,712,557 ,4 ,561 ,802 ,0,3,1,3,0,1,0,76.14,69.95 ,33.33
03,006,01,018,0331,713,682 ,5 ,687 ,1070 ,0,3,1,3,0,1,0,76.14,64.21 ,33.33
03,006,01,018,0331,714,686 ,10 ,696 ,1110 ,0,3,1,3,0,1,0,76.14,62.70 ,33.33
03,006,01,018,0331,715,665 ,8 ,673 ,1077 ,0,3,1,3,0,1,0,76.14,62.49 ,33.33
03,006,01,018,0332,716,881 ,13 ,894 ,1292 ,0,3,1,3,0,1,0,76.14,69.20 ,33.33
03,006,01,018,0333,717,741 ,19 ,760 ,1075 ,0,3,1,3,0,1,0,76.14,70.70 ,33.33
03,006,01,018,0333,718,729 ,3 ,732 ,1165 ,0,3,1,3,0,1,0,76.14,62.83 ,33.33
03,006,01,018,0334,719,718 ,5 ,723 ,1180 ,0,3,1,3,0,1,0,76.14,61.27 ,33.33
03,006,01,018,0334,720,599 ,5 ,604 ,1064 ,0,3,1,3,0,1,0,76.14,56.77 ,33.33
03,006,01,018,0335,721,786 ,5 ,791 ,1364 ,0,3,1,3,0,1,0,76.14,57.99 ,33.33
03,006,01,018,0335,722,791 ,4 ,795 ,1229 ,0,3,1,3,0,1,0,76.14,64.69 ,33.33
03,006,01,018,0336,723,538 ,6 ,544 ,820 ,0,3,1,3,0,1,0,76.14,66.34 ,33.33
03,006,01,018,0336,724,661 ,5 ,666 ,1001 ,0,3,1,3,0,1,0,76.14,66.53 ,33.33
03,006,01,018,0337,725,529 ,8 ,537 ,832 ,0,3,1,3,0,1,0,76.14,64.54 ,33.33
03,006,01,018,0338,726,922 ,12 ,934 ,1336 ,0,3,1,3,0,1,0,76.14,69.91 ,33.33
03,006,01,018,0339,727,1013 ,10 ,1023 ,1471 ,0,3,1,3,0,1,0,76.14,69.54 ,33.33
03,006,01,018,0340,728,608 ,9 ,617 ,885 ,0,3,1,3,0,1,0,76.14,69.72 ,33.33
03,006,01,018,0341,729,842 ,8 ,850 ,1324 ,0,3,1,3,0,1,0,76.14,64.20 ,33.33
03,006,01,018,0342,730,969 ,13 ,982 ,1576 ,0,3,1,3,0,1,0,76.14,62.31 ,33.33
03,006,01,018,0342,731,956 ,11 ,967 ,1669 ,0,3,1,3,0,1,0,76.14,57.94 ,33.33
03,006,01,018,0342,732,1016 ,5 ,1021 ,1707 ,0,3,1,3,0,1,0,76.14,59.81 ,33.33
03,006,01,018,0343,733,911 ,5 ,916 ,1323 ,0,3,1,3,0,1,0,76.14,69.24 ,33.33
03,006,01,018,0343,734,828 ,11 ,839 ,1365 ,0,3,1,3,0,1,0,76.14,61.47 ,33.33
03,006,01,018,0343,735,642 ,16 ,658 ,1132 ,0,3,1,3,0,1,0,76.14,58.13 ,33.33
03,006,01,018,0344,736,724 ,7 ,731 ,1263 ,0,3,1,3,0,1,0,76.14,57.88 ,33.33
03,006,01,018,0344,737,683 ,14 ,697 ,1197 ,0,3,1,3,0,1,0,76.14,58.23 ,33.33
03,006,01,018,0344,738,536 ,7 ,543 ,1001 ,0,3,1,3,0,1,0,76.14,54.25 ,33.33
03,006,01,018,0345,739,938 ,16 ,954 ,1558 ,0,3,1,3,0,1,0,76.14,61.23 ,33.33
03,006,01,018,0345,740,899 ,10 ,909 ,1386 ,0,3,1,3,0,1,0,76.14,65.58 ,33.33
03,006,01,019,0346,741,789 ,7 ,796 ,1327 ,0,3,1,3,0,1,0,76.14,59.98 ,33.33
03,006,01,019,0346,742,583 ,6 ,589 ,945 ,0,3,1,3,0,1,0,76.14,62.33 ,33.33
03,006,01,019,0347,743,758 ,3 ,761 ,1256 ,0,3,1,3,0,1,0,76.14,60.59 ,33.33
03,006,01,019,0347,744,664 ,7 ,671 ,1147 ,0,3,1,3,0,1,0,76.14,58.50 ,33.33
03,006,01,019,0348,745,1062 ,14 ,1076 ,1612 ,0,3,1,3,0,1,0,76.14,66.75 ,33.33
03,006,01,019,0349,746,833 ,12 ,845 ,1378 ,0,3,1,3,0,1,0,76.14,61.32 ,33.33
03,006,01,019,0349,747,701 ,6 ,707 ,1225 ,0,3,1,3,0,1,0,76.14,57.71 ,33.33
03,006,01,019,0350,748,639 ,6 ,645 ,994 ,0,3,1,3,0,1,0,76.14,64.89 ,33.33
03,006,01,019,0351,749,807 ,5 ,812 ,1149 ,0,3,1,3,0,1,0,76.14,70.67 ,33.33
03,006,01,019,0351,750,566 ,6 ,572 ,824 ,0,3,1,3,0,1,0,76.14,69.42 ,33.33
03,006,01,019,0352,751,896 ,7 ,903 ,1447 ,0,3,1,3,0,1,0,76.14,62.40 ,33.33
03,006,01,019,0352,752,657 ,5 ,662 ,1006 ,0,3,1,3,0,1,0,76.14,65.81 ,33.33
03,006,01,019,0352,753,655 ,11 ,666 ,1014 ,0,3,1,3,0,1,0,76.14,65.68 ,33.33
03,006,01,019,0352,754,562 ,6 ,568 ,850 ,0,3,1,3,0,1,0,76.14,66.82 ,33.33
03,006,01,019,0353,755,875 ,6 ,881 ,1451 ,0,3,1,3,0,1,0,76.14,60.72 ,33.33
03,006,01,019,0353,756,623 ,31 ,654 ,1087 ,0,3,1,3,0,1,0,76.14,60.17 ,33.33
03,006,01,019,0354,757,753 ,6 ,759 ,1195 ,0,3,1,3,0,1,0,76.14,63.51 ,33.33
03,006,01,019,0354,758,882 ,7 ,889 ,1397 ,0,3,1,3,0,1,0,76.14,63.64 ,33.33
03,006,01,019,0354,759,833 ,17 ,850 ,1325 ,0,3,1,3,0,1,0,76.14,64.15 ,33.33
03,006,01,019,0355,760,703 ,4 ,707 ,1293 ,0,3,1,3,0,1,0,76.14,54.68 ,33.33
03,006,01,019,0355,761,679 ,7 ,686 ,1261 ,0,3,1,3,0,1,0,76.14,54.40 ,33.33
03,006,01,019,0355,762,850 ,8 ,858 ,1379 ,0,3,1,3,0,1,0,76.14,62.22 ,33.33
03,006,01,019,0356,763,685 ,8 ,693 ,1192 ,0,3,1,3,0,1,0,76.14,58.14 ,33.33
03,006,01,019,0356,764,717 ,14 ,731 ,1316 ,0,3,1,3,0,1,0,76.14,55.55 ,33.33
03,006,01,019,0356,765,678 ,2 ,680 ,1143 ,0,3,1,3,0,1,0,76.14,59.49 ,33.33
03,006,01,019,0356,766,484 ,6 ,490 ,802 ,0,3,1,3,0,1,0,76.14,61.10 ,33.33
03,006,01,019,0357,767,682 ,7 ,689 ,1269 ,0,3,1,3,0,1,0,76.14,54.29 ,33.33
03,006,01,019,0357,768,506 ,8 ,514 ,790 ,0,3,1,3,0,1,0,76.14,65.06 ,33.33
03,006,01,019,0358,769,861 ,7 ,868 ,1499 ,0,3,1,3,0,1,0,76.14,57.91 ,33.33
03,006,01,019,0358,770,861 ,10 ,871 ,1542 ,0,3,1,3,0,1,0,76.14,56.49 ,33.33
03,006,01,019,0358,771,913 ,7 ,920 ,1616 ,0,3,1,3,0,1,0,76.14,56.93 ,33.33
03,006,01,019,0359,772,900 ,8 ,908 ,1364 ,0,3,1,3,0,1,0,76.14,66.57 ,33.33
03,006,01,019,0360,773,762 ,6 ,768 ,1459 ,0,3,1,3,0,1,0,76.14,52.64 ,33.33
03,006,01,019,0360,774,783 ,5 ,788 ,1451 ,0,3,1,3,0,1,0,76.14,54.31 ,33.33
03,006,01,019,0360,775,802 ,7 ,809 ,1404 ,0,3,1,3,0,1,0,76.14,57.62 ,33.33
03,006,01,019,0360,776,698 ,6 ,704 ,1295 ,0,3,1,3,0,1,0,76.14,54.36 ,33.33
03,006,01,019,0361,777,881 ,14 ,895 ,1569 ,0,3,1,3,0,1,0,76.14,57.04 ,33.33
03,006,01,019,0361,778,867 ,2 ,869 ,1632 ,0,3,1,3,0,1,0,76.14,53.25 ,33.33
03,006,01,020,0362,779,732 ,7 ,739 ,1121 ,0,3,1,3,0,1,0,76.14,65.92 ,33.33
03,006,01,020,0363,780,955 ,14 ,969 ,1719 ,0,3,1,3,0,1,0,76.14,56.37 ,33.33
03,006,01,020,0363,781,880 ,7 ,887 ,1491 ,0,3,1,3,0,1,0,76.14,59.49 ,33.33
03,006,01,020,0363,782,755 ,10 ,765 ,1251 ,0,3,1,3,0,1,0,76.14,61.15 ,33.33
03,006,01,020,0363,783,820 ,5 ,825 ,1525 ,0,3,1,3,0,1,0,76.14,54.10 ,33.33
03,006,01,020,0363,784,849 ,10 ,859 ,1490 ,0,3,1,3,0,1,0,76.14,57.65 ,33.33
03,006,01,020,0364,785,902 ,8 ,910 ,1450 ,0,3,1,3,0,1,0,76.14,62.76 ,33.33
03,006,01,020,0364,786,766 ,10 ,776 ,1420 ,0,3,1,3,0,1,0,76.14,54.65 ,33.33
03,006,01,020,0364,787,636 ,9 ,645 ,1120 ,0,3,1,3,0,1,0,76.14,57.59 ,33.33
03,006,01,020,0365,788,1158 ,14 ,1172 ,1809 ,0,3,1,3,0,1,0,76.14,64.79 ,33.33
03,006,01,020,0366,789,1027 ,9 ,1036 ,1586 ,0,3,1,3,0,1,0,76.14,65.32 ,33.33
03,006,01,020,0367,790,583 ,8 ,591 ,937 ,0,3,1,3,0,1,0,76.14,63.07 ,33.33
03,006,01,020,0368,791,653 ,4 ,657 ,1077 ,0,3,1,3,0,1,0,76.14,61.00 ,33.33
03,006,01,020,0369,792,975 ,5 ,980 ,1640 ,0,3,1,3,0,1,0,76.14,59.76 ,33.33
03,006,01,020,0369,793,965 ,14 ,979 ,1767 ,0,3,1,3,0,1,0,76.14,55.40 ,33.33
03,006,01,020,0369,794,882 ,11 ,893 ,1459 ,0,3,1,3,0,1,0,76.14,61.21 ,33.33
03,006,01,020,0370,795,893 ,10 ,903 ,1497 ,0,3,1,3,0,1,0,76.14,60.32 ,33.33
03,006,01,020,0370,796,970 ,9 ,979 ,1576 ,0,3,1,3,0,1,0,76.14,62.12 ,33.33
03,006,01,020,0371,797,896 ,12 ,908 ,1458 ,0,3,1,3,0,1,0,76.14,62.28 ,33.33
03,006,01,020,0372,798,618 ,5 ,623 ,1019 ,0,3,1,3,0,1,0,76.14,61.14 ,33.33
03,006,01,020,0372,799,623 ,4 ,627 ,981 ,0,3,1,3,0,1,0,76.14,63.91 ,33.33
03,006,01,020,0373,800,800 ,11 ,811 ,1160 ,0,3,1,3,0,1,0,76.14,69.91 ,33.33
03,006,01,020,0373,801,793 ,12 ,805 ,1228 ,0,3,1,3,0,1,0,76.14,65.55 ,33.33
03,006,01,020,0374,802,708 ,6 ,714 ,1040 ,0,3,1,3,0,1,0,76.14,68.65 ,33.33
03,006,01,020,0374,803,528 ,6 ,534 ,942 ,0,3,1,3,0,1,0,76.14,56.69 ,33.33
03,006,01,020,0375,804,1038 ,14 ,1052 ,1685 ,0,3,1,3,0,1,0,76.14,62.43 ,33.33
03,006,01,020,0376,805,721 ,6 ,727 ,1163 ,0,3,1,3,0,1,0,76.14,62.51 ,33.33
03,006,01,020,0377,806,760 ,16 ,776 ,1239 ,0,3,1,3,0,1,0,76.14,62.63 ,33.33
03,006,01,020,0377,807,703 ,7 ,710 ,1161 ,0,3,1,3,0,1,0,76.14,61.15 ,33.33
03,006,01,020,0378,808,698 ,4 ,702 ,1051 ,0,3,1,3,0,1,0,76.14,66.79 ,33.33
03,006,01,020,0378,809,538 ,13 ,551 ,916 ,0,3,1,3,0,1,0,76.14,60.15 ,33.33
03,006,01,020,0379,810,693 ,8 ,701 ,1029 ,0,3,1,3,0,1,0,76.14,68.12 ,33.33
03,006,01,020,0379,811,564 ,7 ,571 ,940 ,0,3,1,3,0,1,0,76.14,60.74 ,33.33
03,006,01,020,0379,812,569 ,2 ,571 ,881 ,0,3,1,3,0,1,0,76.14,64.81 ,33.33
03,006,01,020,0380,813,650 ,2 ,652 ,1039 ,0,3,1,3,0,1,0,76.14,62.75 ,33.33
03,006,01,020,0381,814,823 ,20 ,843 ,1247 ,0,3,1,3,0,1,0,76.14,67.60 ,33.33
03,006,01,020,0381,815,624 ,10 ,634 ,951 ,0,3,1,3,0,1,0,76.14,66.67 ,33.33
03,006,01,021,0382,816,538 ,4 ,542 ,872 ,0,3,1,3,0,1,0,76.14,62.16 ,33.33
03,006,01,021,0382,817,313 ,1 ,314 ,533 ,0,3,1,3,0,1,0,76.14,58.91 ,33.33
03,006,01,021,0383,818,249 ,1 ,250 ,459 ,0,3,1,3,0,1,0,76.14,54.47 ,33.33
03,006,01,021,0384,819,354 ,5 ,359 ,625 ,0,3,1,3,0,1,0,76.14,57.44 ,33.33
03,006,01,021,0384,820,226 ,2 ,228 ,406 ,0,3,1,3,0,1,0,76.14,56.16 ,33.33
03,006,01,021,0385,821,60 ,0 ,60 ,105 ,0,3,1,3,0,1,0,76.14,57.14 ,33.33
03,006,01,021,0385,822,56 ,0 ,56 ,121 ,0,3,1,3,0,1,0,76.14,46.28 ,33.33
03,006,01,021,0385,823,163 ,1 ,164 ,300 ,0,3,1,3,0,1,0,76.14,54.67 ,33.33
03,006,01,021,0386,824,226 ,1 ,227 ,429 ,0,3,1,3,0,1,0,76.14,52.91 ,33.33
03,006,01,021,0386,825,68 ,0 ,68 ,112 ,0,3,1,3,0,1,0,76.14,60.71 ,33.33
03,006,01,021,0387,826,226 ,1 ,227 ,371 ,0,3,1,3,0,1,0,76.14,61.19 ,33.33
03,006,01,021,0388,827,64 ,1 ,65 ,190 ,0,3,1,3,0,1,0,76.14,34.21 ,33.33
03,006,01,021,0388,828,319 ,2 ,321 ,789 ,0,3,1,3,0,1,0,76.14,40.68 ,33.33
03,006,01,021,0388,829,64 ,0 ,64 ,232 ,0,3,1,3,0,1,0,76.14,27.59 ,33.33
03,006,01,021,0388,830,27 ,0 ,27 ,93 ,0,3,1,3,0,1,0,76.14,29.03 ,33.33
03,006,01,021,0389,831,68 ,0 ,68 ,190 ,0,3,1,3,0,1,0,76.14,35.79 ,33.33
03,006,01,021,0389,832,76 ,0 ,76 ,183 ,0,3,1,3,0,1,0,76.14,41.53 ,33.33
03,007,01,001,0001,1,811 ,7 ,818 ,1257 ,0,3,1,3,0,1,0,76.14,65.08 ,33.33
03,007,01,001,0001,2,952 ,8 ,960 ,1477 ,0,3,1,3,0,1,0,76.14,65.00 ,33.33
03,007,01,001,0002,3,1045 ,7 ,1052 ,1591 ,0,3,1,3,0,1,0,76.14,66.12 ,33.33
03,007,01,001,0003,4,957 ,6 ,963 ,1519 ,0,3,1,3,0,1,0,76.14,63.40 ,33.33
03,007,01,001,0004,5,659 ,7 ,666 ,973 ,0,3,1,3,0,1,0,76.14,68.45 ,33.33
03,007,01,001,0004,6,698 ,2 ,700 ,1087 ,0,3,1,3,0,1,0,76.14,64.40 ,33.33
03,007,01,001,0005,7,692 ,6 ,698 ,1002 ,0,3,1,3,0,1,0,76.14,69.66 ,33.33
03,007,01,001,0006,8,1001 ,11 ,1012 ,1381 ,0,3,1,3,0,1,0,76.14,73.28 ,33.33
03,007,01,001,0007,9,695 ,5 ,700 ,1032 ,0,3,1,3,0,1,0,76.14,67.83 ,33.33
03,007,01,001,0007,10,810 ,9 ,819 ,1312 ,0,3,1,3,0,1,0,76.14,62.42 ,33.33
03,007,01,001,0008,11,493 ,6 ,499 ,758 ,0,3,1,3,0,1,0,76.14,65.83 ,33.33
03,007,01,001,0009,12,623 ,8 ,631 ,930 ,0,3,1,3,0,1,0,76.14,67.85 ,33.33
03,007,01,001,0010,13,533 ,0 ,533 ,799 ,0,3,1,3,0,1,0,76.14,66.71 ,33.33
03,007,01,001,0011,14,910 ,14 ,924 ,1423 ,0,3,1,3,0,1,0,76.14,64.93 ,33.33
03,007,01,001,0012,15,508 ,6 ,514 ,792 ,0,3,1,3,0,1,0,76.14,64.90 ,33.33
03,007,01,001,0013,16,700 ,2 ,702 ,1102 ,0,3,1,3,0,1,0,76.14,63.70 ,33.33
03,007,01,001,0013,17,760 ,5 ,765 ,1130 ,0,3,1,3,0,1,0,76.14,67.70 ,33.33
03,007,01,001,0014,18,744 ,6 ,750 ,1048 ,0,3,1,3,0,1,0,76.14,71.56 ,33.33
03,007,01,001,0014,19,880 ,3 ,883 ,1275 ,0,3,1,3,0,1,0,76.14,69.25 ,33.33
03,007,01,001,0015,20,1000 ,13 ,1013 ,1397 ,0,3,1,3,0,1,0,76.14,72.51 ,33.33
03,007,01,001,0016,21,706 ,8 ,714 ,999 ,0,3,1,3,0,1,0,76.14,71.47 ,33.33
03,007,01,001,0016,22,582 ,9 ,591 ,1145 ,0,3,1,3,0,1,0,76.14,51.62 ,33.33
03,007,01,001,0017,23,957 ,8 ,965 ,1527 ,0,3,1,3,0,1,0,76.14,63.20 ,33.33
03,007,01,001,0017,24,1008 ,13 ,1021 ,1646 ,0,3,1,3,0,1,0,76.14,62.03 ,33.33
03,007,01,001,0017,25,1013 ,8 ,1021 ,1568 ,0,3,1,3,0,1,0,76.14,65.11 ,33.33
03,007,01,001,0017,26,940 ,7 ,947 ,1507 ,0,3,1,3,0,1,0,76.14,62.84 ,33.33
03,007,01,001,0018,27,1220 ,10 ,1230 ,1812 ,0,3,1,3,0,1,0,76.14,67.88 ,33.33
03,007,01,001,0018,28,1265 ,12 ,1277 ,1817 ,0,3,1,3,0,1,0,76.14,70.28 ,33.33
03,007,01,001,0019,29,1135 ,5 ,1140 ,1773 ,0,3,1,3,0,1,0,76.14,64.30 ,33.33
03,007,01,001,0019,30,1078 ,8 ,1086 ,1741 ,0,3,1,3,0,1,0,76.14,62.38 ,33.33
03,007,01,001,0019,31,1132 ,11 ,1143 ,1741 ,0,3,1,3,0,1,0,76.14,65.65 ,33.33
03,007,01,001,0020,32,1089 ,7 ,1096 ,1585 ,0,3,1,3,0,1,0,76.14,69.15 ,33.33
03,007,01,001,0020,33,1069 ,9 ,1078 ,1725 ,0,3,1,3,0,1,0,76.14,62.49 ,33.33
03,007,01,001,0020,34,994 ,8 ,1002 ,1675 ,0,3,1,3,0,1,0,76.14,59.82 ,33.33
03,007,01,001,0020,35,952 ,22 ,974 ,1527 ,0,3,1,3,0,1,0,76.14,63.79 ,33.33
03,007,01,001,0021,36,1012 ,9 ,1021 ,1500 ,0,3,1,3,0,1,0,76.14,68.07 ,33.33
03,007,01,001,0022,37,746 ,6 ,752 ,1062 ,0,3,1,3,0,1,0,76.14,70.81 ,33.33
03,007,01,001,0023,38,968 ,6 ,974 ,1355 ,0,3,1,3,0,1,0,76.14,71.88 ,33.33
03,007,01,001,0023,39,922 ,17 ,939 ,1428 ,0,3,1,3,0,1,0,76.14,65.76 ,33.33
03,007,01,001,0024,40,952 ,7 ,959 ,1458 ,0,3,1,3,0,1,0,76.14,65.78 ,33.33
03,007,01,001,0024,41,1044 ,9 ,1053 ,1609 ,0,3,1,3,0,1,0,76.14,65.44 ,33.33
03,007,01,001,0025,42,626 ,6 ,632 ,884 ,0,3,1,3,0,1,0,76.14,71.49 ,33.33
03,007,01,001,0026,43,647 ,6 ,653 ,972 ,0,3,1,3,0,1,0,76.14,67.18 ,33.33
03,007,01,001,0027,44,839 ,13 ,852 ,1198 ,0,3,1,3,0,1,0,76.14,71.12 ,33.33
03,007,01,001,0028,45,657 ,7 ,664 ,968 ,0,3,1,3,0,1,0,76.14,68.60 ,33.33
03,007,01,001,0029,46,615 ,8 ,623 ,892 ,0,3,1,3,0,1,0,76.14,69.84 ,33.33
03,007,01,001,0029,47,1027 ,10 ,1037 ,1577 ,0,3,1,3,0,1,0,76.14,65.76 ,33.33
03,007,01,001,0030,48,845 ,7 ,852 ,1229 ,0,3,1,3,0,1,0,76.14,69.32 ,33.33
03,007,01,001,0031,49,878 ,7 ,885 ,1302 ,0,3,1,3,0,1,0,76.14,67.97 ,33.33
03,007,01,001,0031,50,932 ,12 ,944 ,1360 ,0,3,1,3,0,1,0,76.14,69.41 ,33.33
03,007,01,001,0032,51,838 ,8 ,846 ,1316 ,0,3,1,3,0,1,0,76.14,64.29 ,33.33
03,007,01,001,0032,52,945 ,8 ,953 ,1453 ,0,3,1,3,0,1,0,76.14,65.59 ,33.33
03,007,01,001,0033,53,777 ,10 ,787 ,1178 ,0,3,1,3,0,1,0,76.14,66.81 ,33.33
03,007,01,001,0034,54,1073 ,12 ,1085 ,1712 ,0,3,1,3,0,1,0,76.14,63.38 ,33.33
03,007,01,001,0034,55,992 ,10 ,1002 ,1615 ,0,3,1,3,0,1,0,76.14,62.04 ,33.33
03,007,01,001,0035,56,1088 ,10 ,1098 ,1685 ,0,3,1,3,0,1,0,76.14,65.16 ,33.33
03,007,01,001,0035,57,1161 ,8 ,1169 ,1854 ,0,3,1,3,0,1,0,76.14,63.05 ,33.33
03,007,01,001,0036,58,1030 ,16 ,1046 ,1516 ,0,3,1,3,0,1,0,76.14,69.00 ,33.33
03,007,01,001,0036,59,852 ,8 ,860 ,1298 ,0,3,1,3,0,1,0,76.14,66.26 ,33.33
03,007,01,001,0036,60,1040 ,7 ,1047 ,1654 ,0,3,1,3,0,1,0,76.14,63.30 ,33.33
03,007,01,001,0037,61,1116 ,5 ,1121 ,1664 ,0,3,1,3,0,1,0,76.14,67.37 ,33.33
03,007,01,001,0037,62,880 ,14 ,894 ,1384 ,0,3,1,3,0,1,0,76.14,64.60 ,33.33
03,007,01,001,0038,63,819 ,5 ,824 ,1213 ,0,3,1,3,0,1,0,76.14,67.93 ,33.33
03,007,01,001,0038,64,855 ,12 ,867 ,1298 ,0,3,1,3,0,1,0,76.14,66.80 ,33.33
03,007,01,001,0039,65,1056 ,14 ,1070 ,1511 ,0,3,1,3,0,1,0,76.14,70.81 ,33.33
03,007,01,001,0040,66,1173 ,7 ,1180 ,1781 ,0,3,1,3,0,1,0,76.14,66.25 ,33.33
03,007,01,001,0041,67,894 ,7 ,901 ,1279 ,0,3,1,3,0,1,0,76.14,70.45 ,33.33
03,007,01,001,0041,68,1024 ,15 ,1039 ,1576 ,0,3,1,3,0,1,0,76.14,65.93 ,33.33
03,007,01,001,0042,69,772 ,8 ,780 ,1232 ,0,3,1,3,0,1,0,76.14,63.31 ,33.33
03,007,01,001,0042,70,1043 ,15 ,1058 ,1515 ,0,3,1,3,0,1,0,76.14,69.83 ,33.33
03,007,01,001,0043,71,818 ,10 ,828 ,1213 ,0,3,1,3,0,1,0,76.14,68.26 ,33.33
03,007,01,001,0043,72,980 ,12 ,992 ,1504 ,0,3,1,3,0,1,0,76.14,65.96 ,33.33
03,007,01,001,0043,73,794 ,16 ,810 ,1281 ,0,3,1,3,0,1,0,76.14,63.23 ,33.33
03,007,01,001,0044,74,544 ,5 ,549 ,843 ,0,3,1,3,0,1,0,76.14,65.12 ,33.33
03,007,01,001,0044,75,627 ,6 ,633 ,949 ,0,3,1,3,0,1,0,76.14,66.70 ,33.33
03,007,01,001,0045,76,1019 ,9 ,1028 ,1589 ,0,3,1,3,0,1,0,76.14,64.69 ,33.33
03,007,01,001,0046,77,641 ,8 ,649 ,951 ,0,3,1,3,0,1,0,76.14,68.24 ,33.33
03,007,01,001,0047,78,964 ,9 ,973 ,1496 ,0,3,1,3,0,1,0,76.14,65.04 ,33.33
03,007,01,001,0048,79,940 ,5 ,945 ,1445 ,0,3,1,3,0,1,0,76.14,65.40 ,33.33
03,007,01,001,0049,80,585 ,3 ,588 ,823 ,0,3,1,3,0,1,0,76.14,71.45 ,33.33
03,007,01,001,0049,81,587 ,4 ,591 ,904 ,0,3,1,3,0,1,0,76.14,65.38 ,33.33
03,007,01,001,0050,82,1221 ,5 ,1226 ,1803 ,0,3,1,3,0,1,0,76.14,68.00 ,33.33
03,007,01,001,0050,83,1281 ,12 ,1293 ,1977 ,0,3,1,3,0,1,0,76.14,65.40 ,33.33
03,007,01,001,0051,84,1277 ,13 ,1290 ,1907 ,0,3,1,3,0,1,0,76.14,67.65 ,33.33
03,007,01,001,0051,85,1222 ,3 ,1225 ,1840 ,0,3,1,3,0,1,0,76.14,66.58 ,33.33
03,007,01,001,0052,86,580 ,9 ,589 ,818 ,0,3,1,3,0,1,0,76.14,72.00 ,33.33
03,007,01,001,0053,87,832 ,7 ,839 ,1169 ,0,3,1,3,0,1,0,76.14,71.77 ,33.33
03,007,01,001,0053,88,733 ,3 ,736 ,1055 ,0,3,1,3,0,1,0,76.14,69.76 ,33.33
03,007,01,001,0054,89,746 ,6 ,752 ,1042 ,0,3,1,3,0,1,0,76.14,72.17 ,33.33
03,007,01,001,0055,90,699 ,10 ,709 ,1061 ,0,3,1,3,0,1,0,76.14,66.82 ,33.33
03,007,01,001,0055,91,758 ,6 ,764 ,1197 ,0,3,1,3,0,1,0,76.14,63.83 ,33.33
03,007,01,001,0056,92,1107 ,8 ,1115 ,1787 ,0,3,1,3,0,1,0,76.14,62.40 ,33.33
03,007,01,001,0056,93,1370 ,25 ,1395 ,2082 ,0,3,1,3,0,1,0,76.14,67.00 ,33.33
03,007,01,001,0056,94,1246 ,12 ,1258 ,1959 ,0,3,1,3,0,1,0,76.14,64.22 ,33.33
03,007,01,001,0057,95,669 ,15 ,684 ,1070 ,0,3,1,3,0,1,0,76.14,63.93 ,33.33
03,007,01,001,0057,96,769 ,2 ,771 ,1218 ,0,3,1,3,0,1,0,76.14,63.30 ,33.33
03,007,01,001,0058,97,1152 ,15 ,1167 ,1774 ,0,3,1,3,0,1,0,76.14,65.78 ,33.33
03,007,01,001,0058,98,1056 ,6 ,1062 ,1564 ,0,3,1,3,0,1,0,76.14,67.90 ,33.33
03,007,01,001,0058,99,441 ,8 ,449 ,644 ,0,3,1,3,0,1,0,76.14,69.72 ,33.33
03,007,01,001,0059,100,803 ,15 ,818 ,1227 ,0,3,1,3,0,1,0,76.14,66.67 ,33.33
03,007,01,001,0059,101,586 ,4 ,590 ,918 ,0,3,1,3,0,1,0,76.14,64.27 ,33.33
03,007,01,001,0060,102,1065 ,18 ,1083 ,1631 ,0,3,1,3,0,1,0,76.14,66.40 ,33.33
03,007,01,001,0061,103,981 ,11 ,992 ,1540 ,0,3,1,3,0,1,0,76.14,64.42 ,33.33
03,007,01,001,0061,104,802 ,8 ,810 ,1086 ,0,3,1,3,0,1,0,76.14,74.59 ,33.33
03,007,01,001,0062,105,1153 ,13 ,1166 ,1613 ,0,3,1,3,0,1,0,76.14,72.29 ,33.33
03,007,01,001,0062,106,840 ,5 ,845 ,1207 ,0,3,1,3,0,1,0,76.14,70.01 ,33.33
03,007,01,001,0063,107,1292 ,8 ,1300 ,2059 ,0,3,1,3,0,1,0,76.14,63.14 ,33.33
03,007,01,001,0063,108,1029 ,9 ,1038 ,1595 ,0,3,1,3,0,1,0,76.14,65.08 ,33.33
03,007,01,001,0064,109,966 ,5 ,971 ,1385 ,0,3,1,3,0,1,0,76.14,70.11 ,33.33
03,007,01,001,0064,110,661 ,7 ,668 ,857 ,0,3,1,3,0,1,0,76.14,77.95 ,33.33
03,007,01,001,0065,111,876 ,16 ,892 ,1339 ,0,3,1,3,0,1,0,76.14,66.62 ,33.33
03,007,01,001,0065,112,969 ,13 ,982 ,1534 ,0,3,1,3,0,1,0,76.14,64.02 ,33.33
03,007,01,001,0065,113,953 ,6 ,959 ,1570 ,0,3,1,3,0,1,0,76.14,61.08 ,33.33
03,007,01,001,0065,114,963 ,8 ,971 ,1568 ,0,3,1,3,0,1,0,76.14,61.93 ,33.33
03,007,01,001,0066,115,716 ,26 ,742 ,1109 ,0,3,1,3,0,1,0,76.14,66.91 ,33.33
03,007,01,001,0067,116,731 ,4 ,735 ,987 ,0,3,1,3,0,1,0,76.14,74.47 ,33.33
03,007,01,001,0068,117,826 ,8 ,834 ,1210 ,0,3,1,3,0,1,0,76.14,68.93 ,33.33
03,007,01,001,0068,118,995 ,12 ,1007 ,1509 ,0,3,1,3,0,1,0,76.14,66.73 ,33.33
03,007,01,001,0069,119,652 ,3 ,655 ,803 ,0,3,1,3,0,1,0,76.14,81.57 ,33.33
03,007,01,001,0070,120,686 ,7 ,693 ,993 ,0,3,1,3,0,1,0,76.14,69.79 ,33.33
03,007,01,001,0071,121,570 ,3 ,573 ,782 ,0,3,1,3,0,1,0,76.14,73.27 ,33.33
03,007,01,001,0072,122,882 ,6 ,888 ,1201 ,0,3,1,3,0,1,0,76.14,73.94 ,33.33
03,007,01,001,0073,123,812 ,12 ,824 ,1133 ,0,3,1,3,0,1,0,76.14,72.73 ,33.33
03,007,01,002,0074,124,819 ,7 ,826 ,1199 ,0,3,1,3,0,1,0,76.14,68.89 ,33.33
03,007,01,002,0074,125,1178 ,5 ,1183 ,1606 ,0,3,1,3,0,1,0,76.14,73.66 ,33.33
03,007,01,002,0075,126,1124 ,15 ,1139 ,1611 ,0,3,1,3,0,1,0,76.14,70.70 ,33.33
03,007,01,002,0076,127,631 ,4 ,635 ,943 ,0,3,1,3,0,1,0,76.14,67.34 ,33.33
03,007,01,002,0076,128,880 ,10 ,890 ,1273 ,0,3,1,3,0,1,0,76.14,69.91 ,33.33
03,007,01,002,0077,129,712 ,11 ,723 ,1015 ,0,3,1,3,0,1,0,76.14,71.23 ,33.33
03,007,01,002,0078,130,964 ,9 ,973 ,1332 ,0,3,1,3,0,1,0,76.14,73.05 ,33.33
03,007,01,002,0079,131,1018 ,15 ,1033 ,1472 ,0,3,1,3,0,1,0,76.14,70.18 ,33.33
03,007,01,002,0080,132,498 ,2 ,500 ,681 ,0,3,1,3,0,1,0,76.14,73.42 ,33.33
03,007,01,002,0081,133,653 ,6 ,659 ,894 ,0,3,1,3,0,1,0,76.14,73.71 ,33.33
03,007,01,002,0081,134,491 ,5 ,496 ,674 ,0,3,1,3,0,1,0,76.14,73.59 ,33.33
03,007,01,002,0082,135,870 ,12 ,882 ,1227 ,0,3,1,3,0,1,0,76.14,71.88 ,33.33
03,007,01,002,0082,136,943 ,10 ,953 ,1383 ,0,3,1,3,0,1,0,76.14,68.91 ,33.33
03,007,01,002,0082,137,912 ,8 ,920 ,1347 ,0,3,1,3,0,1,0,76.14,68.30 ,33.33
03,007,01,002,0083,138,831 ,10 ,841 ,1239 ,0,3,1,3,0,1,0,76.14,67.88 ,33.33
03,007,01,002,0083,139,730 ,9 ,739 ,1110 ,0,3,1,3,0,1,0,76.14,66.58 ,33.33
03,007,01,002,0084,140,1092 ,12 ,1104 ,1625 ,0,3,1,3,0,1,0,76.14,67.94 ,33.33
03,007,01,002,0084,141,1289 ,11 ,1300 ,2069 ,0,3,1,3,0,1,0,76.14,62.83 ,33.33
03,007,01,002,0085,142,900 ,10 ,910 ,1299 ,0,3,1,3,0,1,0,76.14,70.05 ,33.33
03,007,01,002,0086,143,1173 ,11 ,1184 ,1849 ,0,3,1,3,0,1,0,76.14,64.03 ,33.33
03,007,01,002,0086,144,771 ,17 ,788 ,1095 ,0,3,1,3,0,1,0,76.14,71.96 ,33.33
03,007,01,002,0087,145,561 ,5 ,566 ,832 ,0,3,1,3,0,1,0,76.14,68.03 ,33.33
03,007,01,002,0088,146,592 ,5 ,597 ,952 ,0,3,1,3,0,1,0,76.14,62.71 ,33.33
03,007,01,002,0089,147,1026 ,7 ,1033 ,1623 ,0,3,1,3,0,1,0,76.14,63.65 ,33.33
03,007,01,002,0090,148,882 ,9 ,891 ,1472 ,0,3,1,3,0,1,0,76.14,60.53 ,33.33
03,007,01,002,0091,149,953 ,8 ,961 ,1460 ,0,3,1,3,0,1,0,76.14,65.82 ,33.33
03,007,01,003,0092,150,1201 ,21 ,1222 ,1692 ,0,3,1,3,0,1,0,76.14,72.22 ,33.33
03,007,01,003,0093,151,981 ,12 ,993 ,1339 ,0,3,1,3,0,1,0,76.14,74.16 ,33.33
03,007,01,003,0094,152,1155 ,23 ,1178 ,1616 ,0,3,1,3,0,1,0,76.14,72.90 ,33.33
03,007,01,003,0095,153,429 ,3 ,432 ,561 ,0,3,1,3,0,1,0,76.14,77.01 ,33.33
03,007,01,003,0096,154,804 ,7 ,811 ,1102 ,0,3,1,3,0,1,0,76.14,73.59 ,33.33
03,007,01,003,0096,155,804 ,9 ,813 ,1149 ,0,3,1,3,0,1,0,76.14,70.76 ,33.33
03,007,01,003,0097,156,726 ,11 ,737 ,1140 ,0,3,1,3,0,1,0,76.14,64.65 ,33.33
03,007,01,003,0097,157,747 ,12 ,759 ,1038 ,0,3,1,3,0,1,0,76.14,73.12 ,33.33
03,007,01,003,0098,158,1045 ,24 ,1069 ,1539 ,0,3,1,3,0,1,0,76.14,69.46 ,33.33
03,007,01,003,0099,159,621 ,19 ,640 ,887 ,0,3,1,3,0,1,0,76.14,72.15 ,33.33
03,007,01,003,0100,160,673 ,9 ,682 ,937 ,0,3,1,3,0,1,0,76.14,72.79 ,33.33
03,007,01,003,0101,161,726 ,9 ,735 ,1054 ,0,3,1,3,0,1,0,76.14,69.73 ,33.33
03,007,01,003,0102,162,468 ,5 ,473 ,672 ,0,3,1,3,0,1,0,76.14,70.39 ,33.33
03,007,01,003,0103,163,1036 ,11 ,1047 ,1470 ,0,3,1,3,0,1,0,76.14,71.22 ,33.33
03,007,01,003,0104,164,871 ,9 ,880 ,1240 ,0,3,1,3,0,1,0,76.14,70.97 ,33.33
03,007,01,003,0105,165,651 ,8 ,659 ,973 ,0,3,1,3,0,1,0,76.14,67.73 ,33.33
03,007,01,003,0106,166,678 ,10 ,688 ,1046 ,0,3,1,3,0,1,0,76.14,65.77 ,33.33
03,007,01,004,0107,167,805 ,7 ,812 ,1167 ,0,3,1,3,0,1,0,76.14,69.58 ,33.33
03,007,01,004,0108,168,373 ,4 ,377 ,556 ,0,3,1,3,0,1,0,76.14,67.81 ,33.33
03,007,01,004,0109,169,662 ,7 ,669 ,976 ,0,3,1,3,0,1,0,76.14,68.55 ,33.33
03,007,01,004,0110,170,611 ,6 ,617 ,856 ,0,3,1,3,0,1,0,76.14,72.08 ,33.33
03,007,01,004,0111,171,679 ,6 ,685 ,978 ,0,3,1,3,0,1,0,76.14,70.04 ,33.33
03,007,01,004,0112,172,1265 ,14 ,1279 ,1919 ,0,3,1,3,0,1,0,76.14,66.65 ,33.33
03,007,01,004,0113,173,761 ,15 ,776 ,1176 ,0,3,1,3,0,1,0,76.14,65.99 ,33.33
03,007,01,004,0114,174,209 ,2 ,211 ,322 ,0,3,1,3,0,1,0,76.14,65.53 ,33.33
03,007,01,004,0115,175,497 ,5 ,502 ,648 ,0,3,1,3,0,1,0,76.14,77.47 ,33.33
03,007,01,004,0116,176,548 ,4 ,552 ,753 ,0,3,1,3,0,1,0,76.14,73.31 ,33.33
03,007,01,004,0117,177,824 ,15 ,839 ,1125 ,0,3,1,3,0,1,0,76.14,74.58 ,33.33
03,007,01,004,0118,178,398 ,4 ,402 ,595 ,0,3,1,3,0,1,0,76.14,67.56 ,33.33
03,007,01,004,0119,179,665 ,1 ,666 ,925 ,0,3,1,3,0,1,0,76.14,72.00 ,33.33
03,007,01,004,0120,180,864 ,11 ,875 ,1268 ,0,3,1,3,0,1,0,76.14,69.01 ,33.33
03,007,01,004,0121,181,1002 ,13 ,1015 ,1513 ,0,3,1,3,0,1,0,76.14,67.09 ,33.33
03,007,01,004,0121,182,1260 ,3 ,1263 ,1844 ,0,3,1,3,0,1,0,76.14,68.49 ,33.33
03,007,01,004,0122,183,1222 ,10 ,1232 ,1804 ,0,3,1,3,0,1,0,76.14,68.29 ,33.33
03,007,01,004,0122,184,1330 ,8 ,1338 ,1914 ,0,3,1,3,0,1,0,76.14,69.91 ,33.33
03,007,01,004,0123,185,1120 ,13 ,1133 ,1747 ,0,3,1,3,0,1,0,76.14,64.85 ,33.33
03,007,01,004,0123,186,1090 ,11 ,1101 ,1638 ,0,3,1,3,0,1,0,76.14,67.22 ,33.33
03,007,01,004,0124,187,1318 ,13 ,1331 ,1950 ,0,3,1,3,0,1,0,76.14,68.26 ,33.33
03,007,01,004,0124,188,1100 ,13 ,1113 ,1571 ,0,3,1,3,0,1,0,76.14,70.85 ,33.33
03,007,01,004,0124,189,1399 ,12 ,1411 ,2013 ,0,3,1,3,0,1,0,76.14,70.09 ,33.33
03,007,01,004,0125,190,1280 ,15 ,1295 ,1824 ,0,3,1,3,0,1,0,76.14,71.00 ,33.33
03,007,01,004,0125,191,851 ,12 ,863 ,1259 ,0,3,1,3,0,1,0,76.14,68.55 ,33.33
03,007,01,004,0125,192,647 ,5 ,652 ,1119 ,0,3,1,3,0,1,0,76.14,58.27 ,33.33
03,007,01,004,0126,193,1007 ,8 ,1015 ,1493 ,0,3,1,3,0,1,0,76.14,67.98 ,33.33
03,007,01,004,0126,194,1264 ,21 ,1285 ,1694 ,0,3,1,3,0,1,0,76.14,75.86 ,33.33
03,007,01,004,0127,195,1142 ,14 ,1156 ,1651 ,0,3,1,3,0,1,0,76.14,70.02 ,33.33
03,007,01,004,0128,196,1100 ,14 ,1114 ,1508 ,0,3,1,3,0,1,0,76.14,73.87 ,33.33
03,007,01,004,0128,197,1004 ,10 ,1014 ,1397 ,0,3,1,3,0,1,0,76.14,72.58 ,33.33
03,007,01,004,0129,198,636 ,3 ,639 ,879 ,0,3,1,3,0,1,0,76.14,72.70 ,33.33
03,007,01,004,0129,199,1051 ,8 ,1059 ,1454 ,0,3,1,3,0,1,0,76.14,72.83 ,33.33
03,007,01,004,0130,200,966 ,8 ,974 ,1390 ,0,3,1,3,0,1,0,76.14,70.07 ,33.33
03,007,01,004,0130,201,1057 ,13 ,1070 ,1483 ,0,3,1,3,0,1,0,76.14,72.15 ,33.33
03,007,01,004,0131,202,726 ,8 ,734 ,1016 ,0,3,1,3,0,1,0,76.14,72.24 ,33.33
03,007,01,004,0131,203,1373 ,13 ,1386 ,1871 ,0,3,1,3,0,1,0,76.14,74.08 ,33.33
03,007,01,004,0132,204,1260 ,17 ,1277 ,1807 ,0,3,1,3,0,1,0,76.14,70.67 ,33.33
03,007,01,004,0133,205,1026 ,5 ,1031 ,1391 ,0,3,1,3,0,1,0,76.14,74.12 ,33.33
03,007,01,004,0133,206,641 ,7 ,648 ,827 ,0,3,1,3,0,1,0,76.14,78.36 ,33.33
03,007,01,004,0134,207,914 ,6 ,920 ,1362 ,0,3,1,3,0,1,0,76.14,67.55 ,33.33
03,007,01,004,0134,208,1219 ,12 ,1231 ,1757 ,0,3,1,3,0,1,0,76.14,70.06 ,33.33
03,007,01,004,0135,209,985 ,4 ,989 ,1365 ,0,3,1,3,0,1,0,76.14,72.45 ,33.33
03,007,01,004,0135,210,944 ,19 ,963 ,1341 ,0,3,1,3,0,1,0,76.14,71.81 ,33.33
03,007,01,004,0135,211,599 ,6 ,605 ,769 ,0,3,1,3,0,1,0,76.14,78.67 ,33.33
03,007,01,005,0136,212,809 ,9 ,818 ,1178 ,0,3,1,3,0,1,0,76.14,69.44 ,33.33
03,007,01,005,0136,213,647 ,11 ,658 ,904 ,0,3,1,3,0,1,0,76.14,72.79 ,33.33
03,007,01,005,0137,214,804 ,7 ,811 ,1099 ,0,3,1,3,0,1,0,76.14,73.79 ,33.33
03,007,01,005,0138,215,796 ,21 ,817 ,1077 ,0,3,1,3,0,1,0,76.14,75.86 ,33.33
03,007,01,005,0139,216,920 ,17 ,937 ,1242 ,0,3,1,3,0,1,0,76.14,75.44 ,33.33
03,007,01,005,0140,217,517 ,10 ,527 ,727 ,0,3,1,3,0,1,0,76.14,72.49 ,33.33
03,007,01,005,0141,218,887 ,14 ,901 ,1159 ,0,3,1,3,0,1,0,76.14,77.74 ,33.33
03,007,01,005,0142,219,795 ,14 ,809 ,1081 ,0,3,1,3,0,1,0,76.14,74.84 ,33.33
03,007,01,005,0143,220,735 ,8 ,743 ,968 ,0,3,1,3,0,1,0,76.14,76.76 ,33.33
03,007,01,005,0143,221,840 ,9 ,849 ,1233 ,0,3,1,3,0,1,0,76.14,68.86 ,33.33
03,007,01,005,0144,222,1021 ,26 ,1047 ,1342 ,0,3,1,3,0,1,0,76.14,78.02 ,33.33
03,007,01,005,0145,223,975 ,14 ,989 ,1273 ,0,3,1,3,0,1,0,76.14,77.69 ,33.33
03,007,01,005,0146,224,747 ,11 ,758 ,985 ,0,3,1,3,0,1,0,76.14,76.95 ,33.33
03,007,01,005,0146,225,779 ,8 ,787 ,1108 ,0,3,1,3,0,1,0,76.14,71.03 ,33.33
03,007,01,005,0147,226,697 ,3 ,700 ,971 ,0,3,1,3,0,1,0,76.14,72.09 ,33.33
03,007,01,005,0147,227,510 ,8 ,518 ,715 ,0,3,1,3,0,1,0,76.14,72.45 ,33.33
03,007,01,005,0148,228,615 ,8 ,623 ,906 ,0,3,1,3,0,1,0,76.14,68.76 ,33.33
03,007,01,005,0148,229,845 ,13 ,858 ,1186 ,0,3,1,3,0,1,0,76.14,72.34 ,33.33
03,007,01,005,0149,230,817 ,10 ,827 ,1100 ,0,3,1,3,0,1,0,76.14,75.18 ,33.33
03,007,01,005,0150,231,782 ,7 ,789 ,1033 ,0,3,1,3,0,1,0,76.14,76.38 ,33.33
03,007,01,005,0151,232,765 ,8 ,773 ,1026 ,0,3,1,3,0,1,0,76.14,75.34 ,33.33
03,007,01,005,0151,233,753 ,14 ,767 ,1076 ,0,3,1,3,0,1,0,76.14,71.28 ,33.33
03,007,01,005,0152,234,680 ,3 ,683 ,884 ,0,3,1,3,0,1,0,76.14,77.26 ,33.33
03,007,01,005,0152,235,679 ,13 ,692 ,942 ,0,3,1,3,0,1,0,76.14,73.46 ,33.33
03,007,01,005,0153,236,708 ,11 ,719 ,917 ,0,3,1,3,0,1,0,76.14,78.41 ,33.33
03,007,01,005,0153,237,853 ,13 ,866 ,1171 ,0,3,1,3,0,1,0,76.14,73.95 ,33.33
03,007,01,005,0154,238,872 ,11 ,883 ,1192 ,0,3,1,3,0,1,0,76.14,74.08 ,33.33
03,007,01,005,0155,239,958 ,14 ,972 ,1272 ,0,3,1,3,0,1,0,76.14,76.42 ,33.33
03,007,01,005,0156,240,1069 ,15 ,1084 ,1581 ,0,3,1,3,0,1,0,76.14,68.56 ,33.33
03,007,01,005,0156,241,903 ,8 ,911 ,1281 ,0,3,1,3,0,1,0,76.14,71.12 ,33.33
03,007,01,005,0157,242,741 ,4 ,745 ,1013 ,0,3,1,3,0,1,0,76.14,73.54 ,33.33
03,007,01,005,0157,243,865 ,13 ,878 ,1164 ,0,3,1,3,0,1,0,76.14,75.43 ,33.33
03,007,01,006,0158,244,687 ,5 ,692 ,1015 ,0,3,1,3,0,1,0,76.14,68.18 ,33.33
03,007,01,006,0158,245,431 ,8 ,439 ,601 ,0,3,1,3,0,1,0,76.14,73.04 ,33.33
03,007,01,006,0159,246,1037 ,18 ,1055 ,1480 ,0,3,1,3,0,1,0,76.14,71.28 ,33.33
03,007,01,006,0160,247,577 ,6 ,583 ,904 ,0,3,1,3,0,1,0,76.14,64.49 ,33.33
03,007,01,006,0160,248,836 ,6 ,842 ,1165 ,0,3,1,3,0,1,0,76.14,72.27 ,33.33
03,007,01,006,0161,249,877 ,11 ,888 ,1186 ,0,3,1,3,0,1,0,76.14,74.87 ,33.33
03,007,01,006,0162,250,613 ,12 ,625 ,878 ,0,3,1,3,0,1,0,76.14,71.18 ,33.33
03,007,01,006,0162,251,556 ,6 ,562 ,780 ,0,3,1,3,0,1,0,76.14,72.05 ,33.33
03,007,01,006,0163,252,794 ,13 ,807 ,1173 ,0,3,1,3,0,1,0,76.14,68.80 ,33.33
03,007,01,006,0163,253,652 ,9 ,661 ,949 ,0,3,1,3,0,1,0,76.14,69.65 ,33.33
03,007,01,006,0163,254,755 ,16 ,771 ,1140 ,0,3,1,3,0,1,0,76.14,67.63 ,33.33
03,007,01,006,0164,255,1091 ,9 ,1100 ,1486 ,0,3,1,3,0,1,0,76.14,74.02 ,33.33
03,007,01,006,0164,256,800 ,10 ,810 ,1166 ,0,3,1,3,0,1,0,76.14,69.47 ,33.33
03,007,01,006,0165,257,851 ,9 ,860 ,1146 ,0,3,1,3,0,1,0,76.14,75.04 ,33.33
03,007,01,006,0165,258,613 ,6 ,619 ,853 ,0,3,1,3,0,1,0,76.14,72.57 ,33.33
03,007,01,006,0166,259,847 ,8 ,855 ,1129 ,0,3,1,3,0,1,0,76.14,75.73 ,33.33
03,007,01,006,0167,260,863 ,7 ,870 ,1268 ,0,3,1,3,0,1,0,76.14,68.61 ,33.33
03,007,01,006,0167,261,866 ,15 ,881 ,1241 ,0,3,1,3,0,1,0,76.14,70.99 ,33.33
03,007,01,006,0167,262,709 ,13 ,722 ,1064 ,0,3,1,3,0,1,0,76.14,67.86 ,33.33
03,007,01,006,0168,263,461 ,7 ,468 ,658 ,0,3,1,3,0,1,0,76.14,71.12 ,33.33
03,007,01,006,0168,264,724 ,6 ,730 ,1098 ,0,3,1,3,0,1,0,76.14,66.48 ,33.33
03,007,01,006,0169,265,1035 ,15 ,1050 ,1366 ,0,3,1,3,0,1,0,76.14,76.87 ,33.33
03,007,01,006,0170,266,1022 ,10 ,1032 ,1428 ,0,3,1,3,0,1,0,76.14,72.27 ,33.33
03,007,01,006,0171,267,864 ,11 ,875 ,1151 ,0,3,1,3,0,1,0,76.14,76.02 ,33.33
03,007,01,006,0171,268,547 ,6 ,553 ,757 ,0,3,1,3,0,1,0,76.14,73.05 ,33.33
03,007,01,007,0172,269,1273 ,15 ,1288 ,1874 ,0,3,1,3,0,1,0,76.14,68.73 ,33.33
03,007,01,007,0172,270,1452 ,18 ,1470 ,2308 ,0,3,1,3,0,1,0,76.14,63.69 ,33.33
03,007,01,007,0173,271,1274 ,10 ,1284 ,1985 ,0,3,1,3,0,1,0,76.14,64.69 ,33.33
03,007,01,007,0173,272,997 ,7 ,1004 ,1572 ,0,3,1,3,0,1,0,76.14,63.87 ,33.33
03,007,01,007,0174,273,351 ,2 ,353 ,444 ,0,3,1,3,0,1,0,76.14,79.50 ,33.33
03,007,01,007,0175,274,934 ,10 ,944 ,1401 ,0,3,1,3,0,1,0,76.14,67.38 ,33.33
03,007,01,007,0176,275,899 ,9 ,908 ,1430 ,0,3,1,3,0,1,0,76.14,63.50 ,33.33
03,007,01,007,0176,276,1092 ,8 ,1100 ,1685 ,0,3,1,3,0,1,0,76.14,65.28 ,33.33
03,007,01,007,0177,277,711 ,7 ,718 ,1115 ,0,3,1,3,0,1,0,76.14,64.39 ,33.33
03,007,01,007,0177,278,854 ,8 ,862 ,1311 ,0,3,1,3,0,1,0,76.14,65.75 ,33.33
03,007,01,007,0178,279,990 ,17 ,1007 ,1389 ,0,3,1,3,0,1,0,76.14,72.50 ,33.33
03,007,01,007,0179,280,609 ,1 ,610 ,778 ,0,3,1,3,0,1,0,76.14,78.41 ,33.33
03,007,01,007,0180,281,429 ,8 ,437 ,567 ,0,3,1,3,0,1,0,76.14,77.07 ,33.33
03,007,01,007,0180,282,809 ,11 ,820 ,1159 ,0,3,1,3,0,1,0,76.14,70.75 ,33.33
03,007,01,007,0181,283,864 ,9 ,873 ,1154 ,0,3,1,3,0,1,0,76.14,75.65 ,33.33
03,007,01,007,0181,284,801 ,10 ,811 ,1292 ,0,3,1,3,0,1,0,76.14,62.77 ,33.33
03,007,01,007,0182,285,917 ,6 ,923 ,1246 ,0,3,1,3,0,1,0,76.14,74.08 ,33.33
03,007,01,007,0183,286,1141 ,14 ,1155 ,1543 ,0,3,1,3,0,1,0,76.14,74.85 ,33.33
03,007,01,007,0184,287,1198 ,13 ,1211 ,1760 ,0,3,1,3,0,1,0,76.14,68.81 ,33.33
03,007,01,007,0185,288,872 ,11 ,883 ,1238 ,0,3,1,3,0,1,0,76.14,71.32 ,33.33
03,007,01,007,0186,289,1188 ,8 ,1196 ,1818 ,0,3,1,3,0,1,0,76.14,65.79 ,33.33
03,007,01,007,0186,290,1131 ,16 ,1147 ,1771 ,0,3,1,3,0,1,0,76.14,64.77 ,33.33
03,007,01,007,0186,291,1322 ,5 ,1327 ,2083 ,0,3,1,3,0,1,0,76.14,63.71 ,33.33
03,007,01,007,0187,292,1027 ,15 ,1042 ,1544 ,0,3,1,3,0,1,0,76.14,67.49 ,33.33
03,007,01,007,0188,293,1120 ,9 ,1129 ,1715 ,0,3,1,3,0,1,0,76.14,65.83 ,33.33
03,007,01,007,0189,294,942 ,14 ,956 ,1334 ,0,3,1,3,0,1,0,76.14,71.66 ,33.33
03,007,01,007,0189,295,707 ,6 ,713 ,1083 ,0,3,1,3,0,1,0,76.14,65.84 ,33.33
03,007,01,007,0190,296,975 ,10 ,985 ,1344 ,0,3,1,3,0,1,0,76.14,73.29 ,33.33
03,007,01,007,0190,297,966 ,8 ,974 ,1317 ,0,3,1,3,0,1,0,76.14,73.96 ,33.33
03,007,01,007,0191,298,620 ,10 ,630 ,793 ,0,3,1,3,0,1,0,76.14,79.45 ,33.33
03,007,01,007,0192,299,762 ,11 ,773 ,1190 ,0,3,1,3,0,1,0,76.14,64.96 ,33.33
03,007,01,007,0192,300,721 ,9 ,730 ,1081 ,0,3,1,3,0,1,0,76.14,67.53 ,33.33
03,007,01,007,0193,301,748 ,10 ,758 ,1056 ,0,3,1,3,0,1,0,76.14,71.78 ,33.33
03,007,01,007,0193,302,729 ,9 ,738 ,1014 ,0,3,1,3,0,1,0,76.14,72.78 ,33.33
03,007,01,007,0194,303,802 ,10 ,812 ,1083 ,0,3,1,3,0,1,0,76.14,74.98 ,33.33
03,007,01,007,0195,304,746 ,12 ,758 ,1009 ,0,3,1,3,0,1,0,76.14,75.12 ,33.33
03,007,01,007,0195,305,968 ,14 ,982 ,1569 ,0,3,1,3,0,1,0,76.14,62.59 ,33.33
03,007,01,007,0196,306,1065 ,10 ,1075 ,1572 ,0,3,1,3,0,1,0,76.14,68.38 ,33.33
03,007,01,007,0196,307,864 ,7 ,871 ,1200 ,0,3,1,3,0,1,0,76.14,72.58 ,33.33
03,007,01,007,0197,308,1118 ,10 ,1128 ,1652 ,0,3,1,3,0,1,0,76.14,68.28 ,33.33
03,007,01,007,0198,309,584 ,9 ,593 ,856 ,0,3,1,3,0,1,0,76.14,69.28 ,33.33
03,007,01,007,0199,310,833 ,8 ,841 ,1205 ,0,3,1,3,0,1,0,76.14,69.79 ,33.33
03,007,01,007,0200,311,1259 ,26 ,1285 ,1714 ,0,3,1,3,0,1,0,76.14,74.97 ,33.33
03,007,01,007,0201,312,1089 ,13 ,1102 ,1679 ,0,3,1,3,0,1,0,76.14,65.63 ,33.33
03,007,01,007,0201,313,816 ,9 ,825 ,1176 ,0,3,1,3,0,1,0,76.14,70.15 ,33.33
03,007,01,007,0202,314,687 ,6 ,693 ,947 ,0,3,1,3,0,1,0,76.14,73.18 ,33.33
03,007,01,007,0202,315,514 ,4 ,518 ,696 ,0,3,1,3,0,1,0,76.14,74.43 ,33.33
03,007,01,008,0203,316,1332 ,22 ,1354 ,1930 ,0,3,1,3,0,1,0,76.14,70.16 ,33.33
03,007,01,008,0204,317,780 ,15 ,795 ,1148 ,0,3,1,3,0,1,0,76.14,69.25 ,33.33
03,007,01,008,0205,318,1336 ,26 ,1362 ,2019 ,0,3,1,3,0,1,0,76.14,67.46 ,33.33
03,007,01,008,0206,319,872 ,10 ,882 ,1157 ,0,3,1,3,0,1,0,76.14,76.23 ,33.33
03,007,01,008,0207,320,710 ,6 ,716 ,1034 ,0,3,1,3,0,1,0,76.14,69.25 ,33.33
03,007,01,008,0208,321,1188 ,13 ,1201 ,1679 ,0,3,1,3,0,1,0,76.14,71.53 ,33.33
03,007,01,008,0209,322,939 ,7 ,946 ,1296 ,0,3,1,3,0,1,0,76.14,72.99 ,33.33
03,007,01,008,0209,323,592 ,8 ,600 ,871 ,0,3,1,3,0,1,0,76.14,68.89 ,33.33
03,007,01,008,0210,324,794 ,7 ,801 ,1096 ,0,3,1,3,0,1,0,76.14,73.08 ,33.33
03,007,01,009,0211,325,780 ,12 ,792 ,1238 ,0,3,1,3,0,1,0,76.14,63.97 ,33.33
03,007,01,009,0211,326,978 ,8 ,986 ,1509 ,0,3,1,3,0,1,0,76.14,65.34 ,33.33
03,007,01,009,0211,327,982 ,15 ,997 ,1533 ,0,3,1,3,0,1,0,76.14,65.04 ,33.33
03,007,01,009,0212,328,1074 ,16 ,1090 ,1545 ,0,3,1,3,0,1,0,76.14,70.55 ,33.33
03,007,01,009,0213,329,873 ,10 ,883 ,1224 ,0,3,1,3,0,1,0,76.14,72.14 ,33.33
03,007,01,009,0214,330,1210 ,19 ,1229 ,1630 ,0,3,1,3,0,1,0,76.14,75.40 ,33.33
03,007,01,009,0215,331,1109 ,9 ,1118 ,1550 ,0,3,1,3,0,1,0,76.14,72.13 ,33.33
03,007,01,009,0216,332,1100 ,12 ,1112 ,1582 ,0,3,1,3,0,1,0,76.14,70.29 ,33.33
03,007,01,009,0217,333,699 ,7 ,706 ,1038 ,0,3,1,3,0,1,0,76.14,68.02 ,33.33
03,007,01,009,0217,334,719 ,6 ,725 ,1179 ,0,3,1,3,0,1,0,76.14,61.49 ,33.33
03,007,01,009,0218,335,1214 ,18 ,1232 ,1692 ,0,3,1,3,0,1,0,76.14,72.81 ,33.33
03,007,01,009,0219,336,823 ,9 ,832 ,1200 ,0,3,1,3,0,1,0,76.14,69.33 ,33.33
03,007,01,009,0220,337,1010 ,18 ,1028 ,1491 ,0,3,1,3,0,1,0,76.14,68.95 ,33.33
03,007,01,009,0221,338,814 ,11 ,825 ,1144 ,0,3,1,3,0,1,0,76.14,72.12 ,33.33
03,007,01,009,0222,339,651 ,7 ,658 ,974 ,0,3,1,3,0,1,0,76.14,67.56 ,33.33
03,007,01,009,0223,340,1428 ,13 ,1441 ,2000 ,0,3,1,3,0,1,0,76.14,72.05 ,33.33
03,007,01,009,0224,341,1433 ,21 ,1454 ,1986 ,0,3,1,3,0,1,0,76.14,73.21 ,33.33
03,007,01,010,0225,342,709 ,12 ,721 ,1105 ,0,3,1,3,0,1,0,76.14,65.25 ,33.33
03,007,01,010,0226,343,699 ,7 ,706 ,1064 ,0,3,1,3,0,1,0,76.14,66.35 ,33.33
03,007,01,010,0226,344,1005 ,10 ,1015 ,1547 ,0,3,1,3,0,1,0,76.14,65.61 ,33.33
03,007,01,010,0227,345,877 ,16 ,893 ,1370 ,0,3,1,3,0,1,0,76.14,65.18 ,33.33
03,007,01,010,0227,346,902 ,8 ,910 ,1532 ,0,3,1,3,0,1,0,76.14,59.40 ,33.33
03,007,01,010,0228,347,862 ,6 ,868 ,1325 ,0,3,1,3,0,1,0,76.14,65.51 ,33.33
03,007,01,010,0228,348,873 ,5 ,878 ,1342 ,0,3,1,3,0,1,0,76.14,65.42 ,33.33
03,007,01,010,0229,349,544 ,6 ,550 ,799 ,0,3,1,3,0,1,0,76.14,68.84 ,33.33
03,007,01,010,0230,350,647 ,8 ,655 ,1049 ,0,3,1,3,0,1,0,76.14,62.44 ,33.33
03,007,01,010,0230,351,1064 ,13 ,1077 ,1658 ,0,3,1,3,0,1,0,76.14,64.96 ,33.33
03,007,01,010,0231,352,636 ,4 ,640 ,933 ,0,3,1,3,0,1,0,76.14,68.60 ,33.33
03,007,01,010,0232,353,497 ,3 ,500 ,695 ,0,3,1,3,0,1,0,76.14,71.94 ,33.33
03,007,01,010,0233,354,578 ,5 ,583 ,832 ,0,3,1,3,0,1,0,76.14,70.07 ,33.33
03,007,01,010,0233,355,598 ,6 ,604 ,891 ,0,3,1,3,0,1,0,76.14,67.79 ,33.33
03,007,01,010,0234,356,1075 ,12 ,1087 ,1799 ,0,3,1,3,0,1,0,76.14,60.42 ,33.33
03,007,01,010,0234,357,869 ,8 ,877 ,1415 ,0,3,1,3,0,1,0,76.14,61.98 ,33.33
03,007,01,010,0234,358,888 ,15 ,903 ,1383 ,0,3,1,3,0,1,0,76.14,65.29 ,33.33
03,007,01,010,0235,359,648 ,8 ,656 ,1012 ,0,3,1,3,0,1,0,76.14,64.82 ,33.33
03,007,01,010,0235,360,803 ,10 ,813 ,1271 ,0,3,1,3,0,1,0,76.14,63.97 ,33.33
03,007,01,010,0236,361,735 ,10 ,745 ,1104 ,0,3,1,3,0,1,0,76.14,67.48 ,33.33
03,007,01,010,0236,362,679 ,8 ,687 ,1040 ,0,3,1,3,0,1,0,76.14,66.06 ,33.33
03,007,01,010,0236,363,533 ,3 ,536 ,793 ,0,3,1,3,0,1,0,76.14,67.59 ,33.33
03,007,01,010,0236,364,552 ,6 ,558 ,829 ,0,3,1,3,0,1,0,76.14,67.31 ,33.33
03,007,01,010,0237,365,632 ,5 ,637 ,1010 ,0,3,1,3,0,1,0,76.14,63.07 ,33.33
03,007,01,010,0237,366,753 ,8 ,761 ,1196 ,0,3,1,3,0,1,0,76.14,63.63 ,33.33
03,007,01,010,0237,367,921 ,10 ,931 ,1367 ,0,3,1,3,0,1,0,76.14,68.11 ,33.33
03,007,01,010,0238,368,966 ,11 ,977 ,1516 ,0,3,1,3,0,1,0,76.14,64.45 ,33.33
03,007,01,010,0238,369,904 ,10 ,914 ,1384 ,0,3,1,3,0,1,0,76.14,66.04 ,33.33
03,007,01,010,0238,370,827 ,9 ,836 ,1295 ,0,3,1,3,0,1,0,76.14,64.56 ,33.33
03,007,01,010,0239,371,1013 ,6 ,1019 ,1525 ,0,3,1,3,0,1,0,76.14,66.82 ,33.33
03,007,01,010,0240,372,1207 ,18 ,1225 ,1796 ,0,3,1,3,0,1,0,76.14,68.21 ,33.33
03,007,01,010,0241,373,889 ,6 ,895 ,1304 ,0,3,1,3,0,1,0,76.14,68.63 ,33.33
03,007,01,010,0242,374,673 ,11 ,684 ,1030 ,0,3,1,3,0,1,0,76.14,66.41 ,33.33
03,007,01,010,0242,375,538 ,3 ,541 ,832 ,0,3,1,3,0,1,0,76.14,65.02 ,33.33
03,007,01,010,0243,376,639 ,7 ,646 ,1048 ,0,3,1,3,0,1,0,76.14,61.64 ,33.33
03,007,01,010,0243,377,659 ,5 ,664 ,1030 ,0,3,1,3,0,1,0,76.14,64.47 ,33.33
03,007,01,010,0244,378,1037 ,15 ,1052 ,1875 ,0,3,1,3,0,1,0,76.14,56.11 ,33.33
03,007,01,010,0244,379,942 ,14 ,956 ,1638 ,0,3,1,3,0,1,0,76.14,58.36 ,33.33
03,007,01,010,0244,380,1002 ,6 ,1008 ,1617 ,0,3,1,3,0,1,0,76.14,62.34 ,33.33
03,007,01,010,0245,381,773 ,7 ,780 ,1159 ,0,3,1,3,0,1,0,76.14,67.30 ,33.33
03,007,01,010,0245,382,848 ,12 ,860 ,1386 ,0,3,1,3,0,1,0,76.14,62.05 ,33.33
03,007,01,010,0246,383,774 ,2 ,776 ,1316 ,0,3,1,3,0,1,0,76.14,58.97 ,33.33
03,007,01,010,0246,384,752 ,10 ,762 ,1158 ,0,3,1,3,0,1,0,76.14,65.80 ,33.33
03,007,01,010,0247,385,595 ,7 ,602 ,943 ,0,3,1,3,0,1,0,76.14,63.84 ,33.33
03,007,01,010,0247,386,610 ,7 ,617 ,966 ,0,3,1,3,0,1,0,76.14,63.87 ,33.33
03,007,01,010,0248,387,678 ,12 ,690 ,1122 ,0,3,1,3,0,1,0,76.14,61.50 ,33.33
03,007,01,010,0248,388,552 ,7 ,559 ,889 ,0,3,1,3,0,1,0,76.14,62.88 ,33.33
03,007,01,010,0249,389,968 ,18 ,986 ,1576 ,0,3,1,3,0,1,0,76.14,62.56 ,33.33
03,007,01,010,0250,390,718 ,8 ,726 ,1129 ,0,3,1,3,0,1,0,76.14,64.30 ,33.33
03,007,01,010,0250,391,666 ,3 ,669 ,981 ,0,3,1,3,0,1,0,76.14,68.20 ,33.33
03,007,01,010,0251,392,796 ,10 ,806 ,1195 ,0,3,1,3,0,1,0,76.14,67.45 ,33.33
03,007,01,010,0251,393,846 ,12 ,858 ,1312 ,0,3,1,3,0,1,0,76.14,65.40 ,33.33
03,007,01,010,0252,394,728 ,3 ,731 ,1091 ,0,3,1,3,0,1,0,76.14,67.00 ,33.33
03,007,01,010,0252,395,631 ,10 ,641 ,927 ,0,3,1,3,0,1,0,76.14,69.15 ,33.33
03,007,01,010,0253,396,572 ,3 ,575 ,836 ,0,3,1,3,0,1,0,76.14,68.78 ,33.33
03,007,01,010,0253,397,634 ,9 ,643 ,999 ,0,3,1,3,0,1,0,76.14,64.36 ,33.33
03,007,01,010,0253,398,860 ,2 ,862 ,1282 ,0,3,1,3,0,1,0,76.14,67.24 ,33.33
03,007,01,010,0254,399,773 ,11 ,784 ,1055 ,0,3,1,3,0,1,0,76.14,74.31 ,33.33
03,007,01,010,0254,400,829 ,6 ,835 ,1194 ,0,3,1,3,0,1,0,76.14,69.93 ,33.33
03,007,01,010,0255,401,695 ,10 ,705 ,1102 ,0,3,1,3,0,1,0,76.14,63.97 ,33.33
03,007,01,010,0255,402,744 ,13 ,757 ,1152 ,0,3,1,3,0,1,0,76.14,65.71 ,33.33
03,007,01,010,0256,403,636 ,4 ,640 ,1044 ,0,3,1,3,0,1,0,76.14,61.30 ,33.33
03,007,01,010,0256,404,784 ,6 ,790 ,1234 ,0,3,1,3,0,1,0,76.14,64.02 ,33.33
03,007,01,010,0257,405,1141 ,14 ,1155 ,1695 ,0,3,1,3,0,1,0,76.14,68.14 ,33.33
03,007,01,010,0258,406,774 ,8 ,782 ,1264 ,0,3,1,3,0,1,0,76.14,61.87 ,33.33
03,007,01,010,0259,407,451 ,6 ,457 ,733 ,0,3,1,3,0,1,0,76.14,62.35 ,33.33
03,007,01,010,0260,408,654 ,6 ,660 ,1010 ,0,3,1,3,0,1,0,76.14,65.35 ,33.33
03,007,01,010,0260,409,550 ,6 ,556 ,843 ,0,3,1,3,0,1,0,76.14,65.95 ,33.33
03,007,01,010,0261,410,723 ,12 ,735 ,1121 ,0,3,1,3,0,1,0,76.14,65.57 ,33.33
03,007,01,010,0261,411,554 ,2 ,556 ,919 ,0,3,1,3,0,1,0,76.14,60.50 ,33.33
03,007,01,010,0262,412,1043 ,12 ,1055 ,1685 ,0,3,1,3,0,1,0,76.14,62.61 ,33.33
03,007,01,010,0263,413,629 ,9 ,638 ,955 ,0,3,1,3,0,1,0,76.14,66.81 ,33.33
03,007,01,010,0263,414,447 ,2 ,449 ,688 ,0,3,1,3,0,1,0,76.14,65.26 ,33.33
03,007,01,010,0264,415,917 ,17 ,934 ,1527 ,0,3,1,3,0,1,0,76.14,61.17 ,33.33
03,007,01,010,0265,416,654 ,14 ,668 ,996 ,0,3,1,3,0,1,0,76.14,67.07 ,33.33
03,007,01,010,0265,417,661 ,7 ,668 ,1037 ,0,3,1,3,0,1,0,76.14,64.42 ,33.33
03,007,01,011,0266,418,780 ,8 ,788 ,1071 ,0,3,1,3,0,1,0,76.14,73.58 ,33.33
03,007,01,011,0266,419,707 ,7 ,714 ,1054 ,0,3,1,3,0,1,0,76.14,67.74 ,33.33
03,007,01,011,0267,420,1055 ,14 ,1069 ,1553 ,0,3,1,3,0,1,0,76.14,68.83 ,33.33
03,007,01,011,0268,421,655 ,9 ,664 ,925 ,0,3,1,3,0,1,0,76.14,71.78 ,33.33
03,007,01,011,0269,422,946 ,7 ,953 ,1373 ,0,3,1,3,0,1,0,76.14,69.41 ,33.33
03,007,01,011,0270,423,908 ,11 ,919 ,1281 ,0,3,1,3,0,1,0,76.14,71.74 ,33.33
03,007,01,011,0271,424,953 ,7 ,960 ,1453 ,0,3,1,3,0,1,0,76.14,66.07 ,33.33
03,007,01,011,0272,425,732 ,6 ,738 ,1099 ,0,3,1,3,0,1,0,76.14,67.15 ,33.33
03,007,01,011,0273,426,836 ,7 ,843 ,1187 ,0,3,1,3,0,1,0,76.14,71.02 ,33.33
03,007,01,011,0274,427,901 ,4 ,905 ,1268 ,0,3,1,3,0,1,0,76.14,71.37 ,33.33
03,007,01,011,0274,428,551 ,5 ,556 ,895 ,0,3,1,3,0,1,0,76.14,62.12 ,33.33
03,007,01,011,0275,429,748 ,4 ,752 ,1035 ,0,3,1,3,0,1,0,76.14,72.66 ,33.33
03,007,01,011,0275,430,710 ,8 ,718 ,1124 ,0,3,1,3,0,1,0,76.14,63.88 ,33.33
03,007,01,011,0276,431,1201 ,17 ,1218 ,1800 ,0,3,1,3,0,1,0,76.14,67.67 ,33.33
03,007,01,011,0277,432,922 ,5 ,927 ,1243 ,0,3,1,3,0,1,0,76.14,74.58 ,33.33
03,007,01,011,0278,433,940 ,5 ,945 ,1439 ,0,3,1,3,0,1,0,76.14,65.67 ,33.33
03,007,01,011,0278,434,722 ,3 ,725 ,1101 ,0,3,1,3,0,1,0,76.14,65.85 ,33.33
03,007,01,011,0279,435,1164 ,15 ,1179 ,1791 ,0,3,1,3,0,1,0,76.14,65.83 ,33.33
03,007,01,011,0280,436,1123 ,11 ,1134 ,1760 ,0,3,1,3,0,1,0,76.14,64.43 ,33.33
03,007,01,011,0281,437,742 ,9 ,751 ,1137 ,0,3,1,3,0,1,0,76.14,66.05 ,33.33
03,007,01,011,0281,438,597 ,12 ,609 ,887 ,0,3,1,3,0,1,0,76.14,68.66 ,33.33
03,007,01,012,0282,439,588 ,5 ,593 ,794 ,0,3,1,3,0,1,0,76.14,74.69 ,33.33
03,007,01,012,0283,440,975 ,4 ,979 ,1469 ,0,3,1,3,0,1,0,76.14,66.64 ,33.33
03,007,01,012,0284,441,1228 ,13 ,1241 ,1846 ,0,3,1,3,0,1,0,76.14,67.23 ,33.33
03,007,01,012,0285,442,1276 ,6 ,1282 ,1910 ,0,3,1,3,0,1,0,76.14,67.12 ,33.33
03,007,01,012,0286,443,1091 ,12 ,1103 ,1634 ,0,3,1,3,0,1,0,76.14,67.50 ,33.33
03,007,01,012,0287,444,870 ,17 ,887 ,1374 ,0,3,1,3,0,1,0,76.14,64.56 ,33.33
03,007,01,012,0288,445,693 ,7 ,700 ,955 ,0,3,1,3,0,1,0,76.14,73.30 ,33.33
03,007,01,012,0289,446,628 ,13 ,641 ,875 ,0,3,1,3,0,1,0,76.14,73.26 ,33.33
03,007,01,012,0290,447,737 ,7 ,744 ,1081 ,0,3,1,3,0,1,0,76.14,68.83 ,33.33
03,007,01,012,0290,448,695 ,11 ,706 ,1026 ,0,3,1,3,0,1,0,76.14,68.81 ,33.33
03,007,01,012,0291,449,912 ,8 ,920 ,1356 ,0,3,1,3,0,1,0,76.14,67.85 ,33.33
03,007,01,012,0292,450,802 ,12 ,814 ,1065 ,0,3,1,3,0,1,0,76.14,76.43 ,33.33
03,007,01,012,0293,451,1070 ,20 ,1090 ,1550 ,0,3,1,3,0,1,0,76.14,70.32 ,33.33
03,007,01,012,0294,452,1156 ,17 ,1173 ,1657 ,0,3,1,3,0,1,0,76.14,70.79 ,33.33
03,007,01,012,0295,453,1077 ,9 ,1086 ,1524 ,0,3,1,3,0,1,0,76.14,71.26 ,33.33
03,007,01,012,0296,454,805 ,7 ,812 ,1206 ,0,3,1,3,0,1,0,76.14,67.33 ,33.33
03,007,01,012,0297,455,612 ,3 ,615 ,866 ,0,3,1,3,0,1,0,76.14,71.02 ,33.33
03,007,01,012,0298,456,497 ,10 ,507 ,720 ,0,3,1,3,0,1,0,76.14,70.42 ,33.33
03,007,01,012,0299,457,532 ,3 ,535 ,740 ,0,3,1,3,0,1,0,76.14,72.30 ,33.33
03,007,01,012,0300,458,477 ,8 ,485 ,687 ,0,3,1,3,0,1,0,76.14,70.60 ,33.33
03,007,01,012,0301,459,651 ,8 ,659 ,951 ,0,3,1,3,0,1,0,76.14,69.30 ,33.33
03,007,01,012,0302,460,614 ,8 ,622 ,835 ,0,3,1,3,0,1,0,76.14,74.49 ,33.33
03,007,01,012,0303,461,462 ,3 ,465 ,681 ,0,3,1,3,0,1,0,76.14,68.28 ,33.33
03,007,01,012,0304,462,809 ,10 ,819 ,1130 ,0,3,1,3,0,1,0,76.14,72.48 ,33.33
03,007,01,012,0305,463,969 ,5 ,974 ,1348 ,0,3,1,3,0,1,0,76.14,72.26 ,33.33
03,007,01,013,0306,464,866 ,4 ,870 ,1245 ,0,3,1,3,0,1,0,76.14,69.88 ,33.33
03,007,01,013,0307,465,562 ,5 ,567 ,748 ,0,3,1,3,0,1,0,76.14,75.80 ,33.33
03,007,01,013,0308,466,978 ,14 ,992 ,1404 ,0,3,1,3,0,1,0,76.14,70.66 ,33.33
03,007,01,013,0309,467,350 ,1 ,351 ,479 ,0,3,1,3,0,1,0,76.14,73.28 ,33.33
03,007,01,013,0310,468,908 ,8 ,916 ,1338 ,0,3,1,3,0,1,0,76.14,68.46 ,33.33
03,007,01,013,0310,469,960 ,11 ,971 ,1517 ,0,3,1,3,0,1,0,76.14,64.01 ,33.33
03,007,01,013,0311,470,614 ,5 ,619 ,872 ,0,3,1,3,0,1,0,76.14,70.99 ,33.33
03,007,01,013,0311,471,703 ,6 ,709 ,979 ,0,3,1,3,0,1,0,76.14,72.42 ,33.33
03,007,01,013,0312,472,775 ,8 ,783 ,1142 ,0,3,1,3,0,1,0,76.14,68.56 ,33.33
03,007,01,013,0312,473,789 ,12 ,801 ,1113 ,0,3,1,3,0,1,0,76.14,71.97 ,33.33
03,007,01,013,0313,474,901 ,5 ,906 ,1255 ,0,3,1,3,0,1,0,76.14,72.19 ,33.33
03,007,01,013,0314,475,924 ,5 ,929 ,1285 ,0,3,1,3,0,1,0,76.14,72.30 ,33.33
03,007,01,013,0314,476,742 ,4 ,746 ,1086 ,0,3,1,3,0,1,0,76.14,68.69 ,33.33
03,007,01,013,0315,477,809 ,9 ,818 ,1182 ,0,3,1,3,0,1,0,76.14,69.20 ,33.33
03,007,01,013,0315,478,756 ,5 ,761 ,1073 ,0,3,1,3,0,1,0,76.14,70.92 ,33.33
03,007,01,013,0316,479,635 ,3 ,638 ,934 ,0,3,1,3,0,1,0,76.14,68.31 ,33.33
03,007,01,013,0316,480,695 ,4 ,699 ,1035 ,0,3,1,3,0,1,0,76.14,67.54 ,33.33
03,007,01,013,0317,481,567 ,6 ,573 ,755 ,0,3,1,3,0,1,0,76.14,75.89 ,33.33
03,007,01,013,0318,482,1123 ,11 ,1134 ,1650 ,0,3,1,3,0,1,0,76.14,68.73 ,33.33
03,007,01,013,0319,483,793 ,12 ,805 ,1102 ,0,3,1,3,0,1,0,76.14,73.05 ,33.33
03,007,01,013,0319,484,752 ,7 ,759 ,1118 ,0,3,1,3,0,1,0,76.14,67.89 ,33.33
03,007,01,013,0320,485,542 ,4 ,546 ,777 ,0,3,1,3,0,1,0,76.14,70.27 ,33.33
03,007,01,013,0321,486,850 ,11 ,861 ,1262 ,0,3,1,3,0,1,0,76.14,68.23 ,33.33
03,007,01,013,0322,487,1029 ,10 ,1039 ,1553 ,0,3,1,3,0,1,0,76.14,66.90 ,33.33
03,007,01,013,0323,488,816 ,8 ,824 ,1233 ,0,3,1,3,0,1,0,76.14,66.83 ,33.33
03,007,01,013,0323,489,875 ,1 ,876 ,1261 ,0,3,1,3,0,1,0,76.14,69.47 ,33.33
03,007,01,013,0323,490,765 ,7 ,772 ,1149 ,0,3,1,3,0,1,0,76.14,67.19 ,33.33
03,007,01,013,0324,491,463 ,10 ,473 ,640 ,0,3,1,3,0,1,0,76.14,73.91 ,33.33
03,007,01,013,0325,492,927 ,7 ,934 ,1254 ,0,3,1,3,0,1,0,76.14,74.48 ,33.33
03,007,01,013,0326,493,522 ,9 ,531 ,721 ,0,3,1,3,0,1,0,76.14,73.65 ,33.33
03,007,01,013,0327,494,866 ,11 ,877 ,1271 ,0,3,1,3,0,1,0,76.14,69.00 ,33.33
03,007,01,013,0328,495,942 ,8 ,950 ,1325 ,0,3,1,3,0,1,0,76.14,71.70 ,33.33
03,007,01,013,0329,496,535 ,5 ,540 ,744 ,0,3,1,3,0,1,0,76.14,72.58 ,33.33
03,007,01,013,0329,497,782 ,10 ,792 ,1177 ,0,3,1,3,0,1,0,76.14,67.29 ,33.33
03,007,01,013,0330,498,1021 ,8 ,1029 ,1540 ,0,3,1,3,0,1,0,76.14,66.82 ,33.33
03,007,01,014,0331,499,1074 ,17 ,1091 ,1520 ,0,3,1,3,0,1,0,76.14,71.78 ,33.33
03,007,01,014,0332,500,1072 ,14 ,1086 ,1473 ,0,3,1,3,0,1,0,76.14,73.73 ,33.33
03,007,01,014,0333,501,907 ,9 ,916 ,1168 ,0,3,1,3,0,1,0,76.14,78.42 ,33.33
03,007,01,014,0334,502,650 ,10 ,660 ,834 ,0,3,1,3,0,1,0,76.14,79.14 ,33.33
03,007,01,014,0335,503,1251 ,13 ,1264 ,1631 ,0,3,1,3,0,1,0,76.14,77.50 ,33.33
03,007,01,014,0336,504,726 ,7 ,733 ,924 ,0,3,1,3,0,1,0,76.14,79.33 ,33.33
03,007,01,014,0337,505,902 ,23 ,925 ,1283 ,0,3,1,3,0,1,0,76.14,72.10 ,33.33
03,007,01,014,0338,506,780 ,10 ,790 ,1036 ,0,3,1,3,0,1,0,76.14,76.25 ,33.33
03,007,01,014,0339,507,558 ,6 ,564 ,702 ,0,3,1,3,0,1,0,76.14,80.34 ,33.33
03,007,01,014,0340,508,889 ,9 ,898 ,1158 ,0,3,1,3,0,1,0,76.14,77.55 ,33.33
03,007,01,014,0341,509,1000 ,25 ,1025 ,1365 ,0,3,1,3,0,1,0,76.14,75.09 ,33.33
03,007,01,014,0342,510,1506 ,10 ,1516 ,1949 ,0,3,1,3,0,1,0,76.14,77.78 ,33.33
03,007,01,014,0343,511,956 ,9 ,965 ,1241 ,0,3,1,3,0,1,0,76.14,77.76 ,33.33
03,007,01,014,0344,512,298 ,3 ,301 ,393 ,0,3,1,3,0,1,0,76.14,76.59 ,33.33
03,007,01,014,0345,513,762 ,9 ,771 ,1058 ,0,3,1,3,0,1,0,76.14,72.87 ,33.33
03,007,01,014,0346,514,609 ,7 ,616 ,770 ,0,3,1,3,0,1,0,76.14,80.00 ,33.33
03,007,01,014,0347,515,978 ,12 ,990 ,1315 ,0,3,1,3,0,1,0,76.14,75.29 ,33.33
03,007,01,014,0348,516,666 ,3 ,669 ,826 ,0,3,1,3,0,1,0,76.14,80.99 ,33.33
03,007,01,014,0349,517,1056 ,10 ,1066 ,1463 ,0,3,1,3,0,1,0,76.14,72.86 ,33.33
03,007,01,014,0350,518,1053 ,9 ,1062 ,1369 ,0,3,1,3,0,1,0,76.14,77.57 ,33.33
03,007,01,014,0351,519,1003 ,11 ,1014 ,1264 ,0,3,1,3,0,1,0,76.14,80.22 ,33.33
03,007,01,014,0352,520,936 ,14 ,950 ,1244 ,0,3,1,3,0,1,0,76.14,76.37 ,33.33
03,007,01,015,0353,521,832 ,11 ,843 ,1225 ,0,3,1,3,0,1,0,76.14,68.82 ,33.33
03,007,01,015,0353,522,995 ,11 ,1006 ,1500 ,0,3,1,3,0,1,0,76.14,67.07 ,33.33
03,007,01,015,0354,523,831 ,7 ,838 ,1211 ,0,3,1,3,0,1,0,76.14,69.20 ,33.33
03,007,01,015,0355,524,996 ,10 ,1006 ,1450 ,0,3,1,3,0,1,0,76.14,69.38 ,33.33
03,007,01,015,0356,525,817 ,12 ,829 ,1132 ,0,3,1,3,0,1,0,76.14,73.23 ,33.33
03,007,01,015,0357,526,1093 ,21 ,1114 ,1621 ,0,3,1,3,0,1,0,76.14,68.72 ,33.33
03,007,01,015,0358,527,1144 ,11 ,1155 ,1733 ,0,3,1,3,0,1,0,76.14,66.65 ,33.33
03,007,01,015,0359,528,910 ,7 ,917 ,1329 ,0,3,1,3,0,1,0,76.14,69.00 ,33.33
03,007,01,015,0360,529,1089 ,7 ,1096 ,1688 ,0,3,1,3,0,1,0,76.14,64.93 ,33.33
03,007,01,015,0361,530,1240 ,17 ,1257 ,1794 ,0,3,1,3,0,1,0,76.14,70.07 ,33.33
03,007,01,015,0362,531,430 ,7 ,437 ,589 ,0,3,1,3,0,1,0,76.14,74.19 ,33.33
03,007,01,015,0363,532,714 ,9 ,723 ,1070 ,0,3,1,3,0,1,0,76.14,67.57 ,33.33
03,007,01,015,0364,533,792 ,7 ,799 ,1159 ,0,3,1,3,0,1,0,76.14,68.94 ,33.33
03,007,01,015,0365,534,530 ,5 ,535 ,839 ,0,3,1,3,0,1,0,76.14,63.77 ,33.33
03,007,01,015,0366,535,597 ,8 ,605 ,891 ,0,3,1,3,0,1,0,76.14,67.90 ,33.33
03,007,01,015,0367,536,1168 ,12 ,1180 ,1704 ,0,3,1,3,0,1,0,76.14,69.25 ,33.33
03,007,01,015,0368,537,932 ,9 ,941 ,1322 ,0,3,1,3,0,1,0,76.14,71.18 ,33.33
03,007,01,015,0369,538,634 ,5 ,639 ,868 ,0,3,1,3,0,1,0,76.14,73.62 ,33.33
03,007,01,015,0370,539,891 ,9 ,900 ,1202 ,0,3,1,3,0,1,0,76.14,74.88 ,33.33
03,007,01,015,0371,540,545 ,4 ,549 ,766 ,0,3,1,3,0,1,0,76.14,71.67 ,33.33
03,007,01,015,0372,541,608 ,10 ,618 ,844 ,0,3,1,3,0,1,0,76.14,73.22 ,33.33
03,007,01,016,0373,542,579 ,7 ,586 ,868 ,0,3,1,3,0,1,0,76.14,67.51 ,33.33
03,007,01,016,0374,543,609 ,9 ,618 ,1003 ,0,3,1,3,0,1,0,76.14,61.62 ,33.33
03,007,01,016,0374,544,439 ,7 ,446 ,995 ,0,3,1,3,0,1,0,76.14,44.82 ,33.33
03,007,01,016,0375,545,397 ,3 ,400 ,624 ,0,3,1,3,0,1,0,76.14,64.10 ,33.33
03,007,01,016,0376,546,997 ,15 ,1012 ,1487 ,0,3,1,3,0,1,0,76.14,68.06 ,33.33
03,007,01,016,0377,547,979 ,11 ,990 ,1468 ,0,3,1,3,0,1,0,76.14,67.44 ,33.33
03,007,01,016,0378,548,804 ,6 ,810 ,1232 ,0,3,1,3,0,1,0,76.14,65.75 ,33.33
03,007,01,016,0379,549,1069 ,9 ,1078 ,1691 ,0,3,1,3,0,1,0,76.14,63.75 ,33.33
03,007,01,016,0380,550,454 ,6 ,460 ,646 ,0,3,1,3,0,1,0,76.14,71.21 ,33.33
03,007,01,016,0381,551,1089 ,10 ,1099 ,1695 ,0,3,1,3,0,1,0,76.14,64.84 ,33.33
03,007,01,016,0381,552,811 ,6 ,817 ,1153 ,0,3,1,3,0,1,0,76.14,70.86 ,33.33
03,007,01,016,0382,553,555 ,1 ,556 ,857 ,0,3,1,3,0,1,0,76.14,64.88 ,33.33
03,007,01,016,0382,554,881 ,14 ,895 ,1295 ,0,3,1,3,0,1,0,76.14,69.11 ,33.33
03,007,01,016,0383,555,718 ,6 ,724 ,1100 ,0,3,1,3,0,1,0,76.14,65.82 ,33.33
03,007,01,016,0384,556,869 ,9 ,878 ,1282 ,0,3,1,3,0,1,0,76.14,68.49 ,33.33
03,007,01,016,0385,557,588 ,6 ,594 ,891 ,0,3,1,3,0,1,0,76.14,66.67 ,33.33
03,007,01,016,0385,558,733 ,6 ,739 ,1088 ,0,3,1,3,0,1,0,76.14,67.92 ,33.33
03,007,01,016,0386,559,613 ,14 ,627 ,993 ,0,3,1,3,0,1,0,76.14,63.14 ,33.33
03,007,01,016,0386,560,697 ,4 ,701 ,1076 ,0,3,1,3,0,1,0,76.14,65.15 ,33.33
03,007,01,016,0387,561,1090 ,19 ,1109 ,1609 ,0,3,1,3,0,1,0,76.14,68.92 ,33.33
03,007,01,016,0388,562,897 ,7 ,904 ,1316 ,0,3,1,3,0,1,0,76.14,68.69 ,33.33
03,007,01,016,0389,563,998 ,20 ,1018 ,1644 ,0,3,1,3,0,1,0,76.14,61.92 ,33.33
03,007,01,016,0390,564,1143 ,6 ,1149 ,1705 ,0,3,1,3,0,1,0,76.14,67.39 ,33.33
03,007,01,016,0390,565,1089 ,11 ,1100 ,1752 ,0,3,1,3,0,1,0,76.14,62.79 ,33.33
03,007,01,016,0391,566,884 ,8 ,892 ,1323 ,0,3,1,3,0,1,0,76.14,67.42 ,33.33
03,007,01,016,0392,567,987 ,11 ,998 ,1520 ,0,3,1,3,0,1,0,76.14,65.66 ,33.33
03,007,01,016,0393,568,611 ,7 ,618 ,888 ,0,3,1,3,0,1,0,76.14,69.59 ,33.33
03,007,01,016,0394,569,560 ,1 ,561 ,815 ,0,3,1,3,0,1,0,76.14,68.83 ,33.33
03,007,01,017,0395,570,853 ,4 ,857 ,1277 ,0,3,1,3,0,1,0,76.14,67.11 ,33.33
03,007,01,017,0395,571,896 ,4 ,900 ,1304 ,0,3,1,3,0,1,0,76.14,69.02 ,33.33
03,007,01,017,0396,572,801 ,13 ,814 ,1160 ,0,3,1,3,0,1,0,76.14,70.17 ,33.33
03,007,01,017,0396,573,921 ,16 ,937 ,1388 ,0,3,1,3,0,1,0,76.14,67.51 ,33.33
03,007,01,017,0396,574,843 ,7 ,850 ,1284 ,0,3,1,3,0,1,0,76.14,66.20 ,33.33
03,007,01,017,0397,575,679 ,4 ,683 ,1027 ,0,3,1,3,0,1,0,76.14,66.50 ,33.33
03,007,01,017,0397,576,936 ,4 ,940 ,1451 ,0,3,1,3,0,1,0,76.14,64.78 ,33.33
03,007,01,017,0398,577,509 ,10 ,519 ,785 ,0,3,1,3,0,1,0,76.14,66.11 ,33.33
03,007,01,017,0399,578,724 ,6 ,730 ,1041 ,0,3,1,3,0,1,0,76.14,70.12 ,33.33
03,007,01,017,0400,579,754 ,6 ,760 ,1079 ,0,3,1,3,0,1,0,76.14,70.44 ,33.33
03,007,01,017,0401,580,962 ,13 ,975 ,1433 ,0,3,1,3,0,1,0,76.14,68.04 ,33.33
03,007,01,017,0402,581,673 ,12 ,685 ,986 ,0,3,1,3,0,1,0,76.14,69.47 ,33.33
03,007,01,017,0403,582,816 ,14 ,830 ,1243 ,0,3,1,3,0,1,0,76.14,66.77 ,33.33
03,007,01,017,0404,583,582 ,10 ,592 ,829 ,0,3,1,3,0,1,0,76.14,71.41 ,33.33
03,007,01,017,0405,584,1281 ,14 ,1295 ,1905 ,0,3,1,3,0,1,0,76.14,67.98 ,33.33
03,007,01,017,0406,585,1015 ,11 ,1026 ,1473 ,0,3,1,3,0,1,0,76.14,69.65 ,33.33
03,007,01,017,0407,586,980 ,13 ,993 ,1398 ,0,3,1,3,0,1,0,76.14,71.03 ,33.33
03,007,01,017,0408,587,822 ,13 ,835 ,1114 ,0,3,1,3,0,1,0,76.14,74.96 ,33.33
03,007,01,017,0409,588,684 ,2 ,686 ,980 ,0,3,1,3,0,1,0,76.14,70.00 ,33.33
03,007,01,017,0410,589,745 ,8 ,753 ,1061 ,0,3,1,3,0,1,0,76.14,70.97 ,33.33
03,007,01,017,0411,590,700 ,7 ,707 ,998 ,0,3,1,3,0,1,0,76.14,70.84 ,33.33
03,007,01,017,0412,591,730 ,11 ,741 ,1032 ,0,3,1,3,0,1,0,76.14,71.80 ,33.33
03,007,01,017,0413,592,498 ,3 ,501 ,684 ,0,3,1,3,0,1,0,76.14,73.25 ,33.33
03,007,01,017,0414,593,640 ,2 ,642 ,887 ,0,3,1,3,0,1,0,76.14,72.38 ,33.33
03,007,01,017,0415,594,668 ,9 ,677 ,945 ,0,3,1,3,0,1,0,76.14,71.64 ,33.33
03,007,01,017,0416,595,554 ,6 ,560 ,808 ,0,3,1,3,0,1,0,76.14,69.31 ,33.33
03,007,01,017,0417,596,952 ,14 ,966 ,1354 ,0,3,1,3,0,1,0,76.14,71.34 ,33.33
03,007,01,017,0418,597,1306 ,17 ,1323 ,1949 ,0,3,1,3,0,1,0,76.14,67.88 ,33.33
03,007,01,018,0419,598,717 ,10 ,727 ,1022 ,0,3,1,3,0,1,0,76.14,71.14 ,33.33
03,007,01,018,0420,599,507 ,4 ,511 ,718 ,0,3,1,3,0,1,0,76.14,71.17 ,33.33
03,007,01,018,0421,600,575 ,10 ,585 ,874 ,0,3,1,3,0,1,0,76.14,66.93 ,33.33
03,007,01,018,0422,601,710 ,7 ,717 ,1026 ,0,3,1,3,0,1,0,76.14,69.88 ,33.33
03,007,01,018,0423,602,442 ,2 ,444 ,647 ,0,3,1,3,0,1,0,76.14,68.62 ,33.33
03,007,01,018,0424,603,486 ,6 ,492 ,660 ,0,3,1,3,0,1,0,76.14,74.55 ,33.33
03,007,01,018,0425,604,702 ,6 ,708 ,999 ,0,3,1,3,0,1,0,76.14,70.87 ,33.33
03,007,01,018,0426,605,714 ,5 ,719 ,1038 ,0,3,1,3,0,1,0,76.14,69.27 ,33.33
03,007,01,018,0427,606,631 ,7 ,638 ,880 ,0,3,1,3,0,1,0,76.14,72.50 ,33.33
03,007,01,018,0428,607,363 ,1 ,364 ,489 ,0,3,1,3,0,1,0,76.14,74.44 ,33.33
03,007,01,018,0429,608,620 ,9 ,629 ,951 ,0,3,1,3,0,1,0,76.14,66.14 ,33.33
03,007,01,018,0430,609,576 ,11 ,587 ,863 ,0,3,1,3,0,1,0,76.14,68.02 ,33.33
03,007,01,018,0431,610,585 ,6 ,591 ,798 ,0,3,1,3,0,1,0,76.14,74.06 ,33.33
03,007,01,018,0432,611,574 ,4 ,578 ,792 ,0,3,1,3,0,1,0,76.14,72.98 ,33.33
03,007,01,018,0433,612,533 ,2 ,535 ,729 ,0,3,1,3,0,1,0,76.14,73.39 ,33.33
03,007,01,018,0434,613,477 ,6 ,483 ,666 ,0,3,1,3,0,1,0,76.14,72.52 ,33.33
03,007,01,018,0435,614,467 ,4 ,471 ,617 ,0,3,1,3,0,1,0,76.14,76.34 ,33.33
03,007,01,019,0436,615,799 ,9 ,808 ,1150 ,0,3,1,3,0,1,0,76.14,70.26 ,33.33
03,007,01,019,0436,616,793 ,8 ,801 ,1175 ,0,3,1,3,0,1,0,76.14,68.17 ,33.33
03,007,01,019,0437,617,1212 ,4 ,1216 ,1725 ,0,3,1,3,0,1,0,76.14,70.49 ,33.33
03,007,01,019,0438,618,905 ,10 ,915 ,1320 ,0,3,1,3,0,1,0,76.14,69.32 ,33.33
03,007,01,019,0438,619,828 ,9 ,837 ,1184 ,0,3,1,3,0,1,0,76.14,70.69 ,33.33
03,007,01,019,0438,620,950 ,14 ,964 ,1398 ,0,3,1,3,0,1,0,76.14,68.96 ,33.33
03,007,01,019,0439,621,1040 ,17 ,1057 ,1590 ,0,3,1,3,0,1,0,76.14,66.48 ,33.33
03,007,01,019,0440,622,923 ,11 ,934 ,1400 ,0,3,1,3,0,1,0,76.14,66.71 ,33.33
03,007,01,019,0441,623,531 ,7 ,538 ,807 ,0,3,1,3,0,1,0,76.14,66.67 ,33.33
03,007,01,019,0442,624,446 ,4 ,450 ,629 ,0,3,1,3,0,1,0,76.14,71.54 ,33.33
03,007,01,019,0443,625,515 ,2 ,517 ,743 ,0,3,1,3,0,1,0,76.14,69.58 ,33.33
03,007,01,019,0444,626,909 ,8 ,917 ,1395 ,0,3,1,3,0,1,0,76.14,65.73 ,33.33
03,007,01,019,0445,627,845 ,8 ,853 ,1287 ,0,3,1,3,0,1,0,76.14,66.28 ,33.33
03,007,01,019,0446,628,1066 ,8 ,1074 ,1729 ,0,3,1,3,0,1,0,76.14,62.12 ,33.33
03,007,01,019,0447,629,653 ,14 ,667 ,1000 ,0,3,1,3,0,1,0,76.14,66.70 ,33.33
03,007,01,019,0447,630,816 ,11 ,827 ,1309 ,0,3,1,3,0,1,0,76.14,63.18 ,33.33
03,007,01,019,0448,631,720 ,10 ,730 ,1058 ,0,3,1,3,0,1,0,76.14,69.00 ,33.33
03,007,01,019,0449,632,1099 ,15 ,1114 ,1741 ,0,3,1,3,0,1,0,76.14,63.99 ,33.33
03,007,01,019,0450,633,953 ,10 ,963 ,1540 ,0,3,1,3,0,1,0,76.14,62.53 ,33.33
03,007,01,020,0451,634,446 ,10 ,456 ,765 ,0,3,1,3,0,1,0,76.14,59.61 ,33.33
03,007,01,020,0451,635,601 ,9 ,610 ,987 ,0,3,1,3,0,1,0,76.14,61.80 ,33.33
03,007,01,020,0452,636,423 ,4 ,427 ,677 ,0,3,1,3,0,1,0,76.14,63.07 ,33.33
03,007,01,020,0453,637,605 ,4 ,609 ,942 ,0,3,1,3,0,1,0,76.14,64.65 ,33.33
03,007,01,020,0454,638,492 ,4 ,496 ,747 ,0,3,1,3,0,1,0,76.14,66.40 ,33.33
03,007,01,020,0454,639,538 ,7 ,545 ,877 ,0,3,1,3,0,1,0,76.14,62.14 ,33.33
03,007,01,020,0455,640,931 ,17 ,948 ,1429 ,0,3,1,3,0,1,0,76.14,66.34 ,33.33
03,007,01,020,0456,641,520 ,8 ,528 ,819 ,0,3,1,3,0,1,0,76.14,64.47 ,33.33
03,007,01,020,0456,642,585 ,11 ,596 ,889 ,0,3,1,3,0,1,0,76.14,67.04 ,33.33
03,007,01,020,0457,643,893 ,16 ,909 ,1316 ,0,3,1,3,0,1,0,76.14,69.07 ,33.33
03,007,01,020,0458,644,885 ,12 ,897 ,1462 ,0,3,1,3,0,1,0,76.14,61.35 ,33.33
03,007,01,020,0459,645,735 ,10 ,745 ,1128 ,0,3,1,3,0,1,0,76.14,66.05 ,33.33
03,007,01,020,0459,646,591 ,16 ,607 ,936 ,0,3,1,3,0,1,0,76.14,64.85 ,33.33
03,007,01,020,0460,647,632 ,7 ,639 ,949 ,0,3,1,3,0,1,0,76.14,67.33 ,33.33
03,007,01,020,0460,648,564 ,3 ,567 ,899 ,0,3,1,3,0,1,0,76.14,63.07 ,33.33
03,007,01,020,0461,649,645 ,5 ,650 ,938 ,0,3,1,3,0,1,0,76.14,69.30 ,33.33
03,007,01,020,0461,650,583 ,5 ,588 ,978 ,0,3,1,3,0,1,0,76.14,60.12 ,33.33
03,007,01,020,0462,651,507 ,9 ,516 ,802 ,0,3,1,3,0,1,0,76.14,64.34 ,33.33
03,007,01,020,0463,652,744 ,3 ,747 ,1119 ,0,3,1,3,0,1,0,76.14,66.76 ,33.33
03,007,01,020,0464,653,571 ,10 ,581 ,970 ,0,3,1,3,0,1,0,76.14,59.90 ,33.33
03,007,01,020,0465,654,458 ,9 ,467 ,737 ,0,3,1,3,0,1,0,76.14,63.36 ,33.33
03,007,01,020,0466,655,605 ,2 ,607 ,896 ,0,3,1,3,0,1,0,76.14,67.75 ,33.33
03,007,01,020,0467,656,837 ,8 ,845 ,1199 ,0,3,1,3,0,1,0,76.14,70.48 ,33.33
03,007,01,020,0468,657,600 ,8 ,608 ,883 ,0,3,1,3,0,1,0,76.14,68.86 ,33.33
03,007,01,020,0469,658,801 ,6 ,807 ,1281 ,0,3,1,3,0,1,0,76.14,63.00 ,33.33
03,007,01,021,0470,659,817 ,9 ,826 ,1233 ,0,3,1,3,0,1,0,76.14,66.99 ,33.33
03,007,01,021,0471,660,504 ,3 ,507 ,669 ,0,3,1,3,0,1,0,76.14,75.78 ,33.33
03,007,01,021,0472,661,1389 ,18 ,1407 ,2063 ,0,3,1,3,0,1,0,76.14,68.20 ,33.33
03,007,01,021,0473,662,860 ,5 ,865 ,1283 ,0,3,1,3,0,1,0,76.14,67.42 ,33.33
03,007,01,021,0474,663,827 ,6 ,833 ,1206 ,0,3,1,3,0,1,0,76.14,69.07 ,33.33
03,007,01,021,0475,664,687 ,6 ,693 ,1000 ,0,3,1,3,0,1,0,76.14,69.30 ,33.33
03,007,01,021,0476,665,782 ,10 ,792 ,1140 ,0,3,1,3,0,1,0,76.14,69.47 ,33.33
03,007,01,021,0477,666,671 ,5 ,676 ,1024 ,0,3,1,3,0,1,0,76.14,66.02 ,33.33
03,007,01,021,0478,667,451 ,9 ,460 ,653 ,0,3,1,3,0,1,0,76.14,70.44 ,33.33
03,007,01,021,0479,668,609 ,7 ,616 ,851 ,0,3,1,3,0,1,0,76.14,72.39 ,33.33
03,007,01,021,0480,669,737 ,6 ,743 ,1014 ,0,3,1,3,0,1,0,76.14,73.27 ,33.33
03,007,01,021,0481,670,832 ,14 ,846 ,1235 ,0,3,1,3,0,1,0,76.14,68.50 ,33.33
03,007,01,021,0482,671,1050 ,11 ,1061 ,1697 ,0,3,1,3,0,1,0,76.14,62.52 ,33.33
03,007,01,021,0483,672,609 ,11 ,620 ,826 ,0,3,1,3,0,1,0,76.14,75.06 ,33.33
03,007,01,021,0484,673,635 ,6 ,641 ,861 ,0,3,1,3,0,1,0,76.14,74.45 ,33.33
03,007,01,021,0485,674,985 ,9 ,994 ,1457 ,0,3,1,3,0,1,0,76.14,68.22 ,33.33
03,007,01,021,0486,675,1061 ,10 ,1071 ,1553 ,0,3,1,3,0,1,0,76.14,68.96 ,33.33
03,007,01,021,0487,676,200 ,1 ,201 ,287 ,0,3,1,3,0,1,0,76.14,70.03 ,33.33
03,007,01,021,0488,677,407 ,12 ,419 ,637 ,0,3,1,3,0,1,0,76.14,65.78 ,33.33
03,007,01,021,0489,678,519 ,7 ,526 ,751 ,0,3,1,3,0,1,0,76.14,70.04 ,33.33
03,007,01,022,0490,679,644 ,6 ,650 ,1001 ,0,3,1,3,0,1,0,76.14,64.94 ,33.33
03,007,01,022,0490,680,794 ,15 ,809 ,1285 ,0,3,1,3,0,1,0,76.14,62.96 ,33.33
03,007,01,022,0491,681,964 ,10 ,974 ,1583 ,0,3,1,3,0,1,0,76.14,61.53 ,33.33
03,007,01,022,0492,682,1056 ,7 ,1063 ,1597 ,0,3,1,3,0,1,0,76.14,66.56 ,33.33
03,007,01,022,0493,683,646 ,11 ,657 ,951 ,0,3,1,3,0,1,0,76.14,69.09 ,33.33
03,007,01,022,0493,684,796 ,3 ,799 ,1203 ,0,3,1,3,0,1,0,76.14,66.42 ,33.33
03,007,01,022,0494,685,789 ,12 ,801 ,1168 ,0,3,1,3,0,1,0,76.14,68.58 ,33.33
03,007,01,022,0495,686,942 ,22 ,964 ,1459 ,0,3,1,3,0,1,0,76.14,66.07 ,33.33
03,007,01,022,0496,687,899 ,10 ,909 ,1344 ,0,3,1,3,0,1,0,76.14,67.63 ,33.33
03,007,01,022,0496,688,1065 ,14 ,1079 ,1642 ,0,3,1,3,0,1,0,76.14,65.71 ,33.33
03,007,01,022,0497,689,1074 ,13 ,1087 ,1618 ,0,3,1,3,0,1,0,76.14,67.18 ,33.33
03,007,01,022,0498,690,474 ,8 ,482 ,701 ,0,3,1,3,0,1,0,76.14,68.76 ,33.33
03,007,01,022,0499,691,370 ,2 ,372 ,594 ,0,3,1,3,0,1,0,76.14,62.63 ,33.33
03,007,01,022,0500,692,1025 ,17 ,1042 ,1627 ,0,3,1,3,0,1,0,76.14,64.04 ,33.33
03,007,01,022,0501,693,692 ,9 ,701 ,1161 ,0,3,1,3,0,1,0,76.14,60.38 ,33.33
03,007,01,022,0502,694,518 ,14 ,532 ,809 ,0,3,1,3,0,1,0,76.14,65.76 ,33.33
03,007,01,022,0503,695,590 ,6 ,596 ,900 ,0,3,1,3,0,1,0,76.14,66.22 ,33.33
03,007,01,022,0504,696,812 ,5 ,817 ,1353 ,0,3,1,3,0,1,0,76.14,60.38 ,33.33
03,007,01,022,0505,697,610 ,4 ,614 ,969 ,0,3,1,3,0,1,0,76.14,63.36 ,33.33
03,007,01,022,0506,698,671 ,5 ,676 ,992 ,0,3,1,3,0,1,0,76.14,68.15 ,33.33
03,007,01,023,0507,699,609 ,7 ,616 ,842 ,0,3,1,3,0,1,0,76.14,73.16 ,33.33
03,007,01,023,0507,700,827 ,9 ,836 ,1229 ,0,3,1,3,0,1,0,76.14,68.02 ,33.33
03,007,01,023,0508,701,879 ,13 ,892 ,1318 ,0,3,1,3,0,1,0,76.14,67.68 ,33.33
03,007,01,023,0508,702,1074 ,8 ,1082 ,1555 ,0,3,1,3,0,1,0,76.14,69.58 ,33.33
03,007,01,023,0509,703,933 ,21 ,954 ,1324 ,0,3,1,3,0,1,0,76.14,72.05 ,33.33
03,007,01,023,0510,704,825 ,5 ,830 ,1249 ,0,3,1,3,0,1,0,76.14,66.45 ,33.33
03,007,01,023,0510,705,957 ,15 ,972 ,1513 ,0,3,1,3,0,1,0,76.14,64.24 ,33.33
03,007,01,023,0511,706,1143 ,15 ,1158 ,1636 ,0,3,1,3,0,1,0,76.14,70.78 ,33.33
03,007,01,023,0512,707,974 ,12 ,986 ,1462 ,0,3,1,3,0,1,0,76.14,67.44 ,33.33
03,007,01,023,0513,708,823 ,6 ,829 ,1202 ,0,3,1,3,0,1,0,76.14,68.97 ,33.33
03,007,01,023,0514,709,805 ,11 ,816 ,1077 ,0,3,1,3,0,1,0,76.14,75.77 ,33.33
03,007,01,023,0515,710,765 ,8 ,773 ,1105 ,0,3,1,3,0,1,0,76.14,69.95 ,33.33
03,007,01,023,0516,711,845 ,7 ,852 ,1205 ,0,3,1,3,0,1,0,76.14,70.71 ,33.33
03,007,01,023,0517,712,792 ,10 ,802 ,1253 ,0,3,1,3,0,1,0,76.14,64.01 ,33.33
03,007,01,023,0517,713,832 ,9 ,841 ,1192 ,0,3,1,3,0,1,0,76.14,70.55 ,33.33
03,007,01,023,0518,714,497 ,8 ,505 ,705 ,0,3,1,3,0,1,0,76.14,71.63 ,33.33
03,007,01,023,0518,715,940 ,12 ,952 ,1390 ,0,3,1,3,0,1,0,76.14,68.49 ,33.33
03,007,01,023,0519,716,930 ,17 ,947 ,1407 ,0,3,1,3,0,1,0,76.14,67.31 ,33.33
03,007,01,023,0520,717,1192 ,19 ,1211 ,1659 ,0,3,1,3,0,1,0,76.14,73.00 ,33.33
03,007,01,023,0521,718,921 ,14 ,935 ,1293 ,0,3,1,3,0,1,0,76.14,72.31 ,33.33
03,007,01,023,0522,719,593 ,2 ,595 ,817 ,0,3,1,3,0,1,0,76.14,72.83 ,33.33
03,007,01,023,0523,720,1083 ,30 ,1113 ,1545 ,0,3,1,3,0,1,0,76.14,72.04 ,33.33
03,007,01,023,0524,721,928 ,11 ,939 ,1275 ,0,3,1,3,0,1,0,76.14,73.65 ,33.33
03,007,01,023,0525,722,774 ,11 ,785 ,1090 ,0,3,1,3,0,1,0,76.14,72.02 ,33.33
03,007,01,023,0526,723,877 ,11 ,888 ,1210 ,0,3,1,3,0,1,0,76.14,73.39 ,33.33
03,007,01,023,0526,724,783 ,7 ,790 ,1163 ,0,3,1,3,0,1,0,76.14,67.93 ,33.33
03,007,01,023,0526,725,881 ,10 ,891 ,1154 ,0,3,1,3,0,1,0,76.14,77.21 ,33.33
03,007,01,023,0527,726,933 ,12 ,945 ,1320 ,0,3,1,3,0,1,0,76.14,71.59 ,33.33
03,007,01,023,0528,727,738 ,10 ,748 ,1015 ,0,3,1,3,0,1,0,76.14,73.69 ,33.33
03,007,01,023,0529,728,637 ,5 ,642 ,875 ,0,3,1,3,0,1,0,76.14,73.37 ,33.33
03,007,01,023,0530,729,913 ,10 ,923 ,1232 ,0,3,1,3,0,1,0,76.14,74.92 ,33.33
03,007,01,023,0531,730,717 ,14 ,731 ,1036 ,0,3,1,3,0,1,0,76.14,70.56 ,33.33
03,007,01,023,0532,731,753 ,5 ,758 ,1030 ,0,3,1,3,0,1,0,76.14,73.59 ,33.33
03,007,01,023,0533,732,541 ,8 ,549 ,733 ,0,3,1,3,0,1,0,76.14,74.90 ,33.33
03,007,01,024,0534,733,628 ,4 ,632 ,1033 ,0,3,1,3,0,1,0,76.14,61.18 ,33.33
03,007,01,024,0535,734,286 ,4 ,290 ,510 ,0,3,1,3,0,1,0,76.14,56.86 ,33.33
03,007,01,024,0536,735,523 ,6 ,529 ,870 ,0,3,1,3,0,1,0,76.14,60.80 ,33.33
03,007,01,024,0537,736,350 ,6 ,356 ,637 ,0,3,1,3,0,1,0,76.14,55.89 ,33.33
03,007,01,024,0538,737,654 ,7 ,661 ,947 ,0,3,1,3,0,1,0,76.14,69.80 ,33.33
03,007,01,024,0539,738,1264 ,13 ,1277 ,1867 ,0,3,1,3,0,1,0,76.14,68.40 ,33.33
03,007,01,024,0540,739,871 ,15 ,886 ,1392 ,0,3,1,3,0,1,0,76.14,63.65 ,33.33
03,007,01,024,0541,740,497 ,7 ,504 ,994 ,0,3,1,3,0,1,0,76.14,50.70 ,33.33
03,007,01,024,0542,741,479 ,7 ,486 ,729 ,0,3,1,3,0,1,0,76.14,66.67 ,33.33
03,007,01,024,0543,742,509 ,7 ,516 ,725 ,0,3,1,3,0,1,0,76.14,71.17 ,33.33
03,007,01,024,0544,743,678 ,6 ,684 ,996 ,0,3,1,3,0,1,0,76.14,68.67 ,33.33
03,007,01,024,0545,744,450 ,6 ,456 ,675 ,0,3,1,3,0,1,0,76.14,67.56 ,33.33
03,007,01,024,0546,745,367 ,4 ,371 ,606 ,0,3,1,3,0,1,0,76.14,61.22 ,33.33
03,007,01,024,0547,746,735 ,11 ,746 ,1184 ,0,3,1,3,0,1,0,76.14,63.01 ,33.33
03,007,01,024,0547,747,560 ,9 ,569 ,905 ,0,3,1,3,0,1,0,76.14,62.87 ,33.33
03,007,01,024,0548,748,547 ,6 ,553 ,795 ,0,3,1,3,0,1,0,76.14,69.56 ,33.33
03,007,01,024,0549,749,507 ,4 ,511 ,804 ,0,3,1,3,0,1,0,76.14,63.56 ,33.33
03,007,01,024,0550,750,871 ,12 ,883 ,1389 ,0,3,1,3,0,1,0,76.14,63.57 ,33.33
03,007,01,024,0551,751,470 ,3 ,473 ,782 ,0,3,1,3,0,1,0,76.14,60.49 ,33.33
03,007,01,024,0552,752,960 ,10 ,970 ,1368 ,0,3,1,3,0,1,0,76.14,70.91 ,33.33
03,007,01,024,0553,753,294 ,5 ,299 ,547 ,0,3,1,3,0,1,0,76.14,54.66 ,33.33
03,007,01,024,0554,754,1016 ,7 ,1023 ,1438 ,0,3,1,3,0,1,0,76.14,71.14 ,33.33
03,007,01,024,0555,755,612 ,5 ,617 ,913 ,0,3,1,3,0,1,0,76.14,67.58 ,33.33
03,007,01,024,0555,756,768 ,9 ,777 ,1166 ,0,3,1,3,0,1,0,76.14,66.64 ,33.33
03,007,01,024,0556,757,505 ,0 ,505 ,721 ,0,3,1,3,0,1,0,76.14,70.04 ,33.33
03,007,01,024,0557,758,738 ,5 ,743 ,1042 ,0,3,1,3,0,1,0,76.14,71.31 ,33.33
03,007,01,024,0558,759,883 ,4 ,887 ,1349 ,0,3,1,3,0,1,0,76.14,65.75 ,33.33
03,007,01,024,0559,760,1118 ,11 ,1129 ,1598 ,0,3,1,3,0,1,0,76.14,70.65 ,33.33
03,007,01,024,0559,761,877 ,9 ,886 ,1335 ,0,3,1,3,0,1,0,76.14,66.37 ,33.33
03,007,01,025,0560,762,833 ,10 ,843 ,1313 ,0,3,1,3,0,1,0,76.14,64.20 ,33.33
03,007,01,025,0561,763,892 ,18 ,910 ,1426 ,0,3,1,3,0,1,0,76.14,63.81 ,33.33
03,007,01,025,0562,764,573 ,6 ,579 ,869 ,0,3,1,3,0,1,0,76.14,66.63 ,33.33
03,007,01,025,0563,765,803 ,8 ,811 ,1265 ,0,3,1,3,0,1,0,76.14,64.11 ,33.33
03,007,01,025,0564,766,689 ,8 ,697 ,1062 ,0,3,1,3,0,1,0,76.14,65.63 ,33.33
03,007,01,025,0565,767,411 ,3 ,414 ,643 ,0,3,1,3,0,1,0,76.14,64.39 ,33.33
03,007,01,025,0565,768,406 ,4 ,410 ,562 ,0,3,1,3,0,1,0,76.14,72.95 ,33.33
03,007,01,025,0566,769,509 ,4 ,513 ,767 ,0,3,1,3,0,1,0,76.14,66.88 ,33.33
03,007,01,025,0567,770,289 ,3 ,292 ,454 ,0,3,1,3,0,1,0,76.14,64.32 ,33.33
03,007,01,025,0567,771,438 ,3 ,441 ,761 ,0,3,1,3,0,1,0,76.14,57.95 ,33.33
03,007,01,025,0568,772,610 ,7 ,617 ,904 ,0,3,1,3,0,1,0,76.14,68.25 ,33.33
03,007,01,025,0569,773,433 ,5 ,438 ,747 ,0,3,1,3,0,1,0,76.14,58.63 ,33.33
03,007,01,025,0570,774,792 ,9 ,801 ,1168 ,0,3,1,3,0,1,0,76.14,68.58 ,33.33
03,007,01,025,0571,775,843 ,7 ,850 ,1328 ,0,3,1,3,0,1,0,76.14,64.01 ,33.33
03,007,01,025,0572,776,610 ,9 ,619 ,1067 ,0,3,1,3,0,1,0,76.14,58.01 ,33.33
03,007,01,025,0573,777,455 ,2 ,457 ,803 ,0,3,1,3,0,1,0,76.14,56.91 ,33.33
03,007,01,025,0574,778,593 ,6 ,599 ,1001 ,0,3,1,3,0,1,0,76.14,59.84 ,33.33
03,007,01,026,0575,779,749 ,9 ,758 ,1100 ,0,3,1,3,0,1,0,76.14,68.91 ,33.33
03,007,01,026,0576,780,1205 ,25 ,1230 ,1725 ,0,3,1,3,0,1,0,76.14,71.30 ,33.33
03,007,01,026,0577,781,564 ,3 ,567 ,804 ,0,3,1,3,0,1,0,76.14,70.52 ,33.33
03,007,01,026,0578,782,522 ,5 ,527 ,798 ,0,3,1,3,0,1,0,76.14,66.04 ,33.33
03,007,01,026,0579,783,1081 ,14 ,1095 ,1512 ,0,3,1,3,0,1,0,76.14,72.42 ,33.33
03,007,01,026,0580,784,465 ,6 ,471 ,655 ,0,3,1,3,0,1,0,76.14,71.91 ,33.33
03,007,01,026,0581,785,685 ,2 ,687 ,971 ,0,3,1,3,0,1,0,76.14,70.75 ,33.33
03,007,01,026,0582,786,803 ,13 ,816 ,1163 ,0,3,1,3,0,1,0,76.14,70.16 ,33.33
03,007,01,026,0583,787,356 ,2 ,358 ,555 ,0,3,1,3,0,1,0,76.14,64.50 ,33.33
03,007,01,026,0584,788,611 ,5 ,616 ,889 ,0,3,1,3,0,1,0,76.14,69.29 ,33.33
03,007,01,026,0585,789,460 ,2 ,462 ,719 ,0,3,1,3,0,1,0,76.14,64.26 ,33.33
03,007,01,026,0586,790,423 ,3 ,426 ,655 ,0,3,1,3,0,1,0,76.14,65.04 ,33.33
03,007,01,026,0587,791,537 ,3 ,540 ,784 ,0,3,1,3,0,1,0,76.14,68.88 ,33.33
03,007,01,026,0588,792,441 ,0 ,441 ,677 ,0,3,1,3,0,1,0,76.14,65.14 ,33.33
03,008,01,001,0001,1,564 ,4 ,568 ,942 ,0,3,1,3,0,1,0,76.14,60.30 ,33.33
03,008,01,001,0002,2,849 ,4 ,853 ,1377 ,0,3,1,3,0,1,0,76.14,61.95 ,33.33
03,008,01,001,0003,3,557 ,2 ,559 ,813 ,0,3,1,3,0,1,0,76.14,68.76 ,33.33
03,008,01,001,0004,4,378 ,0 ,378 ,547 ,0,3,1,3,0,1,0,76.14,69.10 ,33.33
03,008,01,001,0005,5,424 ,2 ,426 ,677 ,0,3,1,3,0,1,0,76.14,62.92 ,33.33
03,008,01,001,0006,6,306 ,0 ,306 ,440 ,0,3,1,3,0,1,0,76.14,69.55 ,33.33
03,008,01,001,0007,7,654 ,1 ,655 ,1036 ,0,3,1,3,0,1,0,76.14,63.22 ,33.33
03,008,01,001,0008,8,783 ,7 ,790 ,1408 ,0,3,1,3,0,1,0,76.14,56.11 ,33.33
03,008,01,001,0008,9,838 ,5 ,843 ,1439 ,0,3,1,3,0,1,0,76.14,58.58 ,33.33
03,008,01,001,0008,10,883 ,9 ,892 ,1497 ,0,3,1,3,0,1,0,76.14,59.59 ,33.33
03,008,01,001,0009,11,773 ,10 ,783 ,1311 ,0,3,1,3,0,1,0,76.14,59.73 ,33.33
03,008,01,001,0009,12,941 ,5 ,946 ,1456 ,0,3,1,3,0,1,0,76.14,64.97 ,33.33
03,008,01,001,0010,13,1178 ,12 ,1190 ,1799 ,0,3,1,3,0,1,0,76.14,66.15 ,33.33
03,008,01,001,0011,14,1024 ,11 ,1035 ,1698 ,0,3,1,3,0,1,0,76.14,60.95 ,33.33
03,008,01,001,0011,15,924 ,11 ,935 ,1619 ,0,3,1,3,0,1,0,76.14,57.75 ,33.33
03,008,01,001,0012,16,656 ,2 ,658 ,1180 ,0,3,1,3,0,1,0,76.14,55.76 ,33.33
03,008,01,001,0012,17,795 ,5 ,800 ,1316 ,0,3,1,3,0,1,0,76.14,60.79 ,33.33
03,008,01,001,0012,18,793 ,2 ,795 ,1293 ,0,3,1,3,0,1,0,76.14,61.48 ,33.33
03,008,01,001,0012,19,799 ,2 ,801 ,1377 ,0,3,1,3,0,1,0,76.14,58.17 ,33.33
03,008,01,001,0013,20,355 ,2 ,357 ,547 ,0,3,1,3,0,1,0,76.14,65.27,33.33
03,008,01,001,0013,21,880 ,3 ,883 ,1441 ,0,3,1,3,0,1,0,76.14,61.28,33.33
03,008,01,001,0014,22,517 ,2 ,519 ,884 ,0,3,1,3,0,1,0,76.14,58.71 ,33.33
03,008,01,001,0015,23,1074 ,13 ,1087 ,1768 ,0,3,1,3,0,1,0,76.14,61.48 ,33.33
03,008,01,001,0015,24,966 ,6 ,972 ,1759 ,0,3,1,3,0,1,0,76.14,55.26 ,33.33
03,008,01,001,0015,25,240 ,2 ,242 ,354 ,0,3,1,3,0,1,0,76.14,68.36 ,33.33
03,008,01,001,0016,26,234 ,3 ,237 ,406 ,0,3,1,3,0,1,0,76.14,58.37 ,33.33
03,008,01,001,0017,27,688 ,5 ,693 ,1078 ,0,3,1,3,0,1,0,76.14,64.29 ,33.33
03,008,01,001,0017,28,571 ,0 ,571 ,908 ,0,3,1,3,0,1,0,76.14,62.89 ,33.33
03,008,01,001,0018,29,973 ,4 ,977 ,1589 ,0,3,1,3,0,1,0,76.14,61.49 ,33.33
03,008,01,001,0018,30,1113 ,8 ,1121 ,1719 ,0,3,1,3,0,1,0,76.14,65.21 ,33.33
03,008,01,001,0018,31,983 ,7 ,990 ,1550 ,0,3,1,3,0,1,0,76.14,63.87 ,33.33
03,008,01,001,0019,32,684 ,4 ,688 ,1096 ,0,3,1,3,0,1,0,76.14,62.77 ,33.33
03,008,01,001,0019,33,865 ,6 ,871 ,1458 ,0,3,1,3,0,1,0,76.14,59.74,33.33
03,008,01,001,0019,34,1124 ,3 ,1127 ,1901 ,0,3,1,3,0,1,0,76.14,59.28,33.33
03,008,01,001,0019,35,366 ,4 ,370 ,587 ,0,3,1,3,0,1,0,76.14,63.03 ,33.33
03,008,01,001,0020,36,863 ,9 ,872 ,1361 ,0,3,1,3,0,1,0,76.14,64.07 ,33.33
03,008,01,001,0021,37,334 ,3 ,337 ,575 ,0,3,1,3,0,1,0,76.14,58.61 ,33.33
03,008,01,001,0022,38,477 ,2 ,479 ,723 ,0,3,1,3,0,1,0,76.14,66.25 ,33.33
03,008,01,001,0022,39,655 ,2 ,657 ,1033 ,0,3,1,3,0,1,0,76.14,63.60 ,33.33
03,008,01,001,0023,40,632 ,2 ,634 ,924 ,0,3,1,3,0,1,0,76.14,68.61,33.33
03,008,01,001,0023,41,603 ,3 ,606 ,875 ,0,3,1,3,0,1,0,76.14,69.26,33.33
03,008,01,001,0024,42,452 ,3 ,455 ,682 ,0,3,1,3,0,1,0,76.14,66.72,33.33
03,008,01,001,0024,43,529 ,5 ,534 ,775 ,0,3,1,3,0,1,0,76.14,68.90 ,33.33
03,008,01,001,0025,44,623 ,4 ,627 ,1055 ,0,3,1,3,0,1,0,76.14,59.43 ,33.33
03,008,01,001,0025,45,802 ,4 ,806 ,1283 ,0,3,1,3,0,1,0,76.14,62.82 ,33.33
03,008,01,001,0026,46,731 ,9 ,740 ,1272 ,0,3,1,3,0,1,0,76.14,58.18 ,33.33
03,008,01,001,0026,47,1070 ,7 ,1077 ,1845 ,0,3,1,3,0,1,0,76.14,58.37 ,33.33
03,008,01,001,0026,48,778 ,8 ,786 ,1191 ,0,3,1,3,0,1,0,76.14,65.99 ,33.33
03,008,01,001,0026,49,888 ,3 ,891 ,1571 ,0,3,1,3,0,1,0,76.14,56.72 ,33.33
03,008,01,001,0027,50,852 ,15 ,867 ,1585 ,0,3,1,3,0,1,0,76.14,54.70 ,33.33
03,008,01,001,0027,51,764 ,7 ,771 ,1313 ,0,3,1,3,0,1,0,76.14,58.72 ,33.33
03,008,01,001,0027,52,688 ,6 ,694 ,1255 ,0,3,1,3,0,1,0,76.14,55.3,33.33
03,008,01,001,0028,53,1070 ,10 ,1080 ,1945 ,0,3,1,3,0,1,0,76.14,55.53,33.33
03,008,01,001,0028,54,1067 ,9 ,1076 ,1904 ,0,3,1,3,0,1,0,76.14,56.51 ,33.33
03,008,01,001,0029,55,759 ,6 ,765 ,1268 ,0,3,1,3,0,1,0,76.14,60.33 ,33.33
03,008,01,001,0029,56,646 ,6 ,652 ,1196 ,0,3,1,3,0,1,0,76.14,54.52 ,33.33
03,008,01,001,0030,57,790 ,11 ,801 ,1307 ,0,3,1,3,0,1,0,76.14,61.29 ,33.33
03,008,01,001,0030,58,687 ,3 ,690 ,1200 ,0,3,1,3,0,1,0,76.14,57.50 ,33.33
03,008,01,001,0031,59,665 ,3 ,668 ,1234 ,0,3,1,3,0,1,0,76.14,54.13 ,33.33
03,008,01,001,0032,60,473 ,9 ,482 ,744 ,0,3,1,3,0,1,0,76.14,64.78 ,33.33
03,008,01,001,0033,61,422 ,4 ,426 ,719 ,0,3,1,3,0,1,0,76.14,59.25 ,33.33
03,008,01,001,0034,62,981 ,3 ,984 ,1780 ,0,3,1,3,0,1,0,76.14,55.28 ,33.33
03,008,01,002,0035,63,457 ,3 ,460 ,855 ,0,3,1,3,0,1,0,76.14,53.80 ,33.33
03,008,01,002,0035,64,514 ,3 ,517 ,888 ,0,3,1,3,0,1,0,76.14,58.22 ,33.33
03,008,01,002,0035,65,619 ,3 ,622 ,1177 ,0,3,1,3,0,1,0,76.14,52.85 ,33.33
03,008,01,002,0036,66,547 ,2 ,549 ,986 ,0,3,1,3,0,1,0,76.14,55.68 ,33.33
03,008,01,002,0036,67,525 ,3 ,528 ,1030 ,0,3,1,3,0,1,0,76.14,51.26 ,33.33
03,008,01,002,0036,68,558 ,3 ,561 ,1061 ,0,3,1,3,0,1,0,76.14,52.87 ,33.33
03,008,01,002,0037,69,538 ,8 ,546 ,909 ,0,3,1,3,0,1,0,76.14,60.07,33.33
03,008,01,002,0038,70,664 ,5 ,669 ,1226 ,0,3,1,3,0,1,0,76.14,54.57,33.33
03,008,01,002,0038,71,585 ,6 ,591 ,1149 ,0,3,1,3,0,1,0,76.14,51.44 ,33.33
03,008,01,002,0039,72,931 ,6 ,937 ,1638 ,0,3,1,3,0,1,0,76.14,57.20 ,33.33
03,008,01,002,0039,73,806 ,5 ,811 ,1495 ,0,3,1,3,0,1,0,76.14,54.25,33.33
03,008,01,002,0040,74,549 ,5 ,554 ,979 ,0,3,1,3,0,1,0,76.14,56.59,33.33
03,008,01,002,0040,75,506 ,2 ,508 ,946 ,0,3,1,3,0,1,0,76.14,53.70 ,33.33
03,008,01,002,0041,76,501 ,4 ,505 ,1007 ,0,3,1,3,0,1,0,76.14,50.15 ,33.33
03,008,01,002,0041,77,612 ,6 ,618 ,1157 ,0,3,1,3,0,1,0,76.14,53.41 ,33.33
03,008,01,002,0042,78,665 ,4 ,669 ,1188 ,0,3,1,3,0,1,0,76.14,56.31 ,33.33
03,008,01,002,0042,79,566 ,4 ,570 ,1058 ,0,3,1,3,0,1,0,76.14,53.88 ,33.33
03,008,01,002,0043,80,538 ,4 ,542 ,1015 ,0,3,1,3,0,1,0,76.14,53.40 ,33.33
03,008,01,002,0043,81,546 ,2 ,548 ,1008 ,0,3,1,3,0,1,0,76.14,54.37 ,33.33
03,008,01,002,0043,82,680 ,5 ,685 ,1431 ,0,3,1,3,0,1,0,76.14,47.87 ,33.33
03,008,01,002,0044,83,728 ,4 ,732 ,1181 ,0,3,1,3,0,1,0,76.14,61.98 ,33.33
03,008,01,002,0045,84,736 ,6 ,742 ,1395 ,0,3,1,3,0,1,0,76.14,53.19 ,33.33
03,008,01,002,0045,85,765 ,8 ,773 ,1379 ,0,3,1,3,0,1,0,76.14,56.06 ,33.33
03,008,01,002,0045,86,645 ,1 ,646 ,1241 ,0,3,1,3,0,1,0,76.14,52.05 ,33.33
03,008,01,002,0045,87,790 ,5 ,795 ,1616 ,0,3,1,3,0,1,0,76.14,49.20 ,33.33
03,008,01,002,0046,88,554 ,1 ,555 ,940 ,0,3,1,3,0,1,0,76.14,59.04 ,33.33
03,008,01,002,0047,89,602 ,3 ,605 ,1089 ,0,3,1,3,0,1,0,76.14,55.56 ,33.33
03,008,01,002,0047,90,610 ,5 ,615 ,1193 ,0,3,1,3,0,1,0,76.14,51.55 ,33.33
03,008,01,002,0048,91,644 ,7 ,651 ,1342 ,0,3,1,3,0,1,0,76.14,48.51 ,33.33
03,008,01,002,0048,92,370 ,1 ,371 ,705 ,0,3,1,3,0,1,0,76.14,52.62 ,33.33
03,008,01,002,0048,93,605 ,10 ,615 ,1222 ,0,3,1,3,0,1,0,76.14,50.33 ,33.33
03,008,01,002,0048,94,807 ,5 ,812 ,1538 ,0,3,1,3,0,1,0,76.14,52.80 ,33.33
03,008,01,002,0048,95,476 ,2 ,478 ,990 ,0,3,1,3,0,1,0,76.14,48.28 ,33.33
03,008,01,002,0049,96,480 ,4 ,484 ,945 ,0,3,1,3,0,1,0,76.14,51.22,33.33
03,008,01,002,0049,97,426 ,4 ,430 ,946 ,0,3,1,3,0,1,0,76.14,45.45,33.33
03,008,01,002,0049,98,571 ,6 ,577 ,1160 ,0,3,1,3,0,1,0,76.14,49.74 ,33.33
03,008,01,002,0050,99,522 ,6 ,528 ,996 ,0,3,1,3,0,1,0,76.14,53.01 ,33.33
03,008,01,002,0051,100,528 ,6 ,534 ,972 ,0,3,1,3,0,1,0,76.14,54.94 ,33.33
03,008,01,002,0052,101,535 ,9 ,544 ,904 ,0,3,1,3,0,1,0,76.14,60.18 ,33.33
03,008,01,002,0053,102,542 ,3 ,545 ,1023 ,0,3,1,3,0,1,0,76.14,53.27 ,33.33
03,008,01,002,0054,103,205 ,1 ,206 ,372 ,0,3,1,3,0,1,0,76.14,55.38 ,33.33
03,008,01,002,0055,104,619 ,4 ,623 ,1277 ,0,3,1,3,0,1,0,76.14,48.79 ,33.33
03,008,01,002,0056,105,708 ,5 ,713 ,1313 ,0,3,1,3,0,1,0,76.14,54.30 ,33.33
03,008,01,002,0057,106,808 ,5 ,813 ,1542 ,0,3,1,3,0,1,0,76.14,52.72,33.33
03,008,01,002,0058,107,489 ,3 ,492 ,875 ,0,3,1,3,0,1,0,76.14,56.23,33.33
03,008,01,002,0058,108,174 ,0 ,174 ,337 ,0,3,1,3,0,1,0,76.14,51.63,33.33
03,008,01,002,0059,109,419 ,2 ,421 ,659 ,0,3,1,3,0,1,0,76.14,63.88 ,33.33
03,008,01,002,0060,110,434 ,2 ,436 ,794 ,0,3,1,3,0,1,0,76.14,54.91 ,33.33
03,008,01,002,0061,111,739 ,3 ,742 ,1293 ,0,3,1,3,0,1,0,76.14,57.39 ,33.33
03,008,01,002,0061,112,152 ,0 ,152 ,254 ,0,3,1,3,0,1,0,76.14,59.84 ,33.33
03,008,01,002,0062,113,676 ,10 ,686 ,1195 ,0,3,1,3,0,1,0,76.14,57.41 ,33.33
03,008,01,002,0063,114,415 ,0 ,415 ,674 ,0,3,1,3,0,1,0,76.14,61.57 ,33.33
03,008,01,002,0064,115,477 ,7 ,484 ,973 ,0,3,1,3,0,1,0,76.14,49.74,33.33
03,008,01,002,0065,116,616 ,4 ,620 ,1090 ,0,3,1,3,0,1,0,76.14,56.88,33.33
03,008,01,002,0065,117,744 ,11 ,755 ,1332 ,0,3,1,3,0,1,0,76.14,56.68,33.33
03,008,01,002,0066,118,633 ,4 ,637 ,1154 ,0,3,1,3,0,1,0,76.14,55.20 ,33.33
03,008,01,002,0067,119,571 ,2 ,573 ,1030 ,0,3,1,3,0,1,0,76.14,55.63 ,33.33
03,008,01,002,0067,120,471 ,4 ,475 ,892 ,0,3,1,3,0,1,0,76.14,53.25 ,33.33
03,008,01,002,0067,121,298 ,4 ,302 ,549 ,0,3,1,3,0,1,0,76.14,55.01 ,33.33
03,008,01,003,0068,122,510 ,6 ,516 ,870 ,0,3,1,3,0,1,0,76.14,59.31 ,33.33
03,008,01,003,0068,123,686 ,5 ,691 ,1116 ,0,3,1,3,0,1,0,76.14,61.92 ,33.33
03,008,01,003,0069,124,1063 ,10 ,1073 ,1730 ,0,3,1,3,0,1,0,76.14,62.02 ,33.33
03,008,01,003,0069,125,1016 ,4 ,1020 ,1745 ,0,3,1,3,0,1,0,76.14,58.45 ,33.33
03,008,01,003,0070,126,602 ,5 ,607 ,925 ,0,3,1,3,0,1,0,76.14,65.62 ,33.33
03,008,01,003,0070,127,682 ,3 ,685 ,1108 ,0,3,1,3,0,1,0,76.14,61.82 ,33.33
03,008,01,003,0071,128,458 ,7 ,465 ,717 ,0,3,1,3,0,1,0,76.14,64.85 ,33.33
03,008,01,003,0072,129,773 ,4 ,777 ,1256 ,0,3,1,3,0,1,0,76.14,61.86 ,33.33
03,008,01,003,0073,130,587 ,2 ,589 ,917 ,0,3,1,3,0,1,0,76.14,64.23 ,33.33
03,008,01,003,0073,131,787 ,7 ,794 ,1332 ,0,3,1,3,0,1,0,76.14,59.61 ,33.33
03,008,01,003,0074,132,669 ,4 ,673 ,1166 ,0,3,1,3,0,1,0,76.14,57.72,33.33
03,008,01,003,0074,133,782 ,9 ,791 ,1389 ,0,3,1,3,0,1,0,76.14,56.95,33.33
03,008,01,003,0074,134,735 ,5 ,740 ,1287 ,0,3,1,3,0,1,0,76.14,57.50 ,33.33
03,008,01,003,0074,135,932 ,8 ,940 ,1581 ,0,3,1,3,0,1,0,76.14,59.46 ,33.33
03,008,01,003,0075,136,975 ,6 ,981 ,1672 ,0,3,1,3,0,1,0,76.14,58.67,33.33
03,008,01,003,0075,137,912 ,5 ,917 ,1573 ,0,3,1,3,0,1,0,76.14,58.3,33.33
03,008,01,003,0075,138,814 ,2 ,816 ,1340 ,0,3,1,3,0,1,0,76.14,60.90 ,33.33
03,008,01,003,0075,139,966 ,1 ,967 ,1568 ,0,3,1,3,0,1,0,76.14,61.67 ,33.33
03,008,01,003,0076,140,860 ,3 ,863 ,1359 ,0,3,1,3,0,1,0,76.14,63.50 ,33.33
03,008,01,003,0076,141,804 ,6 ,810 ,1392 ,0,3,1,3,0,1,0,76.14,58.19 ,33.33
03,008,01,003,0077,142,885 ,6 ,891 ,1498 ,0,3,1,3,0,1,0,76.14,59.48 ,33.33
03,008,01,003,0077,143,596 ,6 ,602 ,979 ,0,3,1,3,0,1,0,76.14,61.49 ,33.33
03,008,01,003,0078,144,659 ,7 ,666 ,1102 ,0,3,1,3,0,1,0,76.14,60.44,33.33
03,008,01,003,0078,145,720 ,6 ,726 ,1208 ,0,3,1,3,0,1,0,76.14,60.1,33.33
03,008,01,003,0078,146,580 ,3 ,583 ,1194 ,0,3,1,3,0,1,0,76.14,48.83,33.33
03,008,01,003,0079,147,693 ,4 ,697 ,1087 ,0,3,1,3,0,1,0,76.14,64.12 ,33.33
03,008,01,003,0079,148,447 ,2 ,449 ,734 ,0,3,1,3,0,1,0,76.14,61.17 ,33.33
03,008,01,003,0080,149,729 ,13 ,742 ,1263 ,0,3,1,3,0,1,0,76.14,58.75 ,33.33
03,008,01,003,0080,150,868 ,6 ,874 ,1548 ,0,3,1,3,0,1,0,76.14,56.46 ,33.33
03,008,01,003,0081,151,811 ,7 ,818 ,1407 ,0,3,1,3,0,1,0,76.14,58.14 ,33.33
03,008,01,003,0081,152,914 ,6 ,920 ,1672 ,0,3,1,3,0,1,0,76.14,55.02 ,33.33
03,008,01,003,0081,153,443 ,7 ,450 ,818 ,0,3,1,3,0,1,0,76.14,55.01 ,33.33
03,008,01,003,0081,154,657 ,6 ,663 ,1221 ,0,3,1,3,0,1,0,76.14,54.30 ,33.33
03,008,01,003,0082,155,786 ,2 ,788 ,1290 ,0,3,1,3,0,1,0,76.14,61.09 ,33.33
03,008,01,003,0082,156,656 ,5 ,661 ,1111 ,0,3,1,3,0,1,0,76.14,59.50 ,33.33
03,008,01,003,0082,157,549 ,3 ,552 ,978 ,0,3,1,3,0,1,0,76.14,56.44 ,33.33
03,008,01,003,0083,158,876 ,6 ,882 ,1496 ,0,3,1,3,0,1,0,76.14,58.96 ,33.33
03,008,01,003,0083,159,813 ,7 ,820 ,1426 ,0,3,1,3,0,1,0,76.14,57.50 ,33.33
03,008,01,003,0084,160,460 ,7 ,467 ,727 ,0,3,1,3,0,1,0,76.14,64.24 ,33.33
03,008,01,003,0084,161,824 ,4 ,828 ,1318 ,0,3,1,3,0,1,0,76.14,62.82 ,33.33
03,008,01,003,0085,162,748 ,12 ,760 ,1240 ,0,3,1,3,0,1,0,76.14,61.29 ,33.33
03,008,01,003,0086,163,737 ,5 ,742 ,1170 ,0,3,1,3,0,1,0,76.14,63.42 ,33.33
03,008,01,003,0086,164,694 ,7 ,701 ,1237 ,0,3,1,3,0,1,0,76.14,56.67 ,33.33
03,008,01,003,0087,165,939 ,2 ,941 ,1534 ,0,3,1,3,0,1,0,76.14,61.34 ,33.33
03,008,01,003,0087,166,795 ,7 ,802 ,1460 ,0,3,1,3,0,1,0,76.14,54.93 ,33.33
03,008,01,003,0087,167,579 ,3 ,582 ,1011 ,0,3,1,3,0,1,0,76.14,57.57 ,33.33
03,008,01,003,0087,168,318 ,0 ,318 ,520 ,0,3,1,3,0,1,0,76.14,61.15 ,33.33
03,008,01,003,0088,169,868 ,7 ,875 ,1426 ,0,3,1,3,0,1,0,76.14,61.36 ,33.33
03,008,01,003,0088,170,273 ,1 ,274 ,483 ,0,3,1,3,0,1,0,76.14,56.73 ,33.33
03,008,01,003,0089,171,633 ,3 ,636 ,1087 ,0,3,1,3,0,1,0,76.14,58.51,33.33
03,008,01,003,0089,172,464 ,10 ,474 ,823 ,0,3,1,3,0,1,0,76.14,57.59,33.33
03,008,01,003,0090,173,840 ,5 ,845 ,1426 ,0,3,1,3,0,1,0,76.14,59.26 ,33.33
03,008,01,003,0090,174,624 ,4 ,628 ,1091 ,0,3,1,3,0,1,0,76.14,57.56 ,33.33
03,008,01,003,0090,175,592 ,4 ,596 ,962 ,0,3,1,3,0,1,0,76.14,61.95 ,33.33
03,008,01,003,0091,176,580 ,4 ,584 ,923 ,0,3,1,3,0,1,0,76.14,63.27 ,33.33
03,008,01,003,0092,177,342 ,7 ,349 ,641 ,0,3,1,3,0,1,0,76.14,54.45,33.33
03,008,01,003,0092,178,561 ,10 ,571 ,1020 ,0,3,1,3,0,1,0,76.14,55.98,33.33
03,008,01,003,0093,179,601 ,3 ,604 ,1019 ,0,3,1,3,0,1,0,76.14,59.27 ,33.33
03,008,01,003,0094,180,602 ,10 ,612 ,1125 ,0,3,1,3,0,1,0,76.14,54.40 ,33.33
03,008,01,003,0094,181,669 ,4 ,673 ,1167 ,0,3,1,3,0,1,0,76.14,57.67 ,33.33
03,008,01,004,0095,182,730 ,2 ,732 ,1213 ,0,3,1,3,0,1,0,76.14,60.35 ,33.33
03,008,01,004,0095,183,551 ,1 ,552 ,893 ,0,3,1,3,0,1,0,76.14,61.81 ,33.33
03,008,01,004,0096,184,446 ,2 ,448 ,689 ,0,3,1,3,0,1,0,76.14,65.02 ,33.33
03,008,01,004,0097,185,620 ,3 ,623 ,1099 ,0,3,1,3,0,1,0,76.14,56.69,33.33
03,008,01,004,0097,186,771 ,5 ,776 ,1441 ,0,3,1,3,0,1,0,76.14,53.85,33.33
03,008,01,004,0097,187,981 ,10 ,991 ,1883 ,0,3,1,3,0,1,0,76.14,52.63 ,33.33
03,008,01,004,0098,188,800 ,6 ,806 ,1334 ,0,3,1,3,0,1,0,76.14,60.42 ,33.33
03,008,01,004,0098,189,1052 ,6 ,1058 ,1845 ,0,3,1,3,0,1,0,76.14,57.34 ,33.33
03,008,01,004,0099,190,413 ,5 ,418 ,668 ,0,3,1,3,0,1,0,76.14,62.57 ,33.33
03,008,01,004,0099,191,770 ,9 ,779 ,1520 ,0,3,1,3,0,1,0,76.14,51.25 ,33.33
03,008,01,004,0100,192,957 ,16 ,973 ,1765 ,0,3,1,3,0,1,0,76.14,55.13 ,33.33
03,008,01,004,0100,193,916 ,4 ,920 ,1627 ,0,3,1,3,0,1,0,76.14,56.55 ,33.33
03,008,01,004,0101,194,307 ,2 ,309 ,503 ,0,3,1,3,0,1,0,76.14,61.43,33.33
03,008,01,004,0101,195,316 ,1 ,317 ,548 ,0,3,1,3,0,1,0,76.14,57.85,33.33
03,008,01,004,0102,196,663 ,1 ,664 ,1087 ,0,3,1,3,0,1,0,76.14,61.09 ,33.33
03,008,01,004,0103,197,752 ,4 ,756 ,1312 ,0,3,1,3,0,1,0,76.14,57.62 ,33.33
03,008,01,004,0104,198,150 ,2 ,152 ,244 ,0,3,1,3,0,1,0,76.14,62.30 ,33.33
03,008,01,004,0104,199,298 ,0 ,298 ,504 ,0,3,1,3,0,1,0,76.14,59.13 ,33.33
03,008,01,004,0105,200,261 ,0 ,261 ,425 ,0,3,1,3,0,1,0,76.14,61.41 ,33.33
03,008,01,004,0106,201,772 ,3 ,775 ,1477 ,0,3,1,3,0,1,0,76.14,52.47 ,33.33
03,008,01,004,0106,202,836 ,4 ,840 ,1544 ,0,3,1,3,0,1,0,76.14,54.40 ,33.33
03,008,01,004,0106,203,699 ,2 ,701 ,1256 ,0,3,1,3,0,1,0,76.14,55.81 ,33.33
03,008,01,004,0107,204,959 ,6 ,965 ,1792 ,0,3,1,3,0,1,0,76.14,53.85 ,33.33
03,008,01,004,0107,205,773 ,7 ,780 ,1499 ,0,3,1,3,0,1,0,76.14,52.03 ,33.33
03,008,01,004,0108,206,503 ,1 ,504 ,865 ,0,3,1,3,0,1,0,76.14,58.27 ,33.33
03,008,01,004,0108,207,443 ,5 ,448 ,778 ,0,3,1,3,0,1,0,76.14,57.58 ,33.33
03,008,01,004,0109,208,653 ,6 ,659 ,1223 ,0,3,1,3,0,1,0,76.14,53.88 ,33.33
03,008,01,004,0109,209,507 ,3 ,510 ,905 ,0,3,1,3,0,1,0,76.14,56.35 ,33.33
03,008,01,004,0109,210,378 ,2 ,380 ,577 ,0,3,1,3,0,1,0,76.14,65.86 ,33.33
03,008,01,004,0110,211,363 ,6 ,369 ,661 ,0,3,1,3,0,1,0,76.14,55.82 ,33.33
03,008,01,004,0111,212,600 ,6 ,606 ,1158 ,0,3,1,3,0,1,0,76.14,52.33 ,33.33
03,008,01,004,0111,213,354 ,1 ,355 ,672 ,0,3,1,3,0,1,0,76.14,52.83 ,33.33
03,008,01,004,0112,214,563 ,4 ,567 ,992 ,0,3,1,3,0,1,0,76.14,57.16 ,33.33
03,008,01,004,0113,215,769 ,9 ,778 ,1322 ,0,3,1,3,0,1,0,76.14,58.85,33.33
03,008,01,004,0114,216,399 ,4 ,403 ,715 ,0,3,1,3,0,1,0,76.14,56.36,33.33
03,008,01,004,0115,217,275 ,3 ,278 ,436 ,0,3,1,3,0,1,0,76.14,63.76 ,33.33
03,008,01,004,0115,218,90 ,0 ,90 ,182 ,0,3,1,3,0,1,0,76.14,49.45 ,33.33
03,008,01,004,0116,219,814 ,7 ,821 ,1459 ,0,3,1,3,0,1,0,76.14,56.27,33.33
03,008,01,004,0117,220,221 ,2 ,223 ,384 ,0,3,1,3,0,1,0,76.14,58.07,33.33
03,008,01,004,0117,221,346 ,1 ,347 ,505 ,0,3,1,3,0,1,0,76.14,68.71 ,33.33
03,008,01,004,0118,222,123 ,0 ,123 ,205 ,0,3,1,3,0,1,0,76.14,60.00 ,33.33
03,008,01,004,0118,223,222 ,1 ,223 ,370 ,0,3,1,3,0,1,0,76.14,60.27 ,33.33
03,008,01,004,0119,224,288 ,0 ,288 ,518 ,0,3,1,3,0,1,0,76.14,55.60 ,33.33
03,008,01,004,0119,225,188 ,0 ,188 ,349 ,0,3,1,3,0,1,0,76.14,53.87 ,33.33
03,008,01,004,0120,226,275 ,4 ,279 ,532 ,0,3,1,3,0,1,0,76.14,52.44 ,33.33
03,008,01,004,0121,227,401 ,3 ,404 ,710 ,0,3,1,3,0,1,0,76.14,56.90 ,33.33
03,008,01,004,0122,228,297 ,4 ,301 ,581 ,0,3,1,3,0,1,0,76.14,51.81 ,33.33
03,008,01,004,0122,229,233 ,2 ,235 ,456 ,0,3,1,3,0,1,0,76.14,51.54 ,33.33
03,008,01,005,0123,230,587 ,7 ,594 ,951 ,0,3,1,3,0,1,0,76.14,62.46,33.33
03,008,01,005,0124,231,542 ,4 ,546 ,932 ,0,3,1,3,0,1,0,76.14,58.58,33.33
03,008,01,005,0125,232,339 ,1 ,340 ,558 ,0,3,1,3,0,1,0,76.14,60.93 ,33.33
03,008,01,005,0126,233,644 ,11 ,655 ,1219 ,0,3,1,3,0,1,0,76.14,53.73 ,33.33
03,008,01,005,0127,234,365 ,1 ,366 ,562 ,0,3,1,3,0,1,0,76.14,65.12 ,33.33
03,008,01,005,0128,235,288 ,1 ,289 ,448 ,0,3,1,3,0,1,0,76.14,64.51 ,33.33
03,008,01,005,0129,236,601 ,3 ,604 ,894 ,0,3,1,3,0,1,0,76.14,67.56 ,33.33
03,008,01,005,0130,237,766 ,6 ,772 ,1401 ,0,3,1,3,0,1,0,76.14,55.10 ,33.33
03,008,01,005,0131,238,542 ,1 ,543 ,907 ,0,3,1,3,0,1,0,76.14,59.87 ,33.33
03,008,01,005,0132,239,327 ,0 ,327 ,622 ,0,3,1,3,0,1,0,76.14,52.57 ,33.33
03,008,01,005,0132,240,226 ,2 ,228 ,442 ,0,3,1,3,0,1,0,76.14,51.58 ,33.33
03,008,01,005,0133,241,211 ,1 ,212 ,414 ,0,3,1,3,0,1,0,76.14,51.21 ,33.33
03,008,01,006,0134,242,557 ,4 ,561 ,1018 ,0,3,1,3,0,1,0,76.14,55.11 ,33.33
03,008,01,006,0135,243,683 ,7 ,690 ,1288 ,0,3,1,3,0,1,0,76.14,53.57 ,33.33
03,008,01,006,0135,244,913 ,7 ,920 ,1665 ,0,3,1,3,0,1,0,76.14,55.26 ,33.33
03,008,01,006,0136,245,387 ,3 ,390 ,759 ,0,3,1,3,0,1,0,76.14,51.38 ,33.33
03,008,01,006,0136,246,726 ,5 ,731 ,1265 ,0,3,1,3,0,1,0,76.14,57.79 ,33.33
03,008,01,006,0137,247,860 ,5 ,865 ,1557 ,0,3,1,3,0,1,0,76.14,55.56 ,33.33
03,008,01,006,0138,248,607 ,4 ,611 ,1031 ,0,3,1,3,0,1,0,76.14,59.26 ,33.33
03,008,01,006,0139,249,605 ,3 ,608 ,1003 ,0,3,1,3,0,1,0,76.14,60.62 ,33.33
03,008,01,006,0140,250,972 ,6 ,978 ,1654 ,0,3,1,3,0,1,0,76.14,59.13 ,33.33
03,008,01,006,0140,251,529 ,2 ,531 ,905 ,0,3,1,3,0,1,0,76.14,58.67 ,33.33
03,008,01,006,0140,252,566 ,3 ,569 ,1087 ,0,3,1,3,0,1,0,76.14,52.35 ,33.33
03,008,01,006,0141,253,460 ,4 ,464 ,789 ,0,3,1,3,0,1,0,76.14,58.81 ,33.33
03,008,01,006,0141,254,438 ,3 ,441 ,840 ,0,3,1,3,0,1,0,76.14,52.50 ,33.33
03,008,01,006,0142,255,497 ,8 ,505 ,850 ,0,3,1,3,0,1,0,76.14,59.41 ,33.33
03,008,01,006,0143,256,611 ,12 ,623 ,988 ,0,3,1,3,0,1,0,76.14,63.06 ,33.33
03,008,01,006,0144,257,618 ,5 ,623 ,1044 ,0,3,1,3,0,1,0,76.14,59.67 ,33.33
03,008,01,006,0144,258,478 ,5 ,483 ,836 ,0,3,1,3,0,1,0,76.14,57.78,33.33
03,008,01,006,0144,259,605 ,9 ,614 ,1025 ,0,3,1,3,0,1,0,76.14,59.9,33.33
03,008,01,006,0144,260,532 ,3 ,535 ,929 ,0,3,1,3,0,1,0,76.14,57.59,33.33
03,008,01,006,0144,261,431 ,5 ,436 ,757 ,0,3,1,3,0,1,0,76.14,57.60 ,33.33
03,008,01,006,0147,262,431 ,3 ,434 ,686 ,0,3,1,3,0,1,0,76.14,63.27 ,33.33
03,008,01,006,0147,263,327 ,4 ,331 ,557 ,0,3,1,3,0,1,0,76.14,59.43 ,33.33
03,008,01,006,0148,264,549 ,9 ,558 ,932 ,0,3,1,3,0,1,0,76.14,59.87 ,33.33
03,008,01,006,0149,265,586 ,10 ,596 ,1029 ,0,3,1,3,0,1,0,76.14,57.92,33.33
03,008,01,006,0149,266,269 ,4 ,273 ,457 ,0,3,1,3,0,1,0,76.14,59.74,33.33
03,008,01,006,0150,267,766 ,4 ,770 ,1497 ,0,3,1,3,0,1,0,76.14,51.44 ,33.33
03,008,01,006,0151,268,641 ,9 ,650 ,1132 ,0,3,1,3,0,1,0,76.14,57.42 ,33.33
03,008,01,006,0152,269,469 ,6 ,475 ,808 ,0,3,1,3,0,1,0,76.14,58.79 ,33.33
03,008,01,006,0153,270,516 ,6 ,522 ,880 ,0,3,1,3,0,1,0,76.14,59.32 ,33.33
03,008,01,006,0154,271,459 ,3 ,462 ,814 ,0,3,1,3,0,1,0,76.14,56.76 ,33.33
03,008,01,006,0155,272,468 ,4 ,472 ,767 ,0,3,1,3,0,1,0,76.14,61.54 ,33.33
03,008,01,006,0155,273,512 ,8 ,520 ,870 ,0,3,1,3,0,1,0,76.14,59.77,33.33
03,008,01,007,0156,274,812 ,7 ,819 ,1573 ,0,3,1,3,0,1,0,76.14,52.07,33.33
03,008,01,007,0157,275,990 ,6 ,996 ,1672 ,0,3,1,3,0,1,0,76.14,59.57,33.33
03,008,01,007,0158,276,505 ,3 ,508 ,764 ,0,3,1,3,0,1,0,76.14,66.49,33.33
03,008,01,007,0158,277,244 ,0 ,244 ,416 ,0,3,1,3,0,1,0,76.14,58.65,33.33
03,008,01,007,0159,278,534 ,8 ,542 ,773 ,0,3,1,3,0,1,0,76.14,70.12,33.33
03,008,01,007,0159,279,692 ,3 ,695 ,1073 ,0,3,1,3,0,1,0,76.14,64.77,33.33
03,008,01,007,0160,280,319 ,2 ,321 ,566 ,0,3,1,3,0,1,0,76.14,56.71,33.33
03,008,01,007,0160,281,273 ,1 ,274 ,451 ,0,3,1,3,0,1,0,76.14,60.75,33.33
03,008,01,007,0161,282,382 ,1 ,383 ,603 ,0,3,1,3,0,1,0,76.14,63.52,33.33
03,008,01,007,0162,283,861 ,3 ,864 ,1524 ,0,3,1,3,0,1,0,76.14,56.69,33.33
03,008,01,007,0163,284,539 ,5 ,544 ,895 ,0,3,1,3,0,1,0,76.14,60.78,33.33
03,008,01,007,0164,285,804 ,5 ,809 ,1352 ,0,3,1,3,0,1,0,76.14,59.84,33.33
03,008,01,007,0165,286,847 ,3 ,850 ,1343 ,0,3,1,3,0,1,0,76.14,63.29,33.33
03,008,01,007,0166,287,316 ,3 ,319 ,642 ,0,3,1,3,0,1,0,76.14,49.69,33.33
03,008,01,007,0166,288,237 ,0 ,237 ,428 ,0,3,1,3,0,1,0,76.14,55.37,33.33
03,008,01,007,0167,289,417 ,3 ,420 ,714 ,0,3,1,3,0,1,0,76.14,58.82,33.33
03,008,01,007,0168,290,397 ,0 ,397 ,768 ,0,3,1,3,0,1,0,76.14,51.69,33.33
03,008,01,008,0169,291,473 ,7 ,480 ,840 ,0,3,1,3,0,1,0,76.14,57.14,33.33
03,008,01,008,0170,292,154 ,3 ,157 ,271 ,0,3,1,3,0,1,0,76.14,57.93,33.33
03,008,01,008,0170,293,130 ,3 ,133 ,245 ,0,3,1,3,0,1,0,76.14,54.29,33.33
03,008,01,008,0171,294,220 ,1 ,221 ,375 ,0,3,1,3,0,1,0,76.14,58.93,33.33
03,008,01,008,0171,295,210 ,0 ,210 ,359 ,0,3,1,3,0,1,0,76.14,58.5,33.33
03,008,01,008,0172,296,258 ,1 ,259 ,436 ,0,3,1,3,0,1,0,76.14,59.4,33.33
03,008,01,008,0172,297,169 ,2 ,171 ,356 ,0,3,1,3,0,1,0,76.14,48.03,33.33
03,008,01,008,0173,298,369 ,5 ,374 ,683 ,0,3,1,3,0,1,0,76.14,54.76,33.33
03,008,01,008,0174,299,528 ,6 ,534 ,974 ,0,3,1,3,0,1,0,76.14,54.83,33.33
03,008,01,008,0174,300,462 ,1 ,463 ,781 ,0,3,1,3,0,1,0,76.14,59.28,33.33
03,008,01,008,0175,301,145 ,0 ,145 ,263 ,0,3,1,3,0,1,0,76.14,55.13,33.33
03,008,01,008,0176,302,425 ,2 ,427 ,711 ,0,3,1,3,0,1,0,76.14,60.06,33.33
03,008,01,008,0177,303,303 ,3 ,306 ,545 ,0,3,1,3,0,1,0,76.14,56.15,33.33
03,008,01,008,0178,304,216 ,3 ,219 ,366 ,0,3,1,3,0,1,0,76.14,59.84,33.33
03,008,01,008,0178,305,441 ,4 ,445 ,790 ,0,3,1,3,0,1,0,76.14,56.33,33.33
03,008,01,008,0179,306,280 ,3 ,283 ,470 ,0,3,1,3,0,1,0,76.14,60.21,33.33
03,008,01,008,0179,307,363 ,7 ,370 ,640 ,0,3,1,3,0,1,0,76.14,57.81,33.33
03,008,01,008,0180,308,534 ,4 ,538 ,945 ,0,3,1,3,0,1,0,76.14,56.93,33.33
03,008,01,008,0181,309,253 ,4 ,257 ,470 ,0,3,1,3,0,1,0,76.14,54.68,33.33
03,008,01,008,0182,310,430 ,1 ,431 ,706 ,0,3,1,3,0,1,0,76.14,61.05,33.33
03,008,01,008,0183,311,314 ,4 ,318 ,538 ,0,3,1,3,0,1,0,76.14,59.11,33.33
03,008,01,008,0184,312,357 ,3 ,360 ,673 ,0,3,1,3,0,1,0,76.14,53.49,33.33
03,008,01,008,0185,313,283 ,1 ,284 ,436 ,0,3,1,3,0,1,0,76.14,65.14,33.33
03,008,01,008,0186,314,324 ,3 ,327 ,543 ,0,3,1,3,0,1,0,76.14,60.22,33.33
03,008,01,009,0187,315,970 ,13 ,983 ,1894 ,0,3,1,3,0,1,0,76.14,51.9,33.33
03,008,01,009,0188,316,785 ,10 ,795 ,1514 ,0,3,1,3,0,1,0,76.14,52.51,33.33
03,008,01,009,0189,317,269 ,3 ,272 ,517 ,0,3,1,3,0,1,0,76.14,52.61,33.33
03,008,01,009,0189,318,286 ,2 ,288 ,552 ,0,3,1,3,0,1,0,76.14,52.17,33.33
03,008,01,009,0190,319,614 ,5 ,619 ,1224 ,0,3,1,3,0,1,0,76.14,50.57,33.33
03,008,01,009,0191,320,144 ,1 ,145 ,228 ,0,3,1,3,0,1,0,76.14,63.6,33.33
03,008,01,009,0191,321,247 ,2 ,249 ,519 ,0,3,1,3,0,1,0,76.14,47.98,33.33
03,008,01,009,0191,322,101 ,2 ,103 ,200 ,0,3,1,3,0,1,0,76.14,51.5,33.33
03,008,01,009,0192,323,388 ,4 ,392 ,746 ,0,3,1,3,0,1,0,76.14,52.55,33.33
03,008,01,009,0192,324,161 ,1 ,162 ,286 ,0,3,1,3,0,1,0,76.14,56.64,33.33
03,008,01,009,0192,325,161 ,1 ,162 ,290 ,0,3,1,3,0,1,0,76.14,55.86,33.33
03,008,01,009,0193,326,163 ,3 ,166 ,287 ,0,3,1,3,0,1,0,76.14,57.84,33.33
03,008,01,009,0193,327,198 ,1 ,199 ,378 ,0,3,1,3,0,1,0,76.14,52.65,33.33
03,008,01,009,0194,328,323 ,1 ,324 ,553 ,0,3,1,3,0,1,0,76.14,58.59,33.33
03,008,01,009,0194,329,103 ,1 ,104 ,168 ,0,3,1,3,0,1,0,76.14,61.9,33.33
03,008,01,009,0195,330,336 ,2 ,338 ,638 ,0,3,1,3,0,1,0,76.14,52.98,33.33
03,008,01,009,0195,331,212 ,1 ,213 ,382 ,0,3,1,3,0,1,0,76.14,55.76,33.33
03,008,01,009,0196,332,405 ,4 ,409 ,809 ,0,3,1,3,0,1,0,76.14,50.56,33.33
03,008,01,009,0197,333,257 ,1 ,258 ,522 ,0,3,1,3,0,1,0,76.14,49.43,33.33
03,008,01,009,0198,334,220 ,1 ,221 ,418 ,0,3,1,3,0,1,0,76.14,52.87,33.33
03,008,01,009,0198,335,313 ,5 ,318 ,535 ,0,3,1,3,0,1,0,76.14,59.44,33.33
03,008,01,009,0199,336,245 ,1 ,246 ,425 ,0,3,1,3,0,1,0,76.14,57.88,33.33
03,008,01,009,0199,337,168 ,0 ,168 ,314 ,0,3,1,3,0,1,0,76.14,53.5,33.33
03,008,01,010,0200,338,483 ,5 ,488 ,879 ,0,3,1,3,0,1,0,76.14,55.52,33.33
03,008,01,010,0200,339,385 ,0 ,385 ,751 ,0,3,1,3,0,1,0,76.14,51.26,33.33
03,008,01,010,0201,340,433 ,1 ,434 ,879 ,0,3,1,3,0,1,0,76.14,49.37,33.33
03,008,01,010,0201,341,454 ,4 ,458 ,802 ,0,3,1,3,0,1,0,76.14,57.11,33.33
03,008,01,010,0202,342,408 ,3 ,411 ,756 ,0,3,1,3,0,1,0,76.14,54.37,33.33
03,008,01,010,0203,343,720 ,7 ,727 ,1503 ,0,3,1,3,0,1,0,76.14,48.37,33.33
03,008,01,010,0204,344,337 ,7 ,344 ,694 ,0,3,1,3,0,1,0,76.14,49.57,33.33
03,008,01,010,0205,345,405 ,8 ,413 ,824 ,0,3,1,3,0,1,0,76.14,50.12,33.33
03,008,01,010,0206,346,564 ,6 ,570 ,1075 ,0,3,1,3,0,1,0,76.14,53.02,33.33
03,008,01,010,0206,347,391 ,5 ,396 ,902 ,0,3,1,3,0,1,0,76.14,43.9,33.33
03,008,01,010,0207,348,477 ,4 ,481 ,897 ,0,3,1,3,0,1,0,76.14,53.62,33.33
03,008,01,010,0207,349,510 ,13 ,523 ,947 ,0,3,1,3,0,1,0,76.14,55.23,33.33
03,008,01,010,0208,350,462 ,3 ,465 ,854 ,0,3,1,3,0,1,0,76.14,54.45,33.33
03,008,01,010,0209,351,678 ,10 ,688 ,1198 ,0,3,1,3,0,1,0,76.14,57.43,33.33
03,008,01,010,0210,352,390 ,5 ,395 ,754 ,0,3,1,3,0,1,0,76.14,52.39,33.33
03,008,01,010,0211,353,619 ,5 ,624 ,1115 ,0,3,1,3,0,1,0,76.14,55.96,33.33
03,008,01,010,0211,354,238 ,0 ,238 ,490 ,0,3,1,3,0,1,0,76.14,48.57,33.33
03,008,01,010,0212,355,567 ,12 ,579 ,1193 ,0,3,1,3,0,1,0,76.14,48.53,33.33
03,008,01,010,0212,356,347 ,3 ,350 ,677 ,0,3,1,3,0,1,0,76.14,51.7,33.33
03,008,01,011,0213,357,485 ,4 ,489 ,895 ,0,3,1,3,0,1,0,76.14,54.64,33.33
03,008,01,011,0214,358,295 ,2 ,297 ,555 ,0,3,1,3,0,1,0,76.14,53.51,33.33
03,008,01,011,0214,359,569 ,5 ,574 ,1069 ,0,3,1,3,0,1,0,76.14,53.7,33.33
03,008,01,011,0215,360,441 ,2 ,443 ,720 ,0,3,1,3,0,1,0,76.14,61.53,33.33
03,008,01,011,0216,361,602 ,3 ,605 ,1029 ,0,3,1,3,0,1,0,76.14,58.79,33.33
03,008,01,011,0217,362,298 ,3 ,301 ,529 ,0,3,1,3,0,1,0,76.14,56.9,33.33
03,008,01,011,0218,363,560 ,2 ,562 ,990 ,0,3,1,3,0,1,0,76.14,56.77,33.33
03,008,01,011,0219,364,769 ,5 ,774 ,1391 ,0,3,1,3,0,1,0,76.14,55.64,33.33
03,008,01,011,0220,365,667 ,5 ,672 ,1061 ,0,3,1,3,0,1,0,76.14,63.34,33.33
03,008,01,011,0221,366,797 ,4 ,801 ,1367 ,0,3,1,3,0,1,0,76.14,58.6,33.33
03,008,01,011,0222,367,518 ,7 ,525 ,1041 ,0,3,1,3,0,1,0,76.14,50.43,33.33
03,008,01,011,0223,368,582 ,4 ,586 ,1151 ,0,3,1,3,0,1,0,76.14,50.91,33.33
03,008,01,011,0224,369,182 ,2 ,184 ,370 ,0,3,1,3,0,1,0,76.14,49.73,33.33
03,008,01,011,0225,370,209 ,2 ,211 ,365 ,0,3,1,3,0,1,0,76.14,57.81,33.33
03,008,01,011,0226,371,592 ,3 ,595 ,1161 ,0,3,1,3,0,1,0,76.14,51.25,33.33
03,008,01,011,0227,372,189 ,4 ,193 ,347 ,0,3,1,3,0,1,0,76.14,55.62,33.33
03,008,01,011,0228,373,213 ,2 ,215 ,361 ,0,3,1,3,0,1,0,76.14,59.56,33.33
03,008,01,011,0229,374,517 ,1 ,518 ,914 ,0,3,1,3,0,1,0,76.14,56.67,33.33
03,008,01,011,0230,375,307 ,3 ,310 ,541 ,0,3,1,3,0,1,0,76.14,57.3,33.33
03,008,01,011,0231,376,367 ,3 ,370 ,690 ,0,3,1,3,0,1,0,76.14,53.62,33.33
03,008,01,012,0232,377,8 ,0 ,8 ,16 ,0,3,1,3,0,1,0,76.14,50,33.33
03,008,01,012,0233,378,40 ,0 ,40 ,76 ,0,3,1,3,0,1,0,76.14,52.63,33.33
03,008,01,012,0234,379,13 ,0 ,13 ,33 ,0,3,1,3,0,1,0,76.14,39.39,33.33
03,008,01,012,0235,380,20 ,0 ,20 ,58 ,0,3,1,3,0,1,0,76.14,34.48,33.33
03,008,01,012,0235,381,69 ,0 ,69 ,164 ,0,3,1,3,0,1,0,76.14,42.07,33.33
03,008,01,012,0236,382,435 ,5 ,440 ,725 ,0,3,1,3,0,1,0,76.14,60.69,33.33
03,008,01,012,0236,383,206 ,1 ,207 ,375 ,0,3,1,3,0,1,0,76.14,55.2,33.33
03,008,01,012,0237,384,196 ,2 ,198 ,337 ,0,3,1,3,0,1,0,76.14,58.75,33.33
03,008,01,012,0237,385,256 ,3 ,259 ,408 ,0,3,1,3,0,1,0,76.14,63.48,33.33
03,008,01,012,0238,386,311 ,7 ,318 ,530 ,0,3,1,3,0,1,0,76.14,60,33.33
03,008,01,012,0239,387,181 ,2 ,183 ,327 ,0,3,1,3,0,1,0,76.14,55.96,33.33
03,008,01,012,0240,388,32 ,0 ,32 ,63 ,0,3,1,3,0,1,0,76.14,50.79,33.33
03,008,01,012,0241,389,109 ,0 ,109 ,230 ,0,3,1,3,0,1,0,76.14,47.39,33.33
03,008,01,012,0242,390,13 ,0 ,13 ,33 ,0,3,1,3,0,1,0,76.14,39.39,33.33
03,008,01,012,0242,391,138 ,1 ,139 ,267 ,0,3,1,3,0,1,0,76.14,52.06,33.33
03,008,01,012,0243,392,568 ,3 ,571 ,924 ,0,3,1,3,0,1,0,76.14,61.8,33.33
03,008,01,012,0243,393,207 ,1 ,208 ,441 ,0,3,1,3,0,1,0,76.14,47.17,33.33
03,008,01,012,0244,394,233 ,5 ,238 ,470 ,0,3,1,3,0,1,0,76.14,50.64,33.33
03,008,01,012,0244,395,147 ,0 ,147 ,264 ,0,3,1,3,0,1,0,76.14,55.68,33.33
03,008,01,012,0245,396,155 ,2 ,157 ,285 ,0,3,1,3,0,1,0,76.14,55.09,33.33
03,008,01,013,0246,397,117 ,0 ,117 ,233 ,0,3,1,3,0,1,0,76.14,50.21,33.33
03,008,01,013,0246,398,162 ,1 ,163 ,308 ,0,3,1,3,0,1,0,76.14,52.92,33.33
03,008,01,013,0247,399,247 ,0 ,247 ,516 ,0,3,1,3,0,1,0,76.14,47.87,33.33
03,008,01,013,0247,400,216 ,2 ,218 ,362 ,0,3,1,3,0,1,0,76.14,60.22,33.33
03,008,01,013,0247,401,127 ,1 ,128 ,229 ,0,3,1,3,0,1,0,76.14,55.9,33.33
03,008,01,013,0248,402,46 ,0 ,46 ,76 ,0,3,1,3,0,1,0,76.14,60.53,33.33
03,008,01,013,0249,403,34 ,0 ,34 ,66 ,0,3,1,3,0,1,0,76.14,51.52,33.33
03,008,01,013,0250,404,72 ,0 ,72 ,147 ,0,3,1,3,0,1,0,76.14,48.98,33.33
03,008,01,013,0250,405,4 ,0 ,4 ,19 ,0,3,1,3,0,1,0,76.14,21.05,33.33
03,008,01,013,0251,406,10 ,0 ,10 ,26 ,0,3,1,3,0,1,0,76.14,38.46,33.33
03,008,01,013,0252,407,9 ,1 ,10 ,22 ,0,3,1,3,0,1,0,76.14,45.45,33.33
03,008,01,013,0252,408,7 ,0 ,7 ,10 ,0,3,1,3,0,1,0,76.14,70,33.33
03,008,01,013,0252,409,10 ,0 ,10 ,27 ,0,3,1,3,0,1,0,76.14,37.04,33.33
03,008,01,013,0253,410,7 ,0 ,7 ,13 ,0,3,1,3,0,1,0,76.14,53.85,33.33
03,008,01,013,0254,411,18 ,0 ,18 ,35 ,0,3,1,3,0,1,0,76.14,51.43,33.33
03,008,01,013,0254,412,55 ,2 ,57 ,216 ,0,3,1,3,0,1,0,76.14,26.39,33.33
03,008,01,013,0255,413,11 ,0 ,11 ,34 ,0,3,1,3,0,1,0,76.14,32.35,33.33
03,008,01,013,0255,414,4 ,0 ,4 ,13 ,0,3,1,3,0,1,0,76.14,30.77,33.33
03,008,01,013,0255,415,15 ,0 ,15 ,43 ,0,3,1,3,0,1,0,76.14,34.88,33.33
03,008,01,013,0256,416,19 ,0 ,19 ,50 ,0,3,1,3,0,1,0,76.14,38,33.33
03,008,01,013,0257,417,10 ,0 ,10 ,29 ,0,3,1,3,0,1,0,76.14,34.48,33.33
03,008,01,013,0258,418,34 ,0 ,34 ,85 ,0,3,1,3,0,1,0,76.14,40,33.33
03,008,01,013,0259,419,26 ,0 ,26 ,88 ,0,3,1,3,0,1,0,76.14,29.55,33.33
03,008,01,013,0259,420,17 ,0 ,17 ,33 ,0,3,1,3,0,1,0,76.14,51.52,33.33
03,008,01,013,0260,421,20 ,1 ,21 ,47 ,0,3,1,3,0,1,0,76.14,44.68,33.33
03,009,01,001,0001,1,524 ,0 ,524 ,761 ,0,3,1,3,0,1,0,76.14,68.86 ,33.33
03,009,01,001,0002,2,485 ,5 ,490 ,695 ,0,3,1,3,0,1,0,76.14,70.50 ,33.33
03,009,01,001,0003,3,522 ,3 ,525 ,753 ,0,3,1,3,0,1,0,76.14,69.72 ,33.33
03,009,01,001,0004,4,666 ,8 ,674 ,914 ,0,3,1,3,0,1,0,76.14,73.74 ,33.33
03,009,01,001,0005,5,588 ,5 ,593 ,908 ,0,3,1,3,0,1,0,76.14,65.31 ,33.33
03,009,01,001,0006,6,813 ,7 ,820 ,1245 ,0,3,1,3,0,1,0,76.14,65.86 ,33.33
03,009,01,001,0006,7,1031 ,13 ,1044 ,1696 ,0,3,1,3,0,1,0,76.14,61.56 ,33.33
03,009,01,001,0007,8,736 ,4 ,740 ,1173 ,0,3,1,3,0,1,0,76.14,63.09 ,33.33
03,009,01,001,0007,9,737 ,7 ,744 ,1148 ,0,3,1,3,0,1,0,76.14,64.81 ,33.33
03,009,01,001,0007,10,882 ,14 ,896 ,1331 ,0,3,1,3,0,1,0,76.14,67.32 ,33.33
03,009,01,001,0008,11,911 ,7 ,918 ,1438 ,0,3,1,3,0,1,0,76.14,63.84 ,33.33
03,009,01,001,0008,12,1096 ,14 ,1110 ,1645 ,0,3,1,3,0,1,0,76.14,67.48 ,33.33
03,009,01,001,0009,13,658 ,7 ,665 ,1130 ,0,3,1,3,0,1,0,76.14,58.85 ,33.33
03,009,01,001,0009,14,775 ,12 ,787 ,1251 ,0,3,1,3,0,1,0,76.14,62.91 ,33.33
03,009,01,001,0010,15,775 ,8 ,783 ,1124 ,0,3,1,3,0,1,0,76.14,69.66 ,33.33
03,009,01,001,0010,16,782 ,19 ,801 ,1234 ,0,3,1,3,0,1,0,76.14,64.91 ,33.33
03,009,01,001,0011,17,591 ,5 ,596 ,919 ,0,3,1,3,0,1,0,76.14,64.85 ,33.33
03,009,01,001,0011,18,541 ,3 ,544 ,898 ,0,3,1,3,0,1,0,76.14,60.58 ,33.33
03,009,01,001,0012,19,516 ,9 ,525 ,784 ,0,3,1,3,0,1,0,76.14,66.96 ,33.33
03,009,01,001,0012,20,454 ,6 ,460 ,659 ,0,3,1,3,0,1,0,76.14,69.80 ,33.33
03,009,01,001,0013,21,713 ,5 ,718 ,1125 ,0,3,1,3,0,1,0,76.14,63.82 ,33.33
03,009,01,001,0014,22,942 ,7 ,949 ,1408 ,0,3,1,3,0,1,0,76.14,67.40 ,33.33
03,009,01,001,0014,23,814 ,6 ,820 ,1301 ,0,3,1,3,0,1,0,76.14,63.03 ,33.33
03,009,01,001,0015,24,710 ,9 ,719 ,1163 ,0,3,1,3,0,1,0,76.14,61.82 ,33.33
03,009,01,001,0015,25,830 ,11 ,841 ,1188 ,0,3,1,3,0,1,0,76.14,70.79 ,33.33
03,009,01,001,0016,26,617 ,7 ,624 ,898 ,0,3,1,3,0,1,0,76.14,69.49 ,33.33
03,009,01,001,0016,27,661 ,10 ,671 ,1128 ,0,3,1,3,0,1,0,76.14,59.49 ,33.33
03,009,01,001,0017,28,996 ,12 ,1008 ,1505 ,0,3,1,3,0,1,0,76.14,66.98 ,33.33
03,009,01,001,0017,29,648 ,6 ,654 ,1139 ,0,3,1,3,0,1,0,76.14,57.42 ,33.33
03,009,01,001,0017,30,600 ,6 ,606 ,902 ,0,3,1,3,0,1,0,76.14,67.18 ,33.33
03,009,01,001,0018,31,638 ,8 ,646 ,977 ,0,3,1,3,0,1,0,76.14,66.12 ,33.33
03,009,01,001,0018,32,703 ,5 ,708 ,1052 ,0,3,1,3,0,1,0,76.14,67.30 ,33.33
03,009,01,001,0019,33,747 ,4 ,751 ,1121 ,0,3,1,3,0,1,0,76.14,66.99 ,33.33
03,009,01,001,0019,34,693 ,2 ,695 ,1102 ,0,3,1,3,0,1,0,76.14,63.07 ,33.33
03,009,01,001,0019,35,626 ,2 ,628 ,1027 ,0,3,1,3,0,1,0,76.14,61.15 ,33.33
03,009,01,001,0020,36,623 ,3 ,626 ,924 ,0,3,1,3,0,1,0,76.14,67.75 ,33.33
03,009,01,001,0020,37,781 ,6 ,787 ,1196 ,0,3,1,3,0,1,0,76.14,65.80 ,33.33
03,009,01,001,0021,38,804 ,8 ,812 ,1169 ,0,3,1,3,0,1,0,76.14,69.46 ,33.33
03,009,01,001,0022,39,507 ,22 ,529 ,752 ,0,3,1,3,0,1,0,76.14,70.35 ,33.33
03,009,01,001,0023,40,741 ,8 ,749 ,1111 ,0,3,1,3,0,1,0,76.14,67.42 ,33.33
03,009,01,001,0023,41,429 ,4 ,433 ,669 ,0,3,1,3,0,1,0,76.14,64.72 ,33.33
03,009,01,001,0024,42,416 ,4 ,420 ,598 ,0,3,1,3,0,1,0,76.14,70.23 ,33.33
03,009,01,001,0025,43,991 ,19 ,1010 ,1622 ,0,3,1,3,0,1,0,76.14,62.27 ,33.33
03,009,01,001,0026,44,397 ,5 ,402 ,565 ,0,3,1,3,0,1,0,76.14,71.15 ,33.33
03,009,01,001,0027,45,842 ,5 ,847 ,1209 ,0,3,1,3,0,1,0,76.14,70.06 ,33.33
03,009,01,001,0027,46,442 ,6 ,448 ,703 ,0,3,1,3,0,1,0,76.14,63.73 ,33.33
03,009,01,001,0028,47,902 ,6 ,908 ,1291 ,0,3,1,3,0,1,0,76.14,70.33 ,33.33
03,009,01,001,0028,48,1017 ,10 ,1027 ,1603 ,0,3,1,3,0,1,0,76.14,64.07 ,33.33
03,009,01,001,0028,49,1095 ,11 ,1106 ,1585 ,0,3,1,3,0,1,0,76.14,69.78 ,33.33
03,009,01,001,0029,50,1143 ,6 ,1149 ,1717 ,0,3,1,3,0,1,0,76.14,66.92 ,33.33
03,009,01,001,0029,51,950 ,6 ,956 ,1429 ,0,3,1,3,0,1,0,76.14,66.90 ,33.33
03,009,01,001,0030,52,1065 ,6 ,1071 ,1565 ,0,3,1,3,0,1,0,76.14,68.43 ,33.33
03,009,01,001,0031,53,811 ,12 ,823 ,1204 ,0,3,1,3,0,1,0,76.14,68.36 ,33.33
03,009,01,001,0031,54,769 ,9 ,778 ,1220 ,0,3,1,3,0,1,0,76.14,63.77 ,33.33
03,009,01,001,0031,55,865 ,9 ,874 ,1382 ,0,3,1,3,0,1,0,76.14,63.24 ,33.33
03,009,01,001,0032,56,626 ,6 ,632 ,944 ,0,3,1,3,0,1,0,76.14,66.95 ,33.33
03,009,01,001,0033,57,770 ,11 ,781 ,1239 ,0,3,1,3,0,1,0,76.14,63.03 ,33.33
03,009,01,001,0034,58,538 ,7 ,545 ,736 ,0,3,1,3,0,1,0,76.14,74.05 ,33.33
03,009,01,001,0034,59,670 ,4 ,674 ,972 ,0,3,1,3,0,1,0,76.14,69.34 ,33.33
03,009,01,001,0035,60,883 ,14 ,897 ,1258 ,0,3,1,3,0,1,0,76.14,71.30 ,33.33
03,009,01,001,0036,61,693 ,11 ,704 ,1052 ,0,3,1,3,0,1,0,76.14,66.92 ,33.33
03,009,01,001,0036,62,932 ,6 ,938 ,1514 ,0,3,1,3,0,1,0,76.14,61.96 ,33.33
03,009,01,001,0037,63,660 ,7 ,667 ,984 ,0,3,1,3,0,1,0,76.14,67.78 ,33.33
03,009,01,001,0037,64,983 ,11 ,994 ,1487 ,0,3,1,3,0,1,0,76.14,66.85 ,33.33
03,009,01,001,0038,65,801 ,4 ,805 ,1131 ,0,3,1,3,0,1,0,76.14,71.18 ,33.33
03,009,01,002,0039,66,726 ,8 ,734 ,1131 ,0,3,1,3,0,1,0,76.14,64.90 ,33.33
03,009,01,002,0040,67,1004 ,8 ,1012 ,1586 ,0,3,1,3,0,1,0,76.14,63.81 ,33.33
03,009,01,002,0040,68,962 ,5 ,967 ,1532 ,0,3,1,3,0,1,0,76.14,63.12 ,33.33
03,009,01,002,0040,69,869 ,2 ,871 ,1442 ,0,3,1,3,0,1,0,76.14,60.40 ,33.33
03,009,01,002,0041,70,616 ,1 ,617 ,1105 ,0,3,1,3,0,1,0,76.14,55.84 ,33.33
03,009,01,002,0041,71,604 ,2 ,606 ,915 ,0,3,1,3,0,1,0,76.14,66.23 ,33.33
03,009,01,002,0042,72,846 ,6 ,852 ,1315 ,0,3,1,3,0,1,0,76.14,64.79 ,33.33
03,009,01,002,0043,73,814 ,4 ,818 ,1249 ,0,3,1,3,0,1,0,76.14,65.49 ,33.33
03,009,01,002,0044,74,826 ,1 ,827 ,1258 ,0,3,1,3,0,1,0,76.14,65.74 ,33.33
03,009,01,002,0045,75,618 ,2 ,620 ,871 ,0,3,1,3,0,1,0,76.14,71.18 ,33.33
03,009,01,002,0046,76,604 ,5 ,609 ,924 ,0,3,1,3,0,1,0,76.14,65.91 ,33.33
03,009,01,002,0047,77,665 ,5 ,670 ,911 ,0,3,1,3,0,1,0,76.14,73.55 ,33.33
03,009,01,002,0048,78,480 ,6 ,486 ,736 ,0,3,1,3,0,1,0,76.14,66.03 ,33.33
03,009,01,002,0049,79,878 ,9 ,887 ,1175 ,0,3,1,3,0,1,0,76.14,75.49 ,33.33
03,009,01,002,0050,80,963 ,9 ,972 ,1472 ,0,3,1,3,0,1,0,76.14,66.03 ,33.33
03,009,01,002,0051,81,819 ,12 ,831 ,1374 ,0,3,1,3,0,1,0,76.14,60.48 ,33.33
03,009,01,002,0051,82,380 ,5 ,385 ,636 ,0,3,1,3,0,1,0,76.14,60.53 ,33.33
03,009,01,002,0052,83,932 ,9 ,941 ,1428 ,0,3,1,3,0,1,0,76.14,65.90 ,33.33
03,009,01,002,0052,84,906 ,6 ,912 ,1398 ,0,3,1,3,0,1,0,76.14,65.24 ,33.33
03,009,01,002,0052,85,950 ,7 ,957 ,1533 ,0,3,1,3,0,1,0,76.14,62.43 ,33.33
03,009,01,002,0053,86,611 ,10 ,621 ,913 ,0,3,1,3,0,1,0,76.14,68.02 ,33.33
03,009,01,002,0054,87,575 ,4 ,579 ,828 ,0,3,1,3,0,1,0,76.14,69.93 ,33.33
03,009,01,002,0055,88,672 ,3 ,675 ,940 ,0,3,1,3,0,1,0,76.14,71.81 ,33.33
03,009,01,002,0056,89,549 ,4 ,553 ,841 ,0,3,1,3,0,1,0,76.14,65.76 ,33.33
03,009,01,002,0056,90,481 ,8 ,489 ,744 ,0,3,1,3,0,1,0,76.14,65.73 ,33.33
03,009,01,002,0057,91,643 ,13 ,656 ,968 ,0,3,1,3,0,1,0,76.14,67.77 ,33.33
03,009,01,002,0058,92,732 ,4 ,736 ,1050 ,0,3,1,3,0,1,0,76.14,70.10 ,33.33
03,009,01,002,0058,93,899 ,7 ,906 ,1398 ,0,3,1,3,0,1,0,76.14,64.81 ,33.33
03,009,01,002,0059,94,742 ,7 ,749 ,1040 ,0,3,1,3,0,1,0,76.14,72.02 ,33.33
03,009,01,002,0059,95,682 ,9 ,691 ,1022 ,0,3,1,3,0,1,0,76.14,67.61 ,33.33
03,009,01,002,0060,96,1020 ,8 ,1028 ,1578 ,0,3,1,3,0,1,0,76.14,65.15 ,33.33
03,009,01,003,0061,97,708 ,9 ,717 ,1121 ,0,3,1,3,0,1,0,76.14,63.96 ,33.33
03,009,01,003,0061,98,715 ,7 ,722 ,1182 ,0,3,1,3,0,1,0,76.14,61.08 ,33.33
03,009,01,003,0062,99,432 ,2 ,434 ,684 ,0,3,1,3,0,1,0,76.14,63.45 ,33.33
03,009,01,003,0062,100,634 ,3 ,637 ,1011 ,0,3,1,3,0,1,0,76.14,63.01 ,33.33
03,009,01,003,0063,101,782 ,7 ,789 ,1209 ,0,3,1,3,0,1,0,76.14,65.26 ,33.33
03,009,01,003,0063,102,900 ,8 ,908 ,1443 ,0,3,1,3,0,1,0,76.14,62.92 ,33.33
03,009,01,003,0064,103,601 ,2 ,603 ,1017 ,0,3,1,3,0,1,0,76.14,59.29 ,33.33
03,009,01,003,0064,104,776 ,7 ,783 ,1393 ,0,3,1,3,0,1,0,76.14,56.21 ,33.33
03,009,01,003,0065,105,657 ,5 ,662 ,1045 ,0,3,1,3,0,1,0,76.14,63.35 ,33.33
03,009,01,003,0066,106,869 ,5 ,874 ,1428 ,0,3,1,3,0,1,0,76.14,61.20 ,33.33
03,009,01,003,0066,107,932 ,11 ,943 ,1540 ,0,3,1,3,0,1,0,76.14,61.23 ,33.33
03,009,01,003,0067,108,720 ,5 ,725 ,1157 ,0,3,1,3,0,1,0,76.14,62.66 ,33.33
03,009,01,003,0067,109,771 ,9 ,780 ,1243 ,0,3,1,3,0,1,0,76.14,62.75 ,33.33
03,009,01,003,0067,110,635 ,1 ,636 ,1102 ,0,3,1,3,0,1,0,76.14,57.71 ,33.33
03,009,01,003,0068,111,875 ,13 ,888 ,1349 ,0,3,1,3,0,1,0,76.14,65.83 ,33.33
03,009,01,003,0069,112,995 ,7 ,1002 ,1632 ,0,3,1,3,0,1,0,76.14,61.40 ,33.33
03,009,01,003,0070,113,559 ,4 ,563 ,960 ,0,3,1,3,0,1,0,76.14,58.65 ,33.33
03,009,01,003,0070,114,526 ,10 ,536 ,822 ,0,3,1,3,0,1,0,76.14,65.21 ,33.33
03,009,01,003,0071,115,926 ,12 ,938 ,1534 ,0,3,1,3,0,1,0,76.14,61.15 ,33.33
03,009,01,003,0071,116,615 ,11 ,626 ,1092 ,0,3,1,3,0,1,0,76.14,57.33 ,33.33
03,009,01,003,0072,117,1055 ,9 ,1064 ,1663 ,0,3,1,3,0,1,0,76.14,63.98 ,33.33
03,009,01,003,0073,118,604 ,10 ,614 ,942 ,0,3,1,3,0,1,0,76.14,65.18 ,33.33
03,009,01,003,0074,119,365 ,2 ,367 ,631 ,0,3,1,3,0,1,0,76.14,58.16 ,33.33
03,009,01,003,0075,120,799 ,7 ,806 ,1259 ,0,3,1,3,0,1,0,76.14,64.02 ,33.33
03,009,01,003,0075,121,698 ,8 ,706 ,1092 ,0,3,1,3,0,1,0,76.14,64.65 ,33.33
03,009,01,003,0076,122,552 ,9 ,561 ,789 ,0,3,1,3,0,1,0,76.14,71.10 ,33.33
03,009,01,003,0077,123,479 ,10 ,489 ,823 ,0,3,1,3,0,1,0,76.14,59.42 ,33.33
03,009,01,003,0077,124,594 ,11 ,605 ,904 ,0,3,1,3,0,1,0,76.14,66.92 ,33.33
03,009,01,003,0078,125,1058 ,6 ,1064 ,1575 ,0,3,1,3,0,1,0,76.14,67.56 ,33.33
03,009,01,003,0079,126,939 ,14 ,953 ,1433 ,0,3,1,3,0,1,0,76.14,66.50 ,33.33
03,009,01,003,0079,127,870 ,9 ,879 ,1405 ,0,3,1,3,0,1,0,76.14,62.56 ,33.33
03,009,01,003,0080,128,759 ,16 ,775 ,1222 ,0,3,1,3,0,1,0,76.14,63.42 ,33.33
03,009,01,003,0080,129,656 ,8 ,664 ,1049 ,0,3,1,3,0,1,0,76.14,63.30 ,33.33
03,009,01,003,0081,130,874 ,8 ,882 ,1214 ,0,3,1,3,0,1,0,76.14,72.65 ,33.33
03,009,01,003,0081,131,760 ,9 ,769 ,1253 ,0,3,1,3,0,1,0,76.14,61.37 ,33.33
03,009,01,003,0082,132,839 ,7 ,846 ,1307 ,0,3,1,3,0,1,0,76.14,64.73 ,33.33
03,009,01,003,0083,133,967 ,5 ,972 ,1319 ,0,3,1,3,0,1,0,76.14,73.69 ,33.33
03,009,01,003,0084,134,724 ,4 ,728 ,1181 ,0,3,1,3,0,1,0,76.14,61.64 ,33.33
03,009,01,003,0085,135,973 ,15 ,988 ,1497 ,0,3,1,3,0,1,0,76.14,66.00 ,33.33
03,009,01,003,0086,136,521 ,9 ,530 ,870 ,0,3,1,3,0,1,0,76.14,60.92 ,33.33
03,009,01,003,0087,137,588 ,6 ,594 ,976 ,0,3,1,3,0,1,0,76.14,60.86 ,33.33
03,009,01,003,0088,138,532 ,9 ,541 ,773 ,0,3,1,3,0,1,0,76.14,69.99 ,33.33
03,009,01,003,0089,139,688 ,3 ,691 ,1041 ,0,3,1,3,0,1,0,76.14,66.38 ,33.33
03,009,01,004,0090,140,1075 ,6 ,1081 ,1603 ,0,3,1,3,0,1,0,76.14,67.44 ,33.33
03,009,01,004,0091,141,1002 ,10 ,1012 ,1509 ,0,3,1,3,0,1,0,76.14,67.06 ,33.33
03,009,01,004,0092,142,1088 ,5 ,1093 ,1672 ,0,3,1,3,0,1,0,76.14,65.37 ,33.33
03,009,01,004,0093,143,852 ,4 ,856 ,1287 ,0,3,1,3,0,1,0,76.14,66.51 ,33.33
03,009,01,004,0093,144,946 ,8 ,954 ,1609 ,0,3,1,3,0,1,0,76.14,59.29 ,33.33
03,009,01,004,0094,145,294 ,3 ,297 ,441 ,0,3,1,3,0,1,0,76.14,67.35 ,33.33
03,009,01,004,0095,146,463 ,7 ,470 ,684 ,0,3,1,3,0,1,0,76.14,68.71 ,33.33
03,009,01,004,0096,147,409 ,1 ,410 ,632 ,0,3,1,3,0,1,0,76.14,64.87 ,33.33
03,009,01,004,0097,148,635 ,5 ,640 ,994 ,0,3,1,3,0,1,0,76.14,64.39 ,33.33
03,009,01,004,0098,149,656 ,5 ,661 ,1068 ,0,3,1,3,0,1,0,76.14,61.89 ,33.33
03,009,01,004,0098,150,792 ,6 ,798 ,1206 ,0,3,1,3,0,1,0,76.14,66.17 ,33.33
03,009,01,004,0099,151,791 ,11 ,802 ,1297 ,0,3,1,3,0,1,0,76.14,61.84 ,33.33
03,009,01,004,0099,152,618 ,5 ,623 ,994 ,0,3,1,3,0,1,0,76.14,62.68 ,33.33
03,009,01,004,0099,153,724 ,8 ,732 ,1186 ,0,3,1,3,0,1,0,76.14,61.72 ,33.33
03,009,01,004,0100,154,870 ,5 ,875 ,1294 ,0,3,1,3,0,1,0,76.14,67.62 ,33.33
03,009,01,004,0101,155,1003 ,15 ,1018 ,1501 ,0,3,1,3,0,1,0,76.14,67.82 ,33.33
03,009,01,004,0102,156,633 ,5 ,638 ,917 ,0,3,1,3,0,1,0,76.14,69.57 ,33.33
03,009,01,004,0102,157,573 ,7 ,580 ,818 ,0,3,1,3,0,1,0,76.14,70.90 ,33.33
03,009,01,004,0103,158,601 ,6 ,607 ,891 ,0,3,1,3,0,1,0,76.14,68.13 ,33.33
03,009,01,004,0104,159,698 ,9 ,707 ,1105 ,0,3,1,3,0,1,0,76.14,63.98 ,33.33
03,009,01,004,0105,160,1003 ,10 ,1013 ,1499 ,0,3,1,3,0,1,0,76.14,67.58 ,33.33
03,009,01,004,0106,161,628 ,6 ,634 ,859 ,0,3,1,3,0,1,0,76.14,73.81 ,33.33
03,009,01,004,0107,162,709 ,9 ,718 ,974 ,0,3,1,3,0,1,0,76.14,73.72 ,33.33
03,009,01,004,0108,163,872 ,9 ,881 ,1360 ,0,3,1,3,0,1,0,76.14,64.78 ,33.33
03,009,01,004,0109,164,544 ,4 ,548 ,760 ,0,3,1,3,0,1,0,76.14,72.11 ,33.33
03,009,01,004,0110,165,584 ,1 ,585 ,813 ,0,3,1,3,0,1,0,76.14,71.96 ,33.33
03,009,01,004,0111,166,652 ,10 ,662 ,965 ,0,3,1,3,0,1,0,76.14,68.60 ,33.33
03,009,01,004,0112,167,863 ,13 ,876 ,1371 ,0,3,1,3,0,1,0,76.14,63.89 ,33.33
03,009,01,004,0113,168,634 ,5 ,639 ,970 ,0,3,1,3,0,1,0,76.14,65.88 ,33.33
03,009,01,004,0114,169,573 ,6 ,579 ,916 ,0,3,1,3,0,1,0,76.14,63.21 ,33.33
03,009,01,004,0115,170,583 ,8 ,591 ,929 ,0,3,1,3,0,1,0,76.14,63.62 ,33.33
03,009,01,004,0115,171,533 ,5 ,538 ,861 ,0,3,1,3,0,1,0,76.14,62.49 ,33.33
03,009,01,004,0116,172,965 ,15 ,980 ,1438 ,0,3,1,3,0,1,0,76.14,68.15 ,33.33
03,009,01,005,0117,173,624 ,5 ,629 ,917 ,0,3,1,3,0,1,0,76.14,68.59 ,33.33
03,009,01,005,0118,174,711 ,12 ,723 ,1018 ,0,3,1,3,0,1,0,76.14,71.02 ,33.33
03,009,01,005,0119,175,922 ,11 ,933 ,1390 ,0,3,1,3,0,1,0,76.14,67.12 ,33.33
03,009,01,005,0120,176,649 ,8 ,657 ,922 ,0,3,1,3,0,1,0,76.14,71.26 ,33.33
03,009,01,005,0121,177,489 ,8 ,497 ,707 ,0,3,1,3,0,1,0,76.14,70.30 ,33.33
03,009,01,005,0121,178,308 ,6 ,314 ,448 ,0,3,1,3,0,1,0,76.14,70.09 ,33.33
03,009,01,005,0122,179,1071 ,14 ,1085 ,1659 ,0,3,1,3,0,1,0,76.14,65.40 ,33.33
03,009,01,005,0123,180,384 ,2 ,386 ,620 ,0,3,1,3,0,1,0,76.14,62.26 ,33.33
03,009,01,005,0123,181,459 ,5 ,464 ,714 ,0,3,1,3,0,1,0,76.14,64.99 ,33.33
03,009,01,005,0124,182,459 ,4 ,463 ,822 ,0,3,1,3,0,1,0,76.14,56.33 ,33.33
03,009,01,005,0124,183,397 ,6 ,403 ,592 ,0,3,1,3,0,1,0,76.14,68.07 ,33.33
03,009,01,005,0125,184,534 ,8 ,542 ,880 ,0,3,1,3,0,1,0,76.14,61.59 ,33.33
03,009,01,005,0125,185,403 ,5 ,408 ,559 ,0,3,1,3,0,1,0,76.14,72.99 ,33.33
03,009,01,005,0126,186,790 ,5 ,795 ,1333 ,0,3,1,3,0,1,0,76.14,59.64 ,33.33
03,009,01,005,0126,187,645 ,4 ,649 ,1019 ,0,3,1,3,0,1,0,76.14,63.69 ,33.33
03,009,01,005,0127,188,545 ,4 ,549 ,813 ,0,3,1,3,0,1,0,76.14,67.53 ,33.33
03,009,01,005,0127,189,416 ,8 ,424 ,712 ,0,3,1,3,0,1,0,76.14,59.55 ,33.33
03,009,01,005,0128,190,578 ,13 ,591 ,883 ,0,3,1,3,0,1,0,76.14,66.93 ,33.33
03,009,01,005,0129,191,629 ,8 ,637 ,1043 ,0,3,1,3,0,1,0,76.14,61.07 ,33.33
03,009,01,005,0129,192,500 ,1 ,501 ,839 ,0,3,1,3,0,1,0,76.14,59.71 ,33.33
03,009,01,005,0130,193,604 ,2 ,606 ,965 ,0,3,1,3,0,1,0,76.14,62.80 ,33.33
03,009,01,005,0130,194,533 ,6 ,539 ,856 ,0,3,1,3,0,1,0,76.14,62.97 ,33.33
03,009,01,005,0131,195,602 ,2 ,604 ,923 ,0,3,1,3,0,1,0,76.14,65.44 ,33.33
03,009,01,005,0131,196,529 ,4 ,533 ,865 ,0,3,1,3,0,1,0,76.14,61.62 ,33.33
03,009,01,005,0132,197,626 ,3 ,629 ,993 ,0,3,1,3,0,1,0,76.14,63.34 ,33.33
03,009,01,005,0133,198,898 ,9 ,907 ,1475 ,0,3,1,3,0,1,0,76.14,61.49 ,33.33
03,009,01,006,0134,199,545 ,7 ,552 ,789 ,0,3,1,3,0,1,0,76.14,69.96 ,33.33
03,009,01,006,0135,200,510 ,3 ,513 ,749 ,0,3,1,3,0,1,0,76.14,68.49 ,33.33
03,009,01,006,0136,201,337 ,4 ,341 ,512 ,0,3,1,3,0,1,0,76.14,66.60 ,33.33
03,009,01,006,0137,202,702 ,6 ,708 ,998 ,0,3,1,3,0,1,0,76.14,70.94 ,33.33
03,009,01,006,0138,203,267 ,4 ,271 ,430 ,0,3,1,3,0,1,0,76.14,63.02 ,33.33
03,009,01,006,0139,204,305 ,3 ,308 ,452 ,0,3,1,3,0,1,0,76.14,68.14 ,33.33
03,009,01,006,0140,205,292 ,1 ,293 ,417 ,0,3,1,3,0,1,0,76.14,70.26 ,33.33
03,009,01,006,0141,206,616 ,6 ,622 ,949 ,0,3,1,3,0,1,0,76.14,65.54 ,33.33
03,009,01,006,0142,207,374 ,0 ,374 ,551 ,0,3,1,3,0,1,0,76.14,67.88 ,33.33
03,009,01,006,0143,208,247 ,0 ,247 ,382 ,0,3,1,3,0,1,0,76.14,64.66 ,33.33
03,009,01,006,0144,209,421 ,6 ,427 ,669 ,0,3,1,3,0,1,0,76.14,63.83 ,33.33
03,009,01,006,0145,210,347 ,2 ,349 ,545 ,0,3,1,3,0,1,0,76.14,64.04 ,33.33
03,009,01,006,0145,211,491 ,8 ,499 ,811 ,0,3,1,3,0,1,0,76.14,61.53 ,33.33
03,009,01,006,0146,212,341 ,3 ,344 ,528 ,0,3,1,3,0,1,0,76.14,65.15 ,33.33
03,009,01,006,0147,213,738 ,6 ,744 ,1182 ,0,3,1,3,0,1,0,76.14,62.94 ,33.33
03,009,01,006,0147,214,778 ,14 ,792 ,1249 ,0,3,1,3,0,1,0,76.14,63.41 ,33.33
03,009,01,006,0147,215,752 ,12 ,764 ,1177 ,0,3,1,3,0,1,0,76.14,64.91 ,33.33
03,009,01,006,0147,216,781 ,4 ,785 ,1247 ,0,3,1,3,0,1,0,76.14,62.95 ,33.33
03,009,01,006,0148,217,898 ,8 ,906 ,1448 ,0,3,1,3,0,1,0,76.14,62.57 ,33.33
03,009,01,006,0149,218,841 ,13 ,854 ,1345 ,0,3,1,3,0,1,0,76.14,63.49 ,33.33
03,009,01,006,0149,219,718 ,6 ,724 ,1209 ,0,3,1,3,0,1,0,76.14,59.88 ,33.33
03,009,01,006,0149,220,751 ,7 ,758 ,1253 ,0,3,1,3,0,1,0,76.14,60.49 ,33.33
03,009,01,006,0149,221,806 ,4 ,810 ,1291 ,0,3,1,3,0,1,0,76.14,62.74 ,33.33
03,009,01,006,0150,222,746 ,6 ,752 ,1190 ,0,3,1,3,0,1,0,76.14,63.19 ,33.33
03,009,01,006,0151,223,366 ,7 ,373 ,583 ,0,3,1,3,0,1,0,76.14,63.98 ,33.33
03,009,01,006,0151,224,256 ,0 ,256 ,394 ,0,3,1,3,0,1,0,76.14,64.97 ,33.33
03,009,01,006,0152,225,264 ,4 ,268 ,436 ,0,3,1,3,0,1,0,76.14,61.47 ,33.33
03,009,01,006,0153,226,537 ,2 ,539 ,853 ,0,3,1,3,0,1,0,76.14,63.19 ,33.33
03,009,01,006,0154,227,830 ,12 ,842 ,1427 ,0,3,1,3,0,1,0,76.14,59.00 ,33.33
03,009,01,006,0155,228,722 ,5 ,727 ,1213 ,0,3,1,3,0,1,0,76.14,59.93 ,33.33
03,009,01,006,0156,229,550 ,3 ,553 ,1013 ,0,3,1,3,0,1,0,76.14,54.59 ,33.33
03,009,01,006,0157,230,339 ,6 ,345 ,644 ,0,3,1,3,0,1,0,76.14,53.57 ,33.33
03,009,01,006,0158,231,690 ,11 ,701 ,1030 ,0,3,1,3,0,1,0,76.14,68.06 ,33.33
03,009,01,006,0158,232,401 ,3 ,404 ,620 ,0,3,1,3,0,1,0,76.14,65.16 ,33.33
03,009,01,006,0159,233,727 ,4 ,731 ,1203 ,0,3,1,3,0,1,0,76.14,60.76 ,33.33
03,009,01,006,0159,234,942 ,15 ,957 ,1595 ,0,3,1,3,0,1,0,76.14,60.00 ,33.33
03,009,01,006,0160,235,647 ,4 ,651 ,1025 ,0,3,1,3,0,1,0,76.14,63.51 ,33.33
03,009,01,006,0161,236,348 ,0 ,348 ,562 ,0,3,1,3,0,1,0,76.14,61.92 ,33.33
03,009,01,007,0162,237,717 ,8 ,725 ,1136 ,0,3,1,3,0,1,0,76.14,63.82 ,33.33
03,009,01,007,0162,238,659 ,9 ,668 ,953 ,0,3,1,3,0,1,0,76.14,70.09 ,33.33
03,009,01,007,0163,239,963 ,12 ,975 ,1545 ,0,3,1,3,0,1,0,76.14,63.11 ,33.33
03,009,01,007,0164,240,805 ,11 ,816 ,1288 ,0,3,1,3,0,1,0,76.14,63.35 ,33.33
03,009,01,007,0164,241,877 ,14 ,891 ,1557 ,0,3,1,3,0,1,0,76.14,57.23 ,33.33
03,009,01,007,0165,242,714 ,6 ,720 ,1122 ,0,3,1,3,0,1,0,76.14,64.17 ,33.33
03,009,01,007,0165,243,186 ,1 ,187 ,314 ,0,3,1,3,0,1,0,76.14,59.55 ,33.33
03,009,01,007,0166,244,789 ,10 ,799 ,1167 ,0,3,1,3,0,1,0,76.14,68.47 ,33.33
03,009,01,007,0167,245,788 ,10 ,798 ,1212 ,0,3,1,3,0,1,0,76.14,65.84 ,33.33
03,009,01,007,0168,246,644 ,6 ,650 ,979 ,0,3,1,3,0,1,0,76.14,66.39 ,33.33
03,009,01,007,0169,247,617 ,2 ,619 ,933 ,0,3,1,3,0,1,0,76.14,66.35 ,33.33
03,009,01,007,0169,248,662 ,11 ,673 ,1124 ,0,3,1,3,0,1,0,76.14,59.88 ,33.33
03,009,01,007,0170,249,601 ,6 ,607 ,911 ,0,3,1,3,0,1,0,76.14,66.63 ,33.33
03,009,01,007,0170,250,699 ,6 ,705 ,1041 ,0,3,1,3,0,1,0,76.14,67.72 ,33.33
03,009,01,007,0171,251,926 ,5 ,931 ,1399 ,0,3,1,3,0,1,0,76.14,66.55 ,33.33
03,009,01,007,0172,252,504 ,6 ,510 ,688 ,0,3,1,3,0,1,0,76.14,74.13 ,33.33
03,009,01,007,0173,253,544 ,16 ,560 ,988 ,0,3,1,3,0,1,0,76.14,56.68 ,33.33
03,009,01,007,0173,254,567 ,15 ,582 ,936 ,0,3,1,3,0,1,0,76.14,62.18 ,33.33
03,009,01,007,0174,255,629 ,7 ,636 ,1070 ,0,3,1,3,0,1,0,76.14,59.44 ,33.33
03,009,01,007,0174,256,540 ,6 ,546 ,948 ,0,3,1,3,0,1,0,76.14,57.59 ,33.33
03,009,01,007,0175,257,465 ,11 ,476 ,660 ,0,3,1,3,0,1,0,76.14,72.12 ,33.33
03,009,01,007,0176,258,785 ,10 ,795 ,1266 ,0,3,1,3,0,1,0,76.14,62.80 ,33.33
03,009,01,007,0177,259,219 ,2 ,221 ,321 ,0,3,1,3,0,1,0,76.14,68.85 ,33.33
03,009,01,007,0178,260,434 ,9 ,443 ,788 ,0,3,1,3,0,1,0,76.14,56.22 ,33.33
03,009,01,007,0179,261,676 ,3 ,679 ,1167 ,0,3,1,3,0,1,0,76.14,58.18 ,33.33
03,009,01,007,0180,262,328 ,2 ,330 ,537 ,0,3,1,3,0,1,0,76.14,61.45 ,33.33
03,009,01,007,0181,263,456 ,4 ,460 ,675 ,0,3,1,3,0,1,0,76.14,68.15 ,33.33
03,009,01,008,0182,264,521 ,3 ,524 ,785 ,0,3,1,3,0,1,0,76.14,66.75 ,33.33
03,009,01,008,0183,265,978 ,14 ,992 ,1511 ,0,3,1,3,0,1,0,76.14,65.65 ,33.33
03,009,01,008,0183,266,385 ,3 ,388 ,575 ,0,3,1,3,0,1,0,76.14,67.48 ,33.33
03,009,01,008,0184,267,719 ,7 ,726 ,1096 ,0,3,1,3,0,1,0,76.14,66.24 ,33.33
03,009,01,008,0185,268,659 ,4 ,663 ,990 ,0,3,1,3,0,1,0,76.14,66.97 ,33.33
03,009,01,008,0186,269,866 ,10 ,876 ,1400 ,0,3,1,3,0,1,0,76.14,62.57 ,33.33
03,009,01,008,0186,270,318 ,3 ,321 ,482 ,0,3,1,3,0,1,0,76.14,66.60 ,33.33
03,009,01,008,0187,271,842 ,12 ,854 ,1326 ,0,3,1,3,0,1,0,76.14,64.40 ,33.33
03,009,01,008,0187,272,330 ,4 ,334 ,489 ,0,3,1,3,0,1,0,76.14,68.30 ,33.33
03,009,01,008,0188,273,833 ,10 ,843 ,1385 ,0,3,1,3,0,1,0,76.14,60.87 ,33.33
03,009,01,008,0189,274,786 ,5 ,791 ,1254 ,0,3,1,3,0,1,0,76.14,63.08 ,33.33
03,009,01,008,0190,275,495 ,5 ,500 ,804 ,0,3,1,3,0,1,0,76.14,62.19 ,33.33
03,009,01,008,0191,276,429 ,8 ,437 ,684 ,0,3,1,3,0,1,0,76.14,63.89 ,33.33
03,009,01,008,0192,277,777 ,6 ,783 ,1227 ,0,3,1,3,0,1,0,76.14,63.81 ,33.33
03,009,01,008,0193,278,573 ,8 ,581 ,832 ,0,3,1,3,0,1,0,76.14,69.83 ,33.33
03,009,01,008,0194,279,443 ,5 ,448 ,716 ,0,3,1,3,0,1,0,76.14,62.57 ,33.33
03,009,01,008,0195,280,518 ,5 ,523 ,781 ,0,3,1,3,0,1,0,76.14,66.97 ,33.33
03,009,01,008,0196,281,533 ,5 ,538 ,788 ,0,3,1,3,0,1,0,76.14,68.27 ,33.33
03,009,01,009,0197,282,849 ,8 ,857 ,1308 ,0,3,1,3,0,1,0,76.14,65.52 ,33.33
03,009,01,009,0197,283,797 ,9 ,806 ,1163 ,0,3,1,3,0,1,0,76.14,69.30 ,33.33
03,009,01,009,0197,284,678 ,9 ,687 ,1079 ,0,3,1,3,0,1,0,76.14,63.67 ,33.33
03,009,01,009,0198,285,614 ,6 ,620 ,917 ,0,3,1,3,0,1,0,76.14,67.61 ,33.33
03,009,01,009,0199,286,995 ,9 ,1004 ,1619 ,0,3,1,3,0,1,0,76.14,62.01 ,33.33
03,009,01,009,0200,287,374 ,3 ,377 ,582 ,0,3,1,3,0,1,0,76.14,64.78 ,33.33
03,009,01,009,0200,288,490 ,3 ,493 ,687 ,0,3,1,3,0,1,0,76.14,71.76 ,33.33
03,009,01,009,0201,289,798 ,9 ,807 ,1149 ,0,3,1,3,0,1,0,76.14,70.23 ,33.33
03,009,01,009,0202,290,587 ,6 ,593 ,838 ,0,3,1,3,0,1,0,76.14,70.76 ,33.33
03,009,01,009,0202,291,586 ,7 ,593 ,911 ,0,3,1,3,0,1,0,76.14,65.09 ,33.33
03,009,01,009,0203,292,898 ,3 ,901 ,1354 ,0,3,1,3,0,1,0,76.14,66.54 ,33.33
03,009,01,009,0203,293,766 ,0 ,766 ,1163 ,0,3,1,3,0,1,0,76.14,65.86 ,33.33
03,009,01,009,0204,294,892 ,10 ,902 ,1282 ,0,3,1,3,0,1,0,76.14,70.36 ,33.33
03,009,01,009,0205,295,565 ,4 ,569 ,894 ,0,3,1,3,0,1,0,76.14,63.65 ,33.33
03,009,01,009,0205,296,685 ,2 ,687 ,1000 ,0,3,1,3,0,1,0,76.14,68.70 ,33.33
03,009,01,009,0206,297,782 ,11 ,793 ,1170 ,0,3,1,3,0,1,0,76.14,67.78 ,33.33
03,009,01,009,0207,298,623 ,4 ,627 ,891 ,0,3,1,3,0,1,0,76.14,70.37 ,33.33
03,009,01,009,0207,299,598 ,13 ,611 ,868 ,0,3,1,3,0,1,0,76.14,70.39 ,33.33
03,009,01,009,0208,300,1141 ,9 ,1150 ,1588 ,0,3,1,3,0,1,0,76.14,72.42 ,33.33
03,009,01,009,0209,301,937 ,16 ,953 ,1335 ,0,3,1,3,0,1,0,76.14,71.39 ,33.33
03,009,01,009,0210,302,758 ,3 ,761 ,1158 ,0,3,1,3,0,1,0,76.14,65.72 ,33.33
03,009,01,009,0210,303,401 ,3 ,404 ,605 ,0,3,1,3,0,1,0,76.14,66.78 ,33.33
03,009,01,010,0211,304,730 ,8 ,738 ,1054 ,0,3,1,3,0,1,0,76.14,70.02 ,33.33
03,009,01,010,0212,305,1113 ,11 ,1124 ,1755 ,0,3,1,3,0,1,0,76.14,64.05 ,33.33
03,009,01,010,0212,306,1066 ,10 ,1076 ,1665 ,0,3,1,3,0,1,0,76.14,64.62 ,33.33
03,009,01,010,0213,307,899 ,13 ,912 ,1404 ,0,3,1,3,0,1,0,76.14,64.96 ,33.33
03,009,01,010,0213,308,468 ,2 ,470 ,721 ,0,3,1,3,0,1,0,76.14,65.19 ,33.33
03,009,01,010,0214,309,437 ,4 ,441 ,594 ,0,3,1,3,0,1,0,76.14,74.24 ,33.33
03,009,01,010,0215,310,649 ,7 ,656 ,927 ,0,3,1,3,0,1,0,76.14,70.77 ,33.33
03,009,01,010,0216,311,740 ,4 ,744 ,1036 ,0,3,1,3,0,1,0,76.14,71.81 ,33.33
03,009,01,010,0216,312,1022 ,12 ,1034 ,1503 ,0,3,1,3,0,1,0,76.14,68.80 ,33.33
03,009,01,010,0217,313,473 ,8 ,481 ,654 ,0,3,1,3,0,1,0,76.14,73.55 ,33.33
03,009,01,010,0218,314,791 ,3 ,794 ,1111 ,0,3,1,3,0,1,0,76.14,71.47 ,33.33
03,009,01,010,0219,315,734 ,9 ,743 ,1044 ,0,3,1,3,0,1,0,76.14,71.17 ,33.33
03,009,01,010,0220,316,661 ,6 ,667 ,918 ,0,3,1,3,0,1,0,76.14,72.66 ,33.33
03,009,01,010,0220,317,609 ,3 ,612 ,858 ,0,3,1,3,0,1,0,76.14,71.33 ,33.33
03,009,01,011,0221,318,940 ,10 ,950 ,1446 ,0,3,1,3,0,1,0,76.14,65.70 ,33.33
03,009,01,011,0222,319,1054 ,3 ,1057 ,1654 ,0,3,1,3,0,1,0,76.14,63.91 ,33.33
03,009,01,011,0223,320,476 ,2 ,478 ,697 ,0,3,1,3,0,1,0,76.14,68.58 ,33.33
03,009,01,011,0223,321,673 ,6 ,679 ,1075 ,0,3,1,3,0,1,0,76.14,63.16 ,33.33
03,009,01,011,0224,322,342 ,2 ,344 ,492 ,0,3,1,3,0,1,0,76.14,69.92 ,33.33
03,009,01,011,0224,323,699 ,4 ,703 ,1134 ,0,3,1,3,0,1,0,76.14,61.99 ,33.33
03,009,01,011,0225,324,863 ,4 ,867 ,1244 ,0,3,1,3,0,1,0,76.14,69.69 ,33.33
03,009,01,011,0226,325,657 ,2 ,659 ,1023 ,0,3,1,3,0,1,0,76.14,64.42 ,33.33
03,009,01,011,0226,326,621 ,3 ,624 ,964 ,0,3,1,3,0,1,0,76.14,64.73 ,33.33
03,009,01,011,0227,327,597 ,5 ,602 ,969 ,0,3,1,3,0,1,0,76.14,62.13 ,33.33
03,009,01,011,0228,328,854 ,7 ,861 ,1373 ,0,3,1,3,0,1,0,76.14,62.71 ,33.33
03,009,01,011,0229,329,592 ,3 ,595 ,918 ,0,3,1,3,0,1,0,76.14,64.81 ,33.33
03,009,01,011,0230,330,505 ,0 ,505 ,769 ,0,3,1,3,0,1,0,76.14,65.67 ,33.33
03,009,01,011,0231,331,979 ,11 ,990 ,1528 ,0,3,1,3,0,1,0,76.14,64.79 ,33.33
03,009,01,011,0232,332,740 ,8 ,748 ,1222 ,0,3,1,3,0,1,0,76.14,61.21 ,33.33
03,009,01,011,0232,333,487 ,4 ,491 ,731 ,0,3,1,3,0,1,0,76.14,67.17 ,33.33
03,009,01,011,0233,334,599 ,5 ,604 ,928 ,0,3,1,3,0,1,0,76.14,65.09 ,33.33
03,009,01,011,0234,335,709 ,6 ,715 ,1119 ,0,3,1,3,0,1,0,76.14,63.90 ,33.33
03,009,01,011,0234,336,390 ,4 ,394 ,675 ,0,3,1,3,0,1,0,76.14,58.37 ,33.33
03,009,01,011,0235,337,856 ,6 ,862 ,1426 ,0,3,1,3,0,1,0,76.14,60.45 ,33.33
03,009,01,011,0236,338,558 ,2 ,560 ,1001 ,0,3,1,3,0,1,0,76.14,55.94 ,33.33
03,009,01,011,0237,339,543 ,6 ,549 ,862 ,0,3,1,3,0,1,0,76.14,63.69 ,33.33
03,009,01,011,0238,340,699 ,8 ,707 ,1067 ,0,3,1,3,0,1,0,76.14,66.26 ,33.33
03,009,01,012,0239,341,841 ,10 ,851 ,1274 ,0,3,1,3,0,1,0,76.14,66.80 ,33.33
03,009,01,012,0240,342,888 ,8 ,896 ,1408 ,0,3,1,3,0,1,0,76.14,63.64 ,33.33
03,009,01,012,0241,343,614 ,5 ,619 ,1004 ,0,3,1,3,0,1,0,76.14,61.65 ,33.33
03,009,01,012,0241,344,843 ,8 ,851 ,1273 ,0,3,1,3,0,1,0,76.14,66.85 ,33.33
03,009,01,012,0242,345,724 ,7 ,731 ,1095 ,0,3,1,3,0,1,0,76.14,66.76 ,33.33
03,009,01,012,0242,346,590 ,5 ,595 ,968 ,0,3,1,3,0,1,0,76.14,61.47 ,33.33
03,009,01,012,0243,347,589 ,9 ,598 ,977 ,0,3,1,3,0,1,0,76.14,61.21 ,33.33
03,009,01,012,0243,348,671 ,7 ,678 ,1067 ,0,3,1,3,0,1,0,76.14,63.54 ,33.33
03,009,01,012,0244,349,870 ,10 ,880 ,1370 ,0,3,1,3,0,1,0,76.14,64.23 ,33.33
03,009,01,012,0245,350,706 ,17 ,723 ,1076 ,0,3,1,3,0,1,0,76.14,67.19 ,33.33
03,009,01,012,0245,351,686 ,5 ,691 ,976 ,0,3,1,3,0,1,0,76.14,70.80 ,33.33
03,009,01,012,0246,352,595 ,5 ,600 ,913 ,0,3,1,3,0,1,0,76.14,65.72 ,33.33
03,009,01,012,0247,353,507 ,18 ,525 ,798 ,0,3,1,3,0,1,0,76.14,65.79 ,33.33
03,009,01,012,0247,354,575 ,5 ,580 ,950 ,0,3,1,3,0,1,0,76.14,61.05 ,33.33
03,009,01,012,0248,355,611 ,6 ,617 ,995 ,0,3,1,3,0,1,0,76.14,62.01 ,33.33
03,009,01,012,0248,356,598 ,5 ,603 ,1065 ,0,3,1,3,0,1,0,76.14,56.62 ,33.33
03,009,01,012,0249,357,954 ,7 ,961 ,1518 ,0,3,1,3,0,1,0,76.14,63.31 ,33.33
03,009,01,012,0250,358,761 ,21 ,782 ,1214 ,0,3,1,3,0,1,0,76.14,64.42 ,33.33
03,009,01,012,0251,359,838 ,10 ,848 ,1282 ,0,3,1,3,0,1,0,76.14,66.15 ,33.33
03,009,01,012,0252,360,591 ,4 ,595 ,854 ,0,3,1,3,0,1,0,76.14,69.67 ,33.33
03,009,01,013,0253,361,436 ,3 ,439 ,652 ,0,3,1,3,0,1,0,76.14,67.33 ,33.33
03,009,01,013,0253,362,1034 ,12 ,1046 ,1627 ,0,3,1,3,0,1,0,76.14,64.29 ,33.33
03,009,01,013,0253,363,755 ,7 ,762 ,1170 ,0,3,1,3,0,1,0,76.14,65.13 ,33.33
03,009,01,013,0254,364,831 ,7 ,838 ,1242 ,0,3,1,3,0,1,0,76.14,67.47 ,33.33
03,009,01,013,0254,365,854 ,17 ,871 ,1369 ,0,3,1,3,0,1,0,76.14,63.62 ,33.33
03,009,01,013,0255,366,286 ,4 ,290 ,503 ,0,3,1,3,0,1,0,76.14,57.65 ,33.33
03,009,01,013,0255,367,574 ,2 ,576 ,853 ,0,3,1,3,0,1,0,76.14,67.53 ,33.33
03,009,01,013,0256,368,462 ,4 ,466 ,733 ,0,3,1,3,0,1,0,76.14,63.57 ,33.33
03,009,01,013,0256,369,708 ,5 ,713 ,1088 ,0,3,1,3,0,1,0,76.14,65.53 ,33.33
03,009,01,013,0257,370,501 ,2 ,503 ,851 ,0,3,1,3,0,1,0,76.14,59.11 ,33.33
03,009,01,013,0257,371,377 ,2 ,379 ,616 ,0,3,1,3,0,1,0,76.14,61.53 ,33.33
03,009,01,013,0258,372,628 ,5 ,633 ,1013 ,0,3,1,3,0,1,0,76.14,62.49 ,33.33
03,009,01,013,0258,373,686 ,4 ,690 ,1132 ,0,3,1,3,0,1,0,76.14,60.95 ,33.33
03,009,01,013,0259,374,638 ,9 ,647 ,999 ,0,3,1,3,0,1,0,76.14,64.76 ,33.33
03,009,01,013,0259,375,800 ,8 ,808 ,1296 ,0,3,1,3,0,1,0,76.14,62.35 ,33.33
03,009,01,013,0260,376,525 ,2 ,527 ,900 ,0,3,1,3,0,1,0,76.14,58.56 ,33.33
03,009,01,013,0260,377,564 ,1 ,565 ,952 ,0,3,1,3,0,1,0,76.14,59.35 ,33.33
03,009,01,013,0261,378,619 ,4 ,623 ,999 ,0,3,1,3,0,1,0,76.14,62.36 ,33.33
03,009,01,013,0261,379,994 ,11 ,1005 ,1610 ,0,3,1,3,0,1,0,76.14,62.42 ,33.33
03,009,01,013,0262,380,487 ,6 ,493 ,789 ,0,3,1,3,0,1,0,76.14,62.48 ,33.33
03,009,01,013,0263,381,749 ,8 ,757 ,1209 ,0,3,1,3,0,1,0,76.14,62.61 ,33.33
03,009,01,013,0263,382,628 ,11 ,639 ,1022 ,0,3,1,3,0,1,0,76.14,62.52 ,33.33
03,009,01,013,0264,383,814 ,12 ,826 ,1479 ,0,3,1,3,0,1,0,76.14,55.85 ,33.33
03,009,01,014,0265,384,772 ,8 ,780 ,1280 ,0,3,1,3,0,1,0,76.14,60.94 ,33.33
03,009,01,014,0266,385,325 ,4 ,329 ,501 ,0,3,1,3,0,1,0,76.14,65.67 ,33.33
03,009,01,014,0267,386,600 ,9 ,609 ,1032 ,0,3,1,3,0,1,0,76.14,59.01 ,33.33
03,009,01,014,0267,387,482 ,5 ,487 ,762 ,0,3,1,3,0,1,0,76.14,63.91 ,33.33
03,009,01,014,0268,388,990 ,6 ,996 ,1466 ,0,3,1,3,0,1,0,76.14,67.94 ,33.33
03,009,01,014,0269,389,769 ,8 ,777 ,1213 ,0,3,1,3,0,1,0,76.14,64.06 ,33.33
03,009,01,014,0270,390,519 ,3 ,522 ,995 ,0,3,1,3,0,1,0,76.14,52.46 ,33.33
03,009,01,014,0271,391,384 ,6 ,390 ,611 ,0,3,1,3,0,1,0,76.14,63.83 ,33.33
03,009,01,014,0272,392,645 ,4 ,649 ,966 ,0,3,1,3,0,1,0,76.14,67.18 ,33.33
03,009,01,014,0273,393,527 ,8 ,535 ,923 ,0,3,1,3,0,1,0,76.14,57.96 ,33.33
03,009,01,014,0274,394,684 ,5 ,689 ,1024 ,0,3,1,3,0,1,0,76.14,67.29 ,33.33
03,009,01,014,0274,395,755 ,3 ,758 ,1150 ,0,3,1,3,0,1,0,76.14,65.91 ,33.33
03,009,01,014,0275,396,492 ,4 ,496 ,817 ,0,3,1,3,0,1,0,76.14,60.71 ,33.33
03,009,01,014,0275,397,285 ,1 ,286 ,460 ,0,3,1,3,0,1,0,76.14,62.17 ,33.33
03,009,01,014,0276,398,764 ,3 ,767 ,1252 ,0,3,1,3,0,1,0,76.14,61.26 ,33.33
03,009,01,015,0277,399,695 ,7 ,702 ,972 ,0,3,1,3,0,1,0,76.14,72.22 ,33.33
03,009,01,015,0277,400,676 ,5 ,681 ,942 ,0,3,1,3,0,1,0,76.14,72.29 ,33.33
03,009,01,015,0278,401,987 ,6 ,993 ,1411 ,0,3,1,3,0,1,0,76.14,70.38 ,33.33
03,009,01,015,0279,402,968 ,9 ,977 ,1446 ,0,3,1,3,0,1,0,76.14,67.57 ,33.33
03,009,01,015,0280,403,321 ,2 ,323 ,430 ,0,3,1,3,0,1,0,76.14,75.12 ,33.33
03,009,01,015,0280,404,705 ,9 ,714 ,981 ,0,3,1,3,0,1,0,76.14,72.78 ,33.33
03,009,01,015,0281,405,384 ,4 ,388 ,516 ,0,3,1,3,0,1,0,76.14,75.19 ,33.33
03,009,01,015,0281,406,549 ,3 ,552 ,787 ,0,3,1,3,0,1,0,76.14,70.14 ,33.33
03,009,01,015,0282,407,636 ,2 ,638 ,970 ,0,3,1,3,0,1,0,76.14,65.77 ,33.33
03,009,01,015,0283,408,549 ,2 ,551 ,804 ,0,3,1,3,0,1,0,76.14,68.53 ,33.33
03,009,01,015,0284,409,793 ,8 ,801 ,1281 ,0,3,1,3,0,1,0,76.14,62.53 ,33.33
03,009,01,015,0285,410,609 ,5 ,614 ,979 ,0,3,1,3,0,1,0,76.14,62.72 ,33.33
03,009,01,016,0286,411,822 ,10 ,832 ,1251 ,0,3,1,3,0,1,0,76.14,66.51 ,33.33
03,009,01,016,0287,412,669 ,9 ,678 ,1051 ,0,3,1,3,0,1,0,76.14,64.51 ,33.33
03,009,01,016,0288,413,663 ,3 ,666 ,1059 ,0,3,1,3,0,1,0,76.14,62.89 ,33.33
03,009,01,016,0289,414,611 ,6 ,617 ,1009 ,0,3,1,3,0,1,0,76.14,61.15 ,33.33
03,009,01,016,0289,415,592 ,4 ,596 ,966 ,0,3,1,3,0,1,0,76.14,61.70 ,33.33
03,009,01,016,0290,416,487 ,11 ,498 ,903 ,0,3,1,3,0,1,0,76.14,55.15 ,33.33
03,009,01,016,0291,417,809 ,7 ,816 ,1525 ,0,3,1,3,0,1,0,76.14,53.51 ,33.33
03,009,01,016,0292,418,708 ,10 ,718 ,1251 ,0,3,1,3,0,1,0,76.14,57.39 ,33.33
03,009,01,016,0292,419,421 ,3 ,424 ,698 ,0,3,1,3,0,1,0,76.14,60.74 ,33.33
03,009,01,016,0293,420,365 ,4 ,369 ,659 ,0,3,1,3,0,1,0,76.14,55.99 ,33.33
03,009,01,016,0294,421,250 ,2 ,252 ,487 ,0,3,1,3,0,1,0,76.14,51.75 ,33.33
03,009,01,016,0295,422,405 ,6 ,411 ,699 ,0,3,1,3,0,1,0,76.14,58.80 ,33.33
03,009,01,016,0296,423,752 ,7 ,759 ,1284 ,0,3,1,3,0,1,0,76.14,59.11 ,33.33
03,009,01,016,0296,424,410 ,1 ,411 ,642 ,0,3,1,3,0,1,0,76.14,64.02 ,33.33
03,009,01,016,0297,425,676 ,7 ,683 ,1064 ,0,3,1,3,0,1,0,76.14,64.19 ,33.33
03,009,01,016,0297,426,309 ,3 ,312 ,515 ,0,3,1,3,0,1,0,76.14,60.58 ,33.33
03,009,01,016,0298,427,930 ,6 ,936 ,1473 ,0,3,1,3,0,1,0,76.14,63.54 ,33.33
03,009,01,016,0299,428,680 ,1 ,681 ,1062 ,0,3,1,3,0,1,0,76.14,64.12 ,33.33
03,009,01,016,0299,429,630 ,5 ,635 ,1053 ,0,3,1,3,0,1,0,76.14,60.30 ,33.33
03,009,01,016,0299,430,629 ,5 ,634 ,1145 ,0,3,1,3,0,1,0,76.14,55.37 ,33.33
03,009,01,016,0300,431,888 ,6 ,894 ,1335 ,0,3,1,3,0,1,0,76.14,66.97 ,33.33
03,009,01,016,0300,432,490 ,7 ,497 ,706 ,0,3,1,3,0,1,0,76.14,70.40 ,33.33
03,009,01,017,0301,433,548 ,5 ,553 ,860 ,0,3,1,3,0,1,0,76.14,64.30 ,33.33
03,009,01,017,0301,434,748 ,11 ,759 ,1144 ,0,3,1,3,0,1,0,76.14,66.35 ,33.33
03,009,01,017,0301,435,712 ,9 ,721 ,1218 ,0,3,1,3,0,1,0,76.14,59.20 ,33.33
03,009,01,017,0302,436,498 ,6 ,504 ,835 ,0,3,1,3,0,1,0,76.14,60.36 ,33.33
03,009,01,017,0302,437,490 ,5 ,495 ,822 ,0,3,1,3,0,1,0,76.14,60.22 ,33.33
03,009,01,017,0303,438,912 ,10 ,922 ,1503 ,0,3,1,3,0,1,0,76.14,61.34 ,33.33
03,009,01,017,0304,439,521 ,4 ,525 ,809 ,0,3,1,3,0,1,0,76.14,64.89 ,33.33
03,009,01,017,0305,440,696 ,7 ,703 ,1066 ,0,3,1,3,0,1,0,76.14,65.95 ,33.33
03,009,01,017,0306,441,681 ,5 ,686 ,1216 ,0,3,1,3,0,1,0,76.14,56.41 ,33.33
03,009,01,017,0307,442,626 ,3 ,629 ,1054 ,0,3,1,3,0,1,0,76.14,59.68 ,33.33
03,009,01,017,0308,443,468 ,1 ,469 ,921 ,0,3,1,3,0,1,0,76.14,50.92 ,33.33
03,009,01,017,0309,444,383 ,3 ,386 ,669 ,0,3,1,3,0,1,0,76.14,57.70 ,33.33
03,009,01,017,0310,445,542 ,6 ,548 ,877 ,0,3,1,3,0,1,0,76.14,62.49 ,33.33
03,009,01,017,0311,446,255 ,3 ,258 ,459 ,0,3,1,3,0,1,0,76.14,56.21 ,33.33
03,009,01,017,0312,447,718 ,7 ,725 ,1223 ,0,3,1,3,0,1,0,76.14,59.28 ,33.33
03,009,01,017,0313,448,952 ,14 ,966 ,1533 ,0,3,1,3,0,1,0,76.14,63.01 ,33.33
03,009,01,017,0314,449,691 ,5 ,696 ,1102 ,0,3,1,3,0,1,0,76.14,63.16 ,33.33
03,009,01,017,0315,450,532 ,9 ,541 ,923 ,0,3,1,3,0,1,0,76.14,58.61 ,33.33
03,009,01,017,0316,451,820 ,9 ,829 ,1329 ,0,3,1,3,0,1,0,76.14,62.38 ,33.33
03,009,01,017,0317,452,625 ,12 ,637 ,1023 ,0,3,1,3,0,1,0,76.14,62.27 ,33.33
03,009,01,017,0318,453,490 ,3 ,493 ,772 ,0,3,1,3,0,1,0,76.14,63.86 ,33.33
03,009,01,017,0318,454,544 ,8 ,552 ,887 ,0,3,1,3,0,1,0,76.14,62.23 ,33.33
03,009,01,017,0319,455,432 ,3 ,435 ,667 ,0,3,1,3,0,1,0,76.14,65.22 ,33.33
03,009,01,017,0320,456,576 ,7 ,583 ,918 ,0,3,1,3,0,1,0,76.14,63.51 ,33.33
03,009,01,017,0321,457,515 ,4 ,519 ,740 ,0,3,1,3,0,1,0,76.14,70.14 ,33.33
03,009,01,018,0322,458,617 ,9 ,626 ,1025 ,0,3,1,3,0,1,0,76.14,61.07 ,33.33
03,009,01,018,0322,459,472 ,7 ,479 ,732 ,0,3,1,3,0,1,0,76.14,65.44 ,33.33
03,009,01,018,0323,460,1048 ,14 ,1062 ,1587 ,0,3,1,3,0,1,0,76.14,66.92 ,33.33
03,009,01,018,0323,461,345 ,4 ,349 ,572 ,0,3,1,3,0,1,0,76.14,61.01 ,33.33
03,009,01,018,0324,462,443 ,2 ,445 ,716 ,0,3,1,3,0,1,0,76.14,62.15 ,33.33
03,009,01,018,0325,463,638 ,5 ,643 ,1080 ,0,3,1,3,0,1,0,76.14,59.54 ,33.33
03,009,01,018,0326,464,633 ,3 ,636 ,1094 ,0,3,1,3,0,1,0,76.14,58.14 ,33.33
03,009,01,018,0327,465,520 ,9 ,529 ,969 ,0,3,1,3,0,1,0,76.14,54.59 ,33.33
03,009,01,018,0328,466,451 ,6 ,457 ,874 ,0,3,1,3,0,1,0,76.14,52.29 ,33.33
03,009,01,018,0329,467,721 ,9 ,730 ,1209 ,0,3,1,3,0,1,0,76.14,60.38 ,33.33
03,009,01,018,0330,468,601 ,4 ,605 ,1141 ,0,3,1,3,0,1,0,76.14,53.02 ,33.33
03,009,01,018,0331,469,462 ,2 ,464 ,953 ,0,3,1,3,0,1,0,76.14,48.69 ,33.33
03,009,01,018,0332,470,337 ,6 ,343 ,647 ,0,3,1,3,0,1,0,76.14,53.01 ,33.33
03,009,01,018,0333,471,514 ,4 ,518 ,986 ,0,3,1,3,0,1,0,76.14,52.54 ,33.33
03,009,01,018,0334,472,228 ,4 ,232 ,414 ,0,3,1,3,0,1,0,76.14,56.04 ,33.33
03,009,01,018,0335,473,525 ,4 ,529 ,980 ,0,3,1,3,0,1,0,76.14,53.98 ,33.33
03,009,01,018,0335,474,511 ,6 ,517 ,814 ,0,3,1,3,0,1,0,76.14,63.51 ,33.33
03,009,01,018,0336,475,486 ,5 ,491 ,895 ,0,3,1,3,0,1,0,76.14,54.86 ,33.33
03,009,01,018,0337,476,386 ,5 ,391 ,814 ,0,3,1,3,0,1,0,76.14,48.03 ,33.33
03,009,01,018,0338,477,488 ,7 ,495 ,1021 ,0,3,1,3,0,1,0,76.14,48.48 ,33.33
03,009,01,018,0339,478,552 ,6 ,558 ,1141 ,0,3,1,3,0,1,0,76.14,48.90 ,33.33
03,009,01,018,0340,479,677 ,3 ,680 ,1283 ,0,3,1,3,0,1,0,76.14,53.00 ,33.33
03,009,01,018,0341,480,534 ,6 ,540 ,1086 ,0,3,1,3,0,1,0,76.14,49.72 ,33.33
03,009,01,018,0342,481,409 ,1 ,410 ,829 ,0,3,1,3,0,1,0,76.14,49.46 ,33.33
03,009,01,019,0343,482,712 ,5 ,717 ,1084 ,0,3,1,3,0,1,0,76.14,66.14 ,33.33
03,009,01,019,0344,483,868 ,10 ,878 ,1319 ,0,3,1,3,0,1,0,76.14,66.57 ,33.33
03,009,01,019,0345,484,411 ,0 ,411 ,693 ,0,3,1,3,0,1,0,76.14,59.31 ,33.33
03,009,01,019,0346,485,430 ,3 ,433 ,678 ,0,3,1,3,0,1,0,76.14,63.86 ,33.33
03,009,01,019,0347,486,449 ,7 ,456 ,931 ,0,3,1,3,0,1,0,76.14,48.98 ,33.33
03,009,01,019,0348,487,605 ,11 ,616 ,1001 ,0,3,1,3,0,1,0,76.14,61.54 ,33.33
03,009,01,019,0349,488,927 ,6 ,933 ,1472 ,0,3,1,3,0,1,0,76.14,63.38 ,33.33
03,009,01,019,0350,489,447 ,2 ,449 ,901 ,0,3,1,3,0,1,0,76.14,49.83 ,33.33
03,009,01,019,0350,490,649 ,3 ,652 ,1194 ,0,3,1,3,0,1,0,76.14,54.61 ,33.33
03,009,01,019,0351,491,451 ,2 ,453 ,874 ,0,3,1,3,0,1,0,76.14,51.83 ,33.33
03,009,01,019,0351,492,473 ,3 ,476 ,879 ,0,3,1,3,0,1,0,76.14,54.15 ,33.33
03,009,01,019,0352,493,848 ,9 ,857 ,1525 ,0,3,1,3,0,1,0,76.14,56.20 ,33.33
03,009,01,019,0353,494,281 ,4 ,285 ,572 ,0,3,1,3,0,1,0,76.14,49.83 ,33.33
03,009,01,019,0354,495,876 ,8 ,884 ,1530 ,0,3,1,3,0,1,0,76.14,57.78 ,33.33
03,009,01,019,0355,496,464 ,8 ,472 ,803 ,0,3,1,3,0,1,0,76.14,58.78 ,33.33
03,009,01,019,0356,497,235 ,2 ,237 ,350 ,0,3,1,3,0,1,0,76.14,67.71 ,33.33
03,009,01,019,0356,498,863 ,7 ,870 ,1352 ,0,3,1,3,0,1,0,76.14,64.35 ,33.33
03,009,01,019,0357,499,675 ,0 ,675 ,1033 ,0,3,1,3,0,1,0,76.14,65.34 ,33.33
03,009,01,019,0358,500,597 ,4 ,601 ,910 ,0,3,1,3,0,1,0,76.14,66.04 ,33.33
03,009,01,019,0358,501,573 ,3 ,576 ,956 ,0,3,1,3,0,1,0,76.14,60.25 ,33.33
03,009,01,019,0359,502,776 ,3 ,779 ,1317 ,0,3,1,3,0,1,0,76.14,59.15 ,33.33
03,009,01,019,0360,503,686 ,6 ,692 ,1060 ,0,3,1,3,0,1,0,76.14,65.28 ,33.33
03,009,01,019,0361,504,513 ,3 ,516 ,789 ,0,3,1,3,0,1,0,76.14,65.40 ,33.33
03,009,01,019,0362,505,641 ,7 ,648 ,1057 ,0,3,1,3,0,1,0,76.14,61.31 ,33.33
03,009,01,019,0363,506,447 ,4 ,451 ,754 ,0,3,1,3,0,1,0,76.14,59.81 ,33.33
03,009,01,020,0364,507,851 ,5 ,856 ,1374 ,0,3,1,3,0,1,0,76.14,62.30 ,33.33
03,009,01,020,0364,508,652 ,4 ,656 ,904 ,0,3,1,3,0,1,0,76.14,72.57 ,33.33
03,009,01,020,0365,509,803 ,5 ,808 ,1154 ,0,3,1,3,0,1,0,76.14,70.02 ,33.33
03,009,01,020,0365,510,520 ,7 ,527 ,789 ,0,3,1,3,0,1,0,76.14,66.79 ,33.33
03,009,01,020,0366,511,495 ,3 ,498 ,762 ,0,3,1,3,0,1,0,76.14,65.35 ,33.33
03,009,01,020,0367,512,473 ,5 ,478 ,745 ,0,3,1,3,0,1,0,76.14,64.16 ,33.33
03,009,01,020,0368,513,712 ,5 ,717 ,1080 ,0,3,1,3,0,1,0,76.14,66.39 ,33.33
03,009,01,020,0369,514,567 ,6 ,573 ,927 ,0,3,1,3,0,1,0,76.14,61.81 ,33.33
03,009,01,020,0370,515,774 ,8 ,782 ,1173 ,0,3,1,3,0,1,0,76.14,66.67 ,33.33
03,009,01,020,0371,516,496 ,3 ,499 ,794 ,0,3,1,3,0,1,0,76.14,62.85 ,33.33
03,009,01,020,0372,517,644 ,5 ,649 ,1068 ,0,3,1,3,0,1,0,76.14,60.77 ,33.33
03,009,01,020,0373,518,442 ,9 ,451 ,751 ,0,3,1,3,0,1,0,76.14,60.05 ,33.33
03,009,01,020,0374,519,410 ,2 ,412 ,683 ,0,3,1,3,0,1,0,76.14,60.32 ,33.33
03,009,01,020,0375,520,673 ,9 ,682 ,1204 ,0,3,1,3,0,1,0,76.14,56.64 ,33.33
03,009,01,020,0376,521,459 ,5 ,464 ,753 ,0,3,1,3,0,1,0,76.14,61.62 ,33.33
03,009,01,020,0377,522,650 ,8 ,658 ,1060 ,0,3,1,3,0,1,0,76.14,62.08 ,33.33
03,009,01,020,0378,523,644 ,10 ,654 ,1039 ,0,3,1,3,0,1,0,76.14,62.95 ,33.33
03,009,01,020,0379,524,536 ,5 ,541 ,892 ,0,3,1,3,0,1,0,76.14,60.65 ,33.33
03,009,01,020,0380,525,887 ,6 ,893 ,1228 ,0,3,1,3,0,1,0,76.14,72.72 ,33.33
03,009,01,020,0381,526,410 ,4 ,414 ,608 ,0,3,1,3,0,1,0,76.14,68.09 ,33.33
03,009,01,020,0382,527,521 ,8 ,529 ,786 ,0,3,1,3,0,1,0,76.14,67.30 ,33.33
03,009,01,020,0383,528,516 ,8 ,524 ,854 ,0,3,1,3,0,1,0,76.14,61.36 ,33.33
03,009,01,020,0384,529,523 ,5 ,528 ,838 ,0,3,1,3,0,1,0,76.14,63.01 ,33.33
03,009,01,020,0385,530,701 ,8 ,709 ,1060 ,0,3,1,3,0,1,0,76.14,66.89 ,33.33
03,009,01,020,0386,531,807 ,6 ,813 ,1257 ,0,3,1,3,0,1,0,76.14,64.68 ,33.33
03,009,01,020,0387,532,574 ,2 ,576 ,828 ,0,3,1,3,0,1,0,76.14,69.57 ,33.33
03,010,01,001,0001,1,993 ,9 ,1002 ,1791 ,0,3,1,3,0,1,0,76.14,55.95 ,33.33
03,010,01,001,0002,2,293 ,3 ,296 ,499 ,0,3,1,3,0,1,0,76.14,59.32 ,33.33
03,010,01,001,0003,3,832 ,9 ,841 ,1372 ,0,3,1,3,0,1,0,76.14,61.30 ,33.33
03,010,01,001,0004,4,980 ,8 ,988 ,1516 ,0,3,1,3,0,1,0,76.14,65.17 ,33.33
03,010,01,001,0005,5,470 ,1 ,471 ,716 ,0,3,1,3,0,1,0,76.14,65.78 ,33.33
03,010,01,001,0005,6,263 ,4 ,267 ,384 ,0,3,1,3,0,1,0,76.14,69.53 ,33.33
03,010,01,001,0006,7,502 ,9 ,511 ,868 ,0,3,1,3,0,1,0,76.14,58.87 ,33.33
03,010,01,001,0007,8,557 ,10 ,567 ,822 ,0,3,1,3,0,1,0,76.14,68.98 ,33.33
03,010,01,001,0008,9,145 ,2 ,147 ,212 ,0,3,1,3,0,1,0,76.14,69.34 ,33.33
03,010,01,001,0008,10,317 ,2 ,319 ,488 ,0,3,1,3,0,1,0,76.14,65.37 ,33.33
03,010,01,001,0008,11,296 ,6 ,302 ,508 ,0,3,1,3,0,1,0,76.14,59.45 ,33.33
03,010,01,001,0009,12,575 ,5 ,580 ,894 ,0,3,1,3,0,1,0,76.14,64.88 ,33.33
03,010,01,001,0010,13,746 ,5 ,751 ,1206 ,0,3,1,3,0,1,0,76.14,62.27 ,33.33
03,010,01,001,0011,14,536 ,1 ,537 ,891 ,0,3,1,3,0,1,0,76.14,60.27 ,33.33
03,010,01,001,0011,15,430 ,7 ,437 ,964 ,0,3,1,3,0,1,0,76.14,45.33 ,33.33
03,010,01,001,0012,16,287 ,3 ,290 ,493 ,0,3,1,3,0,1,0,76.14,58.82 ,33.33
03,010,01,001,0012,17,136 ,1 ,137 ,223 ,0,3,1,3,0,1,0,76.14,61.43 ,33.33
03,010,01,001,0013,18,228 ,1 ,229 ,308 ,0,3,1,3,0,1,0,76.14,74.35 ,33.33
03,010,01,001,0013,19,162 ,3 ,165 ,256 ,0,3,1,3,0,1,0,76.14,64.45 ,33.33
03,010,01,001,0014,20,414 ,2 ,416 ,623 ,0,3,1,3,0,1,0,76.14,66.77,33.33
03,010,01,001,0014,21,932 ,5 ,937 ,1566 ,0,3,1,3,0,1,0,76.14,59.83,33.33
03,010,01,001,0015,22,834 ,17 ,851 ,1510 ,0,3,1,3,0,1,0,76.14,56.36 ,33.33
03,010,01,001,0015,23,734 ,9 ,743 ,1437 ,0,3,1,3,0,1,0,76.14,51.70 ,33.33
03,010,01,001,0016,24,1012 ,9 ,1021 ,1770 ,0,3,1,3,0,1,0,76.14,57.68 ,33.33
03,010,01,001,0017,25,635 ,5 ,640 ,1058 ,0,3,1,3,0,1,0,76.14,60.49 ,33.33
03,010,01,001,0017,26,617 ,9 ,626 ,1211 ,0,3,1,3,0,1,0,76.14,51.69 ,33.33
03,010,01,001,0018,27,424 ,3 ,427 ,712 ,0,3,1,3,0,1,0,76.14,59.97 ,33.33
03,010,01,002,0019,28,566 ,7 ,573 ,986 ,0,3,1,3,0,1,0,76.14,58.11 ,33.33
03,010,01,002,0019,29,533 ,3 ,536 ,826 ,0,3,1,3,0,1,0,76.14,64.89 ,33.33
03,010,01,002,0020,30,1133 ,13 ,1146 ,1866 ,0,3,1,3,0,1,0,76.14,61.41 ,33.33
03,010,01,002,0021,31,673 ,4 ,677 ,1107 ,0,3,1,3,0,1,0,76.14,61.16 ,33.33
03,010,01,002,0022,32,305 ,1 ,306 ,481 ,0,3,1,3,0,1,0,76.14,63.62 ,33.33
03,010,01,002,0023,33,438 ,6 ,444 ,710 ,0,3,1,3,0,1,0,76.14,62.54,33.33
03,010,01,002,0024,34,428 ,4 ,432 ,699 ,0,3,1,3,0,1,0,76.14,61.8,33.33
03,010,01,002,0025,35,510 ,4 ,514 ,781 ,0,3,1,3,0,1,0,76.14,65.81 ,33.33
03,010,01,002,0026,36,536 ,4 ,540 ,843 ,0,3,1,3,0,1,0,76.14,64.06 ,33.33
03,010,01,002,0026,37,614 ,3 ,617 ,999 ,0,3,1,3,0,1,0,76.14,61.76 ,33.33
03,010,01,002,0027,38,539 ,8 ,547 ,909 ,0,3,1,3,0,1,0,76.14,60.18 ,33.33
03,010,01,002,0027,39,900 ,14 ,914 ,1535 ,0,3,1,3,0,1,0,76.14,59.54 ,33.33
03,010,01,002,0028,40,1209 ,14 ,1223 ,2143 ,0,3,1,3,0,1,0,76.14,57.07,33.33
03,010,01,002,0028,41,1000 ,7 ,1007 ,1643 ,0,3,1,3,0,1,0,76.14,61.29,33.33
03,010,01,002,0029,42,429 ,7 ,436 ,667 ,0,3,1,3,0,1,0,76.14,65.37,33.33
03,010,01,002,0030,43,428 ,1 ,429 ,694 ,0,3,1,3,0,1,0,76.14,61.82 ,33.33
03,010,01,002,0031,44,510 ,7 ,517 ,814 ,0,3,1,3,0,1,0,76.14,63.51 ,33.33
03,010,01,002,0032,45,692 ,4 ,696 ,1069 ,0,3,1,3,0,1,0,76.14,65.11 ,33.33
03,010,01,002,0033,46,423 ,3 ,426 ,641 ,0,3,1,3,0,1,0,76.14,66.46 ,33.33
03,010,01,002,0034,47,838 ,12 ,850 ,1386 ,0,3,1,3,0,1,0,76.14,61.33 ,33.33
03,010,01,002,0034,48,815 ,10 ,825 ,1274 ,0,3,1,3,0,1,0,76.14,64.76 ,33.33
03,010,01,002,0035,49,1129 ,18 ,1147 ,1838 ,0,3,1,3,0,1,0,76.14,62.40 ,33.33
03,010,01,002,0036,50,389 ,1 ,390 ,626 ,0,3,1,3,0,1,0,76.14,62.30 ,33.33
03,010,01,002,0037,51,558 ,1 ,559 ,988 ,0,3,1,3,0,1,0,76.14,56.58 ,33.33
03,010,01,002,0038,52,668 ,8 ,676 ,971 ,0,3,1,3,0,1,0,76.14,69.62,33.33
03,010,01,002,0039,53,494 ,4 ,498 ,815 ,0,3,1,3,0,1,0,76.14,61.1,33.33
03,010,01,002,0040,54,191 ,1 ,192 ,278 ,0,3,1,3,0,1,0,76.14,69.06 ,33.33
03,010,01,002,0041,55,502 ,6 ,508 ,792 ,0,3,1,3,0,1,0,76.14,64.14 ,33.33
03,010,01,002,0042,56,379 ,5 ,384 ,617 ,0,3,1,3,0,1,0,76.14,62.24 ,33.33
03,010,01,002,0043,57,653 ,10 ,663 ,1127 ,0,3,1,3,0,1,0,76.14,58.83 ,33.33
03,010,01,002,0044,58,891 ,12 ,903 ,1426 ,0,3,1,3,0,1,0,76.14,63.32 ,33.33
03,010,01,002,0045,59,336 ,2 ,338 ,556 ,0,3,1,3,0,1,0,76.14,60.79 ,33.33
03,010,01,003,0046,60,452 ,9 ,461 ,717 ,0,3,1,3,0,1,0,76.14,64.30 ,33.33
03,010,01,003,0047,61,249 ,3 ,252 ,442 ,0,3,1,3,0,1,0,76.14,57.01 ,33.33
03,010,01,003,0048,62,248 ,2 ,250 ,396 ,0,3,1,3,0,1,0,76.14,63.13 ,33.33
03,010,01,003,0048,63,855 ,7 ,862 ,1310 ,0,3,1,3,0,1,0,76.14,65.80 ,33.33
03,010,01,003,0049,64,735 ,11 ,746 ,1203 ,0,3,1,3,0,1,0,76.14,62.01 ,33.33
03,010,01,003,0050,65,674 ,14 ,688 ,1103 ,0,3,1,3,0,1,0,76.14,62.38 ,33.33
03,010,01,003,0050,66,442 ,8 ,450 ,706 ,0,3,1,3,0,1,0,76.14,63.74 ,33.33
03,010,01,003,0051,67,545 ,3 ,548 ,982 ,0,3,1,3,0,1,0,76.14,55.80 ,33.33
03,010,01,003,0052,68,472 ,4 ,476 ,783 ,0,3,1,3,0,1,0,76.14,60.79 ,33.33
03,010,01,003,0053,69,503 ,13 ,516 ,818 ,0,3,1,3,0,1,0,76.14,63.08,33.33
03,010,01,003,0054,70,863 ,6 ,869 ,1371 ,0,3,1,3,0,1,0,76.14,63.38,33.33
03,010,01,003,0055,71,993 ,11 ,1004 ,1607 ,0,3,1,3,0,1,0,76.14,62.48 ,33.33
03,010,01,003,0056,72,929 ,11 ,940 ,1521 ,0,3,1,3,0,1,0,76.14,61.80 ,33.33
03,010,01,003,0057,73,219 ,0 ,219 ,301 ,0,3,1,3,0,1,0,76.14,72.76,33.33
03,010,01,003,0057,74,180 ,4 ,184 ,264 ,0,3,1,3,0,1,0,76.14,69.7,33.33
03,010,01,003,0058,75,310 ,3 ,313 ,490 ,0,3,1,3,0,1,0,76.14,63.88 ,33.33
03,010,01,003,0058,76,201 ,0 ,201 ,273 ,0,3,1,3,0,1,0,76.14,73.63 ,33.33
03,010,01,003,0059,77,648 ,13 ,661 ,1166 ,0,3,1,3,0,1,0,76.14,56.69 ,33.33
03,010,01,003,0060,78,582 ,6 ,588 ,962 ,0,3,1,3,0,1,0,76.14,61.12 ,33.33
03,010,01,003,0060,79,598 ,5 ,603 ,982 ,0,3,1,3,0,1,0,76.14,61.41 ,33.33
03,010,01,003,0061,80,215 ,1 ,216 ,326 ,0,3,1,3,0,1,0,76.14,66.26 ,33.33
03,010,01,003,0062,81,105 ,1 ,106 ,201 ,0,3,1,3,0,1,0,76.14,52.74 ,33.33
03,010,01,003,0062,82,158 ,3 ,161 ,241 ,0,3,1,3,0,1,0,76.14,66.80 ,33.33
03,010,01,003,0063,83,86 ,0 ,86 ,138 ,0,3,1,3,0,1,0,76.14,62.32 ,33.33
03,010,01,003,0063,84,120 ,1 ,121 ,200 ,0,3,1,3,0,1,0,76.14,60.50 ,33.33
03,010,01,003,0064,85,508 ,4 ,512 ,808 ,0,3,1,3,0,1,0,76.14,63.37 ,33.33
03,010,01,003,0065,86,617 ,9 ,626 ,1050 ,0,3,1,3,0,1,0,76.14,59.62 ,33.33
03,010,01,003,0066,87,657 ,4 ,661 ,1239 ,0,3,1,3,0,1,0,76.14,53.35 ,33.33
03,010,01,003,0067,88,662 ,13 ,675 ,1162 ,0,3,1,3,0,1,0,76.14,58.09 ,33.33
03,010,01,003,0067,89,742 ,6 ,748 ,1277 ,0,3,1,3,0,1,0,76.14,58.57 ,33.33
03,010,01,003,0068,90,596 ,10 ,606 ,1110 ,0,3,1,3,0,1,0,76.14,54.59 ,33.33
03,010,01,004,0069,91,338 ,4 ,342 ,494 ,0,3,1,3,0,1,0,76.14,69.23 ,33.33
03,010,01,004,0070,92,1183 ,9 ,1192 ,1988 ,0,3,1,3,0,1,0,76.14,59.96 ,33.33
03,010,01,004,0071,93,610 ,5 ,615 ,1012 ,0,3,1,3,0,1,0,76.14,60.77 ,33.33
03,010,01,004,0072,94,1082 ,12 ,1094 ,1853 ,0,3,1,3,0,1,0,76.14,59.04 ,33.33
03,010,01,004,0072,95,799 ,4 ,803 ,1326 ,0,3,1,3,0,1,0,76.14,60.56 ,33.33
03,010,01,004,0072,96,1004 ,4 ,1008 ,1801 ,0,3,1,3,0,1,0,76.14,55.97,33.33
03,010,01,004,0073,97,697 ,11 ,708 ,1132 ,0,3,1,3,0,1,0,76.14,62.54,33.33
03,010,01,004,0074,98,860 ,5 ,865 ,1414 ,0,3,1,3,0,1,0,76.14,61.17 ,33.33
03,010,01,004,0075,99,437 ,2 ,439 ,682 ,0,3,1,3,0,1,0,76.14,64.37 ,33.33
03,010,01,004,0076,100,466 ,3 ,469 ,808 ,0,3,1,3,0,1,0,76.14,58.04 ,33.33
03,010,01,004,0077,101,436 ,2 ,438 ,666 ,0,3,1,3,0,1,0,76.14,65.77 ,33.33
03,010,01,004,0078,102,179 ,1 ,180 ,303 ,0,3,1,3,0,1,0,76.14,59.41 ,33.33
03,010,01,004,0079,103,1126 ,14 ,1140 ,1751 ,0,3,1,3,0,1,0,76.14,65.11 ,33.33
03,010,01,004,0080,104,907 ,11 ,918 ,1458 ,0,3,1,3,0,1,0,76.14,62.96 ,33.33
03,010,01,004,0081,105,688 ,5 ,693 ,1093 ,0,3,1,3,0,1,0,76.14,63.40 ,33.33
03,010,01,004,0081,106,219 ,3 ,222 ,403 ,0,3,1,3,0,1,0,76.14,55.09,33.33
03,010,01,004,0082,107,510 ,3 ,513 ,837 ,0,3,1,3,0,1,0,76.14,61.29,33.33
03,010,01,004,0083,108,900 ,10 ,910 ,1529 ,0,3,1,3,0,1,0,76.14,59.52,33.33
03,010,01,004,0084,109,1137 ,10 ,1147 ,1920 ,0,3,1,3,0,1,0,76.14,59.74 ,33.33
03,010,01,004,0085,110,617 ,5 ,622 ,972 ,0,3,1,3,0,1,0,76.14,63.99 ,33.33
03,010,01,004,0086,111,473 ,0 ,473 ,689 ,0,3,1,3,0,1,0,76.14,68.65 ,33.33
03,010,01,004,0087,112,489 ,1 ,490 ,735 ,0,3,1,3,0,1,0,76.14,66.67 ,33.33
03,010,01,004,0088,113,531 ,6 ,537 ,848 ,0,3,1,3,0,1,0,76.14,63.33 ,33.33
03,010,01,004,0089,114,502 ,3 ,505 ,782 ,0,3,1,3,0,1,0,76.14,64.58 ,33.33
03,010,01,005,0090,115,661 ,6 ,667 ,1090 ,0,3,1,3,0,1,0,76.14,61.19,33.33
03,010,01,005,0090,116,522 ,3 ,525 ,983 ,0,3,1,3,0,1,0,76.14,53.41,33.33
03,010,01,005,0091,117,999 ,7 ,1006 ,1594 ,0,3,1,3,0,1,0,76.14,63.11,33.33
03,010,01,005,0092,118,842 ,13 ,855 ,1508 ,0,3,1,3,0,1,0,76.14,56.70 ,33.33
03,010,01,005,0092,119,928 ,4 ,932 ,1488 ,0,3,1,3,0,1,0,76.14,62.63 ,33.33
03,010,01,005,0093,120,603 ,1 ,604 ,992 ,0,3,1,3,0,1,0,76.14,60.89 ,33.33
03,010,01,005,0093,121,577 ,7 ,584 ,1089 ,0,3,1,3,0,1,0,76.14,53.63 ,33.33
03,010,01,005,0094,122,827 ,9 ,836 ,1357 ,0,3,1,3,0,1,0,76.14,61.61 ,33.33
03,010,01,005,0095,123,1110 ,8 ,1118 ,1791 ,0,3,1,3,0,1,0,76.14,62.42 ,33.33
03,010,01,005,0096,124,812 ,7 ,819 ,1368 ,0,3,1,3,0,1,0,76.14,59.87 ,33.33
03,010,01,005,0097,125,1072 ,12 ,1084 ,1669 ,0,3,1,3,0,1,0,76.14,64.95 ,33.33
03,010,01,005,0098,126,470 ,2 ,472 ,755 ,0,3,1,3,0,1,0,76.14,62.52 ,33.33
03,010,01,005,0099,127,412 ,9 ,421 ,721 ,0,3,1,3,0,1,0,76.14,58.39 ,33.33
03,010,01,005,0100,128,451 ,11 ,462 ,770 ,0,3,1,3,0,1,0,76.14,60.00 ,33.33
03,010,01,005,0101,129,887 ,8 ,895 ,1499 ,0,3,1,3,0,1,0,76.14,59.71 ,33.33
03,010,01,005,0101,130,252 ,1 ,253 ,399 ,0,3,1,3,0,1,0,76.14,63.41 ,33.33
03,010,01,005,0102,131,537 ,4 ,541 ,908 ,0,3,1,3,0,1,0,76.14,59.58 ,33.33
03,010,01,005,0103,132,342 ,3 ,345 ,568 ,0,3,1,3,0,1,0,76.14,60.74,33.33
03,010,01,005,0104,133,532 ,6 ,538 ,912 ,0,3,1,3,0,1,0,76.14,58.99,33.33
03,010,01,005,0105,134,1159 ,9 ,1168 ,2025 ,0,3,1,3,0,1,0,76.14,57.68 ,33.33
03,010,01,005,0105,135,433 ,3 ,436 ,743 ,0,3,1,3,0,1,0,76.14,58.68 ,33.33
03,010,01,005,0105,136,478 ,5 ,483 ,896 ,0,3,1,3,0,1,0,76.14,53.91,33.33
03,010,01,005,0106,137,995 ,10 ,1005 ,1787 ,0,3,1,3,0,1,0,76.14,56.24,33.33
03,010,01,005,0107,138,815 ,8 ,823 ,1532 ,0,3,1,3,0,1,0,76.14,53.72 ,33.33
03,010,01,005,0107,139,695 ,10 ,705 ,1272 ,0,3,1,3,0,1,0,76.14,55.42 ,33.33
03,010,01,005,0107,140,893 ,3 ,896 ,1581 ,0,3,1,3,0,1,0,76.14,56.67 ,33.33
03,010,01,005,0108,141,566 ,4 ,570 ,1022 ,0,3,1,3,0,1,0,76.14,55.77 ,33.33
03,010,01,005,0108,142,656 ,6 ,662 ,1146 ,0,3,1,3,0,1,0,76.14,57.77 ,33.33
03,010,01,005,0109,143,734 ,9 ,743 ,1404 ,0,3,1,3,0,1,0,76.14,52.92 ,33.33
03,010,01,005,0109,144,479 ,5 ,484 ,827 ,0,3,1,3,0,1,0,76.14,58.52,33.33
03,010,01,005,0110,145,895 ,17 ,912 ,1629 ,0,3,1,3,0,1,0,76.14,55.99,33.33
03,010,01,005,0111,146,1016 ,7 ,1023 ,1754 ,0,3,1,3,0,1,0,76.14,58.32,33.33
03,010,01,005,0112,147,697 ,8 ,705 ,1186 ,0,3,1,3,0,1,0,76.14,59.44 ,33.33
03,010,01,005,0112,148,507 ,6 ,513 ,1082 ,0,3,1,3,0,1,0,76.14,47.41 ,33.33
03,010,01,005,0113,149,736 ,18 ,754 ,1242 ,0,3,1,3,0,1,0,76.14,60.71 ,33.33
03,010,01,005,0113,150,750 ,14 ,764 ,1372 ,0,3,1,3,0,1,0,76.14,55.69 ,33.33
03,010,01,005,0114,151,1017 ,12 ,1029 ,1764 ,0,3,1,3,0,1,0,76.14,58.33 ,33.33
03,010,01,005,0115,152,1167 ,10 ,1177 ,2015 ,0,3,1,3,0,1,0,76.14,58.41 ,33.33
03,010,01,005,0116,153,923 ,4 ,927 ,1599 ,0,3,1,3,0,1,0,76.14,57.97 ,33.33
03,010,01,005,0116,154,965 ,11 ,976 ,1872 ,0,3,1,3,0,1,0,76.14,52.14 ,33.33
03,010,01,005,0117,155,766 ,5 ,771 ,1243 ,0,3,1,3,0,1,0,76.14,62.03 ,33.33
03,010,01,006,0118,156,846 ,10 ,856 ,1410 ,0,3,1,3,0,1,0,76.14,60.71 ,33.33
03,010,01,006,0119,157,423 ,5 ,428 ,725 ,0,3,1,3,0,1,0,76.14,59.03 ,33.33
03,010,01,006,0120,158,235 ,0 ,235 ,390 ,0,3,1,3,0,1,0,76.14,60.26 ,33.33
03,010,01,006,0120,159,160 ,1 ,161 ,292 ,0,3,1,3,0,1,0,76.14,55.14 ,33.33
03,010,01,006,0121,160,469 ,4 ,473 ,817 ,0,3,1,3,0,1,0,76.14,57.89 ,33.33
03,010,01,006,0122,161,512 ,6 ,518 ,872 ,0,3,1,3,0,1,0,76.14,59.40 ,33.33
03,010,01,006,0123,162,709 ,2 ,711 ,1236 ,0,3,1,3,0,1,0,76.14,57.52 ,33.33
03,010,01,006,0124,163,533 ,4 ,537 ,930 ,0,3,1,3,0,1,0,76.14,57.74 ,33.33
03,010,01,006,0125,164,350 ,4 ,354 ,591 ,0,3,1,3,0,1,0,76.14,59.90 ,33.33
03,010,01,006,0125,165,246 ,3 ,249 ,398 ,0,3,1,3,0,1,0,76.14,62.56 ,33.33
03,010,01,006,0126,166,607 ,5 ,612 ,1080 ,0,3,1,3,0,1,0,76.14,56.67 ,33.33
03,010,01,006,0127,167,435 ,4 ,439 ,786 ,0,3,1,3,0,1,0,76.14,55.85 ,33.33
03,010,01,006,0128,168,534 ,6 ,540 ,901 ,0,3,1,3,0,1,0,76.14,59.93 ,33.33
03,010,01,006,0128,169,224 ,2 ,226 ,374 ,0,3,1,3,0,1,0,76.14,60.43 ,33.33
03,010,01,006,0129,170,585 ,2 ,587 ,1013 ,0,3,1,3,0,1,0,76.14,57.95 ,33.33
03,010,01,006,0130,171,428 ,3 ,431 ,739 ,0,3,1,3,0,1,0,76.14,58.32,33.33
03,010,01,006,0131,172,548 ,6 ,554 ,868 ,0,3,1,3,0,1,0,76.14,63.82,33.33
03,010,01,007,0132,173,515 ,2 ,517 ,807 ,0,3,1,3,0,1,0,76.14,64.06 ,33.33
03,010,01,007,0132,174,640 ,7 ,647 ,968 ,0,3,1,3,0,1,0,76.14,66.84 ,33.33
03,010,01,007,0133,175,473 ,5 ,478 ,798 ,0,3,1,3,0,1,0,76.14,59.90 ,33.33
03,010,01,007,0133,176,507 ,3 ,510 ,834 ,0,3,1,3,0,1,0,76.14,61.15 ,33.33
03,010,01,007,0134,177,879 ,9 ,888 ,1448 ,0,3,1,3,0,1,0,76.14,61.33,33.33
03,010,01,007,0135,178,911 ,3 ,914 ,1532 ,0,3,1,3,0,1,0,76.14,59.66,33.33
03,010,01,007,0136,179,716 ,6 ,722 ,1170 ,0,3,1,3,0,1,0,76.14,61.71 ,33.33
03,010,01,007,0137,180,466 ,9 ,475 ,786 ,0,3,1,3,0,1,0,76.14,60.43 ,33.33
03,010,01,007,0137,181,453 ,1 ,454 ,729 ,0,3,1,3,0,1,0,76.14,62.28 ,33.33
03,010,01,007,0138,182,416 ,4 ,420 ,717 ,0,3,1,3,0,1,0,76.14,58.58 ,33.33
03,010,01,007,0138,183,564 ,1 ,565 ,897 ,0,3,1,3,0,1,0,76.14,62.99 ,33.33
03,010,01,007,0139,184,581 ,4 ,585 ,970 ,0,3,1,3,0,1,0,76.14,60.31 ,33.33
03,010,01,007,0140,185,517 ,2 ,519 ,888 ,0,3,1,3,0,1,0,76.14,58.45,33.33
03,010,01,007,0140,186,523 ,3 ,526 ,831 ,0,3,1,3,0,1,0,76.14,63.3,33.33
03,010,01,007,0141,187,921 ,7 ,928 ,1436 ,0,3,1,3,0,1,0,76.14,64.62 ,33.33
03,010,01,007,0142,188,847 ,8 ,855 ,1429 ,0,3,1,3,0,1,0,76.14,59.83 ,33.33
03,010,01,007,0143,189,576 ,3 ,579 ,963 ,0,3,1,3,0,1,0,76.14,60.12 ,33.33
03,010,01,007,0144,190,660 ,12 ,672 ,988 ,0,3,1,3,0,1,0,76.14,68.02 ,33.33
03,010,01,007,0145,191,615 ,9 ,624 ,983 ,0,3,1,3,0,1,0,76.14,63.48 ,33.33
03,010,01,007,0146,192,698 ,6 ,704 ,1120 ,0,3,1,3,0,1,0,76.14,62.86 ,33.33
03,010,01,007,0147,193,672 ,3 ,675 ,1148 ,0,3,1,3,0,1,0,76.14,58.80 ,33.33
03,010,01,007,0148,194,645 ,5 ,650 ,1116 ,0,3,1,3,0,1,0,76.14,58.24,33.33
03,010,01,007,0149,195,363 ,8 ,371 ,596 ,0,3,1,3,0,1,0,76.14,62.25,33.33
03,010,01,007,0150,196,498 ,3 ,501 ,848 ,0,3,1,3,0,1,0,76.14,59.08 ,33.33
03,010,01,007,0151,197,388 ,1 ,389 ,598 ,0,3,1,3,0,1,0,76.14,65.05 ,33.33
03,010,01,007,0152,198,588 ,4 ,592 ,942 ,0,3,1,3,0,1,0,76.14,62.85 ,33.33
03,010,01,007,0153,199,350 ,7 ,357 ,580 ,0,3,1,3,0,1,0,76.14,61.55 ,33.33
03,010,01,007,0154,200,351 ,2 ,353 ,500 ,0,3,1,3,0,1,0,76.14,70.60 ,33.33
03,010,01,008,0155,201,743 ,10 ,753 ,1291 ,0,3,1,3,0,1,0,76.14,58.33 ,33.33
03,010,01,008,0156,202,505 ,5 ,510 ,940 ,0,3,1,3,0,1,0,76.14,54.26 ,33.33
03,010,01,008,0157,203,521 ,3 ,524 ,903 ,0,3,1,3,0,1,0,76.14,58.03 ,33.33
03,010,01,008,0158,204,187 ,5 ,192 ,294 ,0,3,1,3,0,1,0,76.14,65.31 ,33.33
03,010,01,008,0159,205,729 ,6 ,735 ,1233 ,0,3,1,3,0,1,0,76.14,59.61 ,33.33
03,010,01,008,0160,206,760 ,5 ,765 ,1287 ,0,3,1,3,0,1,0,76.14,59.44 ,33.33
03,010,01,008,0161,207,528 ,2 ,530 ,895 ,0,3,1,3,0,1,0,76.14,59.22 ,33.33
03,010,01,008,0162,208,422 ,2 ,424 ,745 ,0,3,1,3,0,1,0,76.14,56.91 ,33.33
03,010,01,008,0163,209,339 ,5 ,344 ,587 ,0,3,1,3,0,1,0,76.14,58.60 ,33.33
03,010,01,008,0163,210,91 ,2 ,93 ,192 ,0,3,1,3,0,1,0,76.14,48.44 ,33.33
03,010,01,008,0164,211,147 ,0 ,147 ,250 ,0,3,1,3,0,1,0,76.14,58.80 ,33.33
03,010,01,008,0164,212,164 ,2 ,166 ,282 ,0,3,1,3,0,1,0,76.14,58.87 ,33.33
03,010,01,008,0164,213,236 ,3 ,239 ,380 ,0,3,1,3,0,1,0,76.14,62.89 ,33.33
03,010,01,008,0164,214,302 ,2 ,304 ,519 ,0,3,1,3,0,1,0,76.14,58.57 ,33.33
03,010,01,008,0165,215,343 ,2 ,345 ,628 ,0,3,1,3,0,1,0,76.14,54.94,33.33
03,010,01,008,0166,216,505 ,7 ,512 ,791 ,0,3,1,3,0,1,0,76.14,64.73,33.33
03,010,01,008,0167,217,671 ,6 ,677 ,1085 ,0,3,1,3,0,1,0,76.14,62.40 ,33.33
03,010,01,008,0168,218,562 ,6 ,568 ,919 ,0,3,1,3,0,1,0,76.14,61.81 ,33.33
03,010,01,008,0169,219,582 ,6 ,588 ,991 ,0,3,1,3,0,1,0,76.14,59.33,33.33
03,010,01,008,0170,220,896 ,6 ,902 ,1453 ,0,3,1,3,0,1,0,76.14,62.08,33.33
03,010,01,008,0171,221,399 ,6 ,405 ,719 ,0,3,1,3,0,1,0,76.14,56.33 ,33.33
03,010,01,008,0172,222,274 ,10 ,284 ,561 ,0,3,1,3,0,1,0,76.14,50.62 ,33.33
03,010,01,008,0173,223,434 ,3 ,437 ,758 ,0,3,1,3,0,1,0,76.14,57.65 ,33.33
03,010,01,008,0174,224,492 ,6 ,498 ,954 ,0,3,1,3,0,1,0,76.14,52.20 ,33.33
03,010,01,008,0175,225,488 ,4 ,492 ,879 ,0,3,1,3,0,1,0,76.14,55.97 ,33.33
03,010,01,008,0176,226,328 ,3 ,331 ,630 ,0,3,1,3,0,1,0,76.14,52.54 ,33.33
03,010,01,008,0177,227,460 ,4 ,464 ,787 ,0,3,1,3,0,1,0,76.14,58.96 ,33.33
03,010,01,008,0178,228,505 ,3 ,508 ,838 ,0,3,1,3,0,1,0,76.14,60.62 ,33.33
03,010,01,008,0179,229,233 ,1 ,234 ,429 ,0,3,1,3,0,1,0,76.14,54.55 ,33.33
03,010,01,008,0179,230,101 ,2 ,103 ,184 ,0,3,1,3,0,1,0,76.14,55.98,33.33
03,010,01,009,0180,231,1053 ,10 ,1063 ,1822 ,0,3,1,3,0,1,0,76.14,58.34,33.33
03,010,01,009,0181,232,602 ,8 ,610 ,1016 ,0,3,1,3,0,1,0,76.14,60.04 ,33.33
03,010,01,009,0182,233,996 ,7 ,1003 ,1623 ,0,3,1,3,0,1,0,76.14,61.80 ,33.33
03,010,01,009,0183,234,888 ,9 ,897 ,1475 ,0,3,1,3,0,1,0,76.14,60.81 ,33.33
03,010,01,009,0184,235,755 ,4 ,759 ,1267 ,0,3,1,3,0,1,0,76.14,59.91 ,33.33
03,010,01,009,0185,236,457 ,0 ,457 ,712 ,0,3,1,3,0,1,0,76.14,64.19 ,33.33
03,010,01,009,0186,237,285 ,1 ,286 ,455 ,0,3,1,3,0,1,0,76.14,62.86 ,33.33
03,010,01,009,0187,238,591 ,4 ,595 ,976 ,0,3,1,3,0,1,0,76.14,60.96 ,33.33
03,010,01,009,0188,239,625 ,3 ,628 ,1145 ,0,3,1,3,0,1,0,76.14,54.85 ,33.33
03,010,01,009,0189,240,502 ,4 ,506 ,871 ,0,3,1,3,0,1,0,76.14,58.09 ,33.33
03,010,01,009,0190,241,137 ,0 ,137 ,191 ,0,3,1,3,0,1,0,76.14,71.73 ,33.33
03,010,01,009,0190,242,136 ,0 ,136 ,240 ,0,3,1,3,0,1,0,76.14,56.67 ,33.33
03,010,01,009,0191,243,641 ,8 ,649 ,1076 ,0,3,1,3,0,1,0,76.14,60.32 ,33.33
03,010,01,009,0192,244,215 ,2 ,217 ,381 ,0,3,1,3,0,1,0,76.14,56.96 ,33.33
03,010,01,009,0193,245,640 ,5 ,645 ,1087 ,0,3,1,3,0,1,0,76.14,59.34 ,33.33
03,010,01,009,0193,246,192 ,2 ,194 ,283 ,0,3,1,3,0,1,0,76.14,68.55 ,33.33
03,010,01,009,0194,247,889 ,15 ,904 ,1310 ,0,3,1,3,0,1,0,76.14,69.01 ,33.33
03,010,01,009,0195,248,556 ,9 ,565 ,902 ,0,3,1,3,0,1,0,76.14,62.64 ,33.33
03,010,01,009,0196,249,413 ,9 ,422 ,772 ,0,3,1,3,0,1,0,76.14,54.66 ,33.33
03,010,01,009,0197,250,547 ,11 ,558 ,958 ,0,3,1,3,0,1,0,76.14,58.25 ,33.33
03,010,01,009,0198,251,234 ,1 ,235 ,399 ,0,3,1,3,0,1,0,76.14,58.90 ,33.33
03,010,01,009,0198,252,232 ,3 ,235 ,416 ,0,3,1,3,0,1,0,76.14,56.49 ,33.33
03,010,01,009,0199,253,677 ,11 ,688 ,1138 ,0,3,1,3,0,1,0,76.14,60.46 ,33.33
03,010,01,009,0200,254,619 ,4 ,623 ,995 ,0,3,1,3,0,1,0,76.14,62.61 ,33.33
03,010,01,009,0201,255,769 ,18 ,787 ,1311 ,0,3,1,3,0,1,0,76.14,60.03 ,33.33
03,010,01,009,0202,256,280 ,3 ,283 ,446 ,0,3,1,3,0,1,0,76.14,63.45 ,33.33
03,010,01,009,0202,257,241 ,2 ,243 ,360 ,0,3,1,3,0,1,0,76.14,67.50 ,33.33
03,010,01,010,0203,258,382 ,8 ,390 ,561 ,0,3,1,3,0,1,0,76.14,69.52,33.33
03,010,01,010,0203,259,181 ,2 ,183 ,229 ,0,3,1,3,0,1,0,76.14,79.91,33.33
03,010,01,010,0204,260,1041 ,17 ,1058 ,1532 ,0,3,1,3,0,1,0,76.14,69.06,33.33
03,010,01,010,0205,261,888 ,11 ,899 ,1291 ,0,3,1,3,0,1,0,76.14,69.64 ,33.33
03,010,01,010,0206,262,653 ,6 ,659 ,903 ,0,3,1,3,0,1,0,76.14,72.98 ,33.33
03,010,01,010,0207,263,502 ,9 ,511 ,714 ,0,3,1,3,0,1,0,76.14,71.57 ,33.33
03,010,01,010,0208,264,949 ,9 ,958 ,1305 ,0,3,1,3,0,1,0,76.14,73.41 ,33.33
03,010,01,010,0209,265,277 ,1 ,278 ,429 ,0,3,1,3,0,1,0,76.14,64.8,33.33
03,010,01,010,0210,266,251 ,2 ,253 ,346 ,0,3,1,3,0,1,0,76.14,73.12,33.33
03,010,01,010,0210,267,90 ,0 ,90 ,126 ,0,3,1,3,0,1,0,76.14,71.43 ,33.33
03,010,01,010,0211,268,572 ,13 ,585 ,803 ,0,3,1,3,0,1,0,76.14,72.85 ,33.33
03,010,01,010,0212,269,291 ,3 ,294 ,445 ,0,3,1,3,0,1,0,76.14,66.07 ,33.33
03,010,01,010,0213,270,328 ,3 ,331 ,483 ,0,3,1,3,0,1,0,76.14,68.53 ,33.33
03,010,01,010,0214,271,400 ,8 ,408 ,595 ,0,3,1,3,0,1,0,76.14,68.57 ,33.33
03,010,01,010,0215,272,1031 ,11 ,1042 ,1534 ,0,3,1,3,0,1,0,76.14,67.93 ,33.33
03,010,01,010,0216,273,573 ,5 ,578 ,862 ,0,3,1,3,0,1,0,76.14,67.05,33.33
03,010,01,010,0217,274,633 ,5 ,638 ,891 ,0,3,1,3,0,1,0,76.14,71.6,33.33
03,010,01,010,0218,275,567 ,9 ,576 ,860 ,0,3,1,3,0,1,0,76.14,66.98,33.33
03,010,01,010,0219,276,331 ,5 ,336 ,524 ,0,3,1,3,0,1,0,76.14,64.12,33.33
03,010,01,010,0220,277,421 ,2 ,423 ,585 ,0,3,1,3,0,1,0,76.14,72.31,33.33
03,010,01,010,0221,278,490 ,1 ,491 ,668 ,0,3,1,3,0,1,0,76.14,73.5,33.33
03,010,01,010,0221,279,89 ,2 ,91 ,160 ,0,3,1,3,0,1,0,76.14,56.88,33.33
03,010,01,010,0222,280,312 ,2 ,314 ,475 ,0,3,1,3,0,1,0,76.14,66.11,33.33
03,010,01,010,0223,281,456 ,6 ,462 ,673 ,0,3,1,3,0,1,0,76.14,68.65,33.33
03,010,01,010,0224,282,386 ,6 ,392 ,606 ,0,3,1,3,0,1,0,76.14,64.69,33.33
03,010,01,010,0224,283,89 ,0 ,89 ,144 ,0,3,1,3,0,1,0,76.14,61.81,33.33
03,010,01,011,0225,284,328 ,5 ,333 ,512 ,0,3,1,3,0,1,0,76.14,65.04,33.33
03,010,01,011,0226,285,449 ,2 ,451 ,652 ,0,3,1,3,0,1,0,76.14,69.17,33.33
03,010,01,011,0227,286,858 ,11 ,869 ,1334 ,0,3,1,3,0,1,0,76.14,65.14,33.33
03,010,01,011,0228,287,788 ,6 ,794 ,1163 ,0,3,1,3,0,1,0,76.14,68.27,33.33
03,010,01,011,0229,288,200 ,2 ,202 ,303 ,0,3,1,3,0,1,0,76.14,66.67,33.33
03,010,01,011,0229,289,108 ,0 ,108 ,161 ,0,3,1,3,0,1,0,76.14,67.08,33.33
03,010,01,011,0230,290,735 ,9 ,744 ,1155 ,0,3,1,3,0,1,0,76.14,64.42,33.33
03,010,01,011,0231,291,334 ,3 ,337 ,517 ,0,3,1,3,0,1,0,76.14,65.18,33.33
03,010,01,011,0232,292,561 ,0 ,561 ,903 ,0,3,1,3,0,1,0,76.14,62.13,33.33
03,010,01,011,0233,293,710 ,7 ,717 ,1116 ,0,3,1,3,0,1,0,76.14,64.25,33.33
03,010,01,011,0234,294,679 ,7 ,686 ,1078 ,0,3,1,3,0,1,0,76.14,63.64,33.33
03,010,01,011,0235,295,557 ,1 ,558 ,922 ,0,3,1,3,0,1,0,76.14,60.52,33.33
03,010,01,011,0236,296,455 ,7 ,462 ,698 ,0,3,1,3,0,1,0,76.14,66.19,33.33
03,010,01,011,0236,297,145 ,2 ,147 ,227 ,0,3,1,3,0,1,0,76.14,64.76,33.33
03,010,01,011,0237,298,683 ,8 ,691 ,980 ,0,3,1,3,0,1,0,76.14,70.51,33.33
03,010,01,011,0237,299,231 ,0 ,231 ,322 ,0,3,1,3,0,1,0,76.14,71.74,33.33
03,010,01,011,0238,300,768 ,4 ,772 ,1126 ,0,3,1,3,0,1,0,76.14,68.56,33.33
03,010,01,011,0238,301,278 ,3 ,281 ,402 ,0,3,1,3,0,1,0,76.14,69.9,33.33
03,010,01,011,0239,302,211 ,2 ,213 ,287 ,0,3,1,3,0,1,0,76.14,74.22,33.33
03,010,01,011,0239,303,192 ,2 ,194 ,281 ,0,3,1,3,0,1,0,76.14,69.04,33.33
03,010,01,012,0240,304,377 ,3 ,380 ,610 ,0,3,1,3,0,1,0,76.14,62.3,33.33
03,010,01,012,0240,305,537 ,4 ,541 ,807 ,0,3,1,3,0,1,0,76.14,67.04,33.33
03,010,01,012,0240,306,1077 ,10 ,1087 ,1732 ,0,3,1,3,0,1,0,76.14,62.76,33.33
03,010,01,012,0241,307,1076 ,4 ,1080 ,1645 ,0,3,1,3,0,1,0,76.14,65.65,33.33
03,010,01,012,0241,308,353 ,2 ,355 ,515 ,0,3,1,3,0,1,0,76.14,68.93,33.33
03,010,01,012,0242,309,752 ,10 ,762 ,1131 ,0,3,1,3,0,1,0,76.14,67.37,33.33
03,010,01,012,0242,310,253 ,0 ,253 ,354 ,0,3,1,3,0,1,0,76.14,71.47,33.33
03,010,01,012,0243,311,287 ,3 ,290 ,494 ,0,3,1,3,0,1,0,76.14,58.7,33.33
03,010,01,012,0243,312,716 ,8 ,724 ,1134 ,0,3,1,3,0,1,0,76.14,63.84,33.33
03,010,01,012,0244,313,681 ,9 ,690 ,1126 ,0,3,1,3,0,1,0,76.14,61.28,33.33
03,010,01,012,0244,314,464 ,4 ,468 ,670 ,0,3,1,3,0,1,0,76.14,69.85,33.33
03,010,01,012,0245,315,406 ,10 ,416 ,642 ,0,3,1,3,0,1,0,76.14,64.8,33.33
03,010,01,012,0246,316,415 ,1 ,416 ,539 ,0,3,1,3,0,1,0,76.14,77.18,33.33
03,010,01,012,0246,317,430 ,4 ,434 ,586 ,0,3,1,3,0,1,0,76.14,74.06,33.33
03,010,01,012,0246,318,247 ,3 ,250 ,360 ,0,3,1,3,0,1,0,76.14,69.44,33.33
03,010,01,012,0247,319,1217 ,13 ,1230 ,1954 ,0,3,1,3,0,1,0,76.14,62.95,33.33
03,010,01,012,0248,320,557 ,4 ,561 ,839 ,0,3,1,3,0,1,0,76.14,66.87,33.33
03,010,01,012,0249,321,1304 ,12 ,1316 ,1835 ,0,3,1,3,0,1,0,76.14,71.72,33.33
03,010,01,012,0250,322,702 ,4 ,706 ,1104 ,0,3,1,3,0,1,0,76.14,63.95,33.33
03,010,01,012,0251,323,463 ,3 ,466 ,681 ,0,3,1,3,0,1,0,76.14,68.43,33.33
03,010,01,012,0252,324,392 ,1 ,393 ,529 ,0,3,1,3,0,1,0,76.14,74.29,33.33
03,010,01,012,0253,325,523 ,9 ,532 ,811 ,0,3,1,3,0,1,0,76.14,65.6,33.33
03,010,01,012,0253,326,290 ,3 ,293 ,491 ,0,3,1,3,0,1,0,76.14,59.67,33.33
03,010,01,012,0254,327,849 ,8 ,857 ,1371 ,0,3,1,3,0,1,0,76.14,62.51,33.33
03,010,01,012,0254,328,492 ,8 ,500 ,828 ,0,3,1,3,0,1,0,76.14,60.39,33.33
03,010,01,012,0255,329,1101 ,17 ,1118 ,1727 ,0,3,1,3,0,1,0,76.14,64.74,33.33
03,010,01,012,0256,330,1161 ,10 ,1171 ,1863 ,0,3,1,3,0,1,0,76.14,62.86,33.33
03,010,01,012,0257,331,612 ,11 ,623 ,996 ,0,3,1,3,0,1,0,76.14,62.55,33.33
03,010,01,012,0258,332,968 ,9 ,977 ,1798 ,0,3,1,3,0,1,0,76.14,54.34,33.33
03,010,01,012,0258,333,958 ,11 ,969 ,1825 ,0,3,1,3,0,1,0,76.14,53.1,33.33
03,010,01,012,0259,334,750 ,11 ,761 ,1323 ,0,3,1,3,0,1,0,76.14,57.52,33.33
03,010,01,012,0259,335,906 ,12 ,918 ,1557 ,0,3,1,3,0,1,0,76.14,58.96,33.33
03,010,01,012,0260,336,545 ,8 ,553 ,778 ,0,3,1,3,0,1,0,76.14,71.08,33.33
03,010,01,012,0261,337,1115 ,16 ,1131 ,1848 ,0,3,1,3,0,1,0,76.14,61.2,33.33
03,010,01,012,0262,338,1065 ,12 ,1077 ,1847 ,0,3,1,3,0,1,0,76.14,58.31,33.33
03,010,01,012,0263,339,532 ,4 ,536 ,796 ,0,3,1,3,0,1,0,76.14,67.34,33.33
03,010,01,012,0264,340,665 ,5 ,670 ,1023 ,0,3,1,3,0,1,0,76.14,65.49,33.33
03,010,01,012,0265,341,779 ,7 ,786 ,1315 ,0,3,1,3,0,1,0,76.14,59.77,33.33
03,010,01,013,0266,342,1003 ,7 ,1010 ,1635 ,0,3,1,3,0,1,0,76.14,61.77,33.33
03,010,01,013,0267,343,522 ,7 ,529 ,857 ,0,3,1,3,0,1,0,76.14,61.73,33.33
03,010,01,013,0268,344,475 ,3 ,478 ,749 ,0,3,1,3,0,1,0,76.14,63.82,33.33
03,010,01,013,0269,345,503 ,6 ,509 ,882 ,0,3,1,3,0,1,0,76.14,57.71,33.33
03,010,01,013,0270,346,762 ,4 ,766 ,1353 ,0,3,1,3,0,1,0,76.14,56.61,33.33
03,010,01,013,0271,347,586 ,5 ,591 ,1054 ,0,3,1,3,0,1,0,76.14,56.07,33.33
03,010,01,013,0271,348,824 ,10 ,834 ,1575 ,0,3,1,3,0,1,0,76.14,52.95,33.33
03,010,01,013,0272,349,808 ,4 ,812 ,1517 ,0,3,1,3,0,1,0,76.14,53.53,33.33
03,010,01,013,0272,350,673 ,3 ,676 ,1192 ,0,3,1,3,0,1,0,76.14,56.71,33.33
03,010,01,013,0273,351,1030 ,8 ,1038 ,1822 ,0,3,1,3,0,1,0,76.14,56.97,33.33
03,010,01,013,0273,352,906 ,12 ,918 ,1785 ,0,3,1,3,0,1,0,76.14,51.43,33.33
03,010,01,013,0273,353,1013 ,9 ,1022 ,1975 ,0,3,1,3,0,1,0,76.14,51.75,33.33
03,010,01,013,0274,354,1054 ,11 ,1065 ,2269 ,0,3,1,3,0,1,0,76.14,46.94,33.33
03,010,01,013,0274,355,748 ,12 ,760 ,1568 ,0,3,1,3,0,1,0,76.14,48.47,33.33
03,010,01,013,0274,356,625 ,5 ,630 ,1141 ,0,3,1,3,0,1,0,76.14,55.21,33.33
03,010,01,013,0275,357,1031 ,11 ,1042 ,1690 ,0,3,1,3,0,1,0,76.14,61.66,33.33
03,010,01,013,0276,358,790 ,9 ,799 ,1348 ,0,3,1,3,0,1,0,76.14,59.27,33.33
03,010,01,013,0277,359,881 ,17 ,898 ,1621 ,0,3,1,3,0,1,0,76.14,55.4,33.33
03,010,01,013,0277,360,273 ,3 ,276 ,471 ,0,3,1,3,0,1,0,76.14,58.6,33.33
03,010,01,013,0278,361,644 ,7 ,651 ,1084 ,0,3,1,3,0,1,0,76.14,60.06,33.33
03,010,01,013,0279,362,525 ,3 ,528 ,914 ,0,3,1,3,0,1,0,76.14,57.77,33.33
03,010,01,013,0279,363,211 ,1 ,212 ,304 ,0,3,1,3,0,1,0,76.14,69.74,33.33
03,010,01,013,0280,364,579 ,6 ,585 ,963 ,0,3,1,3,0,1,0,76.14,60.75,33.33
03,010,01,013,0281,365,817 ,10 ,827 ,1333 ,0,3,1,3,0,1,0,76.14,62.04,33.33
03,010,01,013,0281,366,393 ,4 ,397 ,678 ,0,3,1,3,0,1,0,76.14,58.55,33.33
03,010,01,013,0282,367,506 ,7 ,513 ,738 ,0,3,1,3,0,1,0,76.14,69.51,33.33
03,010,01,013,0283,368,355 ,2 ,357 ,636 ,0,3,1,3,0,1,0,76.14,56.13,33.33
03,010,01,013,0284,369,454 ,3 ,457 ,721 ,0,3,1,3,0,1,0,76.14,63.38,33.33
03,010,01,013,0285,370,333 ,5 ,338 ,548 ,0,3,1,3,0,1,0,76.14,61.68,33.33
03,010,01,013,0285,371,343 ,3 ,346 ,556 ,0,3,1,3,0,1,0,76.14,62.23,33.33
03,010,01,013,0286,372,246 ,0 ,246 ,332 ,0,3,1,3,0,1,0,76.14,74.1,33.33
03,010,01,013,0287,373,216 ,3 ,219 ,327 ,0,3,1,3,0,1,0,76.14,66.97,33.33
03,010,01,014,0288,374,639 ,5 ,644 ,1225 ,0,3,1,3,0,1,0,76.14,52.57,33.33
03,010,01,014,0288,375,632 ,4 ,636 ,1099 ,0,3,1,3,0,1,0,76.14,57.87,33.33
03,010,01,014,0289,376,1079 ,11 ,1090 ,1910 ,0,3,1,3,0,1,0,76.14,57.07,33.33
03,010,01,014,0290,377,452 ,5 ,457 ,784 ,0,3,1,3,0,1,0,76.14,58.29,33.33
03,010,01,014,0291,378,532 ,9 ,541 ,872 ,0,3,1,3,0,1,0,76.14,62.04,33.33
03,010,01,014,0292,379,825 ,15 ,840 ,1303 ,0,3,1,3,0,1,0,76.14,64.47,33.33
03,010,01,014,0293,380,378 ,2 ,380 ,553 ,0,3,1,3,0,1,0,76.14,68.72,33.33
03,010,01,014,0294,381,581 ,5 ,586 ,1054 ,0,3,1,3,0,1,0,76.14,55.6,33.33
03,010,01,014,0295,382,705 ,4 ,709 ,1216 ,0,3,1,3,0,1,0,76.14,58.31,33.33
03,010,01,014,0295,383,1019 ,15 ,1034 ,1818 ,0,3,1,3,0,1,0,76.14,56.88,33.33
03,010,01,014,0295,384,893 ,6 ,899 ,1759 ,0,3,1,3,0,1,0,76.14,51.11,33.33
03,010,01,014,0296,385,762 ,9 ,771 ,1270 ,0,3,1,3,0,1,0,76.14,60.71,33.33
03,010,01,014,0297,386,752 ,10 ,762 ,1342 ,0,3,1,3,0,1,0,76.14,56.78,33.33
03,010,01,014,0298,387,960 ,7 ,967 ,1597 ,0,3,1,3,0,1,0,76.14,60.55,33.33
03,010,01,014,0299,388,425 ,4 ,429 ,690 ,0,3,1,3,0,1,0,76.14,62.17,33.33
03,010,01,014,0299,389,660 ,5 ,665 ,1045 ,0,3,1,3,0,1,0,76.14,63.64,33.33
03,010,01,014,0300,390,432 ,1 ,433 ,716 ,0,3,1,3,0,1,0,76.14,60.47,33.33
03,010,01,014,0300,391,188 ,0 ,188 ,336 ,0,3,1,3,0,1,0,76.14,55.95,33.33
03,010,01,014,0301,392,451 ,8 ,459 ,777 ,0,3,1,3,0,1,0,76.14,59.07,33.33
03,010,01,014,0302,393,335 ,2 ,337 ,518 ,0,3,1,3,0,1,0,76.14,65.06,33.33
03,010,01,014,0302,394,231 ,1 ,232 ,395 ,0,3,1,3,0,1,0,76.14,58.73,33.33
03,010,01,014,0303,395,349 ,3 ,352 ,560 ,0,3,1,3,0,1,0,76.14,62.86,33.33
03,010,01,014,0304,396,132 ,1 ,133 ,241 ,0,3,1,3,0,1,0,76.14,55.19,33.33
03,010,01,014,0304,397,896 ,9 ,905 ,1478 ,0,3,1,3,0,1,0,76.14,61.23,33.33
03,010,01,014,0305,398,432 ,12 ,444 ,755 ,0,3,1,3,0,1,0,76.14,58.81,33.33
03,010,01,014,0306,399,288 ,0 ,288 ,473 ,0,3,1,3,0,1,0,76.14,60.89,33.33
03,010,01,014,0307,400,568 ,16 ,584 ,948 ,0,3,1,3,0,1,0,76.14,61.6,33.33
03,010,01,014,0307,401,579 ,3 ,582 ,948 ,0,3,1,3,0,1,0,76.14,61.39,33.33
03,010,01,014,0308,402,478 ,8 ,486 ,875 ,0,3,1,3,0,1,0,76.14,55.54,33.33
03,010,01,014,0308,403,74 ,3 ,77 ,127 ,0,3,1,3,0,1,0,76.14,60.63,33.33
03,010,01,014,0309,404,138 ,2 ,140 ,281 ,0,3,1,3,0,1,0,76.14,49.82,33.33
03,010,01,014,0310,405,199 ,2 ,201 ,423 ,0,3,1,3,0,1,0,76.14,47.52,33.33
03,010,01,014,0310,406,254 ,1 ,255 ,391 ,0,3,1,3,0,1,0,76.14,65.22,33.33
03,010,01,014,0311,407,305 ,2 ,307 ,476 ,0,3,1,3,0,1,0,76.14,64.5,33.33
03,010,01,014,0311,408,155 ,0 ,155 ,300 ,0,3,1,3,0,1,0,76.14,51.67,33.33
03,010,01,015,0312,409,649 ,10 ,659 ,1131 ,0,3,1,3,0,1,0,76.14,58.27,33.33
03,010,01,015,0312,410,633 ,6 ,639 ,1216 ,0,3,1,3,0,1,0,76.14,52.55,33.33
03,010,01,015,0313,411,600 ,2 ,602 ,1006 ,0,3,1,3,0,1,0,76.14,59.84,33.33
03,010,01,015,0314,412,672 ,5 ,677 ,1159 ,0,3,1,3,0,1,0,76.14,58.41,33.33
03,010,01,015,0314,413,686 ,7 ,693 ,1264 ,0,3,1,3,0,1,0,76.14,54.83,33.33
03,010,01,015,0314,414,899 ,7 ,906 ,1484 ,0,3,1,3,0,1,0,76.14,61.05,33.33
03,010,01,015,0315,415,360 ,4 ,364 ,580 ,0,3,1,3,0,1,0,76.14,62.76,33.33
03,010,01,015,0316,416,312 ,0 ,312 ,498 ,0,3,1,3,0,1,0,76.14,62.65,33.33
03,010,01,015,0317,417,385 ,4 ,389 ,673 ,0,3,1,3,0,1,0,76.14,57.8,33.33
03,010,01,015,0318,418,398 ,2 ,400 ,572 ,0,3,1,3,0,1,0,76.14,69.93,33.33
03,010,01,015,0319,419,963 ,11 ,974 ,1698 ,0,3,1,3,0,1,0,76.14,57.36,33.33
03,010,01,015,0320,420,513 ,4 ,517 ,941 ,0,3,1,3,0,1,0,76.14,54.94,33.33
03,010,01,015,0321,421,292 ,5 ,297 ,519 ,0,3,1,3,0,1,0,76.14,57.23,33.33
03,010,01,015,0322,422,267 ,3 ,270 ,440 ,0,3,1,3,0,1,0,76.14,61.36,33.33
03,010,01,015,0323,423,279 ,1 ,280 ,494 ,0,3,1,3,0,1,0,76.14,56.68,33.33
03,010,01,015,0324,424,284 ,1 ,285 ,392 ,0,3,1,3,0,1,0,76.14,72.7,33.33
03,010,01,015,0325,425,263 ,3 ,266 ,465 ,0,3,1,3,0,1,0,76.14,57.2,33.33
03,010,01,015,0326,426,162 ,3 ,165 ,285 ,0,3,1,3,0,1,0,76.14,57.89,33.33
03,010,01,015,0327,427,456 ,4 ,460 ,759 ,0,3,1,3,0,1,0,76.14,60.61,33.33
03,010,01,015,0328,428,447 ,17 ,464 ,729 ,0,3,1,3,0,1,0,76.14,63.65,33.33
03,010,01,015,0329,429,344 ,5 ,349 ,599 ,0,3,1,3,0,1,0,76.14,58.26,33.33
03,010,01,015,0329,430,280 ,2 ,282 ,441 ,0,3,1,3,0,1,0,76.14,63.95,33.33
03,010,01,016,0330,431,637 ,9 ,646 ,1066 ,0,3,1,3,0,1,0,76.14,60.6,33.33
03,010,01,016,0331,432,214 ,1 ,215 ,410 ,0,3,1,3,0,1,0,76.14,52.44,33.33
03,010,01,016,0332,433,470 ,0 ,470 ,821 ,0,3,1,3,0,1,0,76.14,57.25,33.33
03,010,01,016,0333,434,943 ,10 ,953 ,1675 ,0,3,1,3,0,1,0,76.14,56.9,33.33
03,010,01,016,0334,435,482 ,5 ,487 ,831 ,0,3,1,3,0,1,0,76.14,58.6,33.33
03,010,01,016,0335,436,512 ,5 ,517 ,807 ,0,3,1,3,0,1,0,76.14,64.06,33.33
03,010,01,016,0336,437,288 ,2 ,290 ,427 ,0,3,1,3,0,1,0,76.14,67.92,33.33
03,010,01,016,0336,438,299 ,2 ,301 ,403 ,0,3,1,3,0,1,0,76.14,74.69,33.33
03,010,01,016,0337,439,461 ,4 ,465 ,830 ,0,3,1,3,0,1,0,76.14,56.02,33.33
03,010,01,016,0338,440,239 ,2 ,241 ,406 ,0,3,1,3,0,1,0,76.14,59.36,33.33
03,010,01,016,0338,441,289 ,4 ,293 ,547 ,0,3,1,3,0,1,0,76.14,53.56,33.33
03,010,01,016,0339,442,292 ,1 ,293 ,542 ,0,3,1,3,0,1,0,76.14,54.06,33.33
03,010,01,016,0340,443,114 ,1 ,115 ,176 ,0,3,1,3,0,1,0,76.14,65.34,33.33
03,010,01,016,0340,444,117 ,1 ,118 ,232 ,0,3,1,3,0,1,0,76.14,50.86,33.33
03,010,01,017,0341,445,512 ,3 ,515 ,976 ,0,3,1,3,0,1,0,76.14,52.77,33.33
03,010,01,017,0342,446,123 ,0 ,123 ,233 ,0,3,1,3,0,1,0,76.14,52.79,33.33
03,010,01,017,0342,447,130 ,0 ,130 ,236 ,0,3,1,3,0,1,0,76.14,55.08,33.33
03,010,01,017,0343,448,82 ,2 ,84 ,148 ,0,3,1,3,0,1,0,76.14,56.76,33.33
03,010,01,017,0343,449,97 ,1 ,98 ,152 ,0,3,1,3,0,1,0,76.14,64.47,33.33
03,010,01,017,0344,450,176 ,2 ,178 ,330 ,0,3,1,3,0,1,0,76.14,53.94,33.33
03,010,01,017,0344,451,88 ,0 ,88 ,148 ,0,3,1,3,0,1,0,76.14,59.46,33.33
03,010,01,017,0344,452,114 ,0 ,114 ,230 ,0,3,1,3,0,1,0,76.14,49.57,33.33
03,010,01,017,0345,453,199 ,1 ,200 ,376 ,0,3,1,3,0,1,0,76.14,53.19,33.33
03,010,01,018,0346,454,188 ,0 ,188 ,335 ,0,3,1,3,0,1,0,76.14,56.12,33.33
03,010,01,018,0347,455,92 ,0 ,92 ,170 ,0,3,1,3,0,1,0,76.14,54.12,33.33
03,010,01,018,0348,456,85 ,1 ,86 ,210 ,0,3,1,3,0,1,0,76.14,40.95,33.33
03,010,01,018,0349,457,132 ,2 ,134 ,238 ,0,3,1,3,0,1,0,76.14,56.3,33.33
03,010,01,018,0349,458,42 ,0 ,42 ,69 ,0,3,1,3,0,1,0,76.14,60.87,33.33
03,010,01,018,0350,459,172 ,4 ,176 ,307 ,0,3,1,3,0,1,0,76.14,57.33,33.33
03,010,01,018,0351,460,5 ,0 ,5 ,19 ,0,3,1,3,0,1,0,76.14,26.32,33.33
03,010,01,018,0352,461,153 ,1 ,154 ,275 ,0,3,1,3,0,1,0,76.14,56,33.33
03,010,01,018,0353,462,40 ,0 ,40 ,115 ,0,3,1,3,0,1,0,76.14,34.78,33.33
03,010,01,018,0354,463,5 ,0 ,5 ,14 ,0,3,1,3,0,1,0,76.14,35.71,33.33
03,010,01,018,0355,464,8 ,0 ,8 ,30 ,0,3,1,3,0,1,0,76.14,26.67,33.33
03,010,01,018,0356,465,9 ,0 ,9 ,21 ,0,3,1,3,0,1,0,76.14,42.86,33.33
03,010,01,018,0357,466,49 ,1 ,50 ,89 ,0,3,1,3,0,1,0,76.14,56.18,33.33
03,011,01,001,0001,1,834 ,2 ,836 ,1518 ,0,3,1,3,0,1,0,76.14,55.07 ,33.33
03,011,01,001,0001,2,818 ,4 ,822 ,1392 ,0,3,1,3,0,1,0,76.14,59.05 ,33.33
03,011,01,001,0001,3,886 ,7 ,893 ,1541 ,0,3,1,3,0,1,0,76.14,57.95 ,33.33
03,011,01,001,0002,4,740 ,3 ,743 ,1215 ,0,3,1,3,0,1,0,76.14,61.15 ,33.33
03,011,01,001,0002,5,711 ,4 ,715 ,1184 ,0,3,1,3,0,1,0,76.14,60.39 ,33.33
03,011,01,001,0003,6,749 ,29 ,778 ,1338 ,0,3,1,3,0,1,0,76.14,58.15 ,33.33
03,011,01,001,0003,7,787 ,7 ,794 ,1370 ,0,3,1,3,0,1,0,76.14,57.96 ,33.33
03,011,01,001,0004,8,505 ,2 ,507 ,863 ,0,3,1,3,0,1,0,76.14,58.75 ,33.33
03,011,01,001,0005,9,795 ,6 ,801 ,1253 ,0,3,1,3,0,1,0,76.14,63.93 ,33.33
03,011,01,001,0006,10,647 ,5 ,652 ,986 ,0,3,1,3,0,1,0,76.14,66.13 ,33.33
03,011,01,001,0007,11,583 ,4 ,587 ,1028 ,0,3,1,3,0,1,0,76.14,57.10 ,33.33
03,011,01,001,0007,12,533 ,6 ,539 ,941 ,0,3,1,3,0,1,0,76.14,57.28 ,33.33
03,011,01,001,0007,13,681 ,5 ,686 ,1166 ,0,3,1,3,0,1,0,76.14,58.83 ,33.33
03,011,01,001,0008,14,674 ,8 ,682 ,1160 ,0,3,1,3,0,1,0,76.14,58.79 ,33.33
03,011,01,001,0008,15,677 ,6 ,683 ,1219 ,0,3,1,3,0,1,0,76.14,56.03 ,33.33
03,011,01,001,0008,16,677 ,3 ,680 ,1190 ,0,3,1,3,0,1,0,76.14,57.14 ,33.33
03,011,01,001,0008,17,775 ,4 ,779 ,1332 ,0,3,1,3,0,1,0,76.14,58.48 ,33.33
03,011,01,001,0008,18,1024 ,6 ,1030 ,1746 ,0,3,1,3,0,1,0,76.14,58.99 ,33.33
03,011,01,001,0009,19,627 ,3 ,630 ,1078 ,0,3,1,3,0,1,0,76.14,58.44 ,33.33
03,011,01,001,0010,20,840 ,8 ,848 ,1434 ,0,3,1,3,0,1,0,76.14,59.14 ,33.33
03,011,01,001,0011,21,270 ,3 ,273 ,444 ,0,3,1,3,0,1,0,76.14,61.49 ,33.33
03,011,01,001,0012,22,710 ,3 ,713 ,1138 ,0,3,1,3,0,1,0,76.14,62.65 ,33.33
03,011,01,001,0012,23,698 ,6 ,704 ,1233 ,0,3,1,3,0,1,0,76.14,57.10 ,33.33
03,011,01,001,0013,24,883 ,7 ,890 ,1509 ,0,3,1,3,0,1,0,76.14,58.98 ,33.33
03,011,01,001,0014,25,831 ,10 ,841 ,1519 ,0,3,1,3,0,1,0,76.14,55.37 ,33.33
03,011,01,001,0014,26,897 ,3 ,900 ,1563 ,0,3,1,3,0,1,0,76.14,57.58 ,33.33
03,011,01,001,0015,27,945 ,6 ,951 ,1701 ,0,3,1,3,0,1,0,76.14,55.91 ,33.33
03,011,01,001,0015,28,950 ,10 ,960 ,1782 ,0,3,1,3,0,1,0,76.14,53.87 ,33.33
03,011,01,001,0016,29,733 ,10 ,743 ,1255 ,0,3,1,3,0,1,0,76.14,59.20 ,33.33
03,011,01,001,0016,30,837 ,5 ,842 ,1600 ,0,3,1,3,0,1,0,76.14,52.63 ,33.33
03,011,01,001,0017,31,618 ,4 ,622 ,1041 ,0,3,1,3,0,1,0,76.14,59.75 ,33.33
03,011,01,001,0017,32,680 ,3 ,683 ,1240 ,0,3,1,3,0,1,0,76.14,55.08 ,33.33
03,011,01,001,0017,33,924 ,9 ,933 ,1737 ,0,3,1,3,0,1,0,76.14,53.71 ,33.33
03,011,01,001,0018,34,971 ,5 ,976 ,1594 ,0,3,1,3,0,1,0,76.14,61.23 ,33.33
03,011,01,001,0019,35,798 ,10 ,808 ,1296 ,0,3,1,3,0,1,0,76.14,62.35 ,33.33
03,011,01,001,0020,36,915 ,5 ,920 ,1482 ,0,3,1,3,0,1,0,76.14,62.08 ,33.33
03,011,01,001,0021,37,1001 ,6 ,1007 ,1594 ,0,3,1,3,0,1,0,76.14,63.17 ,33.33
03,011,01,001,0022,38,895 ,7 ,902 ,1400 ,0,3,1,3,0,1,0,76.14,64.43 ,33.33
03,011,01,001,0022,39,913 ,4 ,917 ,1680 ,0,3,1,3,0,1,0,76.14,54.58 ,33.33
03,011,01,001,0023,40,851 ,9 ,860 ,1499 ,0,3,1,3,0,1,0,76.14,57.37 ,33.33
03,011,01,001,0024,41,205 ,1 ,206 ,359 ,0,3,1,3,0,1,0,76.14,57.38 ,33.33
03,011,01,001,0025,42,331 ,2 ,333 ,444 ,0,3,1,3,0,1,0,76.14,75.00 ,33.33
03,011,01,001,0026,43,480 ,4 ,484 ,734 ,0,3,1,3,0,1,0,76.14,65.94 ,33.33
03,011,01,001,0027,44,647 ,9 ,656 ,997 ,0,3,1,3,0,1,0,76.14,65.80 ,33.33
03,011,01,001,0028,45,389 ,8 ,397 ,587 ,0,3,1,3,0,1,0,76.14,67.63 ,33.33
03,011,01,002,0029,46,598 ,1 ,599 ,925 ,0,3,1,3,0,1,0,76.14,64.76 ,33.33
03,011,01,002,0029,47,310 ,1 ,311 ,486 ,0,3,1,3,0,1,0,76.14,63.99 ,33.33
03,011,01,002,0030,48,389 ,3 ,392 ,619 ,0,3,1,3,0,1,0,76.14,63.33 ,33.33
03,011,01,002,0031,49,275 ,3 ,278 ,379 ,0,3,1,3,0,1,0,76.14,73.35 ,33.33
03,011,01,002,0032,50,374 ,4 ,378 ,551 ,0,3,1,3,0,1,0,76.14,68.60 ,33.33
03,011,01,002,0033,51,341 ,4 ,345 ,532 ,0,3,1,3,0,1,0,76.14,64.85 ,33.33
03,011,01,002,0034,52,246 ,3 ,249 ,391 ,0,3,1,3,0,1,0,76.14,63.68 ,33.33
03,011,01,002,0035,53,503 ,2 ,505 ,784 ,0,3,1,3,0,1,0,76.14,64.41 ,33.33
03,011,01,002,0036,54,431 ,6 ,437 ,755 ,0,3,1,3,0,1,0,76.14,57.88 ,33.33
03,011,01,002,0036,55,659 ,2 ,661 ,1194 ,0,3,1,3,0,1,0,76.14,55.36 ,33.33
03,011,01,002,0036,56,670 ,5 ,675 ,1313 ,0,3,1,3,0,1,0,76.14,51.41 ,33.33
03,011,01,002,0037,57,517 ,6 ,523 ,768 ,0,3,1,3,0,1,0,76.14,68.10 ,33.33
03,011,01,002,0038,58,588 ,8 ,596 ,968 ,0,3,1,3,0,1,0,76.14,61.57 ,33.33
03,011,01,002,0039,59,590 ,4 ,594 ,1082 ,0,3,1,3,0,1,0,76.14,54.90 ,33.33
03,011,01,002,0039,60,717 ,8 ,725 ,1195 ,0,3,1,3,0,1,0,76.14,60.67 ,33.33
03,011,01,002,0039,61,636 ,7 ,643 ,1006 ,0,3,1,3,0,1,0,76.14,63.92 ,33.33
03,011,01,002,0040,62,500 ,2 ,502 ,777 ,0,3,1,3,0,1,0,76.14,64.61 ,33.33
03,011,01,002,0041,63,488 ,5 ,493 ,769 ,0,3,1,3,0,1,0,76.14,64.11 ,33.33
03,011,01,002,0042,64,559 ,5 ,564 ,879 ,0,3,1,3,0,1,0,76.14,64.16 ,33.33
03,011,01,002,0042,65,477 ,4 ,481 ,754 ,0,3,1,3,0,1,0,76.14,63.79 ,33.33
03,011,01,002,0043,66,302 ,3 ,305 ,490 ,0,3,1,3,0,1,0,76.14,62.24 ,33.33
03,011,01,002,0044,67,221 ,4 ,225 ,297 ,0,3,1,3,0,1,0,76.14,75.76 ,33.33
03,011,01,002,0045,68,431 ,4 ,435 ,670 ,0,3,1,3,0,1,0,76.14,64.93 ,33.33
03,011,01,002,0046,69,274 ,1 ,275 ,474 ,0,3,1,3,0,1,0,76.14,58.02 ,33.33
03,011,01,002,0047,70,533 ,3 ,536 ,785 ,0,3,1,3,0,1,0,76.14,68.28 ,33.33
03,011,01,002,0048,71,284 ,3 ,287 ,416 ,0,3,1,3,0,1,0,76.14,68.99 ,33.33
03,011,01,002,0049,72,181 ,3 ,184 ,272 ,0,3,1,3,0,1,0,76.14,67.65 ,33.33
03,011,01,002,0050,73,273 ,0 ,273 ,374 ,0,3,1,3,0,1,0,76.14,72.99 ,33.33
03,011,01,002,0051,74,261 ,1 ,262 ,411 ,0,3,1,3,0,1,0,76.14,63.75 ,33.33
03,011,01,002,0052,75,359 ,2 ,361 ,545 ,0,3,1,3,0,1,0,76.14,66.24 ,33.33
03,011,01,002,0053,76,636 ,7 ,643 ,949 ,0,3,1,3,0,1,0,76.14,67.76 ,33.33
03,011,01,003,0054,77,720 ,8 ,728 ,1212 ,0,3,1,3,0,1,0,76.14,60.07 ,33.33
03,011,01,003,0054,78,357 ,5 ,362 ,589 ,0,3,1,3,0,1,0,76.14,61.46 ,33.33
03,011,01,003,0055,79,471 ,4 ,475 ,786 ,0,3,1,3,0,1,0,76.14,60.43 ,33.33
03,011,01,003,0055,80,685 ,2 ,687 ,1096 ,0,3,1,3,0,1,0,76.14,62.68 ,33.33
03,011,01,003,0055,81,576 ,5 ,581 ,937 ,0,3,1,3,0,1,0,76.14,62.01 ,33.33
03,011,01,003,0056,82,934 ,6 ,940 ,1471 ,0,3,1,3,0,1,0,76.14,63.90 ,33.33
03,011,01,003,0057,83,483 ,3 ,486 ,748 ,0,3,1,3,0,1,0,76.14,64.97 ,33.33
03,011,01,003,0057,84,485 ,4 ,489 ,810 ,0,3,1,3,0,1,0,76.14,60.37 ,33.33
03,011,01,003,0058,85,575 ,2 ,577 ,859 ,0,3,1,3,0,1,0,76.14,67.17 ,33.33
03,011,01,003,0059,86,487 ,3 ,490 ,830 ,0,3,1,3,0,1,0,76.14,59.04 ,33.33
03,011,01,003,0059,87,298 ,6 ,304 ,530 ,0,3,1,3,0,1,0,76.14,57.36 ,33.33
03,011,01,003,0060,88,315 ,3 ,318 ,455 ,0,3,1,3,0,1,0,76.14,69.89 ,33.33
03,011,01,003,0061,89,365 ,6 ,371 ,622 ,0,3,1,3,0,1,0,76.14,59.65 ,33.33
03,011,01,003,0062,90,298 ,5 ,303 ,460 ,0,3,1,3,0,1,0,76.14,65.87 ,33.33
03,011,01,003,0063,91,335 ,0 ,335 ,646 ,0,3,1,3,0,1,0,76.14,51.86 ,33.33
03,011,01,003,0064,92,474 ,6 ,480 ,794 ,0,3,1,3,0,1,0,76.14,60.45 ,33.33
03,011,01,003,0064,93,265 ,1 ,266 ,433 ,0,3,1,3,0,1,0,76.14,61.43 ,33.33
03,011,01,003,0065,94,429 ,4 ,433 ,743 ,0,3,1,3,0,1,0,76.14,58.28 ,33.33
03,011,01,003,0065,95,323 ,5 ,328 ,549 ,0,3,1,3,0,1,0,76.14,59.74 ,33.33
03,011,01,003,0065,96,337 ,8 ,345 ,581 ,0,3,1,3,0,1,0,76.14,59.38 ,33.33
03,011,01,003,0066,97,792 ,6 ,798 ,1235 ,0,3,1,3,0,1,0,76.14,64.62 ,33.33
03,011,01,003,0067,98,927 ,5 ,932 ,1406 ,0,3,1,3,0,1,0,76.14,66.29 ,33.33
03,011,01,003,0068,99,581 ,4 ,585 ,870 ,0,3,1,3,0,1,0,76.14,67.24 ,33.33
03,011,01,003,0069,100,462 ,5 ,467 ,681 ,0,3,1,3,0,1,0,76.14,68.58 ,33.33
03,011,01,003,0070,101,581 ,9 ,590 ,883 ,0,3,1,3,0,1,0,76.14,66.82 ,33.33
03,011,01,003,0071,102,579 ,4 ,583 ,932 ,0,3,1,3,0,1,0,76.14,62.55 ,33.33
03,011,01,003,0072,103,500 ,2 ,502 ,782 ,0,3,1,3,0,1,0,76.14,64.19 ,33.33
03,011,01,003,0073,104,784 ,7 ,791 ,1257 ,0,3,1,3,0,1,0,76.14,62.93 ,33.33
03,011,01,003,0074,105,474 ,5 ,479 ,704 ,0,3,1,3,0,1,0,76.14,68.04 ,33.33
03,011,01,003,0075,106,515 ,2 ,517 ,774 ,0,3,1,3,0,1,0,76.14,66.80 ,33.33
03,011,01,003,0076,107,557 ,1 ,558 ,913 ,0,3,1,3,0,1,0,76.14,61.12 ,33.33
03,011,01,003,0077,108,380 ,5 ,385 ,658 ,0,3,1,3,0,1,0,76.14,58.51 ,33.33
03,011,01,004,0078,109,476 ,4 ,480 ,795 ,0,3,1,3,0,1,0,76.14,60.38 ,33.33
03,011,01,004,0078,110,444 ,5 ,449 ,750 ,0,3,1,3,0,1,0,76.14,59.87 ,33.33
03,011,01,004,0079,111,529 ,2 ,531 ,810 ,0,3,1,3,0,1,0,76.14,65.56 ,33.33
03,011,01,004,0079,112,632 ,8 ,640 ,1005 ,0,3,1,3,0,1,0,76.14,63.68 ,33.33
03,011,01,004,0080,113,494 ,4 ,498 ,717 ,0,3,1,3,0,1,0,76.14,69.46 ,33.33
03,011,01,004,0081,114,752 ,8 ,760 ,1224 ,0,3,1,3,0,1,0,76.14,62.09 ,33.33
03,011,01,004,0081,115,788 ,0 ,788 ,1270 ,0,3,1,3,0,1,0,76.14,62.05 ,33.33
03,011,01,004,0082,116,850 ,5 ,855 ,1291 ,0,3,1,3,0,1,0,76.14,66.23 ,33.33
03,011,01,004,0083,117,271 ,1 ,272 ,458 ,0,3,1,3,0,1,0,76.14,59.39 ,33.33
03,011,01,004,0083,118,203 ,3 ,206 ,313 ,0,3,1,3,0,1,0,76.14,65.81 ,33.33
03,011,01,004,0084,119,526 ,5 ,531 ,808 ,0,3,1,3,0,1,0,76.14,65.72 ,33.33
03,011,01,004,0084,120,433 ,5 ,438 ,702 ,0,3,1,3,0,1,0,76.14,62.39 ,33.33
03,011,01,004,0085,121,497 ,1 ,498 ,759 ,0,3,1,3,0,1,0,76.14,65.61 ,33.33
03,011,01,004,0085,122,469 ,6 ,475 ,733 ,0,3,1,3,0,1,0,76.14,64.80 ,33.33
03,011,01,004,0085,123,204 ,3 ,207 ,292 ,0,3,1,3,0,1,0,76.14,70.89 ,33.33
03,011,01,004,0086,124,433 ,2 ,435 ,693 ,0,3,1,3,0,1,0,76.14,62.77 ,33.33
03,011,01,004,0086,125,472 ,2 ,474 ,716 ,0,3,1,3,0,1,0,76.14,66.20 ,33.33
03,011,01,004,0087,126,431 ,4 ,435 ,666 ,0,3,1,3,0,1,0,76.14,65.32 ,33.33
03,011,01,004,0088,127,725 ,5 ,730 ,1177 ,0,3,1,3,0,1,0,76.14,62.02 ,33.33
03,011,01,004,0088,128,158 ,1 ,159 ,214 ,0,3,1,3,0,1,0,76.14,74.30 ,33.33
03,011,01,004,0089,129,651 ,4 ,655 ,1102 ,0,3,1,3,0,1,0,76.14,59.44 ,33.33
03,011,01,004,0089,130,112 ,0 ,112 ,153 ,0,3,1,3,0,1,0,76.14,73.20 ,33.33
03,011,01,004,0090,131,574 ,9 ,583 ,962 ,0,3,1,3,0,1,0,76.14,60.60 ,33.33
03,011,01,004,0090,132,349 ,1 ,350 ,493 ,0,3,1,3,0,1,0,76.14,70.99 ,33.33
03,011,01,004,0090,133,123 ,2 ,125 ,195 ,0,3,1,3,0,1,0,76.14,64.10 ,33.33
03,011,01,005,0091,134,443 ,5 ,448 ,688 ,0,3,1,3,0,1,0,76.14,65.12 ,33.33
03,011,01,005,0091,135,562 ,5 ,567 ,838 ,0,3,1,3,0,1,0,76.14,67.66 ,33.33
03,011,01,005,0092,136,483 ,4 ,487 ,765 ,0,3,1,3,0,1,0,76.14,63.66 ,33.33
03,011,01,005,0092,137,326 ,4 ,330 ,530 ,0,3,1,3,0,1,0,76.14,62.26 ,33.33
03,011,01,005,0093,138,649 ,4 ,653 ,1021 ,0,3,1,3,0,1,0,76.14,63.96 ,33.33
03,011,01,005,0093,139,149 ,1 ,150 ,232 ,0,3,1,3,0,1,0,76.14,64.66 ,33.33
03,011,01,005,0094,140,392 ,3 ,395 ,600 ,0,3,1,3,0,1,0,76.14,65.83 ,33.33
03,011,01,005,0094,141,466 ,2 ,468 ,733 ,0,3,1,3,0,1,0,76.14,63.85 ,33.33
03,011,01,005,0095,142,711 ,5 ,716 ,1180 ,0,3,1,3,0,1,0,76.14,60.68 ,33.33
03,011,01,005,0096,143,747 ,9 ,756 ,1278 ,0,3,1,3,0,1,0,76.14,59.15 ,33.33
03,011,01,005,0097,144,475 ,3 ,478 ,800 ,0,3,1,3,0,1,0,76.14,59.75 ,33.33
03,011,01,005,0098,145,333 ,4 ,337 ,479 ,0,3,1,3,0,1,0,76.14,70.35 ,33.33
03,011,01,005,0099,146,298 ,8 ,306 ,550 ,0,3,1,3,0,1,0,76.14,55.64 ,33.33
03,011,01,005,0100,147,489 ,7 ,496 ,777 ,0,3,1,3,0,1,0,76.14,63.84 ,33.33
03,011,01,005,0101,148,282 ,2 ,284 ,448 ,0,3,1,3,0,1,0,76.14,63.39 ,33.33
03,011,01,005,0102,149,366 ,2 ,368 ,581 ,0,3,1,3,0,1,0,76.14,63.34 ,33.33
03,011,01,005,0102,150,331 ,2 ,333 ,548 ,0,3,1,3,0,1,0,76.14,60.77 ,33.33
03,011,01,005,0103,151,372 ,1 ,373 ,545 ,0,3,1,3,0,1,0,76.14,68.44 ,33.33
03,011,01,005,0104,152,632 ,5 ,637 ,1048 ,0,3,1,3,0,1,0,76.14,60.78 ,33.33
03,011,01,005,0105,153,400 ,5 ,405 ,569 ,0,3,1,3,0,1,0,76.14,71.18 ,33.33
03,011,01,005,0106,154,691 ,5 ,696 ,985 ,0,3,1,3,0,1,0,76.14,70.66 ,33.33
03,011,01,005,0106,155,290 ,2 ,292 ,452 ,0,3,1,3,0,1,0,76.14,64.60 ,33.33
03,011,01,005,0107,156,444 ,3 ,447 ,646 ,0,3,1,3,0,1,0,76.14,69.20 ,33.33
03,011,01,005,0107,157,525 ,7 ,532 ,868 ,0,3,1,3,0,1,0,76.14,61.29 ,33.33
03,011,01,005,0108,158,757 ,6 ,763 ,1228 ,0,3,1,3,0,1,0,76.14,62.13 ,33.33
03,011,01,005,0109,159,438 ,5 ,443 ,682 ,0,3,1,3,0,1,0,76.14,64.96 ,33.33
03,011,01,005,0109,160,380 ,0 ,380 ,651 ,0,3,1,3,0,1,0,76.14,58.37 ,33.33
03,011,01,005,0110,161,731 ,13 ,744 ,1163 ,0,3,1,3,0,1,0,76.14,63.97 ,33.33
03,011,01,005,0111,162,484 ,6 ,490 ,813 ,0,3,1,3,0,1,0,76.14,60.27 ,33.33
03,011,01,006,0112,163,783 ,6 ,789 ,1455 ,0,3,1,3,0,1,0,76.14,54.23 ,33.33
03,011,01,006,0113,164,684 ,5 ,689 ,1184 ,0,3,1,3,0,1,0,76.14,58.19 ,33.33
03,011,01,006,0113,165,674 ,7 ,681 ,1170 ,0,3,1,3,0,1,0,76.14,58.21 ,33.33
03,011,01,006,0114,166,431 ,5 ,436 ,777 ,0,3,1,3,0,1,0,76.14,56.11 ,33.33
03,011,01,006,0114,167,443 ,5 ,448 ,765 ,0,3,1,3,0,1,0,76.14,58.56 ,33.33
03,011,01,006,0115,168,589 ,6 ,595 ,1166 ,0,3,1,3,0,1,0,76.14,51.03 ,33.33
03,011,01,006,0116,169,565 ,3 ,568 ,923 ,0,3,1,3,0,1,0,76.14,61.54 ,33.33
03,011,01,006,0117,170,452 ,5 ,457 ,748 ,0,3,1,3,0,1,0,76.14,61.10 ,33.33
03,011,01,006,0117,171,399 ,3 ,402 ,588 ,0,3,1,3,0,1,0,76.14,68.37 ,33.33
03,011,01,006,0118,172,520 ,5 ,525 ,902 ,0,3,1,3,0,1,0,76.14,58.20 ,33.33
03,011,01,006,0119,173,513 ,7 ,520 ,765 ,0,3,1,3,0,1,0,76.14,67.97 ,33.33
03,011,01,006,0119,174,312 ,3 ,315 ,471 ,0,3,1,3,0,1,0,76.14,66.88 ,33.33
03,011,01,006,0119,175,423 ,3 ,426 ,639 ,0,3,1,3,0,1,0,76.14,66.67 ,33.33
03,011,01,006,0120,176,294 ,6 ,300 ,500 ,0,3,1,3,0,1,0,76.14,60.00 ,33.33
03,011,01,006,0121,177,252 ,1 ,253 ,467 ,0,3,1,3,0,1,0,76.14,54.18 ,33.33
03,011,01,006,0122,178,246 ,5 ,251 ,403 ,0,3,1,3,0,1,0,76.14,62.28 ,33.33
03,011,01,006,0123,179,624 ,2 ,626 ,1124 ,0,3,1,3,0,1,0,76.14,55.69 ,33.33
03,011,01,006,0123,180,621 ,4 ,625 ,1177 ,0,3,1,3,0,1,0,76.14,53.10 ,33.33
03,011,01,006,0124,181,108 ,0 ,108 ,773 ,0,3,1,3,0,1,0,76.14,13.97 ,33.33
03,011,01,006,0125,182,625 ,5 ,630 ,1161 ,0,3,1,3,0,1,0,76.14,54.26 ,33.33
03,011,01,006,0126,183,609 ,2 ,611 ,1129 ,0,3,1,3,0,1,0,76.14,54.12 ,33.33
03,011,01,006,0127,184,564 ,3 ,567 ,955 ,0,3,1,3,0,1,0,76.14,59.37 ,33.33
03,011,01,007,0128,185,448 ,0 ,448 ,617 ,0,3,1,3,0,1,0,76.14,72.61 ,33.33
03,011,01,007,0129,186,403 ,1 ,404 ,585 ,0,3,1,3,0,1,0,76.14,69.06 ,33.33
03,011,01,007,0130,187,793 ,4 ,797 ,1193 ,0,3,1,3,0,1,0,76.14,66.81 ,33.33
03,011,01,007,0130,188,583 ,2 ,585 ,923 ,0,3,1,3,0,1,0,76.14,63.38 ,33.33
03,011,01,007,0131,189,767 ,4 ,771 ,1126 ,0,3,1,3,0,1,0,76.14,68.47 ,33.33
03,011,01,007,0131,190,752 ,8 ,760 ,1185 ,0,3,1,3,0,1,0,76.14,64.14 ,33.33
03,011,01,007,0132,191,912 ,7 ,919 ,1408 ,0,3,1,3,0,1,0,76.14,65.27 ,33.33
03,011,01,007,0133,192,611 ,3 ,614 ,967 ,0,3,1,3,0,1,0,76.14,63.50 ,33.33
03,011,01,007,0133,193,590 ,2 ,592 ,940 ,0,3,1,3,0,1,0,76.14,62.98 ,33.33
03,011,01,007,0134,194,886 ,10 ,896 ,1330 ,0,3,1,3,0,1,0,76.14,67.37 ,33.33
03,011,01,007,0135,195,680 ,2 ,682 ,1002 ,0,3,1,3,0,1,0,76.14,68.06 ,33.33
03,011,01,007,0136,196,988 ,11 ,999 ,1489 ,0,3,1,3,0,1,0,76.14,67.09 ,33.33
03,011,01,007,0136,197,1005 ,7 ,1012 ,1489 ,0,3,1,3,0,1,0,76.14,67.97 ,33.33
03,011,01,007,0137,198,773 ,2 ,775 ,1145 ,0,3,1,3,0,1,0,76.14,67.69 ,33.33
03,011,01,007,0138,199,923 ,7 ,930 ,1409 ,0,3,1,3,0,1,0,76.14,66.00 ,33.33
03,011,01,007,0138,200,754 ,8 ,762 ,1122 ,0,3,1,3,0,1,0,76.14,67.91 ,33.33
03,011,01,007,0139,201,459 ,5 ,464 ,660 ,0,3,1,3,0,1,0,76.14,70.30 ,33.33
03,011,01,007,0140,202,510 ,2 ,512 ,738 ,0,3,1,3,0,1,0,76.14,69.38 ,33.33
03,011,01,007,0141,203,436 ,3 ,439 ,655 ,0,3,1,3,0,1,0,76.14,67.02 ,33.33
03,011,01,007,0141,204,1037 ,5 ,1042 ,1586 ,0,3,1,3,0,1,0,76.14,65.70 ,33.33
03,011,01,007,0142,205,1051 ,11 ,1062 ,1555 ,0,3,1,3,0,1,0,76.14,68.30 ,33.33
03,011,01,007,0143,206,635 ,2 ,637 ,952 ,0,3,1,3,0,1,0,76.14,66.91 ,33.33
03,011,01,007,0144,207,911 ,3 ,914 ,1322 ,0,3,1,3,0,1,0,76.14,69.14 ,33.33
03,011,01,007,0145,208,397 ,3 ,400 ,531 ,0,3,1,3,0,1,0,76.14,75.33 ,33.33
03,011,01,007,0146,209,655 ,9 ,664 ,959 ,0,3,1,3,0,1,0,76.14,69.24 ,33.33
03,011,01,007,0147,210,376 ,3 ,379 ,528 ,0,3,1,3,0,1,0,76.14,71.78 ,33.33
03,011,01,007,0148,211,796 ,9 ,805 ,1078 ,0,3,1,3,0,1,0,76.14,74.68 ,33.33
03,011,01,007,0149,212,705 ,4 ,709 ,1037 ,0,3,1,3,0,1,0,76.14,68.37 ,33.33
03,011,01,007,0150,213,394 ,0 ,394 ,627 ,0,3,1,3,0,1,0,76.14,62.84 ,33.33
03,011,01,007,0151,214,440 ,0 ,440 ,666 ,0,3,1,3,0,1,0,76.14,66.07 ,33.33
03,011,01,007,0152,215,516 ,2 ,518 ,741 ,0,3,1,3,0,1,0,76.14,69.91 ,33.33
03,011,01,007,0153,216,643 ,5 ,648 ,935 ,0,3,1,3,0,1,0,76.14,69.30 ,33.33
03,011,01,007,0154,217,581 ,2 ,583 ,842 ,0,3,1,3,0,1,0,76.14,69.24 ,33.33
03,011,01,007,0155,218,564 ,3 ,567 ,839 ,0,3,1,3,0,1,0,76.14,67.58 ,33.33
03,011,01,007,0156,219,752 ,5 ,757 ,1138 ,0,3,1,3,0,1,0,76.14,66.52 ,33.33
03,011,01,008,0157,220,641 ,4 ,645 ,958 ,0,3,1,3,0,1,0,76.14,67.33 ,33.33
03,011,01,008,0158,221,920 ,3 ,923 ,1373 ,0,3,1,3,0,1,0,76.14,67.23 ,33.33
03,011,01,008,0158,222,799 ,1 ,800 ,1260 ,0,3,1,3,0,1,0,76.14,63.49 ,33.33
03,011,01,008,0159,223,725 ,6 ,731 ,1138 ,0,3,1,3,0,1,0,76.14,64.24 ,33.33
03,011,01,008,0160,224,1023 ,8 ,1031 ,1539 ,0,3,1,3,0,1,0,76.14,66.99 ,33.33
03,011,01,008,0161,225,684 ,5 ,689 ,1075 ,0,3,1,3,0,1,0,76.14,64.09 ,33.33
03,011,01,008,0161,226,701 ,7 ,708 ,1105 ,0,3,1,3,0,1,0,76.14,64.07 ,33.33
03,011,01,008,0162,227,664 ,1 ,665 ,1042 ,0,3,1,3,0,1,0,76.14,63.82 ,33.33
03,011,01,008,0162,228,714 ,3 ,717 ,1084 ,0,3,1,3,0,1,0,76.14,66.14 ,33.33
03,011,01,008,0163,229,560 ,2 ,562 ,802 ,0,3,1,3,0,1,0,76.14,70.07 ,33.33
03,011,01,008,0164,230,543 ,1 ,544 ,766 ,0,3,1,3,0,1,0,76.14,71.02 ,33.33
03,011,01,008,0165,231,805 ,9 ,814 ,1220 ,0,3,1,3,0,1,0,76.14,66.72 ,33.33
03,011,01,008,0166,232,726 ,3 ,729 ,1140 ,0,3,1,3,0,1,0,76.14,63.95 ,33.33
03,011,01,008,0167,233,655 ,2 ,657 ,997 ,0,3,1,3,0,1,0,76.14,65.90 ,33.33
03,011,01,008,0167,234,550 ,3 ,553 ,861 ,0,3,1,3,0,1,0,76.14,64.23 ,33.33
03,011,01,008,0168,235,602 ,9 ,611 ,872 ,0,3,1,3,0,1,0,76.14,70.07 ,33.33
03,011,01,008,0169,236,860 ,4 ,864 ,1334 ,0,3,1,3,0,1,0,76.14,64.77 ,33.33
03,011,01,008,0170,237,761 ,4 ,765 ,1173 ,0,3,1,3,0,1,0,76.14,65.22 ,33.33
03,011,01,008,0171,238,846 ,8 ,854 ,1261 ,0,3,1,3,0,1,0,76.14,67.72 ,33.33
03,011,01,009,0172,239,519 ,5 ,524 ,825 ,0,3,1,3,0,1,0,76.14,63.52 ,33.33
03,011,01,009,0172,240,472 ,6 ,478 ,763 ,0,3,1,3,0,1,0,76.14,62.65 ,33.33
03,011,01,009,0172,241,756 ,5 ,761 ,1222 ,0,3,1,3,0,1,0,76.14,62.27 ,33.33
03,011,01,009,0173,242,828 ,8 ,836 ,1394 ,0,3,1,3,0,1,0,76.14,59.97 ,33.33
03,011,01,009,0173,243,722 ,9 ,731 ,1187 ,0,3,1,3,0,1,0,76.14,61.58 ,33.33
03,011,01,009,0174,244,825 ,4 ,829 ,1300 ,0,3,1,3,0,1,0,76.14,63.77 ,33.33
03,011,01,009,0175,245,617 ,8 ,625 ,1023 ,0,3,1,3,0,1,0,76.14,61.09 ,33.33
03,011,01,009,0176,246,574 ,6 ,580 ,889 ,0,3,1,3,0,1,0,76.14,65.24 ,33.33
03,011,01,009,0177,247,560 ,4 ,564 ,904 ,0,3,1,3,0,1,0,76.14,62.39 ,33.33
03,011,01,009,0177,248,588 ,6 ,594 ,998 ,0,3,1,3,0,1,0,76.14,59.52 ,33.33
03,011,01,009,0177,249,630 ,5 ,635 ,1034 ,0,3,1,3,0,1,0,76.14,61.41 ,33.33
03,011,01,009,0178,250,660 ,5 ,665 ,989 ,0,3,1,3,0,1,0,76.14,67.24 ,33.33
03,011,01,009,0178,251,609 ,6 ,615 ,957 ,0,3,1,3,0,1,0,76.14,64.26 ,33.33
03,011,01,009,0179,252,525 ,4 ,529 ,758 ,0,3,1,3,0,1,0,76.14,69.79 ,33.33
03,011,01,009,0179,253,520 ,4 ,524 ,827 ,0,3,1,3,0,1,0,76.14,63.36 ,33.33
03,011,01,009,0180,254,666 ,9 ,675 ,1088 ,0,3,1,3,0,1,0,76.14,62.04 ,33.33
03,011,01,009,0181,255,420 ,4 ,424 ,600 ,0,3,1,3,0,1,0,76.14,70.67 ,33.33
03,011,01,009,0182,256,521 ,6 ,527 ,830 ,0,3,1,3,0,1,0,76.14,63.49 ,33.33
03,011,01,009,0183,257,467 ,2 ,469 ,731 ,0,3,1,3,0,1,0,76.14,64.16 ,33.33
03,011,01,010,0184,258,635 ,3 ,638 ,955 ,0,3,1,3,0,1,0,76.14,66.81 ,33.33
03,011,01,010,0184,259,607 ,9 ,616 ,964 ,0,3,1,3,0,1,0,76.14,63.90 ,33.33
03,011,01,010,0185,260,815 ,11 ,826 ,1312 ,0,3,1,3,0,1,0,76.14,62.96 ,33.33
03,011,01,010,0185,261,758 ,3 ,761 ,1176 ,0,3,1,3,0,1,0,76.14,64.71 ,33.33
03,011,01,010,0186,262,644 ,4 ,648 ,989 ,0,3,1,3,0,1,0,76.14,65.52 ,33.33
03,011,01,010,0187,263,178 ,2 ,180 ,305 ,0,3,1,3,0,1,0,76.14,59.02 ,33.33
03,011,01,010,0188,264,316 ,0 ,316 ,476 ,0,3,1,3,0,1,0,76.14,66.39 ,33.33
03,011,01,010,0189,265,586 ,5 ,591 ,908 ,0,3,1,3,0,1,0,76.14,65.09 ,33.33
03,011,01,010,0189,266,593 ,6 ,599 ,954 ,0,3,1,3,0,1,0,76.14,62.79 ,33.33
03,011,01,010,0190,267,511 ,3 ,514 ,822 ,0,3,1,3,0,1,0,76.14,62.53 ,33.33
03,011,01,010,0190,268,698 ,4 ,702 ,1049 ,0,3,1,3,0,1,0,76.14,66.92 ,33.33
03,011,01,010,0190,269,665 ,5 ,670 ,1030 ,0,3,1,3,0,1,0,76.14,65.05 ,33.33
03,011,01,010,0191,270,624 ,11 ,635 ,1110 ,0,3,1,3,0,1,0,76.14,57.21 ,33.33
03,011,01,010,0192,271,982 ,6 ,988 ,1396 ,0,3,1,3,0,1,0,76.14,70.77 ,33.33
03,011,01,010,0193,272,484 ,4 ,488 ,693 ,0,3,1,3,0,1,0,76.14,70.42 ,33.33
03,011,01,010,0194,273,415 ,2 ,417 ,592 ,0,3,1,3,0,1,0,76.14,70.44 ,33.33
03,011,01,010,0195,274,544 ,1 ,545 ,788 ,0,3,1,3,0,1,0,76.14,69.16 ,33.33
03,011,01,010,0195,275,584 ,5 ,589 ,824 ,0,3,1,3,0,1,0,76.14,71.48 ,33.33
03,011,01,010,0195,276,368 ,3 ,371 ,560 ,0,3,1,3,0,1,0,76.14,66.25 ,33.33
03,011,01,010,0196,277,557 ,5 ,562 ,906 ,0,3,1,3,0,1,0,76.14,62.03 ,33.33
03,011,01,011,0197,278,536 ,3 ,539 ,848 ,0,3,1,3,0,1,0,76.14,63.56 ,33.33
03,011,01,011,0197,279,176 ,2 ,178 ,267 ,0,3,1,3,0,1,0,76.14,66.67 ,33.33
03,011,01,011,0198,280,509 ,5 ,514 ,782 ,0,3,1,3,0,1,0,76.14,65.73 ,33.33
03,011,01,011,0199,281,894 ,10 ,904 ,1525 ,0,3,1,3,0,1,0,76.14,59.28 ,33.33
03,011,01,011,0200,282,662 ,8 ,670 ,1072 ,0,3,1,3,0,1,0,76.14,62.50 ,33.33
03,011,01,011,0201,283,552 ,2 ,554 ,843 ,0,3,1,3,0,1,0,76.14,65.72 ,33.33
03,011,01,011,0202,284,421 ,4 ,425 ,688 ,0,3,1,3,0,1,0,76.14,61.77 ,33.33
03,011,01,011,0203,285,616 ,7 ,623 ,1050 ,0,3,1,3,0,1,0,76.14,59.33 ,33.33
03,011,01,011,0204,286,535 ,2 ,537 ,901 ,0,3,1,3,0,1,0,76.14,59.60 ,33.33
03,011,01,011,0205,287,580 ,3 ,583 ,937 ,0,3,1,3,0,1,0,76.14,62.22 ,33.33
03,011,01,011,0206,288,456 ,4 ,460 ,638 ,0,3,1,3,0,1,0,76.14,72.10 ,33.33
03,011,01,012,0207,289,555 ,4 ,559 ,874 ,0,3,1,3,0,1,0,76.14,63.96 ,33.33
03,011,01,012,0207,290,551 ,7 ,558 ,886 ,0,3,1,3,0,1,0,76.14,62.98 ,33.33
03,011,01,012,0208,291,738 ,5 ,743 ,1240 ,0,3,1,3,0,1,0,76.14,59.92 ,33.33
03,011,01,012,0208,292,942 ,6 ,948 ,1546 ,0,3,1,3,0,1,0,76.14,61.32 ,33.33
03,011,01,012,0209,293,667 ,6 ,673 ,1086 ,0,3,1,3,0,1,0,76.14,61.97 ,33.33
03,011,01,012,0209,294,769 ,4 ,773 ,1234 ,0,3,1,3,0,1,0,76.14,62.64 ,33.33
03,011,01,012,0209,295,725 ,3 ,728 ,1127 ,0,3,1,3,0,1,0,76.14,64.60 ,33.33
03,011,01,012,0209,296,827 ,6 ,833 ,1346 ,0,3,1,3,0,1,0,76.14,61.89 ,33.33
03,011,01,012,0210,297,889 ,5 ,894 ,1447 ,0,3,1,3,0,1,0,76.14,61.78 ,33.33
03,011,01,012,0210,298,887 ,7 ,894 ,1411 ,0,3,1,3,0,1,0,76.14,63.36 ,33.33
03,011,01,012,0210,299,980 ,4 ,984 ,1578 ,0,3,1,3,0,1,0,76.14,62.36 ,33.33
03,011,01,012,0210,300,944 ,8 ,952 ,1620 ,0,3,1,3,0,1,0,76.14,58.77 ,33.33
03,011,01,012,0211,301,746 ,6 ,752 ,1241 ,0,3,1,3,0,1,0,76.14,60.60 ,33.33
03,011,01,012,0211,302,744 ,2 ,746 ,1235 ,0,3,1,3,0,1,0,76.14,60.40 ,33.33
03,011,01,012,0211,303,772 ,5 ,777 ,1342 ,0,3,1,3,0,1,0,76.14,57.90 ,33.33
03,011,01,012,0211,304,1013 ,6 ,1019 ,1699 ,0,3,1,3,0,1,0,76.14,59.98 ,33.33
03,011,01,012,0211,305,757 ,3 ,760 ,1195 ,0,3,1,3,0,1,0,76.14,63.60 ,33.33
03,011,01,012,0211,306,635 ,2 ,637 ,1082 ,0,3,1,3,0,1,0,76.14,58.87 ,33.33
03,011,01,012,0211,307,695 ,1 ,696 ,1345 ,0,3,1,3,0,1,0,76.14,51.75 ,33.33
03,011,01,012,0212,308,680 ,8 ,688 ,1062 ,0,3,1,3,0,1,0,76.14,64.78 ,33.33
03,011,01,012,0212,309,645 ,5 ,650 ,1065 ,0,3,1,3,0,1,0,76.14,61.03 ,33.33
03,011,01,012,0212,310,705 ,3 ,708 ,1172 ,0,3,1,3,0,1,0,76.14,60.41 ,33.33
03,011,01,012,0213,311,650 ,2 ,652 ,1009 ,0,3,1,3,0,1,0,76.14,64.62 ,33.33
03,011,01,012,0213,312,588 ,2 ,590 ,956 ,0,3,1,3,0,1,0,76.14,61.72 ,33.33
03,011,01,012,0214,313,605 ,6 ,611 ,861 ,0,3,1,3,0,1,0,76.14,70.96 ,33.33
03,011,01,012,0215,314,867 ,3 ,870 ,1349 ,0,3,1,3,0,1,0,76.14,64.49 ,33.33
03,011,01,012,0216,315,423 ,4 ,427 ,685 ,0,3,1,3,0,1,0,76.14,62.34 ,33.33
03,011,01,012,0217,316,256 ,1 ,257 ,392 ,0,3,1,3,0,1,0,76.14,65.56 ,33.33
03,011,01,012,0218,317,840 ,8 ,848 ,1371 ,0,3,1,3,0,1,0,76.14,61.85 ,33.33
03,011,01,012,0219,318,431 ,4 ,435 ,693 ,0,3,1,3,0,1,0,76.14,62.77 ,33.33
03,011,01,012,0220,319,570 ,3 ,573 ,855 ,0,3,1,3,0,1,0,76.14,67.02 ,33.33
03,011,01,012,0221,320,598 ,3 ,601 ,958 ,0,3,1,3,0,1,0,76.14,62.73 ,33.33
03,011,01,012,0222,321,699 ,6 ,705 ,1062 ,0,3,1,3,0,1,0,76.14,66.38 ,33.33
03,011,01,012,0223,322,574 ,5 ,579 ,843 ,0,3,1,3,0,1,0,76.14,68.68 ,33.33
03,011,01,012,0224,323,670 ,10 ,680 ,978 ,0,3,1,3,0,1,0,76.14,69.53 ,33.33
03,011,01,012,0225,324,848 ,6 ,854 ,1291 ,0,3,1,3,0,1,0,76.14,66.15 ,33.33
03,011,01,012,0226,325,507 ,1 ,508 ,762 ,0,3,1,3,0,1,0,76.14,66.67 ,33.33
03,011,01,012,0226,326,513 ,1 ,514 ,782 ,0,3,1,3,0,1,0,76.14,65.73 ,33.33
03,011,01,012,0227,327,588 ,4 ,592 ,889 ,0,3,1,3,0,1,0,76.14,66.59 ,33.33
03,011,01,013,0228,328,498 ,2 ,500 ,757 ,0,3,1,3,0,1,0,76.14,66.05 ,33.33
03,011,01,013,0228,329,358 ,2 ,360 ,536 ,0,3,1,3,0,1,0,76.14,67.16 ,33.33
03,011,01,013,0229,330,786 ,5 ,791 ,1299 ,0,3,1,3,0,1,0,76.14,60.89 ,33.33
03,011,01,013,0230,331,329 ,3 ,332 ,510 ,0,3,1,3,0,1,0,76.14,65.10 ,33.33
03,011,01,013,0231,332,564 ,3 ,567 ,911 ,0,3,1,3,0,1,0,76.14,62.24 ,33.33
03,011,01,013,0232,333,391 ,3 ,394 ,581 ,0,3,1,3,0,1,0,76.14,67.81 ,33.33
03,011,01,013,0233,334,762 ,5 ,767 ,1238 ,0,3,1,3,0,1,0,76.14,61.95 ,33.33
03,011,01,013,0233,335,670 ,4 ,674 ,1021 ,0,3,1,3,0,1,0,76.14,66.01 ,33.33
03,011,01,013,0233,336,859 ,4 ,863 ,1369 ,0,3,1,3,0,1,0,76.14,63.04 ,33.33
03,011,01,013,0234,337,918 ,6 ,924 ,1491 ,0,3,1,3,0,1,0,76.14,61.97 ,33.33
03,011,01,013,0235,338,530 ,5 ,535 ,808 ,0,3,1,3,0,1,0,76.14,66.21 ,33.33
03,011,01,013,0235,339,343 ,3 ,346 ,542 ,0,3,1,3,0,1,0,76.14,63.84 ,33.33
03,011,01,013,0236,340,459 ,2 ,461 ,717 ,0,3,1,3,0,1,0,76.14,64.30 ,33.33
03,011,01,013,0236,341,509 ,3 ,512 ,824 ,0,3,1,3,0,1,0,76.14,62.14 ,33.33
03,011,01,013,0237,342,391 ,2 ,393 ,569 ,0,3,1,3,0,1,0,76.14,69.07 ,33.33
03,011,01,013,0238,343,334 ,3 ,337 ,528 ,0,3,1,3,0,1,0,76.14,63.83 ,33.33
03,011,01,013,0239,344,538 ,10 ,548 ,873 ,0,3,1,3,0,1,0,76.14,62.77 ,33.33
03,011,01,013,0240,345,206 ,2 ,208 ,335 ,0,3,1,3,0,1,0,76.14,62.09 ,33.33
03,011,01,013,0241,346,437 ,1 ,438 ,644 ,0,3,1,3,0,1,0,76.14,68.01 ,33.33
03,011,01,013,0242,347,220 ,2 ,222 ,336 ,0,3,1,3,0,1,0,76.14,66.07 ,33.33
03,011,01,013,0243,348,296 ,1 ,297 ,424 ,0,3,1,3,0,1,0,76.14,70.05 ,33.33
03,011,01,013,0244,349,303 ,2 ,305 ,472 ,0,3,1,3,0,1,0,76.14,64.62 ,33.33
03,011,01,013,0245,350,208 ,1 ,209 ,330 ,0,3,1,3,0,1,0,76.14,63.33 ,33.33
03,011,01,013,0246,351,373 ,4 ,377 ,591 ,0,3,1,3,0,1,0,76.14,63.79 ,33.33
03,011,01,013,0246,352,195 ,0 ,195 ,307 ,0,3,1,3,0,1,0,76.14,63.52 ,33.33
03,011,01,013,0247,353,269 ,2 ,271 ,440 ,0,3,1,3,0,1,0,76.14,61.59 ,33.33
03,011,01,013,0248,354,679 ,3 ,682 ,1088 ,0,3,1,3,0,1,0,76.14,62.68 ,33.33
03,011,01,013,0249,355,312 ,2 ,314 ,478 ,0,3,1,3,0,1,0,76.14,65.69 ,33.33
03,011,01,013,0250,356,477 ,1 ,478 ,676 ,0,3,1,3,0,1,0,76.14,70.71 ,33.33
03,011,01,013,0251,357,508 ,4 ,512 ,673 ,0,3,1,3,0,1,0,76.14,76.08 ,33.33
03,011,01,013,0252,358,314 ,3 ,317 ,479 ,0,3,1,3,0,1,0,76.14,66.18 ,33.33
03,011,01,013,0253,359,294 ,4 ,298 ,450 ,0,3,1,3,0,1,0,76.14,66.22 ,33.33
03,011,01,014,0254,360,558 ,8 ,566 ,882 ,0,3,1,3,0,1,0,76.14,64.17 ,33.33
03,011,01,014,0254,361,562 ,5 ,567 ,798 ,0,3,1,3,0,1,0,76.14,71.05 ,33.33
03,011,01,014,0254,362,739 ,13 ,752 ,1126 ,0,3,1,3,0,1,0,76.14,66.79 ,33.33
03,011,01,014,0255,363,842 ,10 ,852 ,1309 ,0,3,1,3,0,1,0,76.14,65.09 ,33.33
03,011,01,014,0255,364,627 ,7 ,634 ,945 ,0,3,1,3,0,1,0,76.14,67.09 ,33.33
03,011,01,014,0255,365,869 ,7 ,876 ,1386 ,0,3,1,3,0,1,0,76.14,63.20 ,33.33
03,011,01,014,0256,366,866 ,11 ,877 ,1318 ,0,3,1,3,0,1,0,76.14,66.54 ,33.33
03,011,01,014,0256,367,463 ,5 ,468 ,649 ,0,3,1,3,0,1,0,76.14,72.11 ,33.33
03,011,01,014,0257,368,655 ,6 ,661 ,999 ,0,3,1,3,0,1,0,76.14,66.17 ,33.33
03,011,01,014,0257,369,274 ,1 ,275 ,384 ,0,3,1,3,0,1,0,76.14,71.61 ,33.33
03,011,01,014,0258,370,498 ,2 ,500 ,744 ,0,3,1,3,0,1,0,76.14,67.20 ,33.33
03,011,01,014,0258,371,526 ,7 ,533 ,794 ,0,3,1,3,0,1,0,76.14,67.13 ,33.33
03,011,01,014,0259,372,909 ,10 ,919 ,1329 ,0,3,1,3,0,1,0,76.14,69.15 ,33.33
03,011,01,014,0260,373,850 ,8 ,858 ,1327 ,0,3,1,3,0,1,0,76.14,64.66 ,33.33
03,011,01,014,0261,374,603 ,8 ,611 ,817 ,0,3,1,3,0,1,0,76.14,74.79 ,33.33
03,011,01,014,0262,375,798 ,4 ,802 ,1196 ,0,3,1,3,0,1,0,76.14,67.06 ,33.33
03,011,01,014,0263,376,818 ,6 ,824 ,1176 ,0,3,1,3,0,1,0,76.14,70.07 ,33.33
03,011,01,014,0264,377,605 ,6 ,611 ,886 ,0,3,1,3,0,1,0,76.14,68.96 ,33.33
03,011,01,014,0265,378,297 ,3 ,300 ,389 ,0,3,1,3,0,1,0,76.14,77.12 ,33.33
03,011,01,014,0266,379,503 ,1 ,504 ,748 ,0,3,1,3,0,1,0,76.14,67.38 ,33.33
03,011,01,015,0267,380,354 ,0 ,354 ,547 ,0,3,1,3,0,1,0,76.14,64.72 ,33.33
03,011,01,015,0268,381,457 ,6 ,463 ,714 ,0,3,1,3,0,1,0,76.14,64.85 ,33.33
03,011,01,015,0269,382,349 ,3 ,352 ,498 ,0,3,1,3,0,1,0,76.14,70.68 ,33.33
03,011,01,015,0270,383,561 ,4 ,565 ,841 ,0,3,1,3,0,1,0,76.14,67.18 ,33.33
03,011,01,015,0271,384,686 ,4 ,690 ,940 ,0,3,1,3,0,1,0,76.14,73.40 ,33.33
03,011,01,015,0272,385,381 ,1 ,382 ,564 ,0,3,1,3,0,1,0,76.14,67.73 ,33.33
03,011,01,015,0273,386,314 ,3 ,317 ,435 ,0,3,1,3,0,1,0,76.14,72.87 ,33.33
03,011,01,015,0274,387,543 ,2 ,545 ,785 ,0,3,1,3,0,1,0,76.14,69.43 ,33.33
03,011,01,015,0275,388,506 ,4 ,510 ,792 ,0,3,1,3,0,1,0,76.14,64.39 ,33.33
03,011,01,015,0275,389,626 ,1 ,627 ,915 ,0,3,1,3,0,1,0,76.14,68.52 ,33.33
03,011,01,015,0276,390,249 ,0 ,249 ,356 ,0,3,1,3,0,1,0,76.14,69.94 ,33.33
03,011,01,015,0277,391,548 ,4 ,552 ,880 ,0,3,1,3,0,1,0,76.14,62.73 ,33.33
03,011,01,015,0278,392,527 ,3 ,530 ,842 ,0,3,1,3,0,1,0,76.14,62.95 ,33.33
03,011,01,015,0279,393,869 ,13 ,882 ,1428 ,0,3,1,3,0,1,0,76.14,61.76 ,33.33
03,011,01,015,0280,394,587 ,4 ,591 ,959 ,0,3,1,3,0,1,0,76.14,61.63 ,33.33
03,011,01,015,0281,395,418 ,2 ,420 ,615 ,0,3,1,3,0,1,0,76.14,68.29 ,33.33
03,011,01,015,0282,396,687 ,6 ,693 ,1045 ,0,3,1,3,0,1,0,76.14,66.32 ,33.33
03,011,01,015,0283,397,392 ,4 ,396 ,570 ,0,3,1,3,0,1,0,76.14,69.47 ,33.33
03,011,01,015,0284,398,517 ,8 ,525 ,724 ,0,3,1,3,0,1,0,76.14,72.51 ,33.33
03,011,01,015,0285,399,694 ,5 ,699 ,1067 ,0,3,1,3,0,1,0,76.14,65.51 ,33.33
03,011,01,015,0286,400,488 ,3 ,491 ,690 ,0,3,1,3,0,1,0,76.14,71.16 ,33.33
03,011,01,015,0287,401,610 ,2 ,612 ,912 ,0,3,1,3,0,1,0,76.14,67.11 ,33.33
03,011,01,015,0288,402,934 ,15 ,949 ,1609 ,0,3,1,3,0,1,0,76.14,58.98 ,33.33
03,011,01,015,0289,403,856 ,5 ,861 ,1319 ,0,3,1,3,0,1,0,76.14,65.28 ,33.33
03,011,01,016,0290,404,670 ,7 ,677 ,970 ,0,3,1,3,0,1,0,76.14,69.79 ,33.33
03,011,01,016,0291,405,850 ,5 ,855 ,1342 ,0,3,1,3,0,1,0,76.14,63.71 ,33.33
03,011,01,016,0292,406,691 ,8 ,699 ,1032 ,0,3,1,3,0,1,0,76.14,67.73 ,33.33
03,011,01,016,0293,407,363 ,2 ,365 ,517 ,0,3,1,3,0,1,0,76.14,70.60 ,33.33
03,011,01,016,0293,408,642 ,3 ,645 ,972 ,0,3,1,3,0,1,0,76.14,66.36 ,33.33
03,011,01,016,0294,409,395 ,3 ,398 ,584 ,0,3,1,3,0,1,0,76.14,68.15 ,33.33
03,011,01,016,0294,410,231 ,4 ,235 ,328 ,0,3,1,3,0,1,0,76.14,71.65 ,33.33
03,011,01,016,0295,411,417 ,3 ,420 ,580 ,0,3,1,3,0,1,0,76.14,72.41 ,33.33
03,011,01,016,0295,412,304 ,3 ,307 ,451 ,0,3,1,3,0,1,0,76.14,68.07 ,33.33
03,011,01,016,0296,413,428 ,3 ,431 ,662 ,0,3,1,3,0,1,0,76.14,65.11 ,33.33
03,011,01,016,0296,414,256 ,3 ,259 ,416 ,0,3,1,3,0,1,0,76.14,62.26 ,33.33
03,011,01,016,0297,415,446 ,2 ,448 ,743 ,0,3,1,3,0,1,0,76.14,60.30 ,33.33
03,011,01,016,0298,416,461 ,1 ,462 ,634 ,0,3,1,3,0,1,0,76.14,72.87 ,33.33
03,011,01,016,0299,417,440 ,2 ,442 ,719 ,0,3,1,3,0,1,0,76.14,61.47 ,33.33
03,011,01,016,0300,418,264 ,1 ,265 ,394 ,0,3,1,3,0,1,0,76.14,67.26 ,33.33
03,011,01,016,0300,419,163 ,1 ,164 ,225 ,0,3,1,3,0,1,0,76.14,72.89 ,33.33
03,011,01,016,0301,420,279 ,1 ,280 ,438 ,0,3,1,3,0,1,0,76.14,63.93 ,33.33
03,011,01,016,0302,421,587 ,1 ,588 ,909 ,0,3,1,3,0,1,0,76.14,64.69 ,33.33
03,011,01,016,0303,422,423 ,4 ,427 ,692 ,0,3,1,3,0,1,0,76.14,61.71 ,33.33
03,011,01,016,0304,423,516 ,0 ,516 ,820 ,0,3,1,3,0,1,0,76.14,62.93 ,33.33
03,011,01,016,0304,424,394 ,2 ,396 ,646 ,0,3,1,3,0,1,0,76.14,61.30 ,33.33
03,011,01,016,0305,425,787 ,5 ,792 ,1268 ,0,3,1,3,0,1,0,76.14,62.46 ,33.33
03,011,01,016,0306,426,494 ,4 ,498 ,861 ,0,3,1,3,0,1,0,76.14,57.84 ,33.33
03,011,01,016,0306,427,680 ,5 ,685 ,1173 ,0,3,1,3,0,1,0,76.14,58.40 ,33.33
03,011,01,016,0307,428,609 ,1 ,610 ,1009 ,0,3,1,3,0,1,0,76.14,60.46 ,33.33
03,011,01,017,0308,429,362 ,6 ,368 ,517 ,0,3,1,3,0,1,0,76.14,71.18 ,33.33
03,011,01,017,0308,430,270 ,5 ,275 ,374 ,0,3,1,3,0,1,0,76.14,73.53 ,33.33
03,011,01,017,0309,431,359 ,2 ,361 ,532 ,0,3,1,3,0,1,0,76.14,67.86 ,33.33
03,011,01,017,0310,432,246 ,4 ,250 ,379 ,0,3,1,3,0,1,0,76.14,65.96 ,33.33
03,011,01,017,0311,433,319 ,3 ,322 ,468 ,0,3,1,3,0,1,0,76.14,68.80 ,33.33
03,011,01,017,0311,434,199 ,1 ,200 ,312 ,0,3,1,3,0,1,0,76.14,64.10 ,33.33
03,011,01,017,0312,435,512 ,6 ,518 ,813 ,0,3,1,3,0,1,0,76.14,63.71 ,33.33
03,011,01,017,0312,436,360 ,4 ,364 ,535 ,0,3,1,3,0,1,0,76.14,68.04 ,33.33
03,011,01,017,0313,437,520 ,5 ,525 ,774 ,0,3,1,3,0,1,0,76.14,67.83 ,33.33
03,011,01,017,0314,438,269 ,1 ,270 ,401 ,0,3,1,3,0,1,0,76.14,67.33 ,33.33
03,011,01,017,0314,439,251 ,1 ,252 ,370 ,0,3,1,3,0,1,0,76.14,68.11 ,33.33
03,011,01,017,0315,440,421 ,1 ,422 ,600 ,0,3,1,3,0,1,0,76.14,70.33 ,33.33
03,011,01,017,0316,441,663 ,0 ,663 ,1055 ,0,3,1,3,0,1,0,76.14,62.84 ,33.33
03,011,01,017,0317,442,441 ,2 ,443 ,675 ,0,3,1,3,0,1,0,76.14,65.63 ,33.33
03,011,01,017,0318,443,445 ,4 ,449 ,647 ,0,3,1,3,0,1,0,76.14,69.40 ,33.33
03,011,01,017,0318,444,336 ,4 ,340 ,523 ,0,3,1,3,0,1,0,76.14,65.01 ,33.33
03,011,01,017,0319,445,440 ,1 ,441 ,696 ,0,3,1,3,0,1,0,76.14,63.36 ,33.33
03,011,01,017,0320,446,459 ,4 ,463 ,689 ,0,3,1,3,0,1,0,76.14,67.20 ,33.33
03,011,01,018,0321,447,437 ,3 ,440 ,713 ,0,3,1,3,0,1,0,76.14,61.71 ,33.33
03,011,01,018,0321,448,568 ,6 ,574 ,922 ,0,3,1,3,0,1,0,76.14,62.26 ,33.33
03,011,01,018,0322,449,544 ,1 ,545 ,950 ,0,3,1,3,0,1,0,76.14,57.37 ,33.33
03,011,01,018,0322,450,664 ,3 ,667 ,1056 ,0,3,1,3,0,1,0,76.14,63.16 ,33.33
03,011,01,018,0322,451,504 ,5 ,509 ,821 ,0,3,1,3,0,1,0,76.14,62.00 ,33.33
03,011,01,018,0322,452,551 ,1 ,552 ,974 ,0,3,1,3,0,1,0,76.14,56.67 ,33.33
03,011,01,018,0323,453,496 ,2 ,498 ,818 ,0,3,1,3,0,1,0,76.14,60.88 ,33.33
03,011,01,018,0323,454,404 ,0 ,404 ,845 ,0,3,1,3,0,1,0,76.14,47.81 ,33.33
03,011,01,018,0324,455,678 ,0 ,678 ,1101 ,0,3,1,3,0,1,0,76.14,61.58 ,33.33
03,011,01,018,0324,456,525 ,7 ,532 ,867 ,0,3,1,3,0,1,0,76.14,61.36 ,33.33
03,011,01,018,0324,457,595 ,7 ,602 ,1047 ,0,3,1,3,0,1,0,76.14,57.50 ,33.33
03,011,01,018,0324,458,496 ,7 ,503 ,799 ,0,3,1,3,0,1,0,76.14,62.95 ,33.33
03,011,01,018,0325,459,285 ,1 ,286 ,437 ,0,3,1,3,0,1,0,76.14,65.45 ,33.33
03,011,01,018,0326,460,365 ,0 ,365 ,614 ,0,3,1,3,0,1,0,76.14,59.45 ,33.33
03,011,01,018,0327,461,287 ,4 ,291 ,441 ,0,3,1,3,0,1,0,76.14,65.99 ,33.33
03,011,01,018,0328,462,622 ,4 ,626 ,983 ,0,3,1,3,0,1,0,76.14,63.68 ,33.33
03,011,01,018,0329,463,520 ,7 ,527 ,849 ,0,3,1,3,0,1,0,76.14,62.07 ,33.33
03,011,01,018,0329,464,681 ,5 ,686 ,1126 ,0,3,1,3,0,1,0,76.14,60.92 ,33.33
03,011,01,018,0329,465,630 ,7 ,637 ,1046 ,0,3,1,3,0,1,0,76.14,60.90 ,33.33
03,011,01,018,0330,466,532 ,3 ,535 ,837 ,0,3,1,3,0,1,0,76.14,63.92 ,33.33
03,011,01,018,0330,467,572 ,3 ,575 ,874 ,0,3,1,3,0,1,0,76.14,65.79 ,33.33
03,011,01,018,0331,468,736 ,8 ,744 ,1175 ,0,3,1,3,0,1,0,76.14,63.32 ,33.33
03,011,01,018,0332,469,598 ,1 ,599 ,903 ,0,3,1,3,0,1,0,76.14,66.33 ,33.33
03,011,01,018,0332,470,410 ,5 ,415 ,600 ,0,3,1,3,0,1,0,76.14,69.17 ,33.33
03,011,01,018,0332,471,570 ,4 ,574 ,992 ,0,3,1,3,0,1,0,76.14,57.86 ,33.33
03,011,01,018,0333,472,691 ,4 ,695 ,1108 ,0,3,1,3,0,1,0,76.14,62.73 ,33.33
03,011,01,018,0333,473,612 ,2 ,614 ,960 ,0,3,1,3,0,1,0,76.14,63.96 ,33.33
03,011,01,018,0334,474,654 ,5 ,659 ,938 ,0,3,1,3,0,1,0,76.14,70.26 ,33.33
03,011,01,018,0334,475,523 ,6 ,529 ,809 ,0,3,1,3,0,1,0,76.14,65.39 ,33.33
03,011,01,018,0335,476,747 ,5 ,752 ,1089 ,0,3,1,3,0,1,0,76.14,69.05 ,33.33
03,011,01,018,0335,477,625 ,10 ,635 ,1047 ,0,3,1,3,0,1,0,76.14,60.65 ,33.33
03,011,01,018,0336,478,858 ,8 ,866 ,1318 ,0,3,1,3,0,1,0,76.14,65.71 ,33.33
03,011,01,018,0337,479,315 ,4 ,319 ,477 ,0,3,1,3,0,1,0,76.14,66.88 ,33.33
03,011,01,018,0338,480,586 ,5 ,591 ,1043 ,0,3,1,3,0,1,0,76.14,56.66 ,33.33
03,011,01,018,0338,481,683 ,5 ,688 ,1047 ,0,3,1,3,0,1,0,76.14,65.71 ,33.33
03,011,01,018,0339,482,509 ,5 ,514 ,847 ,0,3,1,3,0,1,0,76.14,60.68 ,33.33
03,011,01,018,0340,483,664 ,3 ,667 ,1032 ,0,3,1,3,0,1,0,76.14,64.63 ,33.33
03,011,01,019,0341,484,599 ,3 ,602 ,921 ,0,3,1,3,0,1,0,76.14,65.36 ,33.33
03,011,01,019,0342,485,780 ,13 ,793 ,1265 ,0,3,1,3,0,1,0,76.14,62.69 ,33.33
03,011,01,019,0342,486,922 ,3 ,925 ,1492 ,0,3,1,3,0,1,0,76.14,62.00 ,33.33
03,011,01,019,0343,487,647 ,9 ,656 ,1099 ,0,3,1,3,0,1,0,76.14,59.69 ,33.33
03,011,01,019,0343,488,872 ,9 ,881 ,1515 ,0,3,1,3,0,1,0,76.14,58.15 ,33.33
03,011,01,019,0343,489,1003 ,7 ,1010 ,1625 ,0,3,1,3,0,1,0,76.14,62.15 ,33.33
03,011,01,019,0344,490,620 ,5 ,625 ,979 ,0,3,1,3,0,1,0,76.14,63.84 ,33.33
03,011,01,019,0344,491,701 ,6 ,707 ,1173 ,0,3,1,3,0,1,0,76.14,60.27 ,33.33
03,011,01,019,0345,492,785 ,7 ,792 ,1282 ,0,3,1,3,0,1,0,76.14,61.78 ,33.33
03,011,01,019,0346,493,419 ,2 ,421 ,676 ,0,3,1,3,0,1,0,76.14,62.28 ,33.33
03,011,01,019,0347,494,283 ,1 ,284 ,445 ,0,3,1,3,0,1,0,76.14,63.82 ,33.33
03,011,01,019,0348,495,724 ,11 ,735 ,1171 ,0,3,1,3,0,1,0,76.14,62.77 ,33.33
03,011,01,019,0349,496,873 ,3 ,876 ,1248 ,0,3,1,3,0,1,0,76.14,70.19 ,33.33
03,011,01,019,0350,497,812 ,7 ,819 ,1282 ,0,3,1,3,0,1,0,76.14,63.88 ,33.33
03,011,01,019,0350,498,392 ,11 ,403 ,601 ,0,3,1,3,0,1,0,76.14,67.05 ,33.33
03,011,01,019,0351,499,602 ,7 ,609 ,916 ,0,3,1,3,0,1,0,76.14,66.48 ,33.33
03,011,01,019,0352,500,540 ,7 ,547 ,874 ,0,3,1,3,0,1,0,76.14,62.59 ,33.33
03,011,01,019,0352,501,446 ,3 ,449 ,706 ,0,3,1,3,0,1,0,76.14,63.60 ,33.33
03,011,01,019,0353,502,422 ,5 ,427 ,664 ,0,3,1,3,0,1,0,76.14,64.31 ,33.33
03,011,01,019,0354,503,650 ,9 ,659 ,1054 ,0,3,1,3,0,1,0,76.14,62.52 ,33.33
03,011,01,019,0355,504,449 ,10 ,459 ,739 ,0,3,1,3,0,1,0,76.14,62.11 ,33.33
03,011,01,019,0355,505,646 ,8 ,654 ,1021 ,0,3,1,3,0,1,0,76.14,64.05 ,33.33
03,011,01,019,0356,506,573 ,4 ,577 ,861 ,0,3,1,3,0,1,0,76.14,67.02 ,33.33
03,011,01,019,0357,507,615 ,9 ,624 ,999 ,0,3,1,3,0,1,0,76.14,62.46 ,33.33
03,011,01,019,0358,508,883 ,8 ,891 ,1389 ,0,3,1,3,0,1,0,76.14,64.15 ,33.33
03,011,01,019,0359,509,898 ,9 ,907 ,1392 ,0,3,1,3,0,1,0,76.14,65.16 ,33.33
03,011,01,019,0360,510,611 ,5 ,616 ,1027 ,0,3,1,3,0,1,0,76.14,59.98 ,33.33
03,011,01,019,0361,511,778 ,7 ,785 ,1292 ,0,3,1,3,0,1,0,76.14,60.76 ,33.33
03,011,01,019,0361,512,872 ,3 ,875 ,1510 ,0,3,1,3,0,1,0,76.14,57.95 ,33.33
03,011,01,020,0362,513,530 ,4 ,534 ,912 ,0,3,1,3,0,1,0,76.14,58.55 ,33.33
03,011,01,020,0362,514,399 ,6 ,405 ,697 ,0,3,1,3,0,1,0,76.14,58.11 ,33.33
03,011,01,020,0362,515,484 ,6 ,490 ,854 ,0,3,1,3,0,1,0,76.14,57.38 ,33.33
03,011,01,020,0363,516,617 ,3 ,620 ,1045 ,0,3,1,3,0,1,0,76.14,59.33 ,33.33
03,011,01,020,0363,517,675 ,9 ,684 ,1106 ,0,3,1,3,0,1,0,76.14,61.84 ,33.33
03,011,01,020,0363,518,502 ,3 ,505 ,823 ,0,3,1,3,0,1,0,76.14,61.36 ,33.33
03,011,01,020,0363,519,696 ,5 ,701 ,1127 ,0,3,1,3,0,1,0,76.14,62.20 ,33.33
03,011,01,020,0363,520,711 ,0 ,711 ,1251 ,0,3,1,3,0,1,0,76.14,56.83 ,33.33
03,011,01,020,0364,521,525 ,4 ,529 ,866 ,0,3,1,3,0,1,0,76.14,61.09 ,33.33
03,011,01,020,0364,522,718 ,2 ,720 ,1145 ,0,3,1,3,0,1,0,76.14,62.88 ,33.33
03,011,01,020,0365,523,467 ,1 ,468 ,653 ,0,3,1,3,0,1,0,76.14,71.67 ,33.33
03,011,01,020,0366,524,542 ,3 ,545 ,920 ,0,3,1,3,0,1,0,76.14,59.24 ,33.33
03,011,01,020,0367,525,799 ,5 ,804 ,1221 ,0,3,1,3,0,1,0,76.14,65.85 ,33.33
03,011,01,020,0368,526,688 ,3 ,691 ,1053 ,0,3,1,3,0,1,0,76.14,65.62 ,33.33
03,011,01,020,0368,527,461 ,2 ,463 ,680 ,0,3,1,3,0,1,0,76.14,68.09 ,33.33
03,011,01,020,0368,528,442 ,3 ,445 ,695 ,0,3,1,3,0,1,0,76.14,64.03 ,33.33
03,011,01,020,0369,529,650 ,6 ,656 ,1111 ,0,3,1,3,0,1,0,76.14,59.05 ,33.33
03,011,01,020,0369,530,670 ,6 ,676 ,1090 ,0,3,1,3,0,1,0,76.14,62.02 ,33.33
03,011,01,020,0369,531,773 ,5 ,778 ,1234 ,0,3,1,3,0,1,0,76.14,63.05 ,33.33
03,011,01,020,0370,532,485 ,2 ,487 ,753 ,0,3,1,3,0,1,0,76.14,64.67 ,33.33
03,011,01,020,0370,533,484 ,3 ,487 ,782 ,0,3,1,3,0,1,0,76.14,62.28 ,33.33
03,011,01,020,0371,534,476 ,0 ,476 ,771 ,0,3,1,3,0,1,0,76.14,61.74 ,33.33
03,011,01,020,0371,535,718 ,8 ,726 ,1106 ,0,3,1,3,0,1,0,76.14,65.64 ,33.33
03,011,01,020,0371,536,660 ,3 ,663 ,1068 ,0,3,1,3,0,1,0,76.14,62.08 ,33.33
03,011,01,020,0372,537,298 ,4 ,302 ,465 ,0,3,1,3,0,1,0,76.14,64.95 ,33.33
03,011,01,020,0372,538,447 ,4 ,451 ,920 ,0,3,1,3,0,1,0,76.14,49.02 ,33.33
03,011,01,020,0372,539,610 ,2 ,612 ,869 ,0,3,1,3,0,1,0,76.14,70.43 ,33.33
03,011,01,021,0373,540,784 ,9 ,793 ,1187 ,0,3,1,3,0,1,0,76.14,66.81 ,33.33
03,011,01,021,0373,541,552 ,6 ,558 ,865 ,0,3,1,3,0,1,0,76.14,64.51 ,33.33
03,011,01,021,0374,542,632 ,5 ,637 ,996 ,0,3,1,3,0,1,0,76.14,63.96 ,33.33
03,011,01,021,0374,543,486 ,13 ,499 ,802 ,0,3,1,3,0,1,0,76.14,62.22 ,33.33
03,011,01,021,0375,544,888 ,5 ,893 ,1375 ,0,3,1,3,0,1,0,76.14,64.95 ,33.33
03,011,01,021,0376,545,773 ,11 ,784 ,1138 ,0,3,1,3,0,1,0,76.14,68.89 ,33.33
03,011,01,021,0377,546,532 ,3 ,535 ,764 ,0,3,1,3,0,1,0,76.14,70.03 ,33.33
03,011,01,021,0378,547,619 ,3 ,622 ,777 ,0,3,1,3,0,1,0,76.14,80.05 ,33.33
03,011,01,021,0378,548,569 ,7 ,576 ,745 ,0,3,1,3,0,1,0,76.14,77.32 ,33.33
03,011,01,021,0379,549,609 ,16 ,625 ,1025 ,0,3,1,3,0,1,0,76.14,60.98 ,33.33
03,011,01,021,0380,550,653 ,3 ,656 ,1019 ,0,3,1,3,0,1,0,76.14,64.38 ,33.33
03,011,01,021,0380,551,798 ,3 ,801 ,1187 ,0,3,1,3,0,1,0,76.14,67.48 ,33.33
03,011,01,021,0381,552,763 ,8 ,771 ,1219 ,0,3,1,3,0,1,0,76.14,63.25 ,33.33
03,011,01,021,0381,553,636 ,3 ,639 ,990 ,0,3,1,3,0,1,0,76.14,64.55 ,33.33
03,011,01,021,0382,554,427 ,3 ,430 ,636 ,0,3,1,3,0,1,0,76.14,67.61 ,33.33
03,011,01,021,0383,555,871 ,8 ,879 ,1390 ,0,3,1,3,0,1,0,76.14,63.24 ,33.33
03,011,01,021,0384,556,475 ,2 ,477 ,695 ,0,3,1,3,0,1,0,76.14,68.63 ,33.33
03,011,01,021,0385,557,582 ,8 ,590 ,994 ,0,3,1,3,0,1,0,76.14,59.36 ,33.33
03,011,01,021,0385,558,532 ,4 ,536 ,866 ,0,3,1,3,0,1,0,76.14,61.89 ,33.33
03,011,01,021,0386,559,745 ,11 ,756 ,1131 ,0,3,1,3,0,1,0,76.14,66.84 ,33.33
03,011,01,021,0386,560,663 ,7 ,670 ,1120 ,0,3,1,3,0,1,0,76.14,59.82 ,33.33
03,011,01,021,0387,561,646 ,2 ,648 ,909 ,0,3,1,3,0,1,0,76.14,71.29 ,33.33
03,011,01,021,0388,562,368 ,6 ,374 ,504 ,0,3,1,3,0,1,0,76.14,74.21 ,33.33
03,011,01,022,0389,563,576 ,3 ,579 ,886 ,0,3,1,3,0,1,0,76.14,65.35 ,33.33
03,011,01,022,0389,564,561 ,7 ,568 ,917 ,0,3,1,3,0,1,0,76.14,61.94 ,33.33
03,011,01,022,0390,565,495 ,1 ,496 ,741 ,0,3,1,3,0,1,0,76.14,66.94 ,33.33
03,011,01,022,0390,566,560 ,4 ,564 ,817 ,0,3,1,3,0,1,0,76.14,69.03 ,33.33
03,011,01,022,0391,567,559 ,9 ,568 ,873 ,0,3,1,3,0,1,0,76.14,65.06 ,33.33
03,011,01,022,0392,568,508 ,2 ,510 ,775 ,0,3,1,3,0,1,0,76.14,65.81 ,33.33
03,011,01,022,0393,569,378 ,0 ,378 ,559 ,0,3,1,3,0,1,0,76.14,67.62 ,33.33
03,011,01,022,0394,570,255 ,2 ,257 ,358 ,0,3,1,3,0,1,0,76.14,71.79 ,33.33
03,011,01,022,0395,571,218 ,2 ,220 ,371 ,0,3,1,3,0,1,0,76.14,59.30 ,33.33
03,011,01,023,0396,572,599 ,4 ,603 ,903 ,0,3,1,3,0,1,0,76.14,66.78 ,33.33
03,011,01,023,0397,573,603 ,4 ,607 ,1001 ,0,3,1,3,0,1,0,76.14,60.64 ,33.33
03,011,01,023,0397,574,620 ,9 ,629 ,1058 ,0,3,1,3,0,1,0,76.14,59.45 ,33.33
03,011,01,023,0397,575,646 ,4 ,650 ,1026 ,0,3,1,3,0,1,0,76.14,63.35 ,33.33
03,011,01,023,0397,576,601 ,3 ,604 ,1024 ,0,3,1,3,0,1,0,76.14,58.98 ,33.33
03,011,01,023,0398,577,422 ,3 ,425 ,637 ,0,3,1,3,0,1,0,76.14,66.72 ,33.33
03,011,01,023,0398,578,432 ,4 ,436 ,647 ,0,3,1,3,0,1,0,76.14,67.39 ,33.33
03,011,01,023,0399,579,577 ,2 ,579 ,912 ,0,3,1,3,0,1,0,76.14,63.49 ,33.33
03,011,01,023,0399,580,309 ,3 ,312 ,509 ,0,3,1,3,0,1,0,76.14,61.30 ,33.33
03,011,01,023,0400,581,326 ,3 ,329 ,502 ,0,3,1,3,0,1,0,76.14,65.54 ,33.33
03,011,01,023,0401,582,312 ,1 ,313 ,512 ,0,3,1,3,0,1,0,76.14,61.13 ,33.33
03,011,01,023,0402,583,526 ,4 ,530 ,770 ,0,3,1,3,0,1,0,76.14,68.83 ,33.33
03,011,01,023,0403,584,492 ,6 ,498 ,692 ,0,3,1,3,0,1,0,76.14,71.97 ,33.33
03,011,01,023,0403,585,569 ,6 ,575 ,868 ,0,3,1,3,0,1,0,76.14,66.24 ,33.33
03,011,01,023,0404,586,443 ,2 ,445 ,688 ,0,3,1,3,0,1,0,76.14,64.68 ,33.33
03,011,01,023,0405,587,615 ,6 ,621 ,1001 ,0,3,1,3,0,1,0,76.14,62.04 ,33.33
03,011,01,024,0406,588,597 ,6 ,603 ,958 ,0,3,1,3,0,1,0,76.14,62.94 ,33.33
03,011,01,024,0406,589,568 ,6 ,574 ,928 ,0,3,1,3,0,1,0,76.14,61.85 ,33.33
03,011,01,024,0407,590,723 ,6 ,729 ,1265 ,0,3,1,3,0,1,0,76.14,57.63 ,33.33
03,011,01,024,0408,591,482 ,2 ,484 ,808 ,0,3,1,3,0,1,0,76.14,59.90 ,33.33
03,011,01,024,0409,592,646 ,10 ,656 ,1046 ,0,3,1,3,0,1,0,76.14,62.72 ,33.33
03,011,01,024,0410,593,644 ,2 ,646 ,1000 ,0,3,1,3,0,1,0,76.14,64.60 ,33.33
03,011,01,024,0411,594,464 ,3 ,467 ,712 ,0,3,1,3,0,1,0,76.14,65.59 ,33.33
03,011,01,024,0412,595,698 ,7 ,705 ,1052 ,0,3,1,3,0,1,0,76.14,67.02 ,33.33
03,011,01,024,0412,596,713 ,9 ,722 ,1198 ,0,3,1,3,0,1,0,76.14,60.27 ,33.33
03,011,01,025,0413,597,465 ,1 ,466 ,686 ,0,3,1,3,0,1,0,76.14,67.93 ,33.33
03,011,01,025,0413,598,477 ,4 ,481 ,677 ,0,3,1,3,0,1,0,76.14,71.05 ,33.33
03,011,01,025,0414,599,562 ,4 ,566 ,796 ,0,3,1,3,0,1,0,76.14,71.11 ,33.33
03,011,01,025,0415,600,450 ,0 ,450 ,656 ,0,3,1,3,0,1,0,76.14,68.60 ,33.33
03,011,01,025,0416,601,334 ,2 ,336 ,481 ,0,3,1,3,0,1,0,76.14,69.85 ,33.33
03,011,01,025,0417,602,424 ,0 ,424 ,600 ,0,3,1,3,0,1,0,76.14,70.67 ,33.33
03,011,01,025,0418,603,514 ,4 ,518 ,792 ,0,3,1,3,0,1,0,76.14,65.40 ,33.33
03,011,01,025,0419,604,753 ,4 ,757 ,1173 ,0,3,1,3,0,1,0,76.14,64.54 ,33.33
03,011,01,025,0420,605,602 ,2 ,604 ,880 ,0,3,1,3,0,1,0,76.14,68.64 ,33.33
03,011,01,025,0421,606,271 ,3 ,274 ,554 ,0,3,1,3,0,1,0,76.14,49.46 ,33.33
03,011,01,026,0422,607,262 ,5 ,267 ,426 ,0,3,1,3,0,1,0,76.14,62.68 ,33.33
03,011,01,026,0423,608,448 ,3 ,451 ,677 ,0,3,1,3,0,1,0,76.14,66.62 ,33.33
03,011,01,026,0424,609,351 ,3 ,354 ,514 ,0,3,1,3,0,1,0,76.14,68.87 ,33.33
03,011,01,026,0425,610,577 ,2 ,579 ,858 ,0,3,1,3,0,1,0,76.14,67.48 ,33.33
03,011,01,026,0426,611,253 ,6 ,259 ,381 ,0,3,1,3,0,1,0,76.14,67.98 ,33.33
03,011,01,026,0427,612,307 ,3 ,310 ,454 ,0,3,1,3,0,1,0,76.14,68.28 ,33.33
03,011,01,026,0428,613,289 ,1 ,290 ,440 ,0,3,1,3,0,1,0,76.14,65.91 ,33.33
03,011,01,026,0429,614,204 ,1 ,205 ,314 ,0,3,1,3,0,1,0,76.14,65.29 ,33.33
03,011,01,026,0430,615,132 ,0 ,132 ,225 ,0,3,1,3,0,1,0,76.14,58.67 ,33.33
03,011,01,026,0431,616,332 ,2 ,334 ,547 ,0,3,1,3,0,1,0,76.14,61.06 ,33.33
03,011,01,027,0432,617,632 ,6 ,638 ,1071 ,0,3,1,3,0,1,0,76.14,59.57 ,33.33
03,011,01,027,0432,618,675 ,1 ,676 ,1027 ,0,3,1,3,0,1,0,76.14,65.82 ,33.33
03,011,01,027,0432,619,650 ,5 ,655 ,1077 ,0,3,1,3,0,1,0,76.14,60.82 ,33.33
03,011,01,027,0432,620,567 ,5 ,572 ,919 ,0,3,1,3,0,1,0,76.14,62.24 ,33.33
03,011,01,027,0433,621,713 ,4 ,717 ,1048 ,0,3,1,3,0,1,0,76.14,68.42 ,33.33
03,011,01,027,0433,622,749 ,6 ,755 ,1205 ,0,3,1,3,0,1,0,76.14,62.66 ,33.33
03,011,01,027,0434,623,552 ,1 ,553 ,873 ,0,3,1,3,0,1,0,76.14,63.34 ,33.33
03,011,01,027,0434,624,636 ,3 ,639 ,1077 ,0,3,1,3,0,1,0,76.14,59.33 ,33.33
03,011,01,027,0435,625,550 ,3 ,553 ,1055 ,0,3,1,3,0,1,0,76.14,52.42 ,33.33
03,011,01,027,0435,626,564 ,5 ,569 ,1017 ,0,3,1,3,0,1,0,76.14,55.95 ,33.33
03,011,01,027,0435,627,395 ,1 ,396 ,775 ,0,3,1,3,0,1,0,76.14,51.10 ,33.33
03,011,01,027,0435,628,431 ,6 ,437 ,850 ,0,3,1,3,0,1,0,76.14,51.41 ,33.33
03,011,01,027,0435,629,464 ,1 ,465 ,888 ,0,3,1,3,0,1,0,76.14,52.36 ,33.33
03,011,01,027,0436,630,668 ,6 ,674 ,1046 ,0,3,1,3,0,1,0,76.14,64.44 ,33.33
03,011,01,027,0436,631,729 ,2 ,731 ,1186 ,0,3,1,3,0,1,0,76.14,61.64 ,33.33
03,011,01,027,0436,632,594 ,4 ,598 ,972 ,0,3,1,3,0,1,0,76.14,61.52 ,33.33
03,011,01,027,0436,633,510 ,3 ,513 ,917 ,0,3,1,3,0,1,0,76.14,55.94 ,33.33
03,011,01,027,0436,634,615 ,2 ,617 ,1102 ,0,3,1,3,0,1,0,76.14,55.99 ,33.33
03,011,01,027,0436,635,573 ,3 ,576 ,965 ,0,3,1,3,0,1,0,76.14,59.69 ,33.33
03,011,01,027,0436,636,488 ,5 ,493 ,846 ,0,3,1,3,0,1,0,76.14,58.27 ,33.33
03,011,01,027,0437,637,501 ,4 ,505 ,866 ,0,3,1,3,0,1,0,76.14,58.31 ,33.33
03,011,01,027,0437,638,386 ,3 ,389 ,666 ,0,3,1,3,0,1,0,76.14,58.41 ,33.33
03,011,01,027,0437,639,649 ,5 ,654 ,1104 ,0,3,1,3,0,1,0,76.14,59.24 ,33.33
03,011,01,027,0438,640,631 ,7 ,638 ,1035 ,0,3,1,3,0,1,0,76.14,61.64 ,33.33
03,011,01,027,0438,641,713 ,4 ,717 ,1134 ,0,3,1,3,0,1,0,76.14,63.23 ,33.33
03,011,01,027,0438,642,677 ,9 ,686 ,1134 ,0,3,1,3,0,1,0,76.14,60.49 ,33.33
03,011,01,027,0438,643,621 ,5 ,626 ,1067 ,0,3,1,3,0,1,0,76.14,58.67 ,33.33
03,011,01,027,0438,644,592 ,1 ,593 ,1160 ,0,3,1,3,0,1,0,76.14,51.12 ,33.33
03,011,01,027,0438,645,618 ,7 ,625 ,1098 ,0,3,1,3,0,1,0,76.14,56.92 ,33.33
03,011,01,027,0439,646,617 ,7 ,624 ,1124 ,0,3,1,3,0,1,0,76.14,55.52 ,33.33
03,011,01,027,0439,647,684 ,1 ,685 ,1133 ,0,3,1,3,0,1,0,76.14,60.46 ,33.33
03,011,01,027,0439,648,710 ,4 ,714 ,1111 ,0,3,1,3,0,1,0,76.14,64.27 ,33.33
03,011,01,027,0439,649,456 ,5 ,461 ,783 ,0,3,1,3,0,1,0,76.14,58.88 ,33.33
03,011,01,027,0440,650,914 ,5 ,919 ,1323 ,0,3,1,3,0,1,0,76.14,69.46 ,33.33
03,011,01,027,0441,651,483 ,3 ,486 ,699 ,0,3,1,3,0,1,0,76.14,69.53 ,33.33
03,011,01,027,0442,652,704 ,5 ,709 ,1102 ,0,3,1,3,0,1,0,76.14,64.34 ,33.33
03,011,01,027,0442,653,665 ,5 ,670 ,1124 ,0,3,1,3,0,1,0,76.14,59.61 ,33.33
03,011,01,027,0443,654,648 ,9 ,657 ,1101 ,0,3,1,3,0,1,0,76.14,59.67 ,33.33
03,011,01,027,0443,655,699 ,0 ,699 ,1150 ,0,3,1,3,0,1,0,76.14,60.78 ,33.33
03,011,01,027,0443,656,673 ,6 ,679 ,1088 ,0,3,1,3,0,1,0,76.14,62.41 ,33.33
03,011,01,027,0443,657,176 ,1 ,177 ,318 ,0,3,1,3,0,1,0,76.14,55.66 ,33.33
03,011,01,027,0444,658,724 ,13 ,737 ,1080 ,0,3,1,3,0,1,0,76.14,68.24 ,33.33
03,011,01,027,0445,659,601 ,6 ,607 ,930 ,0,3,1,3,0,1,0,76.14,65.27 ,33.33
03,011,01,027,0445,660,623 ,4 ,627 ,1068 ,0,3,1,3,0,1,0,76.14,58.71 ,33.33
03,011,01,027,0446,661,662 ,7 ,669 ,1097 ,0,3,1,3,0,1,0,76.14,60.98 ,33.33
03,011,01,027,0446,662,571 ,10 ,581 ,940 ,0,3,1,3,0,1,0,76.14,61.81 ,33.33
03,011,01,027,0447,663,599 ,3 ,602 ,858 ,0,3,1,3,0,1,0,76.14,70.16 ,33.33
03,011,01,027,0447,664,692 ,12 ,704 ,1120 ,0,3,1,3,0,1,0,76.14,62.86 ,33.33
03,011,01,027,0448,665,867 ,4 ,871 ,1270 ,0,3,1,3,0,1,0,76.14,68.58 ,33.33
03,011,01,027,0449,666,939 ,5 ,944 ,1384 ,0,3,1,3,0,1,0,76.14,68.21 ,33.33
03,011,01,028,0450,667,845 ,10 ,855 ,1434 ,0,3,1,3,0,1,0,76.14,59.62 ,33.33
03,011,01,028,0450,668,879 ,7 ,886 ,1517 ,0,3,1,3,0,1,0,76.14,58.40 ,33.33
03,011,01,028,0450,669,525 ,5 ,530 ,878 ,0,3,1,3,0,1,0,76.14,60.36 ,33.33
03,011,01,028,0450,670,629 ,2 ,631 ,1041 ,0,3,1,3,0,1,0,76.14,60.61 ,33.33
03,011,01,028,0451,671,943 ,8 ,951 ,1558 ,0,3,1,3,0,1,0,76.14,61.04 ,33.33
03,011,01,028,0451,672,816 ,4 ,820 ,1364 ,0,3,1,3,0,1,0,76.14,60.12 ,33.33
03,011,01,028,0452,673,656 ,2 ,658 ,1044 ,0,3,1,3,0,1,0,76.14,63.03 ,33.33
03,011,01,028,0452,674,634 ,4 ,638 ,1047 ,0,3,1,3,0,1,0,76.14,60.94 ,33.33
03,011,01,028,0452,675,604 ,2 ,606 ,1003 ,0,3,1,3,0,1,0,76.14,60.42 ,33.33
03,011,01,028,0453,676,690 ,7 ,697 ,1089 ,0,3,1,3,0,1,0,76.14,64.00 ,33.33
03,011,01,028,0453,677,556 ,8 ,564 ,972 ,0,3,1,3,0,1,0,76.14,58.02 ,33.33
03,011,01,028,0454,678,842 ,3 ,845 ,1244 ,0,3,1,3,0,1,0,76.14,67.93 ,33.33
03,011,01,028,0454,679,588 ,4 ,592 ,871 ,0,3,1,3,0,1,0,76.14,67.97 ,33.33
03,011,01,028,0454,680,478 ,3 ,481 ,880 ,0,3,1,3,0,1,0,76.14,54.66 ,33.33
03,011,01,028,0455,681,826 ,4 ,830 ,1374 ,0,3,1,3,0,1,0,76.14,60.41 ,33.33
03,011,01,028,0455,682,578 ,6 ,584 ,981 ,0,3,1,3,0,1,0,76.14,59.53 ,33.33
03,011,01,028,0456,683,485 ,2 ,487 ,831 ,0,3,1,3,0,1,0,76.14,58.60 ,33.33
03,011,01,028,0456,684,542 ,1 ,543 ,870 ,0,3,1,3,0,1,0,76.14,62.41 ,33.33
03,011,01,028,0456,685,661 ,7 ,668 ,1055 ,0,3,1,3,0,1,0,76.14,63.32 ,33.33
03,011,01,028,0457,686,651 ,3 ,654 ,998 ,0,3,1,3,0,1,0,76.14,65.53 ,33.33
03,011,01,028,0457,687,682 ,2 ,684 ,1104 ,0,3,1,3,0,1,0,76.14,61.96 ,33.33
03,011,01,028,0458,688,539 ,1 ,540 ,930 ,0,3,1,3,0,1,0,76.14,58.06 ,33.33
03,011,01,028,0458,689,568 ,2 ,570 ,988 ,0,3,1,3,0,1,0,76.14,57.69 ,33.33
03,011,01,028,0458,690,562 ,2 ,564 ,886 ,0,3,1,3,0,1,0,76.14,63.66 ,33.33
03,011,01,028,0459,691,920 ,8 ,928 ,1383 ,0,3,1,3,0,1,0,76.14,67.10 ,33.33
03,011,01,028,0460,692,838 ,3 ,841 ,1325 ,0,3,1,3,0,1,0,76.14,63.47 ,33.33
03,011,01,028,0461,693,733 ,7 ,740 ,1114 ,0,3,1,3,0,1,0,76.14,66.43 ,33.33
03,011,01,028,0461,694,572 ,3 ,575 ,908 ,0,3,1,3,0,1,0,76.14,63.33 ,33.33
03,011,01,028,0462,695,383 ,4 ,387 ,607 ,0,3,1,3,0,1,0,76.14,63.76 ,33.33
03,011,01,028,0463,696,499 ,2 ,501 ,761 ,0,3,1,3,0,1,0,76.14,65.83 ,33.33
03,011,01,028,0463,697,595 ,2 ,597 ,911 ,0,3,1,3,0,1,0,76.14,65.53 ,33.33
03,011,01,028,0464,698,739 ,7 ,746 ,1196 ,0,3,1,3,0,1,0,76.14,62.37 ,33.33
03,011,01,028,0465,699,658 ,2 ,660 ,1034 ,0,3,1,3,0,1,0,76.14,63.83 ,33.33
03,011,01,028,0465,700,544 ,3 ,547 ,932 ,0,3,1,3,0,1,0,76.14,58.69 ,33.33
03,011,01,028,0466,701,674 ,4 ,678 ,1110 ,0,3,1,3,0,1,0,76.14,61.08 ,33.33
03,011,01,028,0466,702,644 ,2 ,646 ,1007 ,0,3,1,3,0,1,0,76.14,64.15 ,33.33
03,011,01,028,0467,703,757 ,4 ,761 ,1088 ,0,3,1,3,0,1,0,76.14,69.94 ,33.33
03,011,01,028,0467,704,635 ,5 ,640 ,1102 ,0,3,1,3,0,1,0,76.14,58.08 ,33.33
03,011,01,028,0468,705,646 ,5 ,651 ,1045 ,0,3,1,3,0,1,0,76.14,62.30 ,33.33
03,011,01,028,0468,706,536 ,3 ,539 ,885 ,0,3,1,3,0,1,0,76.14,60.90 ,33.33
03,011,01,028,0469,707,473 ,5 ,478 ,761 ,0,3,1,3,0,1,0,76.14,62.81 ,33.33
03,011,01,028,0469,708,382 ,4 ,386 ,593 ,0,3,1,3,0,1,0,76.14,65.09 ,33.33
03,011,01,028,0470,709,669 ,4 ,673 ,1120 ,0,3,1,3,0,1,0,76.14,60.09 ,33.33
03,011,01,028,0470,710,677 ,9 ,686 ,1112 ,0,3,1,3,0,1,0,76.14,61.69 ,33.33
03,011,01,029,0471,711,581 ,0 ,581 ,870 ,0,3,1,3,0,1,0,76.14,66.78 ,33.33
03,011,01,029,0471,712,696 ,5 ,701 ,1077 ,0,3,1,3,0,1,0,76.14,65.09 ,33.33
03,011,01,029,0472,713,546 ,1 ,547 ,829 ,0,3,1,3,0,1,0,76.14,65.98 ,33.33
03,011,01,029,0472,714,696 ,8 ,704 ,1063 ,0,3,1,3,0,1,0,76.14,66.23 ,33.33
03,011,01,029,0473,715,684 ,8 ,692 ,1019 ,0,3,1,3,0,1,0,76.14,67.91 ,33.33
03,011,01,029,0473,716,684 ,4 ,688 ,1063 ,0,3,1,3,0,1,0,76.14,64.72 ,33.33
03,011,01,029,0473,717,811 ,14 ,825 ,1308 ,0,3,1,3,0,1,0,76.14,63.07 ,33.33
03,011,01,029,0474,718,836 ,5 ,841 ,1212 ,0,3,1,3,0,1,0,76.14,69.39 ,33.33
03,011,01,029,0474,719,841 ,6 ,847 ,1258 ,0,3,1,3,0,1,0,76.14,67.33 ,33.33
03,011,01,029,0475,720,608 ,2 ,610 ,882 ,0,3,1,3,0,1,0,76.14,69.16 ,33.33
03,011,01,029,0476,721,495 ,5 ,500 ,758 ,0,3,1,3,0,1,0,76.14,65.96 ,33.33
03,011,01,029,0477,722,839 ,11 ,850 ,1400 ,0,3,1,3,0,1,0,76.14,60.71 ,33.33
03,011,01,029,0477,723,900 ,5 ,905 ,1341 ,0,3,1,3,0,1,0,76.14,67.49 ,33.33
03,011,01,029,0478,724,668 ,3 ,671 ,1059 ,0,3,1,3,0,1,0,76.14,63.36 ,33.33
03,011,01,029,0478,725,578 ,4 ,582 ,967 ,0,3,1,3,0,1,0,76.14,60.19 ,33.33
03,011,01,029,0478,726,684 ,6 ,690 ,995 ,0,3,1,3,0,1,0,76.14,69.35 ,33.33
03,011,01,029,0479,727,538 ,4 ,542 ,839 ,0,3,1,3,0,1,0,76.14,64.60 ,33.33
03,011,01,029,0479,728,694 ,6 ,700 ,1077 ,0,3,1,3,0,1,0,76.14,65.00 ,33.33
03,011,01,029,0480,729,484 ,5 ,489 ,730 ,0,3,1,3,0,1,0,76.14,66.99 ,33.33
03,011,01,029,0480,730,469 ,4 ,473 ,718 ,0,3,1,3,0,1,0,76.14,65.88 ,33.33
03,011,01,029,0481,731,634 ,3 ,637 ,1007 ,0,3,1,3,0,1,0,76.14,63.26 ,33.33
03,011,01,029,0481,732,697 ,10 ,707 ,1112 ,0,3,1,3,0,1,0,76.14,63.58 ,33.33
03,011,01,029,0482,733,528 ,2 ,530 ,741 ,0,3,1,3,0,1,0,76.14,71.52 ,33.33
03,011,01,029,0482,734,515 ,8 ,523 ,795 ,0,3,1,3,0,1,0,76.14,65.79 ,33.33
03,011,01,029,0483,735,595 ,7 ,602 ,867 ,0,3,1,3,0,1,0,76.14,69.43 ,33.33
03,011,01,029,0483,736,255 ,3 ,258 ,352 ,0,3,1,3,0,1,0,76.14,73.30 ,33.33
03,011,01,029,0484,737,524 ,5 ,529 ,767 ,0,3,1,3,0,1,0,76.14,68.97 ,33.33
03,011,01,029,0485,738,573 ,4 ,577 ,775 ,0,3,1,3,0,1,0,76.14,74.45 ,33.33
03,011,01,029,0486,739,518 ,6 ,524 ,826 ,0,3,1,3,0,1,0,76.14,63.44 ,33.33
03,011,01,029,0486,740,489 ,3 ,492 ,729 ,0,3,1,3,0,1,0,76.14,67.49 ,33.33
03,011,01,029,0487,741,288 ,6 ,294 ,404 ,0,3,1,3,0,1,0,76.14,72.77 ,33.33
03,011,01,030,0488,742,829 ,6 ,835 ,1185 ,0,3,1,3,0,1,0,76.14,70.46 ,33.33
03,011,01,030,0489,743,452 ,3 ,455 ,690 ,0,3,1,3,0,1,0,76.14,65.94 ,33.33
03,011,01,030,0490,744,103 ,1 ,104 ,201 ,0,3,1,3,0,1,0,76.14,51.74 ,33.33
03,011,01,030,0491,745,217 ,3 ,220 ,311 ,0,3,1,3,0,1,0,76.14,70.74 ,33.33
03,011,01,030,0492,746,187 ,1 ,188 ,271 ,0,3,1,3,0,1,0,76.14,69.37 ,33.33
03,011,01,030,0493,747,203 ,1 ,204 ,297 ,0,3,1,3,0,1,0,76.14,68.69 ,33.33
03,011,01,030,0494,748,308 ,2 ,310 ,423 ,0,3,1,3,0,1,0,76.14,73.29 ,33.33
03,011,01,030,0495,749,256 ,1 ,257 ,383 ,0,3,1,3,0,1,0,76.14,67.10 ,33.33
03,011,01,031,0496,750,541 ,4 ,545 ,1046 ,0,3,1,3,0,1,0,76.14,52.10 ,33.33
03,011,01,031,0496,751,577 ,2 ,579 ,1090 ,0,3,1,3,0,1,0,76.14,53.12 ,33.33
03,011,01,031,0496,752,565 ,2 ,567 ,1119 ,0,3,1,3,0,1,0,76.14,50.67 ,33.33
03,011,01,031,0496,753,474 ,1 ,475 ,1055 ,0,3,1,3,0,1,0,76.14,45.02 ,33.33
03,011,01,031,0497,754,548 ,5 ,553 ,969 ,0,3,1,3,0,1,0,76.14,57.07 ,33.33
03,011,01,031,0497,755,541 ,2 ,543 ,947 ,0,3,1,3,0,1,0,76.14,57.34 ,33.33
03,011,01,031,0497,756,531 ,4 ,535 ,1047 ,0,3,1,3,0,1,0,76.14,51.10 ,33.33
03,011,01,031,0498,757,529 ,0 ,529 ,1163 ,0,3,1,3,0,1,0,76.14,45.49 ,33.33
03,011,01,031,0498,758,397 ,5 ,402 ,713 ,0,3,1,3,0,1,0,76.14,56.38 ,33.33
03,011,01,031,0498,759,416 ,3 ,419 ,757 ,0,3,1,3,0,1,0,76.14,55.35 ,33.33
03,011,01,031,0498,760,484 ,3 ,487 ,991 ,0,3,1,3,0,1,0,76.14,49.14 ,33.33
03,011,01,031,0499,761,687 ,6 ,693 ,1182 ,0,3,1,3,0,1,0,76.14,58.63 ,33.33
03,011,01,031,0499,762,499 ,2 ,501 ,1044 ,0,3,1,3,0,1,0,76.14,47.99 ,33.33
03,011,01,031,0499,763,605 ,8 ,613 ,1099 ,0,3,1,3,0,1,0,76.14,55.78 ,33.33
03,011,01,031,0499,764,577 ,1 ,578 ,1068 ,0,3,1,3,0,1,0,76.14,54.12 ,33.33
03,011,01,031,0500,765,648 ,2 ,650 ,1129 ,0,3,1,3,0,1,0,76.14,57.57 ,33.33
03,011,01,031,0500,766,635 ,7 ,642 ,1259 ,0,3,1,3,0,1,0,76.14,50.99 ,33.33
03,011,01,031,0500,767,748 ,2 ,750 ,1270 ,0,3,1,3,0,1,0,76.14,59.06 ,33.33
03,011,01,031,0500,768,628 ,4 ,632 ,1158 ,0,3,1,3,0,1,0,76.14,54.58 ,33.33
03,011,01,031,0500,769,701 ,8 ,709 ,1187 ,0,3,1,3,0,1,0,76.14,59.73 ,33.33
03,011,01,031,0501,770,588 ,4 ,592 ,1016 ,0,3,1,3,0,1,0,76.14,58.27 ,33.33
03,011,01,031,0501,771,583 ,4 ,587 ,1104 ,0,3,1,3,0,1,0,76.14,53.17 ,33.33
03,011,01,031,0501,772,654 ,2 ,656 ,1222 ,0,3,1,3,0,1,0,76.14,53.68 ,33.33
03,011,01,031,0501,773,726 ,2 ,728 ,1547 ,0,3,1,3,0,1,0,76.14,47.06 ,33.33
03,011,01,031,0501,774,530 ,3 ,533 ,1417 ,0,3,1,3,0,1,0,76.14,37.61 ,33.33
03,011,01,031,0502,775,723 ,5 ,728 ,1306 ,0,3,1,3,0,1,0,76.14,55.74 ,33.33
03,011,01,031,0502,776,796 ,2 ,798 ,1451 ,0,3,1,3,0,1,0,76.14,55.00 ,33.33
03,011,01,031,0502,777,779 ,7 ,786 ,1418 ,0,3,1,3,0,1,0,76.14,55.43 ,33.33
03,011,01,031,0502,778,835 ,4 ,839 ,1638 ,0,3,1,3,0,1,0,76.14,51.22 ,33.33
03,011,01,031,0503,779,768 ,3 ,771 ,1303 ,0,3,1,3,0,1,0,76.14,59.17 ,33.33
03,011,01,031,0503,780,678 ,8 ,686 ,1232 ,0,3,1,3,0,1,0,76.14,55.68 ,33.33
03,011,01,031,0503,781,599 ,7 ,606 ,1011 ,0,3,1,3,0,1,0,76.14,59.94 ,33.33
03,011,01,031,0503,782,609 ,2 ,611 ,1187 ,0,3,1,3,0,1,0,76.14,51.47 ,33.33
03,011,01,031,0503,783,535 ,4 ,539 ,1057 ,0,3,1,3,0,1,0,76.14,50.99 ,33.33
03,011,01,031,0504,784,597 ,5 ,602 ,1182 ,0,3,1,3,0,1,0,76.14,50.93 ,33.33
03,011,01,031,0504,785,580 ,4 ,584 ,1086 ,0,3,1,3,0,1,0,76.14,53.78 ,33.33
03,011,01,031,0504,786,543 ,4 ,547 ,1078 ,0,3,1,3,0,1,0,76.14,50.74 ,33.33
03,011,01,031,0504,787,594 ,2 ,596 ,1147 ,0,3,1,3,0,1,0,76.14,51.96 ,33.33
03,011,01,031,0505,788,459 ,1 ,460 ,830 ,0,3,1,3,0,1,0,76.14,55.42 ,33.33
03,011,01,031,0505,789,405 ,2 ,407 ,672 ,0,3,1,3,0,1,0,76.14,60.57 ,33.33
03,011,01,031,0505,790,421 ,4 ,425 ,712 ,0,3,1,3,0,1,0,76.14,59.69 ,33.33
03,011,01,031,0506,791,699 ,7 ,706 ,1282 ,0,3,1,3,0,1,0,76.14,55.07 ,33.33
03,011,01,031,0506,792,655 ,2 ,657 ,1317 ,0,3,1,3,0,1,0,76.14,49.89 ,33.33
03,011,01,031,0507,793,637 ,4 ,641 ,1222 ,0,3,1,3,0,1,0,76.14,52.45 ,33.33
03,011,01,031,0507,794,722 ,8 ,730 ,1337 ,0,3,1,3,0,1,0,76.14,54.60 ,33.33
03,011,01,031,0507,795,535 ,1 ,536 ,1316 ,0,3,1,3,0,1,0,76.14,40.73 ,33.33
03,011,01,031,0508,796,501 ,1 ,502 ,846 ,0,3,1,3,0,1,0,76.14,59.34 ,33.33
03,011,01,031,0508,797,419 ,4 ,423 ,677 ,0,3,1,3,0,1,0,76.14,62.48 ,33.33
03,011,01,031,0509,798,421 ,5 ,426 ,659 ,0,3,1,3,0,1,0,76.14,64.64 ,33.33
03,011,01,031,0509,799,282 ,2 ,284 ,431 ,0,3,1,3,0,1,0,76.14,65.89 ,33.33
03,011,01,031,0510,800,694 ,9 ,703 ,1277 ,0,3,1,3,0,1,0,76.14,55.05 ,33.33
03,011,01,031,0510,801,690 ,4 ,694 ,1243 ,0,3,1,3,0,1,0,76.14,55.83 ,33.33
03,011,01,031,0510,802,506 ,2 ,508 ,964 ,0,3,1,3,0,1,0,76.14,52.70 ,33.33
03,011,01,031,0510,803,406 ,1 ,407 ,853 ,0,3,1,3,0,1,0,76.14,47.71 ,33.33
03,011,01,031,0510,804,488 ,0 ,488 ,859 ,0,3,1,3,0,1,0,76.14,56.81 ,33.33
03,011,01,031,0510,805,670 ,2 ,672 ,1223 ,0,3,1,3,0,1,0,76.14,54.95 ,33.33
03,011,01,031,0511,806,524 ,6 ,530 ,950 ,0,3,1,3,0,1,0,76.14,55.79 ,33.33
03,011,01,031,0511,807,668 ,4 ,672 ,1131 ,0,3,1,3,0,1,0,76.14,59.42 ,33.33
03,011,01,031,0511,808,647 ,6 ,653 ,1054 ,0,3,1,3,0,1,0,76.14,61.95 ,33.33
03,011,01,031,0511,809,782 ,5 ,787 ,1298 ,0,3,1,3,0,1,0,76.14,60.63 ,33.33
03,011,01,031,0512,810,416 ,7 ,423 ,778 ,0,3,1,3,0,1,0,76.14,54.37 ,33.33
03,011,01,031,0512,811,591 ,3 ,594 ,948 ,0,3,1,3,0,1,0,76.14,62.66 ,33.33
03,011,01,031,0512,812,348 ,2 ,350 ,530 ,0,3,1,3,0,1,0,76.14,66.04 ,33.33
03,011,01,031,0513,813,711 ,5 ,716 ,1146 ,0,3,1,3,0,1,0,76.14,62.48 ,33.33
03,011,01,031,0513,814,687 ,5 ,692 ,1136 ,0,3,1,3,0,1,0,76.14,60.92 ,33.33
03,011,01,031,0513,815,595 ,7 ,602 ,1244 ,0,3,1,3,0,1,0,76.14,48.39 ,33.33
03,011,01,031,0514,816,605 ,4 ,609 ,1039 ,0,3,1,3,0,1,0,76.14,58.61 ,33.33
03,011,01,031,0514,817,544 ,8 ,552 ,938 ,0,3,1,3,0,1,0,76.14,58.85 ,33.33
03,011,01,031,0514,818,611 ,7 ,618 ,1195 ,0,3,1,3,0,1,0,76.14,51.72 ,33.33
03,011,01,031,0514,819,598 ,1 ,599 ,1040 ,0,3,1,3,0,1,0,76.14,57.60 ,33.33
03,011,01,031,0514,820,658 ,3 ,661 ,1277 ,0,3,1,3,0,1,0,76.14,51.76 ,33.33
03,011,01,031,0514,821,513 ,2 ,515 ,1091 ,0,3,1,3,0,1,0,76.14,47.20 ,33.33
03,011,01,031,0515,822,824 ,4 ,828 ,1323 ,0,3,1,3,0,1,0,76.14,62.59 ,33.33
03,011,01,031,0515,823,333 ,1 ,334 ,556 ,0,3,1,3,0,1,0,76.14,60.07 ,33.33
03,011,01,031,0516,824,521 ,4 ,525 ,827 ,0,3,1,3,0,1,0,76.14,63.48 ,33.33
03,011,01,031,0516,825,500 ,5 ,505 ,906 ,0,3,1,3,0,1,0,76.14,55.74 ,33.33
03,011,01,031,0517,826,633 ,2 ,635 ,1056 ,0,3,1,3,0,1,0,76.14,60.13 ,33.33
03,011,01,031,0517,827,620 ,2 ,622 ,1076 ,0,3,1,3,0,1,0,76.14,57.81 ,33.33
03,011,01,031,0517,828,619 ,7 ,626 ,1085 ,0,3,1,3,0,1,0,76.14,57.70 ,33.33
03,011,01,031,0517,829,543 ,1 ,544 ,1065 ,0,3,1,3,0,1,0,76.14,51.08 ,33.33
03,011,01,031,0518,830,347 ,5 ,352 ,551 ,0,3,1,3,0,1,0,76.14,63.88 ,33.33
03,011,01,031,0518,831,449 ,3 ,452 ,750 ,0,3,1,3,0,1,0,76.14,60.27 ,33.33
03,011,01,031,0519,832,624 ,3 ,627 ,1043 ,0,3,1,3,0,1,0,76.14,60.12 ,33.33
03,011,01,031,0519,833,632 ,6 ,638 ,984 ,0,3,1,3,0,1,0,76.14,64.84 ,33.33
03,011,01,031,0519,834,602 ,5 ,607 ,982 ,0,3,1,3,0,1,0,76.14,61.81 ,33.33
03,011,01,031,0520,835,653 ,5 ,658 ,1032 ,0,3,1,3,0,1,0,76.14,63.76 ,33.33
03,011,01,031,0520,836,650 ,6 ,656 ,1126 ,0,3,1,3,0,1,0,76.14,58.26 ,33.33
03,011,01,031,0520,837,586 ,4 ,590 ,1097 ,0,3,1,3,0,1,0,76.14,53.78 ,33.33
03,011,01,031,0521,838,706 ,3 ,709 ,1237 ,0,3,1,3,0,1,0,76.14,57.32 ,33.33
03,011,01,031,0521,839,669 ,2 ,671 ,1248 ,0,3,1,3,0,1,0,76.14,53.77 ,33.33
03,011,01,031,0521,840,551 ,2 ,553 ,917 ,0,3,1,3,0,1,0,76.14,60.31 ,33.33
03,011,01,031,0521,841,541 ,1 ,542 ,940 ,0,3,1,3,0,1,0,76.14,57.66 ,33.33
03,011,01,031,0521,842,691 ,2 ,693 ,1165 ,0,3,1,3,0,1,0,76.14,59.48 ,33.33
03,011,01,031,0522,843,784 ,7 ,791 ,1349 ,0,3,1,3,0,1,0,76.14,58.64 ,33.33
03,011,01,031,0522,844,741 ,5 ,746 ,1188 ,0,3,1,3,0,1,0,76.14,62.79 ,33.33
03,011,01,031,0522,845,611 ,8 ,619 ,988 ,0,3,1,3,0,1,0,76.14,62.65 ,33.33
03,011,01,031,0523,846,657 ,3 ,660 ,1161 ,0,3,1,3,0,1,0,76.14,56.85 ,33.33
03,011,01,031,0523,847,804 ,5 ,809 ,1356 ,0,3,1,3,0,1,0,76.14,59.66 ,33.33
03,011,01,031,0523,848,773 ,4 ,777 ,1334 ,0,3,1,3,0,1,0,76.14,58.25 ,33.33
03,011,01,031,0523,849,801 ,11 ,812 ,1504 ,0,3,1,3,0,1,0,76.14,53.99 ,33.33
03,011,01,031,0524,850,661 ,0 ,661 ,1138 ,0,3,1,3,0,1,0,76.14,58.08 ,33.33
03,011,01,031,0524,851,630 ,5 ,635 ,1055 ,0,3,1,3,0,1,0,76.14,60.19 ,33.33
03,011,01,031,0524,852,793 ,6 ,799 ,1412 ,0,3,1,3,0,1,0,76.14,56.59 ,33.33
03,011,01,031,0524,853,627 ,5 ,632 ,1095 ,0,3,1,3,0,1,0,76.14,57.72 ,33.33
03,011,01,031,0524,854,738 ,6 ,744 ,1239 ,0,3,1,3,0,1,0,76.14,60.05 ,33.33
03,011,01,031,0525,855,483 ,1 ,484 ,793 ,0,3,1,3,0,1,0,76.14,61.03 ,33.33
03,011,01,031,0525,856,593 ,5 ,598 ,957 ,0,3,1,3,0,1,0,76.14,62.49 ,33.33
03,011,01,031,0526,857,607 ,5 ,612 ,960 ,0,3,1,3,0,1,0,76.14,63.75 ,33.33
03,011,01,031,0527,858,355 ,4 ,359 ,626 ,0,3,1,3,0,1,0,76.14,57.35 ,33.33
03,011,01,031,0527,859,579 ,4 ,583 ,920 ,0,3,1,3,0,1,0,76.14,63.37 ,33.33
03,011,01,031,0528,860,647 ,6 ,653 ,1060 ,0,3,1,3,0,1,0,76.14,61.60 ,33.33
03,011,01,031,0528,861,663 ,1 ,664 ,1103 ,0,3,1,3,0,1,0,76.14,60.20 ,33.33
03,011,01,031,0529,862,544 ,3 ,547 ,1177 ,0,3,1,3,0,1,0,76.14,46.47 ,33.33
03,011,01,031,0529,863,718 ,6 ,724 ,1454 ,0,3,1,3,0,1,0,76.14,49.79 ,33.33
03,011,01,031,0529,864,649 ,3 ,652 ,1147 ,0,3,1,3,0,1,0,76.14,56.84 ,33.33
03,011,01,031,0529,865,572 ,1 ,573 ,1125 ,0,3,1,3,0,1,0,76.14,50.93 ,33.33
03,011,01,031,0529,866,629 ,4 ,633 ,1215 ,0,3,1,3,0,1,0,76.14,52.10 ,33.33
03,011,01,031,0529,867,568 ,7 ,575 ,1182 ,0,3,1,3,0,1,0,76.14,48.65 ,33.33
03,011,01,031,0529,868,526 ,4 ,530 ,1049 ,0,3,1,3,0,1,0,76.14,50.52 ,33.33
03,011,01,031,0529,869,500 ,4 ,504 ,888 ,0,3,1,3,0,1,0,76.14,56.76 ,33.33
03,011,01,031,0529,870,653 ,6 ,659 ,1205 ,0,3,1,3,0,1,0,76.14,54.69 ,33.33
03,011,01,031,0530,871,570 ,4 ,574 ,888 ,0,3,1,3,0,1,0,76.14,64.64 ,33.33
03,011,01,031,0530,872,442 ,3 ,445 ,787 ,0,3,1,3,0,1,0,76.14,56.54 ,33.33
03,011,01,031,0531,873,349 ,1 ,350 ,556 ,0,3,1,3,0,1,0,76.14,62.95 ,33.33
03,011,01,031,0531,874,504 ,5 ,509 ,994 ,0,3,1,3,0,1,0,76.14,51.21 ,33.33
03,011,01,031,0532,875,623 ,6 ,629 ,1057 ,0,3,1,3,0,1,0,76.14,59.51 ,33.33
03,011,01,031,0532,876,614 ,3 ,617 ,1108 ,0,3,1,3,0,1,0,76.14,55.69 ,33.33
03,011,01,031,0533,877,780 ,6 ,786 ,1361 ,0,3,1,3,0,1,0,76.14,57.75 ,33.33
03,011,01,031,0533,878,919 ,9 ,928 ,1482 ,0,3,1,3,0,1,0,76.14,62.62 ,33.33
03,011,01,031,0534,879,508 ,4 ,512 ,1157 ,0,3,1,3,0,1,0,76.14,44.25 ,33.33
03,011,01,031,0534,880,506 ,6 ,512 ,1100 ,0,3,1,3,0,1,0,76.14,46.55 ,33.33
03,011,01,031,0534,881,553 ,7 ,560 ,983 ,0,3,1,3,0,1,0,76.14,56.97 ,33.33
03,011,01,031,0534,882,671 ,2 ,673 ,1073 ,0,3,1,3,0,1,0,76.14,62.72 ,33.33
03,011,01,031,0534,883,577 ,1 ,578 ,1069 ,0,3,1,3,0,1,0,76.14,54.07 ,33.33
03,012,01,001,0001,1,391 ,4 ,395 ,626 ,0,3,1,3,0,1,0,76.14,63.10 ,33.33
03,012,01,001,0001,2,387 ,0 ,387 ,652 ,0,3,1,3,0,1,0,76.14,59.36 ,33.33
03,012,01,001,0002,3,493 ,1 ,494 ,865 ,0,3,1,3,0,1,0,76.14,57.11 ,33.33
03,012,01,001,0003,4,821 ,4 ,825 ,1346 ,0,3,1,3,0,1,0,76.14,61.29 ,33.33
03,012,01,001,0003,5,574 ,6 ,580 ,952 ,0,3,1,3,0,1,0,76.14,60.92 ,33.33
03,012,01,001,0004,6,844 ,17 ,861 ,1424 ,0,3,1,3,0,1,0,76.14,60.46 ,33.33
03,012,01,001,0004,7,724 ,4 ,728 ,1257 ,0,3,1,3,0,1,0,76.14,57.92 ,33.33
03,012,01,001,0004,8,666 ,6 ,672 ,1121 ,0,3,1,3,0,1,0,76.14,59.95 ,33.33
03,012,01,001,0004,9,725 ,9 ,734 ,1192 ,0,3,1,3,0,1,0,76.14,61.58 ,33.33
03,012,01,001,0005,10,622 ,3 ,625 ,1089 ,0,3,1,3,0,1,0,76.14,57.39 ,33.33
03,012,01,001,0005,11,625 ,8 ,633 ,1079 ,0,3,1,3,0,1,0,76.14,58.67 ,33.33
03,012,01,001,0005,12,401 ,3 ,404 ,680 ,0,3,1,3,0,1,0,76.14,59.41 ,33.33
03,012,01,001,0005,13,686 ,6 ,692 ,1148 ,0,3,1,3,0,1,0,76.14,60.28 ,33.33
03,012,01,001,0006,14,624 ,1 ,625 ,1082 ,0,3,1,3,0,1,0,76.14,57.76 ,33.33
03,012,01,001,0006,15,751 ,7 ,758 ,1330 ,0,3,1,3,0,1,0,76.14,56.99 ,33.33
03,012,01,001,0006,16,436 ,3 ,439 ,840 ,0,3,1,3,0,1,0,76.14,52.26 ,33.33
03,012,01,001,0006,17,683 ,6 ,689 ,1183 ,0,3,1,3,0,1,0,76.14,58.24 ,33.33
03,012,01,001,0007,18,661 ,0 ,661 ,1248 ,0,3,1,3,0,1,0,76.14,52.96 ,33.33
03,012,01,001,0007,19,726 ,6 ,732 ,1193 ,0,3,1,3,0,1,0,76.14,61.36 ,33.33
03,012,01,001,0008,20,647 ,6 ,653 ,1121 ,0,3,1,3,0,1,0,76.14,58.25 ,33.33
03,012,01,001,0008,21,962 ,12 ,974 ,1704 ,0,3,1,3,0,1,0,76.14,57.16 ,33.33
03,012,01,001,0009,22,625 ,7 ,632 ,1047 ,0,3,1,3,0,1,0,76.14,60.36 ,33.33
03,012,01,001,0009,23,499 ,4 ,503 ,955 ,0,3,1,3,0,1,0,76.14,52.67 ,33.33
03,012,01,001,0009,24,548 ,2 ,550 ,978 ,0,3,1,3,0,1,0,76.14,56.24 ,33.33
03,012,01,001,0010,25,1070 ,5 ,1075 ,1560 ,0,3,1,3,0,1,0,76.14,68.91 ,33.33
03,012,01,001,0010,26,532 ,2 ,534 ,911 ,0,3,1,3,0,1,0,76.14,58.62 ,33.33
03,012,01,001,0010,27,639 ,4 ,643 ,1026 ,0,3,1,3,0,1,0,76.14,62.67 ,33.33
03,012,01,001,0010,28,673 ,3 ,676 ,1181 ,0,3,1,3,0,1,0,76.14,57.24 ,33.33
03,012,01,001,0010,29,803 ,8 ,811 ,1273 ,0,3,1,3,0,1,0,76.14,63.71 ,33.33
03,012,01,001,0011,30,562 ,3 ,565 ,995 ,0,3,1,3,0,1,0,76.14,56.78 ,33.33
03,012,01,001,0011,31,851 ,5 ,856 ,1476 ,0,3,1,3,0,1,0,76.14,57.99 ,33.33
03,012,01,001,0011,32,607 ,1 ,608 ,1048 ,0,3,1,3,0,1,0,76.14,58.02 ,33.33
03,012,01,001,0011,33,572 ,7 ,579 ,966 ,0,3,1,3,0,1,0,76.14,59.94 ,33.33
03,012,01,001,0011,34,472 ,2 ,474 ,808 ,0,3,1,3,0,1,0,76.14,58.66 ,33.33
03,012,01,001,0012,35,733 ,5 ,738 ,1372 ,0,3,1,3,0,1,0,76.14,53.79 ,33.33
03,012,01,001,0012,36,719 ,7 ,726 ,1376 ,0,3,1,3,0,1,0,76.14,52.76 ,33.33
03,012,01,001,0012,37,708 ,3 ,711 ,1322 ,0,3,1,3,0,1,0,76.14,53.78 ,33.33
03,012,01,001,0012,38,868 ,2 ,870 ,1695 ,0,3,1,3,0,1,0,76.14,51.33 ,33.33
03,012,01,001,0013,39,695 ,5 ,700 ,1197 ,0,3,1,3,0,1,0,76.14,58.48 ,33.33
03,012,01,001,0013,40,674 ,6 ,680 ,1214 ,0,3,1,3,0,1,0,76.14,56.01 ,33.33
03,012,01,001,0014,41,681 ,9 ,690 ,1282 ,0,3,1,3,0,1,0,76.14,53.82 ,33.33
03,012,01,001,0014,42,649 ,2 ,651 ,1206 ,0,3,1,3,0,1,0,76.14,53.98 ,33.33
03,012,01,001,0014,43,582 ,0 ,582 ,1050 ,0,3,1,3,0,1,0,76.14,55.43 ,33.33
03,012,01,001,0014,44,609 ,3 ,612 ,1301 ,0,3,1,3,0,1,0,76.14,47.04 ,33.33
03,012,01,001,0014,45,583 ,5 ,588 ,1070 ,0,3,1,3,0,1,0,76.14,54.95 ,33.33
03,012,01,001,0015,46,499 ,4 ,503 ,789 ,0,3,1,3,0,1,0,76.14,63.75 ,33.33
03,012,01,001,0016,47,293 ,4 ,297 ,484 ,0,3,1,3,0,1,0,76.14,61.36 ,33.33
03,012,01,001,0017,48,308 ,1 ,309 ,523 ,0,3,1,3,0,1,0,76.14,59.08 ,33.33
03,012,01,001,0017,49,502 ,3 ,505 ,788 ,0,3,1,3,0,1,0,76.14,64.09 ,33.33
03,012,01,001,0018,50,503 ,5 ,508 ,847 ,0,3,1,3,0,1,0,76.14,59.98 ,33.33
03,012,01,001,0018,51,465 ,2 ,467 ,796 ,0,3,1,3,0,1,0,76.14,58.67 ,33.33
03,012,01,001,0019,52,725 ,3 ,728 ,1266 ,0,3,1,3,0,1,0,76.14,57.50 ,33.33
03,012,01,001,0019,53,772 ,7 ,779 ,1250 ,0,3,1,3,0,1,0,76.14,62.32 ,33.33
03,012,01,001,0019,54,687 ,4 ,691 ,1183 ,0,3,1,3,0,1,0,76.14,58.41 ,33.33
03,012,01,001,0019,55,713 ,2 ,715 ,1175 ,0,3,1,3,0,1,0,76.14,60.85 ,33.33
03,012,01,001,0020,56,638 ,5 ,643 ,1054 ,0,3,1,3,0,1,0,76.14,61.01 ,33.33
03,012,01,001,0021,57,694 ,8 ,702 ,1086 ,0,3,1,3,0,1,0,76.14,64.64 ,33.33
03,012,01,001,0022,58,762 ,6 ,768 ,1442 ,0,3,1,3,0,1,0,76.14,53.26 ,33.33
03,012,01,001,0023,59,676 ,3 ,679 ,1155 ,0,3,1,3,0,1,0,76.14,58.79 ,33.33
03,012,01,001,0023,60,497 ,6 ,503 ,855 ,0,3,1,3,0,1,0,76.14,58.83 ,33.33
03,012,01,001,0023,61,547 ,3 ,550 ,864 ,0,3,1,3,0,1,0,76.14,63.66 ,33.33
03,012,01,001,0023,62,566 ,2 ,568 ,906 ,0,3,1,3,0,1,0,76.14,62.69 ,33.33
03,012,01,001,0024,63,465 ,4 ,469 ,814 ,0,3,1,3,0,1,0,76.14,57.62 ,33.33
03,012,01,001,0025,64,632 ,4 ,636 ,1059 ,0,3,1,3,0,1,0,76.14,60.06 ,33.33
03,012,01,001,0025,65,623 ,2 ,625 ,1089 ,0,3,1,3,0,1,0,76.14,57.39 ,33.33
03,012,01,001,0025,66,794 ,6 ,800 ,1349 ,0,3,1,3,0,1,0,76.14,59.30 ,33.33
03,012,01,001,0026,67,586 ,1 ,587 ,925 ,0,3,1,3,0,1,0,76.14,63.46 ,33.33
03,012,01,001,0026,68,501 ,3 ,504 ,922 ,0,3,1,3,0,1,0,76.14,54.66 ,33.33
03,012,01,001,0026,69,499 ,4 ,503 ,962 ,0,3,1,3,0,1,0,76.14,52.29 ,33.33
03,012,01,001,0026,70,767 ,7 ,774 ,1304 ,0,3,1,3,0,1,0,76.14,59.36 ,33.33
03,012,01,001,0027,71,657 ,8 ,665 ,1142 ,0,3,1,3,0,1,0,76.14,58.23 ,33.33
03,012,01,001,0027,72,623 ,0 ,623 ,1048 ,0,3,1,3,0,1,0,76.14,59.45 ,33.33
03,012,01,001,0027,73,605 ,2 ,607 ,1064 ,0,3,1,3,0,1,0,76.14,57.05 ,33.33
03,012,01,001,0027,74,644 ,6 ,650 ,1159 ,0,3,1,3,0,1,0,76.14,56.08 ,33.33
03,012,01,001,0027,75,600 ,3 ,603 ,944 ,0,3,1,3,0,1,0,76.14,63.88 ,33.33
03,012,01,001,0028,76,669 ,10 ,679 ,1138 ,0,3,1,3,0,1,0,76.14,59.67 ,33.33
03,012,01,001,0028,77,563 ,6 ,569 ,983 ,0,3,1,3,0,1,0,76.14,57.88 ,33.33
03,012,01,001,0028,78,690 ,7 ,697 ,1139 ,0,3,1,3,0,1,0,76.14,61.19 ,33.33
03,012,01,001,0029,79,285 ,3 ,288 ,439 ,0,3,1,3,0,1,0,76.14,65.60 ,33.33
03,012,01,001,0029,80,314 ,5 ,319 ,473 ,0,3,1,3,0,1,0,76.14,67.44 ,33.33
03,012,01,001,0030,81,922 ,8 ,930 ,1586 ,0,3,1,3,0,1,0,76.14,58.64 ,33.33
03,012,01,001,0031,82,989 ,10 ,999 ,1582 ,0,3,1,3,0,1,0,76.14,63.15 ,33.33
03,012,01,001,0032,83,621 ,3 ,624 ,1125 ,0,3,1,3,0,1,0,76.14,55.47 ,33.33
03,012,01,001,0032,84,554 ,5 ,559 ,959 ,0,3,1,3,0,1,0,76.14,58.29 ,33.33
03,012,01,001,0033,85,693 ,4 ,697 ,1026 ,0,3,1,3,0,1,0,76.14,67.93 ,33.33
03,012,01,001,0033,86,627 ,3 ,630 ,983 ,0,3,1,3,0,1,0,76.14,64.09 ,33.33
03,012,01,001,0033,87,652 ,3 ,655 ,1053 ,0,3,1,3,0,1,0,76.14,62.20 ,33.33
03,012,01,001,0033,88,501 ,3 ,504 ,834 ,0,3,1,3,0,1,0,76.14,60.43 ,33.33
03,012,01,001,0033,89,532 ,5 ,537 ,927 ,0,3,1,3,0,1,0,76.14,57.93 ,33.33
03,012,01,001,0034,90,770 ,3 ,773 ,1326 ,0,3,1,3,0,1,0,76.14,58.30 ,33.33
03,012,01,001,0034,91,755 ,8 ,763 ,1340 ,0,3,1,3,0,1,0,76.14,56.94 ,33.33
03,012,01,001,0034,92,735 ,3 ,738 ,1221 ,0,3,1,3,0,1,0,76.14,60.44 ,33.33
03,012,01,001,0035,93,786 ,8 ,794 ,1304 ,0,3,1,3,0,1,0,76.14,60.89 ,33.33
03,012,01,001,0035,94,825 ,3 ,828 ,1160 ,0,3,1,3,0,1,0,76.14,71.38 ,33.33
03,012,01,001,0035,95,622 ,2 ,624 ,1074 ,0,3,1,3,0,1,0,76.14,58.10 ,33.33
03,012,01,001,0035,96,774 ,4 ,778 ,1264 ,0,3,1,3,0,1,0,76.14,61.55 ,33.33
03,012,01,001,0036,97,605 ,4 ,609 ,958 ,0,3,1,3,0,1,0,76.14,63.57 ,33.33
03,012,01,001,0036,98,644 ,6 ,650 ,1069 ,0,3,1,3,0,1,0,76.14,60.80 ,33.33
03,012,01,001,0037,99,460 ,7 ,467 ,815 ,0,3,1,3,0,1,0,76.14,57.30 ,33.33
03,012,01,001,0037,100,456 ,3 ,459 ,847 ,0,3,1,3,0,1,0,76.14,54.19 ,33.33
03,012,01,001,0038,101,654 ,7 ,661 ,1237 ,0,3,1,3,0,1,0,76.14,53.44 ,33.33
03,012,01,001,0038,102,586 ,5 ,591 ,1017 ,0,3,1,3,0,1,0,76.14,58.11 ,33.33
03,012,01,001,0039,103,806 ,6 ,812 ,1378 ,0,3,1,3,0,1,0,76.14,58.93 ,33.33
03,012,01,001,0039,104,749 ,5 ,754 ,1287 ,0,3,1,3,0,1,0,76.14,58.59 ,33.33
03,012,01,001,0039,105,807 ,5 ,812 ,1413 ,0,3,1,3,0,1,0,76.14,57.47 ,33.33
03,012,01,001,0040,106,603 ,2 ,605 ,1013 ,0,3,1,3,0,1,0,76.14,59.72 ,33.33
03,012,01,001,0040,107,764 ,5 ,769 ,1250 ,0,3,1,3,0,1,0,76.14,61.52 ,33.33
03,012,01,001,0040,108,643 ,3 ,646 ,1087 ,0,3,1,3,0,1,0,76.14,59.43 ,33.33
03,012,01,001,0040,109,757 ,6 ,763 ,1289 ,0,3,1,3,0,1,0,76.14,59.19 ,33.33
03,012,01,001,0041,110,71 ,1 ,72 ,155 ,0,3,1,3,0,1,0,76.14,46.45 ,33.33
03,012,01,001,0042,111,680 ,1 ,681 ,1148 ,0,3,1,3,0,1,0,76.14,59.32 ,33.33
03,012,01,001,0043,112,532 ,8 ,540 ,796 ,0,3,1,3,0,1,0,76.14,67.84 ,33.33
03,012,01,001,0043,113,417 ,13 ,430 ,703 ,0,3,1,3,0,1,0,76.14,61.17 ,33.33
03,012,01,001,0043,114,540 ,2 ,542 ,903 ,0,3,1,3,0,1,0,76.14,60.02 ,33.33
03,012,01,001,0043,115,776 ,7 ,783 ,1346 ,0,3,1,3,0,1,0,76.14,58.17 ,33.33
03,012,01,001,0044,116,434 ,2 ,436 ,656 ,0,3,1,3,0,1,0,76.14,66.46 ,33.33
03,012,01,001,0044,117,514 ,7 ,521 ,736 ,0,3,1,3,0,1,0,76.14,70.79 ,33.33
03,012,01,001,0044,118,585 ,2 ,587 ,852 ,0,3,1,3,0,1,0,76.14,68.90 ,33.33
03,012,01,001,0045,119,548 ,2 ,550 ,951 ,0,3,1,3,0,1,0,76.14,57.83 ,33.33
03,012,01,001,0045,120,457 ,0 ,457 ,823 ,0,3,1,3,0,1,0,76.14,55.53 ,33.33
03,012,01,001,0045,121,477 ,5 ,482 ,916 ,0,3,1,3,0,1,0,76.14,52.62 ,33.33
03,012,01,001,0045,122,700 ,6 ,706 ,1233 ,0,3,1,3,0,1,0,76.14,57.26 ,33.33
03,012,01,001,0046,123,647 ,2 ,649 ,1209 ,0,3,1,3,0,1,0,76.14,53.68 ,33.33
03,012,01,001,0046,124,679 ,2 ,681 ,1306 ,0,3,1,3,0,1,0,76.14,52.14 ,33.33
03,012,01,001,0046,125,638 ,5 ,643 ,1163 ,0,3,1,3,0,1,0,76.14,55.29 ,33.33
03,012,01,001,0047,126,557 ,4 ,561 ,1040 ,0,3,1,3,0,1,0,76.14,53.94 ,33.33
03,012,01,001,0047,127,487 ,2 ,489 ,931 ,0,3,1,3,0,1,0,76.14,52.52 ,33.33
03,012,01,001,0047,128,382 ,3 ,385 ,704 ,0,3,1,3,0,1,0,76.14,54.69 ,33.33
03,012,01,001,0048,129,646 ,3 ,649 ,1168 ,0,3,1,3,0,1,0,76.14,55.57 ,33.33
03,012,01,001,0048,130,599 ,2 ,601 ,1056 ,0,3,1,3,0,1,0,76.14,56.91 ,33.33
03,012,01,001,0049,131,514 ,4 ,518 ,1035 ,0,3,1,3,0,1,0,76.14,50.05 ,33.33
03,012,01,001,0049,132,637 ,5 ,642 ,1090 ,0,3,1,3,0,1,0,76.14,58.90 ,33.33
03,012,01,001,0050,133,484 ,4 ,488 ,866 ,0,3,1,3,0,1,0,76.14,56.35 ,33.33
03,012,01,001,0050,134,562 ,7 ,569 ,1055 ,0,3,1,3,0,1,0,76.14,53.93 ,33.33
03,012,01,001,0050,135,510 ,1 ,511 ,938 ,0,3,1,3,0,1,0,76.14,54.48 ,33.33
03,012,01,001,0050,136,527 ,3 ,530 ,1013 ,0,3,1,3,0,1,0,76.14,52.32 ,33.33
03,012,01,001,0051,137,503 ,4 ,507 ,885 ,0,3,1,3,0,1,0,76.14,57.29 ,33.33
03,012,01,001,0051,138,396 ,0 ,396 ,776 ,0,3,1,3,0,1,0,76.14,51.03 ,33.33
03,012,01,001,0051,139,402 ,4 ,406 ,712 ,0,3,1,3,0,1,0,76.14,57.02 ,33.33
03,012,01,001,0052,140,586 ,6 ,592 ,1019 ,0,3,1,3,0,1,0,76.14,58.10 ,33.33
03,012,01,001,0052,141,552 ,2 ,554 ,939 ,0,3,1,3,0,1,0,76.14,59.00 ,33.33
03,012,01,001,0053,142,535 ,4 ,539 ,959 ,0,3,1,3,0,1,0,76.14,56.20 ,33.33
03,012,01,001,0053,143,478 ,1 ,479 ,901 ,0,3,1,3,0,1,0,76.14,53.16 ,33.33
03,012,01,001,0053,144,449 ,1 ,450 ,862 ,0,3,1,3,0,1,0,76.14,52.20 ,33.33
03,012,01,001,0054,145,478 ,3 ,481 ,927 ,0,3,1,3,0,1,0,76.14,51.89 ,33.33
03,012,01,001,0054,146,643 ,6 ,649 ,1124 ,0,3,1,3,0,1,0,76.14,57.74 ,33.33
03,012,01,001,0054,147,716 ,4 ,720 ,1310 ,0,3,1,3,0,1,0,76.14,54.96 ,33.33
03,012,01,001,0055,148,701 ,5 ,706 ,1253 ,0,3,1,3,0,1,0,76.14,56.34 ,33.33
03,012,01,001,0055,149,788 ,3 ,791 ,1297 ,0,3,1,3,0,1,0,76.14,60.99 ,33.33
03,012,01,001,0055,150,805 ,4 ,809 ,1525 ,0,3,1,3,0,1,0,76.14,53.05 ,33.33
03,012,01,001,0056,151,485 ,7 ,492 ,848 ,0,3,1,3,0,1,0,76.14,58.02 ,33.33
03,012,01,001,0056,152,520 ,3 ,523 ,978 ,0,3,1,3,0,1,0,76.14,53.48 ,33.33
03,012,01,001,0056,153,768 ,4 ,772 ,1315 ,0,3,1,3,0,1,0,76.14,58.71 ,33.33
03,012,01,001,0057,154,640 ,3 ,643 ,1213 ,0,3,1,3,0,1,0,76.14,53.01 ,33.33
03,012,01,001,0057,155,615 ,5 ,620 ,1182 ,0,3,1,3,0,1,0,76.14,52.45 ,33.33
03,012,01,001,0057,156,642 ,3 ,645 ,1253 ,0,3,1,3,0,1,0,76.14,51.48 ,33.33
03,012,01,001,0058,157,689 ,2 ,691 ,1297 ,0,3,1,3,0,1,0,76.14,53.28 ,33.33
03,012,01,001,0058,158,729 ,1 ,730 ,1316 ,0,3,1,3,0,1,0,76.14,55.47 ,33.33
03,012,01,001,0058,159,786 ,19 ,805 ,1359 ,0,3,1,3,0,1,0,76.14,59.23 ,33.33
03,012,01,001,0058,160,608 ,2 ,610 ,1139 ,0,3,1,3,0,1,0,76.14,53.56 ,33.33
03,012,01,001,0058,161,526 ,1 ,527 ,1002 ,0,3,1,3,0,1,0,76.14,52.59 ,33.33
03,012,01,001,0059,162,514 ,1 ,515 ,941 ,0,3,1,3,0,1,0,76.14,54.73 ,33.33
03,012,01,001,0059,163,427 ,3 ,430 ,852 ,0,3,1,3,0,1,0,76.14,50.47 ,33.33
03,012,01,001,0059,164,428 ,2 ,430 ,830 ,0,3,1,3,0,1,0,76.14,51.81 ,33.33
03,012,01,001,0059,165,403 ,1 ,404 ,815 ,0,3,1,3,0,1,0,76.14,49.57 ,33.33
03,012,01,001,0060,166,539 ,7 ,546 ,916 ,0,3,1,3,0,1,0,76.14,59.61 ,33.33
03,012,01,001,0060,167,621 ,6 ,627 ,1067 ,0,3,1,3,0,1,0,76.14,58.76 ,33.33
03,012,01,001,0061,168,501 ,1 ,502 ,977 ,0,3,1,3,0,1,0,76.14,51.38 ,33.33
03,012,01,001,0061,169,537 ,4 ,541 ,1050 ,0,3,1,3,0,1,0,76.14,51.52 ,33.33
03,012,01,001,0061,170,424 ,5 ,429 ,756 ,0,3,1,3,0,1,0,76.14,56.75 ,33.33
03,012,01,001,0061,171,552 ,1 ,553 ,1107 ,0,3,1,3,0,1,0,76.14,49.95 ,33.33
03,012,01,001,0062,172,743 ,4 ,747 ,1254 ,0,3,1,3,0,1,0,76.14,59.57 ,33.33
03,012,01,001,0062,173,646 ,7 ,653 ,1207 ,0,3,1,3,0,1,0,76.14,54.10 ,33.33
03,012,01,001,0062,174,532 ,3 ,535 ,1139 ,0,3,1,3,0,1,0,76.14,46.97 ,33.33
03,012,01,001,0063,175,688 ,7 ,695 ,1397 ,0,3,1,3,0,1,0,76.14,49.75 ,33.33
03,012,01,001,0063,176,774 ,5 ,779 ,1470 ,0,3,1,3,0,1,0,76.14,52.99 ,33.33
03,012,01,001,0063,177,813 ,8 ,821 ,1537 ,0,3,1,3,0,1,0,76.14,53.42 ,33.33
03,012,01,001,0063,178,769 ,5 ,774 ,1362 ,0,3,1,3,0,1,0,76.14,56.83 ,33.33
03,012,01,001,0063,179,763 ,3 ,766 ,1442 ,0,3,1,3,0,1,0,76.14,53.12 ,33.33
03,012,01,001,0063,180,633 ,1 ,634 ,1397 ,0,3,1,3,0,1,0,76.14,45.38 ,33.33
03,012,01,001,0064,181,536 ,5 ,541 ,950 ,0,3,1,3,0,1,0,76.14,56.95 ,33.33
03,012,01,001,0064,182,623 ,2 ,625 ,1115 ,0,3,1,3,0,1,0,76.14,56.05 ,33.33
03,012,01,001,0064,183,580 ,5 ,585 ,1086 ,0,3,1,3,0,1,0,76.14,53.87 ,33.33
03,012,01,001,0065,184,758 ,8 ,766 ,1248 ,0,3,1,3,0,1,0,76.14,61.38 ,33.33
03,012,01,001,0065,185,518 ,6 ,524 ,1019 ,0,3,1,3,0,1,0,76.14,51.42 ,33.33
03,012,01,001,0065,186,776 ,2 ,778 ,1382 ,0,3,1,3,0,1,0,76.14,56.30 ,33.33
03,012,01,001,0066,187,793 ,6 ,799 ,1485 ,0,3,1,3,0,1,0,76.14,53.80 ,33.33
03,012,01,001,0066,188,623 ,8 ,631 ,1189 ,0,3,1,3,0,1,0,76.14,53.07 ,33.33
03,012,01,001,0067,189,575 ,1 ,576 ,983 ,0,3,1,3,0,1,0,76.14,58.60 ,33.33
03,012,01,001,0067,190,413 ,5 ,418 ,772 ,0,3,1,3,0,1,0,76.14,54.15 ,33.33
03,012,01,001,0067,191,635 ,4 ,639 ,1152 ,0,3,1,3,0,1,0,76.14,55.47 ,33.33
03,012,01,001,0067,192,571 ,5 ,576 ,1029 ,0,3,1,3,0,1,0,76.14,55.98 ,33.33
03,012,01,001,0068,193,334 ,3 ,337 ,924 ,0,3,1,3,0,1,0,76.14,36.47 ,33.33
03,012,01,001,0068,194,321 ,4 ,325 ,608 ,0,3,1,3,0,1,0,76.14,53.45 ,33.33
03,012,01,001,0068,195,321 ,3 ,324 ,587 ,0,3,1,3,0,1,0,76.14,55.20 ,33.33
03,012,01,001,0069,196,582 ,5 ,587 ,1101 ,0,3,1,3,0,1,0,76.14,53.32 ,33.33
03,012,01,001,0069,197,568 ,5 ,573 ,1029 ,0,3,1,3,0,1,0,76.14,55.69 ,33.33
03,012,01,001,0069,198,564 ,7 ,571 ,1151 ,0,3,1,3,0,1,0,76.14,49.61 ,33.33
03,012,01,001,0069,199,587 ,6 ,593 ,1330 ,0,3,1,3,0,1,0,76.14,44.59 ,33.33
03,012,01,001,0070,200,514 ,8 ,522 ,967 ,0,3,1,3,0,1,0,76.14,53.98 ,33.33
03,012,01,001,0070,201,553 ,0 ,553 ,1003 ,0,3,1,3,0,1,0,76.14,55.13 ,33.33
03,012,01,001,0071,202,413 ,2 ,415 ,715 ,0,3,1,3,0,1,0,76.14,58.04 ,33.33
03,012,01,001,0071,203,405 ,3 ,408 ,787 ,0,3,1,3,0,1,0,76.14,51.84 ,33.33
03,012,01,001,0071,204,529 ,1 ,530 ,968 ,0,3,1,3,0,1,0,76.14,54.75 ,33.33
03,012,01,001,0072,205,544 ,2 ,546 ,947 ,0,3,1,3,0,1,0,76.14,57.66 ,33.33
03,012,01,001,0072,206,523 ,3 ,526 ,1007 ,0,3,1,3,0,1,0,76.14,52.23 ,33.33
03,012,01,001,0072,207,622 ,8 ,630 ,1066 ,0,3,1,3,0,1,0,76.14,59.10 ,33.33
03,012,01,001,0072,208,614 ,4 ,618 ,1098 ,0,3,1,3,0,1,0,76.14,56.28 ,33.33
03,012,01,001,0073,209,458 ,5 ,463 ,777 ,0,3,1,3,0,1,0,76.14,59.59 ,33.33
03,012,01,001,0073,210,506 ,2 ,508 ,915 ,0,3,1,3,0,1,0,76.14,55.52 ,33.33
03,012,01,001,0073,211,507 ,3 ,510 ,911 ,0,3,1,3,0,1,0,76.14,55.98 ,33.33
03,012,01,001,0073,212,490 ,1 ,491 ,801 ,0,3,1,3,0,1,0,76.14,61.30 ,33.33
03,012,01,001,0074,213,659 ,5 ,664 ,1219 ,0,3,1,3,0,1,0,76.14,54.47 ,33.33
03,012,01,001,0074,214,676 ,6 ,682 ,1214 ,0,3,1,3,0,1,0,76.14,56.18 ,33.33
03,012,01,001,0074,215,637 ,2 ,639 ,1134 ,0,3,1,3,0,1,0,76.14,56.35 ,33.33
03,012,01,001,0075,216,563 ,3 ,566 ,899 ,0,3,1,3,0,1,0,76.14,62.96 ,33.33
03,012,01,001,0075,217,563 ,2 ,565 ,1005 ,0,3,1,3,0,1,0,76.14,56.22 ,33.33
03,012,01,001,0075,218,644 ,5 ,649 ,1090 ,0,3,1,3,0,1,0,76.14,59.54 ,33.33
03,012,01,001,0076,219,620 ,4 ,624 ,1067 ,0,3,1,3,0,1,0,76.14,58.48 ,33.33
03,012,01,001,0076,220,592 ,3 ,595 ,1006 ,0,3,1,3,0,1,0,76.14,59.15 ,33.33
03,012,01,001,0076,221,554 ,2 ,556 ,1106 ,0,3,1,3,0,1,0,76.14,50.27 ,33.33
03,012,01,001,0076,222,501 ,2 ,503 ,941 ,0,3,1,3,0,1,0,76.14,53.45 ,33.33
03,012,01,001,0076,223,563 ,12 ,575 ,1125 ,0,3,1,3,0,1,0,76.14,51.11 ,33.33
03,012,01,001,0077,224,595 ,8 ,603 ,1100 ,0,3,1,3,0,1,0,76.14,54.82 ,33.33
03,012,01,001,0077,225,759 ,9 ,768 ,1409 ,0,3,1,3,0,1,0,76.14,54.51 ,33.33
03,012,01,001,0078,226,535 ,3 ,538 ,922 ,0,3,1,3,0,1,0,76.14,58.35 ,33.33
03,012,01,001,0078,227,521 ,5 ,526 ,914 ,0,3,1,3,0,1,0,76.14,57.55 ,33.33
03,012,01,001,0078,228,480 ,3 ,483 ,1014 ,0,3,1,3,0,1,0,76.14,47.63 ,33.33
03,012,01,002,0079,229,808 ,7 ,815 ,1362 ,0,3,1,3,0,1,0,76.14,59.84 ,33.33
03,012,01,002,0079,230,753 ,8 ,761 ,1262 ,0,3,1,3,0,1,0,76.14,60.30 ,33.33
03,012,01,002,0080,231,632 ,2 ,634 ,1011 ,0,3,1,3,0,1,0,76.14,62.71 ,33.33
03,012,01,002,0080,232,588 ,6 ,594 ,978 ,0,3,1,3,0,1,0,76.14,60.74 ,33.33
03,012,01,002,0080,233,566 ,4 ,570 ,987 ,0,3,1,3,0,1,0,76.14,57.75 ,33.33
03,012,01,002,0081,234,689 ,3 ,692 ,1132 ,0,3,1,3,0,1,0,76.14,61.13 ,33.33
03,012,01,002,0081,235,576 ,5 ,581 ,944 ,0,3,1,3,0,1,0,76.14,61.55 ,33.33
03,012,01,002,0082,236,743 ,5 ,748 ,1175 ,0,3,1,3,0,1,0,76.14,63.66 ,33.33
03,012,01,002,0082,237,724 ,2 ,726 ,1316 ,0,3,1,3,0,1,0,76.14,55.17 ,33.33
03,012,01,002,0083,238,729 ,1 ,730 ,1173 ,0,3,1,3,0,1,0,76.14,62.23 ,33.33
03,012,01,002,0083,239,653 ,2 ,655 ,1106 ,0,3,1,3,0,1,0,76.14,59.22 ,33.33
03,012,01,002,0083,240,623 ,7 ,630 ,1083 ,0,3,1,3,0,1,0,76.14,58.17 ,33.33
03,012,01,002,0084,241,600 ,6 ,606 ,1011 ,0,3,1,3,0,1,0,76.14,59.94 ,33.33
03,012,01,002,0084,242,441 ,3 ,444 ,863 ,0,3,1,3,0,1,0,76.14,51.45 ,33.33
03,012,01,002,0085,243,763 ,5 ,768 ,1271 ,0,3,1,3,0,1,0,76.14,60.42 ,33.33
03,012,01,002,0085,244,659 ,6 ,665 ,1110 ,0,3,1,3,0,1,0,76.14,59.91 ,33.33
03,012,01,002,0086,245,813 ,16 ,829 ,1428 ,0,3,1,3,0,1,0,76.14,58.05 ,33.33
03,012,01,002,0086,246,716 ,6 ,722 ,1121 ,0,3,1,3,0,1,0,76.14,64.41 ,33.33
03,012,01,002,0087,247,535 ,3 ,538 ,903 ,0,3,1,3,0,1,0,76.14,59.58 ,33.33
03,012,01,002,0087,248,463 ,37 ,500 ,787 ,0,3,1,3,0,1,0,76.14,63.53 ,33.33
03,012,01,002,0088,249,601 ,4 ,605 ,1064 ,0,3,1,3,0,1,0,76.14,56.86 ,33.33
03,012,01,002,0088,250,618 ,2 ,620 ,1022 ,0,3,1,3,0,1,0,76.14,60.67 ,33.33
03,012,01,002,0088,251,662 ,6 ,668 ,1045 ,0,3,1,3,0,1,0,76.14,63.92 ,33.33
03,012,01,002,0089,252,571 ,3 ,574 ,950 ,0,3,1,3,0,1,0,76.14,60.42 ,33.33
03,012,01,002,0089,253,653 ,4 ,657 ,1072 ,0,3,1,3,0,1,0,76.14,61.29 ,33.33
03,012,01,002,0089,254,508 ,4 ,512 ,875 ,0,3,1,3,0,1,0,76.14,58.51 ,33.33
03,012,01,002,0090,255,810 ,7 ,817 ,1193 ,0,3,1,3,0,1,0,76.14,68.48 ,33.33
03,012,01,002,0091,256,501 ,13 ,514 ,831 ,0,3,1,3,0,1,0,76.14,61.85 ,33.33
03,012,01,002,0091,257,540 ,4 ,544 ,812 ,0,3,1,3,0,1,0,76.14,67.00 ,33.33
03,012,01,002,0092,258,527 ,5 ,532 ,828 ,0,3,1,3,0,1,0,76.14,64.25 ,33.33
03,012,01,002,0092,259,678 ,8 ,686 ,1130 ,0,3,1,3,0,1,0,76.14,60.71 ,33.33
03,012,01,002,0093,260,512 ,3 ,515 ,958 ,0,3,1,3,0,1,0,76.14,53.76 ,33.33
03,012,01,002,0093,261,638 ,6 ,644 ,1038 ,0,3,1,3,0,1,0,76.14,62.04 ,33.33
03,012,01,002,0093,262,902 ,13 ,915 ,1532 ,0,3,1,3,0,1,0,76.14,59.73 ,33.33
03,012,01,002,0094,263,511 ,2 ,513 ,861 ,0,3,1,3,0,1,0,76.14,59.58 ,33.33
03,012,01,002,0094,264,448 ,4 ,452 ,768 ,0,3,1,3,0,1,0,76.14,58.85 ,33.33
03,012,01,002,0095,265,902 ,15 ,917 ,1359 ,0,3,1,3,0,1,0,76.14,67.48 ,33.33
03,012,01,002,0096,266,556 ,3 ,559 ,896 ,0,3,1,3,0,1,0,76.14,62.39 ,33.33
03,012,01,002,0096,267,562 ,0 ,562 ,913 ,0,3,1,3,0,1,0,76.14,61.56 ,33.33
03,012,01,002,0096,268,676 ,1 ,677 ,1001 ,0,3,1,3,0,1,0,76.14,67.63 ,33.33
03,012,01,002,0097,269,590 ,6 ,596 ,950 ,0,3,1,3,0,1,0,76.14,62.74 ,33.33
03,012,01,002,0097,270,510 ,4 ,514 ,764 ,0,3,1,3,0,1,0,76.14,67.28 ,33.33
03,012,01,002,0098,271,495 ,4 ,499 ,728 ,0,3,1,3,0,1,0,76.14,68.54 ,33.33
03,012,01,002,0098,272,590 ,4 ,594 ,932 ,0,3,1,3,0,1,0,76.14,63.73 ,33.33
03,012,01,002,0099,273,537 ,4 ,541 ,880 ,0,3,1,3,0,1,0,76.14,61.48 ,33.33
03,012,01,002,0100,274,449 ,8 ,457 ,743 ,0,3,1,3,0,1,0,76.14,61.51 ,33.33
03,012,01,002,0101,275,641 ,9 ,650 ,1080 ,0,3,1,3,0,1,0,76.14,60.19 ,33.33
03,012,01,002,0101,276,572 ,9 ,581 ,1009 ,0,3,1,3,0,1,0,76.14,57.58 ,33.33
03,012,01,002,0102,277,334 ,1 ,335 ,582 ,0,3,1,3,0,1,0,76.14,57.56 ,33.33
03,012,01,002,0102,278,478 ,8 ,486 ,867 ,0,3,1,3,0,1,0,76.14,56.06 ,33.33
03,012,01,003,0103,279,609 ,4 ,613 ,959 ,0,3,1,3,0,1,0,76.14,63.92 ,33.33
03,012,01,003,0103,280,638 ,9 ,647 ,1060 ,0,3,1,3,0,1,0,76.14,61.04 ,33.33
03,012,01,003,0104,281,445 ,6 ,451 ,696 ,0,3,1,3,0,1,0,76.14,64.80 ,33.33
03,012,01,003,0104,282,460 ,3 ,463 ,696 ,0,3,1,3,0,1,0,76.14,66.52 ,33.33
03,012,01,003,0105,283,479 ,3 ,482 ,698 ,0,3,1,3,0,1,0,76.14,69.05 ,33.33
03,012,01,003,0105,284,580 ,5 ,585 ,849 ,0,3,1,3,0,1,0,76.14,68.90 ,33.33
03,012,01,003,0106,285,594 ,16 ,610 ,1085 ,0,3,1,3,0,1,0,76.14,56.22 ,33.33
03,012,01,003,0106,286,616 ,2 ,618 ,1019 ,0,3,1,3,0,1,0,76.14,60.65 ,33.33
03,012,01,003,0106,287,489 ,3 ,492 ,855 ,0,3,1,3,0,1,0,76.14,57.54 ,33.33
03,012,01,003,0106,288,678 ,5 ,683 ,1161 ,0,3,1,3,0,1,0,76.14,58.83 ,33.33
03,012,01,003,0106,289,565 ,4 ,569 ,932 ,0,3,1,3,0,1,0,76.14,61.05 ,33.33
03,012,01,003,0106,290,681 ,3 ,684 ,1141 ,0,3,1,3,0,1,0,76.14,59.95 ,33.33
03,012,01,003,0106,291,608 ,19 ,627 ,1016 ,0,3,1,3,0,1,0,76.14,61.71 ,33.33
03,012,01,003,0106,292,628 ,0 ,628 ,1131 ,0,3,1,3,0,1,0,76.14,55.53 ,33.33
03,012,01,003,0107,293,656 ,7 ,663 ,1104 ,0,3,1,3,0,1,0,76.14,60.05 ,33.33
03,012,01,003,0107,294,608 ,6 ,614 ,1059 ,0,3,1,3,0,1,0,76.14,57.98 ,33.33
03,012,01,003,0107,295,496 ,3 ,499 ,970 ,0,3,1,3,0,1,0,76.14,51.44 ,33.33
03,012,01,003,0107,296,658 ,5 ,663 ,1255 ,0,3,1,3,0,1,0,76.14,52.83 ,33.33
03,012,01,003,0107,297,550 ,4 ,554 ,954 ,0,3,1,3,0,1,0,76.14,58.07 ,33.33
03,012,01,003,0108,298,567 ,3 ,570 ,907 ,0,3,1,3,0,1,0,76.14,62.84 ,33.33
03,012,01,003,0108,299,597 ,14 ,611 ,1056 ,0,3,1,3,0,1,0,76.14,57.86 ,33.33
03,012,01,003,0109,300,921 ,8 ,929 ,1470 ,0,3,1,3,0,1,0,76.14,63.20 ,33.33
03,012,01,003,0109,301,719 ,3 ,722 ,1221 ,0,3,1,3,0,1,0,76.14,59.13 ,33.33
03,012,01,003,0109,302,659 ,7 ,666 ,1145 ,0,3,1,3,0,1,0,76.14,58.17 ,33.33
03,012,01,003,0109,303,617 ,3 ,620 ,971 ,0,3,1,3,0,1,0,76.14,63.85 ,33.33
03,012,01,003,0109,304,601 ,4 ,605 ,916 ,0,3,1,3,0,1,0,76.14,66.05 ,33.33
03,012,01,003,0110,305,521 ,6 ,527 ,762 ,0,3,1,3,0,1,0,76.14,69.16 ,33.33
03,012,01,003,0110,306,476 ,4 ,480 ,711 ,0,3,1,3,0,1,0,76.14,67.51 ,33.33
03,012,01,003,0111,307,284 ,5 ,289 ,473 ,0,3,1,3,0,1,0,76.14,61.10 ,33.33
03,012,01,003,0111,308,424 ,8 ,432 ,655 ,0,3,1,3,0,1,0,76.14,65.95 ,33.33
03,012,01,003,0112,309,296 ,5 ,301 ,470 ,0,3,1,3,0,1,0,76.14,64.04 ,33.33
03,012,01,003,0112,310,395 ,4 ,399 ,695 ,0,3,1,3,0,1,0,76.14,57.41 ,33.33
03,012,01,003,0113,311,731 ,5 ,736 ,1174 ,0,3,1,3,0,1,0,76.14,62.69 ,33.33
03,012,01,003,0113,312,525 ,1 ,526 ,866 ,0,3,1,3,0,1,0,76.14,60.74 ,33.33
03,012,01,003,0113,313,532 ,12 ,544 ,890 ,0,3,1,3,0,1,0,76.14,61.12 ,33.33
03,012,01,003,0114,314,473 ,3 ,476 ,842 ,0,3,1,3,0,1,0,76.14,56.53 ,33.33
03,012,01,003,0114,315,603 ,8 ,611 ,1008 ,0,3,1,3,0,1,0,76.14,60.62 ,33.33
03,012,01,003,0114,316,819 ,8 ,827 ,1259 ,0,3,1,3,0,1,0,76.14,65.69 ,33.33
03,012,01,003,0115,317,538 ,3 ,541 ,977 ,0,3,1,3,0,1,0,76.14,55.37 ,33.33
03,012,01,003,0115,318,557 ,6 ,563 ,950 ,0,3,1,3,0,1,0,76.14,59.26 ,33.33
03,012,01,003,0115,319,559 ,4 ,563 ,1021 ,0,3,1,3,0,1,0,76.14,55.14 ,33.33
03,012,01,003,0115,320,533 ,3 ,536 ,908 ,0,3,1,3,0,1,0,76.14,59.03 ,33.33
03,012,01,003,0115,321,664 ,6 ,670 ,1158 ,0,3,1,3,0,1,0,76.14,57.86 ,33.33
03,012,01,003,0115,322,588 ,6 ,594 ,996 ,0,3,1,3,0,1,0,76.14,59.64 ,33.33
03,012,01,003,0116,323,537 ,6 ,543 ,910 ,0,3,1,3,0,1,0,76.14,59.67 ,33.33
03,012,01,003,0116,324,638 ,5 ,643 ,1038 ,0,3,1,3,0,1,0,76.14,61.95 ,33.33
03,012,01,003,0116,325,459 ,3 ,462 ,962 ,0,3,1,3,0,1,0,76.14,48.02 ,33.33
03,012,01,003,0116,326,588 ,4 ,592 ,997 ,0,3,1,3,0,1,0,76.14,59.38 ,33.33
03,012,01,003,0116,327,632 ,6 ,638 ,969 ,0,3,1,3,0,1,0,76.14,65.84 ,33.33
03,012,01,003,0116,328,566 ,3 ,569 ,1014 ,0,3,1,3,0,1,0,76.14,56.11 ,33.33
03,012,01,003,0117,329,526 ,4 ,530 ,1002 ,0,3,1,3,0,1,0,76.14,52.89 ,33.33
03,012,01,003,0117,330,668 ,2 ,670 ,1074 ,0,3,1,3,0,1,0,76.14,62.38 ,33.33
03,012,01,003,0117,331,891 ,4 ,895 ,1590 ,0,3,1,3,0,1,0,76.14,56.29 ,33.33
03,012,01,003,0117,332,744 ,7 ,751 ,1188 ,0,3,1,3,0,1,0,76.14,63.22 ,33.33
03,012,01,003,0118,333,840 ,5 ,845 ,1325 ,0,3,1,3,0,1,0,76.14,63.77 ,33.33
03,012,01,003,0118,334,813 ,6 ,819 ,1388 ,0,3,1,3,0,1,0,76.14,59.01 ,33.33
03,012,01,003,0118,335,753 ,3 ,756 ,1278 ,0,3,1,3,0,1,0,76.14,59.15 ,33.33
03,012,01,003,0119,336,652 ,5 ,657 ,1107 ,0,3,1,3,0,1,0,76.14,59.35 ,33.33
03,012,01,003,0119,337,617 ,2 ,619 ,980 ,0,3,1,3,0,1,0,76.14,63.16 ,33.33
03,012,01,003,0120,338,607 ,4 ,611 ,1137 ,0,3,1,3,0,1,0,76.14,53.74 ,33.33
03,012,01,003,0120,339,717 ,11 ,728 ,1263 ,0,3,1,3,0,1,0,76.14,57.64 ,33.33
03,012,01,003,0120,340,596 ,7 ,603 ,1088 ,0,3,1,3,0,1,0,76.14,55.42 ,33.33
03,012,01,003,0120,341,682 ,7 ,689 ,1197 ,0,3,1,3,0,1,0,76.14,57.56 ,33.33
03,012,01,003,0120,342,526 ,5 ,531 ,952 ,0,3,1,3,0,1,0,76.14,55.78 ,33.33
03,012,01,003,0121,343,500 ,6 ,506 ,758 ,0,3,1,3,0,1,0,76.14,66.75 ,33.33
03,012,01,003,0121,344,339 ,1 ,340 ,582 ,0,3,1,3,0,1,0,76.14,58.42 ,33.33
03,012,01,003,0122,345,619 ,10 ,629 ,1336 ,0,3,1,3,0,1,0,76.14,47.08 ,33.33
03,012,01,003,0122,346,626 ,6 ,632 ,1072 ,0,3,1,3,0,1,0,76.14,58.96 ,33.33
03,012,01,003,0122,347,537 ,4 ,541 ,1135 ,0,3,1,3,0,1,0,76.14,47.67 ,33.33
03,012,01,003,0122,348,281 ,2 ,283 ,425 ,0,3,1,3,0,1,0,76.14,66.59 ,33.33
03,012,01,003,0123,349,514 ,11 ,525 ,764 ,0,3,1,3,0,1,0,76.14,68.72 ,33.33
03,012,01,003,0123,350,367 ,3 ,370 ,663 ,0,3,1,3,0,1,0,76.14,55.81 ,33.33
03,012,01,003,0124,351,663 ,8 ,671 ,1098 ,0,3,1,3,0,1,0,76.14,61.11 ,33.33
03,012,01,003,0124,352,453 ,7 ,460 ,702 ,0,3,1,3,0,1,0,76.14,65.53 ,33.33
03,012,01,003,0125,353,804 ,4 ,808 ,1253 ,0,3,1,3,0,1,0,76.14,64.49 ,33.33
03,012,01,003,0125,354,887 ,15 ,902 ,1306 ,0,3,1,3,0,1,0,76.14,69.07 ,33.33
03,012,01,003,0126,355,847 ,7 ,854 ,1269 ,0,3,1,3,0,1,0,76.14,67.30 ,33.33
03,012,01,003,0127,356,642 ,5 ,647 ,1106 ,0,3,1,3,0,1,0,76.14,58.50 ,33.33
03,012,01,003,0127,357,558 ,3 ,561 ,949 ,0,3,1,3,0,1,0,76.14,59.11 ,33.33
03,012,01,003,0127,358,504 ,2 ,506 ,966 ,0,3,1,3,0,1,0,76.14,52.38 ,33.33
03,012,01,003,0128,359,616 ,1 ,617 ,1011 ,0,3,1,3,0,1,0,76.14,61.03 ,33.33
03,012,01,003,0128,360,469 ,7 ,476 ,793 ,0,3,1,3,0,1,0,76.14,60.03 ,33.33
03,012,01,004,0129,361,657 ,2 ,659 ,1052 ,0,3,1,3,0,1,0,76.14,62.64 ,33.33
03,012,01,004,0129,362,624 ,5 ,629 ,1100 ,0,3,1,3,0,1,0,76.14,57.18 ,33.33
03,012,01,004,0130,363,904 ,3 ,907 ,1727 ,0,3,1,3,0,1,0,76.14,52.52 ,33.33
03,012,01,004,0130,364,785 ,9 ,794 ,1240 ,0,3,1,3,0,1,0,76.14,64.03 ,33.33
03,012,01,004,0130,365,663 ,3 ,666 ,1103 ,0,3,1,3,0,1,0,76.14,60.38 ,33.33
03,012,01,004,0131,366,815 ,8 ,823 ,1307 ,0,3,1,3,0,1,0,76.14,62.97 ,33.33
03,012,01,004,0131,367,713 ,5 ,718 ,1064 ,0,3,1,3,0,1,0,76.14,67.48 ,33.33
03,012,01,004,0131,368,976 ,15 ,991 ,1510 ,0,3,1,3,0,1,0,76.14,65.63 ,33.33
03,012,01,004,0132,369,740 ,5 ,745 ,1091 ,0,3,1,3,0,1,0,76.14,68.29 ,33.33
03,012,01,004,0132,370,668 ,4 ,672 ,1080 ,0,3,1,3,0,1,0,76.14,62.22 ,33.33
03,012,01,004,0133,371,723 ,8 ,731 ,1098 ,0,3,1,3,0,1,0,76.14,66.58 ,33.33
03,012,01,004,0133,372,783 ,3 ,786 ,1180 ,0,3,1,3,0,1,0,76.14,66.61 ,33.33
03,012,01,004,0134,373,530 ,5 ,535 ,766 ,0,3,1,3,0,1,0,76.14,69.84 ,33.33
03,012,01,004,0134,374,486 ,8 ,494 ,742 ,0,3,1,3,0,1,0,76.14,66.58 ,33.33
03,012,01,004,0135,375,799 ,11 ,810 ,1234 ,0,3,1,3,0,1,0,76.14,65.64 ,33.33
03,012,01,004,0136,376,496 ,2 ,498 ,703 ,0,3,1,3,0,1,0,76.14,70.84 ,33.33
03,012,01,004,0136,377,581 ,2 ,583 ,874 ,0,3,1,3,0,1,0,76.14,66.70 ,33.33
03,012,01,004,0137,378,747 ,6 ,753 ,1134 ,0,3,1,3,0,1,0,76.14,66.40 ,33.33
03,012,01,004,0137,379,743 ,4 ,747 ,1125 ,0,3,1,3,0,1,0,76.14,66.40 ,33.33
03,012,01,004,0138,380,738 ,2 ,740 ,1180 ,0,3,1,3,0,1,0,76.14,62.71 ,33.33
03,012,01,004,0138,381,595 ,3 ,598 ,981 ,0,3,1,3,0,1,0,76.14,60.96 ,33.33
03,012,01,004,0138,382,681 ,6 ,687 ,1104 ,0,3,1,3,0,1,0,76.14,62.23 ,33.33
03,012,01,004,0139,383,705 ,5 ,710 ,1088 ,0,3,1,3,0,1,0,76.14,65.26 ,33.33
03,012,01,004,0140,384,668 ,1 ,669 ,944 ,0,3,1,3,0,1,0,76.14,70.87 ,33.33
03,012,01,004,0141,385,603 ,7 ,610 ,955 ,0,3,1,3,0,1,0,76.14,63.87 ,33.33
03,012,01,004,0142,386,518 ,5 ,523 ,814 ,0,3,1,3,0,1,0,76.14,64.25 ,33.33
03,012,01,004,0143,387,862 ,1 ,863 ,1342 ,0,3,1,3,0,1,0,76.14,64.31 ,33.33
03,012,01,004,0144,388,507 ,0 ,507 ,773 ,0,3,1,3,0,1,0,76.14,65.59 ,33.33
03,012,01,004,0144,389,569 ,3 ,572 ,897 ,0,3,1,3,0,1,0,76.14,63.77 ,33.33
03,012,01,004,0145,390,618 ,7 ,625 ,989 ,0,3,1,3,0,1,0,76.14,63.20 ,33.33
03,012,01,004,0145,391,537 ,6 ,543 ,872 ,0,3,1,3,0,1,0,76.14,62.27 ,33.33
03,012,01,004,0146,392,433 ,6 ,439 ,611 ,0,3,1,3,0,1,0,76.14,71.85 ,33.33
03,012,01,005,0147,393,588 ,10 ,598 ,947 ,0,3,1,3,0,1,0,76.14,63.15 ,33.33
03,012,01,005,0148,394,739 ,5 ,744 ,1090 ,0,3,1,3,0,1,0,76.14,68.26 ,33.33
03,012,01,005,0148,395,522 ,5 ,527 ,886 ,0,3,1,3,0,1,0,76.14,59.48 ,33.33
03,012,01,005,0149,396,590 ,6 ,596 ,995 ,0,3,1,3,0,1,0,76.14,59.90 ,33.33
03,012,01,005,0149,397,551 ,4 ,555 ,976 ,0,3,1,3,0,1,0,76.14,56.86 ,33.33
03,012,01,005,0149,398,673 ,4 ,677 ,1062 ,0,3,1,3,0,1,0,76.14,63.75 ,33.33
03,012,01,005,0149,399,645 ,7 ,652 ,1072 ,0,3,1,3,0,1,0,76.14,60.82 ,33.33
03,012,01,005,0150,400,731 ,8 ,739 ,1186 ,0,3,1,3,0,1,0,76.14,62.31 ,33.33
03,012,01,005,0150,401,797 ,4 ,801 ,1323 ,0,3,1,3,0,1,0,76.14,60.54 ,33.33
03,012,01,005,0151,402,935 ,5 ,940 ,1469 ,0,3,1,3,0,1,0,76.14,63.99 ,33.33
03,012,01,005,0151,403,606 ,2 ,608 ,1012 ,0,3,1,3,0,1,0,76.14,60.08 ,33.33
03,012,01,005,0152,404,617 ,4 ,621 ,900 ,0,3,1,3,0,1,0,76.14,69.00 ,33.33
03,012,01,005,0152,405,867 ,9 ,876 ,1413 ,0,3,1,3,0,1,0,76.14,62.00 ,33.33
03,012,01,005,0152,406,713 ,12 ,725 ,1120 ,0,3,1,3,0,1,0,76.14,64.73 ,33.33
03,012,01,005,0152,407,649 ,1 ,650 ,1104 ,0,3,1,3,0,1,0,76.14,58.88 ,33.33
03,012,01,005,0153,408,686 ,7 ,693 ,1216 ,0,3,1,3,0,1,0,76.14,56.99 ,33.33
03,012,01,005,0153,409,707 ,13 ,720 ,1172 ,0,3,1,3,0,1,0,76.14,61.43 ,33.33
03,012,01,005,0153,410,716 ,5 ,721 ,1130 ,0,3,1,3,0,1,0,76.14,63.81 ,33.33
03,012,01,005,0154,411,890 ,5 ,895 ,1369 ,0,3,1,3,0,1,0,76.14,65.38 ,33.33
03,012,01,005,0154,412,772 ,10 ,782 ,1295 ,0,3,1,3,0,1,0,76.14,60.39 ,33.33
03,012,01,005,0155,413,887 ,7 ,894 ,1440 ,0,3,1,3,0,1,0,76.14,62.08 ,33.33
03,012,01,006,0156,414,865 ,9 ,874 ,1486 ,0,3,1,3,0,1,0,76.14,58.82 ,33.33
03,012,01,006,0156,415,775 ,9 ,784 ,1291 ,0,3,1,3,0,1,0,76.14,60.73 ,33.33
03,012,01,006,0156,416,929 ,10 ,939 ,1457 ,0,3,1,3,0,1,0,76.14,64.45 ,33.33
03,012,01,006,0157,417,752 ,8 ,760 ,1154 ,0,3,1,3,0,1,0,76.14,65.86 ,33.33
03,012,01,006,0157,418,718 ,8 ,726 ,1183 ,0,3,1,3,0,1,0,76.14,61.37 ,33.33
03,012,01,006,0157,419,798 ,3 ,801 ,1391 ,0,3,1,3,0,1,0,76.14,57.58 ,33.33
03,012,01,006,0157,420,858 ,5 ,863 ,1671 ,0,3,1,3,0,1,0,76.14,51.65 ,33.33
03,012,01,006,0158,421,599 ,3 ,602 ,1000 ,0,3,1,3,0,1,0,76.14,60.20 ,33.33
03,012,01,006,0158,422,640 ,11 ,651 ,1104 ,0,3,1,3,0,1,0,76.14,58.97 ,33.33
03,012,01,006,0159,423,712 ,7 ,719 ,1089 ,0,3,1,3,0,1,0,76.14,66.02 ,33.33
03,012,01,006,0159,424,669 ,6 ,675 ,1077 ,0,3,1,3,0,1,0,76.14,62.67 ,33.33
03,012,01,006,0160,425,795 ,8 ,803 ,1328 ,0,3,1,3,0,1,0,76.14,60.47 ,33.33
03,012,01,006,0161,426,717 ,12 ,729 ,1172 ,0,3,1,3,0,1,0,76.14,62.20 ,33.33
03,012,01,006,0161,427,658 ,4 ,662 ,1173 ,0,3,1,3,0,1,0,76.14,56.44 ,33.33
03,012,01,006,0161,428,537 ,4 ,541 ,1190 ,0,3,1,3,0,1,0,76.14,45.46 ,33.33
03,012,01,006,0161,429,934 ,11 ,945 ,1717 ,0,3,1,3,0,1,0,76.14,55.04 ,33.33
03,012,01,006,0161,430,890 ,4 ,894 ,1930 ,0,3,1,3,0,1,0,76.14,46.32 ,33.33
03,012,01,006,0162,431,681 ,3 ,684 ,1216 ,0,3,1,3,0,1,0,76.14,56.25 ,33.33
03,012,01,006,0162,432,632 ,5 ,637 ,1106 ,0,3,1,3,0,1,0,76.14,57.59 ,33.33
03,012,01,006,0163,433,557 ,8 ,565 ,881 ,0,3,1,3,0,1,0,76.14,64.13 ,33.33
03,012,01,006,0163,434,574 ,13 ,587 ,814 ,0,3,1,3,0,1,0,76.14,72.11 ,33.33
03,012,01,006,0164,435,734 ,2 ,736 ,1216 ,0,3,1,3,0,1,0,76.14,60.53 ,33.33
03,012,01,006,0164,436,406 ,4 ,410 ,792 ,0,3,1,3,0,1,0,76.14,51.77 ,33.33
03,012,01,006,0165,437,669 ,6 ,675 ,1175 ,0,3,1,3,0,1,0,76.14,57.45 ,33.33
03,012,01,006,0165,438,809 ,2 ,811 ,1462 ,0,3,1,3,0,1,0,76.14,55.47 ,33.33
03,012,01,006,0166,439,693 ,2 ,695 ,1122 ,0,3,1,3,0,1,0,76.14,61.94 ,33.33
03,012,01,006,0166,440,531 ,2 ,533 ,966 ,0,3,1,3,0,1,0,76.14,55.18 ,33.33
03,012,01,006,0167,441,907 ,8 ,915 ,1584 ,0,3,1,3,0,1,0,76.14,57.77 ,33.33
03,012,01,006,0167,442,869 ,8 ,877 ,1556 ,0,3,1,3,0,1,0,76.14,56.36 ,33.33
03,012,01,006,0168,443,813 ,10 ,823 ,1316 ,0,3,1,3,0,1,0,76.14,62.54 ,33.33
03,012,01,006,0169,444,837 ,14 ,851 ,1494 ,0,3,1,3,0,1,0,76.14,56.96 ,33.33
03,012,01,006,0169,445,590 ,3 ,593 ,868 ,0,3,1,3,0,1,0,76.14,68.32 ,33.33
03,012,01,006,0170,446,838 ,12 ,850 ,1300 ,0,3,1,3,0,1,0,76.14,65.38 ,33.33
03,012,01,006,0170,447,297 ,2 ,299 ,465 ,0,3,1,3,0,1,0,76.14,64.30 ,33.33
03,012,01,006,0170,448,684 ,7 ,691 ,1168 ,0,3,1,3,0,1,0,76.14,59.16 ,33.33
03,012,01,006,0171,449,400 ,1 ,401 ,614 ,0,3,1,3,0,1,0,76.14,65.31 ,33.33
03,012,01,007,0172,450,983 ,9 ,992 ,1647 ,0,3,1,3,0,1,0,76.14,60.23 ,33.33
03,012,01,007,0172,451,940 ,3 ,943 ,1498 ,0,3,1,3,0,1,0,76.14,62.95 ,33.33
03,012,01,007,0172,452,749 ,7 ,756 ,1747 ,0,3,1,3,0,1,0,76.14,43.27 ,33.33
03,012,01,007,0172,453,864 ,3 ,867 ,1612 ,0,3,1,3,0,1,0,76.14,53.78 ,33.33
03,012,01,007,0172,454,879 ,8 ,887 ,1439 ,0,3,1,3,0,1,0,76.14,61.64 ,33.33
03,012,01,007,0173,455,825 ,6 ,831 ,1224 ,0,3,1,3,0,1,0,76.14,67.89 ,33.33
03,012,01,007,0173,456,946 ,7 ,953 ,1615 ,0,3,1,3,0,1,0,76.14,59.01 ,33.33
03,012,01,007,0174,457,927 ,5 ,932 ,1485 ,0,3,1,3,0,1,0,76.14,62.76 ,33.33
03,012,01,007,0174,458,916 ,9 ,925 ,1552 ,0,3,1,3,0,1,0,76.14,59.60 ,33.33
03,012,01,007,0174,459,847 ,4 ,851 ,1476 ,0,3,1,3,0,1,0,76.14,57.66 ,33.33
03,012,01,007,0174,460,881 ,4 ,885 ,1665 ,0,3,1,3,0,1,0,76.14,53.15 ,33.33
03,012,01,007,0174,461,848 ,4 ,852 ,1401 ,0,3,1,3,0,1,0,76.14,60.81 ,33.33
03,012,01,007,0175,462,934 ,11 ,945 ,1416 ,0,3,1,3,0,1,0,76.14,66.74 ,33.33
03,012,01,007,0175,463,932 ,5 ,937 ,1504 ,0,3,1,3,0,1,0,76.14,62.30 ,33.33
03,012,01,007,0176,464,787 ,5 ,792 ,1256 ,0,3,1,3,0,1,0,76.14,63.06 ,33.33
03,012,01,007,0176,465,865 ,8 ,873 ,1241 ,0,3,1,3,0,1,0,76.14,70.35 ,33.33
03,012,01,007,0176,466,982 ,4 ,986 ,1675 ,0,3,1,3,0,1,0,76.14,58.87 ,33.33
03,012,01,007,0176,467,826 ,11 ,837 ,1451 ,0,3,1,3,0,1,0,76.14,57.68 ,33.33
03,012,01,007,0177,468,979 ,14 ,993 ,1584 ,0,3,1,3,0,1,0,76.14,62.69 ,33.33
03,012,01,007,0177,469,954 ,15 ,969 ,1656 ,0,3,1,3,0,1,0,76.14,58.51 ,33.33
03,012,01,007,0178,470,485 ,6 ,491 ,690 ,0,3,1,3,0,1,0,76.14,71.16 ,33.33
03,012,01,008,0179,471,804 ,7 ,811 ,1371 ,0,3,1,3,0,1,0,76.14,59.15 ,33.33
03,012,01,008,0179,472,656 ,4 ,660 ,1202 ,0,3,1,3,0,1,0,76.14,54.91 ,33.33
03,012,01,008,0179,473,604 ,9 ,613 ,1211 ,0,3,1,3,0,1,0,76.14,50.62 ,33.33
03,012,01,008,0180,474,727 ,5 ,732 ,1207 ,0,3,1,3,0,1,0,76.14,60.65 ,33.33
03,012,01,008,0181,475,799 ,5 ,804 ,1325 ,0,3,1,3,0,1,0,76.14,60.68 ,33.33
03,012,01,008,0181,476,691 ,4 ,695 ,1180 ,0,3,1,3,0,1,0,76.14,58.90 ,33.33
03,012,01,008,0181,477,387 ,1 ,388 ,642 ,0,3,1,3,0,1,0,76.14,60.44 ,33.33
03,012,01,008,0182,478,337 ,2 ,339 ,565 ,0,3,1,3,0,1,0,76.14,60.00 ,33.33
03,012,01,008,0182,479,357 ,3 ,360 ,592 ,0,3,1,3,0,1,0,76.14,60.81 ,33.33
03,012,01,008,0183,480,961 ,3 ,964 ,1440 ,0,3,1,3,0,1,0,76.14,66.94 ,33.33
03,012,01,008,0184,481,824 ,8 ,832 ,1244 ,0,3,1,3,0,1,0,76.14,66.88 ,33.33
03,012,01,008,0185,482,750 ,9 ,759 ,1230 ,0,3,1,3,0,1,0,76.14,61.71 ,33.33
03,012,01,008,0185,483,512 ,4 ,516 ,917 ,0,3,1,3,0,1,0,76.14,56.27 ,33.33
03,012,01,008,0185,484,419 ,3 ,422 ,865 ,0,3,1,3,0,1,0,76.14,48.79 ,33.33
03,012,01,008,0186,485,898 ,8 ,906 ,1573 ,0,3,1,3,0,1,0,76.14,57.60 ,33.33
03,012,01,008,0186,486,780 ,5 ,785 ,1398 ,0,3,1,3,0,1,0,76.14,56.15 ,33.33
03,012,01,008,0187,487,943 ,7 ,950 ,1560 ,0,3,1,3,0,1,0,76.14,60.90 ,33.33
03,012,01,008,0187,488,867 ,9 ,876 ,1515 ,0,3,1,3,0,1,0,76.14,57.82 ,33.33
03,012,01,008,0188,489,848 ,5 ,853 ,1529 ,0,3,1,3,0,1,0,76.14,55.79 ,33.33
03,012,01,008,0188,490,941 ,3 ,944 ,1579 ,0,3,1,3,0,1,0,76.14,59.78 ,33.33
03,012,01,008,0188,491,820 ,8 ,828 ,1403 ,0,3,1,3,0,1,0,76.14,59.02 ,33.33
03,012,01,008,0189,492,710 ,8 ,718 ,1259 ,0,3,1,3,0,1,0,76.14,57.03 ,33.33
03,012,01,008,0189,493,645 ,7 ,652 ,1098 ,0,3,1,3,0,1,0,76.14,59.38 ,33.33
03,012,01,008,0189,494,864 ,7 ,871 ,1437 ,0,3,1,3,0,1,0,76.14,60.61 ,33.33
03,012,01,008,0190,495,416 ,4 ,420 ,588 ,0,3,1,3,0,1,0,76.14,71.43 ,33.33
03,012,01,008,0191,496,745 ,7 ,752 ,1137 ,0,3,1,3,0,1,0,76.14,66.14 ,33.33
03,012,01,008,0191,497,804 ,6 ,810 ,1299 ,0,3,1,3,0,1,0,76.14,62.36 ,33.33
03,012,01,008,0192,498,620 ,3 ,623 ,1063 ,0,3,1,3,0,1,0,76.14,58.61 ,33.33
03,012,01,008,0192,499,612 ,4 ,616 ,915 ,0,3,1,3,0,1,0,76.14,67.32 ,33.33
03,012,01,008,0193,500,650 ,6 ,656 ,1047 ,0,3,1,3,0,1,0,76.14,62.66 ,33.33
03,012,01,008,0193,501,604 ,5 ,609 ,948 ,0,3,1,3,0,1,0,76.14,64.24 ,33.33
03,012,01,008,0193,502,765 ,4 ,769 ,1265 ,0,3,1,3,0,1,0,76.14,60.79 ,33.33
03,012,01,008,0194,503,783 ,5 ,788 ,1328 ,0,3,1,3,0,1,0,76.14,59.34 ,33.33
03,012,01,008,0194,504,888 ,3 ,891 ,1416 ,0,3,1,3,0,1,0,76.14,62.92 ,33.33
03,012,01,008,0194,505,343 ,0 ,343 ,498 ,0,3,1,3,0,1,0,76.14,68.88 ,33.33
03,012,01,008,0195,506,993 ,14 ,1007 ,1470 ,0,3,1,3,0,1,0,76.14,68.50 ,33.33
03,012,01,008,0196,507,621 ,5 ,626 ,1116 ,0,3,1,3,0,1,0,76.14,56.09 ,33.33
03,012,01,008,0196,508,705 ,7 ,712 ,1083 ,0,3,1,3,0,1,0,76.14,65.74 ,33.33
03,012,01,008,0196,509,648 ,7 ,655 ,1105 ,0,3,1,3,0,1,0,76.14,59.28 ,33.33
03,012,01,008,0196,510,786 ,6 ,792 ,1437 ,0,3,1,3,0,1,0,76.14,55.11 ,33.33
03,012,01,008,0197,511,702 ,8 ,710 ,1167 ,0,3,1,3,0,1,0,76.14,60.84 ,33.33
03,012,01,008,0197,512,477 ,3 ,480 ,788 ,0,3,1,3,0,1,0,76.14,60.91 ,33.33
03,012,01,008,0198,513,837 ,5 ,842 ,1321 ,0,3,1,3,0,1,0,76.14,63.74 ,33.33
03,012,01,008,0199,514,783 ,6 ,789 ,1306 ,0,3,1,3,0,1,0,76.14,60.41 ,33.33
03,012,01,008,0200,515,865 ,6 ,871 ,1277 ,0,3,1,3,0,1,0,76.14,68.21 ,33.33
03,012,01,008,0201,516,697 ,4 ,701 ,994 ,0,3,1,3,0,1,0,76.14,70.52 ,33.33
03,012,01,008,0202,517,689 ,4 ,693 ,1079 ,0,3,1,3,0,1,0,76.14,64.23 ,33.33
03,012,01,008,0202,518,609 ,3 ,612 ,987 ,0,3,1,3,0,1,0,76.14,62.01 ,33.33
03,012,01,008,0202,519,712 ,7 ,719 ,1122 ,0,3,1,3,0,1,0,76.14,64.08 ,33.33
03,012,01,008,0203,520,905 ,7 ,912 ,1338 ,0,3,1,3,0,1,0,76.14,68.16 ,33.33
03,012,01,008,0203,521,238 ,1 ,239 ,302 ,0,3,1,3,0,1,0,76.14,79.14 ,33.33
03,012,01,008,0204,522,523 ,9 ,532 ,731 ,0,3,1,3,0,1,0,76.14,72.78 ,33.33
03,012,01,008,0205,523,984 ,16 ,1000 ,1374 ,0,3,1,3,0,1,0,76.14,72.78 ,33.33
03,012,01,008,0206,524,510 ,7 ,517 ,790 ,0,3,1,3,0,1,0,76.14,65.44 ,33.33
03,012,01,008,0207,525,527 ,7 ,534 ,849 ,0,3,1,3,0,1,0,76.14,62.90 ,33.33
03,012,01,008,0208,526,277 ,2 ,279 ,419 ,0,3,1,3,0,1,0,76.14,66.59 ,33.33
03,012,01,008,0209,527,580 ,4 ,584 ,915 ,0,3,1,3,0,1,0,76.14,63.83 ,33.33
03,012,01,008,0210,528,604 ,8 ,612 ,917 ,0,3,1,3,0,1,0,76.14,66.74 ,33.33
03,012,01,008,0210,529,744 ,0 ,744 ,1183 ,0,3,1,3,0,1,0,76.14,62.89 ,33.33
03,012,01,008,0211,530,378 ,1 ,379 ,572 ,0,3,1,3,0,1,0,76.14,66.26 ,33.33
03,012,01,008,0211,531,500 ,2 ,502 ,732 ,0,3,1,3,0,1,0,76.14,68.58 ,33.33
03,012,01,008,0212,532,369 ,1 ,370 ,507 ,0,3,1,3,0,1,0,76.14,72.98 ,33.33
03,012,01,008,0212,533,424 ,7 ,431 ,615 ,0,3,1,3,0,1,0,76.14,70.08 ,33.33
03,012,01,008,0213,534,254 ,4 ,258 ,425 ,0,3,1,3,0,1,0,76.14,60.71 ,33.33
03,012,01,009,0214,535,650 ,8 ,658 ,1032 ,0,3,1,3,0,1,0,76.14,63.76 ,33.33
03,012,01,009,0214,536,448 ,3 ,451 ,732 ,0,3,1,3,0,1,0,76.14,61.61 ,33.33
03,012,01,009,0215,537,750 ,7 ,757 ,1134 ,0,3,1,3,0,1,0,76.14,66.75 ,33.33
03,012,01,009,0216,538,668 ,8 ,676 ,1006 ,0,3,1,3,0,1,0,76.14,67.20 ,33.33
03,012,01,009,0216,539,699 ,12 ,711 ,1105 ,0,3,1,3,0,1,0,76.14,64.34 ,33.33
03,012,01,009,0217,540,671 ,7 ,678 ,1051 ,0,3,1,3,0,1,0,76.14,64.51 ,33.33
03,012,01,009,0217,541,674 ,4 ,678 ,1125 ,0,3,1,3,0,1,0,76.14,60.27 ,33.33
03,012,01,009,0218,542,741 ,7 ,748 ,1156 ,0,3,1,3,0,1,0,76.14,64.71 ,33.33
03,012,01,009,0218,543,724 ,5 ,729 ,1128 ,0,3,1,3,0,1,0,76.14,64.63 ,33.33
03,012,01,009,0218,544,661 ,1 ,662 ,998 ,0,3,1,3,0,1,0,76.14,66.33 ,33.33
03,012,01,009,0219,545,533 ,5 ,538 ,777 ,0,3,1,3,0,1,0,76.14,69.24 ,33.33
03,012,01,009,0219,546,203 ,2 ,205 ,308 ,0,3,1,3,0,1,0,76.14,66.56 ,33.33
03,012,01,009,0219,547,134 ,1 ,135 ,181 ,0,3,1,3,0,1,0,76.14,74.59 ,33.33
03,012,01,009,0220,548,737 ,8 ,745 ,1109 ,0,3,1,3,0,1,0,76.14,67.18 ,33.33
03,012,01,009,0220,549,472 ,12 ,484 ,841 ,0,3,1,3,0,1,0,76.14,57.55 ,33.33
03,012,01,009,0221,550,681 ,3 ,684 ,1098 ,0,3,1,3,0,1,0,76.14,62.30 ,33.33
03,012,01,009,0221,551,657 ,6 ,663 ,1034 ,0,3,1,3,0,1,0,76.14,64.12 ,33.33
03,012,01,009,0222,552,687 ,15 ,702 ,1055 ,0,3,1,3,0,1,0,76.14,66.54 ,33.33
03,012,01,009,0223,553,580 ,4 ,584 ,1099 ,0,3,1,3,0,1,0,76.14,53.14 ,33.33
03,012,01,009,0223,554,680 ,5 ,685 ,1170 ,0,3,1,3,0,1,0,76.14,58.55 ,33.33
03,012,01,009,0223,555,341 ,3 ,344 ,458 ,0,3,1,3,0,1,0,76.14,75.11 ,33.33
03,012,01,009,0224,556,819 ,3 ,822 ,1146 ,0,3,1,3,0,1,0,76.14,71.73 ,33.33
03,012,01,009,0225,557,451 ,3 ,454 ,739 ,0,3,1,3,0,1,0,76.14,61.43 ,33.33
03,012,01,009,0226,558,491 ,2 ,493 ,722 ,0,3,1,3,0,1,0,76.14,68.28 ,33.33
03,012,01,009,0226,559,483 ,2 ,485 ,732 ,0,3,1,3,0,1,0,76.14,66.26 ,33.33
03,012,01,009,0227,560,636 ,8 ,644 ,1058 ,0,3,1,3,0,1,0,76.14,60.87 ,33.33
03,012,01,009,0227,561,715 ,4 ,719 ,1087 ,0,3,1,3,0,1,0,76.14,66.15 ,33.33
03,012,01,009,0228,562,687 ,6 ,693 ,1068 ,0,3,1,3,0,1,0,76.14,64.89 ,33.33
03,012,01,009,0229,563,404 ,3 ,407 ,586 ,0,3,1,3,0,1,0,76.14,69.45 ,33.33
03,012,01,009,0229,564,645 ,4 ,649 ,902 ,0,3,1,3,0,1,0,76.14,71.95 ,33.33
03,012,01,009,0230,565,424 ,2 ,426 ,646 ,0,3,1,3,0,1,0,76.14,65.94 ,33.33
03,012,01,010,0231,566,296 ,1 ,297 ,429 ,0,3,1,3,0,1,0,76.14,69.23 ,33.33
03,012,01,010,0232,567,725 ,12 ,737 ,1113 ,0,3,1,3,0,1,0,76.14,66.22 ,33.33
03,012,01,010,0233,568,901 ,19 ,920 ,1337 ,0,3,1,3,0,1,0,76.14,68.81 ,33.33
03,012,01,010,0233,569,609 ,7 ,616 ,882 ,0,3,1,3,0,1,0,76.14,69.84 ,33.33
03,012,01,010,0234,570,690 ,6 ,696 ,1060 ,0,3,1,3,0,1,0,76.14,65.66 ,33.33
03,012,01,010,0234,571,591 ,5 ,596 ,935 ,0,3,1,3,0,1,0,76.14,63.74 ,33.33
03,012,01,010,0234,572,669 ,4 ,673 ,1069 ,0,3,1,3,0,1,0,76.14,62.96 ,33.33
03,012,01,010,0235,573,873 ,4 ,877 ,1360 ,0,3,1,3,0,1,0,76.14,64.49 ,33.33
03,012,01,010,0235,574,926 ,8 ,934 ,1411 ,0,3,1,3,0,1,0,76.14,66.19 ,33.33
03,012,01,010,0236,575,507 ,2 ,509 ,809 ,0,3,1,3,0,1,0,76.14,62.92 ,33.33
03,012,01,010,0236,576,699 ,6 ,705 ,1008 ,0,3,1,3,0,1,0,76.14,69.94 ,33.33
03,012,01,010,0237,577,893 ,4 ,897 ,1418 ,0,3,1,3,0,1,0,76.14,63.26 ,33.33
03,012,01,010,0237,578,878 ,8 ,886 ,1391 ,0,3,1,3,0,1,0,76.14,63.70 ,33.33
03,012,01,010,0237,579,284 ,7 ,291 ,504 ,0,3,1,3,0,1,0,76.14,57.74 ,33.33
03,012,01,010,0237,580,274 ,7 ,281 ,540 ,0,3,1,3,0,1,0,76.14,52.04 ,33.33
03,012,01,010,0238,581,583 ,3 ,586 ,890 ,0,3,1,3,0,1,0,76.14,65.84 ,33.33
03,012,01,010,0238,582,365 ,1 ,366 ,565 ,0,3,1,3,0,1,0,76.14,64.78 ,33.33
03,012,01,010,0238,583,468 ,6 ,474 ,808 ,0,3,1,3,0,1,0,76.14,58.66 ,33.33
03,012,01,010,0239,584,667 ,8 ,675 ,1061 ,0,3,1,3,0,1,0,76.14,63.62 ,33.33
03,012,01,010,0239,585,772 ,8 ,780 ,1232 ,0,3,1,3,0,1,0,76.14,63.31 ,33.33
03,012,01,010,0240,586,562 ,2 ,564 ,945 ,0,3,1,3,0,1,0,76.14,59.68 ,33.33
03,012,01,010,0240,587,458 ,8 ,466 ,840 ,0,3,1,3,0,1,0,76.14,55.48 ,33.33
03,012,01,010,0241,588,802 ,11 ,813 ,1242 ,0,3,1,3,0,1,0,76.14,65.46 ,33.33
03,012,01,010,0241,589,690 ,5 ,695 ,1139 ,0,3,1,3,0,1,0,76.14,61.02 ,33.33
03,012,01,011,0242,590,275 ,0 ,275 ,365 ,0,3,1,3,0,1,0,76.14,75.34 ,33.33
03,012,01,011,0243,591,383 ,6 ,389 ,648 ,0,3,1,3,0,1,0,76.14,60.03 ,33.33
03,012,01,011,0244,592,685 ,3 ,688 ,945 ,0,3,1,3,0,1,0,76.14,72.80 ,33.33
03,012,01,011,0245,593,288 ,1 ,289 ,418 ,0,3,1,3,0,1,0,76.14,69.14 ,33.33
03,012,01,011,0246,594,564 ,6 ,570 ,892 ,0,3,1,3,0,1,0,76.14,63.90 ,33.33
03,012,01,011,0247,595,498 ,5 ,503 ,776 ,0,3,1,3,0,1,0,76.14,64.82 ,33.33
03,012,01,011,0247,596,379 ,4 ,383 ,540 ,0,3,1,3,0,1,0,76.14,70.93 ,33.33
03,012,01,011,0248,597,261 ,3 ,264 ,414 ,0,3,1,3,0,1,0,76.14,63.77 ,33.33
03,012,01,011,0249,598,285 ,3 ,288 ,420 ,0,3,1,3,0,1,0,76.14,68.57 ,33.33
03,012,01,011,0250,599,572 ,6 ,578 ,842 ,0,3,1,3,0,1,0,76.14,68.65 ,33.33
03,012,01,011,0251,600,895 ,6 ,901 ,1296 ,0,3,1,3,0,1,0,76.14,69.52 ,33.33
03,012,01,012,0252,601,632 ,7 ,639 ,1024 ,0,3,1,3,0,1,0,76.14,62.40 ,33.33
03,012,01,012,0252,602,656 ,3 ,659 ,1104 ,0,3,1,3,0,1,0,76.14,59.69 ,33.33
03,012,01,012,0252,603,636 ,3 ,639 ,1102 ,0,3,1,3,0,1,0,76.14,57.99 ,33.33
03,012,01,012,0252,604,565 ,6 ,571 ,995 ,0,3,1,3,0,1,0,76.14,57.39 ,33.33
03,012,01,012,0253,605,920 ,4 ,924 ,1457 ,0,3,1,3,0,1,0,76.14,63.42 ,33.33
03,012,01,012,0253,606,753 ,4 ,757 ,1248 ,0,3,1,3,0,1,0,76.14,60.66 ,33.33
03,012,01,012,0254,607,847 ,15 ,862 ,1455 ,0,3,1,3,0,1,0,76.14,59.24 ,33.33
03,012,01,012,0254,608,640 ,4 ,644 ,1104 ,0,3,1,3,0,1,0,76.14,58.33 ,33.33
03,012,01,012,0255,609,574 ,8 ,582 ,940 ,0,3,1,3,0,1,0,76.14,61.91 ,33.33
03,012,01,012,0255,610,613 ,7 ,620 ,1113 ,0,3,1,3,0,1,0,76.14,55.71 ,33.33
03,012,01,012,0256,611,766 ,4 ,770 ,1331 ,0,3,1,3,0,1,0,76.14,57.85 ,33.33
03,012,01,012,0257,612,736 ,6 ,742 ,1294 ,0,3,1,3,0,1,0,76.14,57.34 ,33.33
03,012,01,012,0258,613,611 ,8 ,619 ,1006 ,0,3,1,3,0,1,0,76.14,61.53 ,33.33
03,012,01,012,0258,614,541 ,7 ,548 ,927 ,0,3,1,3,0,1,0,76.14,59.12 ,33.33
03,012,01,012,0259,615,691 ,9 ,700 ,1123 ,0,3,1,3,0,1,0,76.14,62.33 ,33.33
03,012,01,012,0260,616,822 ,17 ,839 ,1346 ,0,3,1,3,0,1,0,76.14,62.33 ,33.33
03,012,01,012,0260,617,310 ,3 ,313 ,511 ,0,3,1,3,0,1,0,76.14,61.25 ,33.33
03,012,01,012,0261,618,441 ,5 ,446 ,725 ,0,3,1,3,0,1,0,76.14,61.52 ,33.33
03,012,01,012,0262,619,506 ,7 ,513 ,825 ,0,3,1,3,0,1,0,76.14,62.18 ,33.33
03,012,01,012,0262,620,465 ,8 ,473 ,762 ,0,3,1,3,0,1,0,76.14,62.07 ,33.33
03,012,01,012,0263,621,596 ,6 ,602 ,979 ,0,3,1,3,0,1,0,76.14,61.49 ,33.33
03,012,01,013,0264,622,537 ,6 ,543 ,796 ,0,3,1,3,0,1,0,76.14,68.22 ,33.33
03,012,01,013,0264,623,583 ,4 ,587 ,918 ,0,3,1,3,0,1,0,76.14,63.94 ,33.33
03,012,01,013,0265,624,784 ,7 ,791 ,1223 ,0,3,1,3,0,1,0,76.14,64.68 ,33.33
03,012,01,013,0265,625,782 ,8 ,790 ,1291 ,0,3,1,3,0,1,0,76.14,61.19 ,33.33
03,012,01,013,0266,626,615 ,8 ,623 ,954 ,0,3,1,3,0,1,0,76.14,65.30 ,33.33
03,012,01,013,0266,627,602 ,10 ,612 ,921 ,0,3,1,3,0,1,0,76.14,66.45 ,33.33
03,012,01,013,0266,628,646 ,49 ,695 ,1061 ,0,3,1,3,0,1,0,76.14,65.50 ,33.33
03,012,01,013,0267,629,541 ,4 ,545 ,931 ,0,3,1,3,0,1,0,76.14,58.54 ,33.33
03,012,01,013,0267,630,680 ,8 ,688 ,1020 ,0,3,1,3,0,1,0,76.14,67.45 ,33.33
03,012,01,013,0268,631,465 ,4 ,469 ,782 ,0,3,1,3,0,1,0,76.14,59.97 ,33.33
03,012,01,013,0268,632,520 ,4 ,524 ,790 ,0,3,1,3,0,1,0,76.14,66.33 ,33.33
03,012,01,013,0269,633,596 ,4 ,600 ,891 ,0,3,1,3,0,1,0,76.14,67.34 ,33.33
03,012,01,013,0270,634,680 ,9 ,689 ,1052 ,0,3,1,3,0,1,0,76.14,65.49 ,33.33
03,012,01,013,0270,635,723 ,7 ,730 ,1146 ,0,3,1,3,0,1,0,76.14,63.70 ,33.33
03,012,01,013,0271,636,684 ,14 ,698 ,1114 ,0,3,1,3,0,1,0,76.14,62.66 ,33.33
03,012,01,013,0271,637,721 ,1 ,722 ,1176 ,0,3,1,3,0,1,0,76.14,61.39 ,33.33
03,012,01,013,0271,638,744 ,7 ,751 ,1276 ,0,3,1,3,0,1,0,76.14,58.86 ,33.33
03,012,01,013,0272,639,923 ,8 ,931 ,1534 ,0,3,1,3,0,1,0,76.14,60.69 ,33.33
03,012,01,013,0272,640,854 ,7 ,861 ,1368 ,0,3,1,3,0,1,0,76.14,62.94 ,33.33
03,012,01,013,0273,641,908 ,10 ,918 ,1485 ,0,3,1,3,0,1,0,76.14,61.82 ,33.33
03,012,01,013,0273,642,735 ,11 ,746 ,1202 ,0,3,1,3,0,1,0,76.14,62.06 ,33.33
03,012,01,013,0274,643,705 ,11 ,716 ,1049 ,0,3,1,3,0,1,0,76.14,68.26 ,33.33
03,012,01,013,0274,644,737 ,9 ,746 ,1141 ,0,3,1,3,0,1,0,76.14,65.38 ,33.33
03,012,01,013,0275,645,698 ,7 ,705 ,1093 ,0,3,1,3,0,1,0,76.14,64.50 ,33.33
03,012,01,013,0275,646,677 ,7 ,684 ,1055 ,0,3,1,3,0,1,0,76.14,64.83 ,33.33
03,012,01,013,0276,647,814 ,8 ,822 ,1264 ,0,3,1,3,0,1,0,76.14,65.03 ,33.33
03,012,01,013,0276,648,926 ,9 ,935 ,1508 ,0,3,1,3,0,1,0,76.14,62.00 ,33.33
03,012,01,013,0277,649,760 ,4 ,764 ,1279 ,0,3,1,3,0,1,0,76.14,59.73 ,33.33
03,012,01,013,0277,650,777 ,13 ,790 ,1354 ,0,3,1,3,0,1,0,76.14,58.35 ,33.33
03,012,01,013,0278,651,687 ,3 ,690 ,1158 ,0,3,1,3,0,1,0,76.14,59.59 ,33.33
03,012,01,013,0279,652,774 ,15 ,789 ,1190 ,0,3,1,3,0,1,0,76.14,66.30 ,33.33
03,012,01,013,0280,653,626 ,10 ,636 ,933 ,0,3,1,3,0,1,0,76.14,68.17 ,33.33
03,012,01,013,0281,654,788 ,7 ,795 ,1105 ,0,3,1,3,0,1,0,76.14,71.95 ,33.33
03,012,01,013,0282,655,644 ,11 ,655 ,879 ,0,3,1,3,0,1,0,76.14,74.52 ,33.33
03,012,01,013,0283,656,985 ,6 ,991 ,1542 ,0,3,1,3,0,1,0,76.14,64.27 ,33.33
03,012,01,014,0284,657,451 ,6 ,457 ,672 ,0,3,1,3,0,1,0,76.14,68.01 ,33.33
03,012,01,014,0284,658,479 ,9 ,488 ,787 ,0,3,1,3,0,1,0,76.14,62.01 ,33.33
03,012,01,014,0284,659,693 ,0 ,693 ,1106 ,0,3,1,3,0,1,0,76.14,62.66 ,33.33
03,012,01,014,0285,660,645 ,5 ,650 ,1053 ,0,3,1,3,0,1,0,76.14,61.73 ,33.33
03,012,01,014,0286,661,457 ,7 ,464 ,728 ,0,3,1,3,0,1,0,76.14,63.74 ,33.33
03,012,01,014,0286,662,505 ,2 ,507 ,776 ,0,3,1,3,0,1,0,76.14,65.34 ,33.33
03,012,01,014,0286,663,792 ,9 ,801 ,1272 ,0,3,1,3,0,1,0,76.14,62.97 ,33.33
03,012,01,014,0287,664,644 ,8 ,652 ,1009 ,0,3,1,3,0,1,0,76.14,64.62 ,33.33
03,012,01,014,0287,665,502 ,6 ,508 ,910 ,0,3,1,3,0,1,0,76.14,55.82 ,33.33
03,012,01,014,0288,666,495 ,5 ,500 ,817 ,0,3,1,3,0,1,0,76.14,61.20 ,33.33
03,012,01,014,0288,667,531 ,2 ,533 ,956 ,0,3,1,3,0,1,0,76.14,55.75 ,33.33
03,012,01,014,0289,668,740 ,7 ,747 ,1159 ,0,3,1,3,0,1,0,76.14,64.45 ,33.33
03,012,01,014,0290,669,669 ,4 ,673 ,1065 ,0,3,1,3,0,1,0,76.14,63.19 ,33.33
03,012,01,014,0291,670,480 ,3 ,483 ,828 ,0,3,1,3,0,1,0,76.14,58.33 ,33.33
03,012,01,014,0292,671,417 ,3 ,420 ,680 ,0,3,1,3,0,1,0,76.14,61.76 ,33.33
03,012,01,014,0292,672,581 ,6 ,587 ,1013 ,0,3,1,3,0,1,0,76.14,57.95 ,33.33
03,012,01,014,0293,673,558 ,6 ,564 ,892 ,0,3,1,3,0,1,0,76.14,63.23 ,33.33
03,012,01,014,0293,674,589 ,4 ,593 ,989 ,0,3,1,3,0,1,0,76.14,59.96 ,33.33
03,012,01,014,0294,675,704 ,11 ,715 ,1179 ,0,3,1,3,0,1,0,76.14,60.64 ,33.33
03,012,01,014,0295,676,558 ,2 ,560 ,894 ,0,3,1,3,0,1,0,76.14,62.64 ,33.33
03,012,01,014,0295,677,660 ,5 ,665 ,1116 ,0,3,1,3,0,1,0,76.14,59.59 ,33.33
03,012,01,014,0296,678,563 ,10 ,573 ,997 ,0,3,1,3,0,1,0,76.14,57.47 ,33.33
03,012,01,014,0297,679,494 ,5 ,499 ,753 ,0,3,1,3,0,1,0,76.14,66.27 ,33.33
03,012,01,015,0298,680,684 ,4 ,688 ,1048 ,0,3,1,3,0,1,0,76.14,65.65 ,33.33
03,012,01,015,0299,681,560 ,2 ,562 ,894 ,0,3,1,3,0,1,0,76.14,62.86 ,33.33
03,012,01,015,0300,682,984 ,6 ,990 ,1605 ,0,3,1,3,0,1,0,76.14,61.68 ,33.33
03,012,01,015,0301,683,733 ,4 ,737 ,1372 ,0,3,1,3,0,1,0,76.14,53.72 ,33.33
03,012,01,015,0301,684,830 ,3 ,833 ,1461 ,0,3,1,3,0,1,0,76.14,57.02 ,33.33
03,012,01,015,0302,685,824 ,9 ,833 ,1479 ,0,3,1,3,0,1,0,76.14,56.32 ,33.33
03,012,01,015,0303,686,1110 ,5 ,1115 ,1859 ,0,3,1,3,0,1,0,76.14,59.98 ,33.33
03,012,01,015,0304,687,713 ,4 ,717 ,1174 ,0,3,1,3,0,1,0,76.14,61.07 ,33.33
03,012,01,015,0305,688,574 ,1 ,575 ,983 ,0,3,1,3,0,1,0,76.14,58.49 ,33.33
03,012,01,015,0306,689,719 ,7 ,726 ,1197 ,0,3,1,3,0,1,0,76.14,60.65 ,33.33
03,012,01,015,0307,690,755 ,7 ,762 ,1278 ,0,3,1,3,0,1,0,76.14,59.62 ,33.33
03,012,01,015,0308,691,716 ,13 ,729 ,1247 ,0,3,1,3,0,1,0,76.14,58.46 ,33.33
03,012,01,015,0308,692,973 ,11 ,984 ,1715 ,0,3,1,3,0,1,0,76.14,57.38 ,33.33
03,012,01,015,0309,693,750 ,3 ,753 ,1190 ,0,3,1,3,0,1,0,76.14,63.28 ,33.33
03,012,01,015,0310,694,641 ,10 ,651 ,1061 ,0,3,1,3,0,1,0,76.14,61.36 ,33.33
03,012,01,015,0311,695,743 ,19 ,762 ,1270 ,0,3,1,3,0,1,0,76.14,60.00 ,33.33
03,012,01,015,0312,696,1018 ,6 ,1024 ,1715 ,0,3,1,3,0,1,0,76.14,59.71 ,33.33
03,012,01,015,0312,697,933 ,9 ,942 ,1959 ,0,3,1,3,0,1,0,76.14,48.09 ,33.33
03,012,01,016,0313,698,443 ,4 ,447 ,698 ,0,3,1,3,0,1,0,76.14,64.04 ,33.33
03,012,01,016,0313,699,509 ,5 ,514 ,786 ,0,3,1,3,0,1,0,76.14,65.39 ,33.33
03,012,01,016,0314,700,567 ,4 ,571 ,861 ,0,3,1,3,0,1,0,76.14,66.32 ,33.33
03,012,01,016,0314,701,525 ,7 ,532 ,887 ,0,3,1,3,0,1,0,76.14,59.98 ,33.33
03,012,01,016,0315,702,596 ,6 ,602 ,959 ,0,3,1,3,0,1,0,76.14,62.77 ,33.33
03,012,01,016,0315,703,367 ,14 ,381 ,713 ,0,3,1,3,0,1,0,76.14,53.44 ,33.33
03,012,01,016,0315,704,369 ,0 ,369 ,706 ,0,3,1,3,0,1,0,76.14,52.27 ,33.33
03,012,01,016,0316,705,213 ,1 ,214 ,382 ,0,3,1,3,0,1,0,76.14,56.02 ,33.33
03,012,01,016,0317,706,749 ,13 ,762 ,1048 ,0,3,1,3,0,1,0,76.14,72.71 ,33.33
03,012,01,016,0317,707,570 ,6 ,576 ,983 ,0,3,1,3,0,1,0,76.14,58.60 ,33.33
03,012,01,016,0318,708,824 ,7 ,831 ,1280 ,0,3,1,3,0,1,0,76.14,64.92 ,33.33
03,012,01,016,0318,709,813 ,5 ,818 ,1366 ,0,3,1,3,0,1,0,76.14,59.88 ,33.33
03,012,01,017,0319,710,1063 ,9 ,1072 ,1514 ,0,3,1,3,0,1,0,76.14,70.81 ,33.33
03,012,01,017,0320,711,1261 ,13 ,1274 ,1773 ,0,3,1,3,0,1,0,76.14,71.86 ,33.33
03,012,01,017,0321,712,1285 ,12 ,1297 ,1918 ,0,3,1,3,0,1,0,76.14,67.62 ,33.33
03,012,01,017,0322,713,694 ,4 ,698 ,966 ,0,3,1,3,0,1,0,76.14,72.26 ,33.33
03,012,01,017,0323,714,697 ,5 ,702 ,1083 ,0,3,1,3,0,1,0,76.14,64.82 ,33.33
03,012,01,017,0324,715,1285 ,9 ,1294 ,1818 ,0,3,1,3,0,1,0,76.14,71.18 ,33.33
03,012,01,017,0325,716,430 ,1 ,431 ,584 ,0,3,1,3,0,1,0,76.14,73.80 ,33.33
03,012,01,017,0326,717,503 ,1 ,504 ,717 ,0,3,1,3,0,1,0,76.14,70.29 ,33.33
03,012,01,017,0327,718,1058 ,8 ,1066 ,1555 ,0,3,1,3,0,1,0,76.14,68.55 ,33.33
03,012,01,017,0328,719,565 ,5 ,570 ,859 ,0,3,1,3,0,1,0,76.14,66.36 ,33.33
03,012,01,017,0329,720,756 ,14 ,770 ,1015 ,0,3,1,3,0,1,0,76.14,75.86 ,33.33
03,012,01,017,0330,721,854 ,11 ,865 ,1181 ,0,3,1,3,0,1,0,76.14,73.24 ,33.33
03,012,01,017,0330,722,574 ,6 ,580 ,850 ,0,3,1,3,0,1,0,76.14,68.24 ,33.33
03,012,01,018,0331,723,624 ,3 ,627 ,1017 ,0,3,1,3,0,1,0,76.14,61.65 ,33.33
03,012,01,018,0331,724,616 ,6 ,622 ,979 ,0,3,1,3,0,1,0,76.14,63.53 ,33.33
03,012,01,018,0332,725,552 ,3 ,555 ,940 ,0,3,1,3,0,1,0,76.14,59.04 ,33.33
03,012,01,018,0332,726,614 ,1 ,615 ,1042 ,0,3,1,3,0,1,0,76.14,59.02 ,33.33
03,012,01,018,0333,727,498 ,4 ,502 ,826 ,0,3,1,3,0,1,0,76.14,60.77 ,33.33
03,012,01,018,0333,728,433 ,2 ,435 ,650 ,0,3,1,3,0,1,0,76.14,66.92 ,33.33
03,012,01,018,0333,729,475 ,3 ,478 ,782 ,0,3,1,3,0,1,0,76.14,61.13 ,33.33
03,012,01,018,0334,730,794 ,1 ,795 ,1153 ,0,3,1,3,0,1,0,76.14,68.95 ,33.33
03,012,01,018,0335,731,621 ,5 ,626 ,1046 ,0,3,1,3,0,1,0,76.14,59.85 ,33.33
03,012,01,018,0336,732,614 ,6 ,620 ,926 ,0,3,1,3,0,1,0,76.14,66.95 ,33.33
03,012,01,018,0337,733,724 ,7 ,731 ,1153 ,0,3,1,3,0,1,0,76.14,63.40 ,33.33
03,012,01,018,0337,734,709 ,7 ,716 ,1168 ,0,3,1,3,0,1,0,76.14,61.30 ,33.33
03,012,01,018,0337,735,626 ,6 ,632 ,1096 ,0,3,1,3,0,1,0,76.14,57.66 ,33.33
03,012,01,018,0338,736,721 ,4 ,725 ,1135 ,0,3,1,3,0,1,0,76.14,63.88 ,33.33
03,012,01,018,0338,737,480 ,6 ,486 ,738 ,0,3,1,3,0,1,0,76.14,65.85 ,33.33
03,012,01,018,0339,738,901 ,4 ,905 ,1359 ,0,3,1,3,0,1,0,76.14,66.59 ,33.33
03,012,01,018,0339,739,574 ,8 ,582 ,963 ,0,3,1,3,0,1,0,76.14,60.44 ,33.33
03,012,01,018,0340,740,412 ,3 ,415 ,694 ,0,3,1,3,0,1,0,76.14,59.80 ,33.33
03,012,01,018,0341,741,668 ,1 ,669 ,1087 ,0,3,1,3,0,1,0,76.14,61.55 ,33.33
03,012,01,018,0341,742,683 ,2 ,685 ,1183 ,0,3,1,3,0,1,0,76.14,57.90 ,33.33
03,012,01,018,0342,743,624 ,3 ,627 ,1113 ,0,3,1,3,0,1,0,76.14,56.33 ,33.33
03,012,01,018,0342,744,783 ,6 ,789 ,1352 ,0,3,1,3,0,1,0,76.14,58.36 ,33.33
03,012,01,018,0343,745,514 ,4 ,518 ,866 ,0,3,1,3,0,1,0,76.14,59.82 ,33.33
03,012,01,018,0343,746,445 ,5 ,450 ,855 ,0,3,1,3,0,1,0,76.14,52.63 ,33.33
03,012,01,018,0344,747,766 ,16 ,782 ,1159 ,0,3,1,3,0,1,0,76.14,67.47 ,33.33
03,012,01,018,0344,748,570 ,4 ,574 ,1013 ,0,3,1,3,0,1,0,76.14,56.66 ,33.33
03,012,01,018,0345,749,729 ,6 ,735 ,1121 ,0,3,1,3,0,1,0,76.14,65.57 ,33.33
03,012,01,018,0345,750,787 ,9 ,796 ,1342 ,0,3,1,3,0,1,0,76.14,59.31 ,33.33
03,012,01,019,0346,751,691 ,4 ,695 ,1145 ,0,3,1,3,0,1,0,76.14,60.70 ,33.33
03,012,01,019,0346,752,639 ,3 ,642 ,1132 ,0,3,1,3,0,1,0,76.14,56.71 ,33.33
03,012,01,019,0347,753,845 ,3 ,848 ,1299 ,0,3,1,3,0,1,0,76.14,65.28 ,33.33
03,012,01,019,0347,754,694 ,4 ,698 ,1118 ,0,3,1,3,0,1,0,76.14,62.43 ,33.33
03,012,01,019,0348,755,513 ,2 ,515 ,888 ,0,3,1,3,0,1,0,76.14,58.00 ,33.33
03,012,01,019,0349,756,389 ,3 ,392 ,583 ,0,3,1,3,0,1,0,76.14,67.24 ,33.33
03,012,01,019,0350,757,490 ,7 ,497 ,751 ,0,3,1,3,0,1,0,76.14,66.18 ,33.33
03,012,01,019,0351,758,457 ,5 ,462 ,749 ,0,3,1,3,0,1,0,76.14,61.68 ,33.33
03,012,01,019,0352,759,367 ,1 ,368 ,577 ,0,3,1,3,0,1,0,76.14,63.78 ,33.33
03,012,01,019,0353,760,497 ,3 ,500 ,905 ,0,3,1,3,0,1,0,76.14,55.25 ,33.33
03,012,01,019,0353,761,626 ,2 ,628 ,1040 ,0,3,1,3,0,1,0,76.14,60.38 ,33.33
03,012,01,019,0354,762,930 ,12 ,942 ,1615 ,0,3,1,3,0,1,0,76.14,58.33 ,33.33
03,012,01,019,0354,763,840 ,11 ,851 ,1424 ,0,3,1,3,0,1,0,76.14,59.76 ,33.33
03,012,01,019,0355,764,603 ,6 ,609 ,1046 ,0,3,1,3,0,1,0,76.14,58.22 ,33.33
03,012,01,019,0355,765,334 ,5 ,339 ,574 ,0,3,1,3,0,1,0,76.14,59.06 ,33.33
03,012,01,019,0355,766,180 ,1 ,181 ,281 ,0,3,1,3,0,1,0,76.14,64.41 ,33.33
03,012,01,019,0356,767,602 ,9 ,611 ,1007 ,0,3,1,3,0,1,0,76.14,60.68 ,33.33
03,012,01,019,0356,768,516 ,6 ,522 ,844 ,0,3,1,3,0,1,0,76.14,61.85 ,33.33
03,012,01,019,0357,769,712 ,8 ,720 ,1101 ,0,3,1,3,0,1,0,76.14,65.40 ,33.33
03,012,01,019,0357,770,311 ,3 ,314 ,435 ,0,3,1,3,0,1,0,76.14,72.18 ,33.33
03,012,01,019,0358,771,549 ,5 ,554 ,934 ,0,3,1,3,0,1,0,76.14,59.31 ,33.33
03,012,01,019,0358,772,309 ,3 ,312 ,519 ,0,3,1,3,0,1,0,76.14,60.12 ,33.33
03,012,01,019,0359,773,660 ,7 ,667 ,1004 ,0,3,1,3,0,1,0,76.14,66.43 ,33.33
03,012,01,019,0360,774,599 ,7 ,606 ,889 ,0,3,1,3,0,1,0,76.14,68.17 ,33.33
03,012,01,019,0361,775,880 ,7 ,887 ,1306 ,0,3,1,3,0,1,0,76.14,67.92 ,33.33
03,012,01,019,0362,776,635 ,3 ,638 ,920 ,0,3,1,3,0,1,0,76.14,69.35 ,33.33
03,012,01,019,0363,777,957 ,8 ,965 ,1358 ,0,3,1,3,0,1,0,76.14,71.06 ,33.33
03,012,01,019,0364,778,617 ,5 ,622 ,863 ,0,3,1,3,0,1,0,76.14,72.07 ,33.33
03,012,01,019,0365,779,834 ,5 ,839 ,1230 ,0,3,1,3,0,1,0,76.14,68.21 ,33.33
03,012,01,019,0365,780,726 ,2 ,728 ,1103 ,0,3,1,3,0,1,0,76.14,66.00 ,33.33
03,012,01,019,0366,781,529 ,6 ,535 ,924 ,0,3,1,3,0,1,0,76.14,57.90 ,33.33
03,012,01,019,0366,782,559 ,3 ,562 ,983 ,0,3,1,3,0,1,0,76.14,57.17 ,33.33
03,012,01,019,0367,783,393 ,4 ,397 ,659 ,0,3,1,3,0,1,0,76.14,60.24 ,33.33
03,012,01,019,0368,784,246 ,2 ,248 ,379 ,0,3,1,3,0,1,0,76.14,65.44 ,33.33
03,012,01,019,0369,785,425 ,5 ,430 ,640 ,0,3,1,3,0,1,0,76.14,67.19 ,33.33
03,012,01,019,0370,786,136 ,1 ,137 ,206 ,0,3,1,3,0,1,0,76.14,66.50 ,33.33
03,012,01,020,0371,787,546 ,3 ,549 ,917 ,0,3,1,3,0,1,0,76.14,59.87 ,33.33
03,012,01,020,0371,788,551 ,8 ,559 ,919 ,0,3,1,3,0,1,0,76.14,60.83 ,33.33
03,012,01,020,0372,789,822 ,7 ,829 ,1361 ,0,3,1,3,0,1,0,76.14,60.91 ,33.33
03,012,01,020,0373,790,914 ,3 ,917 ,1482 ,0,3,1,3,0,1,0,76.14,61.88 ,33.33
03,012,01,020,0374,791,547 ,9 ,556 ,947 ,0,3,1,3,0,1,0,76.14,58.71 ,33.33
03,012,01,020,0374,792,755 ,1 ,756 ,1307 ,0,3,1,3,0,1,0,76.14,57.84 ,33.33
03,012,01,020,0375,793,710 ,4 ,714 ,1171 ,0,3,1,3,0,1,0,76.14,60.97 ,33.33
03,012,01,020,0375,794,612 ,3 ,615 ,1000 ,0,3,1,3,0,1,0,76.14,61.50 ,33.33
03,012,01,020,0376,795,744 ,7 ,751 ,1171 ,0,3,1,3,0,1,0,76.14,64.13 ,33.33
03,012,01,020,0376,796,798 ,13 ,811 ,1351 ,0,3,1,3,0,1,0,76.14,60.03 ,33.33
03,012,01,020,0377,797,766 ,6 ,772 ,1275 ,0,3,1,3,0,1,0,76.14,60.55 ,33.33
03,012,01,020,0377,798,764 ,8 ,772 ,1232 ,0,3,1,3,0,1,0,76.14,62.66 ,33.33
03,012,01,020,0378,799,636 ,3 ,639 ,1007 ,0,3,1,3,0,1,0,76.14,63.46 ,33.33
03,012,01,020,0378,800,597 ,3 ,600 ,1010 ,0,3,1,3,0,1,0,76.14,59.41 ,33.33
03,012,01,020,0379,801,956 ,6 ,962 ,1478 ,0,3,1,3,0,1,0,76.14,65.09 ,33.33
03,012,01,020,0380,802,580 ,7 ,587 ,969 ,0,3,1,3,0,1,0,76.14,60.58 ,33.33
03,012,01,020,0380,803,469 ,4 ,473 ,735 ,0,3,1,3,0,1,0,76.14,64.35 ,33.33
03,012,01,020,0381,804,868 ,6 ,874 ,1407 ,0,3,1,3,0,1,0,76.14,62.12 ,33.33
03,012,01,020,0382,805,600 ,11 ,611 ,978 ,0,3,1,3,0,1,0,76.14,62.47 ,33.33
03,012,01,020,0382,806,597 ,3 ,600 ,1014 ,0,3,1,3,0,1,0,76.14,59.17 ,33.33
03,012,01,020,0383,807,522 ,2 ,524 ,844 ,0,3,1,3,0,1,0,76.14,62.09 ,33.33
03,012,01,020,0383,808,513 ,6 ,519 ,848 ,0,3,1,3,0,1,0,76.14,61.20 ,33.33
03,012,01,020,0384,809,593 ,3 ,596 ,1048 ,0,3,1,3,0,1,0,76.14,56.87 ,33.33
03,012,01,020,0385,810,676 ,10 ,686 ,1123 ,0,3,1,3,0,1,0,76.14,61.09 ,33.33
03,012,01,020,0386,811,851 ,2 ,853 ,1359 ,0,3,1,3,0,1,0,76.14,62.77 ,33.33
03,012,01,020,0386,812,668 ,3 ,671 ,1007 ,0,3,1,3,0,1,0,76.14,66.63 ,33.33
03,012,01,020,0387,813,504 ,1 ,505 ,756 ,0,3,1,3,0,1,0,76.14,66.80 ,33.33
03,012,01,020,0387,814,518 ,5 ,523 ,869 ,0,3,1,3,0,1,0,76.14,60.18 ,33.33
03,012,01,020,0388,815,845 ,5 ,850 ,1387 ,0,3,1,3,0,1,0,76.14,61.28 ,33.33
03,012,01,020,0389,816,742 ,3 ,745 ,1218 ,0,3,1,3,0,1,0,76.14,61.17 ,33.33
03,012,01,020,0390,817,535 ,4 ,539 ,859 ,0,3,1,3,0,1,0,76.14,62.75 ,33.33
03,012,01,020,0390,818,473 ,2 ,475 ,834 ,0,3,1,3,0,1,0,76.14,56.95 ,33.33
03,012,01,021,0391,819,528 ,13 ,541 ,1043 ,0,3,1,3,0,1,0,76.14,51.87 ,33.33
03,012,01,021,0392,820,745 ,9 ,754 ,1141 ,0,3,1,3,0,1,0,76.14,66.08 ,33.33
03,012,01,021,0393,821,746 ,11 ,757 ,1551 ,0,3,1,3,0,1,0,76.14,48.81 ,33.33
03,012,01,021,0394,822,728 ,3 ,731 ,1311 ,0,3,1,3,0,1,0,76.14,55.76 ,33.33
03,012,01,021,0395,823,507 ,3 ,510 ,885 ,0,3,1,3,0,1,0,76.14,57.63 ,33.33
03,012,01,021,0396,824,470 ,6 ,476 ,808 ,0,3,1,3,0,1,0,76.14,58.91 ,33.33
03,012,01,021,0397,825,400 ,7 ,407 ,735 ,0,3,1,3,0,1,0,76.14,55.37 ,33.33
03,012,01,021,0398,826,435 ,6 ,441 ,623 ,0,3,1,3,0,1,0,76.14,70.79 ,33.33
03,012,01,021,0399,827,207 ,3 ,210 ,344 ,0,3,1,3,0,1,0,76.14,61.05 ,33.33
03,012,01,021,0400,828,686 ,12 ,698 ,1352 ,0,3,1,3,0,1,0,76.14,51.63 ,33.33
03,012,01,021,0401,829,723 ,9 ,732 ,1496 ,0,3,1,3,0,1,0,76.14,48.93 ,33.33
03,012,01,021,0402,830,655 ,4 ,659 ,1096 ,0,3,1,3,0,1,0,76.14,60.13 ,33.33
03,012,01,022,0403,831,362 ,0 ,362 ,606 ,0,3,1,3,0,1,0,76.14,59.74 ,33.33
03,012,01,022,0404,832,685 ,3 ,688 ,1042 ,0,3,1,3,0,1,0,76.14,66.03 ,33.33
03,012,01,022,0405,833,530 ,4 ,534 ,833 ,0,3,1,3,0,1,0,76.14,64.11 ,33.33
03,012,01,022,0406,834,980 ,8 ,988 ,1591 ,0,3,1,3,0,1,0,76.14,62.10 ,33.33
03,012,01,022,0407,835,468 ,2 ,470 ,714 ,0,3,1,3,0,1,0,76.14,65.83 ,33.33
03,012,01,022,0408,836,447 ,6 ,453 ,715 ,0,3,1,3,0,1,0,76.14,63.36 ,33.33
03,012,01,022,0409,837,622 ,6 ,628 ,1126 ,0,3,1,3,0,1,0,76.14,55.77 ,33.33
03,012,01,023,0410,838,433 ,0 ,433 ,750 ,0,3,1,3,0,1,0,76.14,57.73 ,33.33
03,012,01,023,0411,839,371 ,4 ,375 ,773 ,0,3,1,3,0,1,0,76.14,48.51 ,33.33
03,012,01,023,0412,840,627 ,4 ,631 ,1098 ,0,3,1,3,0,1,0,76.14,57.47 ,33.33
03,012,01,023,0412,841,429 ,5 ,434 ,788 ,0,3,1,3,0,1,0,76.14,55.08 ,33.33
03,012,01,023,0413,842,657 ,11 ,668 ,1126 ,0,3,1,3,0,1,0,76.14,59.33 ,33.33
03,012,01,023,0413,843,370 ,6 ,376 ,612 ,0,3,1,3,0,1,0,76.14,61.44 ,33.33
03,012,01,023,0414,844,922 ,8 ,930 ,1506 ,0,3,1,3,0,1,0,76.14,61.75 ,33.33
03,012,01,023,0415,845,1013 ,9 ,1022 ,1758 ,0,3,1,3,0,1,0,76.14,58.13 ,33.33
03,012,01,023,0416,846,738 ,9 ,747 ,1305 ,0,3,1,3,0,1,0,76.14,57.24 ,33.33
03,012,01,024,0417,847,467 ,2 ,469 ,787 ,0,3,1,3,0,1,0,76.14,59.59 ,33.33
03,012,01,024,0418,848,567 ,7 ,574 ,1029 ,0,3,1,3,0,1,0,76.14,55.78 ,33.33
03,012,01,024,0419,849,269 ,2 ,271 ,483 ,0,3,1,3,0,1,0,76.14,56.11 ,33.33
03,012,01,024,0420,850,289 ,1 ,290 ,465 ,0,3,1,3,0,1,0,76.14,62.37 ,33.33
03,012,01,024,0421,851,600 ,9 ,609 ,1030 ,0,3,1,3,0,1,0,76.14,59.13 ,33.33
03,012,01,024,0422,852,447 ,2 ,449 ,692 ,0,3,1,3,0,1,0,76.14,64.88 ,33.33
03,012,01,024,0422,853,632 ,18 ,650 ,1055 ,0,3,1,3,0,1,0,76.14,61.61 ,33.33
03,012,01,024,0423,854,380 ,5 ,385 ,608 ,0,3,1,3,0,1,0,76.14,63.32 ,33.33
03,012,01,024,0424,855,234 ,1 ,235 ,363 ,0,3,1,3,0,1,0,76.14,64.74 ,33.33
03,012,01,024,0425,856,259 ,3 ,262 ,405 ,0,3,1,3,0,1,0,76.14,64.69 ,33.33
03,012,01,024,0426,857,559 ,5 ,564 ,783 ,0,3,1,3,0,1,0,76.14,72.03 ,33.33
03,012,01,024,0427,858,418 ,2 ,420 ,644 ,0,3,1,3,0,1,0,76.14,65.22 ,33.33
03,012,01,024,0428,859,334 ,2 ,336 ,497 ,0,3,1,3,0,1,0,76.14,67.61 ,33.33
03,012,01,024,0429,860,814 ,4 ,818 ,1158 ,0,3,1,3,0,1,0,76.14,70.64 ,33.33
03,012,01,024,0430,861,663 ,1 ,664 ,981 ,0,3,1,3,0,1,0,76.14,67.69 ,33.33
03,012,01,024,0431,862,323 ,1 ,324 ,505 ,0,3,1,3,0,1,0,76.14,64.16 ,33.33
03,012,01,024,0432,863,462 ,3 ,465 ,676 ,0,3,1,3,0,1,0,76.14,68.79 ,33.33
03,012,01,024,0433,864,457 ,3 ,460 ,693 ,0,3,1,3,0,1,0,76.14,66.38 ,33.33
03,012,01,024,0434,865,419 ,8 ,427 ,622 ,0,3,1,3,0,1,0,76.14,68.65 ,33.33
03,012,01,025,0435,866,23 ,0 ,23 ,58 ,0,3,1,3,0,1,0,76.14,39.66 ,33.33
03,012,01,025,0436,867,11 ,0 ,11 ,23 ,0,3,1,3,0,1,0,76.14,47.83 ,33.33
03,012,01,025,0437,868,9 ,0 ,9 ,25 ,0,3,1,3,0,1,0,76.14,36.00 ,33.33
03,012,01,026,0438,869,12 ,0 ,12 ,28 ,0,3,1,3,0,1,0,76.14,42.86 ,33.33
03,012,01,026,0438,870,7 ,0 ,7 ,14 ,0,3,1,3,0,1,0,76.14,50.00 ,33.33
03,012,01,026,0439,871,43 ,0 ,43 ,86 ,0,3,1,3,0,1,0,76.14,50.00 ,33.33
03,012,01,026,0440,872,24 ,0 ,24 ,59 ,0,3,1,3,0,1,0,76.14,40.68 ,33.33
03,012,01,026,0441,873,44 ,0 ,44 ,107 ,0,3,1,3,0,1,0,76.14,41.12 ,33.33
03,012,01,026,0442,874,6 ,2 ,8 ,18 ,0,3,1,3,0,1,0,76.14,44.44 ,33.33
03,012,01,026,0443,875,8 ,0 ,8 ,15 ,0,3,1,3,0,1,0,76.14,53.33 ,33.33
03,012,01,026,0444,876,4 ,0 ,4 ,10 ,0,3,1,3,0,1,0,76.14,40.00 ,33.33
03,012,01,026,0445,877,11 ,0 ,11 ,19 ,0,3,1,3,0,1,0,76.14,57.89 ,33.33
03,012,01,027,0446,878,61 ,0 ,61 ,187 ,0,3,1,3,0,1,0,76.14,32.62 ,33.33
03,012,01,027,0447,879,14 ,1 ,15 ,45 ,0,3,1,3,0,1,0,76.14,33.33 ,33.33
03,012,01,027,0448,880,55 ,1 ,56 ,98 ,0,3,1,3,0,1,0,76.14,57.14 ,33.33
03,013,01,001,0001,1,946 ,2 ,948 ,1465 ,0,3,1,3,0,1,0,76.14,64.71 ,33.33
03,013,01,001,0002,2,932 ,1 ,933 ,1470 ,0,3,1,3,0,1,0,76.14,63.47 ,33.33
03,013,01,001,0003,3,668 ,5 ,673 ,1058 ,0,3,1,3,0,1,0,76.14,63.61 ,33.33
03,013,01,001,0004,4,880 ,4 ,884 ,1387 ,0,3,1,3,0,1,0,76.14,63.73 ,33.33
03,013,01,001,0004,5,822 ,5 ,827 ,1405 ,0,3,1,3,0,1,0,76.14,58.86 ,33.33
03,013,01,001,0005,6,918 ,4 ,922 ,1456 ,0,3,1,3,0,1,0,76.14,63.32 ,33.33
03,013,01,001,0006,7,558 ,0 ,558 ,845 ,0,3,1,3,0,1,0,76.14,66.04 ,33.33
03,013,01,001,0007,8,923 ,5 ,928 ,1387 ,0,3,1,3,0,1,0,76.14,66.91 ,33.33
03,013,01,001,0008,9,892 ,3 ,895 ,1391 ,0,3,1,3,0,1,0,76.14,64.34 ,33.33
03,013,01,001,0009,10,762 ,3 ,765 ,1283 ,0,3,1,3,0,1,0,76.14,59.63 ,33.33
03,013,01,001,0010,11,897 ,2 ,899 ,1560 ,0,3,1,3,0,1,0,76.14,57.63 ,33.33
03,013,01,001,0011,12,574 ,5 ,579 ,909 ,0,3,1,3,0,1,0,76.14,63.70 ,33.33
03,013,01,001,0012,13,1038 ,5 ,1043 ,1676 ,0,3,1,3,0,1,0,76.14,62.23 ,33.33
03,013,01,001,0012,14,1114 ,7 ,1121 ,1850 ,0,3,1,3,0,1,0,76.14,60.59 ,33.33
03,013,01,001,0012,15,996 ,7 ,1003 ,1693 ,0,3,1,3,0,1,0,76.14,59.24 ,33.33
03,013,01,001,0012,16,1015 ,6 ,1021 ,1726 ,0,3,1,3,0,1,0,76.14,59.15 ,33.33
03,013,01,001,0012,17,1013 ,6 ,1019 ,1677 ,0,3,1,3,0,1,0,76.14,60.76 ,33.33
03,013,01,001,0013,18,663 ,3 ,666 ,1086 ,0,3,1,3,0,1,0,76.14,61.33 ,33.33
03,013,01,001,0013,19,846 ,2 ,848 ,1406 ,0,3,1,3,0,1,0,76.14,60.31 ,33.33
03,013,01,001,0013,20,890 ,7 ,897 ,1428 ,0,3,1,3,0,1,0,76.14,62.82,33.33
03,013,01,001,0014,21,769 ,1 ,770 ,1191 ,0,3,1,3,0,1,0,76.14,64.65,33.33
03,013,01,001,0014,22,747 ,4 ,751 ,1205 ,0,3,1,3,0,1,0,76.14,62.32 ,33.33
03,013,01,001,0015,23,743 ,4 ,747 ,1179 ,0,3,1,3,0,1,0,76.14,63.36 ,33.33
03,013,01,001,0015,24,793 ,9 ,802 ,1273 ,0,3,1,3,0,1,0,76.14,63.00 ,33.33
03,013,01,001,0015,25,761 ,3 ,764 ,1149 ,0,3,1,3,0,1,0,76.14,66.49 ,33.33
03,013,01,001,0016,26,643 ,2 ,645 ,1080 ,0,3,1,3,0,1,0,76.14,59.72 ,33.33
03,013,01,001,0016,27,574 ,1 ,575 ,968 ,0,3,1,3,0,1,0,76.14,59.40 ,33.33
03,013,01,001,0017,28,924 ,5 ,929 ,1604 ,0,3,1,3,0,1,0,76.14,57.92 ,33.33
03,013,01,001,0017,29,964 ,18 ,982 ,1647 ,0,3,1,3,0,1,0,76.14,59.62 ,33.33
03,013,01,001,0017,30,932 ,8 ,940 ,1589 ,0,3,1,3,0,1,0,76.14,59.16 ,33.33
03,013,01,001,0017,31,959 ,3 ,962 ,1597 ,0,3,1,3,0,1,0,76.14,60.24 ,33.33
03,013,01,001,0018,32,651 ,1 ,652 ,993 ,0,3,1,3,0,1,0,76.14,65.66 ,33.33
03,013,01,001,0019,33,914 ,7 ,921 ,1390 ,0,3,1,3,0,1,0,76.14,66.26,33.33
03,013,01,001,0020,34,689 ,3 ,692 ,1113 ,0,3,1,3,0,1,0,76.14,62.17,33.33
03,013,01,001,0021,35,890 ,4 ,894 ,1483 ,0,3,1,3,0,1,0,76.14,60.28 ,33.33
03,013,01,001,0021,36,885 ,1 ,886 ,1537 ,0,3,1,3,0,1,0,76.14,57.64 ,33.33
03,013,01,001,0022,37,1155 ,8 ,1163 ,1940 ,0,3,1,3,0,1,0,76.14,59.95 ,33.33
03,013,01,001,0022,38,910 ,4 ,914 ,1514 ,0,3,1,3,0,1,0,76.14,60.37 ,33.33
03,013,01,001,0022,39,1093 ,4 ,1097 ,1801 ,0,3,1,3,0,1,0,76.14,60.91 ,33.33
03,013,01,001,0022,40,1055 ,5 ,1060 ,1836 ,0,3,1,3,0,1,0,76.14,57.73,33.33
03,013,01,001,0023,41,856 ,4 ,860 ,1316 ,0,3,1,3,0,1,0,76.14,65.35,33.33
03,013,01,001,0024,42,769 ,3 ,772 ,1230 ,0,3,1,3,0,1,0,76.14,62.76,33.33
03,013,01,001,0025,43,897 ,5 ,902 ,1382 ,0,3,1,3,0,1,0,76.14,65.27 ,33.33
03,013,01,001,0026,44,596 ,5 ,601 ,959 ,0,3,1,3,0,1,0,76.14,62.67 ,33.33
03,013,01,001,0026,45,659 ,3 ,662 ,1017 ,0,3,1,3,0,1,0,76.14,65.09 ,33.33
03,013,01,001,0027,46,731 ,2 ,733 ,1134 ,0,3,1,3,0,1,0,76.14,64.64 ,33.33
03,013,01,001,0028,47,614 ,3 ,617 ,993 ,0,3,1,3,0,1,0,76.14,62.13 ,33.33
03,013,01,001,0028,48,580 ,8 ,588 ,946 ,0,3,1,3,0,1,0,76.14,62.16 ,33.33
03,013,01,001,0029,49,954 ,1 ,955 ,1554 ,0,3,1,3,0,1,0,76.14,61.45 ,33.33
03,013,01,001,0029,50,804 ,11 ,815 ,1226 ,0,3,1,3,0,1,0,76.14,66.48 ,33.33
03,013,01,001,0030,51,733 ,3 ,736 ,1119 ,0,3,1,3,0,1,0,76.14,65.77 ,33.33
03,013,01,001,0031,52,960 ,7 ,967 ,1364 ,0,3,1,3,0,1,0,76.14,70.89,33.33
03,013,01,001,0031,53,468 ,1 ,469 ,859 ,0,3,1,3,0,1,0,76.14,54.6,33.33
03,013,01,001,0032,54,1033 ,11 ,1044 ,1465 ,0,3,1,3,0,1,0,76.14,71.26 ,33.33
03,013,01,001,0033,55,900 ,6 ,906 ,1412 ,0,3,1,3,0,1,0,76.14,64.16 ,33.33
03,013,01,001,0033,56,968 ,5 ,973 ,1740 ,0,3,1,3,0,1,0,76.14,55.92 ,33.33
03,013,01,001,0033,57,1022 ,11 ,1033 ,1570 ,0,3,1,3,0,1,0,76.14,65.80 ,33.33
03,013,01,001,0034,58,328 ,1 ,329 ,526 ,0,3,1,3,0,1,0,76.14,62.55 ,33.33
03,013,01,001,0035,59,741 ,1 ,742 ,1038 ,0,3,1,3,0,1,0,76.14,71.48 ,33.33
03,013,01,001,0036,60,1030 ,12 ,1042 ,1559 ,0,3,1,3,0,1,0,76.14,66.84 ,33.33
03,013,01,001,0037,61,804 ,5 ,809 ,1257 ,0,3,1,3,0,1,0,76.14,64.36 ,33.33
03,013,01,001,0037,62,688 ,7 ,695 ,1131 ,0,3,1,3,0,1,0,76.14,61.45 ,33.33
03,013,01,001,0038,63,914 ,5 ,919 ,1359 ,0,3,1,3,0,1,0,76.14,67.62 ,33.33
03,013,01,001,0039,64,996 ,6 ,1002 ,1716 ,0,3,1,3,0,1,0,76.14,58.39 ,33.33
03,013,01,001,0040,65,494 ,3 ,497 ,771 ,0,3,1,3,0,1,0,76.14,64.46 ,33.33
03,013,01,001,0041,66,808 ,2 ,810 ,1362 ,0,3,1,3,0,1,0,76.14,59.47 ,33.33
03,013,01,001,0041,67,1038 ,2 ,1040 ,1658 ,0,3,1,3,0,1,0,76.14,62.73 ,33.33
03,013,01,001,0042,68,1055 ,8 ,1063 ,1778 ,0,3,1,3,0,1,0,76.14,59.79 ,33.33
03,013,01,001,0043,69,448 ,5 ,453 ,740 ,0,3,1,3,0,1,0,76.14,61.22,33.33
03,013,01,001,0044,70,799 ,8 ,807 ,1386 ,0,3,1,3,0,1,0,76.14,58.23,33.33
03,013,01,001,0044,71,1006 ,6 ,1012 ,1591 ,0,3,1,3,0,1,0,76.14,63.61 ,33.33
03,013,01,001,0044,72,1032 ,7 ,1039 ,1831 ,0,3,1,3,0,1,0,76.14,56.74 ,33.33
03,013,01,001,0044,73,1058 ,4 ,1062 ,1847 ,0,3,1,3,0,1,0,76.14,57.5,33.33
03,013,01,001,0045,74,943 ,6 ,949 ,1509 ,0,3,1,3,0,1,0,76.14,62.89,33.33
03,013,01,001,0045,75,903 ,3 ,906 ,1539 ,0,3,1,3,0,1,0,76.14,58.87 ,33.33
03,013,01,001,0045,76,1081 ,7 ,1088 ,1780 ,0,3,1,3,0,1,0,76.14,61.12 ,33.33
03,013,01,001,0045,77,896 ,9 ,905 ,1510 ,0,3,1,3,0,1,0,76.14,59.93 ,33.33
03,013,01,001,0045,78,919 ,5 ,924 ,1522 ,0,3,1,3,0,1,0,76.14,60.71 ,33.33
03,013,01,001,0046,79,774 ,6 ,780 ,1397 ,0,3,1,3,0,1,0,76.14,55.83 ,33.33
03,013,01,001,0046,80,939 ,6 ,945 ,1666 ,0,3,1,3,0,1,0,76.14,56.72 ,33.33
03,013,01,001,0046,81,846 ,2 ,848 ,1472 ,0,3,1,3,0,1,0,76.14,57.61 ,33.33
03,013,01,001,0046,82,848 ,3 ,851 ,1405 ,0,3,1,3,0,1,0,76.14,60.57 ,33.33
03,013,01,001,0046,83,990 ,4 ,994 ,1916 ,0,3,1,3,0,1,0,76.14,51.88 ,33.33
03,013,01,001,0047,84,710 ,1 ,711 ,1182 ,0,3,1,3,0,1,0,76.14,60.15 ,33.33
03,013,01,001,0047,85,642 ,7 ,649 ,1115 ,0,3,1,3,0,1,0,76.14,58.21 ,33.33
03,013,01,001,0048,86,994 ,4 ,998 ,1548 ,0,3,1,3,0,1,0,76.14,64.47 ,33.33
03,013,01,001,0049,87,623 ,1 ,624 ,986 ,0,3,1,3,0,1,0,76.14,63.29 ,33.33
03,013,01,001,0049,88,659 ,5 ,664 ,996 ,0,3,1,3,0,1,0,76.14,66.67 ,33.33
03,013,01,001,0050,89,868 ,5 ,873 ,1692 ,0,3,1,3,0,1,0,76.14,51.60 ,33.33
03,013,01,001,0050,90,881 ,4 ,885 ,1479 ,0,3,1,3,0,1,0,76.14,59.84 ,33.33
03,013,01,001,0050,91,850 ,4 ,854 ,1492 ,0,3,1,3,0,1,0,76.14,57.24 ,33.33
03,013,01,001,0051,92,627 ,2 ,629 ,1004 ,0,3,1,3,0,1,0,76.14,62.65 ,33.33
03,013,01,001,0051,93,687 ,4 ,691 ,1062 ,0,3,1,3,0,1,0,76.14,65.07 ,33.33
03,013,01,001,0052,94,940 ,3 ,943 ,1440 ,0,3,1,3,0,1,0,76.14,65.49 ,33.33
03,013,01,001,0052,95,881 ,3 ,884 ,1441 ,0,3,1,3,0,1,0,76.14,61.35 ,33.33
03,013,01,001,0052,96,1111 ,7 ,1118 ,1785 ,0,3,1,3,0,1,0,76.14,62.63,33.33
03,013,01,001,0053,97,882 ,4 ,886 ,1355 ,0,3,1,3,0,1,0,76.14,65.39,33.33
03,013,01,001,0053,98,819 ,3 ,822 ,1362 ,0,3,1,3,0,1,0,76.14,60.35 ,33.33
03,013,01,001,0054,99,861 ,3 ,864 ,1258 ,0,3,1,3,0,1,0,76.14,68.68 ,33.33
03,013,01,001,0055,100,581 ,4 ,585 ,851 ,0,3,1,3,0,1,0,76.14,68.74 ,33.33
03,013,01,001,0056,101,657 ,4 ,661 ,1000 ,0,3,1,3,0,1,0,76.14,66.10 ,33.33
03,013,01,001,0057,102,846 ,5 ,851 ,1354 ,0,3,1,3,0,1,0,76.14,62.85 ,33.33
03,013,01,001,0057,103,752 ,3 ,755 ,1261 ,0,3,1,3,0,1,0,76.14,59.87 ,33.33
03,013,01,001,0057,104,904 ,6 ,910 ,1581 ,0,3,1,3,0,1,0,76.14,57.56 ,33.33
03,013,01,001,0057,105,764 ,3 ,767 ,1327 ,0,3,1,3,0,1,0,76.14,57.80 ,33.33
03,013,01,001,0058,106,809 ,4 ,813 ,1258 ,0,3,1,3,0,1,0,76.14,64.63,33.33
03,013,01,001,0058,107,711 ,4 ,715 ,1106 ,0,3,1,3,0,1,0,76.14,64.65,33.33
03,013,01,001,0059,108,1029 ,2 ,1031 ,1760 ,0,3,1,3,0,1,0,76.14,58.58,33.33
03,013,01,001,0059,109,1020 ,4 ,1024 ,1718 ,0,3,1,3,0,1,0,76.14,59.60 ,33.33
03,013,01,001,0060,110,574 ,6 ,580 ,936 ,0,3,1,3,0,1,0,76.14,61.97 ,33.33
03,013,01,001,0061,111,1093 ,5 ,1098 ,1750 ,0,3,1,3,0,1,0,76.14,62.74 ,33.33
03,013,01,001,0062,112,953 ,7 ,960 ,1470 ,0,3,1,3,0,1,0,76.14,65.31 ,33.33
03,013,01,001,0063,113,616 ,1 ,617 ,933 ,0,3,1,3,0,1,0,76.14,66.13 ,33.33
03,013,01,001,0064,114,705 ,6 ,711 ,1157 ,0,3,1,3,0,1,0,76.14,61.45 ,33.33
03,013,01,001,0064,115,657 ,4 ,661 ,1129 ,0,3,1,3,0,1,0,76.14,58.55,33.33
03,013,01,002,0065,116,393 ,4 ,397 ,587 ,0,3,1,3,0,1,0,76.14,67.63,33.33
03,013,01,002,0066,117,841 ,2 ,843 ,1487 ,0,3,1,3,0,1,0,76.14,56.69,33.33
03,013,01,002,0066,118,797 ,7 ,804 ,1357 ,0,3,1,3,0,1,0,76.14,59.25 ,33.33
03,013,01,002,0066,119,645 ,1 ,646 ,1176 ,0,3,1,3,0,1,0,76.14,54.93 ,33.33
03,013,01,002,0067,120,497 ,1 ,498 ,709 ,0,3,1,3,0,1,0,76.14,70.24 ,33.33
03,013,01,002,0068,121,723 ,2 ,725 ,1137 ,0,3,1,3,0,1,0,76.14,63.76 ,33.33
03,013,01,002,0069,122,863 ,6 ,869 ,1431 ,0,3,1,3,0,1,0,76.14,60.73 ,33.33
03,013,01,002,0070,123,540 ,1 ,541 ,813 ,0,3,1,3,0,1,0,76.14,66.54 ,33.33
03,013,01,002,0071,124,780 ,3 ,783 ,1268 ,0,3,1,3,0,1,0,76.14,61.75 ,33.33
03,013,01,002,0071,125,820 ,4 ,824 ,1449 ,0,3,1,3,0,1,0,76.14,56.87 ,33.33
03,013,01,002,0071,126,968 ,3 ,971 ,1559 ,0,3,1,3,0,1,0,76.14,62.28 ,33.33
03,013,01,002,0072,127,1070 ,6 ,1076 ,1659 ,0,3,1,3,0,1,0,76.14,64.86 ,33.33
03,013,01,002,0072,128,1133 ,7 ,1140 ,1875 ,0,3,1,3,0,1,0,76.14,60.80 ,33.33
03,013,01,002,0072,129,1099 ,3 ,1102 ,1913 ,0,3,1,3,0,1,0,76.14,57.61 ,33.33
03,013,01,002,0073,130,1085 ,8 ,1093 ,1832 ,0,3,1,3,0,1,0,76.14,59.66 ,33.33
03,013,01,002,0074,131,712 ,4 ,716 ,1197 ,0,3,1,3,0,1,0,76.14,59.82 ,33.33
03,013,01,002,0075,132,1073 ,6 ,1079 ,1821 ,0,3,1,3,0,1,0,76.14,59.25,33.33
03,013,01,002,0076,133,1223 ,7 ,1230 ,2058 ,0,3,1,3,0,1,0,76.14,59.77,33.33
03,013,01,002,0077,134,1145 ,11 ,1156 ,2038 ,0,3,1,3,0,1,0,76.14,56.72 ,33.33
03,013,01,002,0077,135,925 ,4 ,929 ,1561 ,0,3,1,3,0,1,0,76.14,59.51 ,33.33
03,013,01,002,0077,136,954 ,6 ,960 ,1601 ,0,3,1,3,0,1,0,76.14,59.96,33.33
03,013,01,002,0078,137,812 ,3 ,815 ,1381 ,0,3,1,3,0,1,0,76.14,59.02,33.33
03,013,01,002,0079,138,765 ,7 ,772 ,1300 ,0,3,1,3,0,1,0,76.14,59.38 ,33.33
03,013,01,002,0080,139,508 ,5 ,513 ,864 ,0,3,1,3,0,1,0,76.14,59.38 ,33.33
03,013,01,002,0081,140,327 ,4 ,331 ,580 ,0,3,1,3,0,1,0,76.14,57.07 ,33.33
03,013,01,002,0082,141,882 ,3 ,885 ,1586 ,0,3,1,3,0,1,0,76.14,55.80 ,33.33
03,013,01,002,0083,142,1018 ,7 ,1025 ,1523 ,0,3,1,3,0,1,0,76.14,67.30 ,33.33
03,013,01,002,0084,143,1228 ,10 ,1238 ,1895 ,0,3,1,3,0,1,0,76.14,65.33 ,33.33
03,013,01,002,0085,144,941 ,11 ,952 ,1584 ,0,3,1,3,0,1,0,76.14,60.1,33.33
03,013,01,003,0086,145,660 ,5 ,665 ,1110 ,0,3,1,3,0,1,0,76.14,59.91,33.33
03,013,01,003,0086,146,743 ,5 ,748 ,1184 ,0,3,1,3,0,1,0,76.14,63.18,33.33
03,013,01,003,0087,147,344 ,0 ,344 ,564 ,0,3,1,3,0,1,0,76.14,60.99 ,33.33
03,013,01,003,0088,148,301 ,0 ,301 ,454 ,0,3,1,3,0,1,0,76.14,66.30 ,33.33
03,013,01,003,0089,149,461 ,6 ,467 ,760 ,0,3,1,3,0,1,0,76.14,61.45 ,33.33
03,013,01,003,0090,150,324 ,2 ,326 ,533 ,0,3,1,3,0,1,0,76.14,61.16 ,33.33
03,013,01,003,0091,151,804 ,5 ,809 ,1302 ,0,3,1,3,0,1,0,76.14,62.14 ,33.33
03,013,01,003,0091,152,545 ,2 ,547 ,940 ,0,3,1,3,0,1,0,76.14,58.19 ,33.33
03,013,01,003,0091,153,765 ,14 ,779 ,1351 ,0,3,1,3,0,1,0,76.14,57.66 ,33.33
03,013,01,003,0091,154,754 ,4 ,758 ,1453 ,0,3,1,3,0,1,0,76.14,52.17 ,33.33
03,013,01,003,0091,155,643 ,4 ,647 ,1027 ,0,3,1,3,0,1,0,76.14,63.00 ,33.33
03,013,01,003,0092,156,513 ,0 ,513 ,731 ,0,3,1,3,0,1,0,76.14,70.18 ,33.33
03,013,01,003,0093,157,462 ,5 ,467 ,814 ,0,3,1,3,0,1,0,76.14,57.37 ,33.33
03,013,01,003,0094,158,715 ,5 ,720 ,1286 ,0,3,1,3,0,1,0,76.14,55.99 ,33.33
03,013,01,003,0094,159,372 ,1 ,373 ,593 ,0,3,1,3,0,1,0,76.14,62.90 ,33.33
03,013,01,003,0095,160,515 ,0 ,515 ,898 ,0,3,1,3,0,1,0,76.14,57.35 ,33.33
03,013,01,003,0096,161,856 ,9 ,865 ,1340 ,0,3,1,3,0,1,0,76.14,64.55 ,33.33
03,013,01,003,0097,162,412 ,0 ,412 ,724 ,0,3,1,3,0,1,0,76.14,56.91 ,33.33
03,013,01,003,0098,163,698 ,2 ,700 ,1336 ,0,3,1,3,0,1,0,76.14,52.40 ,33.33
03,013,01,003,0099,164,459 ,3 ,462 ,809 ,0,3,1,3,0,1,0,76.14,57.11 ,33.33
03,013,01,003,0099,165,585 ,4 ,589 ,1123 ,0,3,1,3,0,1,0,76.14,52.45 ,33.33
03,013,01,003,0100,166,696 ,1 ,697 ,1223 ,0,3,1,3,0,1,0,76.14,56.99 ,33.33
03,013,01,003,0100,167,750 ,3 ,753 ,1415 ,0,3,1,3,0,1,0,76.14,53.22 ,33.33
03,013,01,003,0101,168,903 ,4 ,907 ,1598 ,0,3,1,3,0,1,0,76.14,56.76 ,33.33
03,013,01,003,0102,169,298 ,2 ,300 ,503 ,0,3,1,3,0,1,0,76.14,59.64 ,33.33
03,013,01,003,0102,170,822 ,4 ,826 ,1283 ,0,3,1,3,0,1,0,76.14,64.38 ,33.33
03,013,01,003,0103,171,576 ,3 ,579 ,1060 ,0,3,1,3,0,1,0,76.14,54.62,33.33
03,013,01,003,0103,172,784 ,0 ,784 ,1404 ,0,3,1,3,0,1,0,76.14,55.84,33.33
03,013,01,003,0103,173,767 ,2 ,769 ,1539 ,0,3,1,3,0,1,0,76.14,49.97 ,33.33
03,013,01,003,0104,174,697 ,1 ,698 ,1089 ,0,3,1,3,0,1,0,76.14,64.10 ,33.33
03,013,01,003,0104,175,448 ,5 ,453 ,736 ,0,3,1,3,0,1,0,76.14,61.55 ,33.33
03,013,01,003,0105,176,1005 ,7 ,1012 ,1608 ,0,3,1,3,0,1,0,76.14,62.94 ,33.33
03,013,01,003,0106,177,616 ,5 ,621 ,911 ,0,3,1,3,0,1,0,76.14,68.17,33.33
03,013,01,003,0107,178,461 ,2 ,463 ,736 ,0,3,1,3,0,1,0,76.14,62.91,33.33
03,013,01,003,0108,179,189 ,0 ,189 ,304 ,0,3,1,3,0,1,0,76.14,62.17 ,33.33
03,013,01,004,0109,180,587 ,5 ,592 ,976 ,0,3,1,3,0,1,0,76.14,60.66 ,33.33
03,013,01,004,0110,181,542 ,6 ,548 ,918 ,0,3,1,3,0,1,0,76.14,59.69 ,33.33
03,013,01,004,0110,182,585 ,7 ,592 ,1059 ,0,3,1,3,0,1,0,76.14,55.90 ,33.33
03,013,01,004,0111,183,622 ,3 ,625 ,1087 ,0,3,1,3,0,1,0,76.14,57.50 ,33.33
03,013,01,004,0112,184,620 ,7 ,627 ,1143 ,0,3,1,3,0,1,0,76.14,54.86 ,33.33
03,013,01,004,0112,185,571 ,5 ,576 ,1060 ,0,3,1,3,0,1,0,76.14,54.34,33.33
03,013,01,004,0112,186,641 ,6 ,647 ,1256 ,0,3,1,3,0,1,0,76.14,51.51,33.33
03,013,01,004,0113,187,787 ,7 ,794 ,1441 ,0,3,1,3,0,1,0,76.14,55.10 ,33.33
03,013,01,004,0113,188,613 ,6 ,619 ,1196 ,0,3,1,3,0,1,0,76.14,51.76 ,33.33
03,013,01,004,0114,189,408 ,8 ,416 ,770 ,0,3,1,3,0,1,0,76.14,54.03 ,33.33
03,013,01,004,0115,190,271 ,6 ,277 ,476 ,0,3,1,3,0,1,0,76.14,58.19 ,33.33
03,013,01,004,0116,191,245 ,3 ,248 ,466 ,0,3,1,3,0,1,0,76.14,53.22 ,33.33
03,013,01,004,0117,192,497 ,3 ,500 ,916 ,0,3,1,3,0,1,0,76.14,54.59 ,33.33
03,013,01,004,0118,193,440 ,6 ,446 ,727 ,0,3,1,3,0,1,0,76.14,61.35 ,33.33
03,013,01,004,0119,194,568 ,5 ,573 ,982 ,0,3,1,3,0,1,0,76.14,58.35,33.33
03,013,01,004,0120,195,434 ,0 ,434 ,762 ,0,3,1,3,0,1,0,76.14,56.96,33.33
03,013,01,004,0120,196,402 ,4 ,406 ,747 ,0,3,1,3,0,1,0,76.14,54.35 ,33.33
03,013,01,004,0121,197,541 ,4 ,545 ,935 ,0,3,1,3,0,1,0,76.14,58.29 ,33.33
03,013,01,004,0121,198,477 ,3 ,480 ,928 ,0,3,1,3,0,1,0,76.14,51.72 ,33.33
03,013,01,004,0122,199,386 ,1 ,387 ,695 ,0,3,1,3,0,1,0,76.14,55.68 ,33.33
03,013,01,004,0122,200,353 ,4 ,357 ,659 ,0,3,1,3,0,1,0,76.14,54.17 ,33.33
03,013,01,004,0123,201,329 ,4 ,333 ,642 ,0,3,1,3,0,1,0,76.14,51.87 ,33.33
03,013,01,004,0123,202,440 ,2 ,442 ,725 ,0,3,1,3,0,1,0,76.14,60.97 ,33.33
03,013,01,004,0124,203,777 ,6 ,783 ,1218 ,0,3,1,3,0,1,0,76.14,64.29 ,33.33
03,013,01,004,0125,204,598 ,7 ,605 ,1023 ,0,3,1,3,0,1,0,76.14,59.14 ,33.33
03,013,01,005,0126,205,1014 ,4 ,1018 ,1434 ,0,3,1,3,0,1,0,76.14,70.99 ,33.33
03,013,01,005,0127,206,1344 ,11 ,1355 ,1841 ,0,3,1,3,0,1,0,76.14,73.60 ,33.33
03,013,01,005,0128,207,667 ,6 ,673 ,933 ,0,3,1,3,0,1,0,76.14,72.13 ,33.33
03,013,01,005,0128,208,638 ,4 ,642 ,924 ,0,3,1,3,0,1,0,76.14,69.48 ,33.33
03,013,01,005,0129,209,388 ,1 ,389 ,527 ,0,3,1,3,0,1,0,76.14,73.81 ,33.33
03,013,01,005,0130,210,870 ,10 ,880 ,1123 ,0,3,1,3,0,1,0,76.14,78.36 ,33.33
03,013,01,005,0131,211,565 ,2 ,567 ,816 ,0,3,1,3,0,1,0,76.14,69.49 ,33.33
03,013,01,005,0132,212,270 ,4 ,274 ,364 ,0,3,1,3,0,1,0,76.14,75.27 ,33.33
03,013,01,005,0133,213,548 ,2 ,550 ,778 ,0,3,1,3,0,1,0,76.14,70.69 ,33.33
03,013,01,005,0134,214,1194 ,10 ,1204 ,1792 ,0,3,1,3,0,1,0,76.14,67.19 ,33.33
03,013,01,005,0134,215,1068 ,8 ,1076 ,1510 ,0,3,1,3,0,1,0,76.14,71.26,33.33
03,013,01,005,0135,216,365 ,0 ,365 ,500 ,0,3,1,3,0,1,0,76.14,73,33.33
03,013,01,005,0136,217,386 ,3 ,389 ,548 ,0,3,1,3,0,1,0,76.14,70.99 ,33.33
03,013,01,005,0137,218,903 ,8 ,911 ,1265 ,0,3,1,3,0,1,0,76.14,72.02 ,33.33
03,013,01,005,0138,219,660 ,8 ,668 ,1009 ,0,3,1,3,0,1,0,76.14,66.2,33.33
03,013,01,005,0138,220,716 ,9 ,725 ,1056 ,0,3,1,3,0,1,0,76.14,68.66,33.33
03,013,01,005,0139,221,1156 ,10 ,1166 ,1735 ,0,3,1,3,0,1,0,76.14,67.20 ,33.33
03,013,01,005,0140,222,966 ,6 ,972 ,1506 ,0,3,1,3,0,1,0,76.14,64.54 ,33.33
03,013,01,005,0141,223,972 ,3 ,975 ,1400 ,0,3,1,3,0,1,0,76.14,69.64 ,33.33
03,013,01,005,0142,224,628 ,2 ,630 ,895 ,0,3,1,3,0,1,0,76.14,70.39 ,33.33
03,013,01,005,0143,225,1149 ,6 ,1155 ,1685 ,0,3,1,3,0,1,0,76.14,68.55 ,33.33
03,013,01,005,0144,226,1135 ,9 ,1144 ,1604 ,0,3,1,3,0,1,0,76.14,71.32 ,33.33
03,013,01,005,0145,227,978 ,6 ,984 ,1397 ,0,3,1,3,0,1,0,76.14,70.44 ,33.33
03,013,01,005,0146,228,783 ,3 ,786 ,995 ,0,3,1,3,0,1,0,76.14,78.99 ,33.33
03,013,01,005,0147,229,909 ,5 ,914 ,1267 ,0,3,1,3,0,1,0,76.14,72.14 ,33.33
03,013,01,005,0148,230,526 ,3 ,529 ,678 ,0,3,1,3,0,1,0,76.14,78.02,33.33
03,013,01,005,0149,231,816 ,8 ,824 ,1107 ,0,3,1,3,0,1,0,76.14,74.44,33.33
03,013,01,005,0150,232,946 ,4 ,950 ,1233 ,0,3,1,3,0,1,0,76.14,77.05 ,33.33
03,013,01,005,0151,233,693 ,7 ,700 ,919 ,0,3,1,3,0,1,0,76.14,76.17 ,33.33
03,013,01,005,0152,234,607 ,0 ,607 ,812 ,0,3,1,3,0,1,0,76.14,74.75 ,33.33
03,013,01,005,0152,235,706 ,4 ,710 ,993 ,0,3,1,3,0,1,0,76.14,71.50 ,33.33
03,013,01,005,0153,236,1015 ,6 ,1021 ,1493 ,0,3,1,3,0,1,0,76.14,68.39 ,33.33
03,013,01,005,0154,237,944 ,6 ,950 ,1452 ,0,3,1,3,0,1,0,76.14,65.43 ,33.33
03,013,01,005,0155,238,637 ,1 ,638 ,910 ,0,3,1,3,0,1,0,76.14,70.11 ,33.33
03,013,01,005,0155,239,721 ,6 ,727 ,1084 ,0,3,1,3,0,1,0,76.14,67.07 ,33.33
03,013,01,006,0156,240,596 ,5 ,601 ,943 ,0,3,1,3,0,1,0,76.14,63.73 ,33.33
03,013,01,006,0156,241,813 ,3 ,816 ,1320 ,0,3,1,3,0,1,0,76.14,61.82 ,33.33
03,013,01,006,0157,242,743 ,3 ,746 ,1187 ,0,3,1,3,0,1,0,76.14,62.85 ,33.33
03,013,01,006,0157,243,1003 ,7 ,1010 ,1632 ,0,3,1,3,0,1,0,76.14,61.89 ,33.33
03,013,01,006,0158,244,1058 ,6 ,1064 ,1524 ,0,3,1,3,0,1,0,76.14,69.82 ,33.33
03,013,01,006,0159,245,403 ,0 ,403 ,614 ,0,3,1,3,0,1,0,76.14,65.64 ,33.33
03,013,01,006,0159,246,790 ,3 ,793 ,1293 ,0,3,1,3,0,1,0,76.14,61.33 ,33.33
03,013,01,006,0160,247,682 ,3 ,685 ,968 ,0,3,1,3,0,1,0,76.14,70.76 ,33.33
03,013,01,006,0161,248,1014 ,7 ,1021 ,1447 ,0,3,1,3,0,1,0,76.14,70.56 ,33.33
03,013,01,006,0162,249,713 ,9 ,722 ,1042 ,0,3,1,3,0,1,0,76.14,69.29 ,33.33
03,013,01,006,0163,250,526 ,2 ,528 ,777 ,0,3,1,3,0,1,0,76.14,67.95 ,33.33
03,013,01,006,0164,251,941 ,3 ,944 ,1445 ,0,3,1,3,0,1,0,76.14,65.33 ,33.33
03,013,01,006,0165,252,635 ,4 ,639 ,880 ,0,3,1,3,0,1,0,76.14,72.61 ,33.33
03,013,01,006,0166,253,732 ,6 ,738 ,1124 ,0,3,1,3,0,1,0,76.14,65.66 ,33.33
03,013,01,006,0167,254,783 ,8 ,791 ,1321 ,0,3,1,3,0,1,0,76.14,59.88 ,33.33
03,013,01,006,0168,255,1024 ,3 ,1027 ,1707 ,0,3,1,3,0,1,0,76.14,60.16 ,33.33
03,013,01,006,0169,256,729 ,4 ,733 ,1079 ,0,3,1,3,0,1,0,76.14,67.93 ,33.33
03,013,01,006,0170,257,777 ,4 ,781 ,1226 ,0,3,1,3,0,1,0,76.14,63.70 ,33.33
03,013,01,006,0170,258,594 ,7 ,601 ,1006 ,0,3,1,3,0,1,0,76.14,59.74,33.33
03,013,01,006,0171,259,318 ,2 ,320 ,498 ,0,3,1,3,0,1,0,76.14,64.26,33.33
03,013,01,007,0172,260,479 ,1 ,480 ,701 ,0,3,1,3,0,1,0,76.14,68.47,33.33
03,013,01,007,0172,261,763 ,9 ,772 ,1108 ,0,3,1,3,0,1,0,76.14,69.68 ,33.33
03,013,01,007,0173,262,568 ,1 ,569 ,827 ,0,3,1,3,0,1,0,76.14,68.80 ,33.33
03,013,01,007,0174,263,534 ,2 ,536 ,786 ,0,3,1,3,0,1,0,76.14,68.19 ,33.33
03,013,01,007,0174,264,545 ,5 ,550 ,786 ,0,3,1,3,0,1,0,76.14,69.97 ,33.33
03,013,01,007,0175,265,683 ,2 ,685 ,1078 ,0,3,1,3,0,1,0,76.14,63.54,33.33
03,013,01,007,0175,266,792 ,2 ,794 ,1205 ,0,3,1,3,0,1,0,76.14,65.89,33.33
03,013,01,007,0176,267,765 ,9 ,774 ,1112 ,0,3,1,3,0,1,0,76.14,69.60 ,33.33
03,013,01,007,0177,268,574 ,2 ,576 ,843 ,0,3,1,3,0,1,0,76.14,68.33 ,33.33
03,013,01,007,0178,269,474 ,2 ,476 ,684 ,0,3,1,3,0,1,0,76.14,69.59 ,33.33
03,013,01,008,0179,270,1089 ,7 ,1096 ,1553 ,0,3,1,3,0,1,0,76.14,70.57 ,33.33
03,013,01,008,0180,271,885 ,1 ,886 ,1278 ,0,3,1,3,0,1,0,76.14,69.33 ,33.33
03,013,01,008,0181,272,964 ,6 ,970 ,1419 ,0,3,1,3,0,1,0,76.14,68.36 ,33.33
03,013,01,008,0182,273,691 ,5 ,696 ,1037 ,0,3,1,3,0,1,0,76.14,67.12,33.33
03,013,01,008,0183,274,878 ,7 ,885 ,1235 ,0,3,1,3,0,1,0,76.14,71.66,33.33
03,013,01,008,0184,275,958 ,2 ,960 ,1452 ,0,3,1,3,0,1,0,76.14,66.12,33.33
03,013,01,008,0185,276,470 ,1 ,471 ,618 ,0,3,1,3,0,1,0,76.14,76.21,33.33
03,013,01,008,0185,277,1101 ,7 ,1108 ,1691 ,0,3,1,3,0,1,0,76.14,65.52,33.33
03,013,01,008,0185,278,815 ,6 ,821 ,1320 ,0,3,1,3,0,1,0,76.14,62.2,33.33
03,013,01,008,0186,279,959 ,3 ,962 ,1422 ,0,3,1,3,0,1,0,76.14,67.65,33.33
03,013,01,008,0187,280,931 ,8 ,939 ,1252 ,0,3,1,3,0,1,0,76.14,75,33.33
03,013,01,008,0188,281,1262 ,8 ,1270 ,1692 ,0,3,1,3,0,1,0,76.14,75.06,33.33
03,013,01,008,0189,282,955 ,5 ,960 ,1317 ,0,3,1,3,0,1,0,76.14,72.89,33.33
03,013,01,009,0190,283,637 ,2 ,639 ,1006 ,0,3,1,3,0,1,0,76.14,63.52,33.33
03,013,01,009,0190,284,739 ,7 ,746 ,1200 ,0,3,1,3,0,1,0,76.14,62.17,33.33
03,013,01,009,0191,285,947 ,6 ,953 ,1394 ,0,3,1,3,0,1,0,76.14,68.36,33.33
03,013,01,009,0192,286,983 ,7 ,990 ,1384 ,0,3,1,3,0,1,0,76.14,71.53,33.33
03,013,01,009,0193,287,800 ,7 ,807 ,1125 ,0,3,1,3,0,1,0,76.14,71.73,33.33
03,013,01,009,0194,288,517 ,5 ,522 ,790 ,0,3,1,3,0,1,0,76.14,66.08,33.33
03,013,01,009,0195,289,744 ,3 ,747 ,1198 ,0,3,1,3,0,1,0,76.14,62.35,33.33
03,013,01,009,0196,290,560 ,4 ,564 ,863 ,0,3,1,3,0,1,0,76.14,65.35,33.33
03,013,01,009,0196,291,519 ,8 ,527 ,866 ,0,3,1,3,0,1,0,76.14,60.85,33.33
03,013,01,009,0197,292,863 ,2 ,865 ,1214 ,0,3,1,3,0,1,0,76.14,71.25,33.33
03,013,01,009,0198,293,301 ,1 ,302 ,406 ,0,3,1,3,0,1,0,76.14,74.38,33.33
03,013,01,009,0198,294,837 ,4 ,841 ,1169 ,0,3,1,3,0,1,0,76.14,71.94,33.33
03,013,01,009,0199,295,727 ,3 ,730 ,1004 ,0,3,1,3,0,1,0,76.14,72.71,33.33
03,013,01,009,0199,296,903 ,3 ,906 ,1313 ,0,3,1,3,0,1,0,76.14,69,33.33
03,013,01,009,0200,297,1015 ,17 ,1032 ,1461 ,0,3,1,3,0,1,0,76.14,70.64,33.33
03,013,01,009,0200,298,340 ,4 ,344 ,494 ,0,3,1,3,0,1,0,76.14,69.64,33.33
03,013,01,009,0201,299,546 ,7 ,553 ,842 ,0,3,1,3,0,1,0,76.14,65.68,33.33
03,013,01,009,0201,300,621 ,5 ,626 ,899 ,0,3,1,3,0,1,0,76.14,69.63,33.33
03,013,01,009,0202,301,530 ,4 ,534 ,823 ,0,3,1,3,0,1,0,76.14,64.88,33.33
03,013,01,009,0203,302,310 ,2 ,312 ,453 ,0,3,1,3,0,1,0,76.14,68.87,33.33
03,013,01,010,0204,303,1187 ,3 ,1190 ,1758 ,0,3,1,3,0,1,0,76.14,67.69,33.33
03,013,01,010,0205,304,736 ,7 ,743 ,1134 ,0,3,1,3,0,1,0,76.14,65.52,33.33
03,013,01,010,0205,305,735 ,6 ,741 ,1150 ,0,3,1,3,0,1,0,76.14,64.43,33.33
03,013,01,010,0206,306,1043 ,7 ,1050 ,1628 ,0,3,1,3,0,1,0,76.14,64.5,33.33
03,013,01,010,0207,307,652 ,5 ,657 ,908 ,0,3,1,3,0,1,0,76.14,72.36,33.33
03,013,01,010,0208,308,857 ,9 ,866 ,1357 ,0,3,1,3,0,1,0,76.14,63.82,33.33
03,013,01,010,0208,309,888 ,9 ,897 ,1342 ,0,3,1,3,0,1,0,76.14,66.84,33.33
03,013,01,010,0209,310,1126 ,13 ,1139 ,1851 ,0,3,1,3,0,1,0,76.14,61.53,33.33
03,013,01,010,0210,311,549 ,5 ,554 ,864 ,0,3,1,3,0,1,0,76.14,64.12,33.33
03,013,01,010,0211,312,883 ,0 ,883 ,1436 ,0,3,1,3,0,1,0,76.14,61.49,33.33
03,013,01,010,0211,313,874 ,16 ,890 ,1471 ,0,3,1,3,0,1,0,76.14,60.5,33.33
03,013,01,010,0212,314,888 ,3 ,891 ,1473 ,0,3,1,3,0,1,0,76.14,60.49,33.33
03,013,01,010,0212,315,816 ,4 ,820 ,1491 ,0,3,1,3,0,1,0,76.14,55,33.33
03,013,01,010,0213,316,650 ,4 ,654 ,971 ,0,3,1,3,0,1,0,76.14,67.35,33.33
03,013,01,010,0214,317,913 ,9 ,922 ,1483 ,0,3,1,3,0,1,0,76.14,62.17,33.33
03,013,01,010,0215,318,376 ,7 ,383 ,556 ,0,3,1,3,0,1,0,76.14,68.88,33.33
03,013,01,011,0216,319,572 ,2 ,574 ,933 ,0,3,1,3,0,1,0,76.14,61.52,33.33
03,013,01,011,0216,320,735 ,6 ,741 ,1219 ,0,3,1,3,0,1,0,76.14,60.79,33.33
03,013,01,011,0217,321,896 ,3 ,899 ,1360 ,0,3,1,3,0,1,0,76.14,66.1,33.33
03,013,01,011,0218,322,551 ,5 ,556 ,819 ,0,3,1,3,0,1,0,76.14,67.89,33.33
03,013,01,011,0219,323,400 ,2 ,402 ,612 ,0,3,1,3,0,1,0,76.14,65.69,33.33
03,013,01,011,0220,324,657 ,3 ,660 ,1019 ,0,3,1,3,0,1,0,76.14,64.77,33.33
03,013,01,011,0221,325,716 ,5 ,721 ,1156 ,0,3,1,3,0,1,0,76.14,62.37,33.33
03,013,01,011,0222,326,405 ,4 ,409 ,673 ,0,3,1,3,0,1,0,76.14,60.77,33.33
03,013,01,011,0223,327,506 ,6 ,512 ,806 ,0,3,1,3,0,1,0,76.14,63.52,33.33
03,013,01,011,0224,328,454 ,1 ,455 ,712 ,0,3,1,3,0,1,0,76.14,63.9,33.33
03,013,01,011,0225,329,774 ,1 ,775 ,1313 ,0,3,1,3,0,1,0,76.14,59.03,33.33
03,013,01,011,0226,330,876 ,4 ,880 ,1547 ,0,3,1,3,0,1,0,76.14,56.88,33.33
03,013,01,011,0227,331,555 ,10 ,565 ,955 ,0,3,1,3,0,1,0,76.14,59.16,33.33
03,013,01,011,0227,332,612 ,4 ,616 ,993 ,0,3,1,3,0,1,0,76.14,62.03,33.33
03,013,01,011,0228,333,786 ,4 ,790 ,1248 ,0,3,1,3,0,1,0,76.14,63.3,33.33
03,013,01,011,0229,334,590 ,1 ,591 ,939 ,0,3,1,3,0,1,0,76.14,62.94,33.33
03,013,01,011,0230,335,695 ,5 ,700 ,1047 ,0,3,1,3,0,1,0,76.14,66.86,33.33
03,013,01,011,0231,336,687 ,6 ,693 ,1027 ,0,3,1,3,0,1,0,76.14,67.48,33.33
03,013,01,011,0232,337,726 ,5 ,731 ,1104 ,0,3,1,3,0,1,0,76.14,66.21,33.33
03,013,01,011,0233,338,505 ,2 ,507 ,733 ,0,3,1,3,0,1,0,76.14,69.17,33.33
03,013,01,011,0233,339,370 ,7 ,377 ,597 ,0,3,1,3,0,1,0,76.14,63.15,33.33
03,013,01,011,0234,340,926 ,2 ,928 ,1471 ,0,3,1,3,0,1,0,76.14,63.09,33.33
03,013,01,012,0235,341,828 ,3 ,831 ,1251 ,0,3,1,3,0,1,0,76.14,66.43,33.33
03,013,01,012,0236,342,539 ,1 ,540 ,783 ,0,3,1,3,0,1,0,76.14,68.97,33.33
03,013,01,012,0237,343,924 ,6 ,930 ,1440 ,0,3,1,3,0,1,0,76.14,64.58,33.33
03,013,01,012,0238,344,595 ,5 ,600 ,903 ,0,3,1,3,0,1,0,76.14,66.45,33.33
03,013,01,012,0239,345,347 ,2 ,349 ,523 ,0,3,1,3,0,1,0,76.14,66.73,33.33
03,013,01,012,0240,346,809 ,10 ,819 ,1232 ,0,3,1,3,0,1,0,76.14,66.48,33.33
03,013,01,012,0241,347,833 ,9 ,842 ,1142 ,0,3,1,3,0,1,0,76.14,73.73,33.33
03,013,01,012,0242,348,898 ,4 ,902 ,1334 ,0,3,1,3,0,1,0,76.14,67.62,33.33
03,013,01,012,0243,349,471 ,5 ,476 ,852 ,0,3,1,3,0,1,0,76.14,55.87,33.33
03,013,01,012,0243,350,467 ,10 ,477 ,799 ,0,3,1,3,0,1,0,76.14,59.7,33.33
03,013,01,012,0244,351,605 ,6 ,611 ,994 ,0,3,1,3,0,1,0,76.14,61.47,33.33
03,013,01,012,0244,352,577 ,11 ,588 ,911 ,0,3,1,3,0,1,0,76.14,64.54,33.33
03,013,01,012,0245,353,1020 ,3 ,1023 ,1566 ,0,3,1,3,0,1,0,76.14,65.33,33.33
03,013,01,012,0246,354,1065 ,9 ,1074 ,1476 ,0,3,1,3,0,1,0,76.14,72.76,33.33
03,013,01,012,0247,355,669 ,8 ,677 ,1063 ,0,3,1,3,0,1,0,76.14,63.69,33.33
03,013,01,012,0248,356,338 ,2 ,340 ,555 ,0,3,1,3,0,1,0,76.14,61.26,33.33
03,013,01,012,0248,357,377 ,2 ,379 ,615 ,0,3,1,3,0,1,0,76.14,61.63,33.33
03,013,01,013,0249,358,838 ,7 ,845 ,1349 ,0,3,1,3,0,1,0,76.14,62.64,33.33
03,013,01,013,0249,359,1190 ,7 ,1197 ,1919 ,0,3,1,3,0,1,0,76.14,62.38,33.33
03,013,01,013,0250,360,638 ,5 ,643 ,1064 ,0,3,1,3,0,1,0,76.14,60.43,33.33
03,013,01,013,0250,361,1010 ,4 ,1014 ,1679 ,0,3,1,3,0,1,0,76.14,60.39,33.33
03,013,01,013,0251,362,916 ,6 ,922 ,1314 ,0,3,1,3,0,1,0,76.14,70.17,33.33
03,013,01,013,0252,363,394 ,3 ,397 ,592 ,0,3,1,3,0,1,0,76.14,67.06,33.33
03,013,01,013,0253,364,660 ,3 ,663 ,1021 ,0,3,1,3,0,1,0,76.14,64.94,33.33
03,013,01,013,0253,365,671 ,5 ,676 ,1090 ,0,3,1,3,0,1,0,76.14,62.02,33.33
03,013,01,013,0254,366,558 ,1 ,559 ,821 ,0,3,1,3,0,1,0,76.14,68.09,33.33
03,013,01,013,0254,367,697 ,3 ,700 ,1173 ,0,3,1,3,0,1,0,76.14,59.68,33.33
03,013,01,013,0255,368,694 ,3 ,697 ,1041 ,0,3,1,3,0,1,0,76.14,66.95,33.33
03,013,01,013,0255,369,847 ,8 ,855 ,1348 ,0,3,1,3,0,1,0,76.14,63.43,33.33
03,013,01,013,0255,370,1031 ,4 ,1035 ,1655 ,0,3,1,3,0,1,0,76.14,62.54,33.33
03,013,01,013,0256,371,741 ,8 ,749 ,1233 ,0,3,1,3,0,1,0,76.14,60.75,33.33
03,013,01,013,0256,372,739 ,3 ,742 ,1225 ,0,3,1,3,0,1,0,76.14,60.57,33.33
03,013,01,013,0257,373,496 ,3 ,499 ,725 ,0,3,1,3,0,1,0,76.14,68.83,33.33
03,013,01,013,0257,374,621 ,4 ,625 ,896 ,0,3,1,3,0,1,0,76.14,69.75,33.33
03,013,01,013,0258,375,528 ,6 ,534 ,778 ,0,3,1,3,0,1,0,76.14,68.64,33.33
03,013,01,013,0258,376,749 ,2 ,751 ,1127 ,0,3,1,3,0,1,0,76.14,66.64,33.33
03,013,01,013,0259,377,928 ,7 ,935 ,1566 ,0,3,1,3,0,1,0,76.14,59.71,33.33
03,013,01,013,0260,378,715 ,1 ,716 ,1104 ,0,3,1,3,0,1,0,76.14,64.86,33.33
03,013,01,013,0260,379,1111 ,6 ,1117 ,1764 ,0,3,1,3,0,1,0,76.14,63.32,33.33
03,013,01,013,0261,380,603 ,2 ,605 ,902 ,0,3,1,3,0,1,0,76.14,67.07,33.33
03,013,01,013,0262,381,746 ,1 ,747 ,1099 ,0,3,1,3,0,1,0,76.14,67.97,33.33
03,013,01,013,0263,382,635 ,1 ,636 ,1138 ,0,3,1,3,0,1,0,76.14,55.89,33.33
03,013,01,013,0263,383,710 ,7 ,717 ,1236 ,0,3,1,3,0,1,0,76.14,58.01,33.33
03,013,01,013,0264,384,887 ,14 ,901 ,1465 ,0,3,1,3,0,1,0,76.14,61.5,33.33
03,013,01,013,0265,385,814 ,6 ,820 ,1337 ,0,3,1,3,0,1,0,76.14,61.33,33.33
03,013,01,013,0265,386,636 ,6 ,642 ,1136 ,0,3,1,3,0,1,0,76.14,56.51,33.33
03,013,01,013,0266,387,822 ,7 ,829 ,1417 ,0,3,1,3,0,1,0,76.14,58.5,33.33
03,013,01,013,0266,388,596 ,6 ,602 ,1057 ,0,3,1,3,0,1,0,76.14,56.95,33.33
03,013,01,013,0267,389,421 ,0 ,421 ,656 ,0,3,1,3,0,1,0,76.14,64.18,33.33
03,013,01,013,0267,390,409 ,12 ,421 ,888 ,0,3,1,3,0,1,0,76.14,47.41,33.33
03,013,01,013,0268,391,765 ,6 ,771 ,1253 ,0,3,1,3,0,1,0,76.14,61.53,33.33
03,013,01,013,0268,392,316 ,3 ,319 ,503 ,0,3,1,3,0,1,0,76.14,63.42,33.33
03,013,01,013,0269,393,664 ,9 ,673 ,1156 ,0,3,1,3,0,1,0,76.14,58.22,33.33
03,013,01,013,0269,394,595 ,5 ,600 ,1086 ,0,3,1,3,0,1,0,76.14,55.25,33.33
03,013,01,013,0270,395,587 ,4 ,591 ,1143 ,0,3,1,3,0,1,0,76.14,51.71,33.33
03,013,01,013,0271,396,452 ,2 ,454 ,747 ,0,3,1,3,0,1,0,76.14,60.78,33.33
03,013,01,014,0272,397,1028 ,4 ,1032 ,1463 ,0,3,1,3,0,1,0,76.14,70.54,33.33
03,013,01,014,0273,398,569 ,3 ,572 ,850 ,0,3,1,3,0,1,0,76.14,67.29,33.33
03,013,01,014,0274,399,503 ,2 ,505 ,674 ,0,3,1,3,0,1,0,76.14,74.93,33.33
03,013,01,014,0275,400,438 ,2 ,440 ,613 ,0,3,1,3,0,1,0,76.14,71.78,33.33
03,013,01,014,0276,401,905 ,4 ,909 ,1328 ,0,3,1,3,0,1,0,76.14,68.45,33.33
03,013,01,014,0277,402,689 ,5 ,694 ,959 ,0,3,1,3,0,1,0,76.14,72.37,33.33
03,013,01,014,0278,403,446 ,1 ,447 ,605 ,0,3,1,3,0,1,0,76.14,73.88,33.33
03,013,01,014,0279,404,335 ,3 ,338 ,477 ,0,3,1,3,0,1,0,76.14,70.86,33.33
03,013,01,014,0280,405,933 ,9 ,942 ,1343 ,0,3,1,3,0,1,0,76.14,70.14,33.33
03,013,01,014,0280,406,841 ,7 ,848 ,1233 ,0,3,1,3,0,1,0,76.14,68.78,33.33
03,013,01,014,0281,407,335 ,1 ,336 ,451 ,0,3,1,3,0,1,0,76.14,74.5,33.33
03,013,01,014,0282,408,431 ,0 ,431 ,614 ,0,3,1,3,0,1,0,76.14,70.2,33.33
03,013,01,014,0283,409,516 ,1 ,517 ,698 ,0,3,1,3,0,1,0,76.14,74.07,33.33
03,013,01,014,0284,410,671 ,5 ,676 ,1088 ,0,3,1,3,0,1,0,76.14,62.13,33.33
03,013,01,014,0285,411,787 ,5 ,792 ,1150 ,0,3,1,3,0,1,0,76.14,68.87,33.33
03,013,01,014,0286,412,707 ,6 ,713 ,1033 ,0,3,1,3,0,1,0,76.14,69.02,33.33
03,013,01,015,0287,413,949 ,6 ,955 ,1601 ,0,3,1,3,0,1,0,76.14,59.65,33.33
03,013,01,015,0287,414,229 ,0 ,229 ,340 ,0,3,1,3,0,1,0,76.14,67.35,33.33
03,013,01,015,0288,415,519 ,3 ,522 ,801 ,0,3,1,3,0,1,0,76.14,65.17,33.33
03,013,01,015,0288,416,253 ,1 ,254 ,382 ,0,3,1,3,0,1,0,76.14,66.49,33.33
03,013,01,015,0289,417,697 ,4 ,701 ,988 ,0,3,1,3,0,1,0,76.14,70.95,33.33
03,013,01,015,0290,418,494 ,2 ,496 ,743 ,0,3,1,3,0,1,0,76.14,66.76,33.33
03,013,01,015,0291,419,413 ,3 ,416 ,674 ,0,3,1,3,0,1,0,76.14,61.72,33.33
03,013,01,015,0291,420,245 ,1 ,246 ,358 ,0,3,1,3,0,1,0,76.14,68.72,33.33
03,013,01,015,0291,421,377 ,0 ,377 ,648 ,0,3,1,3,0,1,0,76.14,58.18,33.33
03,013,01,015,0292,422,740 ,8 ,748 ,1339 ,0,3,1,3,0,1,0,76.14,55.86,33.33
03,013,01,015,0293,423,306 ,4 ,310 ,550 ,0,3,1,3,0,1,0,76.14,56.36,33.33
03,013,01,015,0293,424,330 ,0 ,330 ,534 ,0,3,1,3,0,1,0,76.14,61.8,33.33
03,013,01,016,0294,425,664 ,2 ,666 ,1219 ,0,3,1,3,0,1,0,76.14,54.63,33.33
03,013,01,016,0295,426,500 ,6 ,506 ,856 ,0,3,1,3,0,1,0,76.14,59.11,33.33
03,013,01,016,0296,427,632 ,3 ,635 ,975 ,0,3,1,3,0,1,0,76.14,65.13,33.33
03,013,01,016,0297,428,416 ,1 ,417 ,659 ,0,3,1,3,0,1,0,76.14,63.28,33.33
03,013,01,016,0298,429,546 ,4 ,550 ,898 ,0,3,1,3,0,1,0,76.14,61.25,33.33
03,013,01,016,0298,430,539 ,3 ,542 ,915 ,0,3,1,3,0,1,0,76.14,59.23,33.33
03,013,01,016,0299,431,662 ,3 ,665 ,1267 ,0,3,1,3,0,1,0,76.14,52.49,33.33
03,013,01,016,0299,432,707 ,5 ,712 ,1261 ,0,3,1,3,0,1,0,76.14,56.46,33.33
03,013,01,016,0299,433,684 ,6 ,690 ,1225 ,0,3,1,3,0,1,0,76.14,56.33,33.33
03,013,01,016,0300,434,579 ,0 ,579 ,974 ,0,3,1,3,0,1,0,76.14,59.45,33.33
03,013,01,016,0300,435,685 ,3 ,688 ,1086 ,0,3,1,3,0,1,0,76.14,63.35,33.33
03,013,01,016,0301,436,1065 ,7 ,1072 ,1642 ,0,3,1,3,0,1,0,76.14,65.29,33.33
03,013,01,016,0302,437,647 ,1 ,648 ,1050 ,0,3,1,3,0,1,0,76.14,61.71,33.33
03,013,01,016,0302,438,665 ,7 ,672 ,1122 ,0,3,1,3,0,1,0,76.14,59.89,33.33
03,013,01,016,0303,439,394 ,2 ,396 ,740 ,0,3,1,3,0,1,0,76.14,53.51,33.33
03,013,01,016,0304,440,503 ,6 ,509 ,962 ,0,3,1,3,0,1,0,76.14,52.91,33.33
03,013,01,016,0305,441,872 ,5 ,877 ,1411 ,0,3,1,3,0,1,0,76.14,62.15,33.33
03,013,01,016,0305,442,889 ,5 ,894 ,1382 ,0,3,1,3,0,1,0,76.14,64.69,33.33
03,013,01,016,0306,443,425 ,0 ,425 ,632 ,0,3,1,3,0,1,0,76.14,67.25,33.33
03,013,01,016,0307,444,522 ,6 ,528 ,949 ,0,3,1,3,0,1,0,76.14,55.64,33.33
03,013,01,016,0308,445,259 ,4 ,263 ,418 ,0,3,1,3,0,1,0,76.14,62.92,33.33
03,013,01,017,0309,446,654 ,2 ,656 ,897 ,0,3,1,3,0,1,0,76.14,73.13,33.33
03,013,01,017,0309,447,526 ,0 ,526 ,735 ,0,3,1,3,0,1,0,76.14,71.56,33.33
03,013,01,017,0310,448,698 ,0 ,698 ,1085 ,0,3,1,3,0,1,0,76.14,64.33,33.33
03,013,01,017,0310,449,850 ,5 ,855 ,1297 ,0,3,1,3,0,1,0,76.14,65.92,33.33
03,013,01,017,0311,450,670 ,0 ,670 ,1012 ,0,3,1,3,0,1,0,76.14,66.21,33.33
03,013,01,017,0311,451,712 ,3 ,715 ,1030 ,0,3,1,3,0,1,0,76.14,69.42,33.33
03,013,01,017,0312,452,517 ,3 ,520 ,764 ,0,3,1,3,0,1,0,76.14,68.06,33.33
03,013,01,017,0313,453,573 ,4 ,577 ,809 ,0,3,1,3,0,1,0,76.14,71.32,33.33
03,013,01,017,0314,454,812 ,5 ,817 ,1226 ,0,3,1,3,0,1,0,76.14,66.64,33.33
03,013,01,017,0314,455,627 ,3 ,630 ,1006 ,0,3,1,3,0,1,0,76.14,62.62,33.33
03,013,01,017,0315,456,628 ,2 ,630 ,972 ,0,3,1,3,0,1,0,76.14,64.81,33.33
03,013,01,017,0315,457,717 ,3 ,720 ,1075 ,0,3,1,3,0,1,0,76.14,66.98,33.33
03,013,01,017,0316,458,782 ,3 ,785 ,1048 ,0,3,1,3,0,1,0,76.14,74.9,33.33
03,013,01,017,0316,459,786 ,3 ,789 ,1124 ,0,3,1,3,0,1,0,76.14,70.2,33.33
03,013,01,017,0317,460,655 ,6 ,661 ,956 ,0,3,1,3,0,1,0,76.14,69.14,33.33
03,013,01,017,0317,461,559 ,2 ,561 ,854 ,0,3,1,3,0,1,0,76.14,65.69,33.33
03,013,01,017,0317,462,684 ,2 ,686 ,1101 ,0,3,1,3,0,1,0,76.14,62.31,33.33
03,013,01,017,0318,463,890 ,5 ,895 ,1265 ,0,3,1,3,0,1,0,76.14,70.75,33.33
03,013,01,017,0319,464,633 ,9 ,642 ,1014 ,0,3,1,3,0,1,0,76.14,63.31,33.33
03,013,01,017,0319,465,750 ,2 ,752 ,1175 ,0,3,1,3,0,1,0,76.14,64,33.33
03,013,01,017,0320,466,607 ,4 ,611 ,923 ,0,3,1,3,0,1,0,76.14,66.2,33.33
03,013,01,017,0320,467,481 ,4 ,485 ,772 ,0,3,1,3,0,1,0,76.14,62.82,33.33
03,013,01,017,0321,468,895 ,9 ,904 ,1421 ,0,3,1,3,0,1,0,76.14,63.62,33.33
03,013,01,017,0322,469,809 ,4 ,813 ,1424 ,0,3,1,3,0,1,0,76.14,57.09,33.33
03,013,01,017,0322,470,828 ,5 ,833 ,1388 ,0,3,1,3,0,1,0,76.14,60.01,33.33
03,013,01,017,0322,471,750 ,0 ,750 ,1303 ,0,3,1,3,0,1,0,76.14,57.56,33.33
03,013,01,017,0323,472,626 ,6 ,632 ,1074 ,0,3,1,3,0,1,0,76.14,58.85,33.33
03,013,01,017,0323,473,674 ,7 ,681 ,1166 ,0,3,1,3,0,1,0,76.14,58.4,33.33
03,013,01,018,0324,474,1292 ,5 ,1297 ,2062 ,0,3,1,3,0,1,0,76.14,62.9,33.33
03,013,01,018,0325,475,980 ,4 ,984 ,1695 ,0,3,1,3,0,1,0,76.14,58.05,33.33
03,013,01,018,0326,476,778 ,10 ,788 ,1157 ,0,3,1,3,0,1,0,76.14,68.11,33.33
03,013,01,018,0327,477,783 ,4 ,787 ,1161 ,0,3,1,3,0,1,0,76.14,67.79,33.33
03,013,01,018,0328,478,636 ,5 ,641 ,931 ,0,3,1,3,0,1,0,76.14,68.85,33.33
03,013,01,018,0329,479,969 ,11 ,980 ,1488 ,0,3,1,3,0,1,0,76.14,65.86,33.33
03,013,01,018,0330,480,534 ,2 ,536 ,818 ,0,3,1,3,0,1,0,76.14,65.53,33.33
03,013,01,018,0331,481,1079 ,9 ,1088 ,1786 ,0,3,1,3,0,1,0,76.14,60.92,33.33
03,013,01,019,0332,482,885 ,2 ,887 ,1473 ,0,3,1,3,0,1,0,76.14,60.22,33.33
03,013,01,019,0333,483,944 ,7 ,951 ,1628 ,0,3,1,3,0,1,0,76.14,58.42,33.33
03,013,01,019,0334,484,506 ,4 ,510 ,822 ,0,3,1,3,0,1,0,76.14,62.04,33.33
03,013,01,019,0335,485,972 ,2 ,974 ,1558 ,0,3,1,3,0,1,0,76.14,62.52,33.33
03,013,01,019,0336,486,963 ,6 ,969 ,1525 ,0,3,1,3,0,1,0,76.14,63.54,33.33
03,013,01,019,0336,487,1070 ,5 ,1075 ,1734 ,0,3,1,3,0,1,0,76.14,62,33.33
03,013,01,019,0337,488,587 ,4 ,591 ,911 ,0,3,1,3,0,1,0,76.14,64.87,33.33
03,013,01,019,0338,489,658 ,6 ,664 ,1344 ,0,3,1,3,0,1,0,76.14,49.4,33.33
03,013,01,019,0339,490,1029 ,10 ,1039 ,1895 ,0,3,1,3,0,1,0,76.14,54.83,33.33
03,013,01,019,0340,491,979 ,2 ,981 ,1508 ,0,3,1,3,0,1,0,76.14,65.05,33.33
03,013,01,019,0340,492,745 ,10 ,755 ,1294 ,0,3,1,3,0,1,0,76.14,58.35,33.33
03,013,01,019,0341,493,749 ,5 ,754 ,1146 ,0,3,1,3,0,1,0,76.14,65.79,33.33
03,013,01,020,0342,494,1185 ,8 ,1193 ,1775 ,0,3,1,3,0,1,0,76.14,67.21,33.33
03,013,01,020,0343,495,651 ,7 ,658 ,986 ,0,3,1,3,0,1,0,76.14,66.73,33.33
03,013,01,020,0344,496,350 ,0 ,350 ,526 ,0,3,1,3,0,1,0,76.14,66.54,33.33
03,013,01,020,0345,497,496 ,4 ,500 ,761 ,0,3,1,3,0,1,0,76.14,65.7,33.33
03,013,01,020,0346,498,656 ,5 ,661 ,1051 ,0,3,1,3,0,1,0,76.14,62.89,33.33
03,013,01,020,0347,499,638 ,8 ,646 ,1001 ,0,3,1,3,0,1,0,76.14,64.54,33.33
03,013,01,020,0348,500,641 ,2 ,643 ,1015 ,0,3,1,3,0,1,0,76.14,63.35,33.33
03,013,01,020,0349,501,693 ,5 ,698 ,1149 ,0,3,1,3,0,1,0,76.14,60.75,33.33
03,013,01,020,0350,502,587 ,8 ,595 ,965 ,0,3,1,3,0,1,0,76.14,61.66,33.33
03,013,01,020,0351,503,381 ,1 ,382 ,586 ,0,3,1,3,0,1,0,76.14,65.19,33.33
03,013,01,021,0352,504,1020 ,5 ,1025 ,1492 ,0,3,1,3,0,1,0,76.14,68.7,33.33
03,013,01,021,0353,505,1044 ,14 ,1058 ,1622 ,0,3,1,3,0,1,0,76.14,65.23,33.33
03,013,01,021,0354,506,614 ,1 ,615 ,922 ,0,3,1,3,0,1,0,76.14,66.7,33.33
03,013,01,021,0355,507,1091 ,4 ,1095 ,1672 ,0,3,1,3,0,1,0,76.14,65.49,33.33
03,013,01,021,0356,508,1210 ,3 ,1213 ,1958 ,0,3,1,3,0,1,0,76.14,61.95,33.33
03,013,01,021,0357,509,611 ,4 ,615 ,952 ,0,3,1,3,0,1,0,76.14,64.6,33.33
03,013,01,021,0357,510,774 ,3 ,777 ,1268 ,0,3,1,3,0,1,0,76.14,61.28,33.33
03,013,01,021,0358,511,818 ,7 ,825 ,1122 ,0,3,1,3,0,1,0,76.14,73.53,33.33
03,013,01,021,0359,512,583 ,5 ,588 ,830 ,0,3,1,3,0,1,0,76.14,70.84,33.33
03,013,01,021,0360,513,820 ,3 ,823 ,1187 ,0,3,1,3,0,1,0,76.14,69.33,33.33
03,013,01,021,0361,514,695 ,5 ,700 ,1038 ,0,3,1,3,0,1,0,76.14,67.44,33.33
03,013,01,021,0362,515,719 ,5 ,724 ,1131 ,0,3,1,3,0,1,0,76.14,64.01,33.33
03,013,01,021,0363,516,634 ,0 ,634 ,1074 ,0,3,1,3,0,1,0,76.14,59.03,33.33
03,013,01,021,0363,517,766 ,3 ,769 ,1216 ,0,3,1,3,0,1,0,76.14,63.24,33.33
03,013,01,022,0364,518,1001 ,8 ,1009 ,1963 ,0,3,1,3,0,1,0,76.14,51.4,33.33
03,013,01,022,0365,519,586 ,2 ,588 ,1101 ,0,3,1,3,0,1,0,76.14,53.41,33.33
03,013,01,022,0366,520,472 ,3 ,475 ,928 ,0,3,1,3,0,1,0,76.14,51.19,33.33
03,013,01,022,0367,521,703 ,0 ,703 ,1521 ,0,3,1,3,0,1,0,76.14,46.22,33.33
03,013,01,022,0368,522,525 ,6 ,531 ,1169 ,0,3,1,3,0,1,0,76.14,45.42,33.33
03,013,01,022,0369,523,460 ,3 ,463 ,1048 ,0,3,1,3,0,1,0,76.14,44.18,33.33
03,013,01,022,0370,524,685 ,5 ,690 ,1496 ,0,3,1,3,0,1,0,76.14,46.12,33.33
03,013,01,022,0371,525,391 ,4 ,395 ,778 ,0,3,1,3,0,1,0,76.14,50.77,33.33
03,013,01,023,0372,526,365 ,1 ,366 ,536 ,0,3,1,3,0,1,0,76.14,68.28,33.33
03,013,01,023,0372,527,531 ,6 ,537 ,813 ,0,3,1,3,0,1,0,76.14,66.05,33.33
03,013,01,023,0373,528,425 ,3 ,428 ,589 ,0,3,1,3,0,1,0,76.14,72.67,33.33
03,013,01,023,0374,529,430 ,6 ,436 ,711 ,0,3,1,3,0,1,0,76.14,61.32,33.33
03,013,01,023,0375,530,468 ,6 ,474 ,763 ,0,3,1,3,0,1,0,76.14,62.12,33.33
03,013,01,023,0376,531,262 ,1 ,263 ,428 ,0,3,1,3,0,1,0,76.14,61.45,33.33
03,013,01,023,0377,532,547 ,11 ,558 ,965 ,0,3,1,3,0,1,0,76.14,57.82,33.33
03,013,01,023,0378,533,372 ,7 ,379 ,655 ,0,3,1,3,0,1,0,76.14,57.86,33.33
03,013,01,023,0378,534,354 ,3 ,357 ,658 ,0,3,1,3,0,1,0,76.14,54.26,33.33
03,013,01,023,0379,535,281 ,1 ,282 ,415 ,0,3,1,3,0,1,0,76.14,67.95,33.33
03,013,01,023,0380,536,265 ,1 ,266 ,455 ,0,3,1,3,0,1,0,76.14,58.46,33.33
03,013,01,023,0381,537,312 ,3 ,315 ,513 ,0,3,1,3,0,1,0,76.14,61.4,33.33
03,013,01,023,0382,538,288 ,3 ,291 ,477 ,0,3,1,3,0,1,0,76.14,61.01,33.33
03,013,01,024,0383,539,649 ,5 ,654 ,1246 ,0,3,1,3,0,1,0,76.14,52.49,33.33
03,013,01,024,0384,540,539 ,25 ,564 ,1073 ,0,3,1,3,0,1,0,76.14,52.56,33.33
03,013,01,024,0385,541,570 ,20 ,590 ,1056 ,0,3,1,3,0,1,0,76.14,55.87,33.33
03,013,01,024,0386,542,248 ,1 ,249 ,435 ,0,3,1,3,0,1,0,76.14,57.24,33.33
03,013,01,024,0387,543,116 ,8 ,124 ,251 ,0,3,1,3,0,1,0,76.14,49.4,33.33
03,013,01,024,0388,544,294 ,4 ,298 ,612 ,0,3,1,3,0,1,0,76.14,48.69,33.33
03,013,01,024,0389,545,110 ,1 ,111 ,238 ,0,3,1,3,0,1,0,76.14,46.64,33.33
03,013,01,024,0390,546,164 ,7 ,171 ,306 ,0,3,1,3,0,1,0,76.14,55.88,33.33
03,013,01,025,0391,547,578 ,2 ,580 ,883 ,0,3,1,3,0,1,0,76.14,65.69,33.33
03,013,01,025,0391,548,575 ,6 ,581 ,886 ,0,3,1,3,0,1,0,76.14,65.58,33.33
03,013,01,025,0392,549,359 ,0 ,359 ,564 ,0,3,1,3,0,1,0,76.14,63.65,33.33
03,013,01,025,0392,550,272 ,0 ,272 ,462 ,0,3,1,3,0,1,0,76.14,58.87,33.33
03,013,01,025,0393,551,545 ,5 ,550 ,1040 ,0,3,1,3,0,1,0,76.14,52.88,33.33
03,013,01,025,0394,552,488 ,1 ,489 ,963 ,0,3,1,3,0,1,0,76.14,50.78,33.33
03,013,01,026,0395,553,55 ,2 ,57 ,105 ,0,3,1,3,0,1,0,76.14,54.29,33.33
03,013,01,026,0396,554,2 ,0 ,2 ,12 ,0,3,1,3,0,1,0,76.14,16.67,33.33
03,013,01,026,0397,555,4 ,0 ,4 ,14 ,0,3,1,3,0,1,0,76.14,28.57,33.33
03,013,01,026,0398,556,4 ,0 ,4 ,15 ,0,3,1,3,0,1,0,76.14,26.67,33.33
03,013,01,026,0399,557,15 ,1 ,16 ,46 ,0,3,1,3,0,1,0,76.14,34.78,33.33
03,013,01,026,0400,558,23 ,0 ,23 ,39 ,0,3,1,3,0,1,0,76.14,58.97,33.33
03,013,01,026,0401,559,5 ,0 ,5 ,12 ,0,3,1,3,0,1,0,76.14,41.67,33.33
03,013,01,026,0402,560,18 ,0 ,18 ,30 ,0,3,1,3,0,1,0,76.14,60,33.33
03,013,01,026,0403,561,32 ,2 ,34 ,68 ,0,3,1,3,0,1,0,76.14,50,33.33
03,013,01,026,0404,562,18 ,1 ,19 ,42 ,0,3,1,3,0,1,0,76.14,45.24,33.33
03,013,01,027,0405,563,3 ,0 ,3 ,5 ,0,3,1,3,0,1,0,76.14,60,33.33
03,013,01,027,0405,564,4 ,0 ,4 ,11 ,0,3,1,3,0,1,0,76.14,36.36,33.33
03,013,01,027,0405,565,5 ,1 ,6 ,11 ,0,3,1,3,0,1,0,76.14,54.55,33.33
03,013,01,027,0406,566,2 ,0 ,2 ,3 ,0,3,1,3,0,1,0,76.14,66.67,33.33
03,013,01,027,0407,567,2 ,0 ,2 ,4 ,0,3,1,3,0,1,0,76.14,50,33.33
03,013,01,027,0408,568,3 ,0 ,3 ,17 ,0,3,1,3,0,1,0,76.14,17.65,33.33
03,013,01,027,0409,569,2 ,0 ,2 ,4 ,0,3,1,3,0,1,0,76.14,50,33.33
03,013,01,027,0410,570,2 ,0 ,2 ,5 ,0,3,1,3,0,1,0,76.14,40,33.33
03,013,01,028,0411,571,8 ,0 ,8 ,15 ,0,3,1,3,0,1,0,76.14,53.33,33.33
03,013,01,028,0412,572,41 ,1 ,42 ,68 ,0,3,1,3,0,1,0,76.14,61.76,33.33
03,013,01,028,0413,573,30 ,0 ,30 ,56 ,0,3,1,3,0,1,0,76.14,53.57,33.33
03,013,01,028,0414,574,25 ,0 ,25 ,49 ,0,3,1,3,0,1,0,76.14,51.02,33.33
03,013,01,028,0415,575,6 ,0 ,6 ,15 ,0,3,1,3,0,1,0,76.14,40,33.33
03,013,01,028,0416,576,16 ,1 ,17 ,31 ,0,3,1,3,0,1,0,76.14,54.84,33.33
03,013,01,028,0416,577,20 ,0 ,20 ,40 ,0,3,1,3,0,1,0,76.14,50,33.33
03,013,01,028,0416,578,18 ,0 ,18 ,38 ,0,3,1,3,0,1,0,76.14,47.37,33.33
03,013,01,029,0417,579,16 ,0 ,16 ,34 ,0,3,1,3,0,1,0,76.14,47.06,33.33
03,013,01,029,0417,580,9 ,0 ,9 ,12 ,0,3,1,3,0,1,0,76.14,75,33.33
03,013,01,029,0418,581,17 ,0 ,17 ,38 ,0,3,1,3,0,1,0,76.14,44.74,33.33
03,013,01,029,0419,582,9 ,0 ,9 ,23 ,0,3,1,3,0,1,0,76.14,39.13,33.33
03,013,01,029,0420,583,7 ,0 ,7 ,10 ,0,3,1,3,0,1,0,76.14,70,33.33
03,013,01,029,0421,584,1 ,0 ,1 ,9 ,0,3,1,3,0,1,0,76.14,11.11,33.33
03,013,01,029,0422,585,8 ,0 ,8 ,27 ,0,3,1,3,0,1,0,76.14,29.63,33.33
03,013,01,030,0423,586,7 ,0 ,7 ,20 ,0,3,1,3,0,1,0,76.14,35,33.33
03,013,01,030,0424,587,10 ,0 ,10 ,16 ,0,3,1,3,0,1,0,76.14,62.5,33.33
03,013,01,030,0424,588,3 ,0 ,3 ,5 ,0,3,1,3,0,1,0,76.14,60,33.33
03,013,01,030,0425,589,16 ,0 ,16 ,35 ,0,3,1,3,0,1,0,76.14,45.71,33.33
03,013,01,030,0425,590,5 ,0 ,5 ,12 ,0,3,1,3,0,1,0,76.14,41.67,33.33
03,013,01,030,0426,591,21 ,1 ,22 ,58 ,0,3,1,3,0,1,0,76.14,37.93,33.33
03,013,01,030,0427,592,16 ,0 ,16 ,33 ,0,3,1,3,0,1,0,76.14,48.48,33.33
03,013,01,030,0428,593,30 ,0 ,30 ,43 ,0,3,1,3,0,1,0,76.14,69.77,33.33
03,013,01,030,0429,594,22 ,1 ,23 ,44 ,0,3,1,3,0,1,0,76.14,52.27,33.33
03,013,01,031,0430,595,14 ,0 ,14 ,49 ,0,3,1,3,0,1,0,76.14,28.57,33.33
03,013,01,031,0431,596,16 ,0 ,16 ,43 ,0,3,1,3,0,1,0,76.14,37.21,33.33
03,013,01,031,0432,597,5 ,0 ,5 ,12 ,0,3,1,3,0,1,0,76.14,41.67,33.33
03,013,01,031,0433,598,61 ,1 ,62 ,110 ,0,3,1,3,0,1,0,76.14,56.36,33.33
03,013,01,031,0434,599,49 ,0 ,49 ,92 ,0,3,1,3,0,1,0,76.14,53.26,33.33
03,013,01,031,0435,600,6 ,0 ,6 ,14 ,0,3,1,3,0,1,0,76.14,42.86,33.33
03,013,01,032,0436,601,28 ,0 ,28 ,57 ,0,3,1,3,0,1,0,76.14,49.12,33.33
03,013,01,032,0437,602,29 ,0 ,29 ,70 ,0,3,1,3,0,1,0,76.14,41.43,33.33
03,013,01,032,0438,603,13 ,0 ,13 ,35 ,0,3,1,3,0,1,0,76.14,37.14,33.33
03,013,01,032,0439,604,11 ,0 ,11 ,25 ,0,3,1,3,0,1,0,76.14,44,33.33
03,013,01,032,0440,605,7 ,0 ,7 ,25 ,0,3,1,3,0,1,0,76.14,28,33.33
03,013,01,032,0441,606,8 ,0 ,8 ,23 ,0,3,1,3,0,1,0,76.14,34.78,33.33
03,013,01,032,0442,607,16 ,0 ,16 ,34 ,0,3,1,3,0,1,0,76.14,47.06,33.33
03,013,01,032,0443,608,7 ,0 ,7 ,20 ,0,3,1,3,0,1,0,76.14,35,33.33
03,013,01,033,0444,609,57 ,0 ,57 ,102 ,0,3,1,3,0,1,0,76.14,55.88,33.33
03,013,01,033,0444,610,25 ,0 ,25 ,41 ,0,3,1,3,0,1,0,76.14,60.98,33.33
03,013,01,033,0445,611,8 ,0 ,8 ,22 ,0,3,1,3,0,1,0,76.14,36.36,33.33
03,013,01,033,0446,612,11 ,0 ,11 ,19 ,0,3,1,3,0,1,0,76.14,57.89,33.33
03,013,01,033,0447,613,47 ,0 ,47 ,97 ,0,3,1,3,0,1,0,76.14,48.45,33.33
03,013,01,033,0448,614,21 ,1 ,22 ,31 ,0,3,1,3,0,1,0,76.14,70.97,33.33
03,013,01,033,0449,615,11 ,0 ,11 ,23 ,0,3,1,3,0,1,0,76.14,47.83,33.33
03,014,01,001,0001,1,502 ,4 ,506 ,983 ,0,3,1,3,0,1,0,76.14,51.48 ,33.33
03,014,01,001,0002,2,813 ,8 ,821 ,1429 ,0,3,1,3,0,1,0,76.14,57.45 ,33.33
03,014,01,001,0003,3,850 ,4 ,854 ,1566 ,0,3,1,3,0,1,0,76.14,54.53 ,33.33
03,014,01,001,0003,4,1031 ,1 ,1032 ,1875 ,0,3,1,3,0,1,0,76.14,55.04 ,33.33
03,014,01,001,0004,5,831 ,5 ,836 ,1570 ,0,3,1,3,0,1,0,76.14,53.25 ,33.33
03,014,01,001,0004,6,645 ,5 ,650 ,1263 ,0,3,1,3,0,1,0,76.14,51.46 ,33.33
03,014,01,001,0005,7,361 ,3 ,364 ,739 ,0,3,1,3,0,1,0,76.14,49.26 ,33.33
03,014,01,001,0006,8,571 ,2 ,573 ,1062 ,0,3,1,3,0,1,0,76.14,53.95 ,33.33
03,014,01,001,0007,9,209 ,1 ,210 ,434 ,0,3,1,3,0,1,0,76.14,48.39 ,33.33
03,014,01,001,0008,10,815 ,2 ,817 ,1588 ,0,3,1,3,0,1,0,76.14,51.45 ,33.33
03,014,01,001,0009,11,429 ,2 ,431 ,719 ,0,3,1,3,0,1,0,76.14,59.94 ,33.33
03,014,01,001,0010,12,320 ,4 ,324 ,569 ,0,3,1,3,0,1,0,76.14,56.94 ,33.33
03,014,01,001,0011,13,367 ,7 ,374 ,743 ,0,3,1,3,0,1,0,76.14,50.34 ,33.33
03,014,01,001,0012,14,427 ,3 ,430 ,821 ,0,3,1,3,0,1,0,76.14,52.38 ,33.33
03,014,01,001,0013,15,653 ,2 ,655 ,1328 ,0,3,1,3,0,1,0,76.14,49.32 ,33.33
03,014,01,001,0014,16,495 ,1 ,496 ,894 ,0,3,1,3,0,1,0,76.14,55.48 ,33.33
03,014,01,001,0015,17,524 ,1 ,525 ,918 ,0,3,1,3,0,1,0,76.14,57.19 ,33.33
03,014,01,001,0016,18,394 ,1 ,395 ,733 ,0,3,1,3,0,1,0,76.14,53.89 ,33.33
03,014,01,001,0017,19,228 ,1 ,229 ,431 ,0,3,1,3,0,1,0,76.14,53.13 ,33.33
03,014,01,001,0018,20,646 ,3 ,649 ,1191 ,0,3,1,3,0,1,0,76.14,54.49 ,33.33
03,014,01,001,0018,21,946 ,2 ,948 ,1696 ,0,3,1,3,0,1,0,76.14,55.90 ,33.33
03,014,01,001,0019,22,348 ,4 ,352 ,681 ,0,3,1,3,0,1,0,76.14,51.69 ,33.33
03,014,01,001,0020,23,229 ,3 ,232 ,440 ,0,3,1,3,0,1,0,76.14,52.73 ,33.33
03,014,01,001,0021,24,591 ,1 ,592 ,1118 ,0,3,1,3,0,1,0,76.14,52.95 ,33.33
03,014,01,001,0022,25,619 ,5 ,624 ,1217 ,0,3,1,3,0,1,0,76.14,51.27 ,33.33
03,014,01,001,0022,26,921 ,4 ,925 ,1770 ,0,3,1,3,0,1,0,76.14,52.26 ,33.33
03,014,01,001,0022,27,884 ,5 ,889 ,1737 ,0,3,1,3,0,1,0,76.14,51.18 ,33.33
03,014,01,001,0023,28,496 ,0 ,496 ,930 ,0,3,1,3,0,1,0,76.14,53.33 ,33.33
03,014,01,001,0023,29,739 ,3 ,742 ,1282 ,0,3,1,3,0,1,0,76.14,57.88 ,33.33
03,014,01,001,0024,30,728 ,3 ,731 ,1315 ,0,3,1,3,0,1,0,76.14,55.59 ,33.33
03,014,01,001,0024,31,681 ,3 ,684 ,1271 ,0,3,1,3,0,1,0,76.14,53.82 ,33.33
03,014,01,001,0025,32,837 ,3 ,840 ,1616 ,0,3,1,3,0,1,0,76.14,51.98 ,33.33
03,014,01,001,0026,33,307 ,0 ,307 ,604 ,0,3,1,3,0,1,0,76.14,50.83 ,33.33
03,014,01,001,0026,34,573 ,2 ,575 ,1103 ,0,3,1,3,0,1,0,76.14,52.13 ,33.33
03,014,01,001,0027,35,504 ,1 ,505 ,946 ,0,3,1,3,0,1,0,76.14,53.38 ,33.33
03,014,01,001,0028,36,622 ,2 ,624 ,1181 ,0,3,1,3,0,1,0,76.14,52.84 ,33.33
03,014,01,001,0029,37,603 ,2 ,605 ,1114 ,0,3,1,3,0,1,0,76.14,54.31 ,33.33
03,014,01,001,0030,38,771 ,3 ,774 ,1504 ,0,3,1,3,0,1,0,76.14,51.46 ,33.33
03,014,01,001,0030,39,703 ,4 ,707 ,1443 ,0,3,1,3,0,1,0,76.14,49.00 ,33.33
03,014,01,001,0030,40,715 ,4 ,719 ,1436 ,0,3,1,3,0,1,0,76.14,50.07 ,33.33
03,014,01,001,0030,41,697 ,5 ,702 ,1412 ,0,3,1,3,0,1,0,76.14,49.72 ,33.33
03,014,01,001,0031,42,520 ,2 ,522 ,1028 ,0,3,1,3,0,1,0,76.14,50.78 ,33.33
03,014,01,001,0031,43,427 ,4 ,431 ,903 ,0,3,1,3,0,1,0,76.14,47.73 ,33.33
03,014,01,001,0031,44,572 ,4 ,576 ,1194 ,0,3,1,3,0,1,0,76.14,48.24 ,33.33
03,014,01,001,0032,45,828 ,8 ,836 ,1609 ,0,3,1,3,0,1,0,76.14,51.96 ,33.33
03,014,01,001,0033,46,499 ,6 ,505 ,956 ,0,3,1,3,0,1,0,76.14,52.82 ,33.33
03,014,01,001,0034,47,596 ,5 ,601 ,1143 ,0,3,1,3,0,1,0,76.14,52.58 ,33.33
03,014,01,001,0035,48,221 ,5 ,226 ,480 ,0,3,1,3,0,1,0,76.14,47.08 ,33.33
03,014,01,001,0036,49,536 ,7 ,543 ,910 ,0,3,1,3,0,1,0,76.14,59.67 ,33.33
03,014,01,001,0036,50,272 ,0 ,272 ,532 ,0,3,1,3,0,1,0,76.14,51.13 ,33.33
03,014,01,001,0037,51,507 ,4 ,511 ,1083 ,0,3,1,3,0,1,0,76.14,47.18 ,33.33
03,014,01,001,0038,52,640 ,1 ,641 ,1075 ,0,3,1,3,0,1,0,76.14,59.63 ,33.33
03,014,01,001,0038,53,546 ,2 ,548 ,950 ,0,3,1,3,0,1,0,76.14,57.68 ,33.33
03,014,01,001,0039,54,448 ,0 ,448 ,848 ,0,3,1,3,0,1,0,76.14,52.83 ,33.33
03,014,01,001,0039,55,341 ,1 ,342 ,622 ,0,3,1,3,0,1,0,76.14,54.98 ,33.33
03,014,01,001,0040,56,492 ,3 ,495 ,824 ,0,3,1,3,0,1,0,76.14,60.07 ,33.33
03,014,01,001,0040,57,465 ,2 ,467 ,872 ,0,3,1,3,0,1,0,76.14,53.56 ,33.33
03,014,01,001,0041,58,467 ,2 ,469 ,943 ,0,3,1,3,0,1,0,76.14,49.73 ,33.33
03,014,01,001,0042,59,393 ,1 ,394 ,785 ,0,3,1,3,0,1,0,76.14,50.19 ,33.33
03,014,01,001,0043,60,498 ,0 ,498 ,862 ,0,3,1,3,0,1,0,76.14,57.77 ,33.33
03,014,01,001,0044,61,435 ,0 ,435 ,804 ,0,3,1,3,0,1,0,76.14,54.10 ,33.33
03,014,01,001,0045,62,431 ,4 ,435 ,872 ,0,3,1,3,0,1,0,76.14,49.89 ,33.33
03,014,01,001,0046,63,497 ,7 ,504 ,1117 ,0,3,1,3,0,1,0,76.14,45.12 ,33.33
03,014,01,002,0047,64,73 ,0 ,73 ,184 ,0,3,1,3,0,1,0,76.14,39.67 ,33.33
03,014,01,002,0047,65,61 ,1 ,62 ,153 ,0,3,1,3,0,1,0,76.14,40.52 ,33.33
03,014,01,002,0047,66,35 ,0 ,35 ,89 ,0,3,1,3,0,1,0,76.14,39.33 ,33.33
03,014,01,002,0048,67,61 ,0 ,61 ,138 ,0,3,1,3,0,1,0,76.14,44.20 ,33.33
03,014,01,002,0049,68,36 ,0 ,36 ,97 ,0,3,1,3,0,1,0,76.14,37.11 ,33.33
03,014,01,002,0049,69,524 ,1 ,525 ,1028 ,0,3,1,3,0,1,0,76.14,51.07 ,33.33
03,014,01,002,0050,70,704 ,4 ,708 ,1341 ,0,3,1,3,0,1,0,76.14,52.80 ,33.33
03,014,01,002,0050,71,579 ,0 ,579 ,1047 ,0,3,1,3,0,1,0,76.14,55.30 ,33.33
03,014,01,002,0051,72,175 ,1 ,176 ,389 ,0,3,1,3,0,1,0,76.14,45.24 ,33.33
03,014,01,002,0051,73,361 ,2 ,363 ,717 ,0,3,1,3,0,1,0,76.14,50.63 ,33.33
03,014,01,002,0052,74,97 ,0 ,97 ,195 ,0,3,1,3,0,1,0,76.14,49.74 ,33.33
03,014,01,002,0052,75,139 ,0 ,139 ,366 ,0,3,1,3,0,1,0,76.14,37.98 ,33.33
03,014,01,002,0053,76,97 ,0 ,97 ,227 ,0,3,1,3,0,1,0,76.14,42.73 ,33.33
03,014,01,002,0053,77,102 ,1 ,103 ,251 ,0,3,1,3,0,1,0,76.14,41.04 ,33.33
03,014,01,002,0054,78,26 ,0 ,26 ,51 ,0,3,1,3,0,1,0,76.14,50.98 ,33.33
03,014,01,002,0054,79,17 ,0 ,17 ,40 ,0,3,1,3,0,1,0,76.14,42.50 ,33.33
03,014,01,003,0055,80,489 ,5 ,494 ,865 ,0,3,1,3,0,1,0,76.14,57.11 ,33.33
03,014,01,003,0055,81,345 ,2 ,347 ,699 ,0,3,1,3,0,1,0,76.14,49.64 ,33.33
03,014,01,003,0056,82,508 ,8 ,516 ,850 ,0,3,1,3,0,1,0,76.14,60.71 ,33.33
03,014,01,003,0057,83,353 ,3 ,356 ,647 ,0,3,1,3,0,1,0,76.14,55.02 ,33.33
03,014,01,003,0058,84,524 ,2 ,526 ,953 ,0,3,1,3,0,1,0,76.14,55.19 ,33.33
03,014,01,003,0059,85,346 ,2 ,348 ,654 ,0,3,1,3,0,1,0,76.14,53.21 ,33.33
03,014,01,003,0060,86,245 ,2 ,247 ,484 ,0,3,1,3,0,1,0,76.14,51.03 ,33.33
03,014,01,003,0060,87,399 ,5 ,404 ,716 ,0,3,1,3,0,1,0,76.14,56.42 ,33.33
03,014,01,003,0061,88,106 ,0 ,106 ,214 ,0,3,1,3,0,1,0,76.14,49.53 ,33.33
03,014,01,004,0062,89,489 ,3 ,492 ,849 ,0,3,1,3,0,1,0,76.14,57.95 ,33.33
03,014,01,004,0062,90,422 ,2 ,424 ,852 ,0,3,1,3,0,1,0,76.14,49.77 ,33.33
03,014,01,004,0063,91,126 ,1 ,127 ,244 ,0,3,1,3,0,1,0,76.14,52.05 ,33.33
03,014,01,004,0063,92,237 ,0 ,237 ,426 ,0,3,1,3,0,1,0,76.14,55.63 ,33.33
03,014,01,004,0063,93,142 ,0 ,142 ,304 ,0,3,1,3,0,1,0,76.14,46.71 ,33.33
03,014,01,004,0064,94,241 ,2 ,243 ,551 ,0,3,1,3,0,1,0,76.14,44.10 ,33.33
03,014,01,004,0064,95,224 ,1 ,225 ,443 ,0,3,1,3,0,1,0,76.14,50.79 ,33.33
03,014,01,004,0065,96,337 ,2 ,339 ,729 ,0,3,1,3,0,1,0,76.14,46.50 ,33.33
03,014,01,004,0065,97,145 ,1 ,146 ,311 ,0,3,1,3,0,1,0,76.14,46.95 ,33.33
03,014,01,004,0066,98,84 ,1 ,85 ,194 ,0,3,1,3,0,1,0,76.14,43.81 ,33.33
03,014,01,004,0066,99,16 ,0 ,16 ,33 ,0,3,1,3,0,1,0,76.14,48.48 ,33.33
03,014,01,004,0067,100,674 ,2 ,676 ,1300 ,0,3,1,3,0,1,0,76.14,52.00 ,33.33
03,014,01,004,0067,101,362 ,6 ,368 ,667 ,0,3,1,3,0,1,0,76.14,55.17 ,33.33
03,014,01,004,0067,102,357 ,1 ,358 ,669 ,0,3,1,3,0,1,0,76.14,53.51 ,33.33
03,014,01,004,0068,103,311 ,5 ,316 ,649 ,0,3,1,3,0,1,0,76.14,48.69 ,33.33
03,014,01,004,0069,104,204 ,1 ,205 ,410 ,0,3,1,3,0,1,0,76.14,50.00 ,33.33
03,014,01,004,0070,105,103 ,1 ,104 ,218 ,0,3,1,3,0,1,0,76.14,47.71 ,33.33
03,014,01,004,0071,106,472 ,6 ,478 ,862 ,0,3,1,3,0,1,0,76.14,55.45 ,33.33
03,014,01,004,0071,107,84 ,1 ,85 ,185 ,0,3,1,3,0,1,0,76.14,45.95 ,33.33
03,014,01,004,0072,108,219 ,2 ,221 ,428 ,0,3,1,3,0,1,0,76.14,51.64 ,33.33
03,014,01,004,0073,109,216 ,1 ,217 ,351 ,0,3,1,3,0,1,0,76.14,61.82 ,33.33
03,014,01,004,0074,110,126 ,1 ,127 ,254 ,0,3,1,3,0,1,0,76.14,50.00 ,33.33
03,014,01,005,0075,111,82 ,0 ,82 ,200 ,0,3,1,3,0,1,0,76.14,41.00 ,33.33
03,014,01,005,0075,112,278 ,1 ,279 ,525 ,0,3,1,3,0,1,0,76.14,53.14 ,33.33
03,014,01,005,0076,113,545 ,3 ,548 ,1056 ,0,3,1,3,0,1,0,76.14,51.89 ,33.33
03,014,01,005,0077,114,338 ,3 ,341 ,798 ,0,3,1,3,0,1,0,76.14,42.73 ,33.33
03,014,01,005,0077,115,113 ,0 ,113 ,235 ,0,3,1,3,0,1,0,76.14,48.09 ,33.33
03,014,01,005,0078,116,368 ,3 ,371 ,754 ,0,3,1,3,0,1,0,76.14,49.20 ,33.33
03,014,01,005,0079,117,312 ,1 ,313 ,593 ,0,3,1,3,0,1,0,76.14,52.78 ,33.33
03,014,01,005,0080,118,174 ,0 ,174 ,341 ,0,3,1,3,0,1,0,76.14,51.03 ,33.33
03,014,01,005,0081,119,217 ,0 ,217 ,442 ,0,3,1,3,0,1,0,76.14,49.10 ,33.33
03,014,01,005,0081,120,277 ,5 ,282 ,529 ,0,3,1,3,0,1,0,76.14,53.31 ,33.33
03,014,01,006,0082,121,471 ,3 ,474 ,929 ,0,3,1,3,0,1,0,76.14,51.02 ,33.33
03,014,01,006,0082,122,487 ,0 ,487 ,910 ,0,3,1,3,0,1,0,76.14,53.52 ,33.33
03,014,01,006,0083,123,280 ,1 ,281 ,576 ,0,3,1,3,0,1,0,76.14,48.78 ,33.33
03,014,01,006,0083,124,268 ,2 ,270 ,615 ,0,3,1,3,0,1,0,76.14,43.90 ,33.33
03,014,01,006,0084,125,292 ,0 ,292 ,633 ,0,3,1,3,0,1,0,76.14,46.13 ,33.33
03,014,01,006,0085,126,35 ,1 ,36 ,104 ,0,3,1,3,0,1,0,76.14,34.62 ,33.33
03,014,01,006,0086,127,228 ,0 ,228 ,400 ,0,3,1,3,0,1,0,76.14,57.00 ,33.33
03,014,01,006,0087,128,368 ,1 ,369 ,741 ,0,3,1,3,0,1,0,76.14,49.80 ,33.33
03,014,01,006,0088,129,192 ,1 ,193 ,392 ,0,3,1,3,0,1,0,76.14,49.23 ,33.33
03,014,01,006,0089,130,174 ,4 ,178 ,353 ,0,3,1,3,0,1,0,76.14,50.42 ,33.33
03,014,01,006,0090,131,149 ,3 ,152 ,330 ,0,3,1,3,0,1,0,76.14,46.06 ,33.33
03,014,01,006,0091,132,57 ,0 ,57 ,142 ,0,3,1,3,0,1,0,76.14,40.14 ,33.33
03,014,01,007,0092,133,125 ,1 ,126 ,274 ,0,3,1,3,0,1,0,76.14,45.99 ,33.33
03,014,01,007,0092,134,222 ,4 ,226 ,414 ,0,3,1,3,0,1,0,76.14,54.59 ,33.33
03,014,01,007,0092,135,240 ,1 ,241 ,520 ,0,3,1,3,0,1,0,76.14,46.35 ,33.33
03,014,01,007,0093,136,298 ,1 ,299 ,566 ,0,3,1,3,0,1,0,76.14,52.83 ,33.33
03,014,01,007,0094,137,93 ,1 ,94 ,201 ,0,3,1,3,0,1,0,76.14,46.77 ,33.33
03,014,01,007,0095,138,127 ,0 ,127 ,323 ,0,3,1,3,0,1,0,76.14,39.32 ,33.33
03,014,01,007,0096,139,312 ,2 ,314 ,618 ,0,3,1,3,0,1,0,76.14,50.81 ,33.33
03,014,01,007,0097,140,147 ,1 ,148 ,385 ,0,3,1,3,0,1,0,76.14,38.44 ,33.33
03,014,01,007,0097,141,91 ,0 ,91 ,202 ,0,3,1,3,0,1,0,76.14,45.05 ,33.33
03,014,01,007,0097,142,157 ,1 ,158 ,280 ,0,3,1,3,0,1,0,76.14,56.43 ,33.33
03,014,01,007,0098,143,77 ,1 ,78 ,180 ,0,3,1,3,0,1,0,76.14,43.33 ,33.33
03,014,01,008,0099,144,38 ,0 ,38 ,89 ,0,3,1,3,0,1,0,76.14,42.70 ,33.33
03,014,01,008,0099,145,95 ,0 ,95 ,248 ,0,3,1,3,0,1,0,76.14,38.31 ,33.33
03,014,01,008,0100,146,146 ,0 ,146 ,360 ,0,3,1,3,0,1,0,76.14,40.56 ,33.33
03,014,01,008,0101,147,491 ,5 ,496 ,1080 ,0,3,1,3,0,1,0,76.14,45.93 ,33.33
03,014,01,008,0101,148,77 ,1 ,78 ,200 ,0,3,1,3,0,1,0,76.14,39.00 ,33.33
03,014,01,008,0102,149,200 ,1 ,201 ,503 ,0,3,1,3,0,1,0,76.14,39.96 ,33.33
03,014,01,008,0103,150,74 ,0 ,74 ,183 ,0,3,1,3,0,1,0,76.14,40.44 ,33.33
03,014,01,008,0103,151,41 ,0 ,41 ,80 ,0,3,1,3,0,1,0,76.14,51.25 ,33.33
03,014,01,008,0104,152,62 ,0 ,62 ,128 ,0,3,1,3,0,1,0,76.14,48.44 ,33.33
03,014,01,008,0104,153,119 ,2 ,121 ,255 ,0,3,1,3,0,1,0,76.14,47.45 ,33.33
03,014,01,009,0105,154,460 ,1 ,461 ,904 ,0,3,1,3,0,1,0,76.14,51.00 ,33.33
03,014,01,009,0106,155,322 ,0 ,322 ,620 ,0,3,1,3,0,1,0,76.14,51.94 ,33.33
03,014,01,009,0107,156,371 ,2 ,373 ,681 ,0,3,1,3,0,1,0,76.14,54.77 ,33.33
03,014,01,009,0108,157,196 ,0 ,196 ,385 ,0,3,1,3,0,1,0,76.14,50.91 ,33.33
03,014,01,009,0109,158,265 ,1 ,266 ,479 ,0,3,1,3,0,1,0,76.14,55.53 ,33.33
03,014,01,009,0109,159,311 ,1 ,312 ,676 ,0,3,1,3,0,1,0,76.14,46.15 ,33.33
03,014,01,009,0110,160,434 ,2 ,436 ,765 ,0,3,1,3,0,1,0,76.14,56.99 ,33.33
03,014,01,009,0110,161,240 ,0 ,240 ,459 ,0,3,1,3,0,1,0,76.14,52.29 ,33.33
03,014,01,009,0111,162,175 ,3 ,178 ,367 ,0,3,1,3,0,1,0,76.14,48.50 ,33.33
03,014,01,009,0111,163,54 ,1 ,55 ,95 ,0,3,1,3,0,1,0,76.14,57.89 ,33.33
03,014,01,009,0112,164,75 ,2 ,77 ,157 ,0,3,1,3,0,1,0,76.14,49.04 ,33.33
03,014,01,009,0112,165,97 ,1 ,98 ,208 ,0,3,1,3,0,1,0,76.14,47.12 ,33.33
03,014,01,009,0112,166,24 ,0 ,24 ,52 ,0,3,1,3,0,1,0,76.14,46.15 ,33.33
03,014,01,009,0113,167,7 ,0 ,7 ,14 ,0,3,1,3,0,1,0,76.14,50.00 ,33.33
03,014,01,009,0113,168,89 ,0 ,89 ,198 ,0,3,1,3,0,1,0,76.14,44.95 ,33.33
03,014,01,010,0114,169,134 ,1 ,135 ,359 ,0,3,1,3,0,1,0,76.14,37.60 ,33.33
03,014,01,010,0115,170,533 ,4 ,537 ,1449 ,0,3,1,3,0,1,0,76.14,37.06 ,33.33
03,014,01,010,0116,171,443 ,6 ,449 ,1056 ,0,3,1,3,0,1,0,76.14,42.52 ,33.33
03,014,01,010,0117,172,26 ,0 ,26 ,93 ,0,3,1,3,0,1,0,76.14,27.96 ,33.33
03,014,01,010,0118,173,13 ,0 ,13 ,47 ,0,3,1,3,0,1,0,76.14,27.66 ,33.33
03,014,01,010,0118,174,19 ,0 ,19 ,50 ,0,3,1,3,0,1,0,76.14,38.00 ,33.33
03,014,01,011,0119,175,358 ,0 ,358 ,806 ,0,3,1,3,0,1,0,76.14,44.42 ,33.33
03,014,01,011,0120,176,323 ,1 ,324 ,873 ,0,3,1,3,0,1,0,76.14,37.11 ,33.33
03,014,01,011,0121,177,180 ,3 ,183 ,453 ,0,3,1,3,0,1,0,76.14,40.40 ,33.33
03,014,01,011,0121,178,67 ,0 ,67 ,133 ,0,3,1,3,0,1,0,76.14,50.38 ,33.33
03,014,01,012,0122,179,12 ,1 ,13 ,24 ,0,3,1,3,0,1,0,76.14,54.17 ,33.33
03,014,01,012,0123,180,26 ,0 ,26 ,51 ,0,3,1,3,0,1,0,76.14,50.98 ,33.33
03,014,01,012,0124,181,56 ,0 ,56 ,110 ,0,3,1,3,0,1,0,76.14,50.91 ,33.33
03,014,01,012,0125,182,40 ,0 ,40 ,72 ,0,3,1,3,0,1,0,76.14,55.56 ,33.33
03,014,01,012,0126,183,11 ,1 ,12 ,20 ,0,3,1,3,0,1,0,76.14,60.00 ,33.33
03,014,01,012,0127,184,8 ,1 ,9 ,29 ,0,3,1,3,0,1,0,76.14,31.03 ,33.33
03,014,01,013,0128,185,49 ,1 ,50 ,95 ,0,3,1,3,0,1,0,76.14,52.63 ,33.33
03,014,01,013,0129,186,10 ,0 ,10 ,23 ,0,3,1,3,0,1,0,76.14,43.48 ,33.33
03,014,01,013,0130,187,10 ,0 ,10 ,20 ,0,3,1,3,0,1,0,76.14,50.00 ,33.33
03,014,01,013,0131,188,17 ,0 ,17 ,36 ,0,3,1,3,0,1,0,76.14,47.22 ,33.33
03,014,01,013,0132,189,13 ,0 ,13 ,28 ,0,3,1,3,0,1,0,76.14,46.43 ,33.33
03,014,01,013,0132,190,37 ,0 ,37 ,76 ,0,3,1,3,0,1,0,76.14,48.68 ,33.33
03,014,01,014,0133,191,28 ,0 ,28 ,62 ,0,3,1,3,0,1,0,76.14,45.16 ,33.33
03,014,01,014,0134,192,13 ,0 ,13 ,30 ,0,3,1,3,0,1,0,76.14,43.33 ,33.33
03,014,01,014,0135,193,15 ,1 ,16 ,24 ,0,3,1,3,0,1,0,76.14,66.67 ,33.33
03,014,01,014,0136,194,5 ,0 ,5 ,8 ,0,3,1,3,0,1,0,76.14,62.50 ,33.33
03,014,01,014,0137,195,7 ,0 ,7 ,16 ,0,3,1,3,0,1,0,76.14,43.75 ,33.33
03,014,01,015,0138,196,43 ,0 ,43 ,100 ,0,3,1,3,0,1,0,76.14,43.00 ,33.33
03,014,01,015,0138,197,17 ,1 ,18 ,40 ,0,3,1,3,0,1,0,76.14,45.00 ,33.33
03,014,01,015,0139,198,31 ,0 ,31 ,65 ,0,3,1,3,0,1,0,76.14,47.69 ,33.33
03,014,01,015,0140,199,23 ,0 ,23 ,59 ,0,3,1,3,0,1,0,76.14,38.98 ,33.33
03,014,01,015,0141,200,6 ,0 ,6 ,16 ,0,3,1,3,0,1,0,76.14,37.50 ,33.33
03,014,01,015,0142,201,8 ,0 ,8 ,34 ,0,3,1,3,0,1,0,76.14,23.53 ,33.33
03,014,01,015,0143,202,10 ,0 ,10 ,23 ,0,3,1,3,0,1,0,76.14,43.48 ,33.33
03,014,01,016,0144,203,32 ,0 ,32 ,105 ,0,3,1,3,0,1,0,76.14,30.48 ,33.33
03,014,01,016,0145,204,46 ,0 ,46 ,116 ,0,3,1,3,0,1,0,76.14,39.66 ,33.33
03,014,01,016,0146,205,9 ,0 ,9 ,38 ,0,3,1,3,0,1,0,76.14,23.68 ,33.33
03,014,01,016,0147,206,4 ,0 ,4 ,25 ,0,3,1,3,0,1,0,76.14,16.00 ,33.33
03,015,01,001,0001,1,687 ,3 ,690 ,1307 ,0,3,1,3,0,1,0,76.14,52.79 ,33.33
03,015,01,001,0002,2,465 ,3 ,468 ,850 ,0,3,1,3,0,1,0,76.14,55.06 ,33.33
03,015,01,001,0002,3,379 ,11 ,390 ,746 ,0,3,1,3,0,1,0,76.14,52.28 ,33.33
03,015,01,001,0002,4,616 ,5 ,621 ,1194 ,0,3,1,3,0,1,0,76.14,52.01 ,33.33
03,015,01,001,0003,5,190 ,4 ,194 ,424 ,0,3,1,3,0,1,0,76.14,45.75 ,33.33
03,015,01,001,0003,6,577 ,7 ,584 ,1233 ,0,3,1,3,0,1,0,76.14,47.36 ,33.33
03,015,01,001,0003,7,397 ,6 ,403 ,723 ,0,3,1,3,0,1,0,76.14,55.74 ,33.33
03,015,01,001,0004,8,337 ,1 ,338 ,782 ,0,3,1,3,0,1,0,76.14,43.22 ,33.33
03,015,01,001,0005,9,350 ,3 ,353 ,795 ,0,3,1,3,0,1,0,76.14,44.40 ,33.33
03,015,01,001,0005,10,457 ,2 ,459 ,987 ,0,3,1,3,0,1,0,76.14,46.50 ,33.33
03,015,01,001,0006,11,467 ,6 ,473 ,980 ,0,3,1,3,0,1,0,76.14,48.27 ,33.33
03,015,01,001,0006,12,695 ,6 ,701 ,1264 ,0,3,1,3,0,1,0,76.14,55.46 ,33.33
03,015,01,001,0007,13,489 ,5 ,494 ,972 ,0,3,1,3,0,1,0,76.14,50.82 ,33.33
03,015,01,001,0007,14,446 ,4 ,450 ,815 ,0,3,1,3,0,1,0,76.14,55.21 ,33.33
03,015,01,001,0008,15,600 ,4 ,604 ,1256 ,0,3,1,3,0,1,0,76.14,48.09 ,33.33
03,015,01,001,0008,16,702 ,2 ,704 ,1427 ,0,3,1,3,0,1,0,76.14,49.33 ,33.33
03,015,01,001,0009,17,638 ,7 ,645 ,1201 ,0,3,1,3,0,1,0,76.14,53.71 ,33.33
03,015,01,001,0010,18,233 ,2 ,235 ,491 ,0,3,1,3,0,1,0,76.14,47.86 ,33.33
03,015,01,001,0011,19,356 ,2 ,358 ,647 ,0,3,1,3,0,1,0,76.14,55.33 ,33.33
03,015,01,001,0012,20,331 ,4 ,335 ,571 ,0,3,1,3,0,1,0,76.14,58.67,33.33
03,015,01,001,0013,21,215 ,0 ,215 ,345 ,0,3,1,3,0,1,0,76.14,62.32,33.33
03,015,01,001,0014,22,312 ,0 ,312 ,552 ,0,3,1,3,0,1,0,76.14,56.52 ,33.33
03,015,01,001,0015,23,710 ,13 ,723 ,1342 ,0,3,1,3,0,1,0,76.14,53.87 ,33.33
03,015,01,001,0016,24,237 ,3 ,240 ,449 ,0,3,1,3,0,1,0,76.14,53.45 ,33.33
03,015,01,001,0017,25,374 ,1 ,375 ,675 ,0,3,1,3,0,1,0,76.14,55.56 ,33.33
03,015,01,001,0018,26,520 ,8 ,528 ,976 ,0,3,1,3,0,1,0,76.14,54.10 ,33.33
03,015,01,001,0019,27,323 ,3 ,326 ,607 ,0,3,1,3,0,1,0,76.14,53.71 ,33.33
03,015,01,001,0020,28,395 ,0 ,395 ,720 ,0,3,1,3,0,1,0,76.14,54.86 ,33.33
03,015,01,001,0021,29,530 ,4 ,534 ,1055 ,0,3,1,3,0,1,0,76.14,50.62 ,33.33
03,015,01,001,0022,30,408 ,3 ,411 ,836 ,0,3,1,3,0,1,0,76.14,49.16 ,33.33
03,015,01,001,0023,31,457 ,3 ,460 ,862 ,0,3,1,3,0,1,0,76.14,53.36 ,33.33
03,015,01,001,0023,32,484 ,6 ,490 ,985 ,0,3,1,3,0,1,0,76.14,49.75 ,33.33
03,015,01,001,0023,33,524 ,7 ,531 ,996 ,0,3,1,3,0,1,0,76.14,53.31,33.33
03,015,01,001,0024,34,389 ,3 ,392 ,809 ,0,3,1,3,0,1,0,76.14,48.45,33.33
03,015,01,001,0024,35,439 ,3 ,442 ,892 ,0,3,1,3,0,1,0,76.14,49.55 ,33.33
03,015,01,001,0025,36,633 ,4 ,637 ,1257 ,0,3,1,3,0,1,0,76.14,50.68 ,33.33
03,015,01,001,0025,37,760 ,3 ,763 ,1478 ,0,3,1,3,0,1,0,76.14,51.62 ,33.33
03,015,01,001,0026,38,440 ,3 ,443 ,890 ,0,3,1,3,0,1,0,76.14,49.78 ,33.33
03,015,01,001,0026,39,687 ,6 ,693 ,1409 ,0,3,1,3,0,1,0,76.14,49.18 ,33.33
03,015,01,001,0027,40,457 ,6 ,463 ,1029 ,0,3,1,3,0,1,0,76.14,45,33.33
03,015,01,001,0027,41,419 ,2 ,421 ,947 ,0,3,1,3,0,1,0,76.14,44.46,33.33
03,015,01,001,0027,42,508 ,4 ,512 ,1050 ,0,3,1,3,0,1,0,76.14,48.76,33.33
03,015,01,001,0027,43,540 ,2 ,542 ,991 ,0,3,1,3,0,1,0,76.14,54.69 ,33.33
03,015,01,001,0028,44,597 ,3 ,600 ,1225 ,0,3,1,3,0,1,0,76.14,48.98 ,33.33
03,015,01,001,0028,45,622 ,2 ,624 ,1226 ,0,3,1,3,0,1,0,76.14,50.90 ,33.33
03,015,01,001,0029,46,838 ,5 ,843 ,1573 ,0,3,1,3,0,1,0,76.14,53.59 ,33.33
03,015,01,001,0029,47,678 ,7 ,685 ,1508 ,0,3,1,3,0,1,0,76.14,45.42 ,33.33
03,015,01,001,0030,48,383 ,3 ,386 ,718 ,0,3,1,3,0,1,0,76.14,53.76 ,33.33
03,015,01,001,0030,49,387 ,6 ,393 ,974 ,0,3,1,3,0,1,0,76.14,40.35 ,33.33
03,015,01,001,0031,50,477 ,4 ,481 ,1002 ,0,3,1,3,0,1,0,76.14,48.00 ,33.33
03,015,01,001,0032,51,263 ,3 ,266 ,495 ,0,3,1,3,0,1,0,76.14,53.74 ,33.33
03,015,01,001,0033,52,667 ,6 ,673 ,1225 ,0,3,1,3,0,1,0,76.14,54.94,33.33
03,015,01,001,0034,53,415 ,7 ,422 ,799 ,0,3,1,3,0,1,0,76.14,52.82,33.33
03,015,01,001,0035,54,563 ,6 ,569 ,1159 ,0,3,1,3,0,1,0,76.14,49.09 ,33.33
03,015,01,001,0035,55,423 ,0 ,423 ,847 ,0,3,1,3,0,1,0,76.14,49.94 ,33.33
03,015,01,001,0036,56,552 ,1 ,553 ,1092 ,0,3,1,3,0,1,0,76.14,50.64 ,33.33
03,015,01,001,0036,57,336 ,4 ,340 ,668 ,0,3,1,3,0,1,0,76.14,50.90 ,33.33
03,015,01,001,0037,58,526 ,1 ,527 ,1105 ,0,3,1,3,0,1,0,76.14,47.69 ,33.33
03,015,01,001,0037,59,466 ,2 ,468 ,1016 ,0,3,1,3,0,1,0,76.14,46.06 ,33.33
03,015,01,001,0038,60,501 ,3 ,504 ,1236 ,0,3,1,3,0,1,0,76.14,40.78 ,33.33
03,015,01,001,0038,61,552 ,2 ,554 ,1254 ,0,3,1,3,0,1,0,76.14,44.18 ,33.33
03,015,01,001,0039,62,606 ,5 ,611 ,1202 ,0,3,1,3,0,1,0,76.14,50.83 ,33.33
03,015,01,001,0040,63,667 ,8 ,675 ,1405 ,0,3,1,3,0,1,0,76.14,48.04 ,33.33
03,015,01,001,0040,64,745 ,3 ,748 ,1546 ,0,3,1,3,0,1,0,76.14,48.38 ,33.33
03,015,01,001,0040,65,658 ,5 ,663 ,1393 ,0,3,1,3,0,1,0,76.14,47.60 ,33.33
03,015,01,001,0041,66,487 ,2 ,489 ,1029 ,0,3,1,3,0,1,0,76.14,47.52 ,33.33
03,015,01,001,0041,67,606 ,7 ,613 ,1223 ,0,3,1,3,0,1,0,76.14,50.12 ,33.33
03,015,01,001,0041,68,493 ,4 ,497 ,1033 ,0,3,1,3,0,1,0,76.14,48.11 ,33.33
03,015,01,001,0042,69,383 ,2 ,385 ,807 ,0,3,1,3,0,1,0,76.14,47.71,33.33
03,015,01,001,0043,70,641 ,2 ,643 ,1574 ,0,3,1,3,0,1,0,76.14,40.85,33.33
03,015,01,001,0043,71,642 ,8 ,650 ,1309 ,0,3,1,3,0,1,0,76.14,49.66 ,33.33
03,015,01,001,0044,72,352 ,3 ,355 ,913 ,0,3,1,3,0,1,0,76.14,38.88 ,33.33
03,015,01,002,0045,73,187 ,2 ,189 ,344 ,0,3,1,3,0,1,0,76.14,54.94,33.33
03,015,01,002,0045,74,460 ,5 ,465 ,920 ,0,3,1,3,0,1,0,76.14,50.54,33.33
03,015,01,002,0046,75,309 ,1 ,310 ,586 ,0,3,1,3,0,1,0,76.14,52.90 ,33.33
03,015,01,002,0046,76,146 ,3 ,149 ,236 ,0,3,1,3,0,1,0,76.14,63.14 ,33.33
03,015,01,002,0047,77,157 ,1 ,158 ,285 ,0,3,1,3,0,1,0,76.14,55.44 ,33.33
03,015,01,002,0047,78,489 ,4 ,493 ,948 ,0,3,1,3,0,1,0,76.14,52.00 ,33.33
03,015,01,002,0047,79,300 ,1 ,301 ,673 ,0,3,1,3,0,1,0,76.14,44.73 ,33.33
03,015,01,002,0048,80,154 ,3 ,157 ,353 ,0,3,1,3,0,1,0,76.14,44.48 ,33.33
03,015,01,002,0048,81,395 ,2 ,397 ,834 ,0,3,1,3,0,1,0,76.14,47.60 ,33.33
03,015,01,002,0048,82,212 ,3 ,215 ,422 ,0,3,1,3,0,1,0,76.14,50.95 ,33.33
03,015,01,002,0049,83,288 ,3 ,291 ,653 ,0,3,1,3,0,1,0,76.14,44.56 ,33.33
03,015,01,002,0049,84,385 ,3 ,388 ,820 ,0,3,1,3,0,1,0,76.14,47.32 ,33.33
03,015,01,002,0049,85,480 ,6 ,486 ,968 ,0,3,1,3,0,1,0,76.14,50.21 ,33.33
03,015,01,002,0050,86,274 ,4 ,278 ,614 ,0,3,1,3,0,1,0,76.14,45.28 ,33.33
03,015,01,002,0051,87,498 ,3 ,501 ,1071 ,0,3,1,3,0,1,0,76.14,46.78 ,33.33
03,015,01,002,0051,88,504 ,4 ,508 ,938 ,0,3,1,3,0,1,0,76.14,54.16 ,33.33
03,015,01,002,0051,89,357 ,4 ,361 ,748 ,0,3,1,3,0,1,0,76.14,48.26 ,33.33
03,015,01,002,0052,90,334 ,1 ,335 ,571 ,0,3,1,3,0,1,0,76.14,58.67 ,33.33
03,015,01,002,0052,91,165 ,4 ,169 ,394 ,0,3,1,3,0,1,0,76.14,42.89 ,33.33
03,015,01,003,0053,92,111 ,0 ,111 ,236 ,0,3,1,3,0,1,0,76.14,47.03 ,33.33
03,015,01,003,0053,93,32 ,0 ,32 ,90 ,0,3,1,3,0,1,0,76.14,35.56 ,33.33
03,015,01,003,0054,94,189 ,1 ,190 ,346 ,0,3,1,3,0,1,0,76.14,54.91 ,33.33
03,015,01,003,0055,95,86 ,0 ,86 ,216 ,0,3,1,3,0,1,0,76.14,39.81 ,33.33
03,015,01,003,0055,96,51 ,2 ,53 ,155 ,0,3,1,3,0,1,0,76.14,34.19,33.33
03,015,01,003,0056,97,54 ,0 ,54 ,120 ,0,3,1,3,0,1,0,76.14,45,33.33
03,015,01,003,0057,98,29 ,0 ,29 ,88 ,0,3,1,3,0,1,0,76.14,32.95 ,33.33
03,015,01,003,0057,99,25 ,0 ,25 ,65 ,0,3,1,3,0,1,0,76.14,38.46 ,33.33
03,015,01,003,0058,100,65 ,1 ,66 ,144 ,0,3,1,3,0,1,0,76.14,45.83 ,33.33
03,015,01,003,0059,101,49 ,1 ,50 ,104 ,0,3,1,3,0,1,0,76.14,48.08 ,33.33
03,015,01,003,0060,102,37 ,0 ,37 ,73 ,0,3,1,3,0,1,0,76.14,50.68 ,33.33
03,015,01,003,0061,103,29 ,2 ,31 ,66 ,0,3,1,3,0,1,0,76.14,46.97 ,33.33
03,015,01,003,0061,104,9 ,0 ,9 ,17 ,0,3,1,3,0,1,0,76.14,52.94 ,33.33
03,015,01,004,0062,105,717 ,6 ,723 ,1552 ,0,3,1,3,0,1,0,76.14,46.59 ,33.33
03,015,01,004,0062,106,755 ,3 ,758 ,1648 ,0,3,1,3,0,1,0,76.14,46,33.33
03,015,01,004,0063,107,701 ,2 ,703 ,1483 ,0,3,1,3,0,1,0,76.14,47.4,33.33
03,015,01,004,0063,108,438 ,4 ,442 ,973 ,0,3,1,3,0,1,0,76.14,45.43,33.33
03,015,01,004,0064,109,765 ,12 ,777 ,1667 ,0,3,1,3,0,1,0,76.14,46.61 ,33.33
03,015,01,004,0064,110,831 ,8 ,839 ,1609 ,0,3,1,3,0,1,0,76.14,52.14 ,33.33
03,015,01,004,0064,111,671 ,6 ,677 ,1349 ,0,3,1,3,0,1,0,76.14,50.19 ,33.33
03,015,01,004,0065,112,682 ,4 ,686 ,1386 ,0,3,1,3,0,1,0,76.14,49.49 ,33.33
03,015,01,004,0065,113,455 ,5 ,460 ,1118 ,0,3,1,3,0,1,0,76.14,41.14 ,33.33
03,015,01,004,0065,114,536 ,4 ,540 ,1105 ,0,3,1,3,0,1,0,76.14,48.87 ,33.33
03,015,01,004,0066,115,400 ,1 ,401 ,837 ,0,3,1,3,0,1,0,76.14,47.91,33.33
03,015,01,004,0066,116,569 ,1 ,570 ,1160 ,0,3,1,3,0,1,0,76.14,49.14,33.33
03,015,01,004,0067,117,580 ,6 ,586 ,1096 ,0,3,1,3,0,1,0,76.14,53.47,33.33
03,015,01,004,0068,118,373 ,5 ,378 ,810 ,0,3,1,3,0,1,0,76.14,46.67 ,33.33
03,015,01,004,0069,119,739 ,7 ,746 ,1495 ,0,3,1,3,0,1,0,76.14,49.90 ,33.33
03,015,01,004,0069,120,273 ,3 ,276 ,587 ,0,3,1,3,0,1,0,76.14,47.02 ,33.33
03,015,01,004,0070,121,597 ,5 ,602 ,1215 ,0,3,1,3,0,1,0,76.14,49.55 ,33.33
03,015,01,004,0070,122,696 ,7 ,703 ,1297 ,0,3,1,3,0,1,0,76.14,54.20 ,33.33
03,015,01,004,0071,123,412 ,2 ,414 ,853 ,0,3,1,3,0,1,0,76.14,48.53 ,33.33
03,015,01,004,0071,124,571 ,1 ,572 ,1313 ,0,3,1,3,0,1,0,76.14,43.56 ,33.33
03,015,01,004,0072,125,655 ,3 ,658 ,1402 ,0,3,1,3,0,1,0,76.14,46.93 ,33.33
03,015,01,004,0072,126,620 ,10 ,630 ,1305 ,0,3,1,3,0,1,0,76.14,48.28 ,33.33
03,015,01,004,0073,127,755 ,3 ,758 ,1525 ,0,3,1,3,0,1,0,76.14,49.70 ,33.33
03,015,01,004,0073,128,764 ,6 ,770 ,1464 ,0,3,1,3,0,1,0,76.14,52.60 ,33.33
03,015,01,004,0073,129,748 ,6 ,754 ,1464 ,0,3,1,3,0,1,0,76.14,51.50 ,33.33
03,015,01,004,0073,130,694 ,5 ,699 ,1430 ,0,3,1,3,0,1,0,76.14,48.88 ,33.33
03,015,01,004,0074,131,794 ,8 ,802 ,1633 ,0,3,1,3,0,1,0,76.14,49.11 ,33.33
03,015,01,004,0074,132,940 ,11 ,951 ,1967 ,0,3,1,3,0,1,0,76.14,48.35,33.33
03,015,01,004,0075,133,523 ,5 ,528 ,1047 ,0,3,1,3,0,1,0,76.14,50.43,33.33
03,015,01,004,0075,134,586 ,4 ,590 ,1247 ,0,3,1,3,0,1,0,76.14,47.31 ,33.33
03,015,01,004,0075,135,532 ,6 ,538 ,1163 ,0,3,1,3,0,1,0,76.14,46.26 ,33.33
03,015,01,004,0075,136,567 ,1 ,568 ,1128 ,0,3,1,3,0,1,0,76.14,50.35,33.33
03,015,01,004,0076,137,520 ,1 ,521 ,1074 ,0,3,1,3,0,1,0,76.14,48.51,33.33
03,015,01,004,0076,138,585 ,5 ,590 ,1336 ,0,3,1,3,0,1,0,76.14,44.16 ,33.33
03,015,01,004,0076,139,339 ,2 ,341 ,780 ,0,3,1,3,0,1,0,76.14,43.72 ,33.33
03,015,01,004,0077,140,644 ,5 ,649 ,1420 ,0,3,1,3,0,1,0,76.14,45.70 ,33.33
03,015,01,004,0078,141,574 ,7 ,581 ,1298 ,0,3,1,3,0,1,0,76.14,44.76 ,33.33
03,015,01,004,0078,142,380 ,8 ,388 ,865 ,0,3,1,3,0,1,0,76.14,44.86 ,33.33
03,015,01,004,0078,143,446 ,1 ,447 ,955 ,0,3,1,3,0,1,0,76.14,46.81 ,33.33
03,015,01,004,0079,144,471 ,2 ,473 ,923 ,0,3,1,3,0,1,0,76.14,51.25,33.33
03,015,01,005,0080,145,422 ,2 ,424 ,780 ,0,3,1,3,0,1,0,76.14,54.36,33.33
03,015,01,005,0081,146,161 ,1 ,162 ,285 ,0,3,1,3,0,1,0,76.14,56.84,33.33
03,015,01,005,0082,147,901 ,6 ,907 ,1787 ,0,3,1,3,0,1,0,76.14,50.76 ,33.33
03,015,01,005,0083,148,551 ,3 ,554 ,1170 ,0,3,1,3,0,1,0,76.14,47.35 ,33.33
03,015,01,005,0084,149,331 ,1 ,332 ,629 ,0,3,1,3,0,1,0,76.14,52.78 ,33.33
03,015,01,005,0085,150,557 ,6 ,563 ,1059 ,0,3,1,3,0,1,0,76.14,53.16 ,33.33
03,015,01,005,0086,151,279 ,2 ,281 ,506 ,0,3,1,3,0,1,0,76.14,55.53 ,33.33
03,015,01,005,0087,152,68 ,1 ,69 ,145 ,0,3,1,3,0,1,0,76.14,47.59 ,33.33
03,015,01,005,0088,153,275 ,3 ,278 ,538 ,0,3,1,3,0,1,0,76.14,51.67 ,33.33
03,015,01,005,0089,154,378 ,2 ,380 ,730 ,0,3,1,3,0,1,0,76.14,52.05 ,33.33
03,015,01,005,0089,155,160 ,1 ,161 ,335 ,0,3,1,3,0,1,0,76.14,48.06 ,33.33
03,015,01,005,0090,156,435 ,5 ,440 ,984 ,0,3,1,3,0,1,0,76.14,44.72 ,33.33
03,015,01,005,0090,157,434 ,4 ,438 ,889 ,0,3,1,3,0,1,0,76.14,49.27 ,33.33
03,015,01,005,0091,158,177 ,1 ,178 ,347 ,0,3,1,3,0,1,0,76.14,51.30 ,33.33
03,015,01,005,0092,159,48 ,0 ,48 ,94 ,0,3,1,3,0,1,0,76.14,51.06 ,33.33
03,015,01,005,0092,160,27 ,0 ,27 ,49 ,0,3,1,3,0,1,0,76.14,55.10 ,33.33
03,015,01,005,0093,161,104 ,0 ,104 ,235 ,0,3,1,3,0,1,0,76.14,44.26 ,33.33
03,015,01,005,0094,162,157 ,1 ,158 ,351 ,0,3,1,3,0,1,0,76.14,45.01 ,33.33
03,015,01,005,0095,163,158 ,1 ,159 ,355 ,0,3,1,3,0,1,0,76.14,44.79 ,33.33
03,015,01,005,0095,164,23 ,1 ,24 ,48 ,0,3,1,3,0,1,0,76.14,50.00 ,33.33
03,015,01,006,0096,165,638 ,5 ,643 ,1153 ,0,3,1,3,0,1,0,76.14,55.77 ,33.33
03,015,01,006,0097,166,355 ,3 ,358 ,612 ,0,3,1,3,0,1,0,76.14,58.50 ,33.33
03,015,01,006,0098,167,407 ,2 ,409 ,675 ,0,3,1,3,0,1,0,76.14,60.59 ,33.33
03,015,01,006,0099,168,615 ,3 ,618 ,1086 ,0,3,1,3,0,1,0,76.14,56.91 ,33.33
03,015,01,006,0100,169,218 ,0 ,218 ,395 ,0,3,1,3,0,1,0,76.14,55.19 ,33.33
03,015,01,006,0100,170,242 ,0 ,242 ,444 ,0,3,1,3,0,1,0,76.14,54.50 ,33.33
03,015,01,006,0101,171,73 ,1 ,74 ,154 ,0,3,1,3,0,1,0,76.14,48.05,33.33
03,015,01,006,0101,172,33 ,0 ,33 ,61 ,0,3,1,3,0,1,0,76.14,54.1,33.33
03,015,01,006,0102,173,313 ,3 ,316 ,630 ,0,3,1,3,0,1,0,76.14,50.16 ,33.33
03,015,01,006,0102,174,280 ,2 ,282 ,576 ,0,3,1,3,0,1,0,76.14,48.96 ,33.33
03,015,01,006,0103,175,327 ,5 ,332 ,622 ,0,3,1,3,0,1,0,76.14,53.38 ,33.33
03,015,01,006,0104,176,312 ,2 ,314 ,633 ,0,3,1,3,0,1,0,76.14,49.61 ,33.33
03,015,01,006,0105,177,426 ,7 ,433 ,817 ,0,3,1,3,0,1,0,76.14,53,33.33
03,015,01,006,0106,178,492 ,5 ,497 ,969 ,0,3,1,3,0,1,0,76.14,51.29,33.33
03,015,01,006,0107,179,64 ,0 ,64 ,109 ,0,3,1,3,0,1,0,76.14,58.72 ,33.33
03,015,01,007,0108,180,552 ,4 ,556 ,1032 ,0,3,1,3,0,1,0,76.14,53.88 ,33.33
03,015,01,007,0109,181,488 ,2 ,490 ,828 ,0,3,1,3,0,1,0,76.14,59.18 ,33.33
03,015,01,007,0110,182,119 ,1 ,120 ,283 ,0,3,1,3,0,1,0,76.14,42.40 ,33.33
03,015,01,007,0111,183,180 ,0 ,180 ,368 ,0,3,1,3,0,1,0,76.14,48.91 ,33.33
03,015,01,007,0112,184,383 ,5 ,388 ,697 ,0,3,1,3,0,1,0,76.14,55.67 ,33.33
03,015,01,007,0113,185,39 ,0 ,39 ,80 ,0,3,1,3,0,1,0,76.14,48.75,33.33
03,015,01,007,0113,186,42 ,0 ,42 ,114 ,0,3,1,3,0,1,0,76.14,36.84,33.33
03,015,01,007,0114,187,58 ,0 ,58 ,120 ,0,3,1,3,0,1,0,76.14,48.33 ,33.33
03,015,01,007,0114,188,103 ,1 ,104 ,208 ,0,3,1,3,0,1,0,76.14,50.00 ,33.33
03,015,01,007,0115,189,40 ,0 ,40 ,104 ,0,3,1,3,0,1,0,76.14,38.46 ,33.33
03,015,01,007,0116,190,74 ,2 ,76 ,174 ,0,3,1,3,0,1,0,76.14,43.68 ,33.33
03,015,01,007,0117,191,253 ,3 ,256 ,423 ,0,3,1,3,0,1,0,76.14,60.52 ,33.33
03,015,01,007,0118,192,243 ,4 ,247 ,488 ,0,3,1,3,0,1,0,76.14,50.61 ,33.33
03,015,01,007,0118,193,72 ,0 ,72 ,112 ,0,3,1,3,0,1,0,76.14,64.29 ,33.33
03,015,01,007,0119,194,139 ,4 ,143 ,317 ,0,3,1,3,0,1,0,76.14,45.11,33.33
03,015,01,007,0120,195,162 ,2 ,164 ,367 ,0,3,1,3,0,1,0,76.14,44.69,33.33
03,015,01,007,0121,196,245 ,4 ,249 ,523 ,0,3,1,3,0,1,0,76.14,47.61 ,33.33
03,015,01,008,0122,197,31 ,0 ,31 ,97 ,0,3,1,3,0,1,0,76.14,31.96 ,33.33
03,015,01,008,0123,198,69 ,0 ,69 ,138 ,0,3,1,3,0,1,0,76.14,50.00 ,33.33
03,015,01,008,0124,199,27 ,1 ,28 ,44 ,0,3,1,3,0,1,0,76.14,63.64 ,33.33
03,015,01,008,0124,200,214 ,5 ,219 ,489 ,0,3,1,3,0,1,0,76.14,44.79 ,33.33
03,015,01,008,0124,201,24 ,0 ,24 ,53 ,0,3,1,3,0,1,0,76.14,45.28 ,33.33
03,015,01,008,0125,202,23 ,0 ,23 ,74 ,0,3,1,3,0,1,0,76.14,31.08 ,33.33
03,015,01,008,0126,203,35 ,0 ,35 ,75 ,0,3,1,3,0,1,0,76.14,46.67 ,33.33
03,015,01,009,0127,204,15 ,1 ,16 ,44 ,0,3,1,3,0,1,0,76.14,36.36 ,33.33
03,015,01,009,0128,205,13 ,1 ,14 ,34 ,0,3,1,3,0,1,0,76.14,41.18 ,33.33
03,015,01,009,0129,206,24 ,0 ,24 ,47 ,0,3,1,3,0,1,0,76.14,51.06 ,33.33
03,015,01,009,0130,207,33 ,0 ,33 ,58 ,0,3,1,3,0,1,0,76.14,56.90 ,33.33
03,015,01,009,0131,208,4 ,0 ,4 ,10 ,0,3,1,3,0,1,0,76.14,40.00 ,33.33
03,015,01,009,0131,209,6 ,0 ,6 ,24 ,0,3,1,3,0,1,0,76.14,25.00 ,33.33
03,015,01,009,0132,210,37 ,0 ,37 ,86 ,0,3,1,3,0,1,0,76.14,43.02 ,33.33
03,015,01,010,0133,211,438 ,1 ,439 ,821 ,0,3,1,3,0,1,0,76.14,53.47 ,33.33
03,015,01,010,0133,212,449 ,2 ,451 ,946 ,0,3,1,3,0,1,0,76.14,47.67 ,33.33
03,015,01,010,0134,213,391 ,4 ,395 ,785 ,0,3,1,3,0,1,0,76.14,50.32 ,33.33
03,015,01,010,0134,214,375 ,2 ,377 ,748 ,0,3,1,3,0,1,0,76.14,50.40 ,33.33
03,015,01,010,0135,215,215 ,1 ,216 ,387 ,0,3,1,3,0,1,0,76.14,55.81,33.33
03,015,01,010,0136,216,381 ,1 ,382 ,813 ,0,3,1,3,0,1,0,76.14,46.99,33.33
03,015,01,010,0137,217,166 ,0 ,166 ,369 ,0,3,1,3,0,1,0,76.14,44.99 ,33.33
03,015,01,010,0138,218,210 ,3 ,213 ,468 ,0,3,1,3,0,1,0,76.14,45.51 ,33.33
03,015,01,010,0139,219,120 ,1 ,121 ,276 ,0,3,1,3,0,1,0,76.14,43.84,33.33
03,015,01,010,0140,220,25 ,0 ,25 ,51 ,0,3,1,3,0,1,0,76.14,49.02,33.33
03,015,01,010,0141,221,327 ,2 ,329 ,605 ,0,3,1,3,0,1,0,76.14,54.38 ,33.33
03,015,01,010,0142,222,104 ,3 ,107 ,275 ,0,3,1,3,0,1,0,76.14,38.91 ,33.33
03,015,01,010,0143,223,222 ,2 ,224 ,444 ,0,3,1,3,0,1,0,76.14,50.45 ,33.33
03,015,01,011,0144,224,611 ,9 ,620 ,1296 ,0,3,1,3,0,1,0,76.14,47.84 ,33.33
03,015,01,011,0144,225,679 ,6 ,685 ,1415 ,0,3,1,3,0,1,0,76.14,48.41 ,33.33
03,015,01,011,0144,226,832 ,6 ,838 ,1558 ,0,3,1,3,0,1,0,76.14,53.79 ,33.33
03,015,01,011,0145,227,677 ,5 ,682 ,1322 ,0,3,1,3,0,1,0,76.14,51.59 ,33.33
03,015,01,011,0146,228,389 ,3 ,392 ,821 ,0,3,1,3,0,1,0,76.14,47.75 ,33.33
03,015,01,011,0146,229,401 ,4 ,405 ,822 ,0,3,1,3,0,1,0,76.14,49.27 ,33.33
03,015,01,011,0147,230,541 ,5 ,546 ,1021 ,0,3,1,3,0,1,0,76.14,53.48,33.33
03,015,01,011,0147,231,207 ,19 ,226 ,836 ,0,3,1,3,0,1,0,76.14,27.03,33.33
03,015,01,011,0147,232,72 ,13 ,85 ,535 ,0,3,1,3,0,1,0,76.14,15.89 ,33.33
03,015,01,011,0148,233,476 ,3 ,479 ,1001 ,0,3,1,3,0,1,0,76.14,47.85 ,33.33
03,015,01,011,0149,234,522 ,7 ,529 ,1080 ,0,3,1,3,0,1,0,76.14,48.98 ,33.33
03,015,01,011,0150,235,200 ,6 ,206 ,536 ,0,3,1,3,0,1,0,76.14,38.43 ,33.33
03,015,01,011,0151,236,146 ,1 ,147 ,358 ,0,3,1,3,0,1,0,76.14,41.06 ,33.33
03,015,01,011,0152,237,160 ,0 ,160 ,331 ,0,3,1,3,0,1,0,76.14,48.34 ,33.33
03,015,01,011,0153,238,272 ,3 ,275 ,655 ,0,3,1,3,0,1,0,76.14,41.98 ,33.33
03,015,01,011,0153,239,133 ,1 ,134 ,275 ,0,3,1,3,0,1,0,76.14,48.73 ,33.33
03,015,01,011,0154,240,199 ,3 ,202 ,476 ,0,3,1,3,0,1,0,76.14,42.44 ,33.33
03,015,01,011,0155,241,173 ,5 ,178 ,455 ,0,3,1,3,0,1,0,76.14,39.12 ,33.33
03,015,01,011,0156,242,30 ,0 ,30 ,76 ,0,3,1,3,0,1,0,76.14,39.47 ,33.33
03,015,01,011,0157,243,482 ,2 ,484 ,939 ,0,3,1,3,0,1,0,76.14,51.54 ,33.33
03,015,01,011,0158,244,452 ,4 ,456 ,972 ,0,3,1,3,0,1,0,76.14,46.91 ,33.33
03,015,01,012,0159,245,202 ,2 ,204 ,420 ,0,3,1,3,0,1,0,76.14,48.57 ,33.33
03,015,01,012,0160,246,445 ,3 ,448 ,1120 ,0,3,1,3,0,1,0,76.14,40.00 ,33.33
03,015,01,012,0161,247,214 ,2 ,216 ,585 ,0,3,1,3,0,1,0,76.14,36.92 ,33.33
03,015,01,012,0162,248,223 ,4 ,227 ,547 ,0,3,1,3,0,1,0,76.14,41.50 ,33.33
03,015,01,012,0163,249,483 ,5 ,488 ,1031 ,0,3,1,3,0,1,0,76.14,47.33 ,33.33
03,015,01,012,0164,250,189 ,3 ,192 ,446 ,0,3,1,3,0,1,0,76.14,43.05 ,33.33
03,015,01,012,0165,251,407 ,2 ,409 ,837 ,0,3,1,3,0,1,0,76.14,48.86 ,33.33
03,015,01,012,0166,252,182 ,2 ,184 ,389 ,0,3,1,3,0,1,0,76.14,47.30 ,33.33
03,015,01,012,0167,253,696 ,5 ,701 ,1494 ,0,3,1,3,0,1,0,76.14,46.92 ,33.33
03,015,01,012,0168,254,200 ,0 ,200 ,507 ,0,3,1,3,0,1,0,76.14,39.45 ,33.33
03,015,01,012,0169,255,143 ,1 ,144 ,312 ,0,3,1,3,0,1,0,76.14,46.15 ,33.33
03,015,01,012,0170,256,218 ,3 ,221 ,517 ,0,3,1,3,0,1,0,76.14,42.75 ,33.33
03,015,01,012,0171,257,291 ,1 ,292 ,536 ,0,3,1,3,0,1,0,76.14,54.48 ,33.33
03,015,01,013,0172,258,9 ,0 ,9 ,19 ,0,3,1,3,0,1,0,76.14,47.37,33.33
03,015,01,013,0173,259,7 ,0 ,7 ,19 ,0,3,1,3,0,1,0,76.14,36.84,33.33
03,015,01,013,0173,260,6 ,0 ,6 ,18 ,0,3,1,3,0,1,0,76.14,33.33,33.33
03,015,01,013,0174,261,6 ,0 ,6 ,7 ,0,3,1,3,0,1,0,76.14,85.71 ,33.33
03,015,01,013,0174,262,10 ,0 ,10 ,18 ,0,3,1,3,0,1,0,76.14,55.56 ,33.33
03,015,01,013,0175,263,40 ,0 ,40 ,79 ,0,3,1,3,0,1,0,76.14,50.63 ,33.33
03,015,01,013,0176,264,27 ,0 ,27 ,58 ,0,3,1,3,0,1,0,76.14,46.55 ,33.33
03,015,01,013,0176,265,12 ,0 ,12 ,29 ,0,3,1,3,0,1,0,76.14,41.38,33.33
03,015,01,013,0177,266,13 ,0 ,13 ,34 ,0,3,1,3,0,1,0,76.14,38.24,33.33
03,015,01,013,0177,267,13 ,0 ,13 ,19 ,0,3,1,3,0,1,0,76.14,68.42 ,33.33
03,015,01,013,0177,268,10 ,0 ,10 ,16 ,0,3,1,3,0,1,0,76.14,62.50 ,33.33
03,016,01,001,0001,1,187 ,1 ,188 ,300 ,0,3,1,3,0,1,0,76.14,62.67 ,33.33
03,016,01,001,0002,2,187 ,0 ,187 ,319 ,0,3,1,3,0,1,0,76.14,58.62 ,33.33
03,016,01,001,0003,3,314 ,4 ,318 ,526 ,0,3,1,3,0,1,0,76.14,60.46 ,33.33
03,016,01,001,0004,4,283 ,4 ,287 ,491 ,0,3,1,3,0,1,0,76.14,58.45 ,33.33
03,016,01,001,0005,5,509 ,7 ,516 ,867 ,0,3,1,3,0,1,0,76.14,59.52 ,33.33
03,016,01,001,0006,6,585 ,5 ,590 ,978 ,0,3,1,3,0,1,0,76.14,60.33 ,33.33
03,016,01,001,0007,7,423 ,5 ,428 ,705 ,0,3,1,3,0,1,0,76.14,60.71 ,33.33
03,016,01,001,0008,8,509 ,1 ,510 ,924 ,0,3,1,3,0,1,0,76.14,55.19 ,33.33
03,016,01,001,0008,9,538 ,2 ,540 ,902 ,0,3,1,3,0,1,0,76.14,59.87 ,33.33
03,016,01,001,0009,10,342 ,2 ,344 ,554 ,0,3,1,3,0,1,0,76.14,62.09 ,33.33
03,016,01,001,0009,11,329 ,3 ,332 ,605 ,0,3,1,3,0,1,0,76.14,54.88 ,33.33
03,016,01,001,0010,12,743 ,3 ,746 ,1224 ,0,3,1,3,0,1,0,76.14,60.95 ,33.33
03,016,01,001,0010,13,676 ,4 ,680 ,1174 ,0,3,1,3,0,1,0,76.14,57.92 ,33.33
03,016,01,001,0011,14,607 ,3 ,610 ,1131 ,0,3,1,3,0,1,0,76.14,53.93 ,33.33
03,016,01,001,0011,15,652 ,4 ,656 ,1197 ,0,3,1,3,0,1,0,76.14,54.80 ,33.33
03,016,01,001,0011,16,647 ,5 ,652 ,1131 ,0,3,1,3,0,1,0,76.14,57.65 ,33.33
03,016,01,001,0011,17,679 ,11 ,690 ,1202 ,0,3,1,3,0,1,0,76.14,57.40 ,33.33
03,016,01,001,0012,18,615 ,7 ,622 ,1131 ,0,3,1,3,0,1,0,76.14,55.00 ,33.33
03,016,01,001,0012,19,649 ,5 ,654 ,1141 ,0,3,1,3,0,1,0,76.14,57.32 ,33.33
03,016,01,001,0013,20,686 ,3 ,689 ,1159 ,0,3,1,3,0,1,0,76.14,59.45 ,33.33
03,016,01,001,0014,21,777 ,6 ,783 ,1366 ,0,3,1,3,0,1,0,76.14,57.32 ,33.33
03,016,01,001,0014,22,832 ,3 ,835 ,1480 ,0,3,1,3,0,1,0,76.14,56.42 ,33.33
03,016,01,001,0015,23,635 ,4 ,639 ,1066 ,0,3,1,3,0,1,0,76.14,59.94 ,33.33
03,016,01,001,0015,24,559 ,5 ,564 ,967 ,0,3,1,3,0,1,0,76.14,58.32 ,33.33
03,016,01,001,0016,25,690 ,2 ,692 ,1160 ,0,3,1,3,0,1,0,76.14,59.66 ,33.33
03,016,01,001,0016,26,511 ,3 ,514 ,924 ,0,3,1,3,0,1,0,76.14,55.63 ,33.33
03,016,01,001,0017,27,763 ,5 ,768 ,1231 ,0,3,1,3,0,1,0,76.14,62.39 ,33.33
03,016,01,001,0018,28,403 ,7 ,410 ,686 ,0,3,1,3,0,1,0,76.14,59.77 ,33.33
03,016,01,001,0019,29,355 ,3 ,358 ,567 ,0,3,1,3,0,1,0,76.14,63.14 ,33.33
03,016,01,001,0020,30,873 ,10 ,883 ,1512 ,0,3,1,3,0,1,0,76.14,58.40 ,33.33
03,016,01,001,0021,31,221 ,4 ,225 ,323 ,0,3,1,3,0,1,0,76.14,69.66 ,33.33
03,016,01,001,0022,32,791 ,5 ,796 ,1374 ,0,3,1,3,0,1,0,76.14,57.93 ,33.33
03,016,01,001,0023,33,268 ,2 ,270 ,436 ,0,3,1,3,0,1,0,76.14,61.93 ,33.33
03,016,01,001,0024,34,365 ,0 ,365 ,604 ,0,3,1,3,0,1,0,76.14,60.43 ,33.33
03,016,01,001,0025,35,493 ,4 ,497 ,814 ,0,3,1,3,0,1,0,76.14,61.06 ,33.33
03,016,01,001,0026,36,258 ,1 ,259 ,387 ,0,3,1,3,0,1,0,76.14,66.93 ,33.33
03,016,01,001,0027,37,569 ,3 ,572 ,1061 ,0,3,1,3,0,1,0,76.14,53.91 ,33.33
03,016,01,001,0027,38,502 ,4 ,506 ,973 ,0,3,1,3,0,1,0,76.14,52.00 ,33.33
03,016,01,001,0028,39,820 ,6 ,826 ,1406 ,0,3,1,3,0,1,0,76.14,58.75 ,33.33
03,016,01,001,0029,40,104 ,2 ,106 ,178 ,0,3,1,3,0,1,0,76.14,59.55 ,33.33
03,016,01,001,0030,41,207 ,2 ,209 ,336 ,0,3,1,3,0,1,0,76.14,62.20 ,33.33
03,016,01,001,0031,42,628 ,4 ,632 ,1064 ,0,3,1,3,0,1,0,76.14,59.40 ,33.33
03,016,01,001,0032,43,664 ,6 ,670 ,1231 ,0,3,1,3,0,1,0,76.14,54.43 ,33.33
03,016,01,001,0033,44,207 ,2 ,209 ,602 ,0,3,1,3,0,1,0,76.14,34.72 ,33.33
03,016,01,001,0034,45,55 ,0 ,55 ,201 ,0,3,1,3,0,1,0,76.14,27.36 ,33.33
03,016,01,002,0035,46,532 ,8 ,540 ,845 ,0,3,1,3,0,1,0,76.14,63.91 ,33.33
03,016,01,002,0036,47,187 ,1 ,188 ,306 ,0,3,1,3,0,1,0,76.14,61.44 ,33.33
03,016,01,002,0037,48,106 ,0 ,106 ,203 ,0,3,1,3,0,1,0,76.14,52.22 ,33.33
03,016,01,002,0038,49,148 ,1 ,149 ,243 ,0,3,1,3,0,1,0,76.14,61.32 ,33.33
03,016,01,002,0039,50,359 ,4 ,363 ,607 ,0,3,1,3,0,1,0,76.14,59.80 ,33.33
03,016,01,002,0040,51,169 ,3 ,172 ,279 ,0,3,1,3,0,1,0,76.14,61.65 ,33.33
03,016,01,002,0041,52,328 ,4 ,332 ,556 ,0,3,1,3,0,1,0,76.14,59.71 ,33.33
03,016,01,002,0042,53,263 ,0 ,263 ,459 ,0,3,1,3,0,1,0,76.14,57.30 ,33.33
03,016,01,002,0043,54,268 ,1 ,269 ,421 ,0,3,1,3,0,1,0,76.14,63.90 ,33.33
03,016,01,002,0044,55,64 ,0 ,64 ,108 ,0,3,1,3,0,1,0,76.14,59.26 ,33.33
03,016,01,002,0045,56,436 ,7 ,443 ,722 ,0,3,1,3,0,1,0,76.14,61.36 ,33.33
03,016,01,002,0046,57,90 ,0 ,90 ,165 ,0,3,1,3,0,1,0,76.14,54.55 ,33.33
03,016,01,002,0047,58,179 ,1 ,180 ,296 ,0,3,1,3,0,1,0,76.14,60.81 ,33.33
03,016,01,002,0048,59,143 ,1 ,144 ,228 ,0,3,1,3,0,1,0,76.14,63.16 ,33.33
03,016,01,002,0049,60,101 ,0 ,101 ,166 ,0,3,1,3,0,1,0,76.14,60.84 ,33.33
03,016,01,002,0050,61,130 ,0 ,130 ,189 ,0,3,1,3,0,1,0,76.14,68.78 ,33.33
03,016,01,002,0051,62,61 ,0 ,61 ,109 ,0,3,1,3,0,1,0,76.14,55.96 ,33.33
03,016,01,002,0052,63,402 ,2 ,404 ,628 ,0,3,1,3,0,1,0,76.14,64.33 ,33.33
03,016,01,002,0053,64,470 ,4 ,474 ,876 ,0,3,1,3,0,1,0,76.14,54.11 ,33.33
03,016,01,002,0054,65,303 ,1 ,304 ,532 ,0,3,1,3,0,1,0,76.14,57.14 ,33.33
03,016,01,002,0055,66,465 ,6 ,471 ,783 ,0,3,1,3,0,1,0,76.14,60.15 ,33.33
03,016,01,002,0055,67,437 ,2 ,439 ,752 ,0,3,1,3,0,1,0,76.14,58.38 ,33.33
03,016,01,002,0056,68,387 ,1 ,388 ,641 ,0,3,1,3,0,1,0,76.14,60.53 ,33.33
03,016,01,003,0057,69,279 ,2 ,281 ,441 ,0,3,1,3,0,1,0,76.14,63.72 ,33.33
03,016,01,003,0058,70,306 ,2 ,308 ,537 ,0,3,1,3,0,1,0,76.14,57.36 ,33.33
03,016,01,003,0059,71,53 ,1 ,54 ,89 ,0,3,1,3,0,1,0,76.14,60.67 ,33.33
03,016,01,003,0060,72,75 ,0 ,75 ,117 ,0,3,1,3,0,1,0,76.14,64.10 ,33.33
03,016,01,003,0061,73,123 ,2 ,125 ,239 ,0,3,1,3,0,1,0,76.14,52.30 ,33.33
03,016,01,003,0062,74,112 ,0 ,112 ,207 ,0,3,1,3,0,1,0,76.14,54.11 ,33.33
03,016,01,003,0063,75,98 ,0 ,98 ,145 ,0,3,1,3,0,1,0,76.14,67.59 ,33.33
03,016,01,003,0064,76,751 ,8 ,759 ,1306 ,0,3,1,3,0,1,0,76.14,58.12 ,33.33
03,016,01,003,0065,77,154 ,2 ,156 ,282 ,0,3,1,3,0,1,0,76.14,55.32 ,33.33
03,016,01,003,0066,78,373 ,4 ,377 ,644 ,0,3,1,3,0,1,0,76.14,58.54 ,33.33
03,016,01,003,0067,79,382 ,1 ,383 ,673 ,0,3,1,3,0,1,0,76.14,56.91 ,33.33
03,016,01,003,0068,80,510 ,4 ,514 ,1212 ,0,3,1,3,0,1,0,76.14,42.41 ,33.33
03,016,01,003,0069,81,276 ,41 ,317 ,972 ,0,3,1,3,0,1,0,76.14,32.61 ,33.33
03,016,01,003,0070,82,70 ,0 ,70 ,209 ,0,3,1,3,0,1,0,76.14,33.49 ,33.33
03,016,01,003,0071,83,80 ,3 ,83 ,175 ,0,3,1,3,0,1,0,76.14,47.43 ,33.33
03,016,01,004,0072,84,130 ,0 ,130 ,253 ,0,3,1,3,0,1,0,76.14,51.38 ,33.33
03,016,01,004,0073,85,194 ,2 ,196 ,387 ,0,3,1,3,0,1,0,76.14,50.65 ,33.33
03,016,01,004,0074,86,405 ,4 ,409 ,748 ,0,3,1,3,0,1,0,76.14,54.68 ,33.33
03,016,01,004,0075,87,135 ,0 ,135 ,262 ,0,3,1,3,0,1,0,76.14,51.53 ,33.33
03,016,01,004,0076,88,298 ,6 ,304 ,597 ,0,3,1,3,0,1,0,76.14,50.92 ,33.33
03,016,01,004,0077,89,58 ,2 ,60 ,120 ,0,3,1,3,0,1,0,76.14,50.00 ,33.33
03,016,01,004,0078,90,265 ,1 ,266 ,495 ,0,3,1,3,0,1,0,76.14,53.74 ,33.33
03,016,01,004,0079,91,97 ,0 ,97 ,188 ,0,3,1,3,0,1,0,76.14,51.60 ,33.33
03,016,01,004,0080,92,273 ,1 ,274 ,583 ,0,3,1,3,0,1,0,76.14,47.00 ,33.33
03,016,01,004,0081,93,627 ,4 ,631 ,1178 ,0,3,1,3,0,1,0,76.14,53.57 ,33.33
03,016,01,004,0082,94,396 ,1 ,397 ,799 ,0,3,1,3,0,1,0,76.14,49.69 ,33.33
03,016,01,004,0082,95,499 ,4 ,503 ,984 ,0,3,1,3,0,1,0,76.14,51.12 ,33.33
03,016,01,005,0083,96,186 ,0 ,186 ,410 ,0,3,1,3,0,1,0,76.14,45.37 ,33.33
03,016,01,005,0084,97,133 ,1 ,134 ,311 ,0,3,1,3,0,1,0,76.14,43.09 ,33.33
03,016,01,005,0085,98,75 ,0 ,75 ,217 ,0,3,1,3,0,1,0,76.14,34.56 ,33.33
03,016,01,005,0086,99,133 ,0 ,133 ,280 ,0,3,1,3,0,1,0,76.14,47.50 ,33.33
03,016,01,005,0087,100,206 ,3 ,209 ,567 ,0,3,1,3,0,1,0,76.14,36.86 ,33.33
03,016,01,005,0087,101,207 ,2 ,209 ,599 ,0,3,1,3,0,1,0,76.14,34.89 ,33.33
03,016,01,005,0088,102,29 ,1 ,30 ,266 ,0,3,1,3,0,1,0,76.14,11.28 ,33.33
03,016,01,005,0089,103,39 ,0 ,39 ,331 ,0,3,1,3,0,1,0,76.14,11.78 ,33.33
03,016,01,005,0090,104,16 ,0 ,16 ,171 ,0,3,1,3,0,1,0,76.14,9.36 ,33.33
03,016,01,005,0091,105,97 ,3 ,100 ,217 ,0,3,1,3,0,1,0,76.14,46.08 ,33.33
03,016,01,006,0092,106,84 ,0 ,84 ,221 ,0,3,1,3,0,1,0,76.14,38.01 ,33.33
03,016,01,006,0093,107,148 ,0 ,148 ,409 ,0,3,1,3,0,1,0,76.14,36.19 ,33.33
03,016,01,006,0094,108,172 ,3 ,175 ,442 ,0,3,1,3,0,1,0,76.14,39.59 ,33.33
03,016,01,006,0095,109,104 ,2 ,106 ,254 ,0,3,1,3,0,1,0,76.14,41.73 ,33.33
03,016,01,006,0096,110,99 ,2 ,101 ,247 ,0,3,1,3,0,1,0,76.14,40.89 ,33.33
03,016,01,006,0097,111,348 ,1 ,349 ,831 ,0,3,1,3,0,1,0,76.14,42.00 ,33.33
03,017,01,001,0001,1,383 ,3 ,386 ,566 ,0,3,1,3,0,1,0,76.14,68.20 ,33.33
03,017,01,001,0002,2,692 ,1 ,693 ,1236 ,0,3,1,3,0,1,0,76.14,56.07 ,33.33
03,017,01,001,0002,3,307 ,5 ,312 ,629 ,0,3,1,3,0,1,0,76.14,49.60 ,33.33
03,017,01,001,0002,4,465 ,24 ,489 ,1023 ,0,3,1,3,0,1,0,76.14,47.80 ,33.33
03,017,01,001,0003,5,894 ,10 ,904 ,1545 ,0,3,1,3,0,1,0,76.14,58.51 ,33.33
03,017,01,001,0004,6,645 ,6 ,651 ,1281 ,0,3,1,3,0,1,0,76.14,50.82 ,33.33
03,017,01,001,0005,7,782 ,5 ,787 ,1694 ,0,3,1,3,0,1,0,76.14,46.46 ,33.33
03,017,01,001,0005,8,621 ,9 ,630 ,1213 ,0,3,1,3,0,1,0,76.14,51.94 ,33.33
03,017,01,001,0005,9,194 ,3 ,197 ,485 ,0,3,1,3,0,1,0,76.14,40.62 ,33.33
03,017,01,001,0006,10,292 ,5 ,297 ,737 ,0,3,1,3,0,1,0,76.14,40.30 ,33.33
03,017,01,001,0006,11,491 ,5 ,496 ,1108 ,0,3,1,3,0,1,0,76.14,44.77 ,33.33
03,017,01,001,0006,12,730 ,3 ,733 ,1545 ,0,3,1,3,0,1,0,76.14,47.44 ,33.33
03,017,01,001,0007,13,798 ,2 ,800 ,1480 ,0,3,1,3,0,1,0,76.14,54.05 ,33.33
03,017,01,001,0008,14,1011 ,7 ,1018 ,1904 ,0,3,1,3,0,1,0,76.14,53.47 ,33.33
03,017,01,001,0009,15,464 ,2 ,466 ,898 ,0,3,1,3,0,1,0,76.14,51.89 ,33.33
03,017,01,001,0010,16,499 ,4 ,503 ,988 ,0,3,1,3,0,1,0,76.14,50.91 ,33.33
03,017,01,001,0011,17,628 ,11 ,639 ,1216 ,0,3,1,3,0,1,0,76.14,52.55 ,33.33
03,017,01,001,0012,18,538 ,4 ,542 ,1154 ,0,3,1,3,0,1,0,76.14,46.97 ,33.33
03,017,01,001,0012,19,524 ,7 ,531 ,906 ,0,3,1,3,0,1,0,76.14,58.61 ,33.33
03,017,01,001,0013,20,794 ,5 ,799 ,1350 ,0,3,1,3,0,1,0,76.14,59.19,33.33
03,017,01,001,0014,21,657 ,6 ,663 ,1196 ,0,3,1,3,0,1,0,76.14,55.43,33.33
03,017,01,001,0014,22,548 ,4 ,552 ,924 ,0,3,1,3,0,1,0,76.14,59.74 ,33.33
03,017,01,001,0015,23,618 ,6 ,624 ,1155 ,0,3,1,3,0,1,0,76.14,54.03 ,33.33
03,017,01,001,0015,24,494 ,9 ,503 ,938 ,0,3,1,3,0,1,0,76.14,53.62 ,33.33
03,017,01,001,0016,25,839 ,9 ,848 ,1476 ,0,3,1,3,0,1,0,76.14,57.45 ,33.33
03,017,01,001,0017,26,833 ,3 ,836 ,1434 ,0,3,1,3,0,1,0,76.14,58.30 ,33.33
03,017,01,001,0017,27,546 ,4 ,550 ,945 ,0,3,1,3,0,1,0,76.14,58.20 ,33.33
03,017,01,001,0018,28,794 ,5 ,799 ,1298 ,0,3,1,3,0,1,0,76.14,61.56 ,33.33
03,017,01,001,0019,29,698 ,5 ,703 ,1260 ,0,3,1,3,0,1,0,76.14,55.79 ,33.33
03,017,01,001,0020,30,764 ,3 ,767 ,1438 ,0,3,1,3,0,1,0,76.14,53.34 ,33.33
03,017,01,001,0021,31,706 ,5 ,711 ,1311 ,0,3,1,3,0,1,0,76.14,54.23 ,33.33
03,017,01,001,0022,32,693 ,5 ,698 ,1228 ,0,3,1,3,0,1,0,76.14,56.84 ,33.33
03,017,01,001,0023,33,664 ,4 ,668 ,1169 ,0,3,1,3,0,1,0,76.14,57.14,33.33
03,017,01,001,0024,34,796 ,3 ,799 ,1442 ,0,3,1,3,0,1,0,76.14,55.41,33.33
03,017,01,001,0025,35,562 ,6 ,568 ,1007 ,0,3,1,3,0,1,0,76.14,56.41 ,33.33
03,017,01,001,0026,36,451 ,4 ,455 ,793 ,0,3,1,3,0,1,0,76.14,57.38 ,33.33
03,017,01,002,0027,37,701 ,4 ,705 ,1174 ,0,3,1,3,0,1,0,76.14,60.05 ,33.33
03,017,01,002,0028,38,765 ,6 ,771 ,1231 ,0,3,1,3,0,1,0,76.14,62.63 ,33.33
03,017,01,002,0029,39,557 ,1 ,558 ,974 ,0,3,1,3,0,1,0,76.14,57.29 ,33.33
03,017,01,002,0030,40,717 ,4 ,721 ,1188 ,0,3,1,3,0,1,0,76.14,60.69,33.33
03,017,01,002,0030,41,670 ,9 ,679 ,1171 ,0,3,1,3,0,1,0,76.14,57.98,33.33
03,017,01,002,0031,42,484 ,5 ,489 ,812 ,0,3,1,3,0,1,0,76.14,60.22,33.33
03,017,01,002,0032,43,745 ,7 ,752 ,1245 ,0,3,1,3,0,1,0,76.14,60.40 ,33.33
03,017,01,002,0033,44,414 ,4 ,418 ,684 ,0,3,1,3,0,1,0,76.14,61.11 ,33.33
03,017,01,002,0034,45,371 ,4 ,375 ,696 ,0,3,1,3,0,1,0,76.14,53.88 ,33.33
03,017,01,002,0034,46,536 ,6 ,542 ,1014 ,0,3,1,3,0,1,0,76.14,53.45 ,33.33
03,017,01,002,0035,47,838 ,4 ,842 ,1448 ,0,3,1,3,0,1,0,76.14,58.15 ,33.33
03,017,01,002,0036,48,888 ,11 ,899 ,1539 ,0,3,1,3,0,1,0,76.14,58.41 ,33.33
03,017,01,002,0037,49,694 ,9 ,703 ,1204 ,0,3,1,3,0,1,0,76.14,58.39 ,33.33
03,017,01,002,0037,50,559 ,5 ,564 ,1151 ,0,3,1,3,0,1,0,76.14,49.00 ,33.33
03,017,01,002,0038,51,520 ,5 ,525 ,941 ,0,3,1,3,0,1,0,76.14,55.79 ,33.33
03,017,01,002,0038,52,1219 ,7 ,1226 ,2448 ,0,3,1,3,0,1,0,76.14,50.08,33.33
03,017,01,002,0039,53,952 ,7 ,959 ,1836 ,0,3,1,3,0,1,0,76.14,52.23,33.33
03,017,01,002,0040,54,775 ,7 ,782 ,1533 ,0,3,1,3,0,1,0,76.14,51.01 ,33.33
03,017,01,002,0040,55,971 ,3 ,974 ,1811 ,0,3,1,3,0,1,0,76.14,53.78 ,33.33
03,017,01,002,0041,56,725 ,7 ,732 ,1321 ,0,3,1,3,0,1,0,76.14,55.41 ,33.33
03,017,01,002,0041,57,766 ,5 ,771 ,1346 ,0,3,1,3,0,1,0,76.14,57.28 ,33.33
03,017,01,002,0042,58,946 ,5 ,951 ,1949 ,0,3,1,3,0,1,0,76.14,48.79 ,33.33
03,017,01,002,0042,59,1147 ,6 ,1153 ,2030 ,0,3,1,3,0,1,0,76.14,56.80 ,33.33
03,017,01,002,0043,60,848 ,6 ,854 ,1619 ,0,3,1,3,0,1,0,76.14,52.75 ,33.33
03,017,01,002,0043,61,566 ,1 ,567 ,1161 ,0,3,1,3,0,1,0,76.14,48.84 ,33.33
03,017,01,002,0043,62,544 ,3 ,547 ,1119 ,0,3,1,3,0,1,0,76.14,48.88 ,33.33
03,017,01,002,0044,63,615 ,8 ,623 ,1291 ,0,3,1,3,0,1,0,76.14,48.26 ,33.33
03,017,01,002,0044,64,536 ,2 ,538 ,1192 ,0,3,1,3,0,1,0,76.14,45.13 ,33.33
03,017,01,002,0045,65,455 ,8 ,463 ,908 ,0,3,1,3,0,1,0,76.14,50.99 ,33.33
03,017,01,003,0046,66,934 ,12 ,946 ,1726 ,0,3,1,3,0,1,0,76.14,54.81 ,33.33
03,017,01,003,0047,67,544 ,8 ,552 ,947 ,0,3,1,3,0,1,0,76.14,58.29 ,33.33
03,017,01,003,0048,68,869 ,8 ,877 ,1526 ,0,3,1,3,0,1,0,76.14,57.47 ,33.33
03,017,01,003,0049,69,974 ,9 ,983 ,1756 ,0,3,1,3,0,1,0,76.14,55.98,33.33
03,017,01,003,0050,70,676 ,6 ,682 ,1150 ,0,3,1,3,0,1,0,76.14,59.3,33.33
03,017,01,003,0050,71,600 ,6 ,606 ,1082 ,0,3,1,3,0,1,0,76.14,56.01 ,33.33
03,017,01,003,0051,72,580 ,4 ,584 ,1069 ,0,3,1,3,0,1,0,76.14,54.63 ,33.33
03,017,01,003,0052,73,554 ,3 ,557 ,1009 ,0,3,1,3,0,1,0,76.14,55.2,33.33
03,017,01,003,0053,74,602 ,1 ,603 ,1078 ,0,3,1,3,0,1,0,76.14,55.94,33.33
03,017,01,003,0054,75,574 ,3 ,577 ,1006 ,0,3,1,3,0,1,0,76.14,57.36 ,33.33
03,017,01,003,0055,76,655 ,4 ,659 ,1212 ,0,3,1,3,0,1,0,76.14,54.37 ,33.33
03,017,01,003,0055,77,319 ,2 ,321 ,510 ,0,3,1,3,0,1,0,76.14,62.94 ,33.33
03,017,01,003,0056,78,447 ,5 ,452 ,857 ,0,3,1,3,0,1,0,76.14,52.74 ,33.33
03,017,01,003,0057,79,565 ,7 ,572 ,1033 ,0,3,1,3,0,1,0,76.14,55.37 ,33.33
03,017,01,003,0058,80,771 ,4 ,775 ,1438 ,0,3,1,3,0,1,0,76.14,53.89 ,33.33
03,017,01,003,0058,81,671 ,4 ,675 ,1384 ,0,3,1,3,0,1,0,76.14,48.77 ,33.33
03,017,01,003,0059,82,486 ,3 ,489 ,884 ,0,3,1,3,0,1,0,76.14,55.32 ,33.33
03,017,01,003,0060,83,382 ,4 ,386 ,714 ,0,3,1,3,0,1,0,76.14,54.06 ,33.33
03,017,01,003,0060,84,378 ,2 ,380 ,653 ,0,3,1,3,0,1,0,76.14,58.19 ,33.33
03,017,01,003,0061,85,461 ,7 ,468 ,858 ,0,3,1,3,0,1,0,76.14,54.55 ,33.33
03,017,01,003,0062,86,748 ,1 ,749 ,1363 ,0,3,1,3,0,1,0,76.14,54.95 ,33.33
03,017,01,003,0063,87,515 ,3 ,518 ,956 ,0,3,1,3,0,1,0,76.14,54.18 ,33.33
03,017,01,003,0064,88,498 ,4 ,502 ,942 ,0,3,1,3,0,1,0,76.14,53.29 ,33.33
03,017,01,003,0065,89,554 ,3 ,557 ,1032 ,0,3,1,3,0,1,0,76.14,53.97 ,33.33
03,017,01,003,0066,90,431 ,2 ,433 ,771 ,0,3,1,3,0,1,0,76.14,56.16 ,33.33
03,017,01,003,0067,91,622 ,8 ,630 ,1145 ,0,3,1,3,0,1,0,76.14,55.02 ,33.33
03,017,01,003,0068,92,676 ,7 ,683 ,1158 ,0,3,1,3,0,1,0,76.14,58.98 ,33.33
03,017,01,003,0069,93,815 ,5 ,820 ,1283 ,0,3,1,3,0,1,0,76.14,63.91 ,33.33
03,017,01,003,0069,94,825 ,12 ,837 ,1579 ,0,3,1,3,0,1,0,76.14,53.01 ,33.33
03,017,01,003,0070,95,620 ,2 ,622 ,1158 ,0,3,1,3,0,1,0,76.14,53.71 ,33.33
03,017,01,003,0070,96,660 ,5 ,665 ,1122 ,0,3,1,3,0,1,0,76.14,59.27,33.33
03,017,01,003,0071,97,455 ,2 ,457 ,737 ,0,3,1,3,0,1,0,76.14,62.01,33.33
03,017,01,003,0072,98,405 ,4 ,409 ,652 ,0,3,1,3,0,1,0,76.14,62.73 ,33.33
03,017,01,003,0073,99,511 ,2 ,513 ,848 ,0,3,1,3,0,1,0,76.14,60.50 ,33.33
03,017,01,003,0074,100,409 ,5 ,414 ,690 ,0,3,1,3,0,1,0,76.14,60.00 ,33.33
03,017,01,004,0075,101,467 ,5 ,472 ,774 ,0,3,1,3,0,1,0,76.14,60.98 ,33.33
03,017,01,004,0076,102,653 ,8 ,661 ,1113 ,0,3,1,3,0,1,0,76.14,59.39 ,33.33
03,017,01,004,0077,103,573 ,10 ,583 ,982 ,0,3,1,3,0,1,0,76.14,59.37 ,33.33
03,017,01,004,0078,104,600 ,7 ,607 ,1086 ,0,3,1,3,0,1,0,76.14,55.89 ,33.33
03,017,01,004,0079,105,525 ,6 ,531 ,957 ,0,3,1,3,0,1,0,76.14,55.49 ,33.33
03,017,01,004,0080,106,726 ,12 ,738 ,1284 ,0,3,1,3,0,1,0,76.14,57.48,33.33
03,017,01,004,0081,107,461 ,6 ,467 ,828 ,0,3,1,3,0,1,0,76.14,56.4,33.33
03,017,01,004,0082,108,798 ,7 ,805 ,1410 ,0,3,1,3,0,1,0,76.14,57.09,33.33
03,017,01,004,0083,109,636 ,9 ,645 ,1187 ,0,3,1,3,0,1,0,76.14,54.34 ,33.33
03,017,01,004,0084,110,354 ,2 ,356 ,707 ,0,3,1,3,0,1,0,76.14,50.35 ,33.33
03,017,01,004,0084,111,383 ,3 ,386 ,760 ,0,3,1,3,0,1,0,76.14,50.79 ,33.33
03,017,01,004,0085,112,494 ,6 ,500 ,926 ,0,3,1,3,0,1,0,76.14,54.00 ,33.33
03,017,01,004,0085,113,559 ,5 ,564 ,1045 ,0,3,1,3,0,1,0,76.14,53.97 ,33.33
03,017,01,004,0086,114,345 ,3 ,348 ,654 ,0,3,1,3,0,1,0,76.14,53.21 ,33.33
03,017,01,004,0087,115,380 ,3 ,383 ,727 ,0,3,1,3,0,1,0,76.14,52.68,33.33
03,017,01,004,0088,116,515 ,3 ,518 ,943 ,0,3,1,3,0,1,0,76.14,54.93,33.33
03,017,01,004,0089,117,476 ,10 ,486 ,887 ,0,3,1,3,0,1,0,76.14,54.79,33.33
03,017,01,004,0089,118,400 ,2 ,402 ,762 ,0,3,1,3,0,1,0,76.14,52.76 ,33.33
03,017,01,004,0090,119,559 ,5 ,564 ,1128 ,0,3,1,3,0,1,0,76.14,50.00 ,33.33
03,017,01,004,0091,120,905 ,3 ,908 ,1671 ,0,3,1,3,0,1,0,76.14,54.34 ,33.33
03,017,01,004,0091,121,771 ,4 ,775 ,1467 ,0,3,1,3,0,1,0,76.14,52.83 ,33.33
03,017,01,004,0092,122,836 ,10 ,846 ,1454 ,0,3,1,3,0,1,0,76.14,58.18 ,33.33
03,017,01,004,0092,123,931 ,7 ,938 ,1581 ,0,3,1,3,0,1,0,76.14,59.33 ,33.33
03,017,01,004,0092,124,1052 ,10 ,1062 ,1777 ,0,3,1,3,0,1,0,76.14,59.76 ,33.33
03,017,01,004,0093,125,770 ,6 ,776 ,1479 ,0,3,1,3,0,1,0,76.14,52.47 ,33.33
03,017,01,004,0093,126,399 ,2 ,401 ,837 ,0,3,1,3,0,1,0,76.14,47.91 ,33.33
03,017,01,004,0093,127,1028 ,7 ,1035 ,2359 ,0,3,1,3,0,1,0,76.14,43.87 ,33.33
03,017,01,004,0094,128,739 ,8 ,747 ,1898 ,0,3,1,3,0,1,0,76.14,39.36 ,33.33
03,017,01,004,0094,129,759 ,3 ,762 ,1629 ,0,3,1,3,0,1,0,76.14,46.78 ,33.33
03,017,01,004,0094,130,712 ,7 ,719 ,1450 ,0,3,1,3,0,1,0,76.14,49.59 ,33.33
03,017,01,004,0095,131,859 ,16 ,875 ,1632 ,0,3,1,3,0,1,0,76.14,53.62 ,33.33
03,017,01,004,0096,132,538 ,3 ,541 ,993 ,0,3,1,3,0,1,0,76.14,54.48,33.33
03,017,01,004,0097,133,582 ,5 ,587 ,993 ,0,3,1,3,0,1,0,76.14,59.11,33.33
03,017,01,004,0098,134,477 ,2 ,479 ,853 ,0,3,1,3,0,1,0,76.14,56.15 ,33.33
03,017,01,005,0099,135,754 ,10 ,764 ,1453 ,0,3,1,3,0,1,0,76.14,52.58 ,33.33
03,017,01,005,0100,136,713 ,8 ,721 ,1332 ,0,3,1,3,0,1,0,76.14,54.13,33.33
03,017,01,005,0101,137,658 ,3 ,661 ,1233 ,0,3,1,3,0,1,0,76.14,53.61,33.33
03,017,01,005,0102,138,749 ,10 ,759 ,1302 ,0,3,1,3,0,1,0,76.14,58.29 ,33.33
03,017,01,005,0103,139,547 ,5 ,552 ,1025 ,0,3,1,3,0,1,0,76.14,53.85 ,33.33
03,017,01,005,0104,140,828 ,7 ,835 ,1493 ,0,3,1,3,0,1,0,76.14,55.93 ,33.33
03,017,01,005,0104,141,437 ,2 ,439 ,781 ,0,3,1,3,0,1,0,76.14,56.21 ,33.33
03,017,01,005,0105,142,751 ,2 ,753 ,1501 ,0,3,1,3,0,1,0,76.14,50.17 ,33.33
03,017,01,005,0105,143,251 ,2 ,253 ,462 ,0,3,1,3,0,1,0,76.14,54.76 ,33.33
03,017,01,005,0106,144,499 ,2 ,501 ,902 ,0,3,1,3,0,1,0,76.14,55.54,33.33
03,017,01,005,0107,145,355 ,2 ,357 ,637 ,0,3,1,3,0,1,0,76.14,56.04,33.33
03,017,01,005,0108,146,1043 ,10 ,1053 ,1941 ,0,3,1,3,0,1,0,76.14,54.25,33.33
03,017,01,005,0108,147,741 ,7 ,748 ,1368 ,0,3,1,3,0,1,0,76.14,54.68 ,33.33
03,017,01,005,0109,148,816 ,4 ,820 ,1522 ,0,3,1,3,0,1,0,76.14,53.88 ,33.33
03,017,01,005,0109,149,772 ,4 ,776 ,1472 ,0,3,1,3,0,1,0,76.14,52.72 ,33.33
03,017,01,005,0109,150,1102 ,10 ,1112 ,2312 ,0,3,1,3,0,1,0,76.14,48.10 ,33.33
03,017,01,005,0110,151,959 ,6 ,965 ,1645 ,0,3,1,3,0,1,0,76.14,58.66 ,33.33
03,017,01,005,0110,152,800 ,2 ,802 ,1554 ,0,3,1,3,0,1,0,76.14,51.61 ,33.33
03,017,01,005,0110,153,587 ,6 ,593 ,1036 ,0,3,1,3,0,1,0,76.14,57.24 ,33.33
03,017,01,005,0111,154,1052 ,9 ,1061 ,1913 ,0,3,1,3,0,1,0,76.14,55.46 ,33.33
03,017,01,005,0111,155,766 ,6 ,772 ,1516 ,0,3,1,3,0,1,0,76.14,50.92 ,33.33
03,017,01,005,0112,156,912 ,7 ,919 ,1727 ,0,3,1,3,0,1,0,76.14,53.21 ,33.33
03,017,01,005,0112,157,1029 ,5 ,1034 ,1830 ,0,3,1,3,0,1,0,76.14,56.50 ,33.33
03,017,01,005,0113,158,807 ,9 ,816 ,1466 ,0,3,1,3,0,1,0,76.14,55.66 ,33.33
03,017,01,005,0113,159,746 ,3 ,749 ,1388 ,0,3,1,3,0,1,0,76.14,53.96 ,33.33
03,017,01,005,0114,160,1039 ,7 ,1046 ,1900 ,0,3,1,3,0,1,0,76.14,55.05 ,33.33
03,017,01,005,0114,161,392 ,2 ,394 ,748 ,0,3,1,3,0,1,0,76.14,52.67 ,33.33
03,017,01,005,0115,162,736 ,6 ,742 ,1527 ,0,3,1,3,0,1,0,76.14,48.59 ,33.33
03,017,01,005,0115,163,674 ,8 ,682 ,1312 ,0,3,1,3,0,1,0,76.14,51.98 ,33.33
03,017,01,005,0116,164,1258 ,4 ,1262 ,2504 ,0,3,1,3,0,1,0,76.14,50.40 ,33.33
03,017,01,005,0117,165,984 ,9 ,993 ,2224 ,0,3,1,3,0,1,0,76.14,44.65 ,33.33
03,017,01,005,0117,166,561 ,1 ,562 ,1276 ,0,3,1,3,0,1,0,76.14,44.04 ,33.33
03,017,01,005,0118,167,857 ,9 ,866 ,1690 ,0,3,1,3,0,1,0,76.14,51.24 ,33.33
03,017,01,005,0118,168,757 ,9 ,766 ,1611 ,0,3,1,3,0,1,0,76.14,47.55 ,33.33
03,017,01,005,0119,169,998 ,6 ,1004 ,2069 ,0,3,1,3,0,1,0,76.14,48.53 ,33.33
03,017,01,005,0119,170,506 ,2 ,508 ,1036 ,0,3,1,3,0,1,0,76.14,49.03 ,33.33
03,017,01,005,0120,171,518 ,1 ,519 ,1209 ,0,3,1,3,0,1,0,76.14,42.93,33.33
03,017,01,005,0120,172,1139 ,7 ,1146 ,2283 ,0,3,1,3,0,1,0,76.14,50.2,33.33
03,017,01,005,0121,173,653 ,4 ,657 ,1319 ,0,3,1,3,0,1,0,76.14,49.81 ,33.33
03,017,01,005,0122,174,887 ,4 ,891 ,1823 ,0,3,1,3,0,1,0,76.14,48.88 ,33.33
03,017,01,005,0122,175,755 ,4 ,759 ,1699 ,0,3,1,3,0,1,0,76.14,44.67 ,33.33
03,017,01,006,0123,176,735 ,6 ,741 ,1377 ,0,3,1,3,0,1,0,76.14,53.81 ,33.33
03,017,01,006,0124,177,334 ,1 ,335 ,613 ,0,3,1,3,0,1,0,76.14,54.65,33.33
03,017,01,006,0125,178,398 ,3 ,401 ,693 ,0,3,1,3,0,1,0,76.14,57.86,33.33
03,017,01,006,0126,179,297 ,6 ,303 ,613 ,0,3,1,3,0,1,0,76.14,49.43 ,33.33
03,017,01,006,0127,180,840 ,8 ,848 ,1741 ,0,3,1,3,0,1,0,76.14,48.71 ,33.33
03,017,01,006,0127,181,840 ,10 ,850 ,1569 ,0,3,1,3,0,1,0,76.14,54.17 ,33.33
03,017,01,006,0128,182,716 ,7 ,723 ,1296 ,0,3,1,3,0,1,0,76.14,55.79 ,33.33
03,017,01,006,0128,183,474 ,5 ,479 ,933 ,0,3,1,3,0,1,0,76.14,51.34 ,33.33
03,017,01,006,0129,184,525 ,2 ,527 ,948 ,0,3,1,3,0,1,0,76.14,55.59 ,33.33
03,017,01,006,0129,185,649 ,4 ,653 ,1327 ,0,3,1,3,0,1,0,76.14,49.21,33.33
03,017,01,006,0130,186,231 ,3 ,234 ,393 ,0,3,1,3,0,1,0,76.14,59.54,33.33
03,017,01,006,0131,187,1057 ,7 ,1064 ,2108 ,0,3,1,3,0,1,0,76.14,50.47 ,33.33
03,017,01,006,0131,188,800 ,8 ,808 ,1547 ,0,3,1,3,0,1,0,76.14,52.23 ,33.33
03,017,01,006,0132,189,624 ,9 ,633 ,1087 ,0,3,1,3,0,1,0,76.14,58.23 ,33.33
03,017,01,006,0132,190,551 ,3 ,554 ,1150 ,0,3,1,3,0,1,0,76.14,48.17 ,33.33
03,017,01,006,0133,191,476 ,6 ,482 ,716 ,0,3,1,3,0,1,0,76.14,67.32 ,33.33
03,017,01,006,0133,192,737 ,4 ,741 ,1537 ,0,3,1,3,0,1,0,76.14,48.21 ,33.33
03,017,01,006,0134,193,902 ,4 ,906 ,1879 ,0,3,1,3,0,1,0,76.14,48.22 ,33.33
03,017,01,006,0134,194,658 ,3 ,661 ,1508 ,0,3,1,3,0,1,0,76.14,43.83,33.33
03,017,01,006,0135,195,1276 ,11 ,1287 ,2479 ,0,3,1,3,0,1,0,76.14,51.92,33.33
03,017,01,006,0135,196,936 ,7 ,943 ,1897 ,0,3,1,3,0,1,0,76.14,49.71 ,33.33
03,017,01,007,0136,197,786 ,5 ,791 ,1435 ,0,3,1,3,0,1,0,76.14,55.12 ,33.33
03,017,01,007,0136,198,687 ,2 ,689 ,1401 ,0,3,1,3,0,1,0,76.14,49.18 ,33.33
03,017,01,007,0136,199,439 ,8 ,447 ,811 ,0,3,1,3,0,1,0,76.14,55.12 ,33.33
03,017,01,007,0137,200,584 ,11 ,595 ,1117 ,0,3,1,3,0,1,0,76.14,53.27 ,33.33
03,017,01,007,0137,201,652 ,8 ,660 ,1113 ,0,3,1,3,0,1,0,76.14,59.30 ,33.33
03,017,01,007,0138,202,671 ,3 ,674 ,1167 ,0,3,1,3,0,1,0,76.14,57.75 ,33.33
03,017,01,007,0138,203,427 ,8 ,435 ,790 ,0,3,1,3,0,1,0,76.14,55.06 ,33.33
03,017,01,007,0139,204,949 ,4 ,953 ,1748 ,0,3,1,3,0,1,0,76.14,54.52 ,33.33
03,017,01,007,0139,205,1092 ,12 ,1104 ,1878 ,0,3,1,3,0,1,0,76.14,58.79 ,33.33
03,017,01,007,0140,206,550 ,8 ,558 ,950 ,0,3,1,3,0,1,0,76.14,58.74 ,33.33
03,017,01,007,0140,207,599 ,5 ,604 ,1060 ,0,3,1,3,0,1,0,76.14,56.98 ,33.33
03,017,01,007,0141,208,611 ,2 ,613 ,1148 ,0,3,1,3,0,1,0,76.14,53.40 ,33.33
03,017,01,007,0141,209,443 ,3 ,446 ,854 ,0,3,1,3,0,1,0,76.14,52.22 ,33.33
03,017,01,007,0142,210,144 ,1 ,145 ,297 ,0,3,1,3,0,1,0,76.14,48.82 ,33.33
03,017,01,007,0142,211,643 ,4 ,647 ,1241 ,0,3,1,3,0,1,0,76.14,52.14 ,33.33
03,017,01,007,0143,212,467 ,11 ,478 ,926 ,0,3,1,3,0,1,0,76.14,51.62 ,33.33
03,017,01,007,0144,213,388 ,3 ,391 ,784 ,0,3,1,3,0,1,0,76.14,49.87 ,33.33
03,017,01,007,0144,214,704 ,6 ,710 ,1488 ,0,3,1,3,0,1,0,76.14,47.72 ,33.33
03,017,01,007,0144,215,467 ,5 ,472 ,938 ,0,3,1,3,0,1,0,76.14,50.32,33.33
03,017,01,007,0145,216,698 ,9 ,707 ,1415 ,0,3,1,3,0,1,0,76.14,49.96,33.33
03,017,01,007,0146,217,693 ,5 ,698 ,1483 ,0,3,1,3,0,1,0,76.14,47.07 ,33.33
03,017,01,007,0146,218,786 ,7 ,793 ,1776 ,0,3,1,3,0,1,0,76.14,44.65 ,33.33
03,017,01,007,0147,219,660 ,7 ,667 ,1383 ,0,3,1,3,0,1,0,76.14,48.23,33.33
03,017,01,007,0147,220,858 ,6 ,864 ,1663 ,0,3,1,3,0,1,0,76.14,51.95,33.33
03,017,01,007,0148,221,616 ,4 ,620 ,1305 ,0,3,1,3,0,1,0,76.14,47.51 ,33.33
03,017,01,007,0148,222,754 ,4 ,758 ,1614 ,0,3,1,3,0,1,0,76.14,46.96 ,33.33
03,017,01,007,0148,223,705 ,2 ,707 ,1566 ,0,3,1,3,0,1,0,76.14,45.15 ,33.33
03,017,01,007,0149,224,554 ,7 ,561 ,1189 ,0,3,1,3,0,1,0,76.14,47.18 ,33.33
03,017,01,007,0149,225,436 ,0 ,436 ,934 ,0,3,1,3,0,1,0,76.14,46.68 ,33.33
03,017,01,007,0149,226,554 ,4 ,558 ,1228 ,0,3,1,3,0,1,0,76.14,45.44 ,33.33
03,017,01,007,0150,227,243 ,1 ,244 ,451 ,0,3,1,3,0,1,0,76.14,54.10 ,33.33
03,017,01,007,0151,228,182 ,0 ,182 ,300 ,0,3,1,3,0,1,0,76.14,60.67 ,33.33
03,017,01,007,0152,229,201 ,4 ,205 ,350 ,0,3,1,3,0,1,0,76.14,58.57 ,33.33
03,017,01,007,0153,230,739 ,3 ,742 ,1409 ,0,3,1,3,0,1,0,76.14,52.66,33.33
03,017,01,007,0154,231,256 ,1 ,257 ,438 ,0,3,1,3,0,1,0,76.14,58.68,33.33
03,018,01,001,0001,1,512 ,5 ,517 ,1232 ,0,3,1,3,0,1,0,76.14,41.96 ,33.33
03,018,01,001,0002,2,499 ,0 ,499 ,931 ,0,3,1,3,0,1,0,76.14,53.60 ,33.33
03,018,01,001,0002,3,439 ,3 ,442 ,804 ,0,3,1,3,0,1,0,76.14,54.98 ,33.33
03,018,01,001,0003,4,411 ,3 ,414 ,708 ,0,3,1,3,0,1,0,76.14,58.47 ,33.33
03,018,01,001,0004,5,411 ,2 ,413 ,757 ,0,3,1,3,0,1,0,76.14,54.56 ,33.33
03,018,01,001,0005,6,228 ,2 ,230 ,442 ,0,3,1,3,0,1,0,76.14,52.04 ,33.33
03,018,01,001,0006,7,282 ,2 ,284 ,481 ,0,3,1,3,0,1,0,76.14,59.04 ,33.33
03,018,01,001,0007,8,542 ,2 ,544 ,987 ,0,3,1,3,0,1,0,76.14,55.12 ,33.33
03,018,01,001,0007,9,450 ,4 ,454 ,748 ,0,3,1,3,0,1,0,76.14,60.70 ,33.33
03,018,01,001,0008,10,658 ,4 ,662 ,1168 ,0,3,1,3,0,1,0,76.14,56.68 ,33.33
03,018,01,001,0008,11,576 ,4 ,580 ,957 ,0,3,1,3,0,1,0,76.14,60.61 ,33.33
03,018,01,001,0008,12,755 ,3 ,758 ,1405 ,0,3,1,3,0,1,0,76.14,53.95 ,33.33
03,018,01,001,0009,13,700 ,7 ,707 ,1273 ,0,3,1,3,0,1,0,76.14,55.54 ,33.33
03,018,01,001,0009,14,688 ,9 ,697 ,1266 ,0,3,1,3,0,1,0,76.14,55.06 ,33.33
03,018,01,001,0009,15,686 ,8 ,694 ,1298 ,0,3,1,3,0,1,0,76.14,53.47 ,33.33
03,018,01,001,0010,16,622 ,3 ,625 ,1145 ,0,3,1,3,0,1,0,76.14,54.59 ,33.33
03,018,01,001,0010,17,668 ,1 ,669 ,1240 ,0,3,1,3,0,1,0,76.14,53.95 ,33.33
03,018,01,001,0010,18,667 ,2 ,669 ,1239 ,0,3,1,3,0,1,0,76.14,54.00 ,33.33
03,018,01,001,0011,19,731 ,5 ,736 ,1290 ,0,3,1,3,0,1,0,76.14,57.05 ,33.33
03,018,01,001,0011,20,802 ,3 ,805 ,1392 ,0,3,1,3,0,1,0,76.14,57.83,33.33
03,018,01,001,0011,21,676 ,3 ,679 ,1226 ,0,3,1,3,0,1,0,76.14,55.38,33.33
03,018,01,001,0012,22,535 ,4 ,539 ,984 ,0,3,1,3,0,1,0,76.14,54.78 ,33.33
03,018,01,001,0012,23,912 ,10 ,922 ,1613 ,0,3,1,3,0,1,0,76.14,57.16 ,33.33
03,018,01,001,0013,24,490 ,3 ,493 ,938 ,0,3,1,3,0,1,0,76.14,52.56 ,33.33
03,018,01,001,0013,25,771 ,5 ,776 ,1306 ,0,3,1,3,0,1,0,76.14,59.42 ,33.33
03,018,01,001,0014,26,660 ,2 ,662 ,1184 ,0,3,1,3,0,1,0,76.14,55.91 ,33.33
03,018,01,001,0014,27,523 ,2 ,525 ,944 ,0,3,1,3,0,1,0,76.14,55.61 ,33.33
03,018,01,001,0015,28,496 ,7 ,503 ,899 ,0,3,1,3,0,1,0,76.14,55.95 ,33.33
03,018,01,001,0015,29,611 ,5 ,616 ,994 ,0,3,1,3,0,1,0,76.14,61.97 ,33.33
03,018,01,001,0015,30,554 ,5 ,559 ,987 ,0,3,1,3,0,1,0,76.14,56.64 ,33.33
03,018,01,001,0016,31,688 ,5 ,693 ,1206 ,0,3,1,3,0,1,0,76.14,57.46 ,33.33
03,018,01,001,0016,32,903 ,3 ,906 ,1659 ,0,3,1,3,0,1,0,76.14,54.61 ,33.33
03,018,01,001,0016,33,824 ,5 ,829 ,1421 ,0,3,1,3,0,1,0,76.14,58.34,33.33
03,018,01,001,0017,34,571 ,4 ,575 ,1059 ,0,3,1,3,0,1,0,76.14,54.3,33.33
03,018,01,001,0018,35,502 ,0 ,502 ,871 ,0,3,1,3,0,1,0,76.14,57.63 ,33.33
03,018,01,001,0018,36,511 ,2 ,513 ,975 ,0,3,1,3,0,1,0,76.14,52.62 ,33.33
03,018,01,001,0019,37,781 ,8 ,789 ,1520 ,0,3,1,3,0,1,0,76.14,51.91 ,33.33
03,018,01,001,0019,38,501 ,7 ,508 ,952 ,0,3,1,3,0,1,0,76.14,53.36 ,33.33
03,018,01,001,0020,39,786 ,22 ,808 ,1488 ,0,3,1,3,0,1,0,76.14,54.30 ,33.33
03,018,01,001,0020,40,893 ,2 ,895 ,1570 ,0,3,1,3,0,1,0,76.14,57.01,33.33
03,018,01,001,0021,41,503 ,10 ,513 ,855 ,0,3,1,3,0,1,0,76.14,60,33.33
03,018,01,001,0021,42,536 ,4 ,540 ,904 ,0,3,1,3,0,1,0,76.14,59.73,33.33
03,018,01,001,0022,43,777 ,4 ,781 ,1332 ,0,3,1,3,0,1,0,76.14,58.63 ,33.33
03,018,01,001,0022,44,663 ,5 ,668 ,1181 ,0,3,1,3,0,1,0,76.14,56.56 ,33.33
03,018,01,001,0023,45,893 ,4 ,897 ,1411 ,0,3,1,3,0,1,0,76.14,63.57 ,33.33
03,018,01,001,0023,46,782 ,0 ,782 ,1192 ,0,3,1,3,0,1,0,76.14,65.60 ,33.33
03,018,01,001,0023,47,570 ,2 ,572 ,903 ,0,3,1,3,0,1,0,76.14,63.34 ,33.33
03,018,01,001,0024,48,647 ,5 ,652 ,1075 ,0,3,1,3,0,1,0,76.14,60.65 ,33.33
03,018,01,001,0024,49,653 ,5 ,658 ,1132 ,0,3,1,3,0,1,0,76.14,58.13 ,33.33
03,018,01,001,0024,50,633 ,2 ,635 ,1062 ,0,3,1,3,0,1,0,76.14,59.79 ,33.33
03,018,01,001,0025,51,499 ,5 ,504 ,852 ,0,3,1,3,0,1,0,76.14,59.15 ,33.33
03,018,01,001,0026,52,365 ,7 ,372 ,658 ,0,3,1,3,0,1,0,76.14,56.53,33.33
03,018,01,001,0026,53,551 ,1 ,552 ,850 ,0,3,1,3,0,1,0,76.14,64.94,33.33
03,018,01,001,0026,54,466 ,3 ,469 ,676 ,0,3,1,3,0,1,0,76.14,69.38 ,33.33
03,018,01,001,0027,55,702 ,2 ,704 ,1188 ,0,3,1,3,0,1,0,76.14,59.26 ,33.33
03,018,01,001,0027,56,335 ,2 ,337 ,525 ,0,3,1,3,0,1,0,76.14,64.19 ,33.33
03,018,01,001,0027,57,791 ,5 ,796 ,1497 ,0,3,1,3,0,1,0,76.14,53.17 ,33.33
03,018,01,001,0028,58,546 ,5 ,551 ,992 ,0,3,1,3,0,1,0,76.14,55.54 ,33.33
03,018,01,001,0028,59,339 ,1 ,340 ,712 ,0,3,1,3,0,1,0,76.14,47.75 ,33.33
03,018,01,001,0028,60,627 ,4 ,631 ,1064 ,0,3,1,3,0,1,0,76.14,59.30 ,33.33
03,018,01,001,0029,61,665 ,5 ,670 ,1183 ,0,3,1,3,0,1,0,76.14,56.64 ,33.33
03,018,01,001,0029,62,711 ,3 ,714 ,1222 ,0,3,1,3,0,1,0,76.14,58.43 ,33.33
03,018,01,001,0029,63,852 ,5 ,857 ,1347 ,0,3,1,3,0,1,0,76.14,63.62 ,33.33
03,018,01,001,0029,64,785 ,3 ,788 ,1357 ,0,3,1,3,0,1,0,76.14,58.07 ,33.33
03,018,01,001,0030,65,678 ,10 ,688 ,1203 ,0,3,1,3,0,1,0,76.14,57.19 ,33.33
03,018,01,001,0030,66,593 ,1 ,594 ,1061 ,0,3,1,3,0,1,0,76.14,55.98 ,33.33
03,018,01,001,0031,67,763 ,7 ,770 ,1415 ,0,3,1,3,0,1,0,76.14,54.42 ,33.33
03,018,01,001,0031,68,728 ,8 ,736 ,1391 ,0,3,1,3,0,1,0,76.14,52.91 ,33.33
03,018,01,001,0031,69,659 ,4 ,663 ,1140 ,0,3,1,3,0,1,0,76.14,58.16,33.33
03,018,01,001,0032,70,588 ,2 ,590 ,1075 ,0,3,1,3,0,1,0,76.14,54.88,33.33
03,018,01,001,0032,71,614 ,7 ,621 ,1171 ,0,3,1,3,0,1,0,76.14,53.03 ,33.33
03,018,01,001,0032,72,759 ,7 ,766 ,1377 ,0,3,1,3,0,1,0,76.14,55.63 ,33.33
03,018,01,001,0033,73,744 ,2 ,746 ,1508 ,0,3,1,3,0,1,0,76.14,49.47,33.33
03,018,01,001,0033,74,866 ,7 ,873 ,1489 ,0,3,1,3,0,1,0,76.14,58.63,33.33
03,018,01,001,0033,75,696 ,2 ,698 ,1348 ,0,3,1,3,0,1,0,76.14,51.78 ,33.33
03,018,01,001,0034,76,940 ,4 ,944 ,1693 ,0,3,1,3,0,1,0,76.14,55.76 ,33.33
03,018,01,001,0034,77,919 ,4 ,923 ,1656 ,0,3,1,3,0,1,0,76.14,55.74 ,33.33
03,018,01,001,0035,78,537 ,0 ,537 ,874 ,0,3,1,3,0,1,0,76.14,61.44 ,33.33
03,018,01,001,0036,79,318 ,1 ,319 ,591 ,0,3,1,3,0,1,0,76.14,53.98 ,33.33
03,018,01,001,0037,80,391 ,3 ,394 ,688 ,0,3,1,3,0,1,0,76.14,57.27 ,33.33
03,018,01,001,0038,81,510 ,3 ,513 ,887 ,0,3,1,3,0,1,0,76.14,57.84 ,33.33
03,018,01,001,0039,82,711 ,8 ,719 ,1300 ,0,3,1,3,0,1,0,76.14,55.31 ,33.33
03,018,01,001,0040,83,644 ,5 ,649 ,1226 ,0,3,1,3,0,1,0,76.14,52.94 ,33.33
03,018,01,001,0040,84,579 ,2 ,581 ,1055 ,0,3,1,3,0,1,0,76.14,55.07 ,33.33
03,018,01,001,0040,85,582 ,7 ,589 ,1109 ,0,3,1,3,0,1,0,76.14,53.11 ,33.33
03,018,01,001,0040,86,510 ,0 ,510 ,1101 ,0,3,1,3,0,1,0,76.14,46.32 ,33.33
03,018,01,001,0041,87,555 ,5 ,560 ,971 ,0,3,1,3,0,1,0,76.14,57.67 ,33.33
03,018,01,001,0041,88,615 ,7 ,622 ,1106 ,0,3,1,3,0,1,0,76.14,56.24 ,33.33
03,018,01,001,0041,89,548 ,2 ,550 ,1006 ,0,3,1,3,0,1,0,76.14,54.67 ,33.33
03,018,01,001,0042,90,459 ,1 ,460 ,858 ,0,3,1,3,0,1,0,76.14,53.61 ,33.33
03,018,01,001,0043,91,476 ,3 ,479 ,813 ,0,3,1,3,0,1,0,76.14,58.92 ,33.33
03,018,01,001,0044,92,389 ,5 ,394 ,712 ,0,3,1,3,0,1,0,76.14,55.34 ,33.33
03,018,01,001,0045,93,499 ,3 ,502 ,957 ,0,3,1,3,0,1,0,76.14,52.46 ,33.33
03,018,01,001,0045,94,561 ,3 ,564 ,979 ,0,3,1,3,0,1,0,76.14,57.61 ,33.33
03,018,01,001,0045,95,568 ,1 ,569 ,1040 ,0,3,1,3,0,1,0,76.14,54.71 ,33.33
03,018,01,001,0046,96,346 ,1 ,347 ,652 ,0,3,1,3,0,1,0,76.14,53.22,33.33
03,018,01,001,0046,97,467 ,4 ,471 ,844 ,0,3,1,3,0,1,0,76.14,55.81,33.33
03,018,01,001,0047,98,440 ,5 ,445 ,816 ,0,3,1,3,0,1,0,76.14,54.53 ,33.33
03,018,01,001,0047,99,663 ,5 ,668 ,1263 ,0,3,1,3,0,1,0,76.14,52.89 ,33.33
03,018,01,001,0047,100,619 ,1 ,620 ,1170 ,0,3,1,3,0,1,0,76.14,52.99 ,33.33
03,018,01,001,0048,101,696 ,6 ,702 ,1475 ,0,3,1,3,0,1,0,76.14,47.59 ,33.33
03,018,01,001,0048,102,861 ,5 ,866 ,1543 ,0,3,1,3,0,1,0,76.14,56.12 ,33.33
03,018,01,001,0049,103,745 ,7 ,752 ,1321 ,0,3,1,3,0,1,0,76.14,56.93 ,33.33
03,018,01,001,0049,104,588 ,5 ,593 ,1211 ,0,3,1,3,0,1,0,76.14,48.97 ,33.33
03,018,01,001,0049,105,665 ,2 ,667 ,1270 ,0,3,1,3,0,1,0,76.14,52.52 ,33.33
03,018,01,001,0049,106,599 ,6 ,605 ,1199 ,0,3,1,3,0,1,0,76.14,50.46,33.33
03,018,01,001,0050,107,897 ,6 ,903 ,1735 ,0,3,1,3,0,1,0,76.14,52.05,33.33
03,018,01,001,0050,108,621 ,10 ,631 ,1191 ,0,3,1,3,0,1,0,76.14,52.98,33.33
03,018,01,001,0051,109,603 ,2 ,605 ,1185 ,0,3,1,3,0,1,0,76.14,51.05 ,33.33
03,018,01,001,0051,110,635 ,3 ,638 ,1165 ,0,3,1,3,0,1,0,76.14,54.76 ,33.33
03,018,01,001,0051,111,623 ,2 ,625 ,1122 ,0,3,1,3,0,1,0,76.14,55.70 ,33.33
03,018,01,001,0052,112,475 ,2 ,477 ,1057 ,0,3,1,3,0,1,0,76.14,45.13 ,33.33
03,018,01,001,0052,113,571 ,2 ,573 ,1067 ,0,3,1,3,0,1,0,76.14,53.70 ,33.33
03,018,01,001,0052,114,424 ,2 ,426 ,1101 ,0,3,1,3,0,1,0,76.14,38.69 ,33.33
03,018,01,002,0053,115,273 ,5 ,278 ,521 ,0,3,1,3,0,1,0,76.14,53.36,33.33
03,018,01,002,0054,116,469 ,5 ,474 ,793 ,0,3,1,3,0,1,0,76.14,59.77,33.33
03,018,01,002,0055,117,335 ,3 ,338 ,528 ,0,3,1,3,0,1,0,76.14,64.02,33.33
03,018,01,002,0056,118,293 ,2 ,295 ,538 ,0,3,1,3,0,1,0,76.14,54.83 ,33.33
03,018,01,002,0057,119,413 ,5 ,418 ,743 ,0,3,1,3,0,1,0,76.14,56.26 ,33.33
03,018,01,002,0058,120,699 ,6 ,705 ,1168 ,0,3,1,3,0,1,0,76.14,60.36 ,33.33
03,018,01,002,0059,121,685 ,4 ,689 ,1236 ,0,3,1,3,0,1,0,76.14,55.74 ,33.33
03,018,01,002,0060,122,601 ,2 ,603 ,1123 ,0,3,1,3,0,1,0,76.14,53.70 ,33.33
03,018,01,002,0060,123,569 ,3 ,572 ,1034 ,0,3,1,3,0,1,0,76.14,55.32 ,33.33
03,018,01,002,0060,124,636 ,4 ,640 ,1246 ,0,3,1,3,0,1,0,76.14,51.36 ,33.33
03,018,01,002,0061,125,640 ,6 ,646 ,1291 ,0,3,1,3,0,1,0,76.14,50.04 ,33.33
03,018,01,002,0062,126,420 ,3 ,423 ,797 ,0,3,1,3,0,1,0,76.14,53.07 ,33.33
03,018,01,002,0062,127,471 ,4 ,475 ,907 ,0,3,1,3,0,1,0,76.14,52.37 ,33.33
03,018,01,002,0062,128,510 ,7 ,517 ,1037 ,0,3,1,3,0,1,0,76.14,49.86 ,33.33
03,018,01,002,0062,129,358 ,8 ,366 ,556 ,0,3,1,3,0,1,0,76.14,65.83 ,33.33
03,018,01,002,0062,130,778 ,2 ,780 ,1401 ,0,3,1,3,0,1,0,76.14,55.67 ,33.33
03,018,01,002,0063,131,711 ,5 ,716 ,1317 ,0,3,1,3,0,1,0,76.14,54.37 ,33.33
03,018,01,002,0063,132,684 ,5 ,689 ,1194 ,0,3,1,3,0,1,0,76.14,57.71,33.33
03,018,01,002,0064,133,387 ,2 ,389 ,809 ,0,3,1,3,0,1,0,76.14,48.08,33.33
03,018,01,002,0064,134,575 ,4 ,579 ,928 ,0,3,1,3,0,1,0,76.14,62.39 ,33.33
03,018,01,002,0064,135,537 ,10 ,547 ,1003 ,0,3,1,3,0,1,0,76.14,54.54 ,33.33
03,018,01,002,0065,136,529 ,3 ,532 ,960 ,0,3,1,3,0,1,0,76.14,55.42,33.33
03,018,01,002,0065,137,750 ,3 ,753 ,1396 ,0,3,1,3,0,1,0,76.14,53.94,33.33
03,018,01,002,0065,138,600 ,19 ,619 ,1066 ,0,3,1,3,0,1,0,76.14,58.07 ,33.33
03,018,01,002,0066,139,532 ,6 ,538 ,826 ,0,3,1,3,0,1,0,76.14,65.13 ,33.33
03,018,01,002,0066,140,435 ,5 ,440 ,645 ,0,3,1,3,0,1,0,76.14,68.22 ,33.33
03,018,01,002,0067,141,390 ,6 ,396 ,712 ,0,3,1,3,0,1,0,76.14,55.62 ,33.33
03,018,01,002,0068,142,391 ,2 ,393 ,656 ,0,3,1,3,0,1,0,76.14,59.91 ,33.33
03,018,01,002,0069,143,334 ,3 ,337 ,582 ,0,3,1,3,0,1,0,76.14,57.90 ,33.33
03,018,01,002,0070,144,710 ,12 ,722 ,1275 ,0,3,1,3,0,1,0,76.14,56.63,33.33
03,018,01,002,0071,145,644 ,3 ,647 ,1157 ,0,3,1,3,0,1,0,76.14,55.92,33.33
03,018,01,002,0072,146,521 ,3 ,524 ,906 ,0,3,1,3,0,1,0,76.14,57.84,33.33
03,018,01,002,0073,147,659 ,8 ,667 ,1231 ,0,3,1,3,0,1,0,76.14,54.18 ,33.33
03,018,01,002,0073,148,705 ,3 ,708 ,1423 ,0,3,1,3,0,1,0,76.14,49.75 ,33.33
03,018,01,002,0073,149,622 ,8 ,630 ,1361 ,0,3,1,3,0,1,0,76.14,46.29 ,33.33
03,018,01,002,0074,150,671 ,3 ,674 ,1332 ,0,3,1,3,0,1,0,76.14,50.60 ,33.33
03,018,01,002,0074,151,795 ,4 ,799 ,1559 ,0,3,1,3,0,1,0,76.14,51.25 ,33.33
03,018,01,002,0074,152,658 ,4 ,662 ,1217 ,0,3,1,3,0,1,0,76.14,54.40 ,33.33
03,018,01,002,0075,153,600 ,4 ,604 ,1254 ,0,3,1,3,0,1,0,76.14,48.17 ,33.33
03,018,01,002,0075,154,682 ,5 ,687 ,1247 ,0,3,1,3,0,1,0,76.14,55.09 ,33.33
03,018,01,002,0075,155,604 ,4 ,608 ,1140 ,0,3,1,3,0,1,0,76.14,53.33 ,33.33
03,018,01,002,0076,156,604 ,4 ,608 ,1114 ,0,3,1,3,0,1,0,76.14,54.58 ,33.33
03,018,01,002,0076,157,544 ,9 ,553 ,1021 ,0,3,1,3,0,1,0,76.14,54.16 ,33.33
03,018,01,002,0076,158,596 ,3 ,599 ,1028 ,0,3,1,3,0,1,0,76.14,58.27 ,33.33
03,018,01,002,0077,159,669 ,3 ,672 ,1227 ,0,3,1,3,0,1,0,76.14,54.77 ,33.33
03,018,01,002,0077,160,843 ,3 ,846 ,1446 ,0,3,1,3,0,1,0,76.14,58.51 ,33.33
03,018,01,002,0078,161,507 ,3 ,510 ,907 ,0,3,1,3,0,1,0,76.14,56.23 ,33.33
03,018,01,002,0078,162,632 ,3 ,635 ,1107 ,0,3,1,3,0,1,0,76.14,57.36 ,33.33
03,018,01,002,0079,163,625 ,3 ,628 ,1549 ,0,3,1,3,0,1,0,76.14,40.54 ,33.33
03,018,01,002,0079,164,782 ,4 ,786 ,1540 ,0,3,1,3,0,1,0,76.14,51.04 ,33.33
03,018,01,002,0080,165,672 ,3 ,675 ,1266 ,0,3,1,3,0,1,0,76.14,53.32 ,33.33
03,018,01,002,0080,166,620 ,4 ,624 ,1245 ,0,3,1,3,0,1,0,76.14,50.12 ,33.33
03,018,01,002,0080,167,606 ,5 ,611 ,1207 ,0,3,1,3,0,1,0,76.14,50.62 ,33.33
03,018,01,002,0081,168,564 ,3 ,567 ,1133 ,0,3,1,3,0,1,0,76.14,50.04 ,33.33
03,018,01,002,0081,169,759 ,6 ,765 ,1425 ,0,3,1,3,0,1,0,76.14,53.68 ,33.33
03,018,01,002,0082,170,780 ,6 ,786 ,1356 ,0,3,1,3,0,1,0,76.14,57.96 ,33.33
03,018,01,002,0083,171,837 ,13 ,850 ,1567 ,0,3,1,3,0,1,0,76.14,54.24,33.33
03,018,01,002,0083,172,780 ,2 ,782 ,1536 ,0,3,1,3,0,1,0,76.14,50.91,33.33
03,018,01,002,0083,173,726 ,5 ,731 ,1456 ,0,3,1,3,0,1,0,76.14,50.21 ,33.33
03,018,01,002,0084,174,627 ,2 ,629 ,1221 ,0,3,1,3,0,1,0,76.14,51.52 ,33.33
03,018,01,002,0084,175,581 ,0 ,581 ,1187 ,0,3,1,3,0,1,0,76.14,48.95 ,33.33
03,018,01,002,0084,176,671 ,3 ,674 ,1289 ,0,3,1,3,0,1,0,76.14,52.29 ,33.33
03,018,01,002,0084,177,542 ,6 ,548 ,1041 ,0,3,1,3,0,1,0,76.14,52.64,33.33
03,018,01,002,0085,178,745 ,3 ,748 ,1492 ,0,3,1,3,0,1,0,76.14,50.13,33.33
03,018,01,002,0085,179,773 ,4 ,777 ,1463 ,0,3,1,3,0,1,0,76.14,53.11 ,33.33
03,018,01,002,0085,180,654 ,6 ,660 ,1325 ,0,3,1,3,0,1,0,76.14,49.81 ,33.33
03,018,01,002,0086,181,635 ,2 ,637 ,1021 ,0,3,1,3,0,1,0,76.14,62.39 ,33.33
03,018,01,002,0086,182,619 ,2 ,621 ,944 ,0,3,1,3,0,1,0,76.14,65.78 ,33.33
03,018,01,002,0087,183,727 ,3 ,730 ,1259 ,0,3,1,3,0,1,0,76.14,57.98 ,33.33
03,018,01,002,0087,184,962 ,8 ,970 ,1654 ,0,3,1,3,0,1,0,76.14,58.65 ,33.33
03,018,01,002,0088,185,710 ,2 ,712 ,1316 ,0,3,1,3,0,1,0,76.14,54.1,33.33
03,018,01,002,0088,186,615 ,5 ,620 ,1128 ,0,3,1,3,0,1,0,76.14,54.96,33.33
03,018,01,002,0088,187,699 ,8 ,707 ,1312 ,0,3,1,3,0,1,0,76.14,53.89 ,33.33
03,018,01,002,0089,188,753 ,7 ,760 ,1256 ,0,3,1,3,0,1,0,76.14,60.51 ,33.33
03,018,01,002,0089,189,483 ,1 ,484 ,724 ,0,3,1,3,0,1,0,76.14,66.85 ,33.33
03,018,01,002,0089,190,526 ,3 ,529 ,850 ,0,3,1,3,0,1,0,76.14,62.24 ,33.33
03,018,01,002,0090,191,429 ,5 ,434 ,875 ,0,3,1,3,0,1,0,76.14,49.60 ,33.33
03,018,01,002,0091,192,562 ,3 ,565 ,1066 ,0,3,1,3,0,1,0,76.14,53.00 ,33.33
03,018,01,002,0091,193,544 ,3 ,547 ,1112 ,0,3,1,3,0,1,0,76.14,49.19 ,33.33
03,018,01,002,0091,194,837 ,6 ,843 ,1641 ,0,3,1,3,0,1,0,76.14,51.37,33.33
03,018,01,002,0092,195,515 ,3 ,518 ,944 ,0,3,1,3,0,1,0,76.14,54.87,33.33
03,018,01,002,0092,196,437 ,4 ,441 ,821 ,0,3,1,3,0,1,0,76.14,53.71 ,33.33
03,018,01,002,0093,197,809 ,6 ,815 ,1542 ,0,3,1,3,0,1,0,76.14,52.85 ,33.33
03,018,01,002,0094,198,459 ,4 ,463 ,800 ,0,3,1,3,0,1,0,76.14,57.88 ,33.33
03,018,01,002,0094,199,462 ,2 ,464 ,1038 ,0,3,1,3,0,1,0,76.14,44.70 ,33.33
03,018,01,002,0095,200,676 ,3 ,679 ,1191 ,0,3,1,3,0,1,0,76.14,57.01 ,33.33
03,018,01,002,0096,201,322 ,4 ,326 ,554 ,0,3,1,3,0,1,0,76.14,58.84 ,33.33
03,018,01,003,0097,202,653 ,2 ,655 ,1264 ,0,3,1,3,0,1,0,76.14,51.82 ,33.33
03,018,01,003,0097,203,625 ,5 ,630 ,1378 ,0,3,1,3,0,1,0,76.14,45.72 ,33.33
03,018,01,003,0098,204,670 ,3 ,673 ,1307 ,0,3,1,3,0,1,0,76.14,51.49 ,33.33
03,018,01,003,0098,205,747 ,7 ,754 ,1478 ,0,3,1,3,0,1,0,76.14,51.01 ,33.33
03,018,01,003,0099,206,675 ,6 ,681 ,1275 ,0,3,1,3,0,1,0,76.14,53.41 ,33.33
03,018,01,003,0099,207,585 ,1 ,586 ,1142 ,0,3,1,3,0,1,0,76.14,51.31 ,33.33
03,018,01,003,0100,208,640 ,2 ,642 ,1143 ,0,3,1,3,0,1,0,76.14,56.17 ,33.33
03,018,01,003,0100,209,597 ,6 ,603 ,1331 ,0,3,1,3,0,1,0,76.14,45.30 ,33.33
03,018,01,003,0101,210,704 ,6 ,710 ,1343 ,0,3,1,3,0,1,0,76.14,52.87 ,33.33
03,018,01,003,0101,211,681 ,3 ,684 ,1163 ,0,3,1,3,0,1,0,76.14,58.81 ,33.33
03,018,01,003,0102,212,526 ,9 ,535 ,1026 ,0,3,1,3,0,1,0,76.14,52.14 ,33.33
03,018,01,003,0102,213,440 ,5 ,445 ,851 ,0,3,1,3,0,1,0,76.14,52.29 ,33.33
03,018,01,003,0103,214,874 ,6 ,880 ,1603 ,0,3,1,3,0,1,0,76.14,54.90 ,33.33
03,018,01,003,0104,215,568 ,5 ,573 ,998 ,0,3,1,3,0,1,0,76.14,57.41,33.33
03,018,01,003,0104,216,580 ,3 ,583 ,993 ,0,3,1,3,0,1,0,76.14,58.71,33.33
03,018,01,003,0105,217,668 ,16 ,684 ,1324 ,0,3,1,3,0,1,0,76.14,51.66 ,33.33
03,018,01,003,0105,218,676 ,8 ,684 ,1464 ,0,3,1,3,0,1,0,76.14,46.72 ,33.33
03,018,01,003,0105,219,465 ,4 ,469 ,882 ,0,3,1,3,0,1,0,76.14,53.17,33.33
03,018,01,003,0105,220,571 ,4 ,575 ,1096 ,0,3,1,3,0,1,0,76.14,52.46,33.33
03,018,01,003,0106,221,536 ,4 ,540 ,1000 ,0,3,1,3,0,1,0,76.14,54.00 ,33.33
03,018,01,003,0106,222,473 ,4 ,477 ,903 ,0,3,1,3,0,1,0,76.14,52.82 ,33.33
03,018,01,003,0107,223,338 ,0 ,338 ,668 ,0,3,1,3,0,1,0,76.14,50.60 ,33.33
03,018,01,003,0107,224,940 ,5 ,945 ,1754 ,0,3,1,3,0,1,0,76.14,53.88 ,33.33
03,018,01,003,0108,225,517 ,8 ,525 ,1010 ,0,3,1,3,0,1,0,76.14,51.98 ,33.33
03,018,01,003,0108,226,519 ,1 ,520 ,1049 ,0,3,1,3,0,1,0,76.14,49.57 ,33.33
03,018,01,003,0109,227,748 ,5 ,753 ,1447 ,0,3,1,3,0,1,0,76.14,52.04 ,33.33
03,018,01,003,0109,228,615 ,4 ,619 ,1352 ,0,3,1,3,0,1,0,76.14,45.78 ,33.33
03,018,01,003,0110,229,567 ,3 ,570 ,1005 ,0,3,1,3,0,1,0,76.14,56.72 ,33.33
03,018,01,003,0110,230,536 ,2 ,538 ,1048 ,0,3,1,3,0,1,0,76.14,51.34,33.33
03,018,01,003,0111,231,512 ,5 ,517 ,980 ,0,3,1,3,0,1,0,76.14,52.76,33.33
03,018,01,003,0112,232,419 ,0 ,419 ,785 ,0,3,1,3,0,1,0,76.14,53.38 ,33.33
03,018,01,003,0112,233,480 ,4 ,484 ,923 ,0,3,1,3,0,1,0,76.14,52.44 ,33.33
03,018,01,003,0113,234,548 ,7 ,555 ,1007 ,0,3,1,3,0,1,0,76.14,55.11 ,33.33
03,018,01,003,0113,235,407 ,2 ,409 ,880 ,0,3,1,3,0,1,0,76.14,46.48 ,33.33
03,018,01,003,0114,236,645 ,8 ,653 ,1178 ,0,3,1,3,0,1,0,76.14,55.43 ,33.33
03,018,01,003,0115,237,587 ,2 ,589 ,1193 ,0,3,1,3,0,1,0,76.14,49.37 ,33.33
03,018,01,003,0115,238,525 ,8 ,533 ,1091 ,0,3,1,3,0,1,0,76.14,48.85 ,33.33
03,018,01,003,0115,239,572 ,6 ,578 ,1217 ,0,3,1,3,0,1,0,76.14,47.49 ,33.33
03,018,01,003,0116,240,438 ,4 ,442 ,801 ,0,3,1,3,0,1,0,76.14,55.18 ,33.33
03,018,01,003,0117,241,693 ,7 ,700 ,1332 ,0,3,1,3,0,1,0,76.14,52.55 ,33.33
03,018,01,003,0118,242,339 ,4 ,343 ,641 ,0,3,1,3,0,1,0,76.14,53.51 ,33.33
03,018,01,003,0119,243,366 ,5 ,371 ,722 ,0,3,1,3,0,1,0,76.14,51.39 ,33.33
03,018,01,003,0120,244,424 ,5 ,429 ,800 ,0,3,1,3,0,1,0,76.14,53.63 ,33.33
03,019,01,001,0001,1,541 ,5 ,546 ,936 ,0,3,1,3,0,1,0,76.14,58.33 ,33.33
03,019,01,001,0001,2,575 ,6 ,581 ,992 ,0,3,1,3,0,1,0,76.14,58.57 ,33.33
03,019,01,001,0002,3,976 ,4 ,980 ,1705 ,0,3,1,3,0,1,0,76.14,57.48 ,33.33
03,019,01,001,0003,4,922 ,3 ,925 ,1696 ,0,3,1,3,0,1,0,76.14,54.54 ,33.33
03,019,01,001,0004,5,731 ,7 ,738 ,1294 ,0,3,1,3,0,1,0,76.14,57.03 ,33.33
03,019,01,001,0004,6,634 ,3 ,637 ,1142 ,0,3,1,3,0,1,0,76.14,55.78 ,33.33
03,019,01,001,0005,7,770 ,6 ,776 ,1396 ,0,3,1,3,0,1,0,76.14,55.59 ,33.33
03,019,01,001,0005,8,553 ,6 ,559 ,1021 ,0,3,1,3,0,1,0,76.14,54.75 ,33.33
03,019,01,001,0006,9,1047 ,7 ,1054 ,1860 ,0,3,1,3,0,1,0,76.14,56.67 ,33.33
03,019,01,001,0007,10,488 ,5 ,493 ,832 ,0,3,1,3,0,1,0,76.14,59.25 ,33.33
03,019,01,001,0007,11,715 ,7 ,722 ,1206 ,0,3,1,3,0,1,0,76.14,59.87 ,33.33
03,019,01,001,0008,12,1047 ,8 ,1055 ,1828 ,0,3,1,3,0,1,0,76.14,57.71 ,33.33
03,019,01,002,0009,13,560 ,7 ,567 ,1124 ,0,3,1,3,0,1,0,76.14,50.44 ,33.33
03,019,01,002,0009,14,651 ,6 ,657 ,1164 ,0,3,1,3,0,1,0,76.14,56.44 ,33.33
03,019,01,002,0009,15,681 ,10 ,691 ,1116 ,0,3,1,3,0,1,0,76.14,61.92 ,33.33
03,019,01,002,0010,16,667 ,3 ,670 ,1082 ,0,3,1,3,0,1,0,76.14,61.92 ,33.33
03,019,01,002,0010,17,680 ,7 ,687 ,1140 ,0,3,1,3,0,1,0,76.14,60.26 ,33.33
03,019,01,002,0010,18,671 ,5 ,676 ,1095 ,0,3,1,3,0,1,0,76.14,61.74 ,33.33
03,019,01,002,0011,19,645 ,1 ,646 ,1144 ,0,3,1,3,0,1,0,76.14,56.47 ,33.33
03,019,01,002,0011,20,624 ,7 ,631 ,1093 ,0,3,1,3,0,1,0,76.14,57.73 ,33.33
03,019,01,002,0011,21,650 ,3 ,653 ,1102 ,0,3,1,3,0,1,0,76.14,59.26 ,33.33
03,019,01,002,0012,22,647 ,6 ,653 ,1170 ,0,3,1,3,0,1,0,76.14,55.81 ,33.33
03,019,01,002,0012,23,517 ,3 ,520 ,823 ,0,3,1,3,0,1,0,76.14,63.18 ,33.33
03,019,01,002,0012,24,554 ,1 ,555 ,922 ,0,3,1,3,0,1,0,76.14,60.20 ,33.33
03,019,01,002,0013,25,499 ,2 ,501 ,848 ,0,3,1,3,0,1,0,76.14,59.08 ,33.33
03,019,01,002,0013,26,587 ,8 ,595 ,981 ,0,3,1,3,0,1,0,76.14,60.65 ,33.33
03,019,01,002,0014,27,836 ,4 ,840 ,1346 ,0,3,1,3,0,1,0,76.14,62.41 ,33.33
03,019,01,002,0014,28,615 ,3 ,618 ,1071 ,0,3,1,3,0,1,0,76.14,57.70 ,33.33
03,019,01,002,0015,29,839 ,3 ,842 ,1464 ,0,3,1,3,0,1,0,76.14,57.51 ,33.33
03,019,01,002,0015,30,543 ,1 ,544 ,901 ,0,3,1,3,0,1,0,76.14,60.38 ,33.33
03,019,01,002,0016,31,564 ,8 ,572 ,952 ,0,3,1,3,0,1,0,76.14,60.08 ,33.33
03,019,01,002,0016,32,504 ,2 ,506 ,920 ,0,3,1,3,0,1,0,76.14,55.00 ,33.33
03,019,01,002,0017,33,698 ,4 ,702 ,1142 ,0,3,1,3,0,1,0,76.14,61.47 ,33.33
03,019,01,002,0017,34,714 ,5 ,719 ,1260 ,0,3,1,3,0,1,0,76.14,57.06 ,33.33
03,019,01,002,0017,35,775 ,2 ,777 ,1213 ,0,3,1,3,0,1,0,76.14,64.06 ,33.33
03,019,01,002,0017,36,716 ,2 ,718 ,1207 ,0,3,1,3,0,1,0,76.14,59.49 ,33.33
03,019,01,002,0018,37,719 ,14 ,733 ,1388 ,0,3,1,3,0,1,0,76.14,52.81 ,33.33
03,019,01,002,0018,38,852 ,7 ,859 ,1394 ,0,3,1,3,0,1,0,76.14,61.62 ,33.33
03,019,01,002,0019,39,728 ,7 ,735 ,1319 ,0,3,1,3,0,1,0,76.14,55.72 ,33.33
03,019,01,002,0019,40,694 ,7 ,701 ,1223 ,0,3,1,3,0,1,0,76.14,57.32 ,33.33
03,019,01,002,0019,41,789 ,6 ,795 ,1461 ,0,3,1,3,0,1,0,76.14,54.41 ,33.33
03,019,01,002,0020,42,869 ,8 ,877 ,1407 ,0,3,1,3,0,1,0,76.14,62.33 ,33.33
03,019,01,002,0020,43,445 ,4 ,449 ,722 ,0,3,1,3,0,1,0,76.14,62.19 ,33.33
03,019,01,002,0020,44,635 ,5 ,640 ,1180 ,0,3,1,3,0,1,0,76.14,54.24 ,33.33
03,019,01,002,0021,45,851 ,6 ,857 ,1508 ,0,3,1,3,0,1,0,76.14,56.83 ,33.33
03,019,01,002,0021,46,785 ,2 ,787 ,1326 ,0,3,1,3,0,1,0,76.14,59.35 ,33.33
03,019,01,002,0022,47,731 ,4 ,735 ,1247 ,0,3,1,3,0,1,0,76.14,58.94 ,33.33
03,019,01,002,0022,48,796 ,4 ,800 ,1330 ,0,3,1,3,0,1,0,76.14,60.15 ,33.33
03,019,01,002,0023,49,864 ,8 ,872 ,1263 ,0,3,1,3,0,1,0,76.14,69.04 ,33.33
03,019,01,002,0023,50,560 ,4 ,564 ,1003 ,0,3,1,3,0,1,0,76.14,56.23 ,33.33
03,019,01,002,0023,51,574 ,2 ,576 ,982 ,0,3,1,3,0,1,0,76.14,58.66 ,33.33
03,019,01,002,0024,52,1006 ,4 ,1010 ,1653 ,0,3,1,3,0,1,0,76.14,61.10 ,33.33
03,019,01,002,0025,53,656 ,7 ,663 ,1079 ,0,3,1,3,0,1,0,76.14,61.45 ,33.33
03,019,01,002,0025,54,661 ,9 ,670 ,1127 ,0,3,1,3,0,1,0,76.14,59.45 ,33.33
03,019,01,002,0025,55,795 ,6 ,801 ,1303 ,0,3,1,3,0,1,0,76.14,61.47 ,33.33
03,019,01,002,0025,56,628 ,3 ,631 ,1019 ,0,3,1,3,0,1,0,76.14,61.92 ,33.33
03,019,01,002,0025,57,490 ,2 ,492 ,870 ,0,3,1,3,0,1,0,76.14,56.55 ,33.33
03,019,01,003,0026,58,1044 ,6 ,1050 ,2171 ,0,3,1,3,0,1,0,76.14,48.36 ,33.33
03,019,01,003,0027,59,960 ,7 ,967 ,1776 ,0,3,1,3,0,1,0,76.14,54.45 ,33.33
03,019,01,003,0028,60,1092 ,8 ,1100 ,1966 ,0,3,1,3,0,1,0,76.14,55.95 ,33.33
03,019,01,003,0029,61,751 ,5 ,756 ,1332 ,0,3,1,3,0,1,0,76.14,56.76 ,33.33
03,019,01,003,0029,62,723 ,6 ,729 ,1271 ,0,3,1,3,0,1,0,76.14,57.36 ,33.33
03,019,01,003,0029,63,893 ,10 ,903 ,1581 ,0,3,1,3,0,1,0,76.14,57.12 ,33.33
03,019,01,003,0030,64,1029 ,12 ,1041 ,1756 ,0,3,1,3,0,1,0,76.14,59.28 ,33.33
03,019,01,003,0031,65,694 ,3 ,697 ,1152 ,0,3,1,3,0,1,0,76.14,60.50 ,33.33
03,019,01,003,0031,66,643 ,1 ,644 ,1122 ,0,3,1,3,0,1,0,76.14,57.40 ,33.33
03,019,01,003,0032,67,678 ,3 ,681 ,1157 ,0,3,1,3,0,1,0,76.14,58.86 ,33.33
03,019,01,003,0032,68,557 ,3 ,560 ,929 ,0,3,1,3,0,1,0,76.14,60.28 ,33.33
03,019,01,003,0033,69,792 ,8 ,800 ,1362 ,0,3,1,3,0,1,0,76.14,58.74 ,33.33
03,019,01,003,0033,70,1000 ,4 ,1004 ,1829 ,0,3,1,3,0,1,0,76.14,54.89 ,33.33
03,019,01,003,0033,71,880 ,7 ,887 ,1712 ,0,3,1,3,0,1,0,76.14,51.81 ,33.33
03,019,01,003,0034,72,1099 ,4 ,1103 ,1824 ,0,3,1,3,0,1,0,76.14,60.47 ,33.33
03,019,01,003,0034,73,750 ,6 ,756 ,1295 ,0,3,1,3,0,1,0,76.14,58.38 ,33.33
03,019,01,003,0035,74,879 ,10 ,889 ,1488 ,0,3,1,3,0,1,0,76.14,59.74 ,33.33
03,019,01,003,0035,75,986 ,8 ,994 ,1514 ,0,3,1,3,0,1,0,76.14,65.65 ,33.33
03,019,01,003,0035,76,932 ,7 ,939 ,1701 ,0,3,1,3,0,1,0,76.14,55.20 ,33.33
03,019,01,003,0036,77,575 ,8 ,583 ,969 ,0,3,1,3,0,1,0,76.14,60.17 ,33.33
03,019,01,003,0036,78,657 ,7 ,664 ,1196 ,0,3,1,3,0,1,0,76.14,55.52 ,33.33
03,019,01,003,0037,79,829 ,8 ,837 ,1460 ,0,3,1,3,0,1,0,76.14,57.33 ,33.33
03,019,01,003,0037,80,547 ,1 ,548 ,993 ,0,3,1,3,0,1,0,76.14,55.19 ,33.33
03,019,01,003,0038,81,785 ,4 ,789 ,1366 ,0,3,1,3,0,1,0,76.14,57.76 ,33.33
03,019,01,003,0038,82,617 ,5 ,622 ,1150 ,0,3,1,3,0,1,0,76.14,54.09 ,33.33
03,019,01,003,0039,83,743 ,13 ,756 ,1382 ,0,3,1,3,0,1,0,76.14,54.70 ,33.33
03,019,01,003,0039,84,866 ,5 ,871 ,1509 ,0,3,1,3,0,1,0,76.14,57.72 ,33.33
03,019,01,003,0039,85,758 ,6 ,764 ,1354 ,0,3,1,3,0,1,0,76.14,56.43 ,33.33
03,019,01,003,0039,86,686 ,4 ,690 ,1149 ,0,3,1,3,0,1,0,76.14,60.05 ,33.33
03,019,01,003,0040,87,850 ,8 ,858 ,1502 ,0,3,1,3,0,1,0,76.14,57.12 ,33.33
03,019,01,003,0040,88,875 ,2 ,877 ,1544 ,0,3,1,3,0,1,0,76.14,56.80 ,33.33
03,019,01,003,0041,89,911 ,5 ,916 ,1506 ,0,3,1,3,0,1,0,76.14,60.82 ,33.33
03,019,01,003,0041,90,1021 ,15 ,1036 ,1696 ,0,3,1,3,0,1,0,76.14,61.08 ,33.33
03,019,01,003,0042,91,862 ,9 ,871 ,1566 ,0,3,1,3,0,1,0,76.14,55.62 ,33.33
03,019,01,003,0042,92,785 ,5 ,790 ,1415 ,0,3,1,3,0,1,0,76.14,55.83 ,33.33
03,019,01,003,0042,93,888 ,6 ,894 ,1604 ,0,3,1,3,0,1,0,76.14,55.74 ,33.33
03,019,01,003,0043,94,903 ,4 ,907 ,1683 ,0,3,1,3,0,1,0,76.14,53.89 ,33.33
03,019,01,003,0043,95,918 ,4 ,922 ,1708 ,0,3,1,3,0,1,0,76.14,53.98 ,33.33
03,019,01,003,0043,96,746 ,5 ,751 ,1290 ,0,3,1,3,0,1,0,76.14,58.22 ,33.33
03,019,01,003,0044,97,1050 ,5 ,1055 ,1836 ,0,3,1,3,0,1,0,76.14,57.46 ,33.33
03,019,01,003,0044,98,937 ,4 ,941 ,1848 ,0,3,1,3,0,1,0,76.14,50.92 ,33.33
03,019,01,003,0045,99,852 ,6 ,858 ,1513 ,0,3,1,3,0,1,0,76.14,56.71 ,33.33
03,019,01,003,0045,100,924 ,9 ,933 ,1780 ,0,3,1,3,0,1,0,76.14,52.42 ,33.33
03,019,01,003,0046,101,814 ,2 ,816 ,1327 ,0,3,1,3,0,1,0,76.14,61.49 ,33.33
03,019,01,003,0046,102,862 ,8 ,870 ,1418 ,0,3,1,3,0,1,0,76.14,61.35 ,33.33
03,019,01,003,0047,103,803 ,3 ,806 ,1404 ,0,3,1,3,0,1,0,76.14,57.41 ,33.33
03,019,01,003,0047,104,944 ,7 ,951 ,1601 ,0,3,1,3,0,1,0,76.14,59.40 ,33.33
03,019,01,003,0047,105,848 ,16 ,864 ,1519 ,0,3,1,3,0,1,0,76.14,56.88 ,33.33
03,019,01,003,0048,106,1039 ,6 ,1045 ,1905 ,0,3,1,3,0,1,0,76.14,54.86 ,33.33
03,019,01,003,0048,107,917 ,4 ,921 ,1639 ,0,3,1,3,0,1,0,76.14,56.19 ,33.33
03,019,01,003,0048,108,928 ,7 ,935 ,1566 ,0,3,1,3,0,1,0,76.14,59.71 ,33.33
03,019,01,003,0049,109,603 ,4 ,607 ,1039 ,0,3,1,3,0,1,0,76.14,58.42 ,33.33
03,019,01,003,0049,110,1091 ,4 ,1095 ,1792 ,0,3,1,3,0,1,0,76.14,61.10 ,33.33
03,019,01,003,0050,111,916 ,4 ,920 ,1579 ,0,3,1,3,0,1,0,76.14,58.26 ,33.33
03,019,01,003,0050,112,723 ,4 ,727 ,1197 ,0,3,1,3,0,1,0,76.14,60.74 ,33.33
03,019,01,004,0051,113,597 ,4 ,601 ,1078 ,0,3,1,3,0,1,0,76.14,55.75 ,33.33
03,019,01,004,0051,114,652 ,3 ,655 ,1149 ,0,3,1,3,0,1,0,76.14,57.01 ,33.33
03,019,01,004,0052,115,814 ,7 ,821 ,1336 ,0,3,1,3,0,1,0,76.14,61.45 ,33.33
03,019,01,004,0052,116,736 ,5 ,741 ,1164 ,0,3,1,3,0,1,0,76.14,63.66 ,33.33
03,019,01,004,0053,117,990 ,6 ,996 ,1664 ,0,3,1,3,0,1,0,76.14,59.86 ,33.33
03,019,01,004,0053,118,1030 ,10 ,1040 ,1685 ,0,3,1,3,0,1,0,76.14,61.72 ,33.33
03,019,01,004,0054,119,1090 ,11 ,1101 ,1915 ,0,3,1,3,0,1,0,76.14,57.49 ,33.33
03,019,01,004,0054,120,1060 ,8 ,1068 ,1648 ,0,3,1,3,0,1,0,76.14,64.81 ,33.33
03,019,01,004,0055,121,907 ,5 ,912 ,1572 ,0,3,1,3,0,1,0,76.14,58.02 ,33.33
03,019,01,004,0055,122,925 ,5 ,930 ,1644 ,0,3,1,3,0,1,0,76.14,56.57 ,33.33
03,019,01,004,0056,123,754 ,2 ,756 ,1266 ,0,3,1,3,0,1,0,76.14,59.72 ,33.33
03,019,01,004,0056,124,699 ,3 ,702 ,1223 ,0,3,1,3,0,1,0,76.14,57.40 ,33.33
03,019,01,004,0057,125,632 ,4 ,636 ,1138 ,0,3,1,3,0,1,0,76.14,55.89 ,33.33
03,019,01,004,0057,126,868 ,6 ,874 ,1502 ,0,3,1,3,0,1,0,76.14,58.19 ,33.33
03,019,01,004,0058,127,764 ,3 ,767 ,1289 ,0,3,1,3,0,1,0,76.14,59.50 ,33.33
03,019,01,004,0058,128,509 ,3 ,512 ,935 ,0,3,1,3,0,1,0,76.14,54.76 ,33.33
03,019,01,004,0059,129,787 ,7 ,794 ,1632 ,0,3,1,3,0,1,0,76.14,48.65 ,33.33
03,019,01,004,0059,130,740 ,0 ,740 ,1654 ,0,3,1,3,0,1,0,76.14,44.74 ,33.33
03,019,01,004,0060,131,1036 ,5 ,1041 ,1742 ,0,3,1,3,0,1,0,76.14,59.76 ,33.33
03,019,01,004,0060,132,960 ,7 ,967 ,1667 ,0,3,1,3,0,1,0,76.14,58.01 ,33.33
03,019,01,004,0061,133,716 ,4 ,720 ,1441 ,0,3,1,3,0,1,0,76.14,49.97 ,33.33
03,019,01,004,0061,134,809 ,10 ,819 ,1470 ,0,3,1,3,0,1,0,76.14,55.71 ,33.33
03,019,01,004,0061,135,809 ,8 ,817 ,1498 ,0,3,1,3,0,1,0,76.14,54.54 ,33.33
03,019,01,004,0062,136,605 ,8 ,613 ,1050 ,0,3,1,3,0,1,0,76.14,58.38 ,33.33
03,019,01,004,0062,137,612 ,13 ,625 ,1108 ,0,3,1,3,0,1,0,76.14,56.41 ,33.33
03,019,01,004,0062,138,567 ,5 ,572 ,1063 ,0,3,1,3,0,1,0,76.14,53.81 ,33.33
03,019,01,004,0063,139,614 ,7 ,621 ,1151 ,0,3,1,3,0,1,0,76.14,53.95 ,33.33
03,019,01,004,0063,140,559 ,4 ,563 ,1179 ,0,3,1,3,0,1,0,76.14,47.75 ,33.33
03,019,01,004,0064,141,830 ,4 ,834 ,1522 ,0,3,1,3,0,1,0,76.14,54.80 ,33.33
03,019,01,004,0064,142,912 ,10 ,922 ,1463 ,0,3,1,3,0,1,0,76.14,63.02 ,33.33
03,019,01,004,0065,143,685 ,7 ,692 ,1361 ,0,3,1,3,0,1,0,76.14,50.84 ,33.33
03,019,01,004,0065,144,715 ,9 ,724 ,1218 ,0,3,1,3,0,1,0,76.14,59.44 ,33.33
03,019,01,004,0065,145,672 ,6 ,678 ,1328 ,0,3,1,3,0,1,0,76.14,51.05 ,33.33
03,019,01,004,0066,146,837 ,11 ,848 ,1420 ,0,3,1,3,0,1,0,76.14,59.72 ,33.33
03,019,01,004,0066,147,770 ,5 ,775 ,1505 ,0,3,1,3,0,1,0,76.14,51.50 ,33.33
03,019,01,004,0066,148,748 ,3 ,751 ,1465 ,0,3,1,3,0,1,0,76.14,51.26 ,33.33
03,019,01,004,0067,149,883 ,11 ,894 ,1567 ,0,3,1,3,0,1,0,76.14,57.05 ,33.33
03,019,01,004,0067,150,803 ,4 ,807 ,1483 ,0,3,1,3,0,1,0,76.14,54.42 ,33.33
03,019,01,004,0068,151,936 ,12 ,948 ,1675 ,0,3,1,3,0,1,0,76.14,56.60 ,33.33
03,019,01,004,0068,152,722 ,6 ,728 ,1626 ,0,3,1,3,0,1,0,76.14,44.77 ,33.33
03,019,01,004,0068,153,882 ,4 ,886 ,1754 ,0,3,1,3,0,1,0,76.14,50.51 ,33.33
03,019,01,004,0068,154,887 ,10 ,897 ,1739 ,0,3,1,3,0,1,0,76.14,51.58 ,33.33
03,019,01,004,0069,155,726 ,4 ,730 ,1341 ,0,3,1,3,0,1,0,76.14,54.44 ,33.33
03,019,01,004,0069,156,654 ,1 ,655 ,1244 ,0,3,1,3,0,1,0,76.14,52.65 ,33.33
03,019,01,004,0069,157,644 ,2 ,646 ,1202 ,0,3,1,3,0,1,0,76.14,53.74 ,33.33
03,019,01,004,0070,158,788 ,9 ,797 ,1586 ,0,3,1,3,0,1,0,76.14,50.25 ,33.33
03,019,01,004,0070,159,956 ,6 ,962 ,1883 ,0,3,1,3,0,1,0,76.14,51.09 ,33.33
03,019,01,004,0070,160,771 ,0 ,771 ,1514 ,0,3,1,3,0,1,0,76.14,50.92 ,33.33
03,019,01,004,0071,161,876 ,5 ,881 ,1566 ,0,3,1,3,0,1,0,76.14,56.26 ,33.33
03,019,01,004,0071,162,847 ,4 ,851 ,1455 ,0,3,1,3,0,1,0,76.14,58.49 ,33.33
03,019,01,004,0072,163,1016 ,8 ,1024 ,1752 ,0,3,1,3,0,1,0,76.14,58.45 ,33.33
03,019,01,004,0072,164,1024 ,5 ,1029 ,1571 ,0,3,1,3,0,1,0,76.14,65.50 ,33.33
03,019,01,005,0073,165,955 ,4 ,959 ,1609 ,0,3,1,3,0,1,0,76.14,59.60 ,33.33
03,019,01,005,0074,166,953 ,4 ,957 ,1675 ,0,3,1,3,0,1,0,76.14,57.13 ,33.33
03,019,01,005,0075,167,487 ,2 ,489 ,866 ,0,3,1,3,0,1,0,76.14,56.47 ,33.33
03,019,01,005,0075,168,526 ,7 ,533 ,1006 ,0,3,1,3,0,1,0,76.14,52.98 ,33.33
03,019,01,005,0076,169,1093 ,5 ,1098 ,1571 ,0,3,1,3,0,1,0,76.14,69.89 ,33.33
03,019,01,005,0076,170,935 ,7 ,942 ,1657 ,0,3,1,3,0,1,0,76.14,56.85 ,33.33
03,019,01,005,0077,171,569 ,4 ,573 ,1110 ,0,3,1,3,0,1,0,76.14,51.62 ,33.33
03,019,01,005,0077,172,675 ,5 ,680 ,1108 ,0,3,1,3,0,1,0,76.14,61.37 ,33.33
03,019,01,005,0078,173,688 ,6 ,694 ,1279 ,0,3,1,3,0,1,0,76.14,54.26 ,33.33
03,019,01,005,0079,174,547 ,1 ,548 ,926 ,0,3,1,3,0,1,0,76.14,59.18 ,33.33
03,019,01,005,0079,175,448 ,12 ,460 ,903 ,0,3,1,3,0,1,0,76.14,50.94 ,33.33
03,019,01,005,0080,176,715 ,4 ,719 ,1245 ,0,3,1,3,0,1,0,76.14,57.75 ,33.33
03,019,01,005,0080,177,505 ,1 ,506 ,918 ,0,3,1,3,0,1,0,76.14,55.12 ,33.33
03,019,01,005,0081,178,694 ,6 ,700 ,1177 ,0,3,1,3,0,1,0,76.14,59.47 ,33.33
03,019,01,005,0081,179,416 ,3 ,419 ,808 ,0,3,1,3,0,1,0,76.14,51.86 ,33.33
03,019,01,005,0082,180,686 ,6 ,692 ,1067 ,0,3,1,3,0,1,0,76.14,64.85 ,33.33
03,019,01,005,0082,181,733 ,5 ,738 ,1127 ,0,3,1,3,0,1,0,76.14,65.48 ,33.33
03,019,01,005,0082,182,545 ,6 ,551 ,992 ,0,3,1,3,0,1,0,76.14,55.54 ,33.33
03,019,01,005,0083,183,1046 ,5 ,1051 ,1811 ,0,3,1,3,0,1,0,76.14,58.03 ,33.33
03,019,01,005,0083,184,707 ,5 ,712 ,1143 ,0,3,1,3,0,1,0,76.14,62.29 ,33.33
03,019,01,005,0084,185,810 ,6 ,816 ,1447 ,0,3,1,3,0,1,0,76.14,56.39 ,33.33
03,019,01,005,0084,186,684 ,5 ,689 ,1337 ,0,3,1,3,0,1,0,76.14,51.53 ,33.33
03,019,01,005,0084,187,633 ,4 ,637 ,1243 ,0,3,1,3,0,1,0,76.14,51.25 ,33.33
03,019,01,005,0085,188,1032 ,9 ,1041 ,1784 ,0,3,1,3,0,1,0,76.14,58.35 ,33.33
03,019,01,005,0085,189,940 ,4 ,944 ,1514 ,0,3,1,3,0,1,0,76.14,62.35 ,33.33
03,019,01,005,0086,190,730 ,7 ,737 ,1281 ,0,3,1,3,0,1,0,76.14,57.53 ,33.33
03,019,01,005,0086,191,789 ,5 ,794 ,1336 ,0,3,1,3,0,1,0,76.14,59.43 ,33.33
03,019,01,005,0087,192,780 ,4 ,784 ,1562 ,0,3,1,3,0,1,0,76.14,50.19 ,33.33
03,019,01,005,0087,193,716 ,5 ,721 ,1285 ,0,3,1,3,0,1,0,76.14,56.11 ,33.33
03,019,01,005,0088,194,860 ,7 ,867 ,1531 ,0,3,1,3,0,1,0,76.14,56.63 ,33.33
03,019,01,005,0089,195,802 ,6 ,808 ,1351 ,0,3,1,3,0,1,0,76.14,59.81 ,33.33
03,019,01,005,0089,196,745 ,2 ,747 ,1408 ,0,3,1,3,0,1,0,76.14,53.05 ,33.33
03,019,01,005,0089,197,784 ,4 ,788 ,1437 ,0,3,1,3,0,1,0,76.14,54.84 ,33.33
03,019,01,005,0090,198,898 ,6 ,904 ,1688 ,0,3,1,3,0,1,0,76.14,53.55 ,33.33
03,019,01,005,0091,199,574 ,4 ,578 ,1060 ,0,3,1,3,0,1,0,76.14,54.53 ,33.33
03,019,01,005,0091,200,555 ,1 ,556 ,1037 ,0,3,1,3,0,1,0,76.14,53.62 ,33.33
03,019,01,005,0091,201,606 ,3 ,609 ,1041 ,0,3,1,3,0,1,0,76.14,58.50 ,33.33
03,019,01,005,0091,202,536 ,5 ,541 ,1017 ,0,3,1,3,0,1,0,76.14,53.20 ,33.33
03,019,01,005,0091,203,551 ,1 ,552 ,1003 ,0,3,1,3,0,1,0,76.14,55.03 ,33.33
03,019,01,005,0092,204,911 ,4 ,915 ,1685 ,0,3,1,3,0,1,0,76.14,54.30 ,33.33
03,019,01,005,0092,205,851 ,8 ,859 ,1637 ,0,3,1,3,0,1,0,76.14,52.47 ,33.33
03,019,01,005,0093,206,911 ,5 ,916 ,1589 ,0,3,1,3,0,1,0,76.14,57.65 ,33.33
03,019,01,005,0093,207,668 ,2 ,670 ,1159 ,0,3,1,3,0,1,0,76.14,57.81 ,33.33
03,019,01,005,0094,208,809 ,3 ,812 ,2189 ,0,3,1,3,0,1,0,76.14,37.09 ,33.33
03,019,01,005,0094,209,803 ,3 ,806 ,1586 ,0,3,1,3,0,1,0,76.14,50.82 ,33.33
03,019,01,005,0095,210,536 ,2 ,538 ,932 ,0,3,1,3,0,1,0,76.14,57.73 ,33.33
03,019,01,005,0095,211,857 ,8 ,865 ,1503 ,0,3,1,3,0,1,0,76.14,57.55 ,33.33
03,019,01,005,0096,212,823 ,6 ,829 ,1633 ,0,3,1,3,0,1,0,76.14,50.77 ,33.33
03,019,01,005,0096,213,779 ,5 ,784 ,1434 ,0,3,1,3,0,1,0,76.14,54.67 ,33.33
03,019,01,005,0097,214,587 ,4 ,591 ,1149 ,0,3,1,3,0,1,0,76.14,51.44 ,33.33
03,019,01,005,0097,215,593 ,3 ,596 ,1229 ,0,3,1,3,0,1,0,76.14,48.49 ,33.33
03,019,01,005,0097,216,637 ,1 ,638 ,1228 ,0,3,1,3,0,1,0,76.14,51.95 ,33.33
03,019,01,005,0098,217,456 ,6 ,462 ,1088 ,0,3,1,3,0,1,0,76.14,42.46 ,33.33
03,019,01,005,0098,218,626 ,4 ,630 ,1087 ,0,3,1,3,0,1,0,76.14,57.96 ,33.33
03,019,01,005,0098,219,575 ,2 ,577 ,1056 ,0,3,1,3,0,1,0,76.14,54.64 ,33.33
03,019,01,005,0099,220,538 ,1 ,539 ,1053 ,0,3,1,3,0,1,0,76.14,51.19 ,33.33
03,019,01,005,0099,221,651 ,4 ,655 ,1224 ,0,3,1,3,0,1,0,76.14,53.51 ,33.33
03,019,01,005,0100,222,760 ,7 ,767 ,1421 ,0,3,1,3,0,1,0,76.14,53.98 ,33.33
03,019,01,005,0100,223,733 ,4 ,737 ,1279 ,0,3,1,3,0,1,0,76.14,57.62 ,33.33
03,019,01,005,0100,224,718 ,6 ,724 ,1232 ,0,3,1,3,0,1,0,76.14,58.77 ,33.33
03,019,01,005,0101,225,850 ,5 ,855 ,1493 ,0,3,1,3,0,1,0,76.14,57.27 ,33.33
03,019,01,005,0101,226,783 ,5 ,788 ,1471 ,0,3,1,3,0,1,0,76.14,53.57 ,33.33
03,019,01,005,0102,227,771 ,1 ,772 ,1315 ,0,3,1,3,0,1,0,76.14,58.71 ,33.33
03,019,01,005,0102,228,812 ,8 ,820 ,1335 ,0,3,1,3,0,1,0,76.14,61.42 ,33.33
03,019,01,005,0102,229,639 ,6 ,645 ,1135 ,0,3,1,3,0,1,0,76.14,56.83 ,33.33
03,019,01,005,0103,230,901 ,2 ,903 ,1457 ,0,3,1,3,0,1,0,76.14,61.98 ,33.33
03,019,01,005,0103,231,750 ,8 ,758 ,1292 ,0,3,1,3,0,1,0,76.14,58.67 ,33.33
03,019,01,005,0103,232,793 ,6 ,799 ,1461 ,0,3,1,3,0,1,0,76.14,54.69 ,33.33
03,019,01,005,0103,233,689 ,4 ,693 ,1347 ,0,3,1,3,0,1,0,76.14,51.45 ,33.33
03,019,01,005,0104,234,846 ,3 ,849 ,1491 ,0,3,1,3,0,1,0,76.14,56.94 ,33.33
03,019,01,005,0104,235,628 ,6 ,634 ,1136 ,0,3,1,3,0,1,0,76.14,55.81 ,33.33
03,019,01,005,0104,236,976 ,2 ,978 ,1661 ,0,3,1,3,0,1,0,76.14,58.88 ,33.33
03,019,01,005,0105,237,703 ,2 ,705 ,1349 ,0,3,1,3,0,1,0,76.14,52.26 ,33.33
03,019,01,005,0105,238,646 ,1 ,647 ,1227 ,0,3,1,3,0,1,0,76.14,52.73 ,33.33
03,019,01,005,0106,239,881 ,5 ,886 ,1670 ,0,3,1,3,0,1,0,76.14,53.05 ,33.33
03,019,01,005,0106,240,927 ,9 ,936 ,1620 ,0,3,1,3,0,1,0,76.14,57.78 ,33.33
03,019,01,005,0106,241,877 ,4 ,881 ,1607 ,0,3,1,3,0,1,0,76.14,54.82 ,33.33
03,019,01,005,0107,242,817 ,3 ,820 ,1495 ,0,3,1,3,0,1,0,76.14,54.85 ,33.33
03,019,01,005,0107,243,665 ,4 ,669 ,1335 ,0,3,1,3,0,1,0,76.14,50.11 ,33.33
03,019,01,005,0108,244,666 ,4 ,670 ,1188 ,0,3,1,3,0,1,0,76.14,56.40 ,33.33
03,019,01,005,0108,245,726 ,4 ,730 ,1265 ,0,3,1,3,0,1,0,76.14,57.71 ,33.33
03,019,01,006,0109,246,801 ,5 ,806 ,1330 ,0,3,1,3,0,1,0,76.14,60.60 ,33.33
03,019,01,006,0109,247,683 ,7 ,690 ,1240 ,0,3,1,3,0,1,0,76.14,55.65 ,33.33
03,019,01,006,0109,248,701 ,5 ,706 ,1197 ,0,3,1,3,0,1,0,76.14,58.98 ,33.33
03,019,01,006,0110,249,778 ,3 ,781 ,1497 ,0,3,1,3,0,1,0,76.14,52.17 ,33.33
03,019,01,006,0110,250,764 ,2 ,766 ,1434 ,0,3,1,3,0,1,0,76.14,53.42 ,33.33
03,019,01,006,0111,251,936 ,5 ,941 ,1682 ,0,3,1,3,0,1,0,76.14,55.95 ,33.33
03,019,01,006,0111,252,835 ,6 ,841 ,1509 ,0,3,1,3,0,1,0,76.14,55.73 ,33.33
03,019,01,006,0111,253,1011 ,7 ,1018 ,1530 ,0,3,1,3,0,1,0,76.14,66.54 ,33.33
03,019,01,006,0112,254,673 ,2 ,675 ,1059 ,0,3,1,3,0,1,0,76.14,63.74 ,33.33
03,019,01,006,0112,255,783 ,5 ,788 ,1339 ,0,3,1,3,0,1,0,76.14,58.85 ,33.33
03,019,01,006,0112,256,651 ,7 ,658 ,1229 ,0,3,1,3,0,1,0,76.14,53.54 ,33.33
03,019,01,006,0113,257,724 ,8 ,732 ,1208 ,0,3,1,3,0,1,0,76.14,60.60 ,33.33
03,019,01,006,0113,258,654 ,6 ,660 ,1162 ,0,3,1,3,0,1,0,76.14,56.80 ,33.33
03,019,01,006,0114,259,591 ,1 ,592 ,937 ,0,3,1,3,0,1,0,76.14,63.18 ,33.33
03,019,01,006,0115,260,1002 ,9 ,1011 ,1704 ,0,3,1,3,0,1,0,76.14,59.33 ,33.33
03,019,01,006,0115,261,1021 ,9 ,1030 ,1869 ,0,3,1,3,0,1,0,76.14,55.11 ,33.33
03,019,01,006,0115,262,931 ,6 ,937 ,1674 ,0,3,1,3,0,1,0,76.14,55.97 ,33.33
03,019,01,006,0116,263,873 ,6 ,879 ,1660 ,0,3,1,3,0,1,0,76.14,52.95 ,33.33
03,019,01,006,0116,264,730 ,3 ,733 ,1594 ,0,3,1,3,0,1,0,76.14,45.98 ,33.33
03,019,01,006,0117,265,659 ,3 ,662 ,1397 ,0,3,1,3,0,1,0,76.14,47.39 ,33.33
03,019,01,006,0117,266,756 ,4 ,760 ,1340 ,0,3,1,3,0,1,0,76.14,56.72 ,33.33
03,019,01,006,0118,267,1113 ,12 ,1125 ,1862 ,0,3,1,3,0,1,0,76.14,60.42 ,33.33
03,019,01,006,0118,268,929 ,11 ,940 ,1728 ,0,3,1,3,0,1,0,76.14,54.40 ,33.33
03,019,01,006,0119,269,699 ,10 ,709 ,1426 ,0,3,1,3,0,1,0,76.14,49.72 ,33.33
03,019,01,006,0119,270,695 ,4 ,699 ,1266 ,0,3,1,3,0,1,0,76.14,55.21 ,33.33
03,019,01,006,0119,271,685 ,1 ,686 ,1168 ,0,3,1,3,0,1,0,76.14,58.73 ,33.33
03,019,01,006,0120,272,714 ,4 ,718 ,1213 ,0,3,1,3,0,1,0,76.14,59.19 ,33.33
03,019,01,006,0120,273,864 ,9 ,873 ,1614 ,0,3,1,3,0,1,0,76.14,54.09 ,33.33
03,019,01,006,0120,274,811 ,8 ,819 ,1382 ,0,3,1,3,0,1,0,76.14,59.26 ,33.33
03,019,01,006,0121,275,560 ,0 ,560 ,1178 ,0,3,1,3,0,1,0,76.14,47.54 ,33.33
03,019,01,006,0121,276,765 ,6 ,771 ,1406 ,0,3,1,3,0,1,0,76.14,54.84 ,33.33
03,019,01,006,0122,277,889 ,8 ,897 ,1611 ,0,3,1,3,0,1,0,76.14,55.68 ,33.33
03,019,01,006,0122,278,811 ,1 ,812 ,1551 ,0,3,1,3,0,1,0,76.14,52.35 ,33.33
03,019,01,006,0123,279,928 ,6 ,934 ,1663 ,0,3,1,3,0,1,0,76.14,56.16 ,33.33
03,019,01,006,0123,280,920 ,9 ,929 ,1697 ,0,3,1,3,0,1,0,76.14,54.74 ,33.33
03,019,01,006,0124,281,733 ,3 ,736 ,1387 ,0,3,1,3,0,1,0,76.14,53.06 ,33.33
03,019,01,006,0124,282,736 ,8 ,744 ,1508 ,0,3,1,3,0,1,0,76.14,49.34 ,33.33
03,019,01,006,0124,283,701 ,3 ,704 ,1304 ,0,3,1,3,0,1,0,76.14,53.99 ,33.33
03,019,01,006,0124,284,638 ,3 ,641 ,1202 ,0,3,1,3,0,1,0,76.14,53.33 ,33.33
03,019,01,006,0125,285,741 ,3 ,744 ,1765 ,0,3,1,3,0,1,0,76.14,42.15 ,33.33
03,019,01,006,0125,286,701 ,2 ,703 ,1296 ,0,3,1,3,0,1,0,76.14,54.24 ,33.33
03,019,01,006,0125,287,710 ,8 ,718 ,1282 ,0,3,1,3,0,1,0,76.14,56.01 ,33.33
03,019,01,006,0126,288,903 ,3 ,906 ,1696 ,0,3,1,3,0,1,0,76.14,53.42 ,33.33
03,019,01,006,0126,289,833 ,8 ,841 ,1566 ,0,3,1,3,0,1,0,76.14,53.70 ,33.33
03,019,01,006,0126,290,881 ,5 ,886 ,1696 ,0,3,1,3,0,1,0,76.14,52.24 ,33.33
03,019,01,006,0127,291,804 ,5 ,809 ,1547 ,0,3,1,3,0,1,0,76.14,52.29 ,33.33
03,019,01,006,0127,292,794 ,1 ,795 ,1394 ,0,3,1,3,0,1,0,76.14,57.03 ,33.33
03,019,01,006,0128,293,621 ,3 ,624 ,1167 ,0,3,1,3,0,1,0,76.14,53.47 ,33.33
03,019,01,006,0128,294,697 ,2 ,699 ,1237 ,0,3,1,3,0,1,0,76.14,56.51 ,33.33
03,019,01,006,0128,295,642 ,8 ,650 ,1164 ,0,3,1,3,0,1,0,76.14,55.84 ,33.33
03,019,01,006,0129,296,839 ,6 ,845 ,1520 ,0,3,1,3,0,1,0,76.14,55.59 ,33.33
03,019,01,006,0129,297,971 ,7 ,978 ,1679 ,0,3,1,3,0,1,0,76.14,58.25 ,33.33
03,019,01,006,0129,298,910 ,4 ,914 ,1772 ,0,3,1,3,0,1,0,76.14,51.58 ,33.33
03,019,01,006,0130,299,936 ,11 ,947 ,1679 ,0,3,1,3,0,1,0,76.14,56.40 ,33.33
03,019,01,006,0130,300,967 ,5 ,972 ,1633 ,0,3,1,3,0,1,0,76.14,59.52 ,33.33
03,019,01,006,0131,301,605 ,7 ,612 ,940 ,0,3,1,3,0,1,0,76.14,65.11 ,33.33
03,019,01,006,0132,302,887 ,1 ,888 ,1494 ,0,3,1,3,0,1,0,76.14,59.44 ,33.33
03,019,01,006,0132,303,742 ,6 ,748 ,1378 ,0,3,1,3,0,1,0,76.14,54.28 ,33.33
03,019,01,006,0133,304,793 ,4 ,797 ,1291 ,0,3,1,3,0,1,0,76.14,61.74 ,33.33
03,019,01,006,0133,305,767 ,6 ,773 ,1314 ,0,3,1,3,0,1,0,76.14,58.83 ,33.33
03,019,01,006,0133,306,726 ,4 ,730 ,1377 ,0,3,1,3,0,1,0,76.14,53.01 ,33.33
03,019,01,006,0134,307,603 ,5 ,608 ,1110 ,0,3,1,3,0,1,0,76.14,54.77 ,33.33
03,019,01,006,0134,308,740 ,2 ,742 ,1331 ,0,3,1,3,0,1,0,76.14,55.75 ,33.33
03,019,01,006,0134,309,820 ,7 ,827 ,1528 ,0,3,1,3,0,1,0,76.14,54.12 ,33.33
03,019,01,006,0134,310,535 ,2 ,537 ,741 ,0,3,1,3,0,1,0,76.14,72.47 ,33.33
03,019,01,006,0135,311,670 ,5 ,675 ,1053 ,0,3,1,3,0,1,0,76.14,64.10 ,33.33
03,019,01,006,0135,312,649 ,8 ,657 ,1079 ,0,3,1,3,0,1,0,76.14,60.89 ,33.33
03,019,01,006,0136,313,665 ,11 ,676 ,1106 ,0,3,1,3,0,1,0,76.14,61.12 ,33.33
03,019,01,006,0136,314,875 ,8 ,883 ,1500 ,0,3,1,3,0,1,0,76.14,58.87 ,33.33
03,019,01,006,0137,315,818 ,3 ,821 ,1341 ,0,3,1,3,0,1,0,76.14,61.22 ,33.33
03,019,01,006,0137,316,920 ,3 ,923 ,1526 ,0,3,1,3,0,1,0,76.14,60.48 ,33.33
03,019,01,006,0137,317,774 ,4 ,778 ,1426 ,0,3,1,3,0,1,0,76.14,54.56 ,33.33
03,019,01,006,0137,318,739 ,8 ,747 ,1229 ,0,3,1,3,0,1,0,76.14,60.78 ,33.33
03,019,01,006,0138,319,532 ,1 ,533 ,1032 ,0,3,1,3,0,1,0,76.14,51.65 ,33.33
03,019,01,006,0138,320,519 ,1 ,520 ,951 ,0,3,1,3,0,1,0,76.14,54.68 ,33.33
03,019,01,006,0139,321,1012 ,6 ,1018 ,1799 ,0,3,1,3,0,1,0,76.14,56.59 ,33.33
03,019,01,006,0139,322,874 ,6 ,880 ,1730 ,0,3,1,3,0,1,0,76.14,50.87 ,33.33
03,019,01,006,0140,323,717 ,9 ,726 ,1302 ,0,3,1,3,0,1,0,76.14,55.76 ,33.33
03,019,01,006,0140,324,646 ,4 ,650 ,1229 ,0,3,1,3,0,1,0,76.14,52.89 ,33.33
03,019,01,006,0140,325,755 ,9 ,764 ,1316 ,0,3,1,3,0,1,0,76.14,58.05 ,33.33
03,019,01,006,0141,326,534 ,3 ,537 ,1013 ,0,3,1,3,0,1,0,76.14,53.01 ,33.33
03,019,01,006,0141,327,558 ,1 ,559 ,1044 ,0,3,1,3,0,1,0,76.14,53.54 ,33.33
03,019,01,006,0142,328,871 ,4 ,875 ,1740 ,0,3,1,3,0,1,0,76.14,50.29 ,33.33
03,019,01,006,0143,329,998 ,4 ,1002 ,1667 ,0,3,1,3,0,1,0,76.14,60.11 ,33.33
03,019,01,006,0143,330,815 ,5 ,820 ,1433 ,0,3,1,3,0,1,0,76.14,57.22 ,33.33
03,019,01,006,0144,331,610 ,1 ,611 ,1031 ,0,3,1,3,0,1,0,76.14,59.26 ,33.33
03,019,01,006,0144,332,697 ,4 ,701 ,1271 ,0,3,1,3,0,1,0,76.14,55.15 ,33.33
03,019,01,006,0145,333,779 ,5 ,784 ,1535 ,0,3,1,3,0,1,0,76.14,51.07 ,33.33
03,019,01,006,0145,334,795 ,0 ,795 ,1534 ,0,3,1,3,0,1,0,76.14,51.83 ,33.33
03,019,01,006,0146,335,652 ,3 ,655 ,1112 ,0,3,1,3,0,1,0,76.14,58.90 ,33.33
03,019,01,006,0146,336,491 ,6 ,497 ,807 ,0,3,1,3,0,1,0,76.14,61.59 ,33.33
03,019,01,006,0146,337,683 ,2 ,685 ,1226 ,0,3,1,3,0,1,0,76.14,55.87 ,33.33
03,019,01,007,0147,338,706 ,6 ,712 ,1169 ,0,3,1,3,0,1,0,76.14,60.91 ,33.33
03,019,01,007,0147,339,678 ,13 ,691 ,1235 ,0,3,1,3,0,1,0,76.14,55.95 ,33.33
03,019,01,007,0147,340,731 ,5 ,736 ,1274 ,0,3,1,3,0,1,0,76.14,57.77 ,33.33
03,019,01,007,0147,341,704 ,9 ,713 ,1386 ,0,3,1,3,0,1,0,76.14,51.44 ,33.33
03,019,01,007,0148,342,951 ,8 ,959 ,1654 ,0,3,1,3,0,1,0,76.14,57.98 ,33.33
03,019,01,007,0148,343,920 ,3 ,923 ,1520 ,0,3,1,3,0,1,0,76.14,60.72 ,33.33
03,019,01,007,0148,344,892 ,4 ,896 ,1591 ,0,3,1,3,0,1,0,76.14,56.32 ,33.33
03,019,01,007,0148,345,741 ,3 ,744 ,1755 ,0,3,1,3,0,1,0,76.14,42.39 ,33.33
03,019,01,007,0149,346,758 ,9 ,767 ,1327 ,0,3,1,3,0,1,0,76.14,57.80 ,33.33
03,019,01,007,0149,347,889 ,12 ,901 ,1385 ,0,3,1,3,0,1,0,76.14,65.05 ,33.33
03,019,01,007,0149,348,843 ,7 ,850 ,1320 ,0,3,1,3,0,1,0,76.14,64.39 ,33.33
03,019,01,007,0150,349,802 ,8 ,810 ,1379 ,0,3,1,3,0,1,0,76.14,58.74 ,33.33
03,019,01,007,0150,350,797 ,4 ,801 ,1360 ,0,3,1,3,0,1,0,76.14,58.90 ,33.33
03,019,01,007,0150,351,701 ,8 ,709 ,1164 ,0,3,1,3,0,1,0,76.14,60.91 ,33.33
03,019,01,007,0151,352,363 ,2 ,365 ,585 ,0,3,1,3,0,1,0,76.14,62.39 ,33.33
03,019,01,007,0151,353,619 ,4 ,623 ,918 ,0,3,1,3,0,1,0,76.14,67.86 ,33.33
03,019,01,007,0152,354,835 ,5 ,840 ,1574 ,0,3,1,3,0,1,0,76.14,53.37 ,33.33
03,019,01,007,0152,355,886 ,7 ,893 ,1589 ,0,3,1,3,0,1,0,76.14,56.20 ,33.33
03,019,01,007,0153,356,889 ,7 ,896 ,1580 ,0,3,1,3,0,1,0,76.14,56.71 ,33.33
03,019,01,007,0153,357,700 ,6 ,706 ,1250 ,0,3,1,3,0,1,0,76.14,56.48 ,33.33
03,019,01,007,0153,358,577 ,6 ,583 ,929 ,0,3,1,3,0,1,0,76.14,62.76 ,33.33
03,019,01,007,0153,359,419 ,8 ,427 ,777 ,0,3,1,3,0,1,0,76.14,54.95 ,33.33
03,019,01,007,0154,360,783 ,7 ,790 ,1132 ,0,3,1,3,0,1,0,76.14,69.79 ,33.33
03,019,01,007,0154,361,746 ,2 ,748 ,1224 ,0,3,1,3,0,1,0,76.14,61.11 ,33.33
03,019,01,007,0155,362,822 ,6 ,828 ,1595 ,0,3,1,3,0,1,0,76.14,51.91 ,33.33
03,019,01,007,0155,363,749 ,6 ,755 ,1545 ,0,3,1,3,0,1,0,76.14,48.87 ,33.33
03,019,01,007,0155,364,925 ,6 ,931 ,1709 ,0,3,1,3,0,1,0,76.14,54.48 ,33.33
03,019,01,007,0156,365,868 ,9 ,877 ,1482 ,0,3,1,3,0,1,0,76.14,59.18 ,33.33
03,019,01,007,0156,366,776 ,5 ,781 ,1563 ,0,3,1,3,0,1,0,76.14,49.97 ,33.33
03,019,01,007,0157,367,736 ,7 ,743 ,1298 ,0,3,1,3,0,1,0,76.14,57.24 ,33.33
03,019,01,007,0158,368,671 ,3 ,674 ,1249 ,0,3,1,3,0,1,0,76.14,53.96 ,33.33
03,019,01,007,0158,369,724 ,6 ,730 ,1496 ,0,3,1,3,0,1,0,76.14,48.80 ,33.33
03,019,01,007,0158,370,734 ,3 ,737 ,1422 ,0,3,1,3,0,1,0,76.14,51.83 ,33.33
03,019,01,007,0159,371,795 ,10 ,805 ,1672 ,0,3,1,3,0,1,0,76.14,48.15 ,33.33
03,019,01,007,0159,372,873 ,6 ,879 ,1641 ,0,3,1,3,0,1,0,76.14,53.56 ,33.33
03,019,01,007,0159,373,629 ,5 ,634 ,1157 ,0,3,1,3,0,1,0,76.14,54.80 ,33.33
03,019,01,007,0160,374,853 ,3 ,856 ,1493 ,0,3,1,3,0,1,0,76.14,57.33 ,33.33
03,019,01,007,0160,375,796 ,5 ,801 ,1473 ,0,3,1,3,0,1,0,76.14,54.38 ,33.33
03,019,01,007,0160,376,737 ,9 ,746 ,1458 ,0,3,1,3,0,1,0,76.14,51.17 ,33.33
03,019,01,007,0161,377,877 ,7 ,884 ,1375 ,0,3,1,3,0,1,0,76.14,64.29 ,33.33
03,019,01,007,0161,378,768 ,5 ,773 ,1301 ,0,3,1,3,0,1,0,76.14,59.42 ,33.33
03,019,01,007,0161,379,744 ,4 ,748 ,1335 ,0,3,1,3,0,1,0,76.14,56.03 ,33.33
03,019,01,007,0162,380,740 ,6 ,746 ,1348 ,0,3,1,3,0,1,0,76.14,55.34 ,33.33
03,019,01,007,0162,381,714 ,5 ,719 ,1378 ,0,3,1,3,0,1,0,76.14,52.18 ,33.33
03,019,01,007,0163,382,929 ,6 ,935 ,1562 ,0,3,1,3,0,1,0,76.14,59.86 ,33.33
03,019,01,007,0163,383,694 ,9 ,703 ,1193 ,0,3,1,3,0,1,0,76.14,58.93 ,33.33
03,019,01,007,0163,384,732 ,9 ,741 ,1352 ,0,3,1,3,0,1,0,76.14,54.81 ,33.33
03,019,01,007,0164,385,794 ,7 ,801 ,1422 ,0,3,1,3,0,1,0,76.14,56.33 ,33.33
03,019,01,007,0164,386,698 ,2 ,700 ,1262 ,0,3,1,3,0,1,0,76.14,55.47 ,33.33
03,019,01,007,0165,387,700 ,8 ,708 ,1409 ,0,3,1,3,0,1,0,76.14,50.25 ,33.33
03,019,01,007,0165,388,703 ,7 ,710 ,1277 ,0,3,1,3,0,1,0,76.14,55.60 ,33.33
03,019,01,007,0165,389,672 ,4 ,676 ,1177 ,0,3,1,3,0,1,0,76.14,57.43 ,33.33
03,019,01,007,0166,390,932 ,8 ,940 ,1671 ,0,3,1,3,0,1,0,76.14,56.25 ,33.33
03,019,01,007,0166,391,900 ,5 ,905 ,1564 ,0,3,1,3,0,1,0,76.14,57.86 ,33.33
03,019,01,007,0167,392,619 ,5 ,624 ,1183 ,0,3,1,3,0,1,0,76.14,52.75 ,33.33
03,019,01,007,0167,393,675 ,4 ,679 ,1189 ,0,3,1,3,0,1,0,76.14,57.11 ,33.33
03,019,01,007,0167,394,757 ,6 ,763 ,1286 ,0,3,1,3,0,1,0,76.14,59.33 ,33.33
03,019,01,007,0168,395,575 ,5 ,580 ,1044 ,0,3,1,3,0,1,0,76.14,55.56 ,33.33
03,019,01,007,0168,396,681 ,4 ,685 ,1269 ,0,3,1,3,0,1,0,76.14,53.98 ,33.33
03,019,01,007,0169,397,670 ,5 ,675 ,1174 ,0,3,1,3,0,1,0,76.14,57.50 ,33.33
03,019,01,007,0169,398,655 ,6 ,661 ,1191 ,0,3,1,3,0,1,0,76.14,55.50 ,33.33
03,019,01,007,0169,399,638 ,2 ,640 ,1225 ,0,3,1,3,0,1,0,76.14,52.24 ,33.33
03,019,01,007,0169,400,551 ,4 ,555 ,1160 ,0,3,1,3,0,1,0,76.14,47.84 ,33.33
03,019,01,007,0170,401,916 ,3 ,919 ,1653 ,0,3,1,3,0,1,0,76.14,55.60 ,33.33
03,019,01,007,0170,402,1026 ,5 ,1031 ,1812 ,0,3,1,3,0,1,0,76.14,56.90 ,33.33
03,019,01,007,0171,403,750 ,1 ,751 ,1356 ,0,3,1,3,0,1,0,76.14,55.38 ,33.33
03,019,01,007,0171,404,711 ,4 ,715 ,1431 ,0,3,1,3,0,1,0,76.14,49.97 ,33.33
03,019,01,007,0171,405,775 ,5 ,780 ,1522 ,0,3,1,3,0,1,0,76.14,51.25 ,33.33
03,019,01,008,0172,406,843 ,3 ,846 ,1546 ,0,3,1,3,0,1,0,76.14,54.72 ,33.33
03,019,01,008,0172,407,809 ,5 ,814 ,1463 ,0,3,1,3,0,1,0,76.14,55.64 ,33.33
03,019,01,008,0173,408,911 ,5 ,916 ,1564 ,0,3,1,3,0,1,0,76.14,58.57 ,33.33
03,019,01,008,0173,409,922 ,8 ,930 ,1617 ,0,3,1,3,0,1,0,76.14,57.51 ,33.33
03,019,01,008,0174,410,877 ,6 ,883 ,1522 ,0,3,1,3,0,1,0,76.14,58.02 ,33.33
03,019,01,008,0174,411,915 ,12 ,927 ,1544 ,0,3,1,3,0,1,0,76.14,60.04 ,33.33
03,019,01,008,0175,412,721 ,3 ,724 ,1382 ,0,3,1,3,0,1,0,76.14,52.39 ,33.33
03,019,01,008,0175,413,722 ,5 ,727 ,1322 ,0,3,1,3,0,1,0,76.14,54.99 ,33.33
03,019,01,008,0175,414,799 ,13 ,812 ,1459 ,0,3,1,3,0,1,0,76.14,55.65 ,33.33
03,019,01,008,0175,415,790 ,4 ,794 ,1383 ,0,3,1,3,0,1,0,76.14,57.41 ,33.33
03,019,01,008,0176,416,1064 ,4 ,1068 ,1874 ,0,3,1,3,0,1,0,76.14,56.99 ,33.33
03,019,01,008,0176,417,708 ,6 ,714 ,1346 ,0,3,1,3,0,1,0,76.14,53.05 ,33.33
03,019,01,008,0176,418,786 ,4 ,790 ,1480 ,0,3,1,3,0,1,0,76.14,53.38 ,33.33
03,019,01,008,0177,419,864 ,2 ,866 ,1492 ,0,3,1,3,0,1,0,76.14,58.04 ,33.33
03,019,01,008,0177,420,715 ,7 ,722 ,1186 ,0,3,1,3,0,1,0,76.14,60.88 ,33.33
03,019,01,008,0177,421,726 ,4 ,730 ,1237 ,0,3,1,3,0,1,0,76.14,59.01 ,33.33
03,019,01,008,0177,422,683 ,2 ,685 ,1097 ,0,3,1,3,0,1,0,76.14,62.44 ,33.33
03,019,01,008,0177,423,622 ,4 ,626 ,1129 ,0,3,1,3,0,1,0,76.14,55.45 ,33.33
03,019,01,008,0178,424,968 ,11 ,979 ,1542 ,0,3,1,3,0,1,0,76.14,63.49 ,33.33
03,019,01,008,0178,425,734 ,9 ,743 ,1199 ,0,3,1,3,0,1,0,76.14,61.97 ,33.33
03,019,01,008,0178,426,729 ,5 ,734 ,1211 ,0,3,1,3,0,1,0,76.14,60.61 ,33.33
03,019,01,008,0178,427,583 ,6 ,589 ,1112 ,0,3,1,3,0,1,0,76.14,52.97 ,33.33
03,019,01,008,0178,428,717 ,10 ,727 ,1340 ,0,3,1,3,0,1,0,76.14,54.25 ,33.33
03,019,01,008,0179,429,1064 ,8 ,1072 ,1918 ,0,3,1,3,0,1,0,76.14,55.89 ,33.33
03,019,01,008,0179,430,889 ,6 ,895 ,1695 ,0,3,1,3,0,1,0,76.14,52.80 ,33.33
03,019,01,008,0180,431,937 ,4 ,941 ,1559 ,0,3,1,3,0,1,0,76.14,60.36 ,33.33
03,019,01,008,0180,432,668 ,5 ,673 ,1156 ,0,3,1,3,0,1,0,76.14,58.22 ,33.33
03,019,01,008,0180,433,883 ,8 ,891 ,1613 ,0,3,1,3,0,1,0,76.14,55.24 ,33.33
03,019,01,008,0180,434,910 ,2 ,912 ,1583 ,0,3,1,3,0,1,0,76.14,57.61 ,33.33
03,019,01,008,0181,435,946 ,4 ,950 ,1649 ,0,3,1,3,0,1,0,76.14,57.61 ,33.33
03,019,01,008,0181,436,857 ,8 ,865 ,1626 ,0,3,1,3,0,1,0,76.14,53.20 ,33.33
03,019,01,008,0182,437,885 ,3 ,888 ,1544 ,0,3,1,3,0,1,0,76.14,57.51 ,33.33
03,019,01,008,0182,438,877 ,3 ,880 ,1592 ,0,3,1,3,0,1,0,76.14,55.28 ,33.33
03,019,01,008,0183,439,787 ,3 ,790 ,1247 ,0,3,1,3,0,1,0,76.14,63.35 ,33.33
03,019,01,008,0183,440,898 ,6 ,904 ,1595 ,0,3,1,3,0,1,0,76.14,56.68 ,33.33
03,019,01,008,0183,441,798 ,5 ,803 ,1492 ,0,3,1,3,0,1,0,76.14,53.82 ,33.33
03,019,01,008,0184,442,962 ,9 ,971 ,1656 ,0,3,1,3,0,1,0,76.14,58.64 ,33.33
03,019,01,008,0184,443,735 ,1 ,736 ,1237 ,0,3,1,3,0,1,0,76.14,59.50 ,33.33
03,019,01,008,0184,444,751 ,11 ,762 ,1312 ,0,3,1,3,0,1,0,76.14,58.08 ,33.33
03,019,01,008,0185,445,784 ,15 ,799 ,1424 ,0,3,1,3,0,1,0,76.14,56.11 ,33.33
03,019,01,008,0186,446,964 ,8 ,972 ,1562 ,0,3,1,3,0,1,0,76.14,62.23 ,33.33
03,019,01,008,0186,447,810 ,6 ,816 ,2043 ,0,3,1,3,0,1,0,76.14,39.94 ,33.33
03,019,01,008,0186,448,841 ,2 ,843 ,1445 ,0,3,1,3,0,1,0,76.14,58.34 ,33.33
03,019,01,008,0187,449,488 ,2 ,490 ,794 ,0,3,1,3,0,1,0,76.14,61.71 ,33.33
03,019,01,008,0187,450,898 ,6 ,904 ,1536 ,0,3,1,3,0,1,0,76.14,58.85 ,33.33
03,019,01,008,0187,451,954 ,10 ,964 ,1524 ,0,3,1,3,0,1,0,76.14,63.25 ,33.33
03,019,01,008,0187,452,903 ,4 ,907 ,1380 ,0,3,1,3,0,1,0,76.14,65.72 ,33.33
03,019,01,008,0188,453,637 ,6 ,643 ,1151 ,0,3,1,3,0,1,0,76.14,55.86 ,33.33
03,019,01,008,0188,454,674 ,4 ,678 ,1056 ,0,3,1,3,0,1,0,76.14,64.20 ,33.33
03,019,01,008,0188,455,788 ,3 ,791 ,1349 ,0,3,1,3,0,1,0,76.14,58.64 ,33.33
03,019,01,008,0188,456,622 ,2 ,624 ,1125 ,0,3,1,3,0,1,0,76.14,55.47 ,33.33
03,019,01,008,0188,457,439 ,4 ,443 ,696 ,0,3,1,3,0,1,0,76.14,63.65 ,33.33
03,019,01,008,0189,458,871 ,7 ,878 ,1560 ,0,3,1,3,0,1,0,76.14,56.28 ,33.33
03,019,01,008,0189,459,1118 ,6 ,1124 ,1778 ,0,3,1,3,0,1,0,76.14,63.22 ,33.33
03,019,01,008,0189,460,1031 ,11 ,1042 ,1743 ,0,3,1,3,0,1,0,76.14,59.78 ,33.33
03,019,01,008,0189,461,728 ,2 ,730 ,1382 ,0,3,1,3,0,1,0,76.14,52.82 ,33.33
03,019,01,008,0190,462,923 ,8 ,931 ,1468 ,0,3,1,3,0,1,0,76.14,63.42 ,33.33
03,019,01,008,0190,463,342 ,1 ,343 ,485 ,0,3,1,3,0,1,0,76.14,70.72 ,33.33
03,019,01,008,0191,464,682 ,2 ,684 ,1213 ,0,3,1,3,0,1,0,76.14,56.39 ,33.33
03,019,01,008,0191,465,621 ,4 ,625 ,1155 ,0,3,1,3,0,1,0,76.14,54.11 ,33.33
03,019,01,008,0191,466,847 ,5 ,852 ,1542 ,0,3,1,3,0,1,0,76.14,55.25 ,33.33
03,019,01,008,0191,467,538 ,3 ,541 ,1217 ,0,3,1,3,0,1,0,76.14,44.45 ,33.33
03,019,01,008,0192,468,988 ,7 ,995 ,1600 ,0,3,1,3,0,1,0,76.14,62.19 ,33.33
03,019,01,008,0192,469,1035 ,3 ,1038 ,1743 ,0,3,1,3,0,1,0,76.14,59.55 ,33.33
03,019,01,008,0192,470,871 ,11 ,882 ,1501 ,0,3,1,3,0,1,0,76.14,58.76 ,33.33
03,019,01,008,0193,471,430 ,5 ,435 ,694 ,0,3,1,3,0,1,0,76.14,62.68 ,33.33
03,019,01,008,0193,472,550 ,3 ,553 ,937 ,0,3,1,3,0,1,0,76.14,59.02 ,33.33
03,019,01,008,0194,473,1042 ,5 ,1047 ,1600 ,0,3,1,3,0,1,0,76.14,65.44 ,33.33
03,019,01,008,0195,474,1040 ,10 ,1050 ,1728 ,0,3,1,3,0,1,0,76.14,60.76 ,33.33
03,019,01,008,0196,475,504 ,1 ,505 ,895 ,0,3,1,3,0,1,0,76.14,56.42 ,33.33
03,019,01,008,0197,476,493 ,2 ,495 ,811 ,0,3,1,3,0,1,0,76.14,61.04 ,33.33
03,019,01,008,0198,477,841 ,9 ,850 ,1310 ,0,3,1,3,0,1,0,76.14,64.89 ,33.33
03,019,01,008,0198,478,754 ,13 ,767 ,1372 ,0,3,1,3,0,1,0,76.14,55.90 ,33.33
03,019,01,008,0198,479,888 ,4 ,892 ,1625 ,0,3,1,3,0,1,0,76.14,54.89 ,33.33
03,019,01,008,0199,480,557 ,6 ,563 ,1108 ,0,3,1,3,0,1,0,76.14,50.81 ,33.33
03,019,01,008,0199,481,685 ,3 ,688 ,1258 ,0,3,1,3,0,1,0,76.14,54.69 ,33.33
03,019,01,008,0199,482,534 ,3 ,537 ,1101 ,0,3,1,3,0,1,0,76.14,48.77 ,33.33
03,019,01,008,0200,483,828 ,6 ,834 ,1671 ,0,3,1,3,0,1,0,76.14,49.91 ,33.33
03,019,01,008,0200,484,816 ,6 ,822 ,1572 ,0,3,1,3,0,1,0,76.14,52.29 ,33.33
03,019,01,008,0201,485,828 ,6 ,834 ,1597 ,0,3,1,3,0,1,0,76.14,52.22 ,33.33
03,019,01,008,0201,486,1013 ,6 ,1019 ,1898 ,0,3,1,3,0,1,0,76.14,53.69 ,33.33
03,019,01,008,0202,487,738 ,1 ,739 ,1355 ,0,3,1,3,0,1,0,76.14,54.54 ,33.33
03,019,01,008,0202,488,781 ,4 ,785 ,1561 ,0,3,1,3,0,1,0,76.14,50.29 ,33.33
03,019,01,008,0202,489,899 ,6 ,905 ,1606 ,0,3,1,3,0,1,0,76.14,56.35 ,33.33
03,019,01,008,0203,490,752 ,10 ,762 ,1268 ,0,3,1,3,0,1,0,76.14,60.09 ,33.33
03,019,01,008,0203,491,630 ,6 ,636 ,1226 ,0,3,1,3,0,1,0,76.14,51.88 ,33.33
03,019,01,008,0204,492,765 ,7 ,772 ,1279 ,0,3,1,3,0,1,0,76.14,60.36 ,33.33
03,019,01,008,0204,493,522 ,6 ,528 ,1016 ,0,3,1,3,0,1,0,76.14,51.97 ,33.33
03,019,01,008,0205,494,559 ,6 ,565 ,994 ,0,3,1,3,0,1,0,76.14,56.84 ,33.33
03,019,01,008,0205,495,802 ,9 ,811 ,1550 ,0,3,1,3,0,1,0,76.14,52.32 ,33.33
03,019,01,008,0205,496,649 ,6 ,655 ,1172 ,0,3,1,3,0,1,0,76.14,55.89 ,33.33
03,019,01,008,0206,497,1089 ,8 ,1097 ,1787 ,0,3,1,3,0,1,0,76.14,61.39 ,33.33
03,019,01,008,0206,498,680 ,2 ,682 ,1256 ,0,3,1,3,0,1,0,76.14,54.30 ,33.33
03,019,01,008,0206,499,691 ,5 ,696 ,1260 ,0,3,1,3,0,1,0,76.14,55.24 ,33.33
03,019,01,008,0206,500,577 ,2 ,579 ,1145 ,0,3,1,3,0,1,0,76.14,50.57 ,33.33
03,019,01,008,0207,501,676 ,6 ,682 ,1187 ,0,3,1,3,0,1,0,76.14,57.46 ,33.33
03,019,01,008,0207,502,562 ,3 ,565 ,1176 ,0,3,1,3,0,1,0,76.14,48.04 ,33.33
03,019,01,008,0207,503,942 ,6 ,948 ,1854 ,0,3,1,3,0,1,0,76.14,51.13 ,33.33
03,019,01,008,0208,504,892 ,5 ,897 ,1628 ,0,3,1,3,0,1,0,76.14,55.10 ,33.33
03,019,01,008,0208,505,756 ,10 ,766 ,1370 ,0,3,1,3,0,1,0,76.14,55.91 ,33.33
03,019,01,008,0208,506,741 ,4 ,745 ,1382 ,0,3,1,3,0,1,0,76.14,53.91 ,33.33
03,019,01,008,0209,507,643 ,3 ,646 ,1153 ,0,3,1,3,0,1,0,76.14,56.03 ,33.33
03,019,01,008,0209,508,718 ,7 ,725 ,1287 ,0,3,1,3,0,1,0,76.14,56.33 ,33.33
03,019,01,008,0209,509,728 ,6 ,734 ,1329 ,0,3,1,3,0,1,0,76.14,55.23 ,33.33
03,019,01,008,0210,510,652 ,4 ,656 ,1179 ,0,3,1,3,0,1,0,76.14,55.64 ,33.33
03,019,01,008,0210,511,731 ,3 ,734 ,1342 ,0,3,1,3,0,1,0,76.14,54.69 ,33.33
03,019,01,008,0210,512,556 ,4 ,560 ,1043 ,0,3,1,3,0,1,0,76.14,53.69 ,33.33
03,019,01,008,0210,513,734 ,6 ,740 ,1517 ,0,3,1,3,0,1,0,76.14,48.78 ,33.33
03,019,01,008,0211,514,825 ,3 ,828 ,1414 ,0,3,1,3,0,1,0,76.14,58.56 ,33.33
03,019,01,008,0211,515,685 ,4 ,689 ,1301 ,0,3,1,3,0,1,0,76.14,52.96 ,33.33
03,019,01,008,0211,516,692 ,5 ,697 ,1209 ,0,3,1,3,0,1,0,76.14,57.65 ,33.33
03,019,01,008,0212,517,585 ,5 ,590 ,997 ,0,3,1,3,0,1,0,76.14,59.18 ,33.33
03,019,01,008,0212,518,485 ,2 ,487 ,875 ,0,3,1,3,0,1,0,76.14,55.66 ,33.33
03,019,01,008,0212,519,1003 ,9 ,1012 ,1768 ,0,3,1,3,0,1,0,76.14,57.24 ,33.33
03,019,01,008,0213,520,567 ,3 ,570 ,1130 ,0,3,1,3,0,1,0,76.14,50.44 ,33.33
03,019,01,008,0213,521,731 ,5 ,736 ,1358 ,0,3,1,3,0,1,0,76.14,54.20 ,33.33
03,019,01,008,0213,522,535 ,0 ,535 ,1152 ,0,3,1,3,0,1,0,76.14,46.44 ,33.33
03,020,01,001,0001,1,779 ,6 ,785 ,1378 ,0,3,1,3,0,1,0,76.14,56.97 ,33.33
03,020,01,001,0001,2,701 ,3 ,704 ,1324 ,0,3,1,3,0,1,0,76.14,53.17 ,33.33
03,020,01,001,0001,3,794 ,4 ,798 ,1490 ,0,3,1,3,0,1,0,76.14,53.56 ,33.33
03,020,01,001,0002,4,470 ,5 ,475 ,809 ,0,3,1,3,0,1,0,76.14,58.71 ,33.33
03,020,01,001,0002,5,522 ,8 ,530 ,877 ,0,3,1,3,0,1,0,76.14,60.43 ,33.33
03,020,01,001,0003,6,353 ,0 ,353 ,632 ,0,3,1,3,0,1,0,76.14,55.85 ,33.33
03,020,01,001,0004,7,650 ,4 ,654 ,1189 ,0,3,1,3,0,1,0,76.14,55.00 ,33.33
03,020,01,001,0004,8,661 ,3 ,664 ,1334 ,0,3,1,3,0,1,0,76.14,49.78 ,33.33
03,020,01,001,0004,9,542 ,0 ,542 ,990 ,0,3,1,3,0,1,0,76.14,54.75 ,33.33
03,020,01,001,0005,10,495 ,5 ,500 ,871 ,0,3,1,3,0,1,0,76.14,57.41 ,33.33
03,020,01,001,0006,11,733 ,3 ,736 ,1487 ,0,3,1,3,0,1,0,76.14,49.50 ,33.33
03,020,01,001,0006,12,516 ,1 ,517 ,902 ,0,3,1,3,0,1,0,76.14,57.32 ,33.33
03,020,01,001,0006,13,365 ,0 ,365 ,629 ,0,3,1,3,0,1,0,76.14,58.03 ,33.33
03,020,01,001,0006,14,476 ,3 ,479 ,869 ,0,3,1,3,0,1,0,76.14,55.12 ,33.33
03,020,01,001,0007,15,676 ,2 ,678 ,1233 ,0,3,1,3,0,1,0,76.14,54.99 ,33.33
03,020,01,001,0007,16,566 ,1 ,567 ,1099 ,0,3,1,3,0,1,0,76.14,51.59 ,33.33
03,020,01,001,0008,17,568 ,3 ,571 ,1003 ,0,3,1,3,0,1,0,76.14,56.93 ,33.33
03,020,01,001,0008,18,885 ,7 ,892 ,1603 ,0,3,1,3,0,1,0,76.14,55.65 ,33.33
03,020,01,001,0009,19,717 ,1 ,718 ,1332 ,0,3,1,3,0,1,0,76.14,53.90 ,33.33
03,020,01,001,0009,20,584 ,7 ,591 ,1079 ,0,3,1,3,0,1,0,76.14,54.77,33.33
03,020,01,001,0009,21,614 ,4 ,618 ,1112 ,0,3,1,3,0,1,0,76.14,55.58,33.33
03,020,01,001,0010,22,726 ,6 ,732 ,1343 ,0,3,1,3,0,1,0,76.14,54.50 ,33.33
03,020,01,001,0010,23,524 ,0 ,524 ,933 ,0,3,1,3,0,1,0,76.14,56.16 ,33.33
03,020,01,001,0010,24,488 ,2 ,490 ,967 ,0,3,1,3,0,1,0,76.14,50.67 ,33.33
03,020,01,001,0011,25,678 ,2 ,680 ,1210 ,0,3,1,3,0,1,0,76.14,56.20 ,33.33
03,020,01,001,0011,26,610 ,6 ,616 ,984 ,0,3,1,3,0,1,0,76.14,62.60 ,33.33
03,020,01,001,0011,27,895 ,2 ,897 ,1672 ,0,3,1,3,0,1,0,76.14,53.65 ,33.33
03,020,01,001,0012,28,624 ,4 ,628 ,1114 ,0,3,1,3,0,1,0,76.14,56.37 ,33.33
03,020,01,001,0013,29,174 ,0 ,174 ,297 ,0,3,1,3,0,1,0,76.14,58.59 ,33.33
03,020,01,001,0014,30,275 ,1 ,276 ,452 ,0,3,1,3,0,1,0,76.14,61.06 ,33.33
03,020,01,001,0015,31,318 ,1 ,319 ,535 ,0,3,1,3,0,1,0,76.14,59.63 ,33.33
03,020,01,001,0016,32,305 ,3 ,308 ,518 ,0,3,1,3,0,1,0,76.14,59.46 ,33.33
03,020,01,001,0017,33,357 ,3 ,360 ,668 ,0,3,1,3,0,1,0,76.14,53.89,33.33
03,020,01,001,0018,34,307 ,1 ,308 ,494 ,0,3,1,3,0,1,0,76.14,62.35,33.33
03,020,01,001,0019,35,245 ,0 ,245 ,427 ,0,3,1,3,0,1,0,76.14,57.38 ,33.33
03,020,01,001,0020,36,375 ,3 ,378 ,634 ,0,3,1,3,0,1,0,76.14,59.62 ,33.33
03,020,01,001,0020,37,345 ,2 ,347 ,638 ,0,3,1,3,0,1,0,76.14,54.39 ,33.33
03,020,01,001,0021,38,357 ,1 ,358 ,626 ,0,3,1,3,0,1,0,76.14,57.19 ,33.33
03,020,01,001,0022,39,561 ,6 ,567 ,1011 ,0,3,1,3,0,1,0,76.14,56.08 ,33.33
03,020,01,001,0023,40,191 ,1 ,192 ,377 ,0,3,1,3,0,1,0,76.14,50.93,33.33
03,020,01,001,0024,41,519 ,3 ,522 ,985 ,0,3,1,3,0,1,0,76.14,52.99,33.33
03,020,01,001,0025,42,383 ,1 ,384 ,632 ,0,3,1,3,0,1,0,76.14,60.76,33.33
03,020,01,001,0026,43,392 ,1 ,393 ,715 ,0,3,1,3,0,1,0,76.14,54.97 ,33.33
03,020,01,001,0027,44,416 ,5 ,421 ,706 ,0,3,1,3,0,1,0,76.14,59.63 ,33.33
03,020,01,001,0028,45,382 ,1 ,383 ,648 ,0,3,1,3,0,1,0,76.14,59.10 ,33.33
03,020,01,001,0029,46,702 ,8 ,710 ,1156 ,0,3,1,3,0,1,0,76.14,61.42 ,33.33
03,020,01,001,0030,47,337 ,0 ,337 ,612 ,0,3,1,3,0,1,0,76.14,55.07 ,33.33
03,020,01,001,0031,48,576 ,6 ,582 ,1063 ,0,3,1,3,0,1,0,76.14,54.75 ,33.33
03,020,01,001,0032,49,689 ,2 ,691 ,1276 ,0,3,1,3,0,1,0,76.14,54.15 ,33.33
03,020,01,001,0033,50,443 ,2 ,445 ,770 ,0,3,1,3,0,1,0,76.14,57.79 ,33.33
03,020,01,001,0034,51,394 ,2 ,396 ,639 ,0,3,1,3,0,1,0,76.14,61.97 ,33.33
03,020,01,001,0034,52,385 ,1 ,386 ,721 ,0,3,1,3,0,1,0,76.14,53.54,33.33
03,020,01,001,0035,53,450 ,2 ,452 ,899 ,0,3,1,3,0,1,0,76.14,50.28,33.33
03,020,01,001,0035,54,442 ,1 ,443 ,890 ,0,3,1,3,0,1,0,76.14,49.78 ,33.33
03,020,01,001,0036,55,732 ,4 ,736 ,1277 ,0,3,1,3,0,1,0,76.14,57.64 ,33.33
03,020,01,001,0037,56,400 ,1 ,401 ,724 ,0,3,1,3,0,1,0,76.14,55.39 ,33.33
03,020,01,001,0037,57,428 ,2 ,430 ,814 ,0,3,1,3,0,1,0,76.14,52.83 ,33.33
03,020,01,001,0038,58,673 ,3 ,676 ,1291 ,0,3,1,3,0,1,0,76.14,52.36 ,33.33
03,020,01,001,0038,59,455 ,0 ,455 ,899 ,0,3,1,3,0,1,0,76.14,50.61 ,33.33
03,020,01,001,0038,60,617 ,3 ,620 ,1323 ,0,3,1,3,0,1,0,76.14,46.86 ,33.33
03,020,01,001,0039,61,779 ,4 ,783 ,1387 ,0,3,1,3,0,1,0,76.14,56.45 ,33.33
03,020,01,001,0039,62,392 ,3 ,395 ,657 ,0,3,1,3,0,1,0,76.14,60.12 ,33.33
03,020,01,001,0040,63,537 ,3 ,540 ,1014 ,0,3,1,3,0,1,0,76.14,53.25 ,33.33
03,020,01,001,0040,64,538 ,1 ,539 ,991 ,0,3,1,3,0,1,0,76.14,54.39 ,33.33
03,020,01,001,0041,65,464 ,1 ,465 ,870 ,0,3,1,3,0,1,0,76.14,53.45 ,33.33
03,020,01,001,0041,66,497 ,2 ,499 ,1062 ,0,3,1,3,0,1,0,76.14,46.99 ,33.33
03,020,01,001,0041,67,604 ,3 ,607 ,1217 ,0,3,1,3,0,1,0,76.14,49.88 ,33.33
03,020,01,001,0041,68,788 ,4 ,792 ,1558 ,0,3,1,3,0,1,0,76.14,50.83 ,33.33
03,020,01,001,0042,69,721 ,1 ,722 ,1390 ,0,3,1,3,0,1,0,76.14,51.94,33.33
03,020,01,001,0042,70,844 ,6 ,850 ,1790 ,0,3,1,3,0,1,0,76.14,47.49,33.33
03,020,01,001,0043,71,530 ,5 ,535 ,1120 ,0,3,1,3,0,1,0,76.14,47.77 ,33.33
03,020,01,001,0043,72,538 ,4 ,542 ,1074 ,0,3,1,3,0,1,0,76.14,50.47 ,33.33
03,020,01,001,0044,73,446 ,1 ,447 ,839 ,0,3,1,3,0,1,0,76.14,53.28,33.33
03,020,01,001,0044,74,623 ,4 ,627 ,1209 ,0,3,1,3,0,1,0,76.14,51.86,33.33
03,020,01,001,0044,75,580 ,2 ,582 ,1154 ,0,3,1,3,0,1,0,76.14,50.43 ,33.33
03,020,01,001,0045,76,466 ,5 ,471 ,848 ,0,3,1,3,0,1,0,76.14,55.54 ,33.33
03,020,01,001,0046,77,382 ,2 ,384 ,639 ,0,3,1,3,0,1,0,76.14,60.09 ,33.33
03,020,01,001,0047,78,595 ,2 ,597 ,1040 ,0,3,1,3,0,1,0,76.14,57.40 ,33.33
03,020,01,001,0048,79,432 ,3 ,435 ,797 ,0,3,1,3,0,1,0,76.14,54.58 ,33.33
03,020,01,001,0048,80,341 ,1 ,342 ,658 ,0,3,1,3,0,1,0,76.14,51.98 ,33.33
03,020,01,001,0049,81,515 ,4 ,519 ,853 ,0,3,1,3,0,1,0,76.14,60.84 ,33.33
03,020,01,001,0050,82,282 ,3 ,285 ,477 ,0,3,1,3,0,1,0,76.14,59.75 ,33.33
03,020,01,001,0051,83,750 ,5 ,755 ,1473 ,0,3,1,3,0,1,0,76.14,51.26 ,33.33
03,020,01,001,0051,84,682 ,6 ,688 ,1262 ,0,3,1,3,0,1,0,76.14,54.52 ,33.33
03,020,01,001,0052,85,637 ,1 ,638 ,1172 ,0,3,1,3,0,1,0,76.14,54.44 ,33.33
03,020,01,001,0052,86,477 ,3 ,480 ,981 ,0,3,1,3,0,1,0,76.14,48.93 ,33.33
03,020,01,001,0053,87,861 ,5 ,866 ,1654 ,0,3,1,3,0,1,0,76.14,52.36 ,33.33
03,020,01,001,0053,88,775 ,2 ,777 ,1425 ,0,3,1,3,0,1,0,76.14,54.53 ,33.33
03,020,01,001,0054,89,501 ,1 ,502 ,900 ,0,3,1,3,0,1,0,76.14,55.78 ,33.33
03,020,01,001,0054,90,350 ,2 ,352 ,701 ,0,3,1,3,0,1,0,76.14,50.21 ,33.33
03,020,01,001,0054,91,519 ,1 ,520 ,1133 ,0,3,1,3,0,1,0,76.14,45.90 ,33.33
03,020,01,001,0055,92,615 ,6 ,621 ,1247 ,0,3,1,3,0,1,0,76.14,49.80 ,33.33
03,020,01,001,0055,93,700 ,4 ,704 ,1413 ,0,3,1,3,0,1,0,76.14,49.82 ,33.33
03,020,01,001,0055,94,492 ,2 ,494 ,970 ,0,3,1,3,0,1,0,76.14,50.93 ,33.33
03,020,01,001,0055,95,641 ,8 ,649 ,1210 ,0,3,1,3,0,1,0,76.14,53.64 ,33.33
03,020,01,002,0056,96,556 ,4 ,560 ,1015 ,0,3,1,3,0,1,0,76.14,55.17,33.33
03,020,01,002,0057,97,355 ,0 ,355 ,596 ,0,3,1,3,0,1,0,76.14,59.56,33.33
03,020,01,002,0058,98,251 ,1 ,252 ,477 ,0,3,1,3,0,1,0,76.14,52.83 ,33.33
03,020,01,002,0059,99,378 ,2 ,380 ,631 ,0,3,1,3,0,1,0,76.14,60.22 ,33.33
03,020,01,002,0060,100,285 ,1 ,286 ,531 ,0,3,1,3,0,1,0,76.14,53.86 ,33.33
03,020,01,002,0061,101,489 ,2 ,491 ,773 ,0,3,1,3,0,1,0,76.14,63.52 ,33.33
03,020,01,002,0062,102,330 ,3 ,333 ,581 ,0,3,1,3,0,1,0,76.14,57.31 ,33.33
03,020,01,002,0063,103,641 ,4 ,645 ,1126 ,0,3,1,3,0,1,0,76.14,57.28 ,33.33
03,020,01,002,0064,104,508 ,7 ,515 ,828 ,0,3,1,3,0,1,0,76.14,62.20 ,33.33
03,020,01,002,0065,105,450 ,2 ,452 ,810 ,0,3,1,3,0,1,0,76.14,55.80 ,33.33
03,020,01,002,0066,106,313 ,2 ,315 ,530 ,0,3,1,3,0,1,0,76.14,59.43,33.33
03,020,01,002,0067,107,432 ,3 ,435 ,800 ,0,3,1,3,0,1,0,76.14,54.37,33.33
03,020,01,002,0068,108,317 ,3 ,320 ,528 ,0,3,1,3,0,1,0,76.14,60.61,33.33
03,020,01,002,0069,109,341 ,0 ,341 ,543 ,0,3,1,3,0,1,0,76.14,62.80 ,33.33
03,020,01,002,0070,110,206 ,2 ,208 ,405 ,0,3,1,3,0,1,0,76.14,51.36 ,33.33
03,020,01,002,0071,111,195 ,0 ,195 ,367 ,0,3,1,3,0,1,0,76.14,53.13 ,33.33
03,020,01,002,0072,112,348 ,3 ,351 ,631 ,0,3,1,3,0,1,0,76.14,55.63 ,33.33
03,020,01,002,0073,113,447 ,5 ,452 ,712 ,0,3,1,3,0,1,0,76.14,63.48 ,33.33
03,020,01,002,0074,114,370 ,3 ,373 ,608 ,0,3,1,3,0,1,0,76.14,61.35 ,33.33
03,020,01,002,0075,115,535 ,6 ,541 ,993 ,0,3,1,3,0,1,0,76.14,54.48,33.33
03,020,01,002,0075,116,607 ,2 ,609 ,1138 ,0,3,1,3,0,1,0,76.14,53.51,33.33
03,020,01,002,0075,117,566 ,9 ,575 ,1218 ,0,3,1,3,0,1,0,76.14,47.21,33.33
03,020,01,002,0075,118,672 ,10 ,682 ,1279 ,0,3,1,3,0,1,0,76.14,53.32 ,33.33
03,020,01,002,0075,119,719 ,7 ,726 ,1431 ,0,3,1,3,0,1,0,76.14,50.73 ,33.33
03,020,01,002,0076,120,521 ,4 ,525 ,911 ,0,3,1,3,0,1,0,76.14,57.63 ,33.33
03,020,01,002,0077,121,675 ,8 ,683 ,1299 ,0,3,1,3,0,1,0,76.14,52.58 ,33.33
03,020,01,002,0077,122,786 ,7 ,793 ,1633 ,0,3,1,3,0,1,0,76.14,48.56 ,33.33
03,020,01,002,0077,123,395 ,0 ,395 ,744 ,0,3,1,3,0,1,0,76.14,53.09 ,33.33
03,020,01,002,0078,124,574 ,2 ,576 ,1021 ,0,3,1,3,0,1,0,76.14,56.42 ,33.33
03,020,01,002,0078,125,554 ,5 ,559 ,1041 ,0,3,1,3,0,1,0,76.14,53.70 ,33.33
03,020,01,002,0079,126,679 ,2 ,681 ,1282 ,0,3,1,3,0,1,0,76.14,53.12 ,33.33
03,020,01,002,0080,127,743 ,2 ,745 ,1310 ,0,3,1,3,0,1,0,76.14,56.87 ,33.33
03,020,01,002,0081,128,466 ,6 ,472 ,929 ,0,3,1,3,0,1,0,76.14,50.81 ,33.33
03,020,01,002,0081,129,469 ,2 ,471 ,890 ,0,3,1,3,0,1,0,76.14,52.92 ,33.33
03,020,01,002,0082,130,723 ,4 ,727 ,1287 ,0,3,1,3,0,1,0,76.14,56.49 ,33.33
03,020,01,002,0082,131,516 ,6 ,522 ,963 ,0,3,1,3,0,1,0,76.14,54.21 ,33.33
03,020,01,002,0082,132,538 ,3 ,541 ,990 ,0,3,1,3,0,1,0,76.14,54.65,33.33
03,020,01,002,0083,133,478 ,1 ,479 ,910 ,0,3,1,3,0,1,0,76.14,52.64,33.33
03,020,01,002,0083,134,570 ,1 ,571 ,1134 ,0,3,1,3,0,1,0,76.14,50.35 ,33.33
03,020,01,002,0084,135,440 ,2 ,442 ,772 ,0,3,1,3,0,1,0,76.14,57.25 ,33.33
03,020,01,002,0085,136,288 ,5 ,293 ,590 ,0,3,1,3,0,1,0,76.14,49.66,33.33
03,020,01,002,0085,137,377 ,0 ,377 ,650 ,0,3,1,3,0,1,0,76.14,58,33.33
03,020,01,002,0086,138,562 ,4 ,566 ,991 ,0,3,1,3,0,1,0,76.14,57.11 ,33.33
03,020,01,002,0087,139,423 ,4 ,427 ,888 ,0,3,1,3,0,1,0,76.14,48.09 ,33.33
03,020,01,002,0087,140,542 ,2 ,544 ,1065 ,0,3,1,3,0,1,0,76.14,51.08 ,33.33
03,020,01,002,0088,141,767 ,3 ,770 ,1549 ,0,3,1,3,0,1,0,76.14,49.71 ,33.33
03,020,01,002,0088,142,701 ,8 ,709 ,1321 ,0,3,1,3,0,1,0,76.14,53.67 ,33.33
03,020,01,002,0088,143,879 ,4 ,883 ,1608 ,0,3,1,3,0,1,0,76.14,54.91 ,33.33
03,020,01,002,0089,144,810 ,4 ,814 ,1406 ,0,3,1,3,0,1,0,76.14,57.89,33.33
03,020,01,002,0089,145,721 ,4 ,725 ,1432 ,0,3,1,3,0,1,0,76.14,50.63,33.33
03,020,01,002,0089,146,729 ,5 ,734 ,1531 ,0,3,1,3,0,1,0,76.14,47.94,33.33
03,020,01,002,0090,147,711 ,8 ,719 ,1291 ,0,3,1,3,0,1,0,76.14,55.69 ,33.33
03,020,01,002,0090,148,704 ,3 ,707 ,1265 ,0,3,1,3,0,1,0,76.14,55.89 ,33.33
03,020,01,002,0090,149,412 ,6 ,418 ,898 ,0,3,1,3,0,1,0,76.14,46.55 ,33.33
03,020,01,002,0090,150,699 ,4 ,703 ,1372 ,0,3,1,3,0,1,0,76.14,51.24 ,33.33
03,020,01,002,0090,151,514 ,2 ,516 ,967 ,0,3,1,3,0,1,0,76.14,53.36 ,33.33
03,020,01,002,0090,152,658 ,2 ,660 ,1249 ,0,3,1,3,0,1,0,76.14,52.84 ,33.33
03,020,01,002,0091,153,550 ,4 ,554 ,1024 ,0,3,1,3,0,1,0,76.14,54.10 ,33.33
03,020,01,002,0091,154,769 ,6 ,775 ,1422 ,0,3,1,3,0,1,0,76.14,54.50 ,33.33
03,020,01,002,0091,155,461 ,7 ,468 ,929 ,0,3,1,3,0,1,0,76.14,50.38 ,33.33
03,020,01,002,0092,156,680 ,4 ,684 ,1317 ,0,3,1,3,0,1,0,76.14,51.94 ,33.33
03,020,01,002,0092,157,827 ,4 ,831 ,1610 ,0,3,1,3,0,1,0,76.14,51.61 ,33.33
03,020,01,002,0092,158,717 ,8 ,725 ,1419 ,0,3,1,3,0,1,0,76.14,51.09 ,33.33
03,020,01,002,0093,159,608 ,1 ,609 ,1102 ,0,3,1,3,0,1,0,76.14,55.26 ,33.33
03,020,01,002,0093,160,605 ,7 ,612 ,1140 ,0,3,1,3,0,1,0,76.14,53.68 ,33.33
03,020,01,002,0094,161,686 ,4 ,690 ,1212 ,0,3,1,3,0,1,0,76.14,56.93 ,33.33
03,020,01,002,0095,162,675 ,3 ,678 ,1262 ,0,3,1,3,0,1,0,76.14,53.72 ,33.33
03,020,01,002,0096,163,500 ,2 ,502 ,936 ,0,3,1,3,0,1,0,76.14,53.63 ,33.33
03,020,01,002,0096,164,570 ,3 ,573 ,1027 ,0,3,1,3,0,1,0,76.14,55.79 ,33.33
03,020,01,002,0097,165,577 ,4 ,581 ,1142 ,0,3,1,3,0,1,0,76.14,50.88 ,33.33
03,020,01,002,0097,166,478 ,2 ,480 ,900 ,0,3,1,3,0,1,0,76.14,53.33 ,33.33
03,020,01,002,0098,167,290 ,2 ,292 ,491 ,0,3,1,3,0,1,0,76.14,59.47 ,33.33
03,020,01,002,0099,168,346 ,3 ,349 ,647 ,0,3,1,3,0,1,0,76.14,53.94 ,33.33
03,020,01,002,0100,169,406 ,2 ,408 ,746 ,0,3,1,3,0,1,0,76.14,54.69 ,33.33
03,020,01,002,0100,170,383 ,4 ,387 ,682 ,0,3,1,3,0,1,0,76.14,56.74 ,33.33
03,020,01,002,0101,171,692 ,3 ,695 ,1355 ,0,3,1,3,0,1,0,76.14,51.29,33.33
03,020,01,002,0102,172,484 ,2 ,486 ,925 ,0,3,1,3,0,1,0,76.14,52.54,33.33
03,020,01,002,0102,173,461 ,2 ,463 ,926 ,0,3,1,3,0,1,0,76.14,50.00 ,33.33
03,020,01,002,0103,174,540 ,4 ,544 ,1029 ,0,3,1,3,0,1,0,76.14,52.87 ,33.33
03,020,01,002,0103,175,552 ,0 ,552 ,1120 ,0,3,1,3,0,1,0,76.14,49.29 ,33.33
03,020,01,002,0103,176,465 ,8 ,473 ,865 ,0,3,1,3,0,1,0,76.14,54.68 ,33.33
03,020,01,002,0103,177,520 ,3 ,523 ,975 ,0,3,1,3,0,1,0,76.14,53.64,33.33
03,020,01,002,0104,178,706 ,8 ,714 ,1358 ,0,3,1,3,0,1,0,76.14,52.58,33.33
03,020,01,002,0104,179,808 ,4 ,812 ,1431 ,0,3,1,3,0,1,0,76.14,56.74 ,33.33
03,020,01,002,0104,180,809 ,2 ,811 ,1630 ,0,3,1,3,0,1,0,76.14,49.75 ,33.33
03,020,01,002,0104,181,783 ,5 ,788 ,1590 ,0,3,1,3,0,1,0,76.14,49.56 ,33.33
03,020,01,002,0104,182,668 ,7 ,675 ,1442 ,0,3,1,3,0,1,0,76.14,46.81 ,33.33
03,020,01,002,0104,183,761 ,3 ,764 ,1560 ,0,3,1,3,0,1,0,76.14,48.97 ,33.33
03,020,01,002,0105,184,593 ,5 ,598 ,1126 ,0,3,1,3,0,1,0,76.14,53.11 ,33.33
03,020,01,002,0105,185,584 ,7 ,591 ,1151 ,0,3,1,3,0,1,0,76.14,51.35,33.33
03,020,01,002,0105,186,596 ,1 ,597 ,1137 ,0,3,1,3,0,1,0,76.14,52.51,33.33
03,020,01,002,0106,187,626 ,4 ,630 ,1188 ,0,3,1,3,0,1,0,76.14,53.03 ,33.33
03,020,01,002,0106,188,636 ,7 ,643 ,1162 ,0,3,1,3,0,1,0,76.14,55.34 ,33.33
03,020,01,002,0107,189,641 ,6 ,647 ,1215 ,0,3,1,3,0,1,0,76.14,53.25 ,33.33
03,020,01,002,0108,190,488 ,2 ,490 ,909 ,0,3,1,3,0,1,0,76.14,53.91 ,33.33
03,021,01,001,0001,1,948 ,3 ,951 ,1752 ,0,3,1,3,0,1,0,76.14,54.28 ,33.33
03,021,01,001,0001,2,923 ,3 ,926 ,2104 ,0,3,1,3,0,1,0,76.14,44.01 ,33.33
03,021,01,001,0002,3,711 ,5 ,716 ,1248 ,0,3,1,3,0,1,0,76.14,57.37 ,33.33
03,021,01,001,0002,4,751 ,4 ,755 ,1360 ,0,3,1,3,0,1,0,76.14,55.51 ,33.33
03,021,01,001,0003,5,885 ,4 ,889 ,1470 ,0,3,1,3,0,1,0,76.14,60.48 ,33.33
03,021,01,001,0003,6,689 ,5 ,694 ,1236 ,0,3,1,3,0,1,0,76.14,56.15 ,33.33
03,021,01,001,0003,7,745 ,5 ,750 ,1319 ,0,3,1,3,0,1,0,76.14,56.86 ,33.33
03,021,01,001,0004,8,817 ,6 ,823 ,1524 ,0,3,1,3,0,1,0,76.14,54.00 ,33.33
03,021,01,001,0004,9,1030 ,5 ,1035 ,1961 ,0,3,1,3,0,1,0,76.14,52.78 ,33.33
03,021,01,001,0005,10,594 ,2 ,596 ,1123 ,0,3,1,3,0,1,0,76.14,53.07 ,33.33
03,021,01,001,0005,11,695 ,5 ,700 ,1221 ,0,3,1,3,0,1,0,76.14,57.33 ,33.33
03,021,01,001,0006,12,684 ,2 ,686 ,1264 ,0,3,1,3,0,1,0,76.14,54.27 ,33.33
03,021,01,001,0006,13,786 ,2 ,788 ,1411 ,0,3,1,3,0,1,0,76.14,55.85 ,33.33
03,021,01,001,0006,14,1046 ,9 ,1055 ,1835 ,0,3,1,3,0,1,0,76.14,57.49 ,33.33
03,021,01,001,0007,15,1193 ,10 ,1203 ,2068 ,0,3,1,3,0,1,0,76.14,58.17 ,33.33
03,021,01,001,0008,16,973 ,3 ,976 ,1665 ,0,3,1,3,0,1,0,76.14,58.62 ,33.33
03,021,01,001,0008,17,887 ,6 ,893 ,1486 ,0,3,1,3,0,1,0,76.14,60.09 ,33.33
03,021,01,001,0008,18,870 ,5 ,875 ,1595 ,0,3,1,3,0,1,0,76.14,54.86 ,33.33
03,021,01,001,0009,19,806 ,6 ,812 ,1355 ,0,3,1,3,0,1,0,76.14,59.93 ,33.33
03,021,01,001,0009,20,654 ,8 ,662 ,1198 ,0,3,1,3,0,1,0,76.14,55.26 ,33.33
03,021,01,001,0010,21,859 ,1 ,860 ,1644 ,0,3,1,3,0,1,0,76.14,52.31 ,33.33
03,021,01,001,0010,22,1106 ,6 ,1112 ,2205 ,0,3,1,3,0,1,0,76.14,50.43 ,33.33
03,021,01,001,0011,23,737 ,5 ,742 ,1341 ,0,3,1,3,0,1,0,76.14,55.33 ,33.33
03,021,01,001,0011,24,826 ,3 ,829 ,1474 ,0,3,1,3,0,1,0,76.14,56.24 ,33.33
03,021,01,001,0012,25,807 ,5 ,812 ,1416 ,0,3,1,3,0,1,0,76.14,57.34 ,33.33
03,021,01,001,0012,26,806 ,10 ,816 ,1366 ,0,3,1,3,0,1,0,76.14,59.74 ,33.33
03,021,01,001,0012,27,843 ,4 ,847 ,1705 ,0,3,1,3,0,1,0,76.14,49.68 ,33.33
03,021,01,001,0013,28,1043 ,4 ,1047 ,1995 ,0,3,1,3,0,1,0,76.14,52.48 ,33.33
03,021,01,001,0014,29,886 ,3 ,889 ,1632 ,0,3,1,3,0,1,0,76.14,54.47 ,33.33
03,021,01,001,0014,30,833 ,4 ,837 ,1501 ,0,3,1,3,0,1,0,76.14,55.76 ,33.33
03,021,01,001,0015,31,689 ,1 ,690 ,1397 ,0,3,1,3,0,1,0,76.14,49.39 ,33.33
03,021,01,001,0015,32,759 ,7 ,766 ,1354 ,0,3,1,3,0,1,0,76.14,56.57 ,33.33
03,021,01,001,0015,33,817 ,5 ,822 ,1469 ,0,3,1,3,0,1,0,76.14,55.96 ,33.33
03,021,01,001,0016,34,651 ,1 ,652 ,1180 ,0,3,1,3,0,1,0,76.14,55.25 ,33.33
03,021,01,001,0016,35,528 ,5 ,533 ,950 ,0,3,1,3,0,1,0,76.14,56.11 ,33.33
03,021,01,001,0017,36,1059 ,8 ,1067 ,1832 ,0,3,1,3,0,1,0,76.14,58.24 ,33.33
03,021,01,001,0017,37,796 ,4 ,800 ,1501 ,0,3,1,3,0,1,0,76.14,53.30 ,33.33
03,021,01,001,0017,38,895 ,5 ,900 ,1561 ,0,3,1,3,0,1,0,76.14,57.66 ,33.33
03,021,01,001,0017,39,932 ,5 ,937 ,1695 ,0,3,1,3,0,1,0,76.14,55.28 ,33.33
03,021,01,001,0018,40,680 ,4 ,684 ,1215 ,0,3,1,3,0,1,0,76.14,56.30 ,33.33
03,021,01,001,0018,41,851 ,2 ,853 ,1404 ,0,3,1,3,0,1,0,76.14,60.75 ,33.33
03,021,01,001,0019,42,623 ,5 ,628 ,929 ,0,3,1,3,0,1,0,76.14,67.60 ,33.33
03,021,01,001,0019,43,615 ,6 ,621 ,949 ,0,3,1,3,0,1,0,76.14,65.44 ,33.33
03,021,01,001,0020,44,529 ,7 ,536 ,747 ,0,3,1,3,0,1,0,76.14,71.75 ,33.33
03,021,01,001,0020,45,548 ,5 ,553 ,837 ,0,3,1,3,0,1,0,76.14,66.07 ,33.33
03,021,01,001,0021,46,668 ,3 ,671 ,1184 ,0,3,1,3,0,1,0,76.14,56.67 ,33.33
03,021,01,001,0021,47,1095 ,5 ,1100 ,1850 ,0,3,1,3,0,1,0,76.14,59.46 ,33.33
03,021,01,001,0021,48,673 ,5 ,678 ,1203 ,0,3,1,3,0,1,0,76.14,56.36 ,33.33
03,021,01,001,0022,49,914 ,4 ,918 ,1606 ,0,3,1,3,0,1,0,76.14,57.16 ,33.33
03,021,01,001,0022,50,915 ,5 ,920 ,1672 ,0,3,1,3,0,1,0,76.14,55.02 ,33.33
03,021,01,001,0023,51,852 ,1 ,853 ,1471 ,0,3,1,3,0,1,0,76.14,57.99 ,33.33
03,021,01,001,0023,52,1090 ,6 ,1096 ,1800 ,0,3,1,3,0,1,0,76.14,60.89 ,33.33
03,021,01,001,0024,53,783 ,5 ,788 ,1433 ,0,3,1,3,0,1,0,76.14,54.99 ,33.33
03,021,01,001,0024,54,849 ,3 ,852 ,1464 ,0,3,1,3,0,1,0,76.14,58.20 ,33.33
03,021,01,001,0024,55,743 ,3 ,746 ,1273 ,0,3,1,3,0,1,0,76.14,58.60 ,33.33
03,021,01,001,0025,56,872 ,2 ,874 ,1427 ,0,3,1,3,0,1,0,76.14,61.25 ,33.33
03,021,01,001,0026,57,553 ,3 ,556 ,1005 ,0,3,1,3,0,1,0,76.14,55.32 ,33.33
03,021,01,001,0026,58,672 ,3 ,675 ,1129 ,0,3,1,3,0,1,0,76.14,59.79 ,33.33
03,021,01,001,0027,59,663 ,3 ,666 ,1137 ,0,3,1,3,0,1,0,76.14,58.58 ,33.33
03,021,01,001,0027,60,581 ,4 ,585 ,962 ,0,3,1,3,0,1,0,76.14,60.81 ,33.33
03,021,01,001,0028,61,660 ,4 ,664 ,1102 ,0,3,1,3,0,1,0,76.14,60.25 ,33.33
03,021,01,001,0028,62,678 ,3 ,681 ,1114 ,0,3,1,3,0,1,0,76.14,61.13 ,33.33
03,021,01,001,0029,63,876 ,7 ,883 ,1502 ,0,3,1,3,0,1,0,76.14,58.79 ,33.33
03,021,01,001,0029,64,940 ,6 ,946 ,1585 ,0,3,1,3,0,1,0,76.14,59.68 ,33.33
03,021,01,001,0030,65,825 ,10 ,835 ,1565 ,0,3,1,3,0,1,0,76.14,53.35 ,33.33
03,021,01,001,0031,66,774 ,3 ,777 ,1281 ,0,3,1,3,0,1,0,76.14,60.66 ,33.33
03,021,01,001,0031,67,691 ,5 ,696 ,1186 ,0,3,1,3,0,1,0,76.14,58.68 ,33.33
03,021,01,001,0032,68,882 ,3 ,885 ,1441 ,0,3,1,3,0,1,0,76.14,61.42 ,33.33
03,021,01,001,0032,69,703 ,4 ,707 ,1247 ,0,3,1,3,0,1,0,76.14,56.70 ,33.33
03,021,01,001,0033,70,876 ,7 ,883 ,1590 ,0,3,1,3,0,1,0,76.14,55.53 ,33.33
03,021,01,001,0034,71,883 ,4 ,887 ,1547 ,0,3,1,3,0,1,0,76.14,57.34 ,33.33
03,021,01,001,0034,72,773 ,3 ,776 ,1340 ,0,3,1,3,0,1,0,76.14,57.91 ,33.33
03,021,01,001,0035,73,1175 ,7 ,1182 ,2085 ,0,3,1,3,0,1,0,76.14,56.69 ,33.33
03,021,01,001,0035,74,1025 ,5 ,1030 ,1769 ,0,3,1,3,0,1,0,76.14,58.22 ,33.33
03,021,01,001,0036,75,1147 ,8 ,1155 ,2082 ,0,3,1,3,0,1,0,76.14,55.48 ,33.33
03,021,01,001,0037,76,916 ,2 ,918 ,1760 ,0,3,1,3,0,1,0,76.14,52.16 ,33.33
03,021,01,001,0037,77,996 ,2 ,998 ,1843 ,0,3,1,3,0,1,0,76.14,54.15 ,33.33
03,021,01,001,0037,78,345 ,5 ,350 ,543 ,0,3,1,3,0,1,0,76.14,64.46 ,33.33
03,021,01,001,0038,79,898 ,5 ,903 ,1529 ,0,3,1,3,0,1,0,76.14,59.06 ,33.33
03,021,01,001,0038,80,893 ,3 ,896 ,1555 ,0,3,1,3,0,1,0,76.14,57.62 ,33.33
03,021,01,001,0039,81,1278 ,8 ,1286 ,2149 ,0,3,1,3,0,1,0,76.14,59.84 ,33.33
03,021,01,001,0040,82,933 ,5 ,938 ,1611 ,0,3,1,3,0,1,0,76.14,58.22 ,33.33
03,021,01,001,0041,83,698 ,3 ,701 ,1246 ,0,3,1,3,0,1,0,76.14,56.26 ,33.33
03,021,01,001,0042,84,1063 ,5 ,1068 ,1904 ,0,3,1,3,0,1,0,76.14,56.09 ,33.33
03,021,01,001,0042,85,598 ,5 ,603 ,1034 ,0,3,1,3,0,1,0,76.14,58.32 ,33.33
03,021,01,001,0043,86,1248 ,2 ,1250 ,2105 ,0,3,1,3,0,1,0,76.14,59.38 ,33.33
03,021,01,001,0043,87,1249 ,4 ,1253 ,2134 ,0,3,1,3,0,1,0,76.14,58.72 ,33.33
03,021,01,001,0044,88,737 ,8 ,745 ,1335 ,0,3,1,3,0,1,0,76.14,55.81 ,33.33
03,021,01,001,0044,89,808 ,5 ,813 ,1480 ,0,3,1,3,0,1,0,76.14,54.93 ,33.33
03,021,01,001,0045,90,955 ,6 ,961 ,1707 ,0,3,1,3,0,1,0,76.14,56.30 ,33.33
03,021,01,001,0045,91,988 ,7 ,995 ,1712 ,0,3,1,3,0,1,0,76.14,58.12 ,33.33
03,021,01,002,0046,92,906 ,2 ,908 ,1536 ,0,3,1,3,0,1,0,76.14,59.11 ,33.33
03,021,01,002,0046,93,968 ,8 ,976 ,1631 ,0,3,1,3,0,1,0,76.14,59.84 ,33.33
03,021,01,002,0047,94,555 ,4 ,559 ,964 ,0,3,1,3,0,1,0,76.14,57.99 ,33.33
03,021,01,002,0047,95,536 ,5 ,541 ,906 ,0,3,1,3,0,1,0,76.14,59.71 ,33.33
03,021,01,002,0048,96,857 ,7 ,864 ,1406 ,0,3,1,3,0,1,0,76.14,61.45 ,33.33
03,021,01,002,0048,97,631 ,10 ,641 ,1108 ,0,3,1,3,0,1,0,76.14,57.85 ,33.33
03,021,01,002,0048,98,1032 ,4 ,1036 ,1765 ,0,3,1,3,0,1,0,76.14,58.70 ,33.33
03,021,01,002,0049,99,1173 ,16 ,1189 ,1772 ,0,3,1,3,0,1,0,76.14,67.10 ,33.33
03,021,01,002,0050,100,857 ,11 ,868 ,1451 ,0,3,1,3,0,1,0,76.14,59.82 ,33.33
03,021,01,002,0051,101,435 ,3 ,438 ,745 ,0,3,1,3,0,1,0,76.14,58.79 ,33.33
03,021,01,002,0052,102,576 ,2 ,578 ,941 ,0,3,1,3,0,1,0,76.14,61.42 ,33.33
03,021,01,002,0053,103,632 ,5 ,637 ,1051 ,0,3,1,3,0,1,0,76.14,60.61 ,33.33
03,021,01,002,0054,104,555 ,2 ,557 ,920 ,0,3,1,3,0,1,0,76.14,60.54 ,33.33
03,021,01,002,0055,105,429 ,2 ,431 ,743 ,0,3,1,3,0,1,0,76.14,58.01 ,33.33
03,021,01,002,0055,106,610 ,3 ,613 ,1083 ,0,3,1,3,0,1,0,76.14,56.60 ,33.33
03,021,01,002,0055,107,915 ,6 ,921 ,1530 ,0,3,1,3,0,1,0,76.14,60.20 ,33.33
03,021,01,002,0056,108,669 ,4 ,673 ,1160 ,0,3,1,3,0,1,0,76.14,58.02 ,33.33
03,021,01,002,0056,109,821 ,5 ,826 ,1465 ,0,3,1,3,0,1,0,76.14,56.38 ,33.33
03,021,01,002,0057,110,670 ,8 ,678 ,1063 ,0,3,1,3,0,1,0,76.14,63.78 ,33.33
03,021,01,002,0057,111,642 ,3 ,645 ,1098 ,0,3,1,3,0,1,0,76.14,58.74 ,33.33
03,021,01,002,0058,112,787 ,3 ,790 ,1246 ,0,3,1,3,0,1,0,76.14,63.40 ,33.33
03,021,01,002,0058,113,790 ,6 ,796 ,1266 ,0,3,1,3,0,1,0,76.14,62.88 ,33.33
03,021,01,002,0059,114,685 ,3 ,688 ,1156 ,0,3,1,3,0,1,0,76.14,59.52 ,33.33
03,021,01,002,0059,115,667 ,2 ,669 ,1196 ,0,3,1,3,0,1,0,76.14,55.94 ,33.33
03,021,01,002,0060,116,952 ,5 ,957 ,1571 ,0,3,1,3,0,1,0,76.14,60.92 ,33.33
03,021,01,002,0060,117,932 ,6 ,938 ,1539 ,0,3,1,3,0,1,0,76.14,60.95 ,33.33
03,021,01,002,0061,118,791 ,6 ,797 ,1312 ,0,3,1,3,0,1,0,76.14,60.75 ,33.33
03,021,01,002,0061,119,846 ,4 ,850 ,1398 ,0,3,1,3,0,1,0,76.14,60.80 ,33.33
03,021,01,002,0061,120,659 ,2 ,661 ,1356 ,0,3,1,3,0,1,0,76.14,48.75 ,33.33
03,021,01,002,0062,121,867 ,6 ,873 ,1476 ,0,3,1,3,0,1,0,76.14,59.15 ,33.33
03,021,01,002,0062,122,857 ,9 ,866 ,1659 ,0,3,1,3,0,1,0,76.14,52.20 ,33.33
03,021,01,002,0062,123,936 ,5 ,941 ,1597 ,0,3,1,3,0,1,0,76.14,58.92 ,33.33
03,021,01,002,0063,124,940 ,5 ,945 ,1554 ,0,3,1,3,0,1,0,76.14,60.81 ,33.33
03,021,01,002,0063,125,819 ,3 ,822 ,1405 ,0,3,1,3,0,1,0,76.14,58.51 ,33.33
03,021,01,002,0064,126,582 ,0 ,582 ,960 ,0,3,1,3,0,1,0,76.14,60.62 ,33.33
03,021,01,002,0064,127,611 ,4 ,615 ,1095 ,0,3,1,3,0,1,0,76.14,56.16 ,33.33
03,021,01,002,0065,128,927 ,7 ,934 ,1593 ,0,3,1,3,0,1,0,76.14,58.63 ,33.33
03,021,01,002,0065,129,715 ,2 ,717 ,1325 ,0,3,1,3,0,1,0,76.14,54.11 ,33.33
03,021,01,002,0065,130,660 ,3 ,663 ,1190 ,0,3,1,3,0,1,0,76.14,55.71 ,33.33
03,021,01,002,0066,131,586 ,3 ,589 ,939 ,0,3,1,3,0,1,0,76.14,62.73 ,33.33
03,021,01,002,0066,132,553 ,3 ,556 ,939 ,0,3,1,3,0,1,0,76.14,59.21 ,33.33
03,021,01,002,0067,133,614 ,2 ,616 ,1174 ,0,3,1,3,0,1,0,76.14,52.47 ,33.33
03,021,01,002,0067,134,653 ,8 ,661 ,1213 ,0,3,1,3,0,1,0,76.14,54.49 ,33.33
03,021,01,002,0067,135,659 ,5 ,664 ,1123 ,0,3,1,3,0,1,0,76.14,59.13 ,33.33
03,021,01,002,0068,136,788 ,6 ,794 ,1493 ,0,3,1,3,0,1,0,76.14,53.18 ,33.33
03,021,01,002,0068,137,707 ,3 ,710 ,1223 ,0,3,1,3,0,1,0,76.14,58.05 ,33.33
03,021,01,002,0068,138,777 ,3 ,780 ,1398 ,0,3,1,3,0,1,0,76.14,55.79 ,33.33
03,021,01,002,0069,139,917 ,6 ,923 ,1520 ,0,3,1,3,0,1,0,76.14,60.72 ,33.33
03,021,01,002,0069,140,892 ,12 ,904 ,1657 ,0,3,1,3,0,1,0,76.14,54.56 ,33.33
03,021,01,002,0070,141,843 ,3 ,846 ,1427 ,0,3,1,3,0,1,0,76.14,59.29 ,33.33
03,021,01,002,0070,142,914 ,3 ,917 ,1665 ,0,3,1,3,0,1,0,76.14,55.08 ,33.33
03,021,01,002,0071,143,795 ,2 ,797 ,1339 ,0,3,1,3,0,1,0,76.14,59.52 ,33.33
03,021,01,002,0071,144,839 ,9 ,848 ,1476 ,0,3,1,3,0,1,0,76.14,57.45 ,33.33
03,021,01,002,0071,145,728 ,4 ,732 ,1227 ,0,3,1,3,0,1,0,76.14,59.66 ,33.33
03,021,01,002,0072,146,520 ,1 ,521 ,946 ,0,3,1,3,0,1,0,76.14,55.07 ,33.33
03,021,01,002,0072,147,593 ,3 ,596 ,1437 ,0,3,1,3,0,1,0,76.14,41.48 ,33.33
03,021,01,002,0073,148,616 ,5 ,621 ,1148 ,0,3,1,3,0,1,0,76.14,54.09 ,33.33
03,021,01,002,0073,149,701 ,3 ,704 ,1294 ,0,3,1,3,0,1,0,76.14,54.40 ,33.33
03,021,01,002,0074,150,666 ,1 ,667 ,1283 ,0,3,1,3,0,1,0,76.14,51.99 ,33.33
03,021,01,002,0074,151,644 ,4 ,648 ,1251 ,0,3,1,3,0,1,0,76.14,51.80 ,33.33
03,021,01,002,0074,152,778 ,8 ,786 ,1523 ,0,3,1,3,0,1,0,76.14,51.61 ,33.33
03,021,01,002,0075,153,484 ,4 ,488 ,904 ,0,3,1,3,0,1,0,76.14,53.98 ,33.33
03,021,01,002,0075,154,526 ,3 ,529 ,921 ,0,3,1,3,0,1,0,76.14,57.44 ,33.33
03,021,01,002,0076,155,653 ,4 ,657 ,1006 ,0,3,1,3,0,1,0,76.14,65.31 ,33.33
03,021,01,002,0076,156,540 ,3 ,543 ,853 ,0,3,1,3,0,1,0,76.14,63.66 ,33.33
03,021,01,002,0077,157,641 ,3 ,644 ,1107 ,0,3,1,3,0,1,0,76.14,58.18 ,33.33
03,021,01,002,0077,158,694 ,1 ,695 ,1071 ,0,3,1,3,0,1,0,76.14,64.89 ,33.33
03,021,01,002,0078,159,880 ,5 ,885 ,1452 ,0,3,1,3,0,1,0,76.14,60.95 ,33.33
03,021,01,002,0079,160,949 ,7 ,956 ,1516 ,0,3,1,3,0,1,0,76.14,63.06 ,33.33
03,021,01,002,0080,161,795 ,4 ,799 ,1384 ,0,3,1,3,0,1,0,76.14,57.73 ,33.33
03,021,01,002,0080,162,718 ,2 ,720 ,1254 ,0,3,1,3,0,1,0,76.14,57.42 ,33.33
03,021,01,002,0081,163,577 ,1 ,578 ,876 ,0,3,1,3,0,1,0,76.14,65.98 ,33.33
03,021,01,002,0081,164,672 ,3 ,675 ,1078 ,0,3,1,3,0,1,0,76.14,62.62 ,33.33
03,021,01,002,0082,165,1063 ,5 ,1068 ,1784 ,0,3,1,3,0,1,0,76.14,59.87 ,33.33
03,021,01,002,0083,166,1061 ,7 ,1068 ,1836 ,0,3,1,3,0,1,0,76.14,58.17 ,33.33
03,021,01,002,0084,167,712 ,4 ,716 ,1151 ,0,3,1,3,0,1,0,76.14,62.21 ,33.33
03,021,01,002,0084,168,483 ,5 ,488 ,882 ,0,3,1,3,0,1,0,76.14,55.33 ,33.33
03,021,01,002,0085,169,599 ,8 ,607 ,954 ,0,3,1,3,0,1,0,76.14,63.63 ,33.33
03,021,01,002,0085,170,523 ,2 ,525 ,873 ,0,3,1,3,0,1,0,76.14,60.14 ,33.33
03,021,01,003,0086,171,596 ,1 ,597 ,968 ,0,3,1,3,0,1,0,76.14,61.67 ,33.33
03,021,01,003,0087,172,747 ,5 ,752 ,1234 ,0,3,1,3,0,1,0,76.14,60.94 ,33.33
03,021,01,003,0088,173,737 ,1 ,738 ,1223 ,0,3,1,3,0,1,0,76.14,60.34 ,33.33
03,021,01,003,0089,174,891 ,5 ,896 ,1576 ,0,3,1,3,0,1,0,76.14,56.85 ,33.33
03,021,01,003,0090,175,824 ,2 ,826 ,1439 ,0,3,1,3,0,1,0,76.14,57.40 ,33.33
03,021,01,003,0091,176,627 ,0 ,627 ,1209 ,0,3,1,3,0,1,0,76.14,51.86 ,33.33
03,021,01,003,0091,177,682 ,0 ,682 ,1153 ,0,3,1,3,0,1,0,76.14,59.15 ,33.33
03,021,01,003,0092,178,777 ,1 ,778 ,1284 ,0,3,1,3,0,1,0,76.14,60.59 ,33.33
03,021,01,003,0092,179,670 ,4 ,674 ,1214 ,0,3,1,3,0,1,0,76.14,55.52 ,33.33
03,021,01,003,0093,180,815 ,4 ,819 ,1309 ,0,3,1,3,0,1,0,76.14,62.57 ,33.33
03,021,01,003,0094,181,790 ,5 ,795 ,1322 ,0,3,1,3,0,1,0,76.14,60.14 ,33.33
03,021,01,003,0095,182,778 ,1 ,779 ,1345 ,0,3,1,3,0,1,0,76.14,57.92 ,33.33
03,021,01,003,0096,183,832 ,2 ,834 ,1345 ,0,3,1,3,0,1,0,76.14,62.01 ,33.33
03,021,01,003,0097,184,837 ,6 ,843 ,1410 ,0,3,1,3,0,1,0,76.14,59.79 ,33.33
03,021,01,003,0098,185,808 ,14 ,822 ,1423 ,0,3,1,3,0,1,0,76.14,57.77 ,33.33
03,021,01,003,0099,186,978 ,6 ,984 ,1607 ,0,3,1,3,0,1,0,76.14,61.23 ,33.33
03,021,01,003,0100,187,902 ,8 ,910 ,1486 ,0,3,1,3,0,1,0,76.14,61.24 ,33.33
03,021,01,003,0101,188,866 ,6 ,872 ,1514 ,0,3,1,3,0,1,0,76.14,57.60 ,33.33
03,021,01,003,0102,189,803 ,7 ,810 ,1429 ,0,3,1,3,0,1,0,76.14,56.68 ,33.33
03,021,01,003,0103,190,670 ,5 ,675 ,998 ,0,3,1,3,0,1,0,76.14,67.64 ,33.33
03,021,01,003,0103,191,629 ,1 ,630 ,1028 ,0,3,1,3,0,1,0,76.14,61.28 ,33.33
03,021,01,003,0104,192,662 ,4 ,666 ,1118 ,0,3,1,3,0,1,0,76.14,59.57 ,33.33
03,021,01,003,0104,193,548 ,2 ,550 ,986 ,0,3,1,3,0,1,0,76.14,55.78 ,33.33
03,021,01,003,0105,194,1333 ,3 ,1336 ,2293 ,0,3,1,3,0,1,0,76.14,58.26 ,33.33
03,021,01,003,0105,195,736 ,5 ,741 ,1266 ,0,3,1,3,0,1,0,76.14,58.53 ,33.33
03,021,01,003,0106,196,798 ,3 ,801 ,1343 ,0,3,1,3,0,1,0,76.14,59.64 ,33.33
03,021,01,003,0106,197,1109 ,8 ,1117 ,1914 ,0,3,1,3,0,1,0,76.14,58.36 ,33.33
03,021,01,003,0107,198,942 ,2 ,944 ,1509 ,0,3,1,3,0,1,0,76.14,62.56 ,33.33
03,021,01,003,0107,199,747 ,7 ,754 ,1246 ,0,3,1,3,0,1,0,76.14,60.51 ,33.33
03,021,01,003,0108,200,776 ,3 ,779 ,1286 ,0,3,1,3,0,1,0,76.14,60.58 ,33.33
03,021,01,003,0109,201,556 ,3 ,559 ,1104 ,0,3,1,3,0,1,0,76.14,50.63 ,33.33
03,021,01,003,0109,202,578 ,4 ,582 ,962 ,0,3,1,3,0,1,0,76.14,60.50 ,33.33
03,021,01,003,0110,203,1128 ,8 ,1136 ,1870 ,0,3,1,3,0,1,0,76.14,60.75 ,33.33
03,021,01,003,0111,204,729 ,3 ,732 ,1164 ,0,3,1,3,0,1,0,76.14,62.89 ,33.33
03,021,01,003,0112,205,802 ,3 ,805 ,1336 ,0,3,1,3,0,1,0,76.14,60.25 ,33.33
03,021,01,003,0113,206,970 ,10 ,980 ,1576 ,0,3,1,3,0,1,0,76.14,62.18 ,33.33
03,021,01,003,0114,207,757 ,6 ,763 ,1324 ,0,3,1,3,0,1,0,76.14,57.63 ,33.33
03,021,01,003,0114,208,838 ,6 ,844 ,1608 ,0,3,1,3,0,1,0,76.14,52.49 ,33.33
03,021,01,003,0115,209,611 ,2 ,613 ,1064 ,0,3,1,3,0,1,0,76.14,57.61 ,33.33
03,021,01,003,0116,210,785 ,9 ,794 ,1309 ,0,3,1,3,0,1,0,76.14,60.66 ,33.33
03,021,01,003,0117,211,661 ,0 ,661 ,1272 ,0,3,1,3,0,1,0,76.14,51.97 ,33.33
03,021,01,003,0118,212,505 ,6 ,511 ,934 ,0,3,1,3,0,1,0,76.14,54.71 ,33.33
03,021,01,003,0118,213,853 ,8 ,861 ,1471 ,0,3,1,3,0,1,0,76.14,58.53 ,33.33
03,021,01,003,0119,214,572 ,6 ,578 ,965 ,0,3,1,3,0,1,0,76.14,59.90 ,33.33
03,021,01,003,0120,215,773 ,4 ,777 ,1309 ,0,3,1,3,0,1,0,76.14,59.36 ,33.33
03,021,01,003,0121,216,743 ,7 ,750 ,1222 ,0,3,1,3,0,1,0,76.14,61.37 ,33.33
03,021,01,003,0122,217,1037 ,10 ,1047 ,1777 ,0,3,1,3,0,1,0,76.14,58.92 ,33.33
03,021,01,003,0123,218,746 ,2 ,748 ,1287 ,0,3,1,3,0,1,0,76.14,58.12 ,33.33
03,021,01,004,0124,219,618 ,8 ,626 ,1057 ,0,3,1,3,0,1,0,76.14,59.22 ,33.33
03,021,01,004,0124,220,733 ,4 ,737 ,1236 ,0,3,1,3,0,1,0,76.14,59.63 ,33.33
03,021,01,004,0125,221,309 ,3 ,312 ,721 ,0,3,1,3,0,1,0,76.14,43.27 ,33.33
03,021,01,004,0125,222,540 ,2 ,542 ,1054 ,0,3,1,3,0,1,0,76.14,51.42 ,33.33
03,021,01,004,0126,223,841 ,10 ,851 ,1419 ,0,3,1,3,0,1,0,76.14,59.97 ,33.33
03,021,01,004,0127,224,577 ,1 ,578 ,1019 ,0,3,1,3,0,1,0,76.14,56.72 ,33.33
03,021,01,004,0127,225,606 ,6 ,612 ,1034 ,0,3,1,3,0,1,0,76.14,59.19 ,33.33
03,021,01,004,0128,226,671 ,2 ,673 ,1149 ,0,3,1,3,0,1,0,76.14,58.57 ,33.33
03,021,01,004,0128,227,678 ,2 ,680 ,1084 ,0,3,1,3,0,1,0,76.14,62.73 ,33.33
03,021,01,004,0129,228,853 ,7 ,860 ,1489 ,0,3,1,3,0,1,0,76.14,57.76 ,33.33
03,021,01,004,0129,229,823 ,3 ,826 ,1286 ,0,3,1,3,0,1,0,76.14,64.23 ,33.33
03,021,01,004,0130,230,549 ,0 ,549 ,980 ,0,3,1,3,0,1,0,76.14,56.02 ,33.33
03,021,01,004,0130,231,603 ,1 ,604 ,998 ,0,3,1,3,0,1,0,76.14,60.52 ,33.33
03,021,01,004,0131,232,521 ,3 ,524 ,907 ,0,3,1,3,0,1,0,76.14,57.77 ,33.33
03,021,01,004,0131,233,483 ,2 ,485 ,884 ,0,3,1,3,0,1,0,76.14,54.86 ,33.33
03,021,01,004,0132,234,746 ,7 ,753 ,1120 ,0,3,1,3,0,1,0,76.14,67.23 ,33.33
03,021,01,004,0133,235,565 ,1 ,566 ,955 ,0,3,1,3,0,1,0,76.14,59.27 ,33.33
03,021,01,004,0133,236,543 ,7 ,550 ,893 ,0,3,1,3,0,1,0,76.14,61.59 ,33.33
03,021,01,004,0134,237,508 ,5 ,513 ,885 ,0,3,1,3,0,1,0,76.14,57.97 ,33.33
03,021,01,004,0134,238,493 ,2 ,495 ,859 ,0,3,1,3,0,1,0,76.14,57.63 ,33.33
03,021,01,004,0135,239,697 ,7 ,704 ,1202 ,0,3,1,3,0,1,0,76.14,58.57 ,33.33
03,021,01,004,0136,240,543 ,10 ,553 ,899 ,0,3,1,3,0,1,0,76.14,61.51 ,33.33
03,021,01,004,0136,241,683 ,6 ,689 ,1122 ,0,3,1,3,0,1,0,76.14,61.41 ,33.33
03,021,01,004,0137,242,889 ,5 ,894 ,1515 ,0,3,1,3,0,1,0,76.14,59.01 ,33.33
03,021,01,004,0137,243,799 ,4 ,803 ,1353 ,0,3,1,3,0,1,0,76.14,59.35 ,33.33
03,021,01,004,0138,244,584 ,2 ,586 ,992 ,0,3,1,3,0,1,0,76.14,59.07 ,33.33
03,021,01,004,0138,245,613 ,9 ,622 ,1026 ,0,3,1,3,0,1,0,76.14,60.62 ,33.33
03,021,01,004,0139,246,894 ,5 ,899 ,1430 ,0,3,1,3,0,1,0,76.14,62.87 ,33.33
03,021,01,004,0140,247,502 ,1 ,503 ,770 ,0,3,1,3,0,1,0,76.14,65.32 ,33.33
03,021,01,004,0141,248,558 ,7 ,565 ,830 ,0,3,1,3,0,1,0,76.14,68.07 ,33.33
03,021,01,004,0142,249,730 ,10 ,740 ,1206 ,0,3,1,3,0,1,0,76.14,61.36 ,33.33
03,021,01,004,0143,250,534 ,5 ,539 ,904 ,0,3,1,3,0,1,0,76.14,59.62 ,33.33
03,021,01,004,0144,251,888 ,6 ,894 ,1508 ,0,3,1,3,0,1,0,76.14,59.28 ,33.33
03,021,01,004,0145,252,455 ,3 ,458 ,794 ,0,3,1,3,0,1,0,76.14,57.68 ,33.33
03,021,01,004,0145,253,632 ,2 ,634 ,1099 ,0,3,1,3,0,1,0,76.14,57.69 ,33.33
03,021,01,004,0146,254,856 ,5 ,861 ,1470 ,0,3,1,3,0,1,0,76.14,58.57 ,33.33
03,021,01,004,0147,255,482 ,1 ,483 ,842 ,0,3,1,3,0,1,0,76.14,57.36 ,33.33
03,021,01,004,0147,256,474 ,1 ,475 ,903 ,0,3,1,3,0,1,0,76.14,52.60 ,33.33
03,021,01,004,0148,257,699 ,7 ,706 ,1293 ,0,3,1,3,0,1,0,76.14,54.60 ,33.33
03,021,01,004,0149,258,979 ,2 ,981 ,1649 ,0,3,1,3,0,1,0,76.14,59.49 ,33.33
03,021,01,004,0150,259,657 ,4 ,661 ,1077 ,0,3,1,3,0,1,0,76.14,61.37 ,33.33
03,021,01,004,0150,260,669 ,2 ,671 ,1096 ,0,3,1,3,0,1,0,76.14,61.22 ,33.33
03,021,01,004,0150,261,587 ,3 ,590 ,1013 ,0,3,1,3,0,1,0,76.14,58.24 ,33.33
03,021,01,004,0151,262,592 ,2 ,594 ,1087 ,0,3,1,3,0,1,0,76.14,54.65 ,33.33
03,021,01,004,0151,263,609 ,3 ,612 ,1165 ,0,3,1,3,0,1,0,76.14,52.53 ,33.33
03,021,01,004,0152,264,892 ,4 ,896 ,1532 ,0,3,1,3,0,1,0,76.14,58.49 ,33.33
03,021,01,004,0153,265,832 ,4 ,836 ,1506 ,0,3,1,3,0,1,0,76.14,55.51 ,33.33
03,021,01,004,0154,266,771 ,4 ,775 ,1337 ,0,3,1,3,0,1,0,76.14,57.97 ,33.33
03,021,01,004,0155,267,690 ,2 ,692 ,1599 ,0,3,1,3,0,1,0,76.14,43.28 ,33.33
03,021,01,004,0156,268,749 ,8 ,757 ,1326 ,0,3,1,3,0,1,0,76.14,57.09 ,33.33
03,021,01,004,0156,269,466 ,3 ,469 ,927 ,0,3,1,3,0,1,0,76.14,50.59 ,33.33
03,021,01,004,0156,270,690 ,3 ,693 ,1242 ,0,3,1,3,0,1,0,76.14,55.80 ,33.33
03,021,01,004,0157,271,622 ,0 ,622 ,1125 ,0,3,1,3,0,1,0,76.14,55.29 ,33.33
03,021,01,004,0157,272,776 ,3 ,779 ,1422 ,0,3,1,3,0,1,0,76.14,54.78 ,33.33
03,021,01,004,0157,273,554 ,2 ,556 ,1058 ,0,3,1,3,0,1,0,76.14,52.55 ,33.33
03,021,01,004,0157,274,1042 ,6 ,1048 ,2029 ,0,3,1,3,0,1,0,76.14,51.65 ,33.33
03,021,01,004,0158,275,651 ,6 ,657 ,1196 ,0,3,1,3,0,1,0,76.14,54.93 ,33.33
03,021,01,004,0158,276,666 ,4 ,670 ,1215 ,0,3,1,3,0,1,0,76.14,55.14 ,33.33
03,021,01,004,0158,277,764 ,8 ,772 ,1319 ,0,3,1,3,0,1,0,76.14,58.53 ,33.33
03,021,01,004,0158,278,763 ,4 ,767 ,1561 ,0,3,1,3,0,1,0,76.14,49.14 ,33.33
03,021,01,004,0159,279,835 ,4 ,839 ,1351 ,0,3,1,3,0,1,0,76.14,62.10 ,33.33
03,021,01,004,0160,280,741 ,5 ,746 ,1405 ,0,3,1,3,0,1,0,76.14,53.10 ,33.33
03,021,01,004,0160,281,697 ,5 ,702 ,1356 ,0,3,1,3,0,1,0,76.14,51.77 ,33.33
03,021,01,004,0160,282,762 ,1 ,763 ,1345 ,0,3,1,3,0,1,0,76.14,56.73 ,33.33
03,021,01,004,0161,283,785 ,7 ,792 ,1413 ,0,3,1,3,0,1,0,76.14,56.05 ,33.33
03,021,01,004,0161,284,787 ,6 ,793 ,1357 ,0,3,1,3,0,1,0,76.14,58.44 ,33.33
03,021,01,004,0162,285,862 ,7 ,869 ,1383 ,0,3,1,3,0,1,0,76.14,62.83 ,33.33
03,021,01,004,0163,286,925 ,10 ,935 ,1564 ,0,3,1,3,0,1,0,76.14,59.78 ,33.33
03,021,01,004,0163,287,851 ,5 ,856 ,1492 ,0,3,1,3,0,1,0,76.14,57.37 ,33.33
03,021,01,004,0164,288,720 ,9 ,729 ,1272 ,0,3,1,3,0,1,0,76.14,57.31 ,33.33
03,021,01,004,0164,289,863 ,8 ,871 ,1485 ,0,3,1,3,0,1,0,76.14,58.65 ,33.33
03,021,01,004,0164,290,999 ,5 ,1004 ,1787 ,0,3,1,3,0,1,0,76.14,56.18 ,33.33
03,021,01,004,0165,291,935 ,5 ,940 ,1706 ,0,3,1,3,0,1,0,76.14,55.10 ,33.33
03,021,01,004,0165,292,731 ,5 ,736 ,1336 ,0,3,1,3,0,1,0,76.14,55.09 ,33.33
03,021,01,004,0165,293,581 ,1 ,582 ,974 ,0,3,1,3,0,1,0,76.14,59.75 ,33.33
03,021,01,004,0166,294,705 ,5 ,710 ,1207 ,0,3,1,3,0,1,0,76.14,58.82 ,33.33
03,021,01,004,0166,295,737 ,3 ,740 ,1253 ,0,3,1,3,0,1,0,76.14,59.06 ,33.33
03,021,01,005,0167,296,360 ,3 ,363 ,584 ,0,3,1,3,0,1,0,76.14,62.16 ,33.33
03,021,01,005,0168,297,1174 ,9 ,1183 ,2062 ,0,3,1,3,0,1,0,76.14,57.37 ,33.33
03,021,01,005,0168,298,878 ,5 ,883 ,1588 ,0,3,1,3,0,1,0,76.14,55.60 ,33.33
03,021,01,005,0169,299,976 ,3 ,979 ,1642 ,0,3,1,3,0,1,0,76.14,59.62 ,33.33
03,021,01,005,0169,300,771 ,3 ,774 ,1388 ,0,3,1,3,0,1,0,76.14,55.76 ,33.33
03,021,01,005,0169,301,685 ,5 ,690 ,1237 ,0,3,1,3,0,1,0,76.14,55.78 ,33.33
03,021,01,005,0170,302,837 ,11 ,848 ,1350 ,0,3,1,3,0,1,0,76.14,62.81 ,33.33
03,021,01,005,0170,303,876 ,4 ,880 ,1413 ,0,3,1,3,0,1,0,76.14,62.28 ,33.33
03,021,01,005,0171,304,1018 ,6 ,1024 ,1599 ,0,3,1,3,0,1,0,76.14,64.04 ,33.33
03,021,01,005,0171,305,975 ,4 ,979 ,1746 ,0,3,1,3,0,1,0,76.14,56.07 ,33.33
03,021,01,005,0172,306,1060 ,7 ,1067 ,1744 ,0,3,1,3,0,1,0,76.14,61.18 ,33.33
03,021,01,005,0172,307,1074 ,5 ,1079 ,1895 ,0,3,1,3,0,1,0,76.14,56.94 ,33.33
03,021,01,005,0173,308,789 ,5 ,794 ,1194 ,0,3,1,3,0,1,0,76.14,66.50 ,33.33
03,021,01,005,0173,309,862 ,8 ,870 ,1599 ,0,3,1,3,0,1,0,76.14,54.41 ,33.33
03,021,01,005,0174,310,699 ,4 ,703 ,1115 ,0,3,1,3,0,1,0,76.14,63.05 ,33.33
03,021,01,005,0174,311,965 ,6 ,971 ,1624 ,0,3,1,3,0,1,0,76.14,59.79 ,33.33
03,021,01,005,0174,312,856 ,8 ,864 ,1445 ,0,3,1,3,0,1,0,76.14,59.79 ,33.33
03,021,01,005,0175,313,762 ,4 ,766 ,1234 ,0,3,1,3,0,1,0,76.14,62.07 ,33.33
03,021,01,005,0175,314,792 ,5 ,797 ,1298 ,0,3,1,3,0,1,0,76.14,61.40 ,33.33
03,021,01,005,0176,315,1155 ,5 ,1160 ,1947 ,0,3,1,3,0,1,0,76.14,59.58 ,33.33
03,021,01,005,0177,316,1380 ,8 ,1388 ,2171 ,0,3,1,3,0,1,0,76.14,63.93 ,33.33
03,021,01,005,0178,317,1344 ,9 ,1353 ,2223 ,0,3,1,3,0,1,0,76.14,60.86 ,33.33
03,021,01,005,0178,318,922 ,9 ,931 ,1621 ,0,3,1,3,0,1,0,76.14,57.43 ,33.33
03,021,01,005,0179,319,804 ,7 ,811 ,1313 ,0,3,1,3,0,1,0,76.14,61.77 ,33.33
03,021,01,005,0179,320,758 ,1 ,759 ,1218 ,0,3,1,3,0,1,0,76.14,62.32 ,33.33
03,021,01,005,0180,321,1040 ,7 ,1047 ,1953 ,0,3,1,3,0,1,0,76.14,53.61 ,33.33
03,021,01,005,0180,322,904 ,7 ,911 ,1769 ,0,3,1,3,0,1,0,76.14,51.50 ,33.33
03,021,01,005,0181,323,848 ,5 ,853 ,1524 ,0,3,1,3,0,1,0,76.14,55.97 ,33.33
03,021,01,005,0181,324,872 ,4 ,876 ,1637 ,0,3,1,3,0,1,0,76.14,53.51 ,33.33
03,021,01,005,0182,325,1029 ,8 ,1037 ,1754 ,0,3,1,3,0,1,0,76.14,59.12 ,33.33
03,021,01,005,0182,326,997 ,3 ,1000 ,1794 ,0,3,1,3,0,1,0,76.14,55.74 ,33.33
03,021,01,005,0183,327,856 ,10 ,866 ,1537 ,0,3,1,3,0,1,0,76.14,56.34 ,33.33
03,021,01,005,0183,328,861 ,6 ,867 ,1496 ,0,3,1,3,0,1,0,76.14,57.95 ,33.33
03,021,01,005,0184,329,1008 ,7 ,1015 ,1503 ,0,3,1,3,0,1,0,76.14,67.53 ,33.33
03,021,01,005,0185,330,884 ,1 ,885 ,1561 ,0,3,1,3,0,1,0,76.14,56.69 ,33.33
03,021,01,005,0185,331,1004 ,7 ,1011 ,1750 ,0,3,1,3,0,1,0,76.14,57.77 ,33.33
03,021,01,005,0186,332,690 ,4 ,694 ,1042 ,0,3,1,3,0,1,0,76.14,66.60 ,33.33
03,021,01,005,0187,333,749 ,2 ,751 ,1301 ,0,3,1,3,0,1,0,76.14,57.72 ,33.33
03,021,01,005,0188,334,1105 ,7 ,1112 ,1701 ,0,3,1,3,0,1,0,76.14,65.37 ,33.33
03,021,01,005,0189,335,800 ,3 ,803 ,1333 ,0,3,1,3,0,1,0,76.14,60.24 ,33.33
03,021,01,005,0190,336,1051 ,7 ,1058 ,1810 ,0,3,1,3,0,1,0,76.14,58.45 ,33.33
03,021,01,005,0191,337,638 ,0 ,638 ,825 ,0,3,1,3,0,1,0,76.14,77.33 ,33.33
03,021,01,005,0192,338,633 ,4 ,637 ,1062 ,0,3,1,3,0,1,0,76.14,59.98 ,33.33
03,021,01,005,0192,339,684 ,1 ,685 ,1171 ,0,3,1,3,0,1,0,76.14,58.50 ,33.33
03,021,01,005,0193,340,930 ,4 ,934 ,1480 ,0,3,1,3,0,1,0,76.14,63.11 ,33.33
03,021,01,005,0194,341,593 ,3 ,596 ,1036 ,0,3,1,3,0,1,0,76.14,57.53 ,33.33
03,021,01,005,0194,342,828 ,6 ,834 ,1407 ,0,3,1,3,0,1,0,76.14,59.28 ,33.33
03,021,01,005,0195,343,715 ,2 ,717 ,1179 ,0,3,1,3,0,1,0,76.14,60.81 ,33.33
03,021,01,005,0195,344,650 ,6 ,656 ,1142 ,0,3,1,3,0,1,0,76.14,57.44 ,33.33
03,021,01,005,0196,345,1053 ,9 ,1062 ,1895 ,0,3,1,3,0,1,0,76.14,56.04 ,33.33
03,021,01,005,0196,346,942 ,5 ,947 ,1718 ,0,3,1,3,0,1,0,76.14,55.12 ,33.33
03,021,01,005,0197,347,751 ,6 ,757 ,1338 ,0,3,1,3,0,1,0,76.14,56.58 ,33.33
03,021,01,005,0197,348,675 ,5 ,680 ,1182 ,0,3,1,3,0,1,0,76.14,57.53 ,33.33
03,021,01,005,0197,349,684 ,4 ,688 ,1579 ,0,3,1,3,0,1,0,76.14,43.57 ,33.33
03,021,01,005,0198,350,763 ,7 ,770 ,1368 ,0,3,1,3,0,1,0,76.14,56.29 ,33.33
03,021,01,005,0198,351,976 ,7 ,983 ,1657 ,0,3,1,3,0,1,0,76.14,59.32 ,33.33
03,021,01,005,0199,352,838 ,8 ,846 ,1491 ,0,3,1,3,0,1,0,76.14,56.74 ,33.33
03,021,01,005,0199,353,682 ,5 ,687 ,1211 ,0,3,1,3,0,1,0,76.14,56.73 ,33.33
03,021,01,005,0200,354,868 ,1 ,869 ,1396 ,0,3,1,3,0,1,0,76.14,62.25 ,33.33
03,021,01,005,0200,355,855 ,3 ,858 ,1448 ,0,3,1,3,0,1,0,76.14,59.25 ,33.33
03,021,01,005,0201,356,1143 ,9 ,1152 ,1958 ,0,3,1,3,0,1,0,76.14,58.84 ,33.33
03,021,01,005,0201,357,1207 ,7 ,1214 ,1972 ,0,3,1,3,0,1,0,76.14,61.56 ,33.33
03,021,01,005,0202,358,1029 ,3 ,1032 ,1677 ,0,3,1,3,0,1,0,76.14,61.54 ,33.33
03,021,01,005,0203,359,516 ,3 ,519 ,849 ,0,3,1,3,0,1,0,76.14,61.13 ,33.33
03,021,01,005,0203,360,1137 ,9 ,1146 ,1926 ,0,3,1,3,0,1,0,76.14,59.50 ,33.33
03,021,01,005,0204,361,1148 ,10 ,1158 ,2045 ,0,3,1,3,0,1,0,76.14,56.63 ,33.33
03,021,01,005,0204,362,1232 ,9 ,1241 ,2126 ,0,3,1,3,0,1,0,76.14,58.37 ,33.33
03,021,01,005,0205,363,881 ,9 ,890 ,1489 ,0,3,1,3,0,1,0,76.14,59.77 ,33.33
03,021,01,005,0205,364,1237 ,8 ,1245 ,1962 ,0,3,1,3,0,1,0,76.14,63.46 ,33.33
03,021,01,005,0206,365,637 ,5 ,642 ,1017 ,0,3,1,3,0,1,0,76.14,63.13 ,33.33
03,021,01,005,0206,366,643 ,3 ,646 ,958 ,0,3,1,3,0,1,0,76.14,67.43 ,33.33
03,021,01,005,0207,367,862 ,2 ,864 ,1378 ,0,3,1,3,0,1,0,76.14,62.70 ,33.33
03,021,01,005,0208,368,1100 ,7 ,1107 ,1632 ,0,3,1,3,0,1,0,76.14,67.83 ,33.33
03,021,01,005,0208,369,523 ,2 ,525 ,772 ,0,3,1,3,0,1,0,76.14,68.01 ,33.33
03,021,01,005,0209,370,822 ,3 ,825 ,1283 ,0,3,1,3,0,1,0,76.14,64.30 ,33.33
03,021,01,005,0210,371,706 ,8 ,714 ,1023 ,0,3,1,3,0,1,0,76.14,69.79 ,33.33
03,021,01,005,0211,372,850 ,4 ,854 ,1217 ,0,3,1,3,0,1,0,76.14,70.17 ,33.33
03,021,01,005,0212,373,700 ,1 ,701 ,886 ,0,3,1,3,0,1,0,76.14,79.12 ,33.33
03,021,01,005,0213,374,335 ,2 ,337 ,497 ,0,3,1,3,0,1,0,76.14,67.81 ,33.33
03,021,01,005,0213,375,385 ,2 ,387 ,562 ,0,3,1,3,0,1,0,76.14,68.86 ,33.33
03,021,01,005,0214,376,715 ,1 ,716 ,1089 ,0,3,1,3,0,1,0,76.14,65.75 ,33.33
03,021,01,005,0215,377,399 ,0 ,399 ,642 ,0,3,1,3,0,1,0,76.14,62.15 ,33.33
03,021,01,005,0216,378,984 ,2 ,986 ,1433 ,0,3,1,3,0,1,0,76.14,68.81 ,33.33
03,021,01,005,0217,379,402 ,0 ,402 ,551 ,0,3,1,3,0,1,0,76.14,72.96 ,33.33
03,021,01,006,0218,380,808 ,2 ,810 ,1460 ,0,3,1,3,0,1,0,76.14,55.48 ,33.33
03,021,01,006,0218,381,913 ,9 ,922 ,1495 ,0,3,1,3,0,1,0,76.14,61.67 ,33.33
03,021,01,006,0219,382,1182 ,8 ,1190 ,2276 ,0,3,1,3,0,1,0,76.14,52.28 ,33.33
03,021,01,006,0220,383,879 ,6 ,885 ,1435 ,0,3,1,3,0,1,0,76.14,61.67 ,33.33
03,021,01,006,0221,384,900 ,3 ,903 ,1493 ,0,3,1,3,0,1,0,76.14,60.48 ,33.33
03,021,01,006,0222,385,1206 ,7 ,1213 ,1943 ,0,3,1,3,0,1,0,76.14,62.43 ,33.33
03,021,01,006,0223,386,877 ,7 ,884 ,1502 ,0,3,1,3,0,1,0,76.14,58.85 ,33.33
03,021,01,006,0224,387,360 ,1 ,361 ,518 ,0,3,1,3,0,1,0,76.14,69.69 ,33.33
03,021,01,006,0225,388,795 ,1 ,796 ,1477 ,0,3,1,3,0,1,0,76.14,53.89 ,33.33
03,021,01,006,0226,389,908 ,4 ,912 ,2030 ,0,3,1,3,0,1,0,76.14,44.93 ,33.33
03,021,01,006,0226,390,948 ,4 ,952 ,1916 ,0,3,1,3,0,1,0,76.14,49.69 ,33.33
03,021,01,006,0227,391,738 ,3 ,741 ,1497 ,0,3,1,3,0,1,0,76.14,49.50 ,33.33
03,021,01,006,0227,392,809 ,2 ,811 ,1729 ,0,3,1,3,0,1,0,76.14,46.91 ,33.33
03,021,01,006,0227,393,799 ,7 ,806 ,1726 ,0,3,1,3,0,1,0,76.14,46.70 ,33.33
03,021,01,006,0228,394,960 ,7 ,967 ,1833 ,0,3,1,3,0,1,0,76.14,52.76 ,33.33
03,021,01,006,0228,395,934 ,7 ,941 ,1850 ,0,3,1,3,0,1,0,76.14,50.86 ,33.33
03,021,01,006,0229,396,607 ,2 ,609 ,1316 ,0,3,1,3,0,1,0,76.14,46.28 ,33.33
03,021,01,006,0229,397,710 ,3 ,713 ,1355 ,0,3,1,3,0,1,0,76.14,52.62 ,33.33
03,021,01,006,0230,398,1015 ,2 ,1017 ,1819 ,0,3,1,3,0,1,0,76.14,55.91 ,33.33
03,021,01,006,0230,399,754 ,7 ,761 ,1734 ,0,3,1,3,0,1,0,76.14,43.89 ,33.33
03,021,01,006,0231,400,807 ,5 ,812 ,1528 ,0,3,1,3,0,1,0,76.14,53.14 ,33.33
03,021,01,006,0231,401,854 ,4 ,858 ,1610 ,0,3,1,3,0,1,0,76.14,53.29 ,33.33
03,021,01,006,0232,402,875 ,3 ,878 ,1570 ,0,3,1,3,0,1,0,76.14,55.92 ,33.33
03,021,01,006,0232,403,889 ,1 ,890 ,1648 ,0,3,1,3,0,1,0,76.14,54.00 ,33.33
04,001,01,001,0001,1,509 ,11 ,520 ,1051 ,0,3,1,3,0,1,0,76.14,49.48 ,33.33
04,001,01,001,0001,2,529 ,3 ,532 ,1157 ,0,3,1,3,0,1,0,76.14,45.98 ,33.33
04,001,01,001,0002,3,505 ,8 ,513 ,1096 ,0,3,1,3,0,1,0,76.14,46.81 ,33.33
04,001,01,001,0002,4,643 ,5 ,648 ,1434 ,0,3,1,3,0,1,0,76.14,45.19 ,33.33
04,001,01,001,0003,5,546 ,7 ,553 ,1172 ,0,3,1,3,0,1,0,76.14,47.18 ,33.33
04,001,01,001,0003,6,585 ,7 ,592 ,1292 ,0,3,1,3,0,1,0,76.14,45.82 ,33.33
04,001,01,001,0003,7,845 ,9 ,854 ,1731 ,0,3,1,3,0,1,0,76.14,49.34 ,33.33
04,001,01,001,0004,8,814 ,11 ,825 ,1778 ,0,3,1,3,0,1,0,76.14,46.40 ,33.33
04,001,01,001,0005,9,658 ,10 ,668 ,1480 ,0,3,1,3,0,1,0,76.14,45.14 ,33.33
04,001,01,001,0006,10,418 ,4 ,422 ,795 ,0,3,1,3,0,1,0,76.14,53.08 ,33.33
04,001,01,001,0007,11,729 ,9 ,738 ,1467 ,0,3,1,3,0,1,0,76.14,50.31 ,33.33
04,001,01,001,0008,12,440 ,4 ,444 ,943 ,0,3,1,3,0,1,0,76.14,47.08 ,33.33
04,001,01,002,0009,13,655 ,13 ,668 ,1328 ,0,3,1,3,0,1,0,76.14,50.30 ,33.33
04,001,01,002,0010,14,871 ,17 ,888 ,1670 ,0,3,1,3,0,1,0,76.14,53.17,33.33
04,001,01,002,0011,15,791 ,13 ,804 ,1683 ,0,3,1,3,0,1,0,76.14,47.77,33.33
04,001,01,002,0012,16,778 ,10 ,788 ,1718 ,0,3,1,3,0,1,0,76.14,45.87,33.33
04,001,01,002,0013,17,654 ,8 ,662 ,1398 ,0,3,1,3,0,1,0,76.14,47.35,33.33
04,001,01,002,0014,18,295 ,4 ,299 ,564 ,0,3,1,3,0,1,0,76.14,53.01,33.33
04,001,01,003,0015,19,507 ,6 ,513 ,972 ,0,3,1,3,0,1,0,76.14,52.78,33.33
04,001,01,003,0015,20,579 ,7 ,586 ,1151 ,0,3,1,3,0,1,0,76.14,50.91,33.33
04,001,01,003,0016,21,794 ,11 ,805 ,1572 ,0,3,1,3,0,1,0,76.14,51.21,33.33
04,001,01,003,0017,22,328 ,5 ,333 ,664 ,0,3,1,3,0,1,0,76.14,50.15,33.33
04,001,01,003,0018,23,345 ,4 ,349 ,652 ,0,3,1,3,0,1,0,76.14,53.53,33.33
04,001,01,003,0019,24,368 ,1 ,369 ,718 ,0,3,1,3,0,1,0,76.14,51.39,33.33
04,001,01,003,0020,25,460 ,12 ,472 ,954 ,0,3,1,3,0,1,0,76.14,49.48,33.33
04,001,01,003,0020,26,579 ,5 ,584 ,1144 ,0,3,1,3,0,1,0,76.14,51.05,33.33
04,001,01,003,0021,27,509 ,13 ,522 ,950 ,0,3,1,3,0,1,0,76.14,54.95,33.33
04,001,01,003,0022,28,651 ,8 ,659 ,1369 ,0,3,1,3,0,1,0,76.14,48.14,33.33
04,001,01,004,0023,29,461 ,3 ,464 ,1027 ,0,3,1,3,0,1,0,76.14,45.18,33.33
04,001,01,004,0023,30,581 ,5 ,586 ,1215 ,0,3,1,3,0,1,0,76.14,48.23,33.33
04,001,01,004,0024,31,430 ,6 ,436 ,870 ,0,3,1,3,0,1,0,76.14,50.11,33.33
04,001,01,004,0025,32,448 ,8 ,456 ,965 ,0,3,1,3,0,1,0,76.14,47.25,33.33
04,001,01,004,0026,33,317 ,1 ,318 ,646 ,0,3,1,3,0,1,0,76.14,49.23,33.33
04,001,01,004,0027,34,389 ,2 ,391 ,840 ,0,3,1,3,0,1,0,76.14,46.55,33.33
04,001,01,004,0028,35,399 ,2 ,401 ,834 ,0,3,1,3,0,1,0,76.14,48.08,33.33
04,001,01,004,0029,36,296 ,3 ,299 ,499 ,0,3,1,3,0,1,0,76.14,59.92,33.33
04,001,01,004,0030,37,440 ,4 ,444 ,916 ,0,3,1,3,0,1,0,76.14,48.47,33.33
04,001,01,005,0031,38,709 ,5 ,714 ,1350 ,0,3,1,3,0,1,0,76.14,52.89,33.33
04,001,01,005,0032,39,277 ,1 ,278 ,580 ,0,3,1,3,0,1,0,76.14,47.93,33.33
04,001,01,005,0033,40,396 ,2 ,398 ,838 ,0,3,1,3,0,1,0,76.14,47.49,33.33
04,001,01,005,0034,41,280 ,1 ,281 ,579 ,0,3,1,3,0,1,0,76.14,48.53,33.33
04,001,01,005,0035,42,592 ,2 ,594 ,1125 ,0,3,1,3,0,1,0,76.14,52.8,33.33
04,001,01,006,0036,43,27 ,0 ,27 ,103 ,0,3,1,3,0,1,0,76.14,26.21,33.33
04,001,01,006,0037,44,19 ,0 ,19 ,159 ,0,3,1,3,0,1,0,76.14,11.95,33.33
04,002,01,001,0001,1,970 ,9 ,979 ,1347 ,0,3,1,3,0,1,0,76.14,72.68 ,33.33
04,002,01,001,0002,2,811 ,5 ,816 ,1210 ,0,3,1,3,0,1,0,76.14,67.44 ,33.33
04,002,01,001,0003,3,909 ,13 ,922 ,1521 ,0,3,1,3,0,1,0,76.14,60.62 ,33.33
04,002,01,002,0004,4,603 ,10 ,613 ,933 ,0,3,1,3,0,1,0,76.14,65.70 ,33.33
04,002,01,002,0005,5,271 ,6 ,277 ,438 ,0,3,1,3,0,1,0,76.14,63.24 ,33.33
04,002,01,003,0006,6,279 ,0 ,279 ,489 ,0,3,1,3,0,1,0,76.14,57.06 ,33.33
04,002,01,003,0007,7,211 ,0 ,211 ,376 ,0,3,1,3,0,1,0,76.14,56.12 ,33.33
04,002,01,004,0008,8,397 ,4 ,401 ,643 ,0,3,1,3,0,1,0,76.14,62.36 ,33.33
