00,000,00,000,0000,0,10174005,137448,10311453,15550197,21934888,434,168,353,81,131,37,70.89 ,66.31 ,38.71 
01,000,00,000,0000,0,1221302,11979,1233281,1914578,2630572,69,20,53,16,13,7,72.78 ,64.42 ,28.99 
01,000,01,000,0000,0,619102,6275,625377,972088,1348417,32,10,25,7,6,4,72.09 ,64.33 ,31.25 
01,000,02,000,0000,0,602200,5704,607904,942490,1282155,37,10,28,9,7,3,73.51 ,64.50 ,27.03 
02,000,00,000,0000,0,694094,7317,701411,1061516,1486399,36,11,30,6,10,1,71.42 ,66.08 ,30.56 
02,000,01,000,0000,0,390190,3875,394065,600021,843935,17,6,13,4,5,1,71.10 ,65.68 ,35.29 
02,000,02,000,0000,0,303904,3442,307346,461495,642464,19,5,17,2,5,0,71.83 ,66.60 ,26.32 
03,001,00,000,0000,0,1686473,25379,1711852,2511073,3561286,69,27,55,14,22,5,70.51 ,68.17 ,39.13 
03,001,01,000,0000,0,498262,7886,506148,736128,1070981,23,8,19,4,7,1,68.73 ,68.76 ,34.78 
03,001,02,000,0000,0,600959,9643,610602,911610,1323146,19,10,14,5,8,2,68.90 ,66.98 ,52.63 
03,001,03,000,0000,0,587252,7850,595102,863335,1167159,27,9,22,5,7,2,73.97 ,68.93 ,33.33 
03,002,00,000,0000,0,204046,2184,206230,323032,453205,10,4,9,1,3,1,71.28 ,63.84 ,40.00 
03,003,00,000,0000,0,786642,11909,798551,1165237,1712199,26,13,21,5,10,3,68.05 ,68.53 ,50.00 
03,004,00,000,0000,0,204107,3519,207626,294030,427300,6,3,5,1,3,0,68.81 ,70.61 ,50.00 
03,005,00,000,0000,0,259114,3719,262833,390370,551050,11,4,10,1,4,0,70.84 ,67.33 ,36.36 
03,006,00,000,0000,0,661669,10325,671994,1013034,1484141,21,11,17,4,10,1,68.26 ,66.33 ,52.38 
03,007,00,000,0000,0,614430,9419,623849,915095,1308912,19,10,17,2,8,2,69.91 ,68.17 ,52.63 
03,008,00,000,0000,0,247254,2544,249798,371042,516097,11,4,10,1,4,0,71.89 ,67.32 ,36.36 
03,009,00,000,0000,0,338424,4950,343374,541514,741393,12,6,9,3,4,2,73.04 ,63.41 ,50.00 
03,010,00,000,0000,0,261700,4657,266357,411071,558373,10,4,8,2,3,1,73.62 ,64.80 ,40.00 
03,011,00,000,0000,0,532857,6203,539060,800940,1104525,20,8,17,3,7,1,72.51 ,67.30 ,40.00 
03,012,00,000,0000,0,578730,6870,585600,880896,1221189,19,9,14,5,6,3,72.13 ,66.48 ,47.37 
03,013,00,000,0000,0,409774,4721,414495,619161,855100,15,7,12,3,5,2,72.41 ,66.94 ,46.67 
03,014,00,000,0000,0,71156,1095,72251,122239,167364,5,1,5,0,1,0,73.04 ,59.11 ,20.00 
03,015,00,000,0000,0,117947,2090,120037,195975,268376,6,2,6,0,2,0,73.02 ,61.25 ,33.33 
03,016,00,000,0000,0,40022,636,40658,67168,90906,5,1,4,1,1,0,73.89 ,60.53 ,20.00 
03,017,00,000,0000,0,172074,2631,174705,276434,383292,7,3,6,1,2,1,72.12 ,63.20 ,42.86 
03,018,00,000,0000,0,161768,2422,164190,256635,369718,11,3,7,4,2,1,69.41 ,63.98 ,27.27 
03,019,00,000,0000,0,432572,6535,439107,664334,974095,20,7,17,3,5,2,68.20 ,66.10 ,35.00 
03,020,00,000,0000,0,119970,1497,121467,186527,267231,6,2,4,2,1,1,69.80 ,65.12 ,33.33 
03,021,00,000,0000,0,328303,4071,332374,522165,737788,13,6,10,3,3,3,70.77 ,63.65 ,46.15 
04,001,00,000,0000,0,25025,657,25682,39922,56093,5,1,5,0,1,0,71.17 ,64.33 ,20.00 
04,002,00,000,0000,0,4552,119,4671,6209,8284,2,1,2,0,1,0,74.95 ,75.23 ,50.00 
03,002,01,000,0000,0,204046,2184,206230,323032,453205,10,4,9,1,3,1,71.28 ,63.84 ,40.00 
03,003,01,000,0000,0,786642,11909,798551,1165237,1712199,26,13,21,5,10,3,68.05 ,68.53 ,50.00 
03,004,01,000,0000,0,204107,3519,207626,294030,427300,6,3,5,1,3,0,68.81 ,70.61 ,50.00 
03,005,01,000,0000,0,259114,3719,262833,390370,551050,11,4,10,1,4,0,70.84 ,67.33 ,36.36 
03,006,01,000,0000,0,661669,10325,671994,1013034,1484141,21,11,17,4,10,1,68.26 ,66.33 ,52.38 
03,007,01,000,0000,0,614430,9419,623849,915095,1308912,19,10,17,2,8,2,69.91 ,68.17 ,52.63 
03,008,01,000,0000,0,247254,2544,249798,371042,516097,11,4,10,1,4,0,71.89 ,67.32 ,36.36 
03,009,01,000,0000,0,338424,4950,343374,541514,741393,12,6,9,3,4,2,73.04 ,63.41 ,50.00 
03,010,01,000,0000,0,261700,4657,266357,411071,558373,10,4,8,2,3,1,73.62 ,64.80 ,40.00 
03,011,01,000,0000,0,532857,6203,539060,800940,1104525,20,8,17,3,7,1,72.51 ,67.30 ,40.00 
03,012,01,000,0000,0,578730,6870,585600,880896,1221189,19,9,14,5,6,3,72.13 ,66.48 ,47.37 
03,013,01,000,0000,0,409774,4721,414495,619161,855100,15,7,12,3,5,2,72.41 ,66.94 ,46.67 
03,014,01,000,0000,0,71156,1095,72251,122239,167364,5,1,5,0,1,0,73.04 ,59.11 ,20.00 
03,015,01,000,0000,0,117947,2090,120037,195975,268376,6,2,6,0,2,0,73.02 ,61.25 ,33.33 
03,016,01,000,0000,0,40022,636,40658,67168,90906,5,1,4,1,1,0,73.89 ,60.53 ,20.00 
03,017,01,000,0000,0,172074,2631,174705,276434,383292,7,3,6,1,2,1,72.12 ,63.20 ,42.86 
03,018,01,000,0000,0,161768,2422,164190,256635,369718,11,3,7,4,2,1,69.41 ,63.98 ,27.27 
03,019,01,000,0000,0,432572,6535,439107,664334,974095,20,7,17,3,5,2,68.20 ,66.10 ,35.00 
03,020,01,000,0000,0,119970,1497,121467,186527,267231,6,2,4,2,1,1,69.80 ,65.12 ,33.33 
03,021,01,000,0000,0,328303,4071,332374,522165,737788,13,6,10,3,3,3,70.77 ,63.65 ,46.15 
04,001,01,000,0000,0,25025,657,25682,39922,56093,5,1,5,0,1,0,71.17 ,64.33 ,20.00 
04,002,01,000,0000,0,4552,119,4671,6209,8284,2,1,2,0,1,0,74.95 ,75.23 ,50.00 
01,000,01,001,0000,0,114781,1281,116062,179032,0,3,1,3,0,1,0,77.75,64.83 ,33.33
01,000,01,002,0000,0,135918,1371,137289,213288,0,3,1,3,0,1,0,77.75,64.37 ,33.33
01,000,01,003,0000,0,110805,1088,111893,173690,0,3,1,3,0,1,0,77.75,64.42 ,33.33
01,000,01,004,0000,0,51591,640,52231,81166,0,3,1,3,0,1,0,77.75,64.35 ,33.33
01,000,01,005,0000,0,94234,757,94991,148431,0,3,1,3,0,1,0,77.75,64.00 ,33.33
01,000,01,006,0000,0,111773,1138,112911,176481,0,3,1,3,0,1,0,77.75,63.98 ,33.33
01,000,02,007,0000,0,99392,1052,100444,161246,0,3,1,3,0,1,0,77.75,62.29 ,33.33
01,000,02,008,0000,0,60837,667,61504,97304,0,3,1,3,0,1,0,77.75,63.21 ,33.33
01,000,02,009,0000,0,74595,641,75236,116208,0,3,1,3,0,1,0,77.75,64.74 ,33.33
01,000,02,010,0000,0,98868,1124,99992,153456,0,3,1,3,0,1,0,77.75,65.16 ,33.33
01,000,02,011,0000,0,149352,1082,150434,232943,0,3,1,3,0,1,0,77.75,64.58 ,33.33
01,000,02,012,0000,0,119156,1138,120294,181333,0,3,1,3,0,1,0,77.75,66.34 ,33.33
02,000,01,001,0000,0,15569,164,15733,23418,0,3,1,3,0,1,0,77.75,67.18 ,33.33
02,000,01,002,0000,0,52387,541,52928,79129,0,3,1,3,0,1,0,77.75,66.89 ,33.33
02,000,01,003,0000,0,76919,728,77647,118215,0,3,1,3,0,1,0,77.75,65.68 ,33.33
02,000,01,004,0000,0,69609,685,70294,105519,0,3,1,3,0,1,0,77.75,66.62 ,33.33
02,000,01,005,0000,0,161439,1558,162997,251000,0,3,1,3,0,1,0,77.75,64.94 ,33.33
02,000,01,006,0000,0,14267,199,14466,22740,0,3,1,3,0,1,0,77.75,63.61 ,33.33
02,000,02,007,0000,0,29528,293,29821,45447,0,3,1,3,0,1,0,77.75,65.62 ,33.33
02,000,02,008,0000,0,16287,161,16448,25138,0,3,1,3,0,1,0,77.75,65.43 ,33.33
02,000,02,009,0000,0,94858,1124,95982,145146,0,3,1,3,0,1,0,77.75,66.13 ,33.33
02,000,02,010,0000,0,95694,1066,96760,144137,0,3,1,3,0,1,0,77.75,67.13 ,33.33
02,000,02,011,0000,0,67537,798,68335,101627,0,3,1,3,0,1,0,77.75,67.24 ,33.33
03,001,01,001,0000,0,253695,4148,257843,373955,0,3,1,3,0,1,0,77.75,68.95 ,33.33
03,001,01,002,0000,0,102489,1571,104060,151943,0,3,1,3,0,1,0,77.75,68.49 ,33.33
03,001,01,003,0000,0,67791,1088,68879,101391,0,3,1,3,0,1,0,77.75,67.93 ,33.33
03,001,01,004,0000,0,36644,480,37124,53499,0,3,1,3,0,1,0,77.75,69.39 ,33.33
03,001,01,005,0000,0,37643,599,38242,55340,0,3,1,3,0,1,0,77.75,69.10 ,33.33
03,001,02,006,0000,0,180537,3023,183560,270999,0,3,1,3,0,1,0,77.75,67.73 ,33.33
03,001,02,007,0000,0,71173,1070,72243,110289,0,3,1,3,0,1,0,77.75,65.50 ,33.33
03,001,02,008,0000,0,163000,2529,165529,248791,0,3,1,3,0,1,0,77.75,66.53 ,33.33
03,001,02,009,0000,0,31342,485,31827,47141,0,3,1,3,0,1,0,77.75,67.51 ,33.33
03,001,02,010,0000,0,28943,462,29405,42095,0,3,1,3,0,1,0,77.75,69.85 ,33.33
03,001,02,011,0000,0,23061,336,23397,34162,0,3,1,3,0,1,0,77.75,68.49 ,33.33
03,001,02,012,0000,0,54584,978,55562,84378,0,3,1,3,0,1,0,77.75,65.85 ,33.33
03,001,02,013,0000,0,13606,248,13854,20151,0,3,1,3,0,1,0,77.75,68.75 ,33.33
03,001,02,014,0000,0,10575,181,10756,16225,0,3,1,3,0,1,0,77.75,66.29 ,33.33
03,001,02,015,0000,0,5450,54,5504,8182,0,3,1,3,0,1,0,77.75,67.27 ,33.33
03,001,02,016,0000,0,9886,129,10015,15233,0,3,1,3,0,1,0,77.75,65.75 ,33.33
03,001,02,017,0000,0,8802,148,8950,13964,0,3,1,3,0,1,0,77.75,64.09 ,33.33
03,001,03,018,0000,0,202235,2949,205184,293044,0,3,1,3,0,1,0,77.75,70.02 ,33.33
03,001,03,019,0000,0,115915,1432,117347,166992,0,3,1,3,0,1,0,77.75,70.27 ,33.33
03,001,03,020,0000,0,136770,1661,138431,199342,0,3,1,3,0,1,0,77.75,69.44 ,33.33
03,001,03,021,0000,0,9590,151,9741,14636,0,3,1,3,0,1,0,77.75,66.56 ,33.33
03,001,03,022,0000,0,3946,64,4010,5904,0,3,1,3,0,1,0,77.75,67.92 ,33.33
03,001,03,023,0000,0,3127,44,3171,4885,0,3,1,3,0,1,0,77.75,64.91 ,33.33
03,001,03,024,0000,0,1318,11,1329,1913,0,3,1,3,0,1,0,77.75,69.47 ,33.33
03,001,03,025,0000,0,76404,967,77371,118743,0,3,1,3,0,1,0,77.75,65.16 ,33.33
03,001,03,026,0000,0,22465,358,22823,33773,0,3,1,3,0,1,0,77.75,67.58 ,33.33
03,001,03,027,0000,0,3250,59,3309,5037,0,3,1,3,0,1,0,76.14,65.69 ,33.33
03,001,03,028,0000,0,5543,56,5599,8384,0,3,1,3,0,1,0,76.14,66.78 ,33.33
03,001,03,029,0000,0,6689,98,6787,10682,0,3,1,3,0,1,0,76.14,63.54 ,33.33
03,002,01,001,0000,0,40262,435,40697,63545,0,3,1,3,0,1,0,76.14,64.04 ,33.33
03,002,01,002,0000,0,29983,294,30277,47694,0,3,1,3,0,1,0,76.14,63.48 ,33.33
03,002,01,003,0000,0,20646,203,20849,33560,0,3,1,3,0,1,0,76.14,62.12 ,33.33
03,002,01,004,0000,0,15018,177,15195,23612,0,3,1,3,0,1,0,76.14,64.35 ,33.33
03,002,01,005,0000,0,17486,174,17660,27278,0,3,1,3,0,1,0,76.14,64.74 ,33.33
03,002,01,006,0000,0,12317,122,12439,19410,0,3,1,3,0,1,0,76.14,64.09 ,33.33
03,002,01,007,0000,0,14981,180,15161,24457,0,3,1,3,0,1,0,76.14,61.99 ,33.33
03,002,01,008,0000,0,24069,254,24323,36910,0,3,1,3,0,1,0,76.14,65.90 ,33.33
03,002,01,009,0000,0,17993,202,18195,28242,0,3,1,3,0,1,0,76.14,64.43 ,33.33
03,002,01,010,0000,0,10295,123,10418,16548,0,3,1,3,0,1,0,76.14,62.96 ,33.33
03,002,01,011,0000,0,608,9,617,1013,0,3,1,3,0,1,0,76.14,60.91 ,33.33
03,002,01,012,0000,0,388,11,399,763,0,3,1,3,0,1,0,76.14,52.29 ,33.33
03,003,01,001,0000,0,147884,1761,149645,222973,0,3,1,3,0,1,0,76.14,67.11 ,33.33
03,003,01,002,0000,0,48964,792,49756,77847,0,3,1,3,0,1,0,76.14,63.92 ,33.33
03,003,01,003,0000,0,74717,1458,76175,111279,0,3,1,3,0,1,0,76.14,68.45 ,33.33
03,003,01,004,0000,0,43323,673,43996,65682,0,3,1,3,0,1,0,76.14,66.98 ,33.33
03,003,01,005,0000,0,34707,519,35226,50657,0,3,1,3,0,1,0,76.14,69.54 ,33.33
03,003,01,006,0000,0,37771,571,38342,55111,0,3,1,3,0,1,0,76.14,69.57 ,33.33
03,003,01,007,0000,0,1768,34,1802,2741,0,3,1,3,0,1,0,76.14,65.74 ,33.33
03,003,01,008,0000,0,153110,2206,155316,222843,0,3,1,3,0,1,0,76.14,69.70 ,33.33
03,003,01,009,0000,0,87112,1437,88549,127158,0,3,1,3,0,1,0,76.14,69.64 ,33.33
03,003,01,010,0000,0,58261,978,59239,87000,0,3,1,3,0,1,0,76.14,68.09 ,33.33
03,003,01,011,0000,0,47552,770,48322,70765,0,3,1,3,0,1,0,76.14,68.29 ,33.33
03,003,01,012,0000,0,25288,326,25614,34493,0,3,1,3,0,1,0,76.14,74.26 ,33.33
03,003,01,013,0000,0,26185,384,26569,36688,0,3,1,3,0,1,0,76.14,72.42 ,33.33
03,004,01,001,0000,0,40436,750,41186,60991,0,3,1,3,0,1,0,76.14,67.53 ,33.33
03,004,01,002,0000,0,41578,688,42266,59165,0,3,1,3,0,1,0,76.14,71.44 ,33.33
03,004,01,003,0000,0,18853,342,19195,26189,0,3,1,3,0,1,0,76.14,73.29 ,33.33
03,004,01,004,0000,0,16691,271,16962,23184,0,3,1,3,0,1,0,76.14,73.16 ,33.33
03,004,01,005,0000,0,30992,548,31540,45384,0,3,1,3,0,1,0,76.14,69.50 ,33.33
03,004,01,006,0000,0,20555,352,20907,30670,0,3,1,3,0,1,0,76.14,68.17 ,33.33
03,004,01,007,0000,0,10554,172,10726,14459,0,3,1,3,0,1,0,76.14,74.18 ,33.33
03,004,01,008,0000,0,8051,131,8182,10939,0,3,1,3,0,1,0,76.14,74.80 ,33.33
03,004,01,009,0000,0,5496,97,5593,7593,0,3,1,3,0,1,0,76.14,73.66 ,33.33
03,004,01,010,0000,0,6381,98,6479,9119,0,3,1,3,0,1,0,76.14,71.05 ,33.33
03,004,01,011,0000,0,3633,53,3686,4913,0,3,1,3,0,1,0,76.14,75.03 ,33.33
03,004,01,012,0000,0,638,15,653,989,0,3,1,3,0,1,0,76.14,66.03 ,33.33
03,004,01,013,0000,0,249,2,251,435,0,3,1,3,0,1,0,76.14,57.70 ,33.33
03,005,01,001,0000,0,42190,687,42877,63799,0,3,1,3,0,1,0,76.14,67.21 ,33.33
03,005,01,002,0000,0,22499,283,22782,34512,0,3,1,3,0,1,0,76.14,66.01 ,33.33
03,005,01,003,0000,0,20187,206,20393,29641,0,3,1,3,0,1,0,76.14,68.80 ,33.33
03,005,01,004,0000,0,31213,434,31647,47791,0,3,1,3,0,1,0,76.14,66.22 ,33.33
03,005,01,005,0000,0,39710,511,40221,60515,0,3,1,3,0,1,0,76.14,66.46 ,33.33
03,005,01,006,0000,0,19602,320,19922,30454,0,3,1,3,0,1,0,76.14,65.42 ,33.33
03,005,01,007,0000,0,9857,149,10006,14163,0,3,1,3,0,1,0,76.14,70.65 ,33.33
03,005,01,008,0000,0,8233,120,8353,12610,0,3,1,3,0,1,0,76.14,66.24 ,33.33
03,005,01,009,0000,0,16803,315,17118,24345,0,3,1,3,0,1,0,76.14,70.31 ,33.33
03,005,01,010,0000,0,9943,145,10088,14836,0,3,1,3,0,1,0,76.14,68.00 ,33.33
03,005,01,011,0000,0,5030,63,5093,7732,0,3,1,3,0,1,0,76.14,65.87 ,33.33
03,005,01,012,0000,0,6293,81,6374,9098,0,3,1,3,0,1,0,76.14,70.06 ,33.33
03,005,01,013,0000,0,8599,144,8743,12592,0,3,1,3,0,1,0,76.14,69.43 ,33.33
03,005,01,014,0000,0,4348,75,4423,6570,0,3,1,3,0,1,0,76.14,67.32 ,33.33
03,005,01,015,0000,0,6930,95,7025,10203,0,3,1,3,0,1,0,76.14,68.85 ,33.33
03,005,01,016,0000,0,3903,36,3939,5772,0,3,1,3,0,1,0,76.14,68.24 ,33.33
03,005,01,017,0000,0,2813,41,2854,4257,0,3,1,3,0,1,0,76.14,67.04 ,33.33
03,005,01,018,0000,0,961,14,975,1480,0,3,1,3,0,1,0,76.14,65.88 ,33.33
03,006,01,001,0000,0,72203,1066,73269,109640,0,3,1,3,0,1,0,76.14,66.83 ,33.33
03,006,01,002,0000,0,26971,438,27409,41270,0,3,1,3,0,1,0,76.14,66.41 ,33.33
03,006,01,003,0000,0,34511,529,35040,52390,0,3,1,3,0,1,0,76.14,66.88 ,33.33
03,006,01,004,0000,0,37864,591,38455,58735,0,3,1,3,0,1,0,76.14,65.47 ,33.33
03,006,01,005,0000,0,33435,556,33991,49421,0,3,1,3,0,1,0,76.14,68.78 ,33.33
03,006,01,006,0000,0,23847,467,24314,33720,0,3,1,3,0,1,0,76.14,72.11 ,33.33
03,006,01,007,0000,0,26900,489,27389,38754,0,3,1,3,0,1,0,76.14,70.67 ,33.33
03,006,01,008,0000,0,28800,483,29283,42722,0,3,1,3,0,1,0,76.14,68.54 ,33.33
03,006,01,009,0000,0,37904,593,38497,60512,0,3,1,3,0,1,0,76.14,63.62 ,33.33
03,006,01,010,0000,0,33327,533,33860,52676,0,3,1,3,0,1,0,76.14,64.28 ,33.33
03,006,01,011,0000,0,13300,269,13569,19521,0,3,1,3,0,1,0,76.14,69.51 ,33.33
03,006,01,012,0000,0,7649,137,7786,11228,0,3,1,3,0,1,0,76.14,69.34 ,33.33
03,006,01,013,0000,0,14575,240,14815,21657,0,3,1,3,0,1,0,76.14,68.41 ,33.33
03,006,01,014,0000,0,10734,147,10881,15189,0,3,1,3,0,1,0,76.14,71.64 ,33.33
03,006,01,015,0000,0,29511,466,29977,44284,0,3,1,3,0,1,0,76.14,67.69 ,33.33
03,006,01,016,0000,0,25270,363,25633,36872,0,3,1,3,0,1,0,76.14,69.52 ,33.33
03,006,01,017,0000,0,29392,474,29866,44605,0,3,1,3,0,1,0,76.14,66.96 ,33.33
03,006,01,018,0000,0,30130,441,30571,45731,0,3,1,3,0,1,0,76.14,66.85 ,33.33
03,006,01,019,0000,0,69677,1101,70778,111981,0,3,1,3,0,1,0,76.14,63.21 ,33.33
03,006,01,020,0000,0,72260,891,73151,116057,0,3,1,3,0,1,0,76.14,63.03 ,33.33
03,006,01,021,0000,0,3409,51,3460,6069,0,3,1,3,0,1,0,76.14,57.01 ,33.33
03,007,01,001,0000,0,105578,1600,107178,157330,0,3,1,3,0,1,0,76.14,68.12 ,33.33
03,007,01,002,0000,0,21694,340,22034,31775,0,3,1,3,0,1,0,76.14,69.34 ,33.33
03,007,01,003,0000,0,12636,206,12842,19188,0,3,1,3,0,1,0,76.14,66.93 ,33.33
03,007,01,004,0000,0,38554,582,39136,57039,0,3,1,3,0,1,0,76.14,68.61 ,33.33
03,007,01,005,0000,0,24013,353,24366,33327,0,3,1,3,0,1,0,76.14,73.11 ,33.33
03,007,01,006,0000,0,18207,272,18479,25822,0,3,1,3,0,1,0,76.14,71.56 ,33.33
03,007,01,007,0000,0,40131,690,40821,59199,0,3,1,3,0,1,0,76.14,68.96 ,33.33
03,007,01,008,0000,0,7857,133,7990,11639,0,3,1,3,0,1,0,76.14,68.65 ,33.33
03,007,01,009,0000,0,15396,221,15617,23005,0,3,1,3,0,1,0,76.14,67.89 ,33.33
03,007,01,010,0000,0,56977,728,57705,86089,0,3,1,3,0,1,0,76.14,67.03 ,33.33
03,007,01,011,0000,0,17118,239,17357,25291,0,3,1,3,0,1,0,76.14,68.63 ,33.33
03,007,01,012,0000,0,19858,282,20140,28288,0,3,1,3,0,1,0,76.14,71.20 ,33.33
03,007,01,013,0000,0,25245,311,25556,37507,0,3,1,3,0,1,0,76.14,68.14 ,33.33
03,007,01,014,0000,0,17817,280,18097,25271,0,3,1,3,0,1,0,76.14,71.61 ,33.33
03,007,01,015,0000,0,17026,257,17283,24621,0,3,1,3,0,1,0,76.14,70.20 ,33.33
03,007,01,016,0000,0,22393,366,22759,33462,0,3,1,3,0,1,0,76.14,68.01 ,33.33
03,007,01,017,0000,0,22206,335,22541,31674,0,3,1,3,0,1,0,76.14,71.17 ,33.33
03,007,01,018,0000,0,9694,108,9802,13693,0,3,1,3,0,1,0,76.14,71.58 ,33.33
03,007,01,019,0000,0,15763,245,16008,23591,0,3,1,3,0,1,0,76.14,67.86 ,33.33
03,007,01,020,0000,0,15144,280,15424,24058,0,3,1,3,0,1,0,76.14,64.11 ,33.33
03,007,01,021,0000,0,14178,246,14424,20902,0,3,1,3,0,1,0,76.14,69.01 ,33.33
03,007,01,022,0000,0,14920,310,15230,23396,0,3,1,3,0,1,0,76.14,65.10 ,33.33
03,007,01,023,0000,0,25744,469,26213,40120,0,3,1,3,0,1,0,76.14,65.34 ,33.33
03,007,01,024,0000,0,18291,317,18608,29305,0,3,1,3,0,1,0,76.14,63.50 ,33.33
03,007,01,025,0000,0,9952,151,10103,16520,0,3,1,3,0,1,0,76.14,61.16 ,33.33
03,007,01,026,0000,0,8038,98,8136,12983,0,3,1,3,0,1,0,76.14,62.67 ,33.33
03,008,01,001,0000,0,49556,388,49944,71696,0,3,1,3,0,1,0,76.14,69.66 ,33.33
03,008,01,002,0000,0,39878,456,40334,61422,0,3,1,3,0,1,0,76.14,65.67 ,33.33
03,008,01,003,0000,0,47679,461,48140,68461,0,3,1,3,0,1,0,76.14,70.32 ,33.33
03,008,01,004,0000,0,28879,316,29195,44154,0,3,1,3,0,1,0,76.14,66.12 ,33.33
03,008,01,005,0000,0,6200,76,6276,9129,0,3,1,3,0,1,0,76.14,68.75 ,33.33
03,008,01,006,0000,0,20662,243,20905,31046,0,3,1,3,0,1,0,76.14,67.34 ,33.33
03,008,01,007,0000,0,9970,106,10076,15461,0,3,1,3,0,1,0,76.14,65.17 ,33.33
03,008,01,008,0000,0,8872,107,8979,13560,0,3,1,3,0,1,0,76.14,66.22 ,33.33
03,008,01,009,0000,0,8298,81,8379,13292,0,3,1,3,0,1,0,76.14,63.04 ,33.33
03,008,01,010,0000,0,10956,121,11077,17482,0,3,1,3,0,1,0,76.14,63.36 ,33.33
03,008,01,011,0000,0,10800,124,10924,16640,0,3,1,3,0,1,0,76.14,65.65 ,33.33
03,008,01,012,0000,0,3978,31,4009,6042,0,3,1,3,0,1,0,76.14,66.35 ,33.33
03,008,01,013,0000,0,1526,34,1560,2657,0,3,1,3,0,1,0,76.14,58.71 ,33.33
03,009,01,001,0000,0,46197,662,46859,69810,0,3,1,3,0,1,0,76.14,67.12 ,33.33
03,009,01,002,0000,0,22899,298,23197,34369,0,3,1,3,0,1,0,76.14,67.49 ,33.33
03,009,01,003,0000,0,30346,459,30805,48184,0,3,1,3,0,1,0,76.14,63.93 ,33.33
03,009,01,004,0000,0,21972,273,22245,35917,0,3,1,3,0,1,0,76.14,61.93 ,33.33
03,009,01,005,0000,0,15406,252,15658,23565,0,3,1,3,0,1,0,76.14,66.45 ,33.33
03,009,01,006,0000,0,21600,333,21933,33626,0,3,1,3,0,1,0,76.14,65.23 ,33.33
03,009,01,007,0000,0,17413,237,17650,26445,0,3,1,3,0,1,0,76.14,66.74 ,33.33
03,009,01,008,0000,0,11151,145,11296,17055,0,3,1,3,0,1,0,76.14,66.23 ,33.33
03,009,01,009,0000,0,15312,205,15517,23115,0,3,1,3,0,1,0,76.14,67.13 ,33.33
03,009,01,010,0000,0,10216,165,10381,15070,0,3,1,3,0,1,0,76.14,68.89 ,33.33
03,009,01,011,0000,0,14837,175,15012,24257,0,3,1,3,0,1,0,76.14,61.89 ,33.33
03,009,01,012,0000,0,13319,193,13512,21841,0,3,1,3,0,1,0,76.14,61.87 ,33.33
03,009,01,013,0000,0,13866,210,14076,23483,0,3,1,3,0,1,0,76.14,59.94 ,33.33
03,009,01,014,0000,0,8355,148,8503,14562,0,3,1,3,0,1,0,76.14,58.39 ,33.33
03,009,01,015,0000,0,7309,107,7416,11333,0,3,1,3,0,1,0,76.14,65.44 ,33.33
03,009,01,016,0000,0,12571,201,12772,21830,0,3,1,3,0,1,0,76.14,58.51 ,33.33
03,009,01,017,0000,0,14191,193,14384,24651,0,3,1,3,0,1,0,76.14,58.35 ,33.33
03,009,01,018,0000,0,11975,217,12192,22979,0,3,1,3,0,1,0,76.14,53.06 ,33.33
03,009,01,019,0000,0,14206,220,14426,24458,0,3,1,3,0,1,0,76.14,58.98 ,33.33
03,009,01,020,0000,0,15283,257,15540,24964,0,3,1,3,0,1,0,76.14,62.25 ,33.33
03,010,01,001,0000,0,14750,336,15086,22912,0,3,1,3,0,1,0,76.14,65.84 ,33.33
03,010,01,002,0000,0,20810,365,21175,31712,0,3,1,3,0,1,0,76.14,66.77 ,33.33
03,010,01,003,0000,0,15901,290,16191,25265,0,3,1,3,0,1,0,76.14,64.08 ,33.33
03,010,01,004,0000,0,16902,285,17187,26500,0,3,1,3,0,1,0,76.14,64.86 ,33.33
03,010,01,005,0000,0,31754,499,32253,49652,0,3,1,3,0,1,0,76.14,64.96 ,33.33
03,010,01,006,0000,0,8632,130,8762,13581,0,3,1,3,0,1,0,76.14,64.52 ,33.33
03,010,01,007,0000,0,16043,256,16299,26332,0,3,1,3,0,1,0,76.14,61.90 ,33.33
03,010,01,008,0000,0,13357,266,13623,22632,0,3,1,3,0,1,0,76.14,60.19 ,33.33
03,010,01,009,0000,0,15164,348,15512,23600,0,3,1,3,0,1,0,76.14,65.73 ,33.33
03,010,01,010,0000,0,13257,296,13553,18834,0,3,1,3,0,1,0,76.14,71.96 ,33.33
03,010,01,011,0000,0,8974,176,9150,14112,0,3,1,3,0,1,0,76.14,64.84 ,33.33
03,010,01,012,0000,0,26262,514,26776,40463,0,3,1,3,0,1,0,76.14,66.17 ,33.33
03,010,01,013,0000,0,21401,328,21729,34519,0,3,1,3,0,1,0,76.14,62.95 ,33.33
03,010,01,014,0000,0,19224,255,19479,29977,0,3,1,3,0,1,0,76.14,64.98 ,33.33
03,010,01,015,0000,0,10935,156,11091,17224,0,3,1,3,0,1,0,76.14,64.39 ,33.33
03,010,01,016,0000,0,5633,110,5743,8953,0,3,1,3,0,1,0,76.14,64.15 ,33.33
03,010,01,017,0000,0,1676,24,1700,2983,0,3,1,3,0,1,0,76.14,56.99 ,33.33
03,010,01,018,0000,0,1025,23,1048,1820,0,3,1,3,0,1,0,76.14,57.58 ,33.33
03,011,01,001,0000,0,34089,413,34502,54170,0,3,1,3,0,1,0,76.14,63.69 ,33.33
03,011,01,002,0000,0,13816,179,13995,21543,0,3,1,3,0,1,0,76.14,64.96 ,33.33
03,011,01,003,0000,0,16702,264,16966,26506,0,3,1,3,0,1,0,76.14,64.01 ,33.33
03,011,01,004,0000,0,12215,164,12379,18012,0,3,1,3,0,1,0,76.14,68.73 ,33.33
03,011,01,005,0000,0,14206,208,14414,21680,0,3,1,3,0,1,0,76.14,66.49 ,33.33
03,011,01,006,0000,0,11916,117,12033,19285,0,3,1,3,0,1,0,76.14,62.40 ,33.33
03,011,01,007,0000,0,24357,253,24610,34681,0,3,1,3,0,1,0,76.14,70.96 ,33.33
03,011,01,008,0000,0,14219,162,14381,20742,0,3,1,3,0,1,0,76.14,69.33 ,33.33
03,011,01,009,0000,0,11939,155,12094,17942,0,3,1,3,0,1,0,76.14,67.41 ,33.33
03,011,01,010,0000,0,12107,148,12255,17619,0,3,1,3,0,1,0,76.14,69.56 ,33.33
03,011,01,011,0000,0,6217,63,6280,9612,0,3,1,3,0,1,0,76.14,65.33 ,33.33
03,011,01,012,0000,0,28839,292,29131,41519,0,3,1,3,0,1,0,76.14,70.16 ,33.33
03,011,01,013,0000,0,14658,144,14802,21988,0,3,1,3,0,1,0,76.14,67.32 ,33.33
03,011,01,014,0000,0,13353,150,13503,18741,0,3,1,3,0,1,0,76.14,72.05 ,33.33
03,011,01,015,0000,0,13623,199,13822,20005,0,3,1,3,0,1,0,76.14,69.09 ,33.33
03,011,01,016,0000,0,12091,117,12208,18312,0,3,1,3,0,1,0,76.14,66.67 ,33.33
03,011,01,017,0000,0,6769,76,6845,10358,0,3,1,3,0,1,0,76.14,66.08 ,33.33
03,011,01,018,0000,0,22073,268,22341,32527,0,3,1,3,0,1,0,76.14,68.68 ,33.33
03,011,01,019,0000,0,20893,264,21157,30508,0,3,1,3,0,1,0,76.14,69.35 ,33.33
03,011,01,020,0000,0,16338,196,16534,23822,0,3,1,3,0,1,0,76.14,69.41 ,33.33
03,011,01,021,0000,0,15603,189,15792,21672,0,3,1,3,0,1,0,76.14,72.87 ,33.33
03,011,01,022,0000,0,4221,54,4275,6171,0,3,1,3,0,1,0,76.14,69.28 ,33.33
03,011,01,023,0000,0,8607,97,8704,12657,0,3,1,3,0,1,0,76.14,68.77 ,33.33
03,011,01,024,0000,0,6170,76,6246,9129,0,3,1,3,0,1,0,76.14,68.42 ,33.33
03,011,01,025,0000,0,5054,45,5099,7455,0,3,1,3,0,1,0,76.14,68.40 ,33.33
03,011,01,026,0000,0,3390,36,3426,5003,0,3,1,3,0,1,0,76.14,68.48 ,33.33
03,011,01,027,0000,0,31854,419,32273,48260,0,3,1,3,0,1,0,76.14,66.87 ,33.33
03,011,01,028,0000,0,29569,307,29876,43988,0,3,1,3,0,1,0,76.14,67.92 ,33.33
03,011,01,029,0000,0,20459,161,20620,28238,0,3,1,3,0,1,0,76.14,73.02 ,33.33
03,011,01,030,0000,0,2678,22,2700,3717,0,3,1,3,0,1,0,76.14,72.64 ,33.33
03,011,01,031,0000,0,84832,965,85797,135078,0,3,1,3,0,1,0,76.14,63.52 ,33.33
03,012,01,001,0000,0,144109,1606,145715,228524,0,3,1,3,0,1,0,76.14,63.76 ,33.33
03,012,01,002,0000,0,33654,395,34049,49889,0,3,1,3,0,1,0,76.14,68.25 ,33.33
03,012,01,003,0000,0,54363,615,54978,82143,0,3,1,3,0,1,0,76.14,66.93 ,33.33
03,012,01,004,0000,0,22947,238,23185,33531,0,3,1,3,0,1,0,76.14,69.14 ,33.33
03,012,01,005,0000,0,16098,195,16293,24207,0,3,1,3,0,1,0,76.14,67.31 ,33.33
03,012,01,006,0000,0,24249,327,24576,37845,0,3,1,3,0,1,0,76.14,64.94 ,33.33
03,012,01,007,0000,0,18568,231,18799,28622,0,3,1,3,0,1,0,76.14,65.68 ,33.33
03,012,01,008,0000,0,44145,520,44665,65810,0,3,1,3,0,1,0,76.14,67.87 ,33.33
03,012,01,009,0000,0,19322,270,19592,27630,0,3,1,3,0,1,0,76.14,70.91 ,33.33
03,012,01,010,0000,0,16735,242,16977,23684,0,3,1,3,0,1,0,76.14,71.68 ,33.33
03,012,01,011,0000,0,5373,74,5447,7803,0,3,1,3,0,1,0,76.14,69.81 ,33.33
03,012,01,012,0000,0,14733,177,14910,21822,0,3,1,3,0,1,0,76.14,68.33 ,33.33
03,012,01,013,0000,0,26085,296,26381,38160,0,3,1,3,0,1,0,76.14,69.13 ,33.33
03,012,01,014,0000,0,13464,198,13662,21065,0,3,1,3,0,1,0,76.14,64.86 ,33.33
03,012,01,015,0000,0,15419,169,15588,24065,0,3,1,3,0,1,0,76.14,64.77 ,33.33
03,012,01,016,0000,0,7261,74,7335,10669,0,3,1,3,0,1,0,76.14,68.75 ,33.33
03,012,01,017,0000,0,11668,135,11803,15643,0,3,1,3,0,1,0,76.14,75.45 ,33.33
03,012,01,018,0000,0,19016,219,19235,28303,0,3,1,3,0,1,0,76.14,67.96 ,33.33
03,012,01,019,0000,0,21764,232,21996,32576,0,3,1,3,0,1,0,76.14,67.52 ,33.33
03,012,01,020,0000,0,22513,264,22777,34933,0,3,1,3,0,1,0,76.14,65.20 ,33.33
03,012,01,021,0000,0,7496,140,7636,12770,0,3,1,3,0,1,0,76.14,59.80 ,33.33
03,012,01,022,0000,0,4370,71,4441,6750,0,3,1,3,0,1,0,76.14,65.79 ,33.33
03,012,01,023,0000,0,5832,72,5904,10050,0,3,1,3,0,1,0,76.14,58.75 ,33.33
03,012,01,024,0000,0,9135,102,9237,13550,0,3,1,3,0,1,0,76.14,68.17 ,33.33
03,012,01,025,0000,0,60,1,61,131,0,3,1,3,0,1,0,76.14,46.56 ,33.33
03,012,01,026,0000,0,211,6,217,388,0,3,1,3,0,1,0,76.14,55.93 ,33.33
03,012,01,027,0000,0,140,1,141,333,0,3,1,3,0,1,0,76.14,42.34 ,33.33
03,013,01,001,0000,0,99385,992,100377,150945,0,3,1,3,0,1,0,76.14,66.50 ,33.33
03,013,01,002,0000,0,25888,272,26160,40262,0,3,1,3,0,1,0,76.14,64.97 ,33.33
03,013,01,003,0000,0,21943,234,22177,34244,0,3,1,3,0,1,0,76.14,64.76 ,33.33
03,013,01,004,0000,0,13022,205,13227,22468,0,3,1,3,0,1,0,76.14,58.87 ,33.33
03,013,01,005,0000,0,27687,266,27953,38265,0,3,1,3,0,1,0,76.14,73.05 ,33.33
03,013,01,006,0000,0,15877,189,16066,22200,0,3,1,3,0,1,0,76.14,72.37 ,33.33
03,013,01,007,0000,0,6289,58,6347,8877,0,3,1,3,0,1,0,76.14,71.50 ,33.33
03,013,01,008,0000,0,11929,154,12083,16736,0,3,1,3,0,1,0,76.14,72.20 ,33.33
03,013,01,009,0000,0,13698,158,13856,19575,0,3,1,3,0,1,0,76.14,70.78 ,33.33
03,013,01,010,0000,0,14200,204,14404,20522,0,3,1,3,0,1,0,76.14,70.19 ,33.33
03,013,01,011,0000,0,14489,193,14682,22514,0,3,1,3,0,1,0,76.14,65.21 ,33.33
03,013,01,012,0000,0,12055,163,12218,17538,0,3,1,3,0,1,0,76.14,69.67 ,33.33
03,013,01,013,0000,0,29228,346,29574,44643,0,3,1,3,0,1,0,76.14,66.25 ,33.33
03,013,01,014,0000,0,10233,105,10338,14401,0,3,1,3,0,1,0,76.14,71.79 ,33.33
03,013,01,015,0000,0,5992,59,6051,9029,0,3,1,3,0,1,0,76.14,67.02 ,33.33
03,013,01,016,0000,0,13566,155,13721,21606,0,3,1,3,0,1,0,76.14,63.51 ,33.33
03,013,01,017,0000,0,19962,270,20232,29233,0,3,1,3,0,1,0,76.14,69.21 ,33.33
03,013,01,018,0000,0,7381,90,7471,10763,0,3,1,3,0,1,0,76.14,69.41 ,33.33
03,013,01,019,0000,0,11384,104,11488,16816,0,3,1,3,0,1,0,76.14,68.32 ,33.33
03,013,01,020,0000,0,6845,77,6922,9829,0,3,1,3,0,1,0,76.14,70.42 ,33.33
03,013,01,021,0000,0,11849,135,11984,17443,0,3,1,3,0,1,0,76.14,68.70 ,33.33
03,013,01,022,0000,0,4767,80,4847,10251,0,3,1,3,0,1,0,76.14,47.28 ,33.33
03,013,01,023,0000,0,4895,84,4979,8177,0,3,1,3,0,1,0,76.14,60.89 ,33.33
03,013,01,024,0000,0,3001,44,3045,5482,0,3,1,3,0,1,0,76.14,55.55 ,33.33
03,013,01,025,0000,0,2913,36,2949,4949,0,3,1,3,0,1,0,76.14,59.59 ,33.33
03,013,01,026,0000,0,249,7,256,436,0,3,1,3,0,1,0,76.14,58.72 ,33.33
03,013,01,027,0000,0,28,1,29,66,0,3,1,3,0,1,0,76.14,43.94 ,33.33
03,013,01,028,0000,0,202,10,212,350,0,3,1,3,0,1,0,76.14,60.57 ,33.33
03,013,01,029,0000,0,78,0,78,150,0,3,1,3,0,1,0,76.14,52.00 ,33.33
03,013,01,030,0000,0,203,8,211,344,0,3,1,3,0,1,0,76.14,61.34 ,33.33
03,013,01,031,0000,0,197,5,202,362,0,3,1,3,0,1,0,76.14,55.80 ,33.33
03,013,01,032,0000,0,147,6,153,299,0,3,1,3,0,1,0,76.14,51.17 ,33.33
03,013,01,033,0000,0,192,11,203,386,0,3,1,3,0,1,0,76.14,52.59 ,33.33
03,014,01,001,0000,0,40351,547,40898,66338,0,3,1,3,0,1,0,76.14,61.65 ,33.33
03,014,01,002,0000,0,3652,53,3705,6401,0,3,1,3,0,1,0,76.14,57.88 ,33.33
03,014,01,003,0000,0,3725,45,3770,6252,0,3,1,3,0,1,0,76.14,60.30 ,33.33
03,014,01,004,0000,0,6707,136,6843,11490,0,3,1,3,0,1,0,76.14,59.56 ,33.33
03,014,01,005,0000,0,2968,58,3026,5623,0,3,1,3,0,1,0,76.14,53.81 ,33.33
03,014,01,006,0000,0,3330,62,3392,6494,0,3,1,3,0,1,0,76.14,52.23 ,33.33
03,014,01,007,0000,0,2122,41,2163,4145,0,3,1,3,0,1,0,76.14,52.18 ,33.33
03,014,01,008,0000,0,1672,36,1708,3352,0,3,1,3,0,1,0,76.14,50.95 ,33.33
03,014,01,009,0000,0,3588,67,3655,6323,0,3,1,3,0,1,0,76.14,57.80 ,33.33
03,014,01,010,0000,0,1298,19,1317,2479,0,3,1,3,0,1,0,76.14,53.13 ,33.33
03,014,01,011,0000,0,1030,21,1051,1999,0,3,1,3,0,1,0,76.14,52.58 ,33.33
03,014,01,012,0000,0,195,4,199,333,0,3,1,3,0,1,0,76.14,59.76 ,33.33
03,014,01,013,0000,0,160,2,162,283,0,3,1,3,0,1,0,76.14,57.24 ,33.33
03,014,01,014,0000,0,106,1,107,177,0,3,1,3,0,1,0,76.14,60.45 ,33.33
03,014,01,015,0000,0,157,3,160,356,0,3,1,3,0,1,0,76.14,44.94 ,33.33
03,014,01,016,0000,0,95,0,95,194,0,3,1,3,0,1,0,76.14,48.97 ,33.33
03,015,01,001,0000,0,44471,625,45096,71038,0,3,1,3,0,1,0,76.14,63.48 ,33.33
03,015,01,002,0000,0,7283,155,7438,12370,0,3,1,3,0,1,0,76.14,60.13 ,33.33
03,015,01,003,0000,0,1055,28,1083,1896,0,3,1,3,0,1,0,76.14,57.12 ,33.33
03,015,01,004,0000,0,29139,464,29603,47438,0,3,1,3,0,1,0,76.14,62.40 ,33.33
03,015,01,005,0000,0,6740,124,6864,11353,0,3,1,3,0,1,0,76.14,60.46 ,33.33
03,015,01,006,0000,0,5817,143,5960,9319,0,3,1,3,0,1,0,76.14,63.96 ,33.33
03,015,01,007,0000,0,3877,85,3962,6537,0,3,1,3,0,1,0,76.14,60.61 ,33.33
03,015,01,008,0000,0,587,18,605,1173,0,3,1,3,0,1,0,76.14,51.58 ,33.33
03,015,01,009,0000,0,172,7,179,354,0,3,1,3,0,1,0,76.14,50.56 ,33.33
03,015,01,010,0000,0,4203,68,4271,7300,0,3,1,3,0,1,0,76.14,58.51 ,33.33
03,015,01,011,0000,0,9625,243,9868,17779,0,3,1,3,0,1,0,76.14,55.50 ,33.33
03,015,01,012,0000,0,4786,124,4910,9067,0,3,1,3,0,1,0,76.14,54.15 ,33.33
03,015,01,013,0000,0,192,6,198,351,0,3,1,3,0,1,0,76.14,56.41 ,33.33
03,016,01,001,0000,0,23931,345,24276,37698,0,3,1,3,0,1,0,76.14,64.40 ,33.33
03,016,01,002,0000,0,6292,84,6376,9809,0,3,1,3,0,1,0,76.14,65.00 ,33.33
03,016,01,003,0000,0,3934,38,3972,7119,0,3,1,3,0,1,0,76.14,55.79 ,33.33
03,016,01,004,0000,0,3668,95,3763,6506,0,3,1,3,0,1,0,76.14,57.84 ,33.33
03,016,01,005,0000,0,1289,31,1320,3633,0,3,1,3,0,1,0,76.14,36.33 ,33.33
03,016,01,006,0000,0,908,43,951,2403,0,3,1,3,0,1,0,76.14,39.58 ,33.33
03,017,01,001,0000,0,24770,378,25148,40961,0,3,1,3,0,1,0,76.14,61.39 ,33.33
03,017,01,002,0000,0,23119,289,23408,36408,0,3,1,3,0,1,0,76.14,64.29 ,33.33
03,017,01,003,0000,0,24386,395,24781,37822,0,3,1,3,0,1,0,76.14,65.52 ,33.33
03,017,01,004,0000,0,24545,409,24954,39092,0,3,1,3,0,1,0,76.14,63.83 ,33.33
03,017,01,005,0000,0,34835,529,35364,57004,0,3,1,3,0,1,0,76.14,62.04 ,33.33
03,017,01,006,0000,0,15810,238,16048,26483,0,3,1,3,0,1,0,76.14,60.60 ,33.33
03,017,01,007,0000,0,24609,393,25002,38664,0,3,1,3,0,1,0,76.14,64.66 ,33.33
03,018,01,001,0000,0,75951,1106,77057,120236,0,3,1,3,0,1,0,76.14,64.09 ,33.33
03,018,01,002,0000,0,58022,871,58893,91764,0,3,1,3,0,1,0,76.14,64.18 ,33.33
03,018,01,003,0000,0,27795,445,28240,44635,0,3,1,3,0,1,0,76.14,63.27 ,33.33
03,019,01,001,0000,0,10236,174,10410,15974,0,3,1,3,0,1,0,76.14,65.17 ,33.33
03,019,01,002,0000,0,33112,530,33642,49954,0,3,1,3,0,1,0,76.14,67.35 ,33.33
03,019,01,003,0000,0,43852,725,44577,68544,0,3,1,3,0,1,0,76.14,65.03 ,33.33
03,019,01,004,0000,0,51451,726,52177,77906,0,3,1,3,0,1,0,76.14,66.97 ,33.33
03,019,01,005,0000,0,66099,941,67040,103579,0,3,1,3,0,1,0,76.14,64.72 ,33.33
03,019,01,006,0000,0,75318,1128,76446,116004,0,3,1,3,0,1,0,76.14,65.90 ,33.33
03,019,01,007,0000,0,54778,879,55657,82739,0,3,1,3,0,1,0,76.14,67.27 ,33.33
03,019,01,008,0000,0,97726,1432,99158,149634,0,3,1,3,0,1,0,76.14,66.27 ,33.33
03,020,01,001,0000,0,58269,684,58953,90848,0,3,1,3,0,1,0,76.14,64.89 ,33.33
03,020,01,002,0000,0,61701,813,62514,95679,0,3,1,3,0,1,0,76.14,65.34 ,33.33
03,021,01,001,0000,0,79201,990,80191,126461,0,3,1,3,0,1,0,76.14,63.41 ,33.33
03,021,01,002,0000,0,60927,754,61681,97692,0,3,1,3,0,1,0,76.14,63.14 ,33.33
03,021,01,003,0000,0,21373,279,21652,33055,0,3,1,3,0,1,0,76.14,65.50 ,33.33
03,021,01,004,0000,0,54459,656,55115,87463,0,3,1,3,0,1,0,76.14,63.02 ,33.33
03,021,01,005,0000,0,20171,221,20392,31329,0,3,1,3,0,1,0,76.14,65.09 ,33.33
03,021,01,006,0000,0,71529,954,72483,112132,0,3,1,3,0,1,0,76.14,64.64 ,33.33
03,021,01,007,0000,0,20643,217,20860,34033,0,3,1,3,0,1,0,76.14,61.29 ,33.33
04,001,01,001,0000,0,8374,184,8558,13054,0,3,1,3,0,1,0,76.14,65.56 ,33.33
04,001,01,002,0000,0,4587,132,4719,7280,0,3,1,3,0,1,0,76.14,64.82 ,33.33
04,001,01,003,0000,0,5575,139,5714,8536,0,3,1,3,0,1,0,76.14,66.94 ,33.33
04,001,01,004,0000,0,4186,117,4303,6851,0,3,1,3,0,1,0,76.14,62.81 ,33.33
04,001,01,005,0000,0,2266,85,2351,3919,0,3,1,3,0,1,0,76.14,59.99 ,33.33
04,001,01,006,0000,0,37,0,37,282,0,3,1,3,0,1,0,76.14,13.12 ,33.33
04,002,01,001,0000,0,2871,71,2942,3748,0,3,1,3,0,1,0,76.14,78.50 ,33.33
04,002,01,002,0000,0,913,22,935,1270,0,3,1,3,0,1,0,76.14,73.62 ,33.33
04,002,01,003,0000,0,396,9,405,637,0,3,1,3,0,1,0,76.14,63.58 ,33.33
04,002,01,004,0000,0,372,17,389,554,1,4,2,4,1,2,1,77.14,70.22 ,34.33
01,000,01,001,0001,0,2430,29,2459,3731,0,3,1,3,0,1,0,76.14,65.91 ,33.33
01,000,01,001,0002,0,2237,21,2258,3483,0,3,1,3,0,1,0,76.14,64.83 ,33.33
01,000,01,001,0003,0,2700,20,2720,4272,0,3,1,3,0,1,0,76.14,63.67 ,33.33
01,000,01,001,0004,0,3490,39,3529,5109,0,3,1,3,0,1,0,76.14,69.07 ,33.33
01,000,01,001,0005,0,3397,43,3440,5407,0,3,1,3,0,1,0,76.14,63.62 ,33.33
01,000,01,001,0006,0,3672,28,3700,5716,0,3,1,3,0,1,0,76.14,64.73 ,33.33
01,000,01,001,0007,0,3399,32,3431,5332,0,3,1,3,0,1,0,76.14,64.35 ,33.33
01,000,01,001,0008,0,4062,43,4105,6206,0,3,1,3,0,1,0,76.14,66.15 ,33.33
01,000,01,001,0009,0,3865,41,3906,6067,0,3,1,3,0,1,0,76.14,64.38 ,33.33
01,000,01,001,0010,0,3246,20,3266,5016,0,3,1,3,0,1,0,76.14,65.11 ,33.33
01,000,01,001,0011,0,2324,18,2342,3559,0,3,1,3,0,1,0,76.14,65.81 ,33.33
01,000,01,001,0012,0,2510,19,2529,3628,0,3,1,3,0,1,0,76.14,69.71 ,33.33
01,000,01,001,0013,0,3169,43,3212,4937,0,3,1,3,0,1,0,76.14,65.06 ,33.33
01,000,01,001,0014,0,2658,26,2684,3930,0,3,1,3,0,1,0,76.14,68.30 ,33.33
01,000,01,001,0015,0,2395,29,2424,3787,0,3,1,3,0,1,0,76.14,64.01 ,33.33
01,000,01,001,0016,0,2651,35,2686,4091,0,3,1,3,0,1,0,76.14,65.66 ,33.33
01,000,01,001,0017,0,4276,35,4311,6427,0,3,1,3,0,1,0,76.14,67.08 ,33.33
01,000,01,001,0018,0,2374,24,2398,3758,0,3,1,3,0,1,0,76.14,63.81 ,33.33
01,000,01,001,0019,0,957,5,962,1338,0,3,1,3,0,1,0,76.14,71.90 ,33.33
01,000,01,001,0020,0,4596,46,4642,7259,0,3,1,3,0,1,0,76.14,63.95 ,33.33
01,000,01,001,0021,0,4348,62,4410,6746,0,3,1,3,0,1,0,76.14,65.37 ,33.33
01,000,01,001,0022,0,3569,73,3642,5760,0,3,1,3,0,1,0,76.14,63.23 ,33.33
01,000,01,001,0023,0,2752,44,2796,4430,0,3,1,3,0,1,0,76.14,63.12 ,33.33
01,000,01,001,0024,0,2982,31,3013,4616,0,3,1,3,0,1,0,76.14,65.27 ,33.33
01,000,01,001,0025,0,3158,27,3185,4953,0,3,1,3,0,1,0,76.14,64.30 ,33.33
01,000,01,001,0026,0,1602,19,1621,2705,0,3,1,3,0,1,0,76.14,59.93 ,33.33
01,000,01,001,0027,0,2753,17,2770,4725,0,3,1,3,0,1,0,76.14,58.62 ,33.33
01,000,01,001,0028,0,2225,23,2248,3372,0,3,1,3,0,1,0,76.14,66.67 ,33.33
01,000,01,001,0029,0,3191,40,3231,5163,0,3,1,3,0,1,0,76.14,62.58 ,33.33
01,000,01,001,0030,0,3135,35,3170,4893,0,3,1,3,0,1,0,76.14,64.79 ,33.33
01,000,01,001,0031,0,3107,25,3132,4734,0,3,1,3,0,1,0,76.14,66.16 ,33.33
01,000,01,001,0032,0,1910,29,1939,2913,0,3,1,3,0,1,0,76.14,66.56 ,33.33
01,000,01,001,0033,0,2255,16,2271,3285,0,3,1,3,0,1,0,76.14,69.13 ,33.33
01,000,01,001,0034,0,2068,12,2080,3288,0,3,1,3,0,1,0,76.14,63.26 ,33.33
01,000,01,001,0035,0,2284,47,2331,3739,0,3,1,3,0,1,0,76.14,62.34 ,33.33
01,000,01,001,0036,0,2590,37,2627,4106,0,3,1,3,0,1,0,76.14,63.98 ,33.33
01,000,01,001,0037,0,2852,46,2898,4690,0,3,1,3,0,1,0,76.14,61.79 ,33.33
01,000,01,001,0038,0,4820,73,4893,7602,0,3,1,3,0,1,0,76.14,64.36 ,33.33
01,000,01,001,0039,0,1263,11,1274,1903,0,3,1,3,0,1,0,76.14,66.95 ,33.33
01,000,01,001,0040,0,1509,18,1527,2356,0,3,1,3,0,1,0,76.14,64.81 ,33.33
01,000,01,002,0041,0,753,15,768,1142,0,3,1,3,0,1,0,76.14,67.25 ,33.33
01,000,01,002,0042,0,753,8,761,1180,0,3,1,3,0,1,0,76.14,64.49 ,33.33
01,000,01,002,0043,0,1095,10,1105,1734,0,3,1,3,0,1,0,76.14,63.73 ,33.33
01,000,01,002,0044,0,1638,19,1657,2723,0,3,1,3,0,1,0,76.14,60.85 ,33.33
01,000,01,002,0045,0,861,12,873,1348,0,3,1,3,0,1,0,76.14,64.76 ,33.33
01,000,01,002,0046,0,856,8,864,1196,0,3,1,3,0,1,0,76.14,72.24 ,33.33
01,000,01,002,0047,0,815,15,830,1221,0,3,1,3,0,1,0,76.14,67.98 ,33.33
01,000,01,002,0048,0,3146,34,3180,4899,0,3,1,3,0,1,0,76.14,64.91 ,33.33
01,000,01,002,0049,0,2771,24,2795,4355,0,3,1,3,0,1,0,76.14,64.18 ,33.33
01,000,01,002,0050,0,3206,24,3230,4866,0,3,1,3,0,1,0,76.14,66.38 ,33.33
01,000,01,002,0051,0,2661,20,2681,4100,0,3,1,3,0,1,0,76.14,65.39 ,33.33
01,000,01,002,0052,0,2351,18,2369,3602,0,3,1,3,0,1,0,76.14,65.77 ,33.33
01,000,01,002,0053,0,3605,30,3635,5808,0,3,1,3,0,1,0,76.14,62.59 ,33.33
01,000,01,002,0054,0,3340,27,3367,5466,0,3,1,3,0,1,0,76.14,61.60 ,33.33
01,000,01,002,0055,0,4044,31,4075,6524,0,3,1,3,0,1,0,76.14,62.46 ,33.33
01,000,01,002,0056,0,3324,17,3341,5060,0,3,1,3,0,1,0,76.14,66.03 ,33.33
01,000,01,002,0057,0,2209,19,2228,3573,0,3,1,3,0,1,0,76.14,62.36 ,33.33
01,000,01,002,0058,0,3263,40,3303,5068,0,3,1,3,0,1,0,76.14,65.17 ,33.33
01,000,01,002,0059,0,2740,19,2759,4098,0,3,1,3,0,1,0,76.14,67.33 ,33.33
01,000,01,002,0060,0,3483,35,3518,5505,0,3,1,3,0,1,0,76.14,63.91 ,33.33
01,000,01,002,0061,0,2636,21,2657,3882,0,3,1,3,0,1,0,76.14,68.44 ,33.33
01,000,01,002,0062,0,2095,29,2124,3307,0,3,1,3,0,1,0,76.14,64.23 ,33.33
01,000,01,002,0063,0,2782,24,2806,4487,0,3,1,3,0,1,0,76.14,62.54 ,33.33
01,000,01,002,0064,0,2990,21,3011,4501,0,3,1,3,0,1,0,76.14,66.90 ,33.33
01,000,01,002,0065,0,4124,32,4156,6607,0,3,1,3,0,1,0,76.14,62.90 ,33.33
01,000,01,002,0066,0,3121,27,3148,4762,0,3,1,3,0,1,0,76.14,66.11 ,33.33
01,000,01,002,0067,0,2428,29,2457,3669,0,3,1,3,0,1,0,76.14,66.97 ,33.33
01,000,01,002,0068,0,1407,17,1424,2326,0,3,1,3,0,1,0,76.14,61.22 ,33.33
01,000,01,002,0069,0,2056,20,2076,3158,0,3,1,3,0,1,0,76.14,65.74 ,33.33
01,000,01,002,0070,0,2330,21,2351,3998,0,3,1,3,0,1,0,76.14,58.80 ,33.33
01,000,01,002,0071,0,3612,30,3642,5527,0,3,1,3,0,1,0,76.14,65.89 ,33.33
01,000,01,002,0072,0,3479,41,3520,5345,0,3,1,3,0,1,0,76.14,65.86 ,33.33
01,000,01,002,0073,0,3781,50,3831,5813,0,3,1,3,0,1,0,76.14,65.90 ,33.33
01,000,01,002,0074,0,3876,49,3925,6261,0,3,1,3,0,1,0,76.14,62.69 ,33.33
01,000,01,002,0075,0,2733,31,2764,4289,0,3,1,3,0,1,0,76.14,64.44 ,33.33
01,000,01,002,0076,0,2195,21,2216,3471,0,3,1,3,0,1,0,76.14,63.84 ,33.33
01,000,01,002,0077,0,3594,37,3631,5643,0,3,1,3,0,1,0,76.14,64.35 ,33.33
01,000,01,002,0078,0,2656,23,2679,4275,0,3,1,3,0,1,0,76.14,62.67 ,33.33
01,000,01,002,0079,0,3317,38,3355,5495,0,3,1,3,0,1,0,76.14,61.06 ,33.33
01,000,01,002,0080,0,2459,32,2491,4057,0,3,1,3,0,1,0,76.14,61.40 ,33.33
01,000,01,002,0081,0,2633,28,2661,4409,0,3,1,3,0,1,0,76.14,60.35 ,33.33
01,000,01,002,0082,0,2939,38,2977,4733,0,3,1,3,0,1,0,76.14,62.90 ,33.33
01,000,01,002,0083,0,3798,37,3835,5747,0,3,1,3,0,1,0,76.14,66.73 ,33.33
01,000,01,002,0084,0,1945,14,1959,3075,0,3,1,3,0,1,0,76.14,63.71 ,33.33
01,000,01,002,0085,0,3091,32,3123,4959,0,3,1,3,0,1,0,76.14,62.98 ,33.33
01,000,01,002,0086,0,4092,53,4145,6478,0,3,1,3,0,1,0,76.14,63.99 ,33.33
01,000,01,002,0087,0,3578,69,3647,5484,0,3,1,3,0,1,0,76.14,66.50 ,33.33
01,000,01,002,0088,0,3754,34,3788,5739,0,3,1,3,0,1,0,76.14,66.00 ,33.33
01,000,01,002,0089,0,2587,27,2614,3956,0,3,1,3,0,1,0,76.14,66.08 ,33.33
01,000,01,002,0090,0,2916,21,2937,4367,0,3,1,3,0,1,0,76.14,67.25 ,33.33
01,000,01,003,0091,0,3840,39,3879,5991,0,3,1,3,0,1,0,76.14,64.75 ,33.33
01,000,01,003,0092,0,3868,44,3912,5888,0,3,1,3,0,1,0,76.14,66.44 ,33.33
01,000,01,003,0093,0,3041,21,3062,4799,0,3,1,3,0,1,0,76.14,63.80 ,33.33
01,000,01,003,0094,0,2789,23,2812,4209,0,3,1,3,0,1,0,76.14,66.81 ,33.33
01,000,01,003,0095,0,5182,44,5226,8031,0,3,1,3,0,1,0,76.14,65.07 ,33.33
01,000,01,003,0096,0,4483,38,4521,6984,0,3,1,3,0,1,0,76.14,64.73 ,33.33
01,000,01,003,0097,0,3970,46,4016,6013,0,3,1,3,0,1,0,76.14,66.79 ,33.33
01,000,01,003,0098,0,2654,22,2676,4182,0,3,1,3,0,1,0,76.14,63.99 ,33.33
01,000,01,003,0099,0,3652,32,3684,5567,0,3,1,3,0,1,0,76.14,66.18 ,33.33
01,000,01,003,0100,0,4013,35,4048,6188,0,3,1,3,0,1,0,76.14,65.42 ,33.33
01,000,01,003,0101,0,5263,41,5304,8441,0,3,1,3,0,1,0,76.14,62.84 ,33.33
01,000,01,003,0102,0,2825,24,2849,4397,0,3,1,3,0,1,0,76.14,64.79 ,33.33
01,000,01,003,0103,0,3145,32,3177,4763,0,3,1,3,0,1,0,76.14,66.70 ,33.33
01,000,01,003,0104,0,3292,47,3339,5147,0,3,1,3,0,1,0,76.14,64.87 ,33.33
01,000,01,003,0105,0,2913,40,2953,4372,0,3,1,3,0,1,0,76.14,67.54 ,33.33
01,000,01,003,0106,0,2888,23,2911,4716,0,3,1,3,0,1,0,76.14,61.73 ,33.33
01,000,01,003,0107,0,12076,102,12178,19138,0,3,1,3,0,1,0,76.14,63.63 ,33.33
01,000,01,003,0108,0,3429,24,3453,5338,0,3,1,3,0,1,0,76.14,64.69 ,33.33
01,000,01,003,0109,0,4360,38,4398,6288,0,3,1,3,0,1,0,76.14,69.94 ,33.33
01,000,01,003,0110,0,2477,14,2491,3655,0,3,1,3,0,1,0,76.14,68.15 ,33.33
01,000,01,003,0111,0,3933,51,3984,6618,0,3,1,3,0,1,0,76.14,60.20 ,33.33
01,000,01,003,0112,0,6531,81,6612,10544,0,3,1,3,0,1,0,76.14,62.71 ,33.33
01,000,01,003,0113,0,3279,37,3316,5414,0,3,1,3,0,1,0,76.14,61.25 ,33.33
01,000,01,003,0114,0,4072,47,4119,6481,0,3,1,3,0,1,0,76.14,63.56 ,33.33
01,000,01,003,0115,0,2351,29,2380,3656,0,3,1,3,0,1,0,76.14,65.10 ,33.33
01,000,01,003,0116,0,3112,41,3153,4837,0,3,1,3,0,1,0,76.14,65.19 ,33.33
01,000,01,003,0117,0,1267,16,1283,2036,0,3,1,3,0,1,0,76.14,63.02 ,33.33
01,000,01,003,0118,0,3755,39,3794,6318,0,3,1,3,0,1,0,76.14,60.05 ,33.33
01,000,01,003,0119,0,2345,18,2363,3679,0,3,1,3,0,1,0,76.14,64.23 ,33.33
01,000,01,004,0120,0,2586,35,2621,4004,0,3,1,3,0,1,0,76.14,65.46 ,33.33
01,000,01,004,0121,0,2402,38,2440,3765,0,3,1,3,0,1,0,76.14,64.81 ,33.33
01,000,01,004,0122,0,6247,91,6338,9889,0,3,1,3,0,1,0,76.14,64.09 ,33.33
01,000,01,004,0123,0,2288,22,2310,3337,0,3,1,3,0,1,0,76.14,69.22 ,33.33
01,000,01,004,0124,0,2815,25,2840,4214,0,3,1,3,0,1,0,76.14,67.39 ,33.33
01,000,01,004,0125,0,2224,17,2241,3340,0,3,1,3,0,1,0,76.14,67.10 ,33.33
01,000,01,004,0126,0,3284,47,3331,5022,0,3,1,3,0,1,0,76.14,66.33 ,33.33
01,000,01,004,0127,0,2336,24,2360,3668,0,3,1,3,0,1,0,76.14,64.34 ,33.33
01,000,01,004,0128,0,2166,25,2191,3524,0,3,1,3,0,1,0,76.14,62.17 ,33.33
01,000,01,004,0129,0,3223,44,3267,5281,0,3,1,3,0,1,0,76.14,61.86 ,33.33
01,000,01,004,0130,0,2198,27,2225,3560,0,3,1,3,0,1,0,76.14,62.50 ,33.33
01,000,01,004,0131,0,2757,33,2790,4490,0,3,1,3,0,1,0,76.14,62.14 ,33.33
01,000,01,004,0132,0,1580,21,1601,2584,0,3,1,3,0,1,0,76.14,61.96 ,33.33
01,000,01,004,0133,0,1944,43,1987,3255,0,3,1,3,0,1,0,76.14,61.04 ,33.33
01,000,01,004,0134,0,2031,27,2058,3200,0,3,1,3,0,1,0,76.14,64.31 ,33.33
01,000,01,004,0135,0,4766,33,4799,7177,0,3,1,3,0,1,0,76.14,66.87 ,33.33
01,000,01,004,0136,0,3873,47,3920,6410,0,3,1,3,0,1,0,76.14,61.15 ,33.33
01,000,01,004,0137,0,2871,41,2912,4446,0,3,1,3,0,1,0,76.14,65.50 ,33.33
01,000,01,005,0138,0,3039,23,3062,4705,0,3,1,3,0,1,0,76.14,65.08 ,33.33
01,000,01,005,0139,0,4348,34,4382,6789,0,3,1,3,0,1,0,76.14,64.55 ,33.33
01,000,01,005,0140,0,3563,26,3589,5641,0,3,1,3,0,1,0,76.14,63.62 ,33.33
01,000,01,005,0141,0,2349,19,2368,3675,0,3,1,3,0,1,0,76.14,64.44 ,33.33
01,000,01,005,0142,0,2733,25,2758,4230,0,3,1,3,0,1,0,76.14,65.20 ,33.33
01,000,01,005,0143,0,2576,23,2599,4090,0,3,1,3,0,1,0,76.14,63.55 ,33.33
01,000,01,005,0144,0,2338,9,2347,3747,0,3,1,3,0,1,0,76.14,62.64 ,33.33
01,000,01,005,0145,0,2299,20,2319,3637,0,3,1,3,0,1,0,76.14,63.76 ,33.33
01,000,01,005,0146,0,2241,14,2255,3561,0,3,1,3,0,1,0,76.14,63.32 ,33.33
01,000,01,005,0147,0,3809,28,3837,6059,0,3,1,3,0,1,0,76.14,63.33 ,33.33
01,000,01,005,0148,0,3125,23,3148,4695,0,3,1,3,0,1,0,76.14,67.05 ,33.33
01,000,01,005,0149,0,2368,17,2385,3719,0,3,1,3,0,1,0,76.14,64.13 ,33.33
01,000,01,005,0150,0,1643,13,1656,2542,0,3,1,3,0,1,0,76.14,65.15 ,33.33
01,000,01,005,0151,0,2579,10,2589,3893,0,3,1,3,0,1,0,76.14,66.50 ,33.33
01,000,01,005,0152,0,4319,25,4344,7009,0,3,1,3,0,1,0,76.14,61.98 ,33.33
01,000,01,005,0153,0,3477,27,3504,5310,0,3,1,3,0,1,0,76.14,65.99 ,33.33
01,000,01,005,0154,0,1881,16,1897,3041,0,3,1,3,0,1,0,76.14,62.38 ,33.33
01,000,01,005,0155,0,2963,27,2990,5087,0,3,1,3,0,1,0,76.14,58.78 ,33.33
01,000,01,005,0156,0,4529,43,4572,6876,0,3,1,3,0,1,0,76.14,66.49 ,33.33
01,000,01,005,0157,0,3038,20,3058,4606,0,3,1,3,0,1,0,76.14,66.39 ,33.33
01,000,01,005,0158,0,3783,37,3820,5632,0,3,1,3,0,1,0,76.14,67.83 ,33.33
01,000,01,005,0159,0,3910,34,3944,6305,0,3,1,3,0,1,0,76.14,62.55 ,33.33
01,000,01,005,0160,0,3610,49,3659,5801,0,3,1,3,0,1,0,76.14,63.08 ,33.33
01,000,01,005,0161,0,3248,28,3276,5089,0,3,1,3,0,1,0,76.14,64.37 ,33.33
01,000,01,005,0162,0,3675,31,3706,6159,0,3,1,3,0,1,0,76.14,60.17 ,33.33
01,000,01,005,0163,0,1911,8,1919,3087,0,3,1,3,0,1,0,76.14,62.16 ,33.33
01,000,01,005,0164,0,1651,6,1657,2583,0,3,1,3,0,1,0,76.14,64.15 ,33.33
01,000,01,005,0165,0,1930,12,1942,3041,0,3,1,3,0,1,0,76.14,63.86 ,33.33
01,000,01,005,0166,0,3532,31,3563,5479,0,3,1,3,0,1,0,76.14,65.03 ,33.33
01,000,01,005,0167,0,1575,16,1591,2483,0,3,1,3,0,1,0,76.14,64.08 ,33.33
01,000,01,005,0168,0,1901,17,1918,2954,0,3,1,3,0,1,0,76.14,64.93 ,33.33
01,000,01,005,0169,0,2971,40,3011,4768,0,3,1,3,0,1,0,76.14,63.15 ,33.33
01,000,01,005,0170,0,1320,6,1326,2138,0,3,1,3,0,1,0,76.14,62.02 ,33.33
01,000,01,006,0171,0,2629,18,2647,4078,0,3,1,3,0,1,0,76.14,64.91 ,33.33
01,000,01,006,0172,0,2539,20,2559,3947,0,3,1,3,0,1,0,76.14,64.83 ,33.33
01,000,01,006,0173,0,1540,21,1561,2576,0,3,1,3,0,1,0,76.14,60.60 ,33.33
01,000,01,006,0174,0,1361,16,1377,2301,0,3,1,3,0,1,0,76.14,59.84 ,33.33
01,000,01,006,0175,0,1997,13,2010,3344,0,3,1,3,0,1,0,76.14,60.11 ,33.33
01,000,01,006,0176,0,3081,36,3117,4875,0,3,1,3,0,1,0,76.14,63.94 ,33.33
01,000,01,006,0177,0,2327,20,2347,3799,0,3,1,3,0,1,0,76.14,61.78 ,33.33
01,000,01,006,0178,0,3088,26,3114,4995,0,3,1,3,0,1,0,76.14,62.34 ,33.33
01,000,01,006,0179,0,4176,28,4204,6560,0,3,1,3,0,1,0,76.14,64.09 ,33.33
01,000,01,006,0180,0,1806,20,1826,2886,0,3,1,3,0,1,0,76.14,63.27 ,33.33
01,000,01,006,0181,0,2335,20,2355,3769,0,3,1,3,0,1,0,76.14,62.48 ,33.33
01,000,01,006,0182,0,1909,22,1931,3113,0,3,1,3,0,1,0,76.14,62.03 ,33.33
01,000,01,006,0183,0,2748,19,2767,4252,0,3,1,3,0,1,0,76.14,65.08 ,33.33
01,000,01,006,0184,0,2243,26,2269,3760,0,3,1,3,0,1,0,76.14,60.35 ,33.33
01,000,01,006,0185,0,2320,27,2347,3605,0,3,1,3,0,1,0,76.14,65.10 ,33.33
01,000,01,006,0186,0,3019,34,3053,4566,0,3,1,3,0,1,0,76.14,66.86 ,33.33
01,000,01,006,0187,0,2855,21,2876,4603,0,3,1,3,0,1,0,76.14,62.48 ,33.33
01,000,01,006,0188,0,2759,26,2785,4432,0,3,1,3,0,1,0,76.14,62.84 ,33.33
01,000,01,006,0189,0,1995,16,2011,3074,0,3,1,3,0,1,0,76.14,65.42 ,33.33
01,000,01,006,0190,0,3498,31,3529,5389,0,3,1,3,0,1,0,76.14,65.49 ,33.33
01,000,01,006,0191,0,1415,19,1434,2329,0,3,1,3,0,1,0,76.14,61.57 ,33.33
01,000,01,006,0192,0,3158,38,3196,5178,0,3,1,3,0,1,0,76.14,61.72 ,33.33
01,000,01,006,0193,0,2999,30,3029,4551,0,3,1,3,0,1,0,76.14,66.56 ,33.33
01,000,01,006,0194,0,2462,35,2497,3826,0,3,1,3,0,1,0,76.14,65.26 ,33.33
01,000,01,006,0195,0,4115,42,4157,6484,0,3,1,3,0,1,0,76.14,64.11 ,33.33
01,000,01,006,0196,0,3328,29,3357,5213,0,3,1,3,0,1,0,76.14,64.40 ,33.33
01,000,01,006,0197,0,3029,53,3082,4719,0,3,1,3,0,1,0,76.14,65.31 ,33.33
01,000,01,006,0198,0,2476,20,2496,3893,0,3,1,3,0,1,0,76.14,64.12 ,33.33
01,000,01,006,0199,0,3565,40,3605,5553,0,3,1,3,0,1,0,76.14,64.92 ,33.33
01,000,01,006,0200,0,4957,44,5001,7590,0,3,1,3,0,1,0,76.14,65.89 ,33.33
01,000,01,006,0201,0,2495,22,2517,4015,0,3,1,3,0,1,0,76.14,62.69 ,33.33
01,000,01,006,0202,0,3265,28,3293,5316,0,3,1,3,0,1,0,76.14,61.95 ,33.33
01,000,01,006,0203,0,4112,56,4168,6562,0,3,1,3,0,1,0,76.14,63.52 ,33.33
01,000,01,006,0204,0,2499,20,2519,3932,0,3,1,3,0,1,0,76.14,64.06 ,33.33
01,000,01,006,0205,0,2424,27,2451,3814,0,3,1,3,0,1,0,76.14,64.26 ,33.33
01,000,01,006,0206,0,3582,36,3618,5491,0,3,1,3,0,1,0,76.14,65.89 ,33.33
01,000,01,006,0207,0,1744,18,1762,2739,0,3,1,3,0,1,0,76.14,64.33 ,33.33
01,000,01,006,0208,0,2202,27,2229,3493,0,3,1,3,0,1,0,76.14,63.81 ,33.33
01,000,01,006,0209,0,3652,44,3696,5610,0,3,1,3,0,1,0,76.14,65.88 ,33.33
01,000,01,006,0210,0,2530,23,2553,3953,0,3,1,3,0,1,0,76.14,64.58 ,33.33
01,000,01,006,0211,0,1539,27,1566,2296,0,3,1,3,0,1,0,76.14,68.21 ,33.33
01,000,02,007,0212,0,1483,23,1506,2405,0,3,1,3,0,1,0,76.14,62.62 ,33.33
01,000,02,007,0213,0,1949,30,1979,3587,0,3,1,3,0,1,0,76.14,55.17 ,33.33
01,000,02,007,0214,0,1491,13,1504,2573,0,3,1,3,0,1,0,76.14,58.45 ,33.33
01,000,02,007,0215,0,2426,35,2461,4061,0,3,1,3,0,1,0,76.14,60.60 ,33.33
01,000,02,007,0216,0,956,12,968,1848,0,3,1,3,0,1,0,76.14,52.38 ,33.33
01,000,02,007,0217,0,2423,31,2454,4287,0,3,1,3,0,1,0,76.14,57.24 ,33.33
01,000,02,007,0218,0,1492,18,1510,2844,0,3,1,3,0,1,0,76.14,53.09 ,33.33
01,000,02,007,0219,0,2875,33,2908,4607,0,3,1,3,0,1,0,76.14,63.12 ,33.33
01,000,02,007,0220,0,1737,30,1767,2988,0,3,1,3,0,1,0,76.14,59.14 ,33.33
01,000,02,007,0221,0,1475,27,1502,2575,0,3,1,3,0,1,0,76.14,58.33 ,33.33
01,000,02,007,0222,0,1723,20,1743,3229,0,3,1,3,0,1,0,76.14,53.98 ,33.33
01,000,02,007,0223,0,1784,18,1802,3073,0,3,1,3,0,1,0,76.14,58.64 ,33.33
01,000,02,007,0224,0,2325,22,2347,3892,0,3,1,3,0,1,0,76.14,60.30 ,33.33
01,000,02,007,0225,0,2097,11,2108,2998,0,3,1,3,0,1,0,76.14,70.31 ,33.33
01,000,02,007,0226,0,5131,44,5175,7840,0,3,1,3,0,1,0,76.14,66.01 ,33.33
01,000,02,007,0227,0,4479,36,4515,6592,0,3,1,3,0,1,0,76.14,68.49 ,33.33
01,000,02,007,0228,0,4149,43,4192,6275,0,3,1,3,0,1,0,76.14,66.80 ,33.33
01,000,02,007,0229,0,583,3,586,913,0,3,1,3,0,1,0,76.14,64.18 ,33.33
01,000,02,007,0230,0,2522,28,2550,3973,0,3,1,3,0,1,0,76.14,64.18 ,33.33
01,000,02,007,0231,0,2439,28,2467,4009,0,3,1,3,0,1,0,76.14,61.54 ,33.33
01,000,02,007,0232,0,3220,30,3250,5025,0,3,1,3,0,1,0,76.14,64.68 ,33.33
01,000,02,007,0233,0,2452,37,2489,3937,0,3,1,3,0,1,0,76.14,63.22 ,33.33
01,000,02,007,0234,0,2692,30,2722,4454,0,3,1,3,0,1,0,76.14,61.11 ,33.33
01,000,02,007,0235,0,2555,27,2582,4598,0,3,1,3,0,1,0,76.14,56.15 ,33.33
01,000,02,007,0236,0,4024,58,4082,6618,0,3,1,3,0,1,0,76.14,61.68 ,33.33
01,000,02,007,0237,0,2041,25,2066,3253,0,3,1,3,0,1,0,76.14,63.51 ,33.33
01,000,02,007,0238,0,3569,30,3599,5761,0,3,1,3,0,1,0,76.14,62.47 ,33.33
01,000,02,007,0239,0,3253,25,3278,5306,0,3,1,3,0,1,0,76.14,61.78 ,33.33
01,000,02,007,0240,0,3822,36,3858,6060,0,3,1,3,0,1,0,76.14,63.66 ,33.33
01,000,02,007,0241,0,2595,25,2620,4166,0,3,1,3,0,1,0,76.14,62.89 ,33.33
01,000,02,007,0242,0,2306,25,2331,3776,0,3,1,3,0,1,0,76.14,61.73 ,33.33
01,000,02,007,0243,0,2541,19,2560,4127,0,3,1,3,0,1,0,76.14,62.03 ,33.33
01,000,02,007,0244,0,1820,13,1833,2835,0,3,1,3,0,1,0,76.14,64.66 ,33.33
01,000,02,007,0245,0,3036,35,3071,4929,0,3,1,3,0,1,0,76.14,62.30 ,33.33
01,000,02,007,0246,0,2946,26,2972,4249,0,3,1,3,0,1,0,76.14,69.95 ,33.33
01,000,02,007,0247,0,2220,23,2243,3512,0,3,1,3,0,1,0,76.14,63.87 ,33.33
01,000,02,007,0248,0,2161,9,2170,3369,0,3,1,3,0,1,0,76.14,64.41 ,33.33
01,000,02,007,0249,0,1583,20,1603,2530,0,3,1,3,0,1,0,76.14,63.36 ,33.33
01,000,02,007,0250,0,3050,35,3085,4999,0,3,1,3,0,1,0,76.14,61.71 ,33.33
01,000,02,007,0251,0,1967,19,1986,3173,0,3,1,3,0,1,0,76.14,62.59 ,33.33
01,000,02,008,0252,0,1852,29,1881,3121,0,3,1,3,0,1,0,76.14,60.27 ,33.33
01,000,02,008,0253,0,1948,16,1964,3123,0,3,1,3,0,1,0,76.14,62.89 ,33.33
01,000,02,008,0254,0,1994,30,2024,3305,0,3,1,3,0,1,0,76.14,61.24 ,33.33
01,000,02,008,0255,0,1862,13,1875,2943,0,3,1,3,0,1,0,76.14,63.71 ,33.33
01,000,02,008,0256,0,2632,29,2661,4179,0,3,1,3,0,1,0,76.14,63.68 ,33.33
01,000,02,008,0257,0,1951,22,1973,3140,0,3,1,3,0,1,0,76.14,62.83 ,33.33
01,000,02,008,0258,0,2204,18,2222,3634,0,3,1,3,0,1,0,76.14,61.14 ,33.33
01,000,02,008,0259,0,2854,20,2874,4230,0,3,1,3,0,1,0,76.14,67.94 ,33.33
01,000,02,008,0260,0,2579,26,2605,4031,0,3,1,3,0,1,0,76.14,64.62 ,33.33
01,000,02,008,0261,0,1880,11,1891,3137,0,3,1,3,0,1,0,76.14,60.28 ,33.33
01,000,02,008,0262,0,4586,45,4631,7471,0,3,1,3,0,1,0,76.14,61.99 ,33.33
01,000,02,008,0263,0,1899,22,1921,3165,0,3,1,3,0,1,0,76.14,60.70 ,33.33
01,000,02,008,0264,0,3191,82,3273,5227,0,3,1,3,0,1,0,76.14,62.62 ,33.33
01,000,02,008,0265,0,1519,22,1541,2408,0,3,1,3,0,1,0,76.14,64.00 ,33.33
01,000,02,008,0266,0,1742,13,1755,2697,0,3,1,3,0,1,0,76.14,65.07 ,33.33
01,000,02,008,0267,0,2324,22,2346,3868,0,3,1,3,0,1,0,76.14,60.65 ,33.33
01,000,02,008,0268,0,2310,29,2339,3595,0,3,1,3,0,1,0,76.14,65.06 ,33.33
01,000,02,008,0269,0,1301,9,1310,2001,0,3,1,3,0,1,0,76.14,65.47 ,33.33
01,000,02,008,0270,0,1624,18,1642,2741,0,3,1,3,0,1,0,76.14,59.91 ,33.33
01,000,02,008,0271,0,2780,45,2825,4459,0,3,1,3,0,1,0,76.14,63.36 ,33.33
01,000,02,008,0272,0,3272,36,3308,5196,0,3,1,3,0,1,0,76.14,63.66 ,33.33
01,000,02,008,0273,0,4130,36,4166,6431,0,3,1,3,0,1,0,76.14,64.78 ,33.33
01,000,02,008,0274,0,674,6,680,1079,0,3,1,3,0,1,0,76.14,63.02 ,33.33
01,000,02,008,0275,0,2271,14,2285,3643,0,3,1,3,0,1,0,76.14,62.72 ,33.33
01,000,02,008,0276,0,2435,28,2463,3771,0,3,1,3,0,1,0,76.14,65.31 ,33.33
01,000,02,008,0277,0,3023,26,3049,4709,0,3,1,3,0,1,0,76.14,64.75 ,33.33
01,000,02,009,0278,0,1628,14,1642,2562,0,3,1,3,0,1,0,76.14,64.09 ,33.33
01,000,02,009,0279,0,1538,22,1560,2435,0,3,1,3,0,1,0,76.14,64.07 ,33.33
01,000,02,009,0280,0,1490,6,1496,2287,0,3,1,3,0,1,0,76.14,65.41 ,33.33
01,000,02,009,0281,0,2455,15,2470,3786,0,3,1,3,0,1,0,76.14,65.24 ,33.33
01,000,02,009,0282,0,2489,24,2513,3879,0,3,1,3,0,1,0,76.14,64.78 ,33.33
01,000,02,009,0283,0,3125,22,3147,4580,0,3,1,3,0,1,0,76.14,68.71 ,33.33
01,000,02,009,0284,0,2921,14,2935,4451,0,3,1,3,0,1,0,76.14,65.94 ,33.33
01,000,02,009,0285,0,1781,30,1811,2744,0,3,1,3,0,1,0,76.14,66.00 ,33.33
01,000,02,009,0286,0,2898,16,2914,4314,0,3,1,3,0,1,0,76.14,67.55 ,33.33
01,000,02,009,0287,0,2349,21,2370,3612,0,3,1,3,0,1,0,76.14,65.61 ,33.33
01,000,02,009,0288,0,3213,23,3236,5072,0,3,1,3,0,1,0,76.14,63.80 ,33.33
01,000,02,009,0289,0,2796,41,2837,4414,0,3,1,3,0,1,0,76.14,64.27 ,33.33
01,000,02,009,0290,0,2029,13,2042,3174,0,3,1,3,0,1,0,76.14,64.34 ,33.33
01,000,02,009,0291,0,3544,66,3610,5780,0,3,1,3,0,1,0,76.14,62.46 ,33.33
01,000,02,009,0292,0,1991,15,2006,3034,0,3,1,3,0,1,0,76.14,66.12 ,33.33
01,000,02,009,0293,0,1708,9,1717,2589,0,3,1,3,0,1,0,76.14,66.32 ,33.33
01,000,02,009,0294,0,1764,13,1777,2687,0,3,1,3,0,1,0,76.14,66.13 ,33.33
01,000,02,009,0295,0,1911,16,1927,2986,0,3,1,3,0,1,0,76.14,64.53 ,33.33
01,000,02,009,0296,0,3883,32,3915,5893,0,3,1,3,0,1,0,76.14,66.43 ,33.33
01,000,02,009,0297,0,3137,25,3162,5014,0,3,1,3,0,1,0,76.14,63.06 ,33.33
01,000,02,009,0298,0,4112,34,4146,6081,0,3,1,3,0,1,0,76.14,68.18 ,33.33
01,000,02,009,0299,0,675,8,683,1138,0,3,1,3,0,1,0,76.14,60.02 ,33.33
01,000,02,009,0300,0,1680,14,1694,2875,0,3,1,3,0,1,0,76.14,58.92 ,33.33
01,000,02,009,0301,0,1244,14,1258,2235,0,3,1,3,0,1,0,76.14,56.29 ,33.33
01,000,02,009,0302,0,1779,8,1787,2835,0,3,1,3,0,1,0,76.14,63.03 ,33.33
01,000,02,009,0303,0,2105,12,2117,3388,0,3,1,3,0,1,0,76.14,62.49 ,33.33
01,000,02,009,0304,0,2188,12,2200,3535,0,3,1,3,0,1,0,76.14,62.23 ,33.33
01,000,02,009,0305,0,2230,18,2248,3516,0,3,1,3,0,1,0,76.14,63.94 ,33.33
01,000,02,009,0306,0,2571,15,2586,4052,0,3,1,3,0,1,0,76.14,63.82 ,33.33
01,000,02,009,0307,0,3479,35,3514,5270,0,3,1,3,0,1,0,76.14,66.68 ,33.33
01,000,02,009,0308,0,3882,34,3916,5990,0,3,1,3,0,1,0,76.14,65.38 ,33.33
01,000,02,010,0309,0,2445,38,2483,4033,0,3,1,3,0,1,0,76.14,61.57 ,33.33
01,000,02,010,0310,0,1515,20,1535,2682,0,3,1,3,0,1,0,76.14,57.23 ,33.33
01,000,02,010,0311,0,1592,18,1610,2866,0,3,1,3,0,1,0,76.14,56.18 ,33.33
01,000,02,010,0312,0,3530,39,3569,5676,0,3,1,3,0,1,0,76.14,62.88 ,33.33
01,000,02,010,0313,0,3086,27,3113,5041,0,3,1,3,0,1,0,76.14,61.75 ,33.33
01,000,02,010,0314,0,2716,32,2748,4404,0,3,1,3,0,1,0,76.14,62.40 ,33.33
01,000,02,010,0315,0,2785,26,2811,4261,0,3,1,3,0,1,0,76.14,65.97 ,33.33
01,000,02,010,0316,0,2060,25,2085,3093,0,3,1,3,0,1,0,76.14,67.41 ,33.33
01,000,02,010,0317,0,2387,22,2409,3575,0,3,1,3,0,1,0,76.14,67.38 ,33.33
01,000,02,010,0318,0,2627,16,2643,3868,0,3,1,3,0,1,0,76.14,68.33 ,33.33
01,000,02,010,0319,0,2259,16,2275,3681,0,3,1,3,0,1,0,76.14,61.80 ,33.33
01,000,02,010,0320,0,2950,34,2984,4862,0,3,1,3,0,1,0,76.14,61.37 ,33.33
01,000,02,010,0321,0,4441,57,4498,6950,0,3,1,3,0,1,0,76.14,64.72 ,33.33
01,000,02,010,0322,0,2806,47,2853,4509,0,3,1,3,0,1,0,76.14,63.27 ,33.33
01,000,02,010,0323,0,2693,22,2715,4038,0,3,1,3,0,1,0,76.14,67.24 ,33.33
01,000,02,010,0324,0,2541,30,2571,4005,0,3,1,3,0,1,0,76.14,64.19 ,33.33
01,000,02,010,0325,0,3325,45,3370,5143,0,3,1,3,0,1,0,76.14,65.53 ,33.33
01,000,02,010,0326,0,3210,35,3245,4849,0,3,1,3,0,1,0,76.14,66.92 ,33.33
01,000,02,010,0327,0,2966,32,2998,4292,0,3,1,3,0,1,0,76.14,69.85 ,33.33
01,000,02,010,0328,0,2301,33,2334,3518,0,3,1,3,0,1,0,76.14,66.34 ,33.33
01,000,02,010,0329,0,1719,15,1734,2569,0,3,1,3,0,1,0,76.14,67.50 ,33.33
01,000,02,010,0330,0,2456,30,2486,3721,0,3,1,3,0,1,0,76.14,66.81 ,33.33
01,000,02,010,0331,0,1756,24,1780,2692,0,3,1,3,0,1,0,76.14,66.12 ,33.33
01,000,02,010,0332,0,3520,45,3565,5845,0,3,1,3,0,1,0,76.14,60.99 ,33.33
01,000,02,010,0333,0,2771,30,2801,4296,0,3,1,3,0,1,0,76.14,65.20 ,33.33
01,000,02,010,0334,0,2191,28,2219,3380,0,3,1,3,0,1,0,76.14,65.65 ,33.33
01,000,02,010,0335,0,1664,18,1682,2462,0,3,1,3,0,1,0,76.14,68.32 ,33.33
01,000,02,010,0336,0,2558,24,2582,3888,0,3,1,3,0,1,0,76.14,66.41 ,33.33
01,000,02,010,0337,0,2250,37,2287,3306,0,3,1,3,0,1,0,76.14,69.18 ,33.33
01,000,02,010,0338,0,3845,57,3902,6031,0,3,1,3,0,1,0,76.14,64.70 ,33.33
01,000,02,010,0339,0,2069,23,2092,3145,0,3,1,3,0,1,0,76.14,66.52 ,33.33
01,000,02,010,0340,0,3596,53,3649,5483,0,3,1,3,0,1,0,76.14,66.55 ,33.33
01,000,02,010,0341,0,4272,45,4317,6565,0,3,1,3,0,1,0,76.14,65.76 ,33.33
01,000,02,010,0342,0,2734,27,2761,4267,0,3,1,3,0,1,0,76.14,64.71 ,33.33
01,000,02,010,0343,0,2252,8,2260,3315,0,3,1,3,0,1,0,76.14,68.17 ,33.33
01,000,02,010,0344,0,4980,46,5026,7145,0,3,1,3,0,1,0,76.14,70.34 ,33.33
01,000,02,011,0345,0,2843,22,2865,4474,0,3,1,3,0,1,0,76.14,64.04 ,33.33
01,000,02,011,0346,0,2460,19,2479,3870,0,3,1,3,0,1,0,76.14,64.06 ,33.33
01,000,02,011,0347,0,3185,22,3207,4909,0,3,1,3,0,1,0,76.14,65.33 ,33.33
01,000,02,011,0348,0,3964,21,3985,6332,0,3,1,3,0,1,0,76.14,62.93 ,33.33
01,000,02,011,0349,0,2639,20,2659,4627,0,3,1,3,0,1,0,76.14,57.47 ,33.33
01,000,02,011,0350,0,3643,29,3672,5528,0,3,1,3,0,1,0,76.14,66.43 ,33.33
01,000,02,011,0351,0,3246,24,3270,5163,0,3,1,3,0,1,0,76.14,63.34 ,33.33
01,000,02,011,0352,0,1878,19,1897,2924,0,3,1,3,0,1,0,76.14,64.88 ,33.33
01,000,02,011,0353,0,2275,14,2289,3583,0,3,1,3,0,1,0,76.14,63.89 ,33.33
01,000,02,011,0354,0,3752,32,3784,6280,0,3,1,3,0,1,0,76.14,60.25 ,33.33
01,000,02,011,0355,0,2985,13,2998,4431,0,3,1,3,0,1,0,76.14,67.66 ,33.33
01,000,02,011,0356,0,2239,11,2250,3557,0,3,1,3,0,1,0,76.14,63.26 ,33.33
01,000,02,011,0357,0,2149,8,2157,3293,0,3,1,3,0,1,0,76.14,65.50 ,33.33
01,000,02,011,0358,0,3253,22,3275,5021,0,3,1,3,0,1,0,76.14,65.23 ,33.33
01,000,02,011,0359,0,2848,16,2864,4842,0,3,1,3,0,1,0,76.14,59.15 ,33.33
01,000,02,011,0360,0,2591,12,2603,3943,0,3,1,3,0,1,0,76.14,66.02 ,33.33
01,000,02,011,0361,0,2744,20,2764,4240,0,3,1,3,0,1,0,76.14,65.19 ,33.33
01,000,02,011,0362,0,1671,16,1687,2544,0,3,1,3,0,1,0,76.14,66.31 ,33.33
01,000,02,011,0363,0,1905,11,1916,2819,0,3,1,3,0,1,0,76.14,67.97 ,33.33
01,000,02,011,0364,0,2771,29,2800,3987,0,3,1,3,0,1,0,76.14,70.23 ,33.33
01,000,02,011,0365,0,2675,15,2690,4065,0,3,1,3,0,1,0,76.14,66.17 ,33.33
01,000,02,011,0366,0,3274,20,3294,5224,0,3,1,3,0,1,0,76.14,63.06 ,33.33
01,000,02,011,0367,0,3432,27,3459,5084,0,3,1,3,0,1,0,76.14,68.04 ,33.33
01,000,02,011,0368,0,1895,15,1910,2972,0,3,1,3,0,1,0,76.14,64.27 ,33.33
01,000,02,011,0369,0,2621,24,2645,4063,0,3,1,3,0,1,0,76.14,65.10 ,33.33
01,000,02,011,0370,0,3200,22,3222,4777,0,3,1,3,0,1,0,76.14,67.45 ,33.33
01,000,02,011,0371,0,2756,30,2786,4367,0,3,1,3,0,1,0,76.14,63.80 ,33.33
01,000,02,011,0372,0,2719,20,2739,4429,0,3,1,3,0,1,0,76.14,61.84 ,33.33
01,000,02,011,0373,0,3128,33,3161,4842,0,3,1,3,0,1,0,76.14,65.28 ,33.33
01,000,02,011,0374,0,2924,21,2945,4556,0,3,1,3,0,1,0,76.14,64.64 ,33.33
01,000,02,011,0375,0,2276,24,2300,3495,0,3,1,3,0,1,0,76.14,65.81 ,33.33
01,000,02,011,0376,0,2323,18,2341,3513,0,3,1,3,0,1,0,76.14,66.64 ,33.33
01,000,02,011,0377,0,2226,12,2238,3508,0,3,1,3,0,1,0,76.14,63.80 ,33.33
01,000,02,011,0378,0,3221,15,3236,5014,0,3,1,3,0,1,0,76.14,64.54 ,33.33
01,000,02,011,0379,0,3995,17,4012,5845,0,3,1,3,0,1,0,76.14,68.64 ,33.33
01,000,02,011,0380,0,1698,13,1711,2593,0,3,1,3,0,1,0,76.14,65.99 ,33.33
01,000,02,011,0381,0,1572,9,1581,2421,0,3,1,3,0,1,0,76.14,65.30 ,33.33
01,000,02,011,0382,0,4522,29,4551,6862,0,3,1,3,0,1,0,76.14,66.32 ,33.33
01,000,02,011,0383,0,2097,10,2107,3224,0,3,1,3,0,1,0,76.14,65.35 ,33.33
01,000,02,011,0384,0,1039,10,1049,1672,0,3,1,3,0,1,0,76.14,62.74 ,33.33
01,000,02,011,0385,0,4090,40,4130,6433,0,3,1,3,0,1,0,76.14,64.20 ,33.33
01,000,02,011,0386,0,3288,27,3315,4970,0,3,1,3,0,1,0,76.14,66.70 ,33.33
01,000,02,011,0387,0,1094,12,1106,1659,0,3,1,3,0,1,0,76.14,66.67 ,33.33
01,000,02,011,0388,0,2916,35,2951,4483,0,3,1,3,0,1,0,76.14,65.83 ,33.33
01,000,02,011,0389,0,4084,30,4114,6034,0,3,1,3,0,1,0,76.14,68.18 ,33.33
01,000,02,011,0390,0,2157,28,2185,3364,0,3,1,3,0,1,0,76.14,64.95 ,33.33
01,000,02,011,0391,0,2442,22,2464,4087,0,3,1,3,0,1,0,76.14,60.29 ,33.33
01,000,02,011,0392,0,2934,17,2951,4879,0,3,1,3,0,1,0,76.14,60.48 ,33.33
01,000,02,011,0393,0,3011,22,3033,4861,0,3,1,3,0,1,0,76.14,62.39 ,33.33
01,000,02,011,0394,0,2313,13,2326,3774,0,3,1,3,0,1,0,76.14,61.63 ,33.33
01,000,02,011,0395,0,3006,11,3017,4730,0,3,1,3,0,1,0,76.14,63.78 ,33.33
01,000,02,011,0396,0,2094,17,2111,3398,0,3,1,3,0,1,0,76.14,62.12 ,33.33
01,000,02,011,0397,0,3390,21,3411,5279,0,3,1,3,0,1,0,76.14,64.61 ,33.33
01,000,02,011,0398,0,3899,23,3922,6099,0,3,1,3,0,1,0,76.14,64.31 ,33.33
01,000,02,012,0399,0,2648,30,2678,4089,0,3,1,3,0,1,0,76.14,65.49 ,33.33
01,000,02,012,0400,0,3229,36,3265,5073,0,3,1,3,0,1,0,76.14,64.36 ,33.33
01,000,02,012,0401,0,2259,16,2275,3377,0,3,1,3,0,1,0,76.14,67.37 ,33.33
01,000,02,012,0402,0,3248,33,3281,4907,0,3,1,3,0,1,0,76.14,66.86 ,33.33
01,000,02,012,0403,0,2493,23,2516,3736,0,3,1,3,0,1,0,76.14,67.34 ,33.33
01,000,02,012,0404,0,2786,17,2803,4342,0,3,1,3,0,1,0,76.14,64.56 ,33.33
01,000,02,012,0405,0,2464,15,2479,3626,0,3,1,3,0,1,0,76.14,68.37 ,33.33
01,000,02,012,0406,0,2296,16,2312,3457,0,3,1,3,0,1,0,76.14,66.88 ,33.33
01,000,02,012,0407,0,3506,15,3521,5308,0,3,1,3,0,1,0,76.14,66.33 ,33.33
01,000,02,012,0408,0,2692,24,2716,4144,0,3,1,3,0,1,0,76.14,65.54 ,33.33
01,000,02,012,0409,0,1981,21,2002,2824,0,3,1,3,0,1,0,76.14,70.89 ,33.33
01,000,02,012,0410,0,2510,12,2522,3785,0,3,1,3,0,1,0,76.14,66.63 ,33.33
01,000,02,012,0411,0,4486,49,4535,6701,0,3,1,3,0,1,0,76.14,67.68 ,33.33
01,000,02,012,0412,0,2453,25,2478,3844,0,3,1,3,0,1,0,76.14,64.46 ,33.33
01,000,02,012,0413,0,2872,17,2889,4402,0,3,1,3,0,1,0,76.14,65.63 ,33.33
01,000,02,012,0414,0,3096,27,3123,4875,0,3,1,3,0,1,0,76.14,64.06 ,33.33
01,000,02,012,0415,0,2822,22,2844,4340,0,3,1,3,0,1,0,76.14,65.53 ,33.33
01,000,02,012,0416,0,3211,26,3237,4753,0,3,1,3,0,1,0,76.14,68.10 ,33.33
01,000,02,012,0417,0,3032,18,3050,4465,0,3,1,3,0,1,0,76.14,68.31 ,33.33
01,000,02,012,0418,0,3267,32,3299,5016,0,3,1,3,0,1,0,76.14,65.77 ,33.33
01,000,02,012,0419,0,1907,18,1925,2959,0,3,1,3,0,1,0,76.14,65.06 ,33.33
01,000,02,012,0420,0,3155,23,3178,4698,0,3,1,3,0,1,0,76.14,67.65 ,33.33
01,000,02,012,0421,0,3250,27,3277,4769,0,3,1,3,0,1,0,76.14,68.71 ,33.33
01,000,02,012,0422,0,3766,28,3794,5708,0,3,1,3,0,1,0,76.14,66.47 ,33.33
01,000,02,012,0423,0,2042,48,2090,3505,0,3,1,3,0,1,0,76.14,59.63 ,33.33
01,000,02,012,0424,0,3488,32,3520,5478,0,3,1,3,0,1,0,76.14,64.26 ,33.33
01,000,02,012,0425,0,3918,41,3959,5797,0,3,1,3,0,1,0,76.14,68.29 ,33.33
01,000,02,012,0426,0,4403,51,4454,6801,0,3,1,3,0,1,0,76.14,65.49 ,33.33
01,000,02,012,0427,0,5419,53,5472,8047,0,3,1,3,0,1,0,76.14,68.00 ,33.33
01,000,02,012,0428,0,4200,39,4239,6508,0,3,1,3,0,1,0,76.14,65.14 ,33.33
01,000,02,012,0429,0,5662,32,5694,8512,0,3,1,3,0,1,0,76.14,66.89 ,33.33
01,000,02,012,0430,0,4732,118,4850,7239,0,3,1,3,0,1,0,76.14,67.00 ,33.33
01,000,02,012,0431,0,6979,58,7037,10575,0,3,1,3,0,1,0,76.14,66.54 ,33.33
01,000,02,012,0432,0,1989,24,2013,3111,0,3,1,3,0,1,0,76.14,64.71 ,33.33
01,000,02,012,0433,0,4994,43,5037,7610,0,3,1,3,0,1,0,76.14,66.19 ,33.33
01,000,02,012,0434,0,1464,23,1487,2278,0,3,1,3,0,1,0,76.14,65.28 ,33.33
01,000,02,012,0435,0,437,6,443,674,0,3,1,3,0,1,0,76.14,65.73 ,33.33
02,000,01,001,0001,0,817,7,824,1229,0,3,1,3,0,1,0,76.14,67.05 ,33.33
02,000,01,001,0002,0,409,2,411,577,0,3,1,3,0,1,0,76.14,71.23 ,33.33
02,000,01,001,0003,0,555,11,566,771,0,3,1,3,0,1,0,76.14,73.41 ,33.33
02,000,01,001,0004,0,873,5,878,1284,0,3,1,3,0,1,0,76.14,68.38 ,33.33
02,000,01,001,0005,0,783,3,786,1182,0,3,1,3,0,1,0,76.14,66.50 ,33.33
02,000,01,001,0006,0,1502,11,1513,2214,0,3,1,3,0,1,0,76.14,68.34 ,33.33
02,000,01,001,0007,0,607,5,612,876,0,3,1,3,0,1,0,76.14,69.86 ,33.33
02,000,01,001,0008,0,488,4,492,687,0,3,1,3,0,1,0,76.14,71.62 ,33.33
02,000,01,001,0009,0,738,9,747,1174,0,3,1,3,0,1,0,76.14,63.63 ,33.33
02,000,01,001,0010,0,516,3,519,810,0,3,1,3,0,1,0,76.14,64.07 ,33.33
02,000,01,001,0011,0,1196,17,1213,1899,0,3,1,3,0,1,0,76.14,63.88 ,33.33
02,000,01,001,0012,0,682,6,688,1074,0,3,1,3,0,1,0,76.14,64.06 ,33.33
02,000,01,001,0013,0,735,7,742,1151,0,3,1,3,0,1,0,76.14,64.47 ,33.33
02,000,01,001,0014,0,749,5,754,1144,0,3,1,3,0,1,0,76.14,65.91 ,33.33
02,000,01,001,0015,0,824,8,832,1225,0,3,1,3,0,1,0,76.14,67.92 ,33.33
02,000,01,001,0016,0,462,5,467,651,0,3,1,3,0,1,0,76.14,71.74 ,33.33
02,000,01,001,0017,0,1140,17,1157,1757,0,3,1,3,0,1,0,76.14,65.85 ,33.33
02,000,01,001,0018,0,862,16,878,1297,0,3,1,3,0,1,0,76.14,67.69 ,33.33
02,000,01,001,0019,0,491,4,495,705,0,3,1,3,0,1,0,76.14,70.21 ,33.33
02,000,01,001,0020,0,524,8,532,773,0,3,1,3,0,1,0,76.14,68.82 ,33.33
02,000,01,001,0021,0,616,11,627,938,0,3,1,3,0,1,0,76.14,66.84 ,33.33
02,000,01,002,0022,0,1371,16,1387,2040,0,3,1,3,0,1,0,76.14,67.99 ,33.33
02,000,01,002,0023,0,1402,19,1421,2065,0,3,1,3,0,1,0,76.14,68.81 ,33.33
02,000,01,002,0024,0,2938,29,2967,4189,0,3,1,3,0,1,0,76.14,70.83 ,33.33
02,000,01,002,0025,0,2652,19,2671,3936,0,3,1,3,0,1,0,76.14,67.86 ,33.33
02,000,01,002,0026,0,1004,13,1017,1450,0,3,1,3,0,1,0,76.14,70.14 ,33.33
02,000,01,002,0027,0,825,7,832,1185,0,3,1,3,0,1,0,76.14,70.21 ,33.33
02,000,01,002,0028,0,1437,12,1449,2044,0,3,1,3,0,1,0,76.14,70.89 ,33.33
02,000,01,002,0029,0,2610,26,2636,3912,0,3,1,3,0,1,0,76.14,67.38 ,33.33
02,000,01,002,0030,0,593,6,599,849,0,3,1,3,0,1,0,76.14,70.55 ,33.33
02,000,01,002,0031,0,1075,14,1089,1556,0,3,1,3,0,1,0,76.14,69.99 ,33.33
02,000,01,002,0032,0,1107,16,1123,1669,0,3,1,3,0,1,0,76.14,67.29 ,33.33
02,000,01,002,0033,0,2090,12,2102,3021,0,3,1,3,0,1,0,76.14,69.58 ,33.33
02,000,01,002,0034,0,1940,18,1958,2841,0,3,1,3,0,1,0,76.14,68.92 ,33.33
02,000,01,002,0035,0,1476,12,1488,2085,0,3,1,3,0,1,0,76.14,71.37 ,33.33
02,000,01,002,0036,0,3058,33,3091,5010,0,3,1,3,0,1,0,76.14,61.70 ,33.33
02,000,01,002,0037,0,610,4,614,972,0,3,1,3,0,1,0,76.14,63.17 ,33.33
02,000,01,002,0038,0,5823,53,5876,9167,0,3,1,3,0,1,0,76.14,64.10 ,33.33
02,000,01,002,0039,0,2117,22,2139,3116,0,3,1,3,0,1,0,76.14,68.65 ,33.33
02,000,01,002,0040,0,1847,19,1866,2838,0,3,1,3,0,1,0,76.14,65.75 ,33.33
02,000,01,002,0041,0,1475,4,1479,2269,0,3,1,3,0,1,0,76.14,65.18 ,33.33
02,000,01,002,0042,0,1058,17,1075,1606,0,3,1,3,0,1,0,76.14,66.94 ,33.33
02,000,01,002,0043,0,664,6,670,963,0,3,1,3,0,1,0,76.14,69.57 ,33.33
02,000,01,002,0044,0,645,8,653,992,0,3,1,3,0,1,0,76.14,65.83 ,33.33
02,000,01,002,0045,0,1041,14,1055,1547,0,3,1,3,0,1,0,76.14,68.20 ,33.33
02,000,01,002,0046,0,1018,13,1031,1580,0,3,1,3,0,1,0,76.14,65.25 ,33.33
02,000,01,002,0047,0,1019,9,1028,1500,0,3,1,3,0,1,0,76.14,68.53 ,33.33
02,000,01,002,0048,0,1045,14,1059,1545,0,3,1,3,0,1,0,76.14,68.54 ,33.33
02,000,01,002,0049,0,1093,18,1111,1674,0,3,1,3,0,1,0,76.14,66.37 ,33.33
02,000,01,002,0050,0,563,4,567,839,0,3,1,3,0,1,0,76.14,67.58 ,33.33
02,000,01,002,0051,0,683,10,693,1083,0,3,1,3,0,1,0,76.14,63.99 ,33.33
02,000,01,002,0052,0,729,6,735,1165,0,3,1,3,0,1,0,76.14,63.09 ,33.33
02,000,01,002,0053,0,765,13,778,1162,0,3,1,3,0,1,0,76.14,66.95 ,33.33
02,000,01,002,0054,0,613,5,618,934,0,3,1,3,0,1,0,76.14,66.17 ,33.33
02,000,01,002,0055,0,973,17,990,1542,0,3,1,3,0,1,0,76.14,64.20 ,33.33
02,000,01,002,0056,0,843,6,849,1343,0,3,1,3,0,1,0,76.14,63.22 ,33.33
02,000,01,002,0057,0,955,15,970,1589,0,3,1,3,0,1,0,76.14,61.04 ,33.33
02,000,01,002,0058,0,803,8,811,1213,0,3,1,3,0,1,0,76.14,66.86 ,33.33
02,000,01,002,0059,0,427,4,431,638,0,3,1,3,0,1,0,76.14,67.55 ,33.33
02,000,01,003,0060,0,1098,13,1111,1676,0,3,1,3,0,1,0,76.14,66.29 ,33.33
02,000,01,003,0061,0,900,9,909,1271,0,3,1,3,0,1,0,76.14,71.52 ,33.33
02,000,01,003,0062,0,425,7,432,636,0,3,1,3,0,1,0,76.14,67.92 ,33.33
02,000,01,003,0063,0,503,2,505,707,0,3,1,3,0,1,0,76.14,71.43 ,33.33
02,000,01,003,0064,0,400,9,409,558,0,3,1,3,0,1,0,76.14,73.30 ,33.33
02,000,01,003,0065,0,680,9,689,939,0,3,1,3,0,1,0,76.14,73.38 ,33.33
02,000,01,003,0066,0,746,13,759,1048,0,3,1,3,0,1,0,76.14,72.42 ,33.33
02,000,01,003,0067,0,574,8,582,834,0,3,1,3,0,1,0,76.14,69.78 ,33.33
02,000,01,003,0068,0,1812,21,1833,2589,0,3,1,3,0,1,0,76.14,70.80 ,33.33
02,000,01,003,0069,0,219,4,223,392,0,3,1,3,0,1,0,76.14,56.89 ,33.33
02,000,01,003,0070,0,1020,10,1030,1480,0,3,1,3,0,1,0,76.14,69.59 ,33.33
02,000,01,003,0071,0,494,6,500,677,0,3,1,3,0,1,0,76.14,73.86 ,33.33
02,000,01,003,0072,0,1367,20,1387,1950,0,3,1,3,0,1,0,76.14,71.13 ,33.33
02,000,01,003,0073,0,898,9,907,1273,0,3,1,3,0,1,0,76.14,71.25 ,33.33
02,000,01,003,0074,0,1159,10,1169,1680,0,3,1,3,0,1,0,76.14,69.58 ,33.33
02,000,01,003,0075,0,1713,21,1734,2565,0,3,1,3,0,1,0,76.14,67.60 ,33.33
02,000,01,003,0076,0,926,3,929,1327,0,3,1,3,0,1,0,76.14,70.01 ,33.33
02,000,01,003,0077,0,1306,9,1315,1827,0,3,1,3,0,1,0,76.14,71.98 ,33.33
02,000,01,003,0078,0,1036,14,1050,1471,0,3,1,3,0,1,0,76.14,71.38 ,33.33
02,000,01,003,0079,0,676,3,679,942,0,3,1,3,0,1,0,76.14,72.08 ,33.33
02,000,01,003,0080,0,869,7,876,1196,0,3,1,3,0,1,0,76.14,73.24 ,33.33
02,000,01,003,0081,0,667,8,675,980,0,3,1,3,0,1,0,76.14,68.88 ,33.33
02,000,01,003,0082,0,308,6,314,428,0,3,1,3,0,1,0,76.14,73.36 ,33.33
02,000,01,003,0083,0,401,5,406,580,0,3,1,3,0,1,0,76.14,70.00 ,33.33
02,000,01,003,0084,0,400,0,400,588,0,3,1,3,0,1,0,76.14,68.03 ,33.33
02,000,01,003,0085,0,555,1,556,803,0,3,1,3,0,1,0,76.14,69.24 ,33.33
02,000,01,003,0086,0,393,5,398,550,0,3,1,3,0,1,0,76.14,72.36 ,33.33
02,000,01,003,0087,0,569,2,571,789,0,3,1,3,0,1,0,76.14,72.37 ,33.33
02,000,01,003,0088,0,798,8,806,1129,0,3,1,3,0,1,0,76.14,71.39 ,33.33
02,000,01,003,0089,0,961,9,970,1457,0,3,1,3,0,1,0,76.14,66.58 ,33.33
02,000,01,003,0090,0,879,12,891,1271,0,3,1,3,0,1,0,76.14,70.10 ,33.33
02,000,01,003,0091,0,2423,24,2447,3306,0,3,1,3,0,1,0,76.14,74.02 ,33.33
02,000,01,003,0092,0,1247,19,1266,1723,0,3,1,3,0,1,0,76.14,73.48 ,33.33
02,000,01,003,0093,0,831,8,839,1116,0,3,1,3,0,1,0,76.14,75.18 ,33.33
02,000,01,003,0094,0,1680,16,1696,2356,0,3,1,3,0,1,0,76.14,71.99 ,33.33
02,000,01,003,0095,0,1415,13,1428,1948,0,3,1,3,0,1,0,76.14,73.31 ,33.33
02,000,01,003,0096,0,1079,12,1091,1597,0,3,1,3,0,1,0,76.14,68.32 ,33.33
02,000,01,003,0097,0,1268,14,1282,1786,0,3,1,3,0,1,0,76.14,71.78 ,33.33
02,000,01,003,0098,0,5567,40,5607,8738,0,3,1,3,0,1,0,76.14,64.17 ,33.33
02,000,01,003,0099,0,10129,92,10221,16627,0,3,1,3,0,1,0,76.14,61.47 ,33.33
02,000,01,003,0100,0,2863,27,2890,4350,0,3,1,3,0,1,0,76.14,66.44 ,33.33
02,000,01,003,0101,0,4906,40,4946,7749,0,3,1,3,0,1,0,76.14,63.83 ,33.33
02,000,01,003,0102,0,8775,65,8840,14346,0,3,1,3,0,1,0,76.14,61.62 ,33.33
02,000,01,003,0103,0,9984,95,10079,16960,0,3,1,3,0,1,0,76.14,59.43 ,33.33
02,000,01,004,0104,0,4701,53,4754,7689,0,3,1,3,0,1,0,76.14,61.83 ,33.33
02,000,01,004,0105,0,1350,12,1362,2122,0,3,1,3,0,1,0,76.14,64.18 ,33.33
02,000,01,004,0106,0,2484,33,2517,4045,0,3,1,3,0,1,0,76.14,62.22 ,33.33
02,000,01,004,0107,0,1628,14,1642,2615,0,3,1,3,0,1,0,76.14,62.79 ,33.33
02,000,01,004,0108,0,1655,17,1672,2578,0,3,1,3,0,1,0,76.14,64.86 ,33.33
02,000,01,004,0109,0,1426,22,1448,2344,0,3,1,3,0,1,0,76.14,61.77 ,33.33
02,000,01,004,0110,0,2136,23,2159,3131,0,3,1,3,0,1,0,76.14,68.96 ,33.33
02,000,01,004,0111,0,1507,19,1526,2414,0,3,1,3,0,1,0,76.14,63.21 ,33.33
02,000,01,004,0112,0,2338,12,2350,3357,0,3,1,3,0,1,0,76.14,70.00 ,33.33
02,000,01,004,0113,0,1575,22,1597,2273,0,3,1,3,0,1,0,76.14,70.26 ,33.33
02,000,01,004,0114,0,2129,20,2149,3123,0,3,1,3,0,1,0,76.14,68.81 ,33.33
02,000,01,004,0115,0,1068,13,1081,1623,0,3,1,3,0,1,0,76.14,66.61 ,33.33
02,000,01,004,0116,0,1996,32,2028,3076,0,3,1,3,0,1,0,76.14,65.93 ,33.33
02,000,01,004,0117,0,6670,60,6730,10638,0,3,1,3,0,1,0,76.14,63.26 ,33.33
02,000,01,004,0118,0,1171,9,1180,1673,0,3,1,3,0,1,0,76.14,70.53 ,33.33
02,000,01,004,0119,0,2083,21,2104,2887,0,3,1,3,0,1,0,76.14,72.88 ,33.33
02,000,01,004,0120,0,1384,13,1397,1833,0,3,1,3,0,1,0,76.14,76.21 ,33.33
02,000,01,004,0121,0,2078,24,2102,2983,0,3,1,3,0,1,0,76.14,70.47 ,33.33
02,000,01,004,0122,0,1326,19,1345,2148,0,3,1,3,0,1,0,76.14,62.62 ,33.33
02,000,01,004,0123,0,1376,15,1391,2034,0,3,1,3,0,1,0,76.14,68.39 ,33.33
02,000,01,004,0124,0,1286,12,1298,1795,0,3,1,3,0,1,0,76.14,72.31 ,33.33
02,000,01,004,0125,0,2363,10,2373,3422,0,3,1,3,0,1,0,76.14,69.35 ,33.33
02,000,01,004,0126,0,1018,9,1027,1526,0,3,1,3,0,1,0,76.14,67.30 ,33.33
02,000,01,004,0127,0,1767,12,1779,2650,0,3,1,3,0,1,0,76.14,67.13 ,33.33
02,000,01,004,0128,0,1515,16,1531,2256,0,3,1,3,0,1,0,76.14,67.86 ,33.33
02,000,01,004,0129,0,1355,10,1365,2125,0,3,1,3,0,1,0,76.14,64.24 ,33.33
02,000,01,004,0130,0,1483,12,1495,2097,0,3,1,3,0,1,0,76.14,71.29 ,33.33
02,000,01,004,0131,0,2101,10,2111,3020,0,3,1,3,0,1,0,76.14,69.90 ,33.33
02,000,01,004,0132,0,2196,29,2225,3206,0,3,1,3,0,1,0,76.14,69.40 ,33.33
02,000,01,004,0133,0,1267,19,1286,1945,0,3,1,3,0,1,0,76.14,66.12 ,33.33
02,000,01,004,0134,0,1637,17,1654,2454,0,3,1,3,0,1,0,76.14,67.40 ,33.33
02,000,01,004,0135,0,1781,22,1803,2786,0,3,1,3,0,1,0,76.14,64.72 ,33.33
02,000,01,004,0136,0,3555,31,3586,5322,0,3,1,3,0,1,0,76.14,67.38 ,33.33
02,000,01,004,0137,0,1988,15,2003,3139,0,3,1,3,0,1,0,76.14,63.81 ,33.33
02,000,01,004,0138,0,643,1,644,896,0,3,1,3,0,1,0,76.14,71.88 ,33.33
02,000,01,004,0139,0,550,3,553,834,0,3,1,3,0,1,0,76.14,66.31 ,33.33
02,000,01,004,0140,0,1023,4,1027,1460,0,3,1,3,0,1,0,76.14,70.34 ,33.33
02,000,01,005,0141,0,1761,21,1782,2920,0,3,1,3,0,1,0,76.14,61.03 ,33.33
02,000,01,005,0142,0,3362,26,3388,5237,0,3,1,3,0,1,0,76.14,64.69 ,33.33
02,000,01,005,0143,0,2176,17,2193,3349,0,3,1,3,0,1,0,76.14,65.48 ,33.33
02,000,01,005,0144,0,2121,14,2135,3265,0,3,1,3,0,1,0,76.14,65.39 ,33.33
02,000,01,005,0145,0,2933,29,2962,4736,0,3,1,3,0,1,0,76.14,62.54 ,33.33
02,000,01,005,0146,0,2094,42,2136,2967,0,3,1,3,0,1,0,76.14,71.99 ,33.33
02,000,01,005,0147,0,9202,68,9270,15265,0,3,1,3,0,1,0,76.14,60.73 ,33.33
02,000,01,005,0148,0,4564,47,4611,7075,0,3,1,3,0,1,0,76.14,65.17 ,33.33
02,000,01,005,0149,0,3457,33,3490,5297,0,3,1,3,0,1,0,76.14,65.89 ,33.33
02,000,01,005,0150,0,1334,18,1352,2002,0,3,1,3,0,1,0,76.14,67.53 ,33.33
02,000,01,005,0151,0,999,11,1010,1469,0,3,1,3,0,1,0,76.14,68.75 ,33.33
02,000,01,005,0152,0,2704,24,2728,4085,0,3,1,3,0,1,0,76.14,66.78 ,33.33
02,000,01,005,0153,0,2278,21,2299,3422,0,3,1,3,0,1,0,76.14,67.18 ,33.33
02,000,01,005,0154,0,2553,25,2578,3774,0,3,1,3,0,1,0,76.14,68.31 ,33.33
02,000,01,005,0155,0,3739,36,3775,5963,0,3,1,3,0,1,0,76.14,63.31 ,33.33
02,000,01,005,0156,0,2074,22,2096,3356,0,3,1,3,0,1,0,76.14,62.46 ,33.33
02,000,01,005,0157,0,2722,28,2750,4337,0,3,1,3,0,1,0,76.14,63.41 ,33.33
02,000,01,005,0158,0,1560,17,1577,2596,0,3,1,3,0,1,0,76.14,60.75 ,33.33
02,000,01,005,0159,0,3195,27,3222,5005,0,3,1,3,0,1,0,76.14,64.38 ,33.33
02,000,01,005,0160,0,1796,9,1805,2568,0,3,1,3,0,1,0,76.14,70.29 ,33.33
02,000,01,005,0161,0,1732,15,1747,2587,0,3,1,3,0,1,0,76.14,67.53 ,33.33
02,000,01,005,0162,0,3561,32,3593,5595,0,3,1,3,0,1,0,76.14,64.22 ,33.33
02,000,01,005,0163,0,1642,15,1657,2468,0,3,1,3,0,1,0,76.14,67.14 ,33.33
02,000,01,005,0164,0,1476,14,1490,2302,0,3,1,3,0,1,0,76.14,64.73 ,33.33
02,000,01,005,0165,0,2258,19,2277,3687,0,3,1,3,0,1,0,76.14,61.76 ,33.33
02,000,01,005,0166,0,2475,17,2492,3742,0,3,1,3,0,1,0,76.14,66.60 ,33.33
02,000,01,005,0167,0,3346,31,3377,5416,0,3,1,3,0,1,0,76.14,62.35 ,33.33
02,000,01,005,0168,0,2508,42,2550,3786,0,3,1,3,0,1,0,76.14,67.35 ,33.33
02,000,01,005,0169,0,2717,34,2751,4450,0,3,1,3,0,1,0,76.14,61.82 ,33.33
02,000,01,005,0170,0,3688,28,3716,6069,0,3,1,3,0,1,0,76.14,61.23 ,33.33
02,000,01,005,0171,0,1692,9,1701,2756,0,3,1,3,0,1,0,76.14,61.72 ,33.33
02,000,01,005,0172,0,1654,20,1674,2740,0,3,1,3,0,1,0,76.14,61.09 ,33.33
02,000,01,005,0173,0,2466,29,2495,4035,0,3,1,3,0,1,0,76.14,61.83 ,33.33
02,000,01,005,0174,0,1518,10,1528,2356,0,3,1,3,0,1,0,76.14,64.86 ,33.33
02,000,01,005,0175,0,1316,18,1334,2006,0,3,1,3,0,1,0,76.14,66.50 ,33.33
02,000,01,005,0176,0,2123,22,2145,3283,0,3,1,3,0,1,0,76.14,65.34 ,33.33
02,000,01,005,0177,0,1751,6,1757,2841,0,3,1,3,0,1,0,76.14,61.84 ,33.33
02,000,01,005,0178,0,4883,42,4925,8047,0,3,1,3,0,1,0,76.14,61.20 ,33.33
02,000,01,005,0179,0,2027,8,2035,3150,0,3,1,3,0,1,0,76.14,64.60 ,33.33
02,000,01,005,0180,0,1013,12,1025,1545,0,3,1,3,0,1,0,76.14,66.34 ,33.33
02,000,01,005,0181,0,1048,8,1056,1597,0,3,1,3,0,1,0,76.14,66.12 ,33.33
02,000,01,005,0182,0,1924,20,1944,3030,0,3,1,3,0,1,0,76.14,64.16 ,33.33
02,000,01,005,0183,0,1272,25,1297,2046,0,3,1,3,0,1,0,76.14,63.39 ,33.33
02,000,01,005,0184,0,2262,16,2278,3840,0,3,1,3,0,1,0,76.14,59.32 ,33.33
02,000,01,005,0185,0,2456,20,2476,3901,0,3,1,3,0,1,0,76.14,63.47 ,33.33
02,000,01,005,0186,0,2193,18,2211,3186,0,3,1,3,0,1,0,76.14,69.40 ,33.33
02,000,01,005,0187,0,1830,14,1844,2630,0,3,1,3,0,1,0,76.14,70.11 ,33.33
02,000,01,005,0188,0,1072,4,1076,1502,0,3,1,3,0,1,0,76.14,71.64 ,33.33
02,000,01,005,0189,0,1145,16,1161,1667,0,3,1,3,0,1,0,76.14,69.65 ,33.33
02,000,01,005,0190,0,994,6,1000,1436,0,3,1,3,0,1,0,76.14,69.64 ,33.33
02,000,01,005,0191,0,746,8,754,1065,0,3,1,3,0,1,0,76.14,70.80 ,33.33
02,000,01,005,0192,0,1766,19,1785,2809,0,3,1,3,0,1,0,76.14,63.55 ,33.33
02,000,01,005,0193,0,1583,11,1594,2429,0,3,1,3,0,1,0,76.14,65.62 ,33.33
02,000,01,005,0194,0,1145,7,1152,1907,0,3,1,3,0,1,0,76.14,60.41 ,33.33
02,000,01,005,0195,0,1170,12,1182,1716,0,3,1,3,0,1,0,76.14,68.88 ,33.33
02,000,01,005,0196,0,607,10,617,885,0,3,1,3,0,1,0,76.14,69.72 ,33.33
02,000,01,005,0197,0,761,7,768,1090,0,3,1,3,0,1,0,76.14,70.46 ,33.33
02,000,01,005,0198,0,1135,16,1151,1628,0,3,1,3,0,1,0,76.14,70.70 ,33.33
02,000,01,005,0199,0,1453,11,1464,2060,0,3,1,3,0,1,0,76.14,71.07 ,33.33
02,000,01,005,0200,0,2188,22,2210,3207,0,3,1,3,0,1,0,76.14,68.91 ,33.33
02,000,01,005,0201,0,2544,32,2576,3989,0,3,1,3,0,1,0,76.14,64.58 ,33.33
02,000,01,005,0202,0,2329,16,2345,3651,0,3,1,3,0,1,0,76.14,64.23 ,33.33
02,000,01,005,0203,0,1070,14,1084,1562,0,3,1,3,0,1,0,76.14,69.40 ,33.33
02,000,01,005,0204,0,1179,12,1191,1718,0,3,1,3,0,1,0,76.14,69.32 ,33.33
02,000,01,005,0205,0,1376,14,1390,2080,0,3,1,3,0,1,0,76.14,66.83 ,33.33
02,000,01,005,0206,0,683,8,691,957,0,3,1,3,0,1,0,76.14,72.20 ,33.33
02,000,01,005,0207,0,735,21,756,1100,0,3,1,3,0,1,0,76.14,68.73 ,33.33
02,000,01,005,0208,0,811,4,815,1341,0,3,1,3,0,1,0,76.14,60.78 ,33.33
02,000,01,005,0209,0,892,9,901,1459,0,3,1,3,0,1,0,76.14,61.75 ,33.33
02,000,01,005,0210,0,526,14,540,850,0,3,1,3,0,1,0,76.14,63.53 ,33.33
02,000,01,005,0211,0,355,3,358,477,0,3,1,3,0,1,0,76.14,75.05 ,33.33
02,000,01,005,0212,0,760,8,768,1186,0,3,1,3,0,1,0,76.14,64.76 ,33.33
02,000,01,005,0213,0,2494,25,2519,3968,0,3,1,3,0,1,0,76.14,63.48 ,33.33
02,000,01,005,0214,0,812,7,819,1219,0,3,1,3,0,1,0,76.14,67.19 ,33.33
02,000,01,005,0215,0,600,6,606,1075,0,3,1,3,0,1,0,76.14,56.37 ,33.33
02,000,01,005,0216,0,1072,2,1074,1616,0,3,1,3,0,1,0,76.14,66.46 ,33.33
02,000,01,005,0217,0,818,6,824,1146,0,3,1,3,0,1,0,76.14,71.90 ,33.33
02,000,01,005,0218,0,1367,14,1381,1976,0,3,1,3,0,1,0,76.14,69.89 ,33.33
02,000,01,005,0219,0,836,18,854,1251,0,3,1,3,0,1,0,76.14,68.27 ,33.33
02,000,01,005,0220,0,297,4,301,443,0,3,1,3,0,1,0,76.14,67.95 ,33.33
02,000,01,005,0221,0,1836,24,1860,2682,0,3,1,3,0,1,0,76.14,69.35 ,33.33
02,000,01,005,0222,0,1258,17,1275,1857,0,3,1,3,0,1,0,76.14,68.66 ,33.33
02,000,01,005,0223,0,539,10,549,769,0,3,1,3,0,1,0,76.14,71.39 ,33.33
02,000,01,005,0224,0,884,2,886,1179,0,3,1,3,0,1,0,76.14,75.15 ,33.33
02,000,01,005,0225,0,817,9,826,1196,0,3,1,3,0,1,0,76.14,69.06 ,33.33
02,000,01,005,0226,0,879,9,888,1354,0,3,1,3,0,1,0,76.14,65.58 ,33.33
02,000,01,005,0227,0,871,6,877,1302,0,3,1,3,0,1,0,76.14,67.36 ,33.33
02,000,01,005,0228,0,1579,16,1595,2417,0,3,1,3,0,1,0,76.14,65.99 ,33.33
02,000,01,006,0229,0,848,5,853,1258,0,3,1,3,0,1,0,76.14,67.81 ,33.33
02,000,01,006,0230,0,691,12,703,1101,0,3,1,3,0,1,0,76.14,63.85 ,33.33
02,000,01,006,0231,0,1047,12,1059,1654,0,3,1,3,0,1,0,76.14,64.03 ,33.33
02,000,01,006,0232,0,1283,26,1309,2052,0,3,1,3,0,1,0,76.14,63.79 ,33.33
02,000,01,006,0233,0,1831,34,1865,2816,0,3,1,3,0,1,0,76.14,66.23 ,33.33
02,000,01,006,0234,0,857,13,870,1221,0,3,1,3,0,1,0,76.14,71.25 ,33.33
02,000,01,006,0235,0,846,9,855,1370,0,3,1,3,0,1,0,76.14,62.41 ,33.33
02,000,01,006,0236,0,1440,29,1469,2286,0,3,1,3,0,1,0,76.14,64.26 ,33.33
02,000,01,006,0237,0,1073,15,1088,1685,0,3,1,3,0,1,0,76.14,64.57 ,33.33
02,000,01,006,0238,0,1398,12,1410,2536,0,3,1,3,0,1,0,76.14,55.60 ,33.33
02,000,01,006,0239,0,1029,16,1045,1634,0,3,1,3,0,1,0,76.14,63.95 ,33.33
02,000,01,006,0240,0,554,7,561,1019,0,3,1,3,0,1,0,76.14,55.05 ,33.33
02,000,01,006,0241,0,1370,9,1379,2108,0,3,1,3,0,1,0,76.14,65.42 ,33.33
02,000,02,007,0242,0,1321,15,1336,1919,0,3,1,3,0,1,0,76.14,69.62 ,33.33
02,000,02,007,0243,0,805,10,815,1295,0,3,1,3,0,1,0,76.14,62.93 ,33.33
02,000,02,007,0244,0,1355,10,1365,2210,0,3,1,3,0,1,0,76.14,61.76 ,33.33
02,000,02,007,0245,0,819,7,826,1239,0,3,1,3,0,1,0,76.14,66.67 ,33.33
02,000,02,007,0246,0,1083,12,1095,1575,0,3,1,3,0,1,0,76.14,69.52 ,33.33
02,000,02,007,0247,0,503,8,511,747,0,3,1,3,0,1,0,76.14,68.41 ,33.33
02,000,02,007,0248,0,507,6,513,802,0,3,1,3,0,1,0,76.14,63.97 ,33.33
02,000,02,007,0249,0,1217,13,1230,1931,0,3,1,3,0,1,0,76.14,63.70 ,33.33
02,000,02,007,0250,0,716,4,720,1069,0,3,1,3,0,1,0,76.14,67.35 ,33.33
02,000,02,007,0251,0,503,4,507,746,0,3,1,3,0,1,0,76.14,67.96 ,33.33
02,000,02,007,0252,0,918,9,927,1449,0,3,1,3,0,1,0,76.14,63.98 ,33.33
02,000,02,007,0253,0,713,7,720,1076,0,3,1,3,0,1,0,76.14,66.91 ,33.33
02,000,02,007,0254,0,1402,23,1425,2132,0,3,1,3,0,1,0,76.14,66.84 ,33.33
02,000,02,007,0255,0,1564,11,1575,2393,0,3,1,3,0,1,0,76.14,65.82 ,33.33
02,000,02,007,0256,0,1587,6,1593,2462,0,3,1,3,0,1,0,76.14,64.70 ,33.33
02,000,02,007,0257,0,1202,16,1218,1794,0,3,1,3,0,1,0,76.14,67.89 ,33.33
02,000,02,007,0258,0,1925,20,1945,2897,0,3,1,3,0,1,0,76.14,67.14 ,33.33
02,000,02,007,0259,0,773,9,782,1180,0,3,1,3,0,1,0,76.14,66.27 ,33.33
02,000,02,007,0260,0,714,3,717,1157,0,3,1,3,0,1,0,76.14,61.97 ,33.33
02,000,02,007,0261,0,577,6,583,952,0,3,1,3,0,1,0,76.14,61.24 ,33.33
02,000,02,007,0262,0,598,6,604,918,0,3,1,3,0,1,0,76.14,65.80 ,33.33
02,000,02,007,0263,0,1472,17,1489,2212,0,3,1,3,0,1,0,76.14,67.31 ,33.33
02,000,02,007,0264,0,1434,17,1451,2548,0,3,1,3,0,1,0,76.14,56.95 ,33.33
02,000,02,007,0265,0,572,7,579,868,0,3,1,3,0,1,0,76.14,66.71 ,33.33
02,000,02,007,0266,0,762,5,767,1173,0,3,1,3,0,1,0,76.14,65.39 ,33.33
02,000,02,007,0267,0,675,5,680,1018,0,3,1,3,0,1,0,76.14,66.80 ,33.33
02,000,02,007,0268,0,530,2,532,823,0,3,1,3,0,1,0,76.14,64.64 ,33.33
02,000,02,007,0269,0,577,10,587,873,0,3,1,3,0,1,0,76.14,67.24 ,33.33
02,000,02,007,0270,0,591,3,594,950,0,3,1,3,0,1,0,76.14,62.53 ,33.33
02,000,02,007,0271,0,598,4,602,884,0,3,1,3,0,1,0,76.14,68.10 ,33.33
02,000,02,007,0272,0,532,7,539,743,0,3,1,3,0,1,0,76.14,72.54 ,33.33
02,000,02,007,0273,0,983,11,994,1412,0,3,1,3,0,1,0,76.14,70.40 ,33.33
02,000,02,008,0274,0,565,3,568,835,0,3,1,3,0,1,0,76.14,68.02 ,33.33
02,000,02,008,0275,0,778,8,786,1194,0,3,1,3,0,1,0,76.14,65.83 ,33.33
02,000,02,008,0276,0,958,9,967,1478,0,3,1,3,0,1,0,76.14,65.43 ,33.33
02,000,02,008,0277,0,560,5,565,867,0,3,1,3,0,1,0,76.14,65.17 ,33.33
02,000,02,008,0278,0,567,7,574,930,0,3,1,3,0,1,0,76.14,61.72 ,33.33
02,000,02,008,0279,0,2047,24,2071,3152,0,3,1,3,0,1,0,76.14,65.70 ,33.33
02,000,02,008,0280,0,660,9,669,983,0,3,1,3,0,1,0,76.14,68.06 ,33.33
02,000,02,008,0281,0,683,4,687,1110,0,3,1,3,0,1,0,76.14,61.89 ,33.33
02,000,02,008,0282,0,876,7,883,1411,0,3,1,3,0,1,0,76.14,62.58 ,33.33
02,000,02,008,0283,0,456,3,459,741,0,3,1,3,0,1,0,76.14,61.94 ,33.33
02,000,02,008,0284,0,683,4,687,1031,0,3,1,3,0,1,0,76.14,66.63 ,33.33
02,000,02,008,0285,0,820,8,828,1217,0,3,1,3,0,1,0,76.14,68.04 ,33.33
02,000,02,008,0286,0,714,5,719,1091,0,3,1,3,0,1,0,76.14,65.90 ,33.33
02,000,02,008,0287,0,1161,10,1171,1693,0,3,1,3,0,1,0,76.14,69.17 ,33.33
02,000,02,008,0288,0,709,3,712,1051,0,3,1,3,0,1,0,76.14,67.75 ,33.33
02,000,02,008,0289,0,594,4,598,977,0,3,1,3,0,1,0,76.14,61.21 ,33.33
02,000,02,008,0290,0,993,11,1004,1614,0,3,1,3,0,1,0,76.14,62.21 ,33.33
02,000,02,008,0291,0,850,11,861,1292,0,3,1,3,0,1,0,76.14,66.64 ,33.33
02,000,02,008,0292,0,720,14,734,1101,0,3,1,3,0,1,0,76.14,66.67 ,33.33
02,000,02,008,0293,0,893,12,905,1370,0,3,1,3,0,1,0,76.14,66.06 ,33.33
02,000,02,009,0294,0,418,9,427,638,0,3,1,3,0,1,0,76.14,66.93 ,33.33
02,000,02,009,0295,0,929,8,937,1413,0,3,1,3,0,1,0,76.14,66.31 ,33.33
02,000,02,009,0296,0,948,14,962,1414,0,3,1,3,0,1,0,76.14,68.03 ,33.33
02,000,02,009,0297,0,1113,11,1124,1630,0,3,1,3,0,1,0,76.14,68.96 ,33.33
02,000,02,009,0298,0,924,9,933,1409,0,3,1,3,0,1,0,76.14,66.22 ,33.33
02,000,02,009,0299,0,975,13,988,1510,0,3,1,3,0,1,0,76.14,65.43 ,33.33
02,000,02,009,0300,0,938,5,943,1474,0,3,1,3,0,1,0,76.14,63.98 ,33.33
02,000,02,009,0301,0,473,5,478,678,0,3,1,3,0,1,0,76.14,70.50 ,33.33
02,000,02,009,0302,0,1037,8,1045,1636,0,3,1,3,0,1,0,76.14,63.88 ,33.33
02,000,02,009,0303,0,1346,11,1357,2318,0,3,1,3,0,1,0,76.14,58.54 ,33.33
02,000,02,009,0304,0,812,9,821,1215,0,3,1,3,0,1,0,76.14,67.57 ,33.33
02,000,02,009,0305,0,1041,14,1055,1477,0,3,1,3,0,1,0,76.14,71.43 ,33.33
02,000,02,009,0306,0,1184,16,1200,1920,0,3,1,3,0,1,0,76.14,62.50 ,33.33
02,000,02,009,0307,0,1117,12,1129,1753,0,3,1,3,0,1,0,76.14,64.40 ,33.33
02,000,02,009,0308,0,1321,21,1342,1939,0,3,1,3,0,1,0,76.14,69.21 ,33.33
02,000,02,009,0309,0,800,7,807,1283,0,3,1,3,0,1,0,76.14,62.90 ,33.33
02,000,02,009,0310,0,1818,19,1837,2933,0,3,1,3,0,1,0,76.14,62.63 ,33.33
02,000,02,009,0311,0,1523,20,1543,2334,0,3,1,3,0,1,0,76.14,66.11 ,33.33
02,000,02,009,0312,0,1721,16,1737,2610,0,3,1,3,0,1,0,76.14,66.55 ,33.33
02,000,02,009,0313,0,1448,10,1458,2174,0,3,1,3,0,1,0,76.14,67.07 ,33.33
02,000,02,009,0314,0,670,7,677,1202,0,3,1,3,0,1,0,76.14,56.32 ,33.33
02,000,02,009,0315,0,1777,17,1794,2772,0,3,1,3,0,1,0,76.14,64.72 ,33.33
02,000,02,009,0316,0,1045,12,1057,1715,0,3,1,3,0,1,0,76.14,61.63 ,33.33
02,000,02,009,0317,0,1294,13,1307,2010,0,3,1,3,0,1,0,76.14,65.02 ,33.33
02,000,02,009,0318,0,1023,7,1030,1528,0,3,1,3,0,1,0,76.14,67.41 ,33.33
02,000,02,009,0319,0,545,7,552,805,0,3,1,3,0,1,0,76.14,68.57 ,33.33
02,000,02,009,0320,0,929,18,947,1457,0,3,1,3,0,1,0,76.14,65.00 ,33.33
02,000,02,009,0321,0,1926,18,1944,3003,0,3,1,3,0,1,0,76.14,64.74 ,33.33
02,000,02,009,0322,0,1193,6,1199,1864,0,3,1,3,0,1,0,76.14,64.32 ,33.33
02,000,02,009,0323,0,2147,31,2178,3252,0,3,1,3,0,1,0,76.14,66.97 ,33.33
02,000,02,009,0324,0,1150,17,1167,1785,0,3,1,3,0,1,0,76.14,65.38 ,33.33
02,000,02,009,0325,0,1731,15,1746,2784,0,3,1,3,0,1,0,76.14,62.72 ,33.33
02,000,02,009,0326,0,1575,10,1585,2502,0,3,1,3,0,1,0,76.14,63.35 ,33.33
02,000,02,009,0327,0,869,9,878,1388,0,3,1,3,0,1,0,76.14,63.26 ,33.33
02,000,02,009,0328,0,1075,7,1082,1603,0,3,1,3,0,1,0,76.14,67.50 ,33.33
02,000,02,009,0329,0,1380,13,1393,1953,0,3,1,3,0,1,0,76.14,71.33 ,33.33
02,000,02,009,0330,0,1447,16,1463,2255,0,3,1,3,0,1,0,76.14,64.88 ,33.33
02,000,02,009,0331,0,1172,12,1184,1666,0,3,1,3,0,1,0,76.14,71.07 ,33.33
02,000,02,009,0332,0,1057,15,1072,1536,0,3,1,3,0,1,0,76.14,69.79 ,33.33
02,000,02,009,0333,0,1576,20,1596,2279,0,3,1,3,0,1,0,76.14,70.03 ,33.33
02,000,02,009,0334,0,1254,20,1274,1923,0,3,1,3,0,1,0,76.14,66.25 ,33.33
02,000,02,009,0335,0,2379,19,2398,3749,0,3,1,3,0,1,0,76.14,63.96 ,33.33
02,000,02,009,0336,0,1125,28,1153,1770,0,3,1,3,0,1,0,76.14,65.14 ,33.33
02,000,02,009,0337,0,925,8,933,1328,0,3,1,3,0,1,0,76.14,70.26 ,33.33
02,000,02,009,0338,0,2490,26,2516,3867,0,3,1,3,0,1,0,76.14,65.06 ,33.33
02,000,02,009,0339,0,1295,12,1307,2016,0,3,1,3,0,1,0,76.14,64.83 ,33.33
02,000,02,009,0340,0,1173,8,1181,1735,0,3,1,3,0,1,0,76.14,68.07 ,33.33
02,000,02,009,0341,0,970,13,983,1514,0,3,1,3,0,1,0,76.14,64.93 ,33.33
02,000,02,009,0342,0,1835,22,1857,2751,0,3,1,3,0,1,0,76.14,67.50 ,33.33
02,000,02,009,0343,0,907,8,915,1328,0,3,1,3,0,1,0,76.14,68.90 ,33.33
02,000,02,009,0344,0,683,5,688,1031,0,3,1,3,0,1,0,76.14,66.73 ,33.33
02,000,02,009,0345,0,1316,12,1328,1964,0,3,1,3,0,1,0,76.14,67.62 ,33.33
02,000,02,009,0346,0,1518,41,1559,2168,0,3,1,3,0,1,0,76.14,71.91 ,33.33
02,000,02,009,0347,0,2040,29,2069,2900,0,3,1,3,0,1,0,76.14,71.34 ,33.33
02,000,02,009,0348,0,2022,28,2050,2849,0,3,1,3,0,1,0,76.14,71.96 ,33.33
02,000,02,009,0349,0,1657,22,1679,2498,0,3,1,3,0,1,0,76.14,67.21 ,33.33
02,000,02,009,0350,0,1486,29,1515,2235,0,3,1,3,0,1,0,76.14,67.79 ,33.33
02,000,02,009,0351,0,1522,22,1544,2363,0,3,1,3,0,1,0,76.14,65.34 ,33.33
02,000,02,009,0352,0,1096,13,1109,1697,0,3,1,3,0,1,0,76.14,65.35 ,33.33
02,000,02,009,0353,0,1624,19,1643,2498,0,3,1,3,0,1,0,76.14,65.77 ,33.33
02,000,02,009,0354,0,2535,32,2567,4225,0,3,1,3,0,1,0,76.14,60.76 ,33.33
02,000,02,009,0355,0,2447,25,2472,3839,0,3,1,3,0,1,0,76.14,64.39 ,33.33
02,000,02,009,0356,0,2252,25,2277,3471,0,3,1,3,0,1,0,76.14,65.60 ,33.33
02,000,02,009,0357,0,2584,35,2619,3946,0,3,1,3,0,1,0,76.14,66.37 ,33.33
02,000,02,009,0358,0,1434,21,1455,2168,0,3,1,3,0,1,0,76.14,67.11 ,33.33
02,000,02,009,0359,0,1538,21,1559,2335,0,3,1,3,0,1,0,76.14,66.77 ,33.33
02,000,02,009,0360,0,2563,32,2595,3800,0,3,1,3,0,1,0,76.14,68.29 ,33.33
02,000,02,009,0361,0,1311,28,1339,1956,0,3,1,3,0,1,0,76.14,68.46 ,33.33
02,000,02,009,0362,0,1410,14,1424,2105,0,3,1,3,0,1,0,76.14,67.65 ,33.33
02,000,02,010,0363,0,4974,47,5021,7842,0,3,1,3,0,1,0,76.14,64.03 ,33.33
02,000,02,010,0364,0,1507,20,1527,2360,0,3,1,3,0,1,0,76.14,64.70 ,33.33
02,000,02,010,0365,0,2107,24,2131,3199,0,3,1,3,0,1,0,76.14,66.61 ,33.33
02,000,02,010,0366,0,1272,17,1289,1765,0,3,1,3,0,1,0,76.14,73.03 ,33.33
02,000,02,010,0367,0,994,16,1010,1462,0,3,1,3,0,1,0,76.14,69.08 ,33.33
02,000,02,010,0368,0,1249,16,1265,1925,0,3,1,3,0,1,0,76.14,65.71 ,33.33
02,000,02,010,0369,0,1104,8,1112,1837,0,3,1,3,0,1,0,76.14,60.53 ,33.33
02,000,02,010,0370,0,491,8,499,767,0,3,1,3,0,1,0,76.14,65.06 ,33.33
02,000,02,010,0371,0,1196,15,1211,1787,0,3,1,3,0,1,0,76.14,67.77 ,33.33
02,000,02,010,0372,0,1164,18,1182,1628,0,3,1,3,0,1,0,76.14,72.60 ,33.33
02,000,02,010,0373,0,1666,15,1681,2469,0,3,1,3,0,1,0,76.14,68.08 ,33.33
02,000,02,010,0374,0,904,10,914,1323,0,3,1,3,0,1,0,76.14,69.09 ,33.33
02,000,02,010,0375,0,522,3,525,716,0,3,1,3,0,1,0,76.14,73.32 ,33.33
02,000,02,010,0376,0,613,9,622,943,0,3,1,3,0,1,0,76.14,65.96 ,33.33
02,000,02,010,0377,0,1099,17,1116,1561,0,3,1,3,0,1,0,76.14,71.49 ,33.33
02,000,02,010,0378,0,1390,21,1411,1884,0,3,1,3,0,1,0,76.14,74.89 ,33.33
02,000,02,010,0379,0,1588,27,1615,2404,0,3,1,3,0,1,0,76.14,67.18 ,33.33
02,000,02,010,0380,0,1448,21,1469,2040,0,3,1,3,0,1,0,76.14,72.01 ,33.33
02,000,02,010,0381,0,2429,26,2455,3741,0,3,1,3,0,1,0,76.14,65.62 ,33.33
02,000,02,010,0382,0,797,13,810,1165,0,3,1,3,0,1,0,76.14,69.53 ,33.33
02,000,02,010,0383,0,1230,25,1255,1861,0,3,1,3,0,1,0,76.14,67.44 ,33.33
02,000,02,010,0384,0,585,5,590,844,0,3,1,3,0,1,0,76.14,69.91 ,33.33
02,000,02,010,0385,0,757,6,763,1028,0,3,1,3,0,1,0,76.14,74.22 ,33.33
02,000,02,010,0386,0,1984,28,2012,2631,0,3,1,3,0,1,0,76.14,76.47 ,33.33
02,000,02,010,0387,0,1544,16,1560,2038,0,3,1,3,0,1,0,76.14,76.55 ,33.33
02,000,02,010,0388,0,2173,21,2194,3243,0,3,1,3,0,1,0,76.14,67.65 ,33.33
02,000,02,010,0389,0,2480,19,2499,3596,0,3,1,3,0,1,0,76.14,69.49 ,33.33
02,000,02,010,0390,0,597,9,606,855,0,3,1,3,0,1,0,76.14,70.88 ,33.33
02,000,02,010,0391,0,1554,18,1572,2130,0,3,1,3,0,1,0,76.14,73.80 ,33.33
02,000,02,010,0392,0,1619,13,1632,2547,0,3,1,3,0,1,0,76.14,64.08 ,33.33
02,000,02,010,0393,0,1386,10,1396,2053,0,3,1,3,0,1,0,76.14,68.00 ,33.33
02,000,02,010,0394,0,1375,13,1388,2404,0,3,1,3,0,1,0,76.14,57.74 ,33.33
02,000,02,010,0395,0,1757,15,1772,2850,0,3,1,3,0,1,0,76.14,62.18 ,33.33
02,000,02,010,0396,0,1861,18,1879,3059,0,3,1,3,0,1,0,76.14,61.43 ,33.33
02,000,02,010,0397,0,2802,30,2832,4159,0,3,1,3,0,1,0,76.14,68.09 ,33.33
02,000,02,010,0398,0,1534,10,1544,2215,0,3,1,3,0,1,0,76.14,69.71 ,33.33
02,000,02,010,0399,0,1872,6,1878,2760,0,3,1,3,0,1,0,76.14,68.04 ,33.33
02,000,02,010,0400,0,1703,19,1722,2615,0,3,1,3,0,1,0,76.14,65.85 ,33.33
02,000,02,010,0401,0,1251,13,1264,2048,0,3,1,3,0,1,0,76.14,61.72 ,33.33
02,000,02,010,0402,0,1652,16,1668,2602,0,3,1,3,0,1,0,76.14,64.10 ,33.33
02,000,02,010,0403,0,1235,11,1246,1927,0,3,1,3,0,1,0,76.14,64.66 ,33.33
02,000,02,010,0404,0,2284,19,2303,3414,0,3,1,3,0,1,0,76.14,67.46 ,33.33
02,000,02,010,0405,0,1724,14,1738,2699,0,3,1,3,0,1,0,76.14,64.39 ,33.33
02,000,02,010,0406,0,856,15,871,1296,0,3,1,3,0,1,0,76.14,67.21 ,33.33
02,000,02,010,0407,0,2989,30,3019,4434,0,3,1,3,0,1,0,76.14,68.09 ,33.33
02,000,02,010,0408,0,1621,24,1645,2306,0,3,1,3,0,1,0,76.14,71.34 ,33.33
02,000,02,010,0409,0,3081,30,3111,4559,0,3,1,3,0,1,0,76.14,68.24 ,33.33
02,000,02,010,0410,0,1516,17,1533,2307,0,3,1,3,0,1,0,76.14,66.45 ,33.33
02,000,02,010,0411,0,1329,16,1345,1993,0,3,1,3,0,1,0,76.14,67.49 ,33.33
02,000,02,010,0412,0,2328,30,2358,3452,0,3,1,3,0,1,0,76.14,68.31 ,33.33
02,000,02,010,0413,0,2146,25,2171,3417,0,3,1,3,0,1,0,76.14,63.54 ,33.33
02,000,02,010,0414,0,1956,19,1975,2915,0,3,1,3,0,1,0,76.14,67.75 ,33.33
02,000,02,010,0415,0,1889,27,1916,2636,0,3,1,3,0,1,0,76.14,72.69 ,33.33
02,000,02,010,0416,0,1684,21,1705,2522,0,3,1,3,0,1,0,76.14,67.61 ,33.33
02,000,02,010,0417,0,1661,23,1684,2561,0,3,1,3,0,1,0,76.14,65.76 ,33.33
02,000,02,010,0418,0,1434,19,1453,2238,0,3,1,3,0,1,0,76.14,64.92 ,33.33
02,000,02,010,0419,0,1532,17,1549,2342,0,3,1,3,0,1,0,76.14,66.14 ,33.33
02,000,02,010,0420,0,2535,22,2557,4074,0,3,1,3,0,1,0,76.14,62.76 ,33.33
02,000,02,010,0421,0,1664,26,1690,2689,0,3,1,3,0,1,0,76.14,62.85 ,33.33
02,000,02,011,0422,0,1154,10,1164,1679,0,3,1,3,0,1,0,76.14,69.33 ,33.33
02,000,02,011,0423,0,1999,19,2018,2945,0,3,1,3,0,1,0,76.14,68.52 ,33.33
02,000,02,011,0424,0,1551,18,1569,2285,0,3,1,3,0,1,0,76.14,68.67 ,33.33
02,000,02,011,0425,0,1021,13,1034,1443,0,3,1,3,0,1,0,76.14,71.66 ,33.33
02,000,02,011,0426,0,1817,14,1831,2654,0,3,1,3,0,1,0,76.14,68.99 ,33.33
02,000,02,011,0427,0,1188,10,1198,1693,0,3,1,3,0,1,0,76.14,70.76 ,33.33
02,000,02,011,0428,0,856,14,870,1287,0,3,1,3,0,1,0,76.14,67.60 ,33.33
02,000,02,011,0429,0,1265,13,1278,1850,0,3,1,3,0,1,0,76.14,69.08 ,33.33
02,000,02,011,0430,0,1070,10,1080,1675,0,3,1,3,0,1,0,76.14,64.48 ,33.33
02,000,02,011,0431,0,2669,27,2696,4064,0,3,1,3,0,1,0,76.14,66.34 ,33.33
02,000,02,011,0432,0,1421,9,1430,2025,0,3,1,3,0,1,0,76.14,70.62 ,33.33
02,000,02,011,0433,0,1839,20,1859,2740,0,3,1,3,0,1,0,76.14,67.85 ,33.33
02,000,02,011,0434,0,1561,12,1573,2339,0,3,1,3,0,1,0,76.14,67.25 ,33.33
02,000,02,011,0435,0,2037,17,2054,3136,0,3,1,3,0,1,0,76.14,65.50 ,33.33
02,000,02,011,0436,0,2078,24,2102,3313,0,3,1,3,0,1,0,76.14,63.45 ,33.33
02,000,02,011,0437,0,860,16,876,1258,0,3,1,3,0,1,0,76.14,69.63 ,33.33
02,000,02,011,0438,0,1472,19,1491,2231,0,3,1,3,0,1,0,76.14,66.83 ,33.33
02,000,02,011,0439,0,1609,18,1627,2359,0,3,1,3,0,1,0,76.14,68.97 ,33.33
02,000,02,011,0440,0,1058,11,1069,1560,0,3,1,3,0,1,0,76.14,68.53 ,33.33
02,000,02,011,0441,0,1861,25,1886,2712,0,3,1,3,0,1,0,76.14,69.54 ,33.33
02,000,02,011,0442,0,1394,20,1414,1979,0,3,1,3,0,1,0,76.14,71.45 ,33.33
02,000,02,011,0443,0,2918,29,2947,4432,0,3,1,3,0,1,0,76.14,66.49 ,33.33
02,000,02,011,0444,0,1969,26,1995,2996,0,3,1,3,0,1,0,76.14,66.59 ,33.33
02,000,02,011,0445,0,1245,15,1260,1805,0,3,1,3,0,1,0,76.14,69.81 ,33.33
02,000,02,011,0446,0,1105,10,1115,1621,0,3,1,3,0,1,0,76.14,68.78 ,33.33
02,000,02,011,0447,0,706,7,713,976,0,3,1,3,0,1,0,76.14,73.05 ,33.33
02,000,02,011,0448,0,764,10,774,1130,0,3,1,3,0,1,0,76.14,68.50 ,33.33
02,000,02,011,0449,0,1927,27,1954,2936,0,3,1,3,0,1,0,76.14,66.55 ,33.33
02,000,02,011,0450,0,1110,13,1123,1662,0,3,1,3,0,1,0,76.14,67.57 ,33.33
02,000,02,011,0451,0,1450,32,1482,2100,0,3,1,3,0,1,0,76.14,70.57 ,33.33
02,000,02,011,0452,0,3502,40,3542,5349,0,3,1,3,0,1,0,76.14,66.22 ,33.33
02,000,02,011,0453,0,1707,29,1736,2648,0,3,1,3,0,1,0,76.14,65.56 ,33.33
02,000,02,011,0454,0,1550,22,1572,2129,0,3,1,3,0,1,0,76.14,73.84 ,33.33
02,000,02,011,0455,0,1485,16,1501,2015,0,3,1,3,0,1,0,76.14,74.49 ,33.33
02,000,02,011,0456,0,1095,12,1107,1522,0,3,1,3,0,1,0,76.14,72.73 ,33.33
02,000,02,011,0457,0,1402,12,1414,2082,0,3,1,3,0,1,0,76.14,67.92 ,33.33
02,000,02,011,0458,0,1152,11,1163,1585,0,3,1,3,0,1,0,76.14,73.38 ,33.33
02,000,02,011,0459,0,1724,22,1746,2405,0,3,1,3,0,1,0,76.14,72.60 ,33.33
02,000,02,011,0460,0,2736,33,2769,4527,0,3,1,3,0,1,0,76.14,61.17 ,33.33
02,000,02,011,0461,0,1367,15,1382,2312,0,3,1,3,0,1,0,76.14,59.78 ,33.33
02,000,02,011,0462,0,1490,16,1506,2462,0,3,1,3,0,1,0,76.14,61.17 ,33.33
02,000,02,011,0463,0,1653,40,1693,2809,0,3,1,3,0,1,0,76.14,60.27 ,33.33
02,000,02,011,0464,0,1700,22,1722,2897,0,3,1,3,0,1,0,76.14,59.44 ,33.33
03,001,01,001,0001,0,771,7,778,1119,0,3,1,3,0,1,0,76.14,69.53 ,33.33
03,001,01,001,0002,0,802,8,810,1249,0,3,1,3,0,1,0,76.14,64.85 ,33.33
03,001,01,001,0003,0,457,4,461,654,0,3,1,3,0,1,0,76.14,70.49 ,33.33
03,001,01,001,0004,0,709,11,720,1053,0,3,1,3,0,1,0,76.14,68.38 ,33.33
03,001,01,001,0005,0,957,5,962,1581,0,3,1,3,0,1,0,76.14,60.85 ,33.33
03,001,01,001,0006,0,2560,39,2599,3739,0,3,1,3,0,1,0,76.14,69.51 ,33.33
03,001,01,001,0007,0,1684,27,1711,2524,0,3,1,3,0,1,0,76.14,67.79 ,33.33
03,001,01,001,0008,0,3166,42,3208,4605,0,3,1,3,0,1,0,76.14,69.66 ,33.33
03,001,01,001,0009,0,2280,32,2312,3380,0,3,1,3,0,1,0,76.14,68.40 ,33.33
03,001,01,001,0010,0,1455,23,1478,2147,0,3,1,3,0,1,0,76.14,68.84 ,33.33
03,001,01,001,0011,0,2349,36,2385,3455,0,3,1,3,0,1,0,76.14,69.03 ,33.33
03,001,01,001,0012,0,3141,44,3185,4400,0,3,1,3,0,1,0,76.14,72.39 ,33.33
03,001,01,001,0013,0,1694,25,1719,2351,0,3,1,3,0,1,0,76.14,73.12 ,33.33
03,001,01,001,0014,0,1493,27,1520,2180,0,3,1,3,0,1,0,76.14,69.72 ,33.33
03,001,01,001,0015,0,1474,30,1504,2088,0,3,1,3,0,1,0,76.14,72.03 ,33.33
03,001,01,001,0016,0,2434,30,2464,3270,0,3,1,3,0,1,0,76.14,75.35 ,33.33
03,001,01,001,0017,0,1338,22,1360,1875,0,3,1,3,0,1,0,76.14,72.53 ,33.33
03,001,01,001,0018,0,2389,23,2412,3492,0,3,1,3,0,1,0,76.14,69.07 ,33.33
03,001,01,001,0019,0,2167,45,2212,3269,0,3,1,3,0,1,0,76.14,67.67 ,33.33
03,001,01,001,0020,0,2701,67,2768,4170,0,3,1,3,0,1,0,76.14,66.38 ,33.33
03,001,01,001,0021,0,1688,17,1705,2408,0,3,1,3,0,1,0,76.14,70.81 ,33.33
03,001,01,001,0022,0,1259,13,1272,1737,0,3,1,3,0,1,0,76.14,73.23 ,33.33
03,001,01,001,0023,0,2157,34,2191,3097,0,3,1,3,0,1,0,76.14,70.75 ,33.33
03,001,01,001,0024,0,2595,24,2619,3635,0,3,1,3,0,1,0,76.14,72.05 ,33.33
03,001,01,001,0025,0,2348,34,2382,3480,0,3,1,3,0,1,0,76.14,68.45 ,33.33
03,001,01,001,0026,0,2139,36,2175,3124,0,3,1,3,0,1,0,76.14,69.62 ,33.33
03,001,01,001,0027,0,2146,37,2183,3267,0,3,1,3,0,1,0,76.14,66.82 ,33.33
03,001,01,001,0028,0,1529,24,1553,2317,0,3,1,3,0,1,0,76.14,67.03 ,33.33
03,001,01,001,0029,0,1649,17,1666,2248,0,3,1,3,0,1,0,76.14,74.11 ,33.33
03,001,01,001,0030,0,1579,17,1596,2352,0,3,1,3,0,1,0,76.14,67.86 ,33.33
03,001,01,001,0031,0,1393,24,1417,2008,0,3,1,3,0,1,0,76.14,70.57 ,33.33
03,001,01,001,0032,0,1690,31,1721,2477,0,3,1,3,0,1,0,76.14,69.48 ,33.33
03,001,01,001,0033,0,1368,18,1386,2008,0,3,1,3,0,1,0,76.14,69.02 ,33.33
03,001,01,001,0034,0,2573,51,2624,3734,0,3,1,3,0,1,0,76.14,70.27 ,33.33
03,001,01,001,0035,0,2607,40,2647,3912,0,3,1,3,0,1,0,76.14,67.66 ,33.33
03,001,01,001,0036,0,2611,34,2645,4006,0,3,1,3,0,1,0,76.14,66.03 ,33.33
03,001,01,001,0037,0,3022,37,3059,4635,0,3,1,3,0,1,0,76.14,66.00 ,33.33
03,001,01,001,0038,0,1904,29,1933,2827,0,3,1,3,0,1,0,76.14,68.38 ,33.33
03,001,01,001,0039,0,1643,23,1666,2448,0,3,1,3,0,1,0,76.14,68.06 ,33.33
03,001,01,001,0040,0,1726,36,1762,2517,0,3,1,3,0,1,0,76.14,70.00 ,33.33
03,001,01,001,0041,0,1746,31,1777,2619,0,3,1,3,0,1,0,76.14,67.85 ,33.33
03,001,01,001,0042,0,3580,75,3655,5285,0,3,1,3,0,1,0,76.14,69.16 ,33.33
03,001,01,001,0043,0,1872,26,1898,2785,0,3,1,3,0,1,0,76.14,68.15 ,33.33
03,001,01,001,0044,0,2031,36,2067,2921,0,3,1,3,0,1,0,76.14,70.76 ,33.33
03,001,01,001,0045,0,2611,35,2646,3836,0,3,1,3,0,1,0,76.14,68.98 ,33.33
03,001,01,001,0046,0,1831,26,1857,2774,0,3,1,3,0,1,0,76.14,66.94 ,33.33
03,001,01,001,0047,0,1801,25,1826,2654,0,3,1,3,0,1,0,76.14,68.80 ,33.33
03,001,01,001,0048,0,2668,42,2710,4051,0,3,1,3,0,1,0,76.14,66.90 ,33.33
03,001,01,001,0049,0,1855,28,1883,2934,0,3,1,3,0,1,0,76.14,64.18 ,33.33
03,001,01,001,0050,0,1894,24,1918,2750,0,3,1,3,0,1,0,76.14,69.75 ,33.33
03,001,01,001,0051,0,2183,34,2217,3254,0,3,1,3,0,1,0,76.14,68.13 ,33.33
03,001,01,001,0052,0,1194,13,1207,1788,0,3,1,3,0,1,0,76.14,67.51 ,33.33
03,001,01,001,0053,0,1824,27,1851,2643,0,3,1,3,0,1,0,76.14,70.03 ,33.33
03,001,01,001,0054,0,1659,25,1684,2460,0,3,1,3,0,1,0,76.14,68.46 ,33.33
03,001,01,001,0055,0,4126,54,4180,5984,0,3,1,3,0,1,0,76.14,69.85 ,33.33
03,001,01,001,0056,0,1441,28,1469,2184,0,3,1,3,0,1,0,76.14,67.26 ,33.33
03,001,01,001,0057,0,1672,39,1711,2419,0,3,1,3,0,1,0,76.14,70.73 ,33.33
03,001,01,001,0058,0,2307,41,2348,3355,0,3,1,3,0,1,0,76.14,69.99 ,33.33
03,001,01,001,0059,0,1654,29,1683,2534,0,3,1,3,0,1,0,76.14,66.42 ,33.33
03,001,01,001,0060,0,2922,44,2966,4409,0,3,1,3,0,1,0,76.14,67.27 ,33.33
03,001,01,001,0061,0,1004,26,1030,1498,0,3,1,3,0,1,0,76.14,68.76 ,33.33
03,001,01,001,0062,0,2900,48,2948,4305,0,3,1,3,0,1,0,76.14,68.48 ,33.33
03,001,01,001,0063,0,2407,28,2435,3351,0,3,1,3,0,1,0,76.14,72.66 ,33.33
03,001,01,001,0064,0,2286,31,2317,3324,0,3,1,3,0,1,0,76.14,69.71 ,33.33
03,001,01,001,0065,0,1686,22,1708,2464,0,3,1,3,0,1,0,76.14,69.32 ,33.33
03,001,01,001,0066,0,2710,68,2778,4024,0,3,1,3,0,1,0,76.14,69.04 ,33.33
03,001,01,001,0067,0,1230,12,1242,1795,0,3,1,3,0,1,0,76.14,69.19 ,33.33
03,001,01,001,0068,0,1643,31,1674,2299,0,3,1,3,0,1,0,76.14,72.81 ,33.33
03,001,01,001,0069,0,1477,26,1503,2076,0,3,1,3,0,1,0,76.14,72.40 ,33.33
03,001,01,001,0070,0,1652,33,1685,2372,0,3,1,3,0,1,0,76.14,71.04 ,33.33
03,001,01,001,0071,0,3268,74,3342,4715,0,3,1,3,0,1,0,76.14,70.88 ,33.33
03,001,01,001,0072,0,1566,23,1589,2294,0,3,1,3,0,1,0,76.14,69.27 ,33.33
03,001,01,001,0073,0,1647,29,1676,2305,0,3,1,3,0,1,0,76.14,72.71 ,33.33
03,001,01,001,0074,0,2603,46,2649,3902,0,3,1,3,0,1,0,76.14,67.89 ,33.33
03,001,01,001,0075,0,1613,31,1644,2302,0,3,1,3,0,1,0,76.14,71.42 ,33.33
03,001,01,001,0076,0,1935,30,1965,2902,0,3,1,3,0,1,0,76.14,67.71 ,33.33
03,001,01,001,0077,0,1767,29,1796,2496,0,3,1,3,0,1,0,76.14,71.96 ,33.33
03,001,01,001,0078,0,1753,31,1784,2540,0,3,1,3,0,1,0,76.14,70.24 ,33.33
03,001,01,001,0079,0,1969,38,2007,2843,0,3,1,3,0,1,0,76.14,70.59 ,33.33
03,001,01,001,0080,0,1874,34,1908,2869,0,3,1,3,0,1,0,76.14,66.50 ,33.33
03,001,01,001,0081,0,2884,32,2916,4189,0,3,1,3,0,1,0,76.14,69.61 ,33.33
03,001,01,001,0082,0,1906,48,1954,2810,0,3,1,3,0,1,0,76.14,69.54 ,33.33
03,001,01,001,0083,0,1456,30,1486,2083,0,3,1,3,0,1,0,76.14,71.34 ,33.33
03,001,01,001,0084,0,2289,40,2329,3382,0,3,1,3,0,1,0,76.14,68.86 ,33.33
03,001,01,001,0085,0,1073,28,1101,1570,0,3,1,3,0,1,0,76.14,70.13 ,33.33
03,001,01,001,0086,0,1923,27,1950,2831,0,3,1,3,0,1,0,76.14,68.88 ,33.33
03,001,01,001,0087,0,1327,18,1345,2105,0,3,1,3,0,1,0,76.14,63.90 ,33.33
03,001,01,001,0088,0,1090,12,1102,1593,0,3,1,3,0,1,0,76.14,69.18 ,33.33
03,001,01,001,0089,0,1859,38,1897,2775,0,3,1,3,0,1,0,76.14,68.36 ,33.33
03,001,01,001,0090,0,2036,24,2060,2932,0,3,1,3,0,1,0,76.14,70.26 ,33.33
03,001,01,001,0091,0,1628,26,1654,2358,0,3,1,3,0,1,0,76.14,70.14 ,33.33
03,001,01,001,0092,0,1829,21,1850,2669,0,3,1,3,0,1,0,76.14,69.31 ,33.33
03,001,01,001,0093,0,2774,43,2817,3935,0,3,1,3,0,1,0,76.14,71.59 ,33.33
03,001,01,001,0094,0,1755,35,1790,2552,0,3,1,3,0,1,0,76.14,70.14 ,33.33
03,001,01,001,0095,0,1746,36,1782,2479,0,3,1,3,0,1,0,76.14,71.88 ,33.33
03,001,01,001,0096,0,1832,29,1861,2536,0,3,1,3,0,1,0,76.14,73.38 ,33.33
03,001,01,001,0097,0,3124,57,3181,4537,0,3,1,3,0,1,0,76.14,70.11 ,33.33
03,001,01,001,0098,0,2535,37,2572,3708,0,3,1,3,0,1,0,76.14,69.36 ,33.33
03,001,01,001,0099,0,3992,61,4053,5954,0,3,1,3,0,1,0,76.14,68.07 ,33.33
03,001,01,001,0100,0,1908,20,1928,2676,0,3,1,3,0,1,0,76.14,72.05 ,33.33
03,001,01,001,0101,0,555,12,567,874,0,3,1,3,0,1,0,76.14,64.87 ,33.33
03,001,01,001,0102,0,1618,24,1642,2428,0,3,1,3,0,1,0,76.14,67.63 ,33.33
03,001,01,001,0103,0,2456,27,2483,3566,0,3,1,3,0,1,0,76.14,69.63 ,33.33
03,001,01,001,0104,0,2031,41,2072,3001,0,3,1,3,0,1,0,76.14,69.04 ,33.33
03,001,01,001,0105,0,1594,32,1626,2240,0,3,1,3,0,1,0,76.14,72.59 ,33.33
03,001,01,001,0106,0,1185,21,1206,1705,0,3,1,3,0,1,0,76.14,70.73 ,33.33
03,001,01,001,0107,0,3258,57,3315,4935,0,3,1,3,0,1,0,76.14,67.17 ,33.33
03,001,01,001,0108,0,2952,37,2989,4211,0,3,1,3,0,1,0,76.14,70.98 ,33.33
03,001,01,001,0109,0,2233,36,2269,3274,0,3,1,3,0,1,0,76.14,69.30 ,33.33
03,001,01,001,0110,0,2061,34,2095,3476,0,3,1,3,0,1,0,76.14,60.27 ,33.33
03,001,01,001,0111,0,2717,43,2760,4024,0,3,1,3,0,1,0,76.14,68.59 ,33.33
03,001,01,001,0112,0,1945,41,1986,2796,0,3,1,3,0,1,0,76.14,71.03 ,33.33
03,001,01,001,0113,0,1821,24,1845,2583,0,3,1,3,0,1,0,76.14,71.43 ,33.33
03,001,01,001,0114,0,697,11,708,975,0,3,1,3,0,1,0,76.14,72.62 ,33.33
03,001,01,001,0115,0,2560,38,2598,3907,0,3,1,3,0,1,0,76.14,66.50 ,33.33
03,001,01,001,0116,0,1326,75,1401,2116,0,3,1,3,0,1,0,76.14,66.21 ,33.33
03,001,01,001,0117,0,2264,50,2314,3369,0,3,1,3,0,1,0,76.14,68.69 ,33.33
03,001,01,001,0118,0,1439,31,1470,2181,0,3,1,3,0,1,0,76.14,67.40 ,33.33
03,001,01,001,0119,0,2536,48,2584,3914,0,3,1,3,0,1,0,76.14,66.02 ,33.33
03,001,01,001,0120,0,1568,35,1603,2380,0,3,1,3,0,1,0,76.14,67.35 ,33.33
03,001,01,001,0121,0,3428,55,3483,5315,0,3,1,3,0,1,0,76.14,65.53 ,33.33
03,001,01,001,0122,0,2004,40,2044,3112,0,3,1,3,0,1,0,76.14,65.68 ,33.33
03,001,01,001,0123,0,2701,42,2743,4139,0,3,1,3,0,1,0,76.14,66.27 ,33.33
03,001,01,001,0124,0,4712,89,4801,7311,0,3,1,3,0,1,0,76.14,65.67 ,33.33
03,001,01,001,0125,0,1708,25,1733,2523,0,3,1,3,0,1,0,76.14,68.69 ,33.33
03,001,01,001,0126,0,1852,23,1875,2773,0,3,1,3,0,1,0,76.14,67.62 ,33.33
03,001,01,002,0127,0,877,12,889,1204,0,3,1,3,0,1,0,76.14,73.84 ,33.33
03,001,01,002,0128,0,872,20,892,1205,0,3,1,3,0,1,0,76.14,74.02 ,33.33
03,001,01,002,0129,0,1383,25,1408,2040,0,3,1,3,0,1,0,76.14,69.02 ,33.33
03,001,01,002,0130,0,3099,58,3157,4660,0,3,1,3,0,1,0,76.14,67.75 ,33.33
03,001,01,002,0131,0,1595,36,1631,2378,0,3,1,3,0,1,0,76.14,68.59 ,33.33
03,001,01,002,0132,0,3405,51,3456,5165,0,3,1,3,0,1,0,76.14,66.91 ,33.33
03,001,01,002,0133,0,2275,34,2309,3430,0,3,1,3,0,1,0,76.14,67.32 ,33.33
03,001,01,002,0134,0,2547,50,2597,3928,0,3,1,3,0,1,0,76.14,66.12 ,33.33
03,001,01,002,0135,0,1386,27,1413,2289,0,3,1,3,0,1,0,76.14,61.73 ,33.33
03,001,01,002,0136,0,1067,16,1083,1620,0,3,1,3,0,1,0,76.14,66.85 ,33.33
03,001,01,002,0137,0,957,16,973,1273,0,3,1,3,0,1,0,76.14,76.43 ,33.33
03,001,01,002,0138,0,2111,23,2134,3051,0,3,1,3,0,1,0,76.14,69.94 ,33.33
03,001,01,002,0139,0,2781,44,2825,4051,0,3,1,3,0,1,0,76.14,69.74 ,33.33
03,001,01,002,0140,0,2801,45,2846,4008,0,3,1,3,0,1,0,76.14,71.01 ,33.33
03,001,01,002,0141,0,2583,29,2612,3882,0,3,1,3,0,1,0,76.14,67.28 ,33.33
03,001,01,002,0142,0,2484,39,2523,3595,0,3,1,3,0,1,0,76.14,70.18 ,33.33
03,001,01,002,0143,0,2797,48,2845,4241,0,3,1,3,0,1,0,76.14,67.08 ,33.33
03,001,01,002,0144,0,2039,27,2066,2966,0,3,1,3,0,1,0,76.14,69.66 ,33.33
03,001,01,002,0145,0,1828,25,1853,2561,0,3,1,3,0,1,0,76.14,72.35 ,33.33
03,001,01,002,0146,0,2173,32,2205,3216,0,3,1,3,0,1,0,76.14,68.56 ,33.33
03,001,01,002,0147,0,2611,28,2639,3747,0,3,1,3,0,1,0,76.14,70.43 ,33.33
03,001,01,002,0148,0,1667,29,1696,2374,0,3,1,3,0,1,0,76.14,71.44 ,33.33
03,001,01,002,0149,0,3760,38,3798,5487,0,3,1,3,0,1,0,76.14,69.22 ,33.33
03,001,01,002,0150,0,1563,26,1589,2395,0,3,1,3,0,1,0,76.14,66.35 ,33.33
03,001,01,002,0151,0,2567,44,2611,4027,0,3,1,3,0,1,0,76.14,64.84 ,33.33
03,001,01,002,0152,0,1640,34,1674,2478,0,3,1,3,0,1,0,76.14,67.55 ,33.33
03,001,01,002,0153,0,2041,32,2073,3040,0,3,1,3,0,1,0,76.14,68.19 ,33.33
03,001,01,002,0154,0,2151,25,2176,3086,0,3,1,3,0,1,0,76.14,70.51 ,33.33
03,001,01,002,0155,0,1281,13,1294,1830,0,3,1,3,0,1,0,76.14,70.71 ,33.33
03,001,01,002,0156,0,1407,21,1428,2100,0,3,1,3,0,1,0,76.14,68.00 ,33.33
03,001,01,002,0157,0,1444,22,1466,2057,0,3,1,3,0,1,0,76.14,71.27 ,33.33
03,001,01,002,0158,0,3046,48,3094,4533,0,3,1,3,0,1,0,76.14,68.26 ,33.33
03,001,01,002,0159,0,875,12,887,1269,0,3,1,3,0,1,0,76.14,69.90 ,33.33
03,001,01,002,0160,0,3444,66,3510,4985,0,3,1,3,0,1,0,76.14,70.41 ,33.33
03,001,01,002,0161,0,1538,24,1562,2220,0,3,1,3,0,1,0,76.14,70.36 ,33.33
03,001,01,002,0162,0,3511,42,3553,5204,0,3,1,3,0,1,0,76.14,68.27 ,33.33
03,001,01,002,0163,0,1510,28,1538,2222,0,3,1,3,0,1,0,76.14,69.22 ,33.33
03,001,01,002,0164,0,2438,45,2483,3800,0,3,1,3,0,1,0,76.14,65.34 ,33.33
03,001,01,002,0165,0,2138,27,2165,3188,0,3,1,3,0,1,0,76.14,67.91 ,33.33
03,001,01,002,0166,0,2542,32,2574,3796,0,3,1,3,0,1,0,76.14,67.81 ,33.33
03,001,01,002,0167,0,3391,45,3436,5217,0,3,1,3,0,1,0,76.14,65.86 ,33.33
03,001,01,002,0168,0,2127,38,2165,3137,0,3,1,3,0,1,0,76.14,69.01 ,33.33
03,001,01,002,0169,0,2153,29,2182,3200,0,3,1,3,0,1,0,76.14,68.19 ,33.33
03,001,01,002,0170,0,2050,20,2070,3031,0,3,1,3,0,1,0,76.14,68.29 ,33.33
03,001,01,002,0171,0,3288,59,3347,4803,0,3,1,3,0,1,0,76.14,69.69 ,33.33
03,001,01,002,0172,0,2452,34,2486,3633,0,3,1,3,0,1,0,76.14,68.43 ,33.33
03,001,01,002,0173,0,2794,53,2847,4321,0,3,1,3,0,1,0,76.14,65.89 ,33.33
03,001,01,003,0174,0,2999,53,3052,4362,0,3,1,3,0,1,0,76.14,69.97 ,33.33
03,001,01,003,0175,0,1922,39,1961,2919,0,3,1,3,0,1,0,76.14,67.18 ,33.33
03,001,01,003,0176,0,1537,27,1564,2384,0,3,1,3,0,1,0,76.14,65.60 ,33.33
03,001,01,003,0177,0,1197,10,1207,1864,0,3,1,3,0,1,0,76.14,64.75 ,33.33
03,001,01,003,0178,0,789,12,801,1128,0,3,1,3,0,1,0,76.14,71.01 ,33.33
03,001,01,003,0179,0,1002,20,1022,1466,0,3,1,3,0,1,0,76.14,69.71 ,33.33
03,001,01,003,0180,0,1786,47,1833,2708,0,3,1,3,0,1,0,76.14,67.69 ,33.33
03,001,01,003,0181,0,2107,32,2139,3161,0,3,1,3,0,1,0,76.14,67.67 ,33.33
03,001,01,003,0182,0,2216,31,2247,3547,0,3,1,3,0,1,0,76.14,63.35 ,33.33
03,001,01,003,0183,0,2110,31,2141,3239,0,3,1,3,0,1,0,76.14,66.10 ,33.33
03,001,01,003,0184,0,1591,31,1622,2528,0,3,1,3,0,1,0,76.14,64.16 ,33.33
03,001,01,003,0185,0,1711,34,1745,2692,0,3,1,3,0,1,0,76.14,64.82 ,33.33
03,001,01,003,0186,0,2131,31,2162,3260,0,3,1,3,0,1,0,76.14,66.32 ,33.33
03,001,01,003,0187,0,2096,38,2134,3276,0,3,1,3,0,1,0,76.14,65.14 ,33.33
03,001,01,003,0188,0,716,10,726,993,0,3,1,3,0,1,0,76.14,73.11 ,33.33
03,001,01,003,0189,0,755,11,766,1042,0,3,1,3,0,1,0,76.14,73.51 ,33.33
03,001,01,003,0190,0,1345,29,1374,1892,0,3,1,3,0,1,0,76.14,72.62 ,33.33
03,001,01,003,0191,0,1973,17,1990,2848,0,3,1,3,0,1,0,76.14,69.87 ,33.33
03,001,01,003,0192,0,2686,37,2723,3807,0,3,1,3,0,1,0,76.14,71.53 ,33.33
03,001,01,003,0193,0,1521,34,1555,2150,0,3,1,3,0,1,0,76.14,72.33 ,33.33
03,001,01,003,0194,0,2065,26,2091,3040,0,3,1,3,0,1,0,76.14,68.78 ,33.33
03,001,01,003,0195,0,1692,32,1724,2444,0,3,1,3,0,1,0,76.14,70.54 ,33.33
03,001,01,003,0196,0,1866,25,1891,2723,0,3,1,3,0,1,0,76.14,69.45 ,33.33
03,001,01,003,0197,0,843,10,853,1197,0,3,1,3,0,1,0,76.14,71.26 ,33.33
03,001,01,003,0198,0,1484,24,1508,2165,0,3,1,3,0,1,0,76.14,69.65 ,33.33
03,001,01,003,0199,0,1292,15,1307,2070,0,3,1,3,0,1,0,76.14,63.14 ,33.33
03,001,01,003,0200,0,1166,16,1182,1854,0,3,1,3,0,1,0,76.14,63.75 ,33.33
03,001,01,003,0201,0,2038,40,2078,3041,0,3,1,3,0,1,0,76.14,68.33 ,33.33
03,001,01,003,0202,0,2383,44,2427,3832,0,3,1,3,0,1,0,76.14,63.34 ,33.33
03,001,01,003,0203,0,2007,37,2044,3145,0,3,1,3,0,1,0,76.14,64.99 ,33.33
03,001,01,003,0204,0,2190,28,2218,3318,0,3,1,3,0,1,0,76.14,66.85 ,33.33
03,001,01,003,0205,0,1989,27,2016,2817,0,3,1,3,0,1,0,76.14,71.57 ,33.33
03,001,01,003,0206,0,2719,42,2761,4036,0,3,1,3,0,1,0,76.14,68.41 ,33.33
03,001,01,003,0207,0,1649,22,1671,2460,0,3,1,3,0,1,0,76.14,67.93 ,33.33
03,001,01,003,0208,0,1796,25,1821,2627,0,3,1,3,0,1,0,76.14,69.32 ,33.33
03,001,01,003,0209,0,1767,33,1800,2579,0,3,1,3,0,1,0,76.14,69.79 ,33.33
03,001,01,003,0210,0,747,7,754,1176,0,3,1,3,0,1,0,76.14,64.12 ,33.33
03,001,01,003,0211,0,880,17,897,1260,0,3,1,3,0,1,0,76.14,71.19 ,33.33
03,001,01,003,0212,0,895,12,907,1297,0,3,1,3,0,1,0,76.14,69.93 ,33.33
03,001,01,003,0213,0,860,7,867,1204,0,3,1,3,0,1,0,76.14,72.01 ,33.33
03,001,01,003,0214,0,467,7,474,639,0,3,1,3,0,1,0,76.14,74.18 ,33.33
03,001,01,003,0215,0,806,18,824,1201,0,3,1,3,0,1,0,76.14,68.61 ,33.33
03,001,01,004,0216,0,312,2,314,449,0,3,1,3,0,1,0,76.14,69.93 ,33.33
03,001,01,004,0217,0,670,5,675,899,0,3,1,3,0,1,0,76.14,75.08 ,33.33
03,001,01,004,0218,0,910,9,919,1240,0,3,1,3,0,1,0,76.14,74.11 ,33.33
03,001,01,004,0219,0,1289,13,1302,1822,0,3,1,3,0,1,0,76.14,71.46 ,33.33
03,001,01,004,0220,0,588,4,592,794,0,3,1,3,0,1,0,76.14,74.56 ,33.33
03,001,01,004,0221,0,2733,30,2763,3875,0,3,1,3,0,1,0,76.14,71.30 ,33.33
03,001,01,004,0222,0,2593,39,2632,3932,0,3,1,3,0,1,0,76.14,66.94 ,33.33
03,001,01,004,0223,0,1804,22,1826,2589,0,3,1,3,0,1,0,76.14,70.53 ,33.33
03,001,01,004,0224,0,2777,35,2812,3998,0,3,1,3,0,1,0,76.14,70.34 ,33.33
03,001,01,004,0225,0,3330,43,3373,4750,0,3,1,3,0,1,0,76.14,71.01 ,33.33
03,001,01,004,0226,0,531,9,540,745,0,3,1,3,0,1,0,76.14,72.48 ,33.33
03,001,01,004,0227,0,889,7,896,1208,0,3,1,3,0,1,0,76.14,74.17 ,33.33
03,001,01,004,0228,0,3913,57,3970,5874,0,3,1,3,0,1,0,76.14,67.59 ,33.33
03,001,01,004,0229,0,2329,33,2362,3365,0,3,1,3,0,1,0,76.14,70.19 ,33.33
03,001,01,004,0230,0,2162,33,2195,3280,0,3,1,3,0,1,0,76.14,66.92 ,33.33
03,001,01,004,0231,0,2088,27,2115,3244,0,3,1,3,0,1,0,76.14,65.20 ,33.33
03,001,01,004,0232,0,2128,34,2162,3212,0,3,1,3,0,1,0,76.14,67.31 ,33.33
03,001,01,004,0233,0,2658,38,2696,3873,0,3,1,3,0,1,0,76.14,69.61 ,33.33
03,001,01,004,0234,0,2772,38,2810,4120,0,3,1,3,0,1,0,76.14,68.20 ,33.33
03,001,01,004,0235,0,168,2,170,230,0,3,1,3,0,1,0,76.14,73.91 ,33.33
03,001,01,005,0236,0,235,4,239,322,0,3,1,3,0,1,0,76.14,74.22 ,33.33
03,001,01,005,0237,0,316,3,319,410,0,3,1,3,0,1,0,76.14,77.80 ,33.33
03,001,01,005,0238,0,1743,32,1775,2465,0,3,1,3,0,1,0,76.14,72.01 ,33.33
03,001,01,005,0239,0,933,15,948,1365,0,3,1,3,0,1,0,76.14,69.45 ,33.33
03,001,01,005,0240,0,587,4,591,812,0,3,1,3,0,1,0,76.14,72.78 ,33.33
03,001,01,005,0241,0,3092,26,3118,4519,0,3,1,3,0,1,0,76.14,69.00 ,33.33
03,001,01,005,0242,0,2230,19,2249,3280,0,3,1,3,0,1,0,76.14,68.57 ,33.33
03,001,01,005,0243,0,1974,26,2000,2930,0,3,1,3,0,1,0,76.14,68.26 ,33.33
03,001,01,005,0244,0,2167,27,2194,3266,0,3,1,3,0,1,0,76.14,67.18 ,33.33
03,001,01,005,0245,0,3323,49,3372,4847,0,3,1,3,0,1,0,76.14,69.57 ,33.33
03,001,01,005,0246,0,3252,52,3304,4914,0,3,1,3,0,1,0,76.14,67.24 ,33.33
03,001,01,005,0247,0,3594,45,3639,5359,0,3,1,3,0,1,0,76.14,67.90 ,33.33
03,001,01,005,0248,0,2150,24,2174,3128,0,3,1,3,0,1,0,76.14,69.50 ,33.33
03,001,01,005,0249,0,1403,20,1423,2237,0,3,1,3,0,1,0,76.14,63.61 ,33.33
03,001,01,005,0250,0,1757,64,1821,2581,0,3,1,3,0,1,0,76.14,70.55 ,33.33
03,001,01,005,0251,0,662,12,674,944,0,3,1,3,0,1,0,76.14,71.40 ,33.33
03,001,01,005,0252,0,602,7,609,891,0,3,1,3,0,1,0,76.14,68.35 ,33.33
03,001,01,005,0253,0,298,7,305,458,0,3,1,3,0,1,0,76.14,66.59 ,33.33
03,001,01,005,0254,0,559,6,565,827,0,3,1,3,0,1,0,76.14,68.32 ,33.33
03,001,01,005,0255,0,566,6,572,799,0,3,1,3,0,1,0,76.14,71.59 ,33.33
03,001,01,005,0256,0,847,11,858,1167,0,3,1,3,0,1,0,76.14,73.52 ,33.33
03,001,01,005,0257,0,1262,29,1291,1785,0,3,1,3,0,1,0,76.14,72.32 ,33.33
03,001,01,005,0258,0,1504,24,1528,2213,0,3,1,3,0,1,0,76.14,69.05 ,33.33
03,001,01,005,0259,0,640,5,645,822,0,3,1,3,0,1,0,76.14,78.47 ,33.33
03,001,01,005,0260,0,815,17,832,1264,0,3,1,3,0,1,0,76.14,65.82 ,33.33
03,001,01,005,0261,0,1132,65,1197,1735,0,3,1,3,0,1,0,76.14,68.99 ,33.33
03,001,02,006,0262,0,2298,35,2333,3357,0,3,1,3,0,1,0,76.14,69.50 ,33.33
03,001,02,006,0263,0,788,12,800,1166,0,3,1,3,0,1,0,76.14,68.61 ,33.33
03,001,02,006,0264,0,920,21,941,1325,0,3,1,3,0,1,0,76.14,71.02 ,33.33
03,001,02,006,0265,0,572,8,580,919,0,3,1,3,0,1,0,76.14,63.11 ,33.33
03,001,02,006,0266,0,1026,26,1052,1629,0,3,1,3,0,1,0,76.14,64.58 ,33.33
03,001,02,006,0267,0,1343,22,1365,1989,0,3,1,3,0,1,0,76.14,68.63 ,33.33
03,001,02,006,0268,0,685,10,695,959,0,3,1,3,0,1,0,76.14,72.47 ,33.33
03,001,02,006,0269,0,1640,36,1676,2457,0,3,1,3,0,1,0,76.14,68.21 ,33.33
03,001,02,006,0270,0,947,13,960,1370,0,3,1,3,0,1,0,76.14,70.07 ,33.33
03,001,02,006,0271,0,270,2,272,374,0,3,1,3,0,1,0,76.14,72.73 ,33.33
03,001,02,006,0272,0,2350,34,2384,3555,0,3,1,3,0,1,0,76.14,67.06 ,33.33
03,001,02,006,0273,0,1919,28,1947,2803,0,3,1,3,0,1,0,76.14,69.46 ,33.33
03,001,02,006,0274,0,1998,30,2028,3043,0,3,1,3,0,1,0,76.14,66.64 ,33.33
03,001,02,006,0275,0,1734,27,1761,2586,0,3,1,3,0,1,0,76.14,68.10 ,33.33
03,001,02,006,0276,0,2796,42,2838,4317,0,3,1,3,0,1,0,76.14,65.74 ,33.33
03,001,02,006,0277,0,1146,14,1160,1712,0,3,1,3,0,1,0,76.14,67.76 ,33.33
03,001,02,006,0278,0,1549,17,1566,2221,0,3,1,3,0,1,0,76.14,70.51 ,33.33
03,001,02,006,0279,0,2345,42,2387,3455,0,3,1,3,0,1,0,76.14,69.09 ,33.33
03,001,02,006,0280,0,3171,54,3225,4683,0,3,1,3,0,1,0,76.14,68.87 ,33.33
03,001,02,006,0281,0,2216,50,2266,3373,0,3,1,3,0,1,0,76.14,67.18 ,33.33
03,001,02,006,0282,0,1804,27,1831,2608,0,3,1,3,0,1,0,76.14,70.21 ,33.33
03,001,02,006,0283,0,2946,48,2994,4444,0,3,1,3,0,1,0,76.14,67.37 ,33.33
03,001,02,006,0284,0,3242,53,3295,4740,0,3,1,3,0,1,0,76.14,69.51 ,33.33
03,001,02,006,0285,0,1689,19,1708,2415,0,3,1,3,0,1,0,76.14,70.72 ,33.33
03,001,02,006,0286,0,3084,39,3123,4763,0,3,1,3,0,1,0,76.14,65.57 ,33.33
03,001,02,006,0287,0,864,17,881,1374,0,3,1,3,0,1,0,76.14,64.12 ,33.33
03,001,02,006,0288,0,888,18,906,1466,0,3,1,3,0,1,0,76.14,61.80 ,33.33
03,001,02,006,0289,0,940,16,956,1424,0,3,1,3,0,1,0,76.14,67.13 ,33.33
03,001,02,006,0290,0,1134,17,1151,1642,0,3,1,3,0,1,0,76.14,70.10 ,33.33
03,001,02,006,0291,0,920,18,938,1339,0,3,1,3,0,1,0,76.14,70.05 ,33.33
03,001,02,006,0292,0,818,17,835,1174,0,3,1,3,0,1,0,76.14,71.12 ,33.33
03,001,02,006,0293,0,814,17,831,1221,0,3,1,3,0,1,0,76.14,68.06 ,33.33
03,001,02,006,0294,0,984,9,993,1507,0,3,1,3,0,1,0,76.14,65.89 ,33.33
03,001,02,006,0295,0,774,25,799,1164,0,3,1,3,0,1,0,76.14,68.64 ,33.33
03,001,02,006,0296,0,930,21,951,1430,0,3,1,3,0,1,0,76.14,66.50 ,33.33
03,001,02,006,0297,0,904,20,924,1393,0,3,1,3,0,1,0,76.14,66.33 ,33.33
03,001,02,006,0298,0,1256,25,1281,1876,0,3,1,3,0,1,0,76.14,68.28 ,33.33
03,001,02,006,0299,0,999,12,1011,1581,0,3,1,3,0,1,0,76.14,63.95 ,33.33
03,001,02,006,0300,0,758,17,775,1132,0,3,1,3,0,1,0,76.14,68.46 ,33.33
03,001,02,006,0301,0,714,6,720,1081,0,3,1,3,0,1,0,76.14,66.60 ,33.33
03,001,02,006,0302,0,1062,17,1079,1548,0,3,1,3,0,1,0,76.14,69.70 ,33.33
03,001,02,006,0303,0,580,8,588,833,0,3,1,3,0,1,0,76.14,70.59 ,33.33
03,001,02,006,0304,0,957,13,970,1496,0,3,1,3,0,1,0,76.14,64.84 ,33.33
03,001,02,006,0305,0,1558,15,1573,2354,0,3,1,3,0,1,0,76.14,66.82 ,33.33
03,001,02,006,0306,0,700,9,709,1121,0,3,1,3,0,1,0,76.14,63.25 ,33.33
03,001,02,006,0307,0,1380,13,1393,2067,0,3,1,3,0,1,0,76.14,67.39 ,33.33
03,001,02,006,0308,0,1373,19,1392,2171,0,3,1,3,0,1,0,76.14,64.12 ,33.33
03,001,02,006,0309,0,1478,34,1512,2087,0,3,1,3,0,1,0,76.14,72.45 ,33.33
03,001,02,006,0310,0,1833,30,1863,2814,0,3,1,3,0,1,0,76.14,66.20 ,33.33
03,001,02,006,0311,0,2421,31,2452,3578,0,3,1,3,0,1,0,76.14,68.53 ,33.33
03,001,02,006,0312,0,944,20,964,1344,0,3,1,3,0,1,0,76.14,71.73 ,33.33
03,001,02,006,0313,0,713,15,728,1025,0,3,1,3,0,1,0,76.14,71.02 ,33.33
03,001,02,006,0314,0,1022,15,1037,1524,0,3,1,3,0,1,0,76.14,68.04 ,33.33
03,001,02,006,0315,0,1065,27,1092,1544,0,3,1,3,0,1,0,76.14,70.73 ,33.33
03,001,02,006,0316,0,1117,12,1129,1567,0,3,1,3,0,1,0,76.14,72.05 ,33.33
03,001,02,006,0317,0,1417,23,1440,2100,0,3,1,3,0,1,0,76.14,68.57 ,33.33
03,001,02,006,0318,0,1019,20,1039,1495,0,3,1,3,0,1,0,76.14,69.50 ,33.33
03,001,02,006,0319,0,580,7,587,882,0,3,1,3,0,1,0,76.14,66.55 ,33.33
03,001,02,006,0320,0,964,16,980,1459,0,3,1,3,0,1,0,76.14,67.17 ,33.33
03,001,02,006,0321,0,1157,36,1193,1696,0,3,1,3,0,1,0,76.14,70.34 ,33.33
03,001,02,006,0322,0,1268,21,1289,1982,0,3,1,3,0,1,0,76.14,65.04 ,33.33
03,001,02,006,0323,0,1026,22,1048,1596,0,3,1,3,0,1,0,76.14,65.66 ,33.33
03,001,02,006,0324,0,499,5,504,742,0,3,1,3,0,1,0,76.14,67.92 ,33.33
03,001,02,006,0325,0,900,10,910,1309,0,3,1,3,0,1,0,76.14,69.52 ,33.33
03,001,02,006,0326,0,406,5,411,579,0,3,1,3,0,1,0,76.14,70.98 ,33.33
03,001,02,006,0327,0,1406,43,1449,2150,0,3,1,3,0,1,0,76.14,67.40 ,33.33
03,001,02,006,0328,0,1143,26,1169,1668,0,3,1,3,0,1,0,76.14,70.08 ,33.33
03,001,02,006,0329,0,1361,30,1391,2048,0,3,1,3,0,1,0,76.14,67.92 ,33.33
03,001,02,006,0330,0,898,12,910,1408,0,3,1,3,0,1,0,76.14,64.63 ,33.33
03,001,02,006,0331,0,732,9,741,1060,0,3,1,3,0,1,0,76.14,69.91 ,33.33
03,001,02,006,0332,0,1140,20,1160,1663,0,3,1,3,0,1,0,76.14,69.75 ,33.33
03,001,02,006,0333,0,1326,37,1363,2015,0,3,1,3,0,1,0,76.14,67.64 ,33.33
03,001,02,006,0334,0,1701,42,1743,2527,0,3,1,3,0,1,0,76.14,68.98 ,33.33
03,001,02,006,0335,0,1070,14,1084,1610,0,3,1,3,0,1,0,76.14,67.33 ,33.33
03,001,02,006,0336,0,804,8,812,1166,0,3,1,3,0,1,0,76.14,69.64 ,33.33
03,001,02,006,0337,0,904,13,917,1315,0,3,1,3,0,1,0,76.14,69.73 ,33.33
03,001,02,006,0338,0,1485,25,1510,2236,0,3,1,3,0,1,0,76.14,67.53 ,33.33
03,001,02,006,0339,0,1548,32,1580,2417,0,3,1,3,0,1,0,76.14,65.37 ,33.33
03,001,02,006,0340,0,998,19,1017,1461,0,3,1,3,0,1,0,76.14,69.61 ,33.33
03,001,02,006,0341,0,1242,28,1270,1850,0,3,1,3,0,1,0,76.14,68.65 ,33.33
03,001,02,006,0342,0,2454,47,2501,3769,0,3,1,3,0,1,0,76.14,66.36 ,33.33
03,001,02,006,0343,0,2131,36,2167,3142,0,3,1,3,0,1,0,76.14,68.97 ,33.33
03,001,02,006,0344,0,2653,40,2693,3988,0,3,1,3,0,1,0,76.14,67.53 ,33.33
03,001,02,006,0345,0,1260,20,1280,1878,0,3,1,3,0,1,0,76.14,68.16 ,33.33
03,001,02,006,0346,0,1138,19,1157,1631,0,3,1,3,0,1,0,76.14,70.94 ,33.33
03,001,02,006,0347,0,1453,25,1478,2079,0,3,1,3,0,1,0,76.14,71.09 ,33.33
03,001,02,006,0348,0,2254,36,2290,3395,0,3,1,3,0,1,0,76.14,67.45 ,33.33
03,001,02,006,0349,0,1803,20,1823,2491,0,3,1,3,0,1,0,76.14,73.18 ,33.33
03,001,02,006,0350,0,1565,30,1595,2318,0,3,1,3,0,1,0,76.14,68.81 ,33.33
03,001,02,006,0351,0,1750,31,1781,2648,0,3,1,3,0,1,0,76.14,67.26 ,33.33
03,001,02,006,0352,0,1814,15,1829,2701,0,3,1,3,0,1,0,76.14,67.72 ,33.33
03,001,02,006,0353,0,1736,32,1768,2615,0,3,1,3,0,1,0,76.14,67.61 ,33.33
03,001,02,006,0354,0,2668,49,2717,4014,0,3,1,3,0,1,0,76.14,67.69 ,33.33
03,001,02,006,0355,0,1419,20,1439,2066,0,3,1,3,0,1,0,76.14,69.65 ,33.33
03,001,02,006,0356,0,2343,29,2372,3389,0,3,1,3,0,1,0,76.14,69.99 ,33.33
03,001,02,006,0357,0,1842,31,1873,2788,0,3,1,3,0,1,0,76.14,67.18 ,33.33
03,001,02,006,0358,0,1501,26,1527,2339,0,3,1,3,0,1,0,76.14,65.28 ,33.33
03,001,02,006,0359,0,1699,25,1724,2593,0,3,1,3,0,1,0,76.14,66.49 ,33.33
03,001,02,006,0360,0,2400,36,2436,3581,0,3,1,3,0,1,0,76.14,68.03 ,33.33
03,001,02,006,0361,0,2524,48,2572,3935,0,3,1,3,0,1,0,76.14,65.36 ,33.33
03,001,02,006,0362,0,2668,43,2711,4156,0,3,1,3,0,1,0,76.14,65.23 ,33.33
03,001,02,006,0363,0,2262,25,2287,3546,0,3,1,3,0,1,0,76.14,64.50 ,33.33
03,001,02,006,0364,0,3372,53,3425,5056,0,3,1,3,0,1,0,76.14,67.74 ,33.33
03,001,02,006,0365,0,1837,37,1874,2837,0,3,1,3,0,1,0,76.14,66.06 ,33.33
03,001,02,006,0366,0,2131,42,2173,3165,0,3,1,3,0,1,0,76.14,68.66 ,33.33
03,001,02,006,0367,0,1426,23,1449,2202,0,3,1,3,0,1,0,76.14,65.80 ,33.33
03,001,02,006,0368,0,1648,28,1676,2644,0,3,1,3,0,1,0,76.14,63.39 ,33.33
03,001,02,006,0369,0,1266,28,1294,1969,0,3,1,3,0,1,0,76.14,65.72 ,33.33
03,001,02,006,0370,0,1316,24,1340,2000,0,3,1,3,0,1,0,76.14,67.00 ,33.33
03,001,02,006,0371,0,1317,18,1335,1956,0,3,1,3,0,1,0,76.14,68.25 ,33.33
03,001,02,006,0372,0,2118,25,2143,3113,0,3,1,3,0,1,0,76.14,68.84 ,33.33
03,001,02,006,0373,0,1353,33,1386,1994,0,3,1,3,0,1,0,76.14,69.51 ,33.33
03,001,02,006,0374,0,2294,40,2334,3474,0,3,1,3,0,1,0,76.14,67.18 ,33.33
03,001,02,006,0375,0,1382,18,1400,2155,0,3,1,3,0,1,0,76.14,64.97 ,33.33
03,001,02,006,0376,0,1632,30,1662,2547,0,3,1,3,0,1,0,76.14,65.25 ,33.33
03,001,02,006,0377,0,1144,17,1161,1710,0,3,1,3,0,1,0,76.14,67.89 ,33.33
03,001,02,006,0378,0,1834,38,1872,2723,0,3,1,3,0,1,0,76.14,68.75 ,33.33
03,001,02,006,0379,0,1302,20,1322,2017,0,3,1,3,0,1,0,76.14,65.54 ,33.33
03,001,02,006,0380,0,1925,32,1957,2874,0,3,1,3,0,1,0,76.14,68.09 ,33.33
03,001,02,006,0381,0,1941,32,1973,2968,0,3,1,3,0,1,0,76.14,66.48 ,33.33
03,001,02,006,0382,0,1941,28,1969,3007,0,3,1,3,0,1,0,76.14,65.48 ,33.33
03,001,02,007,0383,0,2519,34,2553,3777,0,3,1,3,0,1,0,76.14,67.59 ,33.33
03,001,02,007,0384,0,1905,26,1931,3036,0,3,1,3,0,1,0,76.14,63.60 ,33.33
03,001,02,007,0385,0,1785,36,1821,2651,0,3,1,3,0,1,0,76.14,68.69 ,33.33
03,001,02,007,0386,0,1563,20,1583,2277,0,3,1,3,0,1,0,76.14,69.52 ,33.33
03,001,02,007,0387,0,2005,32,2037,3376,0,3,1,3,0,1,0,76.14,60.34 ,33.33
03,001,02,007,0388,0,1783,35,1818,2687,0,3,1,3,0,1,0,76.14,67.66 ,33.33
03,001,02,007,0389,0,1556,26,1582,2350,0,3,1,3,0,1,0,76.14,67.32 ,33.33
03,001,02,007,0390,0,2004,41,2045,3273,0,3,1,3,0,1,0,76.14,62.48 ,33.33
03,001,02,007,0391,0,1040,22,1062,1632,0,3,1,3,0,1,0,76.14,65.07 ,33.33
03,001,02,007,0392,0,1753,30,1783,2708,0,3,1,3,0,1,0,76.14,65.84 ,33.33
03,001,02,007,0393,0,2233,27,2260,3517,0,3,1,3,0,1,0,76.14,64.26 ,33.33
03,001,02,007,0394,0,1671,33,1704,2738,0,3,1,3,0,1,0,76.14,62.24 ,33.33
03,001,02,007,0395,0,2627,36,2663,4225,0,3,1,3,0,1,0,76.14,63.03 ,33.33
03,001,02,007,0396,0,2350,31,2381,3665,0,3,1,3,0,1,0,76.14,64.97 ,33.33
03,001,02,007,0397,0,2240,29,2269,3454,0,3,1,3,0,1,0,76.14,65.69 ,33.33
03,001,02,007,0398,0,108,4,112,207,0,3,1,3,0,1,0,76.14,54.11 ,33.33
03,001,02,007,0399,0,2554,37,2591,3827,0,3,1,3,0,1,0,76.14,67.70 ,33.33
03,001,02,007,0400,0,1986,53,2039,2946,0,3,1,3,0,1,0,76.14,69.21 ,33.33
03,001,02,007,0401,0,1974,30,2004,3051,0,3,1,3,0,1,0,76.14,65.68 ,33.33
03,001,02,007,0402,0,1568,21,1589,2482,0,3,1,3,0,1,0,76.14,64.02 ,33.33
03,001,02,007,0403,0,1492,20,1512,2202,0,3,1,3,0,1,0,76.14,68.66 ,33.33
03,001,02,007,0404,0,2332,32,2364,3613,0,3,1,3,0,1,0,76.14,65.43 ,33.33
03,001,02,007,0405,0,2791,40,2831,4377,0,3,1,3,0,1,0,76.14,64.68 ,33.33
03,001,02,007,0406,0,1652,18,1670,2549,0,3,1,3,0,1,0,76.14,65.52 ,33.33
03,001,02,007,0407,0,1655,21,1676,2467,0,3,1,3,0,1,0,76.14,67.94 ,33.33
03,001,02,007,0408,0,1631,21,1652,2349,0,3,1,3,0,1,0,76.14,70.33 ,33.33
03,001,02,007,0409,0,1353,32,1385,2057,0,3,1,3,0,1,0,76.14,67.33 ,33.33
03,001,02,007,0410,0,1847,28,1875,2713,0,3,1,3,0,1,0,76.14,69.11 ,33.33
03,001,02,007,0411,0,1015,17,1032,1551,0,3,1,3,0,1,0,76.14,66.54 ,33.33
03,001,02,007,0412,0,2336,33,2369,3684,0,3,1,3,0,1,0,76.14,64.31 ,33.33
03,001,02,007,0413,0,1315,22,1337,2058,0,3,1,3,0,1,0,76.14,64.97 ,33.33
03,001,02,007,0414,0,1384,18,1402,2088,0,3,1,3,0,1,0,76.14,67.15 ,33.33
03,001,02,007,0415,0,3328,45,3373,5270,0,3,1,3,0,1,0,76.14,64.00 ,33.33
03,001,02,007,0416,0,3308,42,3350,5288,0,3,1,3,0,1,0,76.14,63.35 ,33.33
03,001,02,007,0417,0,2356,26,2382,3656,0,3,1,3,0,1,0,76.14,65.15 ,33.33
03,001,02,007,0418,0,1025,17,1042,1621,0,3,1,3,0,1,0,76.14,64.28 ,33.33
03,001,02,007,0419,0,1709,19,1728,2665,0,3,1,3,0,1,0,76.14,64.84 ,33.33
03,001,02,007,0420,0,1420,16,1436,2202,0,3,1,3,0,1,0,76.14,65.21 ,33.33
03,001,02,008,0421,0,2360,36,2396,3369,0,3,1,3,0,1,0,76.14,71.12 ,33.33
03,001,02,008,0422,0,2886,44,2930,4269,0,3,1,3,0,1,0,76.14,68.63 ,33.33
03,001,02,008,0423,0,1876,38,1914,2863,0,3,1,3,0,1,0,76.14,66.85 ,33.33
03,001,02,008,0424,0,996,11,1007,1405,0,3,1,3,0,1,0,76.14,71.67 ,33.33
03,001,02,008,0425,0,2098,29,2127,3014,0,3,1,3,0,1,0,76.14,70.57 ,33.33
03,001,02,008,0426,0,1185,9,1194,1627,0,3,1,3,0,1,0,76.14,73.39 ,33.33
03,001,02,008,0427,0,2396,42,2438,3616,0,3,1,3,0,1,0,76.14,67.42 ,33.33
03,001,02,008,0428,0,2525,41,2566,3775,0,3,1,3,0,1,0,76.14,67.97 ,33.33
03,001,02,008,0429,0,2155,28,2183,3021,0,3,1,3,0,1,0,76.14,72.26 ,33.33
03,001,02,008,0430,0,1724,28,1752,2840,0,3,1,3,0,1,0,76.14,61.69 ,33.33
03,001,02,008,0431,0,951,9,960,1344,0,3,1,3,0,1,0,76.14,71.43 ,33.33
03,001,02,008,0432,0,1101,15,1116,1558,0,3,1,3,0,1,0,76.14,71.63 ,33.33
03,001,02,008,0433,0,2751,42,2793,3956,0,3,1,3,0,1,0,76.14,70.60 ,33.33
03,001,02,008,0434,0,2089,42,2131,3147,0,3,1,3,0,1,0,76.14,67.72 ,33.33
03,001,02,008,0435,0,1367,23,1390,2023,0,3,1,3,0,1,0,76.14,68.71 ,33.33
03,001,02,008,0436,0,2214,34,2248,3567,0,3,1,3,0,1,0,76.14,63.02 ,33.33
03,001,02,008,0437,0,1661,23,1684,2624,0,3,1,3,0,1,0,76.14,64.18 ,33.33
03,001,02,008,0438,0,2331,35,2366,3599,0,3,1,3,0,1,0,76.14,65.74 ,33.33
03,001,02,008,0439,0,1741,26,1767,2505,0,3,1,3,0,1,0,76.14,70.54 ,33.33
03,001,02,008,0440,0,1136,14,1150,1735,0,3,1,3,0,1,0,76.14,66.28 ,33.33
03,001,02,008,0441,0,1537,22,1559,2376,0,3,1,3,0,1,0,76.14,65.61 ,33.33
03,001,02,008,0442,0,2350,33,2383,3720,0,3,1,3,0,1,0,76.14,64.06 ,33.33
03,001,02,008,0443,0,1423,24,1447,2088,0,3,1,3,0,1,0,76.14,69.30 ,33.33
03,001,02,008,0444,0,1899,22,1921,2726,0,3,1,3,0,1,0,76.14,70.47 ,33.33
03,001,02,008,0445,0,1239,22,1261,1930,0,3,1,3,0,1,0,76.14,65.34 ,33.33
03,001,02,008,0446,0,1794,33,1827,2754,0,3,1,3,0,1,0,76.14,66.34 ,33.33
03,001,02,008,0447,0,2667,42,2709,4069,0,3,1,3,0,1,0,76.14,66.58 ,33.33
03,001,02,008,0448,0,1550,26,1576,2376,0,3,1,3,0,1,0,76.14,66.33 ,33.33
03,001,02,008,0449,0,1596,24,1620,2429,0,3,1,3,0,1,0,76.14,66.69 ,33.33
03,001,02,008,0450,0,2519,41,2560,3835,0,3,1,3,0,1,0,76.14,66.75 ,33.33
03,001,02,008,0451,0,1747,23,1770,2729,0,3,1,3,0,1,0,76.14,64.86 ,33.33
03,001,02,008,0452,0,3167,49,3216,4824,0,3,1,3,0,1,0,76.14,66.67 ,33.33
03,001,02,008,0453,0,3137,57,3194,4782,0,3,1,3,0,1,0,76.14,66.79 ,33.33
03,001,02,008,0454,0,2830,29,2859,4377,0,3,1,3,0,1,0,76.14,65.32 ,33.33
03,001,02,008,0455,0,1179,19,1198,1662,0,3,1,3,0,1,0,76.14,72.08 ,33.33
03,001,02,008,0456,0,2463,30,2493,3656,0,3,1,3,0,1,0,76.14,68.19 ,33.33
03,001,02,008,0457,0,2265,37,2302,3470,0,3,1,3,0,1,0,76.14,66.34 ,33.33
03,001,02,008,0458,0,1960,27,1987,3084,0,3,1,3,0,1,0,76.14,64.43 ,33.33
03,001,02,008,0459,0,1471,18,1489,2122,0,3,1,3,0,1,0,76.14,70.17 ,33.33
03,001,02,008,0460,0,3330,48,3378,4989,0,3,1,3,0,1,0,76.14,67.71 ,33.33
03,001,02,008,0461,0,1678,33,1711,2509,0,3,1,3,0,1,0,76.14,68.19 ,33.33
03,001,02,008,0462,0,924,12,936,1331,0,3,1,3,0,1,0,76.14,70.32 ,33.33
03,001,02,008,0463,0,1169,23,1192,1734,0,3,1,3,0,1,0,76.14,68.74 ,33.33
03,001,02,008,0464,0,3019,48,3067,4549,0,3,1,3,0,1,0,76.14,67.42 ,33.33
03,001,02,008,0465,0,2418,41,2459,3673,0,3,1,3,0,1,0,76.14,66.95 ,33.33
03,001,02,008,0466,0,1381,20,1401,2148,0,3,1,3,0,1,0,76.14,65.22 ,33.33
03,001,02,008,0467,0,1981,25,2006,3015,0,3,1,3,0,1,0,76.14,66.53 ,33.33
03,001,02,008,0468,0,2528,41,2569,3837,0,3,1,3,0,1,0,76.14,66.95 ,33.33
03,001,02,008,0469,0,1788,23,1811,2693,0,3,1,3,0,1,0,76.14,67.25 ,33.33
03,001,02,008,0470,0,2735,45,2780,4158,0,3,1,3,0,1,0,76.14,66.86 ,33.33
03,001,02,008,0471,0,1709,22,1731,2712,0,3,1,3,0,1,0,76.14,63.83 ,33.33
03,001,02,008,0472,0,1371,18,1389,1956,0,3,1,3,0,1,0,76.14,71.01 ,33.33
03,001,02,008,0473,0,2917,55,2972,4411,0,3,1,3,0,1,0,76.14,67.38 ,33.33
03,001,02,008,0474,0,1279,24,1303,1916,0,3,1,3,0,1,0,76.14,68.01 ,33.33
03,001,02,008,0475,0,3129,38,3167,4901,0,3,1,3,0,1,0,76.14,64.62 ,33.33
03,001,02,008,0476,0,2205,53,2258,3378,0,3,1,3,0,1,0,76.14,66.84 ,33.33
03,001,02,008,0477,0,1084,11,1095,1641,0,3,1,3,0,1,0,76.14,66.73 ,33.33
03,001,02,008,0478,0,2415,32,2447,3708,0,3,1,3,0,1,0,76.14,65.99 ,33.33
03,001,02,008,0479,0,2542,29,2571,4006,0,3,1,3,0,1,0,76.14,64.18 ,33.33
03,001,02,008,0480,0,1267,14,1281,1918,0,3,1,3,0,1,0,76.14,66.79 ,33.33
03,001,02,008,0481,0,1306,14,1320,2041,0,3,1,3,0,1,0,76.14,64.67 ,33.33
03,001,02,008,0482,0,1649,31,1680,2525,0,3,1,3,0,1,0,76.14,66.53 ,33.33
03,001,02,008,0483,0,1656,26,1682,2561,0,3,1,3,0,1,0,76.14,65.68 ,33.33
03,001,02,008,0484,0,1419,21,1440,1983,0,3,1,3,0,1,0,76.14,72.62 ,33.33
03,001,02,008,0485,0,905,17,922,1389,0,3,1,3,0,1,0,76.14,66.38 ,33.33
03,001,02,008,0486,0,1613,32,1645,2502,0,3,1,3,0,1,0,76.14,65.75 ,33.33
03,001,02,008,0487,0,1508,15,1523,2370,0,3,1,3,0,1,0,76.14,64.26 ,33.33
03,001,02,008,0488,0,1486,23,1509,2330,0,3,1,3,0,1,0,76.14,64.76 ,33.33
03,001,02,008,0489,0,1499,25,1524,2226,0,3,1,3,0,1,0,76.14,68.46 ,33.33
03,001,02,008,0490,0,2558,37,2595,4101,0,3,1,3,0,1,0,76.14,63.28 ,33.33
03,001,02,008,0491,0,2257,45,2302,3518,0,3,1,3,0,1,0,76.14,65.43 ,33.33
03,001,02,008,0492,0,1900,30,1930,3142,0,3,1,3,0,1,0,76.14,61.43 ,33.33
03,001,02,008,0493,0,1671,34,1705,2737,0,3,1,3,0,1,0,76.14,62.29 ,33.33
03,001,02,008,0494,0,2507,52,2559,4257,0,3,1,3,0,1,0,76.14,60.11 ,33.33
03,001,02,008,0495,0,1121,19,1140,1784,0,3,1,3,0,1,0,76.14,63.90 ,33.33
03,001,02,008,0496,0,2950,51,3001,4654,0,3,1,3,0,1,0,76.14,64.48 ,33.33
03,001,02,008,0497,0,2234,42,2276,3560,0,3,1,3,0,1,0,76.14,63.93 ,33.33
03,001,02,008,0498,0,2282,32,2314,3609,0,3,1,3,0,1,0,76.14,64.12 ,33.33
03,001,02,008,0499,0,1659,33,1692,2605,0,3,1,3,0,1,0,76.14,64.95 ,33.33
03,001,02,008,0500,0,1551,15,1566,2359,0,3,1,3,0,1,0,76.14,66.38 ,33.33
03,001,02,008,0501,0,1120,15,1135,1784,0,3,1,3,0,1,0,76.14,63.62 ,33.33
03,001,02,008,0502,0,1257,15,1272,1874,0,3,1,3,0,1,0,76.14,67.88 ,33.33
03,001,02,008,0503,0,3104,59,3163,4768,0,3,1,3,0,1,0,76.14,66.34 ,33.33
03,001,02,008,0504,0,2583,44,2627,4063,0,3,1,3,0,1,0,76.14,64.66 ,33.33
03,001,02,009,0505,0,2446,39,2485,3665,0,3,1,3,0,1,0,76.14,67.80 ,33.33
03,001,02,009,0506,0,759,14,773,1108,0,3,1,3,0,1,0,76.14,69.77 ,33.33
03,001,02,009,0507,0,1446,23,1469,2246,0,3,1,3,0,1,0,76.14,65.41 ,33.33
03,001,02,009,0508,0,1595,32,1627,2491,0,3,1,3,0,1,0,76.14,65.32 ,33.33
03,001,02,009,0509,0,844,9,853,1246,0,3,1,3,0,1,0,76.14,68.46 ,33.33
03,001,02,009,0510,0,1386,35,1421,2159,0,3,1,3,0,1,0,76.14,65.82 ,33.33
03,001,02,009,0511,0,2460,31,2491,3752,0,3,1,3,0,1,0,76.14,66.39 ,33.33
03,001,02,009,0512,0,1796,36,1832,2907,0,3,1,3,0,1,0,76.14,63.02 ,33.33
03,001,02,009,0513,0,1489,28,1517,2256,0,3,1,3,0,1,0,76.14,67.24 ,33.33
03,001,02,009,0514,0,1685,23,1708,2502,0,3,1,3,0,1,0,76.14,68.27 ,33.33
03,001,02,009,0515,0,1498,28,1526,2211,0,3,1,3,0,1,0,76.14,69.02 ,33.33
03,001,02,009,0516,0,793,11,804,1158,0,3,1,3,0,1,0,76.14,69.43 ,33.33
03,001,02,009,0517,0,1892,35,1927,2849,0,3,1,3,0,1,0,76.14,67.64 ,33.33
03,001,02,009,0518,0,1476,15,1491,2132,0,3,1,3,0,1,0,76.14,69.93 ,33.33
03,001,02,009,0519,0,2225,25,2250,3278,0,3,1,3,0,1,0,76.14,68.64 ,33.33
03,001,02,009,0520,0,3209,43,3252,4885,0,3,1,3,0,1,0,76.14,66.57 ,33.33
03,001,02,009,0521,0,2585,36,2621,3887,0,3,1,3,0,1,0,76.14,67.43 ,33.33
03,001,02,009,0522,0,1369,15,1384,1864,0,3,1,3,0,1,0,76.14,74.25 ,33.33
03,001,02,009,0523,0,389,7,396,545,0,3,1,3,0,1,0,76.14,72.66 ,33.33
03,001,02,010,0524,0,632,7,639,853,0,3,1,3,0,1,0,76.14,74.91 ,33.33
03,001,02,010,0525,0,1544,33,1577,2152,0,3,1,3,0,1,0,76.14,73.28 ,33.33
03,001,02,010,0526,0,2994,41,3035,4482,0,3,1,3,0,1,0,76.14,67.72 ,33.33
03,001,02,010,0527,0,2660,59,2719,3890,0,3,1,3,0,1,0,76.14,69.90 ,33.33
03,001,02,010,0528,0,1733,31,1764,2507,0,3,1,3,0,1,0,76.14,70.36 ,33.33
03,001,02,010,0529,0,1875,25,1900,2709,0,3,1,3,0,1,0,76.14,70.14 ,33.33
03,001,02,010,0530,0,1417,14,1431,1887,0,3,1,3,0,1,0,76.14,75.83 ,33.33
03,001,02,010,0531,0,2064,30,2094,3009,0,3,1,3,0,1,0,76.14,69.59 ,33.33
03,001,02,010,0532,0,2634,54,2688,3945,0,3,1,3,0,1,0,76.14,68.14 ,33.33
03,001,02,010,0533,0,1943,26,1969,2809,0,3,1,3,0,1,0,76.14,70.10 ,33.33
03,001,02,010,0534,0,1197,15,1212,1773,0,3,1,3,0,1,0,76.14,68.36 ,33.33
03,001,02,010,0535,0,1815,36,1851,2616,0,3,1,3,0,1,0,76.14,70.76 ,33.33
03,001,02,010,0536,0,1947,27,1974,2885,0,3,1,3,0,1,0,76.14,68.42 ,33.33
03,001,02,010,0537,0,1971,33,2004,2743,0,3,1,3,0,1,0,76.14,73.06 ,33.33
03,001,02,010,0538,0,2517,31,2548,3835,0,3,1,3,0,1,0,76.14,66.44 ,33.33
03,001,02,011,0539,0,2278,28,2306,3373,0,3,1,3,0,1,0,76.14,68.37 ,33.33
03,001,02,011,0540,0,2241,38,2279,3452,0,3,1,3,0,1,0,76.14,66.02 ,33.33
03,001,02,011,0541,0,2171,34,2205,3144,0,3,1,3,0,1,0,76.14,70.13 ,33.33
03,001,02,011,0542,0,2148,31,2179,3106,0,3,1,3,0,1,0,76.14,70.15 ,33.33
03,001,02,011,0543,0,1612,23,1635,2291,0,3,1,3,0,1,0,76.14,71.37 ,33.33
03,001,02,011,0544,0,806,17,823,1057,0,3,1,3,0,1,0,76.14,77.86 ,33.33
03,001,02,011,0545,0,851,10,861,1227,0,3,1,3,0,1,0,76.14,70.17 ,33.33
03,001,02,011,0546,0,4449,56,4505,6790,0,3,1,3,0,1,0,76.14,66.35 ,33.33
03,001,02,011,0547,0,4001,52,4053,6060,0,3,1,3,0,1,0,76.14,66.88 ,33.33
03,001,02,011,0548,0,605,13,618,943,0,3,1,3,0,1,0,76.14,65.54 ,33.33
03,001,02,011,0549,0,626,16,642,897,0,3,1,3,0,1,0,76.14,71.57 ,33.33
03,001,02,011,0550,0,475,8,483,644,0,3,1,3,0,1,0,76.14,75.00 ,33.33
03,001,02,011,0551,0,280,4,284,428,0,3,1,3,0,1,0,76.14,66.36 ,33.33
03,001,02,011,0552,0,518,6,524,750,0,3,1,3,0,1,0,76.14,69.87 ,33.33
03,001,02,012,0553,0,426,4,430,571,0,3,1,3,0,1,0,76.14,75.31 ,33.33
03,001,02,012,0554,0,677,16,693,968,0,3,1,3,0,1,0,76.14,71.59 ,33.33
03,001,02,012,0555,0,859,19,878,1288,0,3,1,3,0,1,0,76.14,68.17 ,33.33
03,001,02,012,0556,0,916,9,925,1368,0,3,1,3,0,1,0,76.14,67.62 ,33.33
03,001,02,012,0557,0,459,1,460,760,0,3,1,3,0,1,0,76.14,60.53 ,33.33
03,001,02,012,0558,0,1309,21,1330,2140,0,3,1,3,0,1,0,76.14,62.15 ,33.33
03,001,02,012,0559,0,539,13,552,788,0,3,1,3,0,1,0,76.14,70.05 ,33.33
03,001,02,012,0560,0,1158,28,1186,1781,0,3,1,3,0,1,0,76.14,66.59 ,33.33
03,001,02,012,0561,0,662,15,677,966,0,3,1,3,0,1,0,76.14,70.08 ,33.33
03,001,02,012,0562,0,487,16,503,742,0,3,1,3,0,1,0,76.14,67.79 ,33.33
03,001,02,012,0563,0,608,13,621,976,0,3,1,3,0,1,0,76.14,63.63 ,33.33
03,001,02,012,0564,0,3006,33,3039,4684,0,3,1,3,0,1,0,76.14,64.88 ,33.33
03,001,02,012,0565,0,3997,60,4057,6294,0,3,1,3,0,1,0,76.14,64.46 ,33.33
03,001,02,012,0566,0,2576,54,2630,4013,0,3,1,3,0,1,0,76.14,65.54 ,33.33
03,001,02,012,0567,0,866,13,879,1330,0,3,1,3,0,1,0,76.14,66.09 ,33.33
03,001,02,012,0568,0,1611,27,1638,2646,0,3,1,3,0,1,0,76.14,61.90 ,33.33
03,001,02,012,0569,0,628,6,634,923,0,3,1,3,0,1,0,76.14,68.69 ,33.33
03,001,02,012,0570,0,725,12,737,1067,0,3,1,3,0,1,0,76.14,69.07 ,33.33
03,001,02,012,0571,0,7868,138,8006,12482,0,3,1,3,0,1,0,76.14,64.14 ,33.33
03,001,02,012,0572,0,5293,99,5392,8275,0,3,1,3,0,1,0,76.14,65.16 ,33.33
03,001,02,012,0573,0,1048,21,1069,1578,0,3,1,3,0,1,0,76.14,67.74 ,33.33
03,001,02,012,0574,0,5964,126,6090,9359,0,3,1,3,0,1,0,76.14,65.07 ,33.33
03,001,02,012,0575,0,2424,47,2471,3557,0,3,1,3,0,1,0,76.14,69.47 ,33.33
03,001,02,012,0576,0,1015,19,1034,1543,0,3,1,3,0,1,0,76.14,67.01 ,33.33
03,001,02,012,0577,0,685,14,699,1017,0,3,1,3,0,1,0,76.14,68.73 ,33.33
03,001,02,012,0578,0,604,8,612,846,0,3,1,3,0,1,0,76.14,72.34 ,33.33
03,001,02,012,0579,0,861,10,871,1350,0,3,1,3,0,1,0,76.14,64.52 ,33.33
03,001,02,012,0580,0,504,14,518,723,0,3,1,3,0,1,0,76.14,71.65 ,33.33
03,001,02,012,0581,0,511,5,516,727,0,3,1,3,0,1,0,76.14,70.98 ,33.33
03,001,02,012,0582,0,317,3,320,476,0,3,1,3,0,1,0,76.14,67.23 ,33.33
03,001,02,012,0583,0,835,9,844,1281,0,3,1,3,0,1,0,76.14,65.89 ,33.33
03,001,02,012,0584,0,2271,48,2319,3417,0,3,1,3,0,1,0,76.14,67.87 ,33.33
03,001,02,012,0585,0,2875,57,2932,4442,0,3,1,3,0,1,0,76.14,66.01 ,33.33
03,001,02,013,0586,0,2639,51,2690,3947,0,3,1,3,0,1,0,76.14,68.15 ,33.33
03,001,02,013,0587,0,1431,23,1454,2170,0,3,1,3,0,1,0,76.14,67.00 ,33.33
03,001,02,013,0588,0,992,21,1013,1374,0,3,1,3,0,1,0,76.14,73.73 ,33.33
03,001,02,013,0589,0,1430,28,1458,2197,0,3,1,3,0,1,0,76.14,66.36 ,33.33
03,001,02,013,0590,0,708,18,726,1034,0,3,1,3,0,1,0,76.14,70.21 ,33.33
03,001,02,013,0591,0,2387,37,2424,3817,0,3,1,3,0,1,0,76.14,63.51 ,33.33
03,001,02,013,0592,0,1576,31,1607,2334,0,3,1,3,0,1,0,76.14,68.85 ,33.33
03,001,02,013,0593,0,852,13,865,1222,0,3,1,3,0,1,0,76.14,70.79 ,33.33
03,001,02,013,0594,0,777,11,788,997,0,3,1,3,0,1,0,76.14,79.04 ,33.33
03,001,02,013,0595,0,814,15,829,1059,0,3,1,3,0,1,0,76.14,78.28 ,33.33
03,001,02,014,0596,0,270,6,276,369,0,3,1,3,0,1,0,76.14,74.80 ,33.33
03,001,02,014,0597,0,2310,43,2353,3440,0,3,1,3,0,1,0,76.14,68.40 ,33.33
03,001,02,014,0598,0,603,10,613,882,0,3,1,3,0,1,0,76.14,69.50 ,33.33
03,001,02,014,0599,0,521,12,533,804,0,3,1,3,0,1,0,76.14,66.29 ,33.33
03,001,02,014,0600,0,2936,43,2979,4672,0,3,1,3,0,1,0,76.14,63.76 ,33.33
03,001,02,014,0601,0,288,4,292,428,0,3,1,3,0,1,0,76.14,68.22 ,33.33
03,001,02,014,0602,0,370,8,378,552,0,3,1,3,0,1,0,76.14,68.48 ,33.33
03,001,02,014,0603,0,506,7,513,760,0,3,1,3,0,1,0,76.14,67.50 ,33.33
03,001,02,014,0604,0,908,16,924,1463,0,3,1,3,0,1,0,76.14,63.16 ,33.33
03,001,02,014,0605,0,424,10,434,627,0,3,1,3,0,1,0,76.14,69.22 ,33.33
03,001,02,014,0606,0,308,7,315,492,0,3,1,3,0,1,0,76.14,64.02 ,33.33
03,001,02,014,0607,0,443,6,449,628,0,3,1,3,0,1,0,76.14,71.50 ,33.33
03,001,02,014,0608,0,688,9,697,1108,0,3,1,3,0,1,0,76.14,62.91 ,33.33
03,001,02,015,0609,0,574,6,580,836,0,3,1,3,0,1,0,76.14,69.38 ,33.33
03,001,02,015,0610,0,719,7,726,1021,0,3,1,3,0,1,0,76.14,71.11 ,33.33
03,001,02,015,0611,0,1123,16,1139,1717,0,3,1,3,0,1,0,76.14,66.34 ,33.33
03,001,02,015,0612,0,479,5,484,700,0,3,1,3,0,1,0,76.14,69.14 ,33.33
03,001,02,015,0613,0,780,5,785,1162,0,3,1,3,0,1,0,76.14,67.56 ,33.33
03,001,02,015,0614,0,780,10,790,1206,0,3,1,3,0,1,0,76.14,65.51 ,33.33
03,001,02,015,0615,0,206,0,206,324,0,3,1,3,0,1,0,76.14,63.58 ,33.33
03,001,02,015,0616,0,331,4,335,489,0,3,1,3,0,1,0,76.14,68.51 ,33.33
03,001,02,015,0617,0,458,1,459,727,0,3,1,3,0,1,0,76.14,63.14 ,33.33
03,001,02,016,0618,0,287,6,293,418,0,3,1,3,0,1,0,76.14,70.10 ,33.33
03,001,02,016,0619,0,432,6,438,626,0,3,1,3,0,1,0,76.14,69.97 ,33.33
03,001,02,016,0620,0,315,4,319,459,0,3,1,3,0,1,0,76.14,69.50 ,33.33
03,001,02,016,0621,0,917,18,935,1525,0,3,1,3,0,1,0,76.14,61.31 ,33.33
03,001,02,016,0622,0,4110,41,4151,6356,0,3,1,3,0,1,0,76.14,65.31 ,33.33
03,001,02,016,0623,0,957,17,974,1426,0,3,1,3,0,1,0,76.14,68.30 ,33.33
03,001,02,016,0624,0,569,4,573,882,0,3,1,3,0,1,0,76.14,64.97 ,33.33
03,001,02,016,0625,0,243,6,249,385,0,3,1,3,0,1,0,76.14,64.68 ,33.33
03,001,02,016,0626,0,377,1,378,533,0,3,1,3,0,1,0,76.14,70.92 ,33.33
03,001,02,016,0627,0,398,13,411,587,0,3,1,3,0,1,0,76.14,70.02 ,33.33
03,001,02,016,0628,0,501,6,507,798,0,3,1,3,0,1,0,76.14,63.53 ,33.33
03,001,02,016,0629,0,162,0,162,234,0,3,1,3,0,1,0,76.14,69.23 ,33.33
03,001,02,016,0630,0,310,4,314,451,0,3,1,3,0,1,0,76.14,69.62 ,33.33
03,001,02,016,0631,0,308,3,311,553,0,3,1,3,0,1,0,76.14,56.24 ,33.33
03,001,02,017,0632,0,2002,28,2030,2966,0,3,1,3,0,1,0,76.14,68.44 ,33.33
03,001,02,017,0633,0,1098,26,1124,1915,0,3,1,3,0,1,0,76.14,58.69 ,33.33
03,001,02,017,0634,0,915,31,946,1609,0,3,1,3,0,1,0,76.14,58.79 ,33.33
03,001,02,017,0635,0,1377,19,1396,2246,0,3,1,3,0,1,0,76.14,62.15 ,33.33
03,001,02,017,0636,0,1392,18,1410,2120,0,3,1,3,0,1,0,76.14,66.51 ,33.33
03,001,02,017,0637,0,313,1,314,465,0,3,1,3,0,1,0,76.14,67.53 ,33.33
03,001,02,017,0638,0,488,8,496,774,0,3,1,3,0,1,0,76.14,64.08 ,33.33
03,001,02,017,0639,0,335,6,341,527,0,3,1,3,0,1,0,76.14,64.71 ,33.33
03,001,02,017,0640,0,365,7,372,560,0,3,1,3,0,1,0,76.14,66.43 ,33.33
03,001,02,017,0641,0,517,4,521,782,0,3,1,3,0,1,0,76.14,66.62 ,33.33
03,001,03,018,0642,0,2403,50,2453,3718,0,3,1,3,0,1,0,76.14,65.98 ,33.33
03,001,03,018,0643,0,859,11,870,1206,0,3,1,3,0,1,0,76.14,72.14 ,33.33
03,001,03,018,0644,0,3281,36,3317,4674,0,3,1,3,0,1,0,76.14,70.97 ,33.33
03,001,03,018,0645,0,2572,48,2620,3668,0,3,1,3,0,1,0,76.14,71.43 ,33.33
03,001,03,018,0646,0,1442,21,1463,2125,0,3,1,3,0,1,0,76.14,68.85 ,33.33
03,001,03,018,0647,0,2431,28,2459,3482,0,3,1,3,0,1,0,76.14,70.62 ,33.33
03,001,03,018,0648,0,1893,25,1918,2786,0,3,1,3,0,1,0,76.14,68.84 ,33.33
03,001,03,018,0649,0,1917,29,1946,2916,0,3,1,3,0,1,0,76.14,66.74 ,33.33
03,001,03,018,0650,0,2555,30,2585,3724,0,3,1,3,0,1,0,76.14,69.41 ,33.33
03,001,03,018,0651,0,2250,37,2287,3333,0,3,1,3,0,1,0,76.14,68.62 ,33.33
03,001,03,018,0652,0,2375,54,2429,3402,0,3,1,3,0,1,0,76.14,71.40 ,33.33
03,001,03,018,0653,0,2722,33,2755,3777,0,3,1,3,0,1,0,76.14,72.94 ,33.33
03,001,03,018,0654,0,2561,24,2585,3675,0,3,1,3,0,1,0,76.14,70.34 ,33.33
03,001,03,018,0655,0,2551,40,2591,3767,0,3,1,3,0,1,0,76.14,68.78 ,33.33
03,001,03,018,0656,0,2189,27,2216,3169,0,3,1,3,0,1,0,76.14,69.93 ,33.33
03,001,03,018,0657,0,2783,32,2815,3963,0,3,1,3,0,1,0,76.14,71.03 ,33.33
03,001,03,018,0658,0,3958,46,4004,5725,0,3,1,3,0,1,0,76.14,69.94 ,33.33
03,001,03,018,0659,0,2376,21,2397,3391,0,3,1,3,0,1,0,76.14,70.69 ,33.33
03,001,03,018,0660,0,3536,42,3578,5374,0,3,1,3,0,1,0,76.14,66.58 ,33.33
03,001,03,018,0661,0,2402,33,2435,3556,0,3,1,3,0,1,0,76.14,68.48 ,33.33
03,001,03,018,0662,0,2373,44,2417,3438,0,3,1,3,0,1,0,76.14,70.30 ,33.33
03,001,03,018,0663,0,2224,55,2279,3275,0,3,1,3,0,1,0,76.14,69.59 ,33.33
03,001,03,018,0664,0,1312,27,1339,1871,0,3,1,3,0,1,0,76.14,71.57 ,33.33
03,001,03,018,0665,0,2341,27,2368,3234,0,3,1,3,0,1,0,76.14,73.22 ,33.33
03,001,03,018,0666,0,1654,23,1677,2459,0,3,1,3,0,1,0,76.14,68.20 ,33.33
03,001,03,018,0667,0,1194,11,1205,1615,0,3,1,3,0,1,0,76.14,74.61 ,33.33
03,001,03,018,0668,0,2111,29,2140,2899,0,3,1,3,0,1,0,76.14,73.82 ,33.33
03,001,03,018,0669,0,1794,27,1821,2469,0,3,1,3,0,1,0,76.14,73.75 ,33.33
03,001,03,018,0670,0,2425,24,2449,3429,0,3,1,3,0,1,0,76.14,71.42 ,33.33
03,001,03,018,0671,0,2869,36,2905,4004,0,3,1,3,0,1,0,76.14,72.55 ,33.33
03,001,03,018,0672,0,2459,25,2484,3389,0,3,1,3,0,1,0,76.14,73.30 ,33.33
03,001,03,018,0673,0,2302,28,2330,3314,0,3,1,3,0,1,0,76.14,70.31 ,33.33
03,001,03,018,0674,0,2417,40,2457,3534,0,3,1,3,0,1,0,76.14,69.52 ,33.33
03,001,03,018,0675,0,1972,24,1996,2830,0,3,1,3,0,1,0,76.14,70.53 ,33.33
03,001,03,018,0676,0,1558,26,1584,2236,0,3,1,3,0,1,0,76.14,70.84 ,33.33
03,001,03,018,0677,0,2849,29,2878,3936,0,3,1,3,0,1,0,76.14,73.12 ,33.33
03,001,03,018,0678,0,3477,41,3518,4993,0,3,1,3,0,1,0,76.14,70.46 ,33.33
03,001,03,018,0679,0,2505,23,2528,3644,0,3,1,3,0,1,0,76.14,69.37 ,33.33
03,001,03,018,0680,0,2255,24,2279,3224,0,3,1,3,0,1,0,76.14,70.69 ,33.33
03,001,03,018,0681,0,1520,18,1538,2203,0,3,1,3,0,1,0,76.14,69.81 ,33.33
03,001,03,018,0682,0,2327,36,2363,3373,0,3,1,3,0,1,0,76.14,70.06 ,33.33
03,001,03,018,0683,0,1604,23,1627,2313,0,3,1,3,0,1,0,76.14,70.34 ,33.33
03,001,03,018,0684,0,2108,49,2157,3137,0,3,1,3,0,1,0,76.14,68.76 ,33.33
03,001,03,018,0685,0,1770,20,1790,2488,0,3,1,3,0,1,0,76.14,71.95 ,33.33
03,001,03,018,0686,0,3205,38,3243,4886,0,3,1,3,0,1,0,76.14,66.37 ,33.33
03,001,03,018,0687,0,2822,46,2868,3911,0,3,1,3,0,1,0,76.14,73.33 ,33.33
03,001,03,018,0688,0,2184,38,2222,3136,0,3,1,3,0,1,0,76.14,70.85 ,33.33
03,001,03,018,0689,0,2891,49,2940,4330,0,3,1,3,0,1,0,76.14,67.90 ,33.33
03,001,03,018,0690,0,2145,25,2170,3031,0,3,1,3,0,1,0,76.14,71.59 ,33.33
03,001,03,018,0691,0,2036,38,2074,2938,0,3,1,3,0,1,0,76.14,70.59 ,33.33
03,001,03,018,0692,0,1923,32,1955,2705,0,3,1,3,0,1,0,76.14,72.27 ,33.33
03,001,03,018,0693,0,1340,31,1371,1930,0,3,1,3,0,1,0,76.14,71.04 ,33.33
03,001,03,018,0694,0,225,5,230,303,0,3,1,3,0,1,0,76.14,75.91 ,33.33
03,001,03,018,0695,0,2917,48,2965,4158,0,3,1,3,0,1,0,76.14,71.31 ,33.33
03,001,03,018,0696,0,1594,23,1617,2253,0,3,1,3,0,1,0,76.14,71.77 ,33.33
03,001,03,018,0697,0,2122,37,2159,3154,0,3,1,3,0,1,0,76.14,68.45 ,33.33
03,001,03,018,0698,0,2198,19,2217,3157,0,3,1,3,0,1,0,76.14,70.22 ,33.33
03,001,03,018,0699,0,2673,32,2705,3754,0,3,1,3,0,1,0,76.14,72.06 ,33.33
03,001,03,018,0700,0,1373,20,1393,1986,0,3,1,3,0,1,0,76.14,70.14 ,33.33
03,001,03,018,0701,0,3136,43,3179,4566,0,3,1,3,0,1,0,76.14,69.62 ,33.33
03,001,03,018,0702,0,2243,36,2279,3285,0,3,1,3,0,1,0,76.14,69.38 ,33.33
03,001,03,018,0703,0,2363,39,2402,3493,0,3,1,3,0,1,0,76.14,68.77 ,33.33
03,001,03,018,0704,0,2100,32,2132,3018,0,3,1,3,0,1,0,76.14,70.64 ,33.33
03,001,03,018,0705,0,2866,42,2908,4245,0,3,1,3,0,1,0,76.14,68.50 ,33.33
03,001,03,018,0706,0,2962,31,2993,4119,0,3,1,3,0,1,0,76.14,72.66 ,33.33
03,001,03,018,0707,0,1803,27,1830,2529,0,3,1,3,0,1,0,76.14,72.36 ,33.33
03,001,03,018,0708,0,2256,27,2283,3231,0,3,1,3,0,1,0,76.14,70.66 ,33.33
03,001,03,018,0709,0,1984,29,2013,2882,0,3,1,3,0,1,0,76.14,69.85 ,33.33
03,001,03,018,0710,0,965,9,974,1393,0,3,1,3,0,1,0,76.14,69.92 ,33.33
03,001,03,018,0711,0,2062,39,2101,2982,0,3,1,3,0,1,0,76.14,70.46 ,33.33
03,001,03,018,0712,0,325,5,330,500,0,3,1,3,0,1,0,76.14,66.00 ,33.33
03,001,03,018,0713,0,3005,50,3055,4354,0,3,1,3,0,1,0,76.14,70.17 ,33.33
03,001,03,018,0714,0,1581,28,1609,2141,0,3,1,3,0,1,0,76.14,75.15 ,33.33
03,001,03,018,0715,0,1744,35,1779,2565,0,3,1,3,0,1,0,76.14,69.36 ,33.33
03,001,03,018,0716,0,2309,49,2358,3471,0,3,1,3,0,1,0,76.14,67.93 ,33.33
03,001,03,018,0717,0,1268,24,1292,2128,0,3,1,3,0,1,0,76.14,60.71 ,33.33
03,001,03,018,0718,0,1485,23,1508,2149,0,3,1,3,0,1,0,76.14,70.17 ,33.33
03,001,03,018,0719,0,1930,32,1962,3048,0,3,1,3,0,1,0,76.14,64.37 ,33.33
03,001,03,018,0720,0,3007,40,3047,4412,0,3,1,3,0,1,0,76.14,69.06 ,33.33
03,001,03,018,0721,0,2018,34,2052,3022,0,3,1,3,0,1,0,76.14,67.90 ,33.33
03,001,03,018,0722,0,2469,34,2503,3634,0,3,1,3,0,1,0,76.14,68.88 ,33.33
03,001,03,018,0723,0,1967,35,2002,2946,0,3,1,3,0,1,0,76.14,67.96 ,33.33
03,001,03,018,0724,0,1302,17,1319,1830,0,3,1,3,0,1,0,76.14,72.08 ,33.33
03,001,03,018,0725,0,1975,28,2003,2838,0,3,1,3,0,1,0,76.14,70.58 ,33.33
03,001,03,018,0726,0,2311,31,2342,3254,0,3,1,3,0,1,0,76.14,71.97 ,33.33
03,001,03,018,0727,0,1873,45,1918,2736,0,3,1,3,0,1,0,76.14,70.10 ,33.33
03,001,03,018,0728,0,2550,32,2582,3854,0,3,1,3,0,1,0,76.14,67.00 ,33.33
03,001,03,018,0729,0,2589,24,2613,3836,0,3,1,3,0,1,0,76.14,68.12 ,33.33
03,001,03,018,0730,0,2315,39,2354,3353,0,3,1,3,0,1,0,76.14,70.21 ,33.33
03,001,03,018,0731,0,2041,28,2069,3014,0,3,1,3,0,1,0,76.14,68.65 ,33.33
03,001,03,018,0732,0,1613,44,1657,2496,0,3,1,3,0,1,0,76.14,66.39 ,33.33
03,001,03,018,0733,0,1495,22,1517,2091,0,3,1,3,0,1,0,76.14,72.55 ,33.33
03,001,03,018,0734,0,2199,39,2238,3259,0,3,1,3,0,1,0,76.14,68.67 ,33.33
03,001,03,019,0735,0,1064,20,1084,1533,0,3,1,3,0,1,0,76.14,70.71 ,33.33
03,001,03,019,0736,0,705,9,714,1053,0,3,1,3,0,1,0,76.14,67.81 ,33.33
03,001,03,019,0737,0,1470,20,1490,2184,0,3,1,3,0,1,0,76.14,68.22 ,33.33
03,001,03,019,0738,0,2330,27,2357,3390,0,3,1,3,0,1,0,76.14,69.53 ,33.33
03,001,03,019,0739,0,2151,42,2193,3161,0,3,1,3,0,1,0,76.14,69.38 ,33.33
03,001,03,019,0740,0,2214,17,2231,3116,0,3,1,3,0,1,0,76.14,71.60 ,33.33
03,001,03,019,0741,0,2075,26,2101,3105,0,3,1,3,0,1,0,76.14,67.67 ,33.33
03,001,03,019,0742,0,773,17,790,1106,0,3,1,3,0,1,0,76.14,71.43 ,33.33
03,001,03,019,0743,0,1809,25,1834,2675,0,3,1,3,0,1,0,76.14,68.56 ,33.33
03,001,03,019,0744,0,1954,24,1978,2917,0,3,1,3,0,1,0,76.14,67.81 ,33.33
03,001,03,019,0745,0,1375,14,1389,2048,0,3,1,3,0,1,0,76.14,67.82 ,33.33
03,001,03,019,0746,0,2096,25,2121,3208,0,3,1,3,0,1,0,76.14,66.12 ,33.33
03,001,03,019,0747,0,1797,28,1825,2664,0,3,1,3,0,1,0,76.14,68.51 ,33.33
03,001,03,019,0748,0,2639,24,2663,3929,0,3,1,3,0,1,0,76.14,67.78 ,33.33
03,001,03,019,0749,0,2605,36,2641,3657,0,3,1,3,0,1,0,76.14,72.22 ,33.33
03,001,03,019,0750,0,2132,30,2162,3114,0,3,1,3,0,1,0,76.14,69.43 ,33.33
03,001,03,019,0751,0,1757,10,1767,2533,0,3,1,3,0,1,0,76.14,69.76 ,33.33
03,001,03,019,0752,0,1661,24,1685,2370,0,3,1,3,0,1,0,76.14,71.10 ,33.33
03,001,03,019,0753,0,2576,30,2606,3659,0,3,1,3,0,1,0,76.14,71.22 ,33.33
03,001,03,019,0754,0,2750,31,2781,3939,0,3,1,3,0,1,0,76.14,70.60 ,33.33
03,001,03,019,0755,0,2590,40,2630,3718,0,3,1,3,0,1,0,76.14,70.74 ,33.33
03,001,03,019,0756,0,2647,22,2669,3712,0,3,1,3,0,1,0,76.14,71.90 ,33.33
03,001,03,019,0757,0,2229,27,2256,3280,0,3,1,3,0,1,0,76.14,68.78 ,33.33
03,001,03,019,0758,0,1685,21,1706,2423,0,3,1,3,0,1,0,76.14,70.41 ,33.33
03,001,03,019,0759,0,2027,19,2046,2906,0,3,1,3,0,1,0,76.14,70.41 ,33.33
03,001,03,019,0760,0,1521,17,1538,2158,0,3,1,3,0,1,0,76.14,71.27 ,33.33
03,001,03,019,0761,0,1860,14,1874,2650,0,3,1,3,0,1,0,76.14,70.72 ,33.33
03,001,03,019,0762,0,2387,28,2415,3374,0,3,1,3,0,1,0,76.14,71.58 ,33.33
03,001,03,019,0763,0,1708,25,1733,2444,0,3,1,3,0,1,0,76.14,70.91 ,33.33
03,001,03,019,0764,0,1615,31,1646,2375,0,3,1,3,0,1,0,76.14,69.31 ,33.33
03,001,03,019,0765,0,2352,32,2384,3362,0,3,1,3,0,1,0,76.14,70.91 ,33.33
03,001,03,019,0766,0,1792,18,1810,2610,0,3,1,3,0,1,0,76.14,69.35 ,33.33
03,001,03,019,0767,0,2023,21,2044,2993,0,3,1,3,0,1,0,76.14,68.29 ,33.33
03,001,03,019,0768,0,2482,18,2500,3574,0,3,1,3,0,1,0,76.14,69.95 ,33.33
03,001,03,019,0769,0,2368,30,2398,3410,0,3,1,3,0,1,0,76.14,70.32 ,33.33
03,001,03,019,0770,0,2116,19,2135,3236,0,3,1,3,0,1,0,76.14,65.98 ,33.33
03,001,03,019,0771,0,1453,22,1475,2089,0,3,1,3,0,1,0,76.14,70.61 ,33.33
03,001,03,019,0772,0,2338,22,2360,3333,0,3,1,3,0,1,0,76.14,70.81 ,33.33
03,001,03,019,0773,0,1340,19,1359,1969,0,3,1,3,0,1,0,76.14,69.02 ,33.33
03,001,03,019,0774,0,2377,27,2404,3403,0,3,1,3,0,1,0,76.14,70.64 ,33.33
03,001,03,019,0775,0,1795,27,1822,2646,0,3,1,3,0,1,0,76.14,68.86 ,33.33
03,001,03,019,0776,0,2243,31,2274,3101,0,3,1,3,0,1,0,76.14,73.33 ,33.33
03,001,03,019,0777,0,2190,26,2216,3050,0,3,1,3,0,1,0,76.14,72.66 ,33.33
03,001,03,019,0778,0,1136,8,1144,1677,0,3,1,3,0,1,0,76.14,68.22 ,33.33
03,001,03,019,0779,0,2422,30,2452,3465,0,3,1,3,0,1,0,76.14,70.76 ,33.33
03,001,03,019,0780,0,2416,34,2450,3379,0,3,1,3,0,1,0,76.14,72.51 ,33.33
03,001,03,019,0781,0,2681,25,2706,3820,0,3,1,3,0,1,0,76.14,70.84 ,33.33
03,001,03,019,0782,0,3251,32,3283,4692,0,3,1,3,0,1,0,76.14,69.97 ,33.33
03,001,03,019,0783,0,2655,22,2677,3890,0,3,1,3,0,1,0,76.14,68.82 ,33.33
03,001,03,019,0784,0,2328,38,2366,3252,0,3,1,3,0,1,0,76.14,72.76 ,33.33
03,001,03,019,0785,0,702,14,716,956,0,3,1,3,0,1,0,76.14,74.90 ,33.33
03,001,03,019,0786,0,564,12,576,784,0,3,1,3,0,1,0,76.14,73.47 ,33.33
03,001,03,019,0787,0,659,5,664,922,0,3,1,3,0,1,0,76.14,72.02 ,33.33
03,001,03,019,0788,0,547,9,556,719,0,3,1,3,0,1,0,76.14,77.33 ,33.33
03,001,03,019,0789,0,1789,26,1815,2469,0,3,1,3,0,1,0,76.14,73.51 ,33.33
03,001,03,019,0790,0,1467,26,1493,2125,0,3,1,3,0,1,0,76.14,70.26 ,33.33
03,001,03,019,0791,0,1498,21,1519,2163,0,3,1,3,0,1,0,76.14,70.23 ,33.33
03,001,03,019,0792,0,1089,16,1105,1573,0,3,1,3,0,1,0,76.14,70.25 ,33.33
03,001,03,019,0793,0,1239,18,1257,1803,0,3,1,3,0,1,0,76.14,69.72 ,33.33
03,001,03,019,0794,0,1599,23,1622,2194,0,3,1,3,0,1,0,76.14,73.93 ,33.33
03,001,03,019,0795,0,1300,20,1320,1838,0,3,1,3,0,1,0,76.14,71.82 ,33.33
03,001,03,019,0796,0,1502,18,1520,2094,0,3,1,3,0,1,0,76.14,72.59 ,33.33
03,001,03,020,0797,0,988,18,1006,1456,0,3,1,3,0,1,0,76.14,69.09 ,33.33
03,001,03,020,0798,0,785,11,796,1155,0,3,1,3,0,1,0,76.14,68.92 ,33.33
03,001,03,020,0799,0,1298,12,1310,1974,0,3,1,3,0,1,0,76.14,66.36 ,33.33
03,001,03,020,0800,0,859,5,864,1306,0,3,1,3,0,1,0,76.14,66.16 ,33.33
03,001,03,020,0801,0,537,6,543,735,0,3,1,3,0,1,0,76.14,73.88 ,33.33
03,001,03,020,0802,0,1543,20,1563,2078,0,3,1,3,0,1,0,76.14,75.22 ,33.33
03,001,03,020,0803,0,2908,32,2940,4416,0,3,1,3,0,1,0,76.14,66.58 ,33.33
03,001,03,020,0804,0,2888,29,2917,4096,0,3,1,3,0,1,0,76.14,71.22 ,33.33
03,001,03,020,0805,0,1570,20,1590,2311,0,3,1,3,0,1,0,76.14,68.80 ,33.33
03,001,03,020,0806,0,3433,48,3481,5138,0,3,1,3,0,1,0,76.14,67.75 ,33.33
03,001,03,020,0807,0,3898,47,3945,5657,0,3,1,3,0,1,0,76.14,69.74 ,33.33
03,001,03,020,0808,0,1344,14,1358,1873,0,3,1,3,0,1,0,76.14,72.50 ,33.33
03,001,03,020,0809,0,2009,18,2027,2915,0,3,1,3,0,1,0,76.14,69.54 ,33.33
03,001,03,020,0810,0,1606,19,1625,2210,0,3,1,3,0,1,0,76.14,73.53 ,33.33
03,001,03,020,0811,0,3825,43,3868,5567,0,3,1,3,0,1,0,76.14,69.48 ,33.33
03,001,03,020,0812,0,2203,22,2225,3177,0,3,1,3,0,1,0,76.14,70.03 ,33.33
03,001,03,020,0813,0,1495,15,1510,2123,0,3,1,3,0,1,0,76.14,71.13 ,33.33
03,001,03,020,0814,0,1724,27,1751,2534,0,3,1,3,0,1,0,76.14,69.10 ,33.33
03,001,03,020,0815,0,2357,36,2393,3390,0,3,1,3,0,1,0,76.14,70.59 ,33.33
03,001,03,020,0816,0,1849,12,1861,2619,0,3,1,3,0,1,0,76.14,71.06 ,33.33
03,001,03,020,0817,0,2225,24,2249,3210,0,3,1,3,0,1,0,76.14,70.06 ,33.33
03,001,03,020,0818,0,1811,21,1832,2497,0,3,1,3,0,1,0,76.14,73.37 ,33.33
03,001,03,020,0819,0,2257,25,2282,3212,0,3,1,3,0,1,0,76.14,71.05 ,33.33
03,001,03,020,0820,0,995,10,1005,1493,0,3,1,3,0,1,0,76.14,67.31 ,33.33
03,001,03,020,0821,0,566,14,580,804,0,3,1,3,0,1,0,76.14,72.14 ,33.33
03,001,03,020,0822,0,2211,13,2224,3150,0,3,1,3,0,1,0,76.14,70.60 ,33.33
03,001,03,020,0823,0,1355,21,1376,1978,0,3,1,3,0,1,0,76.14,69.57 ,33.33
03,001,03,020,0824,0,2464,28,2492,3517,0,3,1,3,0,1,0,76.14,70.86 ,33.33
03,001,03,020,0825,0,2158,12,2170,3055,0,3,1,3,0,1,0,76.14,71.03 ,33.33
03,001,03,020,0826,0,2250,26,2276,3116,0,3,1,3,0,1,0,76.14,73.04 ,33.33
03,001,03,020,0827,0,2372,19,2391,3478,0,3,1,3,0,1,0,76.14,68.75 ,33.33
03,001,03,020,0828,0,1900,19,1919,2932,0,3,1,3,0,1,0,76.14,65.45 ,33.33
03,001,03,020,0829,0,2403,28,2431,3519,0,3,1,3,0,1,0,76.14,69.08 ,33.33
03,001,03,020,0830,0,2597,37,2634,3801,0,3,1,3,0,1,0,76.14,69.30 ,33.33
03,001,03,020,0831,0,3042,34,3076,4497,0,3,1,3,0,1,0,76.14,68.40 ,33.33
03,001,03,020,0832,0,3389,43,3432,4994,0,3,1,3,0,1,0,76.14,68.72 ,33.33
03,001,03,020,0833,0,1743,24,1767,2542,0,3,1,3,0,1,0,76.14,69.51 ,33.33
03,001,03,020,0834,0,1093,10,1103,1389,0,3,1,3,0,1,0,76.14,79.41 ,33.33
03,001,03,020,0835,0,1581,40,1621,2332,0,3,1,3,0,1,0,76.14,69.51 ,33.33
03,001,03,020,0836,0,1435,23,1458,2075,0,3,1,3,0,1,0,76.14,70.27 ,33.33
03,001,03,020,0837,0,859,13,872,1327,0,3,1,3,0,1,0,76.14,65.71 ,33.33
03,001,03,020,0838,0,1182,29,1211,1710,0,3,1,3,0,1,0,76.14,70.82 ,33.33
03,001,03,020,0839,0,3866,59,3925,5711,0,3,1,3,0,1,0,76.14,68.73 ,33.33
03,001,03,020,0840,0,2713,28,2741,3985,0,3,1,3,0,1,0,76.14,68.78 ,33.33
03,001,03,020,0841,0,2611,51,2662,3857,0,3,1,3,0,1,0,76.14,69.02 ,33.33
03,001,03,020,0842,0,2173,22,2195,3077,0,3,1,3,0,1,0,76.14,71.34 ,33.33
03,001,03,020,0843,0,2541,24,2565,3720,0,3,1,3,0,1,0,76.14,68.95 ,33.33
03,001,03,020,0844,0,4043,53,4096,5933,0,3,1,3,0,1,0,76.14,69.04 ,33.33
03,001,03,020,0845,0,2096,20,2116,3007,0,3,1,3,0,1,0,76.14,70.37 ,33.33
03,001,03,020,0846,0,4464,56,4520,6546,0,3,1,3,0,1,0,76.14,69.05 ,33.33
03,001,03,020,0847,0,1635,9,1644,2343,0,3,1,3,0,1,0,76.14,70.17 ,33.33
03,001,03,020,0848,0,2008,17,2025,2740,0,3,1,3,0,1,0,76.14,73.91 ,33.33
03,001,03,020,0849,0,3030,40,3070,4488,0,3,1,3,0,1,0,76.14,68.40 ,33.33
03,001,03,020,0850,0,2771,33,2804,4336,0,3,1,3,0,1,0,76.14,64.67 ,33.33
03,001,03,020,0851,0,2774,32,2806,4115,0,3,1,3,0,1,0,76.14,68.19 ,33.33
03,001,03,020,0852,0,2938,33,2971,4129,0,3,1,3,0,1,0,76.14,71.95 ,33.33
03,001,03,020,0853,0,2228,26,2254,3242,0,3,1,3,0,1,0,76.14,69.52 ,33.33
03,001,03,020,0854,0,1121,10,1131,1701,0,3,1,3,0,1,0,76.14,66.49 ,33.33
03,001,03,020,0855,0,2256,29,2285,3327,0,3,1,3,0,1,0,76.14,68.68 ,33.33
03,001,03,020,0856,0,2668,29,2697,3868,0,3,1,3,0,1,0,76.14,69.73 ,33.33
03,001,03,020,0857,0,730,7,737,1036,0,3,1,3,0,1,0,76.14,71.14 ,33.33
03,001,03,020,0858,0,887,21,908,1405,0,3,1,3,0,1,0,76.14,64.63 ,33.33
03,001,03,020,0859,0,482,5,487,787,0,3,1,3,0,1,0,76.14,61.88 ,33.33
03,001,03,020,0860,0,1372,18,1390,2067,0,3,1,3,0,1,0,76.14,67.25 ,33.33
03,001,03,020,0861,0,1474,32,1506,2213,0,3,1,3,0,1,0,76.14,68.05 ,33.33
03,001,03,020,0862,0,845,8,853,1346,0,3,1,3,0,1,0,76.14,63.37 ,33.33
03,001,03,020,0863,0,721,16,737,1054,0,3,1,3,0,1,0,76.14,69.92 ,33.33
03,001,03,020,0864,0,473,6,479,709,0,3,1,3,0,1,0,76.14,67.56 ,33.33
03,001,03,021,0865,0,572,13,585,917,0,3,1,3,0,1,0,76.14,63.79 ,33.33
03,001,03,021,0866,0,1748,38,1786,2729,0,3,1,3,0,1,0,76.14,65.45 ,33.33
03,001,03,021,0867,0,1260,20,1280,1868,0,3,1,3,0,1,0,76.14,68.52 ,33.33
03,001,03,021,0868,0,930,14,944,1422,0,3,1,3,0,1,0,76.14,66.39 ,33.33
03,001,03,021,0869,0,1514,18,1532,2309,0,3,1,3,0,1,0,76.14,66.35 ,33.33
03,001,03,021,0870,0,2288,29,2317,3482,0,3,1,3,0,1,0,76.14,66.54 ,33.33
03,001,03,021,0871,0,979,13,992,1454,0,3,1,3,0,1,0,76.14,68.23 ,33.33
03,001,03,021,0872,0,299,6,305,455,0,3,1,3,0,1,0,76.14,67.03 ,33.33
03,001,03,022,0873,0,292,3,295,398,0,3,1,3,0,1,0,76.14,74.12 ,33.33
03,001,03,022,0874,0,425,9,434,663,0,3,1,3,0,1,0,76.14,65.46 ,33.33
03,001,03,022,0875,0,413,6,419,591,0,3,1,3,0,1,0,76.14,70.90 ,33.33
03,001,03,022,0876,0,173,1,174,274,0,3,1,3,0,1,0,76.14,63.50 ,33.33
03,001,03,022,0877,0,285,5,290,411,0,3,1,3,0,1,0,76.14,70.56 ,33.33
03,001,03,022,0878,0,456,6,462,713,0,3,1,3,0,1,0,76.14,64.80 ,33.33
03,001,03,022,0879,0,146,1,147,223,0,3,1,3,0,1,0,76.14,65.92 ,33.33
03,001,03,022,0880,0,517,8,525,759,0,3,1,3,0,1,0,76.14,69.17 ,33.33
03,001,03,022,0881,0,388,6,394,597,0,3,1,3,0,1,0,76.14,66.00 ,33.33
03,001,03,022,0882,0,160,3,163,238,0,3,1,3,0,1,0,76.14,68.49 ,33.33
03,001,03,022,0883,0,259,4,263,416,0,3,1,3,0,1,0,76.14,63.22 ,33.33
03,001,03,022,0884,0,432,12,444,621,0,3,1,3,0,1,0,76.14,71.50 ,33.33
03,001,03,023,0885,0,673,12,685,997,0,3,1,3,0,1,0,76.14,68.71 ,33.33
03,001,03,023,0886,0,232,5,237,357,0,3,1,3,0,1,0,76.14,66.39 ,33.33
03,001,03,023,0887,0,344,8,352,557,0,3,1,3,0,1,0,76.14,63.20 ,33.33
03,001,03,023,0888,0,520,3,523,886,0,3,1,3,0,1,0,76.14,59.03 ,33.33
03,001,03,023,0889,0,458,4,462,727,0,3,1,3,0,1,0,76.14,63.55 ,33.33
03,001,03,023,0890,0,478,9,487,685,0,3,1,3,0,1,0,76.14,71.09 ,33.33
03,001,03,023,0891,0,422,3,425,676,0,3,1,3,0,1,0,76.14,62.87 ,33.33
03,001,03,024,0892,0,360,4,364,530,0,3,1,3,0,1,0,76.14,68.68 ,33.33
03,001,03,024,0893,0,697,6,703,1024,0,3,1,3,0,1,0,76.14,68.65 ,33.33
03,001,03,024,0894,0,89,1,90,110,0,3,1,3,0,1,0,76.14,81.82 ,33.33
03,001,03,024,0895,0,123,0,123,184,0,3,1,3,0,1,0,76.14,66.85 ,33.33
03,001,03,024,0896,0,49,0,49,65,0,3,1,3,0,1,0,76.14,75.38 ,33.33
03,001,03,025,0897,0,1070,7,1077,1523,0,3,1,3,0,1,0,76.14,70.72 ,33.33
03,001,03,025,0898,0,799,10,809,1352,0,3,1,3,0,1,0,76.14,59.84 ,33.33
03,001,03,025,0899,0,603,5,608,949,0,3,1,3,0,1,0,76.14,64.07 ,33.33
03,001,03,025,0900,0,1771,20,1791,2788,0,3,1,3,0,1,0,76.14,64.24 ,33.33
03,001,03,025,0901,0,603,9,612,932,0,3,1,3,0,1,0,76.14,65.67 ,33.33
03,001,03,025,0902,0,318,4,322,483,0,3,1,3,0,1,0,76.14,66.67 ,33.33
03,001,03,025,0903,0,2694,35,2729,4177,0,3,1,3,0,1,0,76.14,65.33 ,33.33
03,001,03,025,0904,0,1324,14,1338,1990,0,3,1,3,0,1,0,76.14,67.24 ,33.33
03,001,03,025,0905,0,1774,21,1795,2729,0,3,1,3,0,1,0,76.14,65.78 ,33.33
03,001,03,025,0906,0,1739,16,1755,2561,0,3,1,3,0,1,0,76.14,68.53 ,33.33
03,001,03,025,0907,0,2847,21,2868,4204,0,3,1,3,0,1,0,76.14,68.22 ,33.33
03,001,03,025,0908,0,2018,32,2050,3157,0,3,1,3,0,1,0,76.14,64.94 ,33.33
03,001,03,025,0909,0,1689,12,1701,2590,0,3,1,3,0,1,0,76.14,65.68 ,33.33
03,001,03,025,0910,0,1911,24,1935,2974,0,3,1,3,0,1,0,76.14,65.06 ,33.33
03,001,03,025,0911,0,1698,35,1733,2798,0,3,1,3,0,1,0,76.14,61.94 ,33.33
03,001,03,025,0912,0,1728,28,1756,2796,0,3,1,3,0,1,0,76.14,62.80 ,33.33
03,001,03,025,0913,0,4888,52,4940,7439,0,3,1,3,0,1,0,76.14,66.41 ,33.33
03,001,03,025,0914,0,958,9,967,1442,0,3,1,3,0,1,0,76.14,67.06 ,33.33
03,001,03,025,0915,0,807,8,815,1233,0,3,1,3,0,1,0,76.14,66.10 ,33.33
03,001,03,025,0916,0,308,6,314,461,0,3,1,3,0,1,0,76.14,68.11 ,33.33
03,001,03,025,0917,0,2209,32,2241,3476,0,3,1,3,0,1,0,76.14,64.47 ,33.33
03,001,03,025,0918,0,1161,19,1180,1678,0,3,1,3,0,1,0,76.14,70.32 ,33.33
03,001,03,025,0919,0,2537,20,2557,3961,0,3,1,3,0,1,0,76.14,64.55 ,33.33
03,001,03,025,0920,0,2111,30,2141,3545,0,3,1,3,0,1,0,76.14,60.39 ,33.33
03,001,03,025,0921,0,725,5,730,1148,0,3,1,3,0,1,0,76.14,63.59 ,33.33
03,001,03,025,0922,0,506,14,520,768,0,3,1,3,0,1,0,76.14,67.71 ,33.33
03,001,03,025,0923,0,628,10,638,902,0,3,1,3,0,1,0,76.14,70.73 ,33.33
03,001,03,025,0924,0,1898,28,1926,2935,0,3,1,3,0,1,0,76.14,65.62 ,33.33
03,001,03,025,0925,0,2073,46,2119,3391,0,3,1,3,0,1,0,76.14,62.49 ,33.33
03,001,03,025,0926,0,1057,26,1083,1604,0,3,1,3,0,1,0,76.14,67.52 ,33.33
03,001,03,025,0927,0,2963,43,3006,4695,0,3,1,3,0,1,0,76.14,64.03 ,33.33
03,001,03,025,0928,0,2226,29,2255,3571,0,3,1,3,0,1,0,76.14,63.15 ,33.33
03,001,03,025,0929,0,864,7,871,1400,0,3,1,3,0,1,0,76.14,62.21 ,33.33
03,001,03,025,0930,0,2799,40,2839,4676,0,3,1,3,0,1,0,76.14,60.71 ,33.33
03,001,03,025,0931,0,1359,25,1384,2188,0,3,1,3,0,1,0,76.14,63.25 ,33.33
03,001,03,025,0932,0,1271,10,1281,2034,0,3,1,3,0,1,0,76.14,62.98 ,33.33
03,001,03,025,0933,0,1087,17,1104,1757,0,3,1,3,0,1,0,76.14,62.83 ,33.33
03,001,03,025,0934,0,2175,19,2194,3476,0,3,1,3,0,1,0,76.14,63.12 ,33.33
03,001,03,025,0935,0,2211,20,2231,3393,0,3,1,3,0,1,0,76.14,65.75 ,33.33
03,001,03,025,0936,0,2539,30,2569,3929,0,3,1,3,0,1,0,76.14,65.39 ,33.33
03,001,03,025,0937,0,1597,9,1606,2373,0,3,1,3,0,1,0,76.14,67.68 ,33.33
03,001,03,025,0938,0,619,7,626,939,0,3,1,3,0,1,0,76.14,66.67 ,33.33
03,001,03,025,0939,0,2692,44,2736,4005,0,3,1,3,0,1,0,76.14,68.31 ,33.33
03,001,03,025,0940,0,1831,21,1852,2802,0,3,1,3,0,1,0,76.14,66.10 ,33.33
03,001,03,025,0941,0,1544,28,1572,2328,0,3,1,3,0,1,0,76.14,67.53 ,33.33
03,001,03,025,0942,0,1571,15,1586,2291,0,3,1,3,0,1,0,76.14,69.23 ,33.33
03,001,03,026,0943,0,554,7,561,775,0,3,1,3,0,1,0,76.14,72.39 ,33.33
03,001,03,026,0944,0,1229,15,1244,1694,0,3,1,3,0,1,0,76.14,73.44 ,33.33
03,001,03,026,0945,0,921,11,932,1298,0,3,1,3,0,1,0,76.14,71.80 ,33.33
03,001,03,026,0946,0,410,9,419,585,0,3,1,3,0,1,0,76.14,71.62 ,33.33
03,001,03,026,0947,0,1005,15,1020,1531,0,3,1,3,0,1,0,76.14,66.62 ,33.33
03,001,03,026,0948,0,851,15,866,1296,0,3,1,3,0,1,0,76.14,66.82 ,33.33
03,001,03,026,0949,0,2514,26,2540,3712,0,3,1,3,0,1,0,76.14,68.43 ,33.33
03,001,03,026,0950,0,1552,17,1569,2327,0,3,1,3,0,1,0,76.14,67.43 ,33.33
03,001,03,026,0951,0,1305,14,1319,1929,0,3,1,3,0,1,0,76.14,68.38 ,33.33
03,001,03,026,0952,0,755,28,783,1126,0,3,1,3,0,1,0,76.14,69.54 ,33.33
03,001,03,026,0953,0,186,2,188,285,0,3,1,3,0,1,0,76.14,65.96 ,33.33
03,001,03,026,0954,0,365,4,369,508,0,3,1,3,0,1,0,76.14,72.64 ,33.33
03,001,03,026,0955,0,243,4,247,362,0,3,1,3,0,1,0,76.14,68.23 ,33.33
03,001,03,026,0956,0,108,0,108,155,0,3,1,3,0,1,0,76.14,69.68 ,33.33
03,001,03,026,0957,0,1096,15,1111,1609,0,3,1,3,0,1,0,76.14,69.05 ,33.33
03,001,03,026,0958,0,1726,51,1777,2815,0,3,1,3,0,1,0,76.14,63.13 ,33.33
03,001,03,026,0959,0,837,14,851,1264,0,3,1,3,0,1,0,76.14,67.33 ,33.33
03,001,03,026,0960,0,1191,19,1210,1810,0,3,1,3,0,1,0,76.14,66.85 ,33.33
03,001,03,026,0961,0,365,7,372,586,0,3,1,3,0,1,0,76.14,63.48 ,33.33
03,001,03,026,0962,0,351,4,355,594,0,3,1,3,0,1,0,76.14,59.76 ,33.33
03,001,03,026,0963,0,238,2,240,417,0,3,1,3,0,1,0,76.14,57.55 ,33.33
03,001,03,026,0964,0,166,2,168,265,0,3,1,3,0,1,0,76.14,63.40 ,33.33
03,001,03,026,0965,0,246,2,248,409,0,3,1,3,0,1,0,76.14,60.64 ,33.33
03,001,03,026,0966,0,185,7,192,284,0,3,1,3,0,1,0,76.14,67.61 ,33.33
03,001,03,026,0967,0,189,2,191,272,0,3,1,3,0,1,0,76.14,70.22 ,33.33
03,001,03,026,0968,0,298,5,303,426,0,3,1,3,0,1,0,76.14,71.13 ,33.33
03,001,03,026,0969,0,276,4,280,431,0,3,1,3,0,1,0,76.14,64.97 ,33.33
03,001,03,026,0970,0,423,9,432,607,0,3,1,3,0,1,0,76.14,71.17 ,33.33
03,001,03,026,0971,0,197,1,198,319,0,3,1,3,0,1,0,76.14,62.07 ,33.33
03,001,03,026,0972,0,126,1,127,200,0,3,1,3,0,1,0,76.14,63.50 ,33.33
03,001,03,026,0973,0,322,7,329,509,0,3,1,3,0,1,0,76.14,64.64 ,33.33
03,001,03,026,0974,0,572,12,584,866,0,3,1,3,0,1,0,76.14,67.44 ,33.33
03,001,03,026,0975,0,1041,17,1058,1540,0,3,1,3,0,1,0,76.14,68.70 ,33.33
03,001,03,026,0976,0,622,10,632,967,0,3,1,3,0,1,0,76.14,65.36 ,33.33
03,001,03,027,0977,0,293,4,297,438,0,3,1,3,0,1,0,76.14,67.81 ,33.33
03,001,03,027,0978,0,222,4,226,320,0,3,1,3,0,1,0,76.14,70.63 ,33.33
03,001,03,027,0979,0,219,6,225,311,0,3,1,3,0,1,0,76.14,72.35 ,33.33
03,001,03,027,0980,0,373,4,377,562,0,3,1,3,0,1,0,76.14,67.08 ,33.33
03,001,03,027,0981,0,175,3,178,282,0,3,1,3,0,1,0,76.14,63.12 ,33.33
03,001,03,027,0982,0,469,11,480,703,0,3,1,3,0,1,0,76.14,68.28 ,33.33
03,001,03,027,0983,0,244,3,247,390,0,3,1,3,0,1,0,76.14,63.33 ,33.33
03,001,03,027,0984,0,655,11,666,1027,0,3,1,3,0,1,0,76.14,64.85 ,33.33
03,001,03,027,0985,0,73,3,76,149,0,3,1,3,0,1,0,76.14,51.01 ,33.33
03,001,03,027,0986,0,310,4,314,506,0,3,1,3,0,1,0,76.14,62.06 ,33.33
03,001,03,027,0987,0,118,3,121,185,0,3,1,3,0,1,0,76.14,65.41 ,33.33
03,001,03,027,0988,0,99,3,102,164,0,3,1,3,0,1,0,76.14,62.20 ,33.33
03,001,03,028,0989,0,373,4,377,574,0,3,1,3,0,1,0,76.14,65.68 ,33.33
03,001,03,028,0990,0,641,5,646,931,0,3,1,3,0,1,0,76.14,69.39 ,33.33
03,001,03,028,0991,0,293,2,295,454,0,3,1,3,0,1,0,76.14,64.98 ,33.33
03,001,03,028,0992,0,1267,21,1288,1858,0,3,1,3,0,1,0,76.14,69.32 ,33.33
03,001,03,028,0993,0,251,2,253,357,0,3,1,3,0,1,0,76.14,70.87 ,33.33
03,001,03,028,0994,0,581,7,588,924,0,3,1,3,0,1,0,76.14,63.64 ,33.33
03,001,03,028,0995,0,464,7,471,721,0,3,1,3,0,1,0,76.14,65.33 ,33.33
03,001,03,028,0996,0,332,0,332,511,0,3,1,3,0,1,0,76.14,64.97 ,33.33
03,001,03,028,0997,0,270,2,272,407,0,3,1,3,0,1,0,76.14,66.83 ,33.33
03,001,03,028,0998,0,323,3,326,470,0,3,1,3,0,1,0,76.14,69.36 ,33.33
03,001,03,028,0999,0,488,3,491,702,0,3,1,3,0,1,0,76.14,69.94 ,33.33
03,001,03,028,1000,0,260,0,260,475,0,3,1,3,0,1,0,76.14,54.74 ,33.33
03,001,03,029,1001,0,575,9,584,919,0,3,1,3,0,1,0,76.14,63.55 ,33.33
03,001,03,029,1002,0,263,1,264,428,0,3,1,3,0,1,0,76.14,61.68 ,33.33
03,001,03,029,1003,0,312,7,319,477,0,3,1,3,0,1,0,76.14,66.88 ,33.33
03,001,03,029,1004,0,486,8,494,792,0,3,1,3,0,1,0,76.14,62.37 ,33.33
03,001,03,029,1005,0,991,20,1011,1562,0,3,1,3,0,1,0,76.14,64.72 ,33.33
03,001,03,029,1006,0,443,9,452,788,0,3,1,3,0,1,0,76.14,57.36 ,33.33
03,001,03,029,1007,0,415,1,416,644,0,3,1,3,0,1,0,76.14,64.60 ,33.33
03,001,03,029,1008,0,1016,13,1029,1549,0,3,1,3,0,1,0,76.14,66.43 ,33.33
03,001,03,029,1009,0,1122,11,1133,1846,0,3,1,3,0,1,0,76.14,61.38 ,33.33
03,001,03,029,1010,0,489,6,495,783,0,3,1,3,0,1,0,76.14,63.22 ,33.33
03,001,03,029,1011,0,577,13,590,894,0,3,1,3,0,1,0,76.14,66.00 ,33.33
03,002,01,001,0001,0,378,3,381,632,0,3,1,3,0,1,0,76.14,60.28 ,33.33
03,002,01,001,0002,0,1402,19,1421,2107,0,3,1,3,0,1,0,76.14,67.44 ,33.33
03,002,01,001,0003,0,1444,23,1467,2238,0,3,1,3,0,1,0,76.14,65.55 ,33.33
03,002,01,001,0004,0,1427,18,1445,2353,0,3,1,3,0,1,0,76.14,61.41 ,33.33
03,002,01,001,0005,0,1802,26,1828,2778,0,3,1,3,0,1,0,76.14,65.80 ,33.33
03,002,01,001,0006,0,2581,21,2602,4068,0,3,1,3,0,1,0,76.14,63.96 ,33.33
03,002,01,001,0007,0,1670,14,1684,2606,0,3,1,3,0,1,0,76.14,64.62 ,33.33
03,002,01,001,0008,0,439,4,443,675,0,3,1,3,0,1,0,76.14,65.63 ,33.33
03,002,01,001,0009,0,290,4,294,457,0,3,1,3,0,1,0,76.14,64.33 ,33.33
03,002,01,001,0010,0,476,3,479,693,0,3,1,3,0,1,0,76.14,69.12 ,33.33
03,002,01,001,0011,0,355,6,361,577,0,3,1,3,0,1,0,76.14,62.56 ,33.33
03,002,01,001,0012,0,375,2,377,598,0,3,1,3,0,1,0,76.14,63.04 ,33.33
03,002,01,001,0013,0,1300,16,1316,2040,0,3,1,3,0,1,0,76.14,64.51 ,33.33
03,002,01,001,0014,0,920,19,939,1486,0,3,1,3,0,1,0,76.14,63.19 ,33.33
03,002,01,001,0015,0,2882,19,2901,4442,0,3,1,3,0,1,0,76.14,65.31 ,33.33
03,002,01,001,0016,0,438,2,440,630,0,3,1,3,0,1,0,76.14,69.84 ,33.33
03,002,01,001,0017,0,579,8,587,992,0,3,1,3,0,1,0,76.14,59.17 ,33.33
03,002,01,001,0018,0,473,3,476,771,0,3,1,3,0,1,0,76.14,61.74 ,33.33
03,002,01,001,0019,0,674,4,678,1108,0,3,1,3,0,1,0,76.14,61.19 ,33.33
03,002,01,001,0020,0,794,5,799,1243,0,3,1,3,0,1,0,76.14,64.28 ,33.33
03,002,01,001,0021,0,2185,18,2203,3435,0,3,1,3,0,1,0,76.14,64.13 ,33.33
03,002,01,001,0022,0,2169,43,2212,3470,0,3,1,3,0,1,0,76.14,63.75 ,33.33
03,002,01,001,0023,0,734,5,739,1157,0,3,1,3,0,1,0,76.14,63.87 ,33.33
03,002,01,001,0024,0,2408,34,2442,3905,0,3,1,3,0,1,0,76.14,62.54 ,33.33
03,002,01,001,0025,0,415,8,423,641,0,3,1,3,0,1,0,76.14,65.99 ,33.33
03,002,01,001,0026,0,363,1,364,558,0,3,1,3,0,1,0,76.14,65.23 ,33.33
03,002,01,001,0027,0,392,7,399,631,0,3,1,3,0,1,0,76.14,63.23 ,33.33
03,002,01,001,0028,0,815,1,816,1273,0,3,1,3,0,1,0,76.14,64.10 ,33.33
03,002,01,001,0029,0,847,6,853,1316,0,3,1,3,0,1,0,76.14,64.82 ,33.33
03,002,01,001,0030,0,656,5,661,1054,0,3,1,3,0,1,0,76.14,62.71 ,33.33
03,002,01,001,0031,0,1347,11,1358,2124,0,3,1,3,0,1,0,76.14,63.94 ,33.33
03,002,01,001,0032,0,1058,4,1062,1732,0,3,1,3,0,1,0,76.14,61.32 ,33.33
03,002,01,001,0033,0,909,4,913,1436,0,3,1,3,0,1,0,76.14,63.58 ,33.33
03,002,01,001,0034,0,1568,17,1585,2487,0,3,1,3,0,1,0,76.14,63.73 ,33.33
03,002,01,001,0035,0,572,4,576,898,0,3,1,3,0,1,0,76.14,64.14 ,33.33
03,002,01,001,0036,0,483,11,494,744,0,3,1,3,0,1,0,76.14,66.40 ,33.33
03,002,01,001,0037,0,488,4,492,802,0,3,1,3,0,1,0,76.14,61.35 ,33.33
03,002,01,001,0038,0,827,16,843,1284,0,3,1,3,0,1,0,76.14,65.65 ,33.33
03,002,01,001,0039,0,508,9,517,803,0,3,1,3,0,1,0,76.14,64.38 ,33.33
03,002,01,001,0040,0,819,8,827,1301,0,3,1,3,0,1,0,76.14,63.57 ,33.33
03,002,01,002,0041,0,316,4,320,515,0,3,1,3,0,1,0,76.14,62.14 ,33.33
03,002,01,002,0042,0,351,5,356,521,0,3,1,3,0,1,0,76.14,68.33 ,33.33
03,002,01,002,0043,0,307,3,310,498,0,3,1,3,0,1,0,76.14,62.25 ,33.33
03,002,01,002,0044,0,782,3,785,1227,0,3,1,3,0,1,0,76.14,63.98 ,33.33
03,002,01,002,0045,0,1290,15,1305,2115,0,3,1,3,0,1,0,76.14,61.70 ,33.33
03,002,01,002,0046,0,1248,12,1260,1948,0,3,1,3,0,1,0,76.14,64.68 ,33.33
03,002,01,002,0047,0,1158,18,1176,1913,0,3,1,3,0,1,0,76.14,61.47 ,33.33
03,002,01,002,0048,0,1343,19,1362,2175,0,3,1,3,0,1,0,76.14,62.62 ,33.33
03,002,01,002,0049,0,902,7,909,1339,0,3,1,3,0,1,0,76.14,67.89 ,33.33
03,002,01,002,0050,0,778,12,790,1177,0,3,1,3,0,1,0,76.14,67.12 ,33.33
03,002,01,002,0051,0,547,3,550,876,0,3,1,3,0,1,0,76.14,62.79 ,33.33
03,002,01,002,0052,0,439,4,443,715,0,3,1,3,0,1,0,76.14,61.96 ,33.33
03,002,01,002,0053,0,545,5,550,878,0,3,1,3,0,1,0,76.14,62.64 ,33.33
03,002,01,002,0054,0,411,4,415,613,0,3,1,3,0,1,0,76.14,67.70 ,33.33
03,002,01,002,0055,0,454,2,456,723,0,3,1,3,0,1,0,76.14,63.07 ,33.33
03,002,01,002,0056,0,2277,15,2292,3540,0,3,1,3,0,1,0,76.14,64.75 ,33.33
03,002,01,002,0057,0,2914,33,2947,4646,0,3,1,3,0,1,0,76.14,63.43 ,33.33
03,002,01,002,0058,0,3209,32,3241,5061,0,3,1,3,0,1,0,76.14,64.04 ,33.33
03,002,01,002,0059,0,2081,16,2097,3349,0,3,1,3,0,1,0,76.14,62.62 ,33.33
03,002,01,002,0060,0,1127,13,1140,1803,0,3,1,3,0,1,0,76.14,63.23 ,33.33
03,002,01,002,0061,0,607,6,613,1001,0,3,1,3,0,1,0,76.14,61.24 ,33.33
03,002,01,002,0062,0,1743,11,1754,2865,0,3,1,3,0,1,0,76.14,61.22 ,33.33
03,002,01,002,0063,0,2072,17,2089,3290,0,3,1,3,0,1,0,76.14,63.50 ,33.33
03,002,01,002,0064,0,1579,19,1598,2539,0,3,1,3,0,1,0,76.14,62.94 ,33.33
03,002,01,002,0065,0,1503,16,1519,2367,0,3,1,3,0,1,0,76.14,64.17 ,33.33
03,002,01,003,0066,0,1847,13,1860,2965,0,3,1,3,0,1,0,76.14,62.73 ,33.33
03,002,01,003,0067,0,512,2,514,757,0,3,1,3,0,1,0,76.14,67.90 ,33.33
03,002,01,003,0068,0,1875,20,1895,2925,0,3,1,3,0,1,0,76.14,64.79 ,33.33
03,002,01,003,0069,0,694,2,696,1010,0,3,1,3,0,1,0,76.14,68.91 ,33.33
03,002,01,003,0070,0,783,5,788,1237,0,3,1,3,0,1,0,76.14,63.70 ,33.33
03,002,01,003,0071,0,173,5,178,305,0,3,1,3,0,1,0,76.14,58.36 ,33.33
03,002,01,003,0072,0,1289,10,1299,2070,0,3,1,3,0,1,0,76.14,62.75 ,33.33
03,002,01,003,0073,0,689,6,695,1102,0,3,1,3,0,1,0,76.14,63.07 ,33.33
03,002,01,003,0074,0,2894,33,2927,4863,0,3,1,3,0,1,0,76.14,60.19 ,33.33
03,002,01,003,0075,0,1417,10,1427,2230,0,3,1,3,0,1,0,76.14,63.99 ,33.33
03,002,01,003,0076,0,776,12,788,1229,0,3,1,3,0,1,0,76.14,64.12 ,33.33
03,002,01,003,0077,0,376,4,380,552,0,3,1,3,0,1,0,76.14,68.84 ,33.33
03,002,01,003,0078,0,297,2,299,511,0,3,1,3,0,1,0,76.14,58.51 ,33.33
03,002,01,003,0079,0,395,2,397,603,0,3,1,3,0,1,0,76.14,65.84 ,33.33
03,002,01,003,0080,0,373,3,376,570,0,3,1,3,0,1,0,76.14,65.96 ,33.33
03,002,01,003,0081,0,377,4,381,632,0,3,1,3,0,1,0,76.14,60.28 ,33.33
03,002,01,003,0082,0,372,3,375,536,0,3,1,3,0,1,0,76.14,69.96 ,33.33
03,002,01,003,0083,0,715,10,725,1112,0,3,1,3,0,1,0,76.14,65.20 ,33.33
03,002,01,003,0084,0,626,6,632,1035,0,3,1,3,0,1,0,76.14,61.06 ,33.33
03,002,01,003,0085,0,745,5,750,1250,0,3,1,3,0,1,0,76.14,60.00 ,33.33
03,002,01,003,0086,0,915,10,925,1674,0,3,1,3,0,1,0,76.14,55.26 ,33.33
03,002,01,003,0087,0,674,10,684,1160,0,3,1,3,0,1,0,76.14,58.97 ,33.33
03,002,01,003,0088,0,770,8,778,1335,0,3,1,3,0,1,0,76.14,58.28 ,33.33
03,002,01,003,0089,0,187,2,189,333,0,3,1,3,0,1,0,76.14,56.76 ,33.33
03,002,01,003,0090,0,448,9,457,816,0,3,1,3,0,1,0,76.14,56.00 ,33.33
03,002,01,003,0091,0,427,7,434,748,0,3,1,3,0,1,0,76.14,58.02 ,33.33
03,002,01,004,0092,0,212,2,214,382,0,3,1,3,0,1,0,76.14,56.02 ,33.33
03,002,01,004,0093,0,384,7,391,709,0,3,1,3,0,1,0,76.14,55.15 ,33.33
03,002,01,004,0094,0,343,9,352,622,0,3,1,3,0,1,0,76.14,56.59 ,33.33
03,002,01,004,0095,0,520,4,524,930,0,3,1,3,0,1,0,76.14,56.34 ,33.33
03,002,01,004,0096,0,230,3,233,401,0,3,1,3,0,1,0,76.14,58.10 ,33.33
03,002,01,004,0097,0,939,9,948,1374,0,3,1,3,0,1,0,76.14,69.00 ,33.33
03,002,01,004,0098,0,531,12,543,874,0,3,1,3,0,1,0,76.14,62.13 ,33.33
03,002,01,004,0099,0,427,3,430,628,0,3,1,3,0,1,0,76.14,68.47 ,33.33
03,002,01,004,0100,0,931,11,942,1411,0,3,1,3,0,1,0,76.14,66.76 ,33.33
03,002,01,004,0101,0,753,12,765,1148,0,3,1,3,0,1,0,76.14,66.64 ,33.33
03,002,01,004,0102,0,522,7,529,759,0,3,1,3,0,1,0,76.14,69.70 ,33.33
03,002,01,004,0103,0,375,5,380,558,0,3,1,3,0,1,0,76.14,68.10 ,33.33
03,002,01,004,0104,0,462,4,466,652,0,3,1,3,0,1,0,76.14,71.47 ,33.33
03,002,01,004,0105,0,403,1,404,607,0,3,1,3,0,1,0,76.14,66.56 ,33.33
03,002,01,004,0106,0,1160,12,1172,1919,0,3,1,3,0,1,0,76.14,61.07 ,33.33
03,002,01,004,0107,0,1124,16,1140,1779,0,3,1,3,0,1,0,76.14,64.08 ,33.33
03,002,01,004,0108,0,859,7,866,1362,0,3,1,3,0,1,0,76.14,63.58 ,33.33
03,002,01,004,0109,0,633,9,642,962,0,3,1,3,0,1,0,76.14,66.74 ,33.33
03,002,01,004,0110,0,1002,9,1011,1625,0,3,1,3,0,1,0,76.14,62.22 ,33.33
03,002,01,004,0111,0,405,5,410,685,0,3,1,3,0,1,0,76.14,59.85 ,33.33
03,002,01,004,0112,0,861,10,871,1270,0,3,1,3,0,1,0,76.14,68.58 ,33.33
03,002,01,004,0113,0,642,4,646,940,0,3,1,3,0,1,0,76.14,68.72 ,33.33
03,002,01,004,0114,0,639,5,644,962,0,3,1,3,0,1,0,76.14,66.94 ,33.33
03,002,01,004,0115,0,661,11,672,1053,0,3,1,3,0,1,0,76.14,63.82 ,33.33
03,002,01,005,0116,0,849,12,861,1410,0,3,1,3,0,1,0,76.14,61.06 ,33.33
03,002,01,005,0117,0,1049,10,1059,1664,0,3,1,3,0,1,0,76.14,63.64 ,33.33
03,002,01,005,0118,0,2121,16,2137,3414,0,3,1,3,0,1,0,76.14,62.60 ,33.33
03,002,01,005,0119,0,1391,6,1397,2118,0,3,1,3,0,1,0,76.14,65.96 ,33.33
03,002,01,005,0120,0,464,6,470,674,0,3,1,3,0,1,0,76.14,69.73 ,33.33
03,002,01,005,0121,0,930,4,934,1383,0,3,1,3,0,1,0,76.14,67.53 ,33.33
03,002,01,005,0122,0,710,8,718,1094,0,3,1,3,0,1,0,76.14,65.63 ,33.33
03,002,01,005,0123,0,865,10,875,1337,0,3,1,3,0,1,0,76.14,65.45 ,33.33
03,002,01,005,0124,0,1184,16,1200,1880,0,3,1,3,0,1,0,76.14,63.83 ,33.33
03,002,01,005,0125,0,1436,15,1451,2275,0,3,1,3,0,1,0,76.14,63.78 ,33.33
03,002,01,005,0126,0,695,8,703,1050,0,3,1,3,0,1,0,76.14,66.95 ,33.33
03,002,01,005,0127,0,477,3,480,730,0,3,1,3,0,1,0,76.14,65.75 ,33.33
03,002,01,005,0128,0,606,10,616,921,0,3,1,3,0,1,0,76.14,66.88 ,33.33
03,002,01,005,0129,0,718,8,726,1103,0,3,1,3,0,1,0,76.14,65.82 ,33.33
03,002,01,005,0130,0,1464,9,1473,2168,0,3,1,3,0,1,0,76.14,67.94 ,33.33
03,002,01,005,0131,0,1683,23,1706,2731,0,3,1,3,0,1,0,76.14,62.47 ,33.33
03,002,01,005,0132,0,595,7,602,920,0,3,1,3,0,1,0,76.14,65.43 ,33.33
03,002,01,005,0133,0,249,3,252,406,0,3,1,3,0,1,0,76.14,62.07 ,33.33
03,002,01,006,0134,0,1197,11,1208,1826,0,3,1,3,0,1,0,76.14,66.16 ,33.33
03,002,01,006,0135,0,561,5,566,934,0,3,1,3,0,1,0,76.14,60.60 ,33.33
03,002,01,006,0136,0,995,9,1004,1638,0,3,1,3,0,1,0,76.14,61.29 ,33.33
03,002,01,006,0137,0,612,8,620,900,0,3,1,3,0,1,0,76.14,68.89 ,33.33
03,002,01,006,0138,0,606,5,611,985,0,3,1,3,0,1,0,76.14,62.03 ,33.33
03,002,01,006,0139,0,978,17,995,1582,0,3,1,3,0,1,0,76.14,62.90 ,33.33
03,002,01,006,0140,0,943,10,953,1584,0,3,1,3,0,1,0,76.14,60.16 ,33.33
03,002,01,006,0141,0,501,3,504,835,0,3,1,3,0,1,0,76.14,60.36 ,33.33
03,002,01,006,0142,0,1339,14,1353,2066,0,3,1,3,0,1,0,76.14,65.49 ,33.33
03,002,01,006,0143,0,825,10,835,1277,0,3,1,3,0,1,0,76.14,65.39 ,33.33
03,002,01,006,0144,0,651,3,654,994,0,3,1,3,0,1,0,76.14,65.79 ,33.33
03,002,01,006,0145,0,1287,8,1295,1930,0,3,1,3,0,1,0,76.14,67.10 ,33.33
03,002,01,006,0146,0,656,7,663,1026,0,3,1,3,0,1,0,76.14,64.62 ,33.33
03,002,01,006,0147,0,1166,12,1178,1833,0,3,1,3,0,1,0,76.14,64.27 ,33.33
03,002,01,007,0148,0,2604,27,2631,4275,0,3,1,3,0,1,0,76.14,61.54 ,33.33
03,002,01,007,0149,0,1080,17,1097,1852,0,3,1,3,0,1,0,76.14,59.23 ,33.33
03,002,01,007,0150,0,796,6,802,1198,0,3,1,3,0,1,0,76.14,66.94 ,33.33
03,002,01,007,0151,0,644,9,653,978,0,3,1,3,0,1,0,76.14,66.77 ,33.33
03,002,01,007,0152,0,800,8,808,1389,0,3,1,3,0,1,0,76.14,58.17 ,33.33
03,002,01,007,0153,0,658,9,667,1139,0,3,1,3,0,1,0,76.14,58.56 ,33.33
03,002,01,007,0154,0,922,19,941,1486,0,3,1,3,0,1,0,76.14,63.32 ,33.33
03,002,01,007,0155,0,426,4,430,740,0,3,1,3,0,1,0,76.14,58.11 ,33.33
03,002,01,007,0156,0,964,11,975,1580,0,3,1,3,0,1,0,76.14,61.71 ,33.33
03,002,01,007,0157,0,661,10,671,1054,0,3,1,3,0,1,0,76.14,63.66 ,33.33
03,002,01,007,0158,0,1345,20,1365,2100,0,3,1,3,0,1,0,76.14,65.00 ,33.33
03,002,01,007,0159,0,1518,14,1532,2394,0,3,1,3,0,1,0,76.14,63.99 ,33.33
03,002,01,007,0160,0,505,12,517,861,0,3,1,3,0,1,0,76.14,60.05 ,33.33
03,002,01,007,0161,0,495,4,499,824,0,3,1,3,0,1,0,76.14,60.56 ,33.33
03,002,01,007,0162,0,700,6,706,1092,0,3,1,3,0,1,0,76.14,64.65 ,33.33
03,002,01,007,0163,0,863,4,867,1495,0,3,1,3,0,1,0,76.14,57.99 ,33.33
03,002,01,008,0164,0,758,9,767,1101,0,3,1,3,0,1,0,76.14,69.66 ,33.33
03,002,01,008,0165,0,809,8,817,1229,0,3,1,3,0,1,0,76.14,66.48 ,33.33
03,002,01,008,0166,0,674,6,680,980,0,3,1,3,0,1,0,76.14,69.39 ,33.33
03,002,01,008,0167,0,565,4,569,839,0,3,1,3,0,1,0,76.14,67.82 ,33.33
03,002,01,008,0168,0,664,8,672,935,0,3,1,3,0,1,0,76.14,71.87 ,33.33
03,002,01,008,0169,0,756,7,763,1145,0,3,1,3,0,1,0,76.14,66.64 ,33.33
03,002,01,008,0170,0,1302,15,1317,1953,0,3,1,3,0,1,0,76.14,67.43 ,33.33
03,002,01,008,0171,0,1257,18,1275,1851,0,3,1,3,0,1,0,76.14,68.88 ,33.33
03,002,01,008,0172,0,578,5,583,811,0,3,1,3,0,1,0,76.14,71.89 ,33.33
03,002,01,008,0173,0,479,7,486,711,0,3,1,3,0,1,0,76.14,68.35 ,33.33
03,002,01,008,0174,0,944,4,948,1265,0,3,1,3,0,1,0,76.14,74.94 ,33.33
03,002,01,008,0175,0,538,5,543,796,0,3,1,3,0,1,0,76.14,68.22 ,33.33
03,002,01,008,0176,0,830,10,840,1234,0,3,1,3,0,1,0,76.14,68.07 ,33.33
03,002,01,008,0177,0,293,2,295,428,0,3,1,3,0,1,0,76.14,68.93 ,33.33
03,002,01,008,0178,0,2509,23,2532,4146,0,3,1,3,0,1,0,76.14,61.07 ,33.33
03,002,01,008,0179,0,1272,6,1278,1971,0,3,1,3,0,1,0,76.14,64.84 ,33.33
03,002,01,008,0180,0,2795,47,2842,4440,0,3,1,3,0,1,0,76.14,64.01 ,33.33
03,002,01,008,0181,0,1673,12,1685,2667,0,3,1,3,0,1,0,76.14,63.18 ,33.33
03,002,01,008,0182,0,1391,20,1411,2198,0,3,1,3,0,1,0,76.14,64.19 ,33.33
03,002,01,008,0183,0,685,10,695,998,0,3,1,3,0,1,0,76.14,69.64 ,33.33
03,002,01,008,0184,0,1333,14,1347,2112,0,3,1,3,0,1,0,76.14,63.78 ,33.33
03,002,01,008,0185,0,812,4,816,1247,0,3,1,3,0,1,0,76.14,65.44 ,33.33
03,002,01,008,0186,0,631,8,639,1018,0,3,1,3,0,1,0,76.14,62.77 ,33.33
03,002,01,008,0187,0,521,2,523,835,0,3,1,3,0,1,0,76.14,62.63 ,33.33
03,002,01,009,0188,0,1043,10,1053,1588,0,3,1,3,0,1,0,76.14,66.31 ,33.33
03,002,01,009,0189,0,945,11,956,1437,0,3,1,3,0,1,0,76.14,66.53 ,33.33
03,002,01,009,0190,0,1339,8,1347,1991,0,3,1,3,0,1,0,76.14,67.65 ,33.33
03,002,01,009,0191,0,906,12,918,1436,0,3,1,3,0,1,0,76.14,63.93 ,33.33
03,002,01,009,0192,0,675,6,681,1071,0,3,1,3,0,1,0,76.14,63.59 ,33.33
03,002,01,009,0193,0,1315,11,1326,2056,0,3,1,3,0,1,0,76.14,64.49 ,33.33
03,002,01,009,0194,0,933,13,946,1457,0,3,1,3,0,1,0,76.14,64.93 ,33.33
03,002,01,009,0195,0,1679,13,1692,2664,0,3,1,3,0,1,0,76.14,63.51 ,33.33
03,002,01,009,0196,0,1740,17,1757,2673,0,3,1,3,0,1,0,76.14,65.73 ,33.33
03,002,01,009,0197,0,1468,14,1482,2278,0,3,1,3,0,1,0,76.14,65.06 ,33.33
03,002,01,009,0198,0,861,15,876,1330,0,3,1,3,0,1,0,76.14,65.86 ,33.33
03,002,01,009,0199,0,944,11,955,1464,0,3,1,3,0,1,0,76.14,65.23 ,33.33
03,002,01,009,0200,0,1185,32,1217,1991,0,3,1,3,0,1,0,76.14,61.13 ,33.33
03,002,01,009,0201,0,1483,12,1495,2345,0,3,1,3,0,1,0,76.14,63.75 ,33.33
03,002,01,009,0202,0,1477,17,1494,2461,0,3,1,3,0,1,0,76.14,60.71 ,33.33
03,002,01,010,0203,0,157,1,158,239,0,3,1,3,0,1,0,76.14,66.11 ,33.33
03,002,01,010,0204,0,374,3,377,599,0,3,1,3,0,1,0,76.14,62.94 ,33.33
03,002,01,010,0205,0,462,6,468,781,0,3,1,3,0,1,0,76.14,59.92 ,33.33
03,002,01,010,0206,0,411,8,419,675,0,3,1,3,0,1,0,76.14,62.07 ,33.33
03,002,01,010,0207,0,288,6,294,453,0,3,1,3,0,1,0,76.14,64.90 ,33.33
03,002,01,010,0208,0,711,8,719,1098,0,3,1,3,0,1,0,76.14,65.48 ,33.33
03,002,01,010,0209,0,724,5,729,1152,0,3,1,3,0,1,0,76.14,63.28 ,33.33
03,002,01,010,0210,0,547,7,554,820,0,3,1,3,0,1,0,76.14,67.56 ,33.33
03,002,01,010,0211,0,592,2,594,1024,0,3,1,3,0,1,0,76.14,58.01 ,33.33
03,002,01,010,0212,0,1829,19,1848,3051,0,3,1,3,0,1,0,76.14,60.57 ,33.33
03,002,01,010,0213,0,424,6,430,687,0,3,1,3,0,1,0,76.14,62.59 ,33.33
03,002,01,010,0214,0,347,3,350,555,0,3,1,3,0,1,0,76.14,63.06 ,33.33
03,002,01,010,0215,0,285,6,291,497,0,3,1,3,0,1,0,76.14,58.55 ,33.33
03,002,01,010,0216,0,412,3,415,665,0,3,1,3,0,1,0,76.14,62.41 ,33.33
03,002,01,010,0217,0,628,12,640,1088,0,3,1,3,0,1,0,76.14,58.82 ,33.33
03,002,01,010,0218,0,511,9,520,807,0,3,1,3,0,1,0,76.14,64.44 ,33.33
03,002,01,010,0219,0,868,6,874,1237,0,3,1,3,0,1,0,76.14,70.65 ,33.33
03,002,01,010,0220,0,725,13,738,1120,0,3,1,3,0,1,0,76.14,65.89 ,33.33
03,002,01,011,0221,0,59,0,59,105,0,3,1,3,0,1,0,76.14,56.19 ,33.33
03,002,01,011,0222,0,57,1,58,94,0,3,1,3,0,1,0,76.14,61.70 ,33.33
03,002,01,011,0223,0,152,3,155,226,0,3,1,3,0,1,0,76.14,68.58 ,33.33
03,002,01,011,0224,0,137,1,138,241,0,3,1,3,0,1,0,76.14,57.26 ,33.33
03,002,01,011,0225,0,43,0,43,80,0,3,1,3,0,1,0,76.14,53.75 ,33.33
03,002,01,011,0226,0,29,3,32,57,0,3,1,3,0,1,0,76.14,56.14 ,33.33
03,002,01,011,0227,0,37,0,37,53,0,3,1,3,0,1,0,76.14,69.81 ,33.33
03,002,01,011,0228,0,18,0,18,23,0,3,1,3,0,1,0,76.14,78.26 ,33.33
03,002,01,011,0229,0,27,0,27,55,0,3,1,3,0,1,0,76.14,49.09 ,33.33
03,002,01,011,0230,0,49,1,50,79,0,3,1,3,0,1,0,76.14,63.29 ,33.33
03,002,01,012,0231,0,47,1,48,81,0,3,1,3,0,1,0,76.14,59.26 ,33.33
03,002,01,012,0232,0,132,3,135,236,0,3,1,3,0,1,0,76.14,57.20 ,33.33
03,002,01,012,0233,0,43,1,44,92,0,3,1,3,0,1,0,76.14,47.83 ,33.33
03,002,01,012,0234,0,30,1,31,53,0,3,1,3,0,1,0,76.14,58.49 ,33.33
03,002,01,012,0235,0,51,1,52,125,0,3,1,3,0,1,0,76.14,41.60 ,33.33
03,002,01,012,0236,0,11,0,11,26,0,3,1,3,0,1,0,76.14,42.31 ,33.33
03,002,01,012,0237,0,74,4,78,150,0,3,1,3,0,1,0,76.14,52.00 ,33.33
03,003,01,001,0001,0,3242,40,3282,4848,0,3,1,3,0,1,0,76.14,67.70 ,33.33
03,003,01,001,0002,0,2438,29,2467,3632,0,3,1,3,0,1,0,76.14,67.92 ,33.33
03,003,01,001,0003,0,2598,38,2636,3836,0,3,1,3,0,1,0,76.14,68.72 ,33.33
03,003,01,001,0004,0,2984,31,3015,4322,0,3,1,3,0,1,0,76.14,69.76 ,33.33
03,003,01,001,0005,0,2039,21,2060,2961,0,3,1,3,0,1,0,76.14,69.57 ,33.33
03,003,01,001,0006,0,3342,50,3392,4857,0,3,1,3,0,1,0,76.14,69.84 ,33.33
03,003,01,001,0007,0,2676,26,2702,4040,0,3,1,3,0,1,0,76.14,66.88 ,33.33
03,003,01,001,0008,0,1632,18,1650,2479,0,3,1,3,0,1,0,76.14,66.56 ,33.33
03,003,01,001,0009,0,1237,10,1247,1810,0,3,1,3,0,1,0,76.14,68.90 ,33.33
03,003,01,001,0010,0,558,9,567,900,0,3,1,3,0,1,0,76.14,63.00 ,33.33
03,003,01,001,0011,0,976,4,980,1524,0,3,1,3,0,1,0,76.14,64.30 ,33.33
03,003,01,001,0012,0,986,16,1002,1402,0,3,1,3,0,1,0,76.14,71.47 ,33.33
03,003,01,001,0013,0,535,3,538,814,0,3,1,3,0,1,0,76.14,66.09 ,33.33
03,003,01,001,0014,0,971,12,983,1441,0,3,1,3,0,1,0,76.14,68.22 ,33.33
03,003,01,001,0015,0,657,9,666,943,0,3,1,3,0,1,0,76.14,70.63 ,33.33
03,003,01,001,0016,0,3047,33,3080,4590,0,3,1,3,0,1,0,76.14,67.10 ,33.33
03,003,01,001,0017,0,976,6,982,1360,0,3,1,3,0,1,0,76.14,72.21 ,33.33
03,003,01,001,0018,0,881,9,890,1334,0,3,1,3,0,1,0,76.14,66.72 ,33.33
03,003,01,001,0019,0,853,9,862,1239,0,3,1,3,0,1,0,76.14,69.57 ,33.33
03,003,01,001,0020,0,642,3,645,936,0,3,1,3,0,1,0,76.14,68.91 ,33.33
03,003,01,001,0021,0,1231,11,1242,1735,0,3,1,3,0,1,0,76.14,71.59 ,33.33
03,003,01,001,0022,0,3125,35,3160,4461,0,3,1,3,0,1,0,76.14,70.84 ,33.33
03,003,01,001,0023,0,2906,38,2944,4472,0,3,1,3,0,1,0,76.14,65.83 ,33.33
03,003,01,001,0024,0,1913,17,1930,2864,0,3,1,3,0,1,0,76.14,67.39 ,33.33
03,003,01,001,0025,0,2303,27,2330,3453,0,3,1,3,0,1,0,76.14,67.48 ,33.33
03,003,01,001,0026,0,2603,36,2639,4002,0,3,1,3,0,1,0,76.14,65.94 ,33.33
03,003,01,001,0027,0,2097,26,2123,3237,0,3,1,3,0,1,0,76.14,65.59 ,33.33
03,003,01,001,0028,0,1700,17,1717,2504,0,3,1,3,0,1,0,76.14,68.57 ,33.33
03,003,01,001,0029,0,3252,36,3288,5127,0,3,1,3,0,1,0,76.14,64.13 ,33.33
03,003,01,001,0030,0,2697,33,2730,4010,0,3,1,3,0,1,0,76.14,68.08 ,33.33
03,003,01,001,0031,0,2666,27,2693,3882,0,3,1,3,0,1,0,76.14,69.37 ,33.33
03,003,01,001,0032,0,1716,23,1739,2502,0,3,1,3,0,1,0,76.14,69.50 ,33.33
03,003,01,001,0033,0,2229,23,2252,3373,0,3,1,3,0,1,0,76.14,66.77 ,33.33
03,003,01,001,0034,0,2701,39,2740,4127,0,3,1,3,0,1,0,76.14,66.39 ,33.33
03,003,01,001,0035,0,1971,27,1998,2861,0,3,1,3,0,1,0,76.14,69.84 ,33.33
03,003,01,001,0036,0,2178,26,2204,3177,0,3,1,3,0,1,0,76.14,69.37 ,33.33
03,003,01,001,0037,0,1385,16,1401,2120,0,3,1,3,0,1,0,76.14,66.08 ,33.33
03,003,01,001,0038,0,2466,31,2497,3821,0,3,1,3,0,1,0,76.14,65.35 ,33.33
03,003,01,001,0039,0,3267,46,3313,5080,0,3,1,3,0,1,0,76.14,65.22 ,33.33
03,003,01,001,0040,0,2264,18,2282,3345,0,3,1,3,0,1,0,76.14,68.22 ,33.33
03,003,01,001,0041,0,2599,44,2643,3914,0,3,1,3,0,1,0,76.14,67.53 ,33.33
03,003,01,001,0042,0,2592,31,2623,3963,0,3,1,3,0,1,0,76.14,66.19 ,33.33
03,003,01,001,0043,0,2516,32,2548,3764,0,3,1,3,0,1,0,76.14,67.69 ,33.33
03,003,01,001,0044,0,3694,50,3744,5711,0,3,1,3,0,1,0,76.14,65.56 ,33.33
03,003,01,001,0045,0,1385,19,1404,1928,0,3,1,3,0,1,0,76.14,72.82 ,33.33
03,003,01,001,0046,0,1683,23,1706,2605,0,3,1,3,0,1,0,76.14,65.49 ,33.33
03,003,01,001,0047,0,2819,31,2850,4405,0,3,1,3,0,1,0,76.14,64.70 ,33.33
03,003,01,001,0048,0,3304,34,3338,5352,0,3,1,3,0,1,0,76.14,62.37 ,33.33
03,003,01,001,0049,0,1700,24,1724,2275,0,3,1,3,0,1,0,76.14,75.78 ,33.33
03,003,01,001,0050,0,2699,24,2723,4154,0,3,1,3,0,1,0,76.14,65.55 ,33.33
03,003,01,001,0051,0,3259,41,3300,4763,0,3,1,3,0,1,0,76.14,69.28 ,33.33
03,003,01,001,0052,0,2619,28,2647,3884,0,3,1,3,0,1,0,76.14,68.15 ,33.33
03,003,01,001,0053,0,2517,30,2547,3921,0,3,1,3,0,1,0,76.14,64.96 ,33.33
03,003,01,001,0054,0,2759,32,2791,4163,0,3,1,3,0,1,0,76.14,67.04 ,33.33
03,003,01,001,0055,0,1752,22,1774,2687,0,3,1,3,0,1,0,76.14,66.02 ,33.33
03,003,01,001,0056,0,2018,20,2038,3014,0,3,1,3,0,1,0,76.14,67.62 ,33.33
03,003,01,001,0057,0,992,10,1002,1367,0,3,1,3,0,1,0,76.14,73.30 ,33.33
03,003,01,001,0058,0,1066,15,1081,1614,0,3,1,3,0,1,0,76.14,66.98 ,33.33
03,003,01,001,0059,0,1151,15,1166,1738,0,3,1,3,0,1,0,76.14,67.09 ,33.33
03,003,01,001,0060,0,2850,36,2886,4187,0,3,1,3,0,1,0,76.14,68.93 ,33.33
03,003,01,001,0061,0,2237,25,2262,3217,0,3,1,3,0,1,0,76.14,70.31 ,33.33
03,003,01,001,0062,0,2336,25,2361,3417,0,3,1,3,0,1,0,76.14,69.10 ,33.33
03,003,01,001,0063,0,3626,50,3676,5634,0,3,1,3,0,1,0,76.14,65.25 ,33.33
03,003,01,001,0064,0,3177,36,3213,4974,0,3,1,3,0,1,0,76.14,64.60 ,33.33
03,003,01,001,0065,0,2716,34,2750,4552,0,3,1,3,0,1,0,76.14,60.41 ,33.33
03,003,01,001,0066,0,1295,10,1305,2221,0,3,1,3,0,1,0,76.14,58.76 ,33.33
03,003,01,001,0067,0,2143,30,2173,3437,0,3,1,3,0,1,0,76.14,63.22 ,33.33
03,003,01,001,0068,0,2241,26,2267,3553,0,3,1,3,0,1,0,76.14,63.81 ,33.33
03,003,01,001,0069,0,2199,36,2235,3138,0,3,1,3,0,1,0,76.14,71.22 ,33.33
03,003,01,002,0070,0,3176,58,3234,4674,0,3,1,3,0,1,0,76.14,69.19 ,33.33
03,003,01,002,0071,0,3607,46,3653,5149,0,3,1,3,0,1,0,76.14,70.95 ,33.33
03,003,01,002,0072,0,2715,50,2765,4055,0,3,1,3,0,1,0,76.14,68.19 ,33.33
03,003,01,002,0073,0,3244,61,3305,4988,0,3,1,3,0,1,0,76.14,66.26 ,33.33
03,003,01,002,0074,0,547,8,555,812,0,3,1,3,0,1,0,76.14,68.35 ,33.33
03,003,01,002,0075,0,1290,9,1299,1744,0,3,1,3,0,1,0,76.14,74.48 ,33.33
03,003,01,002,0076,0,1088,20,1108,1705,0,3,1,3,0,1,0,76.14,64.99 ,33.33
03,003,01,002,0077,0,1111,16,1127,2012,0,3,1,3,0,1,0,76.14,56.01 ,33.33
03,003,01,002,0078,0,2191,35,2226,3802,0,3,1,3,0,1,0,76.14,58.55 ,33.33
03,003,01,002,0079,0,1440,29,1469,2406,0,3,1,3,0,1,0,76.14,61.06 ,33.33
03,003,01,002,0080,0,924,15,939,1459,0,3,1,3,0,1,0,76.14,64.36 ,33.33
03,003,01,002,0081,0,1760,28,1788,2977,0,3,1,3,0,1,0,76.14,60.06 ,33.33
03,003,01,002,0082,0,1594,39,1633,2796,0,3,1,3,0,1,0,76.14,58.40 ,33.33
03,003,01,002,0083,0,1207,18,1225,1837,0,3,1,3,0,1,0,76.14,66.68 ,33.33
03,003,01,002,0084,0,3046,36,3082,4688,0,3,1,3,0,1,0,76.14,65.74 ,33.33
03,003,01,002,0085,0,2243,29,2272,3835,0,3,1,3,0,1,0,76.14,59.24 ,33.33
03,003,01,002,0086,0,1757,32,1789,2742,0,3,1,3,0,1,0,76.14,65.24 ,33.33
03,003,01,002,0087,0,2482,51,2533,4007,0,3,1,3,0,1,0,76.14,63.21 ,33.33
03,003,01,002,0088,0,3797,39,3836,6347,0,3,1,3,0,1,0,76.14,60.44 ,33.33
03,003,01,002,0089,0,1408,32,1440,2275,0,3,1,3,0,1,0,76.14,63.30 ,33.33
03,003,01,002,0090,0,1314,20,1334,2358,0,3,1,3,0,1,0,76.14,56.57 ,33.33
03,003,01,002,0091,0,2761,60,2821,4667,0,3,1,3,0,1,0,76.14,60.45 ,33.33
03,003,01,002,0092,0,832,8,840,1289,0,3,1,3,0,1,0,76.14,65.17 ,33.33
03,003,01,002,0093,0,822,12,834,1248,0,3,1,3,0,1,0,76.14,66.83 ,33.33
03,003,01,002,0094,0,786,10,796,1226,0,3,1,3,0,1,0,76.14,64.93 ,33.33
03,003,01,002,0095,0,1822,31,1853,2749,0,3,1,3,0,1,0,76.14,67.41 ,33.33
03,003,01,003,0096,0,2075,35,2110,3238,0,3,1,3,0,1,0,76.14,65.16 ,33.33
03,003,01,003,0097,0,1908,56,1964,2739,0,3,1,3,0,1,0,76.14,71.71 ,33.33
03,003,01,003,0098,0,2180,59,2239,3190,0,3,1,3,0,1,0,76.14,70.19 ,33.33
03,003,01,003,0099,0,1830,30,1860,2779,0,3,1,3,0,1,0,76.14,66.93 ,33.33
03,003,01,003,0100,0,2097,46,2143,3076,0,3,1,3,0,1,0,76.14,69.67 ,33.33
03,003,01,003,0101,0,2157,36,2193,2960,0,3,1,3,0,1,0,76.14,74.09 ,33.33
03,003,01,003,0102,0,1949,38,1987,2803,0,3,1,3,0,1,0,76.14,70.89 ,33.33
03,003,01,003,0103,0,3096,67,3163,4581,0,3,1,3,0,1,0,76.14,69.05 ,33.33
03,003,01,003,0104,0,1999,40,2039,2810,0,3,1,3,0,1,0,76.14,72.56 ,33.33
03,003,01,003,0105,0,1782,40,1822,2691,0,3,1,3,0,1,0,76.14,67.71 ,33.33
03,003,01,003,0106,0,2656,59,2715,3733,0,3,1,3,0,1,0,76.14,72.73 ,33.33
03,003,01,003,0107,0,1733,24,1757,2749,0,3,1,3,0,1,0,76.14,63.91 ,33.33
03,003,01,003,0108,0,2655,44,2699,3989,0,3,1,3,0,1,0,76.14,67.66 ,33.33
03,003,01,003,0109,0,1887,39,1926,2920,0,3,1,3,0,1,0,76.14,65.96 ,33.33
03,003,01,003,0110,0,1306,23,1329,1919,0,3,1,3,0,1,0,76.14,69.25 ,33.33
03,003,01,003,0111,0,1535,24,1559,2285,0,3,1,3,0,1,0,76.14,68.23 ,33.33
03,003,01,003,0112,0,1554,28,1582,2507,0,3,1,3,0,1,0,76.14,63.10 ,33.33
03,003,01,003,0113,0,1047,35,1082,1584,0,3,1,3,0,1,0,76.14,68.31 ,33.33
03,003,01,003,0114,0,2038,42,2080,3021,0,3,1,3,0,1,0,76.14,68.85 ,33.33
03,003,01,003,0115,0,1313,26,1339,1986,0,3,1,3,0,1,0,76.14,67.42 ,33.33
03,003,01,003,0116,0,1514,21,1535,2273,0,3,1,3,0,1,0,76.14,67.53 ,33.33
03,003,01,003,0117,0,969,14,983,1424,0,3,1,3,0,1,0,76.14,69.03 ,33.33
03,003,01,003,0118,0,2687,55,2742,3949,0,3,1,3,0,1,0,76.14,69.44 ,33.33
03,003,01,003,0119,0,2505,41,2546,3714,0,3,1,3,0,1,0,76.14,68.55 ,33.33
03,003,01,003,0120,0,1690,22,1712,2527,0,3,1,3,0,1,0,76.14,67.75 ,33.33
03,003,01,003,0121,0,1775,25,1800,2574,0,3,1,3,0,1,0,76.14,69.93 ,33.33
03,003,01,003,0122,0,1791,29,1820,2415,0,3,1,3,0,1,0,76.14,75.36 ,33.33
03,003,01,003,0123,0,919,11,930,1336,0,3,1,3,0,1,0,76.14,69.61 ,33.33
03,003,01,003,0124,0,2351,45,2396,3343,0,3,1,3,0,1,0,76.14,71.67 ,33.33
03,003,01,003,0125,0,2019,38,2057,3016,0,3,1,3,0,1,0,76.14,68.20 ,33.33
03,003,01,003,0126,0,1210,23,1233,1805,0,3,1,3,0,1,0,76.14,68.31 ,33.33
03,003,01,003,0127,0,2974,45,3019,4267,0,3,1,3,0,1,0,76.14,70.75 ,33.33
03,003,01,003,0128,0,1776,18,1794,2531,0,3,1,3,0,1,0,76.14,70.88 ,33.33
03,003,01,003,0129,0,2218,22,2240,3247,0,3,1,3,0,1,0,76.14,68.99 ,33.33
03,003,01,003,0130,0,1620,41,1661,2443,0,3,1,3,0,1,0,76.14,67.99 ,33.33
03,003,01,003,0131,0,1435,21,1456,2167,0,3,1,3,0,1,0,76.14,67.19 ,33.33
03,003,01,003,0132,0,967,17,984,1472,0,3,1,3,0,1,0,76.14,66.85 ,33.33
03,003,01,003,0133,0,2565,58,2623,3866,0,3,1,3,0,1,0,76.14,67.85 ,33.33
03,003,01,003,0134,0,2935,121,3056,5350,0,3,1,3,0,1,0,76.14,57.12 ,33.33
03,003,01,004,0135,0,2130,41,2171,3126,0,3,1,3,0,1,0,76.14,69.45 ,33.33
03,003,01,004,0136,0,2161,32,2193,3159,0,3,1,3,0,1,0,76.14,69.42 ,33.33
03,003,01,004,0137,0,2011,33,2044,2839,0,3,1,3,0,1,0,76.14,72.00 ,33.33
03,003,01,004,0138,0,1392,23,1415,2051,0,3,1,3,0,1,0,76.14,68.99 ,33.33
03,003,01,004,0139,0,1453,30,1483,2099,0,3,1,3,0,1,0,76.14,70.65 ,33.33
03,003,01,004,0140,0,1751,22,1773,2542,0,3,1,3,0,1,0,76.14,69.75 ,33.33
03,003,01,004,0141,0,744,7,751,1036,0,3,1,3,0,1,0,76.14,72.49 ,33.33
03,003,01,004,0142,0,1230,22,1252,1655,0,3,1,3,0,1,0,76.14,75.65 ,33.33
03,003,01,004,0143,0,2091,28,2119,2841,0,3,1,3,0,1,0,76.14,74.59 ,33.33
03,003,01,004,0144,0,4266,62,4328,6992,0,3,1,3,0,1,0,76.14,61.90 ,33.33
03,003,01,004,0145,0,1386,23,1409,2252,0,3,1,3,0,1,0,76.14,62.57 ,33.33
03,003,01,004,0146,0,1552,32,1584,2432,0,3,1,3,0,1,0,76.14,65.13 ,33.33
03,003,01,004,0147,0,1773,24,1797,2669,0,3,1,3,0,1,0,76.14,67.33 ,33.33
03,003,01,004,0148,0,1143,15,1158,1750,0,3,1,3,0,1,0,76.14,66.17 ,33.33
03,003,01,004,0149,0,1009,21,1030,1608,0,3,1,3,0,1,0,76.14,64.05 ,33.33
03,003,01,004,0150,0,1870,17,1887,3041,0,3,1,3,0,1,0,76.14,62.05 ,33.33
03,003,01,004,0151,0,2736,22,2758,4322,0,3,1,3,0,1,0,76.14,63.81 ,33.33
03,003,01,004,0152,0,1857,26,1883,2996,0,3,1,3,0,1,0,76.14,62.85 ,33.33
03,003,01,004,0153,0,794,10,804,1458,0,3,1,3,0,1,0,76.14,55.14 ,33.33
03,003,01,004,0154,0,1260,28,1288,1822,0,3,1,3,0,1,0,76.14,70.69 ,33.33
03,003,01,004,0155,0,954,16,970,1388,0,3,1,3,0,1,0,76.14,69.88 ,33.33
03,003,01,004,0156,0,2124,46,2170,3112,0,3,1,3,0,1,0,76.14,69.73 ,33.33
03,003,01,004,0157,0,889,16,905,1241,0,3,1,3,0,1,0,76.14,72.93 ,33.33
03,003,01,004,0158,0,1109,23,1132,1568,0,3,1,3,0,1,0,76.14,72.19 ,33.33
03,003,01,004,0159,0,1437,23,1460,2085,0,3,1,3,0,1,0,76.14,70.02 ,33.33
03,003,01,004,0160,0,2201,31,2232,3598,0,3,1,3,0,1,0,76.14,62.03 ,33.33
03,003,01,005,0161,0,3570,55,3625,4911,0,3,1,3,0,1,0,76.14,73.81 ,33.33
03,003,01,005,0162,0,2781,44,2825,4049,0,3,1,3,0,1,0,76.14,69.77 ,33.33
03,003,01,005,0163,0,2088,35,2123,3058,0,3,1,3,0,1,0,76.14,69.42 ,33.33
03,003,01,005,0164,0,987,9,996,1383,0,3,1,3,0,1,0,76.14,72.02 ,33.33
03,003,01,005,0165,0,3218,38,3256,4757,0,3,1,3,0,1,0,76.14,68.45 ,33.33
03,003,01,005,0166,0,2510,46,2556,3628,0,3,1,3,0,1,0,76.14,70.45 ,33.33
03,003,01,005,0167,0,2877,41,2918,4167,0,3,1,3,0,1,0,76.14,70.03 ,33.33
03,003,01,005,0168,0,934,19,953,1258,0,3,1,3,0,1,0,76.14,75.76 ,33.33
03,003,01,005,0169,0,681,14,695,939,0,3,1,3,0,1,0,76.14,74.01 ,33.33
03,003,01,005,0170,0,1742,30,1772,2429,0,3,1,3,0,1,0,76.14,72.95 ,33.33
03,003,01,005,0171,0,2732,57,2789,4157,0,3,1,3,0,1,0,76.14,67.09 ,33.33
03,003,01,005,0172,0,1493,12,1505,2206,0,3,1,3,0,1,0,76.14,68.22 ,33.33
03,003,01,005,0173,0,864,15,879,1333,0,3,1,3,0,1,0,76.14,65.94 ,33.33
03,003,01,005,0174,0,1642,22,1664,2492,0,3,1,3,0,1,0,76.14,66.77 ,33.33
03,003,01,005,0175,0,1156,12,1168,1627,0,3,1,3,0,1,0,76.14,71.79 ,33.33
03,003,01,005,0176,0,1313,20,1333,1881,0,3,1,3,0,1,0,76.14,70.87 ,33.33
03,003,01,005,0177,0,1218,17,1235,1714,0,3,1,3,0,1,0,76.14,72.05 ,33.33
03,003,01,005,0178,0,1467,13,1480,2199,0,3,1,3,0,1,0,76.14,67.30 ,33.33
03,003,01,005,0179,0,1434,20,1454,2469,0,3,1,3,0,1,0,76.14,58.89 ,33.33
03,003,01,006,0180,0,1184,15,1199,1631,0,3,1,3,0,1,0,76.14,73.51 ,33.33
03,003,01,006,0181,0,750,4,754,1111,0,3,1,3,0,1,0,76.14,67.87 ,33.33
03,003,01,006,0182,0,2359,31,2390,3524,0,3,1,3,0,1,0,76.14,67.82 ,33.33
03,003,01,006,0183,0,2149,22,2171,3133,0,3,1,3,0,1,0,76.14,69.29 ,33.33
03,003,01,006,0184,0,2554,32,2586,3797,0,3,1,3,0,1,0,76.14,68.11 ,33.33
03,003,01,006,0185,0,733,12,745,1012,0,3,1,3,0,1,0,76.14,73.62 ,33.33
03,003,01,006,0186,0,574,19,593,898,0,3,1,3,0,1,0,76.14,66.04 ,33.33
03,003,01,006,0187,0,708,11,719,995,0,3,1,3,0,1,0,76.14,72.26 ,33.33
03,003,01,006,0188,0,1090,16,1106,1545,0,3,1,3,0,1,0,76.14,71.59 ,33.33
03,003,01,006,0189,0,1815,14,1829,2633,0,3,1,3,0,1,0,76.14,69.46 ,33.33
03,003,01,006,0190,0,1411,29,1440,2110,0,3,1,3,0,1,0,76.14,68.25 ,33.33
03,003,01,006,0191,0,604,12,616,916,0,3,1,3,0,1,0,76.14,67.25 ,33.33
03,003,01,006,0192,0,607,12,619,940,0,3,1,3,0,1,0,76.14,65.85 ,33.33
03,003,01,006,0193,0,1105,23,1128,1542,0,3,1,3,0,1,0,76.14,73.15 ,33.33
03,003,01,006,0194,0,1420,25,1445,2041,0,3,1,3,0,1,0,76.14,70.80 ,33.33
03,003,01,006,0195,0,1576,26,1602,2352,0,3,1,3,0,1,0,76.14,68.11 ,33.33
03,003,01,006,0196,0,580,7,587,821,0,3,1,3,0,1,0,76.14,71.50 ,33.33
03,003,01,006,0197,0,1917,39,1956,2641,0,3,1,3,0,1,0,76.14,74.06 ,33.33
03,003,01,006,0198,0,1225,22,1247,1928,0,3,1,3,0,1,0,76.14,64.68 ,33.33
03,003,01,006,0199,0,1218,14,1232,1770,0,3,1,3,0,1,0,76.14,69.60 ,33.33
03,003,01,006,0200,0,1823,21,1844,2535,0,3,1,3,0,1,0,76.14,72.74 ,33.33
03,003,01,006,0201,0,1914,34,1948,2819,0,3,1,3,0,1,0,76.14,69.10 ,33.33
03,003,01,006,0202,0,2594,42,2636,3765,0,3,1,3,0,1,0,76.14,70.01 ,33.33
03,003,01,006,0203,0,770,11,781,1127,0,3,1,3,0,1,0,76.14,69.30 ,33.33
03,003,01,006,0204,0,1127,22,1149,1740,0,3,1,3,0,1,0,76.14,66.03 ,33.33
03,003,01,006,0205,0,1960,32,1992,2863,0,3,1,3,0,1,0,76.14,69.58 ,33.33
03,003,01,006,0206,0,2004,24,2028,2922,0,3,1,3,0,1,0,76.14,69.40 ,33.33
03,003,01,007,0207,0,779,18,797,1168,0,3,1,3,0,1,0,76.14,68.24 ,33.33
03,003,01,007,0208,0,451,5,456,638,0,3,1,3,0,1,0,76.14,71.47 ,33.33
03,003,01,007,0209,0,30,2,32,45,0,3,1,3,0,1,0,76.14,71.11 ,33.33
03,003,01,007,0210,0,29,1,30,45,0,3,1,3,0,1,0,76.14,66.67 ,33.33
03,003,01,007,0211,0,191,3,194,310,0,3,1,3,0,1,0,76.14,62.58 ,33.33
03,003,01,007,0212,0,19,0,19,43,0,3,1,3,0,1,0,76.14,44.19 ,33.33
03,003,01,007,0213,0,62,2,64,95,0,3,1,3,0,1,0,76.14,67.37 ,33.33
03,003,01,007,0214,0,27,1,28,50,0,3,1,3,0,1,0,76.14,56.00 ,33.33
03,003,01,007,0215,0,22,0,22,46,0,3,1,3,0,1,0,76.14,47.83 ,33.33
03,003,01,007,0216,0,158,2,160,301,0,3,1,3,0,1,0,76.14,53.16 ,33.33
03,003,01,008,0217,0,1915,23,1938,2990,0,3,1,3,0,1,0,76.14,64.82 ,33.33
03,003,01,008,0218,0,2156,25,2181,3145,0,3,1,3,0,1,0,76.14,69.35 ,33.33
03,003,01,008,0219,0,2648,39,2687,4047,0,3,1,3,0,1,0,76.14,66.39 ,33.33
03,003,01,008,0220,0,2338,33,2371,3373,0,3,1,3,0,1,0,76.14,70.29 ,33.33
03,003,01,008,0221,0,1950,31,1981,2744,0,3,1,3,0,1,0,76.14,72.19 ,33.33
03,003,01,008,0222,0,2572,40,2612,3695,0,3,1,3,0,1,0,76.14,70.69 ,33.33
03,003,01,008,0223,0,2861,56,2917,4051,0,3,1,3,0,1,0,76.14,72.01 ,33.33
03,003,01,008,0224,0,3006,71,3077,4335,0,3,1,3,0,1,0,76.14,70.98 ,33.33
03,003,01,008,0225,0,2051,36,2087,2846,0,3,1,3,0,1,0,76.14,73.33 ,33.33
03,003,01,008,0226,0,1751,29,1780,2396,0,3,1,3,0,1,0,76.14,74.29 ,33.33
03,003,01,008,0227,0,2299,37,2336,3259,0,3,1,3,0,1,0,76.14,71.68 ,33.33
03,003,01,008,0228,0,2410,39,2449,3532,0,3,1,3,0,1,0,76.14,69.34 ,33.33
03,003,01,008,0229,0,2614,44,2658,3754,0,3,1,3,0,1,0,76.14,70.80 ,33.33
03,003,01,008,0230,0,3040,50,3090,4450,0,3,1,3,0,1,0,76.14,69.44 ,33.33
03,003,01,008,0231,0,1759,27,1786,2574,0,3,1,3,0,1,0,76.14,69.39 ,33.33
03,003,01,008,0232,0,1977,31,2008,2753,0,3,1,3,0,1,0,76.14,72.94 ,33.33
03,003,01,008,0233,0,2790,67,2857,4025,0,3,1,3,0,1,0,76.14,70.98 ,33.33
03,003,01,008,0234,0,2038,36,2074,3105,0,3,1,3,0,1,0,76.14,66.80 ,33.33
03,003,01,008,0235,0,1480,16,1496,2328,0,3,1,3,0,1,0,76.14,64.26 ,33.33
03,003,01,008,0236,0,1981,23,2004,2723,0,3,1,3,0,1,0,76.14,73.60 ,33.33
03,003,01,008,0237,0,2062,22,2084,2910,0,3,1,3,0,1,0,76.14,71.62 ,33.33
03,003,01,008,0238,0,2197,33,2230,3182,0,3,1,3,0,1,0,76.14,70.08 ,33.33
03,003,01,008,0239,0,1631,21,1652,2251,0,3,1,3,0,1,0,76.14,73.39 ,33.33
03,003,01,008,0240,0,1218,21,1239,1783,0,3,1,3,0,1,0,76.14,69.49 ,33.33
03,003,01,008,0241,0,1507,18,1525,2185,0,3,1,3,0,1,0,76.14,69.79 ,33.33
03,003,01,008,0242,0,1551,27,1578,2325,0,3,1,3,0,1,0,76.14,67.87 ,33.33
03,003,01,008,0243,0,1013,15,1028,1476,0,3,1,3,0,1,0,76.14,69.65 ,33.33
03,003,01,008,0244,0,2543,32,2575,3644,0,3,1,3,0,1,0,76.14,70.66 ,33.33
03,003,01,008,0245,0,2249,31,2280,3348,0,3,1,3,0,1,0,76.14,68.10 ,33.33
03,003,01,008,0246,0,2864,42,2906,4395,0,3,1,3,0,1,0,76.14,66.12 ,33.33
03,003,01,008,0247,0,1067,14,1081,1572,0,3,1,3,0,1,0,76.14,68.77 ,33.33
03,003,01,008,0248,0,1655,18,1673,2474,0,3,1,3,0,1,0,76.14,67.62 ,33.33
03,003,01,008,0249,0,3073,43,3116,4554,0,3,1,3,0,1,0,76.14,68.42 ,33.33
03,003,01,008,0250,0,1618,27,1645,2406,0,3,1,3,0,1,0,76.14,68.37 ,33.33
03,003,01,008,0251,0,1874,21,1895,2761,0,3,1,3,0,1,0,76.14,68.63 ,33.33
03,003,01,008,0252,0,1739,21,1760,2461,0,3,1,3,0,1,0,76.14,71.52 ,33.33
03,003,01,008,0253,0,2534,44,2578,3597,0,3,1,3,0,1,0,76.14,71.67 ,33.33
03,003,01,008,0254,0,1337,25,1362,1945,0,3,1,3,0,1,0,76.14,70.03 ,33.33
03,003,01,008,0255,0,2616,36,2652,4040,0,3,1,3,0,1,0,76.14,65.64 ,33.33
03,003,01,008,0256,0,2354,32,2386,3308,0,3,1,3,0,1,0,76.14,72.13 ,33.33
03,003,01,008,0257,0,3058,47,3105,4477,0,3,1,3,0,1,0,76.14,69.35 ,33.33
03,003,01,008,0258,0,1302,24,1326,1884,0,3,1,3,0,1,0,76.14,70.38 ,33.33
03,003,01,008,0259,0,2163,25,2188,3077,0,3,1,3,0,1,0,76.14,71.11 ,33.33
03,003,01,008,0260,0,1146,14,1160,2023,0,3,1,3,0,1,0,76.14,57.34 ,33.33
03,003,01,008,0261,0,2276,27,2303,3312,0,3,1,3,0,1,0,76.14,69.54 ,33.33
03,003,01,008,0262,0,3747,57,3804,5616,0,3,1,3,0,1,0,76.14,67.74 ,33.33
03,003,01,008,0263,0,2646,35,2681,3791,0,3,1,3,0,1,0,76.14,70.72 ,33.33
03,003,01,008,0264,0,3594,53,3647,5227,0,3,1,3,0,1,0,76.14,69.77 ,33.33
03,003,01,008,0265,0,3390,42,3432,4868,0,3,1,3,0,1,0,76.14,70.50 ,33.33
03,003,01,008,0266,0,3510,61,3571,5018,0,3,1,3,0,1,0,76.14,71.16 ,33.33
03,003,01,008,0267,0,2566,24,2590,3906,0,3,1,3,0,1,0,76.14,66.31 ,33.33
03,003,01,008,0268,0,2707,30,2737,3992,0,3,1,3,0,1,0,76.14,68.56 ,33.33
03,003,01,008,0269,0,762,9,771,1088,0,3,1,3,0,1,0,76.14,70.86 ,33.33
03,003,01,008,0270,0,1251,6,1257,1858,0,3,1,3,0,1,0,76.14,67.65 ,33.33
03,003,01,008,0271,0,1091,8,1099,1640,0,3,1,3,0,1,0,76.14,67.01 ,33.33
03,003,01,008,0272,0,3087,36,3123,4499,0,3,1,3,0,1,0,76.14,69.42 ,33.33
03,003,01,008,0273,0,1747,16,1763,2456,0,3,1,3,0,1,0,76.14,71.78 ,33.33
03,003,01,008,0274,0,707,16,723,1014,0,3,1,3,0,1,0,76.14,71.30 ,33.33
03,003,01,008,0275,0,590,6,596,838,0,3,1,3,0,1,0,76.14,71.12 ,33.33
03,003,01,008,0276,0,654,5,659,996,0,3,1,3,0,1,0,76.14,66.16 ,33.33
03,003,01,008,0277,0,715,6,721,1100,0,3,1,3,0,1,0,76.14,65.55 ,33.33
03,003,01,008,0278,0,1520,18,1538,2127,0,3,1,3,0,1,0,76.14,72.31 ,33.33
03,003,01,008,0279,0,2471,37,2508,3530,0,3,1,3,0,1,0,76.14,71.05 ,33.33
03,003,01,008,0280,0,2937,37,2974,4319,0,3,1,3,0,1,0,76.14,68.86 ,33.33
03,003,01,008,0281,0,2199,26,2225,3183,0,3,1,3,0,1,0,76.14,69.90 ,33.33
03,003,01,008,0282,0,1747,34,1781,2501,0,3,1,3,0,1,0,76.14,71.21 ,33.33
03,003,01,008,0283,0,2604,44,2648,3930,0,3,1,3,0,1,0,76.14,67.38 ,33.33
03,003,01,008,0284,0,2182,25,2207,3213,0,3,1,3,0,1,0,76.14,68.69 ,33.33
03,003,01,008,0285,0,1405,21,1426,1961,0,3,1,3,0,1,0,76.14,72.72 ,33.33
03,003,01,008,0286,0,818,12,830,1216,0,3,1,3,0,1,0,76.14,68.26 ,33.33
03,003,01,008,0287,0,2341,22,2363,3395,0,3,1,3,0,1,0,76.14,69.60 ,33.33
03,003,01,008,0288,0,2172,29,2201,2987,0,3,1,3,0,1,0,76.14,73.69 ,33.33
03,003,01,008,0289,0,1956,38,1994,2737,0,3,1,3,0,1,0,76.14,72.85 ,33.33
03,003,01,008,0290,0,1711,20,1731,2322,0,3,1,3,0,1,0,76.14,74.55 ,33.33
03,003,01,009,0291,0,2300,39,2339,3372,0,3,1,3,0,1,0,76.14,69.37 ,33.33
03,003,01,009,0292,0,2487,38,2525,3749,0,3,1,3,0,1,0,76.14,67.35 ,33.33
03,003,01,009,0293,0,3144,34,3178,4724,0,3,1,3,0,1,0,76.14,67.27 ,33.33
03,003,01,009,0294,0,1784,26,1810,2523,0,3,1,3,0,1,0,76.14,71.74 ,33.33
03,003,01,009,0295,0,1116,13,1129,1574,0,3,1,3,0,1,0,76.14,71.73 ,33.33
03,003,01,009,0296,0,1564,29,1593,2285,0,3,1,3,0,1,0,76.14,69.72 ,33.33
03,003,01,009,0297,0,1538,25,1563,2217,0,3,1,3,0,1,0,76.14,70.50 ,33.33
03,003,01,009,0298,0,1166,17,1183,1597,0,3,1,3,0,1,0,76.14,74.08 ,33.33
03,003,01,009,0299,0,2418,36,2454,3462,0,3,1,3,0,1,0,76.14,70.88 ,33.33
03,003,01,009,0300,0,2017,37,2054,2878,0,3,1,3,0,1,0,76.14,71.37 ,33.33
03,003,01,009,0301,0,2054,30,2084,2942,0,3,1,3,0,1,0,76.14,70.84 ,33.33
03,003,01,009,0302,0,1693,32,1725,2520,0,3,1,3,0,1,0,76.14,68.45 ,33.33
03,003,01,009,0303,0,2147,24,2171,3043,0,3,1,3,0,1,0,76.14,71.34 ,33.33
03,003,01,009,0304,0,1497,32,1529,2157,0,3,1,3,0,1,0,76.14,70.89 ,33.33
03,003,01,009,0305,0,893,26,919,1282,0,3,1,3,0,1,0,76.14,71.68 ,33.33
03,003,01,009,0306,0,899,16,915,1264,0,3,1,3,0,1,0,76.14,72.39 ,33.33
03,003,01,009,0307,0,1655,15,1670,2223,0,3,1,3,0,1,0,76.14,75.12 ,33.33
03,003,01,009,0308,0,2272,45,2317,3277,0,3,1,3,0,1,0,76.14,70.70 ,33.33
03,003,01,009,0309,0,2157,27,2184,3053,0,3,1,3,0,1,0,76.14,71.54 ,33.33
03,003,01,009,0310,0,1887,30,1917,2809,0,3,1,3,0,1,0,76.14,68.24 ,33.33
03,003,01,009,0311,0,1507,31,1538,2145,0,3,1,3,0,1,0,76.14,71.70 ,33.33
03,003,01,009,0312,0,2556,47,2603,3683,0,3,1,3,0,1,0,76.14,70.68 ,33.33
03,003,01,009,0313,0,2695,49,2744,3875,0,3,1,3,0,1,0,76.14,70.81 ,33.33
03,003,01,009,0314,0,1373,20,1393,1942,0,3,1,3,0,1,0,76.14,71.73 ,33.33
03,003,01,009,0315,0,1573,28,1601,2209,0,3,1,3,0,1,0,76.14,72.48 ,33.33
03,003,01,009,0316,0,936,16,952,1365,0,3,1,3,0,1,0,76.14,69.74 ,33.33
03,003,01,009,0317,0,3035,37,3072,4369,0,3,1,3,0,1,0,76.14,70.31 ,33.33
03,003,01,009,0318,0,1785,48,1833,2729,0,3,1,3,0,1,0,76.14,67.17 ,33.33
03,003,01,009,0319,0,2503,35,2538,3695,0,3,1,3,0,1,0,76.14,68.69 ,33.33
03,003,01,009,0320,0,2016,29,2045,2952,0,3,1,3,0,1,0,76.14,69.28 ,33.33
03,003,01,009,0321,0,4082,47,4129,5969,0,3,1,3,0,1,0,76.14,69.17 ,33.33
03,003,01,009,0322,0,3304,49,3353,4686,0,3,1,3,0,1,0,76.14,71.55 ,33.33
03,003,01,009,0323,0,2087,26,2113,3183,0,3,1,3,0,1,0,76.14,66.38 ,33.33
03,003,01,009,0324,0,3164,61,3225,5084,0,3,1,3,0,1,0,76.14,63.43 ,33.33
03,003,01,009,0325,0,2201,44,2245,3411,0,3,1,3,0,1,0,76.14,65.82 ,33.33
03,003,01,009,0326,0,2490,49,2539,3601,0,3,1,3,0,1,0,76.14,70.51 ,33.33
03,003,01,009,0327,0,1847,30,1877,2633,0,3,1,3,0,1,0,76.14,71.29 ,33.33
03,003,01,009,0328,0,2152,44,2196,3125,0,3,1,3,0,1,0,76.14,70.27 ,33.33
03,003,01,009,0329,0,1539,33,1572,2206,0,3,1,3,0,1,0,76.14,71.26 ,33.33
03,003,01,009,0330,0,5295,105,5400,7974,0,3,1,3,0,1,0,76.14,67.72 ,33.33
03,003,01,009,0331,0,2284,38,2322,3371,0,3,1,3,0,1,0,76.14,68.88 ,33.33
03,003,01,010,0332,0,2602,53,2655,3782,0,3,1,3,0,1,0,76.14,70.20 ,33.33
03,003,01,010,0333,0,1049,13,1062,1479,0,3,1,3,0,1,0,76.14,71.81 ,33.33
03,003,01,010,0334,0,1847,28,1875,2567,0,3,1,3,0,1,0,76.14,73.04 ,33.33
03,003,01,010,0335,0,997,11,1008,1317,0,3,1,3,0,1,0,76.14,76.54 ,33.33
03,003,01,010,0336,0,1339,19,1358,1869,0,3,1,3,0,1,0,76.14,72.66 ,33.33
03,003,01,010,0337,0,815,23,838,1330,0,3,1,3,0,1,0,76.14,63.01 ,33.33
03,003,01,010,0338,0,2310,38,2348,3568,0,3,1,3,0,1,0,76.14,65.81 ,33.33
03,003,01,010,0339,0,1456,25,1481,2310,0,3,1,3,0,1,0,76.14,64.11 ,33.33
03,003,01,010,0340,0,1656,29,1685,2627,0,3,1,3,0,1,0,76.14,64.14 ,33.33
03,003,01,010,0341,0,2059,23,2082,3344,0,3,1,3,0,1,0,76.14,62.26 ,33.33
03,003,01,010,0342,0,1727,26,1753,2570,0,3,1,3,0,1,0,76.14,68.21 ,33.33
03,003,01,010,0343,0,1805,21,1826,3025,0,3,1,3,0,1,0,76.14,60.36 ,33.33
03,003,01,010,0344,0,1911,31,1942,2815,0,3,1,3,0,1,0,76.14,68.99 ,33.33
03,003,01,010,0345,0,1320,11,1331,1998,0,3,1,3,0,1,0,76.14,66.62 ,33.33
03,003,01,010,0346,0,2026,25,2051,2802,0,3,1,3,0,1,0,76.14,73.20 ,33.33
03,003,01,010,0347,0,807,7,814,1206,0,3,1,3,0,1,0,76.14,67.50 ,33.33
03,003,01,010,0348,0,1073,21,1094,1561,0,3,1,3,0,1,0,76.14,70.08 ,33.33
03,003,01,010,0349,0,1453,21,1474,2115,0,3,1,3,0,1,0,76.14,69.69 ,33.33
03,003,01,010,0350,0,2327,57,2384,3408,0,3,1,3,0,1,0,76.14,69.95 ,33.33
03,003,01,010,0351,0,1955,33,1988,2883,0,3,1,3,0,1,0,76.14,68.96 ,33.33
03,003,01,010,0352,0,1813,38,1851,2677,0,3,1,3,0,1,0,76.14,69.14 ,33.33
03,003,01,010,0353,0,1438,33,1471,2176,0,3,1,3,0,1,0,76.14,67.60 ,33.33
03,003,01,010,0354,0,2026,39,2065,2911,0,3,1,3,0,1,0,76.14,70.94 ,33.33
03,003,01,010,0355,0,2815,40,2855,4022,0,3,1,3,0,1,0,76.14,70.98 ,33.33
03,003,01,010,0356,0,1210,23,1233,1736,0,3,1,3,0,1,0,76.14,71.03 ,33.33
03,003,01,010,0357,0,1818,32,1850,2966,0,3,1,3,0,1,0,76.14,62.37 ,33.33
03,003,01,010,0358,0,1976,41,2017,3061,0,3,1,3,0,1,0,76.14,65.89 ,33.33
03,003,01,010,0359,0,1507,18,1525,2179,0,3,1,3,0,1,0,76.14,69.99 ,33.33
03,003,01,010,0360,0,2340,42,2382,3543,0,3,1,3,0,1,0,76.14,67.23 ,33.33
03,003,01,010,0361,0,915,26,941,1622,0,3,1,3,0,1,0,76.14,58.01 ,33.33
03,003,01,010,0362,0,1393,22,1415,2045,0,3,1,3,0,1,0,76.14,69.19 ,33.33
03,003,01,010,0363,0,1044,15,1059,1449,0,3,1,3,0,1,0,76.14,73.08 ,33.33
03,003,01,010,0364,0,1423,22,1445,2097,0,3,1,3,0,1,0,76.14,68.91 ,33.33
03,003,01,010,0365,0,2056,34,2090,3031,0,3,1,3,0,1,0,76.14,68.95 ,33.33
03,003,01,010,0366,0,1953,38,1991,2909,0,3,1,3,0,1,0,76.14,68.44 ,33.33
03,003,01,011,0367,0,3664,76,3740,5657,0,3,1,3,0,1,0,76.14,66.11 ,33.33
03,003,01,011,0368,0,2627,38,2665,3687,0,3,1,3,0,1,0,76.14,72.28 ,33.33
03,003,01,011,0369,0,4293,63,4356,6625,0,3,1,3,0,1,0,76.14,65.75 ,33.33
03,003,01,011,0370,0,460,15,475,628,0,3,1,3,0,1,0,76.14,75.64 ,33.33
03,003,01,011,0371,0,3375,53,3428,5043,0,3,1,3,0,1,0,76.14,67.98 ,33.33
03,003,01,011,0372,0,3393,49,3442,5094,0,3,1,3,0,1,0,76.14,67.57 ,33.33
03,003,01,011,0373,0,1741,34,1775,2680,0,3,1,3,0,1,0,76.14,66.23 ,33.33
03,003,01,011,0374,0,1450,18,1468,1995,0,3,1,3,0,1,0,76.14,73.58 ,33.33
03,003,01,011,0375,0,5004,86,5090,7273,0,3,1,3,0,1,0,76.14,69.98 ,33.33
03,003,01,011,0376,0,2832,48,2880,4519,0,3,1,3,0,1,0,76.14,63.73 ,33.33
03,003,01,011,0377,0,5309,110,5419,7984,0,3,1,3,0,1,0,76.14,67.87 ,33.33
03,003,01,011,0378,0,2201,31,2232,3097,0,3,1,3,0,1,0,76.14,72.07 ,33.33
03,003,01,011,0379,0,879,12,891,1293,0,3,1,3,0,1,0,76.14,68.91 ,33.33
03,003,01,011,0380,0,665,3,668,964,0,3,1,3,0,1,0,76.14,69.29 ,33.33
03,003,01,011,0381,0,5192,58,5250,7463,0,3,1,3,0,1,0,76.14,70.35 ,33.33
03,003,01,011,0382,0,1574,34,1608,2398,0,3,1,3,0,1,0,76.14,67.06 ,33.33
03,003,01,011,0383,0,1695,22,1717,2671,0,3,1,3,0,1,0,76.14,64.28 ,33.33
03,003,01,011,0384,0,710,8,718,1035,0,3,1,3,0,1,0,76.14,69.37 ,33.33
03,003,01,011,0385,0,488,12,500,659,0,3,1,3,0,1,0,76.14,75.87 ,33.33
03,003,01,012,0386,0,1697,19,1716,2303,0,3,1,3,0,1,0,76.14,74.51 ,33.33
03,003,01,012,0387,0,2200,22,2222,2910,0,3,1,3,0,1,0,76.14,76.36 ,33.33
03,003,01,012,0388,0,887,8,895,1194,0,3,1,3,0,1,0,76.14,74.96 ,33.33
03,003,01,012,0389,0,2022,31,2053,2860,0,3,1,3,0,1,0,76.14,71.78 ,33.33
03,003,01,012,0390,0,1221,12,1233,1644,0,3,1,3,0,1,0,76.14,75.00 ,33.33
03,003,01,012,0391,0,831,14,845,1120,0,3,1,3,0,1,0,76.14,75.45 ,33.33
03,003,01,012,0392,0,1023,12,1035,1341,0,3,1,3,0,1,0,76.14,77.18 ,33.33
03,003,01,012,0393,0,1454,26,1480,1990,0,3,1,3,0,1,0,76.14,74.37 ,33.33
03,003,01,012,0394,0,1202,21,1223,1744,0,3,1,3,0,1,0,76.14,70.13 ,33.33
03,003,01,012,0395,0,1976,26,2002,2726,0,3,1,3,0,1,0,76.14,73.44 ,33.33
03,003,01,012,0396,0,964,12,976,1329,0,3,1,3,0,1,0,76.14,73.44 ,33.33
03,003,01,012,0397,0,1110,8,1118,1452,0,3,1,3,0,1,0,76.14,77.00 ,33.33
03,003,01,012,0398,0,758,14,772,1126,0,3,1,3,0,1,0,76.14,68.56 ,33.33
03,003,01,012,0399,0,549,2,551,835,0,3,1,3,0,1,0,76.14,65.99 ,33.33
03,003,01,012,0400,0,467,6,473,667,0,3,1,3,0,1,0,76.14,70.91 ,33.33
03,003,01,012,0401,0,795,13,808,1070,0,3,1,3,0,1,0,76.14,75.51 ,33.33
03,003,01,012,0402,0,768,16,784,1032,0,3,1,3,0,1,0,76.14,75.97 ,33.33
03,003,01,012,0403,0,1648,22,1670,2184,0,3,1,3,0,1,0,76.14,76.47 ,33.33
03,003,01,012,0404,0,653,6,659,910,0,3,1,3,0,1,0,76.14,72.42 ,33.33
03,003,01,012,0405,0,538,8,546,697,0,3,1,3,0,1,0,76.14,78.34 ,33.33
03,003,01,012,0406,0,626,6,632,811,0,3,1,3,0,1,0,76.14,77.93 ,33.33
03,003,01,012,0407,0,1124,11,1135,1512,0,3,1,3,0,1,0,76.14,75.07 ,33.33
03,003,01,012,0408,0,775,11,786,1036,0,3,1,3,0,1,0,76.14,75.87 ,33.33
03,003,01,013,0409,0,1731,25,1756,2402,0,3,1,3,0,1,0,76.14,73.11 ,33.33
03,003,01,013,0410,0,860,11,871,1140,0,3,1,3,0,1,0,76.14,76.40 ,33.33
03,003,01,013,0411,0,897,22,919,1291,0,3,1,3,0,1,0,76.14,71.19 ,33.33
03,003,01,013,0412,0,794,9,803,1073,0,3,1,3,0,1,0,76.14,74.84 ,33.33
03,003,01,013,0413,0,1036,9,1045,1401,0,3,1,3,0,1,0,76.14,74.59 ,33.33
03,003,01,013,0414,0,469,10,479,643,0,3,1,3,0,1,0,76.14,74.49 ,33.33
03,003,01,013,0415,0,562,4,566,745,0,3,1,3,0,1,0,76.14,75.97 ,33.33
03,003,01,013,0416,0,502,11,513,670,0,3,1,3,0,1,0,76.14,76.57 ,33.33
03,003,01,013,0417,0,836,25,861,1181,0,3,1,3,0,1,0,76.14,72.90 ,33.33
03,003,01,013,0418,0,1263,31,1294,1842,0,3,1,3,0,1,0,76.14,70.25 ,33.33
03,003,01,013,0419,0,1350,14,1364,1869,0,3,1,3,0,1,0,76.14,72.98 ,33.33
03,003,01,013,0420,0,1204,17,1221,1663,0,3,1,3,0,1,0,76.14,73.42 ,33.33
03,003,01,013,0421,0,687,5,692,979,0,3,1,3,0,1,0,76.14,70.68 ,33.33
03,003,01,013,0422,0,2342,42,2384,3396,0,3,1,3,0,1,0,76.14,70.20 ,33.33
03,003,01,013,0423,0,1232,13,1245,1771,0,3,1,3,0,1,0,76.14,70.30 ,33.33
03,003,01,013,0424,0,1131,14,1145,1663,0,3,1,3,0,1,0,76.14,68.85 ,33.33
03,003,01,013,0425,0,1849,17,1866,2534,0,3,1,3,0,1,0,76.14,73.64 ,33.33
03,003,01,013,0426,0,1343,14,1357,1758,0,3,1,3,0,1,0,76.14,77.19 ,33.33
03,003,01,013,0427,0,686,9,695,949,0,3,1,3,0,1,0,76.14,73.23 ,33.33
03,003,01,013,0428,0,1216,21,1237,1752,0,3,1,3,0,1,0,76.14,70.61 ,33.33
03,003,01,013,0429,0,2185,35,2220,3079,0,3,1,3,0,1,0,76.14,72.10 ,33.33
03,003,01,013,0430,0,1063,12,1075,1555,0,3,1,3,0,1,0,76.14,69.13 ,33.33
03,003,01,013,0431,0,947,14,961,1332,0,3,1,3,0,1,0,76.14,72.15 ,33.33
03,004,01,001,0001,0,653,14,667,890,0,3,1,3,0,1,0,76.14,74.94 ,33.33
03,004,01,001,0002,0,249,10,259,310,0,3,1,3,0,1,0,76.14,83.55 ,33.33
03,004,01,001,0003,0,775,22,797,1174,0,3,1,3,0,1,0,76.14,67.89 ,33.33
03,004,01,001,0004,0,414,6,420,560,0,3,1,3,0,1,0,76.14,75.00 ,33.33
03,004,01,001,0005,0,1726,31,1757,2406,0,3,1,3,0,1,0,76.14,73.03 ,33.33
03,004,01,001,0006,0,2962,55,3017,4335,0,3,1,3,0,1,0,76.14,69.60 ,33.33
03,004,01,001,0007,0,2540,43,2583,3799,0,3,1,3,0,1,0,76.14,67.99 ,33.33
03,004,01,001,0008,0,1431,24,1455,2116,0,3,1,3,0,1,0,76.14,68.76 ,33.33
03,004,01,001,0009,0,2198,32,2230,3345,0,3,1,3,0,1,0,76.14,66.67 ,33.33
03,004,01,001,0010,0,2016,27,2043,3010,0,3,1,3,0,1,0,76.14,67.87 ,33.33
03,004,01,001,0011,0,4008,81,4089,6107,0,3,1,3,0,1,0,76.14,66.96 ,33.33
03,004,01,001,0012,0,1853,44,1897,2806,0,3,1,3,0,1,0,76.14,67.61 ,33.33
03,004,01,001,0013,0,2407,34,2441,3692,0,3,1,3,0,1,0,76.14,66.12 ,33.33
03,004,01,001,0014,0,2213,35,2248,3351,0,3,1,3,0,1,0,76.14,67.08 ,33.33
03,004,01,001,0015,0,3070,56,3126,4986,0,3,1,3,0,1,0,76.14,62.70 ,33.33
03,004,01,001,0016,0,2009,42,2051,3288,0,3,1,3,0,1,0,76.14,62.38 ,33.33
03,004,01,001,0017,0,1953,41,1994,2958,0,3,1,3,0,1,0,76.14,67.41 ,33.33
03,004,01,001,0018,0,757,12,769,1144,0,3,1,3,0,1,0,76.14,67.22 ,33.33
03,004,01,001,0019,0,1099,24,1123,1636,0,3,1,3,0,1,0,76.14,68.64 ,33.33
03,004,01,001,0020,0,559,5,564,898,0,3,1,3,0,1,0,76.14,62.81 ,33.33
03,004,01,001,0021,0,1071,25,1096,1625,0,3,1,3,0,1,0,76.14,67.45 ,33.33
03,004,01,001,0022,0,682,23,705,1030,0,3,1,3,0,1,0,76.14,68.45 ,33.33
03,004,01,001,0023,0,779,15,794,1243,0,3,1,3,0,1,0,76.14,63.88 ,33.33
03,004,01,001,0024,0,917,19,936,1323,0,3,1,3,0,1,0,76.14,70.75 ,33.33
03,004,01,001,0025,0,968,14,982,1328,0,3,1,3,0,1,0,76.14,73.95 ,33.33
03,004,01,001,0026,0,1127,16,1143,1631,0,3,1,3,0,1,0,76.14,70.08 ,33.33
03,004,01,002,0027,0,285,6,291,405,0,3,1,3,0,1,0,76.14,71.85 ,33.33
03,004,01,002,0028,0,228,2,230,330,0,3,1,3,0,1,0,76.14,69.70 ,33.33
03,004,01,002,0029,0,265,8,273,362,0,3,1,3,0,1,0,76.14,75.41 ,33.33
03,004,01,002,0030,0,1227,21,1248,1758,0,3,1,3,0,1,0,76.14,70.99 ,33.33
03,004,01,002,0031,0,4180,81,4261,6082,0,3,1,3,0,1,0,76.14,70.06 ,33.33
03,004,01,002,0032,0,1895,36,1931,2696,0,3,1,3,0,1,0,76.14,71.62 ,33.33
03,004,01,002,0033,0,1044,14,1058,1462,0,3,1,3,0,1,0,76.14,72.37 ,33.33
03,004,01,002,0034,0,2314,38,2352,3274,0,3,1,3,0,1,0,76.14,71.84 ,33.33
03,004,01,002,0035,0,1295,18,1313,1763,0,3,1,3,0,1,0,76.14,74.48 ,33.33
03,004,01,002,0036,0,857,18,875,1171,0,3,1,3,0,1,0,76.14,74.72 ,33.33
03,004,01,002,0037,0,589,9,598,778,0,3,1,3,0,1,0,76.14,76.86 ,33.33
03,004,01,002,0038,0,1509,26,1535,2171,0,3,1,3,0,1,0,76.14,70.70 ,33.33
03,004,01,002,0039,0,2309,40,2349,3288,0,3,1,3,0,1,0,76.14,71.44 ,33.33
03,004,01,002,0040,0,1947,29,1976,2677,0,3,1,3,0,1,0,76.14,73.81 ,33.33
03,004,01,002,0041,0,1076,11,1087,1446,0,3,1,3,0,1,0,76.14,75.17 ,33.33
03,004,01,002,0042,0,920,10,930,1360,0,3,1,3,0,1,0,76.14,68.38 ,33.33
03,004,01,002,0043,0,1082,14,1096,1452,0,3,1,3,0,1,0,76.14,75.48 ,33.33
03,004,01,002,0044,0,3791,62,3853,5148,0,3,1,3,0,1,0,76.14,74.84 ,33.33
03,004,01,002,0045,0,3465,54,3519,5116,0,3,1,3,0,1,0,76.14,68.78 ,33.33
03,004,01,002,0046,0,347,5,352,484,0,3,1,3,0,1,0,76.14,72.73 ,33.33
03,004,01,002,0047,0,3099,56,3155,4690,0,3,1,3,0,1,0,76.14,67.27 ,33.33
03,004,01,002,0048,0,4041,72,4113,5834,0,3,1,3,0,1,0,76.14,70.50 ,33.33
03,004,01,002,0049,0,2321,40,2361,3363,0,3,1,3,0,1,0,76.14,70.21 ,33.33
03,004,01,002,0050,0,1032,15,1047,1410,0,3,1,3,0,1,0,76.14,74.26 ,33.33
03,004,01,002,0051,0,460,3,463,645,0,3,1,3,0,1,0,76.14,71.78 ,33.33
03,004,01,003,0052,0,762,8,770,1012,0,3,1,3,0,1,0,76.14,76.09 ,33.33
03,004,01,003,0053,0,500,9,509,681,0,3,1,3,0,1,0,76.14,74.74 ,33.33
03,004,01,003,0054,0,776,18,794,1043,0,3,1,3,0,1,0,76.14,76.13 ,33.33
03,004,01,003,0055,0,1654,27,1681,2290,0,3,1,3,0,1,0,76.14,73.41 ,33.33
03,004,01,003,0056,0,1133,19,1152,1690,0,3,1,3,0,1,0,76.14,68.17 ,33.33
03,004,01,003,0057,0,1316,31,1347,1821,0,3,1,3,0,1,0,76.14,73.97 ,33.33
03,004,01,003,0058,0,1978,49,2027,2772,0,3,1,3,0,1,0,76.14,73.12 ,33.33
03,004,01,003,0059,0,991,21,1012,1356,0,3,1,3,0,1,0,76.14,74.63 ,33.33
03,004,01,003,0060,0,330,4,334,438,0,3,1,3,0,1,0,76.14,76.26 ,33.33
03,004,01,003,0061,0,540,7,547,713,0,3,1,3,0,1,0,76.14,76.72 ,33.33
03,004,01,003,0062,0,451,7,458,604,0,3,1,3,0,1,0,76.14,75.83 ,33.33
03,004,01,003,0063,0,820,10,830,1066,0,3,1,3,0,1,0,76.14,77.86 ,33.33
03,004,01,003,0064,0,787,19,806,1080,0,3,1,3,0,1,0,76.14,74.63 ,33.33
03,004,01,003,0065,0,608,11,619,799,0,3,1,3,0,1,0,76.14,77.47 ,33.33
03,004,01,003,0066,0,2594,42,2636,3799,0,3,1,3,0,1,0,76.14,69.39 ,33.33
03,004,01,003,0067,0,1157,13,1170,1658,0,3,1,3,0,1,0,76.14,70.57 ,33.33
03,004,01,003,0068,0,1237,26,1263,1728,0,3,1,3,0,1,0,76.14,73.09 ,33.33
03,004,01,003,0069,0,723,19,742,974,0,3,1,3,0,1,0,76.14,76.18 ,33.33
03,004,01,003,0070,0,496,2,498,665,0,3,1,3,0,1,0,76.14,74.89 ,33.33
03,004,01,004,0071,0,420,5,425,550,0,3,1,3,0,1,0,76.14,77.27 ,33.33
03,004,01,004,0072,0,1204,18,1222,1669,0,3,1,3,0,1,0,76.14,73.22 ,33.33
03,004,01,004,0073,0,530,10,540,747,0,3,1,3,0,1,0,76.14,72.29 ,33.33
03,004,01,004,0074,0,2464,36,2500,3490,0,3,1,3,0,1,0,76.14,71.63 ,33.33
03,004,01,004,0075,0,543,12,555,725,0,3,1,3,0,1,0,76.14,76.55 ,33.33
03,004,01,004,0076,0,761,8,769,1067,0,3,1,3,0,1,0,76.14,72.07 ,33.33
03,004,01,004,0077,0,674,14,688,1016,0,3,1,3,0,1,0,76.14,67.72 ,33.33
03,004,01,004,0078,0,1920,27,1947,2799,0,3,1,3,0,1,0,76.14,69.56 ,33.33
03,004,01,004,0079,0,559,11,570,760,0,3,1,3,0,1,0,76.14,75.00 ,33.33
03,004,01,004,0080,0,823,15,838,1118,0,3,1,3,0,1,0,76.14,74.96 ,33.33
03,004,01,004,0081,0,701,5,706,975,0,3,1,3,0,1,0,76.14,72.41 ,33.33
03,004,01,004,0082,0,414,12,426,591,0,3,1,3,0,1,0,76.14,72.08 ,33.33
03,004,01,004,0083,0,372,10,382,522,0,3,1,3,0,1,0,76.14,73.18 ,33.33
03,004,01,004,0084,0,417,4,421,637,0,3,1,3,0,1,0,76.14,66.09 ,33.33
03,004,01,004,0085,0,596,12,608,879,0,3,1,3,0,1,0,76.14,69.17 ,33.33
03,004,01,004,0086,0,535,11,546,713,0,3,1,3,0,1,0,76.14,76.58 ,33.33
03,004,01,004,0087,0,1351,32,1383,1785,0,3,1,3,0,1,0,76.14,77.48 ,33.33
03,004,01,004,0088,0,675,9,684,934,0,3,1,3,0,1,0,76.14,73.23 ,33.33
03,004,01,004,0089,0,632,4,636,812,0,3,1,3,0,1,0,76.14,78.33 ,33.33
03,004,01,004,0090,0,488,7,495,620,0,3,1,3,0,1,0,76.14,79.84 ,33.33
03,004,01,004,0091,0,612,9,621,775,0,3,1,3,0,1,0,76.14,80.13 ,33.33
03,004,01,005,0092,0,1711,26,1737,2338,0,3,1,3,0,1,0,76.14,74.29 ,33.33
03,004,01,005,0093,0,1631,18,1649,2359,0,3,1,3,0,1,0,76.14,69.90 ,33.33
03,004,01,005,0094,0,2318,43,2361,3329,0,3,1,3,0,1,0,76.14,70.92 ,33.33
03,004,01,005,0095,0,2570,42,2612,3715,0,3,1,3,0,1,0,76.14,70.31 ,33.33
03,004,01,005,0096,0,580,10,590,850,0,3,1,3,0,1,0,76.14,69.41 ,33.33
03,004,01,005,0097,0,838,20,858,1222,0,3,1,3,0,1,0,76.14,70.21 ,33.33
03,004,01,005,0098,0,1613,26,1639,2274,0,3,1,3,0,1,0,76.14,72.08 ,33.33
03,004,01,005,0099,0,1486,21,1507,2058,0,3,1,3,0,1,0,76.14,73.23 ,33.33
03,004,01,005,0100,0,2281,30,2311,3252,0,3,1,3,0,1,0,76.14,71.06 ,33.33
03,004,01,005,0101,0,1480,18,1498,2105,0,3,1,3,0,1,0,76.14,71.16 ,33.33
03,004,01,005,0102,0,1023,14,1037,1677,0,3,1,3,0,1,0,76.14,61.84 ,33.33
03,004,01,005,0103,0,1695,41,1736,2443,0,3,1,3,0,1,0,76.14,71.06 ,33.33
03,004,01,005,0104,0,724,5,729,995,0,3,1,3,0,1,0,76.14,73.27 ,33.33
03,004,01,005,0105,0,1504,25,1529,2223,0,3,1,3,0,1,0,76.14,68.78 ,33.33
03,004,01,005,0106,0,1466,19,1485,2085,0,3,1,3,0,1,0,76.14,71.22 ,33.33
03,004,01,005,0107,0,845,25,870,1280,0,3,1,3,0,1,0,76.14,67.97 ,33.33
03,004,01,005,0108,0,2227,47,2274,3430,0,3,1,3,0,1,0,76.14,66.30 ,33.33
03,004,01,005,0109,0,1928,40,1968,3069,0,3,1,3,0,1,0,76.14,64.13 ,33.33
03,004,01,005,0110,0,1444,40,1484,2164,0,3,1,3,0,1,0,76.14,68.58 ,33.33
03,004,01,005,0111,0,1628,38,1666,2516,0,3,1,3,0,1,0,76.14,66.22 ,33.33
03,004,01,006,0112,0,635,16,651,865,0,3,1,3,0,1,0,76.14,75.26 ,33.33
03,004,01,006,0113,0,1147,37,1184,1639,0,3,1,3,0,1,0,76.14,72.24 ,33.33
03,004,01,006,0114,0,959,12,971,1338,0,3,1,3,0,1,0,76.14,72.57 ,33.33
03,004,01,006,0115,0,1466,26,1492,2153,0,3,1,3,0,1,0,76.14,69.30 ,33.33
03,004,01,006,0116,0,547,18,565,771,0,3,1,3,0,1,0,76.14,73.28 ,33.33
03,004,01,006,0117,0,1413,22,1435,2036,0,3,1,3,0,1,0,76.14,70.48 ,33.33
03,004,01,006,0118,0,908,10,918,1316,0,3,1,3,0,1,0,76.14,69.76 ,33.33
03,004,01,006,0119,0,1416,22,1438,2116,0,3,1,3,0,1,0,76.14,67.96 ,33.33
03,004,01,006,0120,0,3703,58,3761,5610,0,3,1,3,0,1,0,76.14,67.04 ,33.33
03,004,01,006,0121,0,814,10,824,1226,0,3,1,3,0,1,0,76.14,67.21 ,33.33
03,004,01,006,0122,0,623,17,640,902,0,3,1,3,0,1,0,76.14,70.95 ,33.33
03,004,01,006,0123,0,4358,57,4415,6609,0,3,1,3,0,1,0,76.14,66.80 ,33.33
03,004,01,006,0124,0,2566,47,2613,4089,0,3,1,3,0,1,0,76.14,63.90 ,33.33
03,004,01,007,0125,0,350,5,355,435,0,3,1,3,0,1,0,76.14,81.61 ,33.33
03,004,01,007,0126,0,368,7,375,494,0,3,1,3,0,1,0,76.14,75.91 ,33.33
03,004,01,007,0127,0,602,12,614,829,0,3,1,3,0,1,0,76.14,74.07 ,33.33
03,004,01,007,0128,0,315,1,316,397,0,3,1,3,0,1,0,76.14,79.60 ,33.33
03,004,01,007,0129,0,1689,26,1715,2310,0,3,1,3,0,1,0,76.14,74.24 ,33.33
03,004,01,007,0130,0,1019,29,1048,1370,0,3,1,3,0,1,0,76.14,76.50 ,33.33
03,004,01,007,0131,0,408,8,416,542,0,3,1,3,0,1,0,76.14,76.75 ,33.33
03,004,01,007,0132,0,457,4,461,618,0,3,1,3,0,1,0,76.14,74.60 ,33.33
03,004,01,007,0133,0,1474,21,1495,2027,0,3,1,3,0,1,0,76.14,73.75 ,33.33
03,004,01,007,0134,0,1092,26,1118,1458,0,3,1,3,0,1,0,76.14,76.68 ,33.33
03,004,01,007,0135,0,1998,26,2024,2938,0,3,1,3,0,1,0,76.14,68.89 ,33.33
03,004,01,007,0136,0,782,7,789,1041,0,3,1,3,0,1,0,76.14,75.79 ,33.33
03,004,01,008,0137,0,2246,28,2274,3197,0,3,1,3,0,1,0,76.14,71.13 ,33.33
03,004,01,008,0138,0,626,9,635,832,0,3,1,3,0,1,0,76.14,76.32 ,33.33
03,004,01,008,0139,0,124,3,127,156,0,3,1,3,0,1,0,76.14,81.41 ,33.33
03,004,01,008,0140,0,107,2,109,144,0,3,1,3,0,1,0,76.14,75.69 ,33.33
03,004,01,008,0141,0,259,3,262,334,0,3,1,3,0,1,0,76.14,78.44 ,33.33
03,004,01,008,0142,0,752,15,767,1041,0,3,1,3,0,1,0,76.14,73.68 ,33.33
03,004,01,008,0143,0,613,15,628,837,0,3,1,3,0,1,0,76.14,75.03 ,33.33
03,004,01,008,0144,0,345,4,349,456,0,3,1,3,0,1,0,76.14,76.54 ,33.33
03,004,01,008,0145,0,847,16,863,1115,0,3,1,3,0,1,0,76.14,77.40 ,33.33
03,004,01,008,0146,0,1138,14,1152,1492,0,3,1,3,0,1,0,76.14,77.21 ,33.33
03,004,01,008,0147,0,994,22,1016,1335,0,3,1,3,0,1,0,76.14,76.10 ,33.33
03,004,01,009,0148,0,775,12,787,1111,0,3,1,3,0,1,0,76.14,70.84 ,33.33
03,004,01,009,0149,0,948,22,970,1297,0,3,1,3,0,1,0,76.14,74.79 ,33.33
03,004,01,009,0150,0,356,5,361,485,0,3,1,3,0,1,0,76.14,74.43 ,33.33
03,004,01,009,0151,0,1730,28,1758,2336,0,3,1,3,0,1,0,76.14,75.26 ,33.33
03,004,01,009,0152,0,527,11,538,744,0,3,1,3,0,1,0,76.14,72.31 ,33.33
03,004,01,009,0153,0,260,2,262,339,0,3,1,3,0,1,0,76.14,77.29 ,33.33
03,004,01,009,0154,0,447,8,455,623,0,3,1,3,0,1,0,76.14,73.03 ,33.33
03,004,01,009,0155,0,227,4,231,328,0,3,1,3,0,1,0,76.14,70.43 ,33.33
03,004,01,009,0156,0,226,5,231,330,0,3,1,3,0,1,0,76.14,70.00 ,33.33
03,004,01,010,0157,0,2271,37,2308,3517,0,3,1,3,0,1,0,76.14,65.62 ,33.33
03,004,01,010,0158,0,576,13,589,839,0,3,1,3,0,1,0,76.14,70.20 ,33.33
03,004,01,010,0159,0,544,9,553,731,0,3,1,3,0,1,0,76.14,75.65 ,33.33
03,004,01,010,0160,0,770,12,782,1057,0,3,1,3,0,1,0,76.14,73.98 ,33.33
03,004,01,010,0161,0,479,8,487,625,0,3,1,3,0,1,0,76.14,77.92 ,33.33
03,004,01,010,0162,0,519,5,524,693,0,3,1,3,0,1,0,76.14,75.61 ,33.33
03,004,01,010,0163,0,460,5,465,613,0,3,1,3,0,1,0,76.14,75.86 ,33.33
03,004,01,010,0164,0,408,4,412,539,0,3,1,3,0,1,0,76.14,76.44 ,33.33
03,004,01,010,0165,0,354,5,359,505,0,3,1,3,0,1,0,76.14,71.09 ,33.33
03,004,01,011,0166,0,665,7,672,889,0,3,1,3,0,1,0,76.14,75.59 ,33.33
03,004,01,011,0167,0,550,4,554,717,0,3,1,3,0,1,0,76.14,77.27 ,33.33
03,004,01,011,0168,0,454,6,460,602,0,3,1,3,0,1,0,76.14,76.41 ,33.33
03,004,01,011,0169,0,458,7,465,611,0,3,1,3,0,1,0,76.14,76.10 ,33.33
03,004,01,011,0170,0,859,19,878,1220,0,3,1,3,0,1,0,76.14,71.97 ,33.33
03,004,01,011,0171,0,647,10,657,874,0,3,1,3,0,1,0,76.14,75.17 ,33.33
03,004,01,012,0172,0,288,4,292,413,0,3,1,3,0,1,0,76.14,70.70 ,33.33
03,004,01,012,0173,0,24,0,24,34,0,3,1,3,0,1,0,76.14,70.59 ,33.33
03,004,01,012,0174,0,78,2,80,119,0,3,1,3,0,1,0,76.14,67.23 ,33.33
03,004,01,012,0175,0,113,3,116,179,0,3,1,3,0,1,0,76.14,64.80 ,33.33
03,004,01,012,0176,0,65,0,65,116,0,3,1,3,0,1,0,76.14,56.03 ,33.33
03,004,01,012,0177,0,23,3,26,39,0,3,1,3,0,1,0,76.14,66.67 ,33.33
03,004,01,012,0178,0,16,0,16,31,0,3,1,3,0,1,0,76.14,51.61 ,33.33
03,004,01,012,0179,0,31,3,34,58,0,3,1,3,0,1,0,76.14,58.62 ,33.33
03,004,01,013,0180,0,90,1,91,146,0,3,1,3,0,1,0,76.14,62.33 ,33.33
03,004,01,013,0181,0,43,0,43,82,0,3,1,3,0,1,0,76.14,52.44 ,33.33
03,004,01,013,0182,0,12,0,12,17,0,3,1,3,0,1,0,76.14,70.59 ,33.33
03,004,01,013,0183,0,104,1,105,190,0,3,1,3,0,1,0,76.14,55.26 ,33.33
03,005,01,001,0001,0,620,8,628,915,0,3,1,3,0,1,0,76.14,68.63 ,33.33
03,005,01,001,0002,0,647,8,655,1014,0,3,1,3,0,1,0,76.14,64.60 ,33.33
03,005,01,001,0003,0,1973,36,2009,3000,0,3,1,3,0,1,0,76.14,66.97 ,33.33
03,005,01,001,0004,0,2386,41,2427,3667,0,3,1,3,0,1,0,76.14,66.18 ,33.33
03,005,01,001,0005,0,1480,22,1502,2272,0,3,1,3,0,1,0,76.14,66.11 ,33.33
03,005,01,001,0006,0,2146,39,2185,3265,0,3,1,3,0,1,0,76.14,66.92 ,33.33
03,005,01,001,0007,0,583,16,599,905,0,3,1,3,0,1,0,76.14,66.19 ,33.33
03,005,01,001,0008,0,1603,24,1627,2546,0,3,1,3,0,1,0,76.14,63.90 ,33.33
03,005,01,001,0009,0,653,16,669,962,0,3,1,3,0,1,0,76.14,69.54 ,33.33
03,005,01,001,0010,0,696,13,709,1064,0,3,1,3,0,1,0,76.14,66.64 ,33.33
03,005,01,001,0011,0,391,6,397,647,0,3,1,3,0,1,0,76.14,61.36 ,33.33
03,005,01,001,0012,0,1089,16,1105,1556,0,3,1,3,0,1,0,76.14,71.02 ,33.33
03,005,01,001,0013,0,1549,21,1570,2315,0,3,1,3,0,1,0,76.14,67.82 ,33.33
03,005,01,001,0014,0,2311,36,2347,3439,0,3,1,3,0,1,0,76.14,68.25 ,33.33
03,005,01,001,0015,0,2031,23,2054,2983,0,3,1,3,0,1,0,76.14,68.86 ,33.33
03,005,01,001,0016,0,1220,19,1239,1735,0,3,1,3,0,1,0,76.14,71.41 ,33.33
03,005,01,001,0017,0,2802,41,2843,4152,0,3,1,3,0,1,0,76.14,68.47 ,33.33
03,005,01,001,0018,0,3765,47,3812,5410,0,3,1,3,0,1,0,76.14,70.46 ,33.33
03,005,01,001,0019,0,3617,54,3671,5572,0,3,1,3,0,1,0,76.14,65.88 ,33.33
03,005,01,001,0020,0,2367,33,2400,3467,0,3,1,3,0,1,0,76.14,69.22 ,33.33
03,005,01,001,0021,0,2592,47,2639,4055,0,3,1,3,0,1,0,76.14,65.08 ,33.33
03,005,01,001,0022,0,2992,63,3055,4604,0,3,1,3,0,1,0,76.14,66.36 ,33.33
03,005,01,001,0023,0,703,7,710,1098,0,3,1,3,0,1,0,76.14,64.66 ,33.33
03,005,01,001,0024,0,1974,51,2025,3156,0,3,1,3,0,1,0,76.14,64.16 ,33.33
03,005,01,002,0025,0,1137,10,1147,1756,0,3,1,3,0,1,0,76.14,65.32 ,33.33
03,005,01,002,0026,0,1067,12,1079,1602,0,3,1,3,0,1,0,76.14,67.35 ,33.33
03,005,01,002,0027,0,611,9,620,892,0,3,1,3,0,1,0,76.14,69.51 ,33.33
03,005,01,002,0028,0,804,13,817,1268,0,3,1,3,0,1,0,76.14,64.43 ,33.33
03,005,01,002,0029,0,752,9,761,1120,0,3,1,3,0,1,0,76.14,67.95 ,33.33
03,005,01,002,0030,0,1075,8,1083,1634,0,3,1,3,0,1,0,76.14,66.28 ,33.33
03,005,01,002,0031,0,651,12,663,991,0,3,1,3,0,1,0,76.14,66.90 ,33.33
03,005,01,002,0032,0,1334,23,1357,2094,0,3,1,3,0,1,0,76.14,64.80 ,33.33
03,005,01,002,0033,0,2092,21,2113,3155,0,3,1,3,0,1,0,76.14,66.97 ,33.33
03,005,01,002,0034,0,1171,12,1183,1766,0,3,1,3,0,1,0,76.14,66.99 ,33.33
03,005,01,002,0035,0,618,9,627,997,0,3,1,3,0,1,0,76.14,62.89 ,33.33
03,005,01,002,0036,0,374,4,378,597,0,3,1,3,0,1,0,76.14,63.32 ,33.33
03,005,01,002,0037,0,747,4,751,1107,0,3,1,3,0,1,0,76.14,67.84 ,33.33
03,005,01,002,0038,0,993,9,1002,1528,0,3,1,3,0,1,0,76.14,65.58 ,33.33
03,005,01,002,0039,0,1049,12,1061,1624,0,3,1,3,0,1,0,76.14,65.33 ,33.33
03,005,01,002,0040,0,772,13,785,1224,0,3,1,3,0,1,0,76.14,64.13 ,33.33
03,005,01,002,0041,0,444,4,448,616,0,3,1,3,0,1,0,76.14,72.73 ,33.33
03,005,01,002,0042,0,617,14,631,896,0,3,1,3,0,1,0,76.14,70.42 ,33.33
03,005,01,002,0043,0,464,12,476,718,0,3,1,3,0,1,0,76.14,66.30 ,33.33
03,005,01,002,0044,0,933,7,940,1447,0,3,1,3,0,1,0,76.14,64.96 ,33.33
03,005,01,002,0045,0,960,23,983,1501,0,3,1,3,0,1,0,76.14,65.49 ,33.33
03,005,01,002,0046,0,986,15,1001,1548,0,3,1,3,0,1,0,76.14,64.66 ,33.33
03,005,01,002,0047,0,1219,15,1234,1961,0,3,1,3,0,1,0,76.14,62.93 ,33.33
03,005,01,002,0048,0,771,6,777,1157,0,3,1,3,0,1,0,76.14,67.16 ,33.33
03,005,01,002,0049,0,858,7,865,1313,0,3,1,3,0,1,0,76.14,65.88 ,33.33
03,005,01,003,0050,0,873,10,883,1262,0,3,1,3,0,1,0,76.14,69.97 ,33.33
03,005,01,003,0051,0,1545,8,1553,2151,0,3,1,3,0,1,0,76.14,72.20 ,33.33
03,005,01,003,0052,0,2419,20,2439,3591,0,3,1,3,0,1,0,76.14,67.92 ,33.33
03,005,01,003,0053,0,926,7,933,1296,0,3,1,3,0,1,0,76.14,71.99 ,33.33
03,005,01,003,0054,0,1013,5,1018,1435,0,3,1,3,0,1,0,76.14,70.94 ,33.33
03,005,01,003,0055,0,1023,9,1032,1479,0,3,1,3,0,1,0,76.14,69.78 ,33.33
03,005,01,003,0056,0,1625,12,1637,2502,0,3,1,3,0,1,0,76.14,65.43 ,33.33
03,005,01,003,0057,0,824,5,829,1184,0,3,1,3,0,1,0,76.14,70.02 ,33.33
03,005,01,003,0058,0,440,9,449,647,0,3,1,3,0,1,0,76.14,69.40 ,33.33
03,005,01,003,0059,0,612,5,617,827,0,3,1,3,0,1,0,76.14,74.61 ,33.33
03,005,01,003,0060,0,665,11,676,1016,0,3,1,3,0,1,0,76.14,66.54 ,33.33
03,005,01,003,0061,0,446,10,456,695,0,3,1,3,0,1,0,76.14,65.61 ,33.33
03,005,01,003,0062,0,543,1,544,753,0,3,1,3,0,1,0,76.14,72.24 ,33.33
03,005,01,003,0063,0,1231,11,1242,1749,0,3,1,3,0,1,0,76.14,71.01 ,33.33
03,005,01,003,0064,0,386,5,391,560,0,3,1,3,0,1,0,76.14,69.82 ,33.33
03,005,01,003,0065,0,645,11,656,937,0,3,1,3,0,1,0,76.14,70.01 ,33.33
03,005,01,003,0066,0,342,1,343,509,0,3,1,3,0,1,0,76.14,67.39 ,33.33
03,005,01,003,0067,0,514,5,519,779,0,3,1,3,0,1,0,76.14,66.62 ,33.33
03,005,01,003,0068,0,1414,16,1430,2128,0,3,1,3,0,1,0,76.14,67.20 ,33.33
03,005,01,003,0069,0,872,19,891,1254,0,3,1,3,0,1,0,76.14,71.05 ,33.33
03,005,01,003,0070,0,495,9,504,759,0,3,1,3,0,1,0,76.14,66.40 ,33.33
03,005,01,003,0071,0,805,12,817,1315,0,3,1,3,0,1,0,76.14,62.13 ,33.33
03,005,01,003,0072,0,529,5,534,813,0,3,1,3,0,1,0,76.14,65.68 ,33.33
03,005,01,004,0073,0,1249,15,1264,1858,0,3,1,3,0,1,0,76.14,68.03 ,33.33
03,005,01,004,0074,0,1586,11,1597,2318,0,3,1,3,0,1,0,76.14,68.90 ,33.33
03,005,01,004,0075,0,1431,20,1451,2218,0,3,1,3,0,1,0,76.14,65.42 ,33.33
03,005,01,004,0076,0,1785,17,1802,2701,0,3,1,3,0,1,0,76.14,66.72 ,33.33
03,005,01,004,0077,0,2063,33,2096,3066,0,3,1,3,0,1,0,76.14,68.36 ,33.33
03,005,01,004,0078,0,1648,17,1665,2469,0,3,1,3,0,1,0,76.14,67.44 ,33.33
03,005,01,004,0079,0,1391,15,1406,2175,0,3,1,3,0,1,0,76.14,64.64 ,33.33
03,005,01,004,0080,0,1718,46,1764,2708,0,3,1,3,0,1,0,76.14,65.14 ,33.33
03,005,01,004,0081,0,2787,28,2815,4160,0,3,1,3,0,1,0,76.14,67.67 ,33.33
03,005,01,004,0082,0,3030,26,3056,4860,0,3,1,3,0,1,0,76.14,62.88 ,33.33
03,005,01,004,0083,0,598,10,608,883,0,3,1,3,0,1,0,76.14,68.86 ,33.33
03,005,01,004,0084,0,1450,23,1473,2194,0,3,1,3,0,1,0,76.14,67.14 ,33.33
03,005,01,004,0085,0,796,12,808,1150,0,3,1,3,0,1,0,76.14,70.26 ,33.33
03,005,01,004,0086,0,1002,17,1019,1547,0,3,1,3,0,1,0,76.14,65.87 ,33.33
03,005,01,004,0087,0,366,6,372,526,0,3,1,3,0,1,0,76.14,70.72 ,33.33
03,005,01,004,0088,0,1257,16,1273,2046,0,3,1,3,0,1,0,76.14,62.22 ,33.33
03,005,01,004,0089,0,987,11,998,1382,0,3,1,3,0,1,0,76.14,72.21 ,33.33
03,005,01,004,0090,0,687,13,700,1087,0,3,1,3,0,1,0,76.14,64.40 ,33.33
03,005,01,004,0091,0,1904,46,1950,2973,0,3,1,3,0,1,0,76.14,65.59 ,33.33
03,005,01,004,0092,0,1366,24,1390,2116,0,3,1,3,0,1,0,76.14,65.69 ,33.33
03,005,01,004,0093,0,1560,21,1581,2458,0,3,1,3,0,1,0,76.14,64.32 ,33.33
03,005,01,004,0094,0,552,7,559,896,0,3,1,3,0,1,0,76.14,62.39 ,33.33
03,005,01,005,0095,0,1356,24,1380,2003,0,3,1,3,0,1,0,76.14,68.90 ,33.33
03,005,01,005,0096,0,1235,14,1249,1771,0,3,1,3,0,1,0,76.14,70.53 ,33.33
03,005,01,005,0097,0,1863,16,1879,2735,0,3,1,3,0,1,0,76.14,68.70 ,33.33
03,005,01,005,0098,0,2263,26,2289,3415,0,3,1,3,0,1,0,76.14,67.03 ,33.33
03,005,01,005,0099,0,1785,19,1804,2809,0,3,1,3,0,1,0,76.14,64.22 ,33.33
03,005,01,005,0100,0,1560,22,1582,2305,0,3,1,3,0,1,0,76.14,68.63 ,33.33
03,005,01,005,0101,0,524,5,529,780,0,3,1,3,0,1,0,76.14,67.82 ,33.33
03,005,01,005,0102,0,1651,18,1669,2638,0,3,1,3,0,1,0,76.14,63.27 ,33.33
03,005,01,005,0103,0,2768,24,2792,4234,0,3,1,3,0,1,0,76.14,65.94 ,33.33
03,005,01,005,0104,0,955,28,983,1510,0,3,1,3,0,1,0,76.14,65.10 ,33.33
03,005,01,005,0105,0,532,7,539,736,0,3,1,3,0,1,0,76.14,73.23 ,33.33
03,005,01,005,0106,0,679,5,684,983,0,3,1,3,0,1,0,76.14,69.58 ,33.33
03,005,01,005,0107,0,756,8,764,1098,0,3,1,3,0,1,0,76.14,69.58 ,33.33
03,005,01,005,0108,0,1293,16,1309,1998,0,3,1,3,0,1,0,76.14,65.52 ,33.33
03,005,01,005,0109,0,1474,19,1493,2184,0,3,1,3,0,1,0,76.14,68.36 ,33.33
03,005,01,005,0110,0,2908,39,2947,4501,0,3,1,3,0,1,0,76.14,65.47 ,33.33
03,005,01,005,0111,0,1536,22,1558,2415,0,3,1,3,0,1,0,76.14,64.51 ,33.33
03,005,01,005,0112,0,1597,20,1617,2518,0,3,1,3,0,1,0,76.14,64.22 ,33.33
03,005,01,005,0113,0,1331,18,1349,2118,0,3,1,3,0,1,0,76.14,63.69 ,33.33
03,005,01,005,0114,0,1462,21,1483,2313,0,3,1,3,0,1,0,76.14,64.12 ,33.33
03,005,01,005,0115,0,990,18,1008,1543,0,3,1,3,0,1,0,76.14,65.33 ,33.33
03,005,01,005,0116,0,1038,14,1052,1632,0,3,1,3,0,1,0,76.14,64.46 ,33.33
03,005,01,005,0117,0,1197,20,1217,1890,0,3,1,3,0,1,0,76.14,64.39 ,33.33
03,005,01,005,0118,0,1727,22,1749,2657,0,3,1,3,0,1,0,76.14,65.83 ,33.33
03,005,01,005,0119,0,915,11,926,1293,0,3,1,3,0,1,0,76.14,71.62 ,33.33
03,005,01,005,0120,0,897,15,912,1269,0,3,1,3,0,1,0,76.14,71.87 ,33.33
03,005,01,005,0121,0,613,7,620,866,0,3,1,3,0,1,0,76.14,71.59 ,33.33
03,005,01,005,0122,0,1522,22,1544,2371,0,3,1,3,0,1,0,76.14,65.12 ,33.33
03,005,01,005,0123,0,1283,11,1294,1930,0,3,1,3,0,1,0,76.14,67.05 ,33.33
03,005,01,006,0124,0,947,19,966,1449,0,3,1,3,0,1,0,76.14,66.67 ,33.33
03,005,01,006,0125,0,716,7,723,955,0,3,1,3,0,1,0,76.14,75.71 ,33.33
03,005,01,006,0126,0,929,16,945,1403,0,3,1,3,0,1,0,76.14,67.36 ,33.33
03,005,01,006,0127,0,2258,27,2285,3286,0,3,1,3,0,1,0,76.14,69.54 ,33.33
03,005,01,006,0128,0,1368,24,1392,2177,0,3,1,3,0,1,0,76.14,63.94 ,33.33
03,005,01,006,0129,0,890,8,898,1264,0,3,1,3,0,1,0,76.14,71.04 ,33.33
03,005,01,006,0130,0,873,13,886,1180,0,3,1,3,0,1,0,76.14,75.08 ,33.33
03,005,01,006,0131,0,1495,27,1522,2233,0,3,1,3,0,1,0,76.14,68.16 ,33.33
03,005,01,006,0132,0,916,17,933,1307,0,3,1,3,0,1,0,76.14,71.38 ,33.33
03,005,01,006,0133,0,450,5,455,649,0,3,1,3,0,1,0,76.14,70.11 ,33.33
03,005,01,006,0134,0,870,6,876,1399,0,3,1,3,0,1,0,76.14,62.62 ,33.33
03,005,01,006,0135,0,969,14,983,1609,0,3,1,3,0,1,0,76.14,61.09 ,33.33
03,005,01,006,0136,0,802,15,817,1319,0,3,1,3,0,1,0,76.14,61.94 ,33.33
03,005,01,006,0137,0,607,17,624,999,0,3,1,3,0,1,0,76.14,62.46 ,33.33
03,005,01,006,0138,0,657,13,670,1157,0,3,1,3,0,1,0,76.14,57.91 ,33.33
03,005,01,006,0139,0,600,13,613,1033,0,3,1,3,0,1,0,76.14,59.34 ,33.33
03,005,01,006,0140,0,471,9,480,721,0,3,1,3,0,1,0,76.14,66.57 ,33.33
03,005,01,006,0141,0,677,20,697,1108,0,3,1,3,0,1,0,76.14,62.91 ,33.33
03,005,01,006,0142,0,417,6,423,644,0,3,1,3,0,1,0,76.14,65.68 ,33.33
03,005,01,006,0143,0,805,12,817,1250,0,3,1,3,0,1,0,76.14,65.36 ,33.33
03,005,01,006,0144,0,528,3,531,816,0,3,1,3,0,1,0,76.14,65.07 ,33.33
03,005,01,006,0145,0,641,10,651,1224,0,3,1,3,0,1,0,76.14,53.19 ,33.33
03,005,01,006,0146,0,716,19,735,1272,0,3,1,3,0,1,0,76.14,57.78 ,33.33
03,005,01,007,0147,0,1510,17,1527,2110,0,3,1,3,0,1,0,76.14,72.37 ,33.33
03,005,01,007,0148,0,845,5,850,1168,0,3,1,3,0,1,0,76.14,72.77 ,33.33
03,005,01,007,0149,0,598,8,606,814,0,3,1,3,0,1,0,76.14,74.45 ,33.33
03,005,01,007,0150,0,1073,9,1082,1565,0,3,1,3,0,1,0,76.14,69.14 ,33.33
03,005,01,007,0151,0,733,14,747,1011,0,3,1,3,0,1,0,76.14,73.89 ,33.33
03,005,01,007,0152,0,373,8,381,564,0,3,1,3,0,1,0,76.14,67.55 ,33.33
03,005,01,007,0153,0,507,17,524,723,0,3,1,3,0,1,0,76.14,72.48 ,33.33
03,005,01,007,0154,0,1353,24,1377,1999,0,3,1,3,0,1,0,76.14,68.88 ,33.33
03,005,01,007,0155,0,1486,18,1504,2075,0,3,1,3,0,1,0,76.14,72.48 ,33.33
03,005,01,007,0156,0,933,18,951,1441,0,3,1,3,0,1,0,76.14,66.00 ,33.33
03,005,01,007,0157,0,446,11,457,693,0,3,1,3,0,1,0,76.14,65.95 ,33.33
03,005,01,008,0158,0,1137,18,1155,1701,0,3,1,3,0,1,0,76.14,67.90 ,33.33
03,005,01,008,0159,0,508,3,511,673,0,3,1,3,0,1,0,76.14,75.93 ,33.33
03,005,01,008,0160,0,1077,11,1088,1636,0,3,1,3,0,1,0,76.14,66.50 ,33.33
03,005,01,008,0161,0,874,24,898,1364,0,3,1,3,0,1,0,76.14,65.84 ,33.33
03,005,01,008,0162,0,403,9,412,662,0,3,1,3,0,1,0,76.14,62.24 ,33.33
03,005,01,008,0163,0,800,11,811,1238,0,3,1,3,0,1,0,76.14,65.51 ,33.33
03,005,01,008,0164,0,497,10,507,749,0,3,1,3,0,1,0,76.14,67.69 ,33.33
03,005,01,008,0165,0,957,11,968,1516,0,3,1,3,0,1,0,76.14,63.85 ,33.33
03,005,01,008,0166,0,503,3,506,745,0,3,1,3,0,1,0,76.14,67.92 ,33.33
03,005,01,008,0167,0,356,3,359,528,0,3,1,3,0,1,0,76.14,67.99 ,33.33
03,005,01,008,0168,0,575,7,582,910,0,3,1,3,0,1,0,76.14,63.96 ,33.33
03,005,01,008,0169,0,546,10,556,888,0,3,1,3,0,1,0,76.14,62.61 ,33.33
03,005,01,009,0170,0,1103,19,1122,1522,0,3,1,3,0,1,0,76.14,73.72 ,33.33
03,005,01,009,0171,0,1453,39,1492,2129,0,3,1,3,0,1,0,76.14,70.08 ,33.33
03,005,01,009,0172,0,1820,22,1842,2674,0,3,1,3,0,1,0,76.14,68.89 ,33.33
03,005,01,009,0173,0,1281,28,1309,1941,0,3,1,3,0,1,0,76.14,67.44 ,33.33
03,005,01,009,0174,0,1141,22,1163,1656,0,3,1,3,0,1,0,76.14,70.23 ,33.33
03,005,01,009,0175,0,654,21,675,963,0,3,1,3,0,1,0,76.14,70.09 ,33.33
03,005,01,009,0176,0,736,14,750,1062,0,3,1,3,0,1,0,76.14,70.62 ,33.33
03,005,01,009,0177,0,278,5,283,406,0,3,1,3,0,1,0,76.14,69.70 ,33.33
03,005,01,009,0178,0,1081,21,1102,1634,0,3,1,3,0,1,0,76.14,67.44 ,33.33
03,005,01,009,0179,0,981,21,1002,1416,0,3,1,3,0,1,0,76.14,70.76 ,33.33
03,005,01,009,0180,0,250,2,252,318,0,3,1,3,0,1,0,76.14,79.25 ,33.33
03,005,01,009,0181,0,1197,23,1220,1756,0,3,1,3,0,1,0,76.14,69.48 ,33.33
03,005,01,009,0182,0,763,12,775,1078,0,3,1,3,0,1,0,76.14,71.89 ,33.33
03,005,01,009,0183,0,1029,14,1043,1401,0,3,1,3,0,1,0,76.14,74.45 ,33.33
03,005,01,009,0184,0,929,14,943,1325,0,3,1,3,0,1,0,76.14,71.17 ,33.33
03,005,01,009,0185,0,897,17,914,1367,0,3,1,3,0,1,0,76.14,66.86 ,33.33
03,005,01,009,0186,0,815,12,827,1159,0,3,1,3,0,1,0,76.14,71.35 ,33.33
03,005,01,009,0187,0,160,4,164,233,0,3,1,3,0,1,0,76.14,70.39 ,33.33
03,005,01,009,0188,0,235,5,240,305,0,3,1,3,0,1,0,76.14,78.69 ,33.33
03,005,01,010,0189,0,723,7,730,1046,0,3,1,3,0,1,0,76.14,69.79 ,33.33
03,005,01,010,0190,0,1106,25,1131,1639,0,3,1,3,0,1,0,76.14,69.01 ,33.33
03,005,01,010,0191,0,698,9,707,1078,0,3,1,3,0,1,0,76.14,65.58 ,33.33
03,005,01,010,0192,0,2816,28,2844,4130,0,3,1,3,0,1,0,76.14,68.86 ,33.33
03,005,01,010,0193,0,879,16,895,1263,0,3,1,3,0,1,0,76.14,70.86 ,33.33
03,005,01,010,0194,0,840,11,851,1244,0,3,1,3,0,1,0,76.14,68.41 ,33.33
03,005,01,010,0195,0,1767,28,1795,2737,0,3,1,3,0,1,0,76.14,65.58 ,33.33
03,005,01,010,0196,0,432,7,439,634,0,3,1,3,0,1,0,76.14,69.24 ,33.33
03,005,01,010,0197,0,318,9,327,499,0,3,1,3,0,1,0,76.14,65.53 ,33.33
03,005,01,010,0198,0,364,5,369,566,0,3,1,3,0,1,0,76.14,65.19 ,33.33
03,005,01,011,0199,0,847,11,858,1268,0,3,1,3,0,1,0,76.14,67.67 ,33.33
03,005,01,011,0200,0,447,7,454,674,0,3,1,3,0,1,0,76.14,67.36 ,33.33
03,005,01,011,0201,0,716,12,728,1063,0,3,1,3,0,1,0,76.14,68.49 ,33.33
03,005,01,011,0202,0,521,8,529,865,0,3,1,3,0,1,0,76.14,61.16 ,33.33
03,005,01,011,0203,0,625,5,630,1001,0,3,1,3,0,1,0,76.14,62.94 ,33.33
03,005,01,011,0204,0,750,10,760,1066,0,3,1,3,0,1,0,76.14,71.29 ,33.33
03,005,01,011,0205,0,683,6,689,1059,0,3,1,3,0,1,0,76.14,65.06 ,33.33
03,005,01,011,0206,0,274,3,277,450,0,3,1,3,0,1,0,76.14,61.56 ,33.33
03,005,01,011,0207,0,167,1,168,286,0,3,1,3,0,1,0,76.14,58.74 ,33.33
03,005,01,012,0208,0,1674,13,1687,2367,0,3,1,3,0,1,0,76.14,71.27 ,33.33
03,005,01,012,0209,0,1079,15,1094,1586,0,3,1,3,0,1,0,76.14,68.98 ,33.33
03,005,01,012,0210,0,440,9,449,658,0,3,1,3,0,1,0,76.14,68.24 ,33.33
03,005,01,012,0211,0,623,4,627,851,0,3,1,3,0,1,0,76.14,73.68 ,33.33
03,005,01,012,0212,0,246,0,246,344,0,3,1,3,0,1,0,76.14,71.51 ,33.33
03,005,01,012,0213,0,1210,27,1237,1856,0,3,1,3,0,1,0,76.14,66.65 ,33.33
03,005,01,012,0214,0,796,12,808,1104,0,3,1,3,0,1,0,76.14,73.19 ,33.33
03,005,01,012,0215,0,225,1,226,332,0,3,1,3,0,1,0,76.14,68.07 ,33.33
03,005,01,013,0216,0,2661,45,2706,3881,0,3,1,3,0,1,0,76.14,69.72 ,33.33
03,005,01,013,0217,0,1805,27,1832,2875,0,3,1,3,0,1,0,76.14,63.72 ,33.33
03,005,01,013,0218,0,1151,16,1167,1627,0,3,1,3,0,1,0,76.14,71.73 ,33.33
03,005,01,013,0219,0,948,24,972,1352,0,3,1,3,0,1,0,76.14,71.89 ,33.33
03,005,01,013,0220,0,895,15,910,1282,0,3,1,3,0,1,0,76.14,70.98 ,33.33
03,005,01,013,0221,0,304,7,311,403,0,3,1,3,0,1,0,76.14,77.17 ,33.33
03,005,01,013,0222,0,835,10,845,1172,0,3,1,3,0,1,0,76.14,72.10 ,33.33
03,005,01,014,0223,0,418,7,425,606,0,3,1,3,0,1,0,76.14,70.13 ,33.33
03,005,01,014,0224,0,407,0,407,560,0,3,1,3,0,1,0,76.14,72.68 ,33.33
03,005,01,014,0225,0,603,9,612,915,0,3,1,3,0,1,0,76.14,66.89 ,33.33
03,005,01,014,0226,0,448,6,454,645,0,3,1,3,0,1,0,76.14,70.39 ,33.33
03,005,01,014,0227,0,630,13,643,971,0,3,1,3,0,1,0,76.14,66.22 ,33.33
03,005,01,014,0228,0,353,4,357,540,0,3,1,3,0,1,0,76.14,66.11 ,33.33
03,005,01,014,0229,0,338,8,346,538,0,3,1,3,0,1,0,76.14,64.31 ,33.33
03,005,01,014,0230,0,734,21,755,1145,0,3,1,3,0,1,0,76.14,65.94 ,33.33
03,005,01,014,0231,0,417,7,424,650,0,3,1,3,0,1,0,76.14,65.23 ,33.33
03,005,01,015,0232,0,1132,13,1145,1669,0,3,1,3,0,1,0,76.14,68.60 ,33.33
03,005,01,015,0233,0,340,9,349,477,0,3,1,3,0,1,0,76.14,73.17 ,33.33
03,005,01,015,0234,0,678,7,685,971,0,3,1,3,0,1,0,76.14,70.55 ,33.33
03,005,01,015,0235,0,1980,27,2007,2964,0,3,1,3,0,1,0,76.14,67.71 ,33.33
03,005,01,015,0236,0,373,7,380,538,0,3,1,3,0,1,0,76.14,70.63 ,33.33
03,005,01,015,0237,0,380,2,382,506,0,3,1,3,0,1,0,76.14,75.49 ,33.33
03,005,01,015,0238,0,886,10,896,1363,0,3,1,3,0,1,0,76.14,65.74 ,33.33
03,005,01,015,0239,0,485,8,493,712,0,3,1,3,0,1,0,76.14,69.24 ,33.33
03,005,01,015,0240,0,676,12,688,1003,0,3,1,3,0,1,0,76.14,68.59 ,33.33
03,005,01,016,0241,0,1408,10,1418,2099,0,3,1,3,0,1,0,76.14,67.56 ,33.33
03,005,01,016,0242,0,428,4,432,598,0,3,1,3,0,1,0,76.14,72.24 ,33.33
03,005,01,016,0243,0,562,7,569,840,0,3,1,3,0,1,0,76.14,67.74 ,33.33
03,005,01,016,0244,0,162,3,165,231,0,3,1,3,0,1,0,76.14,71.43 ,33.33
03,005,01,016,0245,0,367,4,371,546,0,3,1,3,0,1,0,76.14,67.95 ,33.33
03,005,01,016,0246,0,411,2,413,622,0,3,1,3,0,1,0,76.14,66.40 ,33.33
03,005,01,016,0247,0,316,4,320,484,0,3,1,3,0,1,0,76.14,66.12 ,33.33
03,005,01,016,0248,0,249,2,251,352,0,3,1,3,0,1,0,76.14,71.31 ,33.33
03,005,01,017,0249,0,176,4,180,272,0,3,1,3,0,1,0,76.14,66.18 ,33.33
03,005,01,017,0250,0,398,8,406,643,0,3,1,3,0,1,0,76.14,63.14 ,33.33
03,005,01,017,0251,0,666,5,671,958,0,3,1,3,0,1,0,76.14,70.04 ,33.33
03,005,01,017,0252,0,416,5,421,628,0,3,1,3,0,1,0,76.14,67.04 ,33.33
03,005,01,017,0253,0,425,8,433,641,0,3,1,3,0,1,0,76.14,67.55 ,33.33
03,005,01,017,0254,0,223,4,227,352,0,3,1,3,0,1,0,76.14,64.49 ,33.33
03,005,01,017,0255,0,509,7,516,763,0,3,1,3,0,1,0,76.14,67.63 ,33.33
03,005,01,018,0256,0,99,3,102,137,0,3,1,3,0,1,0,76.14,74.45 ,33.33
03,005,01,018,0257,0,236,3,239,391,0,3,1,3,0,1,0,76.14,61.13 ,33.33
03,005,01,018,0258,0,412,6,418,622,0,3,1,3,0,1,0,76.14,67.20 ,33.33
03,005,01,018,0259,0,67,0,67,104,0,3,1,3,0,1,0,76.14,64.42 ,33.33
03,005,01,018,0260,0,85,1,86,120,0,3,1,3,0,1,0,76.14,71.67 ,33.33
03,005,01,018,0261,0,17,0,17,26,0,3,1,3,0,1,0,76.14,65.38 ,33.33
03,005,01,018,0262,0,30,0,30,49,0,3,1,3,0,1,0,76.14,61.22 ,33.33
03,005,01,018,0263,0,15,1,16,31,0,3,1,3,0,1,0,76.14,51.61 ,33.33
03,006,01,001,0001,0,1248,19,1267,1920,0,3,1,3,0,1,0,76.14,65.99 ,33.33
03,006,01,001,0002,0,664,8,672,1033,0,3,1,3,0,1,0,76.14,65.05 ,33.33
03,006,01,001,0003,0,561,3,564,880,0,3,1,3,0,1,0,76.14,64.09 ,33.33
03,006,01,001,0004,0,675,6,681,945,0,3,1,3,0,1,0,76.14,72.06 ,33.33
03,006,01,001,0005,0,549,5,554,801,0,3,1,3,0,1,0,76.14,69.16 ,33.33
03,006,01,001,0006,0,2981,34,3015,4447,0,3,1,3,0,1,0,76.14,67.80 ,33.33
03,006,01,001,0007,0,1387,11,1398,2065,0,3,1,3,0,1,0,76.14,67.70 ,33.33
03,006,01,001,0008,0,1588,23,1611,2431,0,3,1,3,0,1,0,76.14,66.27 ,33.33
03,006,01,001,0009,0,2410,45,2455,3621,0,3,1,3,0,1,0,76.14,67.80 ,33.33
03,006,01,001,0010,0,3921,73,3994,6141,0,3,1,3,0,1,0,76.14,65.04 ,33.33
03,006,01,001,0011,0,1174,14,1188,1732,0,3,1,3,0,1,0,76.14,68.59 ,33.33
03,006,01,001,0012,0,851,13,864,1208,0,3,1,3,0,1,0,76.14,71.52 ,33.33
03,006,01,001,0013,0,1759,24,1783,2685,0,3,1,3,0,1,0,76.14,66.41 ,33.33
03,006,01,001,0014,0,660,6,666,880,0,3,1,3,0,1,0,76.14,75.68 ,33.33
03,006,01,001,0015,0,566,6,572,808,0,3,1,3,0,1,0,76.14,70.79 ,33.33
03,006,01,001,0016,0,3157,34,3191,4667,0,3,1,3,0,1,0,76.14,68.37 ,33.33
03,006,01,001,0017,0,1457,17,1474,2143,0,3,1,3,0,1,0,76.14,68.78 ,33.33
03,006,01,001,0018,0,1810,40,1850,2719,0,3,1,3,0,1,0,76.14,68.04 ,33.33
03,006,01,001,0019,0,4538,61,4599,7293,0,3,1,3,0,1,0,76.14,63.06 ,33.33
03,006,01,001,0020,0,3015,49,3064,4675,0,3,1,3,0,1,0,76.14,65.54 ,33.33
03,006,01,001,0021,0,969,17,986,1420,0,3,1,3,0,1,0,76.14,69.44 ,33.33
03,006,01,001,0022,0,664,7,671,1052,0,3,1,3,0,1,0,76.14,63.78 ,33.33
03,006,01,001,0023,0,2926,44,2970,4510,0,3,1,3,0,1,0,76.14,65.85 ,33.33
03,006,01,001,0024,0,5365,113,5478,8281,0,3,1,3,0,1,0,76.14,66.15 ,33.33
03,006,01,001,0025,0,2253,39,2292,3394,0,3,1,3,0,1,0,76.14,67.53 ,33.33
03,006,01,001,0026,0,1584,29,1613,2372,0,3,1,3,0,1,0,76.14,68.00 ,33.33
03,006,01,001,0027,0,4236,66,4302,6530,0,3,1,3,0,1,0,76.14,65.88 ,33.33
03,006,01,001,0028,0,6249,74,6323,9475,0,3,1,3,0,1,0,76.14,66.73 ,33.33
03,006,01,001,0029,0,950,10,960,1433,0,3,1,3,0,1,0,76.14,66.99 ,33.33
03,006,01,001,0030,0,2551,30,2581,3904,0,3,1,3,0,1,0,76.14,66.11 ,33.33
03,006,01,001,0031,0,1959,21,1980,2907,0,3,1,3,0,1,0,76.14,68.11 ,33.33
03,006,01,001,0032,0,1790,24,1814,2697,0,3,1,3,0,1,0,76.14,67.26 ,33.33
03,006,01,001,0033,0,1115,19,1134,1636,0,3,1,3,0,1,0,76.14,69.32 ,33.33
03,006,01,001,0034,0,1550,26,1576,2319,0,3,1,3,0,1,0,76.14,67.96 ,33.33
03,006,01,001,0035,0,1228,27,1255,1799,0,3,1,3,0,1,0,76.14,69.76 ,33.33
03,006,01,001,0036,0,1843,29,1872,2817,0,3,1,3,0,1,0,76.14,66.45 ,33.33
03,006,01,002,0037,0,757,11,768,1137,0,3,1,3,0,1,0,76.14,67.55 ,33.33
03,006,01,002,0038,0,568,11,579,830,0,3,1,3,0,1,0,76.14,69.76 ,33.33
03,006,01,002,0039,0,857,19,876,1341,0,3,1,3,0,1,0,76.14,65.32 ,33.33
03,006,01,002,0040,0,1257,19,1276,1815,0,3,1,3,0,1,0,76.14,70.30 ,33.33
03,006,01,002,0041,0,1481,24,1505,2228,0,3,1,3,0,1,0,76.14,67.55 ,33.33
03,006,01,002,0042,0,640,10,650,964,0,3,1,3,0,1,0,76.14,67.43 ,33.33
03,006,01,002,0043,0,1009,19,1028,1538,0,3,1,3,0,1,0,76.14,66.84 ,33.33
03,006,01,002,0044,0,1989,28,2017,3060,0,3,1,3,0,1,0,76.14,65.92 ,33.33
03,006,01,002,0045,0,1129,14,1143,1820,0,3,1,3,0,1,0,76.14,62.80 ,33.33
03,006,01,002,0046,0,1964,34,1998,3022,0,3,1,3,0,1,0,76.14,66.12 ,33.33
03,006,01,002,0047,0,852,14,866,1347,0,3,1,3,0,1,0,76.14,64.29 ,33.33
03,006,01,002,0048,0,3057,64,3121,4618,0,3,1,3,0,1,0,76.14,67.58 ,33.33
03,006,01,002,0049,0,932,13,945,1447,0,3,1,3,0,1,0,76.14,65.31 ,33.33
03,006,01,002,0050,0,658,11,669,977,0,3,1,3,0,1,0,76.14,68.47 ,33.33
03,006,01,002,0051,0,644,3,647,887,0,3,1,3,0,1,0,76.14,72.94 ,33.33
03,006,01,002,0052,0,1282,10,1292,1918,0,3,1,3,0,1,0,76.14,67.36 ,33.33
03,006,01,002,0053,0,814,16,830,1390,0,3,1,3,0,1,0,76.14,59.71 ,33.33
03,006,01,002,0054,0,1318,14,1332,1981,0,3,1,3,0,1,0,76.14,67.24 ,33.33
03,006,01,002,0055,0,1095,18,1113,1694,0,3,1,3,0,1,0,76.14,65.70 ,33.33
03,006,01,002,0056,0,1037,17,1054,1580,0,3,1,3,0,1,0,76.14,66.71 ,33.33
03,006,01,002,0057,0,759,10,769,1221,0,3,1,3,0,1,0,76.14,62.98 ,33.33
03,006,01,002,0058,0,989,17,1006,1684,0,3,1,3,0,1,0,76.14,59.74 ,33.33
03,006,01,002,0059,0,473,10,483,734,0,3,1,3,0,1,0,76.14,65.80 ,33.33
03,006,01,002,0060,0,487,9,496,657,0,3,1,3,0,1,0,76.14,75.49 ,33.33
03,006,01,002,0061,0,923,23,946,1380,0,3,1,3,0,1,0,76.14,68.55 ,33.33
03,006,01,003,0062,0,859,12,871,1249,0,3,1,3,0,1,0,76.14,69.74 ,33.33
03,006,01,003,0063,0,762,12,774,1161,0,3,1,3,0,1,0,76.14,66.67 ,33.33
03,006,01,003,0064,0,1088,13,1101,1644,0,3,1,3,0,1,0,76.14,66.97 ,33.33
03,006,01,003,0065,0,516,8,524,745,0,3,1,3,0,1,0,76.14,70.34 ,33.33
03,006,01,003,0066,0,1236,21,1257,1886,0,3,1,3,0,1,0,76.14,66.65 ,33.33
03,006,01,003,0067,0,1306,14,1320,1923,0,3,1,3,0,1,0,76.14,68.64 ,33.33
03,006,01,003,0068,0,2080,34,2114,3090,0,3,1,3,0,1,0,76.14,68.41 ,33.33
03,006,01,003,0069,0,1144,18,1162,1689,0,3,1,3,0,1,0,76.14,68.80 ,33.33
03,006,01,003,0070,0,2001,36,2037,3176,0,3,1,3,0,1,0,76.14,64.14 ,33.33
03,006,01,003,0071,0,570,5,575,845,0,3,1,3,0,1,0,76.14,68.05 ,33.33
03,006,01,003,0072,0,585,5,590,892,0,3,1,3,0,1,0,76.14,66.14 ,33.33
03,006,01,003,0073,0,1650,35,1685,2541,0,3,1,3,0,1,0,76.14,66.31 ,33.33
03,006,01,003,0074,0,797,18,815,1056,0,3,1,3,0,1,0,76.14,77.18 ,33.33
03,006,01,003,0075,0,709,19,728,1068,0,3,1,3,0,1,0,76.14,68.16 ,33.33
03,006,01,003,0076,0,1031,18,1049,1493,0,3,1,3,0,1,0,76.14,70.26 ,33.33
03,006,01,003,0077,0,2798,28,2826,4304,0,3,1,3,0,1,0,76.14,65.66 ,33.33
03,006,01,003,0078,0,825,20,845,1234,0,3,1,3,0,1,0,76.14,68.48 ,33.33
03,006,01,003,0079,0,1008,13,1021,1551,0,3,1,3,0,1,0,76.14,65.83 ,33.33
03,006,01,003,0080,0,669,9,678,979,0,3,1,3,0,1,0,76.14,69.25 ,33.33
03,006,01,003,0081,0,2110,33,2143,3224,0,3,1,3,0,1,0,76.14,66.47 ,33.33
03,006,01,003,0082,0,736,10,746,1193,0,3,1,3,0,1,0,76.14,62.53 ,33.33
03,006,01,003,0083,0,1933,19,1952,3069,0,3,1,3,0,1,0,76.14,63.60 ,33.33
03,006,01,003,0084,0,1452,20,1472,2300,0,3,1,3,0,1,0,76.14,64.00 ,33.33
03,006,01,003,0085,0,2351,28,2379,3805,0,3,1,3,0,1,0,76.14,62.52 ,33.33
03,006,01,003,0086,0,913,17,930,1358,0,3,1,3,0,1,0,76.14,68.48 ,33.33
03,006,01,003,0087,0,991,20,1011,1424,0,3,1,3,0,1,0,76.14,71.00 ,33.33
03,006,01,003,0088,0,763,24,787,1186,0,3,1,3,0,1,0,76.14,66.36 ,33.33
03,006,01,003,0089,0,752,12,764,1048,0,3,1,3,0,1,0,76.14,72.90 ,33.33
03,006,01,003,0090,0,876,8,884,1257,0,3,1,3,0,1,0,76.14,70.33 ,33.33
03,006,01,004,0091,0,776,5,781,1183,0,3,1,3,0,1,0,76.14,66.02 ,33.33
03,006,01,004,0092,0,732,12,744,1063,0,3,1,3,0,1,0,76.14,69.99 ,33.33
03,006,01,004,0093,0,1340,11,1351,2027,0,3,1,3,0,1,0,76.14,66.65 ,33.33
03,006,01,004,0094,0,473,6,479,731,0,3,1,3,0,1,0,76.14,65.53 ,33.33
03,006,01,004,0095,0,1245,12,1257,1840,0,3,1,3,0,1,0,76.14,68.32 ,33.33
03,006,01,004,0096,0,944,12,956,1438,0,3,1,3,0,1,0,76.14,66.48 ,33.33
03,006,01,004,0097,0,509,8,517,736,0,3,1,3,0,1,0,76.14,70.24 ,33.33
03,006,01,004,0098,0,302,6,308,450,0,3,1,3,0,1,0,76.14,68.44 ,33.33
03,006,01,004,0099,0,1572,36,1608,2408,0,3,1,3,0,1,0,76.14,66.78 ,33.33
03,006,01,004,0100,0,3151,46,3197,4752,0,3,1,3,0,1,0,76.14,67.28 ,33.33
03,006,01,004,0101,0,733,17,750,1158,0,3,1,3,0,1,0,76.14,64.77 ,33.33
03,006,01,004,0102,0,929,19,948,1434,0,3,1,3,0,1,0,76.14,66.11 ,33.33
03,006,01,004,0103,0,2180,33,2213,3371,0,3,1,3,0,1,0,76.14,65.65 ,33.33
03,006,01,004,0104,0,1723,29,1752,2634,0,3,1,3,0,1,0,76.14,66.51 ,33.33
03,006,01,004,0105,0,1214,26,1240,1842,0,3,1,3,0,1,0,76.14,67.32 ,33.33
03,006,01,004,0106,0,2167,40,2207,3377,0,3,1,3,0,1,0,76.14,65.35 ,33.33
03,006,01,004,0107,0,983,9,992,1453,0,3,1,3,0,1,0,76.14,68.27 ,33.33
03,006,01,004,0108,0,830,21,851,1315,0,3,1,3,0,1,0,76.14,64.71 ,33.33
03,006,01,004,0109,0,836,15,851,1285,0,3,1,3,0,1,0,76.14,66.23 ,33.33
03,006,01,004,0110,0,750,13,763,1263,0,3,1,3,0,1,0,76.14,60.41 ,33.33
03,006,01,004,0111,0,677,21,698,1061,0,3,1,3,0,1,0,76.14,65.79 ,33.33
03,006,01,004,0112,0,804,6,810,1222,0,3,1,3,0,1,0,76.14,66.28 ,33.33
03,006,01,004,0113,0,1199,15,1214,1967,0,3,1,3,0,1,0,76.14,61.72 ,33.33
03,006,01,004,0114,0,1348,26,1374,2152,0,3,1,3,0,1,0,76.14,63.85 ,33.33
03,006,01,004,0115,0,1069,13,1082,1708,0,3,1,3,0,1,0,76.14,63.35 ,33.33
03,006,01,004,0116,0,1245,21,1266,2072,0,3,1,3,0,1,0,76.14,61.10 ,33.33
03,006,01,004,0117,0,3369,39,3408,5429,0,3,1,3,0,1,0,76.14,62.77 ,33.33
03,006,01,004,0118,0,1827,19,1846,2840,0,3,1,3,0,1,0,76.14,65.00 ,33.33
03,006,01,004,0119,0,712,17,729,1102,0,3,1,3,0,1,0,76.14,66.15 ,33.33
03,006,01,004,0120,0,899,17,916,1244,0,3,1,3,0,1,0,76.14,73.63 ,33.33
03,006,01,004,0121,0,649,10,659,1004,0,3,1,3,0,1,0,76.14,65.64 ,33.33
03,006,01,004,0122,0,677,11,688,1174,0,3,1,3,0,1,0,76.14,58.60 ,33.33
03,006,01,005,0123,0,936,11,947,1384,0,3,1,3,0,1,0,76.14,68.42 ,33.33
03,006,01,005,0124,0,1507,24,1531,2176,0,3,1,3,0,1,0,76.14,70.36 ,33.33
03,006,01,005,0125,0,789,6,795,1164,0,3,1,3,0,1,0,76.14,68.30 ,33.33
03,006,01,005,0126,0,413,4,417,557,0,3,1,3,0,1,0,76.14,74.87 ,33.33
03,006,01,005,0127,0,1493,28,1521,2249,0,3,1,3,0,1,0,76.14,67.63 ,33.33
03,006,01,005,0128,0,1740,31,1771,2509,0,3,1,3,0,1,0,76.14,70.59 ,33.33
03,006,01,005,0129,0,2380,45,2425,3533,0,3,1,3,0,1,0,76.14,68.64 ,33.33
03,006,01,005,0130,0,2360,41,2401,3711,0,3,1,3,0,1,0,76.14,64.70 ,33.33
03,006,01,005,0131,0,3202,47,3249,4898,0,3,1,3,0,1,0,76.14,66.33 ,33.33
03,006,01,005,0132,0,3448,60,3508,5183,0,3,1,3,0,1,0,76.14,67.68 ,33.33
03,006,01,005,0133,0,587,7,594,843,0,3,1,3,0,1,0,76.14,70.46 ,33.33
03,006,01,005,0134,0,1444,16,1460,2107,0,3,1,3,0,1,0,76.14,69.29 ,33.33
03,006,01,005,0135,0,2082,40,2122,3082,0,3,1,3,0,1,0,76.14,68.85 ,33.33
03,006,01,005,0136,0,849,18,867,1189,0,3,1,3,0,1,0,76.14,72.92 ,33.33
03,006,01,005,0137,0,1357,27,1384,2044,0,3,1,3,0,1,0,76.14,67.71 ,33.33
03,006,01,005,0138,0,1271,25,1296,1764,0,3,1,3,0,1,0,76.14,73.47 ,33.33
03,006,01,005,0139,0,2844,47,2891,3923,0,3,1,3,0,1,0,76.14,73.69 ,33.33
03,006,01,005,0140,0,2201,31,2232,3370,0,3,1,3,0,1,0,76.14,66.23 ,33.33
03,006,01,005,0141,0,1198,17,1215,1750,0,3,1,3,0,1,0,76.14,69.43 ,33.33
03,006,01,005,0142,0,1334,31,1365,1985,0,3,1,3,0,1,0,76.14,68.77 ,33.33
03,006,01,006,0143,0,1693,25,1718,2416,0,3,1,3,0,1,0,76.14,71.11 ,33.33
03,006,01,006,0144,0,1387,33,1420,1947,0,3,1,3,0,1,0,76.14,72.93 ,33.33
03,006,01,006,0145,0,2177,38,2215,3182,0,3,1,3,0,1,0,76.14,69.61 ,33.33
03,006,01,006,0146,0,414,5,419,554,0,3,1,3,0,1,0,76.14,75.63 ,33.33
03,006,01,006,0147,0,888,19,907,1151,0,3,1,3,0,1,0,76.14,78.80 ,33.33
03,006,01,006,0148,0,537,10,547,741,0,3,1,3,0,1,0,76.14,73.82 ,33.33
03,006,01,006,0149,0,3405,61,3466,4833,0,3,1,3,0,1,0,76.14,71.72 ,33.33
03,006,01,006,0150,0,1633,35,1668,2283,0,3,1,3,0,1,0,76.14,73.06 ,33.33
03,006,01,006,0151,0,1849,32,1881,2640,0,3,1,3,0,1,0,76.14,71.25 ,33.33
03,006,01,006,0152,0,3248,73,3321,4730,0,3,1,3,0,1,0,76.14,70.21 ,33.33
03,006,01,006,0153,0,2281,45,2326,3301,0,3,1,3,0,1,0,76.14,70.46 ,33.33
03,006,01,006,0154,0,1239,27,1266,1712,0,3,1,3,0,1,0,76.14,73.95 ,33.33
03,006,01,006,0155,0,1527,32,1559,2052,0,3,1,3,0,1,0,76.14,75.97 ,33.33
03,006,01,006,0156,0,1569,32,1601,2178,0,3,1,3,0,1,0,76.14,73.51 ,33.33
03,006,01,007,0157,0,1295,32,1327,1841,0,3,1,3,0,1,0,76.14,72.08 ,33.33
03,006,01,007,0158,0,1618,22,1640,2258,0,3,1,3,0,1,0,76.14,72.63 ,33.33
03,006,01,007,0159,0,3375,52,3427,5049,0,3,1,3,0,1,0,76.14,67.87 ,33.33
03,006,01,007,0160,0,2324,39,2363,3318,0,3,1,3,0,1,0,76.14,71.22 ,33.33
03,006,01,007,0161,0,1233,19,1252,1777,0,3,1,3,0,1,0,76.14,70.46 ,33.33
03,006,01,007,0162,0,2746,48,2794,3903,0,3,1,3,0,1,0,76.14,71.59 ,33.33
03,006,01,007,0163,0,1306,21,1327,1811,0,3,1,3,0,1,0,76.14,73.27 ,33.33
03,006,01,007,0164,0,1675,24,1699,2458,0,3,1,3,0,1,0,76.14,69.12 ,33.33
03,006,01,007,0165,0,1910,36,1946,2702,0,3,1,3,0,1,0,76.14,72.02 ,33.33
03,006,01,007,0166,0,1327,22,1349,1866,0,3,1,3,0,1,0,76.14,72.29 ,33.33
03,006,01,007,0167,0,863,29,892,1226,0,3,1,3,0,1,0,76.14,72.76 ,33.33
03,006,01,007,0168,0,988,23,1011,1461,0,3,1,3,0,1,0,76.14,69.20 ,33.33
03,006,01,007,0169,0,1333,25,1358,1915,0,3,1,3,0,1,0,76.14,70.91 ,33.33
03,006,01,007,0170,0,1607,25,1632,2382,0,3,1,3,0,1,0,76.14,68.51 ,33.33
03,006,01,007,0171,0,234,8,242,331,0,3,1,3,0,1,0,76.14,73.11 ,33.33
03,006,01,007,0172,0,1081,24,1105,1538,0,3,1,3,0,1,0,76.14,71.85 ,33.33
03,006,01,007,0173,0,1141,22,1163,1687,0,3,1,3,0,1,0,76.14,68.94 ,33.33
03,006,01,007,0174,0,844,18,862,1231,0,3,1,3,0,1,0,76.14,70.02 ,33.33
03,006,01,008,0175,0,1630,16,1646,2353,0,3,1,3,0,1,0,76.14,69.95 ,33.33
03,006,01,008,0176,0,1012,9,1021,1468,0,3,1,3,0,1,0,76.14,69.55 ,33.33
03,006,01,008,0177,0,1409,20,1429,2025,0,3,1,3,0,1,0,76.14,70.57 ,33.33
03,006,01,008,0178,0,1288,27,1315,1920,0,3,1,3,0,1,0,76.14,68.49 ,33.33
03,006,01,008,0179,0,1406,29,1435,2058,0,3,1,3,0,1,0,76.14,69.73 ,33.33
03,006,01,008,0180,0,1364,22,1386,1917,0,3,1,3,0,1,0,76.14,72.30 ,33.33
03,006,01,008,0181,0,2262,38,2300,3432,0,3,1,3,0,1,0,76.14,67.02 ,33.33
03,006,01,008,0182,0,645,11,656,897,0,3,1,3,0,1,0,76.14,73.13 ,33.33
03,006,01,008,0183,0,3336,35,3371,4931,0,3,1,3,0,1,0,76.14,68.36 ,33.33
03,006,01,008,0184,0,2503,50,2553,3816,0,3,1,3,0,1,0,76.14,66.90 ,33.33
03,006,01,008,0185,0,1357,21,1378,2027,0,3,1,3,0,1,0,76.14,67.98 ,33.33
03,006,01,008,0186,0,1861,28,1889,2938,0,3,1,3,0,1,0,76.14,64.30 ,33.33
03,006,01,008,0187,0,1659,24,1683,2378,0,3,1,3,0,1,0,76.14,70.77 ,33.33
03,006,01,008,0188,0,3870,76,3946,5941,0,3,1,3,0,1,0,76.14,66.42 ,33.33
03,006,01,008,0189,0,1490,37,1527,2203,0,3,1,3,0,1,0,76.14,69.31 ,33.33
03,006,01,008,0190,0,1708,40,1748,2418,0,3,1,3,0,1,0,76.14,72.29 ,33.33
03,006,01,009,0191,0,923,8,931,1357,0,3,1,3,0,1,0,76.14,68.61 ,33.33
03,006,01,009,0192,0,1279,26,1305,1998,0,3,1,3,0,1,0,76.14,65.32 ,33.33
03,006,01,009,0193,0,5099,64,5163,8159,0,3,1,3,0,1,0,76.14,63.28 ,33.33
03,006,01,009,0194,0,4100,72,4172,6697,0,3,1,3,0,1,0,76.14,62.30 ,33.33
03,006,01,009,0195,0,7235,108,7343,11975,0,3,1,3,0,1,0,76.14,61.32 ,33.33
03,006,01,009,0196,0,3619,51,3670,5873,0,3,1,3,0,1,0,76.14,62.49 ,33.33
03,006,01,009,0197,0,5358,80,5438,8319,0,3,1,3,0,1,0,76.14,65.37 ,33.33
03,006,01,009,0198,0,1042,22,1064,1678,0,3,1,3,0,1,0,76.14,63.41 ,33.33
03,006,01,009,0199,0,1877,27,1904,2960,0,3,1,3,0,1,0,76.14,64.32 ,33.33
03,006,01,009,0200,0,2668,36,2704,4017,0,3,1,3,0,1,0,76.14,67.31 ,33.33
03,006,01,009,0201,0,2112,47,2159,3235,0,3,1,3,0,1,0,76.14,66.74 ,33.33
03,006,01,009,0202,0,861,18,879,1442,0,3,1,3,0,1,0,76.14,60.96 ,33.33
03,006,01,009,0203,0,1731,34,1765,2802,0,3,1,3,0,1,0,76.14,62.99 ,33.33
03,006,01,010,0204,0,2179,36,2215,3569,0,3,1,3,0,1,0,76.14,62.06 ,33.33
03,006,01,010,0205,0,2336,24,2360,3649,0,3,1,3,0,1,0,76.14,64.68 ,33.33
03,006,01,010,0206,0,2545,53,2598,4145,0,3,1,3,0,1,0,76.14,62.68 ,33.33
03,006,01,010,0207,0,2156,39,2195,3481,0,3,1,3,0,1,0,76.14,63.06 ,33.33
03,006,01,010,0208,0,2078,29,2107,3415,0,3,1,3,0,1,0,76.14,61.70 ,33.33
03,006,01,010,0209,0,1724,20,1744,2785,0,3,1,3,0,1,0,76.14,62.62 ,33.33
03,006,01,010,0210,0,1853,27,1880,2910,0,3,1,3,0,1,0,76.14,64.60 ,33.33
03,006,01,010,0211,0,5539,107,5646,9253,0,3,1,3,0,1,0,76.14,61.02 ,33.33
03,006,01,010,0212,0,3546,53,3599,5420,0,3,1,3,0,1,0,76.14,66.40 ,33.33
03,006,01,010,0213,0,3350,48,3398,5116,0,3,1,3,0,1,0,76.14,66.42 ,33.33
03,006,01,010,0214,0,1786,32,1818,2632,0,3,1,3,0,1,0,76.14,69.07 ,33.33
03,006,01,010,0215,0,2077,33,2110,3139,0,3,1,3,0,1,0,76.14,67.22 ,33.33
03,006,01,010,0216,0,2158,32,2190,3162,0,3,1,3,0,1,0,76.14,69.26 ,33.33
03,006,01,011,0217,0,1949,28,1977,2777,0,3,1,3,0,1,0,76.14,71.19 ,33.33
03,006,01,011,0218,0,1126,20,1146,1675,0,3,1,3,0,1,0,76.14,68.42 ,33.33
03,006,01,011,0219,0,843,18,861,1208,0,3,1,3,0,1,0,76.14,71.27 ,33.33
03,006,01,011,0220,0,606,12,618,911,0,3,1,3,0,1,0,76.14,67.84 ,33.33
03,006,01,011,0221,0,806,21,827,1194,0,3,1,3,0,1,0,76.14,69.26 ,33.33
03,006,01,011,0222,0,1309,25,1334,1939,0,3,1,3,0,1,0,76.14,68.80 ,33.33
03,006,01,011,0223,0,1723,61,1784,2564,0,3,1,3,0,1,0,76.14,69.58 ,33.33
03,006,01,011,0224,0,547,10,557,770,0,3,1,3,0,1,0,76.14,72.34 ,33.33
03,006,01,011,0225,0,1735,24,1759,2500,0,3,1,3,0,1,0,76.14,70.36 ,33.33
03,006,01,011,0226,0,870,14,884,1269,0,3,1,3,0,1,0,76.14,69.66 ,33.33
03,006,01,011,0227,0,587,11,598,861,0,3,1,3,0,1,0,76.14,69.45 ,33.33
03,006,01,011,0228,0,378,7,385,584,0,3,1,3,0,1,0,76.14,65.92 ,33.33
03,006,01,011,0229,0,821,18,839,1269,0,3,1,3,0,1,0,76.14,66.12 ,33.33
03,006,01,012,0230,0,661,14,675,975,0,3,1,3,0,1,0,76.14,69.23 ,33.33
03,006,01,012,0231,0,761,8,769,1070,0,3,1,3,0,1,0,76.14,71.87 ,33.33
03,006,01,012,0232,0,722,19,741,1037,0,3,1,3,0,1,0,76.14,71.46 ,33.33
03,006,01,012,0233,0,758,22,780,1185,0,3,1,3,0,1,0,76.14,65.82 ,33.33
03,006,01,012,0234,0,461,3,464,649,0,3,1,3,0,1,0,76.14,71.49 ,33.33
03,006,01,012,0235,0,921,12,933,1264,0,3,1,3,0,1,0,76.14,73.81 ,33.33
03,006,01,012,0236,0,1084,13,1097,1677,0,3,1,3,0,1,0,76.14,65.41 ,33.33
03,006,01,012,0237,0,606,11,617,920,0,3,1,3,0,1,0,76.14,67.07 ,33.33
03,006,01,012,0238,0,832,18,850,1236,0,3,1,3,0,1,0,76.14,68.77 ,33.33
03,006,01,012,0239,0,843,17,860,1215,0,3,1,3,0,1,0,76.14,70.78 ,33.33
03,006,01,013,0240,0,697,18,715,982,0,3,1,3,0,1,0,76.14,72.81 ,33.33
03,006,01,013,0241,0,993,17,1010,1471,0,3,1,3,0,1,0,76.14,68.66 ,33.33
03,006,01,013,0242,0,1062,17,1079,1675,0,3,1,3,0,1,0,76.14,64.42 ,33.33
03,006,01,013,0243,0,2351,29,2380,3414,0,3,1,3,0,1,0,76.14,69.71 ,33.33
03,006,01,013,0244,0,1733,31,1764,2690,0,3,1,3,0,1,0,76.14,65.58 ,33.33
03,006,01,013,0245,0,2818,48,2866,4437,0,3,1,3,0,1,0,76.14,64.59 ,33.33
03,006,01,013,0246,0,893,12,905,1323,0,3,1,3,0,1,0,76.14,68.41 ,33.33
03,006,01,013,0247,0,761,8,769,1004,0,3,1,3,0,1,0,76.14,76.59 ,33.33
03,006,01,013,0248,0,1395,26,1421,1982,0,3,1,3,0,1,0,76.14,71.70 ,33.33
03,006,01,013,0249,0,1063,17,1080,1516,0,3,1,3,0,1,0,76.14,71.24 ,33.33
03,006,01,013,0250,0,809,17,826,1163,0,3,1,3,0,1,0,76.14,71.02 ,33.33
03,006,01,014,0251,0,785,10,795,1061,0,3,1,3,0,1,0,76.14,74.93 ,33.33
03,006,01,014,0252,0,781,15,796,1104,0,3,1,3,0,1,0,76.14,72.10 ,33.33
03,006,01,014,0253,0,1571,24,1595,2338,0,3,1,3,0,1,0,76.14,68.22 ,33.33
03,006,01,014,0254,0,857,11,868,1172,0,3,1,3,0,1,0,76.14,74.06 ,33.33
03,006,01,014,0255,0,762,8,770,1115,0,3,1,3,0,1,0,76.14,69.06 ,33.33
03,006,01,014,0256,0,1174,26,1200,1563,0,3,1,3,0,1,0,76.14,76.78 ,33.33
03,006,01,014,0257,0,602,10,612,856,0,3,1,3,0,1,0,76.14,71.50 ,33.33
03,006,01,014,0258,0,1105,13,1118,1581,0,3,1,3,0,1,0,76.14,70.71 ,33.33
03,006,01,014,0259,0,652,7,659,985,0,3,1,3,0,1,0,76.14,66.90 ,33.33
03,006,01,014,0260,0,982,12,994,1353,0,3,1,3,0,1,0,76.14,73.47 ,33.33
03,006,01,014,0261,0,896,8,904,1333,0,3,1,3,0,1,0,76.14,67.82 ,33.33
03,006,01,014,0262,0,567,3,570,728,0,3,1,3,0,1,0,76.14,78.30 ,33.33
03,006,01,015,0263,0,3630,59,3689,5425,0,3,1,3,0,1,0,76.14,68.00 ,33.33
03,006,01,015,0264,0,1422,19,1441,2176,0,3,1,3,0,1,0,76.14,66.22 ,33.33
03,006,01,015,0265,0,2291,39,2330,3372,0,3,1,3,0,1,0,76.14,69.10 ,33.33
03,006,01,015,0266,0,1787,34,1821,2588,0,3,1,3,0,1,0,76.14,70.36 ,33.33
03,006,01,015,0267,0,1313,23,1336,1930,0,3,1,3,0,1,0,76.14,69.22 ,33.33
03,006,01,015,0268,0,5758,77,5835,8953,0,3,1,3,0,1,0,76.14,65.17 ,33.33
03,006,01,015,0269,0,2919,49,2968,4727,0,3,1,3,0,1,0,76.14,62.79 ,33.33
03,006,01,015,0270,0,1383,27,1410,2010,0,3,1,3,0,1,0,76.14,70.15 ,33.33
03,006,01,015,0271,0,1010,12,1022,1426,0,3,1,3,0,1,0,76.14,71.67 ,33.33
03,006,01,015,0272,0,1386,14,1400,2006,0,3,1,3,0,1,0,76.14,69.79 ,33.33
03,006,01,015,0273,0,1128,18,1146,1575,0,3,1,3,0,1,0,76.14,72.76 ,33.33
03,006,01,015,0274,0,2318,30,2348,3441,0,3,1,3,0,1,0,76.14,68.24 ,33.33
03,006,01,015,0275,0,1038,20,1058,1487,0,3,1,3,0,1,0,76.14,71.15 ,33.33
03,006,01,015,0276,0,867,14,881,1292,0,3,1,3,0,1,0,76.14,68.19 ,33.33
03,006,01,015,0277,0,752,13,765,1065,0,3,1,3,0,1,0,76.14,71.83 ,33.33
03,006,01,015,0278,0,509,18,527,811,0,3,1,3,0,1,0,76.14,64.98 ,33.33
03,006,01,016,0279,0,2363,40,2403,3489,0,3,1,3,0,1,0,76.14,68.87 ,33.33
03,006,01,016,0280,0,602,7,609,786,0,3,1,3,0,1,0,76.14,77.48 ,33.33
03,006,01,016,0281,0,2072,32,2104,3123,0,3,1,3,0,1,0,76.14,67.37 ,33.33
03,006,01,016,0282,0,916,17,933,1251,0,3,1,3,0,1,0,76.14,74.58 ,33.33
03,006,01,016,0283,0,1553,25,1578,2164,0,3,1,3,0,1,0,76.14,72.92 ,33.33
03,006,01,016,0284,0,1384,13,1397,2112,0,3,1,3,0,1,0,76.14,66.15 ,33.33
03,006,01,016,0285,0,1726,23,1749,2534,0,3,1,3,0,1,0,76.14,69.02 ,33.33
03,006,01,016,0286,0,1302,10,1312,1786,0,3,1,3,0,1,0,76.14,73.46 ,33.33
03,006,01,016,0287,0,642,4,646,840,0,3,1,3,0,1,0,76.14,76.90 ,33.33
03,006,01,016,0288,0,921,9,930,1296,0,3,1,3,0,1,0,76.14,71.76 ,33.33
03,006,01,016,0289,0,1031,14,1045,1475,0,3,1,3,0,1,0,76.14,70.85 ,33.33
03,006,01,016,0290,0,597,4,601,856,0,3,1,3,0,1,0,76.14,70.21 ,33.33
03,006,01,016,0291,0,884,20,904,1308,0,3,1,3,0,1,0,76.14,69.11 ,33.33
03,006,01,016,0292,0,2755,37,2792,4138,0,3,1,3,0,1,0,76.14,67.47 ,33.33
03,006,01,016,0293,0,2469,40,2509,3599,0,3,1,3,0,1,0,76.14,69.71 ,33.33
03,006,01,016,0294,0,4053,68,4121,6115,0,3,1,3,0,1,0,76.14,67.39 ,33.33
03,006,01,017,0295,0,1392,22,1414,2120,0,3,1,3,0,1,0,76.14,66.70 ,33.33
03,006,01,017,0296,0,1458,20,1478,2220,0,3,1,3,0,1,0,76.14,66.58 ,33.33
03,006,01,017,0297,0,1069,17,1086,1495,0,3,1,3,0,1,0,76.14,72.64 ,33.33
03,006,01,017,0298,0,1635,25,1660,2417,0,3,1,3,0,1,0,76.14,68.68 ,33.33
03,006,01,017,0299,0,668,23,691,970,0,3,1,3,0,1,0,76.14,71.24 ,33.33
03,006,01,017,0300,0,1376,28,1404,1952,0,3,1,3,0,1,0,76.14,71.93 ,33.33
03,006,01,017,0301,0,2822,54,2876,4120,0,3,1,3,0,1,0,76.14,69.81 ,33.33
03,006,01,017,0302,0,1582,35,1617,2379,0,3,1,3,0,1,0,76.14,67.97 ,33.33
03,006,01,017,0303,0,2562,40,2602,3686,0,3,1,3,0,1,0,76.14,70.59 ,33.33
03,006,01,017,0304,0,2279,28,2307,3584,0,3,1,3,0,1,0,76.14,64.37 ,33.33
03,006,01,017,0305,0,2664,39,2703,4056,0,3,1,3,0,1,0,76.14,66.64 ,33.33
03,006,01,017,0306,0,1270,30,1300,1940,0,3,1,3,0,1,0,76.14,67.01 ,33.33
03,006,01,017,0307,0,2808,46,2854,4232,0,3,1,3,0,1,0,76.14,67.44 ,33.33
03,006,01,017,0308,0,923,13,936,1307,0,3,1,3,0,1,0,76.14,71.61 ,33.33
03,006,01,017,0309,0,3045,35,3080,5114,0,3,1,3,0,1,0,76.14,60.23 ,33.33
03,006,01,017,0310,0,1839,19,1858,3013,0,3,1,3,0,1,0,76.14,61.67 ,33.33
03,006,01,018,0311,0,811,11,822,1141,0,3,1,3,0,1,0,76.14,72.04 ,33.33
03,006,01,018,0312,0,4459,46,4505,7164,0,3,1,3,0,1,0,76.14,62.88 ,33.33
03,006,01,018,0313,0,2482,41,2523,3940,0,3,1,3,0,1,0,76.14,64.04 ,33.33
03,006,01,018,0314,0,1210,18,1228,1824,0,3,1,3,0,1,0,76.14,67.32 ,33.33
03,006,01,018,0315,0,1035,8,1043,1551,0,3,1,3,0,1,0,76.14,67.25 ,33.33
03,006,01,018,0316,0,617,5,622,927,0,3,1,3,0,1,0,76.14,67.10 ,33.33
03,006,01,018,0317,0,639,10,649,1026,0,3,1,3,0,1,0,76.14,63.26 ,33.33
03,006,01,018,0318,0,3044,44,3088,4794,0,3,1,3,0,1,0,76.14,64.41 ,33.33
03,006,01,018,0319,0,1932,25,1957,2875,0,3,1,3,0,1,0,76.14,68.07 ,33.33
03,006,01,018,0320,0,918,18,936,1324,0,3,1,3,0,1,0,76.14,70.69 ,33.33
03,006,01,018,0321,0,1324,25,1349,1958,0,3,1,3,0,1,0,76.14,68.90 ,33.33
03,006,01,018,0322,0,1651,26,1677,2293,0,3,1,3,0,1,0,76.14,73.14 ,33.33
03,006,01,018,0323,0,1285,14,1299,1817,0,3,1,3,0,1,0,76.14,71.49 ,33.33
03,006,01,018,0324,0,1062,18,1080,1585,0,3,1,3,0,1,0,76.14,68.14 ,33.33
03,006,01,018,0325,0,744,12,756,1142,0,3,1,3,0,1,0,76.14,66.20 ,33.33
03,006,01,018,0326,0,1527,23,1550,2377,0,3,1,3,0,1,0,76.14,65.21 ,33.33
03,006,01,018,0327,0,1395,17,1412,2012,0,3,1,3,0,1,0,76.14,70.18 ,33.33
03,006,01,018,0328,0,1895,38,1933,2842,0,3,1,3,0,1,0,76.14,68.02 ,33.33
03,006,01,018,0329,0,677,9,686,1037,0,3,1,3,0,1,0,76.14,66.15 ,33.33
03,006,01,018,0330,0,1423,33,1456,2102,0,3,1,3,0,1,0,76.14,69.27 ,33.33
03,006,01,019,0331,0,3200,52,3252,4972,0,3,1,3,0,1,0,76.14,65.41 ,33.33
03,006,01,019,0332,0,4590,49,4639,7434,0,3,1,3,0,1,0,76.14,62.40 ,33.33
03,006,01,019,0333,0,3687,58,3745,5986,0,3,1,3,0,1,0,76.14,62.56 ,33.33
03,006,01,019,0334,0,3872,49,3921,6479,0,3,1,3,0,1,0,76.14,60.52 ,33.33
03,006,01,019,0335,0,5678,89,5767,8761,0,3,1,3,0,1,0,76.14,65.83 ,33.33
03,006,01,019,0336,0,2962,49,3011,4743,0,3,1,3,0,1,0,76.14,63.48 ,33.33
03,006,01,019,0337,0,4770,76,4846,7227,0,3,1,3,0,1,0,76.14,67.05 ,33.33
03,006,01,019,0338,0,4603,72,4675,7138,0,3,1,3,0,1,0,76.14,65.49 ,33.33
03,006,01,019,0339,0,3918,72,3990,6101,0,3,1,3,0,1,0,76.14,65.40 ,33.33
03,006,01,019,0340,0,6910,114,7024,11677,0,3,1,3,0,1,0,76.14,60.15 ,33.33
03,006,01,019,0341,0,5888,91,5979,10431,0,3,1,3,0,1,0,76.14,57.32 ,33.33
03,006,01,019,0342,0,5298,90,5388,8600,0,3,1,3,0,1,0,76.14,62.65 ,33.33
03,006,01,019,0343,0,2422,44,2466,3818,0,3,1,3,0,1,0,76.14,64.59 ,33.33
03,006,01,019,0344,0,2130,29,2159,3307,0,3,1,3,0,1,0,76.14,65.29 ,33.33
03,006,01,019,0345,0,784,11,795,1202,0,3,1,3,0,1,0,76.14,66.14 ,33.33
03,006,01,019,0346,0,3486,55,3541,5495,0,3,1,3,0,1,0,76.14,64.44 ,33.33
03,006,01,019,0347,0,634,13,647,879,0,3,1,3,0,1,0,76.14,73.61 ,33.33
03,006,01,019,0348,0,2816,58,2874,4439,0,3,1,3,0,1,0,76.14,64.74 ,33.33
03,006,01,019,0349,0,2029,30,2059,3292,0,3,1,3,0,1,0,76.14,62.55 ,33.33
03,006,01,020,0350,0,2058,26,2084,3088,0,3,1,3,0,1,0,76.14,67.49 ,33.33
03,006,01,020,0351,0,5721,48,5769,8975,0,3,1,3,0,1,0,76.14,64.28 ,33.33
03,006,01,020,0352,0,1788,21,1809,2679,0,3,1,3,0,1,0,76.14,67.53 ,33.33
03,006,01,020,0353,0,3083,40,3123,5301,0,3,1,3,0,1,0,76.14,58.91 ,33.33
03,006,01,020,0354,0,5271,70,5341,8510,0,3,1,3,0,1,0,76.14,62.76 ,33.33
03,006,01,020,0355,0,1636,14,1650,2565,0,3,1,3,0,1,0,76.14,64.33 ,33.33
03,006,01,020,0356,0,2184,23,2207,3274,0,3,1,3,0,1,0,76.14,67.41 ,33.33
03,006,01,020,0357,0,1335,21,1356,2003,0,3,1,3,0,1,0,76.14,67.70 ,33.33
03,006,01,020,0358,0,668,13,681,926,0,3,1,3,0,1,0,76.14,73.54 ,33.33
03,006,01,020,0359,0,5714,56,5770,9401,0,3,1,3,0,1,0,76.14,61.38 ,33.33
03,006,01,020,0360,0,2659,48,2707,4256,0,3,1,3,0,1,0,76.14,63.60 ,33.33
03,006,01,020,0361,0,4010,48,4058,6346,0,3,1,3,0,1,0,76.14,63.95 ,33.33
03,006,01,020,0362,0,3509,54,3563,5921,0,3,1,3,0,1,0,76.14,60.18 ,33.33
03,006,01,020,0363,0,6192,67,6259,9793,0,3,1,3,0,1,0,76.14,63.91 ,33.33
03,006,01,020,0364,0,1974,36,2010,3121,0,3,1,3,0,1,0,76.14,64.40 ,33.33
03,006,01,020,0365,0,6897,90,6987,11046,0,3,1,3,0,1,0,76.14,63.25 ,33.33
03,006,01,020,0366,0,4629,50,4679,7725,0,3,1,3,0,1,0,76.14,60.57 ,33.33
03,006,01,020,0367,0,4525,64,4589,7331,0,3,1,3,0,1,0,76.14,62.60 ,33.33
03,006,01,020,0368,0,3580,50,3630,5825,0,3,1,3,0,1,0,76.14,62.32 ,33.33
03,006,01,020,0369,0,4827,52,4879,7971,0,3,1,3,0,1,0,76.14,61.21 ,33.33
03,006,01,021,0370,0,873,14,887,1397,0,3,1,3,0,1,0,76.14,63.49 ,33.33
03,006,01,021,0371,0,268,4,272,454,0,3,1,3,0,1,0,76.14,59.91 ,33.33
03,006,01,021,0372,0,652,11,663,1074,0,3,1,3,0,1,0,76.14,61.73 ,33.33
03,006,01,021,0373,0,301,4,305,529,0,3,1,3,0,1,0,76.14,57.66 ,33.33
03,006,01,021,0374,0,332,2,334,545,0,3,1,3,0,1,0,76.14,61.28 ,33.33
03,006,01,021,0375,0,233,3,236,309,0,3,1,3,0,1,0,76.14,76.38 ,33.33
03,006,01,021,0376,0,557,7,564,1347,0,3,1,3,0,1,0,76.14,41.87 ,33.33
03,006,01,021,0377,0,193,6,199,414,0,3,1,3,0,1,0,76.14,48.07 ,33.33
03,007,01,001,0001,0,1824,32,1856,2798,0,3,1,3,0,1,0,76.14,66.33 ,33.33
03,007,01,001,0002,0,1470,19,1489,2230,0,3,1,3,0,1,0,76.14,66.77 ,33.33
03,007,01,001,0003,0,1090,17,1107,1580,0,3,1,3,0,1,0,76.14,70.06 ,33.33
03,007,01,001,0004,0,1035,7,1042,1539,0,3,1,3,0,1,0,76.14,67.71 ,33.33
03,007,01,001,0005,0,1590,99,1689,2416,0,3,1,3,0,1,0,76.14,69.91 ,33.33
03,007,01,001,0006,0,1657,23,1680,2309,0,3,1,3,0,1,0,76.14,72.76 ,33.33
03,007,01,001,0007,0,936,9,945,1357,0,3,1,3,0,1,0,76.14,69.64 ,33.33
03,007,01,001,0008,0,1289,18,1307,1909,0,3,1,3,0,1,0,76.14,68.47 ,33.33
03,007,01,001,0009,0,3820,46,3866,5764,0,3,1,3,0,1,0,76.14,67.07 ,33.33
03,007,01,001,0010,0,2251,29,2280,3316,0,3,1,3,0,1,0,76.14,68.76 ,33.33
03,007,01,001,0011,0,3217,53,3270,4808,0,3,1,3,0,1,0,76.14,68.01 ,33.33
03,007,01,001,0012,0,3976,52,4028,6158,0,3,1,3,0,1,0,76.14,65.41 ,33.33
03,007,01,001,0013,0,987,16,1003,1458,0,3,1,3,0,1,0,76.14,68.79 ,33.33
03,007,01,001,0014,0,740,15,755,1085,0,3,1,3,0,1,0,76.14,69.59 ,33.33
03,007,01,001,0015,0,1011,17,1028,1445,0,3,1,3,0,1,0,76.14,71.14 ,33.33
03,007,01,001,0016,0,734,9,743,1046,0,3,1,3,0,1,0,76.14,71.03 ,33.33
03,007,01,001,0017,0,1794,21,1815,2689,0,3,1,3,0,1,0,76.14,67.50 ,33.33
03,007,01,001,0018,0,2024,19,2043,3045,0,3,1,3,0,1,0,76.14,67.09 ,33.33
03,007,01,001,0019,0,653,3,656,918,0,3,1,3,0,1,0,76.14,71.46 ,33.33
03,007,01,001,0020,0,692,10,702,1012,0,3,1,3,0,1,0,76.14,69.37 ,33.33
03,007,01,001,0021,0,849,8,857,1238,0,3,1,3,0,1,0,76.14,69.22 ,33.33
03,007,01,001,0022,0,845,10,855,1210,0,3,1,3,0,1,0,76.14,70.66 ,33.33
03,007,01,001,0023,0,679,8,687,976,0,3,1,3,0,1,0,76.14,70.39 ,33.33
03,007,01,001,0024,0,1471,12,1483,2197,0,3,1,3,0,1,0,76.14,67.50 ,33.33
03,007,01,001,0025,0,2231,24,2255,3373,0,3,1,3,0,1,0,76.14,66.85 ,33.33
03,007,01,001,0026,0,2759,39,2798,4129,0,3,1,3,0,1,0,76.14,67.76 ,33.33
03,007,01,001,0027,0,1756,22,1778,2672,0,3,1,3,0,1,0,76.14,66.54 ,33.33
03,007,01,001,0028,0,1612,23,1635,2347,0,3,1,3,0,1,0,76.14,69.66 ,33.33
03,007,01,001,0029,0,990,12,1002,1460,0,3,1,3,0,1,0,76.14,68.63 ,33.33
03,007,01,001,0030,0,1182,14,1196,1680,0,3,1,3,0,1,0,76.14,71.19 ,33.33
03,007,01,001,0031,0,1825,26,1851,2757,0,3,1,3,0,1,0,76.14,67.14 ,33.33
03,007,01,001,0032,0,1711,36,1747,2548,0,3,1,3,0,1,0,76.14,68.56 ,33.33
03,007,01,001,0033,0,1663,36,1699,2380,0,3,1,3,0,1,0,76.14,71.39 ,33.33
03,007,01,001,0034,0,1693,16,1709,2454,0,3,1,3,0,1,0,76.14,69.64 ,33.33
03,007,01,001,0035,0,803,7,810,1159,0,3,1,3,0,1,0,76.14,69.89 ,33.33
03,007,01,001,0036,0,2033,31,2064,3094,0,3,1,3,0,1,0,76.14,66.71 ,33.33
03,007,01,001,0037,0,2591,33,2624,3786,0,3,1,3,0,1,0,76.14,69.31 ,33.33
03,007,01,001,0038,0,1208,18,1226,1828,0,3,1,3,0,1,0,76.14,67.07 ,33.33
03,007,01,001,0039,0,946,9,955,1404,0,3,1,3,0,1,0,76.14,68.02 ,33.33
03,007,01,001,0040,0,609,8,617,898,0,3,1,3,0,1,0,76.14,68.71 ,33.33
03,007,01,001,0041,0,939,12,951,1401,0,3,1,3,0,1,0,76.14,67.88 ,33.33
03,007,01,001,0042,0,499,7,506,765,0,3,1,3,0,1,0,76.14,66.14 ,33.33
03,007,01,001,0043,0,618,3,621,948,0,3,1,3,0,1,0,76.14,65.51 ,33.33
03,007,01,001,0044,0,598,7,605,874,0,3,1,3,0,1,0,76.14,69.22 ,33.33
03,007,01,001,0045,0,897,14,911,1354,0,3,1,3,0,1,0,76.14,67.28 ,33.33
03,007,01,001,0046,0,574,8,582,835,0,3,1,3,0,1,0,76.14,69.70 ,33.33
03,007,01,001,0047,0,1447,24,1471,2185,0,3,1,3,0,1,0,76.14,67.32 ,33.33
03,007,01,001,0048,0,948,14,962,1428,0,3,1,3,0,1,0,76.14,67.37 ,33.33
03,007,01,001,0049,0,1181,15,1196,1757,0,3,1,3,0,1,0,76.14,68.07 ,33.33
03,007,01,001,0050,0,2382,27,2409,3577,0,3,1,3,0,1,0,76.14,67.35 ,33.33
03,007,01,001,0051,0,2390,38,2428,3527,0,3,1,3,0,1,0,76.14,68.84 ,33.33
03,007,01,001,0052,0,527,15,542,775,0,3,1,3,0,1,0,76.14,69.94 ,33.33
03,007,01,001,0053,0,1382,22,1404,2061,0,3,1,3,0,1,0,76.14,68.12 ,33.33
03,007,01,001,0054,0,710,13,723,994,0,3,1,3,0,1,0,76.14,72.74 ,33.33
03,007,01,001,0055,0,1360,29,1389,2150,0,3,1,3,0,1,0,76.14,64.60 ,33.33
03,007,01,001,0056,0,3189,56,3245,4993,0,3,1,3,0,1,0,76.14,64.99 ,33.33
03,007,01,001,0057,0,1464,37,1501,2195,0,3,1,3,0,1,0,76.14,68.38 ,33.33
03,007,01,001,0058,0,2568,34,2602,3869,0,3,1,3,0,1,0,76.14,67.25 ,33.33
03,007,01,001,0059,0,1332,24,1356,2060,0,3,1,3,0,1,0,76.14,65.83 ,33.33
03,007,01,001,0060,0,1583,30,1613,2215,0,3,1,3,0,1,0,76.14,72.82 ,33.33
03,007,01,001,0061,0,3707,71,3778,5645,0,3,1,3,0,1,0,76.14,66.93 ,33.33
03,007,01,001,0062,0,630,13,643,930,0,3,1,3,0,1,0,76.14,69.14 ,33.33
03,007,01,001,0063,0,1032,15,1047,1589,0,3,1,3,0,1,0,76.14,65.89 ,33.33
03,007,01,001,0064,0,698,10,708,961,0,3,1,3,0,1,0,76.14,73.67 ,33.33
03,007,01,001,0065,0,1675,24,1699,2564,0,3,1,3,0,1,0,76.14,66.26 ,33.33
03,007,01,001,0066,0,1704,31,1735,2448,0,3,1,3,0,1,0,76.14,70.87 ,33.33
03,007,01,001,0067,0,1879,30,1909,2710,0,3,1,3,0,1,0,76.14,70.44 ,33.33
03,007,01,001,0068,0,2060,22,2082,3250,0,3,1,3,0,1,0,76.14,64.06 ,33.33
03,007,01,001,0069,0,560,6,566,798,0,3,1,3,0,1,0,76.14,70.93 ,33.33
03,007,01,001,0070,0,639,10,649,978,0,3,1,3,0,1,0,76.14,66.36 ,33.33
03,007,01,001,0071,0,560,4,564,778,0,3,1,3,0,1,0,76.14,72.49 ,33.33
03,007,01,001,0072,0,833,13,846,1151,0,3,1,3,0,1,0,76.14,73.50 ,33.33
03,007,01,001,0073,0,767,16,783,1093,0,3,1,3,0,1,0,76.14,71.64 ,33.33
03,007,01,002,0074,0,1932,29,1961,2730,0,3,1,3,0,1,0,76.14,71.83 ,33.33
03,007,01,002,0075,0,1074,16,1090,1569,0,3,1,3,0,1,0,76.14,69.47 ,33.33
03,007,01,002,0076,0,1454,22,1476,2155,0,3,1,3,0,1,0,76.14,68.49 ,33.33
03,007,01,002,0077,0,739,9,748,1000,0,3,1,3,0,1,0,76.14,74.80 ,33.33
03,007,01,002,0078,0,930,17,947,1339,0,3,1,3,0,1,0,76.14,70.72 ,33.33
03,007,01,002,0079,0,961,18,979,1374,0,3,1,3,0,1,0,76.14,71.25 ,33.33
03,007,01,002,0080,0,487,6,493,656,0,3,1,3,0,1,0,76.14,75.15 ,33.33
03,007,01,002,0081,0,1128,11,1139,1522,0,3,1,3,0,1,0,76.14,74.84 ,33.33
03,007,01,002,0082,0,2538,42,2580,3611,0,3,1,3,0,1,0,76.14,71.45 ,33.33
03,007,01,002,0083,0,1506,32,1538,2204,0,3,1,3,0,1,0,76.14,69.78 ,33.33
03,007,01,002,0084,0,2196,40,2236,3403,0,3,1,3,0,1,0,76.14,65.71 ,33.33
03,007,01,002,0085,0,871,13,884,1283,0,3,1,3,0,1,0,76.14,68.90 ,33.33
03,007,01,002,0086,0,1895,29,1924,2835,0,3,1,3,0,1,0,76.14,67.87 ,33.33
03,007,01,002,0087,0,538,11,549,824,0,3,1,3,0,1,0,76.14,66.63 ,33.33
03,007,01,002,0088,0,614,5,619,936,0,3,1,3,0,1,0,76.14,66.13 ,33.33
03,007,01,002,0089,0,966,11,977,1559,0,3,1,3,0,1,0,76.14,62.67 ,33.33
03,007,01,002,0090,0,924,15,939,1400,0,3,1,3,0,1,0,76.14,67.07 ,33.33
03,007,01,002,0091,0,941,14,955,1375,0,3,1,3,0,1,0,76.14,69.45 ,33.33
03,007,01,003,0092,0,1059,20,1079,1663,0,3,1,3,0,1,0,76.14,64.88 ,33.33
03,007,01,003,0093,0,920,7,927,1302,0,3,1,3,0,1,0,76.14,71.20 ,33.33
03,007,01,003,0094,0,1040,24,1064,1561,0,3,1,3,0,1,0,76.14,68.16 ,33.33
03,007,01,003,0095,0,386,8,394,565,0,3,1,3,0,1,0,76.14,69.73 ,33.33
03,007,01,003,0096,0,1458,24,1482,2235,0,3,1,3,0,1,0,76.14,66.31 ,33.33
03,007,01,003,0097,0,1393,24,1417,2128,0,3,1,3,0,1,0,76.14,66.59 ,33.33
03,007,01,003,0098,0,987,14,1001,1452,0,3,1,3,0,1,0,76.14,68.94 ,33.33
03,007,01,003,0099,0,581,6,587,872,0,3,1,3,0,1,0,76.14,67.32 ,33.33
03,007,01,003,0100,0,595,14,609,898,0,3,1,3,0,1,0,76.14,67.82 ,33.33
03,007,01,003,0101,0,694,11,705,1056,0,3,1,3,0,1,0,76.14,66.76 ,33.33
03,007,01,003,0102,0,476,4,480,688,0,3,1,3,0,1,0,76.14,69.77 ,33.33
03,007,01,003,0103,0,962,22,984,1456,0,3,1,3,0,1,0,76.14,67.58 ,33.33
03,007,01,003,0104,0,856,10,866,1260,0,3,1,3,0,1,0,76.14,68.73 ,33.33
03,007,01,003,0105,0,612,9,621,986,0,3,1,3,0,1,0,76.14,62.98 ,33.33
03,007,01,003,0106,0,617,9,626,1066,0,3,1,3,0,1,0,76.14,58.72 ,33.33
03,007,01,004,0107,0,779,9,788,1155,0,3,1,3,0,1,0,76.14,68.23 ,33.33
03,007,01,004,0108,0,374,5,379,556,0,3,1,3,0,1,0,76.14,68.17 ,33.33
03,007,01,004,0109,0,683,4,687,1061,0,3,1,3,0,1,0,76.14,64.75 ,33.33
03,007,01,004,0110,0,608,12,620,870,0,3,1,3,0,1,0,76.14,71.26 ,33.33
03,007,01,004,0111,0,706,8,714,1019,0,3,1,3,0,1,0,76.14,70.07 ,33.33
03,007,01,004,0112,0,1253,16,1269,1859,0,3,1,3,0,1,0,76.14,68.26 ,33.33
03,007,01,004,0113,0,815,15,830,1182,0,3,1,3,0,1,0,76.14,70.22 ,33.33
03,007,01,004,0114,0,203,3,206,315,0,3,1,3,0,1,0,76.14,65.40 ,33.33
03,007,01,004,0115,0,489,6,495,686,0,3,1,3,0,1,0,76.14,72.16 ,33.33
03,007,01,004,0116,0,540,10,550,760,0,3,1,3,0,1,0,76.14,72.37 ,33.33
03,007,01,004,0117,0,785,12,797,1123,0,3,1,3,0,1,0,76.14,70.97 ,33.33
03,007,01,004,0118,0,376,3,379,580,0,3,1,3,0,1,0,76.14,65.34 ,33.33
03,007,01,004,0119,0,646,8,654,926,0,3,1,3,0,1,0,76.14,70.63 ,33.33
03,007,01,004,0120,0,859,14,873,1288,0,3,1,3,0,1,0,76.14,67.78 ,33.33
03,007,01,004,0121,0,2062,34,2096,3053,0,3,1,3,0,1,0,76.14,68.65 ,33.33
03,007,01,004,0122,0,2379,34,2413,3517,0,3,1,3,0,1,0,76.14,68.61 ,33.33
03,007,01,004,0123,0,2020,38,2058,3042,0,3,1,3,0,1,0,76.14,67.65 ,33.33
03,007,01,004,0124,0,3308,44,3352,4847,0,3,1,3,0,1,0,76.14,69.16 ,33.33
03,007,01,004,0125,0,2543,39,2582,3933,0,3,1,3,0,1,0,76.14,65.65 ,33.33
03,007,01,004,0126,0,2064,28,2092,2994,0,3,1,3,0,1,0,76.14,69.87 ,33.33
03,007,01,004,0127,0,979,17,996,1579,0,3,1,3,0,1,0,76.14,63.08 ,33.33
03,007,01,004,0128,0,1789,28,1817,2739,0,3,1,3,0,1,0,76.14,66.34 ,33.33
03,007,01,004,0129,0,1559,20,1579,2307,0,3,1,3,0,1,0,76.14,68.44 ,33.33
03,007,01,004,0130,0,1846,39,1885,2775,0,3,1,3,0,1,0,76.14,67.93 ,33.33
03,007,01,004,0131,0,1940,26,1966,2832,0,3,1,3,0,1,0,76.14,69.42 ,33.33
03,007,01,004,0132,0,1172,26,1198,1750,0,3,1,3,0,1,0,76.14,68.46 ,33.33
03,007,01,004,0133,0,1528,19,1547,2097,0,3,1,3,0,1,0,76.14,73.77 ,33.33
03,007,01,004,0134,0,2036,30,2066,2947,0,3,1,3,0,1,0,76.14,70.11 ,33.33
03,007,01,004,0135,0,2213,35,2248,3247,0,3,1,3,0,1,0,76.14,69.23 ,33.33
03,007,01,005,0136,0,1391,29,1420,2012,0,3,1,3,0,1,0,76.14,70.58 ,33.33
03,007,01,005,0137,0,800,5,805,1077,0,3,1,3,0,1,0,76.14,74.74 ,33.33
03,007,01,005,0138,0,756,8,764,1023,0,3,1,3,0,1,0,76.14,74.68 ,33.33
03,007,01,005,0139,0,892,14,906,1167,0,3,1,3,0,1,0,76.14,77.63 ,33.33
03,007,01,005,0140,0,509,9,518,697,0,3,1,3,0,1,0,76.14,74.32 ,33.33
03,007,01,005,0141,0,898,8,906,1144,0,3,1,3,0,1,0,76.14,79.20 ,33.33
03,007,01,005,0142,0,756,14,770,1064,0,3,1,3,0,1,0,76.14,72.37 ,33.33
03,007,01,005,0143,0,1485,17,1502,2063,0,3,1,3,0,1,0,76.14,72.81 ,33.33
03,007,01,005,0144,0,1062,10,1072,1331,0,3,1,3,0,1,0,76.14,80.54 ,33.33
03,007,01,005,0145,0,936,8,944,1245,0,3,1,3,0,1,0,76.14,75.82 ,33.33
03,007,01,005,0146,0,1373,26,1399,1993,0,3,1,3,0,1,0,76.14,70.20 ,33.33
03,007,01,005,0147,0,1133,19,1152,1609,0,3,1,3,0,1,0,76.14,71.60 ,33.33
03,007,01,005,0148,0,1407,20,1427,1962,0,3,1,3,0,1,0,76.14,72.73 ,33.33
03,007,01,005,0149,0,784,15,799,1095,0,3,1,3,0,1,0,76.14,72.97 ,33.33
03,007,01,005,0150,0,710,13,723,1018,0,3,1,3,0,1,0,76.14,71.02 ,33.33
03,007,01,005,0151,0,1352,27,1379,2021,0,3,1,3,0,1,0,76.14,68.23 ,33.33
03,007,01,005,0152,0,1263,24,1287,1767,0,3,1,3,0,1,0,76.14,72.84 ,33.33
03,007,01,005,0153,0,1469,22,1491,1979,0,3,1,3,0,1,0,76.14,75.34 ,33.33
03,007,01,005,0154,0,849,14,863,1147,0,3,1,3,0,1,0,76.14,75.24 ,33.33
03,007,01,005,0155,0,935,13,948,1241,0,3,1,3,0,1,0,76.14,76.39 ,33.33
03,007,01,005,0156,0,1785,19,1804,2608,0,3,1,3,0,1,0,76.14,69.17 ,33.33
03,007,01,005,0157,0,1468,19,1487,2064,0,3,1,3,0,1,0,76.14,72.04 ,33.33
03,007,01,006,0158,0,1082,12,1094,1567,0,3,1,3,0,1,0,76.14,69.81 ,33.33
03,007,01,006,0159,0,972,21,993,1432,0,3,1,3,0,1,0,76.14,69.34 ,33.33
03,007,01,006,0160,0,1354,16,1370,1983,0,3,1,3,0,1,0,76.14,69.09 ,33.33
03,007,01,006,0161,0,832,6,838,1165,0,3,1,3,0,1,0,76.14,71.93 ,33.33
03,007,01,006,0162,0,1152,19,1171,1634,0,3,1,3,0,1,0,76.14,71.66 ,33.33
03,007,01,006,0163,0,2137,31,2168,3123,0,3,1,3,0,1,0,76.14,69.42 ,33.33
03,007,01,006,0164,0,1801,29,1830,2539,0,3,1,3,0,1,0,76.14,72.08 ,33.33
03,007,01,006,0165,0,1428,25,1453,1904,0,3,1,3,0,1,0,76.14,76.31 ,33.33
03,007,01,006,0166,0,759,14,773,1090,0,3,1,3,0,1,0,76.14,70.92 ,33.33
03,007,01,006,0167,0,2176,34,2210,3195,0,3,1,3,0,1,0,76.14,69.17 ,33.33
03,007,01,006,0168,0,1218,19,1237,1694,0,3,1,3,0,1,0,76.14,73.02 ,33.33
03,007,01,006,0169,0,944,13,957,1303,0,3,1,3,0,1,0,76.14,73.45 ,33.33
03,007,01,006,0170,0,984,16,1000,1364,0,3,1,3,0,1,0,76.14,73.31 ,33.33
03,007,01,006,0171,0,1368,17,1385,1829,0,3,1,3,0,1,0,76.14,75.72 ,33.33
03,007,01,007,0172,0,2506,39,2545,3754,0,3,1,3,0,1,0,76.14,67.79 ,33.33
03,007,01,007,0173,0,2190,36,2226,3303,0,3,1,3,0,1,0,76.14,67.39 ,33.33
03,007,01,007,0174,0,348,5,353,465,0,3,1,3,0,1,0,76.14,75.91 ,33.33
03,007,01,007,0175,0,936,13,949,1338,0,3,1,3,0,1,0,76.14,70.93 ,33.33
03,007,01,007,0176,0,1984,33,2017,2995,0,3,1,3,0,1,0,76.14,67.35 ,33.33
03,007,01,007,0177,0,1452,23,1475,2188,0,3,1,3,0,1,0,76.14,67.41 ,33.33
03,007,01,007,0178,0,894,23,917,1257,0,3,1,3,0,1,0,76.14,72.95 ,33.33
03,007,01,007,0179,0,563,11,574,767,0,3,1,3,0,1,0,76.14,74.84 ,33.33
03,007,01,007,0180,0,1193,16,1209,1617,0,3,1,3,0,1,0,76.14,74.77 ,33.33
03,007,01,007,0181,0,1579,16,1595,2275,0,3,1,3,0,1,0,76.14,70.11 ,33.33
03,007,01,007,0182,0,864,16,880,1235,0,3,1,3,0,1,0,76.14,71.26 ,33.33
03,007,01,007,0183,0,1057,14,1071,1510,0,3,1,3,0,1,0,76.14,70.93 ,33.33
03,007,01,007,0184,0,1090,24,1114,1615,0,3,1,3,0,1,0,76.14,68.98 ,33.33
03,007,01,007,0185,0,870,12,882,1224,0,3,1,3,0,1,0,76.14,72.06 ,33.33
03,007,01,007,0186,0,3332,46,3378,5044,0,3,1,3,0,1,0,76.14,66.97 ,33.33
03,007,01,007,0187,0,972,21,993,1527,0,3,1,3,0,1,0,76.14,65.03 ,33.33
03,007,01,007,0188,0,1062,19,1081,1599,0,3,1,3,0,1,0,76.14,67.60 ,33.33
03,007,01,007,0189,0,1432,30,1462,2289,0,3,1,3,0,1,0,76.14,63.87 ,33.33
03,007,01,007,0190,0,1806,37,1843,2613,0,3,1,3,0,1,0,76.14,70.53 ,33.33
03,007,01,007,0191,0,615,6,621,779,0,3,1,3,0,1,0,76.14,79.72 ,33.33
03,007,01,007,0192,0,1461,29,1490,2180,0,3,1,3,0,1,0,76.14,68.35 ,33.33
03,007,01,007,0193,0,1445,34,1479,2008,0,3,1,3,0,1,0,76.14,73.66 ,33.33
03,007,01,007,0194,0,712,14,726,1051,0,3,1,3,0,1,0,76.14,69.08 ,33.33
03,007,01,007,0195,0,1611,32,1643,2482,0,3,1,3,0,1,0,76.14,66.20 ,33.33
03,007,01,007,0196,0,1596,16,1612,2368,0,3,1,3,0,1,0,76.14,68.07 ,33.33
03,007,01,007,0197,0,1061,19,1080,1602,0,3,1,3,0,1,0,76.14,67.42 ,33.33
03,007,01,007,0198,0,548,10,558,834,0,3,1,3,0,1,0,76.14,66.91 ,33.33
03,007,01,007,0199,0,885,7,892,1227,0,3,1,3,0,1,0,76.14,72.70 ,33.33
03,007,01,007,0200,0,1119,30,1149,1683,0,3,1,3,0,1,0,76.14,68.27 ,33.33
03,007,01,007,0201,0,1854,35,1889,2745,0,3,1,3,0,1,0,76.14,68.82 ,33.33
03,007,01,007,0202,0,1094,24,1118,1625,0,3,1,3,0,1,0,76.14,68.80 ,33.33
03,007,01,008,0203,0,1212,27,1239,1840,0,3,1,3,0,1,0,76.14,67.34 ,33.33
03,007,01,008,0204,0,761,7,768,1115,0,3,1,3,0,1,0,76.14,68.88 ,33.33
03,007,01,008,0205,0,1217,21,1238,1882,0,3,1,3,0,1,0,76.14,65.78 ,33.33
03,007,01,008,0206,0,796,9,805,1143,0,3,1,3,0,1,0,76.14,70.43 ,33.33
03,007,01,008,0207,0,666,14,680,976,0,3,1,3,0,1,0,76.14,69.67 ,33.33
03,007,01,008,0208,0,1072,24,1096,1574,0,3,1,3,0,1,0,76.14,69.63 ,33.33
03,007,01,008,0209,0,1414,21,1435,2086,0,3,1,3,0,1,0,76.14,68.79 ,33.33
03,007,01,008,0210,0,719,10,729,1023,0,3,1,3,0,1,0,76.14,71.26 ,33.33
03,007,01,009,0211,0,2503,34,2537,3927,0,3,1,3,0,1,0,76.14,64.60 ,33.33
03,007,01,009,0212,0,953,16,969,1448,0,3,1,3,0,1,0,76.14,66.92 ,33.33
03,007,01,009,0213,0,851,16,867,1206,0,3,1,3,0,1,0,76.14,71.89 ,33.33
03,007,01,009,0214,0,1137,16,1153,1564,0,3,1,3,0,1,0,76.14,73.72 ,33.33
03,007,01,009,0215,0,919,14,933,1418,0,3,1,3,0,1,0,76.14,65.80 ,33.33
03,007,01,009,0216,0,1031,11,1042,1505,0,3,1,3,0,1,0,76.14,69.24 ,33.33
03,007,01,009,0217,0,1341,22,1363,2093,0,3,1,3,0,1,0,76.14,65.12 ,33.33
03,007,01,009,0218,0,1090,18,1108,1590,0,3,1,3,0,1,0,76.14,69.69 ,33.33
03,007,01,009,0219,0,744,14,758,1122,0,3,1,3,0,1,0,76.14,67.56 ,33.33
03,007,01,009,0220,0,955,12,967,1459,0,3,1,3,0,1,0,76.14,66.28 ,33.33
03,007,01,009,0221,0,746,8,754,1121,0,3,1,3,0,1,0,76.14,67.26 ,33.33
03,007,01,009,0222,0,580,11,591,886,0,3,1,3,0,1,0,76.14,66.70 ,33.33
03,007,01,009,0223,0,1240,17,1257,1786,0,3,1,3,0,1,0,76.14,70.38 ,33.33
03,007,01,009,0224,0,1306,12,1318,1880,0,3,1,3,0,1,0,76.14,70.11 ,33.33
03,007,01,010,0225,0,694,13,707,1064,0,3,1,3,0,1,0,76.14,66.45 ,33.33
03,007,01,010,0226,0,1658,23,1681,2547,0,3,1,3,0,1,0,76.14,66.00 ,33.33
03,007,01,010,0227,0,1838,18,1856,2832,0,3,1,3,0,1,0,76.14,65.54 ,33.33
03,007,01,010,0228,0,1836,15,1851,2711,0,3,1,3,0,1,0,76.14,68.28 ,33.33
03,007,01,010,0229,0,574,3,577,816,0,3,1,3,0,1,0,76.14,70.71 ,33.33
03,007,01,010,0230,0,1685,20,1705,2586,0,3,1,3,0,1,0,76.14,65.93 ,33.33
03,007,01,010,0231,0,675,6,681,948,0,3,1,3,0,1,0,76.14,71.84 ,33.33
03,007,01,010,0232,0,499,4,503,718,0,3,1,3,0,1,0,76.14,70.06 ,33.33
03,007,01,010,0233,0,1178,20,1198,1762,0,3,1,3,0,1,0,76.14,67.99 ,33.33
03,007,01,010,0234,0,2758,30,2788,4212,0,3,1,3,0,1,0,76.14,66.19 ,33.33
03,007,01,010,0235,0,1457,23,1480,2223,0,3,1,3,0,1,0,76.14,66.58 ,33.33
03,007,01,010,0236,0,2463,29,2492,3645,0,3,1,3,0,1,0,76.14,68.37 ,33.33
03,007,01,010,0237,0,2250,25,2275,3391,0,3,1,3,0,1,0,76.14,67.09 ,33.33
03,007,01,010,0238,0,2744,42,2786,4076,0,3,1,3,0,1,0,76.14,68.35 ,33.33
03,007,01,010,0239,0,969,8,977,1424,0,3,1,3,0,1,0,76.14,68.61 ,33.33
03,007,01,010,0240,0,1154,16,1170,1688,0,3,1,3,0,1,0,76.14,69.31 ,33.33
03,007,01,010,0241,0,3269,43,3312,4988,0,3,1,3,0,1,0,76.14,66.40 ,33.33
03,007,01,010,0242,0,3054,31,3085,4663,0,3,1,3,0,1,0,76.14,66.16 ,33.33
03,007,01,010,0243,0,1620,26,1646,2444,0,3,1,3,0,1,0,76.14,67.35 ,33.33
03,007,01,010,0244,0,1498,11,1509,2317,0,3,1,3,0,1,0,76.14,65.13 ,33.33
03,007,01,010,0245,0,1242,16,1258,1864,0,3,1,3,0,1,0,76.14,67.49 ,33.33
03,007,01,010,0246,0,1235,14,1249,1890,0,3,1,3,0,1,0,76.14,66.08 ,33.33
03,007,01,010,0247,0,960,15,975,1435,0,3,1,3,0,1,0,76.14,67.94 ,33.33
03,007,01,010,0248,0,1325,14,1339,1991,0,3,1,3,0,1,0,76.14,67.25 ,33.33
03,007,01,010,0249,0,1625,17,1642,2436,0,3,1,3,0,1,0,76.14,67.41 ,33.33
03,007,01,010,0250,0,1290,29,1319,1948,0,3,1,3,0,1,0,76.14,67.71 ,33.33
03,007,01,010,0251,0,1965,29,1994,2945,0,3,1,3,0,1,0,76.14,67.71 ,33.33
03,007,01,010,0252,0,1550,16,1566,2191,0,3,1,3,0,1,0,76.14,71.47 ,33.33
03,007,01,010,0253,0,1407,24,1431,2169,0,3,1,3,0,1,0,76.14,65.98 ,33.33
03,007,01,010,0254,0,1386,26,1412,2218,0,3,1,3,0,1,0,76.14,63.66 ,33.33
03,007,01,010,0255,0,1015,17,1032,1677,0,3,1,3,0,1,0,76.14,61.54 ,33.33
03,007,01,010,0256,0,814,9,823,1272,0,3,1,3,0,1,0,76.14,64.70 ,33.33
03,007,01,010,0257,0,438,6,444,730,0,3,1,3,0,1,0,76.14,60.82 ,33.33
03,007,01,010,0258,0,1130,17,1147,1743,0,3,1,3,0,1,0,76.14,65.81 ,33.33
03,007,01,010,0259,0,1337,9,1346,1980,0,3,1,3,0,1,0,76.14,67.98 ,33.33
03,007,01,010,0260,0,1094,15,1109,1568,0,3,1,3,0,1,0,76.14,70.73 ,33.33
03,007,01,010,0261,0,1047,17,1064,1607,0,3,1,3,0,1,0,76.14,66.21 ,33.33
03,007,01,010,0262,0,917,13,930,1412,0,3,1,3,0,1,0,76.14,65.86 ,33.33
03,007,01,010,0263,0,1327,19,1346,1958,0,3,1,3,0,1,0,76.14,68.74 ,33.33
03,007,01,011,0264,0,1358,25,1383,1930,0,3,1,3,0,1,0,76.14,71.66 ,33.33
03,007,01,011,0265,0,1067,16,1083,1526,0,3,1,3,0,1,0,76.14,70.97 ,33.33
03,007,01,011,0266,0,619,11,630,871,0,3,1,3,0,1,0,76.14,72.33 ,33.33
03,007,01,011,0267,0,893,11,904,1299,0,3,1,3,0,1,0,76.14,69.59 ,33.33
03,007,01,011,0268,0,837,6,843,1217,0,3,1,3,0,1,0,76.14,69.27 ,33.33
03,007,01,011,0269,0,990,15,1005,1406,0,3,1,3,0,1,0,76.14,71.48 ,33.33
03,007,01,011,0270,0,782,5,787,1130,0,3,1,3,0,1,0,76.14,69.65 ,33.33
03,007,01,011,0271,0,781,19,800,1173,0,3,1,3,0,1,0,76.14,68.20 ,33.33
03,007,01,011,0272,0,1432,17,1449,2082,0,3,1,3,0,1,0,76.14,69.60 ,33.33
03,007,01,011,0273,0,1322,11,1333,1882,0,3,1,3,0,1,0,76.14,70.83 ,33.33
03,007,01,011,0274,0,1119,12,1131,1769,0,3,1,3,0,1,0,76.14,63.93 ,33.33
03,007,01,011,0275,0,863,11,874,1182,0,3,1,3,0,1,0,76.14,73.94 ,33.33
03,007,01,011,0276,0,1592,23,1615,2469,0,3,1,3,0,1,0,76.14,65.41 ,33.33
03,007,01,011,0277,0,1154,16,1170,1705,0,3,1,3,0,1,0,76.14,68.62 ,33.33
03,007,01,011,0278,0,1096,16,1112,1711,0,3,1,3,0,1,0,76.14,64.99 ,33.33
03,007,01,011,0279,0,1213,25,1238,1939,0,3,1,3,0,1,0,76.14,63.85 ,33.33
03,007,01,012,0280,0,601,8,609,812,0,3,1,3,0,1,0,76.14,75.00 ,33.33
03,007,01,012,0281,0,1012,12,1024,1446,0,3,1,3,0,1,0,76.14,70.82 ,33.33
03,007,01,012,0282,0,1215,17,1232,1788,0,3,1,3,0,1,0,76.14,68.90 ,33.33
03,007,01,012,0283,0,1216,19,1235,1810,0,3,1,3,0,1,0,76.14,68.23 ,33.33
03,007,01,012,0284,0,1092,24,1116,1591,0,3,1,3,0,1,0,76.14,70.14 ,33.33
03,007,01,012,0285,0,848,16,864,1275,0,3,1,3,0,1,0,76.14,67.76 ,33.33
03,007,01,012,0286,0,651,12,663,906,0,3,1,3,0,1,0,76.14,73.18 ,33.33
03,007,01,012,0287,0,570,8,578,835,0,3,1,3,0,1,0,76.14,69.22 ,33.33
03,007,01,012,0288,0,1413,14,1427,1981,0,3,1,3,0,1,0,76.14,72.03 ,33.33
03,007,01,012,0289,0,913,7,920,1268,0,3,1,3,0,1,0,76.14,72.56 ,33.33
03,007,01,012,0290,0,779,16,795,1055,0,3,1,3,0,1,0,76.14,75.36 ,33.33
03,007,01,012,0291,0,1022,20,1042,1487,0,3,1,3,0,1,0,76.14,70.07 ,33.33
03,007,01,012,0292,0,1055,10,1065,1608,0,3,1,3,0,1,0,76.14,66.23 ,33.33
03,007,01,012,0293,0,1058,8,1066,1487,0,3,1,3,0,1,0,76.14,71.69 ,33.33
03,007,01,012,0294,0,797,16,813,1149,0,3,1,3,0,1,0,76.14,70.76 ,33.33
03,007,01,012,0295,0,579,9,588,834,0,3,1,3,0,1,0,76.14,70.50 ,33.33
03,007,01,012,0296,0,483,5,488,690,0,3,1,3,0,1,0,76.14,70.72 ,33.33
03,007,01,012,0297,0,540,5,545,726,0,3,1,3,0,1,0,76.14,75.07 ,33.33
03,007,01,012,0298,0,487,8,495,664,0,3,1,3,0,1,0,76.14,74.55 ,33.33
03,007,01,012,0299,0,658,10,668,931,0,3,1,3,0,1,0,76.14,71.75 ,33.33
03,007,01,012,0300,0,610,11,621,834,0,3,1,3,0,1,0,76.14,74.46 ,33.33
03,007,01,012,0301,0,488,7,495,657,0,3,1,3,0,1,0,76.14,75.34 ,33.33
03,007,01,012,0302,0,823,10,833,1119,0,3,1,3,0,1,0,76.14,74.44 ,33.33
03,007,01,012,0303,0,948,10,958,1335,0,3,1,3,0,1,0,76.14,71.76 ,33.33
03,007,01,013,0304,0,848,7,855,1208,0,3,1,3,0,1,0,76.14,70.78 ,33.33
03,007,01,013,0305,0,569,3,572,759,0,3,1,3,0,1,0,76.14,75.36 ,33.33
03,007,01,013,0306,0,923,8,931,1317,0,3,1,3,0,1,0,76.14,70.69 ,33.33
03,007,01,013,0307,0,350,5,355,485,0,3,1,3,0,1,0,76.14,73.20 ,33.33
03,007,01,013,0308,0,1790,18,1808,2745,0,3,1,3,0,1,0,76.14,65.87 ,33.33
03,007,01,013,0309,0,1227,16,1243,1810,0,3,1,3,0,1,0,76.14,68.67 ,33.33
03,007,01,013,0310,0,1379,20,1399,1991,0,3,1,3,0,1,0,76.14,70.27 ,33.33
03,007,01,013,0311,0,876,10,886,1241,0,3,1,3,0,1,0,76.14,71.39 ,33.33
03,007,01,013,0312,0,1509,17,1526,2182,0,3,1,3,0,1,0,76.14,69.94 ,33.33
03,007,01,013,0313,0,1491,10,1501,2169,0,3,1,3,0,1,0,76.14,69.20 ,33.33
03,007,01,013,0314,0,1229,10,1239,1836,0,3,1,3,0,1,0,76.14,67.48 ,33.33
03,007,01,013,0315,0,513,11,524,746,0,3,1,3,0,1,0,76.14,70.24 ,33.33
03,007,01,013,0316,0,1067,16,1083,1577,0,3,1,3,0,1,0,76.14,68.67 ,33.33
03,007,01,013,0317,0,1488,15,1503,2160,0,3,1,3,0,1,0,76.14,69.58 ,33.33
03,007,01,013,0318,0,508,9,517,781,0,3,1,3,0,1,0,76.14,66.20 ,33.33
03,007,01,013,0319,0,791,14,805,1214,0,3,1,3,0,1,0,76.14,66.31 ,33.33
03,007,01,013,0320,0,983,13,996,1452,0,3,1,3,0,1,0,76.14,68.60 ,33.33
03,007,01,013,0321,0,2330,32,2362,3449,0,3,1,3,0,1,0,76.14,68.48 ,33.33
03,007,01,013,0322,0,448,9,457,661,0,3,1,3,0,1,0,76.14,69.14 ,33.33
03,007,01,013,0323,0,790,11,801,1184,0,3,1,3,0,1,0,76.14,67.65 ,33.33
03,007,01,013,0324,0,494,7,501,701,0,3,1,3,0,1,0,76.14,71.47 ,33.33
03,007,01,013,0325,0,782,8,790,1211,0,3,1,3,0,1,0,76.14,65.24 ,33.33
03,007,01,013,0326,0,827,12,839,1312,0,3,1,3,0,1,0,76.14,63.95 ,33.33
03,007,01,013,0327,0,1152,15,1167,1833,0,3,1,3,0,1,0,76.14,63.67 ,33.33
03,007,01,013,0328,0,881,15,896,1483,0,3,1,3,0,1,0,76.14,60.42 ,33.33
03,007,01,014,0329,0,1060,24,1084,1461,0,3,1,3,0,1,0,76.14,74.20 ,33.33
03,007,01,014,0330,0,980,23,1003,1449,0,3,1,3,0,1,0,76.14,69.22 ,33.33
03,007,01,014,0331,0,788,15,803,1092,0,3,1,3,0,1,0,76.14,73.53 ,33.33
03,007,01,014,0332,0,600,10,610,787,0,3,1,3,0,1,0,76.14,77.51 ,33.33
03,007,01,014,0333,0,1180,15,1195,1579,0,3,1,3,0,1,0,76.14,75.68 ,33.33
03,007,01,014,0334,0,645,8,653,917,0,3,1,3,0,1,0,76.14,71.21 ,33.33
03,007,01,014,0335,0,840,14,854,1258,0,3,1,3,0,1,0,76.14,67.89 ,33.33
03,007,01,014,0336,0,714,10,724,1001,0,3,1,3,0,1,0,76.14,72.33 ,33.33
03,007,01,014,0337,0,519,5,524,676,0,3,1,3,0,1,0,76.14,77.51 ,33.33
03,007,01,014,0338,0,814,15,829,1141,0,3,1,3,0,1,0,76.14,72.66 ,33.33
03,007,01,014,0339,0,911,11,922,1259,0,3,1,3,0,1,0,76.14,73.23 ,33.33
03,007,01,014,0340,0,1328,35,1363,1921,0,3,1,3,0,1,0,76.14,70.95 ,33.33
03,007,01,014,0341,0,877,14,891,1226,0,3,1,3,0,1,0,76.14,72.68 ,33.33
03,007,01,014,0342,0,275,1,276,392,0,3,1,3,0,1,0,76.14,70.41 ,33.33
03,007,01,014,0343,0,677,8,685,1007,0,3,1,3,0,1,0,76.14,68.02 ,33.33
03,007,01,014,0344,0,557,4,561,750,0,3,1,3,0,1,0,76.14,74.80 ,33.33
03,007,01,014,0345,0,884,14,898,1301,0,3,1,3,0,1,0,76.14,69.02 ,33.33
03,007,01,014,0346,0,620,3,623,809,0,3,1,3,0,1,0,76.14,77.01 ,33.33
03,007,01,014,0347,0,925,7,932,1454,0,3,1,3,0,1,0,76.14,64.10 ,33.33
03,007,01,014,0348,0,914,16,930,1301,0,3,1,3,0,1,0,76.14,71.48 ,33.33
03,007,01,014,0349,0,848,17,865,1258,0,3,1,3,0,1,0,76.14,68.76 ,33.33
03,007,01,014,0350,0,861,11,872,1232,0,3,1,3,0,1,0,76.14,70.78 ,33.33
03,007,01,015,0351,0,1665,21,1686,2476,0,3,1,3,0,1,0,76.14,68.09 ,33.33
03,007,01,015,0352,0,821,9,830,1195,0,3,1,3,0,1,0,76.14,69.46 ,33.33
03,007,01,015,0353,0,981,14,995,1401,0,3,1,3,0,1,0,76.14,71.02 ,33.33
03,007,01,015,0354,0,761,18,779,1090,0,3,1,3,0,1,0,76.14,71.47 ,33.33
03,007,01,015,0355,0,1044,16,1060,1540,0,3,1,3,0,1,0,76.14,68.83 ,33.33
03,007,01,015,0356,0,1116,17,1133,1591,0,3,1,3,0,1,0,76.14,71.21 ,33.33
03,007,01,015,0357,0,937,13,950,1307,0,3,1,3,0,1,0,76.14,72.69 ,33.33
03,007,01,015,0358,0,1046,7,1053,1528,0,3,1,3,0,1,0,76.14,68.91 ,33.33
03,007,01,015,0359,0,1187,19,1206,1688,0,3,1,3,0,1,0,76.14,71.45 ,33.33
03,007,01,015,0360,0,414,4,418,590,0,3,1,3,0,1,0,76.14,70.85 ,33.33
03,007,01,015,0361,0,678,13,691,1022,0,3,1,3,0,1,0,76.14,67.61 ,33.33
03,007,01,015,0362,0,782,12,794,1124,0,3,1,3,0,1,0,76.14,70.64 ,33.33
03,007,01,015,0363,0,483,10,493,705,0,3,1,3,0,1,0,76.14,69.93 ,33.33
03,007,01,015,0364,0,567,13,580,849,0,3,1,3,0,1,0,76.14,68.32 ,33.33
03,007,01,015,0365,0,1101,22,1123,1608,0,3,1,3,0,1,0,76.14,69.84 ,33.33
03,007,01,015,0366,0,901,8,909,1285,0,3,1,3,0,1,0,76.14,70.74 ,33.33
03,007,01,015,0367,0,590,6,596,861,0,3,1,3,0,1,0,76.14,69.22 ,33.33
03,007,01,015,0368,0,805,8,813,1174,0,3,1,3,0,1,0,76.14,69.25 ,33.33
03,007,01,015,0369,0,539,17,556,757,0,3,1,3,0,1,0,76.14,73.45 ,33.33
03,007,01,015,0370,0,608,10,618,830,0,3,1,3,0,1,0,76.14,74.46 ,33.33
03,007,01,016,0371,0,606,5,611,884,0,3,1,3,0,1,0,76.14,69.12 ,33.33
03,007,01,016,0372,0,1242,81,1323,2348,0,3,1,3,0,1,0,76.14,56.35 ,33.33
03,007,01,016,0373,0,415,5,420,644,0,3,1,3,0,1,0,76.14,65.22 ,33.33
03,007,01,016,0374,0,1008,18,1026,1459,0,3,1,3,0,1,0,76.14,70.32 ,33.33
03,007,01,016,0375,0,964,24,988,1448,0,3,1,3,0,1,0,76.14,68.23 ,33.33
03,007,01,016,0376,0,850,11,861,1202,0,3,1,3,0,1,0,76.14,71.63 ,33.33
03,007,01,016,0377,0,1119,9,1128,1642,0,3,1,3,0,1,0,76.14,68.70 ,33.33
03,007,01,016,0378,0,449,6,455,638,0,3,1,3,0,1,0,76.14,71.32 ,33.33
03,007,01,016,0379,0,1892,18,1910,2718,0,3,1,3,0,1,0,76.14,70.27 ,33.33
03,007,01,016,0380,0,1444,20,1464,2101,0,3,1,3,0,1,0,76.14,69.68 ,33.33
03,007,01,016,0381,0,798,10,808,1070,0,3,1,3,0,1,0,76.14,75.51 ,33.33
03,007,01,016,0382,0,893,9,902,1258,0,3,1,3,0,1,0,76.14,71.70 ,33.33
03,007,01,016,0383,0,1389,12,1401,1963,0,3,1,3,0,1,0,76.14,71.37 ,33.33
03,007,01,016,0384,0,1305,29,1334,2013,0,3,1,3,0,1,0,76.14,66.27 ,33.33
03,007,01,016,0385,0,1062,18,1080,1608,0,3,1,3,0,1,0,76.14,67.16 ,33.33
03,007,01,016,0386,0,876,6,882,1272,0,3,1,3,0,1,0,76.14,69.34 ,33.33
03,007,01,016,0387,0,983,13,996,1540,0,3,1,3,0,1,0,76.14,64.68 ,33.33
03,007,01,016,0388,0,2123,32,2155,3250,0,3,1,3,0,1,0,76.14,66.31 ,33.33
03,007,01,016,0389,0,844,14,858,1295,0,3,1,3,0,1,0,76.14,66.25 ,33.33
03,007,01,016,0390,0,1017,14,1031,1482,0,3,1,3,0,1,0,76.14,69.57 ,33.33
03,007,01,016,0391,0,573,9,582,861,0,3,1,3,0,1,0,76.14,67.60 ,33.33
03,007,01,016,0392,0,541,3,544,766,0,3,1,3,0,1,0,76.14,71.02 ,33.33
03,007,01,017,0393,0,1741,16,1757,2567,0,3,1,3,0,1,0,76.14,68.45 ,33.33
03,007,01,017,0394,0,2481,39,2520,3557,0,3,1,3,0,1,0,76.14,70.85 ,33.33
03,007,01,017,0395,0,1659,12,1671,2407,0,3,1,3,0,1,0,76.14,69.42 ,33.33
03,007,01,017,0396,0,523,11,534,770,0,3,1,3,0,1,0,76.14,69.35 ,33.33
03,007,01,017,0397,0,701,10,711,994,0,3,1,3,0,1,0,76.14,71.53 ,33.33
03,007,01,017,0398,0,693,13,706,990,0,3,1,3,0,1,0,76.14,71.31 ,33.33
03,007,01,017,0399,0,937,15,952,1341,0,3,1,3,0,1,0,76.14,70.99 ,33.33
03,007,01,017,0400,0,636,7,643,881,0,3,1,3,0,1,0,76.14,72.99 ,33.33
03,007,01,017,0401,0,844,20,864,1215,0,3,1,3,0,1,0,76.14,71.11 ,33.33
03,007,01,017,0402,0,575,12,587,826,0,3,1,3,0,1,0,76.14,71.07 ,33.33
03,007,01,017,0403,0,1319,17,1336,1836,0,3,1,3,0,1,0,76.14,72.77 ,33.33
03,007,01,017,0404,0,1026,10,1036,1436,0,3,1,3,0,1,0,76.14,72.14 ,33.33
03,007,01,017,0405,0,985,13,998,1375,0,3,1,3,0,1,0,76.14,72.58 ,33.33
03,007,01,017,0406,0,750,20,770,1065,0,3,1,3,0,1,0,76.14,72.30 ,33.33
03,007,01,017,0407,0,712,10,722,978,0,3,1,3,0,1,0,76.14,73.82 ,33.33
03,007,01,017,0408,0,770,9,779,1046,0,3,1,3,0,1,0,76.14,74.47 ,33.33
03,007,01,017,0409,0,680,8,688,921,0,3,1,3,0,1,0,76.14,74.70 ,33.33
03,007,01,017,0410,0,713,12,725,1020,0,3,1,3,0,1,0,76.14,71.08 ,33.33
03,007,01,017,0411,0,456,12,468,669,0,3,1,3,0,1,0,76.14,69.96 ,33.33
03,007,01,017,0412,0,580,8,588,827,0,3,1,3,0,1,0,76.14,71.10 ,33.33
03,007,01,017,0413,0,682,10,692,958,0,3,1,3,0,1,0,76.14,72.23 ,33.33
03,007,01,017,0414,0,537,5,542,782,0,3,1,3,0,1,0,76.14,69.31 ,33.33
03,007,01,017,0415,0,898,17,915,1340,0,3,1,3,0,1,0,76.14,68.28 ,33.33
03,007,01,017,0416,0,1308,29,1337,1873,0,3,1,3,0,1,0,76.14,71.38 ,33.33
03,007,01,018,0417,0,724,11,735,1018,0,3,1,3,0,1,0,76.14,72.20 ,33.33
03,007,01,018,0418,0,487,7,494,704,0,3,1,3,0,1,0,76.14,70.17 ,33.33
03,007,01,018,0419,0,590,9,599,879,0,3,1,3,0,1,0,76.14,68.15 ,33.33
03,007,01,018,0420,0,711,10,721,1017,0,3,1,3,0,1,0,76.14,70.89 ,33.33
03,007,01,018,0421,0,465,4,469,631,0,3,1,3,0,1,0,76.14,74.33 ,33.33
03,007,01,018,0422,0,492,1,493,660,0,3,1,3,0,1,0,76.14,74.70 ,33.33
03,007,01,018,0423,0,716,10,726,965,0,3,1,3,0,1,0,76.14,75.23 ,33.33
03,007,01,018,0424,0,730,5,735,1012,0,3,1,3,0,1,0,76.14,72.63 ,33.33
03,007,01,018,0425,0,612,8,620,877,0,3,1,3,0,1,0,76.14,70.70 ,33.33
03,007,01,018,0426,0,371,1,372,513,0,3,1,3,0,1,0,76.14,72.51 ,33.33
03,007,01,018,0427,0,592,8,600,910,0,3,1,3,0,1,0,76.14,65.93 ,33.33
03,007,01,018,0428,0,606,10,616,862,0,3,1,3,0,1,0,76.14,71.46 ,33.33
03,007,01,018,0429,0,589,2,591,758,0,3,1,3,0,1,0,76.14,77.97 ,33.33
03,007,01,018,0430,0,577,7,584,811,0,3,1,3,0,1,0,76.14,72.01 ,33.33
03,007,01,018,0431,0,552,4,556,768,0,3,1,3,0,1,0,76.14,72.40 ,33.33
03,007,01,018,0432,0,454,6,460,688,0,3,1,3,0,1,0,76.14,66.86 ,33.33
03,007,01,018,0433,0,426,5,431,620,0,3,1,3,0,1,0,76.14,69.52 ,33.33
03,007,01,019,0434,0,1518,31,1549,2287,0,3,1,3,0,1,0,76.14,67.73 ,33.33
03,007,01,019,0435,0,1192,7,1199,1680,0,3,1,3,0,1,0,76.14,71.37 ,33.33
03,007,01,019,0436,0,2576,46,2622,3795,0,3,1,3,0,1,0,76.14,69.09 ,33.33
03,007,01,019,0437,0,984,15,999,1555,0,3,1,3,0,1,0,76.14,64.24 ,33.33
03,007,01,019,0438,0,915,5,920,1360,0,3,1,3,0,1,0,76.14,67.65 ,33.33
03,007,01,019,0439,0,566,5,571,783,0,3,1,3,0,1,0,76.14,72.92 ,33.33
03,007,01,019,0440,0,452,11,463,632,0,3,1,3,0,1,0,76.14,73.26 ,33.33
03,007,01,019,0441,0,521,8,529,767,0,3,1,3,0,1,0,76.14,68.97 ,33.33
03,007,01,019,0442,0,891,11,902,1395,0,3,1,3,0,1,0,76.14,64.66 ,33.33
03,007,01,019,0443,0,882,14,896,1288,0,3,1,3,0,1,0,76.14,69.57 ,33.33
03,007,01,019,0444,0,1094,16,1110,1686,0,3,1,3,0,1,0,76.14,65.84 ,33.33
03,007,01,019,0445,0,1449,15,1464,2199,0,3,1,3,0,1,0,76.14,66.58 ,33.33
03,007,01,019,0446,0,702,9,711,1033,0,3,1,3,0,1,0,76.14,68.83 ,33.33
03,007,01,019,0447,0,1106,25,1131,1653,0,3,1,3,0,1,0,76.14,68.42 ,33.33
03,007,01,019,0448,0,915,27,942,1478,0,3,1,3,0,1,0,76.14,63.73 ,33.33
03,007,01,020,0449,0,1007,29,1036,1719,0,3,1,3,0,1,0,76.14,60.27 ,33.33
03,007,01,020,0450,0,441,13,454,675,0,3,1,3,0,1,0,76.14,67.26 ,33.33
03,007,01,020,0451,0,593,12,605,922,0,3,1,3,0,1,0,76.14,65.62 ,33.33
03,007,01,020,0452,0,1047,23,1070,1587,0,3,1,3,0,1,0,76.14,67.42 ,33.33
03,007,01,020,0453,0,866,14,880,1314,0,3,1,3,0,1,0,76.14,66.97 ,33.33
03,007,01,020,0454,0,1142,20,1162,1718,0,3,1,3,0,1,0,76.14,67.64 ,33.33
03,007,01,020,0455,0,826,9,835,1246,0,3,1,3,0,1,0,76.14,67.01 ,33.33
03,007,01,020,0456,0,845,14,859,1417,0,3,1,3,0,1,0,76.14,60.62 ,33.33
03,007,01,020,0457,0,1267,18,1285,1997,0,3,1,3,0,1,0,76.14,64.35 ,33.33
03,007,01,020,0458,0,1113,17,1130,1801,0,3,1,3,0,1,0,76.14,62.74 ,33.33
03,007,01,020,0459,0,1175,15,1190,1887,0,3,1,3,0,1,0,76.14,63.06 ,33.33
03,007,01,020,0460,0,495,18,513,793,0,3,1,3,0,1,0,76.14,64.69 ,33.33
03,007,01,020,0461,0,721,14,735,1091,0,3,1,3,0,1,0,76.14,67.37 ,33.33
03,007,01,020,0462,0,546,2,548,946,0,3,1,3,0,1,0,76.14,57.93 ,33.33
03,007,01,020,0463,0,411,10,421,750,0,3,1,3,0,1,0,76.14,56.13 ,33.33
03,007,01,020,0464,0,578,7,585,865,0,3,1,3,0,1,0,76.14,67.63 ,33.33
03,007,01,020,0465,0,766,14,780,1219,0,3,1,3,0,1,0,76.14,63.99 ,33.33
03,007,01,020,0466,0,610,10,620,901,0,3,1,3,0,1,0,76.14,68.81 ,33.33
03,007,01,020,0467,0,695,21,716,1210,0,3,1,3,0,1,0,76.14,59.17 ,33.33
03,007,01,021,0468,0,767,9,776,1208,0,3,1,3,0,1,0,76.14,64.24 ,33.33
03,007,01,021,0469,0,465,6,471,678,0,3,1,3,0,1,0,76.14,69.47 ,33.33
03,007,01,021,0470,0,1308,24,1332,1911,0,3,1,3,0,1,0,76.14,69.70 ,33.33
03,007,01,021,0471,0,753,16,769,1198,0,3,1,3,0,1,0,76.14,64.19 ,33.33
03,007,01,021,0472,0,807,13,820,1159,0,3,1,3,0,1,0,76.14,70.75 ,33.33
03,007,01,021,0473,0,664,15,679,1005,0,3,1,3,0,1,0,76.14,67.56 ,33.33
03,007,01,021,0474,0,819,8,827,1132,0,3,1,3,0,1,0,76.14,73.06 ,33.33
03,007,01,021,0475,0,637,10,647,959,0,3,1,3,0,1,0,76.14,67.47 ,33.33
03,007,01,021,0476,0,449,14,463,669,0,3,1,3,0,1,0,76.14,69.21 ,33.33
03,007,01,021,0477,0,588,9,597,842,0,3,1,3,0,1,0,76.14,70.90 ,33.33
03,007,01,021,0478,0,710,15,725,1004,0,3,1,3,0,1,0,76.14,72.21 ,33.33
03,007,01,021,0479,0,831,17,848,1211,0,3,1,3,0,1,0,76.14,70.02 ,33.33
03,007,01,021,0480,0,1137,20,1157,1700,0,3,1,3,0,1,0,76.14,68.06 ,33.33
03,007,01,021,0481,0,587,5,592,810,0,3,1,3,0,1,0,76.14,73.09 ,33.33
03,007,01,021,0482,0,593,6,599,845,0,3,1,3,0,1,0,76.14,70.89 ,33.33
03,007,01,021,0483,0,947,21,968,1465,0,3,1,3,0,1,0,76.14,66.08 ,33.33
03,007,01,021,0484,0,1015,15,1030,1504,0,3,1,3,0,1,0,76.14,68.48 ,33.33
03,007,01,021,0485,0,208,6,214,298,0,3,1,3,0,1,0,76.14,71.81 ,33.33
03,007,01,021,0486,0,400,8,408,608,0,3,1,3,0,1,0,76.14,67.11 ,33.33
03,007,01,021,0487,0,493,9,502,696,0,3,1,3,0,1,0,76.14,72.13 ,33.33
03,007,01,022,0488,0,1363,41,1404,2217,0,3,1,3,0,1,0,76.14,63.33 ,33.33
03,007,01,022,0489,0,982,26,1008,1493,0,3,1,3,0,1,0,76.14,67.52 ,33.33
03,007,01,022,0490,0,992,13,1005,1556,0,3,1,3,0,1,0,76.14,64.59 ,33.33
03,007,01,022,0491,0,1301,22,1323,2085,0,3,1,3,0,1,0,76.14,63.45 ,33.33
03,007,01,022,0492,0,706,22,728,1119,0,3,1,3,0,1,0,76.14,65.06 ,33.33
03,007,01,022,0493,0,946,13,959,1431,0,3,1,3,0,1,0,76.14,67.02 ,33.33
03,007,01,022,0494,0,1965,42,2007,2917,0,3,1,3,0,1,0,76.14,68.80 ,33.33
03,007,01,022,0495,0,1046,19,1065,1603,0,3,1,3,0,1,0,76.14,66.44 ,33.33
03,007,01,022,0496,0,453,10,463,683,0,3,1,3,0,1,0,76.14,67.79 ,33.33
03,007,01,022,0497,0,382,3,385,594,0,3,1,3,0,1,0,76.14,64.81 ,33.33
03,007,01,022,0498,0,1030,25,1055,1649,0,3,1,3,0,1,0,76.14,63.98 ,33.33
03,007,01,022,0499,0,710,8,718,1159,0,3,1,3,0,1,0,76.14,61.95 ,33.33
03,007,01,022,0500,0,532,17,549,831,0,3,1,3,0,1,0,76.14,66.06 ,33.33
03,007,01,022,0501,0,547,15,562,853,0,3,1,3,0,1,0,76.14,65.89 ,33.33
03,007,01,022,0502,0,790,12,802,1293,0,3,1,3,0,1,0,76.14,62.03 ,33.33
03,007,01,022,0503,0,547,13,560,928,0,3,1,3,0,1,0,76.14,60.34 ,33.33
03,007,01,022,0504,0,628,9,637,985,0,3,1,3,0,1,0,76.14,64.67 ,33.33
03,007,01,023,0505,0,1393,13,1406,2066,0,3,1,3,0,1,0,76.14,68.05 ,33.33
03,007,01,023,0506,0,1837,33,1870,2760,0,3,1,3,0,1,0,76.14,67.75 ,33.33
03,007,01,023,0507,0,879,13,892,1296,0,3,1,3,0,1,0,76.14,68.83 ,33.33
03,007,01,023,0508,0,1615,39,1654,2562,0,3,1,3,0,1,0,76.14,64.56 ,33.33
03,007,01,023,0509,0,934,18,952,1573,0,3,1,3,0,1,0,76.14,60.52 ,33.33
03,007,01,023,0510,0,876,21,897,1453,0,3,1,3,0,1,0,76.14,61.73 ,33.33
03,007,01,023,0511,0,722,20,742,1181,0,3,1,3,0,1,0,76.14,62.83 ,33.33
03,007,01,023,0512,0,709,18,727,1087,0,3,1,3,0,1,0,76.14,66.88 ,33.33
03,007,01,023,0513,0,686,14,700,1085,0,3,1,3,0,1,0,76.14,64.52 ,33.33
03,007,01,023,0514,0,778,10,788,1179,0,3,1,3,0,1,0,76.14,66.84 ,33.33
03,007,01,023,0515,0,1407,24,1431,2320,0,3,1,3,0,1,0,76.14,61.68 ,33.33
03,007,01,023,0516,0,1321,26,1347,2087,0,3,1,3,0,1,0,76.14,64.54 ,33.33
03,007,01,023,0517,0,819,14,833,1363,0,3,1,3,0,1,0,76.14,61.12 ,33.33
03,007,01,023,0518,0,1081,31,1112,1637,0,3,1,3,0,1,0,76.14,67.93 ,33.33
03,007,01,023,0519,0,812,22,834,1281,0,3,1,3,0,1,0,76.14,65.11 ,33.33
03,007,01,023,0520,0,535,12,547,786,0,3,1,3,0,1,0,76.14,69.59 ,33.33
03,007,01,023,0521,0,960,8,968,1501,0,3,1,3,0,1,0,76.14,64.49 ,33.33
03,007,01,023,0522,0,790,9,799,1222,0,3,1,3,0,1,0,76.14,65.38 ,33.33
03,007,01,023,0523,0,689,20,709,1065,0,3,1,3,0,1,0,76.14,66.57 ,33.33
03,007,01,023,0524,0,2238,31,2269,3469,0,3,1,3,0,1,0,76.14,65.41 ,33.33
03,007,01,023,0525,0,808,17,825,1309,0,3,1,3,0,1,0,76.14,63.03 ,33.33
03,007,01,023,0526,0,641,9,650,1002,0,3,1,3,0,1,0,76.14,64.87 ,33.33
03,007,01,023,0527,0,573,11,584,864,0,3,1,3,0,1,0,76.14,67.59 ,33.33
03,007,01,023,0528,0,798,8,806,1206,0,3,1,3,0,1,0,76.14,66.83 ,33.33
03,007,01,023,0529,0,663,11,674,1011,0,3,1,3,0,1,0,76.14,66.67 ,33.33
03,007,01,023,0530,0,673,10,683,1010,0,3,1,3,0,1,0,76.14,67.62 ,33.33
03,007,01,023,0531,0,507,7,514,745,0,3,1,3,0,1,0,76.14,68.99 ,33.33
03,007,01,024,0532,0,595,12,607,1035,0,3,1,3,0,1,0,76.14,58.65 ,33.33
03,007,01,024,0533,0,317,7,324,537,0,3,1,3,0,1,0,76.14,60.34 ,33.33
03,007,01,024,0534,0,553,14,567,898,0,3,1,3,0,1,0,76.14,63.14 ,33.33
03,007,01,024,0535,0,398,4,402,673,0,3,1,3,0,1,0,76.14,59.73 ,33.33
03,007,01,024,0536,0,589,14,603,934,0,3,1,3,0,1,0,76.14,64.56 ,33.33
03,007,01,024,0537,0,1161,23,1184,1812,0,3,1,3,0,1,0,76.14,65.34 ,33.33
03,007,01,024,0538,0,875,16,891,1399,0,3,1,3,0,1,0,76.14,63.69 ,33.33
03,007,01,024,0539,0,543,5,548,1062,0,3,1,3,0,1,0,76.14,51.60 ,33.33
03,007,01,024,0540,0,467,8,475,763,0,3,1,3,0,1,0,76.14,62.25 ,33.33
03,007,01,024,0541,0,495,8,503,768,0,3,1,3,0,1,0,76.14,65.49 ,33.33
03,007,01,024,0542,0,644,15,659,1020,0,3,1,3,0,1,0,76.14,64.61 ,33.33
03,007,01,024,0543,0,392,13,405,679,0,3,1,3,0,1,0,76.14,59.65 ,33.33
03,007,01,024,0544,0,382,8,390,645,0,3,1,3,0,1,0,76.14,60.47 ,33.33
03,007,01,024,0545,0,1253,23,1276,2065,0,3,1,3,0,1,0,76.14,61.79 ,33.33
03,007,01,024,0546,0,526,5,531,792,0,3,1,3,0,1,0,76.14,67.05 ,33.33
03,007,01,024,0547,0,519,9,528,809,0,3,1,3,0,1,0,76.14,65.27 ,33.33
03,007,01,024,0548,0,799,9,808,1369,0,3,1,3,0,1,0,76.14,59.02 ,33.33
03,007,01,024,0549,0,475,9,484,789,0,3,1,3,0,1,0,76.14,61.34 ,33.33
03,007,01,024,0550,0,931,8,939,1330,0,3,1,3,0,1,0,76.14,70.60 ,33.33
03,007,01,024,0551,0,309,6,315,578,0,3,1,3,0,1,0,76.14,54.50 ,33.33
03,007,01,024,0552,0,882,13,895,1420,0,3,1,3,0,1,0,76.14,63.03 ,33.33
03,007,01,024,0553,0,1284,20,1304,2029,0,3,1,3,0,1,0,76.14,64.27 ,33.33
03,007,01,024,0554,0,514,4,518,728,0,3,1,3,0,1,0,76.14,71.15 ,33.33
03,007,01,024,0555,0,682,16,698,1019,0,3,1,3,0,1,0,76.14,68.50 ,33.33
03,007,01,024,0556,0,824,16,840,1368,0,3,1,3,0,1,0,76.14,61.40 ,33.33
03,007,01,024,0557,0,1882,32,1914,2784,0,3,1,3,0,1,0,76.14,68.75 ,33.33
03,007,01,025,0558,0,832,15,847,1371,0,3,1,3,0,1,0,76.14,61.78 ,33.33
03,007,01,025,0559,0,829,18,847,1422,0,3,1,3,0,1,0,76.14,59.56 ,33.33
03,007,01,025,0560,0,568,11,579,908,0,3,1,3,0,1,0,76.14,63.77 ,33.33
03,007,01,025,0561,0,827,9,836,1289,0,3,1,3,0,1,0,76.14,64.86 ,33.33
03,007,01,025,0562,0,666,6,672,1068,0,3,1,3,0,1,0,76.14,62.92 ,33.33
03,007,01,025,0563,0,712,11,723,1206,0,3,1,3,0,1,0,76.14,59.95 ,33.33
03,007,01,025,0564,0,470,6,476,761,0,3,1,3,0,1,0,76.14,62.55 ,33.33
03,007,01,025,0565,0,740,10,750,1234,0,3,1,3,0,1,0,76.14,60.78 ,33.33
03,007,01,025,0566,0,539,7,546,919,0,3,1,3,0,1,0,76.14,59.41 ,33.33
03,007,01,025,0567,0,411,12,423,760,0,3,1,3,0,1,0,76.14,55.66 ,33.33
03,007,01,025,0568,0,765,10,775,1206,0,3,1,3,0,1,0,76.14,64.26 ,33.33
03,007,01,025,0569,0,821,12,833,1351,0,3,1,3,0,1,0,76.14,61.66 ,33.33
03,007,01,025,0570,0,663,9,672,1138,0,3,1,3,0,1,0,76.14,59.05 ,33.33
03,007,01,025,0571,0,465,7,472,811,0,3,1,3,0,1,0,76.14,58.20 ,33.33
03,007,01,025,0572,0,644,8,652,1076,0,3,1,3,0,1,0,76.14,60.59 ,33.33
03,007,01,026,0573,0,680,5,685,1081,0,3,1,3,0,1,0,76.14,63.37 ,33.33
03,007,01,026,0574,0,1082,8,1090,1651,0,3,1,3,0,1,0,76.14,66.02 ,33.33
03,007,01,026,0575,0,529,9,538,831,0,3,1,3,0,1,0,76.14,64.74 ,33.33
03,007,01,026,0576,0,497,5,502,796,0,3,1,3,0,1,0,76.14,63.07 ,33.33
03,007,01,026,0577,0,904,15,919,1525,0,3,1,3,0,1,0,76.14,60.26 ,33.33
03,007,01,026,0578,0,420,8,428,628,0,3,1,3,0,1,0,76.14,68.15 ,33.33
03,007,01,026,0579,0,603,8,611,957,0,3,1,3,0,1,0,76.14,63.85 ,33.33
03,007,01,026,0580,0,769,3,772,1183,0,3,1,3,0,1,0,76.14,65.26 ,33.33
03,007,01,026,0581,0,352,7,359,570,0,3,1,3,0,1,0,76.14,62.98 ,33.33
03,007,01,026,0582,0,546,9,555,888,0,3,1,3,0,1,0,76.14,62.50 ,33.33
03,007,01,026,0583,0,431,5,436,723,0,3,1,3,0,1,0,76.14,60.30 ,33.33
03,007,01,026,0584,0,377,5,382,669,0,3,1,3,0,1,0,76.14,57.10 ,33.33
03,007,01,026,0585,0,474,6,480,774,0,3,1,3,0,1,0,76.14,62.02 ,33.33
03,007,01,026,0586,0,374,5,379,707,0,3,1,3,0,1,0,76.14,53.61 ,33.33
03,008,01,001,0001,0,635,5,640,949,0,3,1,3,0,1,0,76.14,67.44 ,33.33
03,008,01,001,0002,0,924,8,932,1347,0,3,1,3,0,1,0,76.14,69.19 ,33.33
03,008,01,001,0003,0,535,3,538,704,0,3,1,3,0,1,0,76.14,76.42 ,33.33
03,008,01,001,0004,0,412,1,413,527,0,3,1,3,0,1,0,76.14,78.37 ,33.33
03,008,01,001,0005,0,493,6,499,701,0,3,1,3,0,1,0,76.14,71.18 ,33.33
03,008,01,001,0006,0,326,1,327,437,0,3,1,3,0,1,0,76.14,74.83 ,33.33
03,008,01,001,0007,0,751,8,759,1042,0,3,1,3,0,1,0,76.14,72.84 ,33.33
03,008,01,001,0008,0,2794,32,2826,4158,0,3,1,3,0,1,0,76.14,67.97 ,33.33
03,008,01,001,0009,0,1997,8,2005,2772,0,3,1,3,0,1,0,76.14,72.33 ,33.33
03,008,01,001,0010,0,1174,8,1182,1712,0,3,1,3,0,1,0,76.14,69.04 ,33.33
03,008,01,001,0011,0,2019,16,2035,2857,0,3,1,3,0,1,0,76.14,71.23 ,33.33
03,008,01,001,0012,0,3410,16,3426,4961,0,3,1,3,0,1,0,76.14,69.06 ,33.33
03,008,01,001,0013,0,1361,6,1367,1917,0,3,1,3,0,1,0,76.14,71.31 ,33.33
03,008,01,001,0014,0,557,6,563,857,0,3,1,3,0,1,0,76.14,65.69 ,33.33
03,008,01,001,0015,0,2507,23,2530,3664,0,3,1,3,0,1,0,76.14,69.05 ,33.33
03,008,01,001,0016,0,250,3,253,384,0,3,1,3,0,1,0,76.14,65.89 ,33.33
03,008,01,001,0017,0,1385,14,1399,1889,0,3,1,3,0,1,0,76.14,74.06 ,33.33
03,008,01,001,0018,0,3226,21,3247,4570,0,3,1,3,0,1,0,76.14,71.05 ,33.33
03,008,01,001,0019,0,3334,22,3356,4787,0,3,1,3,0,1,0,76.14,70.11 ,33.33
03,008,01,001,0020,0,941,5,946,1299,0,3,1,3,0,1,0,76.14,72.83 ,33.33
03,008,01,001,0021,0,372,5,377,561,0,3,1,3,0,1,0,76.14,67.20 ,33.33
03,008,01,001,0022,0,1265,8,1273,1844,0,3,1,3,0,1,0,76.14,69.03 ,33.33
03,008,01,001,0023,0,1383,8,1391,1940,0,3,1,3,0,1,0,76.14,71.70 ,33.33
03,008,01,001,0024,0,1040,6,1046,1482,0,3,1,3,0,1,0,76.14,70.58 ,33.33
03,008,01,001,0025,0,1660,11,1671,2301,0,3,1,3,0,1,0,76.14,72.62 ,33.33
03,008,01,001,0026,0,3838,32,3870,5462,0,3,1,3,0,1,0,76.14,70.85 ,33.33
03,008,01,001,0027,0,2636,21,2657,3905,0,3,1,3,0,1,0,76.14,68.04 ,33.33
03,008,01,001,0028,0,2292,23,2315,3388,0,3,1,3,0,1,0,76.14,68.33 ,33.33
03,008,01,001,0029,0,1508,17,1525,2262,0,3,1,3,0,1,0,76.14,67.42 ,33.33
03,008,01,001,0030,0,1677,19,1696,2503,0,3,1,3,0,1,0,76.14,67.76 ,33.33
03,008,01,001,0031,0,741,6,747,1269,0,3,1,3,0,1,0,76.14,58.87 ,33.33
03,008,01,001,0032,0,525,4,529,752,0,3,1,3,0,1,0,76.14,70.35 ,33.33
03,008,01,001,0033,0,510,5,515,763,0,3,1,3,0,1,0,76.14,67.50 ,33.33
03,008,01,001,0034,0,1078,11,1089,1730,0,3,1,3,0,1,0,76.14,62.95 ,33.33
03,008,01,002,0035,0,1899,14,1913,2880,0,3,1,3,0,1,0,76.14,66.42 ,33.33
03,008,01,002,0036,0,1907,12,1919,3026,0,3,1,3,0,1,0,76.14,63.42 ,33.33
03,008,01,002,0037,0,621,8,629,943,0,3,1,3,0,1,0,76.14,66.70 ,33.33
03,008,01,002,0038,0,1463,25,1488,2274,0,3,1,3,0,1,0,76.14,65.44 ,33.33
03,008,01,002,0039,0,1967,14,1981,2987,0,3,1,3,0,1,0,76.14,66.32 ,33.33
03,008,01,002,0040,0,1250,15,1265,1878,0,3,1,3,0,1,0,76.14,67.36 ,33.33
03,008,01,002,0041,0,1332,12,1344,2100,0,3,1,3,0,1,0,76.14,64.00 ,33.33
03,008,01,002,0042,0,1420,30,1450,2169,0,3,1,3,0,1,0,76.14,66.85 ,33.33
03,008,01,002,0043,0,2174,23,2197,3443,0,3,1,3,0,1,0,76.14,63.81 ,33.33
03,008,01,002,0044,0,863,11,874,1250,0,3,1,3,0,1,0,76.14,69.92 ,33.33
03,008,01,002,0045,0,3553,38,3591,5532,0,3,1,3,0,1,0,76.14,64.91 ,33.33
03,008,01,002,0046,0,619,6,625,913,0,3,1,3,0,1,0,76.14,68.46 ,33.33
03,008,01,002,0047,0,1468,14,1482,2210,0,3,1,3,0,1,0,76.14,67.06 ,33.33
03,008,01,002,0048,0,3392,46,3438,5322,0,3,1,3,0,1,0,76.14,64.60 ,33.33
03,008,01,002,0049,0,1846,29,1875,3033,0,3,1,3,0,1,0,76.14,61.82 ,33.33
03,008,01,002,0050,0,607,6,613,963,0,3,1,3,0,1,0,76.14,63.66 ,33.33
03,008,01,002,0051,0,651,6,657,956,0,3,1,3,0,1,0,76.14,68.72 ,33.33
03,008,01,002,0052,0,522,3,525,765,0,3,1,3,0,1,0,76.14,68.63 ,33.33
03,008,01,002,0053,0,594,4,598,938,0,3,1,3,0,1,0,76.14,63.75 ,33.33
03,008,01,002,0054,0,200,2,202,347,0,3,1,3,0,1,0,76.14,58.21 ,33.33
03,008,01,002,0055,0,815,13,828,1299,0,3,1,3,0,1,0,76.14,63.74 ,33.33
03,008,01,002,0056,0,820,15,835,1315,0,3,1,3,0,1,0,76.14,63.50 ,33.33
03,008,01,002,0057,0,999,7,1006,1530,0,3,1,3,0,1,0,76.14,65.75 ,33.33
03,008,01,002,0058,0,779,10,789,1189,0,3,1,3,0,1,0,76.14,66.36 ,33.33
03,008,01,002,0059,0,481,4,485,664,0,3,1,3,0,1,0,76.14,73.04 ,33.33
03,008,01,002,0060,0,889,15,904,1196,0,3,1,3,0,1,0,76.14,75.59 ,33.33
03,008,01,002,0061,0,1061,6,1067,1536,0,3,1,3,0,1,0,76.14,69.47 ,33.33
03,008,01,002,0062,0,673,9,682,1140,0,3,1,3,0,1,0,76.14,59.82 ,33.33
03,008,01,002,0063,0,382,2,384,633,0,3,1,3,0,1,0,76.14,60.66 ,33.33
03,008,01,002,0064,0,603,9,612,981,0,3,1,3,0,1,0,76.14,62.39 ,33.33
03,008,01,002,0065,0,1604,18,1622,2371,0,3,1,3,0,1,0,76.14,68.41 ,33.33
03,008,01,002,0066,0,805,8,813,1187,0,3,1,3,0,1,0,76.14,68.49 ,33.33
03,008,01,002,0067,0,1619,22,1641,2452,0,3,1,3,0,1,0,76.14,66.92 ,33.33
03,008,01,003,0068,0,1317,16,1333,1878,0,3,1,3,0,1,0,76.14,70.98 ,33.33
03,008,01,003,0069,0,2289,12,2301,3318,0,3,1,3,0,1,0,76.14,69.35 ,33.33
03,008,01,003,0070,0,1472,11,1483,2048,0,3,1,3,0,1,0,76.14,72.41 ,33.33
03,008,01,003,0071,0,541,8,549,726,0,3,1,3,0,1,0,76.14,75.62 ,33.33
03,008,01,003,0072,0,919,7,926,1262,0,3,1,3,0,1,0,76.14,73.38 ,33.33
03,008,01,003,0073,0,1533,14,1547,2233,0,3,1,3,0,1,0,76.14,69.28 ,33.33
03,008,01,003,0074,0,3585,37,3622,5189,0,3,1,3,0,1,0,76.14,69.80 ,33.33
03,008,01,003,0075,0,4089,30,4119,5814,0,3,1,3,0,1,0,76.14,70.85 ,33.33
03,008,01,003,0076,0,1899,20,1919,2694,0,3,1,3,0,1,0,76.14,71.23 ,33.33
03,008,01,003,0077,0,1653,20,1673,2300,0,3,1,3,0,1,0,76.14,72.74 ,33.33
03,008,01,003,0078,0,2171,18,2189,3258,0,3,1,3,0,1,0,76.14,67.19 ,33.33
03,008,01,003,0079,0,1193,9,1202,1620,0,3,1,3,0,1,0,76.14,74.20 ,33.33
03,008,01,003,0080,0,1845,27,1872,2696,0,3,1,3,0,1,0,76.14,69.44 ,33.33
03,008,01,003,0081,0,3310,32,3342,4951,0,3,1,3,0,1,0,76.14,67.50 ,33.33
03,008,01,003,0082,0,2314,24,2338,3291,0,3,1,3,0,1,0,76.14,71.04 ,33.33
03,008,01,003,0083,0,1956,22,1978,2794,0,3,1,3,0,1,0,76.14,70.79 ,33.33
03,008,01,003,0084,0,1420,15,1435,1916,0,3,1,3,0,1,0,76.14,74.90 ,33.33
03,008,01,003,0085,0,859,4,863,1203,0,3,1,3,0,1,0,76.14,71.74 ,33.33
03,008,01,003,0086,0,1646,12,1658,2322,0,3,1,3,0,1,0,76.14,71.40 ,33.33
03,008,01,003,0087,0,2910,32,2942,4272,0,3,1,3,0,1,0,76.14,68.87 ,33.33
03,008,01,003,0088,0,1259,18,1277,1840,0,3,1,3,0,1,0,76.14,69.40 ,33.33
03,008,01,003,0089,0,1261,15,1276,1764,0,3,1,3,0,1,0,76.14,72.34 ,33.33
03,008,01,003,0090,0,2241,24,2265,3192,0,3,1,3,0,1,0,76.14,70.96 ,33.33
03,008,01,003,0091,0,684,4,688,943,0,3,1,3,0,1,0,76.14,72.96 ,33.33
03,008,01,003,0092,0,1052,15,1067,1639,0,3,1,3,0,1,0,76.14,65.10 ,33.33
03,008,01,003,0093,0,717,4,721,994,0,3,1,3,0,1,0,76.14,72.54 ,33.33
03,008,01,003,0094,0,1544,11,1555,2304,0,3,1,3,0,1,0,76.14,67.49 ,33.33
03,008,01,004,0095,0,1433,10,1443,2121,0,3,1,3,0,1,0,76.14,68.03 ,33.33
03,008,01,004,0096,0,527,7,534,745,0,3,1,3,0,1,0,76.14,71.68 ,33.33
03,008,01,004,0097,0,2884,27,2911,4291,0,3,1,3,0,1,0,76.14,67.84 ,33.33
03,008,01,004,0098,0,2106,18,2124,3173,0,3,1,3,0,1,0,76.14,66.94 ,33.33
03,008,01,004,0099,0,1380,24,1404,2192,0,3,1,3,0,1,0,76.14,64.05 ,33.33
03,008,01,004,0100,0,2166,17,2183,3277,0,3,1,3,0,1,0,76.14,66.62 ,33.33
03,008,01,004,0101,0,703,7,710,1055,0,3,1,3,0,1,0,76.14,67.30 ,33.33
03,008,01,004,0102,0,729,10,739,1028,0,3,1,3,0,1,0,76.14,71.89 ,33.33
03,008,01,004,0103,0,803,8,811,1274,0,3,1,3,0,1,0,76.14,63.66 ,33.33
03,008,01,004,0104,0,511,4,515,768,0,3,1,3,0,1,0,76.14,67.06 ,33.33
03,008,01,004,0105,0,277,4,281,368,0,3,1,3,0,1,0,76.14,76.36 ,33.33
03,008,01,004,0106,0,2564,15,2579,4014,0,3,1,3,0,1,0,76.14,64.25 ,33.33
03,008,01,004,0107,0,2034,20,2054,3180,0,3,1,3,0,1,0,76.14,64.59 ,33.33
03,008,01,004,0108,0,1085,20,1105,1641,0,3,1,3,0,1,0,76.14,67.34 ,33.33
03,008,01,004,0109,0,1728,26,1754,2690,0,3,1,3,0,1,0,76.14,65.20 ,33.33
03,008,01,004,0110,0,389,5,394,666,0,3,1,3,0,1,0,76.14,59.16 ,33.33
03,008,01,004,0111,0,1164,14,1178,1873,0,3,1,3,0,1,0,76.14,62.89 ,33.33
03,008,01,004,0112,0,648,2,650,916,0,3,1,3,0,1,0,76.14,70.96 ,33.33
03,008,01,004,0113,0,946,10,956,1377,0,3,1,3,0,1,0,76.14,69.43 ,33.33
03,008,01,004,0114,0,434,11,445,705,0,3,1,3,0,1,0,76.14,63.12 ,33.33
03,008,01,004,0115,0,409,6,415,634,0,3,1,3,0,1,0,76.14,65.46 ,33.33
03,008,01,004,0116,0,914,5,919,1366,0,3,1,3,0,1,0,76.14,67.28 ,33.33
03,008,01,004,0117,0,634,10,644,923,0,3,1,3,0,1,0,76.14,69.77 ,33.33
03,008,01,004,0118,0,376,6,382,565,0,3,1,3,0,1,0,76.14,67.61 ,33.33
03,008,01,004,0119,0,553,10,563,891,0,3,1,3,0,1,0,76.14,63.19 ,33.33
03,008,01,004,0120,0,345,4,349,571,0,3,1,3,0,1,0,76.14,61.12 ,33.33
03,008,01,004,0121,0,487,7,494,769,0,3,1,3,0,1,0,76.14,64.24 ,33.33
03,008,01,004,0122,0,650,9,659,1081,0,3,1,3,0,1,0,76.14,60.96 ,33.33
03,008,01,005,0123,0,628,8,636,890,0,3,1,3,0,1,0,76.14,71.46 ,33.33
03,008,01,005,0124,0,637,10,647,950,0,3,1,3,0,1,0,76.14,68.11 ,33.33
03,008,01,005,0125,0,376,2,378,556,0,3,1,3,0,1,0,76.14,67.99 ,33.33
03,008,01,005,0126,0,732,10,742,1121,0,3,1,3,0,1,0,76.14,66.19 ,33.33
03,008,01,005,0127,0,389,5,394,554,0,3,1,3,0,1,0,76.14,71.12 ,33.33
03,008,01,005,0128,0,330,5,335,464,0,3,1,3,0,1,0,76.14,72.20 ,33.33
03,008,01,005,0129,0,627,8,635,896,0,3,1,3,0,1,0,76.14,70.87 ,33.33
03,008,01,005,0130,0,902,13,915,1357,0,3,1,3,0,1,0,76.14,67.43 ,33.33
03,008,01,005,0131,0,646,10,656,915,0,3,1,3,0,1,0,76.14,71.69 ,33.33
03,008,01,005,0132,0,681,2,683,1017,0,3,1,3,0,1,0,76.14,67.16 ,33.33
03,008,01,005,0133,0,252,3,255,409,0,3,1,3,0,1,0,76.14,62.35 ,33.33
03,008,01,006,0134,0,706,3,709,1012,0,3,1,3,0,1,0,76.14,70.06 ,33.33
03,008,01,006,0135,0,1882,19,1901,2863,0,3,1,3,0,1,0,76.14,66.40 ,33.33
03,008,01,006,0136,0,1272,21,1293,1953,0,3,1,3,0,1,0,76.14,66.21 ,33.33
03,008,01,006,0137,0,1029,14,1043,1550,0,3,1,3,0,1,0,76.14,67.29 ,33.33
03,008,01,006,0138,0,714,10,724,1031,0,3,1,3,0,1,0,76.14,70.22 ,33.33
03,008,01,006,0139,0,640,13,653,1002,0,3,1,3,0,1,0,76.14,65.17 ,33.33
03,008,01,006,0140,0,2368,23,2391,3432,0,3,1,3,0,1,0,76.14,69.67 ,33.33
03,008,01,006,0141,0,1041,8,1049,1625,0,3,1,3,0,1,0,76.14,64.55 ,33.33
03,008,01,006,0142,0,584,6,590,848,0,3,1,3,0,1,0,76.14,69.58 ,33.33
03,008,01,006,0143,0,731,8,739,989,0,3,1,3,0,1,0,76.14,74.72 ,33.33
03,008,01,006,0144,0,3032,32,3064,4560,0,3,1,3,0,1,0,76.14,67.19 ,33.33
03,008,01,006,0147,0,840,14,854,1255,0,3,1,3,0,1,0,76.14,68.05 ,33.33
03,008,01,006,0148,0,622,8,630,918,0,3,1,3,0,1,0,76.14,68.63 ,33.33
03,008,01,006,0149,0,933,12,945,1455,0,3,1,3,0,1,0,76.14,64.95 ,33.33
03,008,01,006,0150,0,889,11,900,1410,0,3,1,3,0,1,0,76.14,63.83 ,33.33
03,008,01,006,0151,0,717,8,725,1093,0,3,1,3,0,1,0,76.14,66.33 ,33.33
03,008,01,006,0152,0,559,5,564,799,0,3,1,3,0,1,0,76.14,70.59 ,33.33
03,008,01,006,0153,0,551,11,562,849,0,3,1,3,0,1,0,76.14,66.20 ,33.33
03,008,01,006,0154,0,533,6,539,819,0,3,1,3,0,1,0,76.14,65.81 ,33.33
03,008,01,006,0155,0,1019,11,1030,1583,0,3,1,3,0,1,0,76.14,65.07 ,33.33
03,008,01,007,0156,0,950,15,965,1553,0,3,1,3,0,1,0,76.14,62.14 ,33.33
03,008,01,007,0157,0,1094,10,1104,1648,0,3,1,3,0,1,0,76.14,66.99 ,33.33
03,008,01,007,0158,0,770,10,780,1125,0,3,1,3,0,1,0,76.14,69.33 ,33.33
03,008,01,007,0159,0,1281,7,1288,1850,0,3,1,3,0,1,0,76.14,69.62 ,33.33
03,008,01,007,0160,0,672,9,681,1019,0,3,1,3,0,1,0,76.14,66.83 ,33.33
03,008,01,007,0161,0,405,6,411,623,0,3,1,3,0,1,0,76.14,65.97 ,33.33
03,008,01,007,0162,0,928,9,937,1522,0,3,1,3,0,1,0,76.14,61.56 ,33.33
03,008,01,007,0163,0,557,1,558,882,0,3,1,3,0,1,0,76.14,63.27 ,33.33
03,008,01,007,0164,0,913,9,922,1325,0,3,1,3,0,1,0,76.14,69.58 ,33.33
03,008,01,007,0165,0,883,9,892,1276,0,3,1,3,0,1,0,76.14,69.91 ,33.33
03,008,01,007,0166,0,609,8,617,1085,0,3,1,3,0,1,0,76.14,56.87 ,33.33
03,008,01,007,0167,0,438,3,441,751,0,3,1,3,0,1,0,76.14,58.72 ,33.33
03,008,01,007,0168,0,470,10,480,802,0,3,1,3,0,1,0,76.14,59.85 ,33.33
03,008,01,008,0169,0,543,7,550,856,0,3,1,3,0,1,0,76.14,64.25 ,33.33
03,008,01,008,0170,0,352,5,357,513,0,3,1,3,0,1,0,76.14,69.59 ,33.33
03,008,01,008,0171,0,502,5,507,756,0,3,1,3,0,1,0,76.14,67.06 ,33.33
03,008,01,008,0172,0,488,4,492,812,0,3,1,3,0,1,0,76.14,60.59 ,33.33
03,008,01,008,0173,0,400,3,403,691,0,3,1,3,0,1,0,76.14,58.32 ,33.33
03,008,01,008,0174,0,717,6,723,1007,0,3,1,3,0,1,0,76.14,71.80 ,33.33
03,008,01,008,0175,0,738,5,743,1069,0,3,1,3,0,1,0,76.14,69.50 ,33.33
03,008,01,008,0176,0,465,8,473,698,0,3,1,3,0,1,0,76.14,67.77 ,33.33
03,008,01,008,0177,0,332,6,338,542,0,3,1,3,0,1,0,76.14,62.36 ,33.33
03,008,01,008,0178,0,734,7,741,1090,0,3,1,3,0,1,0,76.14,67.98 ,33.33
03,008,01,008,0179,0,787,6,793,1113,0,3,1,3,0,1,0,76.14,71.25 ,33.33
03,008,01,008,0180,0,599,12,611,993,0,3,1,3,0,1,0,76.14,61.53 ,33.33
03,008,01,008,0181,0,309,3,312,463,0,3,1,3,0,1,0,76.14,67.39 ,33.33
03,008,01,008,0182,0,466,7,473,703,0,3,1,3,0,1,0,76.14,67.28 ,33.33
03,008,01,008,0183,0,377,6,383,590,0,3,1,3,0,1,0,76.14,64.92 ,33.33
03,008,01,008,0184,0,416,7,423,676,0,3,1,3,0,1,0,76.14,62.57 ,33.33
03,008,01,008,0185,0,289,4,293,435,0,3,1,3,0,1,0,76.14,67.36 ,33.33
03,008,01,008,0186,0,358,6,364,553,0,3,1,3,0,1,0,76.14,65.82 ,33.33
03,008,01,009,0187,0,1135,8,1143,1842,0,3,1,3,0,1,0,76.14,62.05 ,33.33
03,008,01,009,0188,0,933,7,940,1525,0,3,1,3,0,1,0,76.14,61.64 ,33.33
03,008,01,009,0189,0,643,1,644,1037,0,3,1,3,0,1,0,76.14,62.10 ,33.33
03,008,01,009,0190,0,728,8,736,1183,0,3,1,3,0,1,0,76.14,62.21 ,33.33
03,008,01,009,0191,0,608,13,621,955,0,3,1,3,0,1,0,76.14,65.03 ,33.33
03,008,01,009,0192,0,884,10,894,1318,0,3,1,3,0,1,0,76.14,67.83 ,33.33
03,008,01,009,0193,0,422,1,423,656,0,3,1,3,0,1,0,76.14,64.48 ,33.33
03,008,01,009,0194,0,473,5,478,707,0,3,1,3,0,1,0,76.14,67.61 ,33.33
03,008,01,009,0195,0,622,6,628,977,0,3,1,3,0,1,0,76.14,64.28 ,33.33
03,008,01,009,0196,0,489,7,496,771,0,3,1,3,0,1,0,76.14,64.33 ,33.33
03,008,01,009,0197,0,326,3,329,539,0,3,1,3,0,1,0,76.14,61.04 ,33.33
03,008,01,009,0198,0,589,5,594,992,0,3,1,3,0,1,0,76.14,59.88 ,33.33
03,008,01,009,0199,0,446,7,453,790,0,3,1,3,0,1,0,76.14,57.34 ,33.33
03,008,01,010,0200,0,1073,16,1089,1668,0,3,1,3,0,1,0,76.14,65.29 ,33.33
03,008,01,010,0201,0,1027,10,1037,1641,0,3,1,3,0,1,0,76.14,63.19 ,33.33
03,008,01,010,0202,0,492,5,497,765,0,3,1,3,0,1,0,76.14,64.97 ,33.33
03,008,01,010,0203,0,908,9,917,1540,0,3,1,3,0,1,0,76.14,59.55 ,33.33
03,008,01,010,0204,0,427,8,435,717,0,3,1,3,0,1,0,76.14,60.67 ,33.33
03,008,01,010,0205,0,492,5,497,860,0,3,1,3,0,1,0,76.14,57.79 ,33.33
03,008,01,010,0206,0,1219,9,1228,2052,0,3,1,3,0,1,0,76.14,59.84 ,33.33
03,008,01,010,0207,0,1274,16,1290,1840,0,3,1,3,0,1,0,76.14,70.11 ,33.33
03,008,01,010,0208,0,582,3,585,881,0,3,1,3,0,1,0,76.14,66.40 ,33.33
03,008,01,010,0209,0,812,4,816,1205,0,3,1,3,0,1,0,76.14,67.72 ,33.33
03,008,01,010,0210,0,465,3,468,757,0,3,1,3,0,1,0,76.14,61.82 ,33.33
03,008,01,010,0211,0,1034,14,1048,1640,0,3,1,3,0,1,0,76.14,63.90 ,33.33
03,008,01,010,0212,0,1151,19,1170,1916,0,3,1,3,0,1,0,76.14,61.06 ,33.33
03,008,01,011,0213,0,536,10,546,893,0,3,1,3,0,1,0,76.14,61.14 ,33.33
03,008,01,011,0214,0,1031,15,1046,1681,0,3,1,3,0,1,0,76.14,62.22 ,33.33
03,008,01,011,0215,0,478,6,484,718,0,3,1,3,0,1,0,76.14,67.41 ,33.33
03,008,01,011,0216,0,721,6,727,1069,0,3,1,3,0,1,0,76.14,68.01 ,33.33
03,008,01,011,0217,0,379,9,388,553,0,3,1,3,0,1,0,76.14,70.16 ,33.33
03,008,01,011,0218,0,653,5,658,986,0,3,1,3,0,1,0,76.14,66.73 ,33.33
03,008,01,011,0219,0,844,4,848,1288,0,3,1,3,0,1,0,76.14,65.84 ,33.33
03,008,01,011,0220,0,755,7,762,1062,0,3,1,3,0,1,0,76.14,71.75 ,33.33
03,008,01,011,0221,0,916,12,928,1382,0,3,1,3,0,1,0,76.14,67.15 ,33.33
03,008,01,011,0222,0,638,6,644,1044,0,3,1,3,0,1,0,76.14,61.69 ,33.33
03,008,01,011,0223,0,714,10,724,1111,0,3,1,3,0,1,0,76.14,65.17 ,33.33
03,008,01,011,0224,0,226,4,230,371,0,3,1,3,0,1,0,76.14,61.99 ,33.33
03,008,01,011,0225,0,249,2,251,392,0,3,1,3,0,1,0,76.14,64.03 ,33.33
03,008,01,011,0226,0,733,8,741,1183,0,3,1,3,0,1,0,76.14,62.64 ,33.33
03,008,01,011,0227,0,206,0,206,357,0,3,1,3,0,1,0,76.14,57.70 ,33.33
03,008,01,011,0228,0,254,1,255,387,0,3,1,3,0,1,0,76.14,65.89 ,33.33
03,008,01,011,0229,0,665,6,671,914,0,3,1,3,0,1,0,76.14,73.41 ,33.33
03,008,01,011,0230,0,356,5,361,558,0,3,1,3,0,1,0,76.14,64.70 ,33.33
03,008,01,011,0231,0,446,8,454,691,0,3,1,3,0,1,0,76.14,65.70 ,33.33
03,008,01,012,0232,0,749,5,754,1116,0,3,1,3,0,1,0,76.14,67.56 ,33.33
03,008,01,012,0233,0,374,2,376,527,0,3,1,3,0,1,0,76.14,71.35 ,33.33
03,008,01,012,0234,0,510,7,517,731,0,3,1,3,0,1,0,76.14,70.73 ,33.33
03,008,01,012,0235,0,224,2,226,329,0,3,1,3,0,1,0,76.14,68.69 ,33.33
03,008,01,012,0236,0,47,0,47,74,0,3,1,3,0,1,0,76.14,63.51 ,33.33
03,008,01,012,0237,0,142,3,145,241,0,3,1,3,0,1,0,76.14,60.17 ,33.33
03,008,01,012,0238,0,189,0,189,296,0,3,1,3,0,1,0,76.14,63.85 ,33.33
03,008,01,012,0239,0,173,3,176,260,0,3,1,3,0,1,0,76.14,67.69 ,33.33
03,008,01,012,0240,0,450,4,454,750,0,3,1,3,0,1,0,76.14,60.53 ,33.33
03,008,01,012,0241,0,897,5,902,1334,0,3,1,3,0,1,0,76.14,67.62 ,33.33
03,008,01,012,0242,0,126,0,126,230,0,3,1,3,0,1,0,76.14,54.78 ,33.33
03,008,01,012,0243,0,8,0,8,12,0,3,1,3,0,1,0,76.14,66.67 ,33.33
03,008,01,012,0244,0,61,0,61,94,0,3,1,3,0,1,0,76.14,64.89 ,33.33
03,008,01,012,0245,0,28,0,28,48,0,3,1,3,0,1,0,76.14,58.33 ,33.33
03,008,01,013,0246,0,324,5,329,533,0,3,1,3,0,1,0,76.14,61.73 ,33.33
03,008,01,013,0247,0,653,14,667,1037,0,3,1,3,0,1,0,76.14,64.32 ,33.33
03,008,01,013,0248,0,53,2,55,85,0,3,1,3,0,1,0,76.14,64.71 ,33.33
03,008,01,013,0249,0,34,1,35,63,0,3,1,3,0,1,0,76.14,55.56 ,33.33
03,008,01,013,0250,0,71,1,72,147,0,3,1,3,0,1,0,76.14,48.98 ,33.33
03,008,01,013,0251,0,13,1,14,24,0,3,1,3,0,1,0,76.14,58.33 ,33.33
03,008,01,013,0252,0,10,0,10,20,0,3,1,3,0,1,0,76.14,50.00 ,33.33
03,008,01,013,0253,0,106,7,113,254,0,3,1,3,0,1,0,76.14,44.49 ,33.33
03,008,01,013,0254,0,32,1,33,64,0,3,1,3,0,1,0,76.14,51.56 ,33.33
03,008,01,013,0255,0,46,0,46,90,0,3,1,3,0,1,0,76.14,51.11 ,33.33
03,008,01,013,0256,0,25,0,25,50,0,3,1,3,0,1,0,76.14,50.00 ,33.33
03,008,01,013,0257,0,9,1,10,26,0,3,1,3,0,1,0,76.14,38.46 ,33.33
03,008,01,013,0258,0,44,0,44,83,0,3,1,3,0,1,0,76.14,53.01 ,33.33
03,008,01,013,0259,0,68,1,69,125,0,3,1,3,0,1,0,76.14,55.20 ,33.33
03,008,01,013,0260,0,38,0,38,56,0,3,1,3,0,1,0,76.14,67.86 ,33.33
03,009,01,001,0001,0,654,6,660,952,0,3,1,3,0,1,0,76.14,69.33 ,33.33
03,009,01,001,0002,0,505,9,514,727,0,3,1,3,0,1,0,76.14,70.70 ,33.33
03,009,01,001,0003,0,527,5,532,762,0,3,1,3,0,1,0,76.14,69.82 ,33.33
03,009,01,001,0004,0,432,6,438,600,0,3,1,3,0,1,0,76.14,73.00 ,33.33
03,009,01,001,0005,0,571,3,574,909,0,3,1,3,0,1,0,76.14,63.15 ,33.33
03,009,01,001,0006,0,1626,19,1645,2565,0,3,1,3,0,1,0,76.14,64.13 ,33.33
03,009,01,001,0007,0,2258,30,2288,3455,0,3,1,3,0,1,0,76.14,66.22 ,33.33
03,009,01,001,0008,0,2134,35,2169,3266,0,3,1,3,0,1,0,76.14,66.41 ,33.33
03,009,01,001,0009,0,3790,48,3838,5932,0,3,1,3,0,1,0,76.14,64.70 ,33.33
03,009,01,001,0010,0,992,12,1004,1480,0,3,1,3,0,1,0,76.14,67.84 ,33.33
03,009,01,001,0011,0,736,14,750,1142,0,3,1,3,0,1,0,76.14,65.67 ,33.33
03,009,01,001,0012,0,1635,23,1658,2468,0,3,1,3,0,1,0,76.14,67.18 ,33.33
03,009,01,001,0013,0,1552,22,1574,2355,0,3,1,3,0,1,0,76.14,66.84 ,33.33
03,009,01,001,0014,0,1301,24,1325,1998,0,3,1,3,0,1,0,76.14,66.32 ,33.33
03,009,01,001,0015,0,3505,57,3562,5322,0,3,1,3,0,1,0,76.14,66.93 ,33.33
03,009,01,001,0016,0,2034,23,2057,3189,0,3,1,3,0,1,0,76.14,64.50 ,33.33
03,009,01,001,0017,0,1394,22,1416,2126,0,3,1,3,0,1,0,76.14,66.60 ,33.33
03,009,01,001,0018,0,654,10,664,989,0,3,1,3,0,1,0,76.14,67.14 ,33.33
03,009,01,001,0019,0,510,11,521,715,0,3,1,3,0,1,0,76.14,72.87 ,33.33
03,009,01,001,0020,0,1104,16,1120,1659,0,3,1,3,0,1,0,76.14,67.51 ,33.33
03,009,01,001,0021,0,376,7,383,564,0,3,1,3,0,1,0,76.14,67.91 ,33.33
03,009,01,001,0022,0,809,14,823,1232,0,3,1,3,0,1,0,76.14,66.80 ,33.33
03,009,01,001,0023,0,384,1,385,569,0,3,1,3,0,1,0,76.14,67.66 ,33.33
03,009,01,001,0024,0,1254,21,1275,1784,0,3,1,3,0,1,0,76.14,71.47 ,33.33
03,009,01,001,0025,0,2629,32,2661,4201,0,3,1,3,0,1,0,76.14,63.34 ,33.33
03,009,01,001,0026,0,1961,16,1977,2923,0,3,1,3,0,1,0,76.14,67.64 ,33.33
03,009,01,001,0027,0,1078,13,1091,1509,0,3,1,3,0,1,0,76.14,72.30 ,33.33
03,009,01,001,0028,0,2442,26,2468,3624,0,3,1,3,0,1,0,76.14,68.10 ,33.33
03,009,01,001,0029,0,649,8,657,918,0,3,1,3,0,1,0,76.14,71.57 ,33.33
03,009,01,001,0030,0,623,17,640,917,0,3,1,3,0,1,0,76.14,69.79 ,33.33
03,009,01,001,0031,0,1159,20,1179,1740,0,3,1,3,0,1,0,76.14,67.76 ,33.33
03,009,01,001,0032,0,910,24,934,1304,0,3,1,3,0,1,0,76.14,71.63 ,33.33
03,009,01,001,0033,0,1634,32,1666,2435,0,3,1,3,0,1,0,76.14,68.42 ,33.33
03,009,01,001,0034,0,1602,23,1625,2361,0,3,1,3,0,1,0,76.14,68.83 ,33.33
03,009,01,001,0035,0,773,13,786,1118,0,3,1,3,0,1,0,76.14,70.30 ,33.33
03,009,01,002,0036,0,761,19,780,1140,0,3,1,3,0,1,0,76.14,68.42 ,33.33
03,009,01,002,0037,0,2654,42,2696,4196,0,3,1,3,0,1,0,76.14,64.25 ,33.33
03,009,01,002,0038,0,1252,11,1263,2008,0,3,1,3,0,1,0,76.14,62.90 ,33.33
03,009,01,002,0039,0,857,5,862,1269,0,3,1,3,0,1,0,76.14,67.93 ,33.33
03,009,01,002,0040,0,854,9,863,1255,0,3,1,3,0,1,0,76.14,68.76 ,33.33
03,009,01,002,0041,0,790,10,800,1194,0,3,1,3,0,1,0,76.14,67.00 ,33.33
03,009,01,002,0042,0,583,13,596,863,0,3,1,3,0,1,0,76.14,69.06 ,33.33
03,009,01,002,0043,0,597,10,607,905,0,3,1,3,0,1,0,76.14,67.07 ,33.33
03,009,01,002,0044,0,611,10,621,876,0,3,1,3,0,1,0,76.14,70.89 ,33.33
03,009,01,002,0045,0,480,6,486,738,0,3,1,3,0,1,0,76.14,65.85 ,33.33
03,009,01,002,0046,0,850,14,864,1160,0,3,1,3,0,1,0,76.14,74.48 ,33.33
03,009,01,002,0047,0,929,9,938,1413,0,3,1,3,0,1,0,76.14,66.38 ,33.33
03,009,01,002,0048,0,1129,17,1146,1781,0,3,1,3,0,1,0,76.14,64.35 ,33.33
03,009,01,002,0049,0,2771,36,2807,4243,0,3,1,3,0,1,0,76.14,66.16 ,33.33
03,009,01,002,0050,0,699,13,712,982,0,3,1,3,0,1,0,76.14,72.51 ,33.33
03,009,01,002,0051,0,592,6,598,851,0,3,1,3,0,1,0,76.14,70.27 ,33.33
03,009,01,002,0052,0,638,7,645,932,0,3,1,3,0,1,0,76.14,69.21 ,33.33
03,009,01,002,0053,0,1098,8,1106,1604,0,3,1,3,0,1,0,76.14,68.95 ,33.33
03,009,01,002,0054,0,688,10,698,995,0,3,1,3,0,1,0,76.14,70.15 ,33.33
03,009,01,002,0055,0,1611,17,1628,2384,0,3,1,3,0,1,0,76.14,68.29 ,33.33
03,009,01,002,0056,0,1437,12,1449,2028,0,3,1,3,0,1,0,76.14,71.45 ,33.33
03,009,01,002,0057,0,1018,14,1032,1552,0,3,1,3,0,1,0,76.14,66.49 ,33.33
03,009,01,003,0058,0,1451,10,1461,2228,0,3,1,3,0,1,0,76.14,65.57 ,33.33
03,009,01,003,0059,0,1087,14,1101,1709,0,3,1,3,0,1,0,76.14,64.42 ,33.33
03,009,01,003,0060,0,1644,14,1658,2616,0,3,1,3,0,1,0,76.14,63.38 ,33.33
03,009,01,003,0061,0,1366,18,1384,2332,0,3,1,3,0,1,0,76.14,59.35 ,33.33
03,009,01,003,0062,0,706,8,714,1130,0,3,1,3,0,1,0,76.14,63.19 ,33.33
03,009,01,003,0063,0,1721,21,1742,2883,0,3,1,3,0,1,0,76.14,60.42 ,33.33
03,009,01,003,0064,0,2011,25,2036,3319,0,3,1,3,0,1,0,76.14,61.34 ,33.33
03,009,01,003,0065,0,888,14,902,1328,0,3,1,3,0,1,0,76.14,67.92 ,33.33
03,009,01,003,0066,0,721,15,736,1120,0,3,1,3,0,1,0,76.14,65.71 ,33.33
03,009,01,003,0067,0,1040,20,1060,1672,0,3,1,3,0,1,0,76.14,63.40 ,33.33
03,009,01,003,0068,0,1291,25,1316,2137,0,3,1,3,0,1,0,76.14,61.58 ,33.33
03,009,01,003,0069,0,1022,7,1029,1618,0,3,1,3,0,1,0,76.14,63.60 ,33.33
03,009,01,003,0070,0,563,10,573,881,0,3,1,3,0,1,0,76.14,65.04 ,33.33
03,009,01,003,0071,0,470,1,471,717,0,3,1,3,0,1,0,76.14,65.69 ,33.33
03,009,01,003,0072,0,1477,27,1504,2285,0,3,1,3,0,1,0,76.14,65.82 ,33.33
03,009,01,003,0073,0,549,7,556,790,0,3,1,3,0,1,0,76.14,70.38 ,33.33
03,009,01,003,0074,0,1008,24,1032,1670,0,3,1,3,0,1,0,76.14,61.80 ,33.33
03,009,01,003,0075,0,1006,26,1032,1515,0,3,1,3,0,1,0,76.14,68.12 ,33.33
03,009,01,003,0076,0,1784,24,1808,2843,0,3,1,3,0,1,0,76.14,63.59 ,33.33
03,009,01,003,0077,0,1376,30,1406,2251,0,3,1,3,0,1,0,76.14,62.46 ,33.33
03,009,01,003,0078,0,1551,22,1573,2356,0,3,1,3,0,1,0,76.14,66.77 ,33.33
03,009,01,003,0079,0,799,12,811,1283,0,3,1,3,0,1,0,76.14,63.21 ,33.33
03,009,01,003,0080,0,817,16,833,1294,0,3,1,3,0,1,0,76.14,64.37 ,33.33
03,009,01,003,0081,0,754,11,765,1143,0,3,1,3,0,1,0,76.14,66.93 ,33.33
03,009,01,003,0082,0,994,23,1017,1475,0,3,1,3,0,1,0,76.14,68.95 ,33.33
03,009,01,003,0083,0,535,9,544,864,0,3,1,3,0,1,0,76.14,62.96 ,33.33
03,009,01,003,0084,0,551,10,561,948,0,3,1,3,0,1,0,76.14,59.18 ,33.33
03,009,01,003,0085,0,504,7,511,766,0,3,1,3,0,1,0,76.14,66.71 ,33.33
03,009,01,003,0086,0,660,9,669,1011,0,3,1,3,0,1,0,76.14,66.17 ,33.33
03,009,01,004,0087,0,959,10,969,1567,0,3,1,3,0,1,0,76.14,61.84 ,33.33
03,009,01,004,0088,0,907,13,920,1440,0,3,1,3,0,1,0,76.14,63.89 ,33.33
03,009,01,004,0089,0,952,8,960,1608,0,3,1,3,0,1,0,76.14,59.70 ,33.33
03,009,01,004,0090,0,1765,17,1782,2859,0,3,1,3,0,1,0,76.14,62.33 ,33.33
03,009,01,004,0091,0,280,7,287,450,0,3,1,3,0,1,0,76.14,63.78 ,33.33
03,009,01,004,0092,0,491,1,492,734,0,3,1,3,0,1,0,76.14,67.03 ,33.33
03,009,01,004,0093,0,399,7,406,671,0,3,1,3,0,1,0,76.14,60.51 ,33.33
03,009,01,004,0094,0,618,8,626,986,0,3,1,3,0,1,0,76.14,63.49 ,33.33
03,009,01,004,0095,0,1338,14,1352,2153,0,3,1,3,0,1,0,76.14,62.80 ,33.33
03,009,01,004,0096,0,1994,23,2017,3300,0,3,1,3,0,1,0,76.14,61.12 ,33.33
03,009,01,004,0097,0,753,12,765,1274,0,3,1,3,0,1,0,76.14,60.05 ,33.33
03,009,01,004,0098,0,901,15,916,1422,0,3,1,3,0,1,0,76.14,64.42 ,33.33
03,009,01,004,0099,0,1095,8,1103,1729,0,3,1,3,0,1,0,76.14,63.79 ,33.33
03,009,01,004,0100,0,533,11,544,904,0,3,1,3,0,1,0,76.14,60.18 ,33.33
03,009,01,004,0101,0,685,6,691,1119,0,3,1,3,0,1,0,76.14,61.75 ,33.33
03,009,01,004,0102,0,885,11,896,1481,0,3,1,3,0,1,0,76.14,60.50 ,33.33
03,009,01,004,0103,0,533,8,541,871,0,3,1,3,0,1,0,76.14,62.11 ,33.33
03,009,01,004,0104,0,645,9,654,974,0,3,1,3,0,1,0,76.14,67.15 ,33.33
03,009,01,004,0105,0,842,13,855,1374,0,3,1,3,0,1,0,76.14,62.23 ,33.33
03,009,01,004,0106,0,458,8,466,742,0,3,1,3,0,1,0,76.14,62.80 ,33.33
03,009,01,004,0107,0,539,5,544,796,0,3,1,3,0,1,0,76.14,68.34 ,33.33
03,009,01,004,0108,0,612,6,618,1005,0,3,1,3,0,1,0,76.14,61.49 ,33.33
03,009,01,004,0109,0,791,14,805,1389,0,3,1,3,0,1,0,76.14,57.96 ,33.33
03,009,01,004,0110,0,557,10,567,955,0,3,1,3,0,1,0,76.14,59.37 ,33.33
03,009,01,004,0111,0,516,10,526,927,0,3,1,3,0,1,0,76.14,56.74 ,33.33
03,009,01,004,0112,0,1033,9,1042,1795,0,3,1,3,0,1,0,76.14,58.05 ,33.33
03,009,01,004,0113,0,891,10,901,1392,0,3,1,3,0,1,0,76.14,64.73 ,33.33
03,009,01,005,0114,0,657,5,662,967,0,3,1,3,0,1,0,76.14,68.46 ,33.33
03,009,01,005,0115,0,685,8,693,1003,0,3,1,3,0,1,0,76.14,69.09 ,33.33
03,009,01,005,0116,0,870,5,875,1320,0,3,1,3,0,1,0,76.14,66.29 ,33.33
03,009,01,005,0117,0,620,14,634,874,0,3,1,3,0,1,0,76.14,72.54 ,33.33
03,009,01,005,0118,0,799,10,809,1147,0,3,1,3,0,1,0,76.14,70.53 ,33.33
03,009,01,005,0119,0,941,11,952,1524,0,3,1,3,0,1,0,76.14,62.47 ,33.33
03,009,01,005,0120,0,794,17,811,1306,0,3,1,3,0,1,0,76.14,62.10 ,33.33
03,009,01,005,0121,0,857,15,872,1462,0,3,1,3,0,1,0,76.14,59.64 ,33.33
03,009,01,005,0122,0,955,16,971,1465,0,3,1,3,0,1,0,76.14,66.28 ,33.33
03,009,01,005,0123,0,1469,23,1492,2309,0,3,1,3,0,1,0,76.14,64.62 ,33.33
03,009,01,005,0124,0,1025,16,1041,1502,0,3,1,3,0,1,0,76.14,69.31 ,33.33
03,009,01,005,0125,0,554,9,563,850,0,3,1,3,0,1,0,76.14,66.24 ,33.33
03,009,01,005,0126,0,1194,21,1215,1854,0,3,1,3,0,1,0,76.14,65.53 ,33.33
03,009,01,005,0127,0,1200,20,1220,1773,0,3,1,3,0,1,0,76.14,68.81 ,33.33
03,009,01,005,0128,0,1188,24,1212,1793,0,3,1,3,0,1,0,76.14,67.60 ,33.33
03,009,01,005,0129,0,674,12,686,974,0,3,1,3,0,1,0,76.14,70.43 ,33.33
03,009,01,005,0130,0,924,26,950,1442,0,3,1,3,0,1,0,76.14,65.88 ,33.33
03,009,01,006,0131,0,603,14,617,818,0,3,1,3,0,1,0,76.14,75.43 ,33.33
03,009,01,006,0132,0,584,10,594,797,0,3,1,3,0,1,0,76.14,74.53 ,33.33
03,009,01,006,0133,0,376,3,379,511,0,3,1,3,0,1,0,76.14,74.17 ,33.33
03,009,01,006,0134,0,733,8,741,1049,0,3,1,3,0,1,0,76.14,70.64 ,33.33
03,009,01,006,0135,0,281,5,286,412,0,3,1,3,0,1,0,76.14,69.42 ,33.33
03,009,01,006,0136,0,298,4,302,447,0,3,1,3,0,1,0,76.14,67.56 ,33.33
03,009,01,006,0137,0,317,6,323,467,0,3,1,3,0,1,0,76.14,69.16 ,33.33
03,009,01,006,0138,0,612,7,619,922,0,3,1,3,0,1,0,76.14,67.14 ,33.33
03,009,01,006,0139,0,408,7,415,551,0,3,1,3,0,1,0,76.14,75.32 ,33.33
03,009,01,006,0140,0,275,6,281,398,0,3,1,3,0,1,0,76.14,70.60 ,33.33
03,009,01,006,0141,0,431,9,440,651,0,3,1,3,0,1,0,76.14,67.59 ,33.33
03,009,01,006,0142,0,876,13,889,1343,0,3,1,3,0,1,0,76.14,66.20 ,33.33
03,009,01,006,0143,0,321,8,329,485,0,3,1,3,0,1,0,76.14,67.84 ,33.33
03,009,01,006,0144,0,3218,46,3264,4926,0,3,1,3,0,1,0,76.14,66.26 ,33.33
03,009,01,006,0145,0,820,11,831,1271,0,3,1,3,0,1,0,76.14,65.38 ,33.33
03,009,01,006,0146,0,3086,42,3128,4798,0,3,1,3,0,1,0,76.14,65.19 ,33.33
03,009,01,006,0147,0,722,11,733,1148,0,3,1,3,0,1,0,76.14,63.85 ,33.33
03,009,01,006,0148,0,608,11,619,1014,0,3,1,3,0,1,0,76.14,61.05 ,33.33
03,009,01,006,0149,0,259,3,262,411,0,3,1,3,0,1,0,76.14,63.75 ,33.33
03,009,01,006,0150,0,505,5,510,849,0,3,1,3,0,1,0,76.14,60.07 ,33.33
03,009,01,006,0151,0,881,16,897,1407,0,3,1,3,0,1,0,76.14,63.75 ,33.33
03,009,01,006,0152,0,709,11,720,1255,0,3,1,3,0,1,0,76.14,57.37 ,33.33
03,009,01,006,0153,0,522,16,538,1049,0,3,1,3,0,1,0,76.14,51.29 ,33.33
03,009,01,006,0154,0,342,12,354,639,0,3,1,3,0,1,0,76.14,55.40 ,33.33
03,009,01,006,0155,0,1107,22,1129,1615,0,3,1,3,0,1,0,76.14,69.91 ,33.33
03,009,01,006,0156,0,1662,15,1677,2734,0,3,1,3,0,1,0,76.14,61.34 ,33.33
03,009,01,006,0157,0,675,7,682,1067,0,3,1,3,0,1,0,76.14,63.92 ,33.33
03,009,01,006,0158,0,369,5,374,592,0,3,1,3,0,1,0,76.14,63.18 ,33.33
03,009,01,007,0159,0,1432,23,1455,2075,0,3,1,3,0,1,0,76.14,70.12 ,33.33
03,009,01,007,0160,0,1013,15,1028,1509,0,3,1,3,0,1,0,76.14,68.12 ,33.33
03,009,01,007,0161,0,1705,30,1735,2796,0,3,1,3,0,1,0,76.14,62.05 ,33.33
03,009,01,007,0162,0,958,17,975,1461,0,3,1,3,0,1,0,76.14,66.74 ,33.33
03,009,01,007,0163,0,813,7,820,1142,0,3,1,3,0,1,0,76.14,71.80 ,33.33
03,009,01,007,0164,0,784,13,797,1200,0,3,1,3,0,1,0,76.14,66.42 ,33.33
03,009,01,007,0165,0,657,2,659,946,0,3,1,3,0,1,0,76.14,69.66 ,33.33
03,009,01,007,0166,0,1318,17,1335,2011,0,3,1,3,0,1,0,76.14,66.38 ,33.33
03,009,01,007,0167,0,1304,15,1319,1950,0,3,1,3,0,1,0,76.14,67.64 ,33.33
03,009,01,007,0168,0,951,11,962,1383,0,3,1,3,0,1,0,76.14,69.56 ,33.33
03,009,01,007,0169,0,501,6,507,686,0,3,1,3,0,1,0,76.14,73.91 ,33.33
03,009,01,007,0170,0,1171,10,1181,1874,0,3,1,3,0,1,0,76.14,63.02 ,33.33
03,009,01,007,0171,0,1283,17,1300,2009,0,3,1,3,0,1,0,76.14,64.71 ,33.33
03,009,01,007,0172,0,473,6,479,650,0,3,1,3,0,1,0,76.14,73.69 ,33.33
03,009,01,007,0173,0,886,17,903,1302,0,3,1,3,0,1,0,76.14,69.35 ,33.33
03,009,01,007,0174,0,213,3,216,335,0,3,1,3,0,1,0,76.14,64.48 ,33.33
03,009,01,007,0175,0,465,7,472,785,0,3,1,3,0,1,0,76.14,60.13 ,33.33
03,009,01,007,0176,0,738,6,744,1153,0,3,1,3,0,1,0,76.14,64.53 ,33.33
03,009,01,007,0177,0,320,9,329,519,0,3,1,3,0,1,0,76.14,63.39 ,33.33
03,009,01,007,0178,0,428,6,434,659,0,3,1,3,0,1,0,76.14,65.86 ,33.33
03,009,01,008,0179,0,530,7,537,785,0,3,1,3,0,1,0,76.14,68.41 ,33.33
03,009,01,008,0180,0,1374,15,1389,2044,0,3,1,3,0,1,0,76.14,67.95 ,33.33
03,009,01,008,0181,0,709,8,717,1125,0,3,1,3,0,1,0,76.14,63.73 ,33.33
03,009,01,008,0182,0,669,8,677,1037,0,3,1,3,0,1,0,76.14,65.28 ,33.33
03,009,01,008,0183,0,1174,3,1177,1796,0,3,1,3,0,1,0,76.14,65.53 ,33.33
03,009,01,008,0184,0,1217,21,1238,1788,0,3,1,3,0,1,0,76.14,69.24 ,33.33
03,009,01,008,0185,0,824,12,836,1291,0,3,1,3,0,1,0,76.14,64.76 ,33.33
03,009,01,008,0186,0,835,9,844,1247,0,3,1,3,0,1,0,76.14,67.68 ,33.33
03,009,01,008,0187,0,500,14,514,807,0,3,1,3,0,1,0,76.14,63.69 ,33.33
03,009,01,008,0188,0,494,10,504,700,0,3,1,3,0,1,0,76.14,72.00 ,33.33
03,009,01,008,0189,0,750,10,760,1227,0,3,1,3,0,1,0,76.14,61.94 ,33.33
03,009,01,008,0190,0,543,11,554,836,0,3,1,3,0,1,0,76.14,66.27 ,33.33
03,009,01,008,0191,0,436,7,443,723,0,3,1,3,0,1,0,76.14,61.27 ,33.33
03,009,01,008,0192,0,537,6,543,838,0,3,1,3,0,1,0,76.14,64.80 ,33.33
03,009,01,008,0193,0,559,4,563,811,0,3,1,3,0,1,0,76.14,69.42 ,33.33
03,009,01,009,0194,0,2282,39,2321,3420,0,3,1,3,0,1,0,76.14,67.87 ,33.33
03,009,01,009,0195,0,623,9,632,914,0,3,1,3,0,1,0,76.14,69.15 ,33.33
03,009,01,009,0196,0,990,7,997,1601,0,3,1,3,0,1,0,76.14,62.27 ,33.33
03,009,01,009,0197,0,864,10,874,1273,0,3,1,3,0,1,0,76.14,68.66 ,33.33
03,009,01,009,0198,0,767,4,771,1145,0,3,1,3,0,1,0,76.14,67.34 ,33.33
03,009,01,009,0199,0,1164,7,1171,1741,0,3,1,3,0,1,0,76.14,67.26 ,33.33
03,009,01,009,0200,0,1540,31,1571,2381,0,3,1,3,0,1,0,76.14,65.98 ,33.33
03,009,01,009,0201,0,844,12,856,1223,0,3,1,3,0,1,0,76.14,69.99 ,33.33
03,009,01,009,0202,0,1262,22,1284,1860,0,3,1,3,0,1,0,76.14,69.03 ,33.33
03,009,01,009,0203,0,826,10,836,1149,0,3,1,3,0,1,0,76.14,72.76 ,33.33
03,009,01,009,0204,0,1129,18,1147,1755,0,3,1,3,0,1,0,76.14,65.36 ,33.33
03,009,01,009,0205,0,1027,9,1036,1570,0,3,1,3,0,1,0,76.14,65.99 ,33.33
03,009,01,009,0206,0,866,14,880,1331,0,3,1,3,0,1,0,76.14,66.12 ,33.33
03,009,01,009,0207,0,1128,13,1141,1752,0,3,1,3,0,1,0,76.14,65.13 ,33.33
03,009,01,010,0208,0,723,15,738,1036,0,3,1,3,0,1,0,76.14,71.24 ,33.33
03,009,01,010,0209,0,2156,44,2200,3299,0,3,1,3,0,1,0,76.14,66.69 ,33.33
03,009,01,010,0210,0,1404,23,1427,2111,0,3,1,3,0,1,0,76.14,67.60 ,33.33
03,009,01,010,0211,0,464,3,467,626,0,3,1,3,0,1,0,76.14,74.60 ,33.33
03,009,01,010,0212,0,632,11,643,934,0,3,1,3,0,1,0,76.14,68.84 ,33.33
03,009,01,010,0213,0,1699,18,1717,2502,0,3,1,3,0,1,0,76.14,68.63 ,33.33
03,009,01,010,0214,0,451,8,459,640,0,3,1,3,0,1,0,76.14,71.72 ,33.33
03,009,01,010,0215,0,776,13,789,1129,0,3,1,3,0,1,0,76.14,69.88 ,33.33
03,009,01,010,0216,0,724,6,730,1054,0,3,1,3,0,1,0,76.14,69.26 ,33.33
03,009,01,010,0217,0,1187,24,1211,1739,0,3,1,3,0,1,0,76.14,69.64 ,33.33
03,009,01,011,0218,0,902,11,913,1405,0,3,1,3,0,1,0,76.14,64.98 ,33.33
03,009,01,011,0219,0,1019,12,1031,1633,0,3,1,3,0,1,0,76.14,63.14 ,33.33
03,009,01,011,0220,0,1134,8,1142,1811,0,3,1,3,0,1,0,76.14,63.06 ,33.33
03,009,01,011,0221,0,1027,11,1038,1653,0,3,1,3,0,1,0,76.14,62.79 ,33.33
03,009,01,011,0222,0,813,14,827,1226,0,3,1,3,0,1,0,76.14,67.46 ,33.33
03,009,01,011,0223,0,1268,11,1279,1993,0,3,1,3,0,1,0,76.14,64.17 ,33.33
03,009,01,011,0224,0,577,9,586,964,0,3,1,3,0,1,0,76.14,60.79 ,33.33
03,009,01,011,0225,0,786,8,794,1336,0,3,1,3,0,1,0,76.14,59.43 ,33.33
03,009,01,011,0226,0,544,9,553,958,0,3,1,3,0,1,0,76.14,57.72 ,33.33
03,009,01,011,0227,0,455,6,461,785,0,3,1,3,0,1,0,76.14,58.73 ,33.33
03,009,01,011,0228,0,951,9,960,1534,0,3,1,3,0,1,0,76.14,62.58 ,33.33
03,009,01,011,0229,0,1101,17,1118,1914,0,3,1,3,0,1,0,76.14,58.41 ,33.33
03,009,01,011,0230,0,558,9,567,903,0,3,1,3,0,1,0,76.14,62.79 ,33.33
03,009,01,011,0231,0,1101,13,1114,1803,0,3,1,3,0,1,0,76.14,61.79 ,33.33
03,009,01,011,0232,0,804,13,817,1417,0,3,1,3,0,1,0,76.14,57.66 ,33.33
03,009,01,011,0233,0,585,7,592,1012,0,3,1,3,0,1,0,76.14,58.50 ,33.33
03,009,01,011,0234,0,544,1,545,851,0,3,1,3,0,1,0,76.14,64.04 ,33.33
03,009,01,011,0235,0,668,7,675,1059,0,3,1,3,0,1,0,76.14,63.74 ,33.33
03,009,01,012,0236,0,805,6,811,1284,0,3,1,3,0,1,0,76.14,63.16 ,33.33
03,009,01,012,0237,0,866,12,878,1414,0,3,1,3,0,1,0,76.14,62.09 ,33.33
03,009,01,012,0238,0,1414,24,1438,2228,0,3,1,3,0,1,0,76.14,64.54 ,33.33
03,009,01,012,0239,0,1223,20,1243,2023,0,3,1,3,0,1,0,76.14,61.44 ,33.33
03,009,01,012,0240,0,1272,23,1295,2007,0,3,1,3,0,1,0,76.14,64.52 ,33.33
03,009,01,012,0241,0,847,19,866,1358,0,3,1,3,0,1,0,76.14,63.77 ,33.33
03,009,01,012,0242,0,1296,17,1313,1988,0,3,1,3,0,1,0,76.14,66.05 ,33.33
03,009,01,012,0243,0,564,5,569,883,0,3,1,3,0,1,0,76.14,64.44 ,33.33
03,009,01,012,0244,0,1064,12,1076,1791,0,3,1,3,0,1,0,76.14,60.08 ,33.33
03,009,01,012,0245,0,1132,7,1139,2049,0,3,1,3,0,1,0,76.14,55.59 ,33.33
03,009,01,012,0246,0,803,17,820,1472,0,3,1,3,0,1,0,76.14,55.71 ,33.33
03,009,01,012,0247,0,710,17,727,1196,0,3,1,3,0,1,0,76.14,60.79 ,33.33
03,009,01,012,0248,0,802,7,809,1279,0,3,1,3,0,1,0,76.14,63.25 ,33.33
03,009,01,012,0249,0,521,7,528,869,0,3,1,3,0,1,0,76.14,60.76 ,33.33
03,009,01,013,0250,0,2002,20,2022,3148,0,3,1,3,0,1,0,76.14,64.23 ,33.33
03,009,01,013,0251,0,1601,23,1624,2576,0,3,1,3,0,1,0,76.14,63.04 ,33.33
03,009,01,013,0252,0,853,9,862,1372,0,3,1,3,0,1,0,76.14,62.83 ,33.33
03,009,01,013,0253,0,1115,20,1135,1846,0,3,1,3,0,1,0,76.14,61.48 ,33.33
03,009,01,013,0254,0,880,17,897,1446,0,3,1,3,0,1,0,76.14,62.03 ,33.33
03,009,01,013,0255,0,1181,18,1199,2098,0,3,1,3,0,1,0,76.14,57.15 ,33.33
03,009,01,013,0256,0,1324,19,1343,2154,0,3,1,3,0,1,0,76.14,62.35 ,33.33
03,009,01,013,0257,0,991,15,1006,1846,0,3,1,3,0,1,0,76.14,54.50 ,33.33
03,009,01,013,0258,0,1538,25,1563,2535,0,3,1,3,0,1,0,76.14,61.66 ,33.33
03,009,01,013,0259,0,446,9,455,793,0,3,1,3,0,1,0,76.14,57.38 ,33.33
03,009,01,013,0260,0,1163,18,1181,2167,0,3,1,3,0,1,0,76.14,54.50 ,33.33
03,009,01,013,0261,0,772,17,789,1502,0,3,1,3,0,1,0,76.14,52.53 ,33.33
03,009,01,014,0262,0,676,8,684,1291,0,3,1,3,0,1,0,76.14,52.98 ,33.33
03,009,01,014,0263,0,272,1,273,492,0,3,1,3,0,1,0,76.14,55.49 ,33.33
03,009,01,014,0264,0,1022,16,1038,1792,0,3,1,3,0,1,0,76.14,57.92 ,33.33
03,009,01,014,0265,0,910,15,925,1442,0,3,1,3,0,1,0,76.14,64.15 ,33.33
03,009,01,014,0266,0,715,7,722,1210,0,3,1,3,0,1,0,76.14,59.67 ,33.33
03,009,01,014,0267,0,591,9,600,976,0,3,1,3,0,1,0,76.14,61.48 ,33.33
03,009,01,014,0268,0,1314,36,1350,2190,0,3,1,3,0,1,0,76.14,61.64 ,33.33
03,009,01,014,0269,0,718,9,727,1318,0,3,1,3,0,1,0,76.14,55.16 ,33.33
03,009,01,014,0270,0,777,16,793,1284,0,3,1,3,0,1,0,76.14,61.76 ,33.33
03,009,01,014,0271,0,495,14,509,949,0,3,1,3,0,1,0,76.14,53.64 ,33.33
03,009,01,014,0272,0,508,14,522,1036,0,3,1,3,0,1,0,76.14,50.39 ,33.33
03,009,01,014,0273,0,357,3,360,582,0,3,1,3,0,1,0,76.14,61.86 ,33.33
03,009,01,015,0274,0,1238,19,1257,1842,0,3,1,3,0,1,0,76.14,68.24 ,33.33
03,009,01,015,0275,0,900,16,916,1378,0,3,1,3,0,1,0,76.14,66.47 ,33.33
03,009,01,015,0276,0,867,12,879,1385,0,3,1,3,0,1,0,76.14,63.47 ,33.33
03,009,01,015,0277,0,899,11,910,1376,0,3,1,3,0,1,0,76.14,66.13 ,33.33
03,009,01,015,0278,0,851,13,864,1320,0,3,1,3,0,1,0,76.14,65.45 ,33.33
03,009,01,015,0279,0,587,7,594,970,0,3,1,3,0,1,0,76.14,61.24 ,33.33
03,009,01,015,0280,0,542,8,550,830,0,3,1,3,0,1,0,76.14,66.27 ,33.33
03,009,01,015,0281,0,847,14,861,1259,0,3,1,3,0,1,0,76.14,68.39 ,33.33
03,009,01,015,0282,0,578,7,585,973,0,3,1,3,0,1,0,76.14,60.12 ,33.33
03,009,01,016,0283,0,818,8,826,1312,0,3,1,3,0,1,0,76.14,62.96 ,33.33
03,009,01,016,0284,0,623,7,630,1032,0,3,1,3,0,1,0,76.14,61.05 ,33.33
03,009,01,016,0285,0,589,9,598,1062,0,3,1,3,0,1,0,76.14,56.31 ,33.33
03,009,01,016,0286,0,1115,16,1131,1958,0,3,1,3,0,1,0,76.14,57.76 ,33.33
03,009,01,016,0287,0,482,8,490,931,0,3,1,3,0,1,0,76.14,52.63 ,33.33
03,009,01,016,0288,0,781,19,800,1552,0,3,1,3,0,1,0,76.14,51.55 ,33.33
03,009,01,016,0289,0,1045,17,1062,1979,0,3,1,3,0,1,0,76.14,53.66 ,33.33
03,009,01,016,0290,0,296,15,311,635,0,3,1,3,0,1,0,76.14,48.98 ,33.33
03,009,01,016,0291,0,259,3,262,539,0,3,1,3,0,1,0,76.14,48.61 ,33.33
03,009,01,016,0292,0,382,11,393,671,0,3,1,3,0,1,0,76.14,58.57 ,33.33
03,009,01,016,0293,0,1115,12,1127,1917,0,3,1,3,0,1,0,76.14,58.79 ,33.33
03,009,01,016,0294,0,909,20,929,1551,0,3,1,3,0,1,0,76.14,59.90 ,33.33
03,009,01,016,0295,0,873,9,882,1418,0,3,1,3,0,1,0,76.14,62.20 ,33.33
03,009,01,016,0296,0,1824,21,1845,3248,0,3,1,3,0,1,0,76.14,56.80 ,33.33
03,009,01,016,0297,0,1460,26,1486,2025,0,3,1,3,0,1,0,76.14,73.38 ,33.33
03,009,01,017,0298,0,1831,30,1861,3095,0,3,1,3,0,1,0,76.14,60.13 ,33.33
03,009,01,017,0299,0,895,14,909,1619,0,3,1,3,0,1,0,76.14,56.15 ,33.33
03,009,01,017,0300,0,831,10,841,1506,0,3,1,3,0,1,0,76.14,55.84 ,33.33
03,009,01,017,0301,0,484,4,488,780,0,3,1,3,0,1,0,76.14,62.56 ,33.33
03,009,01,017,0302,0,601,9,610,1049,0,3,1,3,0,1,0,76.14,58.15 ,33.33
03,009,01,017,0303,0,629,11,640,1211,0,3,1,3,0,1,0,76.14,52.85 ,33.33
03,009,01,017,0304,0,603,7,610,1034,0,3,1,3,0,1,0,76.14,58.99 ,33.33
03,009,01,017,0305,0,460,8,468,938,0,3,1,3,0,1,0,76.14,49.89 ,33.33
03,009,01,017,0306,0,405,1,406,706,0,3,1,3,0,1,0,76.14,57.51 ,33.33
03,009,01,017,0307,0,516,7,523,876,0,3,1,3,0,1,0,76.14,59.70 ,33.33
03,009,01,017,0308,0,262,2,264,470,0,3,1,3,0,1,0,76.14,56.17 ,33.33
03,009,01,017,0309,0,712,9,721,1256,0,3,1,3,0,1,0,76.14,57.40 ,33.33
03,009,01,017,0310,0,903,15,918,1586,0,3,1,3,0,1,0,76.14,57.88 ,33.33
03,009,01,017,0311,0,649,5,654,1113,0,3,1,3,0,1,0,76.14,58.76 ,33.33
03,009,01,017,0312,0,568,11,579,942,0,3,1,3,0,1,0,76.14,61.46 ,33.33
03,009,01,017,0313,0,805,7,812,1359,0,3,1,3,0,1,0,76.14,59.75 ,33.33
03,009,01,017,0314,0,616,6,622,1060,0,3,1,3,0,1,0,76.14,58.68 ,33.33
03,009,01,017,0315,0,988,11,999,1686,0,3,1,3,0,1,0,76.14,59.25 ,33.33
03,009,01,017,0316,0,416,4,420,687,0,3,1,3,0,1,0,76.14,61.14 ,33.33
03,009,01,017,0317,0,545,17,562,945,0,3,1,3,0,1,0,76.14,59.47 ,33.33
03,009,01,017,0318,0,472,5,477,733,0,3,1,3,0,1,0,76.14,65.08 ,33.33
03,009,01,018,0319,0,997,21,1018,1736,0,3,1,3,0,1,0,76.14,58.64 ,33.33
03,009,01,018,0320,0,1278,21,1299,2087,0,3,1,3,0,1,0,76.14,62.24 ,33.33
03,009,01,018,0321,0,398,6,404,709,0,3,1,3,0,1,0,76.14,56.98 ,33.33
03,009,01,018,0322,0,624,17,641,1112,0,3,1,3,0,1,0,76.14,57.64 ,33.33
03,009,01,018,0323,0,598,9,607,1136,0,3,1,3,0,1,0,76.14,53.43 ,33.33
03,009,01,018,0324,0,506,5,511,979,0,3,1,3,0,1,0,76.14,52.20 ,33.33
03,009,01,018,0325,0,492,10,502,922,0,3,1,3,0,1,0,76.14,54.45 ,33.33
03,009,01,018,0326,0,655,11,666,1227,0,3,1,3,0,1,0,76.14,54.28 ,33.33
03,009,01,018,0327,0,583,13,596,1143,0,3,1,3,0,1,0,76.14,52.14 ,33.33
03,009,01,018,0328,0,442,4,446,982,0,3,1,3,0,1,0,76.14,45.42 ,33.33
03,009,01,018,0329,0,367,5,372,682,0,3,1,3,0,1,0,76.14,54.55 ,33.33
03,009,01,018,0330,0,509,12,521,993,0,3,1,3,0,1,0,76.14,52.47 ,33.33
03,009,01,018,0331,0,236,2,238,411,0,3,1,3,0,1,0,76.14,57.91 ,33.33
03,009,01,018,0332,0,912,16,928,1770,0,3,1,3,0,1,0,76.14,52.43 ,33.33
03,009,01,018,0333,0,471,12,483,911,0,3,1,3,0,1,0,76.14,53.02 ,33.33
03,009,01,018,0334,0,389,9,398,814,0,3,1,3,0,1,0,76.14,48.89 ,33.33
03,009,01,018,0335,0,465,8,473,1004,0,3,1,3,0,1,0,76.14,47.11 ,33.33
03,009,01,018,0336,0,533,10,543,1138,0,3,1,3,0,1,0,76.14,47.72 ,33.33
03,009,01,018,0337,0,649,10,659,1299,0,3,1,3,0,1,0,76.14,50.73 ,33.33
03,009,01,018,0338,0,503,12,515,1088,0,3,1,3,0,1,0,76.14,47.33 ,33.33
03,009,01,018,0339,0,368,4,372,836,0,3,1,3,0,1,0,76.14,44.50 ,33.33
03,009,01,019,0340,0,654,3,657,1033,0,3,1,3,0,1,0,76.14,63.60 ,33.33
03,009,01,019,0341,0,831,16,847,1255,0,3,1,3,0,1,0,76.14,67.49 ,33.33
03,009,01,019,0342,0,372,8,380,708,0,3,1,3,0,1,0,76.14,53.67 ,33.33
03,009,01,019,0343,0,383,2,385,649,0,3,1,3,0,1,0,76.14,59.32 ,33.33
03,009,01,019,0344,0,453,5,458,927,0,3,1,3,0,1,0,76.14,49.41 ,33.33
03,009,01,019,0345,0,591,11,602,997,0,3,1,3,0,1,0,76.14,60.38 ,33.33
03,009,01,019,0346,0,888,13,901,1435,0,3,1,3,0,1,0,76.14,62.79 ,33.33
03,009,01,019,0347,0,1019,11,1030,1996,0,3,1,3,0,1,0,76.14,51.60 ,33.33
03,009,01,019,0348,0,885,18,903,1732,0,3,1,3,0,1,0,76.14,52.14 ,33.33
03,009,01,019,0349,0,843,13,856,1517,0,3,1,3,0,1,0,76.14,56.43 ,33.33
03,009,01,019,0350,0,291,8,299,543,0,3,1,3,0,1,0,76.14,55.06 ,33.33
03,009,01,019,0351,0,845,19,864,1439,0,3,1,3,0,1,0,76.14,60.04 ,33.33
03,009,01,019,0352,0,447,0,447,743,0,3,1,3,0,1,0,76.14,60.16 ,33.33
03,009,01,019,0353,0,996,18,1014,1621,0,3,1,3,0,1,0,76.14,62.55 ,33.33
03,009,01,019,0354,0,622,6,628,1019,0,3,1,3,0,1,0,76.14,61.63 ,33.33
03,009,01,019,0355,0,1159,19,1178,1866,0,3,1,3,0,1,0,76.14,63.13 ,33.33
03,009,01,019,0356,0,782,9,791,1323,0,3,1,3,0,1,0,76.14,59.79 ,33.33
03,009,01,019,0357,0,635,12,647,1049,0,3,1,3,0,1,0,76.14,61.68 ,33.33
03,009,01,019,0358,0,468,8,476,812,0,3,1,3,0,1,0,76.14,58.62 ,33.33
03,009,01,019,0359,0,602,12,614,1036,0,3,1,3,0,1,0,76.14,59.27 ,33.33
03,009,01,019,0360,0,440,9,449,758,0,3,1,3,0,1,0,76.14,59.23 ,33.33
03,009,01,020,0361,0,1507,25,1532,2283,0,3,1,3,0,1,0,76.14,67.10 ,33.33
03,009,01,020,0362,0,1232,15,1247,1891,0,3,1,3,0,1,0,76.14,65.94 ,33.33
03,009,01,020,0363,0,478,6,484,785,0,3,1,3,0,1,0,76.14,61.66 ,33.33
03,009,01,020,0364,0,441,16,457,765,0,3,1,3,0,1,0,76.14,59.74 ,33.33
03,009,01,020,0365,0,675,16,691,1083,0,3,1,3,0,1,0,76.14,63.80 ,33.33
03,009,01,020,0366,0,532,13,545,948,0,3,1,3,0,1,0,76.14,57.49 ,33.33
03,009,01,020,0367,0,708,14,722,1222,0,3,1,3,0,1,0,76.14,59.08 ,33.33
03,009,01,020,0368,0,483,9,492,808,0,3,1,3,0,1,0,76.14,60.89 ,33.33
03,009,01,020,0369,0,608,6,614,1067,0,3,1,3,0,1,0,76.14,57.54 ,33.33
03,009,01,020,0370,0,433,12,445,770,0,3,1,3,0,1,0,76.14,57.79 ,33.33
03,009,01,020,0371,0,416,4,420,693,0,3,1,3,0,1,0,76.14,60.61 ,33.33
03,009,01,020,0372,0,666,8,674,1235,0,3,1,3,0,1,0,76.14,54.57 ,33.33
03,009,01,020,0373,0,456,10,466,759,0,3,1,3,0,1,0,76.14,61.40 ,33.33
03,009,01,020,0374,0,651,9,660,1073,0,3,1,3,0,1,0,76.14,61.51 ,33.33
03,009,01,020,0375,0,658,9,667,1060,0,3,1,3,0,1,0,76.14,62.92 ,33.33
03,009,01,020,0376,0,555,14,569,904,0,3,1,3,0,1,0,76.14,62.94 ,33.33
03,009,01,020,0377,0,899,9,908,1267,0,3,1,3,0,1,0,76.14,71.67 ,33.33
03,009,01,020,0378,0,401,5,406,634,0,3,1,3,0,1,0,76.14,64.04 ,33.33
03,009,01,020,0379,0,524,9,533,834,0,3,1,3,0,1,0,76.14,63.91 ,33.33
03,009,01,020,0380,0,516,10,526,878,0,3,1,3,0,1,0,76.14,59.91 ,33.33
03,009,01,020,0381,0,440,7,447,811,0,3,1,3,0,1,0,76.14,55.12 ,33.33
03,009,01,020,0382,0,703,9,712,1099,0,3,1,3,0,1,0,76.14,64.79 ,33.33
03,009,01,020,0383,0,762,14,776,1269,0,3,1,3,0,1,0,76.14,61.15 ,33.33
03,009,01,020,0384,0,539,8,547,826,0,3,1,3,0,1,0,76.14,66.22 ,33.33
03,010,01,001,0001,0,1100,28,1128,1704,0,3,1,3,0,1,0,76.14,66.20 ,33.33
03,010,01,001,0002,0,298,7,305,486,0,3,1,3,0,1,0,76.14,62.76 ,33.33
03,010,01,001,0003,0,895,14,909,1367,0,3,1,3,0,1,0,76.14,66.50 ,33.33
03,010,01,001,0004,0,1009,23,1032,1503,0,3,1,3,0,1,0,76.14,68.66 ,33.33
03,010,01,001,0005,0,780,17,797,1082,0,3,1,3,0,1,0,76.14,73.66 ,33.33
03,010,01,001,0006,0,560,17,577,804,0,3,1,3,0,1,0,76.14,71.77 ,33.33
03,010,01,001,0007,0,568,7,575,800,0,3,1,3,0,1,0,76.14,71.88 ,33.33
03,010,01,001,0008,0,684,16,700,935,0,3,1,3,0,1,0,76.14,74.87 ,33.33
03,010,01,001,0009,0,583,11,594,890,0,3,1,3,0,1,0,76.14,66.74 ,33.33
03,010,01,001,0010,0,750,17,767,1183,0,3,1,3,0,1,0,76.14,64.84 ,33.33
03,010,01,001,0011,0,1068,19,1087,1690,0,3,1,3,0,1,0,76.14,64.32 ,33.33
03,010,01,001,0012,0,438,14,452,715,0,3,1,3,0,1,0,76.14,63.22 ,33.33
03,010,01,001,0013,0,362,7,369,576,0,3,1,3,0,1,0,76.14,64.06 ,33.33
03,010,01,001,0014,0,1238,33,1271,1969,0,3,1,3,0,1,0,76.14,64.55 ,33.33
03,010,01,001,0015,0,1604,41,1645,2630,0,3,1,3,0,1,0,76.14,62.55 ,33.33
03,010,01,001,0016,0,1086,30,1116,1686,0,3,1,3,0,1,0,76.14,66.19 ,33.33
03,010,01,001,0017,0,1270,27,1297,2185,0,3,1,3,0,1,0,76.14,59.36 ,33.33
03,010,01,001,0018,0,457,8,465,707,0,3,1,3,0,1,0,76.14,65.77 ,33.33
03,010,01,002,0019,0,1157,16,1173,1808,0,3,1,3,0,1,0,76.14,64.88 ,33.33
03,010,01,002,0020,0,1224,16,1240,1827,0,3,1,3,0,1,0,76.14,67.87 ,33.33
03,010,01,002,0021,0,731,9,740,1103,0,3,1,3,0,1,0,76.14,67.09 ,33.33
03,010,01,002,0022,0,326,3,329,503,0,3,1,3,0,1,0,76.14,65.41 ,33.33
03,010,01,002,0023,0,464,5,469,754,0,3,1,3,0,1,0,76.14,62.20 ,33.33
03,010,01,002,0024,0,535,4,539,758,0,3,1,3,0,1,0,76.14,71.11 ,33.33
03,010,01,002,0025,0,511,5,516,748,0,3,1,3,0,1,0,76.14,68.98 ,33.33
03,010,01,002,0026,0,1255,15,1270,1821,0,3,1,3,0,1,0,76.14,69.74 ,33.33
03,010,01,002,0027,0,1532,28,1560,2435,0,3,1,3,0,1,0,76.14,64.07 ,33.33
03,010,01,002,0028,0,2379,31,2410,3649,0,3,1,3,0,1,0,76.14,66.05 ,33.33
03,010,01,002,0029,0,448,8,456,652,0,3,1,3,0,1,0,76.14,69.94 ,33.33
03,010,01,002,0030,0,427,7,434,684,0,3,1,3,0,1,0,76.14,63.45 ,33.33
03,010,01,002,0031,0,545,14,559,810,0,3,1,3,0,1,0,76.14,69.01 ,33.33
03,010,01,002,0032,0,726,8,734,1016,0,3,1,3,0,1,0,76.14,72.24 ,33.33
03,010,01,002,0033,0,398,7,405,571,0,3,1,3,0,1,0,76.14,70.93 ,33.33
03,010,01,002,0034,0,1747,39,1786,2572,0,3,1,3,0,1,0,76.14,69.44 ,33.33
03,010,01,002,0035,0,1137,36,1173,1710,0,3,1,3,0,1,0,76.14,68.60 ,33.33
03,010,01,002,0036,0,393,6,399,596,0,3,1,3,0,1,0,76.14,66.95 ,33.33
03,010,01,002,0037,0,600,14,614,975,0,3,1,3,0,1,0,76.14,62.97 ,33.33
03,010,01,002,0038,0,649,20,669,989,0,3,1,3,0,1,0,76.14,67.64 ,33.33
03,010,01,002,0039,0,529,14,543,875,0,3,1,3,0,1,0,76.14,62.06 ,33.33
03,010,01,002,0040,0,207,3,210,296,0,3,1,3,0,1,0,76.14,70.95 ,33.33
03,010,01,002,0041,0,519,18,537,821,0,3,1,3,0,1,0,76.14,65.41 ,33.33
03,010,01,002,0042,0,375,7,382,597,0,3,1,3,0,1,0,76.14,63.99 ,33.33
03,010,01,002,0043,0,722,12,734,1153,0,3,1,3,0,1,0,76.14,63.66 ,33.33
03,010,01,002,0044,0,910,17,927,1428,0,3,1,3,0,1,0,76.14,64.92 ,33.33
03,010,01,002,0045,0,364,3,367,561,0,3,1,3,0,1,0,76.14,65.42 ,33.33
03,010,01,003,0046,0,412,13,425,748,0,3,1,3,0,1,0,76.14,56.82 ,33.33
03,010,01,003,0047,0,268,4,272,438,0,3,1,3,0,1,0,76.14,62.10 ,33.33
03,010,01,003,0048,0,1018,12,1030,1586,0,3,1,3,0,1,0,76.14,64.94 ,33.33
03,010,01,003,0049,0,801,17,818,1285,0,3,1,3,0,1,0,76.14,63.66 ,33.33
03,010,01,003,0050,0,1179,14,1193,1823,0,3,1,3,0,1,0,76.14,65.44 ,33.33
03,010,01,003,0051,0,565,9,574,925,0,3,1,3,0,1,0,76.14,62.05 ,33.33
03,010,01,003,0052,0,475,16,491,817,0,3,1,3,0,1,0,76.14,60.10 ,33.33
03,010,01,003,0053,0,532,12,544,849,0,3,1,3,0,1,0,76.14,64.08 ,33.33
03,010,01,003,0054,0,912,12,924,1432,0,3,1,3,0,1,0,76.14,64.53 ,33.33
03,010,01,003,0055,0,955,17,972,1599,0,3,1,3,0,1,0,76.14,60.79 ,33.33
03,010,01,003,0056,0,945,11,956,1548,0,3,1,3,0,1,0,76.14,61.76 ,33.33
03,010,01,003,0057,0,388,6,394,572,0,3,1,3,0,1,0,76.14,68.88 ,33.33
03,010,01,003,0058,0,480,13,493,752,0,3,1,3,0,1,0,76.14,65.56 ,33.33
03,010,01,003,0059,0,734,11,745,1192,0,3,1,3,0,1,0,76.14,62.50 ,33.33
03,010,01,003,0060,0,1180,22,1202,1932,0,3,1,3,0,1,0,76.14,62.22 ,33.33
03,010,01,003,0061,0,235,8,243,362,0,3,1,3,0,1,0,76.14,67.13 ,33.33
03,010,01,003,0062,0,285,4,289,465,0,3,1,3,0,1,0,76.14,62.15 ,33.33
03,010,01,003,0063,0,210,3,213,350,0,3,1,3,0,1,0,76.14,60.86 ,33.33
03,010,01,003,0064,0,539,9,548,794,0,3,1,3,0,1,0,76.14,69.02 ,33.33
03,010,01,003,0065,0,654,10,664,1029,0,3,1,3,0,1,0,76.14,64.53 ,33.33
03,010,01,003,0066,0,833,16,849,1236,0,3,1,3,0,1,0,76.14,68.69 ,33.33
03,010,01,003,0067,0,1584,31,1615,2429,0,3,1,3,0,1,0,76.14,66.49 ,33.33
03,010,01,003,0068,0,717,20,737,1102,0,3,1,3,0,1,0,76.14,66.88 ,33.33
03,010,01,004,0069,0,314,5,319,500,0,3,1,3,0,1,0,76.14,63.80 ,33.33
03,010,01,004,0070,0,1173,12,1185,1906,0,3,1,3,0,1,0,76.14,62.17 ,33.33
03,010,01,004,0071,0,609,10,619,988,0,3,1,3,0,1,0,76.14,62.65 ,33.33
03,010,01,004,0072,0,2983,41,3024,4822,0,3,1,3,0,1,0,76.14,62.71 ,33.33
03,010,01,004,0073,0,730,12,742,1146,0,3,1,3,0,1,0,76.14,64.75 ,33.33
03,010,01,004,0074,0,844,12,856,1340,0,3,1,3,0,1,0,76.14,63.88 ,33.33
03,010,01,004,0075,0,448,2,450,695,0,3,1,3,0,1,0,76.14,64.75 ,33.33
03,010,01,004,0076,0,496,9,505,838,0,3,1,3,0,1,0,76.14,60.26 ,33.33
03,010,01,004,0077,0,473,15,488,684,0,3,1,3,0,1,0,76.14,71.35 ,33.33
03,010,01,004,0078,0,191,8,199,319,0,3,1,3,0,1,0,76.14,62.38 ,33.33
03,010,01,004,0079,0,1107,25,1132,1748,0,3,1,3,0,1,0,76.14,64.76 ,33.33
03,010,01,004,0080,0,937,35,972,1461,0,3,1,3,0,1,0,76.14,66.53 ,33.33
03,010,01,004,0081,0,1010,18,1028,1528,0,3,1,3,0,1,0,76.14,67.28 ,33.33
03,010,01,004,0082,0,532,14,546,815,0,3,1,3,0,1,0,76.14,66.99 ,33.33
03,010,01,004,0083,0,1011,13,1024,1525,0,3,1,3,0,1,0,76.14,67.15 ,33.33
03,010,01,004,0084,0,1186,12,1198,1885,0,3,1,3,0,1,0,76.14,63.55 ,33.33
03,010,01,004,0085,0,658,9,667,987,0,3,1,3,0,1,0,76.14,67.58 ,33.33
03,010,01,004,0086,0,489,6,495,693,0,3,1,3,0,1,0,76.14,71.43 ,33.33
03,010,01,004,0087,0,540,5,545,773,0,3,1,3,0,1,0,76.14,70.50 ,33.33
03,010,01,004,0088,0,679,14,693,1093,0,3,1,3,0,1,0,76.14,63.40 ,33.33
03,010,01,004,0089,0,492,8,500,754,0,3,1,3,0,1,0,76.14,66.31 ,33.33
03,010,01,005,0090,0,1347,13,1360,1992,0,3,1,3,0,1,0,76.14,68.27 ,33.33
03,010,01,005,0091,0,1026,10,1036,1554,0,3,1,3,0,1,0,76.14,66.67 ,33.33
03,010,01,005,0092,0,1901,24,1925,2963,0,3,1,3,0,1,0,76.14,64.97 ,33.33
03,010,01,005,0093,0,1288,16,1304,1961,0,3,1,3,0,1,0,76.14,66.50 ,33.33
03,010,01,005,0094,0,852,12,864,1258,0,3,1,3,0,1,0,76.14,68.68 ,33.33
03,010,01,005,0095,0,1210,17,1227,1799,0,3,1,3,0,1,0,76.14,68.20 ,33.33
03,010,01,005,0096,0,834,13,847,1321,0,3,1,3,0,1,0,76.14,64.12 ,33.33
03,010,01,005,0097,0,1159,22,1181,1629,0,3,1,3,0,1,0,76.14,72.50 ,33.33
03,010,01,005,0098,0,479,0,479,731,0,3,1,3,0,1,0,76.14,65.53 ,33.33
03,010,01,005,0099,0,485,7,492,734,0,3,1,3,0,1,0,76.14,67.03 ,33.33
03,010,01,005,0100,0,500,11,511,776,0,3,1,3,0,1,0,76.14,65.85 ,33.33
03,010,01,005,0101,0,1208,21,1229,1856,0,3,1,3,0,1,0,76.14,66.22 ,33.33
03,010,01,005,0102,0,519,8,527,827,0,3,1,3,0,1,0,76.14,63.72 ,33.33
03,010,01,005,0103,0,348,4,352,584,0,3,1,3,0,1,0,76.14,60.27 ,33.33
03,010,01,005,0104,0,553,10,563,880,0,3,1,3,0,1,0,76.14,63.98 ,33.33
03,010,01,005,0105,0,2055,30,2085,3068,0,3,1,3,0,1,0,76.14,67.96 ,33.33
03,010,01,005,0106,0,1063,14,1077,1692,0,3,1,3,0,1,0,76.14,63.65 ,33.33
03,010,01,005,0107,0,2362,34,2396,3839,0,3,1,3,0,1,0,76.14,62.41 ,33.33
03,010,01,005,0108,0,1230,22,1252,1978,0,3,1,3,0,1,0,76.14,63.30 ,33.33
03,010,01,005,0109,0,1269,19,1288,2092,0,3,1,3,0,1,0,76.14,61.57 ,33.33
03,010,01,005,0110,0,913,13,926,1588,0,3,1,3,0,1,0,76.14,58.31 ,33.33
03,010,01,005,0111,0,1090,24,1114,1694,0,3,1,3,0,1,0,76.14,65.76 ,33.33
03,010,01,005,0112,0,1228,26,1254,2152,0,3,1,3,0,1,0,76.14,58.27 ,33.33
03,010,01,005,0113,0,1524,33,1557,2499,0,3,1,3,0,1,0,76.14,62.30 ,33.33
03,010,01,005,0114,0,1066,22,1088,1667,0,3,1,3,0,1,0,76.14,65.27 ,33.33
03,010,01,005,0115,0,1216,26,1242,1945,0,3,1,3,0,1,0,76.14,63.86 ,33.33
03,010,01,005,0116,0,2250,39,2289,3370,0,3,1,3,0,1,0,76.14,67.92 ,33.33
03,010,01,005,0117,0,779,9,788,1203,0,3,1,3,0,1,0,76.14,65.50 ,33.33
03,010,01,006,0118,0,882,11,893,1383,0,3,1,3,0,1,0,76.14,64.57 ,33.33
03,010,01,006,0119,0,479,5,484,738,0,3,1,3,0,1,0,76.14,65.58 ,33.33
03,010,01,006,0120,0,431,11,442,720,0,3,1,3,0,1,0,76.14,61.39 ,33.33
03,010,01,006,0121,0,542,6,548,848,0,3,1,3,0,1,0,76.14,64.62 ,33.33
03,010,01,006,0122,0,584,12,596,880,0,3,1,3,0,1,0,76.14,67.73 ,33.33
03,010,01,006,0123,0,784,10,794,1246,0,3,1,3,0,1,0,76.14,63.72 ,33.33
03,010,01,006,0124,0,624,5,629,984,0,3,1,3,0,1,0,76.14,63.92 ,33.33
03,010,01,006,0125,0,688,10,698,977,0,3,1,3,0,1,0,76.14,71.44 ,33.33
03,010,01,006,0126,0,646,8,654,1108,0,3,1,3,0,1,0,76.14,59.03 ,33.33
03,010,01,006,0127,0,460,8,468,785,0,3,1,3,0,1,0,76.14,59.62 ,33.33
03,010,01,006,0128,0,872,15,887,1279,0,3,1,3,0,1,0,76.14,69.35 ,33.33
03,010,01,006,0129,0,598,7,605,997,0,3,1,3,0,1,0,76.14,60.68 ,33.33
03,010,01,006,0130,0,442,7,449,736,0,3,1,3,0,1,0,76.14,61.01 ,33.33
03,010,01,006,0131,0,600,15,615,900,0,3,1,3,0,1,0,76.14,68.33 ,33.33
03,010,01,007,0132,0,1114,13,1127,1716,0,3,1,3,0,1,0,76.14,65.68 ,33.33
03,010,01,007,0133,0,1019,15,1034,1674,0,3,1,3,0,1,0,76.14,61.77 ,33.33
03,010,01,007,0134,0,834,15,849,1408,0,3,1,3,0,1,0,76.14,60.30 ,33.33
03,010,01,007,0135,0,882,15,897,1471,0,3,1,3,0,1,0,76.14,60.98 ,33.33
03,010,01,007,0136,0,689,7,696,1186,0,3,1,3,0,1,0,76.14,58.68 ,33.33
03,010,01,007,0137,0,933,13,946,1530,0,3,1,3,0,1,0,76.14,61.83 ,33.33
03,010,01,007,0138,0,1021,15,1036,1605,0,3,1,3,0,1,0,76.14,64.55 ,33.33
03,010,01,007,0139,0,591,8,599,968,0,3,1,3,0,1,0,76.14,61.88 ,33.33
03,010,01,007,0140,0,1042,15,1057,1682,0,3,1,3,0,1,0,76.14,62.84 ,33.33
03,010,01,007,0141,0,906,14,920,1457,0,3,1,3,0,1,0,76.14,63.14 ,33.33
03,010,01,007,0142,0,848,18,866,1419,0,3,1,3,0,1,0,76.14,61.03 ,33.33
03,010,01,007,0143,0,541,7,548,891,0,3,1,3,0,1,0,76.14,61.50 ,33.33
03,010,01,007,0144,0,620,9,629,1021,0,3,1,3,0,1,0,76.14,61.61 ,33.33
03,010,01,007,0145,0,543,15,558,911,0,3,1,3,0,1,0,76.14,61.25 ,33.33
03,010,01,007,0146,0,680,16,696,1109,0,3,1,3,0,1,0,76.14,62.76 ,33.33
03,010,01,007,0147,0,660,14,674,1135,0,3,1,3,0,1,0,76.14,59.38 ,33.33
03,010,01,007,0148,0,626,6,632,1089,0,3,1,3,0,1,0,76.14,58.03 ,33.33
03,010,01,007,0149,0,391,3,394,594,0,3,1,3,0,1,0,76.14,66.33 ,33.33
03,010,01,007,0150,0,479,5,484,834,0,3,1,3,0,1,0,76.14,58.03 ,33.33
03,010,01,007,0151,0,370,8,378,591,0,3,1,3,0,1,0,76.14,63.96 ,33.33
03,010,01,007,0152,0,604,10,614,936,0,3,1,3,0,1,0,76.14,65.60 ,33.33
03,010,01,007,0153,0,326,8,334,604,0,3,1,3,0,1,0,76.14,55.30 ,33.33
03,010,01,007,0154,0,324,7,331,501,0,3,1,3,0,1,0,76.14,66.07 ,33.33
03,010,01,008,0155,0,832,7,839,1292,0,3,1,3,0,1,0,76.14,64.94 ,33.33
03,010,01,008,0156,0,532,15,547,950,0,3,1,3,0,1,0,76.14,57.58 ,33.33
03,010,01,008,0157,0,553,12,565,877,0,3,1,3,0,1,0,76.14,64.42 ,33.33
03,010,01,008,0158,0,210,4,214,317,0,3,1,3,0,1,0,76.14,67.51 ,33.33
03,010,01,008,0159,0,777,15,792,1261,0,3,1,3,0,1,0,76.14,62.81 ,33.33
03,010,01,008,0160,0,777,18,795,1316,0,3,1,3,0,1,0,76.14,60.41 ,33.33
03,010,01,008,0161,0,521,10,531,894,0,3,1,3,0,1,0,76.14,59.40 ,33.33
03,010,01,008,0162,0,449,8,457,740,0,3,1,3,0,1,0,76.14,61.76 ,33.33
03,010,01,008,0163,0,429,12,441,797,0,3,1,3,0,1,0,76.14,55.33 ,33.33
03,010,01,008,0164,0,891,9,900,1442,0,3,1,3,0,1,0,76.14,62.41 ,33.33
03,010,01,008,0165,0,368,10,378,634,0,3,1,3,0,1,0,76.14,59.62 ,33.33
03,010,01,008,0166,0,475,8,483,770,0,3,1,3,0,1,0,76.14,62.73 ,33.33
03,010,01,008,0167,0,627,10,637,1065,0,3,1,3,0,1,0,76.14,59.81 ,33.33
03,010,01,008,0168,0,559,7,566,883,0,3,1,3,0,1,0,76.14,64.10 ,33.33
03,010,01,008,0169,0,628,13,641,1033,0,3,1,3,0,1,0,76.14,62.05 ,33.33
03,010,01,008,0170,0,858,20,878,1431,0,3,1,3,0,1,0,76.14,61.36 ,33.33
03,010,01,008,0171,0,409,5,414,730,0,3,1,3,0,1,0,76.14,56.71 ,33.33
03,010,01,008,0172,0,319,6,325,573,0,3,1,3,0,1,0,76.14,56.72 ,33.33
03,010,01,008,0173,0,411,7,418,807,0,3,1,3,0,1,0,76.14,51.80 ,33.33
03,010,01,008,0174,0,508,15,523,961,0,3,1,3,0,1,0,76.14,54.42 ,33.33
03,010,01,008,0175,0,508,9,517,905,0,3,1,3,0,1,0,76.14,57.13 ,33.33
03,010,01,008,0176,0,365,15,380,645,0,3,1,3,0,1,0,76.14,58.91 ,33.33
03,010,01,008,0177,0,483,8,491,812,0,3,1,3,0,1,0,76.14,60.47 ,33.33
03,010,01,008,0178,0,523,10,533,872,0,3,1,3,0,1,0,76.14,61.12 ,33.33
03,010,01,008,0179,0,345,13,358,625,0,3,1,3,0,1,0,76.14,57.28 ,33.33
03,010,01,009,0180,0,1138,28,1166,1726,0,3,1,3,0,1,0,76.14,67.56 ,33.33
03,010,01,009,0181,0,602,19,621,1001,0,3,1,3,0,1,0,76.14,62.04 ,33.33
03,010,01,009,0182,0,997,23,1020,1564,0,3,1,3,0,1,0,76.14,65.22 ,33.33
03,010,01,009,0183,0,985,19,1004,1475,0,3,1,3,0,1,0,76.14,68.07 ,33.33
03,010,01,009,0184,0,805,26,831,1247,0,3,1,3,0,1,0,76.14,66.64 ,33.33
03,010,01,009,0185,0,482,13,495,724,0,3,1,3,0,1,0,76.14,68.37 ,33.33
03,010,01,009,0186,0,279,3,282,461,0,3,1,3,0,1,0,76.14,61.17 ,33.33
03,010,01,009,0187,0,591,12,603,1002,0,3,1,3,0,1,0,76.14,60.18 ,33.33
03,010,01,009,0188,0,661,14,675,1133,0,3,1,3,0,1,0,76.14,59.58 ,33.33
03,010,01,009,0189,0,554,15,569,885,0,3,1,3,0,1,0,76.14,64.29 ,33.33
03,010,01,009,0190,0,243,6,249,441,0,3,1,3,0,1,0,76.14,56.46 ,33.33
03,010,01,009,0191,0,712,13,725,1113,0,3,1,3,0,1,0,76.14,65.14 ,33.33
03,010,01,009,0192,0,255,4,259,394,0,3,1,3,0,1,0,76.14,65.74 ,33.33
03,010,01,009,0193,0,972,28,1000,1412,0,3,1,3,0,1,0,76.14,70.82 ,33.33
03,010,01,009,0194,0,869,14,883,1301,0,3,1,3,0,1,0,76.14,67.87 ,33.33
03,010,01,009,0195,0,614,27,641,933,0,3,1,3,0,1,0,76.14,68.70 ,33.33
03,010,01,009,0196,0,474,7,481,780,0,3,1,3,0,1,0,76.14,61.67 ,33.33
03,010,01,009,0197,0,633,19,652,966,0,3,1,3,0,1,0,76.14,67.49 ,33.33
03,010,01,009,0198,0,489,12,501,799,0,3,1,3,0,1,0,76.14,62.70 ,33.33
03,010,01,009,0199,0,661,15,676,1096,0,3,1,3,0,1,0,76.14,61.68 ,33.33
03,010,01,009,0200,0,731,15,746,1017,0,3,1,3,0,1,0,76.14,73.35 ,33.33
03,010,01,009,0201,0,843,11,854,1304,0,3,1,3,0,1,0,76.14,65.49 ,33.33
03,010,01,009,0202,0,574,5,579,826,0,3,1,3,0,1,0,76.14,70.10 ,33.33
03,010,01,010,0203,0,644,19,663,898,0,3,1,3,0,1,0,76.14,73.83 ,33.33
03,010,01,010,0204,0,1158,27,1185,1608,0,3,1,3,0,1,0,76.14,73.69 ,33.33
03,010,01,010,0205,0,1042,21,1063,1451,0,3,1,3,0,1,0,76.14,73.26 ,33.33
03,010,01,010,0206,0,818,13,831,1033,0,3,1,3,0,1,0,76.14,80.45 ,33.33
03,010,01,010,0207,0,508,23,531,767,0,3,1,3,0,1,0,76.14,69.23 ,33.33
03,010,01,010,0208,0,1013,13,1026,1378,0,3,1,3,0,1,0,76.14,74.46 ,33.33
03,010,01,010,0209,0,288,7,295,437,0,3,1,3,0,1,0,76.14,67.51 ,33.33
03,010,01,010,0210,0,349,13,362,500,0,3,1,3,0,1,0,76.14,72.40 ,33.33
03,010,01,010,0211,0,625,13,638,842,0,3,1,3,0,1,0,76.14,75.77 ,33.33
03,010,01,010,0212,0,324,7,331,464,0,3,1,3,0,1,0,76.14,71.34 ,33.33
03,010,01,010,0213,0,366,8,374,527,0,3,1,3,0,1,0,76.14,70.97 ,33.33
03,010,01,010,0214,0,412,11,423,612,0,3,1,3,0,1,0,76.14,69.12 ,33.33
03,010,01,010,0215,0,1104,24,1128,1552,0,3,1,3,0,1,0,76.14,72.68 ,33.33
03,010,01,010,0216,0,592,11,603,871,0,3,1,3,0,1,0,76.14,69.23 ,33.33
03,010,01,010,0217,0,632,15,647,933,0,3,1,3,0,1,0,76.14,69.35 ,33.33
03,010,01,010,0218,0,596,10,606,878,0,3,1,3,0,1,0,76.14,69.02 ,33.33
03,010,01,010,0219,0,351,11,362,556,0,3,1,3,0,1,0,76.14,65.11 ,33.33
03,010,01,010,0220,0,441,8,449,583,0,3,1,3,0,1,0,76.14,77.02 ,33.33
03,010,01,010,0221,0,662,13,675,911,0,3,1,3,0,1,0,76.14,74.09 ,33.33
03,010,01,010,0222,0,337,5,342,517,0,3,1,3,0,1,0,76.14,66.15 ,33.33
03,010,01,010,0223,0,484,9,493,744,0,3,1,3,0,1,0,76.14,66.26 ,33.33
03,010,01,010,0224,0,511,15,526,772,0,3,1,3,0,1,0,76.14,68.13 ,33.33
03,010,01,011,0225,0,312,6,318,492,0,3,1,3,0,1,0,76.14,64.63 ,33.33
03,010,01,011,0226,0,452,7,459,646,0,3,1,3,0,1,0,76.14,71.05 ,33.33
03,010,01,011,0227,0,843,14,857,1315,0,3,1,3,0,1,0,76.14,65.17 ,33.33
03,010,01,011,0228,0,763,16,779,1150,0,3,1,3,0,1,0,76.14,67.74 ,33.33
03,010,01,011,0229,0,280,5,285,430,0,3,1,3,0,1,0,76.14,66.28 ,33.33
03,010,01,011,0230,0,683,9,692,1147,0,3,1,3,0,1,0,76.14,60.33 ,33.33
03,010,01,011,0231,0,304,7,311,528,0,3,1,3,0,1,0,76.14,58.90 ,33.33
03,010,01,011,0232,0,551,6,557,905,0,3,1,3,0,1,0,76.14,61.55 ,33.33
03,010,01,011,0233,0,685,10,695,1130,0,3,1,3,0,1,0,76.14,61.50 ,33.33
03,010,01,011,0234,0,644,21,665,1117,0,3,1,3,0,1,0,76.14,59.53 ,33.33
03,010,01,011,0235,0,563,12,575,931,0,3,1,3,0,1,0,76.14,61.76 ,33.33
03,010,01,011,0236,0,530,9,539,912,0,3,1,3,0,1,0,76.14,59.10 ,33.33
03,010,01,011,0237,0,913,16,929,1291,0,3,1,3,0,1,0,76.14,71.96 ,33.33
03,010,01,011,0238,0,1053,32,1085,1540,0,3,1,3,0,1,0,76.14,70.45 ,33.33
03,010,01,011,0239,0,398,6,404,578,0,3,1,3,0,1,0,76.14,69.90 ,33.33
03,010,01,012,0240,0,1979,32,2011,2956,0,3,1,3,0,1,0,76.14,68.03 ,33.33
03,010,01,012,0241,0,1407,16,1423,2071,0,3,1,3,0,1,0,76.14,68.71 ,33.33
03,010,01,012,0242,0,952,31,983,1474,0,3,1,3,0,1,0,76.14,66.69 ,33.33
03,010,01,012,0243,0,978,19,997,1581,0,3,1,3,0,1,0,76.14,63.06 ,33.33
03,010,01,012,0244,0,1138,26,1164,1763,0,3,1,3,0,1,0,76.14,66.02 ,33.33
03,010,01,012,0245,0,471,12,483,664,0,3,1,3,0,1,0,76.14,72.74 ,33.33
03,010,01,012,0246,0,1032,13,1045,1411,0,3,1,3,0,1,0,76.14,74.06 ,33.33
03,010,01,012,0247,0,1265,18,1283,1874,0,3,1,3,0,1,0,76.14,68.46 ,33.33
03,010,01,012,0248,0,576,15,591,823,0,3,1,3,0,1,0,76.14,71.81 ,33.33
03,010,01,012,0249,0,1215,27,1242,1780,0,3,1,3,0,1,0,76.14,69.78 ,33.33
03,010,01,012,0250,0,731,12,743,1094,0,3,1,3,0,1,0,76.14,67.92 ,33.33
03,010,01,012,0251,0,440,9,449,616,0,3,1,3,0,1,0,76.14,72.89 ,33.33
03,010,01,012,0252,0,396,5,401,531,0,3,1,3,0,1,0,76.14,75.52 ,33.33
03,010,01,012,0253,0,845,16,861,1238,0,3,1,3,0,1,0,76.14,69.55 ,33.33
03,010,01,012,0254,0,1394,30,1424,2163,0,3,1,3,0,1,0,76.14,65.83 ,33.33
03,010,01,012,0255,0,1095,21,1116,1770,0,3,1,3,0,1,0,76.14,63.05 ,33.33
03,010,01,012,0256,0,1186,24,1210,1802,0,3,1,3,0,1,0,76.14,67.15 ,33.33
03,010,01,012,0257,0,605,9,614,990,0,3,1,3,0,1,0,76.14,62.02 ,33.33
03,010,01,012,0258,0,1975,41,2016,3465,0,3,1,3,0,1,0,76.14,58.18 ,33.33
03,010,01,012,0259,0,1687,30,1717,2832,0,3,1,3,0,1,0,76.14,60.63 ,33.33
03,010,01,012,0260,0,524,8,532,755,0,3,1,3,0,1,0,76.14,70.46 ,33.33
03,010,01,012,0261,0,1165,25,1190,1822,0,3,1,3,0,1,0,76.14,65.31 ,33.33
03,010,01,012,0262,0,1165,26,1191,1831,0,3,1,3,0,1,0,76.14,65.05 ,33.33
03,010,01,012,0263,0,545,15,560,801,0,3,1,3,0,1,0,76.14,69.91 ,33.33
03,010,01,012,0264,0,727,17,744,1055,0,3,1,3,0,1,0,76.14,70.52 ,33.33
03,010,01,012,0265,0,769,17,786,1301,0,3,1,3,0,1,0,76.14,60.42 ,33.33
03,010,01,013,0266,0,997,21,1018,1606,0,3,1,3,0,1,0,76.14,63.39 ,33.33
03,010,01,013,0267,0,561,11,572,816,0,3,1,3,0,1,0,76.14,70.10 ,33.33
03,010,01,013,0268,0,466,13,479,734,0,3,1,3,0,1,0,76.14,65.26 ,33.33
03,010,01,013,0269,0,524,7,531,850,0,3,1,3,0,1,0,76.14,62.47 ,33.33
03,010,01,013,0270,0,792,9,801,1347,0,3,1,3,0,1,0,76.14,59.47 ,33.33
03,010,01,013,0271,0,1493,25,1518,2544,0,3,1,3,0,1,0,76.14,59.67 ,33.33
03,010,01,013,0272,0,1538,29,1567,2536,0,3,1,3,0,1,0,76.14,61.79 ,33.33
03,010,01,013,0273,0,3236,40,3276,5298,0,3,1,3,0,1,0,76.14,61.83 ,33.33
03,010,01,013,0274,0,2677,62,2739,4762,0,3,1,3,0,1,0,76.14,57.52 ,33.33
03,010,01,013,0275,0,1046,13,1059,1698,0,3,1,3,0,1,0,76.14,62.37 ,33.33
03,010,01,013,0276,0,847,7,854,1295,0,3,1,3,0,1,0,76.14,65.95 ,33.33
03,010,01,013,0277,0,1250,18,1268,2060,0,3,1,3,0,1,0,76.14,61.55 ,33.33
03,010,01,013,0278,0,662,12,674,1068,0,3,1,3,0,1,0,76.14,63.11 ,33.33
03,010,01,013,0279,0,779,7,786,1185,0,3,1,3,0,1,0,76.14,66.33 ,33.33
03,010,01,013,0280,0,663,9,672,938,0,3,1,3,0,1,0,76.14,71.64 ,33.33
03,010,01,013,0281,0,1226,14,1240,1941,0,3,1,3,0,1,0,76.14,63.88 ,33.33
03,010,01,013,0282,0,532,10,542,736,0,3,1,3,0,1,0,76.14,73.64 ,33.33
03,010,01,013,0283,0,419,6,425,627,0,3,1,3,0,1,0,76.14,67.78 ,33.33
03,010,01,013,0284,0,498,4,502,707,0,3,1,3,0,1,0,76.14,71.00 ,33.33
03,010,01,013,0285,0,754,8,762,1117,0,3,1,3,0,1,0,76.14,68.22 ,33.33
03,010,01,013,0286,0,207,3,210,331,0,3,1,3,0,1,0,76.14,63.44 ,33.33
03,010,01,013,0287,0,234,0,234,323,0,3,1,3,0,1,0,76.14,72.45 ,33.33
03,010,01,014,0288,0,1419,27,1446,2200,0,3,1,3,0,1,0,76.14,65.73 ,33.33
03,010,01,014,0289,0,1153,23,1176,1866,0,3,1,3,0,1,0,76.14,63.02 ,33.33
03,010,01,014,0290,0,522,6,528,764,0,3,1,3,0,1,0,76.14,69.11 ,33.33
03,010,01,014,0291,0,587,6,593,868,0,3,1,3,0,1,0,76.14,68.32 ,33.33
03,010,01,014,0292,0,840,12,852,1293,0,3,1,3,0,1,0,76.14,65.89 ,33.33
03,010,01,014,0293,0,416,5,421,545,0,3,1,3,0,1,0,76.14,77.25 ,33.33
03,010,01,014,0294,0,652,4,656,1049,0,3,1,3,0,1,0,76.14,62.54 ,33.33
03,010,01,014,0295,0,2829,42,2871,4641,0,3,1,3,0,1,0,76.14,61.86 ,33.33
03,010,01,014,0296,0,802,14,816,1265,0,3,1,3,0,1,0,76.14,64.51 ,33.33
03,010,01,014,0297,0,830,7,837,1296,0,3,1,3,0,1,0,76.14,64.58 ,33.33
03,010,01,014,0298,0,1008,12,1020,1591,0,3,1,3,0,1,0,76.14,64.11 ,33.33
03,010,01,014,0299,0,1140,14,1154,1724,0,3,1,3,0,1,0,76.14,66.94 ,33.33
03,010,01,014,0300,0,720,10,730,1068,0,3,1,3,0,1,0,76.14,68.35 ,33.33
03,010,01,014,0301,0,470,10,480,773,0,3,1,3,0,1,0,76.14,62.10 ,33.33
03,010,01,014,0302,0,598,6,604,904,0,3,1,3,0,1,0,76.14,66.81 ,33.33
03,010,01,014,0303,0,403,4,407,586,0,3,1,3,0,1,0,76.14,69.45 ,33.33
03,010,01,014,0304,0,1073,9,1082,1645,0,3,1,3,0,1,0,76.14,65.78 ,33.33
03,010,01,014,0305,0,476,5,481,751,0,3,1,3,0,1,0,76.14,64.05 ,33.33
03,010,01,014,0306,0,321,0,321,480,0,3,1,3,0,1,0,76.14,66.88 ,33.33
03,010,01,014,0307,0,1199,14,1213,1830,0,3,1,3,0,1,0,76.14,66.28 ,33.33
03,010,01,014,0308,0,642,8,650,1016,0,3,1,3,0,1,0,76.14,63.98 ,33.33
03,010,01,014,0309,0,163,2,165,298,0,3,1,3,0,1,0,76.14,55.37 ,33.33
03,010,01,014,0310,0,500,10,510,780,0,3,1,3,0,1,0,76.14,65.38 ,33.33
03,010,01,014,0311,0,461,5,466,744,0,3,1,3,0,1,0,76.14,62.63 ,33.33
03,010,01,015,0312,0,1466,21,1487,2371,0,3,1,3,0,1,0,76.14,62.72 ,33.33
03,010,01,015,0313,0,667,9,676,997,0,3,1,3,0,1,0,76.14,67.80 ,33.33
03,010,01,015,0314,0,2349,28,2377,3732,0,3,1,3,0,1,0,76.14,63.69 ,33.33
03,010,01,015,0315,0,402,5,407,620,0,3,1,3,0,1,0,76.14,65.65 ,33.33
03,010,01,015,0316,0,325,4,329,501,0,3,1,3,0,1,0,76.14,65.67 ,33.33
03,010,01,015,0317,0,435,6,441,669,0,3,1,3,0,1,0,76.14,65.92 ,33.33
03,010,01,015,0318,0,433,1,434,573,0,3,1,3,0,1,0,76.14,75.74 ,33.33
03,010,01,015,0319,0,1080,24,1104,1707,0,3,1,3,0,1,0,76.14,64.67 ,33.33
03,010,01,015,0320,0,541,5,546,934,0,3,1,3,0,1,0,76.14,58.46 ,33.33
03,010,01,015,0321,0,292,7,299,503,0,3,1,3,0,1,0,76.14,59.44 ,33.33
03,010,01,015,0322,0,281,3,284,456,0,3,1,3,0,1,0,76.14,62.28 ,33.33
03,010,01,015,0323,0,315,4,319,497,0,3,1,3,0,1,0,76.14,64.19 ,33.33
03,010,01,015,0324,0,278,6,284,395,0,3,1,3,0,1,0,76.14,71.90 ,33.33
03,010,01,015,0325,0,264,6,270,478,0,3,1,3,0,1,0,76.14,56.49 ,33.33
03,010,01,015,0326,0,187,0,187,291,0,3,1,3,0,1,0,76.14,64.26 ,33.33
03,010,01,015,0327,0,454,7,461,743,0,3,1,3,0,1,0,76.14,62.05 ,33.33
03,010,01,015,0328,0,493,8,501,736,0,3,1,3,0,1,0,76.14,68.07 ,33.33
03,010,01,015,0329,0,673,12,685,1021,0,3,1,3,0,1,0,76.14,67.09 ,33.33
03,010,01,016,0330,0,669,13,682,994,0,3,1,3,0,1,0,76.14,68.61 ,33.33
03,010,01,016,0331,0,236,4,240,389,0,3,1,3,0,1,0,76.14,61.70 ,33.33
03,010,01,016,0332,0,532,6,538,799,0,3,1,3,0,1,0,76.14,67.33 ,33.33
03,010,01,016,0333,0,1011,24,1035,1604,0,3,1,3,0,1,0,76.14,64.53 ,33.33
03,010,01,016,0334,0,551,13,564,815,0,3,1,3,0,1,0,76.14,69.20 ,33.33
03,010,01,016,0335,0,466,13,479,773,0,3,1,3,0,1,0,76.14,61.97 ,33.33
03,010,01,016,0336,0,595,10,605,834,0,3,1,3,0,1,0,76.14,72.54 ,33.33
03,010,01,016,0337,0,462,4,466,821,0,3,1,3,0,1,0,76.14,56.76 ,33.33
03,010,01,016,0338,0,567,15,582,949,0,3,1,3,0,1,0,76.14,61.33 ,33.33
03,010,01,016,0339,0,304,6,310,581,0,3,1,3,0,1,0,76.14,53.36 ,33.33
03,010,01,016,0340,0,240,2,242,394,0,3,1,3,0,1,0,76.14,61.42 ,33.33
03,010,01,017,0341,0,568,9,577,1043,0,3,1,3,0,1,0,76.14,55.32 ,33.33
03,010,01,017,0342,0,263,5,268,470,0,3,1,3,0,1,0,76.14,57.02 ,33.33
03,010,01,017,0343,0,237,4,241,342,0,3,1,3,0,1,0,76.14,70.47 ,33.33
03,010,01,017,0344,0,404,6,410,760,0,3,1,3,0,1,0,76.14,53.95 ,33.33
03,010,01,017,0345,0,204,0,204,368,0,3,1,3,0,1,0,76.14,55.43 ,33.33
03,010,01,018,0346,0,187,4,191,333,0,3,1,3,0,1,0,76.14,57.36 ,33.33
03,010,01,018,0347,0,95,1,96,163,0,3,1,3,0,1,0,76.14,58.90 ,33.33
03,010,01,018,0348,0,102,1,103,216,0,3,1,3,0,1,0,76.14,47.69 ,33.33
03,010,01,018,0349,0,149,5,154,299,0,3,1,3,0,1,0,76.14,51.51 ,33.33
03,010,01,018,0350,0,165,3,168,254,0,3,1,3,0,1,0,76.14,66.14 ,33.33
03,010,01,018,0351,0,17,1,18,25,0,3,1,3,0,1,0,76.14,72.00 ,33.33
03,010,01,018,0352,0,170,5,175,254,0,3,1,3,0,1,0,76.14,68.90 ,33.33
03,010,01,018,0353,0,59,0,59,116,0,3,1,3,0,1,0,76.14,50.86 ,33.33
03,010,01,018,0354,0,6,0,6,18,0,3,1,3,0,1,0,76.14,33.33 ,33.33
03,010,01,018,0355,0,9,2,11,26,0,3,1,3,0,1,0,76.14,42.31 ,33.33
03,010,01,018,0356,0,10,0,10,22,0,3,1,3,0,1,0,76.14,45.45 ,33.33
03,010,01,018,0357,0,56,1,57,94,0,3,1,3,0,1,0,76.14,60.64 ,33.33
03,011,01,001,0001,0,2731,23,2754,4233,0,3,1,3,0,1,0,76.14,65.06 ,33.33
03,011,01,001,0002,0,1577,14,1591,2448,0,3,1,3,0,1,0,76.14,64.99 ,33.33
03,011,01,001,0003,0,1682,13,1695,2684,0,3,1,3,0,1,0,76.14,63.15 ,33.33
03,011,01,001,0004,0,518,6,524,900,0,3,1,3,0,1,0,76.14,58.22 ,33.33
03,011,01,001,0005,0,783,10,793,1260,0,3,1,3,0,1,0,76.14,62.94 ,33.33
03,011,01,001,0006,0,651,7,658,966,0,3,1,3,0,1,0,76.14,68.12 ,33.33
03,011,01,001,0007,0,1963,23,1986,3232,0,3,1,3,0,1,0,76.14,61.45 ,33.33
03,011,01,001,0008,0,3803,50,3853,5989,0,3,1,3,0,1,0,76.14,64.33 ,33.33
03,011,01,001,0009,0,628,8,636,1010,0,3,1,3,0,1,0,76.14,62.97 ,33.33
03,011,01,001,0010,0,886,16,902,1422,0,3,1,3,0,1,0,76.14,63.43 ,33.33
03,011,01,001,0011,0,309,4,313,470,0,3,1,3,0,1,0,76.14,66.60 ,33.33
03,011,01,001,0012,0,1534,23,1557,2406,0,3,1,3,0,1,0,76.14,64.71 ,33.33
03,011,01,001,0013,0,979,5,984,1535,0,3,1,3,0,1,0,76.14,64.10 ,33.33
03,011,01,001,0014,0,1801,20,1821,2975,0,3,1,3,0,1,0,76.14,61.21 ,33.33
03,011,01,001,0015,0,1963,16,1979,3187,0,3,1,3,0,1,0,76.14,62.10 ,33.33
03,011,01,001,0016,0,1547,19,1566,2466,0,3,1,3,0,1,0,76.14,63.50 ,33.33
03,011,01,001,0017,0,2293,38,2331,3797,0,3,1,3,0,1,0,76.14,61.39 ,33.33
03,011,01,001,0018,0,993,12,1005,1583,0,3,1,3,0,1,0,76.14,63.49 ,33.33
03,011,01,001,0019,0,796,11,807,1239,0,3,1,3,0,1,0,76.14,65.13 ,33.33
03,011,01,001,0020,0,889,14,903,1464,0,3,1,3,0,1,0,76.14,61.68 ,33.33
03,011,01,001,0021,0,1007,16,1023,1508,0,3,1,3,0,1,0,76.14,67.84 ,33.33
03,011,01,001,0022,0,1759,24,1783,2791,0,3,1,3,0,1,0,76.14,63.88 ,33.33
03,011,01,001,0023,0,935,17,952,1466,0,3,1,3,0,1,0,76.14,64.94 ,33.33
03,011,01,001,0024,0,232,1,233,359,0,3,1,3,0,1,0,76.14,64.90 ,33.33
03,011,01,001,0025,0,322,5,327,457,0,3,1,3,0,1,0,76.14,71.55 ,33.33
03,011,01,001,0026,0,490,4,494,743,0,3,1,3,0,1,0,76.14,66.49 ,33.33
03,011,01,001,0027,0,630,9,639,996,0,3,1,3,0,1,0,76.14,64.16 ,33.33
03,011,01,001,0028,0,388,5,393,584,0,3,1,3,0,1,0,76.14,67.29 ,33.33
03,011,01,002,0029,0,843,15,858,1341,0,3,1,3,0,1,0,76.14,63.98 ,33.33
03,011,01,002,0030,0,367,0,367,549,0,3,1,3,0,1,0,76.14,66.85 ,33.33
03,011,01,002,0031,0,259,2,261,386,0,3,1,3,0,1,0,76.14,67.62 ,33.33
03,011,01,002,0032,0,378,4,382,556,0,3,1,3,0,1,0,76.14,68.71 ,33.33
03,011,01,002,0033,0,376,3,379,541,0,3,1,3,0,1,0,76.14,70.06 ,33.33
03,011,01,002,0034,0,239,4,243,392,0,3,1,3,0,1,0,76.14,61.99 ,33.33
03,011,01,002,0035,0,519,7,526,785,0,3,1,3,0,1,0,76.14,67.01 ,33.33
03,011,01,002,0036,0,1856,27,1883,3118,0,3,1,3,0,1,0,76.14,60.39 ,33.33
03,011,01,002,0037,0,477,3,480,753,0,3,1,3,0,1,0,76.14,63.75 ,33.33
03,011,01,002,0038,0,611,10,621,1000,0,3,1,3,0,1,0,76.14,62.10 ,33.33
03,011,01,002,0039,0,2083,25,2108,3207,0,3,1,3,0,1,0,76.14,65.73 ,33.33
03,011,01,002,0040,0,414,1,415,696,0,3,1,3,0,1,0,76.14,59.63 ,33.33
03,011,01,002,0041,0,483,11,494,787,0,3,1,3,0,1,0,76.14,62.77 ,33.33
03,011,01,002,0042,0,1040,8,1048,1620,0,3,1,3,0,1,0,76.14,64.69 ,33.33
03,011,01,002,0043,0,339,6,345,512,0,3,1,3,0,1,0,76.14,67.38 ,33.33
03,011,01,002,0044,0,216,5,221,284,0,3,1,3,0,1,0,76.14,77.82 ,33.33
03,011,01,002,0045,0,420,8,428,702,0,3,1,3,0,1,0,76.14,60.97 ,33.33
03,011,01,002,0046,0,298,5,303,497,0,3,1,3,0,1,0,76.14,60.97 ,33.33
03,011,01,002,0047,0,562,8,570,805,0,3,1,3,0,1,0,76.14,70.81 ,33.33
03,011,01,002,0048,0,288,4,292,437,0,3,1,3,0,1,0,76.14,66.82 ,33.33
03,011,01,002,0049,0,192,3,195,274,0,3,1,3,0,1,0,76.14,71.17 ,33.33
03,011,01,002,0050,0,277,4,281,375,0,3,1,3,0,1,0,76.14,74.93 ,33.33
03,011,01,002,0051,0,251,3,254,412,0,3,1,3,0,1,0,76.14,61.65 ,33.33
03,011,01,002,0052,0,367,8,375,573,0,3,1,3,0,1,0,76.14,65.45 ,33.33
03,011,01,002,0053,0,661,5,666,941,0,3,1,3,0,1,0,76.14,70.78 ,33.33
03,011,01,003,0054,0,1212,15,1227,1876,0,3,1,3,0,1,0,76.14,65.41 ,33.33
03,011,01,003,0055,0,1733,13,1746,2752,0,3,1,3,0,1,0,76.14,63.44 ,33.33
03,011,01,003,0056,0,910,13,923,1455,0,3,1,3,0,1,0,76.14,63.44 ,33.33
03,011,01,003,0057,0,964,11,975,1514,0,3,1,3,0,1,0,76.14,64.40 ,33.33
03,011,01,003,0058,0,530,11,541,864,0,3,1,3,0,1,0,76.14,62.62 ,33.33
03,011,01,003,0059,0,824,16,840,1369,0,3,1,3,0,1,0,76.14,61.36 ,33.33
03,011,01,003,0060,0,298,4,302,477,0,3,1,3,0,1,0,76.14,63.31 ,33.33
03,011,01,003,0061,0,369,7,376,621,0,3,1,3,0,1,0,76.14,60.55 ,33.33
03,011,01,003,0062,0,321,2,323,479,0,3,1,3,0,1,0,76.14,67.43 ,33.33
03,011,01,003,0063,0,362,9,371,658,0,3,1,3,0,1,0,76.14,56.38 ,33.33
03,011,01,003,0064,0,721,7,728,1238,0,3,1,3,0,1,0,76.14,58.80 ,33.33
03,011,01,003,0065,0,1125,44,1169,2000,0,3,1,3,0,1,0,76.14,58.45 ,33.33
03,011,01,003,0066,0,827,11,838,1242,0,3,1,3,0,1,0,76.14,67.47 ,33.33
03,011,01,003,0067,0,876,14,890,1356,0,3,1,3,0,1,0,76.14,65.63 ,33.33
03,011,01,003,0068,0,602,10,612,883,0,3,1,3,0,1,0,76.14,69.31 ,33.33
03,011,01,003,0069,0,443,8,451,684,0,3,1,3,0,1,0,76.14,65.94 ,33.33
03,011,01,003,0070,0,612,10,622,904,0,3,1,3,0,1,0,76.14,68.81 ,33.33
03,011,01,003,0071,0,608,8,616,931,0,3,1,3,0,1,0,76.14,66.17 ,33.33
03,011,01,003,0072,0,512,8,520,781,0,3,1,3,0,1,0,76.14,66.58 ,33.33
03,011,01,003,0073,0,825,13,838,1275,0,3,1,3,0,1,0,76.14,65.73 ,33.33
03,011,01,003,0074,0,507,9,516,751,0,3,1,3,0,1,0,76.14,68.71 ,33.33
03,011,01,003,0075,0,496,9,505,785,0,3,1,3,0,1,0,76.14,64.33 ,33.33
03,011,01,003,0076,0,609,7,616,936,0,3,1,3,0,1,0,76.14,65.81 ,33.33
03,011,01,003,0077,0,416,5,421,675,0,3,1,3,0,1,0,76.14,62.37 ,33.33
03,011,01,004,0078,0,970,14,984,1481,0,3,1,3,0,1,0,76.14,66.44 ,33.33
03,011,01,004,0079,0,1195,11,1206,1741,0,3,1,3,0,1,0,76.14,69.27 ,33.33
03,011,01,004,0080,0,482,7,489,702,0,3,1,3,0,1,0,76.14,69.66 ,33.33
03,011,01,004,0081,0,1609,35,1644,2428,0,3,1,3,0,1,0,76.14,67.71 ,33.33
03,011,01,004,0082,0,867,4,871,1253,0,3,1,3,0,1,0,76.14,69.51 ,33.33
03,011,01,004,0083,0,539,8,547,780,0,3,1,3,0,1,0,76.14,70.13 ,33.33
03,011,01,004,0084,0,1060,15,1075,1481,0,3,1,3,0,1,0,76.14,72.59 ,33.33
03,011,01,004,0085,0,1285,16,1301,1783,0,3,1,3,0,1,0,76.14,72.97 ,33.33
03,011,01,004,0086,0,924,13,937,1398,0,3,1,3,0,1,0,76.14,67.02 ,33.33
03,011,01,004,0087,0,465,4,469,666,0,3,1,3,0,1,0,76.14,70.42 ,33.33
03,011,01,004,0088,0,894,13,907,1394,0,3,1,3,0,1,0,76.14,65.06 ,33.33
03,011,01,004,0089,0,834,12,846,1242,0,3,1,3,0,1,0,76.14,68.12 ,33.33
03,011,01,004,0090,0,1091,12,1103,1663,0,3,1,3,0,1,0,76.14,66.33 ,33.33
03,011,01,005,0091,0,1013,15,1028,1508,0,3,1,3,0,1,0,76.14,68.17 ,33.33
03,011,01,005,0092,0,865,6,871,1282,0,3,1,3,0,1,0,76.14,67.94 ,33.33
03,011,01,005,0093,0,821,9,830,1279,0,3,1,3,0,1,0,76.14,64.89 ,33.33
03,011,01,005,0094,0,855,18,873,1309,0,3,1,3,0,1,0,76.14,66.69 ,33.33
03,011,01,005,0095,0,787,12,799,1173,0,3,1,3,0,1,0,76.14,68.12 ,33.33
03,011,01,005,0096,0,813,7,820,1240,0,3,1,3,0,1,0,76.14,66.13 ,33.33
03,011,01,005,0097,0,481,8,489,806,0,3,1,3,0,1,0,76.14,60.67 ,33.33
03,011,01,005,0098,0,350,8,358,499,0,3,1,3,0,1,0,76.14,71.74 ,33.33
03,011,01,005,0099,0,306,18,324,565,0,3,1,3,0,1,0,76.14,57.35 ,33.33
03,011,01,005,0100,0,519,9,528,809,0,3,1,3,0,1,0,76.14,65.27 ,33.33
03,011,01,005,0101,0,305,1,306,450,0,3,1,3,0,1,0,76.14,68.00 ,33.33
03,011,01,005,0102,0,743,11,754,1139,0,3,1,3,0,1,0,76.14,66.20 ,33.33
03,011,01,005,0103,0,351,4,355,538,0,3,1,3,0,1,0,76.14,65.99 ,33.33
03,011,01,005,0104,0,673,7,680,1046,0,3,1,3,0,1,0,76.14,65.01 ,33.33
03,011,01,005,0105,0,367,4,371,568,0,3,1,3,0,1,0,76.14,65.32 ,33.33
03,011,01,005,0106,0,1022,15,1037,1426,0,3,1,3,0,1,0,76.14,72.72 ,33.33
03,011,01,005,0107,0,975,10,985,1486,0,3,1,3,0,1,0,76.14,66.29 ,33.33
03,011,01,005,0108,0,748,16,764,1195,0,3,1,3,0,1,0,76.14,63.93 ,33.33
03,011,01,005,0109,0,927,8,935,1370,0,3,1,3,0,1,0,76.14,68.25 ,33.33
03,011,01,005,0110,0,758,9,767,1147,0,3,1,3,0,1,0,76.14,66.87 ,33.33
03,011,01,005,0111,0,527,13,540,845,0,3,1,3,0,1,0,76.14,63.91 ,33.33
03,011,01,006,0112,0,864,11,875,1459,0,3,1,3,0,1,0,76.14,59.97 ,33.33
03,011,01,006,0113,0,1483,12,1495,2327,0,3,1,3,0,1,0,76.14,64.25 ,33.33
03,011,01,006,0114,0,952,14,966,1571,0,3,1,3,0,1,0,76.14,61.49 ,33.33
03,011,01,006,0115,0,595,9,604,945,0,3,1,3,0,1,0,76.14,63.92 ,33.33
03,011,01,006,0116,0,656,4,660,1175,0,3,1,3,0,1,0,76.14,56.17 ,33.33
03,011,01,006,0117,0,941,13,954,1384,0,3,1,3,0,1,0,76.14,68.93 ,33.33
03,011,01,006,0118,0,561,7,568,908,0,3,1,3,0,1,0,76.14,62.56 ,33.33
03,011,01,006,0119,0,1277,8,1285,1874,0,3,1,3,0,1,0,76.14,68.57 ,33.33
03,011,01,006,0120,0,349,6,355,517,0,3,1,3,0,1,0,76.14,68.67 ,33.33
03,011,01,006,0121,0,280,1,281,499,0,3,1,3,0,1,0,76.14,56.31 ,33.33
03,011,01,006,0122,0,249,3,252,396,0,3,1,3,0,1,0,76.14,63.64 ,33.33
03,011,01,006,0123,0,1364,14,1378,2259,0,3,1,3,0,1,0,76.14,61.00 ,33.33
03,011,01,006,0124,0,414,1,415,776,0,3,1,3,0,1,0,76.14,53.48 ,33.33
03,011,01,006,0125,0,668,4,672,1130,0,3,1,3,0,1,0,76.14,59.47 ,33.33
03,011,01,006,0126,0,679,7,686,1116,0,3,1,3,0,1,0,76.14,61.47 ,33.33
03,011,01,006,0127,0,584,3,587,949,0,3,1,3,0,1,0,76.14,61.85 ,33.33
03,011,01,007,0128,0,466,2,468,632,0,3,1,3,0,1,0,76.14,74.05 ,33.33
03,011,01,007,0129,0,422,2,424,614,0,3,1,3,0,1,0,76.14,69.06 ,33.33
03,011,01,007,0130,0,1413,12,1425,2022,0,3,1,3,0,1,0,76.14,70.47 ,33.33
03,011,01,007,0131,0,1513,21,1534,2295,0,3,1,3,0,1,0,76.14,66.84 ,33.33
03,011,01,007,0132,0,965,7,972,1393,0,3,1,3,0,1,0,76.14,69.78 ,33.33
03,011,01,007,0133,0,1242,9,1251,1865,0,3,1,3,0,1,0,76.14,67.08 ,33.33
03,011,01,007,0134,0,915,14,929,1320,0,3,1,3,0,1,0,76.14,70.38 ,33.33
03,011,01,007,0135,0,699,4,703,1013,0,3,1,3,0,1,0,76.14,69.40 ,33.33
03,011,01,007,0136,0,1945,15,1960,2882,0,3,1,3,0,1,0,76.14,68.01 ,33.33
03,011,01,007,0137,0,825,9,834,1151,0,3,1,3,0,1,0,76.14,72.46 ,33.33
03,011,01,007,0138,0,1634,17,1651,2438,0,3,1,3,0,1,0,76.14,67.72 ,33.33
03,011,01,007,0139,0,469,3,472,645,0,3,1,3,0,1,0,76.14,73.18 ,33.33
03,011,01,007,0140,0,551,9,560,722,0,3,1,3,0,1,0,76.14,77.56 ,33.33
03,011,01,007,0141,0,1547,20,1567,2245,0,3,1,3,0,1,0,76.14,69.80 ,33.33
03,011,01,007,0142,0,1040,9,1049,1466,0,3,1,3,0,1,0,76.14,71.56 ,33.33
03,011,01,007,0143,0,662,6,668,912,0,3,1,3,0,1,0,76.14,73.25 ,33.33
03,011,01,007,0144,0,966,14,980,1298,0,3,1,3,0,1,0,76.14,75.50 ,33.33
03,011,01,007,0145,0,395,4,399,514,0,3,1,3,0,1,0,76.14,77.63 ,33.33
03,011,01,007,0146,0,739,6,745,977,0,3,1,3,0,1,0,76.14,76.25 ,33.33
03,011,01,007,0147,0,404,3,407,537,0,3,1,3,0,1,0,76.14,75.79 ,33.33
03,011,01,007,0148,0,740,12,752,1104,0,3,1,3,0,1,0,76.14,68.12 ,33.33
03,011,01,007,0149,0,731,5,736,1021,0,3,1,3,0,1,0,76.14,72.09 ,33.33
03,011,01,007,0150,0,433,4,437,602,0,3,1,3,0,1,0,76.14,72.59 ,33.33
03,011,01,007,0151,0,464,4,468,673,0,3,1,3,0,1,0,76.14,69.54 ,33.33
03,011,01,007,0152,0,496,6,502,710,0,3,1,3,0,1,0,76.14,70.70 ,33.33
03,011,01,007,0153,0,666,9,675,895,0,3,1,3,0,1,0,76.14,75.42 ,33.33
03,011,01,007,0154,0,619,7,626,813,0,3,1,3,0,1,0,76.14,77.00 ,33.33
03,011,01,007,0155,0,578,8,586,802,0,3,1,3,0,1,0,76.14,73.07 ,33.33
03,011,01,007,0156,0,818,12,830,1120,0,3,1,3,0,1,0,76.14,74.11 ,33.33
03,011,01,008,0157,0,680,2,682,980,0,3,1,3,0,1,0,76.14,69.59 ,33.33
03,011,01,008,0158,0,1717,18,1735,2582,0,3,1,3,0,1,0,76.14,67.20 ,33.33
03,011,01,008,0159,0,756,10,766,1149,0,3,1,3,0,1,0,76.14,66.67 ,33.33
03,011,01,008,0160,0,1032,14,1046,1514,0,3,1,3,0,1,0,76.14,69.09 ,33.33
03,011,01,008,0161,0,1391,14,1405,2079,0,3,1,3,0,1,0,76.14,67.58 ,33.33
03,011,01,008,0162,0,1421,13,1434,2139,0,3,1,3,0,1,0,76.14,67.04 ,33.33
03,011,01,008,0163,0,570,3,573,785,0,3,1,3,0,1,0,76.14,72.99 ,33.33
03,011,01,008,0164,0,550,10,560,766,0,3,1,3,0,1,0,76.14,73.11 ,33.33
03,011,01,008,0165,0,830,13,843,1189,0,3,1,3,0,1,0,76.14,70.90 ,33.33
03,011,01,008,0166,0,790,10,800,1107,0,3,1,3,0,1,0,76.14,72.27 ,33.33
03,011,01,008,0167,0,1271,13,1284,1816,0,3,1,3,0,1,0,76.14,70.70 ,33.33
03,011,01,008,0168,0,640,8,648,893,0,3,1,3,0,1,0,76.14,72.56 ,33.33
03,011,01,008,0169,0,883,9,892,1317,0,3,1,3,0,1,0,76.14,67.73 ,33.33
03,011,01,008,0170,0,836,10,846,1181,0,3,1,3,0,1,0,76.14,71.63 ,33.33
03,011,01,008,0171,0,852,15,867,1245,0,3,1,3,0,1,0,76.14,69.64 ,33.33
03,011,01,009,0172,0,1849,21,1870,2747,0,3,1,3,0,1,0,76.14,68.07 ,33.33
03,011,01,009,0173,0,1579,18,1597,2463,0,3,1,3,0,1,0,76.14,64.84 ,33.33
03,011,01,009,0174,0,900,7,907,1336,0,3,1,3,0,1,0,76.14,67.89 ,33.33
03,011,01,009,0175,0,696,6,702,1040,0,3,1,3,0,1,0,76.14,67.50 ,33.33
03,011,01,009,0176,0,595,8,603,863,0,3,1,3,0,1,0,76.14,69.87 ,33.33
03,011,01,009,0177,0,1849,28,1877,2799,0,3,1,3,0,1,0,76.14,67.06 ,33.33
03,011,01,009,0178,0,1271,19,1290,1856,0,3,1,3,0,1,0,76.14,69.50 ,33.33
03,011,01,009,0179,0,1030,17,1047,1551,0,3,1,3,0,1,0,76.14,67.50 ,33.33
03,011,01,009,0180,0,737,12,749,1087,0,3,1,3,0,1,0,76.14,68.91 ,33.33
03,011,01,009,0181,0,392,6,398,583,0,3,1,3,0,1,0,76.14,68.27 ,33.33
03,011,01,009,0182,0,565,6,571,881,0,3,1,3,0,1,0,76.14,64.81 ,33.33
03,011,01,009,0183,0,476,7,483,736,0,3,1,3,0,1,0,76.14,65.63 ,33.33
03,011,01,010,0184,0,1265,18,1283,1925,0,3,1,3,0,1,0,76.14,66.65 ,33.33
03,011,01,010,0185,0,1581,9,1590,2336,0,3,1,3,0,1,0,76.14,68.07 ,33.33
03,011,01,010,0186,0,727,13,740,1040,0,3,1,3,0,1,0,76.14,71.15 ,33.33
03,011,01,010,0187,0,204,4,208,316,0,3,1,3,0,1,0,76.14,65.82 ,33.33
03,011,01,010,0188,0,324,1,325,500,0,3,1,3,0,1,0,76.14,65.00 ,33.33
03,011,01,010,0189,0,1257,10,1267,1834,0,3,1,3,0,1,0,76.14,69.08 ,33.33
03,011,01,010,0190,0,1941,27,1968,2799,0,3,1,3,0,1,0,76.14,70.31 ,33.33
03,011,01,010,0191,0,711,12,723,1095,0,3,1,3,0,1,0,76.14,66.03 ,33.33
03,011,01,010,0192,0,1008,11,1019,1387,0,3,1,3,0,1,0,76.14,73.47 ,33.33
03,011,01,010,0193,0,474,7,481,671,0,3,1,3,0,1,0,76.14,71.68 ,33.33
03,011,01,010,0194,0,448,5,453,601,0,3,1,3,0,1,0,76.14,75.37 ,33.33
03,011,01,010,0195,0,1560,23,1583,2202,0,3,1,3,0,1,0,76.14,71.89 ,33.33
03,011,01,010,0196,0,607,8,615,913,0,3,1,3,0,1,0,76.14,67.36 ,33.33
03,011,01,011,0197,0,725,11,736,1105,0,3,1,3,0,1,0,76.14,66.61 ,33.33
03,011,01,011,0198,0,502,2,504,760,0,3,1,3,0,1,0,76.14,66.32 ,33.33
03,011,01,011,0199,0,978,6,984,1524,0,3,1,3,0,1,0,76.14,64.57 ,33.33
03,011,01,011,0200,0,746,12,758,1110,0,3,1,3,0,1,0,76.14,68.29 ,33.33
03,011,01,011,0201,0,576,8,584,847,0,3,1,3,0,1,0,76.14,68.95 ,33.33
03,011,01,011,0202,0,434,6,440,690,0,3,1,3,0,1,0,76.14,63.77 ,33.33
03,011,01,011,0203,0,655,4,659,1057,0,3,1,3,0,1,0,76.14,62.35 ,33.33
03,011,01,011,0204,0,590,4,594,915,0,3,1,3,0,1,0,76.14,64.92 ,33.33
03,011,01,011,0205,0,557,9,566,954,0,3,1,3,0,1,0,76.14,59.33 ,33.33
03,011,01,011,0206,0,454,1,455,650,0,3,1,3,0,1,0,76.14,70.00 ,33.33
03,011,01,012,0207,0,1231,13,1244,1808,0,3,1,3,0,1,0,76.14,68.81 ,33.33
03,011,01,012,0208,0,1820,22,1842,2637,0,3,1,3,0,1,0,76.14,69.85 ,33.33
03,011,01,012,0209,0,3133,25,3158,4554,0,3,1,3,0,1,0,76.14,69.35 ,33.33
03,011,01,012,0210,0,3818,38,3856,5679,0,3,1,3,0,1,0,76.14,67.90 ,33.33
03,011,01,012,0211,0,5514,56,5570,8270,0,3,1,3,0,1,0,76.14,67.35 ,33.33
03,011,01,012,0212,0,2183,22,2205,3113,0,3,1,3,0,1,0,76.14,70.83 ,33.33
03,011,01,012,0213,0,1323,19,1342,1833,0,3,1,3,0,1,0,76.14,73.21 ,33.33
03,011,01,012,0214,0,634,4,638,848,0,3,1,3,0,1,0,76.14,75.24 ,33.33
03,011,01,012,0215,0,1059,9,1068,1339,0,3,1,3,0,1,0,76.14,79.76 ,33.33
03,011,01,012,0216,0,491,2,493,691,0,3,1,3,0,1,0,76.14,71.35 ,33.33
03,011,01,012,0217,0,293,2,295,395,0,3,1,3,0,1,0,76.14,74.68 ,33.33
03,011,01,012,0218,0,907,12,919,1355,0,3,1,3,0,1,0,76.14,67.82 ,33.33
03,011,01,012,0219,0,474,1,475,644,0,3,1,3,0,1,0,76.14,73.76 ,33.33
03,011,01,012,0220,0,588,10,598,830,0,3,1,3,0,1,0,76.14,72.05 ,33.33
03,011,01,012,0221,0,684,5,689,970,0,3,1,3,0,1,0,76.14,71.03 ,33.33
03,011,01,012,0222,0,757,10,767,1093,0,3,1,3,0,1,0,76.14,70.17 ,33.33
03,011,01,012,0223,0,611,6,617,813,0,3,1,3,0,1,0,76.14,75.89 ,33.33
03,011,01,012,0224,0,764,6,770,995,0,3,1,3,0,1,0,76.14,77.39 ,33.33
03,011,01,012,0225,0,894,11,905,1255,0,3,1,3,0,1,0,76.14,72.11 ,33.33
03,011,01,012,0226,0,1068,13,1081,1534,0,3,1,3,0,1,0,76.14,70.47 ,33.33
03,011,01,012,0227,0,593,6,599,863,0,3,1,3,0,1,0,76.14,69.41 ,33.33
03,011,01,013,0228,0,797,8,805,1177,0,3,1,3,0,1,0,76.14,68.39 ,33.33
03,011,01,013,0229,0,854,7,861,1307,0,3,1,3,0,1,0,76.14,65.88 ,33.33
03,011,01,013,0230,0,350,4,354,503,0,3,1,3,0,1,0,76.14,70.38 ,33.33
03,011,01,013,0231,0,607,6,613,870,0,3,1,3,0,1,0,76.14,70.46 ,33.33
03,011,01,013,0232,0,432,4,436,625,0,3,1,3,0,1,0,76.14,69.76 ,33.33
03,011,01,013,0233,0,2353,16,2369,3524,0,3,1,3,0,1,0,76.14,67.22 ,33.33
03,011,01,013,0234,0,958,14,972,1481,0,3,1,3,0,1,0,76.14,65.63 ,33.33
03,011,01,013,0235,0,913,9,922,1322,0,3,1,3,0,1,0,76.14,69.74 ,33.33
03,011,01,013,0236,0,922,10,932,1409,0,3,1,3,0,1,0,76.14,66.15 ,33.33
03,011,01,013,0237,0,404,2,406,559,0,3,1,3,0,1,0,76.14,72.63 ,33.33
03,011,01,013,0238,0,363,1,364,521,0,3,1,3,0,1,0,76.14,69.87 ,33.33
03,011,01,013,0239,0,566,3,569,834,0,3,1,3,0,1,0,76.14,68.23 ,33.33
03,011,01,013,0240,0,211,5,216,327,0,3,1,3,0,1,0,76.14,66.06 ,33.33
03,011,01,013,0241,0,446,6,452,662,0,3,1,3,0,1,0,76.14,68.28 ,33.33
03,011,01,013,0242,0,210,4,214,336,0,3,1,3,0,1,0,76.14,63.69 ,33.33
03,011,01,013,0243,0,298,3,301,423,0,3,1,3,0,1,0,76.14,71.16 ,33.33
03,011,01,013,0244,0,324,3,327,505,0,3,1,3,0,1,0,76.14,64.75 ,33.33
03,011,01,013,0245,0,217,1,218,332,0,3,1,3,0,1,0,76.14,65.66 ,33.33
03,011,01,013,0246,0,587,4,591,885,0,3,1,3,0,1,0,76.14,66.78 ,33.33
03,011,01,013,0247,0,291,2,293,444,0,3,1,3,0,1,0,76.14,65.99 ,33.33
03,011,01,013,0248,0,694,5,699,1093,0,3,1,3,0,1,0,76.14,63.95 ,33.33
03,011,01,013,0249,0,332,7,339,505,0,3,1,3,0,1,0,76.14,67.13 ,33.33
03,011,01,013,0250,0,450,10,460,710,0,3,1,3,0,1,0,76.14,64.79 ,33.33
03,011,01,013,0251,0,467,4,471,684,0,3,1,3,0,1,0,76.14,68.86 ,33.33
03,011,01,013,0252,0,313,3,316,489,0,3,1,3,0,1,0,76.14,64.62 ,33.33
03,011,01,013,0253,0,299,3,302,461,0,3,1,3,0,1,0,76.14,65.51 ,33.33
03,011,01,014,0254,0,1933,23,1956,2744,0,3,1,3,0,1,0,76.14,71.28 ,33.33
03,011,01,014,0255,0,2406,15,2421,3453,0,3,1,3,0,1,0,76.14,70.11 ,33.33
03,011,01,014,0256,0,1404,24,1428,1910,0,3,1,3,0,1,0,76.14,74.76 ,33.33
03,011,01,014,0257,0,939,9,948,1311,0,3,1,3,0,1,0,76.14,72.31 ,33.33
03,011,01,014,0258,0,1093,21,1114,1562,0,3,1,3,0,1,0,76.14,71.32 ,33.33
03,011,01,014,0259,0,922,10,932,1316,0,3,1,3,0,1,0,76.14,70.82 ,33.33
03,011,01,014,0260,0,891,5,896,1285,0,3,1,3,0,1,0,76.14,69.73 ,33.33
03,011,01,014,0261,0,590,9,599,827,0,3,1,3,0,1,0,76.14,72.43 ,33.33
03,011,01,014,0262,0,850,9,859,1152,0,3,1,3,0,1,0,76.14,74.57 ,33.33
03,011,01,014,0263,0,845,10,855,1171,0,3,1,3,0,1,0,76.14,73.01 ,33.33
03,011,01,014,0264,0,665,5,670,876,0,3,1,3,0,1,0,76.14,76.48 ,33.33
03,011,01,014,0265,0,531,6,537,727,0,3,1,3,0,1,0,76.14,73.87 ,33.33
03,011,01,014,0266,0,284,4,288,407,0,3,1,3,0,1,0,76.14,70.76 ,33.33
03,011,01,015,0267,0,370,5,375,537,0,3,1,3,0,1,0,76.14,69.83 ,33.33
03,011,01,015,0268,0,463,4,467,743,0,3,1,3,0,1,0,76.14,62.85 ,33.33
03,011,01,015,0269,0,411,4,415,511,0,3,1,3,0,1,0,76.14,81.21 ,33.33
03,011,01,015,0270,0,548,9,557,817,0,3,1,3,0,1,0,76.14,68.18 ,33.33
03,011,01,015,0271,0,663,3,666,939,0,3,1,3,0,1,0,76.14,70.93 ,33.33
03,011,01,015,0272,0,375,6,381,550,0,3,1,3,0,1,0,76.14,69.27 ,33.33
03,011,01,015,0273,0,301,5,306,458,0,3,1,3,0,1,0,76.14,66.81 ,33.33
03,011,01,015,0274,0,544,11,555,784,0,3,1,3,0,1,0,76.14,70.79 ,33.33
03,011,01,015,0275,0,1151,19,1170,1680,0,3,1,3,0,1,0,76.14,69.64 ,33.33
03,011,01,015,0276,0,284,7,291,382,0,3,1,3,0,1,0,76.14,76.18 ,33.33
03,011,01,015,0277,0,563,7,570,882,0,3,1,3,0,1,0,76.14,64.63 ,33.33
03,011,01,015,0278,0,550,5,555,822,0,3,1,3,0,1,0,76.14,67.52 ,33.33
03,011,01,015,0279,0,885,15,900,1359,0,3,1,3,0,1,0,76.14,66.23 ,33.33
03,011,01,015,0280,0,655,7,662,949,0,3,1,3,0,1,0,76.14,69.76 ,33.33
03,011,01,015,0281,0,363,5,368,580,0,3,1,3,0,1,0,76.14,63.45 ,33.33
03,011,01,015,0282,0,699,4,703,1026,0,3,1,3,0,1,0,76.14,68.52 ,33.33
03,011,01,015,0283,0,439,2,441,586,0,3,1,3,0,1,0,76.14,75.26 ,33.33
03,011,01,015,0284,0,552,8,560,751,0,3,1,3,0,1,0,76.14,74.57 ,33.33
03,011,01,015,0285,0,664,3,667,995,0,3,1,3,0,1,0,76.14,67.04 ,33.33
03,011,01,015,0286,0,462,12,474,641,0,3,1,3,0,1,0,76.14,73.95 ,33.33
03,011,01,015,0287,0,575,7,582,878,0,3,1,3,0,1,0,76.14,66.29 ,33.33
03,011,01,015,0288,0,1225,39,1264,1809,0,3,1,3,0,1,0,76.14,69.87 ,33.33
03,011,01,015,0289,0,881,12,893,1326,0,3,1,3,0,1,0,76.14,67.35 ,33.33
03,011,01,016,0290,0,640,3,643,921,0,3,1,3,0,1,0,76.14,69.82 ,33.33
03,011,01,016,0291,0,892,6,898,1296,0,3,1,3,0,1,0,76.14,69.29 ,33.33
03,011,01,016,0292,0,716,12,728,1038,0,3,1,3,0,1,0,76.14,70.13 ,33.33
03,011,01,016,0293,0,981,5,986,1477,0,3,1,3,0,1,0,76.14,66.76 ,33.33
03,011,01,016,0294,0,642,12,654,920,0,3,1,3,0,1,0,76.14,71.09 ,33.33
03,011,01,016,0295,0,742,12,754,1029,0,3,1,3,0,1,0,76.14,73.28 ,33.33
03,011,01,016,0296,0,695,3,698,1047,0,3,1,3,0,1,0,76.14,66.67 ,33.33
03,011,01,016,0297,0,509,3,512,793,0,3,1,3,0,1,0,76.14,64.56 ,33.33
03,011,01,016,0298,0,441,1,442,644,0,3,1,3,0,1,0,76.14,68.63 ,33.33
03,011,01,016,0299,0,450,5,455,718,0,3,1,3,0,1,0,76.14,63.37 ,33.33
03,011,01,016,0300,0,415,5,420,609,0,3,1,3,0,1,0,76.14,68.97 ,33.33
03,011,01,016,0301,0,301,1,302,426,0,3,1,3,0,1,0,76.14,70.89 ,33.33
03,011,01,016,0302,0,577,7,584,895,0,3,1,3,0,1,0,76.14,65.25 ,33.33
03,011,01,016,0303,0,476,7,483,715,0,3,1,3,0,1,0,76.14,67.55 ,33.33
03,011,01,016,0304,0,898,13,911,1444,0,3,1,3,0,1,0,76.14,63.09 ,33.33
03,011,01,016,0305,0,810,5,815,1307,0,3,1,3,0,1,0,76.14,62.36 ,33.33
03,011,01,016,0306,0,1296,9,1305,2021,0,3,1,3,0,1,0,76.14,64.57 ,33.33
03,011,01,016,0307,0,610,8,618,1012,0,3,1,3,0,1,0,76.14,61.07 ,33.33
03,011,01,017,0308,0,623,7,630,906,0,3,1,3,0,1,0,76.14,69.54 ,33.33
03,011,01,017,0309,0,347,2,349,509,0,3,1,3,0,1,0,76.14,68.57 ,33.33
03,011,01,017,0310,0,268,7,275,405,0,3,1,3,0,1,0,76.14,67.90 ,33.33
03,011,01,017,0311,0,522,7,529,785,0,3,1,3,0,1,0,76.14,67.39 ,33.33
03,011,01,017,0312,0,884,7,891,1334,0,3,1,3,0,1,0,76.14,66.79 ,33.33
03,011,01,017,0313,0,456,10,466,749,0,3,1,3,0,1,0,76.14,62.22 ,33.33
03,011,01,017,0314,0,516,3,519,761,0,3,1,3,0,1,0,76.14,68.20 ,33.33
03,011,01,017,0315,0,383,3,386,594,0,3,1,3,0,1,0,76.14,64.98 ,33.33
03,011,01,017,0316,0,679,7,686,1087,0,3,1,3,0,1,0,76.14,63.11 ,33.33
03,011,01,017,0317,0,424,6,430,653,0,3,1,3,0,1,0,76.14,65.85 ,33.33
03,011,01,017,0318,0,767,7,774,1156,0,3,1,3,0,1,0,76.14,66.96 ,33.33
03,011,01,017,0319,0,418,4,422,707,0,3,1,3,0,1,0,76.14,59.69 ,33.33
03,011,01,017,0320,0,482,6,488,712,0,3,1,3,0,1,0,76.14,68.54 ,33.33
03,011,01,018,0321,0,1108,10,1118,1602,0,3,1,3,0,1,0,76.14,69.79 ,33.33
03,011,01,018,0322,0,2433,21,2454,3715,0,3,1,3,0,1,0,76.14,66.06 ,33.33
03,011,01,018,0323,0,1033,22,1055,1605,0,3,1,3,0,1,0,76.14,65.73 ,33.33
03,011,01,018,0324,0,2481,25,2506,3653,0,3,1,3,0,1,0,76.14,68.60 ,33.33
03,011,01,018,0325,0,301,1,302,438,0,3,1,3,0,1,0,76.14,68.95 ,33.33
03,011,01,018,0326,0,430,2,432,633,0,3,1,3,0,1,0,76.14,68.25 ,33.33
03,011,01,018,0327,0,317,5,322,435,0,3,1,3,0,1,0,76.14,74.02 ,33.33
03,011,01,018,0328,0,694,7,701,1008,0,3,1,3,0,1,0,76.14,69.54 ,33.33
03,011,01,018,0329,0,1966,30,1996,2932,0,3,1,3,0,1,0,76.14,68.08 ,33.33
03,011,01,018,0330,0,1091,14,1105,1600,0,3,1,3,0,1,0,76.14,69.06 ,33.33
03,011,01,018,0331,0,809,2,811,1147,0,3,1,3,0,1,0,76.14,70.71 ,33.33
03,011,01,018,0332,0,1657,20,1677,2397,0,3,1,3,0,1,0,76.14,69.96 ,33.33
03,011,01,018,0333,0,1307,9,1316,1919,0,3,1,3,0,1,0,76.14,68.58 ,33.33
03,011,01,018,0334,0,1205,22,1227,1722,0,3,1,3,0,1,0,76.14,71.25 ,33.33
03,011,01,018,0335,0,1414,35,1449,2072,0,3,1,3,0,1,0,76.14,69.93 ,33.33
03,011,01,018,0336,0,861,5,866,1268,0,3,1,3,0,1,0,76.14,68.30 ,33.33
03,011,01,018,0337,0,337,5,342,499,0,3,1,3,0,1,0,76.14,68.54 ,33.33
03,011,01,018,0338,0,1353,20,1373,2002,0,3,1,3,0,1,0,76.14,68.58 ,33.33
03,011,01,018,0339,0,549,5,554,838,0,3,1,3,0,1,0,76.14,66.11 ,33.33
03,011,01,018,0340,0,727,8,735,1042,0,3,1,3,0,1,0,76.14,70.54 ,33.33
03,011,01,019,0341,0,620,4,624,926,0,3,1,3,0,1,0,76.14,67.39 ,33.33
03,011,01,019,0342,0,1749,25,1774,2564,0,3,1,3,0,1,0,76.14,69.19 ,33.33
03,011,01,019,0343,0,2667,38,2705,3969,0,3,1,3,0,1,0,76.14,68.15 ,33.33
03,011,01,019,0344,0,1358,7,1365,2058,0,3,1,3,0,1,0,76.14,66.33 ,33.33
03,011,01,019,0345,0,853,9,862,1306,0,3,1,3,0,1,0,76.14,66.00 ,33.33
03,011,01,019,0346,0,439,7,446,663,0,3,1,3,0,1,0,76.14,67.27 ,33.33
03,011,01,019,0347,0,324,3,327,470,0,3,1,3,0,1,0,76.14,69.57 ,33.33
03,011,01,019,0348,0,761,12,773,1160,0,3,1,3,0,1,0,76.14,66.64 ,33.33
03,011,01,019,0349,0,966,12,978,1274,0,3,1,3,0,1,0,76.14,76.77 ,33.33
03,011,01,019,0350,0,1308,31,1339,1845,0,3,1,3,0,1,0,76.14,72.57 ,33.33
03,011,01,019,0351,0,625,15,640,879,0,3,1,3,0,1,0,76.14,72.81 ,33.33
03,011,01,019,0352,0,1152,8,1160,1608,0,3,1,3,0,1,0,76.14,72.14 ,33.33
03,011,01,019,0353,0,477,4,481,667,0,3,1,3,0,1,0,76.14,72.11 ,33.33
03,011,01,019,0354,0,736,8,744,1070,0,3,1,3,0,1,0,76.14,69.53 ,33.33
03,011,01,019,0355,0,1230,16,1246,1748,0,3,1,3,0,1,0,76.14,71.28 ,33.33
03,011,01,019,0356,0,633,9,642,860,0,3,1,3,0,1,0,76.14,74.65 ,33.33
03,011,01,019,0357,0,658,5,663,1006,0,3,1,3,0,1,0,76.14,65.90 ,33.33
03,011,01,019,0358,0,917,13,930,1368,0,3,1,3,0,1,0,76.14,67.98 ,33.33
03,011,01,019,0359,0,958,10,968,1351,0,3,1,3,0,1,0,76.14,71.65 ,33.33
03,011,01,019,0360,0,692,6,698,1038,0,3,1,3,0,1,0,76.14,67.24 ,33.33
03,011,01,019,0361,0,1770,22,1792,2678,0,3,1,3,0,1,0,76.14,66.92 ,33.33
03,011,01,020,0362,0,1589,23,1612,2395,0,3,1,3,0,1,0,76.14,67.31 ,33.33
03,011,01,020,0363,0,3441,41,3482,5139,0,3,1,3,0,1,0,76.14,67.76 ,33.33
03,011,01,020,0364,0,1253,10,1263,1806,0,3,1,3,0,1,0,76.14,69.93 ,33.33
03,011,01,020,0365,0,436,9,445,603,0,3,1,3,0,1,0,76.14,73.80 ,33.33
03,011,01,020,0366,0,571,7,578,881,0,3,1,3,0,1,0,76.14,65.61 ,33.33
03,011,01,020,0367,0,730,4,734,1003,0,3,1,3,0,1,0,76.14,73.18 ,33.33
03,011,01,020,0368,0,1661,20,1681,2315,0,3,1,3,0,1,0,76.14,72.61 ,33.33
03,011,01,020,0369,0,2216,28,2244,3212,0,3,1,3,0,1,0,76.14,69.86 ,33.33
03,011,01,020,0370,0,1060,14,1074,1500,0,3,1,3,0,1,0,76.14,71.60 ,33.33
03,011,01,020,0371,0,1915,21,1936,2806,0,3,1,3,0,1,0,76.14,69.00 ,33.33
03,011,01,020,0372,0,1466,19,1485,2162,0,3,1,3,0,1,0,76.14,68.69 ,33.33
03,011,01,021,0373,0,1416,18,1434,2030,0,3,1,3,0,1,0,76.14,70.64 ,33.33
03,011,01,021,0374,0,1181,14,1195,1750,0,3,1,3,0,1,0,76.14,68.29 ,33.33
03,011,01,021,0375,0,958,8,966,1336,0,3,1,3,0,1,0,76.14,72.31 ,33.33
03,011,01,021,0376,0,858,7,865,1150,0,3,1,3,0,1,0,76.14,75.22 ,33.33
03,011,01,021,0377,0,547,7,554,718,0,3,1,3,0,1,0,76.14,77.16 ,33.33
03,011,01,021,0378,0,1200,15,1215,1501,0,3,1,3,0,1,0,76.14,80.95 ,33.33
03,011,01,021,0379,0,681,11,692,961,0,3,1,3,0,1,0,76.14,72.01 ,33.33
03,011,01,021,0380,0,1526,22,1548,2114,0,3,1,3,0,1,0,76.14,73.23 ,33.33
03,011,01,021,0381,0,1516,22,1538,2148,0,3,1,3,0,1,0,76.14,71.60 ,33.33
03,011,01,021,0382,0,470,7,477,643,0,3,1,3,0,1,0,76.14,74.18 ,33.33
03,011,01,021,0383,0,917,10,927,1348,0,3,1,3,0,1,0,76.14,68.77 ,33.33
03,011,01,021,0384,0,496,2,498,697,0,3,1,3,0,1,0,76.14,71.45 ,33.33
03,011,01,021,0385,0,1211,20,1231,1710,0,3,1,3,0,1,0,76.14,71.99 ,33.33
03,011,01,021,0386,0,1574,17,1591,2168,0,3,1,3,0,1,0,76.14,73.39 ,33.33
03,011,01,021,0387,0,659,2,661,908,0,3,1,3,0,1,0,76.14,72.80 ,33.33
03,011,01,021,0388,0,393,7,400,490,0,3,1,3,0,1,0,76.14,81.63 ,33.33
03,011,01,022,0389,0,1158,18,1176,1741,0,3,1,3,0,1,0,76.14,67.55 ,33.33
03,011,01,022,0390,0,1100,5,1105,1516,0,3,1,3,0,1,0,76.14,72.89 ,33.33
03,011,01,022,0391,0,590,13,603,886,0,3,1,3,0,1,0,76.14,68.06 ,33.33
03,011,01,022,0392,0,491,5,496,746,0,3,1,3,0,1,0,76.14,66.49 ,33.33
03,011,01,022,0393,0,387,5,392,576,0,3,1,3,0,1,0,76.14,68.06 ,33.33
03,011,01,022,0394,0,259,5,264,352,0,3,1,3,0,1,0,76.14,75.00 ,33.33
03,011,01,022,0395,0,236,3,239,354,0,3,1,3,0,1,0,76.14,67.51 ,33.33
03,011,01,023,0396,0,641,4,645,914,0,3,1,3,0,1,0,76.14,70.57 ,33.33
03,011,01,023,0397,0,2677,31,2708,4051,0,3,1,3,0,1,0,76.14,66.85 ,33.33
03,011,01,023,0398,0,890,12,902,1279,0,3,1,3,0,1,0,76.14,70.52 ,33.33
03,011,01,023,0399,0,875,4,879,1370,0,3,1,3,0,1,0,76.14,64.16 ,33.33
03,011,01,023,0400,0,346,6,352,496,0,3,1,3,0,1,0,76.14,70.97 ,33.33
03,011,01,023,0401,0,310,1,311,489,0,3,1,3,0,1,0,76.14,63.60 ,33.33
03,011,01,023,0402,0,553,5,558,776,0,3,1,3,0,1,0,76.14,71.91 ,33.33
03,011,01,023,0403,0,1104,21,1125,1579,0,3,1,3,0,1,0,76.14,71.25 ,33.33
03,011,01,023,0404,0,526,4,530,682,0,3,1,3,0,1,0,76.14,77.71 ,33.33
03,011,01,023,0405,0,685,9,694,1021,0,3,1,3,0,1,0,76.14,67.97 ,33.33
03,011,01,024,0406,0,1273,19,1292,1935,0,3,1,3,0,1,0,76.14,66.77 ,33.33
03,011,01,024,0407,0,784,17,801,1261,0,3,1,3,0,1,0,76.14,63.52 ,33.33
03,011,01,024,0408,0,599,3,602,856,0,3,1,3,0,1,0,76.14,70.33 ,33.33
03,011,01,024,0409,0,696,13,709,1066,0,3,1,3,0,1,0,76.14,66.51 ,33.33
03,011,01,024,0410,0,737,3,740,1040,0,3,1,3,0,1,0,76.14,71.15 ,33.33
03,011,01,024,0411,0,513,9,522,720,0,3,1,3,0,1,0,76.14,72.50 ,33.33
03,011,01,024,0412,0,1568,12,1580,2251,0,3,1,3,0,1,0,76.14,70.19 ,33.33
03,011,01,025,0413,0,982,10,992,1388,0,3,1,3,0,1,0,76.14,71.47 ,33.33
03,011,01,025,0414,0,558,4,562,801,0,3,1,3,0,1,0,76.14,70.16 ,33.33
03,011,01,025,0415,0,451,1,452,673,0,3,1,3,0,1,0,76.14,67.16 ,33.33
03,011,01,025,0416,0,339,3,342,495,0,3,1,3,0,1,0,76.14,69.09 ,33.33
03,011,01,025,0417,0,431,1,432,585,0,3,1,3,0,1,0,76.14,73.85 ,33.33
03,011,01,025,0418,0,552,7,559,825,0,3,1,3,0,1,0,76.14,67.76 ,33.33
03,011,01,025,0419,0,805,9,814,1222,0,3,1,3,0,1,0,76.14,66.61 ,33.33
03,011,01,025,0420,0,638,6,644,917,0,3,1,3,0,1,0,76.14,70.23 ,33.33
03,011,01,025,0421,0,298,4,302,549,0,3,1,3,0,1,0,76.14,55.01 ,33.33
03,011,01,026,0422,0,267,4,271,429,0,3,1,3,0,1,0,76.14,63.17 ,33.33
03,011,01,026,0423,0,502,8,510,720,0,3,1,3,0,1,0,76.14,70.83 ,33.33
03,011,01,026,0424,0,342,2,344,530,0,3,1,3,0,1,0,76.14,64.91 ,33.33
03,011,01,026,0425,0,651,3,654,904,0,3,1,3,0,1,0,76.14,72.35 ,33.33
03,011,01,026,0426,0,264,3,267,370,0,3,1,3,0,1,0,76.14,72.16 ,33.33
03,011,01,026,0427,0,311,8,319,463,0,3,1,3,0,1,0,76.14,68.90 ,33.33
03,011,01,026,0428,0,288,2,290,430,0,3,1,3,0,1,0,76.14,67.44 ,33.33
03,011,01,026,0429,0,209,3,212,328,0,3,1,3,0,1,0,76.14,64.63 ,33.33
03,011,01,026,0430,0,172,1,173,244,0,3,1,3,0,1,0,76.14,70.90 ,33.33
03,011,01,026,0431,0,384,2,386,585,0,3,1,3,0,1,0,76.14,65.98 ,33.33
03,011,01,027,0432,0,2729,22,2751,3946,0,3,1,3,0,1,0,76.14,69.72 ,33.33
03,011,01,027,0433,0,1602,13,1615,2221,0,3,1,3,0,1,0,76.14,72.71 ,33.33
03,011,01,027,0434,0,1227,13,1240,1830,0,3,1,3,0,1,0,76.14,67.76 ,33.33
03,011,01,027,0435,0,2354,23,2377,3865,0,3,1,3,0,1,0,76.14,61.50 ,33.33
03,011,01,027,0436,0,4195,53,4248,6358,0,3,1,3,0,1,0,76.14,66.81 ,33.33
03,011,01,027,0437,0,1624,19,1643,2509,0,3,1,3,0,1,0,76.14,65.48 ,33.33
03,011,01,027,0438,0,3912,54,3966,6233,0,3,1,3,0,1,0,76.14,63.63 ,33.33
03,011,01,027,0439,0,2390,27,2417,3928,0,3,1,3,0,1,0,76.14,61.53 ,33.33
03,011,01,027,0440,0,974,14,988,1303,0,3,1,3,0,1,0,76.14,75.83 ,33.33
03,011,01,027,0441,0,472,2,474,697,0,3,1,3,0,1,0,76.14,68.01 ,33.33
03,011,01,027,0442,0,1407,21,1428,2145,0,3,1,3,0,1,0,76.14,66.57 ,33.33
03,011,01,027,0443,0,2339,33,2372,3554,0,3,1,3,0,1,0,76.14,66.74 ,33.33
03,011,01,027,0444,0,755,19,774,1123,0,3,1,3,0,1,0,76.14,68.92 ,33.33
03,011,01,027,0445,0,1279,31,1310,1989,0,3,1,3,0,1,0,76.14,65.86 ,33.33
03,011,01,027,0446,0,1357,30,1387,1996,0,3,1,3,0,1,0,76.14,69.49 ,33.33
03,011,01,027,0447,0,1396,27,1423,1928,0,3,1,3,0,1,0,76.14,73.81 ,33.33
03,011,01,027,0448,0,859,6,865,1242,0,3,1,3,0,1,0,76.14,69.65 ,33.33
03,011,01,027,0449,0,983,12,995,1393,0,3,1,3,0,1,0,76.14,71.43 ,33.33
03,011,01,028,0450,0,2965,31,2996,4533,0,3,1,3,0,1,0,76.14,66.09 ,33.33
03,011,01,028,0451,0,1728,11,1739,2682,0,3,1,3,0,1,0,76.14,64.84 ,33.33
03,011,01,028,0452,0,1966,32,1998,2997,0,3,1,3,0,1,0,76.14,66.67 ,33.33
03,011,01,028,0453,0,1283,19,1302,1954,0,3,1,3,0,1,0,76.14,66.63 ,33.33
03,011,01,028,0454,0,2013,19,2032,2915,0,3,1,3,0,1,0,76.14,69.71 ,33.33
03,011,01,028,0455,0,1430,21,1451,2274,0,3,1,3,0,1,0,76.14,63.81 ,33.33
03,011,01,028,0456,0,1685,23,1708,2583,0,3,1,3,0,1,0,76.14,66.12 ,33.33
03,011,01,028,0457,0,1373,7,1380,2010,0,3,1,3,0,1,0,76.14,68.66 ,33.33
03,011,01,028,0458,0,1882,13,1895,2730,0,3,1,3,0,1,0,76.14,69.41 ,33.33
03,011,01,028,0459,0,968,11,979,1334,0,3,1,3,0,1,0,76.14,73.39 ,33.33
03,011,01,028,0460,0,876,7,883,1305,0,3,1,3,0,1,0,76.14,67.66 ,33.33
03,011,01,028,0461,0,1351,9,1360,1878,0,3,1,3,0,1,0,76.14,72.42 ,33.33
03,011,01,028,0462,0,395,5,400,568,0,3,1,3,0,1,0,76.14,70.42 ,33.33
03,011,01,028,0463,0,1134,16,1150,1678,0,3,1,3,0,1,0,76.14,68.53 ,33.33
03,011,01,028,0464,0,728,10,738,1173,0,3,1,3,0,1,0,76.14,62.92 ,33.33
03,011,01,028,0465,0,1316,10,1326,1944,0,3,1,3,0,1,0,76.14,68.21 ,33.33
03,011,01,028,0466,0,1450,13,1463,2070,0,3,1,3,0,1,0,76.14,70.68 ,33.33
03,011,01,028,0467,0,1397,9,1406,2042,0,3,1,3,0,1,0,76.14,68.85 ,33.33
03,011,01,028,0468,0,1235,5,1240,1804,0,3,1,3,0,1,0,76.14,68.74 ,33.33
03,011,01,028,0469,0,931,12,943,1307,0,3,1,3,0,1,0,76.14,72.15 ,33.33
03,011,01,028,0470,0,1463,24,1487,2207,0,3,1,3,0,1,0,76.14,67.38 ,33.33
03,011,01,029,0471,0,1379,4,1383,1903,0,3,1,3,0,1,0,76.14,72.67 ,33.33
03,011,01,029,0472,0,1366,8,1374,1838,0,3,1,3,0,1,0,76.14,74.76 ,33.33
03,011,01,029,0473,0,2501,18,2519,3409,0,3,1,3,0,1,0,76.14,73.89 ,33.33
03,011,01,029,0474,0,1905,10,1915,2500,0,3,1,3,0,1,0,76.14,76.60 ,33.33
03,011,01,029,0475,0,615,6,621,840,0,3,1,3,0,1,0,76.14,73.93 ,33.33
03,011,01,029,0476,0,533,4,537,745,0,3,1,3,0,1,0,76.14,72.08 ,33.33
03,011,01,029,0477,0,1861,16,1877,2617,0,3,1,3,0,1,0,76.14,71.72 ,33.33
03,011,01,029,0478,0,2038,24,2062,2943,0,3,1,3,0,1,0,76.14,70.06 ,33.33
03,011,01,029,0479,0,1367,10,1377,1874,0,3,1,3,0,1,0,76.14,73.48 ,33.33
03,011,01,029,0480,0,1045,5,1050,1425,0,3,1,3,0,1,0,76.14,73.68 ,33.33
03,011,01,029,0481,0,1489,19,1508,2076,0,3,1,3,0,1,0,76.14,72.64 ,33.33
03,011,01,029,0482,0,1127,11,1138,1511,0,3,1,3,0,1,0,76.14,75.31 ,33.33
03,011,01,029,0483,0,794,9,803,1196,0,3,1,3,0,1,0,76.14,67.14 ,33.33
03,011,01,029,0484,0,532,4,536,730,0,3,1,3,0,1,0,76.14,73.42 ,33.33
03,011,01,029,0485,0,566,3,569,761,0,3,1,3,0,1,0,76.14,74.77 ,33.33
03,011,01,029,0486,0,1051,8,1059,1494,0,3,1,3,0,1,0,76.14,70.88 ,33.33
03,011,01,029,0487,0,290,2,292,376,0,3,1,3,0,1,0,76.14,77.66 ,33.33
03,011,01,030,0488,0,838,7,845,1145,0,3,1,3,0,1,0,76.14,73.80 ,33.33
03,011,01,030,0489,0,498,2,500,694,0,3,1,3,0,1,0,76.14,72.05 ,33.33
03,011,01,030,0490,0,115,1,116,197,0,3,1,3,0,1,0,76.14,58.88 ,33.33
03,011,01,030,0491,0,224,4,228,306,0,3,1,3,0,1,0,76.14,74.51 ,33.33
03,011,01,030,0492,0,204,1,205,270,0,3,1,3,0,1,0,76.14,75.93 ,33.33
03,011,01,030,0493,0,207,2,209,297,0,3,1,3,0,1,0,76.14,70.37 ,33.33
03,011,01,030,0494,0,324,1,325,425,0,3,1,3,0,1,0,76.14,76.47 ,33.33
03,011,01,030,0495,0,268,4,272,383,0,3,1,3,0,1,0,76.14,71.02 ,33.33
03,011,01,031,0496,0,2218,22,2240,3824,0,3,1,3,0,1,0,76.14,58.58 ,33.33
03,011,01,031,0497,0,1692,17,1709,2787,0,3,1,3,0,1,0,76.14,61.32 ,33.33
03,011,01,031,0498,0,1856,25,1881,3285,0,3,1,3,0,1,0,76.14,57.26 ,33.33
03,011,01,031,0499,0,2432,18,2450,3929,0,3,1,3,0,1,0,76.14,62.36 ,33.33
03,011,01,031,0500,0,3342,46,3388,5481,0,3,1,3,0,1,0,76.14,61.81 ,33.33
03,011,01,031,0501,0,3475,39,3514,5735,0,3,1,3,0,1,0,76.14,61.27 ,33.33
03,011,01,031,0502,0,3196,36,3232,5276,0,3,1,3,0,1,0,76.14,61.26 ,33.33
03,011,01,031,0503,0,3467,35,3502,5506,0,3,1,3,0,1,0,76.14,63.60 ,33.33
03,011,01,031,0504,0,2425,13,2438,3963,0,3,1,3,0,1,0,76.14,61.52 ,33.33
03,011,01,031,0505,0,1400,17,1417,2204,0,3,1,3,0,1,0,76.14,64.29 ,33.33
03,011,01,031,0506,0,1392,19,1411,2325,0,3,1,3,0,1,0,76.14,60.69 ,33.33
03,011,01,031,0507,0,1957,14,1971,3352,0,3,1,3,0,1,0,76.14,58.80 ,33.33
03,011,01,031,0508,0,1016,16,1032,1456,0,3,1,3,0,1,0,76.14,70.88 ,33.33
03,011,01,031,0509,0,747,13,760,1067,0,3,1,3,0,1,0,76.14,71.23 ,33.33
03,011,01,031,0510,0,3647,35,3682,5934,0,3,1,3,0,1,0,76.14,62.05 ,33.33
03,011,01,031,0511,0,2756,36,2792,4259,0,3,1,3,0,1,0,76.14,65.56 ,33.33
03,011,01,031,0512,0,1448,16,1464,2164,0,3,1,3,0,1,0,76.14,67.65 ,33.33
03,011,01,031,0513,0,2084,24,2108,3273,0,3,1,3,0,1,0,76.14,64.41 ,33.33
03,011,01,031,0514,0,3878,47,3925,6203,0,3,1,3,0,1,0,76.14,63.28 ,33.33
03,011,01,031,0515,0,1241,13,1254,1814,0,3,1,3,0,1,0,76.14,69.13 ,33.33
03,011,01,031,0516,0,1007,16,1023,1558,0,3,1,3,0,1,0,76.14,65.66 ,33.33
03,011,01,031,0517,0,2538,31,2569,3846,0,3,1,3,0,1,0,76.14,66.80 ,33.33
03,011,01,031,0518,0,794,4,798,1253,0,3,1,3,0,1,0,76.14,63.69 ,33.33
03,011,01,031,0519,0,2005,16,2021,2882,0,3,1,3,0,1,0,76.14,70.12 ,33.33
03,011,01,031,0520,0,2044,29,2073,3033,0,3,1,3,0,1,0,76.14,68.35 ,33.33
03,011,01,031,0521,0,3189,44,3233,4926,0,3,1,3,0,1,0,76.14,65.63 ,33.33
03,011,01,031,0522,0,2287,25,2312,3425,0,3,1,3,0,1,0,76.14,67.50 ,33.33
03,011,01,031,0523,0,3257,36,3293,5071,0,3,1,3,0,1,0,76.14,64.94 ,33.33
03,011,01,031,0524,0,3420,36,3456,5228,0,3,1,3,0,1,0,76.14,66.11 ,33.33
03,011,01,031,0525,0,1162,31,1193,1741,0,3,1,3,0,1,0,76.14,68.52 ,33.33
03,011,01,031,0526,0,765,13,778,1122,0,3,1,3,0,1,0,76.14,69.34 ,33.33
03,011,01,031,0527,0,1320,30,1350,1982,0,3,1,3,0,1,0,76.14,68.11 ,33.33
03,011,01,031,0528,0,1325,12,1337,2002,0,3,1,3,0,1,0,76.14,66.78 ,33.33
03,011,01,031,0529,0,5708,55,5763,9641,0,3,1,3,0,1,0,76.14,59.78 ,33.33
03,011,01,031,0530,0,1108,16,1124,1699,0,3,1,3,0,1,0,76.14,66.16 ,33.33
03,011,01,031,0531,0,1365,21,1386,2126,0,3,1,3,0,1,0,76.14,65.19 ,33.33
03,011,01,031,0532,0,1254,5,1259,1968,0,3,1,3,0,1,0,76.14,63.97 ,33.33
03,011,01,031,0533,0,1687,16,1703,2683,0,3,1,3,0,1,0,76.14,63.47 ,33.33
03,011,01,031,0534,0,2928,28,2956,5055,0,3,1,3,0,1,0,76.14,58.48 ,33.33
03,012,01,001,0001,0,792,9,801,1263,0,3,1,3,0,1,0,76.14,63.42 ,33.33
03,012,01,001,0002,0,560,4,564,862,0,3,1,3,0,1,0,76.14,65.43 ,33.33
03,012,01,001,0003,0,1507,16,1523,2282,0,3,1,3,0,1,0,76.14,66.74 ,33.33
03,012,01,001,0004,0,3164,38,3202,5008,0,3,1,3,0,1,0,76.14,63.94 ,33.33
03,012,01,001,0005,0,2355,22,2377,3734,0,3,1,3,0,1,0,76.14,63.66 ,33.33
03,012,01,001,0006,0,2671,21,2692,4213,0,3,1,3,0,1,0,76.14,63.90 ,33.33
03,012,01,001,0007,0,1478,11,1489,2344,0,3,1,3,0,1,0,76.14,63.52 ,33.33
03,012,01,001,0008,0,1895,26,1921,2947,0,3,1,3,0,1,0,76.14,65.18 ,33.33
03,012,01,001,0009,0,1827,19,1846,2838,0,3,1,3,0,1,0,76.14,65.05 ,33.33
03,012,01,001,0010,0,2717,36,2753,4152,0,3,1,3,0,1,0,76.14,66.31 ,33.33
03,012,01,001,0011,0,3156,34,3190,4933,0,3,1,3,0,1,0,76.14,64.67 ,33.33
03,012,01,001,0012,0,2844,22,2866,4908,0,3,1,3,0,1,0,76.14,58.39 ,33.33
03,012,01,001,0013,0,1313,9,1322,2041,0,3,1,3,0,1,0,76.14,64.77 ,33.33
03,012,01,001,0014,0,3136,38,3174,5377,0,3,1,3,0,1,0,76.14,59.03 ,33.33
03,012,01,001,0015,0,526,6,532,761,0,3,1,3,0,1,0,76.14,69.91 ,33.33
03,012,01,001,0016,0,324,1,325,497,0,3,1,3,0,1,0,76.14,65.39 ,33.33
03,012,01,001,0017,0,939,7,946,1381,0,3,1,3,0,1,0,76.14,68.50 ,33.33
03,012,01,001,0018,0,1059,9,1068,1634,0,3,1,3,0,1,0,76.14,65.36 ,33.33
03,012,01,001,0019,0,3028,30,3058,4535,0,3,1,3,0,1,0,76.14,67.43 ,33.33
03,012,01,001,0020,0,724,12,736,1082,0,3,1,3,0,1,0,76.14,68.02 ,33.33
03,012,01,001,0021,0,734,10,744,1082,0,3,1,3,0,1,0,76.14,68.76 ,33.33
03,012,01,001,0022,0,819,9,828,1250,0,3,1,3,0,1,0,76.14,66.24 ,33.33
03,012,01,001,0023,0,2342,24,2366,3617,0,3,1,3,0,1,0,76.14,65.41 ,33.33
03,012,01,001,0024,0,503,6,509,777,0,3,1,3,0,1,0,76.14,65.51 ,33.33
03,012,01,001,0025,0,2378,23,2401,3597,0,3,1,3,0,1,0,76.14,66.75 ,33.33
03,012,01,001,0026,0,2491,21,2512,4008,0,3,1,3,0,1,0,76.14,62.67 ,33.33
03,012,01,001,0027,0,3433,37,3470,5385,0,3,1,3,0,1,0,76.14,64.44 ,33.33
03,012,01,001,0028,0,2167,33,2200,3255,0,3,1,3,0,1,0,76.14,67.59 ,33.33
03,012,01,001,0029,0,670,7,677,980,0,3,1,3,0,1,0,76.14,69.08 ,33.33
03,012,01,001,0030,0,382,4,386,574,0,3,1,3,0,1,0,76.14,67.25 ,33.33
03,012,01,001,0031,0,1000,2,1002,1436,0,3,1,3,0,1,0,76.14,69.78 ,33.33
03,012,01,001,0032,0,1344,10,1354,2124,0,3,1,3,0,1,0,76.14,63.75 ,33.33
03,012,01,001,0033,0,3235,35,3270,4853,0,3,1,3,0,1,0,76.14,67.38 ,33.33
03,012,01,001,0034,0,2333,27,2360,3776,0,3,1,3,0,1,0,76.14,62.50 ,33.33
03,012,01,001,0035,0,2429,23,2452,3769,0,3,1,3,0,1,0,76.14,65.06 ,33.33
03,012,01,001,0036,0,1306,11,1317,2030,0,3,1,3,0,1,0,76.14,64.88 ,33.33
03,012,01,001,0037,0,1066,9,1075,1707,0,3,1,3,0,1,0,76.14,62.98 ,33.33
03,012,01,001,0038,0,1360,24,1384,2251,0,3,1,3,0,1,0,76.14,61.48 ,33.33
03,012,01,001,0039,0,2529,26,2555,3877,0,3,1,3,0,1,0,76.14,65.90 ,33.33
03,012,01,001,0040,0,2940,32,2972,4384,0,3,1,3,0,1,0,76.14,67.79 ,33.33
03,012,01,001,0041,0,575,6,581,849,0,3,1,3,0,1,0,76.14,68.43 ,33.33
03,012,01,001,0042,0,1245,17,1262,1973,0,3,1,3,0,1,0,76.14,63.96 ,33.33
03,012,01,001,0043,0,2569,30,2599,3862,0,3,1,3,0,1,0,76.14,67.30 ,33.33
03,012,01,001,0044,0,1701,14,1715,2344,0,3,1,3,0,1,0,76.14,73.17 ,33.33
03,012,01,001,0045,0,2473,25,2498,3880,0,3,1,3,0,1,0,76.14,64.38 ,33.33
03,012,01,001,0046,0,2184,21,2205,3556,0,3,1,3,0,1,0,76.14,62.01 ,33.33
03,012,01,001,0047,0,1562,17,1579,2607,0,3,1,3,0,1,0,76.14,60.57 ,33.33
03,012,01,001,0048,0,1289,24,1313,2060,0,3,1,3,0,1,0,76.14,63.74 ,33.33
03,012,01,001,0049,0,1262,16,1278,1968,0,3,1,3,0,1,0,76.14,64.94 ,33.33
03,012,01,001,0050,0,2294,33,2327,3712,0,3,1,3,0,1,0,76.14,62.69 ,33.33
03,012,01,001,0051,0,1466,11,1477,2290,0,3,1,3,0,1,0,76.14,64.50 ,33.33
03,012,01,001,0052,0,1141,16,1157,1887,0,3,1,3,0,1,0,76.14,61.31 ,33.33
03,012,01,001,0053,0,1528,16,1544,2567,0,3,1,3,0,1,0,76.14,60.15 ,33.33
03,012,01,001,0054,0,1961,19,1980,3218,0,3,1,3,0,1,0,76.14,61.53 ,33.33
03,012,01,001,0055,0,2298,17,2315,3483,0,3,1,3,0,1,0,76.14,66.47 ,33.33
03,012,01,001,0056,0,1805,19,1824,2859,0,3,1,3,0,1,0,76.14,63.80 ,33.33
03,012,01,001,0057,0,2031,23,2054,3347,0,3,1,3,0,1,0,76.14,61.37 ,33.33
03,012,01,001,0058,0,3563,43,3606,5851,0,3,1,3,0,1,0,76.14,61.63 ,33.33
03,012,01,001,0059,0,1879,14,1893,3254,0,3,1,3,0,1,0,76.14,58.17 ,33.33
03,012,01,001,0060,0,1206,22,1228,1863,0,3,1,3,0,1,0,76.14,65.92 ,33.33
03,012,01,001,0061,0,2377,33,2410,3904,0,3,1,3,0,1,0,76.14,61.73 ,33.33
03,012,01,001,0062,0,1652,22,1674,2710,0,3,1,3,0,1,0,76.14,61.77 ,33.33
03,012,01,001,0063,0,3639,37,3676,5979,0,3,1,3,0,1,0,76.14,61.48 ,33.33
03,012,01,001,0064,0,1905,22,1927,3155,0,3,1,3,0,1,0,76.14,61.08 ,33.33
03,012,01,001,0065,0,1853,24,1877,3091,0,3,1,3,0,1,0,76.14,60.72 ,33.33
03,012,01,001,0066,0,1554,31,1585,2599,0,3,1,3,0,1,0,76.14,60.98 ,33.33
03,012,01,001,0067,0,2455,32,2487,3909,0,3,1,3,0,1,0,76.14,63.62 ,33.33
03,012,01,001,0068,0,1267,19,1286,1946,0,3,1,3,0,1,0,76.14,66.08 ,33.33
03,012,01,001,0069,0,2432,30,2462,4357,0,3,1,3,0,1,0,76.14,56.51 ,33.33
03,012,01,001,0070,0,1161,8,1169,1894,0,3,1,3,0,1,0,76.14,61.72 ,33.33
03,012,01,001,0071,0,1578,19,1597,2547,0,3,1,3,0,1,0,76.14,62.70 ,33.33
03,012,01,001,0072,0,2216,26,2242,3488,0,3,1,3,0,1,0,76.14,64.28 ,33.33
03,012,01,001,0073,0,2163,32,2195,3402,0,3,1,3,0,1,0,76.14,64.52 ,33.33
03,012,01,001,0074,0,2010,25,2035,3190,0,3,1,3,0,1,0,76.14,63.79 ,33.33
03,012,01,001,0075,0,2014,23,2037,2995,0,3,1,3,0,1,0,76.14,68.01 ,33.33
03,012,01,001,0076,0,3248,38,3286,5223,0,3,1,3,0,1,0,76.14,62.91 ,33.33
03,012,01,001,0077,0,1428,17,1445,2441,0,3,1,3,0,1,0,76.14,59.20 ,33.33
03,012,01,001,0078,0,1649,22,1671,2740,0,3,1,3,0,1,0,76.14,60.99 ,33.33
03,012,01,002,0079,0,1768,17,1785,2525,0,3,1,3,0,1,0,76.14,70.69 ,33.33
03,012,01,002,0080,0,2029,25,2054,2941,0,3,1,3,0,1,0,76.14,69.84 ,33.33
03,012,01,002,0081,0,1408,13,1421,2078,0,3,1,3,0,1,0,76.14,68.38 ,33.33
03,012,01,002,0082,0,1628,16,1644,2475,0,3,1,3,0,1,0,76.14,66.42 ,33.33
03,012,01,002,0083,0,2112,20,2132,3209,0,3,1,3,0,1,0,76.14,66.44 ,33.33
03,012,01,002,0084,0,1123,18,1141,1807,0,3,1,3,0,1,0,76.14,63.14 ,33.33
03,012,01,002,0085,0,1495,20,1515,2337,0,3,1,3,0,1,0,76.14,64.83 ,33.33
03,012,01,002,0086,0,1727,21,1748,2555,0,3,1,3,0,1,0,76.14,68.41 ,33.33
03,012,01,002,0087,0,1205,16,1221,1738,0,3,1,3,0,1,0,76.14,70.25 ,33.33
03,012,01,002,0088,0,2040,18,2058,2943,0,3,1,3,0,1,0,76.14,69.93 ,33.33
03,012,01,002,0089,0,1970,22,1992,2843,0,3,1,3,0,1,0,76.14,70.07 ,33.33
03,012,01,002,0090,0,908,11,919,1224,0,3,1,3,0,1,0,76.14,75.08 ,33.33
03,012,01,002,0091,0,1153,12,1165,1623,0,3,1,3,0,1,0,76.14,71.78 ,33.33
03,012,01,002,0092,0,1340,14,1354,1950,0,3,1,3,0,1,0,76.14,69.44 ,33.33
03,012,01,002,0093,0,2256,29,2285,3414,0,3,1,3,0,1,0,76.14,66.93 ,33.33
03,012,01,002,0094,0,1129,12,1141,1640,0,3,1,3,0,1,0,76.14,69.57 ,33.33
03,012,01,002,0095,0,929,18,947,1282,0,3,1,3,0,1,0,76.14,73.87 ,33.33
03,012,01,002,0096,0,1810,18,1828,2697,0,3,1,3,0,1,0,76.14,67.78 ,33.33
03,012,01,002,0097,0,1164,12,1176,1704,0,3,1,3,0,1,0,76.14,69.01 ,33.33
03,012,01,002,0098,0,1190,12,1202,1692,0,3,1,3,0,1,0,76.14,71.04 ,33.33
03,012,01,002,0099,0,614,10,624,917,0,3,1,3,0,1,0,76.14,68.05 ,33.33
03,012,01,002,0100,0,449,15,464,704,0,3,1,3,0,1,0,76.14,65.91 ,33.33
03,012,01,002,0101,0,1339,17,1356,2130,0,3,1,3,0,1,0,76.14,63.66 ,33.33
03,012,01,002,0102,0,868,9,877,1461,0,3,1,3,0,1,0,76.14,60.03 ,33.33
03,012,01,003,0103,0,1334,19,1353,1975,0,3,1,3,0,1,0,76.14,68.51 ,33.33
03,012,01,003,0104,0,1011,13,1024,1386,0,3,1,3,0,1,0,76.14,73.88 ,33.33
03,012,01,003,0105,0,1069,8,1077,1492,0,3,1,3,0,1,0,76.14,72.18 ,33.33
03,012,01,003,0106,0,5242,57,5299,8124,0,3,1,3,0,1,0,76.14,65.23 ,33.33
03,012,01,003,0107,0,3119,62,3181,4989,0,3,1,3,0,1,0,76.14,63.76 ,33.33
03,012,01,003,0108,0,1316,14,1330,1965,0,3,1,3,0,1,0,76.14,67.68 ,33.33
03,012,01,003,0109,0,3673,50,3723,5530,0,3,1,3,0,1,0,76.14,67.32 ,33.33
03,012,01,003,0110,0,1669,20,1689,2357,0,3,1,3,0,1,0,76.14,71.66 ,33.33
03,012,01,003,0111,0,1422,20,1442,2001,0,3,1,3,0,1,0,76.14,72.06 ,33.33
03,012,01,003,0112,0,2563,37,2600,3566,0,3,1,3,0,1,0,76.14,72.91 ,33.33
03,012,01,003,0113,0,1780,21,1801,2596,0,3,1,3,0,1,0,76.14,69.38 ,33.33
03,012,01,003,0114,0,2007,21,2028,2958,0,3,1,3,0,1,0,76.14,68.56 ,33.33
03,012,01,003,0115,0,3787,36,3823,5858,0,3,1,3,0,1,0,76.14,65.26 ,33.33
03,012,01,003,0116,0,3543,33,3576,5496,0,3,1,3,0,1,0,76.14,65.07 ,33.33
03,012,01,003,0117,0,2957,20,2977,4410,0,3,1,3,0,1,0,76.14,67.51 ,33.33
03,012,01,003,0118,0,2540,23,2563,3853,0,3,1,3,0,1,0,76.14,66.52 ,33.33
03,012,01,003,0119,0,1385,6,1391,2031,0,3,1,3,0,1,0,76.14,68.49 ,33.33
03,012,01,003,0120,0,3281,30,3311,5331,0,3,1,3,0,1,0,76.14,62.11 ,33.33
03,012,01,003,0121,0,877,12,889,1272,0,3,1,3,0,1,0,76.14,69.89 ,33.33
03,012,01,003,0122,0,1991,23,2014,3422,0,3,1,3,0,1,0,76.14,58.85 ,33.33
03,012,01,003,0123,0,872,18,890,1367,0,3,1,3,0,1,0,76.14,65.11 ,33.33
03,012,01,003,0124,0,1152,17,1169,1727,0,3,1,3,0,1,0,76.14,67.69 ,33.33
03,012,01,003,0125,0,1803,16,1819,2540,0,3,1,3,0,1,0,76.14,71.61 ,33.33
03,012,01,003,0126,0,867,13,880,1219,0,3,1,3,0,1,0,76.14,72.19 ,33.33
03,012,01,003,0127,0,1927,15,1942,2920,0,3,1,3,0,1,0,76.14,66.51 ,33.33
03,012,01,003,0128,0,1176,11,1187,1758,0,3,1,3,0,1,0,76.14,67.52 ,33.33
03,012,01,004,0129,0,1331,15,1346,2050,0,3,1,3,0,1,0,76.14,65.66 ,33.33
03,012,01,004,0130,0,2577,40,2617,4022,0,3,1,3,0,1,0,76.14,65.07 ,33.33
03,012,01,004,0131,0,2770,38,2808,4011,0,3,1,3,0,1,0,76.14,70.01 ,33.33
03,012,01,004,0132,0,1492,12,1504,2146,0,3,1,3,0,1,0,76.14,70.08 ,33.33
03,012,01,004,0133,0,1586,15,1601,2233,0,3,1,3,0,1,0,76.14,71.70 ,33.33
03,012,01,004,0134,0,1089,13,1102,1551,0,3,1,3,0,1,0,76.14,71.05 ,33.33
03,012,01,004,0135,0,874,9,883,1226,0,3,1,3,0,1,0,76.14,72.02 ,33.33
03,012,01,004,0136,0,1153,11,1164,1566,0,3,1,3,0,1,0,76.14,74.33 ,33.33
03,012,01,004,0137,0,1573,15,1588,2168,0,3,1,3,0,1,0,76.14,73.25 ,33.33
03,012,01,004,0138,0,2111,16,2127,3097,0,3,1,3,0,1,0,76.14,68.68 ,33.33
03,012,01,004,0139,0,721,6,727,1061,0,3,1,3,0,1,0,76.14,68.52 ,33.33
03,012,01,004,0140,0,674,4,678,952,0,3,1,3,0,1,0,76.14,71.22 ,33.33
03,012,01,004,0141,0,689,12,701,988,0,3,1,3,0,1,0,76.14,70.95 ,33.33
03,012,01,004,0142,0,557,4,561,831,0,3,1,3,0,1,0,76.14,67.51 ,33.33
03,012,01,004,0143,0,916,7,923,1328,0,3,1,3,0,1,0,76.14,69.50 ,33.33
03,012,01,004,0144,0,1220,10,1230,1765,0,3,1,3,0,1,0,76.14,69.69 ,33.33
03,012,01,004,0145,0,1164,5,1169,1905,0,3,1,3,0,1,0,76.14,61.36 ,33.33
03,012,01,004,0146,0,450,6,456,631,0,3,1,3,0,1,0,76.14,72.27 ,33.33
03,012,01,005,0147,0,623,15,638,965,0,3,1,3,0,1,0,76.14,66.11 ,33.33
03,012,01,005,0148,0,1302,21,1323,2018,0,3,1,3,0,1,0,76.14,65.56 ,33.33
03,012,01,005,0149,0,2639,30,2669,3977,0,3,1,3,0,1,0,76.14,67.11 ,33.33
03,012,01,005,0150,0,1697,12,1709,2501,0,3,1,3,0,1,0,76.14,68.33 ,33.33
03,012,01,005,0151,0,1717,17,1734,2533,0,3,1,3,0,1,0,76.14,68.46 ,33.33
03,012,01,005,0152,0,3040,34,3074,4536,0,3,1,3,0,1,0,76.14,67.77 ,33.33
03,012,01,005,0153,0,2223,25,2248,3488,0,3,1,3,0,1,0,76.14,64.45 ,33.33
03,012,01,005,0154,0,1827,23,1850,2740,0,3,1,3,0,1,0,76.14,67.52 ,33.33
03,012,01,005,0155,0,1030,18,1048,1449,0,3,1,3,0,1,0,76.14,72.33 ,33.33
03,012,01,006,0156,0,2677,31,2708,4022,0,3,1,3,0,1,0,76.14,67.33 ,33.33
03,012,01,006,0157,0,2838,29,2867,4521,0,3,1,3,0,1,0,76.14,63.42 ,33.33
03,012,01,006,0158,0,1317,15,1332,2064,0,3,1,3,0,1,0,76.14,64.53 ,33.33
03,012,01,006,0159,0,1474,22,1496,2165,0,3,1,3,0,1,0,76.14,69.10 ,33.33
03,012,01,006,0160,0,780,12,792,1264,0,3,1,3,0,1,0,76.14,62.66 ,33.33
03,012,01,006,0161,0,2949,42,2991,4894,0,3,1,3,0,1,0,76.14,61.12 ,33.33
03,012,01,006,0162,0,1347,24,1371,2126,0,3,1,3,0,1,0,76.14,64.49 ,33.33
03,012,01,006,0163,0,1175,26,1201,1698,0,3,1,3,0,1,0,76.14,70.73 ,33.33
03,012,01,006,0164,0,994,14,1008,1622,0,3,1,3,0,1,0,76.14,62.15 ,33.33
03,012,01,006,0165,0,1167,23,1190,1816,0,3,1,3,0,1,0,76.14,65.53 ,33.33
03,012,01,006,0166,0,1135,13,1148,1794,0,3,1,3,0,1,0,76.14,63.99 ,33.33
03,012,01,006,0167,0,1839,18,1857,2879,0,3,1,3,0,1,0,76.14,64.50 ,33.33
03,012,01,006,0168,0,767,7,774,1217,0,3,1,3,0,1,0,76.14,63.60 ,33.33
03,012,01,006,0169,0,1633,25,1658,2521,0,3,1,3,0,1,0,76.14,65.77 ,33.33
03,012,01,006,0170,0,1745,20,1765,2671,0,3,1,3,0,1,0,76.14,66.08 ,33.33
03,012,01,006,0171,0,412,6,418,571,0,3,1,3,0,1,0,76.14,73.20 ,33.33
03,012,01,007,0172,0,4365,49,4414,7065,0,3,1,3,0,1,0,76.14,62.48 ,33.33
03,012,01,007,0173,0,1622,23,1645,2456,0,3,1,3,0,1,0,76.14,66.98 ,33.33
03,012,01,007,0174,0,4308,53,4361,7032,0,3,1,3,0,1,0,76.14,62.02 ,33.33
03,012,01,007,0175,0,1932,29,1961,2762,0,3,1,3,0,1,0,76.14,71.00 ,33.33
03,012,01,007,0176,0,3765,46,3811,5571,0,3,1,3,0,1,0,76.14,68.41 ,33.33
03,012,01,007,0177,0,2125,26,2151,3079,0,3,1,3,0,1,0,76.14,69.86 ,33.33
03,012,01,007,0178,0,451,5,456,657,0,3,1,3,0,1,0,76.14,69.41 ,33.33
03,012,01,008,0179,0,2342,19,2361,3636,0,3,1,3,0,1,0,76.14,64.93 ,33.33
03,012,01,008,0180,0,865,7,872,1273,0,3,1,3,0,1,0,76.14,68.50 ,33.33
03,012,01,008,0181,0,1873,25,1898,2932,0,3,1,3,0,1,0,76.14,64.73 ,33.33
03,012,01,008,0182,0,822,7,829,1235,0,3,1,3,0,1,0,76.14,67.13 ,33.33
03,012,01,008,0183,0,830,11,841,1219,0,3,1,3,0,1,0,76.14,68.99 ,33.33
03,012,01,008,0184,0,853,9,862,1212,0,3,1,3,0,1,0,76.14,71.12 ,33.33
03,012,01,008,0185,0,1819,16,1835,2891,0,3,1,3,0,1,0,76.14,63.47 ,33.33
03,012,01,008,0186,0,1811,18,1829,2865,0,3,1,3,0,1,0,76.14,63.84 ,33.33
03,012,01,008,0187,0,1839,18,1857,2744,0,3,1,3,0,1,0,76.14,67.67 ,33.33
03,012,01,008,0188,0,2547,31,2578,3976,0,3,1,3,0,1,0,76.14,64.84 ,33.33
03,012,01,008,0189,0,2208,26,2234,3349,0,3,1,3,0,1,0,76.14,66.71 ,33.33
03,012,01,008,0190,0,415,3,418,572,0,3,1,3,0,1,0,76.14,73.08 ,33.33
03,012,01,008,0191,0,1596,30,1626,2449,0,3,1,3,0,1,0,76.14,66.39 ,33.33
03,012,01,008,0192,0,1182,20,1202,1743,0,3,1,3,0,1,0,76.14,68.96 ,33.33
03,012,01,008,0193,0,2233,17,2250,3260,0,3,1,3,0,1,0,76.14,69.02 ,33.33
03,012,01,008,0194,0,2013,23,2036,3084,0,3,1,3,0,1,0,76.14,66.02 ,33.33
03,012,01,008,0195,0,973,6,979,1360,0,3,1,3,0,1,0,76.14,71.99 ,33.33
03,012,01,008,0196,0,2940,36,2976,4649,0,3,1,3,0,1,0,76.14,64.01 ,33.33
03,012,01,008,0197,0,1285,14,1299,1925,0,3,1,3,0,1,0,76.14,67.48 ,33.33
03,012,01,008,0198,0,934,9,943,1357,0,3,1,3,0,1,0,76.14,69.49 ,33.33
03,012,01,008,0199,0,658,5,663,872,0,3,1,3,0,1,0,76.14,76.03 ,33.33
03,012,01,008,0200,0,874,7,881,1215,0,3,1,3,0,1,0,76.14,72.51 ,33.33
03,012,01,008,0201,0,747,8,755,1035,0,3,1,3,0,1,0,76.14,72.95 ,33.33
03,012,01,008,0202,0,2128,27,2155,3180,0,3,1,3,0,1,0,76.14,67.77 ,33.33
03,012,01,008,0203,0,1177,15,1192,1624,0,3,1,3,0,1,0,76.14,73.40 ,33.33
03,012,01,008,0204,0,555,18,573,737,0,3,1,3,0,1,0,76.14,77.75 ,33.33
03,012,01,008,0205,0,1077,11,1088,1341,0,3,1,3,0,1,0,76.14,81.13 ,33.33
03,012,01,008,0206,0,539,6,545,731,0,3,1,3,0,1,0,76.14,74.56 ,33.33
03,012,01,008,0207,0,594,12,606,869,0,3,1,3,0,1,0,76.14,69.74 ,33.33
03,012,01,008,0208,0,286,2,288,430,0,3,1,3,0,1,0,76.14,66.98 ,33.33
03,012,01,008,0209,0,613,11,624,916,0,3,1,3,0,1,0,76.14,68.12 ,33.33
03,012,01,008,0210,0,1433,19,1452,2124,0,3,1,3,0,1,0,76.14,68.36 ,33.33
03,012,01,008,0211,0,929,12,941,1361,0,3,1,3,0,1,0,76.14,69.14 ,33.33
03,012,01,008,0212,0,869,13,882,1194,0,3,1,3,0,1,0,76.14,73.87 ,33.33
03,012,01,008,0213,0,286,9,295,450,0,3,1,3,0,1,0,76.14,65.56 ,33.33
03,012,01,009,0214,0,1107,15,1122,1620,0,3,1,3,0,1,0,76.14,69.26 ,33.33
03,012,01,009,0215,0,592,15,607,881,0,3,1,3,0,1,0,76.14,68.90 ,33.33
03,012,01,009,0216,0,186,1,187,258,0,3,1,3,0,1,0,76.14,72.48 ,33.33
03,012,01,009,0217,0,1452,12,1464,2137,0,3,1,3,0,1,0,76.14,68.51 ,33.33
03,012,01,009,0218,0,1410,17,1427,2134,0,3,1,3,0,1,0,76.14,66.87 ,33.33
03,012,01,009,0219,0,2140,24,2164,3167,0,3,1,3,0,1,0,76.14,68.33 ,33.33
03,012,01,009,0220,0,960,14,974,1282,0,3,1,3,0,1,0,76.14,75.98 ,33.33
03,012,01,009,0221,0,1295,25,1320,1907,0,3,1,3,0,1,0,76.14,69.22 ,33.33
03,012,01,009,0222,0,1462,24,1486,2034,0,3,1,3,0,1,0,76.14,73.06 ,33.33
03,012,01,009,0223,0,781,10,791,1069,0,3,1,3,0,1,0,76.14,73.99 ,33.33
03,012,01,009,0224,0,1790,28,1818,2629,0,3,1,3,0,1,0,76.14,69.15 ,33.33
03,012,01,009,0225,0,1322,14,1336,1846,0,3,1,3,0,1,0,76.14,72.37 ,33.33
03,012,01,009,0226,0,1071,20,1091,1467,0,3,1,3,0,1,0,76.14,74.37 ,33.33
03,012,01,009,0227,0,1529,23,1552,2116,0,3,1,3,0,1,0,76.14,73.35 ,33.33
03,012,01,009,0228,0,726,9,735,1023,0,3,1,3,0,1,0,76.14,71.85 ,33.33
03,012,01,009,0229,0,1067,17,1084,1413,0,3,1,3,0,1,0,76.14,76.72 ,33.33
03,012,01,009,0230,0,432,2,434,647,0,3,1,3,0,1,0,76.14,67.08 ,33.33
03,012,01,010,0231,0,317,1,318,432,0,3,1,3,0,1,0,76.14,73.61 ,33.33
03,012,01,010,0232,0,802,16,818,1113,0,3,1,3,0,1,0,76.14,73.50 ,33.33
03,012,01,010,0233,0,1654,16,1670,2208,0,3,1,3,0,1,0,76.14,75.63 ,33.33
03,012,01,010,0234,0,2113,11,2124,2969,0,3,1,3,0,1,0,76.14,71.54 ,33.33
03,012,01,010,0235,0,1889,22,1911,2621,0,3,1,3,0,1,0,76.14,72.91 ,33.33
03,012,01,010,0236,0,1213,13,1226,1724,0,3,1,3,0,1,0,76.14,71.11 ,33.33
03,012,01,010,0237,0,2752,62,2814,4037,0,3,1,3,0,1,0,76.14,69.71 ,33.33
03,012,01,010,0238,0,1521,29,1550,2135,0,3,1,3,0,1,0,76.14,72.60 ,33.33
03,012,01,010,0239,0,1567,26,1593,2252,0,3,1,3,0,1,0,76.14,70.74 ,33.33
03,012,01,010,0240,0,1206,16,1222,1764,0,3,1,3,0,1,0,76.14,69.27 ,33.33
03,012,01,010,0241,0,1701,30,1731,2429,0,3,1,3,0,1,0,76.14,71.26 ,33.33
03,012,01,011,0242,0,243,1,244,356,0,3,1,3,0,1,0,76.14,68.54 ,33.33
03,012,01,011,0243,0,428,6,434,672,0,3,1,3,0,1,0,76.14,64.58 ,33.33
03,012,01,011,0244,0,718,10,728,966,0,3,1,3,0,1,0,76.14,75.36 ,33.33
03,012,01,011,0245,0,278,5,283,437,0,3,1,3,0,1,0,76.14,64.76 ,33.33
03,012,01,011,0246,0,570,14,584,898,0,3,1,3,0,1,0,76.14,65.03 ,33.33
03,012,01,011,0247,0,919,14,933,1352,0,3,1,3,0,1,0,76.14,69.01 ,33.33
03,012,01,011,0248,0,299,1,300,417,0,3,1,3,0,1,0,76.14,71.94 ,33.33
03,012,01,011,0249,0,295,2,297,452,0,3,1,3,0,1,0,76.14,65.71 ,33.33
03,012,01,011,0250,0,639,4,643,921,0,3,1,3,0,1,0,76.14,69.82 ,33.33
03,012,01,011,0251,0,984,17,1001,1332,0,3,1,3,0,1,0,76.14,75.15 ,33.33
03,012,01,012,0252,0,2639,20,2659,4021,0,3,1,3,0,1,0,76.14,66.13 ,33.33
03,012,01,012,0253,0,1793,22,1815,2647,0,3,1,3,0,1,0,76.14,68.57 ,33.33
03,012,01,012,0254,0,1648,18,1666,2508,0,3,1,3,0,1,0,76.14,66.43 ,33.33
03,012,01,012,0255,0,1334,14,1348,1990,0,3,1,3,0,1,0,76.14,67.74 ,33.33
03,012,01,012,0256,0,875,11,886,1289,0,3,1,3,0,1,0,76.14,68.74 ,33.33
03,012,01,012,0257,0,804,14,818,1279,0,3,1,3,0,1,0,76.14,63.96 ,33.33
03,012,01,012,0258,0,1218,15,1233,1911,0,3,1,3,0,1,0,76.14,64.52 ,33.33
03,012,01,012,0259,0,837,11,848,1125,0,3,1,3,0,1,0,76.14,75.38 ,33.33
03,012,01,012,0260,0,1296,16,1312,1809,0,3,1,3,0,1,0,76.14,72.53 ,33.33
03,012,01,012,0261,0,481,7,488,701,0,3,1,3,0,1,0,76.14,69.61 ,33.33
03,012,01,012,0262,0,1122,17,1139,1575,0,3,1,3,0,1,0,76.14,72.32 ,33.33
03,012,01,012,0263,0,686,12,698,967,0,3,1,3,0,1,0,76.14,72.18 ,33.33
03,012,01,013,0264,0,1176,16,1192,1704,0,3,1,3,0,1,0,76.14,69.95 ,33.33
03,012,01,013,0265,0,1801,22,1823,2465,0,3,1,3,0,1,0,76.14,73.96 ,33.33
03,012,01,013,0266,0,2085,46,2131,2912,0,3,1,3,0,1,0,76.14,73.18 ,33.33
03,012,01,013,0267,0,1318,10,1328,1937,0,3,1,3,0,1,0,76.14,68.56 ,33.33
03,012,01,013,0268,0,1079,12,1091,1599,0,3,1,3,0,1,0,76.14,68.23 ,33.33
03,012,01,013,0269,0,641,5,646,897,0,3,1,3,0,1,0,76.14,72.02 ,33.33
03,012,01,013,0270,0,1518,21,1539,2217,0,3,1,3,0,1,0,76.14,69.42 ,33.33
03,012,01,013,0271,0,2183,26,2209,3393,0,3,1,3,0,1,0,76.14,65.10 ,33.33
03,012,01,013,0272,0,1713,15,1728,2711,0,3,1,3,0,1,0,76.14,63.74 ,33.33
03,012,01,013,0273,0,1777,5,1782,2621,0,3,1,3,0,1,0,76.14,67.99 ,33.33
03,012,01,013,0274,0,1429,21,1450,2027,0,3,1,3,0,1,0,76.14,71.53 ,33.33
03,012,01,013,0275,0,1391,14,1405,2073,0,3,1,3,0,1,0,76.14,67.78 ,33.33
03,012,01,013,0276,0,1797,23,1820,2584,0,3,1,3,0,1,0,76.14,70.43 ,33.33
03,012,01,013,0277,0,1526,11,1537,2448,0,3,1,3,0,1,0,76.14,62.79 ,33.33
03,012,01,013,0278,0,826,7,833,1165,0,3,1,3,0,1,0,76.14,71.50 ,33.33
03,012,01,013,0279,0,761,11,772,1153,0,3,1,3,0,1,0,76.14,66.96 ,33.33
03,012,01,013,0280,0,664,8,672,916,0,3,1,3,0,1,0,76.14,73.36 ,33.33
03,012,01,013,0281,0,796,7,803,1061,0,3,1,3,0,1,0,76.14,75.68 ,33.33
03,012,01,013,0282,0,629,6,635,852,0,3,1,3,0,1,0,76.14,74.53 ,33.33
03,012,01,013,0283,0,975,10,985,1425,0,3,1,3,0,1,0,76.14,69.12 ,33.33
03,012,01,014,0284,0,1671,17,1688,2497,0,3,1,3,0,1,0,76.14,67.60 ,33.33
03,012,01,014,0285,0,723,16,739,1048,0,3,1,3,0,1,0,76.14,70.52 ,33.33
03,012,01,014,0286,0,2785,37,2822,4472,0,3,1,3,0,1,0,76.14,63.10 ,33.33
03,012,01,014,0287,0,1097,16,1113,1710,0,3,1,3,0,1,0,76.14,65.09 ,33.33
03,012,01,014,0288,0,790,12,802,1167,0,3,1,3,0,1,0,76.14,68.72 ,33.33
03,012,01,014,0289,0,679,5,684,1081,0,3,1,3,0,1,0,76.14,63.27 ,33.33
03,012,01,014,0290,0,549,8,557,838,0,3,1,3,0,1,0,76.14,66.47 ,33.33
03,012,01,014,0291,0,961,15,976,1573,0,3,1,3,0,1,0,76.14,62.05 ,33.33
03,012,01,014,0292,0,1121,20,1141,1772,0,3,1,3,0,1,0,76.14,64.39 ,33.33
03,012,01,014,0293,0,783,13,796,1157,0,3,1,3,0,1,0,76.14,68.80 ,33.33
03,012,01,014,0294,0,1276,20,1296,2019,0,3,1,3,0,1,0,76.14,64.19 ,33.33
03,012,01,014,0295,0,551,15,566,992,0,3,1,3,0,1,0,76.14,57.06 ,33.33
03,012,01,014,0296,0,478,4,482,739,0,3,1,3,0,1,0,76.14,65.22 ,33.33
03,012,01,015,0297,0,736,13,749,1056,0,3,1,3,0,1,0,76.14,70.93 ,33.33
03,012,01,015,0298,0,606,6,612,878,0,3,1,3,0,1,0,76.14,69.70 ,33.33
03,012,01,015,0299,0,1053,12,1065,1563,0,3,1,3,0,1,0,76.14,68.14 ,33.33
03,012,01,015,0300,0,1720,16,1736,2790,0,3,1,3,0,1,0,76.14,62.22 ,33.33
03,012,01,015,0301,0,910,5,915,1392,0,3,1,3,0,1,0,76.14,65.73 ,33.33
03,012,01,015,0302,0,1168,9,1177,1853,0,3,1,3,0,1,0,76.14,63.52 ,33.33
03,012,01,015,0303,0,755,8,763,1194,0,3,1,3,0,1,0,76.14,63.90 ,33.33
03,012,01,015,0304,0,659,5,664,1006,0,3,1,3,0,1,0,76.14,66.00 ,33.33
03,012,01,015,0305,0,791,10,801,1270,0,3,1,3,0,1,0,76.14,63.07 ,33.33
03,012,01,015,0306,0,868,18,886,1304,0,3,1,3,0,1,0,76.14,67.94 ,33.33
03,012,01,015,0307,0,1782,21,1803,2903,0,3,1,3,0,1,0,76.14,62.11 ,33.33
03,012,01,015,0308,0,766,8,774,1205,0,3,1,3,0,1,0,76.14,64.23 ,33.33
03,012,01,015,0309,0,680,5,685,1053,0,3,1,3,0,1,0,76.14,65.05 ,33.33
03,012,01,015,0310,0,774,7,781,1239,0,3,1,3,0,1,0,76.14,63.03 ,33.33
03,012,01,015,0311,0,2151,26,2177,3359,0,3,1,3,0,1,0,76.14,64.81 ,33.33
03,012,01,016,0312,0,1055,16,1071,1528,0,3,1,3,0,1,0,76.14,70.09 ,33.33
03,012,01,016,0313,0,1165,8,1173,1731,0,3,1,3,0,1,0,76.14,67.76 ,33.33
03,012,01,016,0314,0,1634,12,1646,2370,0,3,1,3,0,1,0,76.14,69.45 ,33.33
03,012,01,016,0315,0,255,1,256,416,0,3,1,3,0,1,0,76.14,61.54 ,33.33
03,012,01,016,0316,0,1450,18,1468,2089,0,3,1,3,0,1,0,76.14,70.27 ,33.33
03,012,01,016,0317,0,1702,19,1721,2535,0,3,1,3,0,1,0,76.14,67.89 ,33.33
03,012,01,017,0318,0,1144,12,1156,1472,0,3,1,3,0,1,0,76.14,78.53 ,33.33
03,012,01,017,0319,0,1316,12,1328,1788,0,3,1,3,0,1,0,76.14,74.27 ,33.33
03,012,01,017,0320,0,1385,29,1414,1878,0,3,1,3,0,1,0,76.14,75.29 ,33.33
03,012,01,017,0321,0,736,8,744,961,0,3,1,3,0,1,0,76.14,77.42 ,33.33
03,012,01,017,0322,0,773,11,784,1051,0,3,1,3,0,1,0,76.14,74.60 ,33.33
03,012,01,017,0323,0,1357,8,1365,1841,0,3,1,3,0,1,0,76.14,74.14 ,33.33
03,012,01,017,0324,0,420,6,426,574,0,3,1,3,0,1,0,76.14,74.22 ,33.33
03,012,01,017,0325,0,556,3,559,728,0,3,1,3,0,1,0,76.14,76.79 ,33.33
03,012,01,017,0326,0,1125,6,1131,1553,0,3,1,3,0,1,0,76.14,72.83 ,33.33
03,012,01,017,0327,0,582,19,601,842,0,3,1,3,0,1,0,76.14,71.38 ,33.33
03,012,01,017,0328,0,775,6,781,964,0,3,1,3,0,1,0,76.14,81.02 ,33.33
03,012,01,017,0329,0,1499,15,1514,1991,0,3,1,3,0,1,0,76.14,76.04 ,33.33
03,012,01,018,0330,0,1271,20,1291,1903,0,3,1,3,0,1,0,76.14,67.84 ,33.33
03,012,01,018,0331,0,1342,13,1355,1982,0,3,1,3,0,1,0,76.14,68.37 ,33.33
03,012,01,018,0332,0,1572,16,1588,2270,0,3,1,3,0,1,0,76.14,69.96 ,33.33
03,012,01,018,0333,0,790,4,794,1058,0,3,1,3,0,1,0,76.14,75.05 ,33.33
03,012,01,018,0334,0,718,15,733,1055,0,3,1,3,0,1,0,76.14,69.48 ,33.33
03,012,01,018,0335,0,699,5,704,936,0,3,1,3,0,1,0,76.14,75.21 ,33.33
03,012,01,018,0336,0,2267,29,2296,3371,0,3,1,3,0,1,0,76.14,68.11 ,33.33
03,012,01,018,0337,0,1287,9,1296,1905,0,3,1,3,0,1,0,76.14,68.03 ,33.33
03,012,01,018,0338,0,1553,17,1570,2357,0,3,1,3,0,1,0,76.14,66.61 ,33.33
03,012,01,018,0339,0,427,5,432,660,0,3,1,3,0,1,0,76.14,65.45 ,33.33
03,012,01,018,0340,0,1595,13,1608,2349,0,3,1,3,0,1,0,76.14,68.45 ,33.33
03,012,01,018,0341,0,1475,18,1493,2364,0,3,1,3,0,1,0,76.14,63.16 ,33.33
03,012,01,018,0342,0,937,13,950,1526,0,3,1,3,0,1,0,76.14,62.25 ,33.33
03,012,01,018,0343,0,1440,19,1459,2171,0,3,1,3,0,1,0,76.14,67.20 ,33.33
03,012,01,018,0344,0,1643,23,1666,2396,0,3,1,3,0,1,0,76.14,69.53 ,33.33
03,012,01,019,0345,0,1397,16,1413,2296,0,3,1,3,0,1,0,76.14,61.54 ,33.33
03,012,01,019,0346,0,1621,17,1638,2434,0,3,1,3,0,1,0,76.14,67.30 ,33.33
03,012,01,019,0347,0,581,3,584,885,0,3,1,3,0,1,0,76.14,65.99 ,33.33
03,012,01,019,0348,0,417,5,422,605,0,3,1,3,0,1,0,76.14,69.75 ,33.33
03,012,01,019,0349,0,561,6,567,807,0,3,1,3,0,1,0,76.14,70.26 ,33.33
03,012,01,019,0350,0,496,6,502,736,0,3,1,3,0,1,0,76.14,68.21 ,33.33
03,012,01,019,0351,0,350,1,351,527,0,3,1,3,0,1,0,76.14,66.60 ,33.33
03,012,01,019,0352,0,1187,10,1197,1888,0,3,1,3,0,1,0,76.14,63.40 ,33.33
03,012,01,019,0353,0,1864,15,1879,2955,0,3,1,3,0,1,0,76.14,63.59 ,33.33
03,012,01,019,0354,0,1178,15,1193,1926,0,3,1,3,0,1,0,76.14,61.94 ,33.33
03,012,01,019,0355,0,1189,15,1204,1919,0,3,1,3,0,1,0,76.14,62.74 ,33.33
03,012,01,019,0356,0,1039,13,1052,1533,0,3,1,3,0,1,0,76.14,68.62 ,33.33
03,012,01,019,0357,0,1005,12,1017,1538,0,3,1,3,0,1,0,76.14,66.12 ,33.33
03,012,01,019,0358,0,703,8,711,984,0,3,1,3,0,1,0,76.14,72.26 ,33.33
03,012,01,019,0359,0,634,8,642,903,0,3,1,3,0,1,0,76.14,71.10 ,33.33
03,012,01,019,0360,0,950,13,963,1346,0,3,1,3,0,1,0,76.14,71.55 ,33.33
03,012,01,019,0361,0,708,3,711,931,0,3,1,3,0,1,0,76.14,76.37 ,33.33
03,012,01,019,0362,0,1019,14,1033,1371,0,3,1,3,0,1,0,76.14,75.35 ,33.33
03,012,01,019,0363,0,669,12,681,896,0,3,1,3,0,1,0,76.14,76.00 ,33.33
03,012,01,019,0364,0,1663,23,1686,2377,0,3,1,3,0,1,0,76.14,70.93 ,33.33
03,012,01,019,0365,0,1221,13,1234,1881,0,3,1,3,0,1,0,76.14,65.60 ,33.33
03,012,01,019,0366,0,453,1,454,655,0,3,1,3,0,1,0,76.14,69.31 ,33.33
03,012,01,019,0367,0,281,0,281,376,0,3,1,3,0,1,0,76.14,74.73 ,33.33
03,012,01,019,0368,0,431,3,434,602,0,3,1,3,0,1,0,76.14,72.09 ,33.33
03,012,01,019,0369,0,147,0,147,205,0,3,1,3,0,1,0,76.14,71.71 ,33.33
03,012,01,020,0370,0,1141,17,1158,1763,0,3,1,3,0,1,0,76.14,65.68 ,33.33
03,012,01,020,0371,0,899,11,910,1397,0,3,1,3,0,1,0,76.14,65.14 ,33.33
03,012,01,020,0372,0,934,6,940,1438,0,3,1,3,0,1,0,76.14,65.37 ,33.33
03,012,01,020,0373,0,1428,20,1448,2248,0,3,1,3,0,1,0,76.14,64.41 ,33.33
03,012,01,020,0374,0,1402,19,1421,2211,0,3,1,3,0,1,0,76.14,64.27 ,33.33
03,012,01,020,0375,0,1563,18,1581,2477,0,3,1,3,0,1,0,76.14,63.83 ,33.33
03,012,01,020,0376,0,1609,15,1624,2509,0,3,1,3,0,1,0,76.14,64.73 ,33.33
03,012,01,020,0377,0,1297,16,1313,2045,0,3,1,3,0,1,0,76.14,64.21 ,33.33
03,012,01,020,0378,0,1046,13,1059,1492,0,3,1,3,0,1,0,76.14,70.98 ,33.33
03,012,01,020,0379,0,1124,12,1136,1719,0,3,1,3,0,1,0,76.14,66.08 ,33.33
03,012,01,020,0380,0,923,8,931,1423,0,3,1,3,0,1,0,76.14,65.43 ,33.33
03,012,01,020,0381,0,1268,21,1289,1989,0,3,1,3,0,1,0,76.14,64.81 ,33.33
03,012,01,020,0382,0,1055,12,1067,1663,0,3,1,3,0,1,0,76.14,64.16 ,33.33
03,012,01,020,0383,0,1404,22,1426,2191,0,3,1,3,0,1,0,76.14,65.08 ,33.33
03,012,01,020,0384,0,1581,19,1600,2352,0,3,1,3,0,1,0,76.14,68.03 ,33.33
03,012,01,020,0385,0,1092,10,1102,1620,0,3,1,3,0,1,0,76.14,68.02 ,33.33
03,012,01,020,0386,0,921,9,930,1426,0,3,1,3,0,1,0,76.14,65.22 ,33.33
03,012,01,020,0387,0,777,10,787,1212,0,3,1,3,0,1,0,76.14,64.93 ,33.33
03,012,01,020,0388,0,1049,6,1055,1758,0,3,1,3,0,1,0,76.14,60.01 ,33.33
03,012,01,021,0389,0,642,18,660,1073,0,3,1,3,0,1,0,76.14,61.51 ,33.33
03,012,01,021,0390,0,795,12,807,1187,0,3,1,3,0,1,0,76.14,67.99 ,33.33
03,012,01,021,0391,0,867,15,882,1612,0,3,1,3,0,1,0,76.14,54.71 ,33.33
03,012,01,021,0392,0,818,13,831,1346,0,3,1,3,0,1,0,76.14,61.74 ,33.33
03,012,01,021,0393,0,558,11,569,926,0,3,1,3,0,1,0,76.14,61.45 ,33.33
03,012,01,021,0394,0,507,2,509,841,0,3,1,3,0,1,0,76.14,60.52 ,33.33
03,012,01,021,0395,0,439,8,447,759,0,3,1,3,0,1,0,76.14,58.89 ,33.33
03,012,01,021,0396,0,416,10,426,650,0,3,1,3,0,1,0,76.14,65.54 ,33.33
03,012,01,021,0397,0,241,2,243,359,0,3,1,3,0,1,0,76.14,67.69 ,33.33
03,012,01,021,0398,0,735,9,744,1390,0,3,1,3,0,1,0,76.14,53.53 ,33.33
03,012,01,021,0399,0,799,26,825,1537,0,3,1,3,0,1,0,76.14,53.68 ,33.33
03,012,01,021,0400,0,679,14,693,1090,0,3,1,3,0,1,0,76.14,63.58 ,33.33
03,012,01,022,0401,0,398,2,400,628,0,3,1,3,0,1,0,76.14,63.69 ,33.33
03,012,01,022,0402,0,787,9,796,1084,0,3,1,3,0,1,0,76.14,73.43 ,33.33
03,012,01,022,0403,0,550,9,559,849,0,3,1,3,0,1,0,76.14,65.84 ,33.33
03,012,01,022,0404,0,1009,28,1037,1601,0,3,1,3,0,1,0,76.14,64.77 ,33.33
03,012,01,022,0405,0,481,7,488,733,0,3,1,3,0,1,0,76.14,66.58 ,33.33
03,012,01,022,0406,0,472,4,476,726,0,3,1,3,0,1,0,76.14,65.56 ,33.33
03,012,01,022,0407,0,673,12,685,1129,0,3,1,3,0,1,0,76.14,60.67 ,33.33
03,012,01,023,0408,0,509,8,517,811,0,3,1,3,0,1,0,76.14,63.75 ,33.33
03,012,01,023,0409,0,439,5,444,788,0,3,1,3,0,1,0,76.14,56.35 ,33.33
03,012,01,023,0410,0,1035,15,1050,1930,0,3,1,3,0,1,0,76.14,54.40 ,33.33
03,012,01,023,0411,0,1114,16,1130,1823,0,3,1,3,0,1,0,76.14,61.99 ,33.33
03,012,01,023,0412,0,939,14,953,1531,0,3,1,3,0,1,0,76.14,62.25 ,33.33
03,012,01,023,0413,0,1080,8,1088,1819,0,3,1,3,0,1,0,76.14,59.81 ,33.33
03,012,01,023,0414,0,716,6,722,1348,0,3,1,3,0,1,0,76.14,53.56 ,33.33
03,012,01,024,0415,0,526,4,530,790,0,3,1,3,0,1,0,76.14,67.09 ,33.33
03,012,01,024,0416,0,623,15,638,1051,0,3,1,3,0,1,0,76.14,60.70 ,33.33
03,012,01,024,0417,0,317,5,322,492,0,3,1,3,0,1,0,76.14,65.45 ,33.33
03,012,01,024,0418,0,348,4,352,494,0,3,1,3,0,1,0,76.14,71.26 ,33.33
03,012,01,024,0419,0,699,12,711,1051,0,3,1,3,0,1,0,76.14,67.65 ,33.33
03,012,01,024,0420,0,1212,10,1222,1796,0,3,1,3,0,1,0,76.14,68.04 ,33.33
03,012,01,024,0421,0,455,6,461,609,0,3,1,3,0,1,0,76.14,75.70 ,33.33
03,012,01,024,0422,0,252,3,255,363,0,3,1,3,0,1,0,76.14,70.25 ,33.33
03,012,01,024,0423,0,279,2,281,382,0,3,1,3,0,1,0,76.14,73.56 ,33.33
03,012,01,024,0424,0,602,6,608,773,0,3,1,3,0,1,0,76.14,78.65 ,33.33
03,012,01,024,0425,0,448,6,454,643,0,3,1,3,0,1,0,76.14,70.61 ,33.33
03,012,01,024,0426,0,312,4,316,500,0,3,1,3,0,1,0,76.14,63.20 ,33.33
03,012,01,024,0427,0,772,6,778,1126,0,3,1,3,0,1,0,76.14,69.09 ,33.33
03,012,01,024,0428,0,666,3,669,977,0,3,1,3,0,1,0,76.14,68.47 ,33.33
03,012,01,024,0429,0,339,1,340,512,0,3,1,3,0,1,0,76.14,66.41 ,33.33
03,012,01,024,0430,0,473,5,478,688,0,3,1,3,0,1,0,76.14,69.48 ,33.33
03,012,01,024,0431,0,408,7,415,680,0,3,1,3,0,1,0,76.14,61.03 ,33.33
03,012,01,024,0432,0,404,3,407,623,0,3,1,3,0,1,0,76.14,65.33 ,33.33
03,012,01,025,0433,0,35,0,35,81,0,3,1,3,0,1,0,76.14,43.21 ,33.33
03,012,01,025,0434,0,11,0,11,23,0,3,1,3,0,1,0,76.14,47.83 ,33.33
03,012,01,025,0435,0,14,1,15,27,0,3,1,3,0,1,0,76.14,55.56 ,33.33
03,012,01,026,0436,0,28,1,29,53,0,3,1,3,0,1,0,76.14,54.72 ,33.33
03,012,01,026,0437,0,53,0,53,75,0,3,1,3,0,1,0,76.14,70.67 ,33.33
03,012,01,026,0438,0,33,3,36,71,0,3,1,3,0,1,0,76.14,50.70 ,33.33
03,012,01,026,0439,0,68,2,70,128,0,3,1,3,0,1,0,76.14,54.69 ,33.33
03,012,01,026,0440,0,7,0,7,14,0,3,1,3,0,1,0,76.14,50.00 ,33.33
03,012,01,026,0441,0,8,0,8,15,0,3,1,3,0,1,0,76.14,53.33 ,33.33
03,012,01,026,0442,0,6,0,6,12,0,3,1,3,0,1,0,76.14,50.00 ,33.33
03,012,01,026,0443,0,8,0,8,20,0,3,1,3,0,1,0,76.14,40.00 ,33.33
03,012,01,027,0444,0,54,0,54,171,0,3,1,3,0,1,0,76.14,31.58 ,33.33
03,012,01,027,0445,0,23,0,23,49,0,3,1,3,0,1,0,76.14,46.94 ,33.33
03,012,01,027,0446,0,63,1,64,113,0,3,1,3,0,1,0,76.14,56.64 ,33.33
03,013,01,001,0001,0,769,6,775,1186,0,3,1,3,0,1,0,76.14,65.35 ,33.33
03,013,01,001,0002,0,982,12,994,1488,0,3,1,3,0,1,0,76.14,66.80 ,33.33
03,013,01,001,0003,0,549,5,554,756,0,3,1,3,0,1,0,76.14,73.28 ,33.33
03,013,01,001,0004,0,901,8,909,1392,0,3,1,3,0,1,0,76.14,65.30 ,33.33
03,013,01,001,0005,0,1931,19,1950,2889,0,3,1,3,0,1,0,76.14,67.50 ,33.33
03,013,01,001,0006,0,952,10,962,1424,0,3,1,3,0,1,0,76.14,67.56 ,33.33
03,013,01,001,0007,0,621,6,627,890,0,3,1,3,0,1,0,76.14,70.45 ,33.33
03,013,01,001,0008,0,607,4,611,815,0,3,1,3,0,1,0,76.14,74.97 ,33.33
03,013,01,001,0009,0,832,10,842,1249,0,3,1,3,0,1,0,76.14,67.41 ,33.33
03,013,01,001,0010,0,597,5,602,890,0,3,1,3,0,1,0,76.14,67.64 ,33.33
03,013,01,001,0011,0,772,7,779,1088,0,3,1,3,0,1,0,76.14,71.60 ,33.33
03,013,01,001,0012,0,979,6,985,1524,0,3,1,3,0,1,0,76.14,64.63 ,33.33
03,013,01,001,0013,0,637,4,641,920,0,3,1,3,0,1,0,76.14,69.67 ,33.33
03,013,01,001,0014,0,1303,16,1319,2105,0,3,1,3,0,1,0,76.14,62.66 ,33.33
03,013,01,001,0015,0,1613,13,1626,2433,0,3,1,3,0,1,0,76.14,66.83 ,33.33
03,013,01,001,0016,0,2507,19,2526,3822,0,3,1,3,0,1,0,76.14,66.09 ,33.33
03,013,01,001,0017,0,5333,39,5372,8068,0,3,1,3,0,1,0,76.14,66.58 ,33.33
03,013,01,001,0018,0,2422,26,2448,3620,0,3,1,3,0,1,0,76.14,67.62 ,33.33
03,013,01,001,0019,0,670,5,675,973,0,3,1,3,0,1,0,76.14,69.37 ,33.33
03,013,01,001,0020,0,923,3,926,1375,0,3,1,3,0,1,0,76.14,67.35 ,33.33
03,013,01,001,0021,0,737,8,745,1127,0,3,1,3,0,1,0,76.14,66.10 ,33.33
03,013,01,001,0022,0,3834,49,3883,6075,0,3,1,3,0,1,0,76.14,63.92 ,33.33
03,013,01,001,0023,0,811,6,817,1149,0,3,1,3,0,1,0,76.14,71.11 ,33.33
03,013,01,001,0024,0,1262,14,1276,1893,0,3,1,3,0,1,0,76.14,67.41 ,33.33
03,013,01,001,0025,0,841,6,847,1269,0,3,1,3,0,1,0,76.14,66.75 ,33.33
03,013,01,001,0026,0,1296,23,1319,2017,0,3,1,3,0,1,0,76.14,65.39 ,33.33
03,013,01,001,0027,0,1112,9,1121,1723,0,3,1,3,0,1,0,76.14,65.06 ,33.33
03,013,01,001,0028,0,3006,33,3039,4601,0,3,1,3,0,1,0,76.14,66.05 ,33.33
03,013,01,001,0029,0,2725,31,2756,4187,0,3,1,3,0,1,0,76.14,65.82 ,33.33
03,013,01,001,0030,0,832,16,848,1196,0,3,1,3,0,1,0,76.14,70.90 ,33.33
03,013,01,001,0031,0,723,9,732,1034,0,3,1,3,0,1,0,76.14,70.79 ,33.33
03,013,01,001,0032,0,947,9,956,1406,0,3,1,3,0,1,0,76.14,67.99 ,33.33
03,013,01,001,0033,0,947,15,962,1358,0,3,1,3,0,1,0,76.14,70.84 ,33.33
03,013,01,001,0034,0,1034,11,1045,1590,0,3,1,3,0,1,0,76.14,65.72 ,33.33
03,013,01,001,0035,0,1031,11,1042,1645,0,3,1,3,0,1,0,76.14,63.34 ,33.33
03,013,01,001,0036,0,474,9,483,771,0,3,1,3,0,1,0,76.14,62.65 ,33.33
03,013,01,001,0037,0,527,3,530,787,0,3,1,3,0,1,0,76.14,67.34 ,33.33
03,013,01,001,0038,0,1988,14,2002,3122,0,3,1,3,0,1,0,76.14,64.13 ,33.33
03,013,01,001,0039,0,4080,49,4129,6547,0,3,1,3,0,1,0,76.14,63.07 ,33.33
03,013,01,001,0040,0,3014,26,3040,4564,0,3,1,3,0,1,0,76.14,66.61 ,33.33
03,013,01,001,0041,0,372,4,376,516,0,3,1,3,0,1,0,76.14,72.87 ,33.33
03,013,01,001,0042,0,715,7,722,980,0,3,1,3,0,1,0,76.14,73.67 ,33.33
03,013,01,001,0043,0,1633,11,1644,2391,0,3,1,3,0,1,0,76.14,68.76 ,33.33
03,013,01,001,0044,0,1003,19,1022,1424,0,3,1,3,0,1,0,76.14,71.77 ,33.33
03,013,01,001,0045,0,1500,12,1512,2177,0,3,1,3,0,1,0,76.14,69.45 ,33.33
03,013,01,001,0046,0,1069,19,1088,1473,0,3,1,3,0,1,0,76.14,73.86 ,33.33
03,013,01,001,0047,0,965,10,975,1318,0,3,1,3,0,1,0,76.14,73.98 ,33.33
03,013,01,001,0048,0,2637,22,2659,4196,0,3,1,3,0,1,0,76.14,63.37 ,33.33
03,013,01,001,0049,0,1449,12,1461,2322,0,3,1,3,0,1,0,76.14,62.92 ,33.33
03,013,01,001,0050,0,4339,46,4385,6626,0,3,1,3,0,1,0,76.14,66.18 ,33.33
03,013,01,001,0051,0,1225,7,1232,1787,0,3,1,3,0,1,0,76.14,68.94 ,33.33
03,013,01,001,0052,0,1048,13,1061,1587,0,3,1,3,0,1,0,76.14,66.86 ,33.33
03,013,01,001,0053,0,444,10,454,700,0,3,1,3,0,1,0,76.14,64.86 ,33.33
03,013,01,001,0054,0,4401,47,4448,7207,0,3,1,3,0,1,0,76.14,61.72 ,33.33
03,013,01,001,0055,0,649,4,653,967,0,3,1,3,0,1,0,76.14,67.53 ,33.33
03,013,01,001,0056,0,1342,12,1354,1953,0,3,1,3,0,1,0,76.14,69.33 ,33.33
03,013,01,001,0057,0,672,6,678,1028,0,3,1,3,0,1,0,76.14,65.95 ,33.33
03,013,01,001,0058,0,2915,22,2937,4350,0,3,1,3,0,1,0,76.14,67.52 ,33.33
03,013,01,001,0059,0,1642,19,1661,2548,0,3,1,3,0,1,0,76.14,65.19 ,33.33
03,013,01,001,0060,0,2077,18,2095,3211,0,3,1,3,0,1,0,76.14,65.24 ,33.33
03,013,01,001,0061,0,1371,9,1380,2115,0,3,1,3,0,1,0,76.14,65.25 ,33.33
03,013,01,001,0062,0,3371,46,3417,5286,0,3,1,3,0,1,0,76.14,64.64 ,33.33
03,013,01,001,0063,0,1667,12,1679,2380,0,3,1,3,0,1,0,76.14,70.55 ,33.33
03,013,01,001,0064,0,849,9,858,1216,0,3,1,3,0,1,0,76.14,70.56 ,33.33
03,013,01,001,0065,0,596,5,601,839,0,3,1,3,0,1,0,76.14,71.63 ,33.33
03,013,01,001,0066,0,688,5,693,1005,0,3,1,3,0,1,0,76.14,68.96 ,33.33
03,013,01,001,0067,0,1004,9,1013,1440,0,3,1,3,0,1,0,76.14,70.35 ,33.33
03,013,01,001,0068,0,621,3,624,935,0,3,1,3,0,1,0,76.14,66.74 ,33.33
03,013,01,002,0069,0,413,1,414,627,0,3,1,3,0,1,0,76.14,66.03 ,33.33
03,013,01,002,0070,0,2342,25,2367,3774,0,3,1,3,0,1,0,76.14,62.72 ,33.33
03,013,01,002,0071,0,514,4,518,736,0,3,1,3,0,1,0,76.14,70.38 ,33.33
03,013,01,002,0072,0,761,10,771,1170,0,3,1,3,0,1,0,76.14,65.90 ,33.33
03,013,01,002,0073,0,957,15,972,1484,0,3,1,3,0,1,0,76.14,65.50 ,33.33
03,013,01,002,0074,0,584,5,589,791,0,3,1,3,0,1,0,76.14,74.46 ,33.33
03,013,01,002,0075,0,2730,29,2759,4169,0,3,1,3,0,1,0,76.14,66.18 ,33.33
03,013,01,002,0076,0,3417,20,3437,5326,0,3,1,3,0,1,0,76.14,64.53 ,33.33
03,013,01,002,0077,0,1149,13,1162,1769,0,3,1,3,0,1,0,76.14,65.69 ,33.33
03,013,01,002,0078,0,701,10,711,1133,0,3,1,3,0,1,0,76.14,62.75 ,33.33
03,013,01,002,0079,0,1140,12,1152,1776,0,3,1,3,0,1,0,76.14,64.86 ,33.33
03,013,01,002,0080,0,1239,15,1254,1978,0,3,1,3,0,1,0,76.14,63.40 ,33.33
03,013,01,002,0081,0,3015,29,3044,4786,0,3,1,3,0,1,0,76.14,63.60 ,33.33
03,013,01,002,0082,0,880,8,888,1434,0,3,1,3,0,1,0,76.14,61.92 ,33.33
03,013,01,002,0083,0,831,11,842,1307,0,3,1,3,0,1,0,76.14,64.42 ,33.33
03,013,01,002,0084,0,569,6,575,825,0,3,1,3,0,1,0,76.14,69.70 ,33.33
03,013,01,002,0085,0,379,2,381,591,0,3,1,3,0,1,0,76.14,64.47 ,33.33
03,013,01,002,0086,0,997,10,1007,1559,0,3,1,3,0,1,0,76.14,64.59 ,33.33
03,013,01,002,0087,0,1019,15,1034,1514,0,3,1,3,0,1,0,76.14,68.30 ,33.33
03,013,01,002,0088,0,1244,17,1261,1925,0,3,1,3,0,1,0,76.14,65.51 ,33.33
03,013,01,002,0089,0,1007,15,1022,1588,0,3,1,3,0,1,0,76.14,64.36 ,33.33
03,013,01,003,0090,0,1598,15,1613,2329,0,3,1,3,0,1,0,76.14,69.26 ,33.33
03,013,01,003,0091,0,376,3,379,565,0,3,1,3,0,1,0,76.14,67.08 ,33.33
03,013,01,003,0092,0,349,6,355,479,0,3,1,3,0,1,0,76.14,74.11 ,33.33
03,013,01,003,0093,0,445,9,454,724,0,3,1,3,0,1,0,76.14,62.71 ,33.33
03,013,01,003,0094,0,363,4,367,565,0,3,1,3,0,1,0,76.14,64.96 ,33.33
03,013,01,003,0095,0,3463,41,3504,5512,0,3,1,3,0,1,0,76.14,63.57 ,33.33
03,013,01,003,0096,0,516,3,519,732,0,3,1,3,0,1,0,76.14,70.90 ,33.33
03,013,01,003,0097,0,513,8,521,770,0,3,1,3,0,1,0,76.14,67.66 ,33.33
03,013,01,003,0098,0,1179,13,1192,1798,0,3,1,3,0,1,0,76.14,66.30 ,33.33
03,013,01,003,0099,0,560,3,563,855,0,3,1,3,0,1,0,76.14,65.85 ,33.33
03,013,01,003,0100,0,870,7,877,1359,0,3,1,3,0,1,0,76.14,64.53 ,33.33
03,013,01,003,0101,0,452,4,456,724,0,3,1,3,0,1,0,76.14,62.98 ,33.33
03,013,01,003,0102,0,746,10,756,1304,0,3,1,3,0,1,0,76.14,57.98 ,33.33
03,013,01,003,0103,0,1177,13,1190,1870,0,3,1,3,0,1,0,76.14,63.64 ,33.33
03,013,01,003,0104,0,1553,17,1570,2507,0,3,1,3,0,1,0,76.14,62.62 ,33.33
03,013,01,003,0105,0,966,10,976,1540,0,3,1,3,0,1,0,76.14,63.38 ,33.33
03,013,01,003,0106,0,1084,12,1096,1770,0,3,1,3,0,1,0,76.14,61.92 ,33.33
03,013,01,003,0107,0,2209,19,2228,3631,0,3,1,3,0,1,0,76.14,61.36 ,33.33
03,013,01,003,0108,0,1209,10,1219,1783,0,3,1,3,0,1,0,76.14,68.37 ,33.33
03,013,01,003,0109,0,1056,12,1068,1557,0,3,1,3,0,1,0,76.14,68.59 ,33.33
03,013,01,003,0110,0,612,7,619,874,0,3,1,3,0,1,0,76.14,70.82 ,33.33
03,013,01,003,0111,0,454,4,458,700,0,3,1,3,0,1,0,76.14,65.43 ,33.33
03,013,01,003,0112,0,193,4,197,296,0,3,1,3,0,1,0,76.14,66.55 ,33.33
03,013,01,004,0113,0,614,5,619,973,0,3,1,3,0,1,0,76.14,63.62 ,33.33
03,013,01,004,0114,0,1156,23,1179,1895,0,3,1,3,0,1,0,76.14,62.22 ,33.33
03,013,01,004,0115,0,725,5,730,1143,0,3,1,3,0,1,0,76.14,63.87 ,33.33
03,013,01,004,0116,0,1833,28,1861,3385,0,3,1,3,0,1,0,76.14,54.98 ,33.33
03,013,01,004,0117,0,1444,22,1466,2582,0,3,1,3,0,1,0,76.14,56.78 ,33.33
03,013,01,004,0118,0,423,10,433,789,0,3,1,3,0,1,0,76.14,54.88 ,33.33
03,013,01,004,0119,0,286,4,290,493,0,3,1,3,0,1,0,76.14,58.82 ,33.33
03,013,01,004,0120,0,244,5,249,472,0,3,1,3,0,1,0,76.14,52.75 ,33.33
03,013,01,004,0121,0,528,10,538,916,0,3,1,3,0,1,0,76.14,58.73 ,33.33
03,013,01,004,0122,0,391,12,403,663,0,3,1,3,0,1,0,76.14,60.78 ,33.33
03,013,01,004,0123,0,576,6,582,928,0,3,1,3,0,1,0,76.14,62.72 ,33.33
03,013,01,004,0124,0,919,8,927,1498,0,3,1,3,0,1,0,76.14,61.88 ,33.33
03,013,01,004,0125,0,1013,22,1035,1794,0,3,1,3,0,1,0,76.14,57.69 ,33.33
03,013,01,004,0126,0,712,10,722,1371,0,3,1,3,0,1,0,76.14,52.66 ,33.33
03,013,01,004,0127,0,769,13,782,1343,0,3,1,3,0,1,0,76.14,58.23 ,33.33
03,013,01,004,0128,0,754,10,764,1173,0,3,1,3,0,1,0,76.14,65.13 ,33.33
03,013,01,004,0129,0,635,12,647,1050,0,3,1,3,0,1,0,76.14,61.62 ,33.33
03,013,01,005,0130,0,968,8,976,1414,0,3,1,3,0,1,0,76.14,69.02 ,33.33
03,013,01,005,0131,0,955,15,970,1392,0,3,1,3,0,1,0,76.14,69.68 ,33.33
03,013,01,005,0132,0,1268,12,1280,1775,0,3,1,3,0,1,0,76.14,72.11 ,33.33
03,013,01,005,0133,0,664,6,670,887,0,3,1,3,0,1,0,76.14,75.54 ,33.33
03,013,01,005,0134,0,879,5,884,1144,0,3,1,3,0,1,0,76.14,77.27 ,33.33
03,013,01,005,0135,0,803,9,812,1092,0,3,1,3,0,1,0,76.14,74.36 ,33.33
03,013,01,005,0136,0,516,2,518,655,0,3,1,3,0,1,0,76.14,79.08 ,33.33
03,013,01,005,0137,0,1156,18,1174,1573,0,3,1,3,0,1,0,76.14,74.63 ,33.33
03,013,01,005,0138,0,975,8,983,1357,0,3,1,3,0,1,0,76.14,72.44 ,33.33
03,013,01,005,0139,0,1099,9,1108,1563,0,3,1,3,0,1,0,76.14,70.89 ,33.33
03,013,01,005,0140,0,624,10,634,855,0,3,1,3,0,1,0,76.14,74.15 ,33.33
03,013,01,005,0141,0,811,6,817,1011,0,3,1,3,0,1,0,76.14,80.81 ,33.33
03,013,01,005,0142,0,881,9,890,1226,0,3,1,3,0,1,0,76.14,72.59 ,33.33
03,013,01,005,0143,0,1014,6,1020,1389,0,3,1,3,0,1,0,76.14,73.43 ,33.33
03,013,01,005,0144,0,1300,14,1314,1810,0,3,1,3,0,1,0,76.14,72.60 ,33.33
03,013,01,005,0145,0,1336,13,1349,1829,0,3,1,3,0,1,0,76.14,73.76 ,33.33
03,013,01,005,0146,0,407,3,410,513,0,3,1,3,0,1,0,76.14,79.92 ,33.33
03,013,01,005,0147,0,581,6,587,802,0,3,1,3,0,1,0,76.14,73.19 ,33.33
03,013,01,005,0148,0,840,7,847,1111,0,3,1,3,0,1,0,76.14,76.24 ,33.33
03,013,01,005,0149,0,252,1,253,347,0,3,1,3,0,1,0,76.14,72.91 ,33.33
03,013,01,005,0150,0,894,11,905,1276,0,3,1,3,0,1,0,76.14,70.92 ,33.33
03,013,01,005,0151,0,1063,13,1076,1463,0,3,1,3,0,1,0,76.14,73.55 ,33.33
03,013,01,005,0152,0,1334,18,1352,1861,0,3,1,3,0,1,0,76.14,72.65 ,33.33
03,013,01,005,0153,0,1183,22,1205,1734,0,3,1,3,0,1,0,76.14,69.49 ,33.33
03,013,01,005,0154,0,1378,11,1389,1974,0,3,1,3,0,1,0,76.14,70.36 ,33.33
03,013,01,005,0155,0,884,10,894,1233,0,3,1,3,0,1,0,76.14,72.51 ,33.33
03,013,01,005,0156,0,541,2,543,715,0,3,1,3,0,1,0,76.14,75.94 ,33.33
03,013,01,005,0157,0,403,1,404,563,0,3,1,3,0,1,0,76.14,71.76 ,33.33
03,013,01,005,0158,0,353,1,354,465,0,3,1,3,0,1,0,76.14,76.13 ,33.33
03,013,01,005,0159,0,2325,10,2335,3236,0,3,1,3,0,1,0,76.14,72.16 ,33.33
03,013,01,006,0160,0,1468,17,1485,2111,0,3,1,3,0,1,0,76.14,70.35 ,33.33
03,013,01,006,0161,0,1811,18,1829,2608,0,3,1,3,0,1,0,76.14,70.13 ,33.33
03,013,01,006,0162,0,1038,8,1046,1452,0,3,1,3,0,1,0,76.14,72.04 ,33.33
03,013,01,006,0163,0,1133,12,1145,1689,0,3,1,3,0,1,0,76.14,67.79 ,33.33
03,013,01,006,0164,0,732,5,737,998,0,3,1,3,0,1,0,76.14,73.85 ,33.33
03,013,01,006,0165,0,1058,17,1075,1441,0,3,1,3,0,1,0,76.14,74.60 ,33.33
03,013,01,006,0166,0,786,8,794,1066,0,3,1,3,0,1,0,76.14,74.48 ,33.33
03,013,01,006,0167,0,543,10,553,772,0,3,1,3,0,1,0,76.14,71.63 ,33.33
03,013,01,006,0168,0,1008,8,1016,1383,0,3,1,3,0,1,0,76.14,73.46 ,33.33
03,013,01,006,0169,0,642,5,647,848,0,3,1,3,0,1,0,76.14,76.30 ,33.33
03,013,01,006,0170,0,786,10,796,1091,0,3,1,3,0,1,0,76.14,72.96 ,33.33
03,013,01,006,0171,0,917,11,928,1314,0,3,1,3,0,1,0,76.14,70.62 ,33.33
03,013,01,006,0172,0,1236,17,1253,1644,0,3,1,3,0,1,0,76.14,76.22 ,33.33
03,013,01,006,0173,0,800,16,816,1057,0,3,1,3,0,1,0,76.14,77.20 ,33.33
03,013,01,006,0174,0,1601,21,1622,2231,0,3,1,3,0,1,0,76.14,72.70 ,33.33
03,013,01,006,0175,0,318,6,324,495,0,3,1,3,0,1,0,76.14,65.45 ,33.33
03,013,01,007,0176,0,1191,10,1201,1691,0,3,1,3,0,1,0,76.14,71.02 ,33.33
03,013,01,007,0177,0,651,5,656,898,0,3,1,3,0,1,0,76.14,73.05 ,33.33
03,013,01,007,0178,0,1090,10,1100,1559,0,3,1,3,0,1,0,76.14,70.56 ,33.33
03,013,01,007,0179,0,1481,13,1494,2165,0,3,1,3,0,1,0,76.14,69.01 ,33.33
03,013,01,007,0180,0,800,7,807,1067,0,3,1,3,0,1,0,76.14,75.63 ,33.33
03,013,01,007,0181,0,576,8,584,823,0,3,1,3,0,1,0,76.14,70.96 ,33.33
03,013,01,007,0182,0,500,5,505,674,0,3,1,3,0,1,0,76.14,74.93 ,33.33
03,013,01,008,0183,0,1098,13,1111,1541,0,3,1,3,0,1,0,76.14,72.10 ,33.33
03,013,01,008,0184,0,898,8,906,1262,0,3,1,3,0,1,0,76.14,71.79 ,33.33
03,013,01,008,0185,0,974,15,989,1381,0,3,1,3,0,1,0,76.14,71.61 ,33.33
03,013,01,008,0186,0,707,8,715,972,0,3,1,3,0,1,0,76.14,73.56 ,33.33
03,013,01,008,0187,0,898,18,916,1220,0,3,1,3,0,1,0,76.14,75.08 ,33.33
03,013,01,008,0188,0,982,20,1002,1439,0,3,1,3,0,1,0,76.14,69.63 ,33.33
03,013,01,008,0189,0,2395,23,2418,3474,0,3,1,3,0,1,0,76.14,69.60 ,33.33
03,013,01,008,0190,0,929,9,938,1290,0,3,1,3,0,1,0,76.14,72.71 ,33.33
03,013,01,008,0191,0,852,12,864,1234,0,3,1,3,0,1,0,76.14,70.02 ,33.33
03,013,01,008,0192,0,1254,17,1271,1644,0,3,1,3,0,1,0,76.14,77.31 ,33.33
03,013,01,008,0193,0,942,11,953,1279,0,3,1,3,0,1,0,76.14,74.51 ,33.33
03,013,01,009,0194,0,1404,14,1418,2046,0,3,1,3,0,1,0,76.14,69.31 ,33.33
03,013,01,009,0195,0,938,8,946,1362,0,3,1,3,0,1,0,76.14,69.46 ,33.33
03,013,01,009,0196,0,940,8,948,1359,0,3,1,3,0,1,0,76.14,69.76 ,33.33
03,013,01,009,0197,0,803,6,809,1116,0,3,1,3,0,1,0,76.14,72.49 ,33.33
03,013,01,009,0198,0,561,5,566,785,0,3,1,3,0,1,0,76.14,72.10 ,33.33
03,013,01,009,0199,0,819,11,830,1189,0,3,1,3,0,1,0,76.14,69.81 ,33.33
03,013,01,009,0200,0,1128,17,1145,1654,0,3,1,3,0,1,0,76.14,69.23 ,33.33
03,013,01,009,0201,0,861,6,867,1232,0,3,1,3,0,1,0,76.14,70.37 ,33.33
03,013,01,009,0202,0,1212,9,1221,1571,0,3,1,3,0,1,0,76.14,77.72 ,33.33
03,013,01,009,0203,0,1640,21,1661,2297,0,3,1,3,0,1,0,76.14,72.31 ,33.33
03,013,01,009,0204,0,1315,25,1340,1989,0,3,1,3,0,1,0,76.14,67.37 ,33.33
03,013,01,009,0205,0,1212,21,1233,1717,0,3,1,3,0,1,0,76.14,71.81 ,33.33
03,013,01,009,0206,0,541,3,544,805,0,3,1,3,0,1,0,76.14,67.58 ,33.33
03,013,01,009,0207,0,324,4,328,453,0,3,1,3,0,1,0,76.14,72.41 ,33.33
03,013,01,010,0208,0,1233,13,1246,1703,0,3,1,3,0,1,0,76.14,73.17 ,33.33
03,013,01,010,0209,0,1608,27,1635,2211,0,3,1,3,0,1,0,76.14,73.95 ,33.33
03,013,01,010,0210,0,1083,14,1097,1600,0,3,1,3,0,1,0,76.14,68.56 ,33.33
03,013,01,010,0211,0,743,11,754,911,0,3,1,3,0,1,0,76.14,82.77 ,33.33
03,013,01,010,0212,0,1891,25,1916,2658,0,3,1,3,0,1,0,76.14,72.08 ,33.33
03,013,01,010,0213,0,1271,24,1295,1878,0,3,1,3,0,1,0,76.14,68.96 ,33.33
03,013,01,010,0214,0,625,17,642,850,0,3,1,3,0,1,0,76.14,75.53 ,33.33
03,013,01,010,0215,0,1793,27,1820,2782,0,3,1,3,0,1,0,76.14,65.42 ,33.33
03,013,01,010,0216,0,1900,21,1921,2957,0,3,1,3,0,1,0,76.14,64.96 ,33.33
03,013,01,010,0217,0,639,9,648,958,0,3,1,3,0,1,0,76.14,67.64 ,33.33
03,013,01,010,0218,0,1002,13,1015,1443,0,3,1,3,0,1,0,76.14,70.34 ,33.33
03,013,01,010,0219,0,412,3,415,571,0,3,1,3,0,1,0,76.14,72.68 ,33.33
03,013,01,011,0220,0,1404,10,1414,2181,0,3,1,3,0,1,0,76.14,64.83 ,33.33
03,013,01,011,0221,0,922,15,937,1380,0,3,1,3,0,1,0,76.14,67.90 ,33.33
03,013,01,011,0222,0,580,10,590,828,0,3,1,3,0,1,0,76.14,71.26 ,33.33
03,013,01,011,0223,0,392,3,395,630,0,3,1,3,0,1,0,76.14,62.70 ,33.33
03,013,01,011,0224,0,675,4,679,1025,0,3,1,3,0,1,0,76.14,66.24 ,33.33
03,013,01,011,0225,0,738,8,746,1185,0,3,1,3,0,1,0,76.14,62.95 ,33.33
03,013,01,011,0226,0,419,9,428,675,0,3,1,3,0,1,0,76.14,63.41 ,33.33
03,013,01,011,0227,0,564,10,574,824,0,3,1,3,0,1,0,76.14,69.66 ,33.33
03,013,01,011,0228,0,504,5,509,751,0,3,1,3,0,1,0,76.14,67.78 ,33.33
03,013,01,011,0229,0,793,12,805,1314,0,3,1,3,0,1,0,76.14,61.26 ,33.33
03,013,01,011,0230,0,925,13,938,1518,0,3,1,3,0,1,0,76.14,61.79 ,33.33
03,013,01,011,0231,0,1192,22,1214,1983,0,3,1,3,0,1,0,76.14,61.22 ,33.33
03,013,01,011,0232,0,770,11,781,1239,0,3,1,3,0,1,0,76.14,63.03 ,33.33
03,013,01,011,0233,0,643,9,652,968,0,3,1,3,0,1,0,76.14,67.36 ,33.33
03,013,01,011,0234,0,674,9,683,1046,0,3,1,3,0,1,0,76.14,65.30 ,33.33
03,013,01,011,0235,0,692,14,706,1037,0,3,1,3,0,1,0,76.14,68.08 ,33.33
03,013,01,011,0236,0,767,10,777,1126,0,3,1,3,0,1,0,76.14,69.01 ,33.33
03,013,01,011,0237,0,909,10,919,1366,0,3,1,3,0,1,0,76.14,67.28 ,33.33
03,013,01,011,0238,0,926,9,935,1438,0,3,1,3,0,1,0,76.14,65.02 ,33.33
03,013,01,012,0239,0,854,12,866,1263,0,3,1,3,0,1,0,76.14,68.57 ,33.33
03,013,01,012,0240,0,560,3,563,782,0,3,1,3,0,1,0,76.14,71.99 ,33.33
03,013,01,012,0241,0,981,14,995,1421,0,3,1,3,0,1,0,76.14,70.02 ,33.33
03,013,01,012,0242,0,648,3,651,899,0,3,1,3,0,1,0,76.14,72.41 ,33.33
03,013,01,012,0243,0,375,8,383,542,0,3,1,3,0,1,0,76.14,70.66 ,33.33
03,013,01,012,0244,0,866,13,879,1264,0,3,1,3,0,1,0,76.14,69.54 ,33.33
03,013,01,012,0245,0,836,15,851,1144,0,3,1,3,0,1,0,76.14,74.39 ,33.33
03,013,01,012,0246,0,960,14,974,1372,0,3,1,3,0,1,0,76.14,70.99 ,33.33
03,013,01,012,0247,0,991,17,1008,1673,0,3,1,3,0,1,0,76.14,60.25 ,33.33
03,013,01,012,0248,0,1254,26,1280,1891,0,3,1,3,0,1,0,76.14,67.69 ,33.33
03,013,01,012,0249,0,1105,7,1112,1535,0,3,1,3,0,1,0,76.14,72.44 ,33.33
03,013,01,012,0250,0,1092,12,1104,1493,0,3,1,3,0,1,0,76.14,73.95 ,33.33
03,013,01,012,0251,0,741,7,748,1075,0,3,1,3,0,1,0,76.14,69.58 ,33.33
03,013,01,012,0252,0,792,12,804,1184,0,3,1,3,0,1,0,76.14,67.91 ,33.33
03,013,01,013,0253,0,2136,12,2148,3161,0,3,1,3,0,1,0,76.14,67.95 ,33.33
03,013,01,013,0254,0,1787,14,1801,2740,0,3,1,3,0,1,0,76.14,65.73 ,33.33
03,013,01,013,0255,0,945,6,951,1314,0,3,1,3,0,1,0,76.14,72.37 ,33.33
03,013,01,013,0256,0,397,8,405,590,0,3,1,3,0,1,0,76.14,68.64 ,33.33
03,013,01,013,0257,0,1410,14,1424,2083,0,3,1,3,0,1,0,76.14,68.36 ,33.33
03,013,01,013,0258,0,1264,11,1275,1848,0,3,1,3,0,1,0,76.14,68.99 ,33.33
03,013,01,013,0259,0,2697,30,2727,3962,0,3,1,3,0,1,0,76.14,68.83 ,33.33
03,013,01,013,0260,0,1496,11,1507,2436,0,3,1,3,0,1,0,76.14,61.86 ,33.33
03,013,01,013,0261,0,1187,7,1194,1644,0,3,1,3,0,1,0,76.14,72.63 ,33.33
03,013,01,013,0262,0,1332,9,1341,1905,0,3,1,3,0,1,0,76.14,70.39 ,33.33
03,013,01,013,0263,0,996,16,1012,1532,0,3,1,3,0,1,0,76.14,66.06 ,33.33
03,013,01,013,0264,0,1905,19,1924,2875,0,3,1,3,0,1,0,76.14,66.92 ,33.33
03,013,01,013,0265,0,658,9,667,948,0,3,1,3,0,1,0,76.14,70.36 ,33.33
03,013,01,013,0266,0,740,6,746,1068,0,3,1,3,0,1,0,76.14,69.85 ,33.33
03,013,01,013,0267,0,1388,17,1405,2359,0,3,1,3,0,1,0,76.14,59.56 ,33.33
03,013,01,013,0268,0,896,18,914,1453,0,3,1,3,0,1,0,76.14,62.90 ,33.33
03,013,01,013,0269,0,1584,17,1601,2464,0,3,1,3,0,1,0,76.14,64.98 ,33.33
03,013,01,013,0270,0,1641,21,1662,2559,0,3,1,3,0,1,0,76.14,64.95 ,33.33
03,013,01,013,0271,0,1041,49,1090,1845,0,3,1,3,0,1,0,76.14,59.08 ,33.33
03,013,01,013,0272,0,1131,13,1144,1726,0,3,1,3,0,1,0,76.14,66.28 ,33.33
03,013,01,013,0273,0,1424,13,1437,2201,0,3,1,3,0,1,0,76.14,65.29 ,33.33
03,013,01,013,0274,0,680,18,698,1146,0,3,1,3,0,1,0,76.14,60.91 ,33.33
03,013,01,013,0275,0,493,8,501,784,0,3,1,3,0,1,0,76.14,63.90 ,33.33
03,013,01,014,0276,0,1036,16,1052,1437,0,3,1,3,0,1,0,76.14,73.21 ,33.33
03,013,01,014,0277,0,573,3,576,843,0,3,1,3,0,1,0,76.14,68.33 ,33.33
03,013,01,014,0278,0,509,3,512,676,0,3,1,3,0,1,0,76.14,75.74 ,33.33
03,013,01,014,0279,0,427,1,428,596,0,3,1,3,0,1,0,76.14,71.81 ,33.33
03,013,01,014,0280,0,920,9,929,1315,0,3,1,3,0,1,0,76.14,70.65 ,33.33
03,013,01,014,0281,0,718,7,725,960,0,3,1,3,0,1,0,76.14,75.52 ,33.33
03,013,01,014,0282,0,439,6,445,606,0,3,1,3,0,1,0,76.14,73.43 ,33.33
03,013,01,014,0283,0,345,4,349,464,0,3,1,3,0,1,0,76.14,75.22 ,33.33
03,013,01,014,0284,0,1786,20,1806,2538,0,3,1,3,0,1,0,76.14,71.16 ,33.33
03,013,01,014,0285,0,355,1,356,442,0,3,1,3,0,1,0,76.14,80.54 ,33.33
03,013,01,014,0286,0,420,3,423,608,0,3,1,3,0,1,0,76.14,69.57 ,33.33
03,013,01,014,0287,0,501,6,507,673,0,3,1,3,0,1,0,76.14,75.33 ,33.33
03,013,01,014,0288,0,714,12,726,1089,0,3,1,3,0,1,0,76.14,66.67 ,33.33
03,013,01,014,0289,0,812,4,816,1171,0,3,1,3,0,1,0,76.14,69.68 ,33.33
03,013,01,014,0290,0,678,10,688,983,0,3,1,3,0,1,0,76.14,69.99 ,33.33
03,013,01,015,0291,0,1279,11,1290,1909,0,3,1,3,0,1,0,76.14,67.57 ,33.33
03,013,01,015,0292,0,872,3,875,1227,0,3,1,3,0,1,0,76.14,71.31 ,33.33
03,013,01,015,0293,0,739,6,745,1014,0,3,1,3,0,1,0,76.14,73.47 ,33.33
03,013,01,015,0294,0,519,5,524,758,0,3,1,3,0,1,0,76.14,69.13 ,33.33
03,013,01,015,0295,0,1084,14,1098,1686,0,3,1,3,0,1,0,76.14,65.12 ,33.33
03,013,01,015,0296,0,792,8,800,1345,0,3,1,3,0,1,0,76.14,59.48 ,33.33
03,013,01,015,0297,0,707,12,719,1090,0,3,1,3,0,1,0,76.14,65.96 ,33.33
03,013,01,016,0298,0,758,10,768,1282,0,3,1,3,0,1,0,76.14,59.91 ,33.33
03,013,01,016,0299,0,543,6,549,839,0,3,1,3,0,1,0,76.14,65.44 ,33.33
03,013,01,016,0300,0,624,5,629,937,0,3,1,3,0,1,0,76.14,67.13 ,33.33
03,013,01,016,0301,0,429,5,434,684,0,3,1,3,0,1,0,76.14,63.45 ,33.33
03,013,01,016,0302,0,1130,15,1145,1819,0,3,1,3,0,1,0,76.14,62.95 ,33.33
03,013,01,016,0303,0,2090,24,2114,3668,0,3,1,3,0,1,0,76.14,57.63 ,33.33
03,013,01,016,0304,0,1340,8,1348,2028,0,3,1,3,0,1,0,76.14,66.47 ,33.33
03,013,01,016,0305,0,1175,9,1184,1678,0,3,1,3,0,1,0,76.14,70.56 ,33.33
03,013,01,016,0306,0,1429,18,1447,2195,0,3,1,3,0,1,0,76.14,65.92 ,33.33
03,013,01,016,0307,0,410,6,416,741,0,3,1,3,0,1,0,76.14,56.14 ,33.33
03,013,01,016,0308,0,562,20,582,974,0,3,1,3,0,1,0,76.14,59.75 ,33.33
03,013,01,016,0309,0,1779,14,1793,2764,0,3,1,3,0,1,0,76.14,64.87 ,33.33
03,013,01,016,0310,0,406,2,408,608,0,3,1,3,0,1,0,76.14,67.11 ,33.33
03,013,01,016,0311,0,598,11,609,948,0,3,1,3,0,1,0,76.14,64.24 ,33.33
03,013,01,016,0312,0,293,2,295,441,0,3,1,3,0,1,0,76.14,66.89 ,33.33
03,013,01,017,0313,0,1163,7,1170,1595,0,3,1,3,0,1,0,76.14,73.35 ,33.33
03,013,01,017,0314,0,1637,13,1650,2351,0,3,1,3,0,1,0,76.14,70.18 ,33.33
03,013,01,017,0315,0,1401,16,1417,2017,0,3,1,3,0,1,0,76.14,70.25 ,33.33
03,013,01,017,0316,0,497,12,509,774,0,3,1,3,0,1,0,76.14,65.76 ,33.33
03,013,01,017,0317,0,588,5,593,789,0,3,1,3,0,1,0,76.14,75.16 ,33.33
03,013,01,017,0318,0,1521,36,1557,2227,0,3,1,3,0,1,0,76.14,69.91 ,33.33
03,013,01,017,0319,0,1378,14,1392,1927,0,3,1,3,0,1,0,76.14,72.24 ,33.33
03,013,01,017,0320,0,1670,16,1686,2164,0,3,1,3,0,1,0,76.14,77.91 ,33.33
03,013,01,017,0321,0,1866,38,1904,2809,0,3,1,3,0,1,0,76.14,67.78 ,33.33
03,013,01,017,0322,0,935,11,946,1265,0,3,1,3,0,1,0,76.14,74.78 ,33.33
03,013,01,017,0323,0,1427,20,1447,2084,0,3,1,3,0,1,0,76.14,69.43 ,33.33
03,013,01,017,0324,0,1132,13,1145,1713,0,3,1,3,0,1,0,76.14,66.84 ,33.33
03,013,01,017,0325,0,947,10,957,1405,0,3,1,3,0,1,0,76.14,68.11 ,33.33
03,013,01,017,0326,0,2395,29,2424,3898,0,3,1,3,0,1,0,76.14,62.19 ,33.33
03,013,01,017,0327,0,1405,30,1435,2215,0,3,1,3,0,1,0,76.14,64.79 ,33.33
03,013,01,018,0328,0,1405,15,1420,2009,0,3,1,3,0,1,0,76.14,70.68 ,33.33
03,013,01,018,0329,0,1074,4,1078,1654,0,3,1,3,0,1,0,76.14,65.18 ,33.33
03,013,01,018,0330,0,777,16,793,1100,0,3,1,3,0,1,0,76.14,72.09 ,33.33
03,013,01,018,0331,0,779,7,786,1118,0,3,1,3,0,1,0,76.14,70.30 ,33.33
03,013,01,018,0332,0,570,6,576,874,0,3,1,3,0,1,0,76.14,65.90 ,33.33
03,013,01,018,0333,0,1036,12,1048,1497,0,3,1,3,0,1,0,76.14,70.01 ,33.33
03,013,01,018,0334,0,544,10,554,774,0,3,1,3,0,1,0,76.14,71.58 ,33.33
03,013,01,018,0335,0,1196,20,1216,1737,0,3,1,3,0,1,0,76.14,70.01 ,33.33
03,013,01,019,0336,0,1023,11,1034,1460,0,3,1,3,0,1,0,76.14,70.82 ,33.33
03,013,01,019,0337,0,1070,13,1083,1625,0,3,1,3,0,1,0,76.14,66.65 ,33.33
03,013,01,019,0338,0,581,5,586,843,0,3,1,3,0,1,0,76.14,69.51 ,33.33
03,013,01,019,0339,0,1111,6,1117,1588,0,3,1,3,0,1,0,76.14,70.34 ,33.33
03,013,01,019,0340,0,2293,21,2314,3196,0,3,1,3,0,1,0,76.14,72.40 ,33.33
03,013,01,019,0341,0,632,2,634,905,0,3,1,3,0,1,0,76.14,70.06 ,33.33
03,013,01,019,0342,0,815,9,824,1329,0,3,1,3,0,1,0,76.14,62.00 ,33.33
03,013,01,019,0343,0,1178,10,1188,1864,0,3,1,3,0,1,0,76.14,63.73 ,33.33
03,013,01,019,0344,0,1906,18,1924,2876,0,3,1,3,0,1,0,76.14,66.90 ,33.33
03,013,01,019,0345,0,775,9,784,1130,0,3,1,3,0,1,0,76.14,69.38 ,33.33
03,013,01,020,0346,0,1256,12,1268,1778,0,3,1,3,0,1,0,76.14,71.32 ,33.33
03,013,01,020,0347,0,695,2,697,1003,0,3,1,3,0,1,0,76.14,69.49 ,33.33
03,013,01,020,0348,0,380,5,385,574,0,3,1,3,0,1,0,76.14,67.07 ,33.33
03,013,01,020,0349,0,555,12,567,777,0,3,1,3,0,1,0,76.14,72.97 ,33.33
03,013,01,020,0350,0,720,9,729,1040,0,3,1,3,0,1,0,76.14,70.10 ,33.33
03,013,01,020,0351,0,706,6,712,1002,0,3,1,3,0,1,0,76.14,71.06 ,33.33
03,013,01,020,0352,0,742,9,751,1019,0,3,1,3,0,1,0,76.14,73.70 ,33.33
03,013,01,020,0353,0,728,13,741,1105,0,3,1,3,0,1,0,76.14,67.06 ,33.33
03,013,01,020,0354,0,645,5,650,949,0,3,1,3,0,1,0,76.14,68.49 ,33.33
03,013,01,020,0355,0,418,4,422,582,0,3,1,3,0,1,0,76.14,72.51 ,33.33
03,013,01,021,0356,0,1027,9,1036,1510,0,3,1,3,0,1,0,76.14,68.61 ,33.33
03,013,01,021,0357,0,1109,14,1123,1625,0,3,1,3,0,1,0,76.14,69.11 ,33.33
03,013,01,021,0358,0,641,7,648,959,0,3,1,3,0,1,0,76.14,67.57 ,33.33
03,013,01,021,0359,0,1156,8,1164,1687,0,3,1,3,0,1,0,76.14,69.00 ,33.33
03,013,01,021,0360,0,1273,21,1294,1920,0,3,1,3,0,1,0,76.14,67.40 ,33.33
03,013,01,021,0361,0,1413,16,1429,2185,0,3,1,3,0,1,0,76.14,65.40 ,33.33
03,013,01,021,0362,0,818,9,827,1126,0,3,1,3,0,1,0,76.14,73.45 ,33.33
03,013,01,021,0363,0,629,7,636,840,0,3,1,3,0,1,0,76.14,75.71 ,33.33
03,013,01,021,0364,0,868,13,881,1215,0,3,1,3,0,1,0,76.14,72.51 ,33.33
03,013,01,021,0365,0,717,11,728,1037,0,3,1,3,0,1,0,76.14,70.20 ,33.33
03,013,01,021,0366,0,711,8,719,1103,0,3,1,3,0,1,0,76.14,65.19 ,33.33
03,013,01,021,0367,0,1487,12,1499,2236,0,3,1,3,0,1,0,76.14,67.04 ,33.33
03,013,01,022,0368,0,1036,19,1055,1968,0,3,1,3,0,1,0,76.14,53.61 ,33.33
03,013,01,022,0369,0,599,10,609,1108,0,3,1,3,0,1,0,76.14,54.96 ,33.33
03,013,01,022,0370,0,485,9,494,1018,0,3,1,3,0,1,0,76.14,48.53 ,33.33
03,013,01,022,0371,0,750,9,759,1587,0,3,1,3,0,1,0,76.14,47.83 ,33.33
03,013,01,022,0372,0,492,9,501,1231,0,3,1,3,0,1,0,76.14,40.70 ,33.33
03,013,01,022,0373,0,432,10,442,1083,0,3,1,3,0,1,0,76.14,40.81 ,33.33
03,013,01,022,0374,0,626,11,637,1477,0,3,1,3,0,1,0,76.14,43.13 ,33.33
03,013,01,022,0375,0,347,3,350,779,0,3,1,3,0,1,0,76.14,44.93 ,33.33
03,013,01,023,0376,0,874,17,891,1350,0,3,1,3,0,1,0,76.14,66.00 ,33.33
03,013,01,023,0377,0,390,3,393,564,0,3,1,3,0,1,0,76.14,69.68 ,33.33
03,013,01,023,0378,0,440,6,446,743,0,3,1,3,0,1,0,76.14,60.03 ,33.33
03,013,01,023,0379,0,478,6,484,810,0,3,1,3,0,1,0,76.14,59.75 ,33.33
03,013,01,023,0380,0,255,4,259,429,0,3,1,3,0,1,0,76.14,60.37 ,33.33
03,013,01,023,0381,0,543,13,556,997,0,3,1,3,0,1,0,76.14,55.77 ,33.33
03,013,01,023,0382,0,784,14,798,1377,0,3,1,3,0,1,0,76.14,57.95 ,33.33
03,013,01,023,0383,0,287,2,289,427,0,3,1,3,0,1,0,76.14,67.68 ,33.33
03,013,01,023,0384,0,242,7,249,455,0,3,1,3,0,1,0,76.14,54.73 ,33.33
03,013,01,023,0385,0,327,2,329,537,0,3,1,3,0,1,0,76.14,61.27 ,33.33
03,013,01,023,0386,0,275,10,285,488,0,3,1,3,0,1,0,76.14,58.40 ,33.33
03,013,01,024,0387,0,742,9,751,1346,0,3,1,3,0,1,0,76.14,55.79 ,33.33
03,013,01,024,0388,0,136,5,141,271,0,3,1,3,0,1,0,76.14,52.03 ,33.33
03,013,01,024,0389,0,650,14,664,1170,0,3,1,3,0,1,0,76.14,56.75 ,33.33
03,013,01,024,0390,0,666,5,671,1108,0,3,1,3,0,1,0,76.14,60.56 ,33.33
03,013,01,024,0391,0,217,3,220,412,0,3,1,3,0,1,0,76.14,53.40 ,33.33
03,013,01,024,0392,0,313,8,321,646,0,3,1,3,0,1,0,76.14,49.69 ,33.33
03,013,01,024,0393,0,112,0,112,227,0,3,1,3,0,1,0,76.14,49.34 ,33.33
03,013,01,024,0394,0,165,0,165,302,0,3,1,3,0,1,0,76.14,54.64 ,33.33
03,013,01,025,0395,0,1232,15,1247,1838,0,3,1,3,0,1,0,76.14,67.85 ,33.33
03,013,01,025,0396,0,683,8,691,1059,0,3,1,3,0,1,0,76.14,65.25 ,33.33
03,013,01,025,0397,0,537,10,547,1067,0,3,1,3,0,1,0,76.14,51.27 ,33.33
03,013,01,025,0398,0,461,3,464,985,0,3,1,3,0,1,0,76.14,47.11 ,33.33
03,013,01,026,0399,0,79,2,81,122,0,3,1,3,0,1,0,76.14,66.39 ,33.33
03,013,01,026,0400,0,9,0,9,17,0,3,1,3,0,1,0,76.14,52.94 ,33.33
03,013,01,026,0401,0,6,0,6,15,0,3,1,3,0,1,0,76.14,40.00 ,33.33
03,013,01,026,0402,0,6,0,6,20,0,3,1,3,0,1,0,76.14,30.00 ,33.33
03,013,01,026,0403,0,25,3,28,49,0,3,1,3,0,1,0,76.14,57.14 ,33.33
03,013,01,026,0404,0,30,0,30,42,0,3,1,3,0,1,0,76.14,71.43 ,33.33
03,013,01,026,0405,0,9,0,9,15,0,3,1,3,0,1,0,76.14,60.00 ,33.33
03,013,01,026,0406,0,21,0,21,38,0,3,1,3,0,1,0,76.14,55.26 ,33.33
03,013,01,026,0407,0,49,1,50,79,0,3,1,3,0,1,0,76.14,63.29 ,33.33
03,013,01,026,0408,0,15,1,16,39,0,3,1,3,0,1,0,76.14,41.03 ,33.33
03,013,01,027,0409,0,10,1,11,24,0,3,1,3,0,1,0,76.14,45.83 ,33.33
03,013,01,027,0410,0,7,0,7,15,0,3,1,3,0,1,0,76.14,46.67 ,33.33
03,013,01,027,0411,0,2,0,2,3,0,3,1,3,0,1,0,76.14,66.67 ,33.33
03,013,01,027,0412,0,2,0,2,3,0,3,1,3,0,1,0,76.14,66.67 ,33.33
03,013,01,027,0413,0,6,0,6,17,0,3,1,3,0,1,0,76.14,35.29 ,33.33
03,013,01,027,0414,0,1,0,1,4,0,3,1,3,0,1,0,76.14,25.00 ,33.33
03,013,01,028,0415,0,10,0,10,18,0,3,1,3,0,1,0,76.14,55.56 ,33.33
03,013,01,028,0416,0,57,0,57,86,0,3,1,3,0,1,0,76.14,66.28 ,33.33
03,013,01,028,0417,0,34,0,34,59,0,3,1,3,0,1,0,76.14,57.63 ,33.33
03,013,01,028,0418,0,27,2,29,53,0,3,1,3,0,1,0,76.14,54.72 ,33.33
03,013,01,028,0419,0,5,0,5,12,0,3,1,3,0,1,0,76.14,41.67 ,33.33
03,013,01,028,0420,0,69,8,77,122,0,3,1,3,0,1,0,76.14,63.11 ,33.33
03,013,01,029,0421,0,28,0,28,39,0,3,1,3,0,1,0,76.14,71.79 ,33.33
03,013,01,029,0422,0,17,0,17,42,0,3,1,3,0,1,0,76.14,40.48 ,33.33
03,013,01,029,0423,0,10,0,10,22,0,3,1,3,0,1,0,76.14,45.45 ,33.33
03,013,01,029,0424,0,7,0,7,12,0,3,1,3,0,1,0,76.14,58.33 ,33.33
03,013,01,029,0425,0,2,0,2,6,0,3,1,3,0,1,0,76.14,33.33 ,33.33
03,013,01,029,0426,0,14,0,14,29,0,3,1,3,0,1,0,76.14,48.28 ,33.33
03,013,01,030,0427,0,15,0,15,26,0,3,1,3,0,1,0,76.14,57.69 ,33.33
03,013,01,030,0428,0,15,0,15,27,0,3,1,3,0,1,0,76.14,55.56 ,33.33
03,013,01,030,0429,0,35,0,35,60,0,3,1,3,0,1,0,76.14,58.33 ,33.33
03,013,01,030,0430,0,42,2,44,73,0,3,1,3,0,1,0,76.14,60.27 ,33.33
03,013,01,030,0431,0,26,1,27,45,0,3,1,3,0,1,0,76.14,60.00 ,33.33
03,013,01,030,0432,0,39,2,41,53,0,3,1,3,0,1,0,76.14,77.36 ,33.33
03,013,01,030,0433,0,31,3,34,60,0,3,1,3,0,1,0,76.14,56.67 ,33.33
03,013,01,031,0434,0,20,3,23,54,0,3,1,3,0,1,0,76.14,42.59 ,33.33
03,013,01,031,0435,0,27,1,28,45,0,3,1,3,0,1,0,76.14,62.22 ,33.33
03,013,01,031,0436,0,2,0,2,9,0,3,1,3,0,1,0,76.14,22.22 ,33.33
03,013,01,031,0437,0,64,0,64,125,0,3,1,3,0,1,0,76.14,51.20 ,33.33
03,013,01,031,0438,0,78,1,79,113,0,3,1,3,0,1,0,76.14,69.91 ,33.33
03,013,01,031,0439,0,6,0,6,16,0,3,1,3,0,1,0,76.14,37.50 ,33.33
03,013,01,032,0440,0,30,1,31,50,0,3,1,3,0,1,0,76.14,62.00 ,33.33
03,013,01,032,0441,0,37,1,38,75,0,3,1,3,0,1,0,76.14,50.67 ,33.33
03,013,01,032,0442,0,20,1,21,48,0,3,1,3,0,1,0,76.14,43.75 ,33.33
03,013,01,032,0443,0,7,0,7,22,0,3,1,3,0,1,0,76.14,31.82 ,33.33
03,013,01,032,0444,0,15,2,17,29,0,3,1,3,0,1,0,76.14,58.62 ,33.33
03,013,01,032,0445,0,9,0,9,17,0,3,1,3,0,1,0,76.14,52.94 ,33.33
03,013,01,032,0446,0,21,1,22,35,0,3,1,3,0,1,0,76.14,62.86 ,33.33
03,013,01,032,0447,0,8,0,8,23,0,3,1,3,0,1,0,76.14,34.78 ,33.33
03,013,01,033,0448,0,98,4,102,161,0,3,1,3,0,1,0,76.14,63.35 ,33.33
03,013,01,033,0449,0,16,1,17,31,0,3,1,3,0,1,0,76.14,54.84 ,33.33
03,013,01,033,0450,0,13,1,14,23,0,3,1,3,0,1,0,76.14,60.87 ,33.33
03,013,01,033,0451,0,44,3,47,108,0,3,1,3,0,1,0,76.14,43.52 ,33.33
03,013,01,033,0452,0,14,0,14,37,0,3,1,3,0,1,0,76.14,37.84 ,33.33
03,013,01,033,0453,0,7,2,9,26,0,3,1,3,0,1,0,76.14,34.62 ,33.33
03,014,01,001,0001,0,682,9,691,1054,0,3,1,3,0,1,0,76.14,65.56 ,33.33
03,014,01,001,0002,0,1000,8,1008,1457,0,3,1,3,0,1,0,76.14,69.18 ,33.33
03,014,01,001,0003,0,2014,17,2031,3265,0,3,1,3,0,1,0,76.14,62.21 ,33.33
03,014,01,001,0004,0,1719,26,1745,2741,0,3,1,3,0,1,0,76.14,63.66 ,33.33
03,014,01,001,0005,0,442,5,447,765,0,3,1,3,0,1,0,76.14,58.43 ,33.33
03,014,01,001,0006,0,639,7,646,1086,0,3,1,3,0,1,0,76.14,59.48 ,33.33
03,014,01,001,0007,0,264,5,269,462,0,3,1,3,0,1,0,76.14,58.23 ,33.33
03,014,01,001,0008,0,989,17,1006,1654,0,3,1,3,0,1,0,76.14,60.82 ,33.33
03,014,01,001,0009,0,463,9,472,733,0,3,1,3,0,1,0,76.14,64.39 ,33.33
03,014,01,001,0010,0,392,4,396,637,0,3,1,3,0,1,0,76.14,62.17 ,33.33
03,014,01,001,0011,0,458,5,463,771,0,3,1,3,0,1,0,76.14,60.05 ,33.33
03,014,01,001,0012,0,524,9,533,867,0,3,1,3,0,1,0,76.14,61.48 ,33.33
03,014,01,001,0013,0,805,14,819,1355,0,3,1,3,0,1,0,76.14,60.44 ,33.33
03,014,01,001,0014,0,551,7,558,887,0,3,1,3,0,1,0,76.14,62.91 ,33.33
03,014,01,001,0015,0,640,6,646,998,0,3,1,3,0,1,0,76.14,64.73 ,33.33
03,014,01,001,0016,0,444,6,450,721,0,3,1,3,0,1,0,76.14,62.41 ,33.33
03,014,01,001,0017,0,302,2,304,441,0,3,1,3,0,1,0,76.14,68.93 ,33.33
03,014,01,001,0018,0,1751,18,1769,2844,0,3,1,3,0,1,0,76.14,62.20 ,33.33
03,014,01,001,0019,0,397,7,404,701,0,3,1,3,0,1,0,76.14,57.63 ,33.33
03,014,01,001,0020,0,267,6,273,474,0,3,1,3,0,1,0,76.14,57.59 ,33.33
03,014,01,001,0021,0,678,8,686,1173,0,3,1,3,0,1,0,76.14,58.48 ,33.33
03,014,01,001,0022,0,2680,27,2707,4440,0,3,1,3,0,1,0,76.14,60.97 ,33.33
03,014,01,001,0023,0,1297,14,1311,2138,0,3,1,3,0,1,0,76.14,61.32 ,33.33
03,014,01,001,0024,0,1774,16,1790,2743,0,3,1,3,0,1,0,76.14,65.26 ,33.33
03,014,01,001,0025,0,846,12,858,1420,0,3,1,3,0,1,0,76.14,60.42 ,33.33
03,014,01,001,0026,0,949,18,967,1657,0,3,1,3,0,1,0,76.14,58.36 ,33.33
03,014,01,001,0027,0,561,4,565,865,0,3,1,3,0,1,0,76.14,65.32 ,33.33
03,014,01,001,0028,0,720,9,729,1092,0,3,1,3,0,1,0,76.14,66.76 ,33.33
03,014,01,001,0029,0,686,13,699,1078,0,3,1,3,0,1,0,76.14,64.84 ,33.33
03,014,01,001,0030,0,3225,29,3254,5491,0,3,1,3,0,1,0,76.14,59.26 ,33.33
03,014,01,001,0031,0,1749,29,1778,3029,0,3,1,3,0,1,0,76.14,58.70 ,33.33
03,014,01,001,0032,0,907,13,920,1578,0,3,1,3,0,1,0,76.14,58.30 ,33.33
03,014,01,001,0033,0,557,11,568,939,0,3,1,3,0,1,0,76.14,60.49 ,33.33
03,014,01,001,0034,0,680,22,702,1108,0,3,1,3,0,1,0,76.14,63.36 ,33.33
03,014,01,001,0035,0,274,7,281,479,0,3,1,3,0,1,0,76.14,58.66 ,33.33
03,014,01,001,0036,0,955,30,985,1596,0,3,1,3,0,1,0,76.14,61.72 ,33.33
03,014,01,001,0037,0,643,4,647,1080,0,3,1,3,0,1,0,76.14,59.91 ,33.33
03,014,01,001,0038,0,1224,15,1239,1791,0,3,1,3,0,1,0,76.14,69.18 ,33.33
03,014,01,001,0039,0,849,12,861,1439,0,3,1,3,0,1,0,76.14,59.83 ,33.33
03,014,01,001,0040,0,1097,14,1111,1780,0,3,1,3,0,1,0,76.14,62.42 ,33.33
03,014,01,001,0041,0,569,5,574,993,0,3,1,3,0,1,0,76.14,57.80 ,33.33
03,014,01,001,0042,0,499,5,504,866,0,3,1,3,0,1,0,76.14,58.20 ,33.33
03,014,01,001,0043,0,516,6,522,831,0,3,1,3,0,1,0,76.14,62.82 ,33.33
03,014,01,001,0044,0,531,4,535,836,0,3,1,3,0,1,0,76.14,64.00 ,33.33
03,014,01,001,0045,0,519,10,529,870,0,3,1,3,0,1,0,76.14,60.80 ,33.33
03,014,01,001,0046,0,623,23,646,1113,0,3,1,3,0,1,0,76.14,58.04 ,33.33
03,014,01,002,0047,0,238,3,241,466,0,3,1,3,0,1,0,76.14,51.72 ,33.33
03,014,01,002,0048,0,84,3,87,163,0,3,1,3,0,1,0,76.14,53.37 ,33.33
03,014,01,002,0049,0,1455,21,1476,2443,0,3,1,3,0,1,0,76.14,60.42 ,33.33
03,014,01,002,0050,0,680,7,687,1048,0,3,1,3,0,1,0,76.14,65.55 ,33.33
03,014,01,002,0051,0,602,7,609,1087,0,3,1,3,0,1,0,76.14,56.03 ,33.33
03,014,01,002,0052,0,292,8,300,591,0,3,1,3,0,1,0,76.14,50.76 ,33.33
03,014,01,002,0053,0,254,2,256,494,0,3,1,3,0,1,0,76.14,51.82 ,33.33
03,014,01,002,0054,0,47,2,49,109,0,3,1,3,0,1,0,76.14,44.95 ,33.33
03,014,01,003,0055,0,971,14,985,1618,0,3,1,3,0,1,0,76.14,60.88 ,33.33
03,014,01,003,0056,0,547,8,555,863,0,3,1,3,0,1,0,76.14,64.31 ,33.33
03,014,01,003,0057,0,394,5,399,670,0,3,1,3,0,1,0,76.14,59.55 ,33.33
03,014,01,003,0058,0,622,4,626,957,0,3,1,3,0,1,0,76.14,65.41 ,33.33
03,014,01,003,0059,0,363,3,366,682,0,3,1,3,0,1,0,76.14,53.67 ,33.33
03,014,01,003,0060,0,727,10,737,1233,0,3,1,3,0,1,0,76.14,59.77 ,33.33
03,014,01,003,0061,0,101,1,102,229,0,3,1,3,0,1,0,76.14,44.54 ,33.33
03,014,01,004,0062,0,1085,18,1103,1799,0,3,1,3,0,1,0,76.14,61.31 ,33.33
03,014,01,004,0063,0,561,5,566,956,0,3,1,3,0,1,0,76.14,59.21 ,33.33
03,014,01,004,0064,0,619,12,631,1092,0,3,1,3,0,1,0,76.14,57.78 ,33.33
03,014,01,004,0065,0,562,8,570,1051,0,3,1,3,0,1,0,76.14,54.23 ,33.33
03,014,01,004,0066,0,124,4,128,233,0,3,1,3,0,1,0,76.14,54.94 ,33.33
03,014,01,004,0067,0,1706,44,1750,2841,0,3,1,3,0,1,0,76.14,61.60 ,33.33
03,014,01,004,0068,0,394,10,404,697,0,3,1,3,0,1,0,76.14,57.96 ,33.33
03,014,01,004,0069,0,242,6,248,423,0,3,1,3,0,1,0,76.14,58.63 ,33.33
03,014,01,004,0070,0,154,6,160,268,0,3,1,3,0,1,0,76.14,59.70 ,33.33
03,014,01,004,0071,0,628,7,635,1064,0,3,1,3,0,1,0,76.14,59.68 ,33.33
03,014,01,004,0072,0,261,7,268,448,0,3,1,3,0,1,0,76.14,59.82 ,33.33
03,014,01,004,0073,0,236,3,239,373,0,3,1,3,0,1,0,76.14,64.08 ,33.33
03,014,01,004,0074,0,135,6,141,245,0,3,1,3,0,1,0,76.14,57.55 ,33.33
03,014,01,005,0075,0,440,10,450,771,0,3,1,3,0,1,0,76.14,58.37 ,33.33
03,014,01,005,0076,0,564,12,576,1046,0,3,1,3,0,1,0,76.14,55.07 ,33.33
03,014,01,005,0077,0,514,6,520,1046,0,3,1,3,0,1,0,76.14,49.71 ,33.33
03,014,01,005,0078,0,392,10,402,782,0,3,1,3,0,1,0,76.14,51.41 ,33.33
03,014,01,005,0079,0,320,10,330,633,0,3,1,3,0,1,0,76.14,52.13 ,33.33
03,014,01,005,0080,0,193,4,197,361,0,3,1,3,0,1,0,76.14,54.57 ,33.33
03,014,01,005,0081,0,545,6,551,984,0,3,1,3,0,1,0,76.14,56.00 ,33.33
03,014,01,006,0082,0,1044,13,1057,1865,0,3,1,3,0,1,0,76.14,56.68 ,33.33
03,014,01,006,0083,0,646,11,657,1307,0,3,1,3,0,1,0,76.14,50.27 ,33.33
03,014,01,006,0084,0,307,2,309,679,0,3,1,3,0,1,0,76.14,45.51 ,33.33
03,014,01,006,0085,0,47,2,49,109,0,3,1,3,0,1,0,76.14,44.95 ,33.33
03,014,01,006,0086,0,239,3,242,410,0,3,1,3,0,1,0,76.14,59.02 ,33.33
03,014,01,006,0087,0,406,11,417,809,0,3,1,3,0,1,0,76.14,51.55 ,33.33
03,014,01,006,0088,0,208,2,210,426,0,3,1,3,0,1,0,76.14,49.30 ,33.33
03,014,01,006,0089,0,181,8,189,374,0,3,1,3,0,1,0,76.14,50.53 ,33.33
03,014,01,006,0090,0,185,5,190,354,0,3,1,3,0,1,0,76.14,53.67 ,33.33
03,014,01,006,0091,0,67,5,72,161,0,3,1,3,0,1,0,76.14,44.72 ,33.33
03,014,01,007,0092,0,667,10,677,1229,0,3,1,3,0,1,0,76.14,55.09 ,33.33
03,014,01,007,0093,0,323,8,331,606,0,3,1,3,0,1,0,76.14,54.62 ,33.33
03,014,01,007,0094,0,110,2,112,219,0,3,1,3,0,1,0,76.14,51.14 ,33.33
03,014,01,007,0095,0,155,4,159,315,0,3,1,3,0,1,0,76.14,50.48 ,33.33
03,014,01,007,0096,0,346,6,352,652,0,3,1,3,0,1,0,76.14,53.99 ,33.33
03,014,01,007,0097,0,443,10,453,945,0,3,1,3,0,1,0,76.14,47.94 ,33.33
03,014,01,007,0098,0,78,1,79,179,0,3,1,3,0,1,0,76.14,44.13 ,33.33
03,014,01,008,0099,0,172,3,175,377,0,3,1,3,0,1,0,76.14,46.42 ,33.33
03,014,01,008,0100,0,182,3,185,406,0,3,1,3,0,1,0,76.14,45.57 ,33.33
03,014,01,008,0101,0,587,7,594,1104,0,3,1,3,0,1,0,76.14,53.80 ,33.33
03,014,01,008,0102,0,252,12,264,537,0,3,1,3,0,1,0,76.14,49.16 ,33.33
03,014,01,008,0103,0,103,2,105,215,0,3,1,3,0,1,0,76.14,48.84 ,33.33
03,014,01,008,0104,0,209,9,218,437,0,3,1,3,0,1,0,76.14,49.89 ,33.33
03,014,01,008,0105,0,167,0,167,276,0,3,1,3,0,1,0,76.14,60.51 ,33.33
03,014,01,009,0106,0,514,10,524,924,0,3,1,3,0,1,0,76.14,56.71 ,33.33
03,014,01,009,0107,0,347,11,358,614,0,3,1,3,0,1,0,76.14,58.31 ,33.33
03,014,01,009,0108,0,376,8,384,701,0,3,1,3,0,1,0,76.14,54.78 ,33.33
03,014,01,009,0109,0,227,5,232,380,0,3,1,3,0,1,0,76.14,61.05 ,33.33
03,014,01,009,0110,0,680,9,689,1190,0,3,1,3,0,1,0,76.14,57.90 ,33.33
03,014,01,009,0111,0,785,9,794,1265,0,3,1,3,0,1,0,76.14,62.77 ,33.33
03,014,01,009,0112,0,270,7,277,493,0,3,1,3,0,1,0,76.14,56.19 ,33.33
03,014,01,009,0113,0,264,3,267,509,0,3,1,3,0,1,0,76.14,52.46 ,33.33
03,014,01,009,0114,0,125,5,130,247,0,3,1,3,0,1,0,76.14,52.63 ,33.33
03,014,01,010,0115,0,128,0,128,248,0,3,1,3,0,1,0,76.14,51.61 ,33.33
03,014,01,010,0116,0,597,9,606,1178,0,3,1,3,0,1,0,76.14,51.44 ,33.33
03,014,01,010,0117,0,481,10,491,861,0,3,1,3,0,1,0,76.14,57.03 ,33.33
03,014,01,010,0118,0,47,0,47,104,0,3,1,3,0,1,0,76.14,45.19 ,33.33
03,014,01,010,0119,0,45,0,45,88,0,3,1,3,0,1,0,76.14,51.14 ,33.33
03,014,01,011,0120,0,356,7,363,663,0,3,1,3,0,1,0,76.14,54.75 ,33.33
03,014,01,011,0121,0,341,7,348,738,0,3,1,3,0,1,0,76.14,47.15 ,33.33
03,014,01,011,0122,0,333,7,340,598,0,3,1,3,0,1,0,76.14,56.86 ,33.33
03,014,01,012,0123,0,13,1,14,27,0,3,1,3,0,1,0,76.14,51.85 ,33.33
03,014,01,012,0124,0,34,0,34,55,0,3,1,3,0,1,0,76.14,61.82 ,33.33
03,014,01,012,0125,0,71,2,73,125,0,3,1,3,0,1,0,76.14,58.40 ,33.33
03,014,01,012,0126,0,44,1,45,75,0,3,1,3,0,1,0,76.14,60.00 ,33.33
03,014,01,012,0127,0,14,0,14,22,0,3,1,3,0,1,0,76.14,63.64 ,33.33
03,014,01,012,0128,0,19,0,19,29,0,3,1,3,0,1,0,76.14,65.52 ,33.33
03,014,01,013,0129,0,58,1,59,95,0,3,1,3,0,1,0,76.14,62.11 ,33.33
03,014,01,013,0130,0,14,0,14,24,0,3,1,3,0,1,0,76.14,58.33 ,33.33
03,014,01,013,0131,0,13,0,13,22,0,3,1,3,0,1,0,76.14,59.09 ,33.33
03,014,01,013,0132,0,19,0,19,40,0,3,1,3,0,1,0,76.14,47.50 ,33.33
03,014,01,013,0133,0,56,1,57,102,0,3,1,3,0,1,0,76.14,55.88 ,33.33
03,014,01,014,0134,0,46,1,47,77,0,3,1,3,0,1,0,76.14,61.04 ,33.33
03,014,01,014,0135,0,31,0,31,46,0,3,1,3,0,1,0,76.14,67.39 ,33.33
03,014,01,014,0136,0,16,0,16,31,0,3,1,3,0,1,0,76.14,51.61 ,33.33
03,014,01,014,0137,0,5,0,5,8,0,3,1,3,0,1,0,76.14,62.50 ,33.33
03,014,01,014,0138,0,8,0,8,15,0,3,1,3,0,1,0,76.14,53.33 ,33.33
03,014,01,015,0139,0,83,0,83,163,0,3,1,3,0,1,0,76.14,50.92 ,33.33
03,014,01,015,0140,0,19,1,20,55,0,3,1,3,0,1,0,76.14,36.36 ,33.33
03,014,01,015,0141,0,30,2,32,67,0,3,1,3,0,1,0,76.14,47.76 ,33.33
03,014,01,015,0142,0,3,0,3,12,0,3,1,3,0,1,0,76.14,25.00 ,33.33
03,014,01,015,0143,0,13,0,13,35,0,3,1,3,0,1,0,76.14,37.14 ,33.33
03,014,01,015,0144,0,9,0,9,24,0,3,1,3,0,1,0,76.14,37.50 ,33.33
03,014,01,016,0145,0,37,0,37,80,0,3,1,3,0,1,0,76.14,46.25 ,33.33
03,014,01,016,0146,0,42,0,42,79,0,3,1,3,0,1,0,76.14,53.16 ,33.33
03,014,01,016,0147,0,6,0,6,20,0,3,1,3,0,1,0,76.14,30.00 ,33.33
03,014,01,016,0148,0,10,0,10,15,0,3,1,3,0,1,0,76.14,66.67 ,33.33
03,015,01,001,0001,0,954,8,962,1412,0,3,1,3,0,1,0,76.14,68.13 ,33.33
03,015,01,001,0002,0,2055,28,2083,3153,0,3,1,3,0,1,0,76.14,66.06 ,33.33
03,015,01,001,0003,0,1474,49,1523,2622,0,3,1,3,0,1,0,76.14,58.09 ,33.33
03,015,01,001,0004,0,430,4,434,748,0,3,1,3,0,1,0,76.14,58.02 ,33.33
03,015,01,001,0005,0,1907,26,1933,3052,0,3,1,3,0,1,0,76.14,63.34 ,33.33
03,015,01,001,0006,0,1150,30,1180,1766,0,3,1,3,0,1,0,76.14,66.82 ,33.33
03,015,01,001,0007,0,1675,20,1695,2596,0,3,1,3,0,1,0,76.14,65.29 ,33.33
03,015,01,001,0008,0,863,16,879,1326,0,3,1,3,0,1,0,76.14,66.29 ,33.33
03,015,01,001,0009,0,289,7,296,511,0,3,1,3,0,1,0,76.14,57.93 ,33.33
03,015,01,001,0010,0,406,5,411,626,0,3,1,3,0,1,0,76.14,65.65 ,33.33
03,015,01,001,0011,0,392,10,402,592,0,3,1,3,0,1,0,76.14,67.91 ,33.33
03,015,01,001,0012,0,256,5,261,379,0,3,1,3,0,1,0,76.14,68.87 ,33.33
03,015,01,001,0013,0,370,5,375,577,0,3,1,3,0,1,0,76.14,64.99 ,33.33
03,015,01,001,0014,0,838,7,845,1294,0,3,1,3,0,1,0,76.14,65.30 ,33.33
03,015,01,001,0015,0,267,4,271,435,0,3,1,3,0,1,0,76.14,62.30 ,33.33
03,015,01,001,0016,0,501,1,502,741,0,3,1,3,0,1,0,76.14,67.75 ,33.33
03,015,01,001,0017,0,643,11,654,966,0,3,1,3,0,1,0,76.14,67.70 ,33.33
03,015,01,001,0018,0,419,5,424,632,0,3,1,3,0,1,0,76.14,67.09 ,33.33
03,015,01,001,0019,0,441,8,449,731,0,3,1,3,0,1,0,76.14,61.42 ,33.33
03,015,01,001,0020,0,657,10,667,1016,0,3,1,3,0,1,0,76.14,65.65 ,33.33
03,015,01,001,0021,0,472,7,479,818,0,3,1,3,0,1,0,76.14,58.56 ,33.33
03,015,01,001,0022,0,1684,29,1713,2693,0,3,1,3,0,1,0,76.14,63.61 ,33.33
03,015,01,001,0023,0,1057,10,1067,1678,0,3,1,3,0,1,0,76.14,63.59 ,33.33
03,015,01,001,0024,0,3242,41,3283,5062,0,3,1,3,0,1,0,76.14,64.86 ,33.33
03,015,01,001,0025,0,2406,34,2440,3931,0,3,1,3,0,1,0,76.14,62.07 ,33.33
03,015,01,001,0026,0,1493,15,1508,2347,0,3,1,3,0,1,0,76.14,64.25 ,33.33
03,015,01,001,0027,0,1901,23,1924,3049,0,3,1,3,0,1,0,76.14,63.10 ,33.33
03,015,01,001,0028,0,966,7,973,1630,0,3,1,3,0,1,0,76.14,59.69 ,33.33
03,015,01,001,0029,0,678,12,690,1078,0,3,1,3,0,1,0,76.14,64.01 ,33.33
03,015,01,001,0030,0,272,10,282,439,0,3,1,3,0,1,0,76.14,64.24 ,33.33
03,015,01,001,0031,0,919,17,936,1396,0,3,1,3,0,1,0,76.14,67.05 ,33.33
03,015,01,001,0032,0,475,7,482,772,0,3,1,3,0,1,0,76.14,62.44 ,33.33
03,015,01,001,0033,0,1289,12,1301,2031,0,3,1,3,0,1,0,76.14,64.06 ,33.33
03,015,01,001,0034,0,1120,17,1137,1737,0,3,1,3,0,1,0,76.14,65.46 ,33.33
03,015,01,001,0035,0,2586,35,2621,4443,0,3,1,3,0,1,0,76.14,58.99 ,33.33
03,015,01,001,0036,0,739,10,749,1148,0,3,1,3,0,1,0,76.14,65.24 ,33.33
03,015,01,001,0037,0,2723,21,2744,4269,0,3,1,3,0,1,0,76.14,64.28 ,33.33
03,015,01,001,0038,0,1937,25,1962,3106,0,3,1,3,0,1,0,76.14,63.17 ,33.33
03,015,01,001,0039,0,2050,24,2074,3378,0,3,1,3,0,1,0,76.14,61.40 ,33.33
03,015,01,001,0040,0,475,10,485,858,0,3,1,3,0,1,0,76.14,56.53 ,33.33
03,015,01,002,0041,0,761,12,773,1265,0,3,1,3,0,1,0,76.14,61.11 ,33.33
03,015,01,002,0042,0,489,10,499,844,0,3,1,3,0,1,0,76.14,59.12 ,33.33
03,015,01,002,0043,0,1089,18,1107,1935,0,3,1,3,0,1,0,76.14,57.21 ,33.33
03,015,01,002,0044,0,984,28,1012,1692,0,3,1,3,0,1,0,76.14,59.81 ,33.33
03,015,01,002,0045,0,1417,19,1436,2405,0,3,1,3,0,1,0,76.14,59.71 ,33.33
03,015,01,002,0046,0,329,5,334,555,0,3,1,3,0,1,0,76.14,60.18 ,33.33
03,015,01,002,0047,0,1578,41,1619,2632,0,3,1,3,0,1,0,76.14,61.51 ,33.33
03,015,01,002,0048,0,636,22,658,1042,0,3,1,3,0,1,0,76.14,63.15 ,33.33
03,015,01,003,0049,0,187,5,192,379,0,3,1,3,0,1,0,76.14,50.66 ,33.33
03,015,01,003,0050,0,222,3,225,367,0,3,1,3,0,1,0,76.14,61.31 ,33.33
03,015,01,003,0051,0,231,3,234,432,0,3,1,3,0,1,0,76.14,54.17 ,33.33
03,015,01,003,0052,0,69,1,70,137,0,3,1,3,0,1,0,76.14,51.09 ,33.33
03,015,01,003,0053,0,74,4,78,149,0,3,1,3,0,1,0,76.14,52.35 ,33.33
03,015,01,003,0054,0,87,2,89,141,0,3,1,3,0,1,0,76.14,63.12 ,33.33
03,015,01,003,0055,0,83,5,88,112,0,3,1,3,0,1,0,76.14,78.57 ,33.33
03,015,01,003,0056,0,56,1,57,87,0,3,1,3,0,1,0,76.14,65.52 ,33.33
03,015,01,003,0057,0,46,4,50,92,0,3,1,3,0,1,0,76.14,54.35 ,33.33
03,015,01,004,0058,0,1791,20,1811,3019,0,3,1,3,0,1,0,76.14,59.99 ,33.33
03,015,01,004,0059,0,1454,30,1484,2407,0,3,1,3,0,1,0,76.14,61.65 ,33.33
03,015,01,004,0060,0,2643,39,2682,4173,0,3,1,3,0,1,0,76.14,64.27 ,33.33
03,015,01,004,0061,0,1793,34,1827,2999,0,3,1,3,0,1,0,76.14,60.92 ,33.33
03,015,01,004,0062,0,1247,18,1265,1941,0,3,1,3,0,1,0,76.14,65.17 ,33.33
03,015,01,004,0063,0,708,21,729,1108,0,3,1,3,0,1,0,76.14,65.79 ,33.33
03,015,01,004,0064,0,475,14,489,833,0,3,1,3,0,1,0,76.14,58.70 ,33.33
03,015,01,004,0065,0,1236,16,1252,2043,0,3,1,3,0,1,0,76.14,61.28 ,33.33
03,015,01,004,0066,0,1510,29,1539,2372,0,3,1,3,0,1,0,76.14,64.88 ,33.33
03,015,01,004,0067,0,1202,11,1213,1990,0,3,1,3,0,1,0,76.14,60.95 ,33.33
03,015,01,004,0068,0,1585,24,1609,2586,0,3,1,3,0,1,0,76.14,62.22 ,33.33
03,015,01,004,0069,0,3609,53,3662,5660,0,3,1,3,0,1,0,76.14,64.70 ,33.33
03,015,01,004,0070,0,2050,31,2081,3317,0,3,1,3,0,1,0,76.14,62.74 ,33.33
03,015,01,004,0071,0,2718,29,2747,4398,0,3,1,3,0,1,0,76.14,62.46 ,33.33
03,015,01,004,0072,0,1853,22,1875,3043,0,3,1,3,0,1,0,76.14,61.62 ,33.33
03,015,01,004,0073,0,812,16,828,1389,0,3,1,3,0,1,0,76.14,59.61 ,33.33
03,015,01,004,0074,0,1921,38,1959,3271,0,3,1,3,0,1,0,76.14,59.89 ,33.33
03,015,01,004,0075,0,532,19,551,889,0,3,1,3,0,1,0,76.14,61.98 ,33.33
03,015,01,005,0076,0,416,10,426,704,0,3,1,3,0,1,0,76.14,60.51 ,33.33
03,015,01,005,0077,0,199,7,206,320,0,3,1,3,0,1,0,76.14,64.38 ,33.33
03,015,01,005,0078,0,1104,21,1125,1825,0,3,1,3,0,1,0,76.14,61.64 ,33.33
03,015,01,005,0079,0,683,9,692,1166,0,3,1,3,0,1,0,76.14,59.35 ,33.33
03,015,01,005,0080,0,396,9,405,635,0,3,1,3,0,1,0,76.14,63.78 ,33.33
03,015,01,005,0081,0,649,3,652,1050,0,3,1,3,0,1,0,76.14,62.10 ,33.33
03,015,01,005,0082,0,338,12,350,530,0,3,1,3,0,1,0,76.14,66.04 ,33.33
03,015,01,005,0083,0,87,3,90,152,0,3,1,3,0,1,0,76.14,59.21 ,33.33
03,015,01,005,0084,0,328,6,334,565,0,3,1,3,0,1,0,76.14,59.12 ,33.33
03,015,01,005,0085,0,630,8,638,1035,0,3,1,3,0,1,0,76.14,61.64 ,33.33
03,015,01,005,0086,0,1303,24,1327,2203,0,3,1,3,0,1,0,76.14,60.24 ,33.33
03,015,01,005,0087,0,78,3,81,131,0,3,1,3,0,1,0,76.14,61.83 ,33.33
03,015,01,005,0088,0,132,2,134,249,0,3,1,3,0,1,0,76.14,53.82 ,33.33
03,015,01,005,0089,0,183,2,185,349,0,3,1,3,0,1,0,76.14,53.01 ,33.33
03,015,01,005,0090,0,214,5,219,439,0,3,1,3,0,1,0,76.14,49.89 ,33.33
03,015,01,006,0091,0,730,20,750,1127,0,3,1,3,0,1,0,76.14,66.55 ,33.33
03,015,01,006,0092,0,433,9,442,640,0,3,1,3,0,1,0,76.14,69.06 ,33.33
03,015,01,006,0093,0,494,2,496,698,0,3,1,3,0,1,0,76.14,71.06 ,33.33
03,015,01,006,0094,0,730,15,745,1129,0,3,1,3,0,1,0,76.14,65.99 ,33.33
03,015,01,006,0095,0,563,15,578,864,0,3,1,3,0,1,0,76.14,66.90 ,33.33
03,015,01,006,0096,0,141,3,144,241,0,3,1,3,0,1,0,76.14,59.75 ,33.33
03,015,01,006,0097,0,734,24,758,1276,0,3,1,3,0,1,0,76.14,59.40 ,33.33
03,015,01,006,0098,0,365,14,379,631,0,3,1,3,0,1,0,76.14,60.06 ,33.33
03,015,01,006,0099,0,385,4,389,689,0,3,1,3,0,1,0,76.14,56.46 ,33.33
03,015,01,006,0100,0,554,18,572,853,0,3,1,3,0,1,0,76.14,67.06 ,33.33
03,015,01,006,0101,0,602,19,621,1042,0,3,1,3,0,1,0,76.14,59.60 ,33.33
03,015,01,006,0102,0,86,0,86,129,0,3,1,3,0,1,0,76.14,66.67 ,33.33
03,015,01,007,0103,0,608,8,616,993,0,3,1,3,0,1,0,76.14,62.03 ,33.33
03,015,01,007,0104,0,559,6,565,861,0,3,1,3,0,1,0,76.14,65.62 ,33.33
03,015,01,007,0105,0,227,10,237,399,0,3,1,3,0,1,0,76.14,59.40 ,33.33
03,015,01,007,0106,0,155,6,161,300,0,3,1,3,0,1,0,76.14,53.67 ,33.33
03,015,01,007,0107,0,427,3,430,713,0,3,1,3,0,1,0,76.14,60.31 ,33.33
03,015,01,007,0108,0,110,0,110,229,0,3,1,3,0,1,0,76.14,48.03 ,33.33
03,015,01,007,0109,0,77,1,78,122,0,3,1,3,0,1,0,76.14,63.93 ,33.33
03,015,01,007,0110,0,55,2,57,110,0,3,1,3,0,1,0,76.14,51.82 ,33.33
03,015,01,007,0111,0,103,2,105,189,0,3,1,3,0,1,0,76.14,55.56 ,33.33
03,015,01,007,0112,0,132,2,134,227,0,3,1,3,0,1,0,76.14,59.03 ,33.33
03,015,01,007,0113,0,331,5,336,469,0,3,1,3,0,1,0,76.14,71.64 ,33.33
03,015,01,007,0114,0,374,17,391,641,0,3,1,3,0,1,0,76.14,61.00 ,33.33
03,015,01,007,0115,0,179,6,185,328,0,3,1,3,0,1,0,76.14,56.40 ,33.33
03,015,01,007,0116,0,218,9,227,367,0,3,1,3,0,1,0,76.14,61.85 ,33.33
03,015,01,007,0117,0,322,8,330,589,0,3,1,3,0,1,0,76.14,56.03 ,33.33
03,015,01,008,0118,0,43,3,46,113,0,3,1,3,0,1,0,76.14,40.71 ,33.33
03,015,01,008,0119,0,70,4,74,146,0,3,1,3,0,1,0,76.14,50.68 ,33.33
03,015,01,008,0120,0,373,7,380,707,0,3,1,3,0,1,0,76.14,53.75 ,33.33
03,015,01,008,0121,0,44,2,46,107,0,3,1,3,0,1,0,76.14,42.99 ,33.33
03,015,01,008,0122,0,57,2,59,100,0,3,1,3,0,1,0,76.14,59.00 ,33.33
03,015,01,009,0123,0,26,3,29,60,0,3,1,3,0,1,0,76.14,48.33 ,33.33
03,015,01,009,0124,0,9,2,11,31,0,3,1,3,0,1,0,76.14,35.48 ,33.33
03,015,01,009,0125,0,31,0,31,61,0,3,1,3,0,1,0,76.14,50.82 ,33.33
03,015,01,009,0126,0,37,1,38,60,0,3,1,3,0,1,0,76.14,63.33 ,33.33
03,015,01,009,0127,0,13,1,14,38,0,3,1,3,0,1,0,76.14,36.84 ,33.33
03,015,01,009,0128,0,56,0,56,104,0,3,1,3,0,1,0,76.14,53.85 ,33.33
03,015,01,010,0129,0,1109,11,1120,1813,0,3,1,3,0,1,0,76.14,61.78 ,33.33
03,015,01,010,0130,0,901,13,914,1586,0,3,1,3,0,1,0,76.14,57.63 ,33.33
03,015,01,010,0131,0,246,1,247,395,0,3,1,3,0,1,0,76.14,62.53 ,33.33
03,015,01,010,0132,0,475,12,487,857,0,3,1,3,0,1,0,76.14,56.83 ,33.33
03,015,01,010,0133,0,244,0,244,422,0,3,1,3,0,1,0,76.14,57.82 ,33.33
03,015,01,010,0134,0,272,7,279,505,0,3,1,3,0,1,0,76.14,55.25 ,33.33
03,015,01,010,0135,0,140,4,144,285,0,3,1,3,0,1,0,76.14,50.53 ,33.33
03,015,01,010,0136,0,24,0,24,51,0,3,1,3,0,1,0,76.14,47.06 ,33.33
03,015,01,010,0137,0,383,11,394,619,0,3,1,3,0,1,0,76.14,63.65 ,33.33
03,015,01,010,0138,0,143,3,146,305,0,3,1,3,0,1,0,76.14,47.87 ,33.33
03,015,01,010,0139,0,266,6,272,462,0,3,1,3,0,1,0,76.14,58.87 ,33.33
03,015,01,011,0140,0,2538,35,2573,4216,0,3,1,3,0,1,0,76.14,61.03 ,33.33
03,015,01,011,0141,0,837,9,846,1338,0,3,1,3,0,1,0,76.14,63.23 ,33.33
03,015,01,011,0142,0,994,17,1011,1701,0,3,1,3,0,1,0,76.14,59.44 ,33.33
03,015,01,011,0143,0,1174,73,1247,2886,0,3,1,3,0,1,0,76.14,43.21 ,33.33
03,015,01,011,0144,0,624,17,641,1078,0,3,1,3,0,1,0,76.14,59.46 ,33.33
03,015,01,011,0145,0,619,15,634,1100,0,3,1,3,0,1,0,76.14,57.64 ,33.33
03,015,01,011,0146,0,286,21,307,619,0,3,1,3,0,1,0,76.14,49.60 ,33.33
03,015,01,011,0147,0,198,6,204,401,0,3,1,3,0,1,0,76.14,50.87 ,33.33
03,015,01,011,0148,0,189,1,190,334,0,3,1,3,0,1,0,76.14,56.89 ,33.33
03,015,01,011,0149,0,510,12,522,1011,0,3,1,3,0,1,0,76.14,51.63 ,33.33
03,015,01,011,0150,0,253,8,261,532,0,3,1,3,0,1,0,76.14,49.06 ,33.33
03,015,01,011,0151,0,232,7,239,474,0,3,1,3,0,1,0,76.14,50.42 ,33.33
03,015,01,011,0152,0,29,1,30,81,0,3,1,3,0,1,0,76.14,37.04 ,33.33
03,015,01,011,0153,0,556,13,569,974,0,3,1,3,0,1,0,76.14,58.42 ,33.33
03,015,01,011,0154,0,586,8,594,1034,0,3,1,3,0,1,0,76.14,57.45 ,33.33
03,015,01,012,0155,0,225,7,232,435,0,3,1,3,0,1,0,76.14,53.33 ,33.33
03,015,01,012,0156,0,593,16,609,1199,0,3,1,3,0,1,0,76.14,50.79 ,33.33
03,015,01,012,0157,0,287,7,294,623,0,3,1,3,0,1,0,76.14,47.19 ,33.33
03,015,01,012,0158,0,289,9,298,571,0,3,1,3,0,1,0,76.14,52.19 ,33.33
03,015,01,012,0159,0,554,19,573,1012,0,3,1,3,0,1,0,76.14,56.62 ,33.33
03,015,01,012,0160,0,219,5,224,457,0,3,1,3,0,1,0,76.14,49.02 ,33.33
03,015,01,012,0161,0,482,15,497,855,0,3,1,3,0,1,0,76.14,58.13 ,33.33
03,015,01,012,0162,0,245,5,250,400,0,3,1,3,0,1,0,76.14,62.50 ,33.33
03,015,01,012,0163,0,880,24,904,1578,0,3,1,3,0,1,0,76.14,57.29 ,33.33
03,015,01,012,0164,0,255,2,257,519,0,3,1,3,0,1,0,76.14,49.52 ,33.33
03,015,01,012,0165,0,167,4,171,345,0,3,1,3,0,1,0,76.14,49.57 ,33.33
03,015,01,012,0166,0,270,6,276,523,0,3,1,3,0,1,0,76.14,52.77 ,33.33
03,015,01,012,0167,0,320,5,325,550,0,3,1,3,0,1,0,76.14,59.09 ,33.33
03,015,01,013,0168,0,13,2,15,27,0,3,1,3,0,1,0,76.14,55.56 ,33.33
03,015,01,013,0169,0,15,0,15,40,0,3,1,3,0,1,0,76.14,37.50 ,33.33
03,015,01,013,0170,0,25,0,25,34,0,3,1,3,0,1,0,76.14,73.53 ,33.33
03,015,01,013,0171,0,38,0,38,78,0,3,1,3,0,1,0,76.14,48.72 ,33.33
03,015,01,013,0172,0,47,2,49,88,0,3,1,3,0,1,0,76.14,55.68 ,33.33
03,015,01,013,0173,0,54,2,56,84,0,3,1,3,0,1,0,76.14,66.67 ,33.33
03,016,01,001,0001,0,210,3,213,341,0,3,1,3,0,1,0,76.14,62.46 ,33.33
03,016,01,001,0002,0,232,5,237,333,0,3,1,3,0,1,0,76.14,71.17 ,33.33
03,016,01,001,0003,0,346,4,350,534,0,3,1,3,0,1,0,76.14,65.54 ,33.33
03,016,01,001,0004,0,322,5,327,484,0,3,1,3,0,1,0,76.14,67.56 ,33.33
03,016,01,001,0005,0,534,5,539,855,0,3,1,3,0,1,0,76.14,63.04 ,33.33
03,016,01,001,0006,0,657,8,665,988,0,3,1,3,0,1,0,76.14,67.31 ,33.33
03,016,01,001,0007,0,509,10,519,755,0,3,1,3,0,1,0,76.14,68.74 ,33.33
03,016,01,001,0008,0,1180,13,1193,1826,0,3,1,3,0,1,0,76.14,65.33 ,33.33
03,016,01,001,0009,0,768,19,787,1189,0,3,1,3,0,1,0,76.14,66.19 ,33.33
03,016,01,001,0010,0,1448,19,1467,2196,0,3,1,3,0,1,0,76.14,66.80 ,33.33
03,016,01,001,0011,0,2701,23,2724,4278,0,3,1,3,0,1,0,76.14,63.67 ,33.33
03,016,01,001,0012,0,1405,14,1419,2233,0,3,1,3,0,1,0,76.14,63.55 ,33.33
03,016,01,001,0013,0,702,6,708,1069,0,3,1,3,0,1,0,76.14,66.23 ,33.33
03,016,01,001,0014,0,1740,28,1768,2610,0,3,1,3,0,1,0,76.14,67.74 ,33.33
03,016,01,001,0015,0,1225,23,1248,1902,0,3,1,3,0,1,0,76.14,65.62 ,33.33
03,016,01,001,0016,0,1188,16,1204,1841,0,3,1,3,0,1,0,76.14,65.40 ,33.33
03,016,01,001,0017,0,822,20,842,1207,0,3,1,3,0,1,0,76.14,69.76 ,33.33
03,016,01,001,0018,0,359,7,366,584,0,3,1,3,0,1,0,76.14,62.67 ,33.33
03,016,01,001,0019,0,358,5,363,519,0,3,1,3,0,1,0,76.14,69.94 ,33.33
03,016,01,001,0020,0,889,10,899,1392,0,3,1,3,0,1,0,76.14,64.58 ,33.33
03,016,01,001,0021,0,223,1,224,313,0,3,1,3,0,1,0,76.14,71.57 ,33.33
03,016,01,001,0022,0,871,10,881,1290,0,3,1,3,0,1,0,76.14,68.29 ,33.33
03,016,01,001,0023,0,282,7,289,427,0,3,1,3,0,1,0,76.14,67.68 ,33.33
03,016,01,001,0024,0,372,5,377,550,0,3,1,3,0,1,0,76.14,68.55 ,33.33
03,016,01,001,0025,0,523,10,533,791,0,3,1,3,0,1,0,76.14,67.38 ,33.33
03,016,01,001,0026,0,262,2,264,365,0,3,1,3,0,1,0,76.14,72.33 ,33.33
03,016,01,001,0027,0,1178,19,1197,1982,0,3,1,3,0,1,0,76.14,60.39 ,33.33
03,016,01,001,0028,0,732,10,742,1310,0,3,1,3,0,1,0,76.14,56.64 ,33.33
03,016,01,001,0029,0,114,3,117,175,0,3,1,3,0,1,0,76.14,66.86 ,33.33
03,016,01,001,0030,0,208,5,213,332,0,3,1,3,0,1,0,76.14,64.16 ,33.33
03,016,01,001,0031,0,661,10,671,1016,0,3,1,3,0,1,0,76.14,66.04 ,33.33
03,016,01,001,0032,0,626,12,638,1126,0,3,1,3,0,1,0,76.14,56.66 ,33.33
03,016,01,001,0033,0,194,8,202,691,0,3,1,3,0,1,0,76.14,29.23 ,33.33
03,016,01,001,0034,0,90,0,90,194,0,3,1,3,0,1,0,76.14,46.39 ,33.33
03,016,01,002,0035,0,549,6,555,824,0,3,1,3,0,1,0,76.14,67.35 ,33.33
03,016,01,002,0036,0,202,1,203,295,0,3,1,3,0,1,0,76.14,68.81 ,33.33
03,016,01,002,0037,0,120,1,121,203,0,3,1,3,0,1,0,76.14,59.61 ,33.33
03,016,01,002,0038,0,147,3,150,236,0,3,1,3,0,1,0,76.14,63.56 ,33.33
03,016,01,002,0039,0,359,6,365,599,0,3,1,3,0,1,0,76.14,60.93 ,33.33
03,016,01,002,0040,0,193,2,195,268,0,3,1,3,0,1,0,76.14,72.76 ,33.33
03,016,01,002,0041,0,354,6,360,540,0,3,1,3,0,1,0,76.14,66.67 ,33.33
03,016,01,002,0042,0,271,6,277,441,0,3,1,3,0,1,0,76.14,62.81 ,33.33
03,016,01,002,0043,0,253,3,256,402,0,3,1,3,0,1,0,76.14,63.68 ,33.33
03,016,01,002,0044,0,73,0,73,130,0,3,1,3,0,1,0,76.14,56.15 ,33.33
03,016,01,002,0045,0,462,4,466,695,0,3,1,3,0,1,0,76.14,67.05 ,33.33
03,016,01,002,0046,0,100,3,103,162,0,3,1,3,0,1,0,76.14,63.58 ,33.33
03,016,01,002,0047,0,185,2,187,277,0,3,1,3,0,1,0,76.14,67.51 ,33.33
03,016,01,002,0048,0,165,2,167,217,0,3,1,3,0,1,0,76.14,76.96 ,33.33
03,016,01,002,0049,0,126,1,127,182,0,3,1,3,0,1,0,76.14,69.78 ,33.33
03,016,01,002,0050,0,127,3,130,178,0,3,1,3,0,1,0,76.14,73.03 ,33.33
03,016,01,002,0051,0,70,1,71,120,0,3,1,3,0,1,0,76.14,59.17 ,33.33
03,016,01,002,0052,0,410,3,413,615,0,3,1,3,0,1,0,76.14,67.15 ,33.33
03,016,01,002,0053,0,490,10,500,814,0,3,1,3,0,1,0,76.14,61.43 ,33.33
03,016,01,002,0054,0,316,7,323,510,0,3,1,3,0,1,0,76.14,63.33 ,33.33
03,016,01,002,0055,0,948,10,958,1485,0,3,1,3,0,1,0,76.14,64.51 ,33.33
03,016,01,002,0056,0,372,4,376,616,0,3,1,3,0,1,0,76.14,61.04 ,33.33
03,016,01,003,0057,0,287,1,288,435,0,3,1,3,0,1,0,76.14,66.21 ,33.33
03,016,01,003,0058,0,339,2,341,522,0,3,1,3,0,1,0,76.14,65.33 ,33.33
03,016,01,003,0059,0,60,0,60,91,0,3,1,3,0,1,0,76.14,65.93 ,33.33
03,016,01,003,0060,0,70,1,71,102,0,3,1,3,0,1,0,76.14,69.61 ,33.33
03,016,01,003,0061,0,144,3,147,249,0,3,1,3,0,1,0,76.14,59.04 ,33.33
03,016,01,003,0062,0,109,2,111,207,0,3,1,3,0,1,0,76.14,53.62 ,33.33
03,016,01,003,0063,0,104,2,106,152,0,3,1,3,0,1,0,76.14,69.74 ,33.33
03,016,01,003,0064,0,851,6,857,1339,0,3,1,3,0,1,0,76.14,64.00 ,33.33
03,016,01,003,0065,0,169,0,169,281,0,3,1,3,0,1,0,76.14,60.14 ,33.33
03,016,01,003,0066,0,376,1,377,637,0,3,1,3,0,1,0,76.14,59.18 ,33.33
03,016,01,003,0067,0,396,6,402,666,0,3,1,3,0,1,0,76.14,60.36 ,33.33
03,016,01,003,0068,0,476,7,483,1142,0,3,1,3,0,1,0,76.14,42.29 ,33.33
03,016,01,003,0069,0,375,2,377,929,0,3,1,3,0,1,0,76.14,40.58 ,33.33
03,016,01,003,0070,0,105,1,106,209,0,3,1,3,0,1,0,76.14,50.72 ,33.33
03,016,01,003,0071,0,73,4,77,158,0,3,1,3,0,1,0,76.14,48.73 ,33.33
03,016,01,004,0072,0,142,7,149,237,0,3,1,3,0,1,0,76.14,62.87 ,33.33
03,016,01,004,0073,0,256,5,261,404,0,3,1,3,0,1,0,76.14,64.60 ,33.33
03,016,01,004,0074,0,422,19,441,760,0,3,1,3,0,1,0,76.14,58.03 ,33.33
03,016,01,004,0075,0,139,1,140,251,0,3,1,3,0,1,0,76.14,55.78 ,33.33
03,016,01,004,0076,0,329,11,340,588,0,3,1,3,0,1,0,76.14,57.82 ,33.33
03,016,01,004,0077,0,61,1,62,103,0,3,1,3,0,1,0,76.14,60.19 ,33.33
03,016,01,004,0078,0,299,12,311,486,0,3,1,3,0,1,0,76.14,63.99 ,33.33
03,016,01,004,0079,0,112,2,114,195,0,3,1,3,0,1,0,76.14,58.46 ,33.33
03,016,01,004,0080,0,321,8,329,605,0,3,1,3,0,1,0,76.14,54.38 ,33.33
03,016,01,004,0081,0,660,14,674,1147,0,3,1,3,0,1,0,76.14,58.76 ,33.33
03,016,01,004,0082,0,927,15,942,1730,0,3,1,3,0,1,0,76.14,54.45 ,33.33
03,016,01,005,0083,0,215,6,221,492,0,3,1,3,0,1,0,76.14,44.92 ,33.33
03,016,01,005,0084,0,166,2,168,322,0,3,1,3,0,1,0,76.14,52.17 ,33.33
03,016,01,005,0085,0,82,5,87,234,0,3,1,3,0,1,0,76.14,37.18 ,33.33
03,016,01,005,0086,0,133,2,135,285,0,3,1,3,0,1,0,76.14,47.37 ,33.33
03,016,01,005,0087,0,410,11,421,1328,0,3,1,3,0,1,0,76.14,31.70 ,33.33
03,016,01,005,0088,0,75,2,77,233,0,3,1,3,0,1,0,76.14,33.05 ,33.33
03,016,01,005,0089,0,76,0,76,316,0,3,1,3,0,1,0,76.14,24.05 ,33.33
03,016,01,005,0090,0,29,0,29,170,0,3,1,3,0,1,0,76.14,17.06 ,33.33
03,016,01,005,0091,0,103,3,106,253,0,3,1,3,0,1,0,76.14,41.90 ,33.33
03,016,01,006,0092,0,83,6,89,218,0,3,1,3,0,1,0,76.14,40.83 ,33.33
03,016,01,006,0093,0,154,4,158,448,0,3,1,3,0,1,0,76.14,35.27 ,33.33
03,016,01,006,0094,0,169,16,185,427,0,3,1,3,0,1,0,76.14,43.33 ,33.33
03,016,01,006,0095,0,97,6,103,277,0,3,1,3,0,1,0,76.14,37.18 ,33.33
03,016,01,006,0096,0,90,4,94,244,0,3,1,3,0,1,0,76.14,38.52 ,33.33
03,016,01,006,0097,0,315,7,322,789,0,3,1,3,0,1,0,76.14,40.81 ,33.33
03,017,01,001,0001,0,420,4,424,557,0,3,1,3,0,1,0,76.14,76.12 ,33.33
03,017,01,001,0002,0,1408,26,1434,2366,0,3,1,3,0,1,0,76.14,60.61 ,33.33
03,017,01,001,0003,0,974,8,982,1546,0,3,1,3,0,1,0,76.14,63.52 ,33.33
03,017,01,001,0004,0,771,8,779,1308,0,3,1,3,0,1,0,76.14,59.56 ,33.33
03,017,01,001,0005,0,2799,48,2847,5676,0,3,1,3,0,1,0,76.14,50.16 ,33.33
03,017,01,001,0006,0,939,20,959,1524,0,3,1,3,0,1,0,76.14,62.93 ,33.33
03,017,01,001,0007,0,1207,19,1226,1928,0,3,1,3,0,1,0,76.14,63.59 ,33.33
03,017,01,001,0008,0,561,14,575,918,0,3,1,3,0,1,0,76.14,62.64 ,33.33
03,017,01,001,0009,0,576,13,589,995,0,3,1,3,0,1,0,76.14,59.20 ,33.33
03,017,01,001,0010,0,744,21,765,1269,0,3,1,3,0,1,0,76.14,60.28 ,33.33
03,017,01,001,0011,0,1193,29,1222,1971,0,3,1,3,0,1,0,76.14,62.00 ,33.33
03,017,01,001,0012,0,875,13,888,1423,0,3,1,3,0,1,0,76.14,62.40 ,33.33
03,017,01,001,0013,0,1331,14,1345,2106,0,3,1,3,0,1,0,76.14,63.87 ,33.33
03,017,01,001,0014,0,1270,18,1288,2087,0,3,1,3,0,1,0,76.14,61.72 ,33.33
03,017,01,001,0015,0,900,12,912,1484,0,3,1,3,0,1,0,76.14,61.46 ,33.33
03,017,01,001,0016,0,1487,14,1501,2391,0,3,1,3,0,1,0,76.14,62.78 ,33.33
03,017,01,001,0017,0,874,5,879,1367,0,3,1,3,0,1,0,76.14,64.30 ,33.33
03,017,01,001,0018,0,832,14,846,1316,0,3,1,3,0,1,0,76.14,64.29 ,33.33
03,017,01,001,0019,0,997,7,1004,1535,0,3,1,3,0,1,0,76.14,65.41 ,33.33
03,017,01,001,0020,0,849,6,855,1363,0,3,1,3,0,1,0,76.14,62.73 ,33.33
03,017,01,001,0021,0,755,9,764,1210,0,3,1,3,0,1,0,76.14,63.14 ,33.33
03,017,01,001,0022,0,773,23,796,1224,0,3,1,3,0,1,0,76.14,65.03 ,33.33
03,017,01,001,0023,0,707,12,719,1072,0,3,1,3,0,1,0,76.14,67.07 ,33.33
03,017,01,001,0024,0,953,17,970,1488,0,3,1,3,0,1,0,76.14,65.19 ,33.33
03,017,01,001,0025,0,575,4,579,837,0,3,1,3,0,1,0,76.14,69.18 ,33.33
03,017,01,002,0026,0,796,13,809,1188,0,3,1,3,0,1,0,76.14,68.10 ,33.33
03,017,01,002,0027,0,792,14,806,1202,0,3,1,3,0,1,0,76.14,67.05 ,33.33
03,017,01,002,0028,0,670,6,676,1034,0,3,1,3,0,1,0,76.14,65.38 ,33.33
03,017,01,002,0029,0,1575,24,1599,2317,0,3,1,3,0,1,0,76.14,69.01 ,33.33
03,017,01,002,0030,0,610,7,617,861,0,3,1,3,0,1,0,76.14,71.66 ,33.33
03,017,01,002,0031,0,877,7,884,1312,0,3,1,3,0,1,0,76.14,67.38 ,33.33
03,017,01,002,0032,0,495,7,502,707,0,3,1,3,0,1,0,76.14,71.00 ,33.33
03,017,01,002,0033,0,1159,11,1170,1745,0,3,1,3,0,1,0,76.14,67.05 ,33.33
03,017,01,002,0034,0,1009,8,1017,1527,0,3,1,3,0,1,0,76.14,66.60 ,33.33
03,017,01,002,0035,0,972,10,982,1527,0,3,1,3,0,1,0,76.14,64.31 ,33.33
03,017,01,002,0036,0,1509,23,1532,2353,0,3,1,3,0,1,0,76.14,65.11 ,33.33
03,017,01,002,0037,0,1923,27,1950,3112,0,3,1,3,0,1,0,76.14,62.66 ,33.33
03,017,01,002,0038,0,1141,15,1156,1833,0,3,1,3,0,1,0,76.14,63.07 ,33.33
03,017,01,002,0039,0,2052,24,2076,3313,0,3,1,3,0,1,0,76.14,62.66 ,33.33
03,017,01,002,0040,0,1735,30,1765,2674,0,3,1,3,0,1,0,76.14,66.01 ,33.33
03,017,01,002,0041,0,1934,17,1951,3073,0,3,1,3,0,1,0,76.14,63.49 ,33.33
03,017,01,002,0042,0,3332,42,3374,5743,0,3,1,3,0,1,0,76.14,58.75 ,33.33
03,017,01,002,0043,0,538,4,542,887,0,3,1,3,0,1,0,76.14,61.10 ,33.33
03,017,01,003,0044,0,1137,22,1159,1788,0,3,1,3,0,1,0,76.14,64.82 ,33.33
03,017,01,003,0045,0,635,5,640,910,0,3,1,3,0,1,0,76.14,70.33 ,33.33
03,017,01,003,0046,0,999,16,1015,1526,0,3,1,3,0,1,0,76.14,66.51 ,33.33
03,017,01,003,0047,0,1125,19,1144,1725,0,3,1,3,0,1,0,76.14,66.32 ,33.33
03,017,01,003,0048,0,1433,23,1456,2243,0,3,1,3,0,1,0,76.14,64.91 ,33.33
03,017,01,003,0049,0,722,8,730,1112,0,3,1,3,0,1,0,76.14,65.65 ,33.33
03,017,01,003,0050,0,623,15,638,1032,0,3,1,3,0,1,0,76.14,61.82 ,33.33
03,017,01,003,0051,0,778,8,786,1157,0,3,1,3,0,1,0,76.14,67.93 ,33.33
03,017,01,003,0052,0,653,12,665,1011,0,3,1,3,0,1,0,76.14,65.78 ,33.33
03,017,01,003,0053,0,1159,11,1170,1691,0,3,1,3,0,1,0,76.14,69.19 ,33.33
03,017,01,003,0054,0,517,7,524,842,0,3,1,3,0,1,0,76.14,62.23 ,33.33
03,017,01,003,0055,0,664,16,680,1061,0,3,1,3,0,1,0,76.14,64.09 ,33.33
03,017,01,003,0056,0,1844,38,1882,2944,0,3,1,3,0,1,0,76.14,63.93 ,33.33
03,017,01,003,0057,0,519,13,532,871,0,3,1,3,0,1,0,76.14,61.08 ,33.33
03,017,01,003,0058,0,941,10,951,1476,0,3,1,3,0,1,0,76.14,64.43 ,33.33
03,017,01,003,0059,0,546,11,557,886,0,3,1,3,0,1,0,76.14,62.87 ,33.33
03,017,01,003,0060,0,866,18,884,1356,0,3,1,3,0,1,0,76.14,65.19 ,33.33
03,017,01,003,0061,0,626,8,634,981,0,3,1,3,0,1,0,76.14,64.63 ,33.33
03,017,01,003,0062,0,609,14,623,971,0,3,1,3,0,1,0,76.14,64.16 ,33.33
03,017,01,003,0063,0,700,20,720,1095,0,3,1,3,0,1,0,76.14,65.75 ,33.33
03,017,01,003,0064,0,405,5,410,655,0,3,1,3,0,1,0,76.14,62.60 ,33.33
03,017,01,003,0065,0,739,7,746,1164,0,3,1,3,0,1,0,76.14,64.09 ,33.33
03,017,01,003,0066,0,719,20,739,1126,0,3,1,3,0,1,0,76.14,65.63 ,33.33
03,017,01,003,0067,0,1881,31,1912,2895,0,3,1,3,0,1,0,76.14,66.04 ,33.33
03,017,01,003,0068,0,1487,16,1503,2293,0,3,1,3,0,1,0,76.14,65.55 ,33.33
03,017,01,003,0069,0,519,4,523,761,0,3,1,3,0,1,0,76.14,68.73 ,33.33
03,017,01,003,0070,0,477,4,481,663,0,3,1,3,0,1,0,76.14,72.55 ,33.33
03,017,01,003,0071,0,567,6,573,852,0,3,1,3,0,1,0,76.14,67.25 ,33.33
03,017,01,003,0072,0,496,8,504,735,0,3,1,3,0,1,0,76.14,68.57 ,33.33
03,017,01,004,0073,0,554,13,567,803,0,3,1,3,0,1,0,76.14,70.61 ,33.33
03,017,01,004,0074,0,742,15,757,1106,0,3,1,3,0,1,0,76.14,68.44 ,33.33
03,017,01,004,0075,0,686,8,694,994,0,3,1,3,0,1,0,76.14,69.82 ,33.33
03,017,01,004,0076,0,750,8,758,1124,0,3,1,3,0,1,0,76.14,67.44 ,33.33
03,017,01,004,0077,0,648,8,656,987,0,3,1,3,0,1,0,76.14,66.46 ,33.33
03,017,01,004,0078,0,872,16,888,1312,0,3,1,3,0,1,0,76.14,67.68 ,33.33
03,017,01,004,0079,0,532,15,547,836,0,3,1,3,0,1,0,76.14,65.43 ,33.33
03,017,01,004,0080,0,1014,27,1041,1558,0,3,1,3,0,1,0,76.14,66.82 ,33.33
03,017,01,004,0081,0,801,18,819,1268,0,3,1,3,0,1,0,76.14,64.59 ,33.33
03,017,01,004,0082,0,906,14,920,1526,0,3,1,3,0,1,0,76.14,60.29 ,33.33
03,017,01,004,0083,0,1323,22,1345,2051,0,3,1,3,0,1,0,76.14,65.58 ,33.33
03,017,01,004,0084,0,440,9,449,707,0,3,1,3,0,1,0,76.14,63.51 ,33.33
03,017,01,004,0085,0,479,6,485,772,0,3,1,3,0,1,0,76.14,62.82 ,33.33
03,017,01,004,0086,0,612,15,627,973,0,3,1,3,0,1,0,76.14,64.44 ,33.33
03,017,01,004,0087,0,1034,20,1054,1599,0,3,1,3,0,1,0,76.14,65.92 ,33.33
03,017,01,004,0088,0,653,17,670,1109,0,3,1,3,0,1,0,76.14,60.41 ,33.33
03,017,01,004,0089,0,1935,40,1975,3079,0,3,1,3,0,1,0,76.14,64.14 ,33.33
03,017,01,004,0090,0,2931,34,2965,4489,0,3,1,3,0,1,0,76.14,66.05 ,33.33
03,017,01,004,0091,0,4738,50,4788,8243,0,3,1,3,0,1,0,76.14,58.09 ,33.33
03,017,01,004,0092,0,1063,24,1087,1691,0,3,1,3,0,1,0,76.14,64.28 ,33.33
03,017,01,004,0093,0,637,5,642,988,0,3,1,3,0,1,0,76.14,64.98 ,33.33
03,017,01,004,0094,0,657,16,673,1014,0,3,1,3,0,1,0,76.14,66.37 ,33.33
03,017,01,004,0095,0,538,9,547,863,0,3,1,3,0,1,0,76.14,63.38 ,33.33
03,017,01,005,0096,0,925,21,946,1485,0,3,1,3,0,1,0,76.14,63.70 ,33.33
03,017,01,005,0097,0,872,16,888,1377,0,3,1,3,0,1,0,76.14,64.49 ,33.33
03,017,01,005,0098,0,786,18,804,1273,0,3,1,3,0,1,0,76.14,63.16 ,33.33
03,017,01,005,0099,0,839,20,859,1331,0,3,1,3,0,1,0,76.14,64.54 ,33.33
03,017,01,005,0100,0,1483,30,1513,2327,0,3,1,3,0,1,0,76.14,65.02 ,33.33
03,017,01,005,0101,0,1221,32,1253,2015,0,3,1,3,0,1,0,76.14,62.18 ,33.33
03,017,01,005,0102,0,651,11,662,1057,0,3,1,3,0,1,0,76.14,62.63 ,33.33
03,017,01,005,0103,0,581,9,590,896,0,3,1,3,0,1,0,76.14,65.85 ,33.33
03,017,01,005,0104,0,467,8,475,704,0,3,1,3,0,1,0,76.14,67.47 ,33.33
03,017,01,005,0105,0,2069,26,2095,3282,0,3,1,3,0,1,0,76.14,63.83 ,33.33
03,017,01,005,0106,0,2952,34,2986,4834,0,3,1,3,0,1,0,76.14,61.77 ,33.33
03,017,01,005,0107,0,1774,21,1795,2840,0,3,1,3,0,1,0,76.14,63.20 ,33.33
03,017,01,005,0108,0,2502,37,2539,4155,0,3,1,3,0,1,0,76.14,61.11 ,33.33
03,017,01,005,0109,0,2434,37,2471,3739,0,3,1,3,0,1,0,76.14,66.09 ,33.33
03,017,01,005,0110,0,2072,35,2107,3317,0,3,1,3,0,1,0,76.14,63.52 ,33.33
03,017,01,005,0111,0,1420,9,1429,2309,0,3,1,3,0,1,0,76.14,61.89 ,33.33
03,017,01,005,0112,0,2184,28,2212,3382,0,3,1,3,0,1,0,76.14,65.41 ,33.33
03,017,01,005,0113,0,3689,51,3740,6324,0,3,1,3,0,1,0,76.14,59.14 ,33.33
03,017,01,005,0114,0,1708,25,1733,2900,0,3,1,3,0,1,0,76.14,59.76 ,33.33
03,017,01,005,0115,0,1658,19,1677,2912,0,3,1,3,0,1,0,76.14,57.59 ,33.33
03,017,01,005,0116,0,725,12,737,1211,0,3,1,3,0,1,0,76.14,60.86 ,33.33
03,017,01,005,0117,0,1823,30,1853,3334,0,3,1,3,0,1,0,76.14,55.58 ,33.33
03,017,01,006,0118,0,733,8,741,1177,0,3,1,3,0,1,0,76.14,62.96 ,33.33
03,017,01,006,0119,0,401,5,406,636,0,3,1,3,0,1,0,76.14,63.84 ,33.33
03,017,01,006,0120,0,488,6,494,746,0,3,1,3,0,1,0,76.14,66.22 ,33.33
03,017,01,006,0121,0,408,6,414,650,0,3,1,3,0,1,0,76.14,63.69 ,33.33
03,017,01,006,0122,0,1932,23,1955,3158,0,3,1,3,0,1,0,76.14,61.91 ,33.33
03,017,01,006,0123,0,1350,21,1371,2126,0,3,1,3,0,1,0,76.14,64.49 ,33.33
03,017,01,006,0124,0,1323,23,1346,2120,0,3,1,3,0,1,0,76.14,63.49 ,33.33
03,017,01,006,0125,0,257,8,265,389,0,3,1,3,0,1,0,76.14,68.12 ,33.33
03,017,01,006,0126,0,2063,39,2102,3499,0,3,1,3,0,1,0,76.14,60.07 ,33.33
03,017,01,006,0127,0,1346,18,1364,2277,0,3,1,3,0,1,0,76.14,59.90 ,33.33
03,017,01,006,0128,0,1429,17,1446,2308,0,3,1,3,0,1,0,76.14,62.65 ,33.33
03,017,01,006,0129,0,1650,17,1667,3188,0,3,1,3,0,1,0,76.14,52.29 ,33.33
03,017,01,006,0130,0,2430,47,2477,4209,0,3,1,3,0,1,0,76.14,58.85 ,33.33
03,017,01,007,0131,0,2388,49,2437,3688,0,3,1,3,0,1,0,76.14,66.08 ,33.33
03,017,01,007,0132,0,1374,27,1401,2040,0,3,1,3,0,1,0,76.14,68.68 ,33.33
03,017,01,007,0133,0,1359,18,1377,2000,0,3,1,3,0,1,0,76.14,68.85 ,33.33
03,017,01,007,0134,0,2393,22,2415,3581,0,3,1,3,0,1,0,76.14,67.44 ,33.33
03,017,01,007,0135,0,1387,19,1406,2071,0,3,1,3,0,1,0,76.14,67.89 ,33.33
03,017,01,007,0136,0,1381,31,1412,2034,0,3,1,3,0,1,0,76.14,69.42 ,33.33
03,017,01,007,0137,0,1000,19,1019,1520,0,3,1,3,0,1,0,76.14,67.04 ,33.33
03,017,01,007,0138,0,595,13,608,932,0,3,1,3,0,1,0,76.14,65.24 ,33.33
03,017,01,007,0139,0,1994,31,2025,3112,0,3,1,3,0,1,0,76.14,65.07 ,33.33
03,017,01,007,0140,0,871,16,887,1396,0,3,1,3,0,1,0,76.14,63.54 ,33.33
03,017,01,007,0141,0,1766,31,1797,3089,0,3,1,3,0,1,0,76.14,58.17 ,33.33
03,017,01,007,0142,0,1794,22,1816,2935,0,3,1,3,0,1,0,76.14,61.87 ,33.33
03,017,01,007,0143,0,2636,29,2665,4309,0,3,1,3,0,1,0,76.14,61.85 ,33.33
03,017,01,007,0144,0,1876,30,1906,3211,0,3,1,3,0,1,0,76.14,59.36 ,33.33
03,017,01,007,0145,0,287,4,291,457,0,3,1,3,0,1,0,76.14,63.68 ,33.33
03,017,01,007,0146,0,223,6,229,315,0,3,1,3,0,1,0,76.14,72.70 ,33.33
03,017,01,007,0147,0,235,6,241,360,0,3,1,3,0,1,0,76.14,66.94 ,33.33
03,017,01,007,0148,0,746,9,755,1171,0,3,1,3,0,1,0,76.14,64.47 ,33.33
03,017,01,007,0149,0,304,11,315,443,0,3,1,3,0,1,0,76.14,71.11 ,33.33
03,018,01,001,0001,0,592,6,598,1093,0,3,1,3,0,1,0,76.14,54.71 ,33.33
03,018,01,001,0002,0,1092,10,1102,1786,0,3,1,3,0,1,0,76.14,61.70 ,33.33
03,018,01,001,0003,0,483,6,489,766,0,3,1,3,0,1,0,76.14,63.84 ,33.33
03,018,01,001,0004,0,483,9,492,783,0,3,1,3,0,1,0,76.14,62.84 ,33.33
03,018,01,001,0005,0,262,5,267,468,0,3,1,3,0,1,0,76.14,57.05 ,33.33
03,018,01,001,0006,0,311,5,316,523,0,3,1,3,0,1,0,76.14,60.42 ,33.33
03,018,01,001,0007,0,1185,13,1198,1825,0,3,1,3,0,1,0,76.14,65.64 ,33.33
03,018,01,001,0008,0,2095,26,2121,3291,0,3,1,3,0,1,0,76.14,64.45 ,33.33
03,018,01,001,0009,0,2258,29,2287,3617,0,3,1,3,0,1,0,76.14,63.23 ,33.33
03,018,01,001,0010,0,2119,20,2139,3340,0,3,1,3,0,1,0,76.14,64.04 ,33.33
03,018,01,001,0011,0,2412,23,2435,3722,0,3,1,3,0,1,0,76.14,65.42 ,33.33
03,018,01,001,0012,0,1532,24,1556,2452,0,3,1,3,0,1,0,76.14,63.46 ,33.33
03,018,01,001,0013,0,1352,22,1374,2176,0,3,1,3,0,1,0,76.14,63.14 ,33.33
03,018,01,001,0014,0,1299,27,1326,2061,0,3,1,3,0,1,0,76.14,64.34 ,33.33
03,018,01,001,0015,0,1861,12,1873,2895,0,3,1,3,0,1,0,76.14,64.70 ,33.33
03,018,01,001,0016,0,2543,36,2579,3969,0,3,1,3,0,1,0,76.14,64.98 ,33.33
03,018,01,001,0017,0,1120,18,1138,1786,0,3,1,3,0,1,0,76.14,63.72 ,33.33
03,018,01,001,0018,0,656,23,679,1037,0,3,1,3,0,1,0,76.14,65.48 ,33.33
03,018,01,001,0019,0,1462,21,1483,2331,0,3,1,3,0,1,0,76.14,63.62 ,33.33
03,018,01,001,0020,0,1859,26,1885,2942,0,3,1,3,0,1,0,76.14,64.07 ,33.33
03,018,01,001,0021,0,1156,22,1178,1661,0,3,1,3,0,1,0,76.14,70.92 ,33.33
03,018,01,001,0022,0,1539,19,1558,2466,0,3,1,3,0,1,0,76.14,63.18 ,33.33
03,018,01,001,0023,0,174,2,176,335,0,3,1,3,0,1,0,76.14,52.54 ,33.33
03,018,01,001,0024,0,1075,16,1091,1520,0,3,1,3,0,1,0,76.14,71.78 ,33.33
03,018,01,001,0025,0,2004,28,2032,3102,0,3,1,3,0,1,0,76.14,65.51 ,33.33
03,018,01,001,0026,0,511,8,519,763,0,3,1,3,0,1,0,76.14,68.02 ,33.33
03,018,01,001,0027,0,1986,24,2010,2903,0,3,1,3,0,1,0,76.14,69.24 ,33.33
03,018,01,001,0028,0,1923,20,1943,3055,0,3,1,3,0,1,0,76.14,63.60 ,33.33
03,018,01,001,0029,0,1822,22,1844,2732,0,3,1,3,0,1,0,76.14,67.50 ,33.33
03,018,01,001,0030,0,3068,40,3108,4681,0,3,1,3,0,1,0,76.14,66.40 ,33.33
03,018,01,001,0031,0,1370,21,1391,2162,0,3,1,3,0,1,0,76.14,64.34 ,33.33
03,018,01,001,0032,0,2485,62,2547,3851,0,3,1,3,0,1,0,76.14,66.14 ,33.33
03,018,01,001,0033,0,2184,43,2227,3530,0,3,1,3,0,1,0,76.14,63.09 ,33.33
03,018,01,001,0034,0,2361,38,2399,3818,0,3,1,3,0,1,0,76.14,62.83 ,33.33
03,018,01,001,0035,0,1905,16,1921,2968,0,3,1,3,0,1,0,76.14,64.72 ,33.33
03,018,01,001,0036,0,500,4,504,808,0,3,1,3,0,1,0,76.14,62.38 ,33.33
03,018,01,001,0037,0,346,7,353,590,0,3,1,3,0,1,0,76.14,59.83 ,33.33
03,018,01,001,0038,0,426,1,427,654,0,3,1,3,0,1,0,76.14,65.29 ,33.33
03,018,01,001,0039,0,599,4,603,904,0,3,1,3,0,1,0,76.14,66.70 ,33.33
03,018,01,001,0040,0,765,9,774,1223,0,3,1,3,0,1,0,76.14,63.29 ,33.33
03,018,01,001,0041,0,2549,30,2579,4284,0,3,1,3,0,1,0,76.14,60.20 ,33.33
03,018,01,001,0042,0,1956,27,1983,3015,0,3,1,3,0,1,0,76.14,65.77 ,33.33
03,018,01,001,0043,0,503,13,516,820,0,3,1,3,0,1,0,76.14,62.93 ,33.33
03,018,01,001,0044,0,538,5,543,809,0,3,1,3,0,1,0,76.14,67.12 ,33.33
03,018,01,001,0045,0,763,19,782,1185,0,3,1,3,0,1,0,76.14,65.99 ,33.33
03,018,01,001,0046,0,1835,41,1876,2976,0,3,1,3,0,1,0,76.14,63.04 ,33.33
03,018,01,001,0047,0,943,11,954,1530,0,3,1,3,0,1,0,76.14,62.35 ,33.33
03,018,01,001,0048,0,1943,39,1982,3088,0,3,1,3,0,1,0,76.14,64.18 ,33.33
03,018,01,001,0049,0,1745,33,1778,2865,0,3,1,3,0,1,0,76.14,62.06 ,33.33
03,018,01,001,0050,0,2810,36,2846,4504,0,3,1,3,0,1,0,76.14,63.19 ,33.33
03,018,01,001,0051,0,1732,26,1758,2681,0,3,1,3,0,1,0,76.14,65.57 ,33.33
03,018,01,001,0052,0,1880,36,1916,3005,0,3,1,3,0,1,0,76.14,63.76 ,33.33
03,018,01,001,0053,0,1579,23,1602,2885,0,3,1,3,0,1,0,76.14,55.53 ,33.33
03,018,01,002,0054,0,326,1,327,500,0,3,1,3,0,1,0,76.14,65.40 ,33.33
03,018,01,002,0055,0,563,4,567,838,0,3,1,3,0,1,0,76.14,67.66 ,33.33
03,018,01,002,0056,0,356,4,360,525,0,3,1,3,0,1,0,76.14,68.57 ,33.33
03,018,01,002,0057,0,327,3,330,537,0,3,1,3,0,1,0,76.14,61.45 ,33.33
03,018,01,002,0058,0,478,4,482,751,0,3,1,3,0,1,0,76.14,64.18 ,33.33
03,018,01,002,0059,0,767,13,780,1130,0,3,1,3,0,1,0,76.14,69.03 ,33.33
03,018,01,002,0060,0,831,10,841,1265,0,3,1,3,0,1,0,76.14,66.48 ,33.33
03,018,01,002,0061,0,2175,27,2202,3455,0,3,1,3,0,1,0,76.14,63.73 ,33.33
03,018,01,002,0062,0,704,8,712,1163,0,3,1,3,0,1,0,76.14,61.22 ,33.33
03,018,01,002,0063,0,2957,74,3031,4657,0,3,1,3,0,1,0,76.14,65.08 ,33.33
03,018,01,002,0064,0,1606,20,1626,2424,0,3,1,3,0,1,0,76.14,67.08 ,33.33
03,018,01,002,0065,0,1957,25,1982,3094,0,3,1,3,0,1,0,76.14,64.06 ,33.33
03,018,01,002,0066,0,2117,35,2152,3187,0,3,1,3,0,1,0,76.14,67.52 ,33.33
03,018,01,002,0067,0,1059,20,1079,1513,0,3,1,3,0,1,0,76.14,71.32 ,33.33
03,018,01,002,0068,0,501,4,505,796,0,3,1,3,0,1,0,76.14,63.44 ,33.33
03,018,01,002,0069,0,436,3,439,669,0,3,1,3,0,1,0,76.14,65.62 ,33.33
03,018,01,002,0070,0,345,5,350,598,0,3,1,3,0,1,0,76.14,58.53 ,33.33
03,018,01,002,0071,0,845,19,864,1323,0,3,1,3,0,1,0,76.14,65.31 ,33.33
03,018,01,002,0072,0,767,12,779,1183,0,3,1,3,0,1,0,76.14,65.85 ,33.33
03,018,01,002,0073,0,567,4,571,899,0,3,1,3,0,1,0,76.14,63.52 ,33.33
03,018,01,002,0074,0,2361,34,2395,3884,0,3,1,3,0,1,0,76.14,61.66 ,33.33
03,018,01,002,0075,0,2423,35,2458,3826,0,3,1,3,0,1,0,76.14,64.24 ,33.33
03,018,01,002,0076,0,2286,34,2320,3610,0,3,1,3,0,1,0,76.14,64.27 ,33.33
03,018,01,002,0077,0,2027,30,2057,3130,0,3,1,3,0,1,0,76.14,65.72 ,33.33
03,018,01,002,0078,0,1613,21,1634,2514,0,3,1,3,0,1,0,76.14,65.00 ,33.33
03,018,01,002,0079,0,1290,21,1311,2035,0,3,1,3,0,1,0,76.14,64.42 ,33.33
03,018,01,002,0080,0,1606,28,1634,2777,0,3,1,3,0,1,0,76.14,58.84 ,33.33
03,018,01,002,0081,0,2099,28,2127,3397,0,3,1,3,0,1,0,76.14,62.61 ,33.33
03,018,01,002,0082,0,1426,22,1448,2256,0,3,1,3,0,1,0,76.14,64.18 ,33.33
03,018,01,002,0083,0,846,14,860,1246,0,3,1,3,0,1,0,76.14,69.02 ,33.33
03,018,01,002,0084,0,2223,22,2245,3538,0,3,1,3,0,1,0,76.14,63.45 ,33.33
03,018,01,002,0085,0,2589,30,2619,4230,0,3,1,3,0,1,0,76.14,61.91 ,33.33
03,018,01,002,0086,0,2414,37,2451,3927,0,3,1,3,0,1,0,76.14,62.41 ,33.33
03,018,01,002,0087,0,822,7,829,1207,0,3,1,3,0,1,0,76.14,68.68 ,33.33
03,018,01,002,0088,0,1828,28,1856,2851,0,3,1,3,0,1,0,76.14,65.10 ,33.33
03,018,01,002,0089,0,2197,35,2232,3506,0,3,1,3,0,1,0,76.14,63.66 ,33.33
03,018,01,002,0090,0,1960,34,1994,2881,0,3,1,3,0,1,0,76.14,69.21 ,33.33
03,018,01,002,0091,0,506,12,518,855,0,3,1,3,0,1,0,76.14,60.58 ,33.33
03,018,01,002,0092,0,2084,34,2118,3556,0,3,1,3,0,1,0,76.14,59.56 ,33.33
03,018,01,002,0093,0,1049,25,1074,1690,0,3,1,3,0,1,0,76.14,63.55 ,33.33
03,018,01,002,0094,0,826,9,835,1318,0,3,1,3,0,1,0,76.14,63.35 ,33.33
03,018,01,002,0095,0,843,14,857,1400,0,3,1,3,0,1,0,76.14,61.21 ,33.33
03,018,01,002,0096,0,707,19,726,1122,0,3,1,3,0,1,0,76.14,64.71 ,33.33
03,018,01,002,0097,0,313,3,316,501,0,3,1,3,0,1,0,76.14,63.07 ,33.33
03,018,01,003,0098,0,1822,21,1843,2933,0,3,1,3,0,1,0,76.14,62.84 ,33.33
03,018,01,003,0099,0,1526,22,1548,2486,0,3,1,3,0,1,0,76.14,62.27 ,33.33
03,018,01,003,0100,0,1392,20,1412,2216,0,3,1,3,0,1,0,76.14,63.72 ,33.33
03,018,01,003,0101,0,1272,14,1286,2186,0,3,1,3,0,1,0,76.14,58.83 ,33.33
03,018,01,003,0102,0,1462,13,1475,2276,0,3,1,3,0,1,0,76.14,64.81 ,33.33
03,018,01,003,0103,0,1053,19,1072,1746,0,3,1,3,0,1,0,76.14,61.40 ,33.33
03,018,01,003,0104,0,957,22,979,1525,0,3,1,3,0,1,0,76.14,64.20 ,33.33
03,018,01,003,0105,0,1266,22,1288,1914,0,3,1,3,0,1,0,76.14,67.29 ,33.33
03,018,01,003,0106,0,2611,42,2653,4433,0,3,1,3,0,1,0,76.14,59.85 ,33.33
03,018,01,003,0107,0,1082,23,1105,1690,0,3,1,3,0,1,0,76.14,65.38 ,33.33
03,018,01,003,0108,0,1144,19,1163,1867,0,3,1,3,0,1,0,76.14,62.29 ,33.33
03,018,01,003,0109,0,1174,29,1203,1920,0,3,1,3,0,1,0,76.14,62.66 ,33.33
03,018,01,003,0110,0,1686,18,1704,2721,0,3,1,3,0,1,0,76.14,62.62 ,33.33
03,018,01,003,0111,0,1287,18,1305,1924,0,3,1,3,0,1,0,76.14,67.83 ,33.33
03,018,01,003,0112,0,585,8,593,960,0,3,1,3,0,1,0,76.14,61.77 ,33.33
03,018,01,003,0113,0,1101,18,1119,1687,0,3,1,3,0,1,0,76.14,66.33 ,33.33
03,018,01,003,0114,0,1130,22,1152,1720,0,3,1,3,0,1,0,76.14,66.98 ,33.33
03,018,01,003,0115,0,740,16,756,1131,0,3,1,3,0,1,0,76.14,66.84 ,33.33
03,018,01,003,0116,0,1947,30,1977,3270,0,3,1,3,0,1,0,76.14,60.46 ,33.33
03,018,01,003,0117,0,478,8,486,755,0,3,1,3,0,1,0,76.14,64.37 ,33.33
03,018,01,003,0118,0,761,15,776,1250,0,3,1,3,0,1,0,76.14,62.08 ,33.33
03,018,01,003,0119,0,381,8,389,623,0,3,1,3,0,1,0,76.14,62.44 ,33.33
03,018,01,003,0120,0,471,8,479,680,0,3,1,3,0,1,0,76.14,70.44 ,33.33
03,018,01,003,0121,0,467,10,477,722,0,3,1,3,0,1,0,76.14,66.07 ,33.33
03,019,01,001,0001,0,595,12,607,926,0,3,1,3,0,1,0,76.14,65.55 ,33.33
03,019,01,001,0002,0,729,10,739,1051,0,3,1,3,0,1,0,76.14,70.31 ,33.33
03,019,01,001,0003,0,710,8,718,1116,0,3,1,3,0,1,0,76.14,64.34 ,33.33
03,019,01,001,0004,0,862,15,877,1409,0,3,1,3,0,1,0,76.14,62.24 ,33.33
03,019,01,001,0005,0,557,8,565,868,0,3,1,3,0,1,0,76.14,65.09 ,33.33
03,019,01,001,0006,0,839,14,853,1271,0,3,1,3,0,1,0,76.14,67.11 ,33.33
03,019,01,001,0007,0,703,11,714,1137,0,3,1,3,0,1,0,76.14,62.80 ,33.33
03,019,01,001,0008,0,920,16,936,1406,0,3,1,3,0,1,0,76.14,66.57 ,33.33
03,019,01,001,0009,0,706,12,718,1119,0,3,1,3,0,1,0,76.14,64.16 ,33.33
03,019,01,001,0010,0,721,14,735,1123,0,3,1,3,0,1,0,76.14,65.45 ,33.33
03,019,01,001,0011,0,643,15,658,1028,0,3,1,3,0,1,0,76.14,64.01 ,33.33
03,019,01,001,0012,0,774,16,790,1248,0,3,1,3,0,1,0,76.14,63.30 ,33.33
03,019,01,001,0013,0,776,13,789,1163,0,3,1,3,0,1,0,76.14,67.84 ,33.33
03,019,01,001,0014,0,701,10,711,1109,0,3,1,3,0,1,0,76.14,64.11 ,33.33
03,019,01,002,0015,0,710,15,725,1053,0,3,1,3,0,1,0,76.14,68.85 ,33.33
03,019,01,002,0016,0,405,13,418,651,0,3,1,3,0,1,0,76.14,64.21 ,33.33
03,019,01,002,0017,0,522,5,527,838,0,3,1,3,0,1,0,76.14,62.89 ,33.33
03,019,01,002,0018,0,617,7,624,897,0,3,1,3,0,1,0,76.14,69.57 ,33.33
03,019,01,002,0019,0,1601,22,1623,2385,0,3,1,3,0,1,0,76.14,68.05 ,33.33
03,019,01,002,0020,0,841,16,857,1286,0,3,1,3,0,1,0,76.14,66.64 ,33.33
03,019,01,002,0021,0,634,6,640,972,0,3,1,3,0,1,0,76.14,65.84 ,33.33
03,019,01,002,0022,0,2535,38,2573,3749,0,3,1,3,0,1,0,76.14,68.63 ,33.33
03,019,01,002,0023,0,1351,18,1369,1939,0,3,1,3,0,1,0,76.14,70.60 ,33.33
03,019,01,002,0024,0,512,12,524,818,0,3,1,3,0,1,0,76.14,64.06 ,33.33
03,019,01,002,0025,0,535,6,541,828,0,3,1,3,0,1,0,76.14,65.34 ,33.33
03,019,01,002,0026,0,741,2,743,1102,0,3,1,3,0,1,0,76.14,67.42 ,33.33
03,019,01,002,0027,0,429,7,436,644,0,3,1,3,0,1,0,76.14,67.70 ,33.33
03,019,01,002,0028,0,665,10,675,996,0,3,1,3,0,1,0,76.14,67.77 ,33.33
03,019,01,002,0029,0,974,9,983,1417,0,3,1,3,0,1,0,76.14,69.37 ,33.33
03,019,01,002,0030,0,897,23,920,1354,0,3,1,3,0,1,0,76.14,67.95 ,33.33
03,019,01,002,0031,0,3358,60,3418,4950,0,3,1,3,0,1,0,76.14,69.05 ,33.33
03,019,01,002,0032,0,3862,64,3926,6018,0,3,1,3,0,1,0,76.14,65.24 ,33.33
03,019,01,002,0033,0,2233,36,2269,3400,0,3,1,3,0,1,0,76.14,66.74 ,33.33
03,019,01,002,0034,0,962,18,980,1519,0,3,1,3,0,1,0,76.14,64.52 ,33.33
03,019,01,002,0035,0,1322,11,1333,1920,0,3,1,3,0,1,0,76.14,69.43 ,33.33
03,019,01,002,0036,0,860,15,875,1335,0,3,1,3,0,1,0,76.14,65.54 ,33.33
03,019,01,002,0037,0,490,7,497,802,0,3,1,3,0,1,0,76.14,61.97 ,33.33
03,019,01,002,0038,0,869,22,891,1346,0,3,1,3,0,1,0,76.14,66.20 ,33.33
03,019,01,002,0039,0,988,17,1005,1475,0,3,1,3,0,1,0,76.14,68.14 ,33.33
03,019,01,002,0040,0,925,19,944,1418,0,3,1,3,0,1,0,76.14,66.57 ,33.33
03,019,01,002,0041,0,3274,52,3326,4842,0,3,1,3,0,1,0,76.14,68.69 ,33.33
03,019,01,003,0042,0,448,2,450,674,0,3,1,3,0,1,0,76.14,66.77 ,33.33
03,019,01,003,0043,0,459,4,463,710,0,3,1,3,0,1,0,76.14,65.21 ,33.33
03,019,01,003,0044,0,555,8,563,790,0,3,1,3,0,1,0,76.14,71.27 ,33.33
03,019,01,003,0045,0,1151,16,1167,1711,0,3,1,3,0,1,0,76.14,68.21 ,33.33
03,019,01,003,0046,0,634,17,651,968,0,3,1,3,0,1,0,76.14,67.25 ,33.33
03,019,01,003,0047,0,745,13,758,1064,0,3,1,3,0,1,0,76.14,71.24 ,33.33
03,019,01,003,0048,0,920,17,937,1392,0,3,1,3,0,1,0,76.14,67.31 ,33.33
03,019,01,003,0049,0,673,8,681,1026,0,3,1,3,0,1,0,76.14,66.37 ,33.33
03,019,01,003,0050,0,2281,35,2316,3418,0,3,1,3,0,1,0,76.14,67.76 ,33.33
03,019,01,003,0051,0,2056,40,2096,3157,0,3,1,3,0,1,0,76.14,66.39 ,33.33
03,019,01,003,0052,0,1625,23,1648,2442,0,3,1,3,0,1,0,76.14,67.49 ,33.33
03,019,01,003,0053,0,1745,34,1779,2698,0,3,1,3,0,1,0,76.14,65.94 ,33.33
03,019,01,003,0054,0,1241,17,1258,1814,0,3,1,3,0,1,0,76.14,69.35 ,33.33
03,019,01,003,0055,0,1660,26,1686,2944,0,3,1,3,0,1,0,76.14,57.27 ,33.33
03,019,01,003,0056,0,1826,31,1857,2747,0,3,1,3,0,1,0,76.14,67.60 ,33.33
03,019,01,003,0057,0,4484,83,4567,7161,0,3,1,3,0,1,0,76.14,63.78 ,33.33
03,019,01,003,0058,0,5509,89,5598,8772,0,3,1,3,0,1,0,76.14,63.82 ,33.33
03,019,01,003,0059,0,4519,67,4586,7206,0,3,1,3,0,1,0,76.14,63.64 ,33.33
03,019,01,003,0060,0,5081,92,5173,8160,0,3,1,3,0,1,0,76.14,63.39 ,33.33
03,019,01,003,0061,0,2192,42,2234,3646,0,3,1,3,0,1,0,76.14,61.27 ,33.33
03,019,01,003,0062,0,4048,61,4109,6044,0,3,1,3,0,1,0,76.14,67.98 ,33.33
03,019,01,004,0063,0,973,13,986,1425,0,3,1,3,0,1,0,76.14,69.19 ,33.33
03,019,01,004,0064,0,439,6,445,627,0,3,1,3,0,1,0,76.14,70.97 ,33.33
03,019,01,004,0065,0,1288,19,1307,2040,0,3,1,3,0,1,0,76.14,64.07 ,33.33
03,019,01,004,0066,0,966,9,975,1542,0,3,1,3,0,1,0,76.14,63.23 ,33.33
03,019,01,004,0067,0,2672,48,2720,4005,0,3,1,3,0,1,0,76.14,67.92 ,33.33
03,019,01,004,0068,0,1352,18,1370,1905,0,3,1,3,0,1,0,76.14,71.92 ,33.33
03,019,01,004,0069,0,1643,28,1671,2381,0,3,1,3,0,1,0,76.14,70.18 ,33.33
03,019,01,004,0070,0,2999,52,3051,4536,0,3,1,3,0,1,0,76.14,67.26 ,33.33
03,019,01,004,0071,0,508,11,519,772,0,3,1,3,0,1,0,76.14,67.23 ,33.33
03,019,01,004,0072,0,1022,12,1034,1606,0,3,1,3,0,1,0,76.14,64.38 ,33.33
03,019,01,004,0073,0,778,8,786,1201,0,3,1,3,0,1,0,76.14,65.45 ,33.33
03,019,01,004,0074,0,752,7,759,1136,0,3,1,3,0,1,0,76.14,66.81 ,33.33
03,019,01,004,0075,0,883,9,892,1322,0,3,1,3,0,1,0,76.14,67.47 ,33.33
03,019,01,004,0076,0,742,9,751,1143,0,3,1,3,0,1,0,76.14,65.70 ,33.33
03,019,01,004,0077,0,1333,27,1360,2052,0,3,1,3,0,1,0,76.14,66.28 ,33.33
03,019,01,004,0078,0,774,13,787,1209,0,3,1,3,0,1,0,76.14,65.10 ,33.33
03,019,01,004,0079,0,1155,11,1166,1829,0,3,1,3,0,1,0,76.14,63.75 ,33.33
03,019,01,004,0080,0,1259,13,1272,1909,0,3,1,3,0,1,0,76.14,66.63 ,33.33
03,019,01,004,0081,0,671,6,677,984,0,3,1,3,0,1,0,76.14,68.80 ,33.33
03,019,01,004,0082,0,1418,28,1446,2182,0,3,1,3,0,1,0,76.14,66.27 ,33.33
03,019,01,004,0083,0,3780,51,3831,5546,0,3,1,3,0,1,0,76.14,69.08 ,33.33
03,019,01,004,0084,0,2485,34,2519,3807,0,3,1,3,0,1,0,76.14,66.17 ,33.33
03,019,01,004,0085,0,2824,34,2858,4342,0,3,1,3,0,1,0,76.14,65.82 ,33.33
03,019,01,004,0086,0,3181,42,3223,4879,0,3,1,3,0,1,0,76.14,66.06 ,33.33
03,019,01,004,0087,0,6975,79,7054,10709,0,3,1,3,0,1,0,76.14,65.87 ,33.33
03,019,01,004,0088,0,1793,31,1824,2581,0,3,1,3,0,1,0,76.14,70.67 ,33.33
03,019,01,004,0089,0,2086,33,2119,3088,0,3,1,3,0,1,0,76.14,68.62 ,33.33
03,019,01,004,0090,0,4700,75,4775,7148,0,3,1,3,0,1,0,76.14,66.80 ,33.33
03,019,01,005,0091,0,609,10,619,926,0,3,1,3,0,1,0,76.14,66.85 ,33.33
03,019,01,005,0092,0,547,9,556,841,0,3,1,3,0,1,0,76.14,66.11 ,33.33
03,019,01,005,0093,0,598,9,607,923,0,3,1,3,0,1,0,76.14,65.76 ,33.33
03,019,01,005,0094,0,534,11,545,856,0,3,1,3,0,1,0,76.14,63.67 ,33.33
03,019,01,005,0095,0,1184,22,1206,1827,0,3,1,3,0,1,0,76.14,66.01 ,33.33
03,019,01,005,0096,0,1311,18,1329,2024,0,3,1,3,0,1,0,76.14,65.66 ,33.33
03,019,01,005,0097,0,560,7,567,931,0,3,1,3,0,1,0,76.14,60.90 ,33.33
03,019,01,005,0098,0,784,8,792,1281,0,3,1,3,0,1,0,76.14,61.83 ,33.33
03,019,01,005,0099,0,789,9,798,1221,0,3,1,3,0,1,0,76.14,65.36 ,33.33
03,019,01,005,0100,0,1062,12,1074,1678,0,3,1,3,0,1,0,76.14,64.00 ,33.33
03,019,01,005,0101,0,493,6,499,721,0,3,1,3,0,1,0,76.14,69.21 ,33.33
03,019,01,005,0102,0,765,7,772,1187,0,3,1,3,0,1,0,76.14,65.04 ,33.33
03,019,01,005,0103,0,510,5,515,824,0,3,1,3,0,1,0,76.14,62.50 ,33.33
03,019,01,005,0104,0,1388,25,1413,2269,0,3,1,3,0,1,0,76.14,62.27 ,33.33
03,019,01,005,0105,0,2001,40,2041,2998,0,3,1,3,0,1,0,76.14,68.08 ,33.33
03,019,01,005,0106,0,1997,30,2027,2955,0,3,1,3,0,1,0,76.14,68.60 ,33.33
03,019,01,005,0107,0,4412,67,4479,6837,0,3,1,3,0,1,0,76.14,65.51 ,33.33
03,019,01,005,0108,0,1985,26,2011,2964,0,3,1,3,0,1,0,76.14,67.85 ,33.33
03,019,01,005,0109,0,1820,23,1843,3014,0,3,1,3,0,1,0,76.14,61.15 ,33.33
03,019,01,005,0110,0,1023,19,1042,1664,0,3,1,3,0,1,0,76.14,62.62 ,33.33
03,019,01,005,0111,0,2541,31,2572,4067,0,3,1,3,0,1,0,76.14,63.24 ,33.33
03,019,01,005,0112,0,1245,14,1259,2102,0,3,1,3,0,1,0,76.14,59.90 ,33.33
03,019,01,005,0113,0,3125,43,3168,4994,0,3,1,3,0,1,0,76.14,63.44 ,33.33
03,019,01,005,0114,0,3744,43,3787,5910,0,3,1,3,0,1,0,76.14,64.08 ,33.33
03,019,01,005,0115,0,3101,42,3143,5056,0,3,1,3,0,1,0,76.14,62.16 ,33.33
03,019,01,005,0116,0,3102,46,3148,5009,0,3,1,3,0,1,0,76.14,62.85 ,33.33
03,019,01,005,0117,0,3699,37,3736,5985,0,3,1,3,0,1,0,76.14,62.42 ,33.33
03,019,01,005,0118,0,2429,33,2462,3791,0,3,1,3,0,1,0,76.14,64.94 ,33.33
03,019,01,005,0119,0,2040,27,2067,3161,0,3,1,3,0,1,0,76.14,65.39 ,33.33
03,019,01,005,0120,0,2427,40,2467,3620,0,3,1,3,0,1,0,76.14,68.15 ,33.33
03,019,01,005,0121,0,3636,48,3684,5437,0,3,1,3,0,1,0,76.14,67.76 ,33.33
03,019,01,005,0122,0,4195,67,4262,6488,0,3,1,3,0,1,0,76.14,65.69 ,33.33
03,019,01,005,0123,0,4725,79,4804,7499,0,3,1,3,0,1,0,76.14,64.06 ,33.33
03,019,01,005,0124,0,1718,28,1746,2519,0,3,1,3,0,1,0,76.14,69.31 ,33.33
03,019,01,006,0125,0,3958,54,4012,6068,0,3,1,3,0,1,0,76.14,66.12 ,33.33
03,019,01,006,0126,0,2861,38,2899,4352,0,3,1,3,0,1,0,76.14,66.61 ,33.33
03,019,01,006,0127,0,2331,38,2369,3652,0,3,1,3,0,1,0,76.14,64.87 ,33.33
03,019,01,006,0128,0,1339,11,1350,1886,0,3,1,3,0,1,0,76.14,71.58 ,33.33
03,019,01,006,0129,0,734,11,745,1001,0,3,1,3,0,1,0,76.14,74.43 ,33.33
03,019,01,006,0130,0,2912,44,2956,4367,0,3,1,3,0,1,0,76.14,67.69 ,33.33
03,019,01,006,0131,0,5345,93,5438,8532,0,3,1,3,0,1,0,76.14,63.74 ,33.33
03,019,01,006,0132,0,4759,79,4838,7325,0,3,1,3,0,1,0,76.14,66.05 ,33.33
03,019,01,006,0133,0,3486,42,3528,5440,0,3,1,3,0,1,0,76.14,64.85 ,33.33
03,019,01,006,0134,0,5193,61,5254,7896,0,3,1,3,0,1,0,76.14,66.54 ,33.33
03,019,01,006,0135,0,2378,25,2403,3646,0,3,1,3,0,1,0,76.14,65.91 ,33.33
03,019,01,006,0136,0,2897,42,2939,4654,0,3,1,3,0,1,0,76.14,63.15 ,33.33
03,019,01,006,0137,0,3994,55,4049,6087,0,3,1,3,0,1,0,76.14,66.52 ,33.33
03,019,01,006,0138,0,2934,47,2981,4477,0,3,1,3,0,1,0,76.14,66.58 ,33.33
03,019,01,006,0139,0,2121,44,2165,3120,0,3,1,3,0,1,0,76.14,69.39 ,33.33
03,019,01,006,0140,0,698,7,705,983,0,3,1,3,0,1,0,76.14,71.72 ,33.33
03,019,01,006,0141,0,1740,29,1769,2669,0,3,1,3,0,1,0,76.14,66.28 ,33.33
03,019,01,006,0142,0,2491,38,2529,3771,0,3,1,3,0,1,0,76.14,67.06 ,33.33
03,019,01,006,0143,0,3069,45,3114,4481,0,3,1,3,0,1,0,76.14,69.49 ,33.33
03,019,01,006,0144,0,1337,28,1365,1966,0,3,1,3,0,1,0,76.14,69.43 ,33.33
03,019,01,006,0145,0,1492,33,1525,2350,0,3,1,3,0,1,0,76.14,64.89 ,33.33
03,019,01,006,0146,0,3216,58,3274,4950,0,3,1,3,0,1,0,76.14,66.14 ,33.33
03,019,01,006,0147,0,12147,164,12311,19473,0,3,1,3,0,1,0,76.14,63.22 ,33.33
03,019,01,006,0148,0,1886,42,1928,2858,0,3,1,3,0,1,0,76.14,67.46 ,33.33
03,019,01,007,0149,0,3122,57,3179,4758,0,3,1,3,0,1,0,76.14,66.81 ,33.33
03,019,01,007,0150,0,3469,48,3517,5207,0,3,1,3,0,1,0,76.14,67.54 ,33.33
03,019,01,007,0151,0,2599,52,2651,3754,0,3,1,3,0,1,0,76.14,70.62 ,33.33
03,019,01,007,0152,0,2339,43,2382,3462,0,3,1,3,0,1,0,76.14,68.80 ,33.33
03,019,01,007,0153,0,1122,30,1152,1562,0,3,1,3,0,1,0,76.14,73.75 ,33.33
03,019,01,007,0154,0,1876,35,1911,2888,0,3,1,3,0,1,0,76.14,66.17 ,33.33
03,019,01,007,0155,0,3329,71,3400,5011,0,3,1,3,0,1,0,76.14,67.85 ,33.33
03,019,01,007,0156,0,1351,20,1371,1828,0,3,1,3,0,1,0,76.14,75.00 ,33.33
03,019,01,007,0157,0,4539,71,4610,7139,0,3,1,3,0,1,0,76.14,64.57 ,33.33
03,019,01,007,0158,0,830,17,847,1217,0,3,1,3,0,1,0,76.14,69.60 ,33.33
03,019,01,007,0159,0,7208,104,7312,10891,0,3,1,3,0,1,0,76.14,67.14 ,33.33
03,019,01,007,0160,0,939,13,952,1362,0,3,1,3,0,1,0,76.14,69.90 ,33.33
03,019,01,007,0161,0,1736,26,1762,2579,0,3,1,3,0,1,0,76.14,68.32 ,33.33
03,019,01,007,0162,0,7672,117,7789,11869,0,3,1,3,0,1,0,76.14,65.62 ,33.33
03,019,01,007,0163,0,5456,90,5546,8410,0,3,1,3,0,1,0,76.14,65.95 ,33.33
03,019,01,007,0164,0,7191,85,7276,10802,0,3,1,3,0,1,0,76.14,67.36 ,33.33
03,019,01,008,0165,0,3784,50,3834,5909,0,3,1,3,0,1,0,76.14,64.88 ,33.33
03,019,01,008,0166,0,2118,32,2150,3289,0,3,1,3,0,1,0,76.14,65.37 ,33.33
03,019,01,008,0167,0,6576,72,6648,10247,0,3,1,3,0,1,0,76.14,64.88 ,33.33
03,019,01,008,0168,0,6610,98,6708,10433,0,3,1,3,0,1,0,76.14,64.30 ,33.33
03,019,01,008,0169,0,4144,62,4206,6686,0,3,1,3,0,1,0,76.14,62.91 ,33.33
03,019,01,008,0170,0,2769,46,2815,4214,0,3,1,3,0,1,0,76.14,66.80 ,33.33
03,019,01,008,0171,0,4723,70,4793,7476,0,3,1,3,0,1,0,76.14,64.11 ,33.33
03,019,01,008,0172,0,2743,38,2781,4260,0,3,1,3,0,1,0,76.14,65.28 ,33.33
03,019,01,008,0173,0,2282,42,2324,3653,0,3,1,3,0,1,0,76.14,63.62 ,33.33
03,019,01,008,0174,0,3031,47,3078,4665,0,3,1,3,0,1,0,76.14,65.98 ,33.33
03,019,01,008,0175,0,3467,57,3524,5140,0,3,1,3,0,1,0,76.14,68.56 ,33.33
03,019,01,008,0176,0,3957,70,4027,5854,0,3,1,3,0,1,0,76.14,68.79 ,33.33
03,019,01,008,0177,0,2862,40,2902,4215,0,3,1,3,0,1,0,76.14,68.85 ,33.33
03,019,01,008,0178,0,1089,15,1104,1544,0,3,1,3,0,1,0,76.14,71.50 ,33.33
03,019,01,008,0179,0,1037,15,1052,1576,0,3,1,3,0,1,0,76.14,66.75 ,33.33
03,019,01,008,0180,0,552,15,567,883,0,3,1,3,0,1,0,76.14,64.21 ,33.33
03,019,01,008,0181,0,487,2,489,723,0,3,1,3,0,1,0,76.14,67.63 ,33.33
03,019,01,008,0182,0,1060,12,1072,1512,0,3,1,3,0,1,0,76.14,70.90 ,33.33
03,019,01,008,0183,0,3158,42,3200,4839,0,3,1,3,0,1,0,76.14,66.13 ,33.33
03,019,01,008,0184,0,4948,67,5015,7834,0,3,1,3,0,1,0,76.14,64.02 ,33.33
03,019,01,008,0185,0,6685,91,6776,10389,0,3,1,3,0,1,0,76.14,65.22 ,33.33
03,019,01,008,0186,0,4098,77,4175,6007,0,3,1,3,0,1,0,76.14,69.50 ,33.33
03,019,01,008,0187,0,3535,61,3596,5099,0,3,1,3,0,1,0,76.14,70.52 ,33.33
03,019,01,008,0188,0,730,9,739,1018,0,3,1,3,0,1,0,76.14,72.59 ,33.33
03,019,01,008,0189,0,3412,58,3470,5090,0,3,1,3,0,1,0,76.14,68.17 ,33.33
03,019,01,008,0190,0,3390,49,3439,5035,0,3,1,3,0,1,0,76.14,68.30 ,33.33
03,019,01,008,0191,0,4543,50,4593,7079,0,3,1,3,0,1,0,76.14,64.88 ,33.33
03,019,01,008,0192,0,2651,33,2684,4056,0,3,1,3,0,1,0,76.14,66.17 ,33.33
03,019,01,008,0193,0,2823,45,2868,4360,0,3,1,3,0,1,0,76.14,65.78 ,33.33
03,019,01,008,0194,0,574,4,578,778,0,3,1,3,0,1,0,76.14,74.29 ,33.33
03,019,01,008,0195,0,3888,63,3951,5771,0,3,1,3,0,1,0,76.14,68.46 ,33.33
03,020,01,001,0001,0,2451,36,2487,3919,0,3,1,3,0,1,0,76.14,63.46 ,33.33
03,020,01,001,0002,0,1211,14,1225,1768,0,3,1,3,0,1,0,76.14,69.29 ,33.33
03,020,01,001,0003,0,391,9,400,608,0,3,1,3,0,1,0,76.14,65.79 ,33.33
03,020,01,001,0004,0,1928,18,1946,3119,0,3,1,3,0,1,0,76.14,62.39 ,33.33
03,020,01,001,0005,0,568,4,572,877,0,3,1,3,0,1,0,76.14,65.22 ,33.33
03,020,01,001,0006,0,2397,28,2425,3592,0,3,1,3,0,1,0,76.14,67.51 ,33.33
03,020,01,001,0007,0,1464,15,1479,2278,0,3,1,3,0,1,0,76.14,64.93 ,33.33
03,020,01,001,0008,0,1673,23,1696,2537,0,3,1,3,0,1,0,76.14,66.85 ,33.33
03,020,01,001,0009,0,2296,30,2326,3457,0,3,1,3,0,1,0,76.14,67.28 ,33.33
03,020,01,001,0010,0,1969,29,1998,3092,0,3,1,3,0,1,0,76.14,64.62 ,33.33
03,020,01,001,0011,0,1939,20,1959,3078,0,3,1,3,0,1,0,76.14,63.65 ,33.33
03,020,01,001,0012,0,746,11,757,1161,0,3,1,3,0,1,0,76.14,65.20 ,33.33
03,020,01,001,0013,0,224,1,225,337,0,3,1,3,0,1,0,76.14,66.77 ,33.33
03,020,01,001,0014,0,301,3,304,455,0,3,1,3,0,1,0,76.14,66.81 ,33.33
03,020,01,001,0015,0,364,5,369,542,0,3,1,3,0,1,0,76.14,68.08 ,33.33
03,020,01,001,0016,0,327,4,331,493,0,3,1,3,0,1,0,76.14,67.14 ,33.33
03,020,01,001,0017,0,426,6,432,638,0,3,1,3,0,1,0,76.14,67.71 ,33.33
03,020,01,001,0018,0,355,1,356,523,0,3,1,3,0,1,0,76.14,68.07 ,33.33
03,020,01,001,0019,0,305,2,307,441,0,3,1,3,0,1,0,76.14,69.61 ,33.33
03,020,01,001,0020,0,868,8,876,1316,0,3,1,3,0,1,0,76.14,66.57 ,33.33
03,020,01,001,0021,0,391,4,395,610,0,3,1,3,0,1,0,76.14,64.75 ,33.33
03,020,01,001,0022,0,634,6,640,1005,0,3,1,3,0,1,0,76.14,63.68 ,33.33
03,020,01,001,0023,0,255,4,259,384,0,3,1,3,0,1,0,76.14,67.45 ,33.33
03,020,01,001,0024,0,672,10,682,1023,0,3,1,3,0,1,0,76.14,66.67 ,33.33
03,020,01,001,0025,0,433,5,438,629,0,3,1,3,0,1,0,76.14,69.63 ,33.33
03,020,01,001,0026,0,483,4,487,736,0,3,1,3,0,1,0,76.14,66.17 ,33.33
03,020,01,001,0027,0,486,5,491,730,0,3,1,3,0,1,0,76.14,67.26 ,33.33
03,020,01,001,0028,0,445,5,450,671,0,3,1,3,0,1,0,76.14,67.06 ,33.33
03,020,01,001,0029,0,811,9,820,1175,0,3,1,3,0,1,0,76.14,69.79 ,33.33
03,020,01,001,0030,0,398,3,401,630,0,3,1,3,0,1,0,76.14,63.65 ,33.33
03,020,01,001,0031,0,735,2,737,1095,0,3,1,3,0,1,0,76.14,67.31 ,33.33
03,020,01,001,0032,0,843,5,848,1268,0,3,1,3,0,1,0,76.14,66.88 ,33.33
03,020,01,001,0033,0,572,7,579,852,0,3,1,3,0,1,0,76.14,67.96 ,33.33
03,020,01,001,0034,0,892,11,903,1369,0,3,1,3,0,1,0,76.14,65.96 ,33.33
03,020,01,001,0035,0,1172,18,1190,1914,0,3,1,3,0,1,0,76.14,62.17 ,33.33
03,020,01,001,0036,0,842,10,852,1325,0,3,1,3,0,1,0,76.14,64.30 ,33.33
03,020,01,001,0037,0,983,18,1001,1540,0,3,1,3,0,1,0,76.14,65.00 ,33.33
03,020,01,001,0038,0,2000,33,2033,3265,0,3,1,3,0,1,0,76.14,62.27 ,33.33
03,020,01,001,0039,0,1397,15,1412,2071,0,3,1,3,0,1,0,76.14,68.18 ,33.33
03,020,01,001,0040,0,1259,13,1272,1963,0,3,1,3,0,1,0,76.14,64.80 ,33.33
03,020,01,001,0041,0,2780,28,2808,4551,0,3,1,3,0,1,0,76.14,61.70 ,33.33
03,020,01,001,0042,0,1806,16,1822,2954,0,3,1,3,0,1,0,76.14,61.68 ,33.33
03,020,01,001,0043,0,1300,18,1318,2094,0,3,1,3,0,1,0,76.14,62.94 ,33.33
03,020,01,001,0044,0,1933,22,1955,3003,0,3,1,3,0,1,0,76.14,65.10 ,33.33
03,020,01,001,0045,0,543,3,546,858,0,3,1,3,0,1,0,76.14,63.64 ,33.33
03,020,01,001,0046,0,438,9,447,647,0,3,1,3,0,1,0,76.14,69.09 ,33.33
03,020,01,001,0047,0,693,6,699,1093,0,3,1,3,0,1,0,76.14,63.95 ,33.33
03,020,01,001,0048,0,916,6,922,1420,0,3,1,3,0,1,0,76.14,64.93 ,33.33
03,020,01,001,0049,0,591,4,595,884,0,3,1,3,0,1,0,76.14,67.31 ,33.33
03,020,01,001,0050,0,312,4,316,505,0,3,1,3,0,1,0,76.14,62.57 ,33.33
03,020,01,001,0051,0,1533,25,1558,2567,0,3,1,3,0,1,0,76.14,60.69 ,33.33
03,020,01,001,0052,0,1256,17,1273,2043,0,3,1,3,0,1,0,76.14,62.31 ,33.33
03,020,01,001,0053,0,1886,24,1910,2947,0,3,1,3,0,1,0,76.14,64.81 ,33.33
03,020,01,001,0054,0,1497,18,1515,2281,0,3,1,3,0,1,0,76.14,66.42 ,33.33
03,020,01,001,0055,0,2879,30,2909,4515,0,3,1,3,0,1,0,76.14,64.43 ,33.33
03,020,01,002,0056,0,677,8,685,1007,0,3,1,3,0,1,0,76.14,68.02 ,33.33
03,020,01,002,0057,0,426,6,432,654,0,3,1,3,0,1,0,76.14,66.06 ,33.33
03,020,01,002,0058,0,323,3,326,509,0,3,1,3,0,1,0,76.14,64.05 ,33.33
03,020,01,002,0059,0,440,5,445,673,0,3,1,3,0,1,0,76.14,66.12 ,33.33
03,020,01,002,0060,0,350,6,356,543,0,3,1,3,0,1,0,76.14,65.56 ,33.33
03,020,01,002,0061,0,587,4,591,827,0,3,1,3,0,1,0,76.14,71.46 ,33.33
03,020,01,002,0062,0,373,6,379,577,0,3,1,3,0,1,0,76.14,65.68 ,33.33
03,020,01,002,0063,0,739,5,744,1115,0,3,1,3,0,1,0,76.14,66.73 ,33.33
03,020,01,002,0064,0,570,2,572,888,0,3,1,3,0,1,0,76.14,64.41 ,33.33
03,020,01,002,0065,0,540,4,544,818,0,3,1,3,0,1,0,76.14,66.50 ,33.33
03,020,01,002,0066,0,330,3,333,494,0,3,1,3,0,1,0,76.14,67.41 ,33.33
03,020,01,002,0067,0,512,7,519,783,0,3,1,3,0,1,0,76.14,66.28 ,33.33
03,020,01,002,0068,0,358,5,363,518,0,3,1,3,0,1,0,76.14,70.08 ,33.33
03,020,01,002,0069,0,372,3,375,523,0,3,1,3,0,1,0,76.14,71.70 ,33.33
03,020,01,002,0070,0,266,6,272,420,0,3,1,3,0,1,0,76.14,64.76 ,33.33
03,020,01,002,0071,0,243,4,247,404,0,3,1,3,0,1,0,76.14,61.14 ,33.33
03,020,01,002,0072,0,391,6,397,618,0,3,1,3,0,1,0,76.14,64.24 ,33.33
03,020,01,002,0073,0,491,5,496,723,0,3,1,3,0,1,0,76.14,68.60 ,33.33
03,020,01,002,0074,0,420,4,424,628,0,3,1,3,0,1,0,76.14,67.52 ,33.33
03,020,01,002,0075,0,3637,63,3700,5830,0,3,1,3,0,1,0,76.14,63.46 ,33.33
03,020,01,002,0076,0,616,6,622,949,0,3,1,3,0,1,0,76.14,65.54 ,33.33
03,020,01,002,0077,0,1956,21,1977,3143,0,3,1,3,0,1,0,76.14,62.90 ,33.33
03,020,01,002,0078,0,1195,15,1210,1812,0,3,1,3,0,1,0,76.14,66.78 ,33.33
03,020,01,002,0079,0,779,10,789,1246,0,3,1,3,0,1,0,76.14,63.32 ,33.33
03,020,01,002,0080,0,853,10,863,1283,0,3,1,3,0,1,0,76.14,67.26 ,33.33
03,020,01,002,0081,0,1095,16,1111,1699,0,3,1,3,0,1,0,76.14,65.39 ,33.33
03,020,01,002,0082,0,1947,32,1979,3094,0,3,1,3,0,1,0,76.14,63.96 ,33.33
03,020,01,002,0083,0,1304,31,1335,2093,0,3,1,3,0,1,0,76.14,63.78 ,33.33
03,020,01,002,0084,0,507,5,512,790,0,3,1,3,0,1,0,76.14,64.81 ,33.33
03,020,01,002,0085,0,816,9,825,1273,0,3,1,3,0,1,0,76.14,64.81 ,33.33
03,020,01,002,0086,0,718,5,723,1091,0,3,1,3,0,1,0,76.14,66.27 ,33.33
03,020,01,002,0087,0,1126,17,1143,1936,0,3,1,3,0,1,0,76.14,59.04 ,33.33
03,020,01,002,0088,0,2691,29,2720,4193,0,3,1,3,0,1,0,76.14,64.87 ,33.33
03,020,01,002,0089,0,2576,25,2601,3925,0,3,1,3,0,1,0,76.14,66.27 ,33.33
03,020,01,002,0090,0,4023,46,4069,6474,0,3,1,3,0,1,0,76.14,62.85 ,33.33
03,020,01,002,0091,0,2014,19,2033,3258,0,3,1,3,0,1,0,76.14,62.40 ,33.33
03,020,01,002,0092,0,2568,30,2598,3979,0,3,1,3,0,1,0,76.14,65.29 ,33.33
03,020,01,002,0093,0,1448,17,1465,2253,0,3,1,3,0,1,0,76.14,65.02 ,33.33
03,020,01,002,0094,0,822,9,831,1253,0,3,1,3,0,1,0,76.14,66.32 ,33.33
03,020,01,002,0095,0,857,13,870,1267,0,3,1,3,0,1,0,76.14,68.67 ,33.33
03,020,01,002,0096,0,1262,13,1275,1884,0,3,1,3,0,1,0,76.14,67.68 ,33.33
03,020,01,002,0097,0,1235,24,1259,2037,0,3,1,3,0,1,0,76.14,61.81 ,33.33
03,020,01,002,0098,0,350,8,358,525,0,3,1,3,0,1,0,76.14,68.19 ,33.33
03,020,01,002,0099,0,419,6,425,655,0,3,1,3,0,1,0,76.14,64.89 ,33.33
03,020,01,002,0100,0,873,10,883,1370,0,3,1,3,0,1,0,76.14,64.45 ,33.33
03,020,01,002,0101,0,861,18,879,1355,0,3,1,3,0,1,0,76.14,64.87 ,33.33
03,020,01,002,0102,0,1187,21,1208,1805,0,3,1,3,0,1,0,76.14,66.93 ,33.33
03,020,01,002,0103,0,2596,40,2636,4010,0,3,1,3,0,1,0,76.14,65.74 ,33.33
03,020,01,002,0104,0,5691,81,5772,8706,0,3,1,3,0,1,0,76.14,66.30 ,33.33
03,020,01,002,0105,0,2103,29,2132,3263,0,3,1,3,0,1,0,76.14,65.34 ,33.33
03,020,01,002,0106,0,1499,15,1514,2226,0,3,1,3,0,1,0,76.14,68.01 ,33.33
03,020,01,002,0107,0,846,17,863,1231,0,3,1,3,0,1,0,76.14,70.11 ,33.33
03,020,01,002,0108,0,823,11,834,1049,0,3,1,3,0,1,0,76.14,79.50 ,33.33
03,021,01,001,0001,0,3474,45,3519,5938,0,3,1,3,0,1,0,76.14,59.26 ,33.33
03,021,01,001,0002,0,2461,54,2515,3888,0,3,1,3,0,1,0,76.14,64.69 ,33.33
03,021,01,001,0003,0,1970,23,1993,3255,0,3,1,3,0,1,0,76.14,61.23 ,33.33
03,021,01,001,0004,0,3924,40,3964,6214,0,3,1,3,0,1,0,76.14,63.79 ,33.33
03,021,01,001,0005,0,1273,11,1284,1997,0,3,1,3,0,1,0,76.14,64.30 ,33.33
03,021,01,001,0006,0,2742,23,2765,4420,0,3,1,3,0,1,0,76.14,62.56 ,33.33
03,021,01,001,0007,0,1540,35,1575,2497,0,3,1,3,0,1,0,76.14,63.08 ,33.33
03,021,01,001,0008,0,2076,25,2101,3630,0,3,1,3,0,1,0,76.14,57.88 ,33.33
03,021,01,001,0009,0,1564,10,1574,2520,0,3,1,3,0,1,0,76.14,62.46 ,33.33
03,021,01,001,0010,0,3824,39,3863,6069,0,3,1,3,0,1,0,76.14,63.65 ,33.33
03,021,01,001,0011,0,3714,44,3758,6272,0,3,1,3,0,1,0,76.14,59.92 ,33.33
03,021,01,001,0012,0,1369,17,1386,2162,0,3,1,3,0,1,0,76.14,64.11 ,33.33
03,021,01,001,0013,0,2819,33,2852,4391,0,3,1,3,0,1,0,76.14,64.95 ,33.33
03,021,01,001,0014,0,1775,25,1800,2683,0,3,1,3,0,1,0,76.14,67.09 ,33.33
03,021,01,001,0015,0,1340,24,1364,1931,0,3,1,3,0,1,0,76.14,70.64 ,33.33
03,021,01,001,0016,0,1195,15,1210,1712,0,3,1,3,0,1,0,76.14,70.68 ,33.33
03,021,01,001,0017,0,2511,38,2549,3943,0,3,1,3,0,1,0,76.14,64.65 ,33.33
03,021,01,001,0018,0,1932,15,1947,3135,0,3,1,3,0,1,0,76.14,62.11 ,33.33
03,021,01,001,0019,0,1935,19,1954,2983,0,3,1,3,0,1,0,76.14,65.50 ,33.33
03,021,01,001,0020,0,2368,22,2390,3796,0,3,1,3,0,1,0,76.14,62.96 ,33.33
03,021,01,001,0021,0,963,5,968,1466,0,3,1,3,0,1,0,76.14,66.03 ,33.33
03,021,01,001,0022,0,520,12,532,852,0,3,1,3,0,1,0,76.14,62.44 ,33.33
03,021,01,001,0023,0,454,2,456,734,0,3,1,3,0,1,0,76.14,62.13 ,33.33
03,021,01,001,0024,0,723,8,731,1128,0,3,1,3,0,1,0,76.14,64.80 ,33.33
03,021,01,001,0025,0,705,6,711,1132,0,3,1,3,0,1,0,76.14,62.81 ,33.33
03,021,01,001,0026,0,493,13,506,766,0,3,1,3,0,1,0,76.14,66.06 ,33.33
03,021,01,001,0027,0,1293,11,1304,1945,0,3,1,3,0,1,0,76.14,67.04 ,33.33
03,021,01,001,0028,0,1809,16,1825,2918,0,3,1,3,0,1,0,76.14,62.54 ,33.33
03,021,01,001,0029,0,980,20,1000,1659,0,3,1,3,0,1,0,76.14,60.28 ,33.33
03,021,01,001,0030,0,1559,27,1586,2498,0,3,1,3,0,1,0,76.14,63.49 ,33.33
03,021,01,001,0031,0,1730,24,1754,2736,0,3,1,3,0,1,0,76.14,64.11 ,33.33
03,021,01,001,0032,0,965,16,981,1608,0,3,1,3,0,1,0,76.14,61.01 ,33.33
03,021,01,001,0033,0,1782,21,1803,2777,0,3,1,3,0,1,0,76.14,64.93 ,33.33
03,021,01,001,0034,0,2549,40,2589,3874,0,3,1,3,0,1,0,76.14,66.83 ,33.33
03,021,01,001,0035,0,1319,17,1336,2117,0,3,1,3,0,1,0,76.14,63.11 ,33.33
03,021,01,001,0036,0,1469,10,1479,2348,0,3,1,3,0,1,0,76.14,62.99 ,33.33
03,021,01,001,0037,0,2952,59,3011,4802,0,3,1,3,0,1,0,76.14,62.70 ,33.33
03,021,01,001,0038,0,1216,18,1234,1856,0,3,1,3,0,1,0,76.14,66.49 ,33.33
03,021,01,001,0039,0,1028,13,1041,1687,0,3,1,3,0,1,0,76.14,61.71 ,33.33
03,021,01,001,0040,0,828,7,835,1392,0,3,1,3,0,1,0,76.14,59.99 ,33.33
03,021,01,001,0041,0,665,9,674,1028,0,3,1,3,0,1,0,76.14,65.56 ,33.33
03,021,01,001,0042,0,772,10,782,1177,0,3,1,3,0,1,0,76.14,66.44 ,33.33
03,021,01,001,0043,0,488,8,496,766,0,3,1,3,0,1,0,76.14,64.75 ,33.33
03,021,01,001,0044,0,2543,27,2570,4084,0,3,1,3,0,1,0,76.14,62.93 ,33.33
03,021,01,001,0045,0,3590,34,3624,5675,0,3,1,3,0,1,0,76.14,63.86 ,33.33
03,021,01,002,0046,0,1953,21,1974,3090,0,3,1,3,0,1,0,76.14,63.88 ,33.33
03,021,01,002,0047,0,1248,20,1268,1976,0,3,1,3,0,1,0,76.14,64.17 ,33.33
03,021,01,002,0048,0,2514,31,2545,4123,0,3,1,3,0,1,0,76.14,61.73 ,33.33
03,021,01,002,0049,0,666,9,675,1006,0,3,1,3,0,1,0,76.14,67.10 ,33.33
03,021,01,002,0050,0,840,9,849,1330,0,3,1,3,0,1,0,76.14,63.83 ,33.33
03,021,01,002,0051,0,682,13,695,1033,0,3,1,3,0,1,0,76.14,67.28 ,33.33
03,021,01,002,0052,0,756,7,763,1175,0,3,1,3,0,1,0,76.14,64.94 ,33.33
03,021,01,002,0053,0,802,16,818,1322,0,3,1,3,0,1,0,76.14,61.88 ,33.33
03,021,01,002,0054,0,583,7,590,944,0,3,1,3,0,1,0,76.14,62.50 ,33.33
03,021,01,002,0055,0,2154,19,2173,3305,0,3,1,3,0,1,0,76.14,65.75 ,33.33
03,021,01,002,0056,0,1661,17,1678,2620,0,3,1,3,0,1,0,76.14,64.05 ,33.33
03,021,01,002,0057,0,1422,13,1435,2212,0,3,1,3,0,1,0,76.14,64.87 ,33.33
03,021,01,002,0058,0,1712,19,1731,2545,0,3,1,3,0,1,0,76.14,68.02 ,33.33
03,021,01,002,0059,0,1493,13,1506,2353,0,3,1,3,0,1,0,76.14,64.00 ,33.33
03,021,01,002,0060,0,1941,24,1965,3070,0,3,1,3,0,1,0,76.14,64.01 ,33.33
03,021,01,002,0061,0,2272,21,2293,3579,0,3,1,3,0,1,0,76.14,64.07 ,33.33
03,021,01,002,0062,0,2853,35,2888,4623,0,3,1,3,0,1,0,76.14,62.47 ,33.33
03,021,01,002,0063,0,1881,26,1907,2964,0,3,1,3,0,1,0,76.14,64.34 ,33.33
03,021,01,002,0064,0,1251,23,1274,1996,0,3,1,3,0,1,0,76.14,63.83 ,33.33
03,021,01,002,0065,0,2514,20,2534,4096,0,3,1,3,0,1,0,76.14,61.87 ,33.33
03,021,01,002,0066,0,1215,16,1231,1917,0,3,1,3,0,1,0,76.14,64.21 ,33.33
03,021,01,002,0067,0,2037,28,2065,3423,0,3,1,3,0,1,0,76.14,60.33 ,33.33
03,021,01,002,0068,0,2359,32,2391,3900,0,3,1,3,0,1,0,76.14,61.31 ,33.33
03,021,01,002,0069,0,1959,20,1979,3112,0,3,1,3,0,1,0,76.14,63.59 ,33.33
03,021,01,002,0070,0,2009,36,2045,3263,0,3,1,3,0,1,0,76.14,62.67 ,33.33
03,021,01,002,0071,0,2355,32,2387,3705,0,3,1,3,0,1,0,76.14,64.43 ,33.33
03,021,01,002,0072,0,2486,29,2515,4445,0,3,1,3,0,1,0,76.14,56.58 ,33.33
03,021,01,002,0073,0,2123,29,2152,3854,0,3,1,3,0,1,0,76.14,55.84 ,33.33
03,021,01,002,0074,0,1120,22,1142,1886,0,3,1,3,0,1,0,76.14,60.55 ,33.33
03,021,01,002,0075,0,675,14,689,1012,0,3,1,3,0,1,0,76.14,68.08 ,33.33
03,021,01,002,0076,0,597,7,604,900,0,3,1,3,0,1,0,76.14,67.11 ,33.33
03,021,01,002,0077,0,1389,12,1401,2159,0,3,1,3,0,1,0,76.14,64.89 ,33.33
03,021,01,002,0078,0,907,11,918,1430,0,3,1,3,0,1,0,76.14,64.20 ,33.33
03,021,01,002,0079,0,947,7,954,1502,0,3,1,3,0,1,0,76.14,63.52 ,33.33
03,021,01,002,0080,0,1624,19,1643,2631,0,3,1,3,0,1,0,76.14,62.45 ,33.33
03,021,01,002,0081,0,450,10,460,650,0,3,1,3,0,1,0,76.14,70.77 ,33.33
03,021,01,002,0082,0,407,7,414,605,0,3,1,3,0,1,0,76.14,68.43 ,33.33
03,021,01,002,0083,0,606,6,612,962,0,3,1,3,0,1,0,76.14,63.62 ,33.33
03,021,01,002,0084,0,492,3,495,760,0,3,1,3,0,1,0,76.14,65.13 ,33.33
03,021,01,002,0085,0,1116,14,1130,1746,0,3,1,3,0,1,0,76.14,64.72 ,33.33
03,021,01,002,0086,0,1189,16,1205,1937,0,3,1,3,0,1,0,76.14,62.21 ,33.33
03,021,01,002,0087,0,504,7,511,740,0,3,1,3,0,1,0,76.14,69.05 ,33.33
03,021,01,002,0088,0,1163,14,1177,1791,0,3,1,3,0,1,0,76.14,65.72 ,33.33
03,021,01,003,0089,0,1955,20,1975,3089,0,3,1,3,0,1,0,76.14,63.94 ,33.33
03,021,01,003,0090,0,1727,11,1738,2681,0,3,1,3,0,1,0,76.14,64.83 ,33.33
03,021,01,003,0091,0,1626,20,1646,2506,0,3,1,3,0,1,0,76.14,65.68 ,33.33
03,021,01,003,0092,0,793,13,806,1223,0,3,1,3,0,1,0,76.14,65.90 ,33.33
03,021,01,003,0093,0,1314,20,1334,1970,0,3,1,3,0,1,0,76.14,67.72 ,33.33
03,021,01,003,0094,0,377,5,382,589,0,3,1,3,0,1,0,76.14,64.86 ,33.33
03,021,01,003,0095,0,488,3,491,683,0,3,1,3,0,1,0,76.14,71.89 ,33.33
03,021,01,003,0096,0,494,10,504,735,0,3,1,3,0,1,0,76.14,68.57 ,33.33
03,021,01,003,0097,0,469,8,477,697,0,3,1,3,0,1,0,76.14,68.44 ,33.33
03,021,01,003,0098,0,376,9,385,558,0,3,1,3,0,1,0,76.14,69.00 ,33.33
03,021,01,003,0099,0,614,5,619,959,0,3,1,3,0,1,0,76.14,64.55 ,33.33
03,021,01,003,0100,0,558,10,568,889,0,3,1,3,0,1,0,76.14,63.89 ,33.33
03,021,01,003,0101,0,1680,13,1693,2609,0,3,1,3,0,1,0,76.14,64.89 ,33.33
03,021,01,003,0102,0,668,10,678,1045,0,3,1,3,0,1,0,76.14,64.88 ,33.33
03,021,01,003,0103,0,560,14,574,805,0,3,1,3,0,1,0,76.14,71.30 ,33.33
03,021,01,003,0104,0,327,3,330,473,0,3,1,3,0,1,0,76.14,69.77 ,33.33
03,021,01,003,0105,0,547,9,556,835,0,3,1,3,0,1,0,76.14,66.59 ,33.33
03,021,01,003,0106,0,370,7,377,569,0,3,1,3,0,1,0,76.14,66.26 ,33.33
03,021,01,003,0107,0,640,8,648,1114,0,3,1,3,0,1,0,76.14,58.17 ,33.33
03,021,01,003,0108,0,1365,21,1386,2216,0,3,1,3,0,1,0,76.14,62.55 ,33.33
03,021,01,003,0109,0,454,6,460,796,0,3,1,3,0,1,0,76.14,57.79 ,33.33
03,021,01,003,0110,0,326,6,332,520,0,3,1,3,0,1,0,76.14,63.85 ,33.33
03,021,01,003,0111,0,168,1,169,237,0,3,1,3,0,1,0,76.14,71.31 ,33.33
03,021,01,003,0112,0,280,3,283,406,0,3,1,3,0,1,0,76.14,69.70 ,33.33
03,021,01,003,0113,0,285,3,288,420,0,3,1,3,0,1,0,76.14,68.57 ,33.33
03,021,01,003,0114,0,202,0,202,291,0,3,1,3,0,1,0,76.14,69.42 ,33.33
03,021,01,003,0115,0,605,13,618,937,0,3,1,3,0,1,0,76.14,65.96 ,33.33
03,021,01,003,0116,0,723,8,731,1068,0,3,1,3,0,1,0,76.14,68.45 ,33.33
03,021,01,003,0117,0,547,8,555,771,0,3,1,3,0,1,0,76.14,71.98 ,33.33
03,021,01,003,0118,0,835,12,847,1364,0,3,1,3,0,1,0,76.14,62.10 ,33.33
03,021,01,004,0119,0,595,6,601,946,0,3,1,3,0,1,0,76.14,63.53 ,33.33
03,021,01,004,0120,0,589,12,601,1090,0,3,1,3,0,1,0,76.14,55.14 ,33.33
03,021,01,004,0121,0,619,7,626,1084,0,3,1,3,0,1,0,76.14,57.75 ,33.33
03,021,01,004,0122,0,740,6,746,1243,0,3,1,3,0,1,0,76.14,60.02 ,33.33
03,021,01,004,0123,0,581,7,588,922,0,3,1,3,0,1,0,76.14,63.77 ,33.33
03,021,01,004,0124,0,622,6,628,996,0,3,1,3,0,1,0,76.14,63.05 ,33.33
03,021,01,004,0125,0,684,8,692,1129,0,3,1,3,0,1,0,76.14,61.29 ,33.33
03,021,01,004,0126,0,523,9,532,854,0,3,1,3,0,1,0,76.14,62.30 ,33.33
03,021,01,004,0127,0,748,15,763,1157,0,3,1,3,0,1,0,76.14,65.95 ,33.33
03,021,01,004,0128,0,572,7,579,913,0,3,1,3,0,1,0,76.14,63.42 ,33.33
03,021,01,004,0129,0,1088,13,1101,1720,0,3,1,3,0,1,0,76.14,64.01 ,33.33
03,021,01,004,0130,0,1176,8,1184,1886,0,3,1,3,0,1,0,76.14,62.78 ,33.33
03,021,01,004,0131,0,1232,16,1248,1931,0,3,1,3,0,1,0,76.14,64.63 ,33.33
03,021,01,004,0132,0,1806,17,1823,2793,0,3,1,3,0,1,0,76.14,65.27 ,33.33
03,021,01,004,0133,0,1293,11,1304,2031,0,3,1,3,0,1,0,76.14,64.20 ,33.33
03,021,01,004,0134,0,1378,14,1392,2176,0,3,1,3,0,1,0,76.14,63.97 ,33.33
03,021,01,004,0135,0,937,17,954,1400,0,3,1,3,0,1,0,76.14,68.14 ,33.33
03,021,01,004,0136,0,1105,23,1128,1828,0,3,1,3,0,1,0,76.14,61.71 ,33.33
03,021,01,004,0137,0,2308,32,2340,3987,0,3,1,3,0,1,0,76.14,58.69 ,33.33
03,021,01,004,0138,0,573,7,580,896,0,3,1,3,0,1,0,76.14,64.73 ,33.33
03,021,01,004,0139,0,763,9,772,1242,0,3,1,3,0,1,0,76.14,62.16 ,33.33
03,021,01,004,0140,0,685,6,691,1075,0,3,1,3,0,1,0,76.14,64.28 ,33.33
03,021,01,004,0141,0,829,15,844,1300,0,3,1,3,0,1,0,76.14,64.92 ,33.33
03,021,01,004,0142,0,655,4,659,1086,0,3,1,3,0,1,0,76.14,60.68 ,33.33
03,021,01,004,0143,0,880,12,892,1467,0,3,1,3,0,1,0,76.14,60.80 ,33.33
03,021,01,004,0144,0,3137,37,3174,4910,0,3,1,3,0,1,0,76.14,64.64 ,33.33
03,021,01,004,0145,0,967,16,983,1533,0,3,1,3,0,1,0,76.14,64.12 ,33.33
03,021,01,004,0146,0,1093,14,1107,1823,0,3,1,3,0,1,0,76.14,60.72 ,33.33
03,021,01,004,0147,0,996,25,1021,1577,0,3,1,3,0,1,0,76.14,64.74 ,33.33
03,021,01,004,0148,0,796,9,805,1353,0,3,1,3,0,1,0,76.14,59.50 ,33.33
03,021,01,004,0149,0,1001,9,1010,1550,0,3,1,3,0,1,0,76.14,65.16 ,33.33
03,021,01,004,0150,0,1309,17,1326,2271,0,3,1,3,0,1,0,76.14,58.39 ,33.33
03,021,01,004,0151,0,2047,27,2074,3235,0,3,1,3,0,1,0,76.14,64.11 ,33.33
03,021,01,004,0152,0,3758,37,3795,6307,0,3,1,3,0,1,0,76.14,60.17 ,33.33
03,021,01,004,0153,0,2827,23,2850,4651,0,3,1,3,0,1,0,76.14,61.28 ,33.33
03,021,01,004,0154,0,817,4,821,1195,0,3,1,3,0,1,0,76.14,68.70 ,33.33
03,021,01,004,0155,0,913,5,918,1412,0,3,1,3,0,1,0,76.14,65.01 ,33.33
03,021,01,004,0156,0,3409,41,3450,5352,0,3,1,3,0,1,0,76.14,64.46 ,33.33
03,021,01,004,0157,0,4709,62,4771,7208,0,3,1,3,0,1,0,76.14,66.19 ,33.33
03,021,01,004,0158,0,3699,43,3742,5934,0,3,1,3,0,1,0,76.14,63.06 ,33.33
03,021,01,005,0159,0,738,7,745,1153,0,3,1,3,0,1,0,76.14,64.61 ,33.33
03,021,01,005,0160,0,695,9,704,1020,0,3,1,3,0,1,0,76.14,69.02 ,33.33
03,021,01,005,0161,0,703,15,718,1121,0,3,1,3,0,1,0,76.14,64.05 ,33.33
03,021,01,005,0162,0,846,10,856,1350,0,3,1,3,0,1,0,76.14,63.41 ,33.33
03,021,01,005,0163,0,470,5,475,699,0,3,1,3,0,1,0,76.14,67.95 ,33.33
03,021,01,005,0164,0,438,10,448,688,0,3,1,3,0,1,0,76.14,65.12 ,33.33
03,021,01,005,0165,0,229,5,234,363,0,3,1,3,0,1,0,76.14,64.46 ,33.33
03,021,01,005,0166,0,274,0,274,424,0,3,1,3,0,1,0,76.14,64.62 ,33.33
03,021,01,005,0167,0,736,13,749,1162,0,3,1,3,0,1,0,76.14,64.46 ,33.33
03,021,01,005,0168,0,244,3,247,376,0,3,1,3,0,1,0,76.14,65.69 ,33.33
03,021,01,005,0169,0,312,2,314,475,0,3,1,3,0,1,0,76.14,66.11 ,33.33
03,021,01,005,0170,0,313,6,319,498,0,3,1,3,0,1,0,76.14,64.06 ,33.33
03,021,01,005,0171,0,429,4,433,634,0,3,1,3,0,1,0,76.14,68.30 ,33.33
03,021,01,005,0172,0,487,7,494,716,0,3,1,3,0,1,0,76.14,68.99 ,33.33
03,021,01,005,0173,0,655,9,664,1019,0,3,1,3,0,1,0,76.14,65.16 ,33.33
03,021,01,005,0174,0,293,3,296,482,0,3,1,3,0,1,0,76.14,61.41 ,33.33
03,021,01,005,0175,0,416,8,424,688,0,3,1,3,0,1,0,76.14,61.63 ,33.33
03,021,01,005,0176,0,330,3,333,477,0,3,1,3,0,1,0,76.14,69.81 ,33.33
03,021,01,005,0177,0,371,5,376,591,0,3,1,3,0,1,0,76.14,63.62 ,33.33
03,021,01,005,0178,0,458,4,462,706,0,3,1,3,0,1,0,76.14,65.44 ,33.33
03,021,01,005,0179,0,449,4,453,731,0,3,1,3,0,1,0,76.14,61.97 ,33.33
03,021,01,005,0180,0,370,1,371,533,0,3,1,3,0,1,0,76.14,69.61 ,33.33
03,021,01,005,0181,0,571,9,580,866,0,3,1,3,0,1,0,76.14,66.97 ,33.33
03,021,01,005,0182,0,310,0,310,469,0,3,1,3,0,1,0,76.14,66.10 ,33.33
03,021,01,005,0183,0,272,5,277,429,0,3,1,3,0,1,0,76.14,64.57 ,33.33
03,021,01,005,0184,0,650,5,655,1023,0,3,1,3,0,1,0,76.14,64.03 ,33.33
03,021,01,005,0185,0,1429,14,1443,2357,0,3,1,3,0,1,0,76.14,61.22 ,33.33
03,021,01,005,0186,0,709,6,715,1076,0,3,1,3,0,1,0,76.14,66.45 ,33.33
03,021,01,005,0187,0,999,7,1006,1478,0,3,1,3,0,1,0,76.14,68.06 ,33.33
03,021,01,005,0188,0,442,4,446,687,0,3,1,3,0,1,0,76.14,64.92 ,33.33
03,021,01,005,0189,0,485,4,489,734,0,3,1,3,0,1,0,76.14,66.62 ,33.33
03,021,01,005,0190,0,918,9,927,1450,0,3,1,3,0,1,0,76.14,63.93 ,33.33
03,021,01,005,0191,0,1050,9,1059,1623,0,3,1,3,0,1,0,76.14,65.25 ,33.33
03,021,01,005,0192,0,2080,16,2096,3231,0,3,1,3,0,1,0,76.14,64.87 ,33.33
03,021,01,006,0193,0,399,7,406,533,0,3,1,3,0,1,0,76.14,76.17 ,33.33
03,021,01,006,0194,0,2053,27,2080,3455,0,3,1,3,0,1,0,76.14,60.20 ,33.33
03,021,01,006,0195,0,2593,24,2617,4136,0,3,1,3,0,1,0,76.14,63.27 ,33.33
03,021,01,006,0196,0,1575,28,1603,2379,0,3,1,3,0,1,0,76.14,67.38 ,33.33
03,021,01,006,0197,0,1915,21,1936,2979,0,3,1,3,0,1,0,76.14,64.99 ,33.33
03,021,01,006,0198,0,1895,32,1927,2923,0,3,1,3,0,1,0,76.14,65.93 ,33.33
03,021,01,006,0199,0,1659,22,1681,2526,0,3,1,3,0,1,0,76.14,66.55 ,33.33
03,021,01,006,0200,0,2470,31,2501,3881,0,3,1,3,0,1,0,76.14,64.44 ,33.33
03,021,01,006,0201,0,1525,14,1539,2428,0,3,1,3,0,1,0,76.14,63.39 ,33.33
03,021,01,006,0202,0,1201,15,1216,1856,0,3,1,3,0,1,0,76.14,65.52 ,33.33
03,021,01,006,0203,0,1386,16,1402,2112,0,3,1,3,0,1,0,76.14,66.38 ,33.33
03,021,01,006,0204,0,2241,35,2276,3577,0,3,1,3,0,1,0,76.14,63.63 ,33.33
03,021,01,006,0205,0,1650,19,1669,2533,0,3,1,3,0,1,0,76.14,65.89 ,33.33
03,021,01,006,0206,0,1910,28,1938,3324,0,3,1,3,0,1,0,76.14,58.30 ,33.33
03,021,01,006,0207,0,1776,22,1798,2987,0,3,1,3,0,1,0,76.14,60.19 ,33.33
03,021,01,006,0208,0,3747,42,3789,6043,0,3,1,3,0,1,0,76.14,62.70 ,33.33
03,021,01,006,0209,0,958,13,971,1359,0,3,1,3,0,1,0,76.14,71.45 ,33.33
03,021,01,006,0210,0,2007,37,2044,3103,0,3,1,3,0,1,0,76.14,65.87 ,33.33
03,021,01,006,0211,0,662,5,667,957,0,3,1,3,0,1,0,76.14,69.70 ,33.33
03,021,01,006,0212,0,773,6,779,1197,0,3,1,3,0,1,0,76.14,65.08 ,33.33
03,021,01,006,0213,0,1197,23,1220,1671,0,3,1,3,0,1,0,76.14,73.01 ,33.33
03,021,01,006,0214,0,792,7,799,1341,0,3,1,3,0,1,0,76.14,59.58 ,33.33
03,021,01,006,0215,0,1057,13,1070,1677,0,3,1,3,0,1,0,76.14,63.80 ,33.33
03,021,01,006,0216,0,608,6,614,811,0,3,1,3,0,1,0,76.14,75.71 ,33.33
03,021,01,006,0217,0,1281,24,1305,2124,0,3,1,3,0,1,0,76.14,61.44 ,33.33
03,021,01,006,0218,0,946,9,955,1511,0,3,1,3,0,1,0,76.14,63.20 ,33.33
03,021,01,006,0219,0,1442,26,1468,2379,0,3,1,3,0,1,0,76.14,61.71 ,33.33
03,021,01,006,0220,0,1481,25,1506,2231,0,3,1,3,0,1,0,76.14,67.50 ,33.33
03,021,01,006,0221,0,1890,33,1923,3097,0,3,1,3,0,1,0,76.14,62.09 ,33.33
03,021,01,006,0222,0,2067,17,2084,3423,0,3,1,3,0,1,0,76.14,60.88 ,33.33
03,021,01,006,0223,0,1691,24,1715,2706,0,3,1,3,0,1,0,76.14,63.38 ,33.33
03,021,01,006,0224,0,1657,26,1683,2708,0,3,1,3,0,1,0,76.14,62.15 ,33.33
03,021,01,006,0225,0,1717,23,1740,2737,0,3,1,3,0,1,0,76.14,63.57 ,33.33
03,021,01,006,0226,0,2365,29,2394,3746,0,3,1,3,0,1,0,76.14,63.91 ,33.33
03,021,01,006,0227,0,1035,19,1054,1572,0,3,1,3,0,1,0,76.14,67.05 ,33.33
03,021,01,006,0228,0,1602,21,1623,2561,0,3,1,3,0,1,0,76.14,63.37 ,33.33
03,021,01,006,0229,0,2367,31,2398,3931,0,3,1,3,0,1,0,76.14,61.00 ,33.33
03,021,01,006,0230,0,2114,25,2139,3324,0,3,1,3,0,1,0,76.14,64.35 ,33.33
03,021,01,006,0231,0,1218,9,1227,1908,0,3,1,3,0,1,0,76.14,64.31 ,33.33
03,021,01,006,0232,0,882,13,895,1350,0,3,1,3,0,1,0,76.14,66.30 ,33.33
03,021,01,006,0233,0,1577,24,1601,2310,0,3,1,3,0,1,0,76.14,69.31 ,33.33
03,021,01,006,0234,0,833,19,852,1170,0,3,1,3,0,1,0,76.14,72.82 ,33.33
03,021,01,006,0235,0,670,9,679,966,0,3,1,3,0,1,0,76.14,70.29 ,33.33
03,021,01,006,0236,0,827,9,836,1158,0,3,1,3,0,1,0,76.14,72.19 ,33.33
03,021,01,006,0237,0,674,7,681,828,0,3,1,3,0,1,0,76.14,82.25 ,33.33
03,021,01,006,0238,0,640,8,648,959,0,3,1,3,0,1,0,76.14,67.57 ,33.33
03,021,01,006,0239,0,685,7,692,1029,0,3,1,3,0,1,0,76.14,67.25 ,33.33
03,021,01,006,0240,0,413,8,421,617,0,3,1,3,0,1,0,76.14,68.23 ,33.33
03,021,01,006,0241,0,969,11,980,1402,0,3,1,3,0,1,0,76.14,69.90 ,33.33
03,021,01,006,0242,0,437,5,442,597,0,3,1,3,0,1,0,76.14,74.04 ,33.33
03,021,01,007,0243,0,3100,31,3131,4941,0,3,1,3,0,1,0,76.14,63.37 ,33.33
03,021,01,007,0244,0,527,9,536,781,0,3,1,3,0,1,0,76.14,68.63 ,33.33
03,021,01,007,0245,0,282,5,287,441,0,3,1,3,0,1,0,76.14,65.08 ,33.33
03,021,01,007,0246,0,241,1,242,340,0,3,1,3,0,1,0,76.14,71.18 ,33.33
03,021,01,007,0247,0,247,1,248,331,0,3,1,3,0,1,0,76.14,74.92 ,33.33
03,021,01,007,0248,0,244,2,246,373,0,3,1,3,0,1,0,76.14,65.95 ,33.33
03,021,01,007,0249,0,569,3,572,823,0,3,1,3,0,1,0,76.14,69.50 ,33.33
03,021,01,007,0250,0,1400,13,1413,2017,0,3,1,3,0,1,0,76.14,70.05 ,33.33
03,021,01,007,0251,0,913,14,927,1421,0,3,1,3,0,1,0,76.14,65.24 ,33.33
03,021,01,007,0252,0,373,9,382,522,0,3,1,3,0,1,0,76.14,73.18 ,33.33
03,021,01,007,0253,0,703,4,707,1151,0,3,1,3,0,1,0,76.14,61.42 ,33.33
03,021,01,007,0254,0,1979,24,2003,3516,0,3,1,3,0,1,0,76.14,56.97 ,33.33
03,021,01,007,0255,0,2256,20,2276,4185,0,3,1,3,0,1,0,76.14,54.38 ,33.33
03,021,01,007,0256,0,1999,27,2026,3295,0,3,1,3,0,1,0,76.14,61.49 ,33.33
03,021,01,007,0257,0,1531,8,1539,2798,0,3,1,3,0,1,0,76.14,55.00 ,33.33
03,021,01,007,0258,0,1223,12,1235,2096,0,3,1,3,0,1,0,76.14,58.92 ,33.33
03,021,01,007,0259,0,1511,17,1528,2524,0,3,1,3,0,1,0,76.14,60.54 ,33.33
03,021,01,007,0260,0,1545,17,1562,2478,0,3,1,3,0,1,0,76.14,63.03 ,33.33
04,001,01,001,0001,0,1234,24,1258,1886,0,3,1,3,0,1,0,76.14,66.70 ,33.33
04,001,01,001,0002,0,1393,36,1429,2166,0,3,1,3,0,1,0,76.14,65.97 ,33.33
04,001,01,001,0003,0,2245,45,2290,3559,0,3,1,3,0,1,0,76.14,64.34 ,33.33
04,001,01,001,0004,0,1010,15,1025,1547,0,3,1,3,0,1,0,76.14,66.26 ,33.33
04,001,01,001,0005,0,764,23,787,1221,0,3,1,3,0,1,0,76.14,64.46 ,33.33
04,001,01,001,0006,0,443,11,454,664,0,3,1,3,0,1,0,76.14,68.37 ,33.33
04,001,01,001,0007,0,849,23,872,1290,0,3,1,3,0,1,0,76.14,67.60 ,33.33
04,001,01,001,0008,0,436,7,443,721,0,3,1,3,0,1,0,76.14,61.44 ,33.33
04,001,01,002,0009,0,797,18,815,1227,0,3,1,3,0,1,0,76.14,66.42 ,33.33
04,001,01,002,0010,0,944,33,977,1512,0,3,1,3,0,1,0,76.14,64.62 ,33.33
04,001,01,002,0011,0,903,22,925,1350,0,3,1,3,0,1,0,76.14,68.52 ,33.33
04,001,01,002,0012,0,946,29,975,1485,0,3,1,3,0,1,0,76.14,65.66 ,33.33
04,001,01,002,0013,0,692,19,711,1190,0,3,1,3,0,1,0,76.14,59.75 ,33.33
04,001,01,002,0014,0,305,11,316,516,0,3,1,3,0,1,0,76.14,61.24 ,33.33
04,001,01,003,0015,0,1178,16,1194,1802,0,3,1,3,0,1,0,76.14,66.26 ,33.33
04,001,01,003,0016,0,852,19,871,1353,0,3,1,3,0,1,0,76.14,64.38 ,33.33
04,001,01,003,0017,0,354,15,369,564,0,3,1,3,0,1,0,76.14,65.43 ,33.33
04,001,01,003,0018,0,358,7,365,571,0,3,1,3,0,1,0,76.14,63.92 ,33.33
04,001,01,003,0019,0,377,12,389,607,0,3,1,3,0,1,0,76.14,64.09 ,33.33
04,001,01,003,0020,0,1037,24,1061,1583,0,3,1,3,0,1,0,76.14,67.02 ,33.33
04,001,01,003,0021,0,585,28,613,863,0,3,1,3,0,1,0,76.14,71.03 ,33.33
04,001,01,003,0022,0,834,18,852,1193,0,3,1,3,0,1,0,76.14,71.42 ,33.33
04,001,01,004,0023,0,1193,34,1227,1950,0,3,1,3,0,1,0,76.14,62.92 ,33.33
04,001,01,004,0024,0,486,13,499,772,0,3,1,3,0,1,0,76.14,64.64 ,33.33
04,001,01,004,0025,0,555,21,576,862,0,3,1,3,0,1,0,76.14,66.82 ,33.33
04,001,01,004,0026,0,302,13,315,558,0,3,1,3,0,1,0,76.14,56.45 ,33.33
04,001,01,004,0027,0,438,6,444,723,0,3,1,3,0,1,0,76.14,61.41 ,33.33
04,001,01,004,0028,0,433,10,443,723,0,3,1,3,0,1,0,76.14,61.27 ,33.33
04,001,01,004,0029,0,295,7,302,459,0,3,1,3,0,1,0,76.14,65.80 ,33.33
04,001,01,004,0030,0,484,13,497,804,0,3,1,3,0,1,0,76.14,61.82 ,33.33
04,001,01,005,0031,0,707,26,733,1148,0,3,1,3,0,1,0,76.14,63.85 ,33.33
04,001,01,005,0032,0,276,6,282,522,0,3,1,3,0,1,0,76.14,54.02 ,33.33
04,001,01,005,0033,0,400,19,419,747,0,3,1,3,0,1,0,76.14,56.09 ,33.33
04,001,01,005,0034,0,284,12,296,515,0,3,1,3,0,1,0,76.14,57.48 ,33.33
04,001,01,005,0035,0,599,22,621,987,0,3,1,3,0,1,0,76.14,62.92 ,33.33
04,001,01,006,0036,0,37,0,37,282,0,3,1,3,0,1,0,76.14,13.12 ,33.33
04,002,01,001,0001,0,1026,16,1042,1357,0,3,1,3,0,1,0,76.14,76.79 ,33.33
04,002,01,001,0002,0,467,12,479,578,0,3,1,3,0,1,0,76.14,82.87 ,33.33
04,002,01,001,0003,0,357,10,367,486,0,3,1,3,0,1,0,76.14,75.51 ,33.33
04,002,01,002,0004,0,1021,33,1054,1327,0,3,1,3,0,1,0,76.14,79.43 ,33.33
04,002,01,002,0005,0,598,13,611,846,0,3,1,3,0,1,0,76.14,72.22 ,33.33
04,002,01,003,0006,0,315,9,324,424,0,3,1,3,0,1,0,76.14,76.42 ,33.33
04,002,01,003,0007,0,227,3,230,385,0,3,1,3,0,1,0,76.14,59.74 ,33.33
04,002,01,004,0008,0,169,6,175,252,0,3,1,3,0,1,0,76.14,69.44 ,33.33
04,002,01,004,0009,0,372,17,389,554,0,3,1,3,0,1,0,76.14,70.22 ,33.33
01,000,01,001,0001,1 ,1184,13,1197,1794,0,3,1,3,0,1,0,76.14,66.72 ,33.33
01,000,01,001,0001,2 ,1246,16,1262,1937,0,3,1,3,0,1,0,76.14,65.15 ,33.33
01,000,01,001,0002,3 ,1149,11,1160,1731,0,3,1,3,0,1,0,76.14,67.01 ,33.33
01,000,01,001,0002,4 ,1088,10,1098,1752,0,3,1,3,0,1,0,76.14,62.67 ,33.33
01,000,01,001,0003,5 ,835,5,840,1327,0,3,1,3,0,1,0,76.14,63.30 ,33.33
01,000,01,001,0003,6 ,939,11,950,1518,0,3,1,3,0,1,0,76.14,62.58 ,33.33
01,000,01,001,0003,7 ,926,4,930,1427,0,3,1,3,0,1,0,76.14,65.17 ,33.33
01,000,01,001,0004,8 ,1391,13,1404,2063,0,3,1,3,0,1,0,76.14,68.06 ,33.33
01,000,01,001,0004,9 ,1072,15,1087,1554,0,3,1,3,0,1,0,76.14,69.95 ,33.33
01,000,01,001,0004,10 ,1027,11,1038,1492,0,3,1,3,0,1,0,76.14,69.57 ,33.33
01,000,01,001,0005,11 ,1089,19,1108,1795,0,3,1,3,0,1,0,76.14,61.73 ,33.33
01,000,01,001,0005,12 ,1199,10,1209,1886,0,3,1,3,0,1,0,76.14,64.10 ,33.33
01,000,01,001,0005,13 ,1109,14,1123,1726,0,3,1,3,0,1,0,76.14,65.06 ,33.33
01,000,01,001,0006,14 ,1204,10,1214,1916,0,3,1,3,0,1,0,76.14,63.36 ,33.33
01,000,01,001,0006,15 ,1287,9,1296,1998,0,3,1,3,0,1,0,76.14,64.86 ,33.33
01,000,01,001,0006,16 ,1181,9,1190,1802,0,3,1,3,0,1,0,76.14,66.04 ,33.33
01,000,01,001,0007,17 ,1184,10,1194,1854,0,3,1,3,0,1,0,76.14,64.40 ,33.33
01,000,01,001,0007,18 ,1146,17,1163,1750,0,3,1,3,0,1,0,76.14,66.46 ,33.33
01,000,01,001,0007,19 ,1069,5,1074,1728,0,3,1,3,0,1,0,76.14,62.15 ,33.33
01,000,01,001,0008,20 ,995,9,1004,1496,0,3,1,3,0,1,0,76.14,67.11 ,33.33
01,000,01,001,0008,21 ,1073,13,1086,1665,0,3,1,3,0,1,0,76.14,65.23 ,33.33
01,000,01,001,0008,22 ,1096,15,1111,1633,0,3,1,3,0,1,0,76.14,68.03 ,33.33
01,000,01,001,0008,23 ,898,6,904,1412,0,3,1,3,0,1,0,76.14,64.02 ,33.33
01,000,01,001,0009,24 ,940,13,953,1464,0,3,1,3,0,1,0,76.14,65.10 ,33.33
01,000,01,001,0009,25 ,1061,12,1073,1637,0,3,1,3,0,1,0,76.14,65.55 ,33.33
01,000,01,001,0009,26 ,1008,10,1018,1613,0,3,1,3,0,1,0,76.14,63.11 ,33.33
01,000,01,001,0009,27 ,856,6,862,1353,0,3,1,3,0,1,0,76.14,63.71 ,33.33
01,000,01,001,0010,28 ,1070,5,1075,1590,0,3,1,3,0,1,0,76.14,67.61 ,33.33
01,000,01,001,0010,29 ,1082,6,1088,1729,0,3,1,3,0,1,0,76.14,62.93 ,33.33
01,000,01,001,0010,30 ,1094,9,1103,1697,0,3,1,3,0,1,0,76.14,65.00 ,33.33
01,000,01,001,0011,31 ,996,7,1003,1543,0,3,1,3,0,1,0,76.14,65.00 ,33.33
01,000,01,001,0011,32 ,1328,11,1339,2016,0,3,1,3,0,1,0,76.14,66.42 ,33.33
01,000,01,001,0012,33 ,1335,8,1343,1836,0,3,1,3,0,1,0,76.14,73.15 ,33.33
01,000,01,001,0012,34 ,1175,11,1186,1792,0,3,1,3,0,1,0,76.14,66.18 ,33.33
01,000,01,001,0013,35 ,1050,17,1067,1682,0,3,1,3,0,1,0,76.14,63.44 ,33.33
01,000,01,001,0013,36 ,1068,10,1078,1680,0,3,1,3,0,1,0,76.14,64.17 ,33.33
01,000,01,001,0013,37 ,1051,16,1067,1575,0,3,1,3,0,1,0,76.14,67.75 ,33.33
01,000,01,001,0014,38 ,1268,13,1281,1835,0,3,1,3,0,1,0,76.14,69.81 ,33.33
01,000,01,001,0014,39 ,1390,13,1403,2095,0,3,1,3,0,1,0,76.14,66.97 ,33.33
01,000,01,001,0015,40 ,1154,16,1170,1783,0,3,1,3,0,1,0,76.14,65.62 ,33.33
01,000,01,001,0015,41 ,1241,13,1254,2004,0,3,1,3,0,1,0,76.14,62.57 ,33.33
01,000,01,001,0016,42 ,1375,21,1396,2073,0,3,1,3,0,1,0,76.14,67.34 ,33.33
01,000,01,001,0016,43 ,1276,14,1290,2018,0,3,1,3,0,1,0,76.14,63.92 ,33.33
01,000,01,001,0017,44 ,1100,12,1112,1763,0,3,1,3,0,1,0,76.14,63.07 ,33.33
01,000,01,001,0017,45 ,1017,6,1023,1511,0,3,1,3,0,1,0,76.14,67.70 ,33.33
01,000,01,001,0017,46 ,1068,5,1073,1553,0,3,1,3,0,1,0,76.14,69.09 ,33.33
01,000,01,001,0017,47 ,1091,12,1103,1600,0,3,1,3,0,1,0,76.14,68.94 ,33.33
01,000,01,001,0018,48 ,1127,13,1140,1792,0,3,1,3,0,1,0,76.14,63.62 ,33.33
01,000,01,001,0018,49 ,1247,11,1258,1966,0,3,1,3,0,1,0,76.14,63.99 ,33.33
01,000,01,001,0019,50 ,957,5,962,1338,0,3,1,3,0,1,0,76.14,71.90 ,33.33
01,000,01,001,0020,51 ,1101,10,1111,1755,0,3,1,3,0,1,0,76.14,63.30 ,33.33
01,000,01,001,0020,52 ,1009,10,1019,1599,0,3,1,3,0,1,0,76.14,63.73 ,33.33
01,000,01,001,0020,53 ,1121,7,1128,1752,0,3,1,3,0,1,0,76.14,64.38 ,33.33
01,000,01,001,0020,54 ,1365,19,1384,2153,0,3,1,3,0,1,0,76.14,64.28 ,33.33
01,000,01,001,0021,55 ,994,10,1004,1455,0,3,1,3,0,1,0,76.14,69.00 ,33.33
01,000,01,001,0021,56 ,1218,16,1234,1888,0,3,1,3,0,1,0,76.14,65.36 ,33.33
01,000,01,001,0021,57 ,1077,15,1092,1601,0,3,1,3,0,1,0,76.14,68.21 ,33.33
01,000,01,001,0021,58 ,1059,21,1080,1802,0,3,1,3,0,1,0,76.14,59.93 ,33.33
01,000,01,001,0022,59 ,1173,13,1186,1819,0,3,1,3,0,1,0,76.14,65.20 ,33.33
01,000,01,001,0022,60 ,1173,17,1190,1942,0,3,1,3,0,1,0,76.14,61.28 ,33.33
01,000,01,001,0022,61 ,1223,43,1266,1999,0,3,1,3,0,1,0,76.14,63.33 ,33.33
01,000,01,001,0023,62 ,988,15,1003,1505,0,3,1,3,0,1,0,76.14,66.64 ,33.33
01,000,01,001,0023,63 ,875,13,888,1375,0,3,1,3,0,1,0,76.14,64.58 ,33.33
01,000,01,001,0023,64 ,889,16,905,1550,0,3,1,3,0,1,0,76.14,58.39 ,33.33
01,000,01,001,0024,65 ,967,13,980,1470,0,3,1,3,0,1,0,76.14,66.67 ,33.33
01,000,01,001,0024,66 ,1072,9,1081,1639,0,3,1,3,0,1,0,76.14,65.95 ,33.33
01,000,01,001,0024,67 ,943,9,952,1507,0,3,1,3,0,1,0,76.14,63.17 ,33.33
01,000,01,001,0025,68 ,1114,12,1126,1690,0,3,1,3,0,1,0,76.14,66.63 ,33.33
01,000,01,001,0025,69 ,1009,9,1018,1591,0,3,1,3,0,1,0,76.14,63.98 ,33.33
01,000,01,001,0025,70 ,1035,6,1041,1672,0,3,1,3,0,1,0,76.14,62.26 ,33.33
01,000,01,001,0026,71 ,772,16,788,1257,0,3,1,3,0,1,0,76.14,62.69 ,33.33
01,000,01,001,0026,72 ,830,3,833,1448,0,3,1,3,0,1,0,76.14,57.53 ,33.33
01,000,01,001,0027,73 ,891,2,893,1542,0,3,1,3,0,1,0,76.14,57.91 ,33.33
01,000,01,001,0027,74 ,974,6,980,1708,0,3,1,3,0,1,0,76.14,57.38 ,33.33
01,000,01,001,0027,75 ,888,9,897,1475,0,3,1,3,0,1,0,76.14,60.81 ,33.33
01,000,01,001,0028,76 ,1002,12,1014,1533,0,3,1,3,0,1,0,76.14,66.14 ,33.33
01,000,01,001,0028,77 ,1223,11,1234,1839,0,3,1,3,0,1,0,76.14,67.10 ,33.33
01,000,01,001,0029,78 ,964,11,975,1579,0,3,1,3,0,1,0,76.14,61.75 ,33.33
01,000,01,001,0029,79 ,1118,15,1133,1708,0,3,1,3,0,1,0,76.14,66.33 ,33.33
01,000,01,001,0029,80 ,1109,14,1123,1876,0,3,1,3,0,1,0,76.14,59.86 ,33.33
01,000,01,001,0030,81 ,1639,22,1661,2589,0,3,1,3,0,1,0,76.14,64.16 ,33.33
01,000,01,001,0030,82 ,980,7,987,1496,0,3,1,3,0,1,0,76.14,65.98 ,33.33
01,000,01,001,0030,83 ,516,6,522,808,0,3,1,3,0,1,0,76.14,64.60 ,33.33
01,000,01,001,0031,84 ,958,7,965,1436,0,3,1,3,0,1,0,76.14,67.20 ,33.33
01,000,01,001,0031,85 ,1037,9,1046,1570,0,3,1,3,0,1,0,76.14,66.62 ,33.33
01,000,01,001,0031,86 ,1112,9,1121,1728,0,3,1,3,0,1,0,76.14,64.87 ,33.33
01,000,01,001,0032,87 ,929,14,943,1413,0,3,1,3,0,1,0,76.14,66.74 ,33.33
01,000,01,001,0032,88 ,981,15,996,1500,0,3,1,3,0,1,0,76.14,66.40 ,33.33
01,000,01,001,0033,89 ,1156,8,1164,1640,0,3,1,3,0,1,0,76.14,70.98 ,33.33
01,000,01,001,0033,90 ,1099,8,1107,1645,0,3,1,3,0,1,0,76.14,67.29 ,33.33
01,000,01,001,0034,91 ,1055,5,1060,1687,0,3,1,3,0,1,0,76.14,62.83 ,33.33
01,000,01,001,0034,92 ,1013,7,1020,1601,0,3,1,3,0,1,0,76.14,63.71 ,33.33
01,000,01,001,0035,93 ,1167,29,1196,1895,0,3,1,3,0,1,0,76.14,63.11 ,33.33
01,000,01,001,0035,94 ,1117,18,1135,1844,0,3,1,3,0,1,0,76.14,61.55 ,33.33
01,000,01,001,0036,95 ,1297,10,1307,2002,0,3,1,3,0,1,0,76.14,65.28 ,33.33
01,000,01,001,0036,96 ,1293,27,1320,2104,0,3,1,3,0,1,0,76.14,62.74 ,33.33
01,000,01,001,0037,97 ,1058,11,1069,1686,0,3,1,3,0,1,0,76.14,63.40 ,33.33
01,000,01,001,0037,98 ,954,12,966,1661,0,3,1,3,0,1,0,76.14,58.16 ,33.33
01,000,01,001,0037,99 ,840,23,863,1343,0,3,1,3,0,1,0,76.14,64.26 ,33.33
01,000,01,001,0038,100 ,996,9,1005,1555,0,3,1,3,0,1,0,76.14,64.63 ,33.33
01,000,01,001,0038,101 ,922,12,934,1520,0,3,1,3,0,1,0,76.14,61.45 ,33.33
01,000,01,001,0038,102 ,1124,11,1135,1773,0,3,1,3,0,1,0,76.14,64.02 ,33.33
01,000,01,001,0038,103 ,937,15,952,1461,0,3,1,3,0,1,0,76.14,65.16 ,33.33
01,000,01,001,0038,104 ,841,26,867,1293,0,3,1,3,0,1,0,76.14,67.05 ,33.33
01,000,01,001,0039,105 ,268,1,269,405,0,3,1,3,0,1,0,76.14,66.42 ,33.33
01,000,01,001,0039,106 ,995,10,1005,1498,0,3,1,3,0,1,0,76.14,67.09 ,33.33
01,000,01,001,0040,107 ,453,3,456,699,0,3,1,3,0,1,0,76.14,65.24 ,33.33
01,000,01,001,0040,108 ,582,5,587,926,0,3,1,3,0,1,0,76.14,63.39 ,33.33
01,000,01,001,0040,109 ,474,10,484,731,0,3,1,3,0,1,0,76.14,66.21 ,33.33
01,000,01,002,0041,110 ,753,15,768,1142,0,3,1,3,0,1,0,76.14,67.25 ,33.33
01,000,01,002,0042,111 ,753,8,761,1180,0,3,1,3,0,1,0,76.14,64.49 ,33.33
01,000,01,002,0043,112 ,1095,10,1105,1734,0,3,1,3,0,1,0,76.14,63.73 ,33.33
01,000,01,002,0044,113 ,588,8,596,929,0,3,1,3,0,1,0,76.14,64.16 ,33.33
01,000,01,002,0044,114 ,548,4,552,973,0,3,1,3,0,1,0,76.14,56.73 ,33.33
01,000,01,002,0044,115 ,502,7,509,821,0,3,1,3,0,1,0,76.14,62.00 ,33.33
01,000,01,002,0045,116 ,861,12,873,1348,0,3,1,3,0,1,0,76.14,64.76 ,33.33
01,000,01,002,0046,117 ,856,8,864,1196,0,3,1,3,0,1,0,76.14,72.24 ,33.33
01,000,01,002,0047,118 ,815,15,830,1221,0,3,1,3,0,1,0,76.14,67.98 ,33.33
01,000,01,002,0048,119 ,894,10,904,1292,0,3,1,3,0,1,0,76.14,69.97 ,33.33
01,000,01,002,0048,120 ,793,3,796,1249,0,3,1,3,0,1,0,76.14,63.73 ,33.33
01,000,01,002,0048,121 ,627,6,633,1021,0,3,1,3,0,1,0,76.14,62.00 ,33.33
01,000,01,002,0048,122 ,832,15,847,1337,0,3,1,3,0,1,0,76.14,63.35 ,33.33
01,000,01,002,0049,123 ,879,7,886,1365,0,3,1,3,0,1,0,76.14,64.91 ,33.33
01,000,01,002,0049,124 ,975,11,986,1514,0,3,1,3,0,1,0,76.14,65.13 ,33.33
01,000,01,002,0049,125 ,917,6,923,1476,0,3,1,3,0,1,0,76.14,62.53 ,33.33
01,000,01,002,0050,126 ,1105,10,1115,1640,0,3,1,3,0,1,0,76.14,67.99 ,33.33
01,000,01,002,0050,127 ,1113,9,1122,1705,0,3,1,3,0,1,0,76.14,65.81 ,33.33
01,000,01,002,0050,128 ,988,5,993,1521,0,3,1,3,0,1,0,76.14,65.29 ,33.33
01,000,01,002,0051,129 ,786,8,794,1229,0,3,1,3,0,1,0,76.14,64.61 ,33.33
01,000,01,002,0051,130 ,929,7,936,1403,0,3,1,3,0,1,0,76.14,66.71 ,33.33
01,000,01,002,0051,131 ,946,5,951,1468,0,3,1,3,0,1,0,76.14,64.78 ,33.33
01,000,01,002,0052,132 ,1148,15,1163,1753,0,3,1,3,0,1,0,76.14,66.34 ,33.33
01,000,01,002,0052,133 ,1203,3,1206,1849,0,3,1,3,0,1,0,76.14,65.22 ,33.33
01,000,01,002,0053,134 ,1276,14,1290,2023,0,3,1,3,0,1,0,76.14,63.77 ,33.33
01,000,01,002,0053,135 ,1232,12,1244,1931,0,3,1,3,0,1,0,76.14,64.42 ,33.33
01,000,01,002,0053,136 ,1097,4,1101,1854,0,3,1,3,0,1,0,76.14,59.39 ,33.33
01,000,01,002,0054,137 ,1129,8,1137,1825,0,3,1,3,0,1,0,76.14,62.30 ,33.33
01,000,01,002,0054,138 ,1076,9,1085,1721,0,3,1,3,0,1,0,76.14,63.04 ,33.33
01,000,01,002,0054,139 ,1135,10,1145,1920,0,3,1,3,0,1,0,76.14,59.64 ,33.33
01,000,01,002,0055,140 ,928,6,934,1527,0,3,1,3,0,1,0,76.14,61.17 ,33.33
01,000,01,002,0055,141 ,1089,6,1095,1759,0,3,1,3,0,1,0,76.14,62.25 ,33.33
01,000,01,002,0055,142 ,1059,11,1070,1704,0,3,1,3,0,1,0,76.14,62.79 ,33.33
01,000,01,002,0055,143 ,968,8,976,1534,0,3,1,3,0,1,0,76.14,63.62 ,33.33
01,000,01,002,0056,144 ,1100,5,1105,1655,0,3,1,3,0,1,0,76.14,66.77 ,33.33
01,000,01,002,0056,145 ,1096,6,1102,1675,0,3,1,3,0,1,0,76.14,65.79 ,33.33
01,000,01,002,0056,146 ,1128,6,1134,1730,0,3,1,3,0,1,0,76.14,65.55 ,33.33
01,000,01,002,0057,147 ,1077,7,1084,1759,0,3,1,3,0,1,0,76.14,61.63 ,33.33
01,000,01,002,0057,148 ,1132,12,1144,1814,0,3,1,3,0,1,0,76.14,63.07 ,33.33
01,000,01,002,0058,149 ,1098,12,1110,1616,0,3,1,3,0,1,0,76.14,68.69 ,33.33
01,000,01,002,0058,150 ,1108,16,1124,1790,0,3,1,3,0,1,0,76.14,62.79 ,33.33
01,000,01,002,0058,151 ,1057,12,1069,1662,0,3,1,3,0,1,0,76.14,64.32 ,33.33
01,000,01,002,0059,152 ,871,9,880,1394,0,3,1,3,0,1,0,76.14,63.13 ,33.33
01,000,01,002,0059,153 ,925,4,929,1419,0,3,1,3,0,1,0,76.14,65.47 ,33.33
01,000,01,002,0059,154 ,944,6,950,1285,0,3,1,3,0,1,0,76.14,73.93 ,33.33
01,000,01,002,0060,155 ,1205,12,1217,1937,0,3,1,3,0,1,0,76.14,62.83 ,33.33
01,000,01,002,0060,156 ,1162,14,1176,1779,0,3,1,3,0,1,0,76.14,66.10 ,33.33
01,000,01,002,0060,157 ,1116,9,1125,1789,0,3,1,3,0,1,0,76.14,62.88 ,33.33
01,000,01,002,0061,158 ,1357,9,1366,1977,0,3,1,3,0,1,0,76.14,69.09 ,33.33
01,000,01,002,0061,159 ,1279,12,1291,1905,0,3,1,3,0,1,0,76.14,67.77 ,33.33
01,000,01,002,0062,160 ,1016,13,1029,1530,0,3,1,3,0,1,0,76.14,67.25 ,33.33
01,000,01,002,0062,161 ,1079,16,1095,1777,0,3,1,3,0,1,0,76.14,61.62 ,33.33
01,000,01,002,0063,162 ,1040,7,1047,1561,0,3,1,3,0,1,0,76.14,67.07 ,33.33
01,000,01,002,0063,163 ,882,7,889,1474,0,3,1,3,0,1,0,76.14,60.31 ,33.33
01,000,01,002,0063,164 ,860,10,870,1452,0,3,1,3,0,1,0,76.14,59.92 ,33.33
01,000,01,002,0064,165 ,1059,5,1064,1548,0,3,1,3,0,1,0,76.14,68.73 ,33.33
01,000,01,002,0064,166 ,950,5,955,1417,0,3,1,3,0,1,0,76.14,67.40 ,33.33
01,000,01,002,0064,167 ,981,11,992,1536,0,3,1,3,0,1,0,76.14,64.58 ,33.33
01,000,01,002,0065,168 ,1138,6,1144,1780,0,3,1,3,0,1,0,76.14,64.27 ,33.33
01,000,01,002,0065,169 ,1029,10,1039,1743,0,3,1,3,0,1,0,76.14,59.61 ,33.33
01,000,01,002,0065,170 ,1006,8,1014,1569,0,3,1,3,0,1,0,76.14,64.63 ,33.33
01,000,01,002,0065,171 ,951,8,959,1515,0,3,1,3,0,1,0,76.14,63.30 ,33.33
01,000,01,002,0066,172 ,1040,12,1052,1612,0,3,1,3,0,1,0,76.14,65.26 ,33.33
01,000,01,002,0066,173 ,1081,11,1092,1601,0,3,1,3,0,1,0,76.14,68.21 ,33.33
01,000,01,002,0066,174 ,1000,4,1004,1549,0,3,1,3,0,1,0,76.14,64.82 ,33.33
01,000,01,002,0067,175 ,1214,11,1225,1854,0,3,1,3,0,1,0,76.14,66.07 ,33.33
01,000,01,002,0067,176 ,1214,18,1232,1815,0,3,1,3,0,1,0,76.14,67.88 ,33.33
01,000,01,002,0068,177 ,752,7,759,1240,0,3,1,3,0,1,0,76.14,61.21 ,33.33
01,000,01,002,0068,178 ,655,10,665,1086,0,3,1,3,0,1,0,76.14,61.23 ,33.33
01,000,01,002,0069,179 ,688,9,697,1070,0,3,1,3,0,1,0,76.14,65.14 ,33.33
01,000,01,002,0069,180 ,367,2,369,588,0,3,1,3,0,1,0,76.14,62.76 ,33.33
01,000,01,002,0069,181 ,1001,9,1010,1500,0,3,1,3,0,1,0,76.14,67.33 ,33.33
01,000,01,002,0070,182 ,834,9,843,1353,0,3,1,3,0,1,0,76.14,62.31 ,33.33
01,000,01,002,0070,183 ,844,10,854,1289,0,3,1,3,0,1,0,76.14,66.25 ,33.33
01,000,01,002,0070,184 ,652,2,654,1356,0,3,1,3,0,1,0,76.14,48.23 ,33.33
01,000,01,002,0071,185 ,1147,16,1163,1783,0,3,1,3,0,1,0,76.14,65.23 ,33.33
01,000,01,002,0071,186 ,1293,7,1300,1938,0,3,1,3,0,1,0,76.14,67.08 ,33.33
01,000,01,002,0071,187 ,1172,7,1179,1806,0,3,1,3,0,1,0,76.14,65.28 ,33.33
01,000,01,002,0072,188 ,1172,11,1183,1732,0,3,1,3,0,1,0,76.14,68.30 ,33.33
01,000,01,002,0072,189 ,1138,19,1157,1701,0,3,1,3,0,1,0,76.14,68.02 ,33.33
01,000,01,002,0072,190 ,1169,11,1180,1912,0,3,1,3,0,1,0,76.14,61.72 ,33.33
01,000,01,002,0073,191 ,1236,17,1253,1965,0,3,1,3,0,1,0,76.14,63.77 ,33.33
01,000,01,002,0073,192 ,1230,7,1237,1862,0,3,1,3,0,1,0,76.14,66.43 ,33.33
01,000,01,002,0073,193 ,1315,26,1341,1986,0,3,1,3,0,1,0,76.14,67.52 ,33.33
01,000,01,002,0074,194 ,1046,19,1065,1639,0,3,1,3,0,1,0,76.14,64.98 ,33.33
01,000,01,002,0074,195 ,1003,10,1013,1614,0,3,1,3,0,1,0,76.14,62.76 ,33.33
01,000,01,002,0074,196 ,982,10,992,1606,0,3,1,3,0,1,0,76.14,61.77 ,33.33
01,000,01,002,0074,197 ,845,10,855,1402,0,3,1,3,0,1,0,76.14,60.98 ,33.33
01,000,01,002,0075,198 ,834,12,846,1368,0,3,1,3,0,1,0,76.14,61.84 ,33.33
01,000,01,002,0075,199 ,915,4,919,1422,0,3,1,3,0,1,0,76.14,64.63 ,33.33
01,000,01,002,0075,200 ,984,15,999,1499,0,3,1,3,0,1,0,76.14,66.64 ,33.33
01,000,01,002,0076,201 ,1084,11,1095,1742,0,3,1,3,0,1,0,76.14,62.86 ,33.33
01,000,01,002,0076,202 ,1111,10,1121,1729,0,3,1,3,0,1,0,76.14,64.84 ,33.33
01,000,01,002,0077,203 ,1141,16,1157,1804,0,3,1,3,0,1,0,76.14,64.14 ,33.33
01,000,01,002,0077,204 ,1192,12,1204,1844,0,3,1,3,0,1,0,76.14,65.29 ,33.33
01,000,01,002,0077,205 ,1261,9,1270,1995,0,3,1,3,0,1,0,76.14,63.66 ,33.33
01,000,01,002,0078,206 ,805,7,812,1337,0,3,1,3,0,1,0,76.14,60.73 ,33.33
01,000,01,002,0078,207 ,889,8,897,1384,0,3,1,3,0,1,0,76.14,64.81 ,33.33
01,000,01,002,0078,208 ,962,8,970,1554,0,3,1,3,0,1,0,76.14,62.42 ,33.33
01,000,01,002,0079,209 ,1094,10,1104,1914,0,3,1,3,0,1,0,76.14,57.68 ,33.33
01,000,01,002,0079,210 ,1156,13,1169,1895,0,3,1,3,0,1,0,76.14,61.69 ,33.33
01,000,01,002,0079,211 ,1067,15,1082,1686,0,3,1,3,0,1,0,76.14,64.18 ,33.33
01,000,01,002,0080,212 ,981,13,994,1552,0,3,1,3,0,1,0,76.14,64.05 ,33.33
01,000,01,002,0080,213 ,696,11,707,1192,0,3,1,3,0,1,0,76.14,59.31 ,33.33
01,000,01,002,0080,214 ,782,8,790,1313,0,3,1,3,0,1,0,76.14,60.17 ,33.33
01,000,01,002,0081,215 ,866,13,879,1461,0,3,1,3,0,1,0,76.14,60.16 ,33.33
01,000,01,002,0081,216 ,906,10,916,1484,0,3,1,3,0,1,0,76.14,61.73 ,33.33
01,000,01,002,0081,217 ,861,5,866,1464,0,3,1,3,0,1,0,76.14,59.15 ,33.33
01,000,01,002,0082,218 ,936,19,955,1563,0,3,1,3,0,1,0,76.14,61.10 ,33.33
01,000,01,002,0082,219 ,958,11,969,1525,0,3,1,3,0,1,0,76.14,63.54 ,33.33
01,000,01,002,0082,220 ,1045,8,1053,1645,0,3,1,3,0,1,0,76.14,64.01 ,33.33
01,000,01,002,0083,221 ,1333,11,1344,1984,0,3,1,3,0,1,0,76.14,67.74 ,33.33
01,000,01,002,0083,222 ,1293,16,1309,2048,0,3,1,3,0,1,0,76.14,63.92 ,33.33
01,000,01,002,0083,223 ,1172,10,1182,1715,0,3,1,3,0,1,0,76.14,68.92 ,33.33
01,000,01,002,0084,224 ,995,5,1000,1635,0,3,1,3,0,1,0,76.14,61.16 ,33.33
01,000,01,002,0084,225 ,950,9,959,1440,0,3,1,3,0,1,0,76.14,66.60 ,33.33
01,000,01,002,0085,226 ,971,8,979,1576,0,3,1,3,0,1,0,76.14,62.12 ,33.33
01,000,01,002,0085,227 ,1055,9,1064,1693,0,3,1,3,0,1,0,76.14,62.85 ,33.33
01,000,01,002,0085,228 ,1065,15,1080,1690,0,3,1,3,0,1,0,76.14,63.91 ,33.33
01,000,01,002,0086,229 ,1111,16,1127,1730,0,3,1,3,0,1,0,76.14,65.14 ,33.33
01,000,01,002,0086,230 ,1049,14,1063,1634,0,3,1,3,0,1,0,76.14,65.06 ,33.33
01,000,01,002,0086,231 ,947,12,959,1532,0,3,1,3,0,1,0,76.14,62.60 ,33.33
01,000,01,002,0086,232 ,985,11,996,1582,0,3,1,3,0,1,0,76.14,62.96 ,33.33
01,000,01,002,0087,233 ,1193,29,1222,1759,0,3,1,3,0,1,0,76.14,69.47 ,33.33
01,000,01,002,0087,234 ,1261,25,1286,1892,0,3,1,3,0,1,0,76.14,67.97 ,33.33
01,000,01,002,0087,235 ,1124,15,1139,1833,0,3,1,3,0,1,0,76.14,62.14 ,33.33
01,000,01,002,0088,236 ,1285,13,1298,2004,0,3,1,3,0,1,0,76.14,64.77 ,33.33
01,000,01,002,0088,237 ,1208,9,1217,1802,0,3,1,3,0,1,0,76.14,67.54 ,33.33
01,000,01,002,0088,238 ,1261,12,1273,1933,0,3,1,3,0,1,0,76.14,65.86 ,33.33
01,000,01,002,0089,239 ,1226,15,1241,1890,0,3,1,3,0,1,0,76.14,65.66 ,33.33
01,000,01,002,0089,240 ,1361,12,1373,2066,0,3,1,3,0,1,0,76.14,66.46 ,33.33
01,000,01,002,0090,241 ,864,3,867,1295,0,3,1,3,0,1,0,76.14,66.95 ,33.33
01,000,01,002,0090,242 ,934,5,939,1429,0,3,1,3,0,1,0,76.14,65.71 ,33.33
01,000,01,002,0090,243 ,1118,13,1131,1643,0,3,1,3,0,1,0,76.14,68.84 ,33.33
01,000,01,003,0091,244 ,928,10,938,1460,0,3,1,3,0,1,0,76.14,64.25 ,33.33
01,000,01,003,0091,245 ,960,12,972,1479,0,3,1,3,0,1,0,76.14,65.72 ,33.33
01,000,01,003,0091,246 ,981,8,989,1487,0,3,1,3,0,1,0,76.14,66.51 ,33.33
01,000,01,003,0091,247 ,971,9,980,1565,0,3,1,3,0,1,0,76.14,62.62 ,33.33
01,000,01,003,0092,248 ,952,14,966,1452,0,3,1,3,0,1,0,76.14,66.53 ,33.33
01,000,01,003,0092,249 ,869,7,876,1375,0,3,1,3,0,1,0,76.14,63.71 ,33.33
01,000,01,003,0092,250 ,765,12,777,1255,0,3,1,3,0,1,0,76.14,61.91 ,33.33
01,000,01,003,0092,251 ,1282,11,1293,1806,0,3,1,3,0,1,0,76.14,71.59 ,33.33
01,000,01,003,0093,252 ,1066,4,1070,1653,0,3,1,3,0,1,0,76.14,64.73 ,33.33
01,000,01,003,0093,253 ,975,10,985,1553,0,3,1,3,0,1,0,76.14,63.43 ,33.33
01,000,01,003,0093,254 ,1000,7,1007,1593,0,3,1,3,0,1,0,76.14,63.21 ,33.33
01,000,01,003,0094,255 ,979,6,985,1463,0,3,1,3,0,1,0,76.14,67.33 ,33.33
01,000,01,003,0094,256 ,955,11,966,1450,0,3,1,3,0,1,0,76.14,66.62 ,33.33
01,000,01,003,0094,257 ,855,6,861,1296,0,3,1,3,0,1,0,76.14,66.44 ,33.33
01,000,01,003,0095,258 ,1090,9,1099,1671,0,3,1,3,0,1,0,76.14,65.77 ,33.33
01,000,01,003,0095,259 ,1046,9,1055,1619,0,3,1,3,0,1,0,76.14,65.16 ,33.33
01,000,01,003,0095,260 ,1055,9,1064,1648,0,3,1,3,0,1,0,76.14,64.56 ,33.33
01,000,01,003,0095,261 ,1043,13,1056,1647,0,3,1,3,0,1,0,76.14,64.12 ,33.33
01,000,01,003,0095,262 ,948,4,952,1446,0,3,1,3,0,1,0,76.14,65.84 ,33.33
01,000,01,003,0096,263 ,1164,10,1174,1786,0,3,1,3,0,1,0,76.14,65.73 ,33.33
01,000,01,003,0096,264 ,1001,13,1014,1630,0,3,1,3,0,1,0,76.14,62.21 ,33.33
01,000,01,003,0096,265 ,1214,12,1226,1862,0,3,1,3,0,1,0,76.14,65.84 ,33.33
01,000,01,003,0096,266 ,1104,3,1107,1706,0,3,1,3,0,1,0,76.14,64.89 ,33.33
01,000,01,003,0097,267 ,953,13,966,1451,0,3,1,3,0,1,0,76.14,66.57 ,33.33
01,000,01,003,0097,268 ,960,9,969,1470,0,3,1,3,0,1,0,76.14,65.92 ,33.33
01,000,01,003,0097,269 ,1087,9,1096,1561,0,3,1,3,0,1,0,76.14,70.21 ,33.33
01,000,01,003,0097,270 ,970,15,985,1531,0,3,1,3,0,1,0,76.14,64.34 ,33.33
01,000,01,003,0098,271 ,920,4,924,1376,0,3,1,3,0,1,0,76.14,67.15 ,33.33
01,000,01,003,0098,272 ,893,9,902,1444,0,3,1,3,0,1,0,76.14,62.47 ,33.33
01,000,01,003,0098,273 ,841,9,850,1362,0,3,1,3,0,1,0,76.14,62.41 ,33.33
01,000,01,003,0099,274 ,974,6,980,1525,0,3,1,3,0,1,0,76.14,64.26 ,33.33
01,000,01,003,0099,275 ,954,11,965,1361,0,3,1,3,0,1,0,76.14,70.90 ,33.33
01,000,01,003,0099,276 ,697,7,704,1092,0,3,1,3,0,1,0,76.14,64.47 ,33.33
01,000,01,003,0099,277 ,1027,8,1035,1589,0,3,1,3,0,1,0,76.14,65.14 ,33.33
01,000,01,003,0100,278 ,1063,13,1076,1604,0,3,1,3,0,1,0,76.14,67.08 ,33.33
01,000,01,003,0100,279 ,958,7,965,1522,0,3,1,3,0,1,0,76.14,63.40 ,33.33
01,000,01,003,0100,280 ,949,7,956,1449,0,3,1,3,0,1,0,76.14,65.98 ,33.33
01,000,01,003,0100,281 ,1043,8,1051,1613,0,3,1,3,0,1,0,76.14,65.16 ,33.33
01,000,01,003,0101,282 ,1064,5,1069,1727,0,3,1,3,0,1,0,76.14,61.90 ,33.33
01,000,01,003,0101,283 ,1052,12,1064,1718,0,3,1,3,0,1,0,76.14,61.93 ,33.33
01,000,01,003,0101,284 ,1123,9,1132,1739,0,3,1,3,0,1,0,76.14,65.09 ,33.33
01,000,01,003,0101,285 ,986,9,995,1623,0,3,1,3,0,1,0,76.14,61.31 ,33.33
01,000,01,003,0101,286 ,1038,6,1044,1634,0,3,1,3,0,1,0,76.14,63.89 ,33.33
01,000,01,003,0102,287 ,925,5,930,1434,0,3,1,3,0,1,0,76.14,64.85 ,33.33
01,000,01,003,0102,288 ,952,9,961,1512,0,3,1,3,0,1,0,76.14,63.56 ,33.33
01,000,01,003,0102,289 ,948,10,958,1451,0,3,1,3,0,1,0,76.14,66.02 ,33.33
01,000,01,003,0103,290 ,1067,10,1077,1606,0,3,1,3,0,1,0,76.14,67.06 ,33.33
01,000,01,003,0103,291 ,1008,6,1014,1529,0,3,1,3,0,1,0,76.14,66.32 ,33.33
01,000,01,003,0103,292 ,1070,16,1086,1628,0,3,1,3,0,1,0,76.14,66.71 ,33.33
01,000,01,003,0104,293 ,263,2,265,402,0,3,1,3,0,1,0,76.14,65.92 ,33.33
01,000,01,003,0104,294 ,1104,23,1127,1744,0,3,1,3,0,1,0,76.14,64.62 ,33.33
01,000,01,003,0104,295 ,1026,10,1036,1550,0,3,1,3,0,1,0,76.14,66.84 ,33.33
01,000,01,003,0104,296 ,899,12,911,1451,0,3,1,3,0,1,0,76.14,62.78 ,33.33
01,000,01,003,0105,297 ,991,14,1005,1516,0,3,1,3,0,1,0,76.14,66.29 ,33.33
01,000,01,003,0105,298 ,898,9,907,1394,0,3,1,3,0,1,0,76.14,65.06 ,33.33
01,000,01,003,0105,299 ,1024,17,1041,1462,0,3,1,3,0,1,0,76.14,71.20 ,33.33
01,000,01,003,0106,300 ,976,11,987,1556,0,3,1,3,0,1,0,76.14,63.43 ,33.33
01,000,01,003,0106,301 ,1009,7,1016,1627,0,3,1,3,0,1,0,76.14,62.45 ,33.33
01,000,01,003,0106,302 ,903,5,908,1533,0,3,1,3,0,1,0,76.14,59.23 ,33.33
01,000,01,003,0107,303 ,1206,9,1215,1908,0,3,1,3,0,1,0,76.14,63.68 ,33.33
01,000,01,003,0107,304 ,1222,7,1229,1949,0,3,1,3,0,1,0,76.14,63.06 ,33.33
01,000,01,003,0107,305 ,1195,10,1205,1824,0,3,1,3,0,1,0,76.14,66.06 ,33.33
01,000,01,003,0107,306 ,1185,10,1195,1849,0,3,1,3,0,1,0,76.14,64.63 ,33.33
01,000,01,003,0107,307 ,1163,4,1167,1861,0,3,1,3,0,1,0,76.14,62.71 ,33.33
01,000,01,003,0107,308 ,1156,8,1164,1820,0,3,1,3,0,1,0,76.14,63.96 ,33.33
01,000,01,003,0107,309 ,1160,14,1174,1797,0,3,1,3,0,1,0,76.14,65.33 ,33.33
01,000,01,003,0107,310 ,1061,6,1067,1750,0,3,1,3,0,1,0,76.14,60.97 ,33.33
01,000,01,003,0107,311 ,1160,15,1175,1890,0,3,1,3,0,1,0,76.14,62.17 ,33.33
01,000,01,003,0107,312 ,1176,11,1187,1794,0,3,1,3,0,1,0,76.14,66.16 ,33.33
01,000,01,003,0107,313 ,392,8,400,696,0,3,1,3,0,1,0,76.14,57.47 ,33.33
01,000,01,003,0108,314 ,1068,9,1077,1716,0,3,1,3,0,1,0,76.14,62.76 ,33.33
01,000,01,003,0108,315 ,1206,10,1216,1825,0,3,1,3,0,1,0,76.14,66.63 ,33.33
01,000,01,003,0108,316 ,1155,5,1160,1797,0,3,1,3,0,1,0,76.14,64.55 ,33.33
01,000,01,003,0109,317 ,1199,12,1211,1773,0,3,1,3,0,1,0,76.14,68.30 ,33.33
01,000,01,003,0109,318 ,1065,7,1072,1584,0,3,1,3,0,1,0,76.14,67.68 ,33.33
01,000,01,003,0109,319 ,1018,10,1028,1451,0,3,1,3,0,1,0,76.14,70.85 ,33.33
01,000,01,003,0109,320 ,1078,9,1087,1480,0,3,1,3,0,1,0,76.14,73.45 ,33.33
01,000,01,003,0110,321 ,1204,7,1211,1852,0,3,1,3,0,1,0,76.14,65.39 ,33.33
01,000,01,003,0110,322 ,1273,7,1280,1803,0,3,1,3,0,1,0,76.14,70.99 ,33.33
01,000,01,003,0111,323 ,1011,10,1021,1688,0,3,1,3,0,1,0,76.14,60.49 ,33.33
01,000,01,003,0111,324 ,975,7,982,1617,0,3,1,3,0,1,0,76.14,60.73 ,33.33
01,000,01,003,0111,325 ,954,16,970,1654,0,3,1,3,0,1,0,76.14,58.65 ,33.33
01,000,01,003,0111,326 ,993,18,1011,1659,0,3,1,3,0,1,0,76.14,60.94 ,33.33
01,000,01,003,0112,327 ,1112,12,1124,1796,0,3,1,3,0,1,0,76.14,62.58 ,33.33
01,000,01,003,0112,328 ,1114,11,1125,1725,0,3,1,3,0,1,0,76.14,65.22 ,33.33
01,000,01,003,0112,329 ,1123,15,1138,1792,0,3,1,3,0,1,0,76.14,63.50 ,33.33
01,000,01,003,0112,330 ,958,14,972,1631,0,3,1,3,0,1,0,76.14,59.60 ,33.33
01,000,01,003,0112,331 ,1161,12,1173,1868,0,3,1,3,0,1,0,76.14,62.79 ,33.33
01,000,01,003,0112,332 ,1063,17,1080,1732,0,3,1,3,0,1,0,76.14,62.36 ,33.33
01,000,01,003,0113,333 ,1101,13,1114,1816,0,3,1,3,0,1,0,76.14,61.34 ,33.33
01,000,01,003,0113,334 ,1113,10,1123,1830,0,3,1,3,0,1,0,76.14,61.37 ,33.33
01,000,01,003,0113,335 ,1065,14,1079,1768,0,3,1,3,0,1,0,76.14,61.03 ,33.33
01,000,01,003,0114,336 ,502,7,509,767,0,3,1,3,0,1,0,76.14,66.36 ,33.33
01,000,01,003,0114,337 ,773,4,777,1241,0,3,1,3,0,1,0,76.14,62.61 ,33.33
01,000,01,003,0114,338 ,649,7,656,1044,0,3,1,3,0,1,0,76.14,62.84 ,33.33
01,000,01,003,0114,339 ,1010,15,1025,1641,0,3,1,3,0,1,0,76.14,62.46 ,33.33
01,000,01,003,0114,340 ,1138,14,1152,1788,0,3,1,3,0,1,0,76.14,64.43 ,33.33
01,000,01,003,0115,341 ,854,5,859,1314,0,3,1,3,0,1,0,76.14,65.37 ,33.33
01,000,01,003,0115,342 ,741,8,749,1192,0,3,1,3,0,1,0,76.14,62.84 ,33.33
01,000,01,003,0115,343 ,756,16,772,1150,0,3,1,3,0,1,0,76.14,67.13 ,33.33
01,000,01,003,0116,344 ,802,15,817,1206,0,3,1,3,0,1,0,76.14,67.74 ,33.33
01,000,01,003,0116,345 ,710,13,723,1049,0,3,1,3,0,1,0,76.14,68.92 ,33.33
01,000,01,003,0116,346 ,800,7,807,1276,0,3,1,3,0,1,0,76.14,63.24 ,33.33
01,000,01,003,0116,347 ,800,6,806,1306,0,3,1,3,0,1,0,76.14,61.72 ,33.33
01,000,01,003,0117,348 ,647,7,654,1016,0,3,1,3,0,1,0,76.14,64.37 ,33.33
01,000,01,003,0117,349 ,620,9,629,1020,0,3,1,3,0,1,0,76.14,61.67 ,33.33
01,000,01,003,0118,350 ,885,5,890,1395,0,3,1,3,0,1,0,76.14,63.80 ,33.33
01,000,01,003,0118,351 ,865,13,878,1645,0,3,1,3,0,1,0,76.14,53.37 ,33.33
01,000,01,003,0118,352 ,1019,10,1029,1709,0,3,1,3,0,1,0,76.14,60.21 ,33.33
01,000,01,003,0118,353 ,986,11,997,1569,0,3,1,3,0,1,0,76.14,63.54 ,33.33
01,000,01,003,0119,354 ,1195,11,1206,1850,0,3,1,3,0,1,0,76.14,65.19 ,33.33
01,000,01,003,0119,355 ,1150,7,1157,1829,0,3,1,3,0,1,0,76.14,63.26 ,33.33
01,000,01,004,0120,356 ,1350,17,1367,2104,0,3,1,3,0,1,0,76.14,64.97 ,33.33
01,000,01,004,0120,357 ,1236,18,1254,1900,0,3,1,3,0,1,0,76.14,66.00 ,33.33
01,000,01,004,0121,358 ,1188,19,1207,1883,0,3,1,3,0,1,0,76.14,64.10 ,33.33
01,000,01,004,0121,359 ,1214,19,1233,1882,0,3,1,3,0,1,0,76.14,65.52 ,33.33
01,000,01,004,0122,360 ,880,14,894,1355,0,3,1,3,0,1,0,76.14,65.98 ,33.33
01,000,01,004,0122,361 ,1014,11,1025,1542,0,3,1,3,0,1,0,76.14,66.47 ,33.33
01,000,01,004,0122,362 ,832,14,846,1350,0,3,1,3,0,1,0,76.14,62.67 ,33.33
01,000,01,004,0122,363 ,1082,15,1097,1667,0,3,1,3,0,1,0,76.14,65.81 ,33.33
01,000,01,004,0122,364 ,1319,21,1340,2170,0,3,1,3,0,1,0,76.14,61.75 ,33.33
01,000,01,004,0122,365 ,1120,16,1136,1805,0,3,1,3,0,1,0,76.14,62.94 ,33.33
01,000,01,004,0123,366 ,1232,11,1243,1749,0,3,1,3,0,1,0,76.14,71.07 ,33.33
01,000,01,004,0123,367 ,1056,11,1067,1588,0,3,1,3,0,1,0,76.14,67.19 ,33.33
01,000,01,004,0124,368 ,1014,10,1024,1459,0,3,1,3,0,1,0,76.14,70.19 ,33.33
01,000,01,004,0124,369 ,934,8,942,1411,0,3,1,3,0,1,0,76.14,66.76 ,33.33
01,000,01,004,0124,370 ,867,7,874,1344,0,3,1,3,0,1,0,76.14,65.03 ,33.33
01,000,01,004,0125,371 ,1145,12,1157,1669,0,3,1,3,0,1,0,76.14,69.32 ,33.33
01,000,01,004,0125,372 ,1079,5,1084,1671,0,3,1,3,0,1,0,76.14,64.87 ,33.33
01,000,01,004,0126,373 ,953,10,963,1494,0,3,1,3,0,1,0,76.14,64.46 ,33.33
01,000,01,004,0126,374 ,873,14,887,1369,0,3,1,3,0,1,0,76.14,64.79 ,33.33
01,000,01,004,0126,375 ,731,7,738,1076,0,3,1,3,0,1,0,76.14,68.59 ,33.33
01,000,01,004,0126,376 ,727,16,743,1083,0,3,1,3,0,1,0,76.14,68.61 ,33.33
01,000,01,004,0127,377 ,1146,9,1155,1911,0,3,1,3,0,1,0,76.14,60.44 ,33.33
01,000,01,004,0127,378 ,1190,15,1205,1757,0,3,1,3,0,1,0,76.14,68.58 ,33.33
01,000,01,004,0128,379 ,1016,16,1032,1741,0,3,1,3,0,1,0,76.14,59.28 ,33.33
01,000,01,004,0128,380 ,1150,9,1159,1783,0,3,1,3,0,1,0,76.14,65.00 ,33.33
01,000,01,004,0129,381 ,1034,15,1049,1746,0,3,1,3,0,1,0,76.14,60.08 ,33.33
01,000,01,004,0129,382 ,919,16,935,1580,0,3,1,3,0,1,0,76.14,59.18 ,33.33
01,000,01,004,0129,383 ,1270,13,1283,1955,0,3,1,3,0,1,0,76.14,65.63 ,33.33
01,000,01,004,0130,384 ,1225,10,1235,1951,0,3,1,3,0,1,0,76.14,63.30 ,33.33
01,000,01,004,0130,385 ,973,17,990,1609,0,3,1,3,0,1,0,76.14,61.53 ,33.33
01,000,01,004,0131,386 ,944,13,957,1580,0,3,1,3,0,1,0,76.14,60.57 ,33.33
01,000,01,004,0131,387 ,903,10,913,1387,0,3,1,3,0,1,0,76.14,65.83 ,33.33
01,000,01,004,0131,388 ,910,10,920,1523,0,3,1,3,0,1,0,76.14,60.41 ,33.33
01,000,01,004,0132,389 ,669,9,678,1054,0,3,1,3,0,1,0,76.14,64.33 ,33.33
01,000,01,004,0132,390 ,911,12,923,1530,0,3,1,3,0,1,0,76.14,60.33 ,33.33
01,000,01,004,0133,391 ,948,19,967,1664,0,3,1,3,0,1,0,76.14,58.11 ,33.33
01,000,01,004,0133,392 ,996,24,1020,1591,0,3,1,3,0,1,0,76.14,64.11 ,33.33
01,000,01,004,0134,393 ,1110,10,1120,1742,0,3,1,3,0,1,0,76.14,64.29 ,33.33
01,000,01,004,0134,394 ,921,17,938,1458,0,3,1,3,0,1,0,76.14,64.33 ,33.33
01,000,01,004,0135,395 ,867,10,877,1343,0,3,1,3,0,1,0,76.14,65.30 ,33.33
01,000,01,004,0135,396 ,1053,3,1056,1583,0,3,1,3,0,1,0,76.14,66.71 ,33.33
01,000,01,004,0135,397 ,965,1,966,1442,0,3,1,3,0,1,0,76.14,66.99 ,33.33
01,000,01,004,0135,398 ,1028,12,1040,1507,0,3,1,3,0,1,0,76.14,69.01 ,33.33
01,000,01,004,0135,399 ,853,7,860,1302,0,3,1,3,0,1,0,76.14,66.05 ,33.33
01,000,01,004,0136,400 ,709,6,715,1090,0,3,1,3,0,1,0,76.14,65.60 ,33.33
01,000,01,004,0136,401 ,736,10,746,1250,0,3,1,3,0,1,0,76.14,59.68 ,33.33
01,000,01,004,0136,402 ,782,8,790,1277,0,3,1,3,0,1,0,76.14,61.86 ,33.33
01,000,01,004,0136,403 ,854,8,862,1375,0,3,1,3,0,1,0,76.14,62.69 ,33.33
01,000,01,004,0136,404 ,792,15,807,1418,0,3,1,3,0,1,0,76.14,56.91 ,33.33
01,000,01,004,0137,405 ,948,16,964,1440,0,3,1,3,0,1,0,76.14,66.94 ,33.33
01,000,01,004,0137,406 ,959,6,965,1431,0,3,1,3,0,1,0,76.14,67.44 ,33.33
01,000,01,004,0137,407 ,964,19,983,1575,0,3,1,3,0,1,0,76.14,62.41 ,33.33
01,000,01,005,0138,408 ,952,9,961,1512,0,3,1,3,0,1,0,76.14,63.56 ,33.33
01,000,01,005,0138,409 ,1084,7,1091,1602,0,3,1,3,0,1,0,76.14,68.10 ,33.33
01,000,01,005,0138,410 ,1003,7,1010,1591,0,3,1,3,0,1,0,76.14,63.48 ,33.33
01,000,01,005,0139,411 ,1116,5,1121,1683,0,3,1,3,0,1,0,76.14,66.61 ,33.33
01,000,01,005,0139,412 ,1016,13,1029,1687,0,3,1,3,0,1,0,76.14,61.00 ,33.33
01,000,01,005,0139,413 ,1073,10,1083,1625,0,3,1,3,0,1,0,76.14,66.65 ,33.33
01,000,01,005,0139,414 ,1143,6,1149,1794,0,3,1,3,0,1,0,76.14,64.05 ,33.33
01,000,01,005,0140,415 ,1203,9,1212,1842,0,3,1,3,0,1,0,76.14,65.80 ,33.33
01,000,01,005,0140,416 ,1160,9,1169,1956,0,3,1,3,0,1,0,76.14,59.76 ,33.33
01,000,01,005,0140,417 ,1200,8,1208,1843,0,3,1,3,0,1,0,76.14,65.55 ,33.33
01,000,01,005,0141,418 ,1253,9,1262,1902,0,3,1,3,0,1,0,76.14,66.35 ,33.33
01,000,01,005,0141,419 ,1096,10,1106,1773,0,3,1,3,0,1,0,76.14,62.38 ,33.33
01,000,01,005,0142,420 ,914,6,920,1502,0,3,1,3,0,1,0,76.14,61.25 ,33.33
01,000,01,005,0142,421 ,703,7,710,1059,0,3,1,3,0,1,0,76.14,67.04 ,33.33
01,000,01,005,0142,422 ,1116,12,1128,1669,0,3,1,3,0,1,0,76.14,67.59 ,33.33
01,000,01,005,0143,423 ,1314,10,1324,2025,0,3,1,3,0,1,0,76.14,65.38 ,33.33
01,000,01,005,0143,424 ,1262,13,1275,2065,0,3,1,3,0,1,0,76.14,61.74 ,33.33
01,000,01,005,0144,425 ,1094,4,1098,1768,0,3,1,3,0,1,0,76.14,62.10 ,33.33
01,000,01,005,0144,426 ,1244,5,1249,1979,0,3,1,3,0,1,0,76.14,63.11 ,33.33
01,000,01,005,0145,427 ,1118,9,1127,1749,0,3,1,3,0,1,0,76.14,64.44 ,33.33
01,000,01,005,0145,428 ,1181,11,1192,1888,0,3,1,3,0,1,0,76.14,63.14 ,33.33
01,000,01,005,0146,429 ,1153,8,1161,1772,0,3,1,3,0,1,0,76.14,65.52 ,33.33
01,000,01,005,0146,430 ,1088,6,1094,1789,0,3,1,3,0,1,0,76.14,61.15 ,33.33
01,000,01,005,0147,431 ,1243,10,1253,2030,0,3,1,3,0,1,0,76.14,61.72 ,33.33
01,000,01,005,0147,432 ,1256,10,1266,2024,0,3,1,3,0,1,0,76.14,62.55 ,33.33
01,000,01,005,0147,433 ,1310,8,1318,2005,0,3,1,3,0,1,0,76.14,65.74 ,33.33
01,000,01,005,0148,434 ,649,3,652,1026,0,3,1,3,0,1,0,76.14,63.55 ,33.33
01,000,01,005,0148,435 ,1050,9,1059,1574,0,3,1,3,0,1,0,76.14,67.28 ,33.33
01,000,01,005,0148,436 ,1426,11,1437,2095,0,3,1,3,0,1,0,76.14,68.59 ,33.33
01,000,01,005,0149,437 ,1174,13,1187,1854,0,3,1,3,0,1,0,76.14,64.02 ,33.33
01,000,01,005,0149,438 ,1194,4,1198,1865,0,3,1,3,0,1,0,76.14,64.24 ,33.33
01,000,01,005,0150,439 ,867,9,876,1340,0,3,1,3,0,1,0,76.14,65.37 ,33.33
01,000,01,005,0150,440 ,776,4,780,1202,0,3,1,3,0,1,0,76.14,64.89 ,33.33
01,000,01,005,0151,441 ,1360,2,1362,2007,0,3,1,3,0,1,0,76.14,67.86 ,33.33
01,000,01,005,0151,442 ,1219,8,1227,1886,0,3,1,3,0,1,0,76.14,65.06 ,33.33
01,000,01,005,0152,443 ,1037,5,1042,1653,0,3,1,3,0,1,0,76.14,63.04 ,33.33
01,000,01,005,0152,444 ,1127,11,1138,1822,0,3,1,3,0,1,0,76.14,62.46 ,33.33
01,000,01,005,0152,445 ,1104,6,1110,1777,0,3,1,3,0,1,0,76.14,62.46 ,33.33
01,000,01,005,0152,446 ,1051,3,1054,1757,0,3,1,3,0,1,0,76.14,59.99 ,33.33
01,000,01,005,0153,447 ,1208,7,1215,1809,0,3,1,3,0,1,0,76.14,67.16 ,33.33
01,000,01,005,0153,448 ,1255,15,1270,1883,0,3,1,3,0,1,0,76.14,67.45 ,33.33
01,000,01,005,0153,449 ,1014,5,1019,1618,0,3,1,3,0,1,0,76.14,62.98 ,33.33
01,000,01,005,0154,450 ,976,9,985,1564,0,3,1,3,0,1,0,76.14,62.98 ,33.33
01,000,01,005,0154,451 ,905,7,912,1477,0,3,1,3,0,1,0,76.14,61.75 ,33.33
01,000,01,005,0155,452 ,1272,10,1282,1996,0,3,1,3,0,1,0,76.14,64.23 ,33.33
01,000,01,005,0155,453 ,1012,10,1022,1973,0,3,1,3,0,1,0,76.14,51.80 ,33.33
01,000,01,005,0155,454 ,679,7,686,1118,0,3,1,3,0,1,0,76.14,61.36 ,33.33
01,000,01,005,0156,455 ,1149,13,1162,1742,0,3,1,3,0,1,0,76.14,66.70 ,33.33
01,000,01,005,0156,456 ,1113,4,1117,1637,0,3,1,3,0,1,0,76.14,68.23 ,33.33
01,000,01,005,0156,457 ,1171,15,1186,1811,0,3,1,3,0,1,0,76.14,65.49 ,33.33
01,000,01,005,0156,458 ,1096,11,1107,1686,0,3,1,3,0,1,0,76.14,65.66 ,33.33
01,000,01,005,0157,459 ,1710,9,1719,2611,0,3,1,3,0,1,0,76.14,65.84 ,33.33
01,000,01,005,0157,460 ,1328,11,1339,1995,0,3,1,3,0,1,0,76.14,67.12 ,33.33
01,000,01,005,0158,461 ,1147,11,1158,1805,0,3,1,3,0,1,0,76.14,64.16 ,33.33
01,000,01,005,0158,462 ,1402,17,1419,2019,0,3,1,3,0,1,0,76.14,70.28 ,33.33
01,000,01,005,0158,463 ,1234,9,1243,1808,0,3,1,3,0,1,0,76.14,68.75 ,33.33
01,000,01,005,0159,464 ,1295,11,1306,2164,0,3,1,3,0,1,0,76.14,60.35 ,33.33
01,000,01,005,0159,465 ,1379,9,1388,2191,0,3,1,3,0,1,0,76.14,63.35 ,33.33
01,000,01,005,0159,466 ,1236,14,1250,1950,0,3,1,3,0,1,0,76.14,64.10 ,33.33
01,000,01,005,0160,467 ,1212,14,1226,1982,0,3,1,3,0,1,0,76.14,61.86 ,33.33
01,000,01,005,0160,468 ,1213,29,1242,1956,0,3,1,3,0,1,0,76.14,63.50 ,33.33
01,000,01,005,0160,469 ,1185,6,1191,1863,0,3,1,3,0,1,0,76.14,63.93 ,33.33
01,000,01,005,0161,470 ,1323,10,1333,2031,0,3,1,3,0,1,0,76.14,65.63 ,33.33
01,000,01,005,0161,471 ,1162,14,1176,1860,0,3,1,3,0,1,0,76.14,63.23 ,33.33
01,000,01,005,0161,472 ,763,4,767,1198,0,3,1,3,0,1,0,76.14,64.02 ,33.33
01,000,01,005,0162,473 ,1233,11,1244,1988,0,3,1,3,0,1,0,76.14,62.58 ,33.33
01,000,01,005,0162,474 ,1184,13,1197,2005,0,3,1,3,0,1,0,76.14,59.70 ,33.33
01,000,01,005,0162,475 ,1258,7,1265,2166,0,3,1,3,0,1,0,76.14,58.40 ,33.33
01,000,01,005,0163,476 ,970,3,973,1626,0,3,1,3,0,1,0,76.14,59.84 ,33.33
01,000,01,005,0163,477 ,941,5,946,1461,0,3,1,3,0,1,0,76.14,64.75 ,33.33
01,000,01,005,0164,478 ,880,2,882,1397,0,3,1,3,0,1,0,76.14,63.14 ,33.33
01,000,01,005,0164,479 ,771,4,775,1186,0,3,1,3,0,1,0,76.14,65.35 ,33.33
01,000,01,005,0165,480 ,946,7,953,1529,0,3,1,3,0,1,0,76.14,62.33 ,33.33
01,000,01,005,0165,481 ,984,5,989,1512,0,3,1,3,0,1,0,76.14,65.41 ,33.33
01,000,01,005,0166,482 ,1242,6,1248,1877,0,3,1,3,0,1,0,76.14,66.49 ,33.33
01,000,01,005,0166,483 ,1140,10,1150,1827,0,3,1,3,0,1,0,76.14,62.94 ,33.33
01,000,01,005,0166,484 ,1150,15,1165,1775,0,3,1,3,0,1,0,76.14,65.63 ,33.33
01,000,01,005,0167,485 ,695,4,699,1066,0,3,1,3,0,1,0,76.14,65.57 ,33.33
01,000,01,005,0167,486 ,880,12,892,1417,0,3,1,3,0,1,0,76.14,62.95 ,33.33
01,000,01,005,0168,487 ,926,7,933,1420,0,3,1,3,0,1,0,76.14,65.70 ,33.33
01,000,01,005,0168,488 ,975,10,985,1534,0,3,1,3,0,1,0,76.14,64.21 ,33.33
01,000,01,005,0169,489 ,957,20,977,1536,0,3,1,3,0,1,0,76.14,63.61 ,33.33
01,000,01,005,0169,490 ,1111,12,1123,1713,0,3,1,3,0,1,0,76.14,65.56 ,33.33
01,000,01,005,0169,491 ,903,8,911,1519,0,3,1,3,0,1,0,76.14,59.97 ,33.33
01,000,01,005,0170,492 ,1320,6,1326,2138,0,3,1,3,0,1,0,76.14,62.02 ,33.33
01,000,01,006,0171,493 ,1303,11,1314,2101,0,3,1,3,0,1,0,76.14,62.54 ,33.33
01,000,01,006,0171,494 ,1326,7,1333,1977,0,3,1,3,0,1,0,76.14,67.43 ,33.33
01,000,01,006,0172,495 ,1341,10,1351,2054,0,3,1,3,0,1,0,76.14,65.77 ,33.33
01,000,01,006,0172,496 ,1198,10,1208,1893,0,3,1,3,0,1,0,76.14,63.81 ,33.33
01,000,01,006,0173,497 ,722,9,731,1182,0,3,1,3,0,1,0,76.14,61.84 ,33.33
01,000,01,006,0173,498 ,818,12,830,1394,0,3,1,3,0,1,0,76.14,59.54 ,33.33
01,000,01,006,0174,499 ,737,13,750,1252,0,3,1,3,0,1,0,76.14,59.90 ,33.33
01,000,01,006,0174,500 ,624,3,627,1049,0,3,1,3,0,1,0,76.14,59.77 ,33.33
01,000,01,006,0175,501 ,987,6,993,1648,0,3,1,3,0,1,0,76.14,60.25 ,33.33
01,000,01,006,0175,502 ,1010,7,1017,1696,0,3,1,3,0,1,0,76.14,59.96 ,33.33
01,000,01,006,0176,503 ,1043,9,1052,1745,0,3,1,3,0,1,0,76.14,60.29 ,33.33
01,000,01,006,0176,504 ,1056,16,1072,1596,0,3,1,3,0,1,0,76.14,67.17 ,33.33
01,000,01,006,0176,505 ,982,11,993,1534,0,3,1,3,0,1,0,76.14,64.73 ,33.33
01,000,01,006,0177,506 ,1200,11,1211,1943,0,3,1,3,0,1,0,76.14,62.33 ,33.33
01,000,01,006,0177,507 ,1127,9,1136,1856,0,3,1,3,0,1,0,76.14,61.21 ,33.33
01,000,01,006,0178,508 ,1044,9,1053,1671,0,3,1,3,0,1,0,76.14,63.02 ,33.33
01,000,01,006,0178,509 ,1055,10,1065,1698,0,3,1,3,0,1,0,76.14,62.72 ,33.33
01,000,01,006,0178,510 ,989,7,996,1626,0,3,1,3,0,1,0,76.14,61.25 ,33.33
01,000,01,006,0179,511 ,1557,8,1565,2388,0,3,1,3,0,1,0,76.14,65.54 ,33.33
01,000,01,006,0179,512 ,1278,7,1285,1961,0,3,1,3,0,1,0,76.14,65.53 ,33.33
01,000,01,006,0179,513 ,1341,13,1354,2211,0,3,1,3,0,1,0,76.14,61.24 ,33.33
01,000,01,006,0180,514 ,879,9,888,1430,0,3,1,3,0,1,0,76.14,62.10 ,33.33
01,000,01,006,0180,515 ,927,11,938,1456,0,3,1,3,0,1,0,76.14,64.42 ,33.33
01,000,01,006,0181,516 ,1188,12,1200,1933,0,3,1,3,0,1,0,76.14,62.08 ,33.33
01,000,01,006,0181,517 ,1147,8,1155,1836,0,3,1,3,0,1,0,76.14,62.91 ,33.33
01,000,01,006,0182,518 ,951,14,965,1529,0,3,1,3,0,1,0,76.14,63.11 ,33.33
01,000,01,006,0182,519 ,958,8,966,1584,0,3,1,3,0,1,0,76.14,60.98 ,33.33
01,000,01,006,0183,520 ,1304,12,1316,2037,0,3,1,3,0,1,0,76.14,64.60 ,33.33
01,000,01,006,0183,521 ,1444,7,1451,2215,0,3,1,3,0,1,0,76.14,65.51 ,33.33
01,000,01,006,0184,522 ,941,7,948,1629,0,3,1,3,0,1,0,76.14,58.20 ,33.33
01,000,01,006,0184,523 ,1302,19,1321,2131,0,3,1,3,0,1,0,76.14,61.99 ,33.33
01,000,01,006,0185,524 ,1151,11,1162,1786,0,3,1,3,0,1,0,76.14,65.06 ,33.33
01,000,01,006,0185,525 ,1169,16,1185,1819,0,3,1,3,0,1,0,76.14,65.15 ,33.33
01,000,01,006,0186,526 ,1480,17,1497,2232,0,3,1,3,0,1,0,76.14,67.07 ,33.33
01,000,01,006,0186,527 ,1539,17,1556,2334,0,3,1,3,0,1,0,76.14,66.67 ,33.33
01,000,01,006,0187,528 ,1493,10,1503,2363,0,3,1,3,0,1,0,76.14,63.61 ,33.33
01,000,01,006,0187,529 ,1362,11,1373,2240,0,3,1,3,0,1,0,76.14,61.29 ,33.33
01,000,01,006,0188,530 ,1414,14,1428,2256,0,3,1,3,0,1,0,76.14,63.30 ,33.33
01,000,01,006,0188,531 ,1345,12,1357,2176,0,3,1,3,0,1,0,76.14,62.36 ,33.33
01,000,01,006,0189,532 ,858,8,866,1342,0,3,1,3,0,1,0,76.14,64.53 ,33.33
01,000,01,006,0189,533 ,1137,8,1145,1732,0,3,1,3,0,1,0,76.14,66.11 ,33.33
01,000,01,006,0190,534 ,1181,18,1199,1879,0,3,1,3,0,1,0,76.14,63.81 ,33.33
01,000,01,006,0190,535 ,1136,6,1142,1711,0,3,1,3,0,1,0,76.14,66.74 ,33.33
01,000,01,006,0190,536 ,1181,7,1188,1799,0,3,1,3,0,1,0,76.14,66.04 ,33.33
01,000,01,006,0191,537 ,754,5,759,1234,0,3,1,3,0,1,0,76.14,61.51 ,33.33
01,000,01,006,0191,538 ,661,14,675,1095,0,3,1,3,0,1,0,76.14,61.64 ,33.33
01,000,01,006,0192,539 ,1181,22,1203,1977,0,3,1,3,0,1,0,76.14,60.85 ,33.33
01,000,01,006,0192,540 ,1010,8,1018,1628,0,3,1,3,0,1,0,76.14,62.53 ,33.33
01,000,01,006,0192,541 ,967,8,975,1573,0,3,1,3,0,1,0,76.14,61.98 ,33.33
01,000,01,006,0193,542 ,941,12,953,1484,0,3,1,3,0,1,0,76.14,64.22 ,33.33
01,000,01,006,0193,543 ,1048,9,1057,1569,0,3,1,3,0,1,0,76.14,67.37 ,33.33
01,000,01,006,0193,544 ,1010,9,1019,1498,0,3,1,3,0,1,0,76.14,68.02 ,33.33
01,000,01,006,0194,545 ,1219,17,1236,1862,0,3,1,3,0,1,0,76.14,66.38 ,33.33
01,000,01,006,0194,546 ,1243,18,1261,1964,0,3,1,3,0,1,0,76.14,64.21 ,33.33
01,000,01,006,0195,547 ,1373,14,1387,2214,0,3,1,3,0,1,0,76.14,62.65 ,33.33
01,000,01,006,0195,548 ,1280,13,1293,2060,0,3,1,3,0,1,0,76.14,62.77 ,33.33
01,000,01,006,0195,549 ,1462,15,1477,2210,0,3,1,3,0,1,0,76.14,66.83 ,33.33
01,000,01,006,0196,550 ,1157,13,1170,1830,0,3,1,3,0,1,0,76.14,63.93 ,33.33
01,000,01,006,0196,551 ,1107,9,1116,1712,0,3,1,3,0,1,0,76.14,65.19 ,33.33
01,000,01,006,0196,552 ,1064,7,1071,1671,0,3,1,3,0,1,0,76.14,64.09 ,33.33
01,000,01,006,0197,553 ,995,11,1006,1493,0,3,1,3,0,1,0,76.14,67.38 ,33.33
01,000,01,006,0197,554 ,1048,27,1075,1727,0,3,1,3,0,1,0,76.14,62.25 ,33.33
01,000,01,006,0197,555 ,986,15,1001,1499,0,3,1,3,0,1,0,76.14,66.78 ,33.33
01,000,01,006,0198,556 ,1234,10,1244,1963,0,3,1,3,0,1,0,76.14,63.37 ,33.33
01,000,01,006,0198,557 ,1242,10,1252,1930,0,3,1,3,0,1,0,76.14,64.87 ,33.33
01,000,01,006,0199,558 ,1281,17,1298,2023,0,3,1,3,0,1,0,76.14,64.16 ,33.33
01,000,01,006,0199,559 ,1100,9,1109,1720,0,3,1,3,0,1,0,76.14,64.48 ,33.33
01,000,01,006,0199,560 ,1184,14,1198,1810,0,3,1,3,0,1,0,76.14,66.19 ,33.33
01,000,01,006,0200,561 ,1140,18,1158,1756,0,3,1,3,0,1,0,76.14,65.95 ,33.33
01,000,01,006,0200,562 ,1278,5,1283,1914,0,3,1,3,0,1,0,76.14,67.03 ,33.33
01,000,01,006,0200,563 ,1077,12,1089,1723,0,3,1,3,0,1,0,76.14,63.20 ,33.33
01,000,01,006,0200,564 ,1462,9,1471,2197,0,3,1,3,0,1,0,76.14,66.95 ,33.33
01,000,01,006,0201,565 ,1186,12,1198,1882,0,3,1,3,0,1,0,76.14,63.66 ,33.33
01,000,01,006,0201,566 ,1309,10,1319,2133,0,3,1,3,0,1,0,76.14,61.84 ,33.33
01,000,01,006,0202,567 ,1319,10,1329,2031,0,3,1,3,0,1,0,76.14,65.44 ,33.33
01,000,01,006,0202,568 ,1179,16,1195,2011,0,3,1,3,0,1,0,76.14,59.42 ,33.33
01,000,01,006,0202,569 ,767,2,769,1274,0,3,1,3,0,1,0,76.14,60.36 ,33.33
01,000,01,006,0203,570 ,1166,13,1179,1957,0,3,1,3,0,1,0,76.14,60.25 ,33.33
01,000,01,006,0203,571 ,1436,21,1457,2237,0,3,1,3,0,1,0,76.14,65.13 ,33.33
01,000,01,006,0203,572 ,1510,22,1532,2368,0,3,1,3,0,1,0,76.14,64.70 ,33.33
01,000,01,006,0204,573 ,796,5,801,1325,0,3,1,3,0,1,0,76.14,60.45 ,33.33
01,000,01,006,0204,574 ,809,7,816,1295,0,3,1,3,0,1,0,76.14,63.01 ,33.33
01,000,01,006,0204,575 ,894,8,902,1312,0,3,1,3,0,1,0,76.14,68.75 ,33.33
01,000,01,006,0205,576 ,1234,13,1247,1970,0,3,1,3,0,1,0,76.14,63.30 ,33.33
01,000,01,006,0205,577 ,1190,14,1204,1844,0,3,1,3,0,1,0,76.14,65.29 ,33.33
01,000,01,006,0206,578 ,1311,15,1326,2030,0,3,1,3,0,1,0,76.14,65.32 ,33.33
01,000,01,006,0206,579 ,1273,14,1287,1935,0,3,1,3,0,1,0,76.14,66.51 ,33.33
01,000,01,006,0206,580 ,998,7,1005,1526,0,3,1,3,0,1,0,76.14,65.86 ,33.33
01,000,01,006,0207,581 ,950,9,959,1446,0,3,1,3,0,1,0,76.14,66.32 ,33.33
01,000,01,006,0207,582 ,794,9,803,1293,0,3,1,3,0,1,0,76.14,62.10 ,33.33
01,000,01,006,0208,583 ,1078,14,1092,1766,0,3,1,3,0,1,0,76.14,61.83 ,33.33
01,000,01,006,0208,584 ,1124,13,1137,1727,0,3,1,3,0,1,0,76.14,65.84 ,33.33
01,000,01,006,0209,585 ,1351,23,1374,2068,0,3,1,3,0,1,0,76.14,66.44 ,33.33
01,000,01,006,0209,586 ,1111,8,1119,1671,0,3,1,3,0,1,0,76.14,66.97 ,33.33
01,000,01,006,0209,587 ,1190,13,1203,1871,0,3,1,3,0,1,0,76.14,64.30 ,33.33
01,000,01,006,0210,588 ,1220,13,1233,1930,0,3,1,3,0,1,0,76.14,63.89 ,33.33
01,000,01,006,0210,589 ,1310,10,1320,2023,0,3,1,3,0,1,0,76.14,65.25 ,33.33
01,000,01,006,0211,590 ,742,9,751,1149,0,3,1,3,0,1,0,76.14,65.36 ,33.33
01,000,01,006,0211,591 ,797,18,815,1147,0,3,1,3,0,1,0,76.14,71.05 ,33.33
01,000,02,007,0212,592 ,815,11,826,1393,0,3,1,3,0,1,0,76.14,59.30 ,33.33
01,000,02,007,0212,593 ,668,12,680,1012,0,3,1,3,0,1,0,76.14,67.19 ,33.33
01,000,02,007,0213,594 ,1028,15,1043,1930,0,3,1,3,0,1,0,76.14,54.04 ,33.33
01,000,02,007,0213,595 ,921,15,936,1657,0,3,1,3,0,1,0,76.14,56.49 ,33.33
01,000,02,007,0214,596 ,594,4,598,961,0,3,1,3,0,1,0,76.14,62.23 ,33.33
01,000,02,007,0214,597 ,897,9,906,1612,0,3,1,3,0,1,0,76.14,56.20 ,33.33
01,000,02,007,0215,598 ,1107,11,1118,1808,0,3,1,3,0,1,0,76.14,61.84 ,33.33
01,000,02,007,0215,599 ,629,12,641,1069,0,3,1,3,0,1,0,76.14,59.96 ,33.33
01,000,02,007,0215,600 ,690,12,702,1184,0,3,1,3,0,1,0,76.14,59.29 ,33.33
01,000,02,007,0216,601 ,956,12,968,1848,0,3,1,3,0,1,0,76.14,52.38 ,33.33
01,000,02,007,0217,602 ,822,16,838,1464,0,3,1,3,0,1,0,76.14,57.24 ,33.33
01,000,02,007,0217,603 ,825,11,836,1458,0,3,1,3,0,1,0,76.14,57.34 ,33.33
01,000,02,007,0217,604 ,776,4,780,1365,0,3,1,3,0,1,0,76.14,57.14 ,33.33
01,000,02,007,0218,605 ,754,15,769,1417,0,3,1,3,0,1,0,76.14,54.27 ,33.33
01,000,02,007,0218,606 ,738,3,741,1427,0,3,1,3,0,1,0,76.14,51.93 ,33.33
01,000,02,007,0219,607 ,854,10,864,1320,0,3,1,3,0,1,0,76.14,65.45 ,33.33
01,000,02,007,0219,608 ,1255,14,1269,1988,0,3,1,3,0,1,0,76.14,63.83 ,33.33
01,000,02,007,0219,609 ,766,9,775,1299,0,3,1,3,0,1,0,76.14,59.66 ,33.33
01,000,02,007,0220,610 ,809,17,826,1454,0,3,1,3,0,1,0,76.14,56.81 ,33.33
01,000,02,007,0220,611 ,928,13,941,1534,0,3,1,3,0,1,0,76.14,61.34 ,33.33
01,000,02,007,0221,612 ,797,16,813,1347,0,3,1,3,0,1,0,76.14,60.36 ,33.33
01,000,02,007,0221,613 ,678,11,689,1228,0,3,1,3,0,1,0,76.14,56.11 ,33.33
01,000,02,007,0222,614 ,805,8,813,1560,0,3,1,3,0,1,0,76.14,52.12 ,33.33
01,000,02,007,0222,615 ,918,12,930,1669,0,3,1,3,0,1,0,76.14,55.72 ,33.33
01,000,02,007,0223,616 ,1073,6,1079,1838,0,3,1,3,0,1,0,76.14,58.71 ,33.33
01,000,02,007,0223,617 ,711,12,723,1235,0,3,1,3,0,1,0,76.14,58.54 ,33.33
01,000,02,007,0224,618 ,807,13,820,1439,0,3,1,3,0,1,0,76.14,56.98 ,33.33
01,000,02,007,0224,619 ,824,2,826,1351,0,3,1,3,0,1,0,76.14,61.14 ,33.33
01,000,02,007,0224,620 ,694,7,701,1102,0,3,1,3,0,1,0,76.14,63.61 ,33.33
01,000,02,007,0225,621 ,1002,8,1010,1516,0,3,1,3,0,1,0,76.14,66.62 ,33.33
01,000,02,007,0225,622 ,1095,3,1098,1482,0,3,1,3,0,1,0,76.14,74.09 ,33.33
01,000,02,007,0226,623 ,1197,10,1207,1894,0,3,1,3,0,1,0,76.14,63.73 ,33.33
01,000,02,007,0226,624 ,1249,9,1258,1923,0,3,1,3,0,1,0,76.14,65.42 ,33.33
01,000,02,007,0226,625 ,1365,11,1376,1967,0,3,1,3,0,1,0,76.14,69.95 ,33.33
01,000,02,007,0226,626 ,1320,14,1334,2056,0,3,1,3,0,1,0,76.14,64.88 ,33.33
01,000,02,007,0227,627 ,998,6,1004,1400,0,3,1,3,0,1,0,76.14,71.71 ,33.33
01,000,02,007,0227,628 ,605,9,614,898,0,3,1,3,0,1,0,76.14,68.37 ,33.33
01,000,02,007,0227,629 ,748,4,752,1103,0,3,1,3,0,1,0,76.14,68.18 ,33.33
01,000,02,007,0227,630 ,768,5,773,1103,0,3,1,3,0,1,0,76.14,70.08 ,33.33
01,000,02,007,0227,631 ,1360,12,1372,2088,0,3,1,3,0,1,0,76.14,65.71 ,33.33
01,000,02,007,0228,632 ,1142,12,1154,1744,0,3,1,3,0,1,0,76.14,66.17 ,33.33
01,000,02,007,0228,633 ,896,10,906,1396,0,3,1,3,0,1,0,76.14,64.90 ,33.33
01,000,02,007,0228,634 ,843,9,852,1306,0,3,1,3,0,1,0,76.14,65.24 ,33.33
01,000,02,007,0228,635 ,1268,12,1280,1829,0,3,1,3,0,1,0,76.14,69.98 ,33.33
01,000,02,007,0229,636 ,583,3,586,913,0,3,1,3,0,1,0,76.14,64.18 ,33.33
01,000,02,007,0230,637 ,1252,14,1266,1898,0,3,1,3,0,1,0,76.14,66.70 ,33.33
01,000,02,007,0230,638 ,1270,14,1284,2075,0,3,1,3,0,1,0,76.14,61.88 ,33.33
01,000,02,007,0231,639 ,914,8,922,1439,0,3,1,3,0,1,0,76.14,64.07 ,33.33
01,000,02,007,0231,640 ,796,6,802,1303,0,3,1,3,0,1,0,76.14,61.55 ,33.33
01,000,02,007,0231,641 ,729,14,743,1267,0,3,1,3,0,1,0,76.14,58.64 ,33.33
01,000,02,007,0232,642 ,1130,7,1137,1714,0,3,1,3,0,1,0,76.14,66.34 ,33.33
01,000,02,007,0232,643 ,1010,6,1016,1562,0,3,1,3,0,1,0,76.14,65.04 ,33.33
01,000,02,007,0232,644 ,1080,17,1097,1749,0,3,1,3,0,1,0,76.14,62.72 ,33.33
01,000,02,007,0233,645 ,812,8,820,1300,0,3,1,3,0,1,0,76.14,63.08 ,33.33
01,000,02,007,0233,646 ,791,13,804,1303,0,3,1,3,0,1,0,76.14,61.70 ,33.33
01,000,02,007,0233,647 ,849,16,865,1334,0,3,1,3,0,1,0,76.14,64.84 ,33.33
01,000,02,007,0234,648 ,1188,13,1201,1999,0,3,1,3,0,1,0,76.14,60.08 ,33.33
01,000,02,007,0234,649 ,1504,17,1521,2455,0,3,1,3,0,1,0,76.14,61.96 ,33.33
01,000,02,007,0235,650 ,867,10,877,1893,0,3,1,3,0,1,0,76.14,46.33 ,33.33
01,000,02,007,0235,651 ,943,10,953,1464,0,3,1,3,0,1,0,76.14,65.10 ,33.33
01,000,02,007,0235,652 ,745,7,752,1241,0,3,1,3,0,1,0,76.14,60.60 ,33.33
01,000,02,007,0236,653 ,1013,9,1022,1623,0,3,1,3,0,1,0,76.14,62.97 ,33.33
01,000,02,007,0236,654 ,942,16,958,1602,0,3,1,3,0,1,0,76.14,59.80 ,33.33
01,000,02,007,0236,655 ,1016,16,1032,1686,0,3,1,3,0,1,0,76.14,61.21 ,33.33
01,000,02,007,0236,656 ,1053,17,1070,1707,0,3,1,3,0,1,0,76.14,62.68 ,33.33
01,000,02,007,0237,657 ,1143,17,1160,1768,0,3,1,3,0,1,0,76.14,65.61 ,33.33
01,000,02,007,0237,658 ,898,8,906,1485,0,3,1,3,0,1,0,76.14,61.01 ,33.33
01,000,02,007,0238,659 ,1171,5,1176,1864,0,3,1,3,0,1,0,76.14,63.09 ,33.33
01,000,02,007,0238,660 ,1238,14,1252,1977,0,3,1,3,0,1,0,76.14,63.33 ,33.33
01,000,02,007,0238,661 ,1160,11,1171,1920,0,3,1,3,0,1,0,76.14,60.99 ,33.33
01,000,02,007,0239,662 ,1047,11,1058,1680,0,3,1,3,0,1,0,76.14,62.98 ,33.33
01,000,02,007,0239,663 ,1057,9,1066,1680,0,3,1,3,0,1,0,76.14,63.45 ,33.33
01,000,02,007,0239,664 ,1149,5,1154,1946,0,3,1,3,0,1,0,76.14,59.30 ,33.33
01,000,02,007,0240,665 ,1270,10,1280,2019,0,3,1,3,0,1,0,76.14,63.40 ,33.33
01,000,02,007,0240,666 ,1202,9,1211,1901,0,3,1,3,0,1,0,76.14,63.70 ,33.33
01,000,02,007,0240,667 ,1350,17,1367,2140,0,3,1,3,0,1,0,76.14,63.88 ,33.33
01,000,02,007,0241,668 ,1360,15,1375,2183,0,3,1,3,0,1,0,76.14,62.99 ,33.33
01,000,02,007,0241,669 ,1235,10,1245,1983,0,3,1,3,0,1,0,76.14,62.78 ,33.33
01,000,02,007,0242,670 ,1165,11,1176,1872,0,3,1,3,0,1,0,76.14,62.82 ,33.33
01,000,02,007,0242,671 ,1141,14,1155,1904,0,3,1,3,0,1,0,76.14,60.66 ,33.33
01,000,02,007,0243,672 ,1071,12,1083,1778,0,3,1,3,0,1,0,76.14,60.91 ,33.33
01,000,02,007,0243,673 ,1470,7,1477,2349,0,3,1,3,0,1,0,76.14,62.88 ,33.33
01,000,02,007,0244,674 ,845,6,851,1358,0,3,1,3,0,1,0,76.14,62.67 ,33.33
01,000,02,007,0244,675 ,975,7,982,1477,0,3,1,3,0,1,0,76.14,66.49 ,33.33
01,000,02,007,0245,676 ,985,12,997,1641,0,3,1,3,0,1,0,76.14,60.76 ,33.33
01,000,02,007,0245,677 ,1041,11,1052,1636,0,3,1,3,0,1,0,76.14,64.30 ,33.33
01,000,02,007,0245,678 ,1010,12,1022,1652,0,3,1,3,0,1,0,76.14,61.86 ,33.33
01,000,02,007,0246,679 ,939,13,952,1413,0,3,1,3,0,1,0,76.14,67.37 ,33.33
01,000,02,007,0246,680 ,886,7,893,1297,0,3,1,3,0,1,0,76.14,68.85 ,33.33
01,000,02,007,0246,681 ,1121,6,1127,1539,0,3,1,3,0,1,0,76.14,73.23 ,33.33
01,000,02,007,0247,682 ,1054,13,1067,1679,0,3,1,3,0,1,0,76.14,63.55 ,33.33
01,000,02,007,0247,683 ,1166,10,1176,1833,0,3,1,3,0,1,0,76.14,64.16 ,33.33
01,000,02,007,0248,684 ,1026,5,1031,1616,0,3,1,3,0,1,0,76.14,63.80 ,33.33
01,000,02,007,0248,685 ,1135,4,1139,1753,0,3,1,3,0,1,0,76.14,64.97 ,33.33
01,000,02,007,0249,686 ,848,6,854,1366,0,3,1,3,0,1,0,76.14,62.52 ,33.33
01,000,02,007,0249,687 ,735,14,749,1164,0,3,1,3,0,1,0,76.14,64.35 ,33.33
01,000,02,007,0250,688 ,1141,21,1162,1839,0,3,1,3,0,1,0,76.14,63.19 ,33.33
01,000,02,007,0250,689 ,884,6,890,1537,0,3,1,3,0,1,0,76.14,57.91 ,33.33
01,000,02,007,0250,690 ,1025,8,1033,1623,0,3,1,3,0,1,0,76.14,63.65 ,33.33
01,000,02,007,0251,691 ,1055,11,1066,1682,0,3,1,3,0,1,0,76.14,63.38 ,33.33
01,000,02,007,0251,692 ,912,8,920,1491,0,3,1,3,0,1,0,76.14,61.70 ,33.33
01,000,02,008,0252,693 ,1020,12,1032,1627,0,3,1,3,0,1,0,76.14,63.43 ,33.33
01,000,02,008,0252,694 ,832,17,849,1494,0,3,1,3,0,1,0,76.14,56.83 ,33.33
01,000,02,008,0253,695 ,1013,7,1020,1644,0,3,1,3,0,1,0,76.14,62.04 ,33.33
01,000,02,008,0253,696 ,935,9,944,1479,0,3,1,3,0,1,0,76.14,63.83 ,33.33
01,000,02,008,0254,697 ,1002,20,1022,1597,0,3,1,3,0,1,0,76.14,63.99 ,33.33
01,000,02,008,0254,698 ,992,10,1002,1708,0,3,1,3,0,1,0,76.14,58.67 ,33.33
01,000,02,008,0255,699 ,1049,9,1058,1689,0,3,1,3,0,1,0,76.14,62.64 ,33.33
01,000,02,008,0255,700 ,813,4,817,1254,0,3,1,3,0,1,0,76.14,65.15 ,33.33
01,000,02,008,0256,701 ,913,9,922,1463,0,3,1,3,0,1,0,76.14,63.02 ,33.33
01,000,02,008,0256,702 ,861,11,872,1352,0,3,1,3,0,1,0,76.14,64.50 ,33.33
01,000,02,008,0256,703 ,858,9,867,1364,0,3,1,3,0,1,0,76.14,63.56 ,33.33
01,000,02,008,0257,704 ,975,15,990,1546,0,3,1,3,0,1,0,76.14,64.04 ,33.33
01,000,02,008,0257,705 ,976,7,983,1594,0,3,1,3,0,1,0,76.14,61.67 ,33.33
01,000,02,008,0258,706 ,1118,10,1128,1910,0,3,1,3,0,1,0,76.14,59.06 ,33.33
01,000,02,008,0258,707 ,1086,8,1094,1724,0,3,1,3,0,1,0,76.14,63.46 ,33.33
01,000,02,008,0259,708 ,983,4,987,1423,0,3,1,3,0,1,0,76.14,69.36 ,33.33
01,000,02,008,0259,709 ,861,7,868,1247,0,3,1,3,0,1,0,76.14,69.61 ,33.33
01,000,02,008,0259,710 ,1010,9,1019,1560,0,3,1,3,0,1,0,76.14,65.32 ,33.33
01,000,02,008,0260,711 ,783,10,793,1223,0,3,1,3,0,1,0,76.14,64.84 ,33.33
01,000,02,008,0260,712 ,866,9,875,1391,0,3,1,3,0,1,0,76.14,62.90 ,33.33
01,000,02,008,0260,713 ,930,7,937,1417,0,3,1,3,0,1,0,76.14,66.13 ,33.33
01,000,02,008,0261,714 ,1000,8,1008,1647,0,3,1,3,0,1,0,76.14,61.20 ,33.33
01,000,02,008,0261,715 ,880,3,883,1490,0,3,1,3,0,1,0,76.14,59.26 ,33.33
01,000,02,008,0262,716 ,957,11,968,1502,0,3,1,3,0,1,0,76.14,64.45 ,33.33
01,000,02,008,0262,717 ,1010,8,1018,1614,0,3,1,3,0,1,0,76.14,63.07 ,33.33
01,000,02,008,0262,718 ,1363,12,1375,2237,0,3,1,3,0,1,0,76.14,61.47 ,33.33
01,000,02,008,0262,719 ,1256,14,1270,2118,0,3,1,3,0,1,0,76.14,59.96 ,33.33
01,000,02,008,0263,720 ,919,7,926,1568,0,3,1,3,0,1,0,76.14,59.06 ,33.33
01,000,02,008,0263,721 ,980,15,995,1597,0,3,1,3,0,1,0,76.14,62.30 ,33.33
01,000,02,008,0264,722 ,1178,56,1234,1951,0,3,1,3,0,1,0,76.14,63.25 ,33.33
01,000,02,008,0264,723 ,1016,18,1034,1656,0,3,1,3,0,1,0,76.14,62.44 ,33.33
01,000,02,008,0264,724 ,997,8,1005,1620,0,3,1,3,0,1,0,76.14,62.04 ,33.33
01,000,02,008,0265,725 ,843,16,859,1321,0,3,1,3,0,1,0,76.14,65.03 ,33.33
01,000,02,008,0265,726 ,676,6,682,1087,0,3,1,3,0,1,0,76.14,62.74 ,33.33
01,000,02,008,0266,727 ,831,6,837,1330,0,3,1,3,0,1,0,76.14,62.93 ,33.33
01,000,02,008,0266,728 ,911,7,918,1367,0,3,1,3,0,1,0,76.14,67.15 ,33.33
01,000,02,008,0267,729 ,1133,7,1140,1925,0,3,1,3,0,1,0,76.14,59.22 ,33.33
01,000,02,008,0267,730 ,1191,15,1206,1943,0,3,1,3,0,1,0,76.14,62.07 ,33.33
01,000,02,008,0268,731 ,1257,16,1273,1942,0,3,1,3,0,1,0,76.14,65.55 ,33.33
01,000,02,008,0268,732 ,1053,13,1066,1653,0,3,1,3,0,1,0,76.14,64.49 ,33.33
01,000,02,008,0269,733 ,1301,9,1310,2001,0,3,1,3,0,1,0,76.14,65.47 ,33.33
01,000,02,008,0270,734 ,820,6,826,1263,0,3,1,3,0,1,0,76.14,65.40 ,33.33
01,000,02,008,0270,735 ,804,12,816,1478,0,3,1,3,0,1,0,76.14,55.21 ,33.33
01,000,02,008,0271,736 ,854,20,874,1437,0,3,1,3,0,1,0,76.14,60.82 ,33.33
01,000,02,008,0271,737 ,1012,12,1024,1626,0,3,1,3,0,1,0,76.14,62.98 ,33.33
01,000,02,008,0271,738 ,914,13,927,1396,0,3,1,3,0,1,0,76.14,66.40 ,33.33
01,000,02,008,0272,739 ,1088,8,1096,1703,0,3,1,3,0,1,0,76.14,64.36 ,33.33
01,000,02,008,0272,740 ,1038,12,1050,1666,0,3,1,3,0,1,0,76.14,63.03 ,33.33
01,000,02,008,0272,741 ,1146,16,1162,1827,0,3,1,3,0,1,0,76.14,63.60 ,33.33
01,000,02,008,0273,742 ,1100,6,1106,1716,0,3,1,3,0,1,0,76.14,64.45 ,33.33
01,000,02,008,0273,743 ,1041,17,1058,1615,0,3,1,3,0,1,0,76.14,65.51 ,33.33
01,000,02,008,0273,744 ,1040,5,1045,1599,0,3,1,3,0,1,0,76.14,65.35 ,33.33
01,000,02,008,0273,745 ,949,8,957,1501,0,3,1,3,0,1,0,76.14,63.76 ,33.33
01,000,02,008,0274,746 ,674,6,680,1079,0,3,1,3,0,1,0,76.14,63.02 ,33.33
01,000,02,008,0275,747 ,1103,7,1110,1850,0,3,1,3,0,1,0,76.14,60.00 ,33.33
01,000,02,008,0275,748 ,1168,7,1175,1793,0,3,1,3,0,1,0,76.14,65.53 ,33.33
01,000,02,008,0276,749 ,1185,13,1198,1847,0,3,1,3,0,1,0,76.14,64.86 ,33.33
01,000,02,008,0276,750 ,1250,15,1265,1924,0,3,1,3,0,1,0,76.14,65.75 ,33.33
01,000,02,008,0277,751 ,1030,11,1041,1587,0,3,1,3,0,1,0,76.14,65.60 ,33.33
01,000,02,008,0277,752 ,1130,7,1137,1728,0,3,1,3,0,1,0,76.14,65.80 ,33.33
01,000,02,008,0277,753 ,863,8,871,1394,0,3,1,3,0,1,0,76.14,62.48 ,33.33
01,000,02,009,0278,754 ,852,8,860,1321,0,3,1,3,0,1,0,76.14,65.10 ,33.33
01,000,02,009,0278,755 ,776,6,782,1241,0,3,1,3,0,1,0,76.14,63.01 ,33.33
01,000,02,009,0279,756 ,724,3,727,1188,0,3,1,3,0,1,0,76.14,61.20 ,33.33
01,000,02,009,0279,757 ,814,19,833,1247,0,3,1,3,0,1,0,76.14,66.80 ,33.33
01,000,02,009,0280,758 ,783,3,786,1132,0,3,1,3,0,1,0,76.14,69.43 ,33.33
01,000,02,009,0280,759 ,707,3,710,1155,0,3,1,3,0,1,0,76.14,61.47 ,33.33
01,000,02,009,0281,760 ,1132,4,1136,1778,0,3,1,3,0,1,0,76.14,63.89 ,33.33
01,000,02,009,0281,761 ,1323,11,1334,2008,0,3,1,3,0,1,0,76.14,66.43 ,33.33
01,000,02,009,0282,762 ,806,7,813,1224,0,3,1,3,0,1,0,76.14,66.42 ,33.33
01,000,02,009,0282,763 ,863,10,873,1357,0,3,1,3,0,1,0,76.14,64.33 ,33.33
01,000,02,009,0282,764 ,820,7,827,1298,0,3,1,3,0,1,0,76.14,63.71 ,33.33
01,000,02,009,0283,765 ,970,7,977,1392,0,3,1,3,0,1,0,76.14,70.19 ,33.33
01,000,02,009,0283,766 ,1115,6,1121,1577,0,3,1,3,0,1,0,76.14,71.08 ,33.33
01,000,02,009,0283,767 ,1040,9,1049,1611,0,3,1,3,0,1,0,76.14,65.11 ,33.33
01,000,02,009,0284,768 ,1030,2,1032,1592,0,3,1,3,0,1,0,76.14,64.82 ,33.33
01,000,02,009,0284,769 ,896,3,899,1372,0,3,1,3,0,1,0,76.14,65.52 ,33.33
01,000,02,009,0284,770 ,995,9,1004,1487,0,3,1,3,0,1,0,76.14,67.52 ,33.33
01,000,02,009,0285,771 ,990,17,1007,1521,0,3,1,3,0,1,0,76.14,66.21 ,33.33
01,000,02,009,0285,772 ,791,13,804,1223,0,3,1,3,0,1,0,76.14,65.74 ,33.33
01,000,02,009,0286,773 ,967,3,970,1435,0,3,1,3,0,1,0,76.14,67.60 ,33.33
01,000,02,009,0286,774 ,1033,6,1039,1515,0,3,1,3,0,1,0,76.14,68.58 ,33.33
01,000,02,009,0286,775 ,898,7,905,1364,0,3,1,3,0,1,0,76.14,66.35 ,33.33
01,000,02,009,0287,776 ,1085,12,1097,1677,0,3,1,3,0,1,0,76.14,65.41 ,33.33
01,000,02,009,0287,777 ,1264,9,1273,1935,0,3,1,3,0,1,0,76.14,65.79 ,33.33
01,000,02,009,0288,778 ,1106,7,1113,1748,0,3,1,3,0,1,0,76.14,63.67 ,33.33
01,000,02,009,0288,779 ,1137,11,1148,1768,0,3,1,3,0,1,0,76.14,64.93 ,33.33
01,000,02,009,0288,780 ,970,5,975,1556,0,3,1,3,0,1,0,76.14,62.66 ,33.33
01,000,02,009,0289,781 ,942,11,953,1497,0,3,1,3,0,1,0,76.14,63.66 ,33.33
01,000,02,009,0289,782 ,968,16,984,1523,0,3,1,3,0,1,0,76.14,64.61 ,33.33
01,000,02,009,0289,783 ,886,14,900,1394,0,3,1,3,0,1,0,76.14,64.56 ,33.33
01,000,02,009,0290,784 ,1074,5,1079,1704,0,3,1,3,0,1,0,76.14,63.32 ,33.33
01,000,02,009,0290,785 ,955,8,963,1470,0,3,1,3,0,1,0,76.14,65.51 ,33.33
01,000,02,009,0291,786 ,949,19,968,1572,0,3,1,3,0,1,0,76.14,61.58 ,33.33
01,000,02,009,0291,787 ,901,18,919,1473,0,3,1,3,0,1,0,76.14,62.39 ,33.33
01,000,02,009,0291,788 ,832,18,850,1391,0,3,1,3,0,1,0,76.14,61.11 ,33.33
01,000,02,009,0291,789 ,862,11,873,1344,0,3,1,3,0,1,0,76.14,64.96 ,33.33
01,000,02,009,0292,790 ,1175,12,1187,1764,0,3,1,3,0,1,0,76.14,67.29 ,33.33
01,000,02,009,0292,791 ,816,3,819,1270,0,3,1,3,0,1,0,76.14,64.49 ,33.33
01,000,02,009,0293,792 ,852,4,856,1289,0,3,1,3,0,1,0,76.14,66.41 ,33.33
01,000,02,009,0293,793 ,856,5,861,1300,0,3,1,3,0,1,0,76.14,66.23 ,33.33
01,000,02,009,0294,794 ,897,5,902,1323,0,3,1,3,0,1,0,76.14,68.18 ,33.33
01,000,02,009,0294,795 ,867,8,875,1364,0,3,1,3,0,1,0,76.14,64.15 ,33.33
01,000,02,009,0295,796 ,877,9,886,1425,0,3,1,3,0,1,0,76.14,62.18 ,33.33
01,000,02,009,0295,797 ,1034,7,1041,1561,0,3,1,3,0,1,0,76.14,66.69 ,33.33
01,000,02,009,0296,798 ,1358,13,1371,2037,0,3,1,3,0,1,0,76.14,67.30 ,33.33
01,000,02,009,0296,799 ,1283,15,1298,1989,0,3,1,3,0,1,0,76.14,65.26 ,33.33
01,000,02,009,0296,800 ,1242,4,1246,1867,0,3,1,3,0,1,0,76.14,66.74 ,33.33
01,000,02,009,0297,801 ,1014,4,1018,1765,0,3,1,3,0,1,0,76.14,57.68 ,33.33
01,000,02,009,0297,802 ,1001,11,1012,1539,0,3,1,3,0,1,0,76.14,65.76 ,33.33
01,000,02,009,0297,803 ,1122,10,1132,1710,0,3,1,3,0,1,0,76.14,66.20 ,33.33
01,000,02,009,0298,804 ,1076,9,1085,1557,0,3,1,3,0,1,0,76.14,69.69 ,33.33
01,000,02,009,0298,805 ,988,6,994,1476,0,3,1,3,0,1,0,76.14,67.34 ,33.33
01,000,02,009,0298,806 ,1041,13,1054,1570,0,3,1,3,0,1,0,76.14,67.13 ,33.33
01,000,02,009,0298,807 ,1007,6,1013,1478,0,3,1,3,0,1,0,76.14,68.54 ,33.33
01,000,02,009,0299,808 ,675,8,683,1138,0,3,1,3,0,1,0,76.14,60.02 ,33.33
01,000,02,009,0300,809 ,787,9,796,1309,0,3,1,3,0,1,0,76.14,60.81 ,33.33
01,000,02,009,0300,810 ,893,5,898,1566,0,3,1,3,0,1,0,76.14,57.34 ,33.33
01,000,02,009,0301,811 ,591,5,596,1078,0,3,1,3,0,1,0,76.14,55.29 ,33.33
01,000,02,009,0301,812 ,653,9,662,1157,0,3,1,3,0,1,0,76.14,57.22 ,33.33
01,000,02,009,0302,813 ,891,6,897,1462,0,3,1,3,0,1,0,76.14,61.35 ,33.33
01,000,02,009,0302,814 ,888,2,890,1373,0,3,1,3,0,1,0,76.14,64.82 ,33.33
01,000,02,009,0303,815 ,1072,6,1078,1720,0,3,1,3,0,1,0,76.14,62.67 ,33.33
01,000,02,009,0303,816 ,1033,6,1039,1668,0,3,1,3,0,1,0,76.14,62.29 ,33.33
01,000,02,009,0304,817 ,1189,4,1193,1874,0,3,1,3,0,1,0,76.14,63.66 ,33.33
01,000,02,009,0304,818 ,999,8,1007,1661,0,3,1,3,0,1,0,76.14,60.63 ,33.33
01,000,02,009,0305,819 ,728,6,734,1111,0,3,1,3,0,1,0,76.14,66.07 ,33.33
01,000,02,009,0305,820 ,858,3,861,1349,0,3,1,3,0,1,0,76.14,63.83 ,33.33
01,000,02,009,0305,821 ,644,9,653,1056,0,3,1,3,0,1,0,76.14,61.84 ,33.33
01,000,02,009,0306,822 ,849,3,852,1320,0,3,1,3,0,1,0,76.14,64.55 ,33.33
01,000,02,009,0306,823 ,962,8,970,1507,0,3,1,3,0,1,0,76.14,64.37 ,33.33
01,000,02,009,0306,824 ,760,4,764,1225,0,3,1,3,0,1,0,76.14,62.37 ,33.33
01,000,02,009,0307,825 ,885,5,890,1397,0,3,1,3,0,1,0,76.14,63.71 ,33.33
01,000,02,009,0307,826 ,795,11,806,1159,0,3,1,3,0,1,0,76.14,69.54 ,33.33
01,000,02,009,0307,827 ,896,8,904,1368,0,3,1,3,0,1,0,76.14,66.08 ,33.33
01,000,02,009,0307,828 ,903,11,914,1346,0,3,1,3,0,1,0,76.14,67.90 ,33.33
01,000,02,009,0308,829 ,1067,11,1078,1621,0,3,1,3,0,1,0,76.14,66.50 ,33.33
01,000,02,009,0308,830 ,1025,7,1032,1596,0,3,1,3,0,1,0,76.14,64.66 ,33.33
01,000,02,009,0308,831 ,889,6,895,1350,0,3,1,3,0,1,0,76.14,66.30 ,33.33
01,000,02,009,0308,832 ,901,10,911,1423,0,3,1,3,0,1,0,76.14,64.02 ,33.33
01,000,02,010,0309,833 ,853,13,866,1374,0,3,1,3,0,1,0,76.14,63.03 ,33.33
01,000,02,010,0309,834 ,673,15,688,1111,0,3,1,3,0,1,0,76.14,61.93 ,33.33
01,000,02,010,0309,835 ,919,10,929,1548,0,3,1,3,0,1,0,76.14,60.01 ,33.33
01,000,02,010,0310,836 ,693,8,701,1266,0,3,1,3,0,1,0,76.14,55.37 ,33.33
01,000,02,010,0310,837 ,822,12,834,1416,0,3,1,3,0,1,0,76.14,58.90 ,33.33
01,000,02,010,0311,838 ,934,11,945,1664,0,3,1,3,0,1,0,76.14,56.79 ,33.33
01,000,02,010,0311,839 ,658,7,665,1202,0,3,1,3,0,1,0,76.14,55.32 ,33.33
01,000,02,010,0312,840 ,1137,14,1151,1865,0,3,1,3,0,1,0,76.14,61.72 ,33.33
01,000,02,010,0312,841 ,1196,16,1212,2027,0,3,1,3,0,1,0,76.14,59.79 ,33.33
01,000,02,010,0312,842 ,1197,9,1206,1784,0,3,1,3,0,1,0,76.14,67.60 ,33.33
01,000,02,010,0313,843 ,916,10,926,1509,0,3,1,3,0,1,0,76.14,61.37 ,33.33
01,000,02,010,0313,844 ,1079,10,1089,1807,0,3,1,3,0,1,0,76.14,60.27 ,33.33
01,000,02,010,0313,845 ,1091,7,1098,1725,0,3,1,3,0,1,0,76.14,63.65 ,33.33
01,000,02,010,0314,846 ,934,14,948,1476,0,3,1,3,0,1,0,76.14,64.23 ,33.33
01,000,02,010,0314,847 ,935,7,942,1526,0,3,1,3,0,1,0,76.14,61.73 ,33.33
01,000,02,010,0314,848 ,847,11,858,1402,0,3,1,3,0,1,0,76.14,61.20 ,33.33
01,000,02,010,0315,849 ,1126,6,1132,1690,0,3,1,3,0,1,0,76.14,66.98 ,33.33
01,000,02,010,0315,850 ,774,8,782,1229,0,3,1,3,0,1,0,76.14,63.63 ,33.33
01,000,02,010,0315,851 ,885,12,897,1342,0,3,1,3,0,1,0,76.14,66.84 ,33.33
01,000,02,010,0316,852 ,1060,16,1076,1573,0,3,1,3,0,1,0,76.14,68.40 ,33.33
01,000,02,010,0316,853 ,1000,9,1009,1520,0,3,1,3,0,1,0,76.14,66.38 ,33.33
01,000,02,010,0317,854 ,1273,11,1284,1902,0,3,1,3,0,1,0,76.14,67.51 ,33.33
01,000,02,010,0317,855 ,1114,11,1125,1673,0,3,1,3,0,1,0,76.14,67.24 ,33.33
01,000,02,010,0318,856 ,916,7,923,1315,0,3,1,3,0,1,0,76.14,70.19 ,33.33
01,000,02,010,0318,857 ,775,2,777,1179,0,3,1,3,0,1,0,76.14,65.90 ,33.33
01,000,02,010,0318,858 ,936,7,943,1374,0,3,1,3,0,1,0,76.14,68.63 ,33.33
01,000,02,010,0319,859 ,1059,6,1065,1686,0,3,1,3,0,1,0,76.14,63.17 ,33.33
01,000,02,010,0319,860 ,1200,10,1210,1995,0,3,1,3,0,1,0,76.14,60.65 ,33.33
01,000,02,010,0320,861 ,1061,7,1068,1660,0,3,1,3,0,1,0,76.14,64.34 ,33.33
01,000,02,010,0320,862 ,868,14,882,1525,0,3,1,3,0,1,0,76.14,57.84 ,33.33
01,000,02,010,0320,863 ,1021,13,1034,1677,0,3,1,3,0,1,0,76.14,61.66 ,33.33
01,000,02,010,0321,864 ,1080,19,1099,1618,0,3,1,3,0,1,0,76.14,67.92 ,33.33
01,000,02,010,0321,865 ,989,12,1001,1573,0,3,1,3,0,1,0,76.14,63.64 ,33.33
01,000,02,010,0321,866 ,1169,11,1180,1792,0,3,1,3,0,1,0,76.14,65.85 ,33.33
01,000,02,010,0321,867 ,1203,15,1218,1967,0,3,1,3,0,1,0,76.14,61.92 ,33.33
01,000,02,010,0322,868 ,1140,15,1155,1891,0,3,1,3,0,1,0,76.14,61.08 ,33.33
01,000,02,010,0322,869 ,826,14,840,1252,0,3,1,3,0,1,0,76.14,67.09 ,33.33
01,000,02,010,0322,870 ,840,18,858,1366,0,3,1,3,0,1,0,76.14,62.81 ,33.33
01,000,02,010,0323,871 ,1000,6,1006,1513,0,3,1,3,0,1,0,76.14,66.49 ,33.33
01,000,02,010,0323,872 ,898,8,906,1330,0,3,1,3,0,1,0,76.14,68.12 ,33.33
01,000,02,010,0323,873 ,795,8,803,1195,0,3,1,3,0,1,0,76.14,67.20 ,33.33
01,000,02,010,0324,874 ,854,8,862,1289,0,3,1,3,0,1,0,76.14,66.87 ,33.33
01,000,02,010,0324,875 ,891,14,905,1376,0,3,1,3,0,1,0,76.14,65.77 ,33.33
01,000,02,010,0324,876 ,796,8,804,1340,0,3,1,3,0,1,0,76.14,60.00 ,33.33
01,000,02,010,0325,877 ,1177,13,1190,1807,0,3,1,3,0,1,0,76.14,65.86 ,33.33
01,000,02,010,0325,878 ,1130,15,1145,1746,0,3,1,3,0,1,0,76.14,65.58 ,33.33
01,000,02,010,0325,879 ,1018,17,1035,1590,0,3,1,3,0,1,0,76.14,65.09 ,33.33
01,000,02,010,0326,880 ,1053,13,1066,1646,0,3,1,3,0,1,0,76.14,64.76 ,33.33
01,000,02,010,0326,881 ,887,11,898,1385,0,3,1,3,0,1,0,76.14,64.84 ,33.33
01,000,02,010,0326,882 ,1270,11,1281,1818,0,3,1,3,0,1,0,76.14,70.46 ,33.33
01,000,02,010,0327,883 ,936,15,951,1296,0,3,1,3,0,1,0,76.14,73.38 ,33.33
01,000,02,010,0327,884 ,1073,7,1080,1538,0,3,1,3,0,1,0,76.14,70.22 ,33.33
01,000,02,010,0327,885 ,957,10,967,1458,0,3,1,3,0,1,0,76.14,66.32 ,33.33
01,000,02,010,0328,886 ,1007,21,1028,1579,0,3,1,3,0,1,0,76.14,65.10 ,33.33
01,000,02,010,0328,887 ,1294,12,1306,1939,0,3,1,3,0,1,0,76.14,67.35 ,33.33
01,000,02,010,0329,888 ,867,3,870,1347,0,3,1,3,0,1,0,76.14,64.59 ,33.33
01,000,02,010,0329,889 ,852,12,864,1222,0,3,1,3,0,1,0,76.14,70.70 ,33.33
01,000,02,010,0330,890 ,1159,16,1175,1763,0,3,1,3,0,1,0,76.14,66.65 ,33.33
01,000,02,010,0330,891 ,1297,14,1311,1958,0,3,1,3,0,1,0,76.14,66.96 ,33.33
01,000,02,010,0331,892 ,942,9,951,1476,0,3,1,3,0,1,0,76.14,64.43 ,33.33
01,000,02,010,0331,893 ,814,15,829,1216,0,3,1,3,0,1,0,76.14,68.17 ,33.33
01,000,02,010,0332,894 ,1360,16,1376,2199,0,3,1,3,0,1,0,76.14,62.57 ,33.33
01,000,02,010,0332,895 ,1081,22,1103,1955,0,3,1,3,0,1,0,76.14,56.42 ,33.33
01,000,02,010,0332,896 ,1079,7,1086,1691,0,3,1,3,0,1,0,76.14,64.22 ,33.33
01,000,02,010,0333,897 ,975,14,989,1520,0,3,1,3,0,1,0,76.14,65.07 ,33.33
01,000,02,010,0333,898 ,971,10,981,1527,0,3,1,3,0,1,0,76.14,64.24 ,33.33
01,000,02,010,0333,899 ,825,6,831,1249,0,3,1,3,0,1,0,76.14,66.53 ,33.33
01,000,02,010,0334,900 ,1086,14,1100,1673,0,3,1,3,0,1,0,76.14,65.75 ,33.33
01,000,02,010,0334,901 ,1105,14,1119,1707,0,3,1,3,0,1,0,76.14,65.55 ,33.33
01,000,02,010,0335,902 ,856,9,865,1267,0,3,1,3,0,1,0,76.14,68.27 ,33.33
01,000,02,010,0335,903 ,808,9,817,1195,0,3,1,3,0,1,0,76.14,68.37 ,33.33
01,000,02,010,0336,904 ,930,7,937,1370,0,3,1,3,0,1,0,76.14,68.39 ,33.33
01,000,02,010,0336,905 ,942,8,950,1424,0,3,1,3,0,1,0,76.14,66.71 ,33.33
01,000,02,010,0336,906 ,686,9,695,1094,0,3,1,3,0,1,0,76.14,63.53 ,33.33
01,000,02,010,0337,907 ,1078,16,1094,1565,0,3,1,3,0,1,0,76.14,69.90 ,33.33
01,000,02,010,0337,908 ,1172,21,1193,1741,0,3,1,3,0,1,0,76.14,68.52 ,33.33
01,000,02,010,0338,909 ,1033,16,1049,1639,0,3,1,3,0,1,0,76.14,64.00 ,33.33
01,000,02,010,0338,910 ,846,5,851,1309,0,3,1,3,0,1,0,76.14,65.01 ,33.33
01,000,02,010,0338,911 ,794,9,803,1260,0,3,1,3,0,1,0,76.14,63.73 ,33.33
01,000,02,010,0338,912 ,1172,27,1199,1823,0,3,1,3,0,1,0,76.14,65.77 ,33.33
01,000,02,010,0339,913 ,1146,15,1161,1780,0,3,1,3,0,1,0,76.14,65.22 ,33.33
01,000,02,010,0339,914 ,923,8,931,1365,0,3,1,3,0,1,0,76.14,68.21 ,33.33
01,000,02,010,0340,915 ,937,17,954,1519,0,3,1,3,0,1,0,76.14,62.80 ,33.33
01,000,02,010,0340,916 ,935,17,952,1444,0,3,1,3,0,1,0,76.14,65.93 ,33.33
01,000,02,010,0340,917 ,781,10,791,1199,0,3,1,3,0,1,0,76.14,65.97 ,33.33
01,000,02,010,0340,918 ,943,9,952,1321,0,3,1,3,0,1,0,76.14,72.07 ,33.33
01,000,02,010,0341,919 ,1243,14,1257,2009,0,3,1,3,0,1,0,76.14,62.57 ,33.33
01,000,02,010,0341,920 ,1101,9,1110,1641,0,3,1,3,0,1,0,76.14,67.64 ,33.33
01,000,02,010,0341,921 ,929,9,938,1410,0,3,1,3,0,1,0,76.14,66.52 ,33.33
01,000,02,010,0341,922 ,999,13,1012,1505,0,3,1,3,0,1,0,76.14,67.24 ,33.33
01,000,02,010,0342,923 ,795,9,804,1253,0,3,1,3,0,1,0,76.14,64.17 ,33.33
01,000,02,010,0342,924 ,988,10,998,1520,0,3,1,3,0,1,0,76.14,65.66 ,33.33
01,000,02,010,0342,925 ,951,8,959,1494,0,3,1,3,0,1,0,76.14,64.19 ,33.33
01,000,02,010,0343,926 ,969,5,974,1541,0,3,1,3,0,1,0,76.14,63.21 ,33.33
01,000,02,010,0343,927 ,1283,3,1286,1774,0,3,1,3,0,1,0,76.14,72.49 ,33.33
01,000,02,010,0344,928 ,1065,10,1075,1484,0,3,1,3,0,1,0,76.14,72.44 ,33.33
01,000,02,010,0344,929 ,996,8,1004,1390,0,3,1,3,0,1,0,76.14,72.23 ,33.33
01,000,02,010,0344,930 ,992,10,1002,1459,0,3,1,3,0,1,0,76.14,68.68 ,33.33
01,000,02,010,0344,931 ,959,11,970,1455,0,3,1,3,0,1,0,76.14,66.67 ,33.33
01,000,02,010,0344,932 ,968,7,975,1357,0,3,1,3,0,1,0,76.14,71.85 ,33.33
01,000,02,011,0345,933 ,1002,4,1006,1496,0,3,1,3,0,1,0,76.14,67.25 ,33.33
01,000,02,011,0345,934 ,951,7,958,1505,0,3,1,3,0,1,0,76.14,63.65 ,33.33
01,000,02,011,0345,935 ,890,11,901,1473,0,3,1,3,0,1,0,76.14,61.17 ,33.33
01,000,02,011,0346,936 ,1228,8,1236,1961,0,3,1,3,0,1,0,76.14,63.03 ,33.33
01,000,02,011,0346,937 ,1232,11,1243,1909,0,3,1,3,0,1,0,76.14,65.11 ,33.33
01,000,02,011,0347,938 ,1000,7,1007,1542,0,3,1,3,0,1,0,76.14,65.30 ,33.33
01,000,02,011,0347,939 ,1214,7,1221,1856,0,3,1,3,0,1,0,76.14,65.79 ,33.33
01,000,02,011,0347,940 ,971,8,979,1511,0,3,1,3,0,1,0,76.14,64.79 ,33.33
01,000,02,011,0348,941 ,976,4,980,1548,0,3,1,3,0,1,0,76.14,63.31 ,33.33
01,000,02,011,0348,942 ,992,6,998,1642,0,3,1,3,0,1,0,76.14,60.78 ,33.33
01,000,02,011,0348,943 ,916,6,922,1441,0,3,1,3,0,1,0,76.14,63.98 ,33.33
01,000,02,011,0348,944 ,1080,5,1085,1701,0,3,1,3,0,1,0,76.14,63.79 ,33.33
01,000,02,011,0349,945 ,938,7,945,1621,0,3,1,3,0,1,0,76.14,58.30 ,33.33
01,000,02,011,0349,946 ,863,6,869,1540,0,3,1,3,0,1,0,76.14,56.43 ,33.33
01,000,02,011,0349,947 ,838,7,845,1466,0,3,1,3,0,1,0,76.14,57.64 ,33.33
01,000,02,011,0350,948 ,1341,18,1359,1992,0,3,1,3,0,1,0,76.14,68.22 ,33.33
01,000,02,011,0350,949 ,1232,11,1243,1904,0,3,1,3,0,1,0,76.14,65.28 ,33.33
01,000,02,011,0350,950 ,1070,0,1070,1632,0,3,1,3,0,1,0,76.14,65.56 ,33.33
01,000,02,011,0351,951 ,1060,6,1066,1609,0,3,1,3,0,1,0,76.14,66.25 ,33.33
01,000,02,011,0351,952 ,1068,8,1076,1728,0,3,1,3,0,1,0,76.14,62.27 ,33.33
01,000,02,011,0351,953 ,1118,10,1128,1826,0,3,1,3,0,1,0,76.14,61.77 ,33.33
01,000,02,011,0352,954 ,915,11,926,1417,0,3,1,3,0,1,0,76.14,65.35 ,33.33
01,000,02,011,0352,955 ,963,8,971,1507,0,3,1,3,0,1,0,76.14,64.43 ,33.33
01,000,02,011,0353,956 ,1103,7,1110,1735,0,3,1,3,0,1,0,76.14,63.98 ,33.33
01,000,02,011,0353,957 ,1172,7,1179,1848,0,3,1,3,0,1,0,76.14,63.80 ,33.33
01,000,02,011,0354,958 ,1117,11,1128,1997,0,3,1,3,0,1,0,76.14,56.48 ,33.33
01,000,02,011,0354,959 ,1311,14,1325,2143,0,3,1,3,0,1,0,76.14,61.83 ,33.33
01,000,02,011,0354,960 ,1324,7,1331,2140,0,3,1,3,0,1,0,76.14,62.20 ,33.33
01,000,02,011,0355,961 ,1046,4,1050,1591,0,3,1,3,0,1,0,76.14,66.00 ,33.33
01,000,02,011,0355,962 ,932,3,935,1386,0,3,1,3,0,1,0,76.14,67.46 ,33.33
01,000,02,011,0355,963 ,1007,6,1013,1454,0,3,1,3,0,1,0,76.14,69.67 ,33.33
01,000,02,011,0356,964 ,1160,6,1166,1821,0,3,1,3,0,1,0,76.14,64.03 ,33.33
01,000,02,011,0356,965 ,1079,5,1084,1736,0,3,1,3,0,1,0,76.14,62.44 ,33.33
01,000,02,011,0357,966 ,1034,3,1037,1577,0,3,1,3,0,1,0,76.14,65.76 ,33.33
01,000,02,011,0357,967 ,1115,5,1120,1716,0,3,1,3,0,1,0,76.14,65.27 ,33.33
01,000,02,011,0358,968 ,1021,5,1026,1563,0,3,1,3,0,1,0,76.14,65.64 ,33.33
01,000,02,011,0358,969 ,1099,9,1108,1673,0,3,1,3,0,1,0,76.14,66.23 ,33.33
01,000,02,011,0358,970 ,1133,8,1141,1785,0,3,1,3,0,1,0,76.14,63.92 ,33.33
01,000,02,011,0359,971 ,692,2,694,1574,0,3,1,3,0,1,0,76.14,44.09 ,33.33
01,000,02,011,0359,972 ,1020,8,1028,1516,0,3,1,3,0,1,0,76.14,67.81 ,33.33
01,000,02,011,0359,973 ,1136,6,1142,1752,0,3,1,3,0,1,0,76.14,65.18 ,33.33
01,000,02,011,0360,974 ,1230,8,1238,1975,0,3,1,3,0,1,0,76.14,62.68 ,33.33
01,000,02,011,0360,975 ,1361,4,1365,1968,0,3,1,3,0,1,0,76.14,69.36 ,33.33
01,000,02,011,0361,976 ,1417,12,1429,2209,0,3,1,3,0,1,0,76.14,64.69 ,33.33
01,000,02,011,0361,977 ,1327,8,1335,2031,0,3,1,3,0,1,0,76.14,65.73 ,33.33
01,000,02,011,0362,978 ,862,9,871,1340,0,3,1,3,0,1,0,76.14,65.00 ,33.33
01,000,02,011,0362,979 ,809,7,816,1204,0,3,1,3,0,1,0,76.14,67.77 ,33.33
01,000,02,011,0363,980 ,968,5,973,1417,0,3,1,3,0,1,0,76.14,68.67 ,33.33
01,000,02,011,0363,981 ,937,6,943,1402,0,3,1,3,0,1,0,76.14,67.26 ,33.33
01,000,02,011,0364,982 ,978,14,992,1387,0,3,1,3,0,1,0,76.14,71.52 ,33.33
01,000,02,011,0364,983 ,879,5,884,1216,0,3,1,3,0,1,0,76.14,72.70 ,33.33
01,000,02,011,0364,984 ,914,10,924,1384,0,3,1,3,0,1,0,76.14,66.76 ,33.33
01,000,02,011,0365,985 ,867,5,872,1338,0,3,1,3,0,1,0,76.14,65.17 ,33.33
01,000,02,011,0365,986 ,909,5,914,1331,0,3,1,3,0,1,0,76.14,68.67 ,33.33
01,000,02,011,0365,987 ,899,5,904,1396,0,3,1,3,0,1,0,76.14,64.76 ,33.33
01,000,02,011,0366,988 ,913,1,914,1519,0,3,1,3,0,1,0,76.14,60.17 ,33.33
01,000,02,011,0366,989 ,1167,14,1181,1805,0,3,1,3,0,1,0,76.14,65.43 ,33.33
01,000,02,011,0366,990 ,1194,5,1199,1900,0,3,1,3,0,1,0,76.14,63.11 ,33.33
01,000,02,011,0367,991 ,1012,8,1020,1565,0,3,1,3,0,1,0,76.14,65.18 ,33.33
01,000,02,011,0367,992 ,1142,10,1152,1646,0,3,1,3,0,1,0,76.14,69.99 ,33.33
01,000,02,011,0367,993 ,1278,9,1287,1873,0,3,1,3,0,1,0,76.14,68.71 ,33.33
01,000,02,011,0368,994 ,879,10,889,1389,0,3,1,3,0,1,0,76.14,64.00 ,33.33
01,000,02,011,0368,995 ,1016,5,1021,1583,0,3,1,3,0,1,0,76.14,64.50 ,33.33
01,000,02,011,0369,996 ,845,8,853,1231,0,3,1,3,0,1,0,76.14,69.29 ,33.33
01,000,02,011,0369,997 ,910,8,918,1423,0,3,1,3,0,1,0,76.14,64.51 ,33.33
01,000,02,011,0369,998 ,866,8,874,1409,0,3,1,3,0,1,0,76.14,62.03 ,33.33
01,000,02,011,0370,999 ,1095,9,1104,1576,0,3,1,3,0,1,0,76.14,70.05 ,33.33
01,000,02,011,0370,1000 ,1083,6,1089,1649,0,3,1,3,0,1,0,76.14,66.04 ,33.33
01,000,02,011,0370,1001 ,1022,7,1029,1552,0,3,1,3,0,1,0,76.14,66.30 ,33.33
01,000,02,011,0371,1002 ,1020,8,1028,1582,0,3,1,3,0,1,0,76.14,64.98 ,33.33
01,000,02,011,0371,1003 ,785,10,795,1277,0,3,1,3,0,1,0,76.14,62.26 ,33.33
01,000,02,011,0371,1004 ,951,12,963,1508,0,3,1,3,0,1,0,76.14,63.86 ,33.33
01,000,02,011,0372,1005 ,923,10,933,1555,0,3,1,3,0,1,0,76.14,60.00 ,33.33
01,000,02,011,0372,1006 ,963,7,970,1478,0,3,1,3,0,1,0,76.14,65.63 ,33.33
01,000,02,011,0372,1007 ,833,3,836,1396,0,3,1,3,0,1,0,76.14,59.89 ,33.33
01,000,02,011,0373,1008 ,912,12,924,1435,0,3,1,3,0,1,0,76.14,64.39 ,33.33
01,000,02,011,0373,1009 ,1092,14,1106,1665,0,3,1,3,0,1,0,76.14,66.43 ,33.33
01,000,02,011,0373,1010 ,1124,7,1131,1742,0,3,1,3,0,1,0,76.14,64.93 ,33.33
01,000,02,011,0374,1011 ,883,5,888,1409,0,3,1,3,0,1,0,76.14,63.02 ,33.33
01,000,02,011,0374,1012 ,1084,10,1094,1654,0,3,1,3,0,1,0,76.14,66.14 ,33.33
01,000,02,011,0374,1013 ,957,6,963,1493,0,3,1,3,0,1,0,76.14,64.50 ,33.33
01,000,02,011,0375,1014 ,1098,13,1111,1689,0,3,1,3,0,1,0,76.14,65.78 ,33.33
01,000,02,011,0375,1015 ,1178,11,1189,1806,0,3,1,3,0,1,0,76.14,65.84 ,33.33
01,000,02,011,0376,1016 ,1186,8,1194,1776,0,3,1,3,0,1,0,76.14,67.23 ,33.33
01,000,02,011,0376,1017 ,1137,10,1147,1737,0,3,1,3,0,1,0,76.14,66.03 ,33.33
01,000,02,011,0377,1018 ,1143,10,1153,1791,0,3,1,3,0,1,0,76.14,64.38 ,33.33
01,000,02,011,0377,1019 ,1083,2,1085,1717,0,3,1,3,0,1,0,76.14,63.19 ,33.33
01,000,02,011,0378,1020 ,1193,4,1197,1798,0,3,1,3,0,1,0,76.14,66.57 ,33.33
01,000,02,011,0378,1021 ,965,6,971,1491,0,3,1,3,0,1,0,76.14,65.12 ,33.33
01,000,02,011,0378,1022 ,1063,5,1068,1725,0,3,1,3,0,1,0,76.14,61.91 ,33.33
01,000,02,011,0379,1023 ,1032,5,1037,1463,0,3,1,3,0,1,0,76.14,70.88 ,33.33
01,000,02,011,0379,1024 ,1030,6,1036,1553,0,3,1,3,0,1,0,76.14,66.71 ,33.33
01,000,02,011,0379,1025 ,935,2,937,1332,0,3,1,3,0,1,0,76.14,70.35 ,33.33
01,000,02,011,0379,1026 ,998,4,1002,1497,0,3,1,3,0,1,0,76.14,66.93 ,33.33
01,000,02,011,0380,1027 ,745,5,750,1106,0,3,1,3,0,1,0,76.14,67.81 ,33.33
01,000,02,011,0380,1028 ,953,8,961,1487,0,3,1,3,0,1,0,76.14,64.63 ,33.33
01,000,02,011,0381,1029 ,757,2,759,1151,0,3,1,3,0,1,0,76.14,65.94 ,33.33
01,000,02,011,0381,1030 ,815,7,822,1270,0,3,1,3,0,1,0,76.14,64.72 ,33.33
01,000,02,011,0382,1031 ,1056,3,1059,1644,0,3,1,3,0,1,0,76.14,64.42 ,33.33
01,000,02,011,0382,1032 ,1188,9,1197,1818,0,3,1,3,0,1,0,76.14,65.84 ,33.33
01,000,02,011,0382,1033 ,1105,5,1110,1669,0,3,1,3,0,1,0,76.14,66.51 ,33.33
01,000,02,011,0382,1034 ,1173,12,1185,1731,0,3,1,3,0,1,0,76.14,68.46 ,33.33
01,000,02,011,0383,1035 ,1025,5,1030,1635,0,3,1,3,0,1,0,76.14,63.00 ,33.33
01,000,02,011,0383,1036 ,1072,5,1077,1589,0,3,1,3,0,1,0,76.14,67.78 ,33.33
01,000,02,011,0384,1037 ,1039,10,1049,1672,0,3,1,3,0,1,0,76.14,62.74 ,33.33
01,000,02,011,0385,1038 ,1012,7,1019,1539,0,3,1,3,0,1,0,76.14,66.21 ,33.33
01,000,02,011,0385,1039 ,1039,12,1051,1633,0,3,1,3,0,1,0,76.14,64.36 ,33.33
01,000,02,011,0385,1040 ,1049,6,1055,1668,0,3,1,3,0,1,0,76.14,63.25 ,33.33
01,000,02,011,0385,1041 ,990,15,1005,1593,0,3,1,3,0,1,0,76.14,63.09 ,33.33
01,000,02,011,0386,1042 ,1097,4,1101,1623,0,3,1,3,0,1,0,76.14,67.84 ,33.33
01,000,02,011,0386,1043 ,1191,14,1205,1789,0,3,1,3,0,1,0,76.14,67.36 ,33.33
01,000,02,011,0386,1044 ,1000,9,1009,1558,0,3,1,3,0,1,0,76.14,64.76 ,33.33
01,000,02,011,0387,1045 ,535,7,542,801,0,3,1,3,0,1,0,76.14,67.67 ,33.33
01,000,02,011,0387,1046 ,559,5,564,858,0,3,1,3,0,1,0,76.14,65.73 ,33.33
01,000,02,011,0388,1047 ,864,10,874,1411,0,3,1,3,0,1,0,76.14,61.94 ,33.33
01,000,02,011,0388,1048 ,1083,10,1093,1617,0,3,1,3,0,1,0,76.14,67.59 ,33.33
01,000,02,011,0388,1049 ,969,15,984,1455,0,3,1,3,0,1,0,76.14,67.63 ,33.33
01,000,02,011,0389,1050 ,1002,9,1011,1470,0,3,1,3,0,1,0,76.14,68.78 ,33.33
01,000,02,011,0389,1051 ,997,6,1003,1441,0,3,1,3,0,1,0,76.14,69.60 ,33.33
01,000,02,011,0389,1052 ,999,12,1011,1515,0,3,1,3,0,1,0,76.14,66.73 ,33.33
01,000,02,011,0389,1053 ,1086,3,1089,1608,0,3,1,3,0,1,0,76.14,67.72 ,33.33
01,000,02,011,0390,1054 ,991,12,1003,1544,0,3,1,3,0,1,0,76.14,64.96 ,33.33
01,000,02,011,0390,1055 ,1166,16,1182,1820,0,3,1,3,0,1,0,76.14,64.95 ,33.33
01,000,02,011,0391,1056 ,1211,15,1226,1990,0,3,1,3,0,1,0,76.14,61.61 ,33.33
01,000,02,011,0391,1057 ,1231,7,1238,2097,0,3,1,3,0,1,0,76.14,59.04 ,33.33
01,000,02,011,0392,1058 ,952,7,959,1629,0,3,1,3,0,1,0,76.14,58.87 ,33.33
01,000,02,011,0392,1059 ,993,3,996,1603,0,3,1,3,0,1,0,76.14,62.13 ,33.33
01,000,02,011,0392,1060 ,989,7,996,1647,0,3,1,3,0,1,0,76.14,60.47 ,33.33
01,000,02,011,0393,1061 ,868,7,875,1415,0,3,1,3,0,1,0,76.14,61.84 ,33.33
01,000,02,011,0393,1062 ,1010,8,1018,1629,0,3,1,3,0,1,0,76.14,62.49 ,33.33
01,000,02,011,0393,1063 ,1133,7,1140,1817,0,3,1,3,0,1,0,76.14,62.74 ,33.33
01,000,02,011,0394,1064 ,1148,6,1154,1835,0,3,1,3,0,1,0,76.14,62.89 ,33.33
01,000,02,011,0394,1065 ,1165,7,1172,1939,0,3,1,3,0,1,0,76.14,60.44 ,33.33
01,000,02,011,0395,1066 ,1083,4,1087,1629,0,3,1,3,0,1,0,76.14,66.73 ,33.33
01,000,02,011,0395,1067 ,994,6,1000,1582,0,3,1,3,0,1,0,76.14,63.21 ,33.33
01,000,02,011,0395,1068 ,929,1,930,1519,0,3,1,3,0,1,0,76.14,61.22 ,33.33
01,000,02,011,0396,1069 ,1041,8,1049,1733,0,3,1,3,0,1,0,76.14,60.53 ,33.33
01,000,02,011,0396,1070 ,1053,9,1062,1665,0,3,1,3,0,1,0,76.14,63.78 ,33.33
01,000,02,011,0397,1071 ,842,9,851,1282,0,3,1,3,0,1,0,76.14,66.38 ,33.33
01,000,02,011,0397,1072 ,1321,8,1329,2050,0,3,1,3,0,1,0,76.14,64.83 ,33.33
01,000,02,011,0397,1073 ,1227,4,1231,1947,0,3,1,3,0,1,0,76.14,63.23 ,33.33
01,000,02,011,0398,1074 ,983,8,991,1568,0,3,1,3,0,1,0,76.14,63.20 ,33.33
01,000,02,011,0398,1075 ,1023,6,1029,1606,0,3,1,3,0,1,0,76.14,64.07 ,33.33
01,000,02,011,0398,1076 ,976,5,981,1542,0,3,1,3,0,1,0,76.14,63.62 ,33.33
01,000,02,011,0398,1077 ,917,4,921,1383,0,3,1,3,0,1,0,76.14,66.59 ,33.33
01,000,02,012,0399,1078 ,1350,19,1369,2092,0,3,1,3,0,1,0,76.14,65.44 ,33.33
01,000,02,012,0399,1079 ,1298,11,1309,1997,0,3,1,3,0,1,0,76.14,65.55 ,33.33
01,000,02,012,0400,1080 ,1138,14,1152,1764,0,3,1,3,0,1,0,76.14,65.31 ,33.33
01,000,02,012,0400,1081 ,1037,18,1055,1657,0,3,1,3,0,1,0,76.14,63.67 ,33.33
01,000,02,012,0400,1082 ,1054,4,1058,1652,0,3,1,3,0,1,0,76.14,64.04 ,33.33
01,000,02,012,0401,1083 ,1116,5,1121,1647,0,3,1,3,0,1,0,76.14,68.06 ,33.33
01,000,02,012,0401,1084 ,1143,11,1154,1730,0,3,1,3,0,1,0,76.14,66.71 ,33.33
01,000,02,012,0402,1085 ,1016,12,1028,1577,0,3,1,3,0,1,0,76.14,65.19 ,33.33
01,000,02,012,0402,1086 ,1093,12,1105,1666,0,3,1,3,0,1,0,76.14,66.33 ,33.33
01,000,02,012,0402,1087 ,1139,9,1148,1664,0,3,1,3,0,1,0,76.14,68.99 ,33.33
01,000,02,012,0403,1088 ,1263,13,1276,1876,0,3,1,3,0,1,0,76.14,68.02 ,33.33
01,000,02,012,0403,1089 ,1230,10,1240,1860,0,3,1,3,0,1,0,76.14,66.67 ,33.33
01,000,02,012,0404,1090 ,941,3,944,1477,0,3,1,3,0,1,0,76.14,63.91 ,33.33
01,000,02,012,0404,1091 ,947,8,955,1484,0,3,1,3,0,1,0,76.14,64.35 ,33.33
01,000,02,012,0404,1092 ,898,6,904,1381,0,3,1,3,0,1,0,76.14,65.46 ,33.33
01,000,02,012,0405,1093 ,1178,8,1186,1737,0,3,1,3,0,1,0,76.14,68.28 ,33.33
01,000,02,012,0405,1094 ,1286,7,1293,1889,0,3,1,3,0,1,0,76.14,68.45 ,33.33
01,000,02,012,0406,1095 ,1104,7,1111,1675,0,3,1,3,0,1,0,76.14,66.33 ,33.33
01,000,02,012,0406,1096 ,1192,9,1201,1782,0,3,1,3,0,1,0,76.14,67.40 ,33.33
01,000,02,012,0407,1097 ,1109,6,1115,1736,0,3,1,3,0,1,0,76.14,64.23 ,33.33
01,000,02,012,0407,1098 ,1060,1,1061,1583,0,3,1,3,0,1,0,76.14,67.02 ,33.33
01,000,02,012,0407,1099 ,1337,8,1345,1989,0,3,1,3,0,1,0,76.14,67.62 ,33.33
01,000,02,012,0408,1100 ,1404,14,1418,2190,0,3,1,3,0,1,0,76.14,64.75 ,33.33
01,000,02,012,0408,1101 ,1288,10,1298,1954,0,3,1,3,0,1,0,76.14,66.43 ,33.33
01,000,02,012,0409,1102 ,1015,6,1021,1476,0,3,1,3,0,1,0,76.14,69.17 ,33.33
01,000,02,012,0409,1103 ,966,15,981,1348,0,3,1,3,0,1,0,76.14,72.77 ,33.33
01,000,02,012,0410,1104 ,1217,10,1227,1908,0,3,1,3,0,1,0,76.14,64.31 ,33.33
01,000,02,012,0410,1105 ,1293,2,1295,1877,0,3,1,3,0,1,0,76.14,68.99 ,33.33
01,000,02,012,0411,1106 ,1304,22,1326,2005,0,3,1,3,0,1,0,76.14,66.13 ,33.33
01,000,02,012,0411,1107 ,1466,7,1473,2174,0,3,1,3,0,1,0,76.14,67.76 ,33.33
01,000,02,012,0411,1108 ,1716,20,1736,2522,0,3,1,3,0,1,0,76.14,68.83 ,33.33
01,000,02,012,0412,1109 ,1257,18,1275,2030,0,3,1,3,0,1,0,76.14,62.81 ,33.33
01,000,02,012,0412,1110 ,1196,7,1203,1814,0,3,1,3,0,1,0,76.14,66.32 ,33.33
01,000,02,012,0413,1111 ,851,9,860,1307,0,3,1,3,0,1,0,76.14,65.80 ,33.33
01,000,02,012,0413,1112 ,942,5,947,1368,0,3,1,3,0,1,0,76.14,69.23 ,33.33
01,000,02,012,0413,1113 ,1079,3,1082,1727,0,3,1,3,0,1,0,76.14,62.65 ,33.33
01,000,02,012,0414,1114 ,988,6,994,1535,0,3,1,3,0,1,0,76.14,64.76 ,33.33
01,000,02,012,0414,1115 ,1007,11,1018,1624,0,3,1,3,0,1,0,76.14,62.68 ,33.33
01,000,02,012,0414,1116 ,1101,10,1111,1716,0,3,1,3,0,1,0,76.14,64.74 ,33.33
01,000,02,012,0415,1117 ,991,10,1001,1602,0,3,1,3,0,1,0,76.14,62.48 ,33.33
01,000,02,012,0415,1118 ,971,6,977,1392,0,3,1,3,0,1,0,76.14,70.19 ,33.33
01,000,02,012,0415,1119 ,860,6,866,1346,0,3,1,3,0,1,0,76.14,64.34 ,33.33
01,000,02,012,0416,1120 ,1174,12,1186,1696,0,3,1,3,0,1,0,76.14,69.93 ,33.33
01,000,02,012,0416,1121 ,1045,9,1054,1544,0,3,1,3,0,1,0,76.14,68.26 ,33.33
01,000,02,012,0416,1122 ,992,5,997,1513,0,3,1,3,0,1,0,76.14,65.90 ,33.33
01,000,02,012,0417,1123 ,987,4,991,1435,0,3,1,3,0,1,0,76.14,69.06 ,33.33
01,000,02,012,0417,1124 ,991,6,997,1473,0,3,1,3,0,1,0,76.14,67.68 ,33.33
01,000,02,012,0417,1125 ,1054,8,1062,1557,0,3,1,3,0,1,0,76.14,68.21 ,33.33
01,000,02,012,0418,1126 ,948,11,959,1510,0,3,1,3,0,1,0,76.14,63.51 ,33.33
01,000,02,012,0418,1127 ,1014,11,1025,1637,0,3,1,3,0,1,0,76.14,62.61 ,33.33
01,000,02,012,0418,1128 ,1305,10,1315,1869,0,3,1,3,0,1,0,76.14,70.36 ,33.33
01,000,02,012,0419,1129 ,948,8,956,1509,0,3,1,3,0,1,0,76.14,63.35 ,33.33
01,000,02,012,0419,1130 ,959,10,969,1450,0,3,1,3,0,1,0,76.14,66.83 ,33.33
01,000,02,012,0420,1131 ,1056,13,1069,1629,0,3,1,3,0,1,0,76.14,65.62 ,33.33
01,000,02,012,0420,1132 ,1158,8,1166,1663,0,3,1,3,0,1,0,76.14,70.11 ,33.33
01,000,02,012,0420,1133 ,941,2,943,1406,0,3,1,3,0,1,0,76.14,67.07 ,33.33
01,000,02,012,0421,1134 ,981,10,991,1438,0,3,1,3,0,1,0,76.14,68.92 ,33.33
01,000,02,012,0421,1135 ,1152,5,1157,1727,0,3,1,3,0,1,0,76.14,66.99 ,33.33
01,000,02,012,0421,1136 ,1117,12,1129,1604,0,3,1,3,0,1,0,76.14,70.39 ,33.33
01,000,02,012,0422,1137 ,1272,6,1278,1935,0,3,1,3,0,1,0,76.14,66.05 ,33.33
01,000,02,012,0422,1138 ,1223,12,1235,1802,0,3,1,3,0,1,0,76.14,68.53 ,33.33
01,000,02,012,0422,1139 ,1271,10,1281,1971,0,3,1,3,0,1,0,76.14,64.99 ,33.33
01,000,02,012,0423,1140 ,981,29,1010,1740,0,3,1,3,0,1,0,76.14,58.05 ,33.33
01,000,02,012,0423,1141 ,1061,19,1080,1765,0,3,1,3,0,1,0,76.14,61.19 ,33.33
01,000,02,012,0424,1142 ,1224,13,1237,1969,0,3,1,3,0,1,0,76.14,62.82 ,33.33
01,000,02,012,0424,1143 ,1009,9,1018,1636,0,3,1,3,0,1,0,76.14,62.22 ,33.33
01,000,02,012,0424,1144 ,1255,10,1265,1873,0,3,1,3,0,1,0,76.14,67.54 ,33.33
01,000,02,012,0425,1145 ,1358,7,1365,1920,0,3,1,3,0,1,0,76.14,71.09 ,33.33
01,000,02,012,0425,1146 ,1236,14,1250,1848,0,3,1,3,0,1,0,76.14,67.64 ,33.33
01,000,02,012,0425,1147 ,1324,20,1344,2029,0,3,1,3,0,1,0,76.14,66.24 ,33.33
01,000,02,012,0426,1148 ,1197,21,1218,1873,0,3,1,3,0,1,0,76.14,65.03 ,33.33
01,000,02,012,0426,1149 ,1045,17,1062,1604,0,3,1,3,0,1,0,76.14,66.21 ,33.33
01,000,02,012,0426,1150 ,1163,7,1170,1744,0,3,1,3,0,1,0,76.14,67.09 ,33.33
01,000,02,012,0426,1151 ,998,6,1004,1580,0,3,1,3,0,1,0,76.14,63.54 ,33.33
01,000,02,012,0427,1152 ,1279,11,1290,1899,0,3,1,3,0,1,0,76.14,67.93 ,33.33
01,000,02,012,0427,1153 ,1542,14,1556,2222,0,3,1,3,0,1,0,76.14,70.03 ,33.33
01,000,02,012,0427,1154 ,1496,13,1509,2216,0,3,1,3,0,1,0,76.14,68.10 ,33.33
01,000,02,012,0427,1155 ,1102,15,1117,1710,0,3,1,3,0,1,0,76.14,65.32 ,33.33
01,000,02,012,0428,1156 ,1076,9,1085,1689,0,3,1,3,0,1,0,76.14,64.24 ,33.33
01,000,02,012,0428,1157 ,1041,14,1055,1583,0,3,1,3,0,1,0,76.14,66.65 ,33.33
01,000,02,012,0428,1158 ,1028,7,1035,1633,0,3,1,3,0,1,0,76.14,63.38 ,33.33
01,000,02,012,0428,1159 ,1055,9,1064,1603,0,3,1,3,0,1,0,76.14,66.38 ,33.33
01,000,02,012,0429,1160 ,1389,5,1394,2093,0,3,1,3,0,1,0,76.14,66.60 ,33.33
01,000,02,012,0429,1161 ,1426,15,1441,2225,0,3,1,3,0,1,0,76.14,64.76 ,33.33
01,000,02,012,0429,1162 ,1294,8,1302,1978,0,3,1,3,0,1,0,76.14,65.82 ,33.33
01,000,02,012,0429,1163 ,1553,4,1557,2216,0,3,1,3,0,1,0,76.14,70.26 ,33.33
01,000,02,012,0430,1164 ,1245,67,1312,1962,0,3,1,3,0,1,0,76.14,66.87 ,33.33
01,000,02,012,0430,1165 ,1206,18,1224,1833,0,3,1,3,0,1,0,76.14,66.78 ,33.33
01,000,02,012,0430,1166 ,1065,13,1078,1644,0,3,1,3,0,1,0,76.14,65.57 ,33.33
01,000,02,012,0430,1167 ,1216,20,1236,1800,0,3,1,3,0,1,0,76.14,68.67 ,33.33
01,000,02,012,0431,1168 ,1099,9,1108,1669,0,3,1,3,0,1,0,76.14,66.39 ,33.33
01,000,02,012,0431,1169 ,1316,10,1326,1979,0,3,1,3,0,1,0,76.14,67.00 ,33.33
01,000,02,012,0431,1170 ,1234,15,1249,1812,0,3,1,3,0,1,0,76.14,68.93 ,33.33
01,000,02,012,0431,1171 ,1122,8,1130,1742,0,3,1,3,0,1,0,76.14,64.87 ,33.33
01,000,02,012,0431,1172 ,1131,6,1137,1731,0,3,1,3,0,1,0,76.14,65.68 ,33.33
01,000,02,012,0431,1173 ,1077,10,1087,1642,0,3,1,3,0,1,0,76.14,66.20 ,33.33
01,000,02,012,0432,1174 ,861,11,872,1361,0,3,1,3,0,1,0,76.14,64.07 ,33.33
01,000,02,012,0432,1175 ,1128,13,1141,1750,0,3,1,3,0,1,0,76.14,65.20 ,33.33
01,000,02,012,0433,1176 ,1267,8,1275,1966,0,3,1,3,0,1,0,76.14,64.85 ,33.33
01,000,02,012,0433,1177 ,1282,19,1301,1942,0,3,1,3,0,1,0,76.14,66.99 ,33.33
01,000,02,012,0433,1178 ,1369,14,1383,2147,0,3,1,3,0,1,0,76.14,64.42 ,33.33
01,000,02,012,0433,1179 ,1076,2,1078,1555,0,3,1,3,0,1,0,76.14,69.32 ,33.33
01,000,02,012,0434,1180 ,1017,15,1032,1559,0,3,1,3,0,1,0,76.14,66.20 ,33.33
01,000,02,012,0434,1181 ,447,8,455,719,0,3,1,3,0,1,0,76.14,63.28 ,33.33
01,000,02,012,0435,1182 ,437,6,443,674,0,3,1,3,0,1,0,76.14,65.73 ,33.33
02,000,01,001,0001,1 ,817,7,824,1229,0,3,1,3,0,1,0,76.14,67.05 ,33.33
02,000,01,001,0002,2 ,409,2,411,577,0,3,1,3,0,1,0,76.14,71.23 ,33.33
02,000,01,001,0003,3 ,555,11,566,771,0,3,1,3,0,1,0,76.14,73.41 ,33.33
02,000,01,001,0004,4 ,873,5,878,1284,0,3,1,3,0,1,0,76.14,68.38 ,33.33
02,000,01,001,0005,5 ,783,3,786,1182,0,3,1,3,0,1,0,76.14,66.50 ,33.33
02,000,01,001,0006,6 ,1502,11,1513,2214,0,3,1,3,0,1,0,76.14,68.34 ,33.33
02,000,01,001,0007,7 ,607,5,612,876,0,3,1,3,0,1,0,76.14,69.86 ,33.33
02,000,01,001,0008,8 ,488,4,492,687,0,3,1,3,0,1,0,76.14,71.62 ,33.33
02,000,01,001,0009,9 ,738,9,747,1174,0,3,1,3,0,1,0,76.14,63.63 ,33.33
02,000,01,001,0010,10 ,516,3,519,810,0,3,1,3,0,1,0,76.14,64.07 ,33.33
02,000,01,001,0011,11 ,1196,17,1213,1899,0,3,1,3,0,1,0,76.14,63.88 ,33.33
02,000,01,001,0012,12 ,682,6,688,1074,0,3,1,3,0,1,0,76.14,64.06 ,33.33
02,000,01,001,0013,13 ,735,7,742,1151,0,3,1,3,0,1,0,76.14,64.47 ,33.33
02,000,01,001,0014,14 ,749,5,754,1144,0,3,1,3,0,1,0,76.14,65.91 ,33.33
02,000,01,001,0015,15 ,824,8,832,1225,0,3,1,3,0,1,0,76.14,67.92 ,33.33
02,000,01,001,0016,16 ,462,5,467,651,0,3,1,3,0,1,0,76.14,71.74 ,33.33
02,000,01,001,0017,17 ,1140,17,1157,1757,0,3,1,3,0,1,0,76.14,65.85 ,33.33
02,000,01,001,0018,18 ,862,16,878,1297,0,3,1,3,0,1,0,76.14,67.69 ,33.33
02,000,01,001,0019,19 ,491,4,495,705,0,3,1,3,0,1,0,76.14,70.21 ,33.33
02,000,01,001,0020,20 ,524,8,532,773,0,3,1,3,0,1,0,76.14,68.82 ,33.33
02,000,01,001,0021,21 ,616,11,627,938,0,3,1,3,0,1,0,76.14,66.84 ,33.33
02,000,01,002,0022,22 ,1371,16,1387,2040,0,3,1,3,0,1,0,76.14,67.99 ,33.33
02,000,01,002,0023,23 ,1402,19,1421,2065,0,3,1,3,0,1,0,76.14,68.81 ,33.33
02,000,01,002,0024,24 ,1497,18,1515,2138,0,3,1,3,0,1,0,76.14,70.86 ,33.33
02,000,01,002,0024,25 ,1441,11,1452,2051,0,3,1,3,0,1,0,76.14,70.79 ,33.33
02,000,01,002,0025,26 ,1250,11,1261,1877,0,3,1,3,0,1,0,76.14,67.18 ,33.33
02,000,01,002,0025,27 ,1402,8,1410,2059,0,3,1,3,0,1,0,76.14,68.48 ,33.33
02,000,01,002,0026,28 ,1004,13,1017,1450,0,3,1,3,0,1,0,76.14,70.14 ,33.33
02,000,01,002,0027,29 ,825,7,832,1185,0,3,1,3,0,1,0,76.14,70.21 ,33.33
02,000,01,002,0028,30 ,1437,12,1449,2044,0,3,1,3,0,1,0,76.14,70.89 ,33.33
02,000,01,002,0029,31 ,1374,12,1386,2086,0,3,1,3,0,1,0,76.14,66.44 ,33.33
02,000,01,002,0029,32 ,1236,14,1250,1826,0,3,1,3,0,1,0,76.14,68.46 ,33.33
02,000,01,002,0030,33 ,593,6,599,849,0,3,1,3,0,1,0,76.14,70.55 ,33.33
02,000,01,002,0031,34 ,1075,14,1089,1556,0,3,1,3,0,1,0,76.14,69.99 ,33.33
02,000,01,002,0032,35 ,1107,16,1123,1669,0,3,1,3,0,1,0,76.14,67.29 ,33.33
02,000,01,002,0033,36 ,1002,4,1006,1470,0,3,1,3,0,1,0,76.14,68.44 ,33.33
02,000,01,002,0033,37 ,1088,8,1096,1551,0,3,1,3,0,1,0,76.14,70.66 ,33.33
02,000,01,002,0034,38 ,1013,5,1018,1442,0,3,1,3,0,1,0,76.14,70.60 ,33.33
02,000,01,002,0034,39 ,927,13,940,1399,0,3,1,3,0,1,0,76.14,67.19 ,33.33
02,000,01,002,0035,40 ,1476,12,1488,2085,0,3,1,3,0,1,0,76.14,71.37 ,33.33
02,000,01,002,0036,41 ,1188,14,1202,1822,0,3,1,3,0,1,0,76.14,65.97 ,33.33
02,000,01,002,0036,42 ,949,10,959,1703,0,3,1,3,0,1,0,76.14,56.31 ,33.33
02,000,01,002,0036,43 ,921,9,930,1485,0,3,1,3,0,1,0,76.14,62.63 ,33.33
02,000,01,002,0037,44 ,610,4,614,972,0,3,1,3,0,1,0,76.14,63.17 ,33.33
02,000,01,002,0038,45 ,1166,18,1184,1789,0,3,1,3,0,1,0,76.14,66.18 ,33.33
02,000,01,002,0038,46 ,1128,8,1136,1710,0,3,1,3,0,1,0,76.14,66.43 ,33.33
02,000,01,002,0038,47 ,1147,9,1156,1793,0,3,1,3,0,1,0,76.14,64.47 ,33.33
02,000,01,002,0038,48 ,1083,11,1094,1723,0,3,1,3,0,1,0,76.14,63.49 ,33.33
02,000,01,002,0038,49 ,1299,7,1306,2152,0,3,1,3,0,1,0,76.14,60.69 ,33.33
02,000,01,002,0039,50 ,972,12,984,1385,0,3,1,3,0,1,0,76.14,71.05 ,33.33
02,000,01,002,0039,51 ,1145,10,1155,1731,0,3,1,3,0,1,0,76.14,66.72 ,33.33
02,000,01,002,0040,52 ,952,9,961,1496,0,3,1,3,0,1,0,76.14,64.24 ,33.33
02,000,01,002,0040,53 ,895,10,905,1342,0,3,1,3,0,1,0,76.14,67.44 ,33.33
02,000,01,002,0041,54 ,628,1,629,942,0,3,1,3,0,1,0,76.14,66.77 ,33.33
02,000,01,002,0041,55 ,847,3,850,1327,0,3,1,3,0,1,0,76.14,64.05 ,33.33
02,000,01,002,0042,56 ,1058,17,1075,1606,0,3,1,3,0,1,0,76.14,66.94 ,33.33
02,000,01,002,0043,57 ,664,6,670,963,0,3,1,3,0,1,0,76.14,69.57 ,33.33
02,000,01,002,0044,58 ,645,8,653,992,0,3,1,3,0,1,0,76.14,65.83 ,33.33
02,000,01,002,0045,59 ,1041,14,1055,1547,0,3,1,3,0,1,0,76.14,68.20 ,33.33
02,000,01,002,0046,60 ,1018,13,1031,1580,0,3,1,3,0,1,0,76.14,65.25 ,33.33
02,000,01,002,0047,61 ,1019,9,1028,1500,0,3,1,3,0,1,0,76.14,68.53 ,33.33
02,000,01,002,0048,62 ,1045,14,1059,1545,0,3,1,3,0,1,0,76.14,68.54 ,33.33
02,000,01,002,0049,63 ,1093,18,1111,1674,0,3,1,3,0,1,0,76.14,66.37 ,33.33
02,000,01,002,0050,64 ,563,4,567,839,0,3,1,3,0,1,0,76.14,67.58 ,33.33
02,000,01,002,0051,65 ,683,10,693,1083,0,3,1,3,0,1,0,76.14,63.99 ,33.33
02,000,01,002,0052,66 ,729,6,735,1165,0,3,1,3,0,1,0,76.14,63.09 ,33.33
02,000,01,002,0053,67 ,765,13,778,1162,0,3,1,3,0,1,0,76.14,66.95 ,33.33
02,000,01,002,0054,68 ,613,5,618,934,0,3,1,3,0,1,0,76.14,66.17 ,33.33
02,000,01,002,0055,69 ,973,17,990,1542,0,3,1,3,0,1,0,76.14,64.20 ,33.33
02,000,01,002,0056,70 ,843,6,849,1343,0,3,1,3,0,1,0,76.14,63.22 ,33.33
02,000,01,002,0057,71 ,955,15,970,1589,0,3,1,3,0,1,0,76.14,61.04 ,33.33
02,000,01,002,0058,72 ,803,8,811,1213,0,3,1,3,0,1,0,76.14,66.86 ,33.33
02,000,01,002,0059,73 ,427,4,431,638,0,3,1,3,0,1,0,76.14,67.55 ,33.33
02,000,01,003,0060,74 ,1098,13,1111,1676,0,3,1,3,0,1,0,76.14,66.29 ,33.33
02,000,01,003,0061,75 ,900,9,909,1271,0,3,1,3,0,1,0,76.14,71.52 ,33.33
02,000,01,003,0062,76 ,425,7,432,636,0,3,1,3,0,1,0,76.14,67.92 ,33.33
02,000,01,003,0063,77 ,503,2,505,707,0,3,1,3,0,1,0,76.14,71.43 ,33.33
02,000,01,003,0064,78 ,400,9,409,558,0,3,1,3,0,1,0,76.14,73.30 ,33.33
02,000,01,003,0065,79 ,680,9,689,939,0,3,1,3,0,1,0,76.14,73.38 ,33.33
02,000,01,003,0066,80 ,746,13,759,1048,0,3,1,3,0,1,0,76.14,72.42 ,33.33
02,000,01,003,0067,81 ,574,8,582,834,0,3,1,3,0,1,0,76.14,69.78 ,33.33
02,000,01,003,0068,82 ,777,10,787,1108,0,3,1,3,0,1,0,76.14,71.03 ,33.33
02,000,01,003,0068,83 ,1035,11,1046,1481,0,3,1,3,0,1,0,76.14,70.63 ,33.33
02,000,01,003,0069,84 ,219,4,223,392,0,3,1,3,0,1,0,76.14,56.89 ,33.33
02,000,01,003,0070,85 ,1020,10,1030,1480,0,3,1,3,0,1,0,76.14,69.59 ,33.33
02,000,01,003,0071,86 ,494,6,500,677,0,3,1,3,0,1,0,76.14,73.86 ,33.33
02,000,01,003,0072,87 ,754,13,767,1043,0,3,1,3,0,1,0,76.14,73.54 ,33.33
02,000,01,003,0072,88 ,613,7,620,907,0,3,1,3,0,1,0,76.14,68.36 ,33.33
02,000,01,003,0073,89 ,898,9,907,1273,0,3,1,3,0,1,0,76.14,71.25 ,33.33
02,000,01,003,0074,90 ,1159,10,1169,1680,0,3,1,3,0,1,0,76.14,69.58 ,33.33
02,000,01,003,0075,91 ,817,13,830,1219,0,3,1,3,0,1,0,76.14,68.09 ,33.33
02,000,01,003,0075,92 ,896,8,904,1346,0,3,1,3,0,1,0,76.14,67.16 ,33.33
02,000,01,003,0076,93 ,926,3,929,1327,0,3,1,3,0,1,0,76.14,70.01 ,33.33
02,000,01,003,0077,94 ,627,4,631,881,0,3,1,3,0,1,0,76.14,71.62 ,33.33
02,000,01,003,0077,95 ,679,5,684,946,0,3,1,3,0,1,0,76.14,72.30 ,33.33
02,000,01,003,0078,96 ,1036,14,1050,1471,0,3,1,3,0,1,0,76.14,71.38 ,33.33
02,000,01,003,0079,97 ,676,3,679,942,0,3,1,3,0,1,0,76.14,72.08 ,33.33
02,000,01,003,0080,98 ,869,7,876,1196,0,3,1,3,0,1,0,76.14,73.24 ,33.33
02,000,01,003,0081,99 ,667,8,675,980,0,3,1,3,0,1,0,76.14,68.88 ,33.33
02,000,01,003,0082,100 ,308,6,314,428,0,3,1,3,0,1,0,76.14,73.36 ,33.33
02,000,01,003,0083,101 ,401,5,406,580,0,3,1,3,0,1,0,76.14,70.00 ,33.33
02,000,01,003,0084,102 ,400,0,400,588,0,3,1,3,0,1,0,76.14,68.03 ,33.33
02,000,01,003,0085,103 ,555,1,556,803,0,3,1,3,0,1,0,76.14,69.24 ,33.33
02,000,01,003,0086,104 ,393,5,398,550,0,3,1,3,0,1,0,76.14,72.36 ,33.33
02,000,01,003,0087,105 ,569,2,571,789,0,3,1,3,0,1,0,76.14,72.37 ,33.33
02,000,01,003,0088,106 ,798,8,806,1129,0,3,1,3,0,1,0,76.14,71.39 ,33.33
02,000,01,003,0089,107 ,961,9,970,1457,0,3,1,3,0,1,0,76.14,66.58 ,33.33
02,000,01,003,0090,108 ,879,12,891,1271,0,3,1,3,0,1,0,76.14,70.10 ,33.33
02,000,01,003,0091,109 ,1032,10,1042,1474,0,3,1,3,0,1,0,76.14,70.69 ,33.33
02,000,01,003,0091,110 ,1391,14,1405,1832,0,3,1,3,0,1,0,76.14,76.69 ,33.33
02,000,01,003,0092,111 ,1247,19,1266,1723,0,3,1,3,0,1,0,76.14,73.48 ,33.33
02,000,01,003,0093,112 ,831,8,839,1116,0,3,1,3,0,1,0,76.14,75.18 ,33.33
02,000,01,003,0094,113 ,1023,8,1031,1423,0,3,1,3,0,1,0,76.14,72.45 ,33.33
02,000,01,003,0094,114 ,657,8,665,933,0,3,1,3,0,1,0,76.14,71.28 ,33.33
02,000,01,003,0095,115 ,1415,13,1428,1948,0,3,1,3,0,1,0,76.14,73.31 ,33.33
02,000,01,003,0096,116 ,1079,12,1091,1597,0,3,1,3,0,1,0,76.14,68.32 ,33.33
02,000,01,003,0097,117 ,1268,14,1282,1786,0,3,1,3,0,1,0,76.14,71.78 ,33.33
02,000,01,003,0098,118 ,1123,5,1128,1704,0,3,1,3,0,1,0,76.14,66.20 ,33.33
02,000,01,003,0098,119 ,1092,7,1099,1748,0,3,1,3,0,1,0,76.14,62.87 ,33.33
02,000,01,003,0098,120 ,938,7,945,1482,0,3,1,3,0,1,0,76.14,63.77 ,33.33
02,000,01,003,0098,121 ,1013,7,1020,1653,0,3,1,3,0,1,0,76.14,61.71 ,33.33
02,000,01,003,0098,122 ,1401,14,1415,2151,0,3,1,3,0,1,0,76.14,65.78 ,33.33
02,000,01,003,0099,123 ,817,5,822,1246,0,3,1,3,0,1,0,76.14,65.97 ,33.33
02,000,01,003,0099,124 ,922,16,938,1394,0,3,1,3,0,1,0,76.14,67.29 ,33.33
02,000,01,003,0099,125 ,1156,10,1166,1849,0,3,1,3,0,1,0,76.14,63.06 ,33.33
02,000,01,003,0099,126 ,1107,11,1118,1751,0,3,1,3,0,1,0,76.14,63.85 ,33.33
02,000,01,003,0099,127 ,902,10,912,1651,0,3,1,3,0,1,0,76.14,55.24 ,33.33
02,000,01,003,0099,128 ,970,3,973,1608,0,3,1,3,0,1,0,76.14,60.51 ,33.33
02,000,01,003,0099,129 ,1111,8,1119,1789,0,3,1,3,0,1,0,76.14,62.55 ,33.33
02,000,01,003,0099,130 ,1032,13,1045,1781,0,3,1,3,0,1,0,76.14,58.67 ,33.33
02,000,01,003,0099,131 ,1017,9,1026,1709,0,3,1,3,0,1,0,76.14,60.04 ,33.33
02,000,01,003,0099,132 ,1095,7,1102,1849,0,3,1,3,0,1,0,76.14,59.60 ,33.33
02,000,01,003,0100,133 ,1085,8,1093,1625,0,3,1,3,0,1,0,76.14,67.26 ,33.33
02,000,01,003,0100,134 ,846,8,854,1277,0,3,1,3,0,1,0,76.14,66.88 ,33.33
02,000,01,003,0100,135 ,932,11,943,1448,0,3,1,3,0,1,0,76.14,65.12 ,33.33
02,000,01,003,0101,136 ,1212,9,1221,1857,0,3,1,3,0,1,0,76.14,65.75 ,33.33
02,000,01,003,0101,137 ,1188,10,1198,1961,0,3,1,3,0,1,0,76.14,61.09 ,33.33
02,000,01,003,0101,138 ,1248,15,1263,1981,0,3,1,3,0,1,0,76.14,63.76 ,33.33
02,000,01,003,0101,139 ,1258,6,1264,1950,0,3,1,3,0,1,0,76.14,64.82 ,33.33
02,000,01,003,0102,140 ,1056,7,1063,1793,0,3,1,3,0,1,0,76.14,59.29 ,33.33
02,000,01,003,0102,141 ,989,6,995,1715,0,3,1,3,0,1,0,76.14,58.02 ,33.33
02,000,01,003,0102,142 ,1114,9,1123,1824,0,3,1,3,0,1,0,76.14,61.57 ,33.33
02,000,01,003,0102,143 ,1120,10,1130,1800,0,3,1,3,0,1,0,76.14,62.78 ,33.33
02,000,01,003,0102,144 ,1137,13,1150,1856,0,3,1,3,0,1,0,76.14,61.96 ,33.33
02,000,01,003,0102,145 ,1073,8,1081,1677,0,3,1,3,0,1,0,76.14,64.46 ,33.33
02,000,01,003,0102,146 ,1174,9,1183,1901,0,3,1,3,0,1,0,76.14,62.23 ,33.33
02,000,01,003,0102,147 ,1112,3,1115,1780,0,3,1,3,0,1,0,76.14,62.64 ,33.33
02,000,01,003,0103,148 ,803,4,807,1324,0,3,1,3,0,1,0,76.14,60.95 ,33.33
02,000,01,003,0103,149 ,886,16,902,1559,0,3,1,3,0,1,0,76.14,57.86 ,33.33
02,000,01,003,0103,150 ,956,10,966,1622,0,3,1,3,0,1,0,76.14,59.56 ,33.33
02,000,01,003,0103,151 ,1105,10,1115,1848,0,3,1,3,0,1,0,76.14,60.34 ,33.33
02,000,01,003,0103,152 ,1079,7,1086,1824,0,3,1,3,0,1,0,76.14,59.54 ,33.33
02,000,01,003,0103,153 ,1198,7,1205,2076,0,3,1,3,0,1,0,76.14,58.04 ,33.33
02,000,01,003,0103,154 ,1031,13,1044,1776,0,3,1,3,0,1,0,76.14,58.78 ,33.33
02,000,01,003,0103,155 ,1038,9,1047,1718,0,3,1,3,0,1,0,76.14,60.94 ,33.33
02,000,01,003,0103,156 ,1308,15,1323,2283,0,3,1,3,0,1,0,76.14,57.95 ,33.33
02,000,01,003,0103,157 ,580,4,584,930,0,3,1,3,0,1,0,76.14,62.80 ,33.33
02,000,01,004,0104,158 ,1115,15,1130,1698,0,3,1,3,0,1,0,76.14,66.55 ,33.33
02,000,01,004,0104,159 ,983,14,997,1632,0,3,1,3,0,1,0,76.14,61.09 ,33.33
02,000,01,004,0104,160 ,872,12,884,1501,0,3,1,3,0,1,0,76.14,58.89 ,33.33
02,000,01,004,0104,161 ,808,4,812,1374,0,3,1,3,0,1,0,76.14,59.10 ,33.33
02,000,01,004,0104,162 ,923,8,931,1484,0,3,1,3,0,1,0,76.14,62.74 ,33.33
02,000,01,004,0105,163 ,705,5,710,1130,0,3,1,3,0,1,0,76.14,62.83 ,33.33
02,000,01,004,0105,164 ,645,7,652,992,0,3,1,3,0,1,0,76.14,65.73 ,33.33
02,000,01,004,0106,165 ,776,3,779,1240,0,3,1,3,0,1,0,76.14,62.82 ,33.33
02,000,01,004,0106,166 ,752,14,766,1163,0,3,1,3,0,1,0,76.14,65.86 ,33.33
02,000,01,004,0106,167 ,956,16,972,1642,0,3,1,3,0,1,0,76.14,59.20 ,33.33
02,000,01,004,0107,168 ,856,9,865,1266,0,3,1,3,0,1,0,76.14,68.33 ,33.33
02,000,01,004,0107,169 ,772,5,777,1349,0,3,1,3,0,1,0,76.14,57.60 ,33.33
02,000,01,004,0108,170 ,893,11,904,1377,0,3,1,3,0,1,0,76.14,65.65 ,33.33
02,000,01,004,0108,171 ,762,6,768,1201,0,3,1,3,0,1,0,76.14,63.95 ,33.33
02,000,01,004,0109,172 ,684,11,695,1152,0,3,1,3,0,1,0,76.14,60.33 ,33.33
02,000,01,004,0109,173 ,742,11,753,1192,0,3,1,3,0,1,0,76.14,63.17 ,33.33
02,000,01,004,0110,174 ,1026,14,1040,1545,0,3,1,3,0,1,0,76.14,67.31 ,33.33
02,000,01,004,0110,175 ,1110,9,1119,1586,0,3,1,3,0,1,0,76.14,70.55 ,33.33
02,000,01,004,0111,176 ,641,8,649,1044,0,3,1,3,0,1,0,76.14,62.16 ,33.33
02,000,01,004,0111,177 ,866,11,877,1370,0,3,1,3,0,1,0,76.14,64.01 ,33.33
02,000,01,004,0112,178 ,1135,6,1141,1645,0,3,1,3,0,1,0,76.14,69.36 ,33.33
02,000,01,004,0112,179 ,1203,6,1209,1712,0,3,1,3,0,1,0,76.14,70.62 ,33.33
02,000,01,004,0113,180 ,1575,22,1597,2273,0,3,1,3,0,1,0,76.14,70.26 ,33.33
02,000,01,004,0114,181 ,1078,11,1089,1600,0,3,1,3,0,1,0,76.14,68.06 ,33.33
02,000,01,004,0114,182 ,1051,9,1060,1523,0,3,1,3,0,1,0,76.14,69.60 ,33.33
02,000,01,004,0115,183 ,1068,13,1081,1623,0,3,1,3,0,1,0,76.14,66.61 ,33.33
02,000,01,004,0116,184 ,980,15,995,1503,0,3,1,3,0,1,0,76.14,66.20 ,33.33
02,000,01,004,0116,185 ,1016,17,1033,1573,0,3,1,3,0,1,0,76.14,65.67 ,33.33
02,000,01,004,0117,186 ,1131,15,1146,1791,0,3,1,3,0,1,0,76.14,63.99 ,33.33
02,000,01,004,0117,187 ,1054,7,1061,1647,0,3,1,3,0,1,0,76.14,64.42 ,33.33
02,000,01,004,0117,188 ,994,9,1003,1600,0,3,1,3,0,1,0,76.14,62.69 ,33.33
02,000,01,004,0117,189 ,1078,10,1088,1802,0,3,1,3,0,1,0,76.14,60.38 ,33.33
02,000,01,004,0117,190 ,1112,10,1122,1748,0,3,1,3,0,1,0,76.14,64.19 ,33.33
02,000,01,004,0117,191 ,1301,9,1310,2050,0,3,1,3,0,1,0,76.14,63.90 ,33.33
02,000,01,004,0118,192 ,1171,9,1180,1673,0,3,1,3,0,1,0,76.14,70.53 ,33.33
02,000,01,004,0119,193 ,1039,10,1049,1473,0,3,1,3,0,1,0,76.14,71.22 ,33.33
02,000,01,004,0119,194 ,1044,11,1055,1414,0,3,1,3,0,1,0,76.14,74.61 ,33.33
02,000,01,004,0120,195 ,1384,13,1397,1833,0,3,1,3,0,1,0,76.14,76.21 ,33.33
02,000,01,004,0121,196 ,983,12,995,1391,0,3,1,3,0,1,0,76.14,71.53 ,33.33
02,000,01,004,0121,197 ,1095,12,1107,1592,0,3,1,3,0,1,0,76.14,69.54 ,33.33
02,000,01,004,0122,198 ,1326,19,1345,2148,0,3,1,3,0,1,0,76.14,62.62 ,33.33
02,000,01,004,0123,199 ,1376,15,1391,2034,0,3,1,3,0,1,0,76.14,68.39 ,33.33
02,000,01,004,0124,200 ,1286,12,1298,1795,0,3,1,3,0,1,0,76.14,72.31 ,33.33
02,000,01,004,0125,201 ,1043,4,1047,1461,0,3,1,3,0,1,0,76.14,71.66 ,33.33
02,000,01,004,0125,202 ,1320,6,1326,1961,0,3,1,3,0,1,0,76.14,67.62 ,33.33
02,000,01,004,0126,203 ,1018,9,1027,1526,0,3,1,3,0,1,0,76.14,67.30 ,33.33
02,000,01,004,0127,204 ,878,4,882,1263,0,3,1,3,0,1,0,76.14,69.83 ,33.33
02,000,01,004,0127,205 ,889,8,897,1387,0,3,1,3,0,1,0,76.14,64.67 ,33.33
02,000,01,004,0128,206 ,1515,16,1531,2256,0,3,1,3,0,1,0,76.14,67.86 ,33.33
02,000,01,004,0129,207 ,1355,10,1365,2125,0,3,1,3,0,1,0,76.14,64.24 ,33.33
02,000,01,004,0130,208 ,1483,12,1495,2097,0,3,1,3,0,1,0,76.14,71.29 ,33.33
02,000,01,004,0131,209 ,1127,3,1130,1576,0,3,1,3,0,1,0,76.14,71.70 ,33.33
02,000,01,004,0131,210 ,974,7,981,1444,0,3,1,3,0,1,0,76.14,67.94 ,33.33
02,000,01,004,0132,211 ,1108,13,1121,1628,0,3,1,3,0,1,0,76.14,68.86 ,33.33
02,000,01,004,0132,212 ,1088,16,1104,1578,0,3,1,3,0,1,0,76.14,69.96 ,33.33
02,000,01,004,0133,213 ,1267,19,1286,1945,0,3,1,3,0,1,0,76.14,66.12 ,33.33
02,000,01,004,0134,214 ,1637,17,1654,2454,0,3,1,3,0,1,0,76.14,67.40 ,33.33
02,000,01,004,0135,215 ,925,17,942,1429,0,3,1,3,0,1,0,76.14,65.92 ,33.33
02,000,01,004,0135,216 ,856,5,861,1357,0,3,1,3,0,1,0,76.14,63.45 ,33.33
02,000,01,004,0136,217 ,1243,13,1256,1800,0,3,1,3,0,1,0,76.14,69.78 ,33.33
02,000,01,004,0136,218 ,1177,11,1188,1794,0,3,1,3,0,1,0,76.14,66.22 ,33.33
02,000,01,004,0136,219 ,1135,7,1142,1728,0,3,1,3,0,1,0,76.14,66.09 ,33.33
02,000,01,004,0137,220 ,852,6,858,1329,0,3,1,3,0,1,0,76.14,64.56 ,33.33
02,000,01,004,0137,221 ,1136,9,1145,1810,0,3,1,3,0,1,0,76.14,63.26 ,33.33
02,000,01,004,0138,222 ,643,1,644,896,0,3,1,3,0,1,0,76.14,71.88 ,33.33
02,000,01,004,0139,223 ,550,3,553,834,0,3,1,3,0,1,0,76.14,66.31 ,33.33
02,000,01,004,0140,224 ,1023,4,1027,1460,0,3,1,3,0,1,0,76.14,70.34 ,33.33
02,000,01,005,0141,225 ,898,13,911,1457,0,3,1,3,0,1,0,76.14,62.53 ,33.33
02,000,01,005,0141,226 ,863,8,871,1463,0,3,1,3,0,1,0,76.14,59.54 ,33.33
02,000,01,005,0142,227 ,809,4,813,1285,0,3,1,3,0,1,0,76.14,63.27 ,33.33
02,000,01,005,0142,228 ,825,9,834,1235,0,3,1,3,0,1,0,76.14,67.53 ,33.33
02,000,01,005,0142,229 ,861,6,867,1358,0,3,1,3,0,1,0,76.14,63.84 ,33.33
02,000,01,005,0142,230 ,867,7,874,1359,0,3,1,3,0,1,0,76.14,64.31 ,33.33
02,000,01,005,0143,231 ,1172,9,1181,1795,0,3,1,3,0,1,0,76.14,65.79 ,33.33
02,000,01,005,0143,232 ,1004,8,1012,1554,0,3,1,3,0,1,0,76.14,65.12 ,33.33
02,000,01,005,0144,233 ,1019,4,1023,1551,0,3,1,3,0,1,0,76.14,65.96 ,33.33
02,000,01,005,0144,234 ,1102,10,1112,1714,0,3,1,3,0,1,0,76.14,64.88 ,33.33
02,000,01,005,0145,235 ,921,13,934,1491,0,3,1,3,0,1,0,76.14,62.64 ,33.33
02,000,01,005,0145,236 ,1020,8,1028,1589,0,3,1,3,0,1,0,76.14,64.69 ,33.33
02,000,01,005,0145,237 ,992,8,1000,1656,0,3,1,3,0,1,0,76.14,60.39 ,33.33
02,000,01,005,0146,238 ,1036,35,1071,1493,0,3,1,3,0,1,0,76.14,71.73 ,33.33
02,000,01,005,0146,239 ,1058,7,1065,1474,0,3,1,3,0,1,0,76.14,72.25 ,33.33
02,000,01,005,0147,240 ,1018,14,1032,1653,0,3,1,3,0,1,0,76.14,62.43 ,33.33
02,000,01,005,0147,241 ,925,11,936,1581,0,3,1,3,0,1,0,76.14,59.20 ,33.33
02,000,01,005,0147,242 ,1077,7,1084,1618,0,3,1,3,0,1,0,76.14,67.00 ,33.33
02,000,01,005,0147,243 ,977,10,987,1613,0,3,1,3,0,1,0,76.14,61.19 ,33.33
02,000,01,005,0147,244 ,1189,6,1195,1924,0,3,1,3,0,1,0,76.14,62.11 ,33.33
02,000,01,005,0147,245 ,984,6,990,1812,0,3,1,3,0,1,0,76.14,54.64 ,33.33
02,000,01,005,0147,246 ,1039,4,1043,1621,0,3,1,3,0,1,0,76.14,64.34 ,33.33
02,000,01,005,0147,247 ,1028,5,1033,1761,0,3,1,3,0,1,0,76.14,58.66 ,33.33
02,000,01,005,0147,248 ,965,5,970,1682,0,3,1,3,0,1,0,76.14,57.67 ,33.33
02,000,01,005,0148,249 ,1144,13,1157,1820,0,3,1,3,0,1,0,76.14,63.57 ,33.33
02,000,01,005,0148,250 ,1166,15,1181,1772,0,3,1,3,0,1,0,76.14,66.65 ,33.33
02,000,01,005,0148,251 ,1113,10,1123,1732,0,3,1,3,0,1,0,76.14,64.84 ,33.33
02,000,01,005,0148,252 ,1141,9,1150,1751,0,3,1,3,0,1,0,76.14,65.68 ,33.33
02,000,01,005,0149,253 ,1208,14,1222,1749,0,3,1,3,0,1,0,76.14,69.87 ,33.33
02,000,01,005,0149,254 ,1163,11,1174,1758,0,3,1,3,0,1,0,76.14,66.78 ,33.33
02,000,01,005,0149,255 ,1086,8,1094,1790,0,3,1,3,0,1,0,76.14,61.12 ,33.33
02,000,01,005,0150,256 ,710,9,719,1079,0,3,1,3,0,1,0,76.14,66.64 ,33.33
02,000,01,005,0150,257 ,624,9,633,923,0,3,1,3,0,1,0,76.14,68.58 ,33.33
02,000,01,005,0151,258 ,999,11,1010,1469,0,3,1,3,0,1,0,76.14,68.75 ,33.33
02,000,01,005,0152,259 ,897,6,903,1364,0,3,1,3,0,1,0,76.14,66.20 ,33.33
02,000,01,005,0152,260 ,910,9,919,1384,0,3,1,3,0,1,0,76.14,66.40 ,33.33
02,000,01,005,0152,261 ,897,9,906,1337,0,3,1,3,0,1,0,76.14,67.76 ,33.33
02,000,01,005,0153,262 ,690,3,693,1054,0,3,1,3,0,1,0,76.14,65.75 ,33.33
02,000,01,005,0153,263 ,770,6,776,1154,0,3,1,3,0,1,0,76.14,67.24 ,33.33
02,000,01,005,0153,264 ,818,12,830,1214,0,3,1,3,0,1,0,76.14,68.37 ,33.33
02,000,01,005,0154,265 ,833,8,841,1180,0,3,1,3,0,1,0,76.14,71.27 ,33.33
02,000,01,005,0154,266 ,812,9,821,1246,0,3,1,3,0,1,0,76.14,65.89 ,33.33
02,000,01,005,0154,267 ,908,8,916,1348,0,3,1,3,0,1,0,76.14,67.95 ,33.33
02,000,01,005,0155,268 ,988,5,993,1530,0,3,1,3,0,1,0,76.14,64.90 ,33.33
02,000,01,005,0155,269 ,876,15,891,1438,0,3,1,3,0,1,0,76.14,61.96 ,33.33
02,000,01,005,0155,270 ,1014,10,1024,1583,0,3,1,3,0,1,0,76.14,64.69 ,33.33
02,000,01,005,0155,271 ,861,6,867,1412,0,3,1,3,0,1,0,76.14,61.40 ,33.33
02,000,01,005,0156,272 ,1071,10,1081,1736,0,3,1,3,0,1,0,76.14,62.27 ,33.33
02,000,01,005,0156,273 ,1003,12,1015,1620,0,3,1,3,0,1,0,76.14,62.65 ,33.33
02,000,01,005,0157,274 ,804,7,811,1281,0,3,1,3,0,1,0,76.14,63.31 ,33.33
02,000,01,005,0157,275 ,951,9,960,1548,0,3,1,3,0,1,0,76.14,62.02 ,33.33
02,000,01,005,0157,276 ,967,12,979,1508,0,3,1,3,0,1,0,76.14,64.92 ,33.33
02,000,01,005,0158,277 ,826,8,834,1303,0,3,1,3,0,1,0,76.14,64.01 ,33.33
02,000,01,005,0158,278 ,734,9,743,1293,0,3,1,3,0,1,0,76.14,57.46 ,33.33
02,000,01,005,0159,279 ,801,3,804,1264,0,3,1,3,0,1,0,76.14,63.61 ,33.33
02,000,01,005,0159,280 ,818,9,827,1279,0,3,1,3,0,1,0,76.14,64.66 ,33.33
02,000,01,005,0159,281 ,810,8,818,1249,0,3,1,3,0,1,0,76.14,65.49 ,33.33
02,000,01,005,0159,282 ,766,7,773,1213,0,3,1,3,0,1,0,76.14,63.73 ,33.33
02,000,01,005,0160,283 ,859,3,862,1270,0,3,1,3,0,1,0,76.14,67.87 ,33.33
02,000,01,005,0160,284 ,937,6,943,1298,0,3,1,3,0,1,0,76.14,72.65 ,33.33
02,000,01,005,0161,285 ,857,10,867,1279,0,3,1,3,0,1,0,76.14,67.79 ,33.33
02,000,01,005,0161,286 ,875,5,880,1308,0,3,1,3,0,1,0,76.14,67.28 ,33.33
02,000,01,005,0162,287 ,912,5,917,1525,0,3,1,3,0,1,0,76.14,60.13 ,33.33
02,000,01,005,0162,288 ,890,6,896,1396,0,3,1,3,0,1,0,76.14,64.18 ,33.33
02,000,01,005,0162,289 ,881,8,889,1326,0,3,1,3,0,1,0,76.14,67.04 ,33.33
02,000,01,005,0162,290 ,878,13,891,1348,0,3,1,3,0,1,0,76.14,66.10 ,33.33
02,000,01,005,0163,291 ,846,11,857,1232,0,3,1,3,0,1,0,76.14,69.56 ,33.33
02,000,01,005,0163,292 ,796,4,800,1236,0,3,1,3,0,1,0,76.14,64.72 ,33.33
02,000,01,005,0164,293 ,749,8,757,1151,0,3,1,3,0,1,0,76.14,65.77 ,33.33
02,000,01,005,0164,294 ,727,6,733,1151,0,3,1,3,0,1,0,76.14,63.68 ,33.33
02,000,01,005,0165,295 ,691,7,698,1137,0,3,1,3,0,1,0,76.14,61.39 ,33.33
02,000,01,005,0165,296 ,772,6,778,1302,0,3,1,3,0,1,0,76.14,59.75 ,33.33
02,000,01,005,0165,297 ,795,6,801,1248,0,3,1,3,0,1,0,76.14,64.18 ,33.33
02,000,01,005,0166,298 ,774,7,781,1180,0,3,1,3,0,1,0,76.14,66.19 ,33.33
02,000,01,005,0166,299 ,826,7,833,1206,0,3,1,3,0,1,0,76.14,69.07 ,33.33
02,000,01,005,0166,300 ,875,3,878,1356,0,3,1,3,0,1,0,76.14,64.75 ,33.33
02,000,01,005,0167,301 ,1219,14,1233,1882,0,3,1,3,0,1,0,76.14,65.52 ,33.33
02,000,01,005,0167,302 ,1061,9,1070,1773,0,3,1,3,0,1,0,76.14,60.35 ,33.33
02,000,01,005,0167,303 ,1066,8,1074,1761,0,3,1,3,0,1,0,76.14,60.99 ,33.33
02,000,01,005,0168,304 ,931,15,946,1390,0,3,1,3,0,1,0,76.14,68.06 ,33.33
02,000,01,005,0168,305 ,830,17,847,1213,0,3,1,3,0,1,0,76.14,69.83 ,33.33
02,000,01,005,0168,306 ,747,10,757,1183,0,3,1,3,0,1,0,76.14,63.99 ,33.33
02,000,01,005,0169,307 ,868,9,877,1490,0,3,1,3,0,1,0,76.14,58.86 ,33.33
02,000,01,005,0169,308 ,878,9,887,1450,0,3,1,3,0,1,0,76.14,61.17 ,33.33
02,000,01,005,0169,309 ,971,16,987,1510,0,3,1,3,0,1,0,76.14,65.36 ,33.33
02,000,01,005,0170,310 ,896,6,902,1430,0,3,1,3,0,1,0,76.14,63.08 ,33.33
02,000,01,005,0170,311 ,921,5,926,1520,0,3,1,3,0,1,0,76.14,60.92 ,33.33
02,000,01,005,0170,312 ,958,11,969,1579,0,3,1,3,0,1,0,76.14,61.37 ,33.33
02,000,01,005,0170,313 ,913,6,919,1540,0,3,1,3,0,1,0,76.14,59.68 ,33.33
02,000,01,005,0171,314 ,865,6,871,1403,0,3,1,3,0,1,0,76.14,62.08 ,33.33
02,000,01,005,0171,315 ,827,3,830,1353,0,3,1,3,0,1,0,76.14,61.35 ,33.33
02,000,01,005,0172,316 ,830,10,840,1357,0,3,1,3,0,1,0,76.14,61.90 ,33.33
02,000,01,005,0172,317 ,824,10,834,1383,0,3,1,3,0,1,0,76.14,60.30 ,33.33
02,000,01,005,0173,318 ,900,7,907,1466,0,3,1,3,0,1,0,76.14,61.87 ,33.33
02,000,01,005,0173,319 ,780,13,793,1320,0,3,1,3,0,1,0,76.14,60.08 ,33.33
02,000,01,005,0173,320 ,786,9,795,1249,0,3,1,3,0,1,0,76.14,63.65 ,33.33
02,000,01,005,0174,321 ,691,2,693,1121,0,3,1,3,0,1,0,76.14,61.82 ,33.33
02,000,01,005,0174,322 ,827,8,835,1235,0,3,1,3,0,1,0,76.14,67.61 ,33.33
02,000,01,005,0175,323 ,653,12,665,965,0,3,1,3,0,1,0,76.14,68.91 ,33.33
02,000,01,005,0175,324 ,663,6,669,1041,0,3,1,3,0,1,0,76.14,64.27 ,33.33
02,000,01,005,0176,325 ,1052,12,1064,1681,0,3,1,3,0,1,0,76.14,63.30 ,33.33
02,000,01,005,0176,326 ,1071,10,1081,1602,0,3,1,3,0,1,0,76.14,67.48 ,33.33
02,000,01,005,0177,327 ,947,1,948,1421,0,3,1,3,0,1,0,76.14,66.71 ,33.33
02,000,01,005,0177,328 ,804,5,809,1420,0,3,1,3,0,1,0,76.14,56.97 ,33.33
02,000,01,005,0178,329 ,1071,12,1083,1742,0,3,1,3,0,1,0,76.14,62.17 ,33.33
02,000,01,005,0178,330 ,1171,12,1183,1820,0,3,1,3,0,1,0,76.14,65.00 ,33.33
02,000,01,005,0178,331 ,952,7,959,1636,0,3,1,3,0,1,0,76.14,58.62 ,33.33
02,000,01,005,0178,332 ,885,5,890,1483,0,3,1,3,0,1,0,76.14,60.01 ,33.33
02,000,01,005,0178,333 ,804,6,810,1366,0,3,1,3,0,1,0,76.14,59.30 ,33.33
02,000,01,005,0179,334 ,961,1,962,1550,0,3,1,3,0,1,0,76.14,62.06 ,33.33
02,000,01,005,0179,335 ,1066,7,1073,1600,0,3,1,3,0,1,0,76.14,67.06 ,33.33
02,000,01,005,0180,336 ,1013,12,1025,1545,0,3,1,3,0,1,0,76.14,66.34 ,33.33
02,000,01,005,0181,337 ,1048,8,1056,1597,0,3,1,3,0,1,0,76.14,66.12 ,33.33
02,000,01,005,0182,338 ,947,12,959,1492,0,3,1,3,0,1,0,76.14,64.28 ,33.33
02,000,01,005,0182,339 ,977,8,985,1538,0,3,1,3,0,1,0,76.14,64.04 ,33.33
02,000,01,005,0183,340 ,615,13,628,994,0,3,1,3,0,1,0,76.14,63.18 ,33.33
02,000,01,005,0183,341 ,657,12,669,1052,0,3,1,3,0,1,0,76.14,63.59 ,33.33
02,000,01,005,0184,342 ,714,4,718,1293,0,3,1,3,0,1,0,76.14,55.53 ,33.33
02,000,01,005,0184,343 ,694,5,699,1206,0,3,1,3,0,1,0,76.14,57.96 ,33.33
02,000,01,005,0184,344 ,854,7,861,1341,0,3,1,3,0,1,0,76.14,64.21 ,33.33
02,000,01,005,0185,345 ,834,5,839,1313,0,3,1,3,0,1,0,76.14,63.90 ,33.33
02,000,01,005,0185,346 ,821,8,829,1317,0,3,1,3,0,1,0,76.14,62.95 ,33.33
02,000,01,005,0185,347 ,801,7,808,1271,0,3,1,3,0,1,0,76.14,63.57 ,33.33
02,000,01,005,0186,348 ,1130,5,1135,1567,0,3,1,3,0,1,0,76.14,72.43 ,33.33
02,000,01,005,0186,349 ,1063,13,1076,1619,0,3,1,3,0,1,0,76.14,66.46 ,33.33
02,000,01,005,0187,350 ,922,7,929,1303,0,3,1,3,0,1,0,76.14,71.30 ,33.33
02,000,01,005,0187,351 ,908,7,915,1327,0,3,1,3,0,1,0,76.14,68.95 ,33.33
02,000,01,005,0188,352 ,1072,4,1076,1502,0,3,1,3,0,1,0,76.14,71.64 ,33.33
02,000,01,005,0189,353 ,1145,16,1161,1667,0,3,1,3,0,1,0,76.14,69.65 ,33.33
02,000,01,005,0190,354 ,994,6,1000,1436,0,3,1,3,0,1,0,76.14,69.64 ,33.33
02,000,01,005,0191,355 ,746,8,754,1065,0,3,1,3,0,1,0,76.14,70.80 ,33.33
02,000,01,005,0192,356 ,893,7,900,1423,0,3,1,3,0,1,0,76.14,63.25 ,33.33
02,000,01,005,0192,357 ,873,12,885,1386,0,3,1,3,0,1,0,76.14,63.85 ,33.33
02,000,01,005,0193,358 ,801,10,811,1198,0,3,1,3,0,1,0,76.14,67.70 ,33.33
02,000,01,005,0193,359 ,782,1,783,1231,0,3,1,3,0,1,0,76.14,63.61 ,33.33
02,000,01,005,0194,360 ,546,1,547,935,0,3,1,3,0,1,0,76.14,58.50 ,33.33
02,000,01,005,0194,361 ,599,6,605,972,0,3,1,3,0,1,0,76.14,62.24 ,33.33
02,000,01,005,0195,362 ,1170,12,1182,1716,0,3,1,3,0,1,0,76.14,68.88 ,33.33
02,000,01,005,0196,363 ,607,10,617,885,0,3,1,3,0,1,0,76.14,69.72 ,33.33
02,000,01,005,0197,364 ,761,7,768,1090,0,3,1,3,0,1,0,76.14,70.46 ,33.33
02,000,01,005,0198,365 ,554,7,561,783,0,3,1,3,0,1,0,76.14,71.65 ,33.33
02,000,01,005,0198,366 ,581,9,590,845,0,3,1,3,0,1,0,76.14,69.82 ,33.33
02,000,01,005,0199,367 ,707,7,714,1009,0,3,1,3,0,1,0,76.14,70.76 ,33.33
02,000,01,005,0199,368 ,746,4,750,1051,0,3,1,3,0,1,0,76.14,71.36 ,33.33
02,000,01,005,0200,369 ,1111,11,1122,1638,0,3,1,3,0,1,0,76.14,68.50 ,33.33
02,000,01,005,0200,370 ,1077,11,1088,1569,0,3,1,3,0,1,0,76.14,69.34 ,33.33
02,000,01,005,0201,371 ,877,16,893,1346,0,3,1,3,0,1,0,76.14,66.34 ,33.33
02,000,01,005,0201,372 ,774,7,781,1165,0,3,1,3,0,1,0,76.14,67.04 ,33.33
02,000,01,005,0201,373 ,893,9,902,1478,0,3,1,3,0,1,0,76.14,61.03 ,33.33
02,000,01,005,0202,374 ,681,7,688,1229,0,3,1,3,0,1,0,76.14,55.98 ,33.33
02,000,01,005,0202,375 ,903,5,908,1270,0,3,1,3,0,1,0,76.14,71.50 ,33.33
02,000,01,005,0202,376 ,745,4,749,1152,0,3,1,3,0,1,0,76.14,65.02 ,33.33
02,000,01,005,0203,377 ,1070,14,1084,1562,0,3,1,3,0,1,0,76.14,69.40 ,33.33
02,000,01,005,0204,378 ,552,4,556,819,0,3,1,3,0,1,0,76.14,67.89 ,33.33
02,000,01,005,0204,379 ,627,8,635,899,0,3,1,3,0,1,0,76.14,70.63 ,33.33
02,000,01,005,0205,380 ,617,4,621,963,0,3,1,3,0,1,0,76.14,64.49 ,33.33
02,000,01,005,0205,381 ,759,10,769,1117,0,3,1,3,0,1,0,76.14,68.85 ,33.33
02,000,01,005,0206,382 ,683,8,691,957,0,3,1,3,0,1,0,76.14,72.20 ,33.33
02,000,01,005,0207,383 ,735,21,756,1100,0,3,1,3,0,1,0,76.14,68.73 ,33.33
02,000,01,005,0208,384 ,811,4,815,1341,0,3,1,3,0,1,0,76.14,60.78 ,33.33
02,000,01,005,0209,385 ,892,9,901,1459,0,3,1,3,0,1,0,76.14,61.75 ,33.33
02,000,01,005,0210,386 ,526,14,540,850,0,3,1,3,0,1,0,76.14,63.53 ,33.33
02,000,01,005,0211,387 ,355,3,358,477,0,3,1,3,0,1,0,76.14,75.05 ,33.33
02,000,01,005,0212,388 ,760,8,768,1186,0,3,1,3,0,1,0,76.14,64.76 ,33.33
02,000,01,005,0213,389 ,849,7,856,1332,0,3,1,3,0,1,0,76.14,64.26 ,33.33
02,000,01,005,0213,390 ,844,14,858,1349,0,3,1,3,0,1,0,76.14,63.60 ,33.33
02,000,01,005,0213,391 ,801,4,805,1287,0,3,1,3,0,1,0,76.14,62.55 ,33.33
02,000,01,005,0214,392 ,812,7,819,1219,0,3,1,3,0,1,0,76.14,67.19 ,33.33
02,000,01,005,0215,393 ,600,6,606,1075,0,3,1,3,0,1,0,76.14,56.37 ,33.33
02,000,01,005,0216,394 ,1072,2,1074,1616,0,3,1,3,0,1,0,76.14,66.46 ,33.33
02,000,01,005,0217,395 ,818,6,824,1146,0,3,1,3,0,1,0,76.14,71.90 ,33.33
02,000,01,005,0218,396 ,691,6,697,983,0,3,1,3,0,1,0,76.14,70.91 ,33.33
02,000,01,005,0218,397 ,676,8,684,993,0,3,1,3,0,1,0,76.14,68.88 ,33.33
02,000,01,005,0219,398 ,836,18,854,1251,0,3,1,3,0,1,0,76.14,68.27 ,33.33
02,000,01,005,0220,399 ,297,4,301,443,0,3,1,3,0,1,0,76.14,67.95 ,33.33
02,000,01,005,0221,400 ,972,7,979,1409,0,3,1,3,0,1,0,76.14,69.48 ,33.33
02,000,01,005,0221,401 ,864,17,881,1273,0,3,1,3,0,1,0,76.14,69.21 ,33.33
02,000,01,005,0222,402 ,628,6,634,935,0,3,1,3,0,1,0,76.14,67.81 ,33.33
02,000,01,005,0222,403 ,630,11,641,922,0,3,1,3,0,1,0,76.14,69.52 ,33.33
02,000,01,005,0223,404 ,539,10,549,769,0,3,1,3,0,1,0,76.14,71.39 ,33.33
02,000,01,005,0224,405 ,884,2,886,1179,0,3,1,3,0,1,0,76.14,75.15 ,33.33
02,000,01,005,0225,406 ,817,9,826,1196,0,3,1,3,0,1,0,76.14,69.06 ,33.33
02,000,01,005,0226,407 ,879,9,888,1354,0,3,1,3,0,1,0,76.14,65.58 ,33.33
02,000,01,005,0227,408 ,871,6,877,1302,0,3,1,3,0,1,0,76.14,67.36 ,33.33
02,000,01,005,0228,409 ,789,10,799,1235,0,3,1,3,0,1,0,76.14,64.70 ,33.33
02,000,01,005,0228,410 ,790,6,796,1182,0,3,1,3,0,1,0,76.14,67.34 ,33.33
02,000,01,006,0229,411 ,848,5,853,1258,0,3,1,3,0,1,0,76.14,67.81 ,33.33
02,000,01,006,0230,412 ,691,12,703,1101,0,3,1,3,0,1,0,76.14,63.85 ,33.33
02,000,01,006,0231,413 ,1047,12,1059,1654,0,3,1,3,0,1,0,76.14,64.03 ,33.33
02,000,01,006,0232,414 ,695,13,708,1100,0,3,1,3,0,1,0,76.14,64.36 ,33.33
02,000,01,006,0232,415 ,588,13,601,952,0,3,1,3,0,1,0,76.14,63.13 ,33.33
02,000,01,006,0233,416 ,941,19,960,1428,0,3,1,3,0,1,0,76.14,67.23 ,33.33
02,000,01,006,0233,417 ,890,15,905,1388,0,3,1,3,0,1,0,76.14,65.20 ,33.33
02,000,01,006,0234,418 ,857,13,870,1221,0,3,1,3,0,1,0,76.14,71.25 ,33.33
02,000,01,006,0235,419 ,846,9,855,1370,0,3,1,3,0,1,0,76.14,62.41 ,33.33
02,000,01,006,0236,420 ,698,22,720,1124,0,3,1,3,0,1,0,76.14,64.06 ,33.33
02,000,01,006,0236,421 ,742,7,749,1162,0,3,1,3,0,1,0,76.14,64.46 ,33.33
02,000,01,006,0237,422 ,1073,15,1088,1685,0,3,1,3,0,1,0,76.14,64.57 ,33.33
02,000,01,006,0238,423 ,489,2,491,878,0,3,1,3,0,1,0,76.14,55.92 ,33.33
02,000,01,006,0238,424 ,909,10,919,1658,0,3,1,3,0,1,0,76.14,55.43 ,33.33
02,000,01,006,0239,425 ,1029,16,1045,1634,0,3,1,3,0,1,0,76.14,63.95 ,33.33
02,000,01,006,0240,426 ,554,7,561,1019,0,3,1,3,0,1,0,76.14,55.05 ,33.33
02,000,01,006,0241,427 ,680,5,685,1045,0,3,1,3,0,1,0,76.14,65.55 ,33.33
02,000,01,006,0241,428 ,690,4,694,1063,0,3,1,3,0,1,0,76.14,65.29 ,33.33
02,000,02,007,0242,429 ,727,8,735,1066,0,3,1,3,0,1,0,76.14,68.95 ,33.33
02,000,02,007,0242,430 ,594,7,601,853,0,3,1,3,0,1,0,76.14,70.46 ,33.33
02,000,02,007,0243,431 ,805,10,815,1295,0,3,1,3,0,1,0,76.14,62.93 ,33.33
02,000,02,007,0244,432 ,862,5,867,1407,0,3,1,3,0,1,0,76.14,61.62 ,33.33
02,000,02,007,0244,433 ,493,5,498,803,0,3,1,3,0,1,0,76.14,62.02 ,33.33
02,000,02,007,0245,434 ,819,7,826,1239,0,3,1,3,0,1,0,76.14,66.67 ,33.33
02,000,02,007,0246,435 ,1083,12,1095,1575,0,3,1,3,0,1,0,76.14,69.52 ,33.33
02,000,02,007,0247,436 ,503,8,511,747,0,3,1,3,0,1,0,76.14,68.41 ,33.33
02,000,02,007,0248,437 ,507,6,513,802,0,3,1,3,0,1,0,76.14,63.97 ,33.33
02,000,02,007,0249,438 ,1217,13,1230,1931,0,3,1,3,0,1,0,76.14,63.70 ,33.33
02,000,02,007,0250,439 ,716,4,720,1069,0,3,1,3,0,1,0,76.14,67.35 ,33.33
02,000,02,007,0251,440 ,503,4,507,746,0,3,1,3,0,1,0,76.14,67.96 ,33.33
02,000,02,007,0252,441 ,918,9,927,1449,0,3,1,3,0,1,0,76.14,63.98 ,33.33
02,000,02,007,0253,442 ,713,7,720,1076,0,3,1,3,0,1,0,76.14,66.91 ,33.33
02,000,02,007,0254,443 ,792,13,805,1180,0,3,1,3,0,1,0,76.14,68.22 ,33.33
02,000,02,007,0254,444 ,610,10,620,952,0,3,1,3,0,1,0,76.14,65.13 ,33.33
02,000,02,007,0255,445 ,827,6,833,1281,0,3,1,3,0,1,0,76.14,65.03 ,33.33
02,000,02,007,0255,446 ,737,5,742,1112,0,3,1,3,0,1,0,76.14,66.73 ,33.33
02,000,02,007,0256,447 ,763,2,765,1201,0,3,1,3,0,1,0,76.14,63.70 ,33.33
02,000,02,007,0256,448 ,824,4,828,1261,0,3,1,3,0,1,0,76.14,65.66 ,33.33
02,000,02,007,0257,449 ,1202,16,1218,1794,0,3,1,3,0,1,0,76.14,67.89 ,33.33
02,000,02,007,0258,450 ,925,10,935,1432,0,3,1,3,0,1,0,76.14,65.29 ,33.33
02,000,02,007,0258,451 ,1000,10,1010,1465,0,3,1,3,0,1,0,76.14,68.94 ,33.33
02,000,02,007,0259,452 ,773,9,782,1180,0,3,1,3,0,1,0,76.14,66.27 ,33.33
02,000,02,007,0260,453 ,714,3,717,1157,0,3,1,3,0,1,0,76.14,61.97 ,33.33
02,000,02,007,0261,454 ,577,6,583,952,0,3,1,3,0,1,0,76.14,61.24 ,33.33
02,000,02,007,0262,455 ,598,6,604,918,0,3,1,3,0,1,0,76.14,65.80 ,33.33
02,000,02,007,0263,456 ,691,10,701,1013,0,3,1,3,0,1,0,76.14,69.20 ,33.33
02,000,02,007,0263,457 ,781,7,788,1199,0,3,1,3,0,1,0,76.14,65.72 ,33.33
02,000,02,007,0264,458 ,626,11,637,1135,0,3,1,3,0,1,0,76.14,56.12 ,33.33
02,000,02,007,0264,459 ,808,6,814,1413,0,3,1,3,0,1,0,76.14,57.61 ,33.33
02,000,02,007,0265,460 ,572,7,579,868,0,3,1,3,0,1,0,76.14,66.71 ,33.33
02,000,02,007,0266,461 ,762,5,767,1173,0,3,1,3,0,1,0,76.14,65.39 ,33.33
02,000,02,007,0267,462 ,675,5,680,1018,0,3,1,3,0,1,0,76.14,66.80 ,33.33
02,000,02,007,0268,463 ,530,2,532,823,0,3,1,3,0,1,0,76.14,64.64 ,33.33
02,000,02,007,0269,464 ,577,10,587,873,0,3,1,3,0,1,0,76.14,67.24 ,33.33
02,000,02,007,0270,465 ,591,3,594,950,0,3,1,3,0,1,0,76.14,62.53 ,33.33
02,000,02,007,0271,466 ,598,4,602,884,0,3,1,3,0,1,0,76.14,68.10 ,33.33
02,000,02,007,0272,467 ,532,7,539,743,0,3,1,3,0,1,0,76.14,72.54 ,33.33
02,000,02,007,0273,468 ,983,11,994,1412,0,3,1,3,0,1,0,76.14,70.40 ,33.33
02,000,02,008,0274,469 ,565,3,568,835,0,3,1,3,0,1,0,76.14,68.02 ,33.33
02,000,02,008,0275,470 ,778,8,786,1194,0,3,1,3,0,1,0,76.14,65.83 ,33.33
02,000,02,008,0276,471 ,958,9,967,1478,0,3,1,3,0,1,0,76.14,65.43 ,33.33
02,000,02,008,0277,472 ,560,5,565,867,0,3,1,3,0,1,0,76.14,65.17 ,33.33
02,000,02,008,0278,473 ,567,7,574,930,0,3,1,3,0,1,0,76.14,61.72 ,33.33
02,000,02,008,0279,474 ,1161,15,1176,1730,0,3,1,3,0,1,0,76.14,67.98 ,33.33
02,000,02,008,0279,475 ,886,9,895,1422,0,3,1,3,0,1,0,76.14,62.94 ,33.33
02,000,02,008,0280,476 ,660,9,669,983,0,3,1,3,0,1,0,76.14,68.06 ,33.33
02,000,02,008,0281,477 ,683,4,687,1110,0,3,1,3,0,1,0,76.14,61.89 ,33.33
02,000,02,008,0282,478 ,876,7,883,1411,0,3,1,3,0,1,0,76.14,62.58 ,33.33
02,000,02,008,0283,479 ,456,3,459,741,0,3,1,3,0,1,0,76.14,61.94 ,33.33
02,000,02,008,0284,480 ,683,4,687,1031,0,3,1,3,0,1,0,76.14,66.63 ,33.33
02,000,02,008,0285,481 ,820,8,828,1217,0,3,1,3,0,1,0,76.14,68.04 ,33.33
02,000,02,008,0286,482 ,714,5,719,1091,0,3,1,3,0,1,0,76.14,65.90 ,33.33
02,000,02,008,0287,483 ,1161,10,1171,1693,0,3,1,3,0,1,0,76.14,69.17 ,33.33
02,000,02,008,0288,484 ,709,3,712,1051,0,3,1,3,0,1,0,76.14,67.75 ,33.33
02,000,02,008,0289,485 ,594,4,598,977,0,3,1,3,0,1,0,76.14,61.21 ,33.33
02,000,02,008,0290,486 ,993,11,1004,1614,0,3,1,3,0,1,0,76.14,62.21 ,33.33
02,000,02,008,0291,487 ,850,11,861,1292,0,3,1,3,0,1,0,76.14,66.64 ,33.33
02,000,02,008,0292,488 ,720,14,734,1101,0,3,1,3,0,1,0,76.14,66.67 ,33.33
02,000,02,008,0293,489 ,893,12,905,1370,0,3,1,3,0,1,0,76.14,66.06 ,33.33
02,000,02,009,0294,490 ,418,9,427,638,0,3,1,3,0,1,0,76.14,66.93 ,33.33
02,000,02,009,0295,491 ,929,8,937,1413,0,3,1,3,0,1,0,76.14,66.31 ,33.33
02,000,02,009,0296,492 ,948,14,962,1414,0,3,1,3,0,1,0,76.14,68.03 ,33.33
02,000,02,009,0297,493 ,1113,11,1124,1630,0,3,1,3,0,1,0,76.14,68.96 ,33.33
02,000,02,009,0298,494 ,924,9,933,1409,0,3,1,3,0,1,0,76.14,66.22 ,33.33
02,000,02,009,0299,495 ,975,13,988,1510,0,3,1,3,0,1,0,76.14,65.43 ,33.33
02,000,02,009,0300,496 ,938,5,943,1474,0,3,1,3,0,1,0,76.14,63.98 ,33.33
02,000,02,009,0301,497 ,473,5,478,678,0,3,1,3,0,1,0,76.14,70.50 ,33.33
02,000,02,009,0302,498 ,1037,8,1045,1636,0,3,1,3,0,1,0,76.14,63.88 ,33.33
02,000,02,009,0303,499 ,1346,11,1357,2318,0,3,1,3,0,1,0,76.14,58.54 ,33.33
02,000,02,009,0304,500 ,812,9,821,1215,0,3,1,3,0,1,0,76.14,67.57 ,33.33
02,000,02,009,0305,501 ,1041,14,1055,1477,0,3,1,3,0,1,0,76.14,71.43 ,33.33
02,000,02,009,0306,502 ,647,12,659,1023,0,3,1,3,0,1,0,76.14,64.42 ,33.33
02,000,02,009,0306,503 ,537,4,541,897,0,3,1,3,0,1,0,76.14,60.31 ,33.33
02,000,02,009,0307,504 ,1117,12,1129,1753,0,3,1,3,0,1,0,76.14,64.40 ,33.33
02,000,02,009,0308,505 ,1321,21,1342,1939,0,3,1,3,0,1,0,76.14,69.21 ,33.33
02,000,02,009,0309,506 ,800,7,807,1283,0,3,1,3,0,1,0,76.14,62.90 ,33.33
02,000,02,009,0310,507 ,950,11,961,1530,0,3,1,3,0,1,0,76.14,62.81 ,33.33
02,000,02,009,0310,508 ,868,8,876,1403,0,3,1,3,0,1,0,76.14,62.44 ,33.33
02,000,02,009,0311,509 ,772,11,783,1179,0,3,1,3,0,1,0,76.14,66.41 ,33.33
02,000,02,009,0311,510 ,751,9,760,1155,0,3,1,3,0,1,0,76.14,65.80 ,33.33
02,000,02,009,0312,511 ,888,9,897,1299,0,3,1,3,0,1,0,76.14,69.05 ,33.33
02,000,02,009,0312,512 ,833,7,840,1311,0,3,1,3,0,1,0,76.14,64.07 ,33.33
02,000,02,009,0313,513 ,1448,10,1458,2174,0,3,1,3,0,1,0,76.14,67.07 ,33.33
02,000,02,009,0314,514 ,670,7,677,1202,0,3,1,3,0,1,0,76.14,56.32 ,33.33
02,000,02,009,0315,515 ,893,5,898,1392,0,3,1,3,0,1,0,76.14,64.51 ,33.33
02,000,02,009,0315,516 ,884,12,896,1380,0,3,1,3,0,1,0,76.14,64.93 ,33.33
02,000,02,009,0316,517 ,1045,12,1057,1715,0,3,1,3,0,1,0,76.14,61.63 ,33.33
02,000,02,009,0317,518 ,730,7,737,1144,0,3,1,3,0,1,0,76.14,64.42 ,33.33
02,000,02,009,0317,519 ,564,6,570,866,0,3,1,3,0,1,0,76.14,65.82 ,33.33
02,000,02,009,0318,520 ,1023,7,1030,1528,0,3,1,3,0,1,0,76.14,67.41 ,33.33
02,000,02,009,0319,521 ,545,7,552,805,0,3,1,3,0,1,0,76.14,68.57 ,33.33
02,000,02,009,0320,522 ,929,18,947,1457,0,3,1,3,0,1,0,76.14,65.00 ,33.33
02,000,02,009,0321,523 ,1015,11,1026,1561,0,3,1,3,0,1,0,76.14,65.73 ,33.33
02,000,02,009,0321,524 ,911,7,918,1442,0,3,1,3,0,1,0,76.14,63.66 ,33.33
02,000,02,009,0322,525 ,1193,6,1199,1864,0,3,1,3,0,1,0,76.14,64.32 ,33.33
02,000,02,009,0323,526 ,1227,20,1247,1882,0,3,1,3,0,1,0,76.14,66.26 ,33.33
02,000,02,009,0323,527 ,920,11,931,1370,0,3,1,3,0,1,0,76.14,67.96 ,33.33
02,000,02,009,0324,528 ,1150,17,1167,1785,0,3,1,3,0,1,0,76.14,65.38 ,33.33
02,000,02,009,0325,529 ,930,10,940,1499,0,3,1,3,0,1,0,76.14,62.71 ,33.33
02,000,02,009,0325,530 ,801,5,806,1285,0,3,1,3,0,1,0,76.14,62.72 ,33.33
02,000,02,009,0326,531 ,743,6,749,1203,0,3,1,3,0,1,0,76.14,62.26 ,33.33
02,000,02,009,0326,532 ,832,4,836,1299,0,3,1,3,0,1,0,76.14,64.36 ,33.33
02,000,02,009,0327,533 ,869,9,878,1388,0,3,1,3,0,1,0,76.14,63.26 ,33.33
02,000,02,009,0328,534 ,1075,7,1082,1603,0,3,1,3,0,1,0,76.14,67.50 ,33.33
02,000,02,009,0329,535 ,1380,13,1393,1953,0,3,1,3,0,1,0,76.14,71.33 ,33.33
02,000,02,009,0330,536 ,560,6,566,880,0,3,1,3,0,1,0,76.14,64.32 ,33.33
02,000,02,009,0330,537 ,887,10,897,1375,0,3,1,3,0,1,0,76.14,65.24 ,33.33
02,000,02,009,0331,538 ,565,6,571,807,0,3,1,3,0,1,0,76.14,70.76 ,33.33
02,000,02,009,0331,539 ,607,6,613,859,0,3,1,3,0,1,0,76.14,71.36 ,33.33
02,000,02,009,0332,540 ,1057,15,1072,1536,0,3,1,3,0,1,0,76.14,69.79 ,33.33
02,000,02,009,0333,541 ,762,11,773,1112,0,3,1,3,0,1,0,76.14,69.51 ,33.33
02,000,02,009,0333,542 ,814,9,823,1167,0,3,1,3,0,1,0,76.14,70.52 ,33.33
02,000,02,009,0334,543 ,557,5,562,857,0,3,1,3,0,1,0,76.14,65.58 ,33.33
02,000,02,009,0334,544 ,697,15,712,1066,0,3,1,3,0,1,0,76.14,66.79 ,33.33
02,000,02,009,0335,545 ,1131,8,1139,1811,0,3,1,3,0,1,0,76.14,62.89 ,33.33
02,000,02,009,0335,546 ,1248,11,1259,1938,0,3,1,3,0,1,0,76.14,64.96 ,33.33
02,000,02,009,0336,547 ,601,23,624,941,0,3,1,3,0,1,0,76.14,66.31 ,33.33
02,000,02,009,0336,548 ,524,5,529,829,0,3,1,3,0,1,0,76.14,63.81 ,33.33
02,000,02,009,0337,549 ,925,8,933,1328,0,3,1,3,0,1,0,76.14,70.26 ,33.33
02,000,02,009,0338,550 ,1249,9,1258,1883,0,3,1,3,0,1,0,76.14,66.81 ,33.33
02,000,02,009,0338,551 ,1241,17,1258,1984,0,3,1,3,0,1,0,76.14,63.41 ,33.33
02,000,02,009,0339,552 ,600,5,605,974,0,3,1,3,0,1,0,76.14,62.11 ,33.33
02,000,02,009,0339,553 ,695,7,702,1042,0,3,1,3,0,1,0,76.14,67.37 ,33.33
02,000,02,009,0340,554 ,1173,8,1181,1735,0,3,1,3,0,1,0,76.14,68.07 ,33.33
02,000,02,009,0341,555 ,970,13,983,1514,0,3,1,3,0,1,0,76.14,64.93 ,33.33
02,000,02,009,0342,556 ,966,12,978,1481,0,3,1,3,0,1,0,76.14,66.04 ,33.33
02,000,02,009,0342,557 ,869,10,879,1270,0,3,1,3,0,1,0,76.14,69.21 ,33.33
02,000,02,009,0343,558 ,907,8,915,1328,0,3,1,3,0,1,0,76.14,68.90 ,33.33
02,000,02,009,0344,559 ,683,5,688,1031,0,3,1,3,0,1,0,76.14,66.73 ,33.33
02,000,02,009,0345,560 ,1316,12,1328,1964,0,3,1,3,0,1,0,76.14,67.62 ,33.33
02,000,02,009,0346,561 ,663,25,688,966,0,3,1,3,0,1,0,76.14,71.22 ,33.33
02,000,02,009,0346,562 ,855,16,871,1202,0,3,1,3,0,1,0,76.14,72.46 ,33.33
02,000,02,009,0347,563 ,1040,17,1057,1390,0,3,1,3,0,1,0,76.14,76.04 ,33.33
02,000,02,009,0347,564 ,1000,12,1012,1510,0,3,1,3,0,1,0,76.14,67.02 ,33.33
02,000,02,009,0348,565 ,1022,14,1036,1387,0,3,1,3,0,1,0,76.14,74.69 ,33.33
02,000,02,009,0348,566 ,1000,14,1014,1462,0,3,1,3,0,1,0,76.14,69.36 ,33.33
02,000,02,009,0349,567 ,847,15,862,1162,0,3,1,3,0,1,0,76.14,74.18 ,33.33
02,000,02,009,0349,568 ,810,7,817,1336,0,3,1,3,0,1,0,76.14,61.15 ,33.33
02,000,02,009,0350,569 ,795,12,807,1184,0,3,1,3,0,1,0,76.14,68.16 ,33.33
02,000,02,009,0350,570 ,691,17,708,1051,0,3,1,3,0,1,0,76.14,67.36 ,33.33
02,000,02,009,0351,571 ,747,10,757,1108,0,3,1,3,0,1,0,76.14,68.32 ,33.33
02,000,02,009,0351,572 ,775,12,787,1255,0,3,1,3,0,1,0,76.14,62.71 ,33.33
02,000,02,009,0352,573 ,1096,13,1109,1697,0,3,1,3,0,1,0,76.14,65.35 ,33.33
02,000,02,009,0353,574 ,924,11,935,1422,0,3,1,3,0,1,0,76.14,65.75 ,33.33
02,000,02,009,0353,575 ,700,8,708,1076,0,3,1,3,0,1,0,76.14,65.80 ,33.33
02,000,02,009,0354,576 ,1213,16,1229,1972,0,3,1,3,0,1,0,76.14,62.32 ,33.33
02,000,02,009,0354,577 ,1322,16,1338,2253,0,3,1,3,0,1,0,76.14,59.39 ,33.33
02,000,02,009,0355,578 ,851,9,860,1268,0,3,1,3,0,1,0,76.14,67.82 ,33.33
02,000,02,009,0355,579 ,797,8,805,1282,0,3,1,3,0,1,0,76.14,62.79 ,33.33
02,000,02,009,0355,580 ,799,8,807,1289,0,3,1,3,0,1,0,76.14,62.61 ,33.33
02,000,02,009,0356,581 ,1108,16,1124,1721,0,3,1,3,0,1,0,76.14,65.31 ,33.33
02,000,02,009,0356,582 ,1144,9,1153,1750,0,3,1,3,0,1,0,76.14,65.89 ,33.33
02,000,02,009,0357,583 ,1337,13,1350,2007,0,3,1,3,0,1,0,76.14,67.26 ,33.33
02,000,02,009,0357,584 ,1247,22,1269,1939,0,3,1,3,0,1,0,76.14,65.45 ,33.33
02,000,02,009,0358,585 ,716,11,727,1104,0,3,1,3,0,1,0,76.14,65.85 ,33.33
02,000,02,009,0358,586 ,718,10,728,1064,0,3,1,3,0,1,0,76.14,68.42 ,33.33
02,000,02,009,0359,587 ,831,13,844,1286,0,3,1,3,0,1,0,76.14,65.63 ,33.33
02,000,02,009,0359,588 ,707,8,715,1049,0,3,1,3,0,1,0,76.14,68.16 ,33.33
02,000,02,009,0360,589 ,834,16,850,1181,0,3,1,3,0,1,0,76.14,71.97 ,33.33
02,000,02,009,0360,590 ,814,7,821,1240,0,3,1,3,0,1,0,76.14,66.21 ,33.33
02,000,02,009,0360,591 ,915,9,924,1379,0,3,1,3,0,1,0,76.14,67.01 ,33.33
02,000,02,009,0361,592 ,1311,28,1339,1956,0,3,1,3,0,1,0,76.14,68.46 ,33.33
02,000,02,009,0362,593 ,726,8,734,1068,0,3,1,3,0,1,0,76.14,68.73 ,33.33
02,000,02,009,0362,594 ,684,6,690,1037,0,3,1,3,0,1,0,76.14,66.54 ,33.33
02,000,02,010,0363,595 ,871,9,880,1275,0,3,1,3,0,1,0,76.14,69.02 ,33.33
02,000,02,010,0363,596 ,816,15,831,1197,0,3,1,3,0,1,0,76.14,69.42 ,33.33
02,000,02,010,0363,597 ,1201,9,1210,1886,0,3,1,3,0,1,0,76.14,64.16 ,33.33
02,000,02,010,0363,598 ,1005,6,1011,1692,0,3,1,3,0,1,0,76.14,59.75 ,33.33
02,000,02,010,0363,599 ,1081,8,1089,1792,0,3,1,3,0,1,0,76.14,60.77 ,33.33
02,000,02,010,0364,600 ,940,14,954,1461,0,3,1,3,0,1,0,76.14,65.30 ,33.33
02,000,02,010,0364,601 ,567,6,573,899,0,3,1,3,0,1,0,76.14,63.74 ,33.33
02,000,02,010,0365,602 ,1064,13,1077,1611,0,3,1,3,0,1,0,76.14,66.85 ,33.33
02,000,02,010,0365,603 ,1043,11,1054,1588,0,3,1,3,0,1,0,76.14,66.37 ,33.33
02,000,02,010,0366,604 ,737,10,747,999,0,3,1,3,0,1,0,76.14,74.77 ,33.33
02,000,02,010,0366,605 ,535,7,542,766,0,3,1,3,0,1,0,76.14,70.76 ,33.33
02,000,02,010,0367,606 ,994,16,1010,1462,0,3,1,3,0,1,0,76.14,69.08 ,33.33
02,000,02,010,0368,607 ,1249,16,1265,1925,0,3,1,3,0,1,0,76.14,65.71 ,33.33
02,000,02,010,0369,608 ,1104,8,1112,1837,0,3,1,3,0,1,0,76.14,60.53 ,33.33
02,000,02,010,0370,609 ,491,8,499,767,0,3,1,3,0,1,0,76.14,65.06 ,33.33
02,000,02,010,0371,610 ,1196,15,1211,1787,0,3,1,3,0,1,0,76.14,67.77 ,33.33
02,000,02,010,0372,611 ,1164,18,1182,1628,0,3,1,3,0,1,0,76.14,72.60 ,33.33
02,000,02,010,0373,612 ,730,10,740,1074,0,3,1,3,0,1,0,76.14,68.90 ,33.33
02,000,02,010,0373,613 ,936,5,941,1395,0,3,1,3,0,1,0,76.14,67.46 ,33.33
02,000,02,010,0374,614 ,904,10,914,1323,0,3,1,3,0,1,0,76.14,69.09 ,33.33
02,000,02,010,0375,615 ,522,3,525,716,0,3,1,3,0,1,0,76.14,73.32 ,33.33
02,000,02,010,0376,616 ,613,9,622,943,0,3,1,3,0,1,0,76.14,65.96 ,33.33
02,000,02,010,0377,617 ,1099,17,1116,1561,0,3,1,3,0,1,0,76.14,71.49 ,33.33
02,000,02,010,0378,618 ,1390,21,1411,1884,0,3,1,3,0,1,0,76.14,74.89 ,33.33
02,000,02,010,0379,619 ,892,15,907,1311,0,3,1,3,0,1,0,76.14,69.18 ,33.33
02,000,02,010,0379,620 ,696,12,708,1093,0,3,1,3,0,1,0,76.14,64.78 ,33.33
02,000,02,010,0380,621 ,833,13,846,1207,0,3,1,3,0,1,0,76.14,70.09 ,33.33
02,000,02,010,0380,622 ,615,8,623,833,0,3,1,3,0,1,0,76.14,74.79 ,33.33
02,000,02,010,0381,623 ,769,13,782,1158,0,3,1,3,0,1,0,76.14,67.53 ,33.33
02,000,02,010,0381,624 ,790,5,795,1231,0,3,1,3,0,1,0,76.14,64.58 ,33.33
02,000,02,010,0381,625 ,870,8,878,1352,0,3,1,3,0,1,0,76.14,64.94 ,33.33
02,000,02,010,0382,626 ,797,13,810,1165,0,3,1,3,0,1,0,76.14,69.53 ,33.33
02,000,02,010,0383,627 ,1230,25,1255,1861,0,3,1,3,0,1,0,76.14,67.44 ,33.33
02,000,02,010,0384,628 ,585,5,590,844,0,3,1,3,0,1,0,76.14,69.91 ,33.33
02,000,02,010,0385,629 ,757,6,763,1028,0,3,1,3,0,1,0,76.14,74.22 ,33.33
02,000,02,010,0386,630 ,911,16,927,1205,0,3,1,3,0,1,0,76.14,76.93 ,33.33
02,000,02,010,0386,631 ,1073,12,1085,1426,0,3,1,3,0,1,0,76.14,76.09 ,33.33
02,000,02,010,0387,632 ,927,10,937,1218,0,3,1,3,0,1,0,76.14,76.93 ,33.33
02,000,02,010,0387,633 ,617,6,623,820,0,3,1,3,0,1,0,76.14,75.98 ,33.33
02,000,02,010,0388,634 ,1078,17,1095,1643,0,3,1,3,0,1,0,76.14,66.65 ,33.33
02,000,02,010,0388,635 ,1095,4,1099,1600,0,3,1,3,0,1,0,76.14,68.69 ,33.33
02,000,02,010,0389,636 ,1247,6,1253,1648,0,3,1,3,0,1,0,76.14,76.03 ,33.33
02,000,02,010,0389,637 ,1233,13,1246,1948,0,3,1,3,0,1,0,76.14,63.96 ,33.33
02,000,02,010,0390,638 ,597,9,606,855,0,3,1,3,0,1,0,76.14,70.88 ,33.33
02,000,02,010,0391,639 ,1554,18,1572,2130,0,3,1,3,0,1,0,76.14,73.80 ,33.33
02,000,02,010,0392,640 ,803,5,808,1213,0,3,1,3,0,1,0,76.14,66.61 ,33.33
02,000,02,010,0392,641 ,816,8,824,1334,0,3,1,3,0,1,0,76.14,61.77 ,33.33
02,000,02,010,0393,642 ,1386,10,1396,2053,0,3,1,3,0,1,0,76.14,68.00 ,33.33
02,000,02,010,0394,643 ,715,6,721,1252,0,3,1,3,0,1,0,76.14,57.59 ,33.33
02,000,02,010,0394,644 ,660,7,667,1152,0,3,1,3,0,1,0,76.14,57.90 ,33.33
02,000,02,010,0395,645 ,937,5,942,1518,0,3,1,3,0,1,0,76.14,62.06 ,33.33
02,000,02,010,0395,646 ,820,10,830,1332,0,3,1,3,0,1,0,76.14,62.31 ,33.33
02,000,02,010,0396,647 ,978,9,987,1501,0,3,1,3,0,1,0,76.14,65.76 ,33.33
02,000,02,010,0396,648 ,883,9,892,1558,0,3,1,3,0,1,0,76.14,57.25 ,33.33
02,000,02,010,0397,649 ,817,15,832,1160,0,3,1,3,0,1,0,76.14,71.72 ,33.33
02,000,02,010,0397,650 ,969,7,976,1444,0,3,1,3,0,1,0,76.14,67.59 ,33.33
02,000,02,010,0397,651 ,1016,8,1024,1555,0,3,1,3,0,1,0,76.14,65.85 ,33.33
02,000,02,010,0398,652 ,723,6,729,1094,0,3,1,3,0,1,0,76.14,66.64 ,33.33
02,000,02,010,0398,653 ,811,4,815,1121,0,3,1,3,0,1,0,76.14,72.70 ,33.33
02,000,02,010,0399,654 ,891,2,893,1325,0,3,1,3,0,1,0,76.14,67.40 ,33.33
02,000,02,010,0399,655 ,981,4,985,1435,0,3,1,3,0,1,0,76.14,68.64 ,33.33
02,000,02,010,0400,656 ,814,11,825,1246,0,3,1,3,0,1,0,76.14,66.21 ,33.33
02,000,02,010,0400,657 ,889,8,897,1369,0,3,1,3,0,1,0,76.14,65.52 ,33.33
02,000,02,010,0401,658 ,615,7,622,1036,0,3,1,3,0,1,0,76.14,60.04 ,33.33
02,000,02,010,0401,659 ,636,6,642,1012,0,3,1,3,0,1,0,76.14,63.44 ,33.33
02,000,02,010,0402,660 ,827,7,834,1295,0,3,1,3,0,1,0,76.14,64.40 ,33.33
02,000,02,010,0402,661 ,825,9,834,1307,0,3,1,3,0,1,0,76.14,63.81 ,33.33
02,000,02,010,0403,662 ,685,7,692,1064,0,3,1,3,0,1,0,76.14,65.04 ,33.33
02,000,02,010,0403,663 ,550,4,554,863,0,3,1,3,0,1,0,76.14,64.19 ,33.33
02,000,02,010,0404,664 ,1214,11,1225,1805,0,3,1,3,0,1,0,76.14,67.87 ,33.33
02,000,02,010,0404,665 ,1070,8,1078,1609,0,3,1,3,0,1,0,76.14,67.00 ,33.33
02,000,02,010,0405,666 ,832,6,838,1341,0,3,1,3,0,1,0,76.14,62.49 ,33.33
02,000,02,010,0405,667 ,892,8,900,1358,0,3,1,3,0,1,0,76.14,66.27 ,33.33
02,000,02,010,0406,668 ,856,15,871,1296,0,3,1,3,0,1,0,76.14,67.21 ,33.33
02,000,02,010,0407,669 ,897,11,908,1359,0,3,1,3,0,1,0,76.14,66.81 ,33.33
02,000,02,010,0407,670 ,1103,8,1111,1577,0,3,1,3,0,1,0,76.14,70.45 ,33.33
02,000,02,010,0407,671 ,989,11,1000,1498,0,3,1,3,0,1,0,76.14,66.76 ,33.33
02,000,02,010,0408,672 ,886,16,902,1267,0,3,1,3,0,1,0,76.14,71.19 ,33.33
02,000,02,010,0408,673 ,735,8,743,1039,0,3,1,3,0,1,0,76.14,71.51 ,33.33
02,000,02,010,0409,674 ,1105,13,1118,1688,0,3,1,3,0,1,0,76.14,66.23 ,33.33
02,000,02,010,0409,675 ,1073,9,1082,1550,0,3,1,3,0,1,0,76.14,69.81 ,33.33
02,000,02,010,0409,676 ,903,8,911,1321,0,3,1,3,0,1,0,76.14,68.96 ,33.33
02,000,02,010,0410,677 ,733,6,739,1110,0,3,1,3,0,1,0,76.14,66.58 ,33.33
02,000,02,010,0410,678 ,783,11,794,1197,0,3,1,3,0,1,0,76.14,66.33 ,33.33
02,000,02,010,0411,679 ,655,5,660,949,0,3,1,3,0,1,0,76.14,69.55 ,33.33
02,000,02,010,0411,680 ,674,11,685,1044,0,3,1,3,0,1,0,76.14,65.61 ,33.33
02,000,02,010,0412,681 ,1210,16,1226,1789,0,3,1,3,0,1,0,76.14,68.53 ,33.33
02,000,02,010,0412,682 ,1118,14,1132,1663,0,3,1,3,0,1,0,76.14,68.07 ,33.33
02,000,02,010,0413,683 ,924,8,932,1453,0,3,1,3,0,1,0,76.14,64.14 ,33.33
02,000,02,010,0413,684 ,1222,17,1239,1964,0,3,1,3,0,1,0,76.14,63.09 ,33.33
02,000,02,010,0414,685 ,1033,10,1043,1496,0,3,1,3,0,1,0,76.14,69.72 ,33.33
02,000,02,010,0414,686 ,923,9,932,1419,0,3,1,3,0,1,0,76.14,65.68 ,33.33
02,000,02,010,0415,687 ,976,12,988,1385,0,3,1,3,0,1,0,76.14,71.34 ,33.33
02,000,02,010,0415,688 ,913,15,928,1251,0,3,1,3,0,1,0,76.14,74.18 ,33.33
02,000,02,010,0416,689 ,976,12,988,1429,0,3,1,3,0,1,0,76.14,69.14 ,33.33
02,000,02,010,0416,690 ,708,9,717,1093,0,3,1,3,0,1,0,76.14,65.60 ,33.33
02,000,02,010,0417,691 ,897,14,911,1315,0,3,1,3,0,1,0,76.14,69.28 ,33.33
02,000,02,010,0417,692 ,764,9,773,1246,0,3,1,3,0,1,0,76.14,62.04 ,33.33
02,000,02,010,0418,693 ,786,6,792,1205,0,3,1,3,0,1,0,76.14,65.73 ,33.33
02,000,02,010,0418,694 ,648,13,661,1033,0,3,1,3,0,1,0,76.14,63.99 ,33.33
02,000,02,010,0419,695 ,610,6,616,914,0,3,1,3,0,1,0,76.14,67.40 ,33.33
02,000,02,010,0419,696 ,922,11,933,1428,0,3,1,3,0,1,0,76.14,65.34 ,33.33
02,000,02,010,0420,697 ,1225,12,1237,1998,0,3,1,3,0,1,0,76.14,61.91 ,33.33
02,000,02,010,0420,698 ,1310,10,1320,2076,0,3,1,3,0,1,0,76.14,63.58 ,33.33
02,000,02,010,0421,699 ,594,10,604,959,0,3,1,3,0,1,0,76.14,62.98 ,33.33
02,000,02,010,0421,700 ,1070,16,1086,1730,0,3,1,3,0,1,0,76.14,62.77 ,33.33
02,000,02,011,0422,701 ,1154,10,1164,1679,0,3,1,3,0,1,0,76.14,69.33 ,33.33
02,000,02,011,0423,702 ,1039,5,1044,1485,0,3,1,3,0,1,0,76.14,70.30 ,33.33
02,000,02,011,0423,703 ,960,14,974,1460,0,3,1,3,0,1,0,76.14,66.71 ,33.33
02,000,02,011,0424,704 ,812,7,819,1196,0,3,1,3,0,1,0,76.14,68.48 ,33.33
02,000,02,011,0424,705 ,739,11,750,1089,0,3,1,3,0,1,0,76.14,68.87 ,33.33
02,000,02,011,0425,706 ,1021,13,1034,1443,0,3,1,3,0,1,0,76.14,71.66 ,33.33
02,000,02,011,0426,707 ,907,4,911,1332,0,3,1,3,0,1,0,76.14,68.39 ,33.33
02,000,02,011,0426,708 ,910,10,920,1322,0,3,1,3,0,1,0,76.14,69.59 ,33.33
02,000,02,011,0427,709 ,1188,10,1198,1693,0,3,1,3,0,1,0,76.14,70.76 ,33.33
02,000,02,011,0428,710 ,856,14,870,1287,0,3,1,3,0,1,0,76.14,67.60 ,33.33
02,000,02,011,0429,711 ,1265,13,1278,1850,0,3,1,3,0,1,0,76.14,69.08 ,33.33
02,000,02,011,0430,712 ,1070,10,1080,1675,0,3,1,3,0,1,0,76.14,64.48 ,33.33
02,000,02,011,0431,713 ,838,8,846,1241,0,3,1,3,0,1,0,76.14,68.17 ,33.33
02,000,02,011,0431,714 ,961,10,971,1445,0,3,1,3,0,1,0,76.14,67.20 ,33.33
02,000,02,011,0431,715 ,870,9,879,1378,0,3,1,3,0,1,0,76.14,63.79 ,33.33
02,000,02,011,0432,716 ,691,4,695,961,0,3,1,3,0,1,0,76.14,72.32 ,33.33
02,000,02,011,0432,717 ,730,5,735,1064,0,3,1,3,0,1,0,76.14,69.08 ,33.33
02,000,02,011,0433,718 ,918,17,935,1363,0,3,1,3,0,1,0,76.14,68.60 ,33.33
02,000,02,011,0433,719 ,921,3,924,1377,0,3,1,3,0,1,0,76.14,67.10 ,33.33
02,000,02,011,0434,720 ,823,8,831,1288,0,3,1,3,0,1,0,76.14,64.52 ,33.33
02,000,02,011,0434,721 ,738,4,742,1051,0,3,1,3,0,1,0,76.14,70.60 ,33.33
02,000,02,011,0435,722 ,1018,7,1025,1585,0,3,1,3,0,1,0,76.14,64.67 ,33.33
02,000,02,011,0435,723 ,1019,10,1029,1551,0,3,1,3,0,1,0,76.14,66.34 ,33.33
02,000,02,011,0436,724 ,1077,12,1089,1793,0,3,1,3,0,1,0,76.14,60.74 ,33.33
02,000,02,011,0436,725 ,1001,12,1013,1520,0,3,1,3,0,1,0,76.14,66.64 ,33.33
02,000,02,011,0437,726 ,860,16,876,1258,0,3,1,3,0,1,0,76.14,69.63 ,33.33
02,000,02,011,0438,727 ,658,9,667,988,0,3,1,3,0,1,0,76.14,67.51 ,33.33
02,000,02,011,0438,728 ,814,10,824,1243,0,3,1,3,0,1,0,76.14,66.29 ,33.33
02,000,02,011,0439,729 ,833,7,840,1218,0,3,1,3,0,1,0,76.14,68.97 ,33.33
02,000,02,011,0439,730 ,776,11,787,1141,0,3,1,3,0,1,0,76.14,68.97 ,33.33
02,000,02,011,0440,731 ,1058,11,1069,1560,0,3,1,3,0,1,0,76.14,68.53 ,33.33
02,000,02,011,0441,732 ,862,19,881,1309,0,3,1,3,0,1,0,76.14,67.30 ,33.33
02,000,02,011,0441,733 ,999,6,1005,1403,0,3,1,3,0,1,0,76.14,71.63 ,33.33
02,000,02,011,0442,734 ,1394,20,1414,1979,0,3,1,3,0,1,0,76.14,71.45 ,33.33
02,000,02,011,0443,735 ,1033,12,1045,1595,0,3,1,3,0,1,0,76.14,65.52 ,33.33
02,000,02,011,0443,736 ,1010,11,1021,1496,0,3,1,3,0,1,0,76.14,68.25 ,33.33
02,000,02,011,0443,737 ,875,6,881,1341,0,3,1,3,0,1,0,76.14,65.70 ,33.33
02,000,02,011,0444,738 ,902,13,915,1437,0,3,1,3,0,1,0,76.14,63.67 ,33.33
02,000,02,011,0444,739 ,1067,13,1080,1559,0,3,1,3,0,1,0,76.14,69.28 ,33.33
02,000,02,011,0445,740 ,1245,15,1260,1805,0,3,1,3,0,1,0,76.14,69.81 ,33.33
02,000,02,011,0446,741 ,1105,10,1115,1621,0,3,1,3,0,1,0,76.14,68.78 ,33.33
02,000,02,011,0447,742 ,706,7,713,976,0,3,1,3,0,1,0,76.14,73.05 ,33.33
02,000,02,011,0448,743 ,764,10,774,1130,0,3,1,3,0,1,0,76.14,68.50 ,33.33
02,000,02,011,0449,744 ,712,9,721,992,0,3,1,3,0,1,0,76.14,72.68 ,33.33
02,000,02,011,0449,745 ,1215,18,1233,1944,0,3,1,3,0,1,0,76.14,63.43 ,33.33
02,000,02,011,0450,746 ,1110,13,1123,1662,0,3,1,3,0,1,0,76.14,67.57 ,33.33
02,000,02,011,0451,747 ,1450,32,1482,2100,0,3,1,3,0,1,0,76.14,70.57 ,33.33
02,000,02,011,0452,748 ,1155,13,1168,1683,0,3,1,3,0,1,0,76.14,69.40 ,33.33
02,000,02,011,0452,749 ,1260,13,1273,1874,0,3,1,3,0,1,0,76.14,67.93 ,33.33
02,000,02,011,0452,750 ,1087,14,1101,1792,0,3,1,3,0,1,0,76.14,61.44 ,33.33
02,000,02,011,0453,751 ,771,16,787,1183,0,3,1,3,0,1,0,76.14,66.53 ,33.33
02,000,02,011,0453,752 ,936,13,949,1465,0,3,1,3,0,1,0,76.14,64.78 ,33.33
02,000,02,011,0454,753 ,1550,22,1572,2129,0,3,1,3,0,1,0,76.14,73.84 ,33.33
02,000,02,011,0455,754 ,1485,16,1501,2015,0,3,1,3,0,1,0,76.14,74.49 ,33.33
02,000,02,011,0456,755 ,1095,12,1107,1522,0,3,1,3,0,1,0,76.14,72.73 ,33.33
02,000,02,011,0457,756 ,1402,12,1414,2082,0,3,1,3,0,1,0,76.14,67.92 ,33.33
02,000,02,011,0458,757 ,1152,11,1163,1585,0,3,1,3,0,1,0,76.14,73.38 ,33.33
02,000,02,011,0459,758 ,854,4,858,1111,0,3,1,3,0,1,0,76.14,77.23 ,33.33
02,000,02,011,0459,759 ,870,18,888,1294,0,3,1,3,0,1,0,76.14,68.62 ,33.33
02,000,02,011,0460,760 ,909,12,921,1462,0,3,1,3,0,1,0,76.14,63.00 ,33.33
02,000,02,011,0460,761 ,815,3,818,1400,0,3,1,3,0,1,0,76.14,58.43 ,33.33
02,000,02,011,0460,762 ,1012,18,1030,1665,0,3,1,3,0,1,0,76.14,61.86 ,33.33
02,000,02,011,0461,763 ,691,7,698,1149,0,3,1,3,0,1,0,76.14,60.75 ,33.33
02,000,02,011,0461,764 ,676,8,684,1163,0,3,1,3,0,1,0,76.14,58.81 ,33.33
02,000,02,011,0462,765 ,831,15,846,1371,0,3,1,3,0,1,0,76.14,61.71 ,33.33
02,000,02,011,0462,766 ,659,1,660,1091,0,3,1,3,0,1,0,76.14,60.49 ,33.33
02,000,02,011,0463,767 ,750,27,777,1345,0,3,1,3,0,1,0,76.14,57.77 ,33.33
02,000,02,011,0463,768 ,903,13,916,1464,0,3,1,3,0,1,0,76.14,62.57 ,33.33
02,000,02,011,0464,769 ,859,11,870,1444,0,3,1,3,0,1,0,76.14,60.25 ,33.33
02,000,02,011,0464,770 ,841,11,852,1453,0,3,1,3,0,1,0,76.14,58.64 ,33.33
03,001,01,001,0001,1 ,771,7,778,1119,0,3,1,3,0,1,0,76.14,69.53 ,33.33
03,001,01,001,0002,2 ,802,8,810,1249,0,3,1,3,0,1,0,76.14,64.85 ,33.33
03,001,01,001,0003,3 ,457,4,461,654,0,3,1,3,0,1,0,76.14,70.49 ,33.33
03,001,01,001,0004,4 ,709,11,720,1053,0,3,1,3,0,1,0,76.14,68.38 ,33.33
03,001,01,001,0005,5 ,523,4,527,797,0,3,1,3,0,1,0,76.14,66.12 ,33.33
03,001,01,001,0005,6 ,434,1,435,784,0,3,1,3,0,1,0,76.14,55.48 ,33.33
03,001,01,001,0006,7 ,647,7,654,925,0,3,1,3,0,1,0,76.14,70.70 ,33.33
03,001,01,001,0006,8 ,617,11,628,928,0,3,1,3,0,1,0,76.14,67.67 ,33.33
03,001,01,001,0006,9 ,530,13,543,801,0,3,1,3,0,1,0,76.14,67.79 ,33.33
03,001,01,001,0006,10 ,766,8,774,1085,0,3,1,3,0,1,0,76.14,71.34 ,33.33
03,001,01,001,0007,11 ,816,14,830,1195,0,3,1,3,0,1,0,76.14,69.46 ,33.33
03,001,01,001,0007,12 ,868,13,881,1329,0,3,1,3,0,1,0,76.14,66.29 ,33.33
03,001,01,001,0008,13 ,742,10,752,1079,0,3,1,3,0,1,0,76.14,69.69 ,33.33
03,001,01,001,0008,14 ,979,17,996,1414,0,3,1,3,0,1,0,76.14,70.44 ,33.33
03,001,01,001,0008,15 ,740,10,750,1073,0,3,1,3,0,1,0,76.14,69.90 ,33.33
03,001,01,001,0008,16 ,705,5,710,1039,0,3,1,3,0,1,0,76.14,68.33 ,33.33
03,001,01,001,0009,17 ,776,17,793,1190,0,3,1,3,0,1,0,76.14,66.64 ,33.33
03,001,01,001,0009,18 ,761,8,769,1156,0,3,1,3,0,1,0,76.14,66.52 ,33.33
03,001,01,001,0009,19 ,743,7,750,1034,0,3,1,3,0,1,0,76.14,72.53 ,33.33
03,001,01,001,0010,20 ,695,11,706,1031,0,3,1,3,0,1,0,76.14,68.48 ,33.33
03,001,01,001,0010,21 ,760,12,772,1116,0,3,1,3,0,1,0,76.14,69.18 ,33.33
03,001,01,001,0011,22 ,754,16,770,1138,0,3,1,3,0,1,0,76.14,67.66 ,33.33
03,001,01,001,0011,23 ,772,7,779,1139,0,3,1,3,0,1,0,76.14,68.39 ,33.33
03,001,01,001,0011,24 ,823,13,836,1178,0,3,1,3,0,1,0,76.14,70.97 ,33.33
03,001,01,001,0012,25 ,776,10,786,1109,0,3,1,3,0,1,0,76.14,70.87 ,33.33
03,001,01,001,0012,26 ,753,11,764,1031,0,3,1,3,0,1,0,76.14,74.10 ,33.33
03,001,01,001,0012,27 ,826,12,838,1179,0,3,1,3,0,1,0,76.14,71.08 ,33.33
03,001,01,001,0012,28 ,786,11,797,1081,0,3,1,3,0,1,0,76.14,73.73 ,33.33
03,001,01,001,0013,29 ,931,17,948,1272,0,3,1,3,0,1,0,76.14,74.53 ,33.33
03,001,01,001,0013,30 ,763,8,771,1079,0,3,1,3,0,1,0,76.14,71.46 ,33.33
03,001,01,001,0014,31 ,752,10,762,1159,0,3,1,3,0,1,0,76.14,65.75 ,33.33
03,001,01,001,0014,32 ,741,17,758,1021,0,3,1,3,0,1,0,76.14,74.24 ,33.33
03,001,01,001,0015,33 ,735,10,745,1050,0,3,1,3,0,1,0,76.14,70.95 ,33.33
03,001,01,001,0015,34 ,739,20,759,1038,0,3,1,3,0,1,0,76.14,73.12 ,33.33
03,001,01,001,0016,35 ,905,12,917,1212,0,3,1,3,0,1,0,76.14,75.66 ,33.33
03,001,01,001,0016,36 ,809,10,819,1042,0,3,1,3,0,1,0,76.14,78.60 ,33.33
03,001,01,001,0016,37 ,720,8,728,1016,0,3,1,3,0,1,0,76.14,71.65 ,33.33
03,001,01,001,0017,38 ,612,15,627,877,0,3,1,3,0,1,0,76.14,71.49 ,33.33
03,001,01,001,0017,39 ,726,7,733,998,0,3,1,3,0,1,0,76.14,73.45 ,33.33
03,001,01,001,0018,40 ,775,13,788,1204,0,3,1,3,0,1,0,76.14,65.45 ,33.33
03,001,01,001,0018,41 ,883,5,888,1251,0,3,1,3,0,1,0,76.14,70.98 ,33.33
03,001,01,001,0018,42 ,731,5,736,1037,0,3,1,3,0,1,0,76.14,70.97 ,33.33
03,001,01,001,0019,43 ,720,11,731,1087,0,3,1,3,0,1,0,76.14,67.25 ,33.33
03,001,01,001,0019,44 ,706,17,723,1085,0,3,1,3,0,1,0,76.14,66.64 ,33.33
03,001,01,001,0019,45 ,741,17,758,1097,0,3,1,3,0,1,0,76.14,69.10 ,33.33
03,001,01,001,0020,46 ,704,10,714,1126,0,3,1,3,0,1,0,76.14,63.41 ,33.33
03,001,01,001,0020,47 ,679,15,694,1057,0,3,1,3,0,1,0,76.14,65.66 ,33.33
03,001,01,001,0020,48 ,564,8,572,876,0,3,1,3,0,1,0,76.14,65.30 ,33.33
03,001,01,001,0020,49 ,754,34,788,1111,0,3,1,3,0,1,0,76.14,70.93 ,33.33
03,001,01,001,0021,50 ,825,7,832,1170,0,3,1,3,0,1,0,76.14,71.11 ,33.33
03,001,01,001,0021,51 ,863,10,873,1238,0,3,1,3,0,1,0,76.14,70.52 ,33.33
03,001,01,001,0022,52 ,571,5,576,797,0,3,1,3,0,1,0,76.14,72.27 ,33.33
03,001,01,001,0022,53 ,688,8,696,940,0,3,1,3,0,1,0,76.14,74.04 ,33.33
03,001,01,001,0023,54 ,682,11,693,1011,0,3,1,3,0,1,0,76.14,68.55 ,33.33
03,001,01,001,0023,55 ,785,18,803,1119,0,3,1,3,0,1,0,76.14,71.76 ,33.33
03,001,01,001,0023,56 ,690,5,695,967,0,3,1,3,0,1,0,76.14,71.87 ,33.33
03,001,01,001,0024,57 ,714,11,725,1010,0,3,1,3,0,1,0,76.14,71.78 ,33.33
03,001,01,001,0024,58 ,976,9,985,1341,0,3,1,3,0,1,0,76.14,73.45 ,33.33
03,001,01,001,0024,59 ,905,4,909,1284,0,3,1,3,0,1,0,76.14,70.79 ,33.33
03,001,01,001,0025,60 ,703,9,712,1053,0,3,1,3,0,1,0,76.14,67.62 ,33.33
03,001,01,001,0025,61 ,789,8,797,1125,0,3,1,3,0,1,0,76.14,70.84 ,33.33
03,001,01,001,0025,62 ,856,17,873,1302,0,3,1,3,0,1,0,76.14,67.05 ,33.33
03,001,01,001,0026,63 ,812,7,819,1166,0,3,1,3,0,1,0,76.14,70.24 ,33.33
03,001,01,001,0026,64 ,684,15,699,1000,0,3,1,3,0,1,0,76.14,69.90 ,33.33
03,001,01,001,0026,65 ,643,14,657,958,0,3,1,3,0,1,0,76.14,68.58 ,33.33
03,001,01,001,0027,66 ,707,18,725,1119,0,3,1,3,0,1,0,76.14,64.79 ,33.33
03,001,01,001,0027,67 ,778,8,786,1144,0,3,1,3,0,1,0,76.14,68.71 ,33.33
03,001,01,001,0027,68 ,661,11,672,1004,0,3,1,3,0,1,0,76.14,66.93 ,33.33
03,001,01,001,0028,69 ,790,9,799,1187,0,3,1,3,0,1,0,76.14,67.31 ,33.33
03,001,01,001,0028,70 ,739,15,754,1130,0,3,1,3,0,1,0,76.14,66.73 ,33.33
03,001,01,001,0029,71 ,904,7,911,1229,0,3,1,3,0,1,0,76.14,74.13 ,33.33
03,001,01,001,0029,72 ,745,10,755,1019,0,3,1,3,0,1,0,76.14,74.09 ,33.33
03,001,01,001,0030,73 ,822,6,828,1202,0,3,1,3,0,1,0,76.14,68.89 ,33.33
03,001,01,001,0030,74 ,757,11,768,1150,0,3,1,3,0,1,0,76.14,66.78 ,33.33
03,001,01,001,0031,75 ,765,11,776,1100,0,3,1,3,0,1,0,76.14,70.55 ,33.33
03,001,01,001,0031,76 ,628,13,641,908,0,3,1,3,0,1,0,76.14,70.59 ,33.33
03,001,01,001,0032,77 ,839,16,855,1236,0,3,1,3,0,1,0,76.14,69.17 ,33.33
03,001,01,001,0032,78 ,851,15,866,1241,0,3,1,3,0,1,0,76.14,69.78 ,33.33
03,001,01,001,0033,79 ,631,12,643,916,0,3,1,3,0,1,0,76.14,70.20 ,33.33
03,001,01,001,0033,80 ,737,6,743,1092,0,3,1,3,0,1,0,76.14,68.04 ,33.33
03,001,01,001,0034,81 ,862,18,880,1272,0,3,1,3,0,1,0,76.14,69.18 ,33.33
03,001,01,001,0034,82 ,713,15,728,989,0,3,1,3,0,1,0,76.14,73.61 ,33.33
03,001,01,001,0034,83 ,998,18,1016,1473,0,3,1,3,0,1,0,76.14,68.97 ,33.33
03,001,01,001,0035,84 ,932,14,946,1378,0,3,1,3,0,1,0,76.14,68.65 ,33.33
03,001,01,001,0035,85 ,842,17,859,1271,0,3,1,3,0,1,0,76.14,67.58 ,33.33
03,001,01,001,0035,86 ,833,9,842,1263,0,3,1,3,0,1,0,76.14,66.67 ,33.33
03,001,01,001,0036,87 ,695,7,702,1047,0,3,1,3,0,1,0,76.14,67.05 ,33.33
03,001,01,001,0036,88 ,829,10,839,1296,0,3,1,3,0,1,0,76.14,64.74 ,33.33
03,001,01,001,0036,89 ,1087,17,1104,1663,0,3,1,3,0,1,0,76.14,66.39 ,33.33
03,001,01,001,0037,90 ,722,11,733,1176,0,3,1,3,0,1,0,76.14,62.33 ,33.33
03,001,01,001,0037,91 ,787,8,795,1238,0,3,1,3,0,1,0,76.14,64.22 ,33.33
03,001,01,001,0037,92 ,716,8,724,1090,0,3,1,3,0,1,0,76.14,66.42 ,33.33
03,001,01,001,0037,93 ,797,10,807,1131,0,3,1,3,0,1,0,76.14,71.35 ,33.33
03,001,01,001,0038,94 ,1052,17,1069,1579,0,3,1,3,0,1,0,76.14,67.70 ,33.33
03,001,01,001,0038,95 ,852,12,864,1248,0,3,1,3,0,1,0,76.14,69.23 ,33.33
03,001,01,001,0039,96 ,826,15,841,1206,0,3,1,3,0,1,0,76.14,69.73 ,33.33
03,001,01,001,0039,97 ,817,8,825,1242,0,3,1,3,0,1,0,76.14,66.43 ,33.33
03,001,01,001,0040,98 ,820,12,832,1175,0,3,1,3,0,1,0,76.14,70.81 ,33.33
03,001,01,001,0040,99 ,906,24,930,1342,0,3,1,3,0,1,0,76.14,69.30 ,33.33
03,001,01,001,0041,100 ,913,13,926,1388,0,3,1,3,0,1,0,76.14,66.71 ,33.33
03,001,01,001,0041,101 ,833,18,851,1231,0,3,1,3,0,1,0,76.14,69.13 ,33.33
03,001,01,001,0042,102 ,1075,20,1095,1602,0,3,1,3,0,1,0,76.14,68.35 ,33.33
03,001,01,001,0042,103 ,1281,24,1305,1897,0,3,1,3,0,1,0,76.14,68.79 ,33.33
03,001,01,001,0042,104 ,1224,31,1255,1786,0,3,1,3,0,1,0,76.14,70.27 ,33.33
03,001,01,001,0043,105 ,543,8,551,770,0,3,1,3,0,1,0,76.14,71.56 ,33.33
03,001,01,001,0043,106 ,565,5,570,849,0,3,1,3,0,1,0,76.14,67.14 ,33.33
03,001,01,001,0043,107 ,764,13,777,1166,0,3,1,3,0,1,0,76.14,66.64 ,33.33
03,001,01,001,0044,108 ,705,18,723,1031,0,3,1,3,0,1,0,76.14,70.13 ,33.33
03,001,01,001,0044,109 ,631,12,643,901,0,3,1,3,0,1,0,76.14,71.37 ,33.33
03,001,01,001,0044,110 ,695,6,701,989,0,3,1,3,0,1,0,76.14,70.88 ,33.33
03,001,01,001,0045,111 ,953,9,962,1391,0,3,1,3,0,1,0,76.14,69.16 ,33.33
03,001,01,001,0045,112 ,659,15,674,948,0,3,1,3,0,1,0,76.14,71.10 ,33.33
03,001,01,001,0045,113 ,999,11,1010,1497,0,3,1,3,0,1,0,76.14,67.47 ,33.33
03,001,01,001,0046,114 ,613,11,624,984,0,3,1,3,0,1,0,76.14,63.41 ,33.33
03,001,01,001,0046,115 ,606,9,615,896,0,3,1,3,0,1,0,76.14,68.64 ,33.33
03,001,01,001,0046,116 ,612,6,618,894,0,3,1,3,0,1,0,76.14,69.13 ,33.33
03,001,01,001,0047,117 ,533,5,538,793,0,3,1,3,0,1,0,76.14,67.84 ,33.33
03,001,01,001,0047,118 ,580,6,586,865,0,3,1,3,0,1,0,76.14,67.75 ,33.33
03,001,01,001,0047,119 ,688,14,702,996,0,3,1,3,0,1,0,76.14,70.48 ,33.33
03,001,01,001,0048,120 ,528,11,539,824,0,3,1,3,0,1,0,76.14,65.41 ,33.33
03,001,01,001,0048,121 ,638,12,650,994,0,3,1,3,0,1,0,76.14,65.39 ,33.33
03,001,01,001,0048,122 ,727,5,732,1104,0,3,1,3,0,1,0,76.14,66.30 ,33.33
03,001,01,001,0048,123 ,775,14,789,1129,0,3,1,3,0,1,0,76.14,69.88 ,33.33
03,001,01,001,0049,124 ,877,16,893,1406,0,3,1,3,0,1,0,76.14,63.51 ,33.33
03,001,01,001,0049,125 ,978,12,990,1528,0,3,1,3,0,1,0,76.14,64.79 ,33.33
03,001,01,001,0050,126 ,984,15,999,1402,0,3,1,3,0,1,0,76.14,71.26 ,33.33
03,001,01,001,0050,127 ,910,9,919,1348,0,3,1,3,0,1,0,76.14,68.18 ,33.33
03,001,01,001,0051,128 ,640,7,647,994,0,3,1,3,0,1,0,76.14,65.09 ,33.33
03,001,01,001,0051,129 ,783,18,801,1185,0,3,1,3,0,1,0,76.14,67.59 ,33.33
03,001,01,001,0051,130 ,760,9,769,1075,0,3,1,3,0,1,0,76.14,71.53 ,33.33
03,001,01,001,0052,131 ,695,6,701,1025,0,3,1,3,0,1,0,76.14,68.39 ,33.33
03,001,01,001,0052,132 ,499,7,506,763,0,3,1,3,0,1,0,76.14,66.32 ,33.33
03,001,01,001,0053,133 ,867,16,883,1257,0,3,1,3,0,1,0,76.14,70.25 ,33.33
03,001,01,001,0053,134 ,957,11,968,1386,0,3,1,3,0,1,0,76.14,69.84 ,33.33
03,001,01,001,0054,135 ,891,13,904,1313,0,3,1,3,0,1,0,76.14,68.85 ,33.33
03,001,01,001,0054,136 ,768,12,780,1147,0,3,1,3,0,1,0,76.14,68.00 ,33.33
03,001,01,001,0055,137 ,1018,14,1032,1455,0,3,1,3,0,1,0,76.14,70.93 ,33.33
03,001,01,001,0055,138 ,719,8,727,1020,0,3,1,3,0,1,0,76.14,71.27 ,33.33
03,001,01,001,0055,139 ,943,17,960,1407,0,3,1,3,0,1,0,76.14,68.23 ,33.33
03,001,01,001,0055,140 ,1446,15,1461,2102,0,3,1,3,0,1,0,76.14,69.51 ,33.33
03,001,01,001,0056,141 ,702,20,722,1090,0,3,1,3,0,1,0,76.14,66.24 ,33.33
03,001,01,001,0056,142 ,739,8,747,1094,0,3,1,3,0,1,0,76.14,68.28 ,33.33
03,001,01,001,0057,143 ,827,17,844,1189,0,3,1,3,0,1,0,76.14,70.98 ,33.33
03,001,01,001,0057,144 ,845,22,867,1230,0,3,1,3,0,1,0,76.14,70.49 ,33.33
03,001,01,001,0058,145 ,823,13,836,1201,0,3,1,3,0,1,0,76.14,69.61 ,33.33
03,001,01,001,0058,146 ,702,13,715,1016,0,3,1,3,0,1,0,76.14,70.37 ,33.33
03,001,01,001,0058,147 ,782,15,797,1138,0,3,1,3,0,1,0,76.14,70.04 ,33.33
03,001,01,001,0059,148 ,801,19,820,1254,0,3,1,3,0,1,0,76.14,65.39 ,33.33
03,001,01,001,0059,149 ,853,10,863,1280,0,3,1,3,0,1,0,76.14,67.42 ,33.33
03,001,01,001,0060,150 ,869,18,887,1329,0,3,1,3,0,1,0,76.14,66.74 ,33.33
03,001,01,001,0060,151 ,954,12,966,1445,0,3,1,3,0,1,0,76.14,66.85 ,33.33
03,001,01,001,0060,152 ,1099,14,1113,1635,0,3,1,3,0,1,0,76.14,68.07 ,33.33
03,001,01,001,0061,153 ,427,7,434,640,0,3,1,3,0,1,0,76.14,67.81 ,33.33
03,001,01,001,0061,154 ,577,19,596,858,0,3,1,3,0,1,0,76.14,69.46 ,33.33
03,001,01,001,0062,155 ,851,13,864,1258,0,3,1,3,0,1,0,76.14,68.68 ,33.33
03,001,01,001,0062,156 ,832,24,856,1283,0,3,1,3,0,1,0,76.14,66.72 ,33.33
03,001,01,001,0062,157 ,635,5,640,938,0,3,1,3,0,1,0,76.14,68.23 ,33.33
03,001,01,001,0062,158 ,582,6,588,826,0,3,1,3,0,1,0,76.14,71.19 ,33.33
03,001,01,001,0063,159 ,848,6,854,1237,0,3,1,3,0,1,0,76.14,69.04 ,33.33
03,001,01,001,0063,160 ,902,12,914,1244,0,3,1,3,0,1,0,76.14,73.47 ,33.33
03,001,01,001,0063,161 ,657,10,667,870,0,3,1,3,0,1,0,76.14,76.67 ,33.33
03,001,01,001,0064,162 ,935,10,945,1353,0,3,1,3,0,1,0,76.14,69.84 ,33.33
03,001,01,001,0064,163 ,747,16,763,1088,0,3,1,3,0,1,0,76.14,70.13 ,33.33
03,001,01,001,0064,164 ,604,5,609,883,0,3,1,3,0,1,0,76.14,68.97 ,33.33
03,001,01,001,0065,165 ,862,11,873,1225,0,3,1,3,0,1,0,76.14,71.27 ,33.33
03,001,01,001,0065,166 ,824,11,835,1239,0,3,1,3,0,1,0,76.14,67.39 ,33.33
03,001,01,001,0066,167 ,958,13,971,1420,0,3,1,3,0,1,0,76.14,68.38 ,33.33
03,001,01,001,0066,168 ,913,19,932,1319,0,3,1,3,0,1,0,76.14,70.66 ,33.33
03,001,01,001,0066,169 ,839,36,875,1285,0,3,1,3,0,1,0,76.14,68.09 ,33.33
03,001,01,001,0067,170 ,583,9,592,866,0,3,1,3,0,1,0,76.14,68.36 ,33.33
03,001,01,001,0067,171 ,647,3,650,929,0,3,1,3,0,1,0,76.14,69.97 ,33.33
03,001,01,001,0068,172 ,865,15,880,1179,0,3,1,3,0,1,0,76.14,74.64 ,33.33
03,001,01,001,0068,173 ,778,16,794,1120,0,3,1,3,0,1,0,76.14,70.89 ,33.33
03,001,01,001,0069,174 ,693,7,700,983,0,3,1,3,0,1,0,76.14,71.21 ,33.33
03,001,01,001,0069,175 ,784,19,803,1093,0,3,1,3,0,1,0,76.14,73.47 ,33.33
03,001,01,001,0070,176 ,843,16,859,1207,0,3,1,3,0,1,0,76.14,71.17 ,33.33
03,001,01,001,0070,177 ,809,17,826,1165,0,3,1,3,0,1,0,76.14,70.90 ,33.33
03,001,01,001,0071,178 ,824,14,838,1155,0,3,1,3,0,1,0,76.14,72.55 ,33.33
03,001,01,001,0071,179 ,734,13,747,1061,0,3,1,3,0,1,0,76.14,70.41 ,33.33
03,001,01,001,0071,180 ,858,26,884,1246,0,3,1,3,0,1,0,76.14,70.95 ,33.33
03,001,01,001,0071,181 ,852,21,873,1253,0,3,1,3,0,1,0,76.14,69.67 ,33.33
03,001,01,001,0072,182 ,827,13,840,1221,0,3,1,3,0,1,0,76.14,68.80 ,33.33
03,001,01,001,0072,183 ,739,10,749,1073,0,3,1,3,0,1,0,76.14,69.80 ,33.33
03,001,01,001,0073,184 ,871,14,885,1249,0,3,1,3,0,1,0,76.14,70.86 ,33.33
03,001,01,001,0073,185 ,776,15,791,1056,0,3,1,3,0,1,0,76.14,74.91 ,33.33
03,001,01,001,0074,186 ,1029,16,1045,1583,0,3,1,3,0,1,0,76.14,66.01 ,33.33
03,001,01,001,0074,187 ,823,12,835,1215,0,3,1,3,0,1,0,76.14,68.72 ,33.33
03,001,01,001,0074,188 ,751,18,769,1104,0,3,1,3,0,1,0,76.14,69.66 ,33.33
03,001,01,001,0075,189 ,851,13,864,1219,0,3,1,3,0,1,0,76.14,70.88 ,33.33
03,001,01,001,0075,190 ,762,18,780,1083,0,3,1,3,0,1,0,76.14,72.02 ,33.33
03,001,01,001,0076,191 ,1136,14,1150,1643,0,3,1,3,0,1,0,76.14,69.99 ,33.33
03,001,01,001,0076,192 ,799,16,815,1259,0,3,1,3,0,1,0,76.14,64.73 ,33.33
03,001,01,001,0077,193 ,985,20,1005,1380,0,3,1,3,0,1,0,76.14,72.83 ,33.33
03,001,01,001,0077,194 ,782,9,791,1116,0,3,1,3,0,1,0,76.14,70.88 ,33.33
03,001,01,001,0078,195 ,943,20,963,1371,0,3,1,3,0,1,0,76.14,70.24 ,33.33
03,001,01,001,0078,196 ,810,11,821,1169,0,3,1,3,0,1,0,76.14,70.23 ,33.33
03,001,01,001,0079,197 ,1159,19,1178,1671,0,3,1,3,0,1,0,76.14,70.50 ,33.33
03,001,01,001,0079,198 ,810,19,829,1172,0,3,1,3,0,1,0,76.14,70.73 ,33.33
03,001,01,001,0080,199 ,507,12,519,857,0,3,1,3,0,1,0,76.14,60.56 ,33.33
03,001,01,001,0080,200 ,630,17,647,989,0,3,1,3,0,1,0,76.14,65.42 ,33.33
03,001,01,001,0080,201 ,737,5,742,1023,0,3,1,3,0,1,0,76.14,72.53 ,33.33
03,001,01,001,0081,202 ,768,6,774,1117,0,3,1,3,0,1,0,76.14,69.29 ,33.33
03,001,01,001,0081,203 ,913,9,922,1310,0,3,1,3,0,1,0,76.14,70.38 ,33.33
03,001,01,001,0081,204 ,628,10,638,956,0,3,1,3,0,1,0,76.14,66.74 ,33.33
03,001,01,001,0081,205 ,575,7,582,806,0,3,1,3,0,1,0,76.14,72.21 ,33.33
03,001,01,001,0082,206 ,643,15,658,963,0,3,1,3,0,1,0,76.14,68.33 ,33.33
03,001,01,001,0082,207 ,560,21,581,804,0,3,1,3,0,1,0,76.14,72.26 ,33.33
03,001,01,001,0082,208 ,703,12,715,1043,0,3,1,3,0,1,0,76.14,68.55 ,33.33
03,001,01,001,0083,209 ,783,18,801,1120,0,3,1,3,0,1,0,76.14,71.52 ,33.33
03,001,01,001,0083,210 ,673,12,685,963,0,3,1,3,0,1,0,76.14,71.13 ,33.33
03,001,01,001,0084,211 ,727,9,736,1088,0,3,1,3,0,1,0,76.14,67.65 ,33.33
03,001,01,001,0084,212 ,796,17,813,1178,0,3,1,3,0,1,0,76.14,69.02 ,33.33
03,001,01,001,0084,213 ,766,14,780,1116,0,3,1,3,0,1,0,76.14,69.89 ,33.33
03,001,01,001,0085,214 ,490,11,501,729,0,3,1,3,0,1,0,76.14,68.72 ,33.33
03,001,01,001,0085,215 ,583,17,600,841,0,3,1,3,0,1,0,76.14,71.34 ,33.33
03,001,01,001,0086,216 ,1051,16,1067,1518,0,3,1,3,0,1,0,76.14,70.29 ,33.33
03,001,01,001,0086,217 ,872,11,883,1313,0,3,1,3,0,1,0,76.14,67.25 ,33.33
03,001,01,001,0087,218 ,638,10,648,943,0,3,1,3,0,1,0,76.14,68.72 ,33.33
03,001,01,001,0087,219 ,689,8,697,1162,0,3,1,3,0,1,0,76.14,59.98 ,33.33
03,001,01,001,0088,220 ,680,10,690,993,0,3,1,3,0,1,0,76.14,69.49 ,33.33
03,001,01,001,0088,221 ,410,2,412,600,0,3,1,3,0,1,0,76.14,68.67 ,33.33
03,001,01,001,0089,222 ,943,13,956,1447,0,3,1,3,0,1,0,76.14,66.07 ,33.33
03,001,01,001,0089,223 ,916,25,941,1328,0,3,1,3,0,1,0,76.14,70.86 ,33.33
03,001,01,001,0090,224 ,730,10,740,1053,0,3,1,3,0,1,0,76.14,70.28 ,33.33
03,001,01,001,0090,225 ,716,7,723,1020,0,3,1,3,0,1,0,76.14,70.88 ,33.33
03,001,01,001,0090,226 ,590,7,597,859,0,3,1,3,0,1,0,76.14,69.50 ,33.33
03,001,01,001,0091,227 ,753,8,761,1111,0,3,1,3,0,1,0,76.14,68.50 ,33.33
03,001,01,001,0091,228 ,875,18,893,1247,0,3,1,3,0,1,0,76.14,71.61 ,33.33
03,001,01,001,0092,229 ,877,12,889,1296,0,3,1,3,0,1,0,76.14,68.60 ,33.33
03,001,01,001,0092,230 ,952,9,961,1373,0,3,1,3,0,1,0,76.14,69.99 ,33.33
03,001,01,001,0093,231 ,853,12,865,1207,0,3,1,3,0,1,0,76.14,71.67 ,33.33
03,001,01,001,0093,232 ,888,13,901,1257,0,3,1,3,0,1,0,76.14,71.68 ,33.33
03,001,01,001,0093,233 ,1033,18,1051,1471,0,3,1,3,0,1,0,76.14,71.45 ,33.33
03,001,01,001,0094,234 ,815,17,832,1149,0,3,1,3,0,1,0,76.14,72.41 ,33.33
03,001,01,001,0094,235 ,940,18,958,1403,0,3,1,3,0,1,0,76.14,68.28 ,33.33
03,001,01,001,0095,236 ,954,20,974,1361,0,3,1,3,0,1,0,76.14,71.57 ,33.33
03,001,01,001,0095,237 ,792,16,808,1118,0,3,1,3,0,1,0,76.14,72.27 ,33.33
03,001,01,001,0096,238 ,997,19,1016,1375,0,3,1,3,0,1,0,76.14,73.89 ,33.33
03,001,01,001,0096,239 ,835,10,845,1161,0,3,1,3,0,1,0,76.14,72.78 ,33.33
03,001,01,001,0097,240 ,811,21,832,1196,0,3,1,3,0,1,0,76.14,69.57 ,33.33
03,001,01,001,0097,241 ,579,10,589,885,0,3,1,3,0,1,0,76.14,66.55 ,33.33
03,001,01,001,0097,242 ,811,13,824,1149,0,3,1,3,0,1,0,76.14,71.71 ,33.33
03,001,01,001,0097,243 ,923,13,936,1307,0,3,1,3,0,1,0,76.14,71.61 ,33.33
03,001,01,001,0098,244 ,980,19,999,1408,0,3,1,3,0,1,0,76.14,70.95 ,33.33
03,001,01,001,0098,245 ,748,10,758,1113,0,3,1,3,0,1,0,76.14,68.10 ,33.33
03,001,01,001,0098,246 ,807,8,815,1187,0,3,1,3,0,1,0,76.14,68.66 ,33.33
03,001,01,001,0099,247 ,969,10,979,1460,0,3,1,3,0,1,0,76.14,67.05 ,33.33
03,001,01,001,0099,248 ,1062,26,1088,1555,0,3,1,3,0,1,0,76.14,69.97 ,33.33
03,001,01,001,0099,249 ,1071,14,1085,1605,0,3,1,3,0,1,0,76.14,67.60 ,33.33
03,001,01,001,0099,250 ,890,11,901,1334,0,3,1,3,0,1,0,76.14,67.54 ,33.33
03,001,01,001,0100,251 ,673,5,678,917,0,3,1,3,0,1,0,76.14,73.94 ,33.33
03,001,01,001,0100,252 ,619,6,625,863,0,3,1,3,0,1,0,76.14,72.42 ,33.33
03,001,01,001,0100,253 ,616,9,625,896,0,3,1,3,0,1,0,76.14,69.75 ,33.33
03,001,01,001,0101,254 ,555,12,567,874,0,3,1,3,0,1,0,76.14,64.87 ,33.33
03,001,01,001,0102,255 ,765,14,779,1113,0,3,1,3,0,1,0,76.14,69.99 ,33.33
03,001,01,001,0102,256 ,853,10,863,1315,0,3,1,3,0,1,0,76.14,65.63 ,33.33
03,001,01,001,0103,257 ,750,9,759,1067,0,3,1,3,0,1,0,76.14,71.13 ,33.33
03,001,01,001,0103,258 ,865,5,870,1232,0,3,1,3,0,1,0,76.14,70.62 ,33.33
03,001,01,001,0103,259 ,841,13,854,1267,0,3,1,3,0,1,0,76.14,67.40 ,33.33
03,001,01,001,0104,260 ,952,15,967,1430,0,3,1,3,0,1,0,76.14,67.62 ,33.33
03,001,01,001,0104,261 ,1079,26,1105,1571,0,3,1,3,0,1,0,76.14,70.34 ,33.33
03,001,01,001,0105,262 ,766,18,784,1077,0,3,1,3,0,1,0,76.14,72.79 ,33.33
03,001,01,001,0105,263 ,828,14,842,1163,0,3,1,3,0,1,0,76.14,72.40 ,33.33
03,001,01,001,0106,264 ,649,11,660,936,0,3,1,3,0,1,0,76.14,70.51 ,33.33
03,001,01,001,0106,265 ,536,10,546,769,0,3,1,3,0,1,0,76.14,71.00 ,33.33
03,001,01,001,0107,266 ,1089,22,1111,1710,0,3,1,3,0,1,0,76.14,64.97 ,33.33
03,001,01,001,0107,267 ,1054,11,1065,1591,0,3,1,3,0,1,0,76.14,66.94 ,33.33
03,001,01,001,0107,268 ,1115,24,1139,1634,0,3,1,3,0,1,0,76.14,69.71 ,33.33
03,001,01,001,0108,269 ,882,12,894,1240,0,3,1,3,0,1,0,76.14,72.10 ,33.33
03,001,01,001,0108,270 ,1094,8,1102,1570,0,3,1,3,0,1,0,76.14,70.19 ,33.33
03,001,01,001,0108,271 ,976,17,993,1401,0,3,1,3,0,1,0,76.14,70.88 ,33.33
03,001,01,001,0109,272 ,805,10,815,1215,0,3,1,3,0,1,0,76.14,67.08 ,33.33
03,001,01,001,0109,273 ,674,13,687,951,0,3,1,3,0,1,0,76.14,72.24 ,33.33
03,001,01,001,0109,274 ,754,13,767,1108,0,3,1,3,0,1,0,76.14,69.22 ,33.33
03,001,01,001,0110,275 ,787,5,792,1238,0,3,1,3,0,1,0,76.14,63.97 ,33.33
03,001,01,001,0110,276 ,665,20,685,1034,0,3,1,3,0,1,0,76.14,66.25 ,33.33
03,001,01,001,0110,277 ,609,9,618,1204,0,3,1,3,0,1,0,76.14,51.33 ,33.33
03,001,01,001,0111,278 ,795,6,801,1172,0,3,1,3,0,1,0,76.14,68.34 ,33.33
03,001,01,001,0111,279 ,954,21,975,1427,0,3,1,3,0,1,0,76.14,68.33 ,33.33
03,001,01,001,0111,280 ,968,16,984,1425,0,3,1,3,0,1,0,76.14,69.05 ,33.33
03,001,01,001,0112,281 ,807,17,824,1182,0,3,1,3,0,1,0,76.14,69.71 ,33.33
03,001,01,001,0112,282 ,524,12,536,779,0,3,1,3,0,1,0,76.14,68.81 ,33.33
03,001,01,001,0112,283 ,614,12,626,835,0,3,1,3,0,1,0,76.14,74.97 ,33.33
03,001,01,001,0113,284 ,860,16,876,1212,0,3,1,3,0,1,0,76.14,72.28 ,33.33
03,001,01,001,0113,285 ,961,8,969,1371,0,3,1,3,0,1,0,76.14,70.68 ,33.33
03,001,01,001,0114,286 ,697,11,708,975,0,3,1,3,0,1,0,76.14,72.62 ,33.33
03,001,01,001,0115,287 ,667,7,674,1034,0,3,1,3,0,1,0,76.14,65.18 ,33.33
03,001,01,001,0115,288 ,533,13,546,870,0,3,1,3,0,1,0,76.14,62.76 ,33.33
03,001,01,001,0115,289 ,744,10,754,1130,0,3,1,3,0,1,0,76.14,66.73 ,33.33
03,001,01,001,0115,290 ,616,8,624,873,0,3,1,3,0,1,0,76.14,71.48 ,33.33
03,001,01,001,0116,291 ,407,29,436,691,0,3,1,3,0,1,0,76.14,63.10 ,33.33
03,001,01,001,0116,292 ,465,22,487,728,0,3,1,3,0,1,0,76.14,66.90 ,33.33
03,001,01,001,0116,293 ,454,24,478,697,0,3,1,3,0,1,0,76.14,68.58 ,33.33
03,001,01,001,0117,294 ,752,16,768,1167,0,3,1,3,0,1,0,76.14,65.81 ,33.33
03,001,01,001,0117,295 ,875,19,894,1283,0,3,1,3,0,1,0,76.14,69.68 ,33.33
03,001,01,001,0117,296 ,637,15,652,919,0,3,1,3,0,1,0,76.14,70.95 ,33.33
03,001,01,001,0118,297 ,828,19,847,1161,0,3,1,3,0,1,0,76.14,72.95 ,33.33
03,001,01,001,0118,298 ,611,12,623,1020,0,3,1,3,0,1,0,76.14,61.08 ,33.33
03,001,01,001,0119,299 ,547,12,559,866,0,3,1,3,0,1,0,76.14,64.55 ,33.33
03,001,01,001,0119,300 ,672,10,682,998,0,3,1,3,0,1,0,76.14,68.34 ,33.33
03,001,01,001,0119,301 ,558,11,569,893,0,3,1,3,0,1,0,76.14,63.72 ,33.33
03,001,01,001,0119,302 ,759,15,774,1157,0,3,1,3,0,1,0,76.14,66.90 ,33.33
03,001,01,001,0120,303 ,776,13,789,1148,0,3,1,3,0,1,0,76.14,68.73 ,33.33
03,001,01,001,0120,304 ,792,22,814,1232,0,3,1,3,0,1,0,76.14,66.07 ,33.33
03,001,01,001,0121,305 ,806,15,821,1224,0,3,1,3,0,1,0,76.14,67.08 ,33.33
03,001,01,001,0121,306 ,772,19,791,1288,0,3,1,3,0,1,0,76.14,61.41 ,33.33
03,001,01,001,0121,307 ,797,11,808,1217,0,3,1,3,0,1,0,76.14,66.39 ,33.33
03,001,01,001,0121,308 ,1053,10,1063,1586,0,3,1,3,0,1,0,76.14,67.02 ,33.33
03,001,01,001,0122,309 ,1166,28,1194,1828,0,3,1,3,0,1,0,76.14,65.32 ,33.33
03,001,01,001,0122,310 ,838,12,850,1284,0,3,1,3,0,1,0,76.14,66.20 ,33.33
03,001,01,001,0123,311 ,892,14,906,1284,0,3,1,3,0,1,0,76.14,70.56 ,33.33
03,001,01,001,0123,312 ,999,12,1011,1536,0,3,1,3,0,1,0,76.14,65.82 ,33.33
03,001,01,001,0123,313 ,810,16,826,1319,0,3,1,3,0,1,0,76.14,62.62 ,33.33
03,001,01,001,0124,314 ,1130,25,1155,1761,0,3,1,3,0,1,0,76.14,65.59 ,33.33
03,001,01,001,0124,315 ,1253,22,1275,1919,0,3,1,3,0,1,0,76.14,66.44 ,33.33
03,001,01,001,0124,316 ,1162,16,1178,1815,0,3,1,3,0,1,0,76.14,64.90 ,33.33
03,001,01,001,0124,317 ,1167,26,1193,1816,0,3,1,3,0,1,0,76.14,65.69 ,33.33
03,001,01,001,0125,318 ,797,13,810,1187,0,3,1,3,0,1,0,76.14,68.24 ,33.33
03,001,01,001,0125,319 ,911,12,923,1336,0,3,1,3,0,1,0,76.14,69.09 ,33.33
03,001,01,001,0126,320 ,884,13,897,1327,0,3,1,3,0,1,0,76.14,67.60 ,33.33
03,001,01,001,0126,321 ,968,10,978,1446,0,3,1,3,0,1,0,76.14,67.63 ,33.33
03,001,01,002,0127,322 ,877,12,889,1204,0,3,1,3,0,1,0,76.14,73.84 ,33.33
03,001,01,002,0128,323 ,872,20,892,1205,0,3,1,3,0,1,0,76.14,74.02 ,33.33
03,001,01,002,0129,324 ,738,16,754,1081,0,3,1,3,0,1,0,76.14,69.75 ,33.33
03,001,01,002,0129,325 ,645,9,654,959,0,3,1,3,0,1,0,76.14,68.20 ,33.33
03,001,01,002,0130,326 ,879,11,890,1264,0,3,1,3,0,1,0,76.14,70.41 ,33.33
03,001,01,002,0130,327 ,709,16,725,1120,0,3,1,3,0,1,0,76.14,64.73 ,33.33
03,001,01,002,0130,328 ,804,18,822,1255,0,3,1,3,0,1,0,76.14,65.50 ,33.33
03,001,01,002,0130,329 ,707,13,720,1021,0,3,1,3,0,1,0,76.14,70.52 ,33.33
03,001,01,002,0131,330 ,803,19,822,1181,0,3,1,3,0,1,0,76.14,69.60 ,33.33
03,001,01,002,0131,331 ,792,17,809,1197,0,3,1,3,0,1,0,76.14,67.59 ,33.33
03,001,01,002,0132,332 ,811,11,822,1255,0,3,1,3,0,1,0,76.14,65.50 ,33.33
03,001,01,002,0132,333 ,725,7,732,1108,0,3,1,3,0,1,0,76.14,66.06 ,33.33
03,001,01,002,0132,334 ,794,16,810,1206,0,3,1,3,0,1,0,76.14,67.16 ,33.33
03,001,01,002,0132,335 ,1075,17,1092,1596,0,3,1,3,0,1,0,76.14,68.42 ,33.33
03,001,01,002,0133,336 ,447,6,453,640,0,3,1,3,0,1,0,76.14,70.78 ,33.33
03,001,01,002,0133,337 ,1008,19,1027,1497,0,3,1,3,0,1,0,76.14,68.60 ,33.33
03,001,01,002,0133,338 ,820,9,829,1293,0,3,1,3,0,1,0,76.14,64.11 ,33.33
03,001,01,002,0134,339 ,895,25,920,1390,0,3,1,3,0,1,0,76.14,66.19 ,33.33
03,001,01,002,0134,340 ,718,16,734,1100,0,3,1,3,0,1,0,76.14,66.73 ,33.33
03,001,01,002,0134,341 ,934,9,943,1438,0,3,1,3,0,1,0,76.14,65.58 ,33.33
03,001,01,002,0135,342 ,614,14,628,1155,0,3,1,3,0,1,0,76.14,54.37 ,33.33
03,001,01,002,0135,343 ,772,13,785,1134,0,3,1,3,0,1,0,76.14,69.22 ,33.33
03,001,01,002,0136,344 ,1067,16,1083,1620,0,3,1,3,0,1,0,76.14,66.85 ,33.33
03,001,01,002,0137,345 ,957,16,973,1273,0,3,1,3,0,1,0,76.14,76.43 ,33.33
03,001,01,002,0138,346 ,1135,15,1150,1642,0,3,1,3,0,1,0,76.14,70.04 ,33.33
03,001,01,002,0138,347 ,976,8,984,1409,0,3,1,3,0,1,0,76.14,69.84 ,33.33
03,001,01,002,0139,348 ,815,12,827,1216,0,3,1,3,0,1,0,76.14,68.01 ,33.33
03,001,01,002,0139,349 ,1021,13,1034,1485,0,3,1,3,0,1,0,76.14,69.63 ,33.33
03,001,01,002,0139,350 ,945,19,964,1350,0,3,1,3,0,1,0,76.14,71.41 ,33.33
03,001,01,002,0140,351 ,761,13,774,1040,0,3,1,3,0,1,0,76.14,74.42 ,33.33
03,001,01,002,0140,352 ,995,13,1008,1445,0,3,1,3,0,1,0,76.14,69.76 ,33.33
03,001,01,002,0140,353 ,1045,19,1064,1523,0,3,1,3,0,1,0,76.14,69.86 ,33.33
03,001,01,002,0141,354 ,808,9,817,1199,0,3,1,3,0,1,0,76.14,68.14 ,33.33
03,001,01,002,0141,355 ,993,14,1007,1507,0,3,1,3,0,1,0,76.14,66.82 ,33.33
03,001,01,002,0141,356 ,782,6,788,1176,0,3,1,3,0,1,0,76.14,67.01 ,33.33
03,001,01,002,0142,357 ,907,12,919,1344,0,3,1,3,0,1,0,76.14,68.38 ,33.33
03,001,01,002,0142,358 ,789,13,802,1115,0,3,1,3,0,1,0,76.14,71.93 ,33.33
03,001,01,002,0142,359 ,788,14,802,1136,0,3,1,3,0,1,0,76.14,70.60 ,33.33
03,001,01,002,0143,360 ,971,14,985,1420,0,3,1,3,0,1,0,76.14,69.37 ,33.33
03,001,01,002,0143,361 ,900,19,919,1412,0,3,1,3,0,1,0,76.14,65.08 ,33.33
03,001,01,002,0143,362 ,926,15,941,1409,0,3,1,3,0,1,0,76.14,66.78 ,33.33
03,001,01,002,0144,363 ,1013,14,1027,1468,0,3,1,3,0,1,0,76.14,69.96 ,33.33
03,001,01,002,0144,364 ,1026,13,1039,1498,0,3,1,3,0,1,0,76.14,69.36 ,33.33
03,001,01,002,0145,365 ,972,10,982,1319,0,3,1,3,0,1,0,76.14,74.45 ,33.33
03,001,01,002,0145,366 ,856,15,871,1242,0,3,1,3,0,1,0,76.14,70.13 ,33.33
03,001,01,002,0146,367 ,990,16,1006,1520,0,3,1,3,0,1,0,76.14,66.18 ,33.33
03,001,01,002,0146,368 ,1183,16,1199,1696,0,3,1,3,0,1,0,76.14,70.70 ,33.33
03,001,01,002,0147,369 ,888,9,897,1284,0,3,1,3,0,1,0,76.14,69.86 ,33.33
03,001,01,002,0147,370 ,812,10,822,1182,0,3,1,3,0,1,0,76.14,69.54 ,33.33
03,001,01,002,0147,371 ,911,9,920,1281,0,3,1,3,0,1,0,76.14,71.82 ,33.33
03,001,01,002,0148,372 ,908,18,926,1280,0,3,1,3,0,1,0,76.14,72.34 ,33.33
03,001,01,002,0148,373 ,759,11,770,1094,0,3,1,3,0,1,0,76.14,70.38 ,33.33
03,001,01,002,0149,374 ,875,13,888,1284,0,3,1,3,0,1,0,76.14,69.16 ,33.33
03,001,01,002,0149,375 ,706,7,713,1075,0,3,1,3,0,1,0,76.14,66.33 ,33.33
03,001,01,002,0149,376 ,731,5,736,1053,0,3,1,3,0,1,0,76.14,69.90 ,33.33
03,001,01,002,0149,377 ,796,9,805,1155,0,3,1,3,0,1,0,76.14,69.70 ,33.33
03,001,01,002,0149,378 ,652,4,656,920,0,3,1,3,0,1,0,76.14,71.30 ,33.33
03,001,01,002,0150,379 ,649,9,658,1020,0,3,1,3,0,1,0,76.14,64.51 ,33.33
03,001,01,002,0150,380 ,914,17,931,1375,0,3,1,3,0,1,0,76.14,67.71 ,33.33
03,001,01,002,0151,381 ,885,18,903,1348,0,3,1,3,0,1,0,76.14,66.99 ,33.33
03,001,01,002,0151,382 ,920,16,936,1402,0,3,1,3,0,1,0,76.14,66.76 ,33.33
03,001,01,002,0151,383 ,762,10,772,1277,0,3,1,3,0,1,0,76.14,60.45 ,33.33
03,001,01,002,0152,384 ,898,18,916,1369,0,3,1,3,0,1,0,76.14,66.91 ,33.33
03,001,01,002,0152,385 ,742,16,758,1109,0,3,1,3,0,1,0,76.14,68.35 ,33.33
03,001,01,002,0153,386 ,644,14,658,965,0,3,1,3,0,1,0,76.14,68.19 ,33.33
03,001,01,002,0153,387 ,631,5,636,952,0,3,1,3,0,1,0,76.14,66.81 ,33.33
03,001,01,002,0153,388 ,766,13,779,1123,0,3,1,3,0,1,0,76.14,69.37 ,33.33
03,001,01,002,0154,389 ,1112,14,1126,1600,0,3,1,3,0,1,0,76.14,70.38 ,33.33
03,001,01,002,0154,390 ,1039,11,1050,1486,0,3,1,3,0,1,0,76.14,70.66 ,33.33
03,001,01,002,0155,391 ,659,6,665,964,0,3,1,3,0,1,0,76.14,68.98 ,33.33
03,001,01,002,0155,392 ,622,7,629,866,0,3,1,3,0,1,0,76.14,72.63 ,33.33
03,001,01,002,0156,393 ,711,9,720,1068,0,3,1,3,0,1,0,76.14,67.42 ,33.33
03,001,01,002,0156,394 ,696,12,708,1032,0,3,1,3,0,1,0,76.14,68.60 ,33.33
03,001,01,002,0157,395 ,824,17,841,1195,0,3,1,3,0,1,0,76.14,70.38 ,33.33
03,001,01,002,0157,396 ,620,5,625,862,0,3,1,3,0,1,0,76.14,72.51 ,33.33
03,001,01,002,0158,397 ,969,18,987,1409,0,3,1,3,0,1,0,76.14,70.05 ,33.33
03,001,01,002,0158,398 ,1106,19,1125,1694,0,3,1,3,0,1,0,76.14,66.41 ,33.33
03,001,01,002,0158,399 ,971,11,982,1430,0,3,1,3,0,1,0,76.14,68.67 ,33.33
03,001,01,002,0159,400 ,875,12,887,1269,0,3,1,3,0,1,0,76.14,69.90 ,33.33
03,001,01,002,0160,401 ,730,15,745,1062,0,3,1,3,0,1,0,76.14,70.15 ,33.33
03,001,01,002,0160,402 ,678,12,690,968,0,3,1,3,0,1,0,76.14,71.28 ,33.33
03,001,01,002,0160,403 ,992,21,1013,1439,0,3,1,3,0,1,0,76.14,70.40 ,33.33
03,001,01,002,0160,404 ,1044,18,1062,1516,0,3,1,3,0,1,0,76.14,70.05 ,33.33
03,001,01,002,0161,405 ,766,9,775,1090,0,3,1,3,0,1,0,76.14,71.10 ,33.33
03,001,01,002,0161,406 ,772,15,787,1130,0,3,1,3,0,1,0,76.14,69.65 ,33.33
03,001,01,002,0162,407 ,873,14,887,1298,0,3,1,3,0,1,0,76.14,68.34 ,33.33
03,001,01,002,0162,408 ,946,10,956,1338,0,3,1,3,0,1,0,76.14,71.45 ,33.33
03,001,01,002,0162,409 ,801,11,812,1238,0,3,1,3,0,1,0,76.14,65.59 ,33.33
03,001,01,002,0162,410 ,891,7,898,1330,0,3,1,3,0,1,0,76.14,67.52 ,33.33
03,001,01,002,0163,411 ,799,12,811,1149,0,3,1,3,0,1,0,76.14,70.58 ,33.33
03,001,01,002,0163,412 ,711,16,727,1073,0,3,1,3,0,1,0,76.14,67.75 ,33.33
03,001,01,002,0164,413 ,738,11,749,1151,0,3,1,3,0,1,0,76.14,65.07 ,33.33
03,001,01,002,0164,414 ,868,21,889,1321,0,3,1,3,0,1,0,76.14,67.30 ,33.33
03,001,01,002,0164,415 ,832,13,845,1328,0,3,1,3,0,1,0,76.14,63.63 ,33.33
03,001,01,002,0165,416 ,734,12,746,1106,0,3,1,3,0,1,0,76.14,67.45 ,33.33
03,001,01,002,0165,417 ,642,7,649,955,0,3,1,3,0,1,0,76.14,67.96 ,33.33
03,001,01,002,0165,418 ,762,8,770,1127,0,3,1,3,0,1,0,76.14,68.32 ,33.33
03,001,01,002,0166,419 ,867,12,879,1364,0,3,1,3,0,1,0,76.14,64.44 ,33.33
03,001,01,002,0166,420 ,721,11,732,1040,0,3,1,3,0,1,0,76.14,70.38 ,33.33
03,001,01,002,0166,421 ,954,9,963,1392,0,3,1,3,0,1,0,76.14,69.18 ,33.33
03,001,01,002,0167,422 ,721,12,733,1072,0,3,1,3,0,1,0,76.14,68.38 ,33.33
03,001,01,002,0167,423 ,892,15,907,1367,0,3,1,3,0,1,0,76.14,66.35 ,33.33
03,001,01,002,0167,424 ,854,11,865,1334,0,3,1,3,0,1,0,76.14,64.84 ,33.33
03,001,01,002,0167,425 ,924,7,931,1444,0,3,1,3,0,1,0,76.14,64.47 ,33.33
03,001,01,002,0168,426 ,954,22,976,1430,0,3,1,3,0,1,0,76.14,68.25 ,33.33
03,001,01,002,0168,427 ,1173,16,1189,1707,0,3,1,3,0,1,0,76.14,69.65 ,33.33
03,001,01,002,0169,428 ,1200,20,1220,1800,0,3,1,3,0,1,0,76.14,67.78 ,33.33
03,001,01,002,0169,429 ,953,9,962,1400,0,3,1,3,0,1,0,76.14,68.71 ,33.33
03,001,01,002,0170,430 ,920,11,931,1366,0,3,1,3,0,1,0,76.14,68.16 ,33.33
03,001,01,002,0170,431 ,1130,9,1139,1665,0,3,1,3,0,1,0,76.14,68.41 ,33.33
03,001,01,002,0171,432 ,853,17,870,1212,0,3,1,3,0,1,0,76.14,71.78 ,33.33
03,001,01,002,0171,433 ,958,14,972,1373,0,3,1,3,0,1,0,76.14,70.79 ,33.33
03,001,01,002,0171,434 ,651,6,657,984,0,3,1,3,0,1,0,76.14,66.77 ,33.33
03,001,01,002,0171,435 ,826,22,848,1234,0,3,1,3,0,1,0,76.14,68.72 ,33.33
03,001,01,002,0172,436 ,911,15,926,1359,0,3,1,3,0,1,0,76.14,68.14 ,33.33
03,001,01,002,0172,437 ,696,8,704,1030,0,3,1,3,0,1,0,76.14,68.35 ,33.33
03,001,01,002,0172,438 ,845,11,856,1244,0,3,1,3,0,1,0,76.14,68.81 ,33.33
03,001,01,002,0173,439 ,766,14,780,1152,0,3,1,3,0,1,0,76.14,67.71 ,33.33
03,001,01,002,0173,440 ,916,20,936,1416,0,3,1,3,0,1,0,76.14,66.10 ,33.33
03,001,01,002,0173,441 ,1112,19,1131,1753,0,3,1,3,0,1,0,76.14,64.52 ,33.33
03,001,01,003,0174,442 ,767,12,779,1152,0,3,1,3,0,1,0,76.14,67.62 ,33.33
03,001,01,003,0174,443 ,833,17,850,1201,0,3,1,3,0,1,0,76.14,70.77 ,33.33
03,001,01,003,0174,444 ,694,16,710,985,0,3,1,3,0,1,0,76.14,72.08 ,33.33
03,001,01,003,0174,445 ,705,8,713,1024,0,3,1,3,0,1,0,76.14,69.63 ,33.33
03,001,01,003,0175,446 ,664,10,674,1029,0,3,1,3,0,1,0,76.14,65.50 ,33.33
03,001,01,003,0175,447 ,650,16,666,956,0,3,1,3,0,1,0,76.14,69.67 ,33.33
03,001,01,003,0175,448 ,608,13,621,934,0,3,1,3,0,1,0,76.14,66.49 ,33.33
03,001,01,003,0176,449 ,671,12,683,971,0,3,1,3,0,1,0,76.14,70.34 ,33.33
03,001,01,003,0176,450 ,866,15,881,1413,0,3,1,3,0,1,0,76.14,62.35 ,33.33
03,001,01,003,0177,451 ,594,5,599,910,0,3,1,3,0,1,0,76.14,65.82 ,33.33
03,001,01,003,0177,452 ,603,5,608,954,0,3,1,3,0,1,0,76.14,63.73 ,33.33
03,001,01,003,0178,453 ,789,12,801,1128,0,3,1,3,0,1,0,76.14,71.01 ,33.33
03,001,01,003,0179,454 ,1002,20,1022,1466,0,3,1,3,0,1,0,76.14,69.71 ,33.33
03,001,01,003,0180,455 ,798,23,821,1288,0,3,1,3,0,1,0,76.14,63.74 ,33.33
03,001,01,003,0180,456 ,988,24,1012,1420,0,3,1,3,0,1,0,76.14,71.27 ,33.33
03,001,01,003,0181,457 ,725,10,735,1092,0,3,1,3,0,1,0,76.14,67.31 ,33.33
03,001,01,003,0181,458 ,743,11,754,1102,0,3,1,3,0,1,0,76.14,68.42 ,33.33
03,001,01,003,0181,459 ,639,11,650,967,0,3,1,3,0,1,0,76.14,67.22 ,33.33
03,001,01,003,0182,460 ,633,11,644,996,0,3,1,3,0,1,0,76.14,64.66 ,33.33
03,001,01,003,0182,461 ,774,13,787,1233,0,3,1,3,0,1,0,76.14,63.83 ,33.33
03,001,01,003,0182,462 ,809,7,816,1318,0,3,1,3,0,1,0,76.14,61.91 ,33.33
03,001,01,003,0183,463 ,724,8,732,1047,0,3,1,3,0,1,0,76.14,69.91 ,33.33
03,001,01,003,0183,464 ,750,14,764,1171,0,3,1,3,0,1,0,76.14,65.24 ,33.33
03,001,01,003,0183,465 ,636,9,645,1021,0,3,1,3,0,1,0,76.14,63.17 ,33.33
03,001,01,003,0184,466 ,827,20,847,1251,0,3,1,3,0,1,0,76.14,67.71 ,33.33
03,001,01,003,0184,467 ,764,11,775,1277,0,3,1,3,0,1,0,76.14,60.69 ,33.33
03,001,01,003,0185,468 ,873,20,893,1310,0,3,1,3,0,1,0,76.14,68.17 ,33.33
03,001,01,003,0185,469 ,838,14,852,1382,0,3,1,3,0,1,0,76.14,61.65 ,33.33
03,001,01,003,0186,470 ,653,4,657,1059,0,3,1,3,0,1,0,76.14,62.04 ,33.33
03,001,01,003,0186,471 ,647,11,658,942,0,3,1,3,0,1,0,76.14,69.85 ,33.33
03,001,01,003,0186,472 ,831,16,847,1259,0,3,1,3,0,1,0,76.14,67.28 ,33.33
03,001,01,003,0187,473 ,802,24,826,1209,0,3,1,3,0,1,0,76.14,68.32 ,33.33
03,001,01,003,0187,474 ,683,4,687,1065,0,3,1,3,0,1,0,76.14,64.51 ,33.33
03,001,01,003,0187,475 ,611,10,621,1002,0,3,1,3,0,1,0,76.14,61.98 ,33.33
03,001,01,003,0188,476 ,716,10,726,993,0,3,1,3,0,1,0,76.14,73.11 ,33.33
03,001,01,003,0189,477 ,755,11,766,1042,0,3,1,3,0,1,0,76.14,73.51 ,33.33
03,001,01,003,0190,478 ,756,16,772,1076,0,3,1,3,0,1,0,76.14,71.75 ,33.33
03,001,01,003,0190,479 ,589,13,602,816,0,3,1,3,0,1,0,76.14,73.77 ,33.33
03,001,01,003,0191,480 ,864,4,868,1250,0,3,1,3,0,1,0,76.14,69.44 ,33.33
03,001,01,003,0191,481 ,1109,13,1122,1598,0,3,1,3,0,1,0,76.14,70.21 ,33.33
03,001,01,003,0192,482 ,716,12,728,1020,0,3,1,3,0,1,0,76.14,71.37 ,33.33
03,001,01,003,0192,483 ,948,12,960,1343,0,3,1,3,0,1,0,76.14,71.48 ,33.33
03,001,01,003,0192,484 ,1022,13,1035,1444,0,3,1,3,0,1,0,76.14,71.68 ,33.33
03,001,01,003,0193,485 ,714,19,733,1006,0,3,1,3,0,1,0,76.14,72.86 ,33.33
03,001,01,003,0193,486 ,807,15,822,1144,0,3,1,3,0,1,0,76.14,71.85 ,33.33
03,001,01,003,0194,487 ,1063,14,1077,1574,0,3,1,3,0,1,0,76.14,68.42 ,33.33
03,001,01,003,0194,488 ,1002,12,1014,1466,0,3,1,3,0,1,0,76.14,69.17 ,33.33
03,001,01,003,0195,489 ,841,17,858,1212,0,3,1,3,0,1,0,76.14,70.79 ,33.33
03,001,01,003,0195,490 ,851,15,866,1232,0,3,1,3,0,1,0,76.14,70.29 ,33.33
03,001,01,003,0196,491 ,795,13,808,1155,0,3,1,3,0,1,0,76.14,69.96 ,33.33
03,001,01,003,0196,492 ,1071,12,1083,1568,0,3,1,3,0,1,0,76.14,69.07 ,33.33
03,001,01,003,0197,493 ,843,10,853,1197,0,3,1,3,0,1,0,76.14,71.26 ,33.33
03,001,01,003,0198,494 ,874,12,886,1208,0,3,1,3,0,1,0,76.14,73.34 ,33.33
03,001,01,003,0198,495 ,610,12,622,957,0,3,1,3,0,1,0,76.14,64.99 ,33.33
03,001,01,003,0199,496 ,677,13,690,1075,0,3,1,3,0,1,0,76.14,64.19 ,33.33
03,001,01,003,0199,497 ,615,2,617,995,0,3,1,3,0,1,0,76.14,62.01 ,33.33
03,001,01,003,0200,498 ,548,8,556,895,0,3,1,3,0,1,0,76.14,62.12 ,33.33
03,001,01,003,0200,499 ,618,8,626,959,0,3,1,3,0,1,0,76.14,65.28 ,33.33
03,001,01,003,0201,500 ,1087,20,1107,1544,0,3,1,3,0,1,0,76.14,71.70 ,33.33
03,001,01,003,0201,501 ,951,20,971,1497,0,3,1,3,0,1,0,76.14,64.86 ,33.33
03,001,01,003,0202,502 ,787,12,799,1259,0,3,1,3,0,1,0,76.14,63.46 ,33.33
03,001,01,003,0202,503 ,814,23,837,1317,0,3,1,3,0,1,0,76.14,63.55 ,33.33
03,001,01,003,0202,504 ,782,9,791,1256,0,3,1,3,0,1,0,76.14,62.98 ,33.33
03,001,01,003,0203,505 ,1024,20,1044,1597,0,3,1,3,0,1,0,76.14,65.37 ,33.33
03,001,01,003,0203,506 ,983,17,1000,1548,0,3,1,3,0,1,0,76.14,64.60 ,33.33
03,001,01,003,0204,507 ,771,6,777,1190,0,3,1,3,0,1,0,76.14,65.29 ,33.33
03,001,01,003,0204,508 ,751,14,765,1130,0,3,1,3,0,1,0,76.14,67.70 ,33.33
03,001,01,003,0204,509 ,668,8,676,998,0,3,1,3,0,1,0,76.14,67.74 ,33.33
03,001,01,003,0205,510 ,638,12,650,914,0,3,1,3,0,1,0,76.14,71.12 ,33.33
03,001,01,003,0205,511 ,777,6,783,1084,0,3,1,3,0,1,0,76.14,72.23 ,33.33
03,001,01,003,0205,512 ,574,9,583,819,0,3,1,3,0,1,0,76.14,71.18 ,33.33
03,001,01,003,0206,513 ,862,20,882,1306,0,3,1,3,0,1,0,76.14,67.53 ,33.33
03,001,01,003,0206,514 ,886,10,896,1300,0,3,1,3,0,1,0,76.14,68.92 ,33.33
03,001,01,003,0206,515 ,971,12,983,1430,0,3,1,3,0,1,0,76.14,68.74 ,33.33
03,001,01,003,0207,516 ,958,9,967,1424,0,3,1,3,0,1,0,76.14,67.91 ,33.33
03,001,01,003,0207,517 ,691,13,704,1036,0,3,1,3,0,1,0,76.14,67.95 ,33.33
03,001,01,003,0208,518 ,606,11,617,913,0,3,1,3,0,1,0,76.14,67.58 ,33.33
03,001,01,003,0208,519 ,689,8,697,1001,0,3,1,3,0,1,0,76.14,69.63 ,33.33
03,001,01,003,0208,520 ,501,6,507,713,0,3,1,3,0,1,0,76.14,71.11 ,33.33
03,001,01,003,0209,521 ,901,17,918,1300,0,3,1,3,0,1,0,76.14,70.62 ,33.33
03,001,01,003,0209,522 ,866,16,882,1279,0,3,1,3,0,1,0,76.14,68.96 ,33.33
03,001,01,003,0210,523 ,747,7,754,1176,0,3,1,3,0,1,0,76.14,64.12 ,33.33
03,001,01,003,0211,524 ,880,17,897,1260,0,3,1,3,0,1,0,76.14,71.19 ,33.33
03,001,01,003,0212,525 ,895,12,907,1297,0,3,1,3,0,1,0,76.14,69.93 ,33.33
03,001,01,003,0213,526 ,860,7,867,1204,0,3,1,3,0,1,0,76.14,72.01 ,33.33
03,001,01,003,0214,527 ,467,7,474,639,0,3,1,3,0,1,0,76.14,74.18 ,33.33
03,001,01,003,0215,528 ,806,18,824,1201,0,3,1,3,0,1,0,76.14,68.61 ,33.33
03,001,01,004,0216,529 ,312,2,314,449,0,3,1,3,0,1,0,76.14,69.93 ,33.33
03,001,01,004,0217,530 ,670,5,675,899,0,3,1,3,0,1,0,76.14,75.08 ,33.33
03,001,01,004,0218,531 ,910,9,919,1240,0,3,1,3,0,1,0,76.14,74.11 ,33.33
03,001,01,004,0219,532 ,705,3,708,1008,0,3,1,3,0,1,0,76.14,70.24 ,33.33
03,001,01,004,0219,533 ,584,10,594,814,0,3,1,3,0,1,0,76.14,72.97 ,33.33
03,001,01,004,0220,534 ,588,4,592,794,0,3,1,3,0,1,0,76.14,74.56 ,33.33
03,001,01,004,0221,535 ,979,12,991,1360,0,3,1,3,0,1,0,76.14,72.87 ,33.33
03,001,01,004,0221,536 ,892,13,905,1279,0,3,1,3,0,1,0,76.14,70.76 ,33.33
03,001,01,004,0221,537 ,862,5,867,1236,0,3,1,3,0,1,0,76.14,70.15 ,33.33
03,001,01,004,0222,538 ,952,21,973,1389,0,3,1,3,0,1,0,76.14,70.05 ,33.33
03,001,01,004,0222,539 ,845,10,855,1322,0,3,1,3,0,1,0,76.14,64.67 ,33.33
03,001,01,004,0222,540 ,796,8,804,1221,0,3,1,3,0,1,0,76.14,65.85 ,33.33
03,001,01,004,0223,541 ,996,13,1009,1393,0,3,1,3,0,1,0,76.14,72.43 ,33.33
03,001,01,004,0223,542 ,808,9,817,1196,0,3,1,3,0,1,0,76.14,68.31 ,33.33
03,001,01,004,0224,543 ,877,15,892,1243,0,3,1,3,0,1,0,76.14,71.76 ,33.33
03,001,01,004,0224,544 ,946,4,950,1338,0,3,1,3,0,1,0,76.14,71.00 ,33.33
03,001,01,004,0224,545 ,954,16,970,1417,0,3,1,3,0,1,0,76.14,68.45 ,33.33
03,001,01,004,0225,546 ,1079,13,1092,1592,0,3,1,3,0,1,0,76.14,68.59 ,33.33
03,001,01,004,0225,547 ,1083,14,1097,1511,0,3,1,3,0,1,0,76.14,72.60 ,33.33
03,001,01,004,0225,548 ,1168,16,1184,1647,0,3,1,3,0,1,0,76.14,71.89 ,33.33
03,001,01,004,0226,549 ,531,9,540,745,0,3,1,3,0,1,0,76.14,72.48 ,33.33
03,001,01,004,0227,550 ,889,7,896,1208,0,3,1,3,0,1,0,76.14,74.17 ,33.33
03,001,01,004,0228,551 ,849,22,871,1357,0,3,1,3,0,1,0,76.14,64.19 ,33.33
03,001,01,004,0228,552 ,1075,11,1086,1614,0,3,1,3,0,1,0,76.14,67.29 ,33.33
03,001,01,004,0228,553 ,997,10,1007,1515,0,3,1,3,0,1,0,76.14,66.47 ,33.33
03,001,01,004,0228,554 ,992,14,1006,1388,0,3,1,3,0,1,0,76.14,72.48 ,33.33
03,001,01,004,0229,555 ,857,15,872,1226,0,3,1,3,0,1,0,76.14,71.13 ,33.33
03,001,01,004,0229,556 ,792,11,803,1137,0,3,1,3,0,1,0,76.14,70.62 ,33.33
03,001,01,004,0229,557 ,680,7,687,1002,0,3,1,3,0,1,0,76.14,68.56 ,33.33
03,001,01,004,0230,558 ,1040,19,1059,1566,0,3,1,3,0,1,0,76.14,67.62 ,33.33
03,001,01,004,0230,559 ,1122,14,1136,1714,0,3,1,3,0,1,0,76.14,66.28 ,33.33
03,001,01,004,0231,560 ,832,15,847,1207,0,3,1,3,0,1,0,76.14,70.17 ,33.33
03,001,01,004,0231,561 ,655,6,661,1024,0,3,1,3,0,1,0,76.14,64.55 ,33.33
03,001,01,004,0231,562 ,601,6,607,1013,0,3,1,3,0,1,0,76.14,59.92 ,33.33
03,001,01,004,0232,563 ,625,8,633,960,0,3,1,3,0,1,0,76.14,65.94 ,33.33
03,001,01,004,0232,564 ,684,12,696,1030,0,3,1,3,0,1,0,76.14,67.57 ,33.33
03,001,01,004,0232,565 ,819,14,833,1222,0,3,1,3,0,1,0,76.14,68.17 ,33.33
03,001,01,004,0233,566 ,852,12,864,1258,0,3,1,3,0,1,0,76.14,68.68 ,33.33
03,001,01,004,0233,567 ,1002,15,1017,1436,0,3,1,3,0,1,0,76.14,70.82 ,33.33
03,001,01,004,0233,568 ,804,11,815,1179,0,3,1,3,0,1,0,76.14,69.13 ,33.33
03,001,01,004,0234,569 ,974,14,988,1535,0,3,1,3,0,1,0,76.14,64.36 ,33.33
03,001,01,004,0234,570 ,850,13,863,1226,0,3,1,3,0,1,0,76.14,70.39 ,33.33
03,001,01,004,0234,571 ,948,11,959,1359,0,3,1,3,0,1,0,76.14,70.57 ,33.33
03,001,01,004,0235,572 ,168,2,170,230,0,3,1,3,0,1,0,76.14,73.91 ,33.33
03,001,01,005,0236,573 ,235,4,239,322,0,3,1,3,0,1,0,76.14,74.22 ,33.33
03,001,01,005,0237,574 ,316,3,319,410,0,3,1,3,0,1,0,76.14,77.80 ,33.33
03,001,01,005,0238,575 ,885,12,897,1219,0,3,1,3,0,1,0,76.14,73.58 ,33.33
03,001,01,005,0238,576 ,858,20,878,1246,0,3,1,3,0,1,0,76.14,70.47 ,33.33
03,001,01,005,0239,577 ,933,15,948,1365,0,3,1,3,0,1,0,76.14,69.45 ,33.33
03,001,01,005,0240,578 ,587,4,591,812,0,3,1,3,0,1,0,76.14,72.78 ,33.33
03,001,01,005,0241,579 ,1016,8,1024,1487,0,3,1,3,0,1,0,76.14,68.86 ,33.33
03,001,01,005,0241,580 ,1053,8,1061,1521,0,3,1,3,0,1,0,76.14,69.76 ,33.33
03,001,01,005,0241,581 ,1023,10,1033,1511,0,3,1,3,0,1,0,76.14,68.37 ,33.33
03,001,01,005,0242,582 ,700,5,705,1061,0,3,1,3,0,1,0,76.14,66.45 ,33.33
03,001,01,005,0242,583 ,764,4,768,1125,0,3,1,3,0,1,0,76.14,68.27 ,33.33
03,001,01,005,0242,584 ,766,10,776,1094,0,3,1,3,0,1,0,76.14,70.93 ,33.33
03,001,01,005,0243,585 ,727,12,739,1091,0,3,1,3,0,1,0,76.14,67.74 ,33.33
03,001,01,005,0243,586 ,590,4,594,825,0,3,1,3,0,1,0,76.14,72.00 ,33.33
03,001,01,005,0243,587 ,657,10,667,1014,0,3,1,3,0,1,0,76.14,65.78 ,33.33
03,001,01,005,0244,588 ,731,11,742,1052,0,3,1,3,0,1,0,76.14,70.53 ,33.33
03,001,01,005,0244,589 ,707,9,716,1086,0,3,1,3,0,1,0,76.14,65.93 ,33.33
03,001,01,005,0244,590 ,729,7,736,1128,0,3,1,3,0,1,0,76.14,65.25 ,33.33
03,001,01,005,0245,591 ,874,14,888,1268,0,3,1,3,0,1,0,76.14,70.03 ,33.33
03,001,01,005,0245,592 ,867,14,881,1330,0,3,1,3,0,1,0,76.14,66.24 ,33.33
03,001,01,005,0245,593 ,821,12,833,1147,0,3,1,3,0,1,0,76.14,72.62 ,33.33
03,001,01,005,0245,594 ,761,9,770,1102,0,3,1,3,0,1,0,76.14,69.87 ,33.33
03,001,01,005,0246,595 ,643,12,655,1016,0,3,1,3,0,1,0,76.14,64.47 ,33.33
03,001,01,005,0246,596 ,796,14,810,1151,0,3,1,3,0,1,0,76.14,70.37 ,33.33
03,001,01,005,0246,597 ,941,14,955,1412,0,3,1,3,0,1,0,76.14,67.63 ,33.33
03,001,01,005,0246,598 ,872,12,884,1335,0,3,1,3,0,1,0,76.14,66.22 ,33.33
03,001,01,005,0247,599 ,1021,16,1037,1450,0,3,1,3,0,1,0,76.14,71.52 ,33.33
03,001,01,005,0247,600 ,815,3,818,1192,0,3,1,3,0,1,0,76.14,68.62 ,33.33
03,001,01,005,0247,601 ,866,11,877,1328,0,3,1,3,0,1,0,76.14,66.04 ,33.33
03,001,01,005,0247,602 ,892,15,907,1389,0,3,1,3,0,1,0,76.14,65.30 ,33.33
03,001,01,005,0248,603 ,1101,15,1116,1642,0,3,1,3,0,1,0,76.14,67.97 ,33.33
03,001,01,005,0248,604 ,1049,9,1058,1486,0,3,1,3,0,1,0,76.14,71.20 ,33.33
03,001,01,005,0249,605 ,675,11,686,1083,0,3,1,3,0,1,0,76.14,63.34 ,33.33
03,001,01,005,0249,606 ,728,9,737,1154,0,3,1,3,0,1,0,76.14,63.86 ,33.33
03,001,01,005,0250,607 ,825,35,860,1181,0,3,1,3,0,1,0,76.14,72.82 ,33.33
03,001,01,005,0250,608 ,932,29,961,1400,0,3,1,3,0,1,0,76.14,68.64 ,33.33
03,001,01,005,0251,609 ,662,12,674,944,0,3,1,3,0,1,0,76.14,71.40 ,33.33
03,001,01,005,0252,610 ,602,7,609,891,0,3,1,3,0,1,0,76.14,68.35 ,33.33
03,001,01,005,0253,611 ,298,7,305,458,0,3,1,3,0,1,0,76.14,66.59 ,33.33
03,001,01,005,0254,612 ,559,6,565,827,0,3,1,3,0,1,0,76.14,68.32 ,33.33
03,001,01,005,0255,613 ,566,6,572,799,0,3,1,3,0,1,0,76.14,71.59 ,33.33
03,001,01,005,0256,614 ,847,11,858,1167,0,3,1,3,0,1,0,76.14,73.52 ,33.33
03,001,01,005,0257,615 ,392,13,405,565,0,3,1,3,0,1,0,76.14,71.68 ,33.33
03,001,01,005,0257,616 ,870,16,886,1220,0,3,1,3,0,1,0,76.14,72.62 ,33.33
03,001,01,005,0258,617 ,670,14,684,981,0,3,1,3,0,1,0,76.14,69.72 ,33.33
03,001,01,005,0258,618 ,834,10,844,1232,0,3,1,3,0,1,0,76.14,68.51 ,33.33
03,001,01,005,0259,619 ,640,5,645,822,0,3,1,3,0,1,0,76.14,78.47 ,33.33
03,001,01,005,0260,620 ,815,17,832,1264,0,3,1,3,0,1,0,76.14,65.82 ,33.33
03,001,01,005,0261,621 ,545,56,601,843,0,3,1,3,0,1,0,76.14,71.29 ,33.33
03,001,01,005,0261,622 ,587,9,596,892,0,3,1,3,0,1,0,76.14,66.82 ,33.33
03,001,02,006,0262,623 ,956,18,974,1414,0,3,1,3,0,1,0,76.14,68.88 ,33.33
03,001,02,006,0262,624 ,833,13,846,1197,0,3,1,3,0,1,0,76.14,70.68 ,33.33
03,001,02,006,0262,625 ,509,4,513,746,0,3,1,3,0,1,0,76.14,68.77 ,33.33
03,001,02,006,0263,626 ,788,12,800,1166,0,3,1,3,0,1,0,76.14,68.61 ,33.33
03,001,02,006,0264,627 ,920,21,941,1325,0,3,1,3,0,1,0,76.14,71.02 ,33.33
03,001,02,006,0265,628 ,572,8,580,919,0,3,1,3,0,1,0,76.14,63.11 ,33.33
03,001,02,006,0266,629 ,503,15,518,804,0,3,1,3,0,1,0,76.14,64.43 ,33.33
03,001,02,006,0266,630 ,523,11,534,825,0,3,1,3,0,1,0,76.14,64.73 ,33.33
03,001,02,006,0267,631 ,562,13,575,862,0,3,1,3,0,1,0,76.14,66.71 ,33.33
03,001,02,006,0267,632 ,781,9,790,1127,0,3,1,3,0,1,0,76.14,70.10 ,33.33
03,001,02,006,0268,633 ,685,10,695,959,0,3,1,3,0,1,0,76.14,72.47 ,33.33
03,001,02,006,0269,634 ,584,5,589,881,0,3,1,3,0,1,0,76.14,66.86 ,33.33
03,001,02,006,0269,635 ,1056,31,1087,1576,0,3,1,3,0,1,0,76.14,68.97 ,33.33
03,001,02,006,0270,636 ,947,13,960,1370,0,3,1,3,0,1,0,76.14,70.07 ,33.33
03,001,02,006,0271,638 ,270,2,272,374,0,3,1,3,0,1,0,76.14,72.73 ,33.33
03,001,02,006,0272,639 ,1256,21,1277,1903,0,3,1,3,0,1,0,76.14,67.10 ,33.33
03,001,02,006,0272,640 ,1094,13,1107,1652,0,3,1,3,0,1,0,76.14,67.01 ,33.33
03,001,02,006,0273,641 ,952,10,962,1357,0,3,1,3,0,1,0,76.14,70.89 ,33.33
03,001,02,006,0273,642 ,967,18,985,1446,0,3,1,3,0,1,0,76.14,68.12 ,33.33
03,001,02,006,0274,643 ,920,14,934,1404,0,3,1,3,0,1,0,76.14,66.52 ,33.33
03,001,02,006,0274,644 ,1078,16,1094,1639,0,3,1,3,0,1,0,76.14,66.75 ,33.33
03,001,02,006,0275,645 ,853,11,864,1269,0,3,1,3,0,1,0,76.14,68.09 ,33.33
03,001,02,006,0275,646 ,881,16,897,1317,0,3,1,3,0,1,0,76.14,68.11 ,33.33
03,001,02,006,0276,647 ,924,10,934,1541,0,3,1,3,0,1,0,76.14,60.61 ,33.33
03,001,02,006,0276,648 ,817,10,827,1209,0,3,1,3,0,1,0,76.14,68.40 ,33.33
03,001,02,006,0276,649 ,1055,22,1077,1567,0,3,1,3,0,1,0,76.14,68.73 ,33.33
03,001,02,006,0277,650 ,505,7,512,769,0,3,1,3,0,1,0,76.14,66.58 ,33.33
03,001,02,006,0277,651 ,641,7,648,943,0,3,1,3,0,1,0,76.14,68.72 ,33.33
03,001,02,006,0278,652 ,891,11,902,1295,0,3,1,3,0,1,0,76.14,69.65 ,33.33
03,001,02,006,0278,653 ,658,6,664,926,0,3,1,3,0,1,0,76.14,71.71 ,33.33
03,001,02,006,0279,654 ,676,13,689,1047,0,3,1,3,0,1,0,76.14,65.81 ,33.33
03,001,02,006,0279,655 ,881,18,899,1244,0,3,1,3,0,1,0,76.14,72.27 ,33.33
03,001,02,006,0279,656 ,788,11,799,1164,0,3,1,3,0,1,0,76.14,68.64 ,33.33
03,001,02,006,0280,657 ,1131,23,1154,1724,0,3,1,3,0,1,0,76.14,66.94 ,33.33
03,001,02,006,0280,658 ,1123,18,1141,1627,0,3,1,3,0,1,0,76.14,70.13 ,33.33
03,001,02,006,0280,659 ,917,13,930,1332,0,3,1,3,0,1,0,76.14,69.82 ,33.33
03,001,02,006,0281,660 ,738,20,758,1122,0,3,1,3,0,1,0,76.14,67.56 ,33.33
03,001,02,006,0281,661 ,891,20,911,1317,0,3,1,3,0,1,0,76.14,69.17 ,33.33
03,001,02,006,0281,662 ,587,10,597,934,0,3,1,3,0,1,0,76.14,63.92 ,33.33
03,001,02,006,0282,663 ,890,12,902,1281,0,3,1,3,0,1,0,76.14,70.41 ,33.33
03,001,02,006,0282,664 ,914,15,929,1327,0,3,1,3,0,1,0,76.14,70.01 ,33.33
03,001,02,006,0283,665 ,832,14,846,1236,0,3,1,3,0,1,0,76.14,68.45 ,33.33
03,001,02,006,0283,666 ,1065,19,1084,1579,0,3,1,3,0,1,0,76.14,68.65 ,33.33
03,001,02,006,0283,667 ,1049,15,1064,1629,0,3,1,3,0,1,0,76.14,65.32 ,33.33
03,001,02,006,0284,668 ,1085,12,1097,1571,0,3,1,3,0,1,0,76.14,69.83 ,33.33
03,001,02,006,0284,669 ,1049,20,1069,1587,0,3,1,3,0,1,0,76.14,67.36 ,33.33
03,001,02,006,0284,670 ,1108,21,1129,1582,0,3,1,3,0,1,0,76.14,71.37 ,33.33
03,001,02,006,0285,671 ,982,12,994,1426,0,3,1,3,0,1,0,76.14,69.71 ,33.33
03,001,02,006,0285,672 ,707,7,714,989,0,3,1,3,0,1,0,76.14,72.19 ,33.33
03,001,02,006,0286,673 ,885,17,902,1366,0,3,1,3,0,1,0,76.14,66.03 ,33.33
03,001,02,006,0286,674 ,1091,11,1102,1679,0,3,1,3,0,1,0,76.14,65.63 ,33.33
03,001,02,006,0286,675 ,1108,11,1119,1718,0,3,1,3,0,1,0,76.14,65.13 ,33.33
03,001,02,006,0287,676 ,864,17,881,1374,0,3,1,3,0,1,0,76.14,64.12 ,33.33
03,001,02,006,0288,677 ,888,18,906,1466,0,3,1,3,0,1,0,76.14,61.80 ,33.33
03,001,02,006,0289,678 ,940,16,956,1424,0,3,1,3,0,1,0,76.14,67.13 ,33.33
03,001,02,006,0290,679 ,577,8,585,828,0,3,1,3,0,1,0,76.14,70.65 ,33.33
03,001,02,006,0290,680 ,557,9,566,814,0,3,1,3,0,1,0,76.14,69.53 ,33.33
03,001,02,006,0291,681 ,920,18,938,1339,0,3,1,3,0,1,0,76.14,70.05 ,33.33
03,001,02,006,0292,682 ,818,17,835,1174,0,3,1,3,0,1,0,76.14,71.12 ,33.33
03,001,02,006,0293,683 ,814,17,831,1221,0,3,1,3,0,1,0,76.14,68.06 ,33.33
03,001,02,006,0294,684 ,984,9,993,1507,0,3,1,3,0,1,0,76.14,65.89 ,33.33
03,001,02,006,0295,685 ,774,25,799,1164,0,3,1,3,0,1,0,76.14,68.64 ,33.33
03,001,02,006,0296,686 ,448,11,459,680,0,3,1,3,0,1,0,76.14,67.50 ,33.33
03,001,02,006,0296,687 ,482,10,492,750,0,3,1,3,0,1,0,76.14,65.60 ,33.33
03,001,02,006,0297,688 ,904,20,924,1393,0,3,1,3,0,1,0,76.14,66.33 ,33.33
03,001,02,006,0298,689 ,574,16,590,858,0,3,1,3,0,1,0,76.14,68.76 ,33.33
03,001,02,006,0298,690 ,682,9,691,1018,0,3,1,3,0,1,0,76.14,67.88 ,33.33
03,001,02,006,0299,691 ,999,12,1011,1581,0,3,1,3,0,1,0,76.14,63.95 ,33.33
03,001,02,006,0300,692 ,758,17,775,1132,0,3,1,3,0,1,0,76.14,68.46 ,33.33
03,001,02,006,0301,693 ,714,6,720,1081,0,3,1,3,0,1,0,76.14,66.60 ,33.33
03,001,02,006,0302,694 ,605,9,614,881,0,3,1,3,0,1,0,76.14,69.69 ,33.33
03,001,02,006,0302,695 ,457,8,465,667,0,3,1,3,0,1,0,76.14,69.72 ,33.33
03,001,02,006,0303,696 ,580,8,588,833,0,3,1,3,0,1,0,76.14,70.59 ,33.33
03,001,02,006,0304,697 ,957,13,970,1496,0,3,1,3,0,1,0,76.14,64.84 ,33.33
03,001,02,006,0305,698 ,852,6,858,1320,0,3,1,3,0,1,0,76.14,65.00 ,33.33
03,001,02,006,0305,699 ,706,9,715,1034,0,3,1,3,0,1,0,76.14,69.15 ,33.33
03,001,02,006,0306,700 ,700,9,709,1121,0,3,1,3,0,1,0,76.14,63.25 ,33.33
03,001,02,006,0307,701 ,678,5,683,988,0,3,1,3,0,1,0,76.14,69.13 ,33.33
03,001,02,006,0307,702 ,702,8,710,1079,0,3,1,3,0,1,0,76.14,65.80 ,33.33
03,001,02,006,0308,703 ,657,10,667,1021,0,3,1,3,0,1,0,76.14,65.33 ,33.33
03,001,02,006,0308,704 ,716,9,725,1150,0,3,1,3,0,1,0,76.14,63.04 ,33.33
03,001,02,006,0309,705 ,571,14,585,773,0,3,1,3,0,1,0,76.14,75.68 ,33.33
03,001,02,006,0309,706 ,907,20,927,1314,0,3,1,3,0,1,0,76.14,70.55 ,33.33
03,001,02,006,0310,707 ,903,19,922,1427,0,3,1,3,0,1,0,76.14,64.61 ,33.33
03,001,02,006,0310,708 ,930,11,941,1387,0,3,1,3,0,1,0,76.14,67.84 ,33.33
03,001,02,006,0311,709 ,994,12,1006,1444,0,3,1,3,0,1,0,76.14,69.67 ,33.33
03,001,02,006,0311,710 ,650,9,659,979,0,3,1,3,0,1,0,76.14,67.31 ,33.33
03,001,02,006,0311,711 ,777,10,787,1155,0,3,1,3,0,1,0,76.14,68.14 ,33.33
03,001,02,006,0312,712 ,944,20,964,1344,0,3,1,3,0,1,0,76.14,71.73 ,33.33
03,001,02,006,0313,713 ,713,15,728,1025,0,3,1,3,0,1,0,76.14,71.02 ,33.33
03,001,02,006,0314,714 ,1022,15,1037,1524,0,3,1,3,0,1,0,76.14,68.04 ,33.33
03,001,02,006,0315,715 ,1065,27,1092,1544,0,3,1,3,0,1,0,76.14,70.73 ,33.33
03,001,02,006,0316,716 ,1117,12,1129,1567,0,3,1,3,0,1,0,76.14,72.05 ,33.33
03,001,02,006,0317,717 ,731,16,747,1091,0,3,1,3,0,1,0,76.14,68.47 ,33.33
03,001,02,006,0317,718 ,686,7,693,1009,0,3,1,3,0,1,0,76.14,68.68 ,33.33
03,001,02,006,0318,719 ,1019,20,1039,1495,0,3,1,3,0,1,0,76.14,69.50 ,33.33
03,001,02,006,0319,720 ,580,7,587,882,0,3,1,3,0,1,0,76.14,66.55 ,33.33
03,001,02,006,0320,721 ,964,16,980,1459,0,3,1,3,0,1,0,76.14,67.17 ,33.33
03,001,02,006,0321,722 ,607,18,625,902,0,3,1,3,0,1,0,76.14,69.29 ,33.33
03,001,02,006,0321,723 ,550,18,568,794,0,3,1,3,0,1,0,76.14,71.54 ,33.33
03,001,02,006,0322,724 ,626,11,637,1007,0,3,1,3,0,1,0,76.14,63.26 ,33.33
03,001,02,006,0322,725 ,642,10,652,975,0,3,1,3,0,1,0,76.14,66.87 ,33.33
03,001,02,006,0323,726 ,1026,22,1048,1596,0,3,1,3,0,1,0,76.14,65.66 ,33.33
03,001,02,006,0324,727 ,499,5,504,742,0,3,1,3,0,1,0,76.14,67.92 ,33.33
03,001,02,006,0325,728 ,900,10,910,1309,0,3,1,3,0,1,0,76.14,69.52 ,33.33
03,001,02,006,0326,729 ,406,5,411,579,0,3,1,3,0,1,0,76.14,70.98 ,33.33
03,001,02,006,0327,730 ,637,23,660,997,0,3,1,3,0,1,0,76.14,66.20 ,33.33
03,001,02,006,0327,731 ,769,20,789,1153,0,3,1,3,0,1,0,76.14,68.43 ,33.33
03,001,02,006,0328,732 ,1143,26,1169,1668,0,3,1,3,0,1,0,76.14,70.08 ,33.33
03,001,02,006,0329,733 ,756,17,773,1130,0,3,1,3,0,1,0,76.14,68.41 ,33.33
03,001,02,006,0329,734 ,605,13,618,918,0,3,1,3,0,1,0,76.14,67.32 ,33.33
03,001,02,006,0330,735 ,898,12,910,1408,0,3,1,3,0,1,0,76.14,64.63 ,33.33
03,001,02,006,0331,736 ,732,9,741,1060,0,3,1,3,0,1,0,76.14,69.91 ,33.33
03,001,02,006,0332,737 ,1140,20,1160,1663,0,3,1,3,0,1,0,76.14,69.75 ,33.33
03,001,02,006,0333,738 ,687,20,707,1073,0,3,1,3,0,1,0,76.14,65.89 ,33.33
03,001,02,006,0333,739 ,639,17,656,942,0,3,1,3,0,1,0,76.14,69.64 ,33.33
03,001,02,006,0334,740 ,913,23,936,1329,0,3,1,3,0,1,0,76.14,70.43 ,33.33
03,001,02,006,0334,741 ,788,19,807,1198,0,3,1,3,0,1,0,76.14,67.36 ,33.33
03,001,02,006,0335,742 ,1070,14,1084,1610,0,3,1,3,0,1,0,76.14,67.33 ,33.33
03,001,02,006,0336,743 ,804,8,812,1166,0,3,1,3,0,1,0,76.14,69.64 ,33.33
03,001,02,006,0337,744 ,904,13,917,1315,0,3,1,3,0,1,0,76.14,69.73 ,33.33
03,001,02,006,0338,745 ,756,13,769,1144,0,3,1,3,0,1,0,76.14,67.22 ,33.33
03,001,02,006,0338,746 ,729,12,741,1092,0,3,1,3,0,1,0,76.14,67.86 ,33.33
03,001,02,006,0339,747 ,750,18,768,1181,0,3,1,3,0,1,0,76.14,65.03 ,33.33
03,001,02,006,0339,748 ,798,14,812,1236,0,3,1,3,0,1,0,76.14,65.70 ,33.33
03,001,02,006,0340,749 ,998,19,1017,1461,0,3,1,3,0,1,0,76.14,69.61 ,33.33
03,001,02,006,0341,750 ,581,15,596,871,0,3,1,3,0,1,0,76.14,68.43 ,33.33
03,001,02,006,0341,751 ,661,13,674,979,0,3,1,3,0,1,0,76.14,68.85 ,33.33
03,001,02,006,0342,752 ,781,11,792,1179,0,3,1,3,0,1,0,76.14,67.18 ,33.33
03,001,02,006,0342,753 ,888,15,903,1365,0,3,1,3,0,1,0,76.14,66.15 ,33.33
03,001,02,006,0342,754 ,785,21,806,1225,0,3,1,3,0,1,0,76.14,65.80 ,33.33
03,001,02,006,0343,755 ,1136,18,1154,1674,0,3,1,3,0,1,0,76.14,68.94 ,33.33
03,001,02,006,0343,756 ,995,18,1013,1468,0,3,1,3,0,1,0,76.14,69.01 ,33.33
03,001,02,006,0344,757 ,621,8,629,992,0,3,1,3,0,1,0,76.14,63.41 ,33.33
03,001,02,006,0344,758 ,988,16,1004,1478,0,3,1,3,0,1,0,76.14,67.93 ,33.33
03,001,02,006,0344,759 ,1044,16,1060,1518,0,3,1,3,0,1,0,76.14,69.83 ,33.33
03,001,02,006,0345,760 ,673,12,685,1001,0,3,1,3,0,1,0,76.14,68.43 ,33.33
03,001,02,006,0345,761 ,587,8,595,877,0,3,1,3,0,1,0,76.14,67.84 ,33.33
03,001,02,006,0346,762 ,559,13,572,813,0,3,1,3,0,1,0,76.14,70.36 ,33.33
03,001,02,006,0346,763 ,579,6,585,818,0,3,1,3,0,1,0,76.14,71.52 ,33.33
03,001,02,006,0347,764 ,666,9,675,961,0,3,1,3,0,1,0,76.14,70.24 ,33.33
03,001,02,006,0347,765 ,787,16,803,1118,0,3,1,3,0,1,0,76.14,71.82 ,33.33
03,001,02,006,0348,766 ,698,4,702,1107,0,3,1,3,0,1,0,76.14,63.41 ,33.33
03,001,02,006,0348,767 ,780,18,798,1166,0,3,1,3,0,1,0,76.14,68.44 ,33.33
03,001,02,006,0348,768 ,776,14,790,1122,0,3,1,3,0,1,0,76.14,70.41 ,33.33
03,001,02,006,0349,769 ,813,10,823,1131,0,3,1,3,0,1,0,76.14,72.77 ,33.33
03,001,02,006,0349,770 ,990,10,1000,1360,0,3,1,3,0,1,0,76.14,73.53 ,33.33
03,001,02,006,0350,771 ,804,15,819,1198,0,3,1,3,0,1,0,76.14,68.36 ,33.33
03,001,02,006,0350,772 ,761,15,776,1120,0,3,1,3,0,1,0,76.14,69.29 ,33.33
03,001,02,006,0351,773 ,962,23,985,1476,0,3,1,3,0,1,0,76.14,66.73 ,33.33
03,001,02,006,0351,774 ,788,8,796,1172,0,3,1,3,0,1,0,76.14,67.92 ,33.33
03,001,02,006,0352,775 ,892,6,898,1371,0,3,1,3,0,1,0,76.14,65.50 ,33.33
03,001,02,006,0352,776 ,922,9,931,1330,0,3,1,3,0,1,0,76.14,70.00 ,33.33
03,001,02,006,0353,777 ,899,15,914,1346,0,3,1,3,0,1,0,76.14,67.90 ,33.33
03,001,02,006,0353,778 ,837,17,854,1269,0,3,1,3,0,1,0,76.14,67.30 ,33.33
03,001,02,006,0354,779 ,1053,19,1072,1528,0,3,1,3,0,1,0,76.14,70.16 ,33.33
03,001,02,006,0354,780 ,731,12,743,1141,0,3,1,3,0,1,0,76.14,65.12 ,33.33
03,001,02,006,0354,781 ,884,18,902,1345,0,3,1,3,0,1,0,76.14,67.06 ,33.33
03,001,02,006,0355,782 ,796,10,806,1117,0,3,1,3,0,1,0,76.14,72.16 ,33.33
03,001,02,006,0355,783 ,623,10,633,949,0,3,1,3,0,1,0,76.14,66.70 ,33.33
03,001,02,006,0356,784 ,641,8,649,916,0,3,1,3,0,1,0,76.14,70.85 ,33.33
03,001,02,006,0356,785 ,841,13,854,1226,0,3,1,3,0,1,0,76.14,69.66 ,33.33
03,001,02,006,0356,786 ,861,8,869,1247,0,3,1,3,0,1,0,76.14,69.69 ,33.33
03,001,02,006,0357,787 ,915,12,927,1368,0,3,1,3,0,1,0,76.14,67.76 ,33.33
03,001,02,006,0357,788 ,927,19,946,1420,0,3,1,3,0,1,0,76.14,66.62 ,33.33
03,001,02,006,0358,789 ,757,17,774,1177,0,3,1,3,0,1,0,76.14,65.76 ,33.33
03,001,02,006,0358,790 ,744,9,753,1162,0,3,1,3,0,1,0,76.14,64.80 ,33.33
03,001,02,006,0359,791 ,931,13,944,1419,0,3,1,3,0,1,0,76.14,66.53 ,33.33
03,001,02,006,0359,792 ,768,12,780,1174,0,3,1,3,0,1,0,76.14,66.44 ,33.33
03,001,02,006,0360,793 ,851,11,862,1238,0,3,1,3,0,1,0,76.14,69.63 ,33.33
03,001,02,006,0360,794 ,647,11,658,983,0,3,1,3,0,1,0,76.14,66.94 ,33.33
03,001,02,006,0360,795 ,902,14,916,1360,0,3,1,3,0,1,0,76.14,67.35 ,33.33
03,001,02,006,0361,796 ,815,13,828,1223,0,3,1,3,0,1,0,76.14,67.70 ,33.33
03,001,02,006,0361,797 ,733,12,745,1146,0,3,1,3,0,1,0,76.14,65.01 ,33.33
03,001,02,006,0361,798 ,976,23,999,1566,0,3,1,3,0,1,0,76.14,63.79 ,33.33
03,001,02,006,0362,799 ,995,21,1016,1585,0,3,1,3,0,1,0,76.14,64.10 ,33.33
03,001,02,006,0362,800 ,921,11,932,1439,0,3,1,3,0,1,0,76.14,64.77 ,33.33
03,001,02,006,0362,801 ,752,11,763,1132,0,3,1,3,0,1,0,76.14,67.40 ,33.33
03,001,02,006,0363,802 ,1013,12,1025,1570,0,3,1,3,0,1,0,76.14,65.29 ,33.33
03,001,02,006,0363,803 ,647,2,649,1020,0,3,1,3,0,1,0,76.14,63.63 ,33.33
03,001,02,006,0363,804 ,602,11,613,956,0,3,1,3,0,1,0,76.14,64.12 ,33.33
03,001,02,006,0364,805 ,1059,20,1079,1520,0,3,1,3,0,1,0,76.14,70.99 ,33.33
03,001,02,006,0364,806 ,1054,13,1067,1600,0,3,1,3,0,1,0,76.14,66.69 ,33.33
03,001,02,006,0364,807 ,1259,20,1279,1936,0,3,1,3,0,1,0,76.14,66.06 ,33.33
03,001,02,006,0365,808 ,714,14,728,1109,0,3,1,3,0,1,0,76.14,65.64 ,33.33
03,001,02,006,0365,809 ,1123,23,1146,1728,0,3,1,3,0,1,0,76.14,66.32 ,33.33
03,001,02,006,0366,810 ,976,19,995,1435,0,3,1,3,0,1,0,76.14,69.34 ,33.33
03,001,02,006,0366,811 ,1155,23,1178,1730,0,3,1,3,0,1,0,76.14,68.09 ,33.33
03,001,02,006,0367,812 ,714,16,730,1062,0,3,1,3,0,1,0,76.14,68.74 ,33.33
03,001,02,006,0367,813 ,712,7,719,1140,0,3,1,3,0,1,0,76.14,63.07 ,33.33
03,001,02,006,0368,814 ,866,16,882,1454,0,3,1,3,0,1,0,76.14,60.66 ,33.33
03,001,02,006,0368,815 ,782,12,794,1190,0,3,1,3,0,1,0,76.14,66.72 ,33.33
03,001,02,006,0369,816 ,430,13,443,695,0,3,1,3,0,1,0,76.14,63.74 ,33.33
03,001,02,006,0369,817 ,836,15,851,1274,0,3,1,3,0,1,0,76.14,66.80 ,33.33
03,001,02,006,0370,818 ,595,11,606,897,0,3,1,3,0,1,0,76.14,67.56 ,33.33
03,001,02,006,0370,819 ,721,13,734,1103,0,3,1,3,0,1,0,76.14,66.55 ,33.33
03,001,02,006,0371,820 ,733,12,745,1058,0,3,1,3,0,1,0,76.14,70.42 ,33.33
03,001,02,006,0371,821 ,584,6,590,898,0,3,1,3,0,1,0,76.14,65.70 ,33.33
03,001,02,006,0372,822 ,1133,13,1146,1598,0,3,1,3,0,1,0,76.14,71.71 ,33.33
03,001,02,006,0372,823 ,985,12,997,1515,0,3,1,3,0,1,0,76.14,65.81 ,33.33
03,001,02,006,0373,824 ,611,11,622,872,0,3,1,3,0,1,0,76.14,71.33 ,33.33
03,001,02,006,0373,825 ,742,22,764,1122,0,3,1,3,0,1,0,76.14,68.09 ,33.33
03,001,02,006,0374,826 ,777,15,792,1165,0,3,1,3,0,1,0,76.14,67.98 ,33.33
03,001,02,006,0374,827 ,742,12,754,1163,0,3,1,3,0,1,0,76.14,64.83 ,33.33
03,001,02,006,0374,828 ,775,13,788,1146,0,3,1,3,0,1,0,76.14,68.76 ,33.33
03,001,02,006,0375,829 ,660,11,671,1037,0,3,1,3,0,1,0,76.14,64.71 ,33.33
03,001,02,006,0375,830 ,722,7,729,1118,0,3,1,3,0,1,0,76.14,65.21 ,33.33
03,001,02,006,0376,831 ,863,23,886,1383,0,3,1,3,0,1,0,76.14,64.06 ,33.33
03,001,02,006,0376,832 ,769,7,776,1164,0,3,1,3,0,1,0,76.14,66.67 ,33.33
03,001,02,006,0377,833 ,492,6,498,728,0,3,1,3,0,1,0,76.14,68.41 ,33.33
03,001,02,006,0377,834 ,652,11,663,982,0,3,1,3,0,1,0,76.14,67.52 ,33.33
03,001,02,006,0378,835 ,1007,22,1029,1530,0,3,1,3,0,1,0,76.14,67.25 ,33.33
03,001,02,006,0378,836 ,827,16,843,1193,0,3,1,3,0,1,0,76.14,70.66 ,33.33
03,001,02,006,0379,837 ,584,14,598,881,0,3,1,3,0,1,0,76.14,67.88 ,33.33
03,001,02,006,0379,838 ,718,6,724,1136,0,3,1,3,0,1,0,76.14,63.73 ,33.33
03,001,02,006,0380,839 ,979,20,999,1481,0,3,1,3,0,1,0,76.14,67.45 ,33.33
03,001,02,006,0380,840 ,946,12,958,1393,0,3,1,3,0,1,0,76.14,68.77 ,33.33
03,001,02,006,0381,841 ,1083,20,1103,1663,0,3,1,3,0,1,0,76.14,66.33 ,33.33
03,001,02,006,0381,842 ,858,12,870,1305,0,3,1,3,0,1,0,76.14,66.67 ,33.33
03,001,02,006,0382,843 ,992,18,1010,1584,0,3,1,3,0,1,0,76.14,63.76 ,33.33
03,001,02,006,0382,844 ,949,10,959,1423,0,3,1,3,0,1,0,76.14,67.39 ,33.33
03,001,02,007,0383,845 ,954,14,968,1376,0,3,1,3,0,1,0,76.14,70.35 ,33.33
03,001,02,007,0383,846 ,832,12,844,1290,0,3,1,3,0,1,0,76.14,65.43 ,33.33
03,001,02,007,0383,847 ,733,8,741,1111,0,3,1,3,0,1,0,76.14,66.70 ,33.33
03,001,02,007,0384,848 ,882,7,889,1412,0,3,1,3,0,1,0,76.14,62.96 ,33.33
03,001,02,007,0384,849 ,1023,19,1042,1624,0,3,1,3,0,1,0,76.14,64.16 ,33.33
03,001,02,007,0385,850 ,893,19,912,1288,0,3,1,3,0,1,0,76.14,70.81 ,33.33
03,001,02,007,0385,851 ,892,17,909,1363,0,3,1,3,0,1,0,76.14,66.69 ,33.33
03,001,02,007,0386,852 ,892,8,900,1277,0,3,1,3,0,1,0,76.14,70.48 ,33.33
03,001,02,007,0386,853 ,671,12,683,1000,0,3,1,3,0,1,0,76.14,68.30 ,33.33
03,001,02,007,0387,854 ,693,12,705,1194,0,3,1,3,0,1,0,76.14,59.05 ,33.33
03,001,02,007,0387,855 ,640,10,650,1072,0,3,1,3,0,1,0,76.14,60.63 ,33.33
03,001,02,007,0387,856 ,672,10,682,1110,0,3,1,3,0,1,0,76.14,61.44 ,33.33
03,001,02,007,0388,857 ,799,18,817,1243,0,3,1,3,0,1,0,76.14,65.73 ,33.33
03,001,02,007,0388,858 ,984,17,1001,1444,0,3,1,3,0,1,0,76.14,69.32 ,33.33
03,001,02,007,0389,859 ,813,16,829,1233,0,3,1,3,0,1,0,76.14,67.23 ,33.33
03,001,02,007,0389,860 ,743,10,753,1117,0,3,1,3,0,1,0,76.14,67.41 ,33.33
03,001,02,007,0390,861 ,954,25,979,1578,0,3,1,3,0,1,0,76.14,62.04 ,33.33
03,001,02,007,0390,862 ,1050,16,1066,1695,0,3,1,3,0,1,0,76.14,62.89 ,33.33
03,001,02,007,0391,863 ,1040,22,1062,1632,0,3,1,3,0,1,0,76.14,65.07 ,33.33
03,001,02,007,0392,864 ,886,14,900,1337,0,3,1,3,0,1,0,76.14,67.31 ,33.33
03,001,02,007,0392,865 ,867,16,883,1371,0,3,1,3,0,1,0,76.14,64.41 ,33.33
03,001,02,007,0393,866 ,734,9,743,1155,0,3,1,3,0,1,0,76.14,64.33 ,33.33
03,001,02,007,0393,867 ,732,6,738,1114,0,3,1,3,0,1,0,76.14,66.25 ,33.33
03,001,02,007,0393,868 ,767,12,779,1248,0,3,1,3,0,1,0,76.14,62.42 ,33.33
03,001,02,007,0394,869 ,796,16,812,1349,0,3,1,3,0,1,0,76.14,60.19 ,33.33
03,001,02,007,0394,870 ,875,17,892,1389,0,3,1,3,0,1,0,76.14,64.22 ,33.33
03,001,02,007,0395,871 ,768,12,780,1272,0,3,1,3,0,1,0,76.14,61.32 ,33.33
03,001,02,007,0395,872 ,886,7,893,1415,0,3,1,3,0,1,0,76.14,63.11 ,33.33
03,001,02,007,0395,873 ,973,17,990,1538,0,3,1,3,0,1,0,76.14,64.37 ,33.33
03,001,02,007,0396,874 ,803,9,812,1226,0,3,1,3,0,1,0,76.14,66.23 ,33.33
03,001,02,007,0396,875 ,711,8,719,1155,0,3,1,3,0,1,0,76.14,62.25 ,33.33
03,001,02,007,0396,876 ,836,14,850,1284,0,3,1,3,0,1,0,76.14,66.20 ,33.33
03,001,02,007,0397,877 ,793,6,799,1266,0,3,1,3,0,1,0,76.14,63.11 ,33.33
03,001,02,007,0397,878 ,709,9,718,1067,0,3,1,3,0,1,0,76.14,67.29 ,33.33
03,001,02,007,0397,879 ,738,14,752,1121,0,3,1,3,0,1,0,76.14,67.08 ,33.33
03,001,02,007,0398,880 ,108,4,112,207,0,3,1,3,0,1,0,76.14,54.11 ,33.33
03,001,02,007,0399,881 ,1108,13,1121,1656,0,3,1,3,0,1,0,76.14,67.69 ,33.33
03,001,02,007,0399,882 ,731,9,740,1092,0,3,1,3,0,1,0,76.14,67.77 ,33.33
03,001,02,007,0399,883 ,715,15,730,1079,0,3,1,3,0,1,0,76.14,67.66 ,33.33
03,001,02,007,0400,884 ,1019,29,1048,1487,0,3,1,3,0,1,0,76.14,70.48 ,33.33
03,001,02,007,0400,885 ,967,24,991,1459,0,3,1,3,0,1,0,76.14,67.92 ,33.33
03,001,02,007,0401,886 ,1018,20,1038,1578,0,3,1,3,0,1,0,76.14,65.78 ,33.33
03,001,02,007,0401,887 ,956,10,966,1473,0,3,1,3,0,1,0,76.14,65.58 ,33.33
03,001,02,007,0402,888 ,757,10,767,1199,0,3,1,3,0,1,0,76.14,63.97 ,33.33
03,001,02,007,0402,889 ,811,11,822,1283,0,3,1,3,0,1,0,76.14,64.07 ,33.33
03,001,02,007,0403,890 ,770,12,782,1137,0,3,1,3,0,1,0,76.14,68.78 ,33.33
03,001,02,007,0403,891 ,722,8,730,1065,0,3,1,3,0,1,0,76.14,68.54 ,33.33
03,001,02,007,0404,892 ,986,10,996,1517,0,3,1,3,0,1,0,76.14,65.66 ,33.33
03,001,02,007,0404,893 ,610,15,625,984,0,3,1,3,0,1,0,76.14,63.52 ,33.33
03,001,02,007,0404,894 ,736,7,743,1112,0,3,1,3,0,1,0,76.14,66.82 ,33.33
03,001,02,007,0405,895 ,1201,18,1219,1895,0,3,1,3,0,1,0,76.14,64.33 ,33.33
03,001,02,007,0405,896 ,811,11,822,1246,0,3,1,3,0,1,0,76.14,65.97 ,33.33
03,001,02,007,0405,897 ,779,11,790,1236,0,3,1,3,0,1,0,76.14,63.92 ,33.33
03,001,02,007,0406,898 ,762,8,770,1181,0,3,1,3,0,1,0,76.14,65.20 ,33.33
03,001,02,007,0406,899 ,890,10,900,1368,0,3,1,3,0,1,0,76.14,65.79 ,33.33
03,001,02,007,0407,900 ,919,14,933,1318,0,3,1,3,0,1,0,76.14,70.79 ,33.33
03,001,02,007,0407,901 ,736,7,743,1149,0,3,1,3,0,1,0,76.14,64.66 ,33.33
03,001,02,007,0408,902 ,881,8,889,1270,0,3,1,3,0,1,0,76.14,70.00 ,33.33
03,001,02,007,0408,903 ,750,13,763,1079,0,3,1,3,0,1,0,76.14,70.71 ,33.33
03,001,02,007,0409,904 ,687,21,708,1046,0,3,1,3,0,1,0,76.14,67.69 ,33.33
03,001,02,007,0409,905 ,666,11,677,1011,0,3,1,3,0,1,0,76.14,66.96 ,33.33
03,001,02,007,0410,906 ,865,11,876,1264,0,3,1,3,0,1,0,76.14,69.30 ,33.33
03,001,02,007,0410,907 ,982,17,999,1449,0,3,1,3,0,1,0,76.14,68.94 ,33.33
03,001,02,007,0411,908 ,1015,17,1032,1551,0,3,1,3,0,1,0,76.14,66.54 ,33.33
03,001,02,007,0412,909 ,772,15,787,1264,0,3,1,3,0,1,0,76.14,62.26 ,33.33
03,001,02,007,0412,910 ,805,10,815,1209,0,3,1,3,0,1,0,76.14,67.41 ,33.33
03,001,02,007,0412,911 ,759,8,767,1211,0,3,1,3,0,1,0,76.14,63.34 ,33.33
03,001,02,007,0413,912 ,615,6,621,987,0,3,1,3,0,1,0,76.14,62.92 ,33.33
03,001,02,007,0413,913 ,700,16,716,1071,0,3,1,3,0,1,0,76.14,66.85 ,33.33
03,001,02,007,0414,914 ,683,7,690,1068,0,3,1,3,0,1,0,76.14,64.61 ,33.33
03,001,02,007,0414,915 ,701,11,712,1020,0,3,1,3,0,1,0,76.14,69.80 ,33.33
03,001,02,007,0415,916 ,821,8,829,1305,0,3,1,3,0,1,0,76.14,63.52 ,33.33
03,001,02,007,0415,917 ,697,14,711,1155,0,3,1,3,0,1,0,76.14,61.56 ,33.33
03,001,02,007,0415,918 ,964,15,979,1435,0,3,1,3,0,1,0,76.14,68.22 ,33.33
03,001,02,007,0415,919 ,846,8,854,1375,0,3,1,3,0,1,0,76.14,62.11 ,33.33
03,001,02,007,0416,920 ,923,6,929,1435,0,3,1,3,0,1,0,76.14,64.74 ,33.33
03,001,02,007,0416,921 ,872,16,888,1416,0,3,1,3,0,1,0,76.14,62.71 ,33.33
03,001,02,007,0416,922 ,719,10,729,1220,0,3,1,3,0,1,0,76.14,59.75 ,33.33
03,001,02,007,0416,923 ,794,10,804,1217,0,3,1,3,0,1,0,76.14,66.06 ,33.33
03,001,02,007,0417,924 ,868,10,878,1306,0,3,1,3,0,1,0,76.14,67.23 ,33.33
03,001,02,007,0417,925 ,769,11,780,1198,0,3,1,3,0,1,0,76.14,65.11 ,33.33
03,001,02,007,0417,926 ,719,5,724,1152,0,3,1,3,0,1,0,76.14,62.85 ,33.33
03,001,02,007,0418,927 ,420,6,426,618,0,3,1,3,0,1,0,76.14,68.93 ,33.33
03,001,02,007,0418,928 ,605,11,616,1003,0,3,1,3,0,1,0,76.14,61.42 ,33.33
03,001,02,007,0419,929 ,890,9,899,1384,0,3,1,3,0,1,0,76.14,64.96 ,33.33
03,001,02,007,0419,930 ,819,10,829,1281,0,3,1,3,0,1,0,76.14,64.72 ,33.33
03,001,02,007,0420,931 ,611,3,614,975,0,3,1,3,0,1,0,76.14,62.97 ,33.33
03,001,02,007,0420,932 ,809,13,822,1227,0,3,1,3,0,1,0,76.14,66.99 ,33.33
03,001,02,008,0421,933 ,833,16,849,1175,0,3,1,3,0,1,0,76.14,72.26 ,33.33
03,001,02,008,0421,934 ,873,8,881,1273,0,3,1,3,0,1,0,76.14,69.21 ,33.33
03,001,02,008,0421,935 ,654,12,666,921,0,3,1,3,0,1,0,76.14,72.31 ,33.33
03,001,02,008,0422,936 ,787,15,802,1168,0,3,1,3,0,1,0,76.14,68.66 ,33.33
03,001,02,008,0422,937 ,961,9,970,1473,0,3,1,3,0,1,0,76.14,65.85 ,33.33
03,001,02,008,0422,938 ,1138,20,1158,1628,0,3,1,3,0,1,0,76.14,71.13 ,33.33
03,001,02,008,0423,939 ,944,18,962,1474,0,3,1,3,0,1,0,76.14,65.26 ,33.33
03,001,02,008,0423,940 ,932,20,952,1389,0,3,1,3,0,1,0,76.14,68.54 ,33.33
03,001,02,008,0424,941 ,996,11,1007,1405,0,3,1,3,0,1,0,76.14,71.67 ,33.33
03,001,02,008,0425,942 ,1141,16,1157,1632,0,3,1,3,0,1,0,76.14,70.89 ,33.33
03,001,02,008,0425,943 ,957,13,970,1382,0,3,1,3,0,1,0,76.14,70.19 ,33.33
03,001,02,008,0426,944 ,1185,9,1194,1627,0,3,1,3,0,1,0,76.14,73.39 ,33.33
03,001,02,008,0427,945 ,726,16,742,1144,0,3,1,3,0,1,0,76.14,64.86 ,33.33
03,001,02,008,0427,946 ,820,12,832,1192,0,3,1,3,0,1,0,76.14,69.80 ,33.33
03,001,02,008,0427,947 ,850,14,864,1280,0,3,1,3,0,1,0,76.14,67.50 ,33.33
03,001,02,008,0428,948 ,749,12,761,1113,0,3,1,3,0,1,0,76.14,68.37 ,33.33
03,001,02,008,0428,949 ,882,16,898,1296,0,3,1,3,0,1,0,76.14,69.29 ,33.33
03,001,02,008,0428,950 ,894,13,907,1366,0,3,1,3,0,1,0,76.14,66.40 ,33.33
03,001,02,008,0429,951 ,718,9,727,1016,0,3,1,3,0,1,0,76.14,71.56 ,33.33
03,001,02,008,0429,952 ,832,8,840,1141,0,3,1,3,0,1,0,76.14,73.62 ,33.33
03,001,02,008,0429,953 ,605,11,616,864,0,3,1,3,0,1,0,76.14,71.30 ,33.33
03,001,02,008,0430,954 ,762,11,773,1151,0,3,1,3,0,1,0,76.14,67.16 ,33.33
03,001,02,008,0430,955 ,962,17,979,1689,0,3,1,3,0,1,0,76.14,57.96 ,33.33
03,001,02,008,0431,956 ,951,9,960,1344,0,3,1,3,0,1,0,76.14,71.43 ,33.33
03,001,02,008,0432,957 ,1101,15,1116,1558,0,3,1,3,0,1,0,76.14,71.63 ,33.33
03,001,02,008,0433,958 ,1035,20,1055,1533,0,3,1,3,0,1,0,76.14,68.82 ,33.33
03,001,02,008,0433,959 ,845,12,857,1228,0,3,1,3,0,1,0,76.14,69.79 ,33.33
03,001,02,008,0433,960 ,871,10,881,1195,0,3,1,3,0,1,0,76.14,73.72 ,33.33
03,001,02,008,0434,961 ,1112,21,1133,1656,0,3,1,3,0,1,0,76.14,68.42 ,33.33
03,001,02,008,0434,962 ,977,21,998,1491,0,3,1,3,0,1,0,76.14,66.93 ,33.33
03,001,02,008,0435,963 ,771,10,781,1147,0,3,1,3,0,1,0,76.14,68.09 ,33.33
03,001,02,008,0435,964 ,596,13,609,876,0,3,1,3,0,1,0,76.14,69.52 ,33.33
03,001,02,008,0436,965 ,688,11,699,1119,0,3,1,3,0,1,0,76.14,62.47 ,33.33
03,001,02,008,0436,966 ,732,11,743,1180,0,3,1,3,0,1,0,76.14,62.97 ,33.33
03,001,02,008,0436,967 ,794,12,806,1268,0,3,1,3,0,1,0,76.14,63.56 ,33.33
03,001,02,008,0437,968 ,747,10,757,1217,0,3,1,3,0,1,0,76.14,62.20 ,33.33
03,001,02,008,0437,969 ,914,13,927,1407,0,3,1,3,0,1,0,76.14,65.88 ,33.33
03,001,02,008,0438,970 ,645,13,658,1067,0,3,1,3,0,1,0,76.14,61.67 ,33.33
03,001,02,008,0438,971 ,719,8,727,1093,0,3,1,3,0,1,0,76.14,66.51 ,33.33
03,001,02,008,0438,972 ,967,14,981,1439,0,3,1,3,0,1,0,76.14,68.17 ,33.33
03,001,02,008,0439,973 ,874,14,888,1261,0,3,1,3,0,1,0,76.14,70.42 ,33.33
03,001,02,008,0439,974 ,867,12,879,1244,0,3,1,3,0,1,0,76.14,70.66 ,33.33
03,001,02,008,0440,975 ,1136,14,1150,1735,0,3,1,3,0,1,0,76.14,66.28 ,33.33
03,001,02,008,0441,976 ,841,18,859,1278,0,3,1,3,0,1,0,76.14,67.21 ,33.33
03,001,02,008,0441,977 ,696,4,700,1098,0,3,1,3,0,1,0,76.14,63.75 ,33.33
03,001,02,008,0442,978 ,853,9,862,1334,0,3,1,3,0,1,0,76.14,64.62 ,33.33
03,001,02,008,0442,979 ,840,18,858,1282,0,3,1,3,0,1,0,76.14,66.93 ,33.33
03,001,02,008,0442,980 ,657,6,663,1104,0,3,1,3,0,1,0,76.14,60.05 ,33.33
03,001,02,008,0443,981 ,743,19,762,1099,0,3,1,3,0,1,0,76.14,69.34 ,33.33
03,001,02,008,0443,982 ,680,5,685,989,0,3,1,3,0,1,0,76.14,69.26 ,33.33
03,001,02,008,0444,983 ,946,13,959,1354,0,3,1,3,0,1,0,76.14,70.83 ,33.33
03,001,02,008,0444,984 ,953,9,962,1372,0,3,1,3,0,1,0,76.14,70.12 ,33.33
03,001,02,008,0445,985 ,651,12,663,1020,0,3,1,3,0,1,0,76.14,65.00 ,33.33
03,001,02,008,0445,986 ,588,10,598,910,0,3,1,3,0,1,0,76.14,65.71 ,33.33
03,001,02,008,0446,987 ,1008,20,1028,1514,0,3,1,3,0,1,0,76.14,67.90 ,33.33
03,001,02,008,0446,988 ,786,13,799,1240,0,3,1,3,0,1,0,76.14,64.44 ,33.33
03,001,02,008,0447,989 ,934,11,945,1370,0,3,1,3,0,1,0,76.14,68.98 ,33.33
03,001,02,008,0447,990 ,887,16,903,1400,0,3,1,3,0,1,0,76.14,64.50 ,33.33
03,001,02,008,0447,991 ,846,15,861,1299,0,3,1,3,0,1,0,76.14,66.28 ,33.33
03,001,02,008,0448,992 ,755,13,768,1186,0,3,1,3,0,1,0,76.14,64.76 ,33.33
03,001,02,008,0448,993 ,795,13,808,1190,0,3,1,3,0,1,0,76.14,67.90 ,33.33
03,001,02,008,0449,994 ,780,14,794,1242,0,3,1,3,0,1,0,76.14,63.93 ,33.33
03,001,02,008,0449,995 ,816,10,826,1187,0,3,1,3,0,1,0,76.14,69.59 ,33.33
03,001,02,008,0450,996 ,915,12,927,1334,0,3,1,3,0,1,0,76.14,69.49 ,33.33
03,001,02,008,0450,997 ,777,8,785,1222,0,3,1,3,0,1,0,76.14,64.24 ,33.33
03,001,02,008,0450,998 ,827,21,848,1279,0,3,1,3,0,1,0,76.14,66.30 ,33.33
03,001,02,008,0451,999 ,912,15,927,1449,0,3,1,3,0,1,0,76.14,63.98 ,33.33
03,001,02,008,0451,1000 ,835,8,843,1280,0,3,1,3,0,1,0,76.14,65.86 ,33.33
03,001,02,008,0452,1001 ,796,13,809,1181,0,3,1,3,0,1,0,76.14,68.50 ,33.33
03,001,02,008,0452,1002 ,766,19,785,1143,0,3,1,3,0,1,0,76.14,68.68 ,33.33
03,001,02,008,0452,1003 ,826,9,835,1263,0,3,1,3,0,1,0,76.14,66.11 ,33.33
03,001,02,008,0452,1004 ,779,8,787,1237,0,3,1,3,0,1,0,76.14,63.62 ,33.33
03,001,02,008,0453,1005 ,1070,25,1095,1612,0,3,1,3,0,1,0,76.14,67.93 ,33.33
03,001,02,008,0453,1006 ,1039,17,1056,1585,0,3,1,3,0,1,0,76.14,66.62 ,33.33
03,001,02,008,0453,1007 ,1028,15,1043,1585,0,3,1,3,0,1,0,76.14,65.80 ,33.33
03,001,02,008,0454,1008 ,949,11,960,1486,0,3,1,3,0,1,0,76.14,64.60 ,33.33
03,001,02,008,0454,1009 ,973,7,980,1486,0,3,1,3,0,1,0,76.14,65.95 ,33.33
03,001,02,008,0454,1010 ,908,11,919,1405,0,3,1,3,0,1,0,76.14,65.41 ,33.33
03,001,02,008,0455,1011 ,1179,19,1198,1662,0,3,1,3,0,1,0,76.14,72.08 ,33.33
03,001,02,008,0456,1012 ,774,9,783,1138,0,3,1,3,0,1,0,76.14,68.80 ,33.33
03,001,02,008,0456,1013 ,732,9,741,1124,0,3,1,3,0,1,0,76.14,65.93 ,33.33
03,001,02,008,0456,1014 ,957,12,969,1394,0,3,1,3,0,1,0,76.14,69.51 ,33.33
03,001,02,008,0457,1015 ,783,13,796,1212,0,3,1,3,0,1,0,76.14,65.68 ,33.33
03,001,02,008,0457,1016 ,755,5,760,1127,0,3,1,3,0,1,0,76.14,67.44 ,33.33
03,001,02,008,0457,1017 ,727,19,746,1131,0,3,1,3,0,1,0,76.14,65.96 ,33.33
03,001,02,008,0458,1018 ,989,12,1001,1569,0,3,1,3,0,1,0,76.14,63.80 ,33.33
03,001,02,008,0458,1019 ,971,15,986,1515,0,3,1,3,0,1,0,76.14,65.08 ,33.33
03,001,02,008,0459,1020 ,766,10,776,1075,0,3,1,3,0,1,0,76.14,72.19 ,33.33
03,001,02,008,0459,1021 ,705,8,713,1047,0,3,1,3,0,1,0,76.14,68.10 ,33.33
03,001,02,008,0460,1022 ,1079,12,1091,1663,0,3,1,3,0,1,0,76.14,65.60 ,33.33
03,001,02,008,0460,1023 ,1235,21,1256,1841,0,3,1,3,0,1,0,76.14,68.22 ,33.33
03,001,02,008,0460,1024 ,1016,15,1031,1485,0,3,1,3,0,1,0,76.14,69.43 ,33.33
03,001,02,008,0461,1025 ,931,18,949,1352,0,3,1,3,0,1,0,76.14,70.19 ,33.33
03,001,02,008,0461,1026 ,747,15,762,1157,0,3,1,3,0,1,0,76.14,65.86 ,33.33
03,001,02,008,0462,1027 ,924,12,936,1331,0,3,1,3,0,1,0,76.14,70.32 ,33.33
03,001,02,008,0463,1028 ,1169,23,1192,1734,0,3,1,3,0,1,0,76.14,68.74 ,33.33
03,001,02,008,0464,1029 ,1014,17,1031,1491,0,3,1,3,0,1,0,76.14,69.15 ,33.33
03,001,02,008,0464,1030 ,1005,18,1023,1548,0,3,1,3,0,1,0,76.14,66.09 ,33.33
03,001,02,008,0464,1031 ,1000,13,1013,1510,0,3,1,3,0,1,0,76.14,67.09 ,33.33
03,001,02,008,0465,1032 ,848,10,858,1332,0,3,1,3,0,1,0,76.14,64.41 ,33.33
03,001,02,008,0465,1033 ,742,16,758,1106,0,3,1,3,0,1,0,76.14,68.54 ,33.33
03,001,02,008,0465,1034 ,828,15,843,1235,0,3,1,3,0,1,0,76.14,68.26 ,33.33
03,001,02,008,0466,1035 ,655,11,666,996,0,3,1,3,0,1,0,76.14,66.87 ,33.33
03,001,02,008,0466,1036 ,726,9,735,1152,0,3,1,3,0,1,0,76.14,63.80 ,33.33
03,001,02,008,0467,1037 ,908,11,919,1401,0,3,1,3,0,1,0,76.14,65.60 ,33.33
03,001,02,008,0467,1038 ,1073,14,1087,1614,0,3,1,3,0,1,0,76.14,67.35 ,33.33
03,001,02,008,0468,1039 ,842,16,858,1281,0,3,1,3,0,1,0,76.14,66.98 ,33.33
03,001,02,008,0468,1040 ,854,9,863,1266,0,3,1,3,0,1,0,76.14,68.17 ,33.33
03,001,02,008,0468,1041 ,832,16,848,1290,0,3,1,3,0,1,0,76.14,65.74 ,33.33
03,001,02,008,0469,1042 ,826,13,839,1269,0,3,1,3,0,1,0,76.14,66.12 ,33.33
03,001,02,008,0469,1043 ,962,10,972,1424,0,3,1,3,0,1,0,76.14,68.26 ,33.33
03,001,02,008,0470,1044 ,1006,15,1021,1521,0,3,1,3,0,1,0,76.14,67.13 ,33.33
03,001,02,008,0470,1045 ,852,19,871,1308,0,3,1,3,0,1,0,76.14,66.59 ,33.33
03,001,02,008,0470,1046 ,877,11,888,1329,0,3,1,3,0,1,0,76.14,66.82 ,33.33
03,001,02,008,0471,1047 ,784,7,791,1234,0,3,1,3,0,1,0,76.14,64.10 ,33.33
03,001,02,008,0471,1048 ,925,15,940,1478,0,3,1,3,0,1,0,76.14,63.60 ,33.33
03,001,02,008,0472,1049 ,658,9,667,957,0,3,1,3,0,1,0,76.14,69.70 ,33.33
03,001,02,008,0472,1050 ,713,9,722,999,0,3,1,3,0,1,0,76.14,72.27 ,33.33
03,001,02,008,0473,1051 ,1143,18,1161,1676,0,3,1,3,0,1,0,76.14,69.27 ,33.33
03,001,02,008,0473,1052 ,856,15,871,1314,0,3,1,3,0,1,0,76.14,66.29 ,33.33
03,001,02,008,0473,1053 ,918,22,940,1421,0,3,1,3,0,1,0,76.14,66.15 ,33.33
03,001,02,008,0474,1054 ,720,15,735,1073,0,3,1,3,0,1,0,76.14,68.50 ,33.33
03,001,02,008,0474,1055 ,559,9,568,843,0,3,1,3,0,1,0,76.14,67.38 ,33.33
03,001,02,008,0475,1056 ,1021,9,1030,1482,0,3,1,3,0,1,0,76.14,69.50 ,33.33
03,001,02,008,0475,1057 ,1043,12,1055,1639,0,3,1,3,0,1,0,76.14,64.37 ,33.33
03,001,02,008,0475,1058 ,1065,17,1082,1780,0,3,1,3,0,1,0,76.14,60.79 ,33.33
03,001,02,008,0476,1059 ,659,12,671,1039,0,3,1,3,0,1,0,76.14,64.58 ,33.33
03,001,02,008,0476,1060 ,726,16,742,1115,0,3,1,3,0,1,0,76.14,66.55 ,33.33
03,001,02,008,0476,1061 ,820,25,845,1224,0,3,1,3,0,1,0,76.14,69.04 ,33.33
03,001,02,008,0477,1062 ,1084,11,1095,1641,0,3,1,3,0,1,0,76.14,66.73 ,33.33
03,001,02,008,0478,1063 ,1006,14,1020,1532,0,3,1,3,0,1,0,76.14,66.58 ,33.33
03,001,02,008,0478,1064 ,1074,15,1089,1695,0,3,1,3,0,1,0,76.14,64.25 ,33.33
03,001,02,008,0478,1065 ,335,3,338,481,0,3,1,3,0,1,0,76.14,70.27 ,33.33
03,001,02,008,0479,1066 ,883,9,892,1359,0,3,1,3,0,1,0,76.14,65.64 ,33.33
03,001,02,008,0479,1067 ,757,11,768,1252,0,3,1,3,0,1,0,76.14,61.34 ,33.33
03,001,02,008,0479,1068 ,902,9,911,1395,0,3,1,3,0,1,0,76.14,65.30 ,33.33
03,001,02,008,0480,1069 ,593,5,598,923,0,3,1,3,0,1,0,76.14,64.79 ,33.33
03,001,02,008,0480,1070 ,674,9,683,995,0,3,1,3,0,1,0,76.14,68.64 ,33.33
03,001,02,008,0481,1071 ,616,4,620,967,0,3,1,3,0,1,0,76.14,64.12 ,33.33
03,001,02,008,0481,1072 ,690,10,700,1074,0,3,1,3,0,1,0,76.14,65.18 ,33.33
03,001,02,008,0482,1073 ,860,17,877,1292,0,3,1,3,0,1,0,76.14,67.88 ,33.33
03,001,02,008,0482,1074 ,789,14,803,1233,0,3,1,3,0,1,0,76.14,65.13 ,33.33
03,001,02,008,0483,1075 ,730,14,744,1121,0,3,1,3,0,1,0,76.14,66.37 ,33.33
03,001,02,008,0483,1076 ,926,12,938,1440,0,3,1,3,0,1,0,76.14,65.14 ,33.33
03,001,02,008,0484,1077 ,726,12,738,1031,0,3,1,3,0,1,0,76.14,71.58 ,33.33
03,001,02,008,0484,1078 ,693,9,702,952,0,3,1,3,0,1,0,76.14,73.74 ,33.33
03,001,02,008,0485,1079 ,905,17,922,1389,0,3,1,3,0,1,0,76.14,66.38 ,33.33
03,001,02,008,0486,1080 ,753,21,774,1178,0,3,1,3,0,1,0,76.14,65.70 ,33.33
03,001,02,008,0486,1081 ,860,11,871,1324,0,3,1,3,0,1,0,76.14,65.79 ,33.33
03,001,02,008,0487,1082 ,765,3,768,1181,0,3,1,3,0,1,0,76.14,65.03 ,33.33
03,001,02,008,0487,1083 ,743,12,755,1189,0,3,1,3,0,1,0,76.14,63.50 ,33.33
03,001,02,008,0488,1084 ,654,12,666,1007,0,3,1,3,0,1,0,76.14,66.14 ,33.33
03,001,02,008,0488,1085 ,832,11,843,1323,0,3,1,3,0,1,0,76.14,63.72 ,33.33
03,001,02,008,0489,1086 ,833,8,841,1225,0,3,1,3,0,1,0,76.14,68.65 ,33.33
03,001,02,008,0489,1087 ,666,17,683,1001,0,3,1,3,0,1,0,76.14,68.23 ,33.33
03,001,02,008,0490,1088 ,869,12,881,1375,0,3,1,3,0,1,0,76.14,64.07 ,33.33
03,001,02,008,0490,1089 ,884,10,894,1425,0,3,1,3,0,1,0,76.14,62.74 ,33.33
03,001,02,008,0490,1090 ,805,15,820,1301,0,3,1,3,0,1,0,76.14,63.03 ,33.33
03,001,02,008,0491,1091 ,791,9,800,1261,0,3,1,3,0,1,0,76.14,63.44 ,33.33
03,001,02,008,0491,1092 ,804,18,822,1218,0,3,1,3,0,1,0,76.14,67.49 ,33.33
03,001,02,008,0491,1093 ,662,18,680,1039,0,3,1,3,0,1,0,76.14,65.45 ,33.33
03,001,02,008,0492,1094 ,854,14,868,1458,0,3,1,3,0,1,0,76.14,59.53 ,33.33
03,001,02,008,0492,1095 ,1046,16,1062,1684,0,3,1,3,0,1,0,76.14,63.06 ,33.33
03,001,02,008,0493,1096 ,869,14,883,1397,0,3,1,3,0,1,0,76.14,63.21 ,33.33
03,001,02,008,0493,1097 ,802,20,822,1340,0,3,1,3,0,1,0,76.14,61.34 ,33.33
03,001,02,008,0494,1098 ,817,18,835,1397,0,3,1,3,0,1,0,76.14,59.77 ,33.33
03,001,02,008,0494,1099 ,799,18,817,1399,0,3,1,3,0,1,0,76.14,58.40 ,33.33
03,001,02,008,0494,1100 ,891,16,907,1461,0,3,1,3,0,1,0,76.14,62.08 ,33.33
03,001,02,008,0495,1101 ,546,10,556,859,0,3,1,3,0,1,0,76.14,64.73 ,33.33
03,001,02,008,0495,1102 ,575,9,584,925,0,3,1,3,0,1,0,76.14,63.14 ,33.33
03,001,02,008,0496,1103 ,740,15,755,1165,0,3,1,3,0,1,0,76.14,64.81 ,33.33
03,001,02,008,0496,1104 ,749,10,759,1204,0,3,1,3,0,1,0,76.14,63.04 ,33.33
03,001,02,008,0496,1105 ,826,13,839,1287,0,3,1,3,0,1,0,76.14,65.19 ,33.33
03,001,02,008,0496,1106 ,635,13,648,998,0,3,1,3,0,1,0,76.14,64.93 ,33.33
03,001,02,008,0497,1107 ,702,14,716,1175,0,3,1,3,0,1,0,76.14,60.94 ,33.33
03,001,02,008,0497,1108 ,806,11,817,1257,0,3,1,3,0,1,0,76.14,65.00 ,33.33
03,001,02,008,0497,1109 ,726,17,743,1128,0,3,1,3,0,1,0,76.14,65.87 ,33.33
03,001,02,008,0498,1110 ,783,10,793,1239,0,3,1,3,0,1,0,76.14,64.00 ,33.33
03,001,02,008,0498,1111 ,1024,15,1039,1638,0,3,1,3,0,1,0,76.14,63.43 ,33.33
03,001,02,008,0498,1112 ,475,7,482,732,0,3,1,3,0,1,0,76.14,65.85 ,33.33
03,001,02,008,0499,1113 ,820,19,839,1264,0,3,1,3,0,1,0,76.14,66.38 ,33.33
03,001,02,008,0499,1114 ,839,14,853,1341,0,3,1,3,0,1,0,76.14,63.61 ,33.33
03,001,02,008,0500,1115 ,756,6,762,1179,0,3,1,3,0,1,0,76.14,64.63 ,33.33
03,001,02,008,0500,1116 ,795,9,804,1180,0,3,1,3,0,1,0,76.14,68.14 ,33.33
03,001,02,008,0501,1117 ,596,5,601,918,0,3,1,3,0,1,0,76.14,65.47 ,33.33
03,001,02,008,0501,1118 ,524,10,534,866,0,3,1,3,0,1,0,76.14,61.66 ,33.33
03,001,02,008,0502,1119 ,605,5,610,868,0,3,1,3,0,1,0,76.14,70.28 ,33.33
03,001,02,008,0502,1120 ,652,10,662,1006,0,3,1,3,0,1,0,76.14,65.81 ,33.33
03,001,02,008,0503,1121 ,773,11,784,1198,0,3,1,3,0,1,0,76.14,65.44 ,33.33
03,001,02,008,0503,1122 ,802,16,818,1228,0,3,1,3,0,1,0,76.14,66.61 ,33.33
03,001,02,008,0503,1123 ,792,24,816,1230,0,3,1,3,0,1,0,76.14,66.34 ,33.33
03,001,02,008,0503,1124 ,737,8,745,1112,0,3,1,3,0,1,0,76.14,67.00 ,33.33
03,001,02,008,0504,1125 ,787,4,791,1184,0,3,1,3,0,1,0,76.14,66.81 ,33.33
03,001,02,008,0504,1126 ,980,19,999,1605,0,3,1,3,0,1,0,76.14,62.24 ,33.33
03,001,02,008,0504,1127 ,816,21,837,1274,0,3,1,3,0,1,0,76.14,65.70 ,33.33
03,001,02,009,0505,1128 ,789,13,802,1212,0,3,1,3,0,1,0,76.14,66.17 ,33.33
03,001,02,009,0505,1129 ,837,11,848,1304,0,3,1,3,0,1,0,76.14,65.03 ,33.33
03,001,02,009,0505,1130 ,820,15,835,1149,0,3,1,3,0,1,0,76.14,72.67 ,33.33
03,001,02,009,0506,1131 ,759,14,773,1108,0,3,1,3,0,1,0,76.14,69.77 ,33.33
03,001,02,009,0507,1132 ,981,18,999,1551,0,3,1,3,0,1,0,76.14,64.41 ,33.33
03,001,02,009,0507,1133 ,465,5,470,695,0,3,1,3,0,1,0,76.14,67.63 ,33.33
03,001,02,009,0508,1134 ,841,21,862,1313,0,3,1,3,0,1,0,76.14,65.65 ,33.33
03,001,02,009,0508,1135 ,754,11,765,1178,0,3,1,3,0,1,0,76.14,64.94 ,33.33
03,001,02,009,0509,1136 ,844,9,853,1246,0,3,1,3,0,1,0,76.14,68.46 ,33.33
03,001,02,009,0510,1137 ,685,22,707,1088,0,3,1,3,0,1,0,76.14,64.98 ,33.33
03,001,02,009,0510,1138 ,701,13,714,1071,0,3,1,3,0,1,0,76.14,66.67 ,33.33
03,001,02,009,0511,1139 ,868,12,880,1245,0,3,1,3,0,1,0,76.14,70.68 ,33.33
03,001,02,009,0511,1140 ,742,12,754,1152,0,3,1,3,0,1,0,76.14,65.45 ,33.33
03,001,02,009,0511,1141 ,850,7,857,1355,0,3,1,3,0,1,0,76.14,63.25 ,33.33
03,001,02,009,0512,1142 ,895,23,918,1448,0,3,1,3,0,1,0,76.14,63.40 ,33.33
03,001,02,009,0512,1143 ,901,13,914,1459,0,3,1,3,0,1,0,76.14,62.65 ,33.33
03,001,02,009,0513,1144 ,752,16,768,1130,0,3,1,3,0,1,0,76.14,67.96 ,33.33
03,001,02,009,0513,1145 ,737,12,749,1126,0,3,1,3,0,1,0,76.14,66.52 ,33.33
03,001,02,009,0514,1146 ,801,13,814,1168,0,3,1,3,0,1,0,76.14,69.69 ,33.33
03,001,02,009,0514,1147 ,884,10,894,1334,0,3,1,3,0,1,0,76.14,67.02 ,33.33
03,001,02,009,0515,1148 ,710,10,720,1035,0,3,1,3,0,1,0,76.14,69.57 ,33.33
03,001,02,009,0515,1149 ,788,18,806,1176,0,3,1,3,0,1,0,76.14,68.54 ,33.33
03,001,02,009,0516,1150 ,793,11,804,1158,0,3,1,3,0,1,0,76.14,69.43 ,33.33
03,001,02,009,0517,1151 ,901,23,924,1368,0,3,1,3,0,1,0,76.14,67.54 ,33.33
03,001,02,009,0517,1152 ,991,12,1003,1481,0,3,1,3,0,1,0,76.14,67.72 ,33.33
03,001,02,009,0518,1153 ,757,7,764,1094,0,3,1,3,0,1,0,76.14,69.84 ,33.33
03,001,02,009,0518,1154 ,719,8,727,1038,0,3,1,3,0,1,0,76.14,70.04 ,33.33
03,001,02,009,0519,1155 ,832,12,844,1261,0,3,1,3,0,1,0,76.14,66.93 ,33.33
03,001,02,009,0519,1156 ,739,6,745,1072,0,3,1,3,0,1,0,76.14,69.50 ,33.33
03,001,02,009,0519,1157 ,654,7,661,945,0,3,1,3,0,1,0,76.14,69.95 ,33.33
03,001,02,009,0520,1158 ,669,6,675,992,0,3,1,3,0,1,0,76.14,68.04 ,33.33
03,001,02,009,0520,1159 ,702,11,713,1064,0,3,1,3,0,1,0,76.14,67.01 ,33.33
03,001,02,009,0520,1160 ,838,15,853,1266,0,3,1,3,0,1,0,76.14,67.38 ,33.33
03,001,02,009,0520,1161 ,1000,11,1011,1563,0,3,1,3,0,1,0,76.14,64.68 ,33.33
03,001,02,009,0521,1162 ,1002,15,1017,1507,0,3,1,3,0,1,0,76.14,67.49 ,33.33
03,001,02,009,0521,1163 ,774,11,785,1159,0,3,1,3,0,1,0,76.14,67.73 ,33.33
03,001,02,009,0521,1164 ,809,10,819,1221,0,3,1,3,0,1,0,76.14,67.08 ,33.33
03,001,02,009,0522,1165 ,719,6,725,976,0,3,1,3,0,1,0,76.14,74.28 ,33.33
03,001,02,009,0522,1166 ,650,9,659,888,0,3,1,3,0,1,0,76.14,74.21 ,33.33
03,001,02,009,0523,1167 ,389,7,396,545,0,3,1,3,0,1,0,76.14,72.66 ,33.33
03,001,02,010,0524,1168 ,454,3,457,603,0,3,1,3,0,1,0,76.14,75.79 ,33.33
03,001,02,010,0524,1169 ,178,4,182,250,0,3,1,3,0,1,0,76.14,72.80 ,33.33
03,001,02,010,0525,1170 ,572,16,588,787,0,3,1,3,0,1,0,76.14,74.71 ,33.33
03,001,02,010,0525,1171 ,616,12,628,898,0,3,1,3,0,1,0,76.14,69.93 ,33.33
03,001,02,010,0525,1172 ,356,5,361,467,0,3,1,3,0,1,0,76.14,77.30 ,33.33
03,001,02,010,0526,1173 ,928,11,939,1383,0,3,1,3,0,1,0,76.14,67.90 ,33.33
03,001,02,010,0526,1174 ,794,12,806,1204,0,3,1,3,0,1,0,76.14,66.94 ,33.33
03,001,02,010,0526,1175 ,619,4,623,927,0,3,1,3,0,1,0,76.14,67.21 ,33.33
03,001,02,010,0526,1176 ,653,14,667,968,0,3,1,3,0,1,0,76.14,68.90 ,33.33
03,001,02,010,0527,1177 ,666,10,676,1003,0,3,1,3,0,1,0,76.14,67.40 ,33.33
03,001,02,010,0527,1178 ,640,10,650,952,0,3,1,3,0,1,0,76.14,68.28 ,33.33
03,001,02,010,0527,1179 ,650,24,674,916,0,3,1,3,0,1,0,76.14,73.58 ,33.33
03,001,02,010,0527,1180 ,704,15,719,1019,0,3,1,3,0,1,0,76.14,70.56 ,33.33
03,001,02,010,0528,1181 ,567,11,578,833,0,3,1,3,0,1,0,76.14,69.39 ,33.33
03,001,02,010,0528,1182 ,538,12,550,802,0,3,1,3,0,1,0,76.14,68.58 ,33.33
03,001,02,010,0528,1183 ,628,8,636,872,0,3,1,3,0,1,0,76.14,72.94 ,33.33
03,001,02,010,0529,1184 ,657,7,664,939,0,3,1,3,0,1,0,76.14,70.71 ,33.33
03,001,02,010,0529,1185 ,662,10,672,969,0,3,1,3,0,1,0,76.14,69.35 ,33.33
03,001,02,010,0529,1186 ,556,8,564,801,0,3,1,3,0,1,0,76.14,70.41 ,33.33
03,001,02,010,0530,1187 ,768,7,775,992,0,3,1,3,0,1,0,76.14,78.13 ,33.33
03,001,02,010,0530,1188 ,649,7,656,895,0,3,1,3,0,1,0,76.14,73.30 ,33.33
03,001,02,010,0531,1189 ,675,10,685,1000,0,3,1,3,0,1,0,76.14,68.50 ,33.33
03,001,02,010,0531,1190 ,555,9,564,825,0,3,1,3,0,1,0,76.14,68.36 ,33.33
03,001,02,010,0531,1191 ,834,11,845,1184,0,3,1,3,0,1,0,76.14,71.37 ,33.33
03,001,02,010,0532,1192 ,783,15,798,1190,0,3,1,3,0,1,0,76.14,67.06 ,33.33
03,001,02,010,0532,1193 ,1080,23,1103,1620,0,3,1,3,0,1,0,76.14,68.09 ,33.33
03,001,02,010,0532,1194 ,771,16,787,1135,0,3,1,3,0,1,0,76.14,69.34 ,33.33
03,001,02,010,0533,1195 ,656,12,668,1004,0,3,1,3,0,1,0,76.14,66.53 ,33.33
03,001,02,010,0533,1196 ,602,8,610,879,0,3,1,3,0,1,0,76.14,69.40 ,33.33
03,001,02,010,0533,1197 ,685,6,691,926,0,3,1,3,0,1,0,76.14,74.62 ,33.33
03,001,02,010,0534,1198 ,638,9,647,933,0,3,1,3,0,1,0,76.14,69.35 ,33.33
03,001,02,010,0534,1199 ,559,6,565,840,0,3,1,3,0,1,0,76.14,67.26 ,33.33
03,001,02,010,0535,1200 ,858,12,870,1212,0,3,1,3,0,1,0,76.14,71.78 ,33.33
03,001,02,010,0535,1201 ,957,24,981,1404,0,3,1,3,0,1,0,76.14,69.87 ,33.33
03,001,02,010,0536,1202 ,860,14,874,1273,0,3,1,3,0,1,0,76.14,68.66 ,33.33
03,001,02,010,0536,1203 ,587,5,592,878,0,3,1,3,0,1,0,76.14,67.43 ,33.33
03,001,02,010,0536,1204 ,500,8,508,734,0,3,1,3,0,1,0,76.14,69.21 ,33.33
03,001,02,010,0537,1205 ,927,14,941,1264,0,3,1,3,0,1,0,76.14,74.45 ,33.33
03,001,02,010,0537,1206 ,1044,19,1063,1479,0,3,1,3,0,1,0,76.14,71.87 ,33.33
03,001,02,010,0538,1207 ,847,14,861,1195,0,3,1,3,0,1,0,76.14,72.05 ,33.33
03,001,02,010,0538,1208 ,935,9,944,1450,0,3,1,3,0,1,0,76.14,65.10 ,33.33
03,001,02,010,0538,1209 ,735,8,743,1190,0,3,1,3,0,1,0,76.14,62.44 ,33.33
03,001,02,011,0539,1210 ,750,9,759,1123,0,3,1,3,0,1,0,76.14,67.59 ,33.33
03,001,02,011,0539,1211 ,703,9,712,1013,0,3,1,3,0,1,0,76.14,70.29 ,33.33
03,001,02,011,0539,1212 ,825,10,835,1237,0,3,1,3,0,1,0,76.14,67.50 ,33.33
03,001,02,011,0540,1213 ,631,7,638,1115,0,3,1,3,0,1,0,76.14,57.22 ,33.33
03,001,02,011,0540,1214 ,841,19,860,1243,0,3,1,3,0,1,0,76.14,69.19 ,33.33
03,001,02,011,0540,1215 ,769,12,781,1094,0,3,1,3,0,1,0,76.14,71.39 ,33.33
03,001,02,011,0541,1216 ,792,12,804,1107,0,3,1,3,0,1,0,76.14,72.63 ,33.33
03,001,02,011,0541,1217 ,853,12,865,1224,0,3,1,3,0,1,0,76.14,70.67 ,33.33
03,001,02,011,0541,1218 ,526,10,536,813,0,3,1,3,0,1,0,76.14,65.93 ,33.33
03,001,02,011,0542,1219 ,1103,18,1121,1586,0,3,1,3,0,1,0,76.14,70.68 ,33.33
03,001,02,011,0542,1220 ,1045,13,1058,1520,0,3,1,3,0,1,0,76.14,69.61 ,33.33
03,001,02,011,0543,1221 ,914,17,931,1291,0,3,1,3,0,1,0,76.14,72.11 ,33.33
03,001,02,011,0543,1222 ,698,6,704,1000,0,3,1,3,0,1,0,76.14,70.40 ,33.33
03,001,02,011,0544,1223 ,806,17,823,1057,0,3,1,3,0,1,0,76.14,77.86 ,33.33
03,001,02,011,0545,1224 ,851,10,861,1227,0,3,1,3,0,1,0,76.14,70.17 ,33.33
03,001,02,011,0546,1225 ,574,8,582,851,0,3,1,3,0,1,0,76.14,68.39 ,33.33
03,001,02,011,0546,1226 ,657,7,664,1039,0,3,1,3,0,1,0,76.14,63.91 ,33.33
03,001,02,011,0546,1227 ,739,15,754,1162,0,3,1,3,0,1,0,76.14,64.89 ,33.33
03,001,02,011,0546,1228 ,677,3,680,1005,0,3,1,3,0,1,0,76.14,67.66 ,33.33
03,001,02,011,0546,1229 ,585,9,594,909,0,3,1,3,0,1,0,76.14,65.35 ,33.33
03,001,02,011,0546,1230 ,610,6,616,933,0,3,1,3,0,1,0,76.14,66.02 ,33.33
03,001,02,011,0546,1231 ,607,8,615,891,0,3,1,3,0,1,0,76.14,69.02 ,33.33
03,001,02,011,0547,1232 ,683,11,694,1072,0,3,1,3,0,1,0,76.14,64.74 ,33.33
03,001,02,011,0547,1233 ,717,10,727,1121,0,3,1,3,0,1,0,76.14,64.85 ,33.33
03,001,02,011,0547,1234 ,900,12,912,1338,0,3,1,3,0,1,0,76.14,68.16 ,33.33
03,001,02,011,0547,1235 ,947,11,958,1382,0,3,1,3,0,1,0,76.14,69.32 ,33.33
03,001,02,011,0547,1236 ,754,8,762,1147,0,3,1,3,0,1,0,76.14,66.43 ,33.33
03,001,02,011,0548,1237 ,605,13,618,943,0,3,1,3,0,1,0,76.14,65.54 ,33.33
03,001,02,011,0549,1238 ,626,16,642,897,0,3,1,3,0,1,0,76.14,71.57 ,33.33
03,001,02,011,0550,1239 ,475,8,483,644,0,3,1,3,0,1,0,76.14,75.00 ,33.33
03,001,02,011,0551,1240 ,280,4,284,428,0,3,1,3,0,1,0,76.14,66.36 ,33.33
03,001,02,011,0552,1241 ,518,6,524,750,0,3,1,3,0,1,0,76.14,69.87 ,33.33
03,001,02,012,0553,1242 ,426,4,430,571,0,3,1,3,0,1,0,76.14,75.31 ,33.33
03,001,02,012,0554,1243 ,677,16,693,968,0,3,1,3,0,1,0,76.14,71.59 ,33.33
03,001,02,012,0555,1244 ,859,19,878,1288,0,3,1,3,0,1,0,76.14,68.17 ,33.33
03,001,02,012,0556,1245 ,916,9,925,1368,0,3,1,3,0,1,0,76.14,67.62 ,33.33
03,001,02,012,0557,1246 ,459,1,460,760,0,3,1,3,0,1,0,76.14,60.53 ,33.33
03,001,02,012,0558,1247 ,712,10,722,1145,0,3,1,3,0,1,0,76.14,63.06 ,33.33
03,001,02,012,0558,1248 ,597,11,608,995,0,3,1,3,0,1,0,76.14,61.11 ,33.33
03,001,02,012,0559,1249 ,539,13,552,788,0,3,1,3,0,1,0,76.14,70.05 ,33.33
03,001,02,012,0560,1250 ,574,10,584,888,0,3,1,3,0,1,0,76.14,65.77 ,33.33
03,001,02,012,0560,1251 ,584,18,602,893,0,3,1,3,0,1,0,76.14,67.41 ,33.33
03,001,02,012,0561,1252 ,662,15,677,966,0,3,1,3,0,1,0,76.14,70.08 ,33.33
03,001,02,012,0562,1253 ,487,16,503,742,0,3,1,3,0,1,0,76.14,67.79 ,33.33
03,001,02,012,0563,1254 ,608,13,621,976,0,3,1,3,0,1,0,76.14,63.63 ,33.33
03,001,02,012,0564,1255 ,1036,10,1046,1622,0,3,1,3,0,1,0,76.14,64.49 ,33.33
03,001,02,012,0564,1256 ,1023,7,1030,1566,0,3,1,3,0,1,0,76.14,65.77 ,33.33
03,001,02,012,0564,1257 ,947,16,963,1496,0,3,1,3,0,1,0,76.14,64.37 ,33.33
03,001,02,012,0565,1258 ,834,12,846,1273,0,3,1,3,0,1,0,76.14,66.46 ,33.33
03,001,02,012,0565,1259 ,1073,15,1088,1710,0,3,1,3,0,1,0,76.14,63.63 ,33.33
03,001,02,012,0565,1260 ,1216,26,1242,1878,0,3,1,3,0,1,0,76.14,66.13 ,33.33
03,001,02,012,0565,1261 ,874,7,881,1433,0,3,1,3,0,1,0,76.14,61.48 ,33.33
03,001,02,012,0566,1262 ,858,25,883,1383,0,3,1,3,0,1,0,76.14,63.85 ,33.33
03,001,02,012,0566,1263 ,882,17,899,1354,0,3,1,3,0,1,0,76.14,66.40 ,33.33
03,001,02,012,0566,1264 ,836,12,848,1276,0,3,1,3,0,1,0,76.14,66.46 ,33.33
03,001,02,012,0567,1265 ,866,13,879,1330,0,3,1,3,0,1,0,76.14,66.09 ,33.33
03,001,02,012,0568,1266 ,871,14,885,1518,0,3,1,3,0,1,0,76.14,58.30 ,33.33
03,001,02,012,0568,1267 ,740,13,753,1128,0,3,1,3,0,1,0,76.14,66.76 ,33.33
03,001,02,012,0569,1268 ,628,6,634,923,0,3,1,3,0,1,0,76.14,68.69 ,33.33
03,001,02,012,0570,1269 ,725,12,737,1067,0,3,1,3,0,1,0,76.14,69.07 ,33.33
03,001,02,012,0571,1270 ,1031,14,1045,1562,0,3,1,3,0,1,0,76.14,66.90 ,33.33
03,001,02,012,0571,1271 ,1043,18,1061,1594,0,3,1,3,0,1,0,76.14,66.56 ,33.33
03,001,02,012,0571,1272 ,1044,24,1068,1665,0,3,1,3,0,1,0,76.14,64.14 ,33.33
03,001,02,012,0571,1273 ,791,16,807,1338,0,3,1,3,0,1,0,76.14,60.31 ,33.33
03,001,02,012,0571,1274 ,1072,20,1092,1704,0,3,1,3,0,1,0,76.14,64.08 ,33.33
03,001,02,012,0571,1275 ,881,13,894,1392,0,3,1,3,0,1,0,76.14,64.22 ,33.33
03,001,02,012,0571,1276 ,952,12,964,1605,0,3,1,3,0,1,0,76.14,60.06 ,33.33
03,001,02,012,0571,1277 ,1054,21,1075,1622,0,3,1,3,0,1,0,76.14,66.28 ,33.33
03,001,02,012,0572,1278 ,953,21,974,1409,0,3,1,3,0,1,0,76.14,69.13 ,33.33
03,001,02,012,0572,1279 ,934,21,955,1457,0,3,1,3,0,1,0,76.14,65.55 ,33.33
03,001,02,012,0572,1280 ,772,11,783,1215,0,3,1,3,0,1,0,76.14,64.44 ,33.33
03,001,02,012,0572,1281 ,797,13,810,1250,0,3,1,3,0,1,0,76.14,64.80 ,33.33
03,001,02,012,0572,1282 ,996,17,1013,1587,0,3,1,3,0,1,0,76.14,63.83 ,33.33
03,001,02,012,0572,1283 ,841,16,857,1357,0,3,1,3,0,1,0,76.14,63.15 ,33.33
03,001,02,012,0573,1284 ,1048,21,1069,1578,0,3,1,3,0,1,0,76.14,67.74 ,33.33
03,001,02,012,0574,1285 ,940,18,958,1470,0,3,1,3,0,1,0,76.14,65.17 ,33.33
03,001,02,012,0574,1286 ,930,18,948,1475,0,3,1,3,0,1,0,76.14,64.27 ,33.33
03,001,02,012,0574,1287 ,1019,26,1045,1584,0,3,1,3,0,1,0,76.14,65.97 ,33.33
03,001,02,012,0574,1288 ,975,16,991,1626,0,3,1,3,0,1,0,76.14,60.95 ,33.33
03,001,02,012,0574,1289 ,1023,27,1050,1552,0,3,1,3,0,1,0,76.14,67.65 ,33.33
03,001,02,012,0574,1290 ,1077,21,1098,1652,0,3,1,3,0,1,0,76.14,66.46 ,33.33
03,001,02,012,0575,1291 ,734,15,749,1095,0,3,1,3,0,1,0,76.14,68.40 ,33.33
03,001,02,012,0575,1292 ,900,17,917,1311,0,3,1,3,0,1,0,76.14,69.95 ,33.33
03,001,02,012,0575,1293 ,790,15,805,1151,0,3,1,3,0,1,0,76.14,69.94 ,33.33
03,001,02,012,0576,1294 ,1015,19,1034,1543,0,3,1,3,0,1,0,76.14,67.01 ,33.33
03,001,02,012,0577,1295 ,685,14,699,1017,0,3,1,3,0,1,0,76.14,68.73 ,33.33
03,001,02,012,0578,1296 ,604,8,612,846,0,3,1,3,0,1,0,76.14,72.34 ,33.33
03,001,02,012,0579,1297 ,861,10,871,1350,0,3,1,3,0,1,0,76.14,64.52 ,33.33
03,001,02,012,0580,1298 ,504,14,518,723,0,3,1,3,0,1,0,76.14,71.65 ,33.33
03,001,02,012,0581,1299 ,511,5,516,727,0,3,1,3,0,1,0,76.14,70.98 ,33.33
03,001,02,012,0582,1300 ,317,3,320,476,0,3,1,3,0,1,0,76.14,67.23 ,33.33
03,001,02,012,0583,1301 ,835,9,844,1281,0,3,1,3,0,1,0,76.14,65.89 ,33.33
03,001,02,012,0584,1302 ,809,14,823,1180,0,3,1,3,0,1,0,76.14,69.75 ,33.33
03,001,02,012,0584,1303 ,674,23,697,1110,0,3,1,3,0,1,0,76.14,62.79 ,33.33
03,001,02,012,0584,1304 ,788,11,799,1127,0,3,1,3,0,1,0,76.14,70.90 ,33.33
03,001,02,012,0585,1305 ,918,14,932,1464,0,3,1,3,0,1,0,76.14,63.66 ,33.33
03,001,02,012,0585,1306 ,1007,23,1030,1552,0,3,1,3,0,1,0,76.14,66.37 ,33.33
03,001,02,012,0585,1307 ,950,20,970,1426,0,3,1,3,0,1,0,76.14,68.02 ,33.33
03,001,02,013,0586,1308 ,1082,24,1106,1656,0,3,1,3,0,1,0,76.14,66.79 ,33.33
03,001,02,013,0586,1309 ,768,10,778,1132,0,3,1,3,0,1,0,76.14,68.73 ,33.33
03,001,02,013,0586,1310 ,789,17,806,1159,0,3,1,3,0,1,0,76.14,69.54 ,33.33
03,001,02,013,0587,1311 ,724,12,736,1158,0,3,1,3,0,1,0,76.14,63.56 ,33.33
03,001,02,013,0587,1312 ,707,11,718,1012,0,3,1,3,0,1,0,76.14,70.95 ,33.33
03,001,02,013,0588,1313 ,992,21,1013,1374,0,3,1,3,0,1,0,76.14,73.73 ,33.33
03,001,02,013,0589,1314 ,621,13,634,991,0,3,1,3,0,1,0,76.14,63.98 ,33.33
03,001,02,013,0589,1315 ,809,15,824,1206,0,3,1,3,0,1,0,76.14,68.33 ,33.33
03,001,02,013,0590,1316 ,708,18,726,1034,0,3,1,3,0,1,0,76.14,70.21 ,33.33
03,001,02,013,0591,1317 ,751,16,767,1147,0,3,1,3,0,1,0,76.14,66.87 ,33.33
03,001,02,013,0591,1318 ,753,12,765,1214,0,3,1,3,0,1,0,76.14,63.01 ,33.33
03,001,02,013,0591,1319 ,883,9,892,1456,0,3,1,3,0,1,0,76.14,61.26 ,33.33
03,001,02,013,0592,1320 ,847,16,863,1243,0,3,1,3,0,1,0,76.14,69.43 ,33.33
03,001,02,013,0592,1321 ,729,15,744,1091,0,3,1,3,0,1,0,76.14,68.19 ,33.33
03,001,02,013,0593,1322 ,852,13,865,1222,0,3,1,3,0,1,0,76.14,70.79 ,33.33
03,001,02,013,0594,1323 ,777,11,788,997,0,3,1,3,0,1,0,76.14,79.04 ,33.33
03,001,02,013,0595,1324 ,814,15,829,1059,0,3,1,3,0,1,0,76.14,78.28 ,33.33
03,001,02,014,0596,1325 ,270,6,276,369,0,3,1,3,0,1,0,76.14,74.80 ,33.33
03,001,02,014,0597,1326 ,783,7,790,1149,0,3,1,3,0,1,0,76.14,68.76 ,33.33
03,001,02,014,0597,1327 ,797,18,815,1178,0,3,1,3,0,1,0,76.14,69.19 ,33.33
03,001,02,014,0597,1328 ,730,18,748,1113,0,3,1,3,0,1,0,76.14,67.21 ,33.33
03,001,02,014,0598,1329 ,603,10,613,882,0,3,1,3,0,1,0,76.14,69.50 ,33.33
03,001,02,014,0599,1330 ,521,12,533,804,0,3,1,3,0,1,0,76.14,66.29 ,33.33
03,001,02,014,0600,1331 ,1031,17,1048,1619,0,3,1,3,0,1,0,76.14,64.73 ,33.33
03,001,02,014,0600,1332 ,940,9,949,1526,0,3,1,3,0,1,0,76.14,62.19 ,33.33
03,001,02,014,0600,1333 ,965,17,982,1527,0,3,1,3,0,1,0,76.14,64.31 ,33.33
03,001,02,014,0601,1334 ,288,4,292,428,0,3,1,3,0,1,0,76.14,68.22 ,33.33
03,001,02,014,0602,1335 ,370,8,378,552,0,3,1,3,0,1,0,76.14,68.48 ,33.33
03,001,02,014,0603,1336 ,506,7,513,760,0,3,1,3,0,1,0,76.14,67.50 ,33.33
03,001,02,014,0604,1337 ,908,16,924,1463,0,3,1,3,0,1,0,76.14,63.16 ,33.33
03,001,02,014,0605,1338 ,424,10,434,627,0,3,1,3,0,1,0,76.14,69.22 ,33.33
03,001,02,014,0606,1339 ,308,7,315,492,0,3,1,3,0,1,0,76.14,64.02 ,33.33
03,001,02,014,0607,1340 ,443,6,449,628,0,3,1,3,0,1,0,76.14,71.50 ,33.33
03,001,02,014,0608,1341 ,688,9,697,1108,0,3,1,3,0,1,0,76.14,62.91 ,33.33
03,001,02,015,0609,1342 ,574,6,580,836,0,3,1,3,0,1,0,76.14,69.38 ,33.33
03,001,02,015,0610,1343 ,719,7,726,1021,0,3,1,3,0,1,0,76.14,71.11 ,33.33
03,001,02,015,0611,1344 ,1123,16,1139,1717,0,3,1,3,0,1,0,76.14,66.34 ,33.33
03,001,02,015,0612,1345 ,479,5,484,700,0,3,1,3,0,1,0,76.14,69.14 ,33.33
03,001,02,015,0613,1346 ,780,5,785,1162,0,3,1,3,0,1,0,76.14,67.56 ,33.33
03,001,02,015,0614,1347 ,780,10,790,1206,0,3,1,3,0,1,0,76.14,65.51 ,33.33
03,001,02,015,0615,1348 ,206,0,206,324,0,3,1,3,0,1,0,76.14,63.58 ,33.33
03,001,02,015,0616,1349 ,331,4,335,489,0,3,1,3,0,1,0,76.14,68.51 ,33.33
03,001,02,015,0617,1350 ,458,1,459,727,0,3,1,3,0,1,0,76.14,63.14 ,33.33
03,001,02,016,0618,1351 ,287,6,293,418,0,3,1,3,0,1,0,76.14,70.10 ,33.33
03,001,02,016,0619,1352 ,432,6,438,626,0,3,1,3,0,1,0,76.14,69.97 ,33.33
03,001,02,016,0620,1353 ,315,4,319,459,0,3,1,3,0,1,0,76.14,69.50 ,33.33
03,001,02,016,0621,1354 ,917,18,935,1525,0,3,1,3,0,1,0,76.14,61.31 ,33.33
03,001,02,016,0622,1355 ,1060,10,1070,1579,0,3,1,3,0,1,0,76.14,67.76 ,33.33
03,001,02,016,0622,1356 ,1082,10,1092,1615,0,3,1,3,0,1,0,76.14,67.62 ,33.33
03,001,02,016,0622,1357 ,1040,14,1054,1671,0,3,1,3,0,1,0,76.14,63.08 ,33.33
03,001,02,016,0622,1358 ,928,7,935,1491,0,3,1,3,0,1,0,76.14,62.71 ,33.33
03,001,02,016,0623,1359 ,455,10,465,667,0,3,1,3,0,1,0,76.14,69.72 ,33.33
03,001,02,016,0623,1360 ,502,7,509,759,0,3,1,3,0,1,0,76.14,67.06 ,33.33
03,001,02,016,0624,1361 ,569,4,573,882,0,3,1,3,0,1,0,76.14,64.97 ,33.33
03,001,02,016,0625,1362 ,243,6,249,385,0,3,1,3,0,1,0,76.14,64.68 ,33.33
03,001,02,016,0626,1363 ,377,1,378,533,0,3,1,3,0,1,0,76.14,70.92 ,33.33
03,001,02,016,0627,1364 ,398,13,411,587,0,3,1,3,0,1,0,76.14,70.02 ,33.33
03,001,02,016,0628,1365 ,501,6,507,798,0,3,1,3,0,1,0,76.14,63.53 ,33.33
03,001,02,016,0629,1366 ,162,0,162,234,0,3,1,3,0,1,0,76.14,69.23 ,33.33
03,001,02,016,0630,1367 ,310,4,314,451,0,3,1,3,0,1,0,76.14,69.62 ,33.33
03,001,02,016,0631,1368 ,308,3,311,553,0,3,1,3,0,1,0,76.14,56.24 ,33.33
03,001,02,017,0632,1369 ,1032,18,1050,1544,0,3,1,3,0,1,0,76.14,68.01 ,33.33
03,001,02,017,0632,1370 ,970,10,980,1422,0,3,1,3,0,1,0,76.14,68.92 ,33.33
03,001,02,017,0633,1371 ,586,14,600,1009,0,3,1,3,0,1,0,76.14,59.46 ,33.33
03,001,02,017,0633,1372 ,512,12,524,906,0,3,1,3,0,1,0,76.14,57.84 ,33.33
03,001,02,017,0634,1373 ,294,19,313,547,0,3,1,3,0,1,0,76.14,57.22 ,33.33
03,001,02,017,0634,1374 ,621,12,633,1062,0,3,1,3,0,1,0,76.14,59.60 ,33.33
03,001,02,017,0635,1375 ,730,11,741,1173,0,3,1,3,0,1,0,76.14,63.17 ,33.33
03,001,02,017,0635,1376 ,647,8,655,1073,0,3,1,3,0,1,0,76.14,61.04 ,33.33
03,001,02,017,0636,1377 ,419,5,424,676,0,3,1,3,0,1,0,76.14,62.72 ,33.33
03,001,02,017,0636,1378 ,973,13,986,1444,0,3,1,3,0,1,0,76.14,68.28 ,33.33
03,001,02,017,0637,1379 ,313,1,314,465,0,3,1,3,0,1,0,76.14,67.53 ,33.33
03,001,02,017,0638,1380 ,488,8,496,774,0,3,1,3,0,1,0,76.14,64.08 ,33.33
03,001,02,017,0639,1381 ,335,6,341,527,0,3,1,3,0,1,0,76.14,64.71 ,33.33
03,001,02,017,0640,1382 ,365,7,372,560,0,3,1,3,0,1,0,76.14,66.43 ,33.33
03,001,02,017,0641,1383 ,517,4,521,782,0,3,1,3,0,1,0,76.14,66.62 ,33.33
03,001,03,018,0642,1384 ,1036,25,1061,1567,0,3,1,3,0,1,0,76.14,67.71 ,33.33
03,001,03,018,0642,1385 ,494,10,504,736,0,3,1,3,0,1,0,76.14,68.48 ,33.33
03,001,03,018,0642,1386 ,873,15,888,1415,0,3,1,3,0,1,0,76.14,62.76 ,33.33
03,001,03,018,0643,1387 ,446,6,452,630,0,3,1,3,0,1,0,76.14,71.75 ,33.33
03,001,03,018,0643,1388 ,413,5,418,576,0,3,1,3,0,1,0,76.14,72.57 ,33.33
03,001,03,018,0644,1389 ,841,13,854,1234,0,3,1,3,0,1,0,76.14,69.21 ,33.33
03,001,03,018,0644,1390 ,1006,8,1014,1350,0,3,1,3,0,1,0,76.14,75.11 ,33.33
03,001,03,018,0644,1391 ,1434,15,1449,2090,0,3,1,3,0,1,0,76.14,69.33 ,33.33
03,001,03,018,0645,1392 ,1410,30,1440,2003,0,3,1,3,0,1,0,76.14,71.89 ,33.33
03,001,03,018,0645,1393 ,1162,18,1180,1665,0,3,1,3,0,1,0,76.14,70.87 ,33.33
03,001,03,018,0646,1394 ,635,12,647,921,0,3,1,3,0,1,0,76.14,70.25 ,33.33
03,001,03,018,0646,1395 ,807,9,816,1204,0,3,1,3,0,1,0,76.14,67.77 ,33.33
03,001,03,018,0647,1396 ,1297,14,1311,1832,0,3,1,3,0,1,0,76.14,71.56 ,33.33
03,001,03,018,0647,1397 ,1134,14,1148,1650,0,3,1,3,0,1,0,76.14,69.58 ,33.33
03,001,03,018,0648,1398 ,916,10,926,1383,0,3,1,3,0,1,0,76.14,66.96 ,33.33
03,001,03,018,0648,1399 ,977,15,992,1403,0,3,1,3,0,1,0,76.14,70.71 ,33.33
03,001,03,018,0649,1400 ,967,16,983,1572,0,3,1,3,0,1,0,76.14,62.53 ,33.33
03,001,03,018,0649,1401 ,950,13,963,1344,0,3,1,3,0,1,0,76.14,71.65 ,33.33
03,001,03,018,0650,1402 ,794,10,804,1157,0,3,1,3,0,1,0,76.14,69.49 ,33.33
03,001,03,018,0650,1403 ,843,10,853,1196,0,3,1,3,0,1,0,76.14,71.32 ,33.33
03,001,03,018,0650,1404 ,918,10,928,1371,0,3,1,3,0,1,0,76.14,67.69 ,33.33
03,001,03,018,0651,1405 ,1061,18,1079,1620,0,3,1,3,0,1,0,76.14,66.60 ,33.33
03,001,03,018,0651,1406 ,1189,19,1208,1713,0,3,1,3,0,1,0,76.14,70.52 ,33.33
03,001,03,018,0652,1407 ,664,17,681,984,0,3,1,3,0,1,0,76.14,69.21 ,33.33
03,001,03,018,0652,1408 ,1073,23,1096,1540,0,3,1,3,0,1,0,76.14,71.17 ,33.33
03,001,03,018,0652,1409 ,638,14,652,878,0,3,1,3,0,1,0,76.14,74.26 ,33.33
03,001,03,018,0653,1410 ,1140,15,1155,1524,0,3,1,3,0,1,0,76.14,75.79 ,33.33
03,001,03,018,0653,1411 ,836,11,847,1200,0,3,1,3,0,1,0,76.14,70.58 ,33.33
03,001,03,018,0653,1412 ,746,7,753,1053,0,3,1,3,0,1,0,76.14,71.51 ,33.33
03,001,03,018,0654,1413 ,1146,12,1158,1652,0,3,1,3,0,1,0,76.14,70.10 ,33.33
03,001,03,018,0654,1414 ,1415,12,1427,2023,0,3,1,3,0,1,0,76.14,70.54 ,33.33
03,001,03,018,0655,1415 ,617,11,628,957,0,3,1,3,0,1,0,76.14,65.62 ,33.33
03,001,03,018,0655,1416 ,992,14,1006,1436,0,3,1,3,0,1,0,76.14,70.06 ,33.33
03,001,03,018,0655,1417 ,942,15,957,1374,0,3,1,3,0,1,0,76.14,69.65 ,33.33
03,001,03,018,0656,1418 ,1003,7,1010,1448,0,3,1,3,0,1,0,76.14,69.75 ,33.33
03,001,03,018,0656,1419 ,1186,20,1206,1721,0,3,1,3,0,1,0,76.14,70.08 ,33.33
03,001,03,018,0657,1420 ,1064,16,1080,1572,0,3,1,3,0,1,0,76.14,68.70 ,33.33
03,001,03,018,0657,1421 ,972,7,979,1349,0,3,1,3,0,1,0,76.14,72.57 ,33.33
03,001,03,018,0657,1422 ,747,9,756,1042,0,3,1,3,0,1,0,76.14,72.55 ,33.33
03,001,03,018,0658,1423 ,1564,17,1581,2272,0,3,1,3,0,1,0,76.14,69.59 ,33.33
03,001,03,018,0658,1424 ,1188,12,1200,1760,0,3,1,3,0,1,0,76.14,68.18 ,33.33
03,001,03,018,0658,1425 ,1206,17,1223,1693,0,3,1,3,0,1,0,76.14,72.24 ,33.33
03,001,03,018,0659,1426 ,1227,13,1240,1754,0,3,1,3,0,1,0,76.14,70.70 ,33.33
03,001,03,018,0659,1427 ,1149,8,1157,1637,0,3,1,3,0,1,0,76.14,70.68 ,33.33
03,001,03,018,0660,1428 ,1655,23,1678,2591,0,3,1,3,0,1,0,76.14,64.76 ,33.33
03,001,03,018,0660,1429 ,1881,19,1900,2783,0,3,1,3,0,1,0,76.14,68.27 ,33.33
03,001,03,018,0661,1430 ,686,11,697,1046,0,3,1,3,0,1,0,76.14,66.63 ,33.33
03,001,03,018,0661,1431 ,854,16,870,1281,0,3,1,3,0,1,0,76.14,67.92 ,33.33
03,001,03,018,0661,1432 ,862,6,868,1229,0,3,1,3,0,1,0,76.14,70.63 ,33.33
03,001,03,018,0662,1433 ,878,21,899,1299,0,3,1,3,0,1,0,76.14,69.21 ,33.33
03,001,03,018,0662,1434 ,657,11,668,954,0,3,1,3,0,1,0,76.14,70.02 ,33.33
03,001,03,018,0662,1435 ,838,12,850,1185,0,3,1,3,0,1,0,76.14,71.73 ,33.33
03,001,03,018,0663,1436 ,1066,25,1091,1581,0,3,1,3,0,1,0,76.14,69.01 ,33.33
03,001,03,018,0663,1437 ,1158,30,1188,1694,0,3,1,3,0,1,0,76.14,70.13 ,33.33
03,001,03,018,0664,1438 ,691,14,705,966,0,3,1,3,0,1,0,76.14,72.98 ,33.33
03,001,03,018,0664,1439 ,621,13,634,905,0,3,1,3,0,1,0,76.14,70.06 ,33.33
03,001,03,018,0665,1440 ,1058,4,1062,1414,0,3,1,3,0,1,0,76.14,75.11 ,33.33
03,001,03,018,0665,1441 ,1283,23,1306,1820,0,3,1,3,0,1,0,76.14,71.76 ,33.33
03,001,03,018,0666,1442 ,743,12,755,1142,0,3,1,3,0,1,0,76.14,66.11 ,33.33
03,001,03,018,0666,1443 ,911,11,922,1317,0,3,1,3,0,1,0,76.14,70.01 ,33.33
03,001,03,018,0667,1444 ,1194,11,1205,1615,0,3,1,3,0,1,0,76.14,74.61 ,33.33
03,001,03,018,0668,1445 ,1129,17,1146,1534,0,3,1,3,0,1,0,76.14,74.71 ,33.33
03,001,03,018,0668,1446 ,982,12,994,1365,0,3,1,3,0,1,0,76.14,72.82 ,33.33
03,001,03,018,0669,1447 ,959,14,973,1298,0,3,1,3,0,1,0,76.14,74.96 ,33.33
03,001,03,018,0669,1448 ,835,13,848,1171,0,3,1,3,0,1,0,76.14,72.42 ,33.33
03,001,03,018,0670,1449 ,1088,14,1102,1581,0,3,1,3,0,1,0,76.14,69.70 ,33.33
03,001,03,018,0670,1450 ,1337,10,1347,1848,0,3,1,3,0,1,0,76.14,72.89 ,33.33
03,001,03,018,0671,1451 ,839,11,850,1140,0,3,1,3,0,1,0,76.14,74.56 ,33.33
03,001,03,018,0671,1452 ,876,14,890,1219,0,3,1,3,0,1,0,76.14,73.01 ,33.33
03,001,03,018,0671,1453 ,1154,11,1165,1645,0,3,1,3,0,1,0,76.14,70.82 ,33.33
03,001,03,018,0672,1454 ,1171,16,1187,1605,0,3,1,3,0,1,0,76.14,73.96 ,33.33
03,001,03,018,0672,1455 ,1288,9,1297,1784,0,3,1,3,0,1,0,76.14,72.70 ,33.33
03,001,03,018,0673,1456 ,788,8,796,1117,0,3,1,3,0,1,0,76.14,71.26 ,33.33
03,001,03,018,0673,1457 ,669,12,681,970,0,3,1,3,0,1,0,76.14,70.21 ,33.33
03,001,03,018,0673,1458 ,845,8,853,1227,0,3,1,3,0,1,0,76.14,69.52 ,33.33
03,001,03,018,0674,1459 ,1266,23,1289,1880,0,3,1,3,0,1,0,76.14,68.56 ,33.33
03,001,03,018,0674,1460 ,1151,17,1168,1654,0,3,1,3,0,1,0,76.14,70.62 ,33.33
03,001,03,018,0675,1461 ,983,12,995,1389,0,3,1,3,0,1,0,76.14,71.63 ,33.33
03,001,03,018,0675,1462 ,989,12,1001,1441,0,3,1,3,0,1,0,76.14,69.47 ,33.33
03,001,03,018,0676,1463 ,818,13,831,1201,0,3,1,3,0,1,0,76.14,69.19 ,33.33
03,001,03,018,0676,1464 ,740,13,753,1035,0,3,1,3,0,1,0,76.14,72.75 ,33.33
03,001,03,018,0677,1465 ,1228,14,1242,1711,0,3,1,3,0,1,0,76.14,72.59 ,33.33
03,001,03,018,0677,1466 ,688,10,698,977,0,3,1,3,0,1,0,76.14,71.44 ,33.33
03,001,03,018,0677,1467 ,933,5,938,1248,0,3,1,3,0,1,0,76.14,75.16 ,33.33
03,001,03,018,0678,1468 ,793,11,804,1171,0,3,1,3,0,1,0,76.14,68.66 ,33.33
03,001,03,018,0678,1469 ,938,10,948,1374,0,3,1,3,0,1,0,76.14,69.00 ,33.33
03,001,03,018,0678,1470 ,950,13,963,1365,0,3,1,3,0,1,0,76.14,70.55 ,33.33
03,001,03,018,0678,1471 ,796,7,803,1083,0,3,1,3,0,1,0,76.14,74.15 ,33.33
03,001,03,018,0679,1472 ,984,10,994,1377,0,3,1,3,0,1,0,76.14,72.19 ,33.33
03,001,03,018,0679,1473 ,1521,13,1534,2267,0,3,1,3,0,1,0,76.14,67.67 ,33.33
03,001,03,018,0680,1474 ,1515,18,1533,2132,0,3,1,3,0,1,0,76.14,71.90 ,33.33
03,001,03,018,0680,1475 ,740,6,746,1092,0,3,1,3,0,1,0,76.14,68.32 ,33.33
03,001,03,018,0681,1476 ,839,13,852,1238,0,3,1,3,0,1,0,76.14,68.82 ,33.33
03,001,03,018,0681,1477 ,681,5,686,965,0,3,1,3,0,1,0,76.14,71.09 ,33.33
03,001,03,018,0682,1478 ,714,9,723,1074,0,3,1,3,0,1,0,76.14,67.32 ,33.33
03,001,03,018,0682,1479 ,765,12,777,1131,0,3,1,3,0,1,0,76.14,68.70 ,33.33
03,001,03,018,0682,1480 ,848,15,863,1168,0,3,1,3,0,1,0,76.14,73.89 ,33.33
03,001,03,018,0683,1481 ,836,13,849,1192,0,3,1,3,0,1,0,76.14,71.22 ,33.33
03,001,03,018,0683,1482 ,768,10,778,1121,0,3,1,3,0,1,0,76.14,69.40 ,33.33
03,001,03,018,0684,1483 ,764,19,783,1153,0,3,1,3,0,1,0,76.14,67.91 ,33.33
03,001,03,018,0684,1484 ,618,14,632,884,0,3,1,3,0,1,0,76.14,71.49 ,33.33
03,001,03,018,0684,1485 ,726,16,742,1100,0,3,1,3,0,1,0,76.14,67.45 ,33.33
03,001,03,018,0685,1486 ,841,11,852,1185,0,3,1,3,0,1,0,76.14,71.90 ,33.33
03,001,03,018,0685,1487 ,929,9,938,1303,0,3,1,3,0,1,0,76.14,71.99 ,33.33
03,001,03,018,0686,1488 ,1077,9,1086,1593,0,3,1,3,0,1,0,76.14,68.17 ,33.33
03,001,03,018,0686,1489 ,1226,20,1246,1873,0,3,1,3,0,1,0,76.14,66.52 ,33.33
03,001,03,018,0686,1490 ,902,9,911,1420,0,3,1,3,0,1,0,76.14,64.15 ,33.33
03,001,03,018,0687,1491 ,770,10,780,1062,0,3,1,3,0,1,0,76.14,73.45 ,33.33
03,001,03,018,0687,1492 ,990,20,1010,1403,0,3,1,3,0,1,0,76.14,71.99 ,33.33
03,001,03,018,0687,1493 ,1062,16,1078,1446,0,3,1,3,0,1,0,76.14,74.55 ,33.33
03,001,03,018,0688,1494 ,1122,15,1137,1591,0,3,1,3,0,1,0,76.14,71.46 ,33.33
03,001,03,018,0688,1495 ,1062,23,1085,1545,0,3,1,3,0,1,0,76.14,70.23 ,33.33
03,001,03,018,0689,1496 ,577,9,586,887,0,3,1,3,0,1,0,76.14,66.07 ,33.33
03,001,03,018,0689,1497 ,589,10,599,875,0,3,1,3,0,1,0,76.14,68.46 ,33.33
03,001,03,018,0689,1498 ,853,12,865,1238,0,3,1,3,0,1,0,76.14,69.87 ,33.33
03,001,03,018,0689,1499 ,872,18,890,1330,0,3,1,3,0,1,0,76.14,66.92 ,33.33
03,001,03,018,0690,1500 ,1359,13,1372,1907,0,3,1,3,0,1,0,76.14,71.95 ,33.33
03,001,03,018,0690,1501 ,786,12,798,1124,0,3,1,3,0,1,0,76.14,71.00 ,33.33
03,001,03,018,0691,1502 ,1019,22,1041,1470,0,3,1,3,0,1,0,76.14,70.82 ,33.33
03,001,03,018,0691,1503 ,1017,16,1033,1468,0,3,1,3,0,1,0,76.14,70.37 ,33.33
03,001,03,018,0692,1504 ,823,16,839,1132,0,3,1,3,0,1,0,76.14,74.12 ,33.33
03,001,03,018,0692,1505 ,1100,16,1116,1573,0,3,1,3,0,1,0,76.14,70.95 ,33.33
03,001,03,018,0693,1506 ,594,9,603,845,0,3,1,3,0,1,0,76.14,71.36 ,33.33
03,001,03,018,0693,1507 ,746,22,768,1085,0,3,1,3,0,1,0,76.14,70.78 ,33.33
03,001,03,018,0694,1508 ,225,5,230,303,0,3,1,3,0,1,0,76.14,75.91 ,33.33
03,001,03,018,0695,1509 ,935,19,954,1357,0,3,1,3,0,1,0,76.14,70.30 ,33.33
03,001,03,018,0695,1510 ,958,20,978,1339,0,3,1,3,0,1,0,76.14,73.04 ,33.33
03,001,03,018,0695,1511 ,1024,9,1033,1462,0,3,1,3,0,1,0,76.14,70.66 ,33.33
03,001,03,018,0696,1512 ,1036,11,1047,1431,0,3,1,3,0,1,0,76.14,73.17 ,33.33
03,001,03,018,0696,1513 ,558,12,570,822,0,3,1,3,0,1,0,76.14,69.34 ,33.33
03,001,03,018,0697,1514 ,1070,19,1089,1579,0,3,1,3,0,1,0,76.14,68.97 ,33.33
03,001,03,018,0697,1515 ,1052,18,1070,1575,0,3,1,3,0,1,0,76.14,67.94 ,33.33
03,001,03,018,0698,1516 ,1134,9,1143,1604,0,3,1,3,0,1,0,76.14,71.26 ,33.33
03,001,03,018,0698,1517 ,1064,10,1074,1553,0,3,1,3,0,1,0,76.14,69.16 ,33.33
03,001,03,018,0699,1518 ,1004,15,1019,1386,0,3,1,3,0,1,0,76.14,73.52 ,33.33
03,001,03,018,0699,1519 ,857,8,865,1240,0,3,1,3,0,1,0,76.14,69.76 ,33.33
03,001,03,018,0699,1520 ,812,9,821,1128,0,3,1,3,0,1,0,76.14,72.78 ,33.33
03,001,03,018,0700,1521 ,729,12,741,1038,0,3,1,3,0,1,0,76.14,71.39 ,33.33
03,001,03,018,0700,1522 ,644,8,652,948,0,3,1,3,0,1,0,76.14,68.78 ,33.33
03,001,03,018,0701,1523 ,1091,15,1106,1534,0,3,1,3,0,1,0,76.14,72.10 ,33.33
03,001,03,018,0701,1524 ,733,8,741,1125,0,3,1,3,0,1,0,76.14,65.87 ,33.33
03,001,03,018,0701,1525 ,1312,20,1332,1907,0,3,1,3,0,1,0,76.14,69.85 ,33.33
03,001,03,018,0702,1526 ,1065,18,1083,1570,0,3,1,3,0,1,0,76.14,68.98 ,33.33
03,001,03,018,0702,1527 ,1178,18,1196,1715,0,3,1,3,0,1,0,76.14,69.74 ,33.33
03,001,03,018,0703,1528 ,1074,21,1095,1645,0,3,1,3,0,1,0,76.14,66.57 ,33.33
03,001,03,018,0703,1529 ,1289,18,1307,1848,0,3,1,3,0,1,0,76.14,70.73 ,33.33
03,001,03,018,0704,1530 ,1090,15,1105,1580,0,3,1,3,0,1,0,76.14,69.94 ,33.33
03,001,03,018,0704,1531 ,1010,17,1027,1438,0,3,1,3,0,1,0,76.14,71.42 ,33.33
03,001,03,018,0705,1532 ,1063,16,1079,1574,0,3,1,3,0,1,0,76.14,68.55 ,33.33
03,001,03,018,0705,1533 ,796,6,802,1164,0,3,1,3,0,1,0,76.14,68.90 ,33.33
03,001,03,018,0705,1534 ,1007,20,1027,1507,0,3,1,3,0,1,0,76.14,68.15 ,33.33
03,001,03,018,0706,1535 ,537,7,544,721,0,3,1,3,0,1,0,76.14,75.45 ,33.33
03,001,03,018,0706,1536 ,874,5,879,1212,0,3,1,3,0,1,0,76.14,72.52 ,33.33
03,001,03,018,0706,1537 ,954,14,968,1331,0,3,1,3,0,1,0,76.14,72.73 ,33.33
03,001,03,018,0706,1538 ,597,5,602,855,0,3,1,3,0,1,0,76.14,70.41 ,33.33
03,001,03,018,0707,1539 ,1065,15,1080,1477,0,3,1,3,0,1,0,76.14,73.12 ,33.33
03,001,03,018,0707,1540 ,738,12,750,1052,0,3,1,3,0,1,0,76.14,71.29 ,33.33
03,001,03,018,0708,1541 ,1163,10,1173,1629,0,3,1,3,0,1,0,76.14,72.01 ,33.33
03,001,03,018,0708,1542 ,1093,17,1110,1602,0,3,1,3,0,1,0,76.14,69.29 ,33.33
03,001,03,018,0709,1543 ,1169,12,1181,1682,0,3,1,3,0,1,0,76.14,70.21 ,33.33
03,001,03,018,0709,1544 ,815,17,832,1200,0,3,1,3,0,1,0,76.14,69.33 ,33.33
03,001,03,018,0710,1545 ,965,9,974,1393,0,3,1,3,0,1,0,76.14,69.92 ,33.33
03,001,03,018,0711,1546 ,1195,22,1217,1700,0,3,1,3,0,1,0,76.14,71.59 ,33.33
03,001,03,018,0711,1547 ,867,17,884,1282,0,3,1,3,0,1,0,76.14,68.95 ,33.33
03,001,03,018,0712,1548 ,325,5,330,500,0,3,1,3,0,1,0,76.14,66.00 ,33.33
03,001,03,018,0713,1549 ,1314,25,1339,1966,0,3,1,3,0,1,0,76.14,68.11 ,33.33
03,001,03,018,0713,1550 ,1284,20,1304,1810,0,3,1,3,0,1,0,76.14,72.04 ,33.33
03,001,03,018,0713,1551 ,407,5,412,578,0,3,1,3,0,1,0,76.14,71.28 ,33.33
03,001,03,018,0714,1552 ,769,13,782,1020,0,3,1,3,0,1,0,76.14,76.67 ,33.33
03,001,03,018,0714,1553 ,812,15,827,1121,0,3,1,3,0,1,0,76.14,73.77 ,33.33
03,001,03,018,0715,1554 ,959,14,973,1391,0,3,1,3,0,1,0,76.14,69.95 ,33.33
03,001,03,018,0715,1555 ,785,21,806,1174,0,3,1,3,0,1,0,76.14,68.65 ,33.33
03,001,03,018,0716,1556 ,859,15,874,1266,0,3,1,3,0,1,0,76.14,69.04 ,33.33
03,001,03,018,0716,1557 ,999,24,1023,1490,0,3,1,3,0,1,0,76.14,68.66 ,33.33
03,001,03,018,0716,1558 ,451,10,461,715,0,3,1,3,0,1,0,76.14,64.48 ,33.33
03,001,03,018,0717,1559 ,428,11,439,776,0,3,1,3,0,1,0,76.14,56.57 ,33.33
03,001,03,018,0717,1560 ,840,13,853,1352,0,3,1,3,0,1,0,76.14,63.09 ,33.33
03,001,03,018,0718,1561 ,860,13,873,1171,0,3,1,3,0,1,0,76.14,74.55 ,33.33
03,001,03,018,0718,1562 ,625,10,635,978,0,3,1,3,0,1,0,76.14,64.93 ,33.33
03,001,03,018,0719,1563 ,995,24,1019,1553,0,3,1,3,0,1,0,76.14,65.61 ,33.33
03,001,03,018,0719,1564 ,935,8,943,1495,0,3,1,3,0,1,0,76.14,63.08 ,33.33
03,001,03,018,0720,1565 ,788,12,800,1212,0,3,1,3,0,1,0,76.14,66.01 ,33.33
03,001,03,018,0720,1566 ,1066,17,1083,1553,0,3,1,3,0,1,0,76.14,69.74 ,33.33
03,001,03,018,0720,1567 ,1153,11,1164,1647,0,3,1,3,0,1,0,76.14,70.67 ,33.33
03,001,03,018,0721,1568 ,950,11,961,1444,0,3,1,3,0,1,0,76.14,66.55 ,33.33
03,001,03,018,0721,1569 ,1068,23,1091,1578,0,3,1,3,0,1,0,76.14,69.14 ,33.33
03,001,03,018,0722,1570 ,896,10,906,1272,0,3,1,3,0,1,0,76.14,71.23 ,33.33
03,001,03,018,0722,1571 ,762,8,770,1156,0,3,1,3,0,1,0,76.14,66.61 ,33.33
03,001,03,018,0722,1572 ,811,16,827,1206,0,3,1,3,0,1,0,76.14,68.57 ,33.33
03,001,03,018,0723,1573 ,1005,16,1021,1467,0,3,1,3,0,1,0,76.14,69.60 ,33.33
03,001,03,018,0723,1574 ,962,19,981,1479,0,3,1,3,0,1,0,76.14,66.33 ,33.33
03,001,03,018,0724,1575 ,647,7,654,908,0,3,1,3,0,1,0,76.14,72.03 ,33.33
03,001,03,018,0724,1576 ,655,10,665,922,0,3,1,3,0,1,0,76.14,72.13 ,33.33
03,001,03,018,0725,1577 ,1059,16,1075,1576,0,3,1,3,0,1,0,76.14,68.21 ,33.33
03,001,03,018,0725,1578 ,916,12,928,1262,0,3,1,3,0,1,0,76.14,73.53 ,33.33
03,001,03,018,0726,1579 ,1133,18,1151,1568,0,3,1,3,0,1,0,76.14,73.41 ,33.33
03,001,03,018,0726,1580 ,1178,13,1191,1686,0,3,1,3,0,1,0,76.14,70.64 ,33.33
03,001,03,018,0727,1581 ,939,26,965,1371,0,3,1,3,0,1,0,76.14,70.39 ,33.33
03,001,03,018,0727,1582 ,934,19,953,1365,0,3,1,3,0,1,0,76.14,69.82 ,33.33
03,001,03,018,0728,1583 ,718,10,728,1122,0,3,1,3,0,1,0,76.14,64.88 ,33.33
03,001,03,018,0728,1584 ,985,14,999,1431,0,3,1,3,0,1,0,76.14,69.81 ,33.33
03,001,03,018,0728,1585 ,847,8,855,1301,0,3,1,3,0,1,0,76.14,65.72 ,33.33
03,001,03,018,0729,1586 ,908,8,916,1357,0,3,1,3,0,1,0,76.14,67.50 ,33.33
03,001,03,018,0729,1587 ,754,8,762,1182,0,3,1,3,0,1,0,76.14,64.47 ,33.33
03,001,03,018,0729,1588 ,927,8,935,1297,0,3,1,3,0,1,0,76.14,72.09 ,33.33
03,001,03,018,0730,1589 ,960,13,973,1363,0,3,1,3,0,1,0,76.14,71.39 ,33.33
03,001,03,018,0730,1590 ,1355,26,1381,1990,0,3,1,3,0,1,0,76.14,69.40 ,33.33
03,001,03,018,0731,1591 ,730,12,742,1107,0,3,1,3,0,1,0,76.14,67.03 ,33.33
03,001,03,018,0731,1592 ,1311,16,1327,1907,0,3,1,3,0,1,0,76.14,69.59 ,33.33
03,001,03,018,0732,1593 ,675,27,702,1044,0,3,1,3,0,1,0,76.14,67.24 ,33.33
03,001,03,018,0732,1594 ,938,17,955,1452,0,3,1,3,0,1,0,76.14,65.77 ,33.33
03,001,03,018,0733,1595 ,570,4,574,813,0,3,1,3,0,1,0,76.14,70.60 ,33.33
03,001,03,018,0733,1596 ,925,18,943,1278,0,3,1,3,0,1,0,76.14,73.79 ,33.33
03,001,03,018,0734,1597 ,1197,18,1215,1797,0,3,1,3,0,1,0,76.14,67.61 ,33.33
03,001,03,018,0734,1598 ,1002,21,1023,1462,0,3,1,3,0,1,0,76.14,69.97 ,33.33
03,001,03,019,0735,1599 ,1064,20,1084,1533,0,3,1,3,0,1,0,76.14,70.71 ,33.33
03,001,03,019,0736,1600 ,705,9,714,1053,0,3,1,3,0,1,0,76.14,67.81 ,33.33
03,001,03,019,0737,1601 ,625,11,636,917,0,3,1,3,0,1,0,76.14,69.36 ,33.33
03,001,03,019,0737,1602 ,845,9,854,1267,0,3,1,3,0,1,0,76.14,67.40 ,33.33
03,001,03,019,0738,1603 ,1168,18,1186,1712,0,3,1,3,0,1,0,76.14,69.28 ,33.33
03,001,03,019,0738,1604 ,1162,9,1171,1678,0,3,1,3,0,1,0,76.14,69.79 ,33.33
03,001,03,019,0739,1605 ,1142,24,1166,1636,0,3,1,3,0,1,0,76.14,71.27 ,33.33
03,001,03,019,0739,1606 ,1009,18,1027,1525,0,3,1,3,0,1,0,76.14,67.34 ,33.33
03,001,03,019,0740,1607 ,1127,10,1137,1576,0,3,1,3,0,1,0,76.14,72.14 ,33.33
03,001,03,019,0740,1608 ,1087,7,1094,1540,0,3,1,3,0,1,0,76.14,71.04 ,33.33
03,001,03,019,0741,1609 ,1047,16,1063,1575,0,3,1,3,0,1,0,76.14,67.49 ,33.33
03,001,03,019,0741,1610 ,1028,10,1038,1530,0,3,1,3,0,1,0,76.14,67.84 ,33.33
03,001,03,019,0742,1611 ,773,17,790,1106,0,3,1,3,0,1,0,76.14,71.43 ,33.33
03,001,03,019,0743,1612 ,786,7,793,1151,0,3,1,3,0,1,0,76.14,68.90 ,33.33
03,001,03,019,0743,1613 ,1023,18,1041,1524,0,3,1,3,0,1,0,76.14,68.31 ,33.33
03,001,03,019,0744,1614 ,998,14,1012,1498,0,3,1,3,0,1,0,76.14,67.56 ,33.33
03,001,03,019,0744,1615 ,956,10,966,1419,0,3,1,3,0,1,0,76.14,68.08 ,33.33
03,001,03,019,0745,1616 ,742,11,753,1111,0,3,1,3,0,1,0,76.14,67.78 ,33.33
03,001,03,019,0745,1617 ,633,3,636,937,0,3,1,3,0,1,0,76.14,67.88 ,33.33
03,001,03,019,0746,1618 ,1124,11,1135,1615,0,3,1,3,0,1,0,76.14,70.28 ,33.33
03,001,03,019,0746,1619 ,972,14,986,1593,0,3,1,3,0,1,0,76.14,61.90 ,33.33
03,001,03,019,0747,1620 ,883,17,900,1252,0,3,1,3,0,1,0,76.14,71.88 ,33.33
03,001,03,019,0747,1621 ,914,11,925,1412,0,3,1,3,0,1,0,76.14,65.51 ,33.33
03,001,03,019,0748,1622 ,797,8,805,1204,0,3,1,3,0,1,0,76.14,66.86 ,33.33
03,001,03,019,0748,1623 ,1077,10,1087,1621,0,3,1,3,0,1,0,76.14,67.06 ,33.33
03,001,03,019,0748,1624 ,765,6,771,1104,0,3,1,3,0,1,0,76.14,69.84 ,33.33
03,001,03,019,0749,1625 ,978,9,987,1357,0,3,1,3,0,1,0,76.14,72.73 ,33.33
03,001,03,019,0749,1626 ,851,14,865,1209,0,3,1,3,0,1,0,76.14,71.55 ,33.33
03,001,03,019,0749,1627 ,776,13,789,1091,0,3,1,3,0,1,0,76.14,72.32 ,33.33
03,001,03,019,0750,1628 ,1128,15,1143,1613,0,3,1,3,0,1,0,76.14,70.86 ,33.33
03,001,03,019,0750,1629 ,1004,15,1019,1501,0,3,1,3,0,1,0,76.14,67.89 ,33.33
03,001,03,019,0751,1630 ,905,2,907,1301,0,3,1,3,0,1,0,76.14,69.72 ,33.33
03,001,03,019,0751,1631 ,852,8,860,1232,0,3,1,3,0,1,0,76.14,69.81 ,33.33
03,001,03,019,0752,1632 ,829,14,843,1192,0,3,1,3,0,1,0,76.14,70.72 ,33.33
03,001,03,019,0752,1633 ,832,10,842,1178,0,3,1,3,0,1,0,76.14,71.48 ,33.33
03,001,03,019,0753,1634 ,1260,14,1274,1766,0,3,1,3,0,1,0,76.14,72.14 ,33.33
03,001,03,019,0753,1635 ,1316,16,1332,1893,0,3,1,3,0,1,0,76.14,70.36 ,33.33
03,001,03,019,0754,1636 ,890,13,903,1307,0,3,1,3,0,1,0,76.14,69.09 ,33.33
03,001,03,019,0754,1637 ,862,9,871,1246,0,3,1,3,0,1,0,76.14,69.90 ,33.33
03,001,03,019,0754,1638 ,998,9,1007,1386,0,3,1,3,0,1,0,76.14,72.66 ,33.33
03,001,03,019,0755,1639 ,879,12,891,1285,0,3,1,3,0,1,0,76.14,69.34 ,33.33
03,001,03,019,0755,1640 ,948,9,957,1339,0,3,1,3,0,1,0,76.14,71.47 ,33.33
03,001,03,019,0755,1641 ,763,19,782,1094,0,3,1,3,0,1,0,76.14,71.48 ,33.33
03,001,03,019,0756,1642 ,813,8,821,1213,0,3,1,3,0,1,0,76.14,67.68 ,33.33
03,001,03,019,0756,1643 ,990,4,994,1357,0,3,1,3,0,1,0,76.14,73.25 ,33.33
03,001,03,019,0756,1644 ,844,10,854,1142,0,3,1,3,0,1,0,76.14,74.78 ,33.33
03,001,03,019,0757,1645 ,1126,14,1140,1673,0,3,1,3,0,1,0,76.14,68.14 ,33.33
03,001,03,019,0757,1646 ,1103,13,1116,1607,0,3,1,3,0,1,0,76.14,69.45 ,33.33
03,001,03,019,0758,1647 ,685,10,695,1010,0,3,1,3,0,1,0,76.14,68.81 ,33.33
03,001,03,019,0758,1648 ,1000,11,1011,1413,0,3,1,3,0,1,0,76.14,71.55 ,33.33
03,001,03,019,0759,1649 ,1145,11,1156,1632,0,3,1,3,0,1,0,76.14,70.83 ,33.33
03,001,03,019,0759,1650 ,882,8,890,1274,0,3,1,3,0,1,0,76.14,69.86 ,33.33
03,001,03,019,0760,1651 ,752,8,760,1044,0,3,1,3,0,1,0,76.14,72.80 ,33.33
03,001,03,019,0760,1652 ,769,9,778,1114,0,3,1,3,0,1,0,76.14,69.84 ,33.33
03,001,03,019,0761,1653 ,972,11,983,1362,0,3,1,3,0,1,0,76.14,72.17 ,33.33
03,001,03,019,0761,1654 ,888,3,891,1288,0,3,1,3,0,1,0,76.14,69.18 ,33.33
03,001,03,019,0762,1655 ,726,7,733,1079,0,3,1,3,0,1,0,76.14,67.93 ,33.33
03,001,03,019,0762,1656 ,951,8,959,1297,0,3,1,3,0,1,0,76.14,73.94 ,33.33
03,001,03,019,0762,1657 ,710,13,723,998,0,3,1,3,0,1,0,76.14,72.44 ,33.33
03,001,03,019,0763,1658 ,837,11,848,1186,0,3,1,3,0,1,0,76.14,71.50 ,33.33
03,001,03,019,0763,1659 ,871,14,885,1258,0,3,1,3,0,1,0,76.14,70.35 ,33.33
03,001,03,019,0764,1660 ,937,16,953,1375,0,3,1,3,0,1,0,76.14,69.31 ,33.33
03,001,03,019,0764,1661 ,678,15,693,1000,0,3,1,3,0,1,0,76.14,69.30 ,33.33
03,001,03,019,0765,1662 ,1081,17,1098,1523,0,3,1,3,0,1,0,76.14,72.09 ,33.33
03,001,03,019,0765,1663 ,1271,15,1286,1839,0,3,1,3,0,1,0,76.14,69.93 ,33.33
03,001,03,019,0766,1664 ,895,7,902,1304,0,3,1,3,0,1,0,76.14,69.17 ,33.33
03,001,03,019,0766,1665 ,897,11,908,1306,0,3,1,3,0,1,0,76.14,69.53 ,33.33
03,001,03,019,0767,1666 ,997,9,1006,1476,0,3,1,3,0,1,0,76.14,68.16 ,33.33
03,001,03,019,0767,1667 ,1026,12,1038,1517,0,3,1,3,0,1,0,76.14,68.42 ,33.33
03,001,03,019,0768,1668 ,913,7,920,1318,0,3,1,3,0,1,0,76.14,69.80 ,33.33
03,001,03,019,0768,1669 ,807,6,813,1139,0,3,1,3,0,1,0,76.14,71.38 ,33.33
03,001,03,019,0768,1670 ,762,5,767,1117,0,3,1,3,0,1,0,76.14,68.67 ,33.33
03,001,03,019,0769,1671 ,626,3,629,906,0,3,1,3,0,1,0,76.14,69.43 ,33.33
03,001,03,019,0769,1672 ,835,13,848,1197,0,3,1,3,0,1,0,76.14,70.84 ,33.33
03,001,03,019,0769,1673 ,907,14,921,1307,0,3,1,3,0,1,0,76.14,70.47 ,33.33
03,001,03,019,0770,1674 ,1024,11,1035,1532,0,3,1,3,0,1,0,76.14,67.56 ,33.33
03,001,03,019,0770,1675 ,1092,8,1100,1704,0,3,1,3,0,1,0,76.14,64.55 ,33.33
03,001,03,019,0771,1676 ,736,12,748,1058,0,3,1,3,0,1,0,76.14,70.70 ,33.33
03,001,03,019,0771,1677 ,717,10,727,1031,0,3,1,3,0,1,0,76.14,70.51 ,33.33
03,001,03,019,0772,1678 ,1090,8,1098,1550,0,3,1,3,0,1,0,76.14,70.84 ,33.33
03,001,03,019,0772,1679 ,1248,14,1262,1783,0,3,1,3,0,1,0,76.14,70.78 ,33.33
03,001,03,019,0773,1680 ,676,7,683,997,0,3,1,3,0,1,0,76.14,68.51 ,33.33
03,001,03,019,0773,1681 ,664,12,676,972,0,3,1,3,0,1,0,76.14,69.55 ,33.33
03,001,03,019,0774,1682 ,1230,18,1248,1773,0,3,1,3,0,1,0,76.14,70.39 ,33.33
03,001,03,019,0774,1683 ,1147,9,1156,1630,0,3,1,3,0,1,0,76.14,70.92 ,33.33
03,001,03,019,0775,1684 ,872,13,885,1310,0,3,1,3,0,1,0,76.14,67.56 ,33.33
03,001,03,019,0775,1685 ,923,14,937,1336,0,3,1,3,0,1,0,76.14,70.13 ,33.33
03,001,03,019,0776,1686 ,1236,14,1250,1729,0,3,1,3,0,1,0,76.14,72.30 ,33.33
03,001,03,019,0776,1687 ,1007,17,1024,1372,0,3,1,3,0,1,0,76.14,74.64 ,33.33
03,001,03,019,0777,1688 ,1108,13,1121,1558,0,3,1,3,0,1,0,76.14,71.95 ,33.33
03,001,03,019,0777,1689 ,1082,13,1095,1492,0,3,1,3,0,1,0,76.14,73.39 ,33.33
03,001,03,019,0778,1690 ,1136,8,1144,1677,0,3,1,3,0,1,0,76.14,68.22 ,33.33
03,001,03,019,0779,1691 ,1122,15,1137,1614,0,3,1,3,0,1,0,76.14,70.45 ,33.33
03,001,03,019,0779,1692 ,1300,15,1315,1851,0,3,1,3,0,1,0,76.14,71.04 ,33.33
03,001,03,019,0780,1693 ,1323,17,1340,1863,0,3,1,3,0,1,0,76.14,71.93 ,33.33
03,001,03,019,0780,1694 ,1093,17,1110,1516,0,3,1,3,0,1,0,76.14,73.22 ,33.33
03,001,03,019,0781,1695 ,856,7,863,1231,0,3,1,3,0,1,0,76.14,70.11 ,33.33
03,001,03,019,0781,1696 ,845,5,850,1200,0,3,1,3,0,1,0,76.14,70.83 ,33.33
03,001,03,019,0781,1697 ,980,13,993,1389,0,3,1,3,0,1,0,76.14,71.49 ,33.33
03,001,03,019,0782,1698 ,1171,15,1186,1786,0,3,1,3,0,1,0,76.14,66.41 ,33.33
03,001,03,019,0782,1699 ,903,5,908,1221,0,3,1,3,0,1,0,76.14,74.37 ,33.33
03,001,03,019,0782,1700 ,1177,12,1189,1685,0,3,1,3,0,1,0,76.14,70.56 ,33.33
03,001,03,019,0783,1701 ,728,9,737,1112,0,3,1,3,0,1,0,76.14,66.28 ,33.33
03,001,03,019,0783,1702 ,1927,13,1940,2778,0,3,1,3,0,1,0,76.14,69.83 ,33.33
03,001,03,019,0784,1703 ,1139,20,1159,1554,0,3,1,3,0,1,0,76.14,74.58 ,33.33
03,001,03,019,0784,1704 ,1189,18,1207,1698,0,3,1,3,0,1,0,76.14,71.08 ,33.33
03,001,03,019,0785,1705 ,702,14,716,956,0,3,1,3,0,1,0,76.14,74.90 ,33.33
03,001,03,019,0786,1706 ,564,12,576,784,0,3,1,3,0,1,0,76.14,73.47 ,33.33
03,001,03,019,0787,1707 ,659,5,664,922,0,3,1,3,0,1,0,76.14,72.02 ,33.33
03,001,03,019,0788,1708 ,547,9,556,719,0,3,1,3,0,1,0,76.14,77.33 ,33.33
03,001,03,019,0789,1709 ,806,14,820,1105,0,3,1,3,0,1,0,76.14,74.21 ,33.33
03,001,03,019,0789,1710 ,983,12,995,1364,0,3,1,3,0,1,0,76.14,72.95 ,33.33
03,001,03,019,0790,1711 ,660,9,669,943,0,3,1,3,0,1,0,76.14,70.94 ,33.33
03,001,03,019,0790,1712 ,807,17,824,1182,0,3,1,3,0,1,0,76.14,69.71 ,33.33
03,001,03,019,0791,1713 ,778,9,787,1145,0,3,1,3,0,1,0,76.14,68.73 ,33.33
03,001,03,019,0791,1714 ,720,12,732,1018,0,3,1,3,0,1,0,76.14,71.91 ,33.33
03,001,03,019,0792,1715 ,1089,16,1105,1573,0,3,1,3,0,1,0,76.14,70.25 ,33.33
03,001,03,019,0793,1716 ,506,8,514,754,0,3,1,3,0,1,0,76.14,68.17 ,33.33
03,001,03,019,0793,1717 ,733,10,743,1049,0,3,1,3,0,1,0,76.14,70.83 ,33.33
03,001,03,019,0794,1718 ,856,13,869,1184,0,3,1,3,0,1,0,76.14,73.40 ,33.33
03,001,03,019,0794,1719 ,743,10,753,1010,0,3,1,3,0,1,0,76.14,74.55 ,33.33
03,001,03,019,0795,1720 ,644,14,658,917,0,3,1,3,0,1,0,76.14,71.76 ,33.33
03,001,03,019,0795,1721 ,656,6,662,921,0,3,1,3,0,1,0,76.14,71.88 ,33.33
03,001,03,019,0796,1722 ,654,12,666,937,0,3,1,3,0,1,0,76.14,71.08 ,33.33
03,001,03,019,0796,1723 ,848,6,854,1157,0,3,1,3,0,1,0,76.14,73.81 ,33.33
03,001,03,020,0797,1724 ,988,18,1006,1456,0,3,1,3,0,1,0,76.14,69.09 ,33.33
03,001,03,020,0798,1725 ,785,11,796,1155,0,3,1,3,0,1,0,76.14,68.92 ,33.33
03,001,03,020,0799,1726 ,711,6,717,1084,0,3,1,3,0,1,0,76.14,66.14 ,33.33
03,001,03,020,0799,1727 ,587,6,593,890,0,3,1,3,0,1,0,76.14,66.63 ,33.33
03,001,03,020,0800,1728 ,859,5,864,1306,0,3,1,3,0,1,0,76.14,66.16 ,33.33
03,001,03,020,0801,1729 ,537,6,543,735,0,3,1,3,0,1,0,76.14,73.88 ,33.33
03,001,03,020,0802,1730 ,793,15,808,1047,0,3,1,3,0,1,0,76.14,77.17 ,33.33
03,001,03,020,0802,1731 ,750,5,755,1031,0,3,1,3,0,1,0,76.14,73.23 ,33.33
03,001,03,020,0803,1732 ,936,6,942,1321,0,3,1,3,0,1,0,76.14,71.31 ,33.33
03,001,03,020,0803,1733 ,1094,11,1105,1816,0,3,1,3,0,1,0,76.14,60.85 ,33.33
03,001,03,020,0803,1734 ,878,15,893,1279,0,3,1,3,0,1,0,76.14,69.82 ,33.33
03,001,03,020,0804,1735 ,1064,10,1074,1536,0,3,1,3,0,1,0,76.14,69.92 ,33.33
03,001,03,020,0804,1736 ,923,8,931,1282,0,3,1,3,0,1,0,76.14,72.62 ,33.33
03,001,03,020,0804,1737 ,901,11,912,1278,0,3,1,3,0,1,0,76.14,71.36 ,33.33
03,001,03,020,0805,1738 ,804,11,815,1187,0,3,1,3,0,1,0,76.14,68.66 ,33.33
03,001,03,020,0805,1739 ,766,9,775,1124,0,3,1,3,0,1,0,76.14,68.95 ,33.33
03,001,03,020,0806,1740 ,950,12,962,1447,0,3,1,3,0,1,0,76.14,66.48 ,33.33
03,001,03,020,0806,1741 ,818,16,834,1259,0,3,1,3,0,1,0,76.14,66.24 ,33.33
03,001,03,020,0806,1742 ,867,7,874,1261,0,3,1,3,0,1,0,76.14,69.31 ,33.33
03,001,03,020,0806,1743 ,798,13,811,1171,0,3,1,3,0,1,0,76.14,69.26 ,33.33
03,001,03,020,0807,1744 ,850,13,863,1207,0,3,1,3,0,1,0,76.14,71.50 ,33.33
03,001,03,020,0807,1745 ,904,8,912,1344,0,3,1,3,0,1,0,76.14,67.86 ,33.33
03,001,03,020,0807,1746 ,1273,16,1289,1779,0,3,1,3,0,1,0,76.14,72.46 ,33.33
03,001,03,020,0807,1747 ,871,10,881,1327,0,3,1,3,0,1,0,76.14,66.39 ,33.33
03,001,03,020,0808,1748 ,734,8,742,997,0,3,1,3,0,1,0,76.14,74.42 ,33.33
03,001,03,020,0808,1749 ,610,6,616,876,0,3,1,3,0,1,0,76.14,70.32 ,33.33
03,001,03,020,0809,1750 ,766,7,773,1099,0,3,1,3,0,1,0,76.14,70.34 ,33.33
03,001,03,020,0809,1751 ,657,7,664,941,0,3,1,3,0,1,0,76.14,70.56 ,33.33
03,001,03,020,0809,1752 ,586,4,590,875,0,3,1,3,0,1,0,76.14,67.43 ,33.33
03,001,03,020,0810,1753 ,831,9,840,1147,0,3,1,3,0,1,0,76.14,73.23 ,33.33
03,001,03,020,0810,1754 ,775,10,785,1063,0,3,1,3,0,1,0,76.14,73.85 ,33.33
03,001,03,020,0811,1755 ,865,14,879,1198,0,3,1,3,0,1,0,76.14,73.37 ,33.33
03,001,03,020,0811,1756 ,980,5,985,1410,0,3,1,3,0,1,0,76.14,69.86 ,33.33
03,001,03,020,0811,1757 ,1097,16,1113,1676,0,3,1,3,0,1,0,76.14,66.41 ,33.33
03,001,03,020,0811,1758 ,883,8,891,1283,0,3,1,3,0,1,0,76.14,69.45 ,33.33
03,001,03,020,0812,1759 ,723,3,726,1043,0,3,1,3,0,1,0,76.14,69.61 ,33.33
03,001,03,020,0812,1760 ,809,7,816,1146,0,3,1,3,0,1,0,76.14,71.20 ,33.33
03,001,03,020,0812,1761 ,671,12,683,988,0,3,1,3,0,1,0,76.14,69.13 ,33.33
03,001,03,020,0813,1762 ,799,5,804,1129,0,3,1,3,0,1,0,76.14,71.21 ,33.33
03,001,03,020,0813,1763 ,696,10,706,994,0,3,1,3,0,1,0,76.14,71.03 ,33.33
03,001,03,020,0814,1764 ,722,9,731,1040,0,3,1,3,0,1,0,76.14,70.29 ,33.33
03,001,03,020,0814,1765 ,1002,18,1020,1494,0,3,1,3,0,1,0,76.14,68.27 ,33.33
03,001,03,020,0815,1766 ,658,10,668,947,0,3,1,3,0,1,0,76.14,70.54 ,33.33
03,001,03,020,0815,1767 ,818,5,823,1106,0,3,1,3,0,1,0,76.14,74.41 ,33.33
03,001,03,020,0815,1768 ,881,21,902,1337,0,3,1,3,0,1,0,76.14,67.46 ,33.33
03,001,03,020,0816,1769 ,889,4,893,1254,0,3,1,3,0,1,0,76.14,71.21 ,33.33
03,001,03,020,0816,1770 ,960,8,968,1365,0,3,1,3,0,1,0,76.14,70.92 ,33.33
03,001,03,020,0817,1771 ,919,11,930,1298,0,3,1,3,0,1,0,76.14,71.65 ,33.33
03,001,03,020,0817,1772 ,602,7,609,913,0,3,1,3,0,1,0,76.14,66.70 ,33.33
03,001,03,020,0817,1773 ,704,6,710,999,0,3,1,3,0,1,0,76.14,71.07 ,33.33
03,001,03,020,0818,1774 ,865,9,874,1189,0,3,1,3,0,1,0,76.14,73.51 ,33.33
03,001,03,020,0818,1775 ,946,12,958,1308,0,3,1,3,0,1,0,76.14,73.24 ,33.33
03,001,03,020,0819,1776 ,1056,11,1067,1469,0,3,1,3,0,1,0,76.14,72.63 ,33.33
03,001,03,020,0819,1777 ,1201,14,1215,1743,0,3,1,3,0,1,0,76.14,69.71 ,33.33
03,001,03,020,0820,1778 ,375,3,378,548,0,3,1,3,0,1,0,76.14,68.98 ,33.33
03,001,03,020,0820,1779 ,620,7,627,945,0,3,1,3,0,1,0,76.14,66.35 ,33.33
03,001,03,020,0821,1780 ,566,14,580,804,0,3,1,3,0,1,0,76.14,72.14 ,33.33
03,001,03,020,0822,1781 ,1179,9,1188,1676,0,3,1,3,0,1,0,76.14,70.88 ,33.33
03,001,03,020,0822,1782 ,1032,4,1036,1474,0,3,1,3,0,1,0,76.14,70.28 ,33.33
03,001,03,020,0823,1784 ,631,8,639,931,0,3,1,3,0,1,0,76.14,68.64 ,33.33
03,001,03,020,0823,1785 ,724,13,737,1047,0,3,1,3,0,1,0,76.14,70.39 ,33.33
03,001,03,020,0824,1786 ,849,12,861,1205,0,3,1,3,0,1,0,76.14,71.45 ,33.33
03,001,03,020,0824,1787 ,763,6,769,1084,0,3,1,3,0,1,0,76.14,70.94 ,33.33
03,001,03,020,0824,1788 ,852,10,862,1228,0,3,1,3,0,1,0,76.14,70.20 ,33.33
03,001,03,020,0825,1789 ,1092,8,1100,1567,0,3,1,3,0,1,0,76.14,70.20 ,33.33
03,001,03,020,0825,1790 ,1066,4,1070,1488,0,3,1,3,0,1,0,76.14,71.91 ,33.33
03,001,03,020,0826,1791 ,1134,15,1149,1568,0,3,1,3,0,1,0,76.14,73.28 ,33.33
03,001,03,020,0826,1792 ,1116,11,1127,1548,0,3,1,3,0,1,0,76.14,72.80 ,33.33
03,001,03,020,0827,1793 ,740,2,742,1092,0,3,1,3,0,1,0,76.14,67.95 ,33.33
03,001,03,020,0827,1794 ,865,8,873,1233,0,3,1,3,0,1,0,76.14,70.80 ,33.33
03,001,03,020,0827,1795 ,767,9,776,1153,0,3,1,3,0,1,0,76.14,67.30 ,33.33
03,001,03,020,0828,1796 ,706,9,715,1092,0,3,1,3,0,1,0,76.14,65.48 ,33.33
03,001,03,020,0828,1797 ,1194,10,1204,1840,0,3,1,3,0,1,0,76.14,65.43 ,33.33
03,001,03,020,0829,1798 ,771,9,780,1089,0,3,1,3,0,1,0,76.14,71.63 ,33.33
03,001,03,020,0829,1799 ,862,6,868,1264,0,3,1,3,0,1,0,76.14,68.67 ,33.33
03,001,03,020,0829,1800 ,770,13,783,1166,0,3,1,3,0,1,0,76.14,67.15 ,33.33
03,001,03,020,0830,1801 ,763,15,778,1156,0,3,1,3,0,1,0,76.14,67.30 ,33.33
03,001,03,020,0830,1802 ,861,6,867,1268,0,3,1,3,0,1,0,76.14,68.38 ,33.33
03,001,03,020,0830,1803 ,973,16,989,1377,0,3,1,3,0,1,0,76.14,71.82 ,33.33
03,001,03,020,0831,1804 ,1123,12,1135,1663,0,3,1,3,0,1,0,76.14,68.25 ,33.33
03,001,03,020,0831,1805 ,1127,16,1143,1666,0,3,1,3,0,1,0,76.14,68.61 ,33.33
03,001,03,020,0831,1806 ,792,6,798,1168,0,3,1,3,0,1,0,76.14,68.32 ,33.33
03,001,03,020,0832,1807 ,1469,18,1487,2141,0,3,1,3,0,1,0,76.14,69.45 ,33.33
03,001,03,020,0832,1808 ,966,11,977,1380,0,3,1,3,0,1,0,76.14,70.80 ,33.33
03,001,03,020,0832,1809 ,954,14,968,1473,0,3,1,3,0,1,0,76.14,65.72 ,33.33
03,001,03,020,0833,1810 ,1168,19,1187,1684,0,3,1,3,0,1,0,76.14,70.49 ,33.33
03,001,03,020,0833,1811 ,575,5,580,858,0,3,1,3,0,1,0,76.14,67.60 ,33.33
03,001,03,020,0834,1812 ,1093,10,1103,1389,0,3,1,3,0,1,0,76.14,79.41 ,33.33
03,001,03,020,0835,1813 ,885,29,914,1328,0,3,1,3,0,1,0,76.14,68.83 ,33.33
03,001,03,020,0835,1814 ,696,11,707,1004,0,3,1,3,0,1,0,76.14,70.42 ,33.33
03,001,03,020,0836,1815 ,631,6,637,888,0,3,1,3,0,1,0,76.14,71.73 ,33.33
03,001,03,020,0836,1816 ,804,17,821,1187,0,3,1,3,0,1,0,76.14,69.17 ,33.33
03,001,03,020,0837,1817 ,859,13,872,1327,0,3,1,3,0,1,0,76.14,65.71 ,33.33
03,001,03,020,0838,1818 ,1182,29,1211,1710,0,3,1,3,0,1,0,76.14,70.82 ,33.33
03,001,03,020,0839,1819 ,898,9,907,1275,0,3,1,3,0,1,0,76.14,71.14 ,33.33
03,001,03,020,0839,1820 ,909,19,928,1348,0,3,1,3,0,1,0,76.14,68.84 ,33.33
03,001,03,020,0839,1821 ,803,14,817,1252,0,3,1,3,0,1,0,76.14,65.26 ,33.33
03,001,03,020,0839,1822 ,1256,17,1273,1836,0,3,1,3,0,1,0,76.14,69.34 ,33.33
03,001,03,020,0840,1823 ,867,10,877,1280,0,3,1,3,0,1,0,76.14,68.52 ,33.33
03,001,03,020,0840,1824 ,859,6,865,1232,0,3,1,3,0,1,0,76.14,70.21 ,33.33
03,001,03,020,0840,1825 ,987,12,999,1473,0,3,1,3,0,1,0,76.14,67.82 ,33.33
03,001,03,020,0841,1826 ,925,17,942,1324,0,3,1,3,0,1,0,76.14,71.15 ,33.33
03,001,03,020,0841,1827 ,876,13,889,1350,0,3,1,3,0,1,0,76.14,65.85 ,33.33
03,001,03,020,0841,1828 ,810,21,831,1183,0,3,1,3,0,1,0,76.14,70.25 ,33.33
03,001,03,020,0842,1829 ,1115,8,1123,1554,0,3,1,3,0,1,0,76.14,72.27 ,33.33
03,001,03,020,0842,1830 ,1058,14,1072,1523,0,3,1,3,0,1,0,76.14,70.39 ,33.33
03,001,03,020,0843,1831 ,660,3,663,1017,0,3,1,3,0,1,0,76.14,65.19 ,33.33
03,001,03,020,0843,1832 ,892,6,898,1263,0,3,1,3,0,1,0,76.14,71.10 ,33.33
03,001,03,020,0843,1833 ,989,15,1004,1440,0,3,1,3,0,1,0,76.14,69.72 ,33.33
03,001,03,020,0844,1834 ,1143,17,1160,1683,0,3,1,3,0,1,0,76.14,68.92 ,33.33
03,001,03,020,0844,1835 ,956,13,969,1363,0,3,1,3,0,1,0,76.14,71.09 ,33.33
03,001,03,020,0844,1836 ,933,13,946,1438,0,3,1,3,0,1,0,76.14,65.79 ,33.33
03,001,03,020,0844,1837 ,1011,10,1021,1449,0,3,1,3,0,1,0,76.14,70.46 ,33.33
03,001,03,020,0845,1838 ,1024,9,1033,1485,0,3,1,3,0,1,0,76.14,69.56 ,33.33
03,001,03,020,0845,1839 ,1072,11,1083,1522,0,3,1,3,0,1,0,76.14,71.16 ,33.33
03,001,03,020,0846,1840 ,977,10,987,1391,0,3,1,3,0,1,0,76.14,70.96 ,33.33
03,001,03,020,0846,1841 ,788,14,802,1142,0,3,1,3,0,1,0,76.14,70.23 ,33.33
03,001,03,020,0846,1842 ,253,4,257,328,0,3,1,3,0,1,0,76.14,78.35 ,33.33
03,001,03,020,0846,1843 ,592,6,598,903,0,3,1,3,0,1,0,76.14,66.22 ,33.33
03,001,03,020,0846,1844 ,1010,6,1016,1506,0,3,1,3,0,1,0,76.14,67.46 ,33.33
03,001,03,020,0846,1845 ,844,16,860,1276,0,3,1,3,0,1,0,76.14,67.40 ,33.33
03,001,03,020,0847,1846 ,897,4,901,1276,0,3,1,3,0,1,0,76.14,70.61 ,33.33
03,001,03,020,0847,1847 ,738,5,743,1067,0,3,1,3,0,1,0,76.14,69.63 ,33.33
03,001,03,020,0848,1848 ,878,7,885,1148,0,3,1,3,0,1,0,76.14,77.09 ,33.33
03,001,03,020,0848,1849 ,1130,10,1140,1592,0,3,1,3,0,1,0,76.14,71.61 ,33.33
03,001,03,020,0849,1850 ,636,9,645,973,0,3,1,3,0,1,0,76.14,66.29 ,33.33
03,001,03,020,0849,1851 ,577,8,585,819,0,3,1,3,0,1,0,76.14,71.43 ,33.33
03,001,03,020,0849,1852 ,839,4,843,1245,0,3,1,3,0,1,0,76.14,67.71 ,33.33
03,001,03,020,0849,1853 ,978,19,997,1451,0,3,1,3,0,1,0,76.14,68.71 ,33.33
03,001,03,020,0850,1854 ,1113,11,1124,1678,0,3,1,3,0,1,0,76.14,66.98 ,33.33
03,001,03,020,0850,1855 ,808,9,817,1303,0,3,1,3,0,1,0,76.14,62.70 ,33.33
03,001,03,020,0850,1856 ,850,13,863,1355,0,3,1,3,0,1,0,76.14,63.69 ,33.33
03,001,03,020,0851,1857 ,1058,12,1070,1585,0,3,1,3,0,1,0,76.14,67.51 ,33.33
03,001,03,020,0851,1858 ,827,11,838,1239,0,3,1,3,0,1,0,76.14,67.64 ,33.33
03,001,03,020,0851,1859 ,889,9,898,1291,0,3,1,3,0,1,0,76.14,69.56 ,33.33
03,001,03,020,0852,1860 ,1080,8,1088,1507,0,3,1,3,0,1,0,76.14,72.20 ,33.33
03,001,03,020,0852,1861 ,971,13,984,1355,0,3,1,3,0,1,0,76.14,72.62 ,33.33
03,001,03,020,0852,1862 ,887,12,899,1267,0,3,1,3,0,1,0,76.14,70.96 ,33.33
03,001,03,020,0853,1863 ,635,7,642,942,0,3,1,3,0,1,0,76.14,68.15 ,33.33
03,001,03,020,0853,1864 ,725,8,733,1067,0,3,1,3,0,1,0,76.14,68.70 ,33.33
03,001,03,020,0853,1865 ,868,11,879,1233,0,3,1,3,0,1,0,76.14,71.29 ,33.33
03,001,03,020,0854,1866 ,448,5,453,688,0,3,1,3,0,1,0,76.14,65.84 ,33.33
03,001,03,020,0854,1867 ,673,5,678,1013,0,3,1,3,0,1,0,76.14,66.93 ,33.33
03,001,03,020,0855,1868 ,1165,16,1181,1718,0,3,1,3,0,1,0,76.14,68.74 ,33.33
03,001,03,020,0855,1869 ,1091,13,1104,1609,0,3,1,3,0,1,0,76.14,68.61 ,33.33
03,001,03,020,0856,1870 ,900,13,913,1321,0,3,1,3,0,1,0,76.14,69.11 ,33.33
03,001,03,020,0856,1871 ,1076,14,1090,1580,0,3,1,3,0,1,0,76.14,68.99 ,33.33
03,001,03,020,0856,1872 ,692,2,694,967,0,3,1,3,0,1,0,76.14,71.77 ,33.33
03,001,03,020,0857,1873 ,730,7,737,1036,0,3,1,3,0,1,0,76.14,71.14 ,33.33
03,001,03,020,0858,1874 ,887,21,908,1405,0,3,1,3,0,1,0,76.14,64.63 ,33.33
03,001,03,020,0859,1875 ,482,5,487,787,0,3,1,3,0,1,0,76.14,61.88 ,33.33
03,001,03,020,0860,1876 ,269,4,273,371,0,3,1,3,0,1,0,76.14,73.58 ,33.33
03,001,03,020,0860,1877 ,1103,14,1117,1696,0,3,1,3,0,1,0,76.14,65.86 ,33.33
03,001,03,020,0861,1878 ,678,10,688,992,0,3,1,3,0,1,0,76.14,69.35 ,33.33
03,001,03,020,0861,1879 ,796,22,818,1221,0,3,1,3,0,1,0,76.14,66.99 ,33.33
03,001,03,020,0862,1880 ,845,8,853,1346,0,3,1,3,0,1,0,76.14,63.37 ,33.33
03,001,03,020,0863,1881 ,721,16,737,1054,0,3,1,3,0,1,0,76.14,69.92 ,33.33
03,001,03,020,0864,1882 ,273,4,277,418,0,3,1,3,0,1,0,76.14,66.27 ,33.33
03,001,03,020,0864,1883 ,200,2,202,291,0,3,1,3,0,1,0,76.14,69.42 ,33.33
03,001,03,021,0865,1884 ,572,13,585,917,0,3,1,3,0,1,0,76.14,63.79 ,33.33
03,001,03,021,0866,1885 ,593,13,606,899,0,3,1,3,0,1,0,76.14,67.41 ,33.33
03,001,03,021,0866,1886 ,663,13,676,1021,0,3,1,3,0,1,0,76.14,66.21 ,33.33
03,001,03,021,0866,1887 ,492,12,504,809,0,3,1,3,0,1,0,76.14,62.30 ,33.33
03,001,03,021,0867,1888 ,660,8,668,955,0,3,1,3,0,1,0,76.14,69.95 ,33.33
03,001,03,021,0867,1889 ,600,12,612,913,0,3,1,3,0,1,0,76.14,67.03 ,33.33
03,001,03,021,0868,1890 ,930,14,944,1422,0,3,1,3,0,1,0,76.14,66.39 ,33.33
03,001,03,021,0869,1891 ,782,5,787,1177,0,3,1,3,0,1,0,76.14,66.86 ,33.33
03,001,03,021,0869,1892 ,732,13,745,1132,0,3,1,3,0,1,0,76.14,65.81 ,33.33
03,001,03,021,0870,1893 ,740,9,749,1143,0,3,1,3,0,1,0,76.14,65.53 ,33.33
03,001,03,021,0870,1894 ,757,7,764,1156,0,3,1,3,0,1,0,76.14,66.09 ,33.33
03,001,03,021,0870,1895 ,791,13,804,1183,0,3,1,3,0,1,0,76.14,67.96 ,33.33
03,001,03,021,0871,1896 ,979,13,992,1454,0,3,1,3,0,1,0,76.14,68.23 ,33.33
03,001,03,021,0872,1897 ,299,6,305,455,0,3,1,3,0,1,0,76.14,67.03 ,33.33
03,001,03,022,0873,1898 ,292,3,295,398,0,3,1,3,0,1,0,76.14,74.12 ,33.33
03,001,03,022,0874,1899 ,425,9,434,663,0,3,1,3,0,1,0,76.14,65.46 ,33.33
03,001,03,022,0875,1900 ,413,6,419,591,0,3,1,3,0,1,0,76.14,70.90 ,33.33
03,001,03,022,0876,1901 ,173,1,174,274,0,3,1,3,0,1,0,76.14,63.50 ,33.33
03,001,03,022,0877,1902 ,191,4,195,288,0,3,1,3,0,1,0,76.14,67.71 ,33.33
03,001,03,022,0877,1903 ,94,1,95,123,0,3,1,3,0,1,0,76.14,77.24 ,33.33
03,001,03,022,0878,1904 ,456,6,462,713,0,3,1,3,0,1,0,76.14,64.80 ,33.33
03,001,03,022,0879,1905 ,146,1,147,223,0,3,1,3,0,1,0,76.14,65.92 ,33.33
03,001,03,022,0880,1906 ,517,8,525,759,0,3,1,3,0,1,0,76.14,69.17 ,33.33
03,001,03,022,0881,1907 ,388,6,394,597,0,3,1,3,0,1,0,76.14,66.00 ,33.33
03,001,03,022,0882,1908 ,160,3,163,238,0,3,1,3,0,1,0,76.14,68.49 ,33.33
03,001,03,022,0883,1909 ,259,4,263,416,0,3,1,3,0,1,0,76.14,63.22 ,33.33
03,001,03,022,0884,1910 ,432,12,444,621,0,3,1,3,0,1,0,76.14,71.50 ,33.33
03,001,03,023,0885,1911 ,673,12,685,997,0,3,1,3,0,1,0,76.14,68.71 ,33.33
03,001,03,023,0886,1912 ,232,5,237,357,0,3,1,3,0,1,0,76.14,66.39 ,33.33
03,001,03,023,0887,1913 ,344,8,352,557,0,3,1,3,0,1,0,76.14,63.20 ,33.33
03,001,03,023,0888,1914 ,520,3,523,886,0,3,1,3,0,1,0,76.14,59.03 ,33.33
03,001,03,023,0889,1915 ,334,2,336,520,0,3,1,3,0,1,0,76.14,64.62 ,33.33
03,001,03,023,0889,1916 ,124,2,126,207,0,3,1,3,0,1,0,76.14,60.87 ,33.33
03,001,03,023,0890,1917 ,202,5,207,296,0,3,1,3,0,1,0,76.14,69.93 ,33.33
03,001,03,023,0890,1918 ,276,4,280,389,0,3,1,3,0,1,0,76.14,71.98 ,33.33
03,001,03,023,0891,1919 ,193,3,196,321,0,3,1,3,0,1,0,76.14,61.06 ,33.33
03,001,03,023,0891,1920 ,229,0,229,355,0,3,1,3,0,1,0,76.14,64.51 ,33.33
03,001,03,024,0892,1921 ,360,4,364,530,0,3,1,3,0,1,0,76.14,68.68 ,33.33
03,001,03,024,0893,1922 ,697,6,703,1024,0,3,1,3,0,1,0,76.14,68.65 ,33.33
03,001,03,024,0894,1923 ,89,1,90,110,0,3,1,3,0,1,0,76.14,81.82 ,33.33
03,001,03,024,0895,1924 ,123,0,123,184,0,3,1,3,0,1,0,76.14,66.85 ,33.33
03,001,03,024,0896,1925 ,49,0,49,65,0,3,1,3,0,1,0,76.14,75.38 ,33.33
03,001,03,025,0897,1926 ,1070,7,1077,1523,0,3,1,3,0,1,0,76.14,70.72 ,33.33
03,001,03,025,0898,1927 ,799,10,809,1352,0,3,1,3,0,1,0,76.14,59.84 ,33.33
03,001,03,025,0899,1928 ,603,5,608,949,0,3,1,3,0,1,0,76.14,64.07 ,33.33
03,001,03,025,0900,1929 ,855,13,868,1393,0,3,1,3,0,1,0,76.14,62.31 ,33.33
03,001,03,025,0900,1930 ,916,7,923,1395,0,3,1,3,0,1,0,76.14,66.16 ,33.33
03,001,03,025,0901,1932 ,603,9,612,932,0,3,1,3,0,1,0,76.14,65.67 ,33.33
03,001,03,025,0902,1933 ,318,4,322,483,0,3,1,3,0,1,0,76.14,66.67 ,33.33
03,001,03,025,0903,1934 ,840,16,856,1319,0,3,1,3,0,1,0,76.14,64.90 ,33.33
03,001,03,025,0903,1935 ,929,14,943,1409,0,3,1,3,0,1,0,76.14,66.93 ,33.33
03,001,03,025,0903,1936 ,925,5,930,1449,0,3,1,3,0,1,0,76.14,64.18 ,33.33
03,001,03,025,0904,1937 ,1324,14,1338,1990,0,3,1,3,0,1,0,76.14,67.24 ,33.33
03,001,03,025,0905,1938 ,546,4,550,821,0,3,1,3,0,1,0,76.14,66.99 ,33.33
03,001,03,025,0905,1939 ,593,9,602,955,0,3,1,3,0,1,0,76.14,63.04 ,33.33
03,001,03,025,0905,1940 ,635,8,643,953,0,3,1,3,0,1,0,76.14,67.47 ,33.33
03,001,03,025,0906,1941 ,883,9,892,1263,0,3,1,3,0,1,0,76.14,70.63 ,33.33
03,001,03,025,0906,1942 ,856,7,863,1298,0,3,1,3,0,1,0,76.14,66.49 ,33.33
03,001,03,025,0907,1943 ,1019,9,1028,1500,0,3,1,3,0,1,0,76.14,68.53 ,33.33
03,001,03,025,0907,1944 ,943,6,949,1385,0,3,1,3,0,1,0,76.14,68.52 ,33.33
03,001,03,025,0907,1945 ,885,6,891,1319,0,3,1,3,0,1,0,76.14,67.55 ,33.33
03,001,03,025,0908,1946 ,1050,13,1063,1594,0,3,1,3,0,1,0,76.14,66.69 ,33.33
03,001,03,025,0908,1947 ,968,19,987,1563,0,3,1,3,0,1,0,76.14,63.15 ,33.33
03,001,03,025,0909,1948 ,832,4,836,1314,0,3,1,3,0,1,0,76.14,63.62 ,33.33
03,001,03,025,0909,1949 ,857,8,865,1276,0,3,1,3,0,1,0,76.14,67.79 ,33.33
03,001,03,025,0910,1950 ,950,8,958,1516,0,3,1,3,0,1,0,76.14,63.19 ,33.33
03,001,03,025,0910,1951 ,961,16,977,1458,0,3,1,3,0,1,0,76.14,67.01 ,33.33
03,001,03,025,0911,1952 ,841,15,856,1385,0,3,1,3,0,1,0,76.14,61.81 ,33.33
03,001,03,025,0911,1953 ,857,20,877,1413,0,3,1,3,0,1,0,76.14,62.07 ,33.33
03,001,03,025,0912,1954 ,908,9,917,1426,0,3,1,3,0,1,0,76.14,64.31 ,33.33
03,001,03,025,0912,1955 ,820,19,839,1370,0,3,1,3,0,1,0,76.14,61.24 ,33.33
03,001,03,025,0913,1956 ,791,6,797,1193,0,3,1,3,0,1,0,76.14,66.81 ,33.33
03,001,03,025,0913,1957 ,623,6,629,923,0,3,1,3,0,1,0,76.14,68.15 ,33.33
03,001,03,025,0913,1958 ,926,7,933,1470,0,3,1,3,0,1,0,76.14,63.47 ,33.33
03,001,03,025,0913,1959 ,827,11,838,1238,0,3,1,3,0,1,0,76.14,67.69 ,33.33
03,001,03,025,0913,1960 ,933,8,941,1382,0,3,1,3,0,1,0,76.14,68.09 ,33.33
03,001,03,025,0913,1961 ,788,14,802,1233,0,3,1,3,0,1,0,76.14,65.04 ,33.33
03,001,03,025,0914,1962 ,958,9,967,1442,0,3,1,3,0,1,0,76.14,67.06 ,33.33
03,001,03,025,0915,1963 ,807,8,815,1233,0,3,1,3,0,1,0,76.14,66.10 ,33.33
03,001,03,025,0916,1964 ,308,6,314,461,0,3,1,3,0,1,0,76.14,68.11 ,33.33
03,001,03,025,0917,1965 ,779,12,791,1184,0,3,1,3,0,1,0,76.14,66.81 ,33.33
03,001,03,025,0917,1966 ,691,13,704,1107,0,3,1,3,0,1,0,76.14,63.60 ,33.33
03,001,03,025,0917,1967 ,739,7,746,1185,0,3,1,3,0,1,0,76.14,62.95 ,33.33
03,001,03,025,0918,1968 ,1161,19,1180,1678,0,3,1,3,0,1,0,76.14,70.32 ,33.33
03,001,03,025,0919,1969 ,882,10,892,1307,0,3,1,3,0,1,0,76.14,68.25 ,33.33
03,001,03,025,0919,1970 ,743,7,750,1189,0,3,1,3,0,1,0,76.14,63.08 ,33.33
03,001,03,025,0919,1971 ,912,3,915,1465,0,3,1,3,0,1,0,76.14,62.46 ,33.33
03,001,03,025,0920,1972 ,739,14,753,1264,0,3,1,3,0,1,0,76.14,59.57 ,33.33
03,001,03,025,0920,1973 ,670,5,675,1139,0,3,1,3,0,1,0,76.14,59.26 ,33.33
03,001,03,025,0920,1974 ,702,11,713,1142,0,3,1,3,0,1,0,76.14,62.43 ,33.33
03,001,03,025,0921,1975 ,725,5,730,1148,0,3,1,3,0,1,0,76.14,63.59 ,33.33
03,001,03,025,0922,1976 ,506,14,520,768,0,3,1,3,0,1,0,76.14,67.71 ,33.33
03,001,03,025,0923,1977 ,628,10,638,902,0,3,1,3,0,1,0,76.14,70.73 ,33.33
03,001,03,025,0924,1978 ,999,19,1018,1502,0,3,1,3,0,1,0,76.14,67.78 ,33.33
03,001,03,025,0924,1979 ,899,9,908,1433,0,3,1,3,0,1,0,76.14,63.36 ,33.33
03,001,03,025,0925,1980 ,1031,19,1050,1723,0,3,1,3,0,1,0,76.14,60.94 ,33.33
03,001,03,025,0925,1981 ,1042,27,1069,1668,0,3,1,3,0,1,0,76.14,64.09 ,33.33
03,001,03,025,0926,1982 ,1057,26,1083,1604,0,3,1,3,0,1,0,76.14,67.52 ,33.33
03,001,03,025,0927,1983 ,804,19,823,1258,0,3,1,3,0,1,0,76.14,65.42 ,33.33
03,001,03,025,0927,1984 ,1098,14,1112,1671,0,3,1,3,0,1,0,76.14,66.55 ,33.33
03,001,03,025,0927,1985 ,1061,10,1071,1766,0,3,1,3,0,1,0,76.14,60.65 ,33.33
03,001,03,025,0928,1986 ,767,9,776,1225,0,3,1,3,0,1,0,76.14,63.35 ,33.33
03,001,03,025,0928,1987 ,736,15,751,1232,0,3,1,3,0,1,0,76.14,60.96 ,33.33
03,001,03,025,0928,1988 ,723,5,728,1114,0,3,1,3,0,1,0,76.14,65.35 ,33.33
03,001,03,025,0929,1989 ,864,7,871,1400,0,3,1,3,0,1,0,76.14,62.21 ,33.33
03,001,03,025,0930,1990 ,947,16,963,1652,0,3,1,3,0,1,0,76.14,58.29 ,33.33
03,001,03,025,0930,1991 ,940,13,953,1582,0,3,1,3,0,1,0,76.14,60.24 ,33.33
03,001,03,025,0930,1992 ,912,11,923,1442,0,3,1,3,0,1,0,76.14,64.01 ,33.33
03,001,03,025,0931,1993 ,708,12,720,1091,0,3,1,3,0,1,0,76.14,65.99 ,33.33
03,001,03,025,0931,1994 ,651,13,664,1097,0,3,1,3,0,1,0,76.14,60.53 ,33.33
03,001,03,025,0932,1995 ,649,6,655,1021,0,3,1,3,0,1,0,76.14,64.15 ,33.33
03,001,03,025,0932,1996 ,622,4,626,1013,0,3,1,3,0,1,0,76.14,61.80 ,33.33
03,001,03,025,0933,1997 ,1087,17,1104,1757,0,3,1,3,0,1,0,76.14,62.83 ,33.33
03,001,03,025,0934,1998 ,1138,14,1152,1754,0,3,1,3,0,1,0,76.14,65.68 ,33.33
03,001,03,025,0934,1999 ,1037,5,1042,1722,0,3,1,3,0,1,0,76.14,60.51 ,33.33
03,001,03,025,0935,2000 ,1069,8,1077,1683,0,3,1,3,0,1,0,76.14,63.99 ,33.33
03,001,03,025,0935,2001 ,1142,12,1154,1710,0,3,1,3,0,1,0,76.14,67.49 ,33.33
03,001,03,025,0936,2002 ,605,4,609,945,0,3,1,3,0,1,0,76.14,64.44 ,33.33
03,001,03,025,0936,2003 ,737,13,750,1189,0,3,1,3,0,1,0,76.14,63.08 ,33.33
03,001,03,025,0936,2004 ,1197,13,1210,1795,0,3,1,3,0,1,0,76.14,67.41 ,33.33
03,001,03,025,0937,2005 ,850,6,856,1277,0,3,1,3,0,1,0,76.14,67.03 ,33.33
03,001,03,025,0937,2006 ,747,3,750,1096,0,3,1,3,0,1,0,76.14,68.43 ,33.33
03,001,03,025,0938,2007 ,619,7,626,939,0,3,1,3,0,1,0,76.14,66.67 ,33.33
03,001,03,025,0939,2008 ,985,16,1001,1429,0,3,1,3,0,1,0,76.14,70.05 ,33.33
03,001,03,025,0939,2009 ,867,8,875,1296,0,3,1,3,0,1,0,76.14,67.52 ,33.33
03,001,03,025,0939,2010 ,840,20,860,1280,0,3,1,3,0,1,0,76.14,67.19 ,33.33
03,001,03,025,0940,2011 ,916,11,927,1394,0,3,1,3,0,1,0,76.14,66.50 ,33.33
03,001,03,025,0940,2012 ,915,10,925,1408,0,3,1,3,0,1,0,76.14,65.70 ,33.33
03,001,03,025,0941,2013 ,841,17,858,1286,0,3,1,3,0,1,0,76.14,66.72 ,33.33
03,001,03,025,0941,2014 ,703,11,714,1042,0,3,1,3,0,1,0,76.14,68.52 ,33.33
03,001,03,025,0942,2015 ,672,11,683,1005,0,3,1,3,0,1,0,76.14,67.96 ,33.33
03,001,03,025,0942,2016 ,899,4,903,1286,0,3,1,3,0,1,0,76.14,70.22 ,33.33
03,001,03,026,0943,2017 ,554,7,561,775,0,3,1,3,0,1,0,76.14,72.39 ,33.33
03,001,03,026,0944,2018 ,648,8,656,914,0,3,1,3,0,1,0,76.14,71.77 ,33.33
03,001,03,026,0944,2019 ,581,7,588,780,0,3,1,3,0,1,0,76.14,75.38 ,33.33
03,001,03,026,0945,2020 ,921,11,932,1298,0,3,1,3,0,1,0,76.14,71.80 ,33.33
03,001,03,026,0946,2021 ,410,9,419,585,0,3,1,3,0,1,0,76.14,71.62 ,33.33
03,001,03,026,0947,2022 ,542,10,552,805,0,3,1,3,0,1,0,76.14,68.57 ,33.33
03,001,03,026,0947,2023 ,463,5,468,726,0,3,1,3,0,1,0,76.14,64.46 ,33.33
03,001,03,026,0948,2024 ,851,15,866,1296,0,3,1,3,0,1,0,76.14,66.82 ,33.33
03,001,03,026,0949,2025 ,1047,15,1062,1548,0,3,1,3,0,1,0,76.14,68.60 ,33.33
03,001,03,026,0949,2026 ,739,9,748,1125,0,3,1,3,0,1,0,76.14,66.49 ,33.33
03,001,03,026,0949,2027 ,728,2,730,1039,0,3,1,3,0,1,0,76.14,70.26 ,33.33
03,001,03,026,0950,2028 ,739,5,744,1036,0,3,1,3,0,1,0,76.14,71.81 ,33.33
03,001,03,026,0950,2029 ,813,12,825,1291,0,3,1,3,0,1,0,76.14,63.90 ,33.33
03,001,03,026,0951,2030 ,789,8,797,1164,0,3,1,3,0,1,0,76.14,68.47 ,33.33
03,001,03,026,0951,2031 ,516,6,522,765,0,3,1,3,0,1,0,76.14,68.24 ,33.33
03,001,03,026,0952,2032 ,755,28,783,1126,0,3,1,3,0,1,0,76.14,69.54 ,33.33
03,001,03,026,0953,2033 ,186,2,188,285,0,3,1,3,0,1,0,76.14,65.96 ,33.33
03,001,03,026,0954,2034 ,365,4,369,508,0,3,1,3,0,1,0,76.14,72.64 ,33.33
03,001,03,026,0955,2035 ,243,4,247,362,0,3,1,3,0,1,0,76.14,68.23 ,33.33
03,001,03,026,0956,2036 ,108,0,108,155,0,3,1,3,0,1,0,76.14,69.68 ,33.33
03,001,03,026,0957,2037 ,584,11,595,836,0,3,1,3,0,1,0,76.14,71.17 ,33.33
03,001,03,026,0957,2038 ,512,4,516,773,0,3,1,3,0,1,0,76.14,66.75 ,33.33
03,001,03,026,0958,2039 ,593,20,613,953,0,3,1,3,0,1,0,76.14,64.32 ,33.33
03,001,03,026,0958,2040 ,489,11,500,815,0,3,1,3,0,1,0,76.14,61.35 ,33.33
03,001,03,026,0958,2041 ,644,20,664,1047,0,3,1,3,0,1,0,76.14,63.42 ,33.33
03,001,03,026,0959,2042 ,458,7,465,654,0,3,1,3,0,1,0,76.14,71.10 ,33.33
03,001,03,026,0959,2043 ,379,7,386,610,0,3,1,3,0,1,0,76.14,63.28 ,33.33
03,001,03,026,0960,2044 ,615,10,625,975,0,3,1,3,0,1,0,76.14,64.10 ,33.33
03,001,03,026,0960,2045 ,576,9,585,835,0,3,1,3,0,1,0,76.14,70.06 ,33.33
03,001,03,026,0961,2046 ,365,7,372,586,0,3,1,3,0,1,0,76.14,63.48 ,33.33
03,001,03,026,0962,2047 ,351,4,355,594,0,3,1,3,0,1,0,76.14,59.76 ,33.33
03,001,03,026,0963,2048 ,238,2,240,417,0,3,1,3,0,1,0,76.14,57.55 ,33.33
03,001,03,026,0964,2049 ,166,2,168,265,0,3,1,3,0,1,0,76.14,63.40 ,33.33
03,001,03,026,0965,2050 ,246,2,248,409,0,3,1,3,0,1,0,76.14,60.64 ,33.33
03,001,03,026,0966,2051 ,185,7,192,284,0,3,1,3,0,1,0,76.14,67.61 ,33.33
03,001,03,026,0967,2052 ,189,2,191,272,0,3,1,3,0,1,0,76.14,70.22 ,33.33
03,001,03,026,0968,2053 ,298,5,303,426,0,3,1,3,0,1,0,76.14,71.13 ,33.33
03,001,03,026,0969,2054 ,276,4,280,431,0,3,1,3,0,1,0,76.14,64.97 ,33.33
03,001,03,026,0970,2055 ,423,9,432,607,0,3,1,3,0,1,0,76.14,71.17 ,33.33
03,001,03,026,0971,2056 ,197,1,198,319,0,3,1,3,0,1,0,76.14,62.07 ,33.33
03,001,03,026,0972,2057 ,126,1,127,200,0,3,1,3,0,1,0,76.14,63.50 ,33.33
03,001,03,026,0973,2058 ,322,7,329,509,0,3,1,3,0,1,0,76.14,64.64 ,33.33
03,001,03,026,0974,2059 ,572,12,584,866,0,3,1,3,0,1,0,76.14,67.44 ,33.33
03,001,03,026,0975,2060 ,495,9,504,751,0,3,1,3,0,1,0,76.14,67.11 ,33.33
03,001,03,026,0975,2061 ,546,8,554,789,0,3,1,3,0,1,0,76.14,70.22 ,33.33
03,001,03,026,0976,2062 ,622,10,632,967,0,3,1,3,0,1,0,76.14,65.36 ,33.33
03,001,03,027,0977,2063 ,293,4,297,438,0,3,1,3,0,1,0,76.14,67.81 ,33.33
03,001,03,027,0978,2064 ,222,4,226,320,0,3,1,3,0,1,0,76.14,70.63 ,33.33
03,001,03,027,0979,2065 ,219,6,225,311,0,3,1,3,0,1,0,76.14,72.35 ,33.33
03,001,03,027,0980,2066 ,373,4,377,562,0,3,1,3,0,1,0,76.14,67.08 ,33.33
03,001,03,027,0981,2067 ,175,3,178,282,0,3,1,3,0,1,0,76.14,63.12 ,33.33
03,001,03,027,0982,2068 ,469,11,480,703,0,3,1,3,0,1,0,76.14,68.28 ,33.33
03,001,03,027,0983,2069 ,244,3,247,390,0,3,1,3,0,1,0,76.14,63.33 ,33.33
03,001,03,027,0984,2070 ,655,11,666,1027,0,3,1,3,0,1,0,76.14,64.85 ,33.33
03,001,03,027,0985,2071 ,73,3,76,149,0,3,1,3,0,1,0,76.14,51.01 ,33.33
03,001,03,027,0986,2072 ,310,4,314,506,0,3,1,3,0,1,0,76.14,62.06 ,33.33
03,001,03,027,0987,2073 ,118,3,121,185,0,3,1,3,0,1,0,76.14,65.41 ,33.33
03,001,03,027,0988,2074 ,99,3,102,164,0,3,1,3,0,1,0,76.14,62.20 ,33.33
03,001,03,028,0989,2075 ,373,4,377,574,0,3,1,3,0,1,0,76.14,65.68 ,33.33
03,001,03,028,0990,2076 ,193,1,194,298,0,3,1,3,0,1,0,76.14,65.10 ,33.33
03,001,03,028,0990,2077 ,448,4,452,633,0,3,1,3,0,1,0,76.14,71.41 ,33.33
03,001,03,028,0991,2078 ,293,2,295,454,0,3,1,3,0,1,0,76.14,64.98 ,33.33
03,001,03,028,0992,2079 ,720,13,733,1091,0,3,1,3,0,1,0,76.14,67.19 ,33.33
03,001,03,028,0992,2080 ,547,8,555,767,0,3,1,3,0,1,0,76.14,72.36 ,33.33
03,001,03,028,0993,2081 ,251,2,253,357,0,3,1,3,0,1,0,76.14,70.87 ,33.33
03,001,03,028,0994,2082 ,420,6,426,647,0,3,1,3,0,1,0,76.14,65.84 ,33.33
03,001,03,028,0994,2083 ,161,1,162,277,0,3,1,3,0,1,0,76.14,58.48 ,33.33
03,001,03,028,0995,2084 ,464,7,471,721,0,3,1,3,0,1,0,76.14,65.33 ,33.33
03,001,03,028,0996,2085 ,332,0,332,511,0,3,1,3,0,1,0,76.14,64.97 ,33.33
03,001,03,028,0997,2086 ,270,2,272,407,0,3,1,3,0,1,0,76.14,66.83 ,33.33
03,001,03,028,0998,2087 ,107,1,108,147,0,3,1,3,0,1,0,76.14,73.47 ,33.33
03,001,03,028,0998,2088 ,216,2,218,323,0,3,1,3,0,1,0,76.14,67.49 ,33.33
03,001,03,028,0999,2089 ,242,3,245,339,0,3,1,3,0,1,0,76.14,72.27 ,33.33
03,001,03,028,0999,2090 ,246,0,246,363,0,3,1,3,0,1,0,76.14,67.77 ,33.33
03,001,03,028,1000,2091 ,184,0,184,339,0,3,1,3,0,1,0,76.14,54.28 ,33.33
03,001,03,028,1000,2092 ,76,0,76,136,0,3,1,3,0,1,0,76.14,55.88 ,33.33
03,001,03,029,1001,2093 ,575,9,584,919,0,3,1,3,0,1,0,76.14,63.55 ,33.33
03,001,03,029,1002,2094 ,263,1,264,428,0,3,1,3,0,1,0,76.14,61.68 ,33.33
03,001,03,029,1003,2095 ,312,7,319,477,0,3,1,3,0,1,0,76.14,66.88 ,33.33
03,001,03,029,1004,2096 ,273,3,276,442,0,3,1,3,0,1,0,76.14,62.44 ,33.33
03,001,03,029,1004,2097 ,213,5,218,350,0,3,1,3,0,1,0,76.14,62.29 ,33.33
03,001,03,029,1005,2098 ,611,15,626,962,0,3,1,3,0,1,0,76.14,65.07 ,33.33
03,001,03,029,1005,2099 ,380,5,385,600,0,3,1,3,0,1,0,76.14,64.17 ,33.33
03,001,03,029,1006,2100 ,443,9,452,788,0,3,1,3,0,1,0,76.14,57.36 ,33.33
03,001,03,029,1007,2101 ,415,1,416,644,0,3,1,3,0,1,0,76.14,64.60 ,33.33
03,001,03,029,1008,2102 ,1016,13,1029,1549,0,3,1,3,0,1,0,76.14,66.43 ,33.33
03,001,03,029,1009,2103 ,678,5,683,1084,0,3,1,3,0,1,0,76.14,63.01 ,33.33
03,001,03,029,1009,2104 ,444,6,450,762,0,3,1,3,0,1,0,76.14,59.06 ,33.33
03,001,03,029,1010,2105 ,231,2,233,375,0,3,1,3,0,1,0,76.14,62.13 ,33.33
03,001,03,029,1010,2106 ,258,4,262,408,0,3,1,3,0,1,0,76.14,64.22 ,33.33
03,001,03,029,1011,2107 ,294,8,302,449,0,3,1,3,0,1,0,76.14,67.26 ,33.33
03,001,03,029,1011,2108 ,283,5,288,445,0,3,1,3,0,1,0,76.14,64.72 ,33.33
03,002,01,001,0001,1 ,378,3,381,632,0,3,1,3,0,1,0,76.14,60.28 ,33.33
03,002,01,001,0002,2 ,503,7,510,728,0,3,1,3,0,1,0,76.14,70.05 ,33.33
03,002,01,001,0002,3 ,899,12,911,1379,0,3,1,3,0,1,0,76.14,66.06 ,33.33
03,002,01,001,0003,4 ,727,11,738,1136,0,3,1,3,0,1,0,76.14,64.96 ,33.33
03,002,01,001,0003,5 ,717,12,729,1102,0,3,1,3,0,1,0,76.14,66.15 ,33.33
03,002,01,001,0004,6 ,725,7,732,1172,0,3,1,3,0,1,0,76.14,62.46 ,33.33
03,002,01,001,0004,7 ,702,11,713,1181,0,3,1,3,0,1,0,76.14,60.37 ,33.33
03,002,01,001,0005,8 ,653,16,669,996,0,3,1,3,0,1,0,76.14,67.17 ,33.33
03,002,01,001,0005,9 ,506,5,511,755,0,3,1,3,0,1,0,76.14,67.68 ,33.33
03,002,01,001,0005,10 ,643,5,648,1027,0,3,1,3,0,1,0,76.14,63.10 ,33.33
03,002,01,001,0006,11 ,947,9,956,1537,0,3,1,3,0,1,0,76.14,62.20 ,33.33
03,002,01,001,0006,12 ,945,3,948,1487,0,3,1,3,0,1,0,76.14,63.75 ,33.33
03,002,01,001,0006,13 ,689,9,698,1044,0,3,1,3,0,1,0,76.14,66.86 ,33.33
03,002,01,001,0007,14 ,746,11,757,1136,0,3,1,3,0,1,0,76.14,66.64 ,33.33
03,002,01,001,0007,15 ,924,3,927,1470,0,3,1,3,0,1,0,76.14,63.06 ,33.33
03,002,01,001,0008,16 ,439,4,443,675,0,3,1,3,0,1,0,76.14,65.63 ,33.33
03,002,01,001,0009,17 ,290,4,294,457,0,3,1,3,0,1,0,76.14,64.33 ,33.33
03,002,01,001,0010,18 ,476,3,479,693,0,3,1,3,0,1,0,76.14,69.12 ,33.33
03,002,01,001,0011,19 ,355,6,361,577,0,3,1,3,0,1,0,76.14,62.56 ,33.33
03,002,01,001,0012,20 ,375,2,377,598,0,3,1,3,0,1,0,76.14,63.04 ,33.33
03,002,01,001,0013,21 ,486,8,494,762,0,3,1,3,0,1,0,76.14,64.83 ,33.33
03,002,01,001,0013,22 ,814,8,822,1278,0,3,1,3,0,1,0,76.14,64.32 ,33.33
03,002,01,001,0014,23 ,390,5,395,608,0,3,1,3,0,1,0,76.14,64.97 ,33.33
03,002,01,001,0014,24 ,530,14,544,878,0,3,1,3,0,1,0,76.14,61.96 ,33.33
03,002,01,001,0015,25 ,790,2,792,1197,0,3,1,3,0,1,0,76.14,66.17 ,33.33
03,002,01,001,0015,26 ,835,6,841,1345,0,3,1,3,0,1,0,76.14,62.53 ,33.33
03,002,01,001,0015,27 ,410,7,417,632,0,3,1,3,0,1,0,76.14,65.98 ,33.33
03,002,01,001,0015,28 ,847,4,851,1268,0,3,1,3,0,1,0,76.14,67.11 ,33.33
03,002,01,001,0016,29 ,438,2,440,630,0,3,1,3,0,1,0,76.14,69.84 ,33.33
03,002,01,001,0017,30 ,579,8,587,992,0,3,1,3,0,1,0,76.14,59.17 ,33.33
03,002,01,001,0018,31 ,473,3,476,771,0,3,1,3,0,1,0,76.14,61.74 ,33.33
03,002,01,001,0019,32 ,674,4,678,1108,0,3,1,3,0,1,0,76.14,61.19 ,33.33
03,002,01,001,0020,33 ,794,5,799,1243,0,3,1,3,0,1,0,76.14,64.28 ,33.33
03,002,01,001,0021,34 ,595,2,597,956,0,3,1,3,0,1,0,76.14,62.45 ,33.33
03,002,01,001,0021,35 ,748,3,751,1159,0,3,1,3,0,1,0,76.14,64.80 ,33.33
03,002,01,001,0021,36 ,842,13,855,1320,0,3,1,3,0,1,0,76.14,64.77 ,33.33
03,002,01,001,0022,37 ,630,9,639,969,0,3,1,3,0,1,0,76.14,65.94 ,33.33
03,002,01,001,0022,38 ,843,21,864,1389,0,3,1,3,0,1,0,76.14,62.20 ,33.33
03,002,01,001,0022,39 ,696,13,709,1112,0,3,1,3,0,1,0,76.14,63.76 ,33.33
03,002,01,001,0023,40 ,734,5,739,1157,0,3,1,3,0,1,0,76.14,63.87 ,33.33
03,002,01,001,0024,41 ,753,9,762,1210,0,3,1,3,0,1,0,76.14,62.98 ,33.33
03,002,01,001,0024,42 ,808,14,822,1300,0,3,1,3,0,1,0,76.14,63.23 ,33.33
03,002,01,001,0024,43 ,847,11,858,1395,0,3,1,3,0,1,0,76.14,61.51 ,33.33
03,002,01,001,0025,44 ,415,8,423,641,0,3,1,3,0,1,0,76.14,65.99 ,33.33
03,002,01,001,0026,45 ,363,1,364,558,0,3,1,3,0,1,0,76.14,65.23 ,33.33
03,002,01,001,0027,46 ,392,7,399,631,0,3,1,3,0,1,0,76.14,63.23 ,33.33
03,002,01,001,0028,47 ,815,1,816,1273,0,3,1,3,0,1,0,76.14,64.10 ,33.33
03,002,01,001,0029,48 ,847,6,853,1316,0,3,1,3,0,1,0,76.14,64.82 ,33.33
03,002,01,001,0030,49 ,656,5,661,1054,0,3,1,3,0,1,0,76.14,62.71 ,33.33
03,002,01,001,0031,50 ,813,2,815,1305,0,3,1,3,0,1,0,76.14,62.45 ,33.33
03,002,01,001,0031,51 ,534,9,543,819,0,3,1,3,0,1,0,76.14,66.30 ,33.33
03,002,01,001,0032,52 ,1058,4,1062,1732,0,3,1,3,0,1,0,76.14,61.32 ,33.33
03,002,01,001,0033,53 ,909,4,913,1436,0,3,1,3,0,1,0,76.14,63.58 ,33.33
03,002,01,001,0034,54 ,900,8,908,1365,0,3,1,3,0,1,0,76.14,66.52 ,33.33
03,002,01,001,0034,55 ,668,9,677,1122,0,3,1,3,0,1,0,76.14,60.34 ,33.33
03,002,01,001,0035,56 ,572,4,576,898,0,3,1,3,0,1,0,76.14,64.14 ,33.33
03,002,01,001,0036,57 ,483,11,494,744,0,3,1,3,0,1,0,76.14,66.40 ,33.33
03,002,01,001,0037,58 ,488,4,492,802,0,3,1,3,0,1,0,76.14,61.35 ,33.33
03,002,01,001,0038,59 ,827,16,843,1284,0,3,1,3,0,1,0,76.14,65.65 ,33.33
03,002,01,001,0039,60 ,508,9,517,803,0,3,1,3,0,1,0,76.14,64.38 ,33.33
03,002,01,001,0040,61 ,819,8,827,1301,0,3,1,3,0,1,0,76.14,63.57 ,33.33
03,002,01,002,0041,62 ,316,4,320,515,0,3,1,3,0,1,0,76.14,62.14 ,33.33
03,002,01,002,0042,63 ,351,5,356,521,0,3,1,3,0,1,0,76.14,68.33 ,33.33
03,002,01,002,0043,64 ,307,3,310,498,0,3,1,3,0,1,0,76.14,62.25 ,33.33
03,002,01,002,0044,65 ,782,3,785,1227,0,3,1,3,0,1,0,76.14,63.98 ,33.33
03,002,01,002,0045,66 ,525,6,531,793,0,3,1,3,0,1,0,76.14,66.96 ,33.33
03,002,01,002,0045,67 ,765,9,774,1322,0,3,1,3,0,1,0,76.14,58.55 ,33.33
03,002,01,002,0046,68 ,700,6,706,1033,0,3,1,3,0,1,0,76.14,68.34 ,33.33
03,002,01,002,0046,69 ,548,6,554,915,0,3,1,3,0,1,0,76.14,60.55 ,33.33
03,002,01,002,0047,70 ,592,10,602,972,0,3,1,3,0,1,0,76.14,61.93 ,33.33
03,002,01,002,0047,71 ,566,8,574,941,0,3,1,3,0,1,0,76.14,61.00 ,33.33
03,002,01,002,0048,72 ,788,12,800,1283,0,3,1,3,0,1,0,76.14,62.35 ,33.33
03,002,01,002,0048,73 ,555,7,562,892,0,3,1,3,0,1,0,76.14,63.00 ,33.33
03,002,01,002,0049,74 ,902,7,909,1339,0,3,1,3,0,1,0,76.14,67.89 ,33.33
03,002,01,002,0050,75 ,778,12,790,1177,0,3,1,3,0,1,0,76.14,67.12 ,33.33
03,002,01,002,0051,76 ,547,3,550,876,0,3,1,3,0,1,0,76.14,62.79 ,33.33
03,002,01,002,0052,77 ,439,4,443,715,0,3,1,3,0,1,0,76.14,61.96 ,33.33
03,002,01,002,0053,78 ,545,5,550,878,0,3,1,3,0,1,0,76.14,62.64 ,33.33
03,002,01,002,0054,79 ,411,4,415,613,0,3,1,3,0,1,0,76.14,67.70 ,33.33
03,002,01,002,0055,80 ,454,2,456,723,0,3,1,3,0,1,0,76.14,63.07 ,33.33
03,002,01,002,0056,81 ,720,5,725,1085,0,3,1,3,0,1,0,76.14,66.82 ,33.33
03,002,01,002,0056,82 ,877,5,882,1417,0,3,1,3,0,1,0,76.14,62.24 ,33.33
03,002,01,002,0056,83 ,680,5,685,1038,0,3,1,3,0,1,0,76.14,65.99 ,33.33
03,002,01,002,0057,84 ,596,5,601,974,0,3,1,3,0,1,0,76.14,61.70 ,33.33
03,002,01,002,0057,85 ,889,5,894,1359,0,3,1,3,0,1,0,76.14,65.78 ,33.33
03,002,01,002,0057,86 ,628,10,638,1021,0,3,1,3,0,1,0,76.14,62.49 ,33.33
03,002,01,002,0057,87 ,801,13,814,1292,0,3,1,3,0,1,0,76.14,63.00 ,33.33
03,002,01,002,0058,88 ,810,7,817,1267,0,3,1,3,0,1,0,76.14,64.48 ,33.33
03,002,01,002,0058,89 ,730,8,738,1174,0,3,1,3,0,1,0,76.14,62.86 ,33.33
03,002,01,002,0058,90 ,872,8,880,1355,0,3,1,3,0,1,0,76.14,64.94 ,33.33
03,002,01,002,0058,91 ,797,9,806,1265,0,3,1,3,0,1,0,76.14,63.72 ,33.33
03,002,01,002,0059,92 ,826,5,831,1353,0,3,1,3,0,1,0,76.14,61.42 ,33.33
03,002,01,002,0059,93 ,623,8,631,1022,0,3,1,3,0,1,0,76.14,61.74 ,33.33
03,002,01,002,0059,94 ,632,3,635,974,0,3,1,3,0,1,0,76.14,65.20 ,33.33
03,002,01,002,0060,95 ,606,6,612,970,0,3,1,3,0,1,0,76.14,63.09 ,33.33
03,002,01,002,0060,96 ,521,7,528,833,0,3,1,3,0,1,0,76.14,63.39 ,33.33
03,002,01,002,0061,97 ,607,6,613,1001,0,3,1,3,0,1,0,76.14,61.24 ,33.33
03,002,01,002,0062,98 ,863,6,869,1438,0,3,1,3,0,1,0,76.14,60.43 ,33.33
03,002,01,002,0062,99 ,880,5,885,1427,0,3,1,3,0,1,0,76.14,62.02 ,33.33
03,002,01,002,0063,100 ,688,4,692,1069,0,3,1,3,0,1,0,76.14,64.73 ,33.33
03,002,01,002,0063,101 ,692,7,699,1102,0,3,1,3,0,1,0,76.14,63.43 ,33.33
03,002,01,002,0063,102 ,692,6,698,1119,0,3,1,3,0,1,0,76.14,62.38 ,33.33
03,002,01,002,0064,103 ,853,9,862,1356,0,3,1,3,0,1,0,76.14,63.57 ,33.33
03,002,01,002,0064,104 ,726,10,736,1183,0,3,1,3,0,1,0,76.14,62.21 ,33.33
03,002,01,002,0065,105 ,762,9,771,1268,0,3,1,3,0,1,0,76.14,60.80 ,33.33
03,002,01,002,0065,106 ,741,7,748,1099,0,3,1,3,0,1,0,76.14,68.06 ,33.33
03,002,01,003,0066,107 ,432,4,436,670,0,3,1,3,0,1,0,76.14,65.07 ,33.33
03,002,01,003,0066,108 ,708,6,714,1190,0,3,1,3,0,1,0,76.14,60.00 ,33.33
03,002,01,003,0066,109 ,707,3,710,1105,0,3,1,3,0,1,0,76.14,64.25 ,33.33
03,002,01,003,0067,110 ,512,2,514,757,0,3,1,3,0,1,0,76.14,67.90 ,33.33
03,002,01,003,0068,111 ,619,7,626,1017,0,3,1,3,0,1,0,76.14,61.55 ,33.33
03,002,01,003,0068,112 ,652,7,659,1003,0,3,1,3,0,1,0,76.14,65.70 ,33.33
03,002,01,003,0068,113 ,604,6,610,905,0,3,1,3,0,1,0,76.14,67.40 ,33.33
03,002,01,003,0069,114 ,421,1,422,627,0,3,1,3,0,1,0,76.14,67.30 ,33.33
03,002,01,003,0069,115 ,273,1,274,383,0,3,1,3,0,1,0,76.14,71.54 ,33.33
03,002,01,003,0070,116 ,506,3,509,791,0,3,1,3,0,1,0,76.14,64.35 ,33.33
03,002,01,003,0070,117 ,277,2,279,446,0,3,1,3,0,1,0,76.14,62.56 ,33.33
03,002,01,003,0071,118 ,173,5,178,305,0,3,1,3,0,1,0,76.14,58.36 ,33.33
03,002,01,003,0072,119 ,663,5,668,1024,0,3,1,3,0,1,0,76.14,65.23 ,33.33
03,002,01,003,0072,120 ,626,5,631,1046,0,3,1,3,0,1,0,76.14,60.33 ,33.33
03,002,01,003,0073,121 ,689,6,695,1102,0,3,1,3,0,1,0,76.14,63.07 ,33.33
03,002,01,003,0074,122 ,804,12,816,1346,0,3,1,3,0,1,0,76.14,60.62 ,33.33
03,002,01,003,0074,123 ,777,11,788,1268,0,3,1,3,0,1,0,76.14,62.15 ,33.33
03,002,01,003,0074,124 ,572,5,577,968,0,3,1,3,0,1,0,76.14,59.61 ,33.33
03,002,01,003,0074,125 ,741,5,746,1281,0,3,1,3,0,1,0,76.14,58.24 ,33.33
03,002,01,003,0075,126 ,707,3,710,1134,0,3,1,3,0,1,0,76.14,62.61 ,33.33
03,002,01,003,0075,127 ,710,7,717,1096,0,3,1,3,0,1,0,76.14,65.42 ,33.33
03,002,01,003,0076,128 ,776,12,788,1229,0,3,1,3,0,1,0,76.14,64.12 ,33.33
03,002,01,003,0077,129 ,376,4,380,552,0,3,1,3,0,1,0,76.14,68.84 ,33.33
03,002,01,003,0078,130 ,297,2,299,511,0,3,1,3,0,1,0,76.14,58.51 ,33.33
03,002,01,003,0079,131 ,395,2,397,603,0,3,1,3,0,1,0,76.14,65.84 ,33.33
03,002,01,003,0080,132 ,373,3,376,570,0,3,1,3,0,1,0,76.14,65.96 ,33.33
03,002,01,003,0081,133 ,377,4,381,632,0,3,1,3,0,1,0,76.14,60.28 ,33.33
03,002,01,003,0082,134 ,372,3,375,536,0,3,1,3,0,1,0,76.14,69.96 ,33.33
03,002,01,003,0083,135 ,715,10,725,1112,0,3,1,3,0,1,0,76.14,65.20 ,33.33
03,002,01,003,0084,136 ,626,6,632,1035,0,3,1,3,0,1,0,76.14,61.06 ,33.33
03,002,01,003,0085,137 ,745,5,750,1250,0,3,1,3,0,1,0,76.14,60.00 ,33.33
03,002,01,003,0086,138 ,483,2,485,860,0,3,1,3,0,1,0,76.14,56.40 ,33.33
03,002,01,003,0086,139 ,432,8,440,814,0,3,1,3,0,1,0,76.14,54.05 ,33.33
03,002,01,003,0087,140 ,674,10,684,1160,0,3,1,3,0,1,0,76.14,58.97 ,33.33
03,002,01,003,0088,141 ,770,8,778,1335,0,3,1,3,0,1,0,76.14,58.28 ,33.33
03,002,01,003,0089,142 ,187,2,189,333,0,3,1,3,0,1,0,76.14,56.76 ,33.33
03,002,01,003,0090,143 ,448,9,457,816,0,3,1,3,0,1,0,76.14,56.00 ,33.33
03,002,01,003,0091,144 ,262,6,268,481,0,3,1,3,0,1,0,76.14,55.72 ,33.33
03,002,01,003,0091,145 ,165,1,166,267,0,3,1,3,0,1,0,76.14,62.17 ,33.33
03,002,01,004,0092,146 ,212,2,214,382,0,3,1,3,0,1,0,76.14,56.02 ,33.33
03,002,01,004,0093,147 ,384,7,391,709,0,3,1,3,0,1,0,76.14,55.15 ,33.33
03,002,01,004,0094,148 ,343,9,352,622,0,3,1,3,0,1,0,76.14,56.59 ,33.33
03,002,01,004,0095,149 ,520,4,524,930,0,3,1,3,0,1,0,76.14,56.34 ,33.33
03,002,01,004,0096,150 ,230,3,233,401,0,3,1,3,0,1,0,76.14,58.10 ,33.33
03,002,01,004,0097,151 ,939,9,948,1374,0,3,1,3,0,1,0,76.14,69.00 ,33.33
03,002,01,004,0098,152 ,531,12,543,874,0,3,1,3,0,1,0,76.14,62.13 ,33.33
03,002,01,004,0099,153 ,427,3,430,628,0,3,1,3,0,1,0,76.14,68.47 ,33.33
03,002,01,004,0100,154 ,931,11,942,1411,0,3,1,3,0,1,0,76.14,66.76 ,33.33
03,002,01,004,0101,155 ,753,12,765,1148,0,3,1,3,0,1,0,76.14,66.64 ,33.33
03,002,01,004,0102,156 ,522,7,529,759,0,3,1,3,0,1,0,76.14,69.70 ,33.33
03,002,01,004,0103,157 ,375,5,380,558,0,3,1,3,0,1,0,76.14,68.10 ,33.33
03,002,01,004,0104,158 ,462,4,466,652,0,3,1,3,0,1,0,76.14,71.47 ,33.33
03,002,01,004,0105,159 ,403,1,404,607,0,3,1,3,0,1,0,76.14,66.56 ,33.33
03,002,01,004,0106,160 ,565,5,570,950,0,3,1,3,0,1,0,76.14,60.00 ,33.33
03,002,01,004,0106,161 ,595,7,602,969,0,3,1,3,0,1,0,76.14,62.13 ,33.33
03,002,01,004,0107,162 ,494,16,510,796,0,3,1,3,0,1,0,76.14,64.07 ,33.33
03,002,01,004,0107,163 ,630,0,630,983,0,3,1,3,0,1,0,76.14,64.09 ,33.33
03,002,01,004,0108,164 ,859,7,866,1362,0,3,1,3,0,1,0,76.14,63.58 ,33.33
03,002,01,004,0109,165 ,633,9,642,962,0,3,1,3,0,1,0,76.14,66.74 ,33.33
03,002,01,004,0110,166 ,1002,9,1011,1625,0,3,1,3,0,1,0,76.14,62.22 ,33.33
03,002,01,004,0111,167 ,405,5,410,685,0,3,1,3,0,1,0,76.14,59.85 ,33.33
03,002,01,004,0112,168 ,861,10,871,1270,0,3,1,3,0,1,0,76.14,68.58 ,33.33
03,002,01,004,0113,169 ,642,4,646,940,0,3,1,3,0,1,0,76.14,68.72 ,33.33
03,002,01,004,0114,170 ,639,5,644,962,0,3,1,3,0,1,0,76.14,66.94 ,33.33
03,002,01,004,0115,171 ,661,11,672,1053,0,3,1,3,0,1,0,76.14,63.82 ,33.33
03,002,01,005,0116,172 ,849,12,861,1410,0,3,1,3,0,1,0,76.14,61.06 ,33.33
03,002,01,005,0117,173 ,1049,10,1059,1664,0,3,1,3,0,1,0,76.14,63.64 ,33.33
03,002,01,005,0118,174 ,1051,7,1058,1674,0,3,1,3,0,1,0,76.14,63.20 ,33.33
03,002,01,005,0118,175 ,1070,9,1079,1740,0,3,1,3,0,1,0,76.14,62.01 ,33.33
03,002,01,005,0119,176 ,838,5,843,1326,0,3,1,3,0,1,0,76.14,63.57 ,33.33
03,002,01,005,0119,177 ,553,1,554,792,0,3,1,3,0,1,0,76.14,69.95 ,33.33
03,002,01,005,0120,178 ,464,6,470,674,0,3,1,3,0,1,0,76.14,69.73 ,33.33
03,002,01,005,0121,179 ,930,4,934,1383,0,3,1,3,0,1,0,76.14,67.53 ,33.33
03,002,01,005,0122,180 ,710,8,718,1094,0,3,1,3,0,1,0,76.14,65.63 ,33.33
03,002,01,005,0123,181 ,865,10,875,1337,0,3,1,3,0,1,0,76.14,65.45 ,33.33
03,002,01,005,0124,182 ,519,5,524,848,0,3,1,3,0,1,0,76.14,61.79 ,33.33
03,002,01,005,0124,183 ,665,11,676,1032,0,3,1,3,0,1,0,76.14,65.50 ,33.33
03,002,01,005,0125,184 ,900,7,907,1393,0,3,1,3,0,1,0,76.14,65.11 ,33.33
03,002,01,005,0125,185 ,536,8,544,882,0,3,1,3,0,1,0,76.14,61.68 ,33.33
03,002,01,005,0126,186 ,695,8,703,1050,0,3,1,3,0,1,0,76.14,66.95 ,33.33
03,002,01,005,0127,187 ,477,3,480,730,0,3,1,3,0,1,0,76.14,65.75 ,33.33
03,002,01,005,0128,188 ,606,10,616,921,0,3,1,3,0,1,0,76.14,66.88 ,33.33
03,002,01,005,0129,189 ,718,8,726,1103,0,3,1,3,0,1,0,76.14,65.82 ,33.33
03,002,01,005,0130,190 ,697,3,700,1021,0,3,1,3,0,1,0,76.14,68.56 ,33.33
03,002,01,005,0130,191 ,767,6,773,1147,0,3,1,3,0,1,0,76.14,67.39 ,33.33
03,002,01,005,0131,192 ,864,10,874,1409,0,3,1,3,0,1,0,76.14,62.03 ,33.33
03,002,01,005,0131,193 ,819,13,832,1322,0,3,1,3,0,1,0,76.14,62.93 ,33.33
03,002,01,005,0132,194 ,595,7,602,920,0,3,1,3,0,1,0,76.14,65.43 ,33.33
03,002,01,005,0133,195 ,249,3,252,406,0,3,1,3,0,1,0,76.14,62.07 ,33.33
03,002,01,006,0134,196 ,633,5,638,951,0,3,1,3,0,1,0,76.14,67.09 ,33.33
03,002,01,006,0134,197 ,564,6,570,875,0,3,1,3,0,1,0,76.14,65.14 ,33.33
03,002,01,006,0135,198 ,561,5,566,934,0,3,1,3,0,1,0,76.14,60.60 ,33.33
03,002,01,006,0136,199 ,507,4,511,835,0,3,1,3,0,1,0,76.14,61.20 ,33.33
03,002,01,006,0136,200 ,488,5,493,803,0,3,1,3,0,1,0,76.14,61.39 ,33.33
03,002,01,006,0137,201 ,612,8,620,900,0,3,1,3,0,1,0,76.14,68.89 ,33.33
03,002,01,006,0138,202 ,606,5,611,985,0,3,1,3,0,1,0,76.14,62.03 ,33.33
03,002,01,006,0139,203 ,495,9,504,778,0,3,1,3,0,1,0,76.14,64.78 ,33.33
03,002,01,006,0139,204 ,483,8,491,804,0,3,1,3,0,1,0,76.14,61.07 ,33.33
03,002,01,006,0140,205 ,524,2,526,854,0,3,1,3,0,1,0,76.14,61.59 ,33.33
03,002,01,006,0140,206 ,419,8,427,730,0,3,1,3,0,1,0,76.14,58.49 ,33.33
03,002,01,006,0141,207 ,501,3,504,835,0,3,1,3,0,1,0,76.14,60.36 ,33.33
03,002,01,006,0142,208 ,511,5,516,800,0,3,1,3,0,1,0,76.14,64.50 ,33.33
03,002,01,006,0142,209 ,828,9,837,1266,0,3,1,3,0,1,0,76.14,66.11 ,33.33
03,002,01,006,0143,210 ,825,10,835,1277,0,3,1,3,0,1,0,76.14,65.39 ,33.33
03,002,01,006,0144,211 ,651,3,654,994,0,3,1,3,0,1,0,76.14,65.79 ,33.33
03,002,01,006,0145,212 ,627,3,630,956,0,3,1,3,0,1,0,76.14,65.90 ,33.33
03,002,01,006,0145,213 ,660,5,665,974,0,3,1,3,0,1,0,76.14,68.28 ,33.33
03,002,01,006,0146,214 ,656,7,663,1026,0,3,1,3,0,1,0,76.14,64.62 ,33.33
03,002,01,006,0147,215 ,541,7,548,874,0,3,1,3,0,1,0,76.14,62.70 ,33.33
03,002,01,006,0147,216 ,625,5,630,959,0,3,1,3,0,1,0,76.14,65.69 ,33.33
03,002,01,007,0148,217 ,891,9,900,1463,0,3,1,3,0,1,0,76.14,61.52 ,33.33
03,002,01,007,0148,218 ,855,7,862,1392,0,3,1,3,0,1,0,76.14,61.93 ,33.33
03,002,01,007,0148,219 ,858,11,869,1420,0,3,1,3,0,1,0,76.14,61.20 ,33.33
03,002,01,007,0149,220 ,563,10,573,969,0,3,1,3,0,1,0,76.14,59.13 ,33.33
03,002,01,007,0149,221 ,517,7,524,883,0,3,1,3,0,1,0,76.14,59.34 ,33.33
03,002,01,007,0150,222 ,796,6,802,1198,0,3,1,3,0,1,0,76.14,66.94 ,33.33
03,002,01,007,0151,223 ,644,9,653,978,0,3,1,3,0,1,0,76.14,66.77 ,33.33
03,002,01,007,0152,224 ,800,8,808,1389,0,3,1,3,0,1,0,76.14,58.17 ,33.33
03,002,01,007,0153,225 ,658,9,667,1139,0,3,1,3,0,1,0,76.14,58.56 ,33.33
03,002,01,007,0154,226 ,630,11,641,997,0,3,1,3,0,1,0,76.14,64.29 ,33.33
03,002,01,007,0154,227 ,292,8,300,489,0,3,1,3,0,1,0,76.14,61.35 ,33.33
03,002,01,007,0155,228 ,268,3,271,458,0,3,1,3,0,1,0,76.14,59.17 ,33.33
03,002,01,007,0155,229 ,158,1,159,282,0,3,1,3,0,1,0,76.14,56.38 ,33.33
03,002,01,007,0156,230 ,964,11,975,1580,0,3,1,3,0,1,0,76.14,61.71 ,33.33
03,002,01,007,0157,231 ,661,10,671,1054,0,3,1,3,0,1,0,76.14,63.66 ,33.33
03,002,01,007,0158,232 ,1021,12,1033,1576,0,3,1,3,0,1,0,76.14,65.55 ,33.33
03,002,01,007,0158,233 ,324,8,332,524,0,3,1,3,0,1,0,76.14,63.36 ,33.33
03,002,01,007,0159,234 ,769,6,775,1189,0,3,1,3,0,1,0,76.14,65.18 ,33.33
03,002,01,007,0159,235 ,749,8,757,1205,0,3,1,3,0,1,0,76.14,62.82 ,33.33
03,002,01,007,0160,236 ,505,12,517,861,0,3,1,3,0,1,0,76.14,60.05 ,33.33
03,002,01,007,0161,237 ,495,4,499,824,0,3,1,3,0,1,0,76.14,60.56 ,33.33
03,002,01,007,0162,238 ,700,6,706,1092,0,3,1,3,0,1,0,76.14,64.65 ,33.33
03,002,01,007,0163,239 ,863,4,867,1495,0,3,1,3,0,1,0,76.14,57.99 ,33.33
03,002,01,008,0164,240 ,758,9,767,1101,0,3,1,3,0,1,0,76.14,69.66 ,33.33
03,002,01,008,0165,241 ,809,8,817,1229,0,3,1,3,0,1,0,76.14,66.48 ,33.33
03,002,01,008,0166,242 ,674,6,680,980,0,3,1,3,0,1,0,76.14,69.39 ,33.33
03,002,01,008,0167,243 ,565,4,569,839,0,3,1,3,0,1,0,76.14,67.82 ,33.33
03,002,01,008,0168,244 ,664,8,672,935,0,3,1,3,0,1,0,76.14,71.87 ,33.33
03,002,01,008,0169,245 ,756,7,763,1145,0,3,1,3,0,1,0,76.14,66.64 ,33.33
03,002,01,008,0170,246 ,623,6,629,927,0,3,1,3,0,1,0,76.14,67.85 ,33.33
03,002,01,008,0170,247 ,679,9,688,1026,0,3,1,3,0,1,0,76.14,67.06 ,33.33
03,002,01,008,0171,248 ,577,5,582,824,0,3,1,3,0,1,0,76.14,70.63 ,33.33
03,002,01,008,0171,249 ,680,13,693,1027,0,3,1,3,0,1,0,76.14,67.48 ,33.33
03,002,01,008,0172,250 ,578,5,583,811,0,3,1,3,0,1,0,76.14,71.89 ,33.33
03,002,01,008,0173,251 ,479,7,486,711,0,3,1,3,0,1,0,76.14,68.35 ,33.33
03,002,01,008,0174,252 ,944,4,948,1265,0,3,1,3,0,1,0,76.14,74.94 ,33.33
03,002,01,008,0175,253 ,538,5,543,796,0,3,1,3,0,1,0,76.14,68.22 ,33.33
03,002,01,008,0176,254 ,830,10,840,1234,0,3,1,3,0,1,0,76.14,68.07 ,33.33
03,002,01,008,0177,255 ,293,2,295,428,0,3,1,3,0,1,0,76.14,68.93 ,33.33
03,002,01,008,0178,256 ,713,10,723,1165,0,3,1,3,0,1,0,76.14,62.06 ,33.33
03,002,01,008,0178,257 ,908,9,917,1505,0,3,1,3,0,1,0,76.14,60.93 ,33.33
03,002,01,008,0178,258 ,888,4,892,1476,0,3,1,3,0,1,0,76.14,60.43 ,33.33
03,002,01,008,0179,259 ,566,4,570,870,0,3,1,3,0,1,0,76.14,65.52 ,33.33
03,002,01,008,0179,260 ,706,2,708,1101,0,3,1,3,0,1,0,76.14,64.31 ,33.33
03,002,01,008,0180,261 ,763,10,773,1175,0,3,1,3,0,1,0,76.14,65.79 ,33.33
03,002,01,008,0180,262 ,658,16,674,1069,0,3,1,3,0,1,0,76.14,63.05 ,33.33
03,002,01,008,0180,263 ,769,17,786,1242,0,3,1,3,0,1,0,76.14,63.29 ,33.33
03,002,01,008,0180,264 ,605,4,609,954,0,3,1,3,0,1,0,76.14,63.84 ,33.33
03,002,01,008,0181,265 ,845,6,851,1301,0,3,1,3,0,1,0,76.14,65.41 ,33.33
03,002,01,008,0181,266 ,828,6,834,1366,0,3,1,3,0,1,0,76.14,61.05 ,33.33
03,002,01,008,0182,267 ,717,12,729,1128,0,3,1,3,0,1,0,76.14,64.63 ,33.33
03,002,01,008,0182,268 ,674,8,682,1070,0,3,1,3,0,1,0,76.14,63.74 ,33.33
03,002,01,008,0183,269 ,685,10,695,998,0,3,1,3,0,1,0,76.14,69.64 ,33.33
03,002,01,008,0184,270 ,673,6,679,1059,0,3,1,3,0,1,0,76.14,64.12 ,33.33
03,002,01,008,0184,271 ,660,8,668,1053,0,3,1,3,0,1,0,76.14,63.44 ,33.33
03,002,01,008,0185,272 ,812,4,816,1247,0,3,1,3,0,1,0,76.14,65.44 ,33.33
03,002,01,008,0186,273 ,631,8,639,1018,0,3,1,3,0,1,0,76.14,62.77 ,33.33
03,002,01,008,0187,274 ,521,2,523,835,0,3,1,3,0,1,0,76.14,62.63 ,33.33
03,002,01,009,0188,275 ,1043,10,1053,1588,0,3,1,3,0,1,0,76.14,66.31 ,33.33
03,002,01,009,0189,276 ,945,11,956,1437,0,3,1,3,0,1,0,76.14,66.53 ,33.33
03,002,01,009,0190,277 ,654,4,658,972,0,3,1,3,0,1,0,76.14,67.70 ,33.33
03,002,01,009,0190,278 ,685,4,689,1019,0,3,1,3,0,1,0,76.14,67.62 ,33.33
03,002,01,009,0191,279 ,906,12,918,1436,0,3,1,3,0,1,0,76.14,63.93 ,33.33
03,002,01,009,0192,280 ,675,6,681,1071,0,3,1,3,0,1,0,76.14,63.59 ,33.33
03,002,01,009,0193,281 ,553,7,560,878,0,3,1,3,0,1,0,76.14,63.78 ,33.33
03,002,01,009,0193,282 ,762,4,766,1178,0,3,1,3,0,1,0,76.14,65.03 ,33.33
03,002,01,009,0194,283 ,933,13,946,1457,0,3,1,3,0,1,0,76.14,64.93 ,33.33
03,002,01,009,0195,284 ,921,1,922,1352,0,3,1,3,0,1,0,76.14,68.20 ,33.33
03,002,01,009,0195,285 ,758,12,770,1312,0,3,1,3,0,1,0,76.14,58.69 ,33.33
03,002,01,009,0196,286 ,996,15,1011,1553,0,3,1,3,0,1,0,76.14,65.10 ,33.33
03,002,01,009,0196,287 ,744,2,746,1120,0,3,1,3,0,1,0,76.14,66.61 ,33.33
03,002,01,009,0197,288 ,930,7,937,1410,0,3,1,3,0,1,0,76.14,66.45 ,33.33
03,002,01,009,0197,289 ,538,7,545,868,0,3,1,3,0,1,0,76.14,62.79 ,33.33
03,002,01,009,0198,290 ,861,15,876,1330,0,3,1,3,0,1,0,76.14,65.86 ,33.33
03,002,01,009,0199,291 ,944,11,955,1464,0,3,1,3,0,1,0,76.14,65.23 ,33.33
03,002,01,009,0200,292 ,615,27,642,1019,0,3,1,3,0,1,0,76.14,63.00 ,33.33
03,002,01,009,0200,293 ,570,5,575,972,0,3,1,3,0,1,0,76.14,59.16 ,33.33
03,002,01,009,0201,294 ,1030,11,1041,1599,0,3,1,3,0,1,0,76.14,65.10 ,33.33
03,002,01,009,0201,295 ,453,1,454,746,0,3,1,3,0,1,0,76.14,60.86 ,33.33
03,002,01,009,0202,296 ,988,10,998,1713,0,3,1,3,0,1,0,76.14,58.26 ,33.33
03,002,01,009,0202,297 ,489,7,496,748,0,3,1,3,0,1,0,76.14,66.31 ,33.33
03,002,01,010,0203,298 ,157,1,158,239,0,3,1,3,0,1,0,76.14,66.11 ,33.33
03,002,01,010,0204,299 ,374,3,377,599,0,3,1,3,0,1,0,76.14,62.94 ,33.33
03,002,01,010,0205,300 ,462,6,468,781,0,3,1,3,0,1,0,76.14,59.92 ,33.33
03,002,01,010,0206,301 ,411,8,419,675,0,3,1,3,0,1,0,76.14,62.07 ,33.33
03,002,01,010,0207,302 ,288,6,294,453,0,3,1,3,0,1,0,76.14,64.90 ,33.33
03,002,01,010,0208,303 ,711,8,719,1098,0,3,1,3,0,1,0,76.14,65.48 ,33.33
03,002,01,010,0209,304 ,724,5,729,1152,0,3,1,3,0,1,0,76.14,63.28 ,33.33
03,002,01,010,0210,305 ,547,7,554,820,0,3,1,3,0,1,0,76.14,67.56 ,33.33
03,002,01,010,0211,306 ,592,2,594,1024,0,3,1,3,0,1,0,76.14,58.01 ,33.33
03,002,01,010,0212,307 ,962,6,968,1588,0,3,1,3,0,1,0,76.14,60.96 ,33.33
03,002,01,010,0212,308 ,867,13,880,1463,0,3,1,3,0,1,0,76.14,60.15 ,33.33
03,002,01,010,0213,309 ,424,6,430,687,0,3,1,3,0,1,0,76.14,62.59 ,33.33
03,002,01,010,0214,310 ,347,3,350,555,0,3,1,3,0,1,0,76.14,63.06 ,33.33
03,002,01,010,0215,311 ,285,6,291,497,0,3,1,3,0,1,0,76.14,58.55 ,33.33
03,002,01,010,0216,312 ,412,3,415,665,0,3,1,3,0,1,0,76.14,62.41 ,33.33
03,002,01,010,0217,313 ,628,12,640,1088,0,3,1,3,0,1,0,76.14,58.82 ,33.33
03,002,01,010,0218,314 ,511,9,520,807,0,3,1,3,0,1,0,76.14,64.44 ,33.33
03,002,01,010,0219,315 ,868,6,874,1237,0,3,1,3,0,1,0,76.14,70.65 ,33.33
03,002,01,010,0220,316 ,725,13,738,1120,0,3,1,3,0,1,0,76.14,65.89 ,33.33
03,002,01,011,0221,317 ,59,0,59,105,0,3,1,3,0,1,0,76.14,56.19 ,33.33
03,002,01,011,0222,318 ,57,1,58,94,0,3,1,3,0,1,0,76.14,61.70 ,33.33
03,002,01,011,0223,319 ,152,3,155,226,0,3,1,3,0,1,0,76.14,68.58 ,33.33
03,002,01,011,0224,320 ,137,1,138,241,0,3,1,3,0,1,0,76.14,57.26 ,33.33
03,002,01,011,0225,321 ,43,0,43,80,0,3,1,3,0,1,0,76.14,53.75 ,33.33
03,002,01,011,0226,322 ,29,3,32,57,0,3,1,3,0,1,0,76.14,56.14 ,33.33
03,002,01,011,0227,323 ,37,0,37,53,0,3,1,3,0,1,0,76.14,69.81 ,33.33
03,002,01,011,0228,324 ,18,0,18,23,0,3,1,3,0,1,0,76.14,78.26 ,33.33
03,002,01,011,0229,325 ,27,0,27,55,0,3,1,3,0,1,0,76.14,49.09 ,33.33
03,002,01,011,0230,326 ,49,1,50,79,0,3,1,3,0,1,0,76.14,63.29 ,33.33
03,002,01,012,0231,327 ,47,1,48,81,0,3,1,3,0,1,0,76.14,59.26 ,33.33
03,002,01,012,0232,328 ,132,3,135,236,0,3,1,3,0,1,0,76.14,57.20 ,33.33
03,002,01,012,0233,329 ,43,1,44,92,0,3,1,3,0,1,0,76.14,47.83 ,33.33
03,002,01,012,0234,330 ,30,1,31,53,0,3,1,3,0,1,0,76.14,58.49 ,33.33
03,002,01,012,0235,331 ,51,1,52,125,0,3,1,3,0,1,0,76.14,41.60 ,33.33
03,002,01,012,0236,332 ,11,0,11,26,0,3,1,3,0,1,0,76.14,42.31 ,33.33
03,002,01,012,0237,333 ,74,4,78,150,0,3,1,3,0,1,0,76.14,52.00 ,33.33
03,003,01,001,0001,1 ,781,9,790,1109,0,3,1,3,0,1,0,76.14,71.24 ,33.33
03,003,01,001,0001,2 ,905,4,909,1297,0,3,1,3,0,1,0,76.14,70.08 ,33.33
03,003,01,001,0001,3 ,787,12,799,1295,0,3,1,3,0,1,0,76.14,61.70 ,33.33
03,003,01,001,0001,4 ,769,15,784,1147,0,3,1,3,0,1,0,76.14,68.35 ,33.33
03,003,01,001,0002,5 ,807,8,815,1215,0,3,1,3,0,1,0,76.14,67.08 ,33.33
03,003,01,001,0002,6 ,758,7,765,1146,0,3,1,3,0,1,0,76.14,66.75 ,33.33
03,003,01,001,0002,7 ,873,14,887,1271,0,3,1,3,0,1,0,76.14,69.79 ,33.33
03,003,01,001,0003,8 ,858,13,871,1236,0,3,1,3,0,1,0,76.14,70.47 ,33.33
03,003,01,001,0003,9 ,923,14,937,1378,0,3,1,3,0,1,0,76.14,68.00 ,33.33
03,003,01,001,0003,10 ,817,11,828,1222,0,3,1,3,0,1,0,76.14,67.76 ,33.33
03,003,01,001,0004,11 ,924,10,934,1300,0,3,1,3,0,1,0,76.14,71.85 ,33.33
03,003,01,001,0004,12 ,1134,11,1145,1669,0,3,1,3,0,1,0,76.14,68.60 ,33.33
03,003,01,001,0004,13 ,926,10,936,1353,0,3,1,3,0,1,0,76.14,69.18 ,33.33
03,003,01,001,0005,14 ,966,5,971,1451,0,3,1,3,0,1,0,76.14,66.92 ,33.33
03,003,01,001,0005,15 ,1073,16,1089,1510,0,3,1,3,0,1,0,76.14,72.12 ,33.33
03,003,01,001,0006,16 ,979,13,992,1451,0,3,1,3,0,1,0,76.14,68.37 ,33.33
03,003,01,001,0006,17 ,1028,19,1047,1443,0,3,1,3,0,1,0,76.14,72.56 ,33.33
03,003,01,001,0006,18 ,1335,18,1353,1963,0,3,1,3,0,1,0,76.14,68.93 ,33.33
03,003,01,001,0007,19 ,959,6,965,1415,0,3,1,3,0,1,0,76.14,68.20 ,33.33
03,003,01,001,0007,20 ,942,12,954,1440,0,3,1,3,0,1,0,76.14,66.25 ,33.33
03,003,01,001,0007,21 ,775,8,783,1185,0,3,1,3,0,1,0,76.14,66.08 ,33.33
03,003,01,001,0008,22 ,794,9,803,1201,0,3,1,3,0,1,0,76.14,66.86 ,33.33
03,003,01,001,0008,23 ,838,9,847,1278,0,3,1,3,0,1,0,76.14,66.28 ,33.33
03,003,01,001,0009,24 ,673,6,679,935,0,3,1,3,0,1,0,76.14,72.62 ,33.33
03,003,01,001,0009,25 ,564,4,568,875,0,3,1,3,0,1,0,76.14,64.91 ,33.33
03,003,01,001,0010,26 ,558,9,567,900,0,3,1,3,0,1,0,76.14,63.00 ,33.33
03,003,01,001,0011,27 ,976,4,980,1524,0,3,1,3,0,1,0,76.14,64.30 ,33.33
03,003,01,001,0012,28 ,986,16,1002,1402,0,3,1,3,0,1,0,76.14,71.47 ,33.33
03,003,01,001,0013,29 ,535,3,538,814,0,3,1,3,0,1,0,76.14,66.09 ,33.33
03,003,01,001,0014,30 ,971,12,983,1441,0,3,1,3,0,1,0,76.14,68.22 ,33.33
03,003,01,001,0015,31 ,657,9,666,943,0,3,1,3,0,1,0,76.14,70.63 ,33.33
03,003,01,001,0016,32 ,762,6,768,1132,0,3,1,3,0,1,0,76.14,67.84 ,33.33
03,003,01,001,0016,33 ,872,14,886,1381,0,3,1,3,0,1,0,76.14,64.16 ,33.33
03,003,01,001,0016,34 ,755,6,761,1046,0,3,1,3,0,1,0,76.14,72.75 ,33.33
03,003,01,001,0016,35 ,658,7,665,1031,0,3,1,3,0,1,0,76.14,64.50 ,33.33
03,003,01,001,0017,36 ,976,6,982,1360,0,3,1,3,0,1,0,76.14,72.21 ,33.33
03,003,01,001,0018,37 ,881,9,890,1334,0,3,1,3,0,1,0,76.14,66.72 ,33.33
03,003,01,001,0019,38 ,853,9,862,1239,0,3,1,3,0,1,0,76.14,69.57 ,33.33
03,003,01,001,0020,39 ,642,3,645,936,0,3,1,3,0,1,0,76.14,68.91 ,33.33
03,003,01,001,0021,40 ,554,8,562,779,0,3,1,3,0,1,0,76.14,72.14 ,33.33
03,003,01,001,0021,41 ,677,3,680,956,0,3,1,3,0,1,0,76.14,71.13 ,33.33
03,003,01,001,0022,42 ,1077,17,1094,1529,0,3,1,3,0,1,0,76.14,71.55 ,33.33
03,003,01,001,0022,43 ,952,8,960,1333,0,3,1,3,0,1,0,76.14,72.02 ,33.33
03,003,01,001,0022,44 ,1096,10,1106,1599,0,3,1,3,0,1,0,76.14,69.17 ,33.33
03,003,01,001,0023,45 ,953,12,965,1381,0,3,1,3,0,1,0,76.14,69.88 ,33.33
03,003,01,001,0023,46 ,1016,15,1031,1476,0,3,1,3,0,1,0,76.14,69.85 ,33.33
03,003,01,001,0023,47 ,937,11,948,1615,0,3,1,3,0,1,0,76.14,58.70 ,33.33
03,003,01,001,0024,48 ,869,4,873,1244,0,3,1,3,0,1,0,76.14,70.18 ,33.33
03,003,01,001,0024,49 ,1044,13,1057,1620,0,3,1,3,0,1,0,76.14,65.25 ,33.33
03,003,01,001,0025,50 ,1018,6,1024,1486,0,3,1,3,0,1,0,76.14,68.91 ,33.33
03,003,01,001,0025,51 ,573,11,584,858,0,3,1,3,0,1,0,76.14,68.07 ,33.33
03,003,01,001,0025,52 ,712,10,722,1109,0,3,1,3,0,1,0,76.14,65.10 ,33.33
03,003,01,001,0026,53 ,919,12,931,1372,0,3,1,3,0,1,0,76.14,67.86 ,33.33
03,003,01,001,0026,54 ,831,14,845,1319,0,3,1,3,0,1,0,76.14,64.06 ,33.33
03,003,01,001,0026,55 ,853,10,863,1311,0,3,1,3,0,1,0,76.14,65.83 ,33.33
03,003,01,001,0027,56 ,1021,10,1031,1670,0,3,1,3,0,1,0,76.14,61.74 ,33.33
03,003,01,001,0027,57 ,1076,16,1092,1567,0,3,1,3,0,1,0,76.14,69.69 ,33.33
03,003,01,001,0028,58 ,922,10,932,1361,0,3,1,3,0,1,0,76.14,68.48 ,33.33
03,003,01,001,0028,59 ,778,7,785,1143,0,3,1,3,0,1,0,76.14,68.68 ,33.33
03,003,01,001,0029,60 ,772,8,780,1267,0,3,1,3,0,1,0,76.14,61.56 ,33.33
03,003,01,001,0029,61 ,859,7,866,1264,0,3,1,3,0,1,0,76.14,68.51 ,33.33
03,003,01,001,0029,62 ,863,10,873,1345,0,3,1,3,0,1,0,76.14,64.91 ,33.33
03,003,01,001,0029,63 ,758,11,769,1251,0,3,1,3,0,1,0,76.14,61.47 ,33.33
03,003,01,001,0030,64 ,961,11,972,1464,0,3,1,3,0,1,0,76.14,66.39 ,33.33
03,003,01,001,0030,65 ,768,12,780,1158,0,3,1,3,0,1,0,76.14,67.36 ,33.33
03,003,01,001,0030,66 ,968,10,978,1388,0,3,1,3,0,1,0,76.14,70.46 ,33.33
03,003,01,001,0031,67 ,894,10,904,1281,0,3,1,3,0,1,0,76.14,70.57 ,33.33
03,003,01,001,0031,68 ,804,6,810,1183,0,3,1,3,0,1,0,76.14,68.47 ,33.33
03,003,01,001,0031,69 ,968,11,979,1418,0,3,1,3,0,1,0,76.14,69.04 ,33.33
03,003,01,001,0032,70 ,836,11,847,1274,0,3,1,3,0,1,0,76.14,66.48 ,33.33
03,003,01,001,0032,71 ,880,12,892,1228,0,3,1,3,0,1,0,76.14,72.64 ,33.33
03,003,01,001,0033,72 ,656,8,664,959,0,3,1,3,0,1,0,76.14,69.24 ,33.33
03,003,01,001,0033,73 ,958,10,968,1438,0,3,1,3,0,1,0,76.14,67.32 ,33.33
03,003,01,001,0033,74 ,615,5,620,976,0,3,1,3,0,1,0,76.14,63.52 ,33.33
03,003,01,001,0034,75 ,836,13,849,1245,0,3,1,3,0,1,0,76.14,68.19 ,33.33
03,003,01,001,0034,76 ,947,16,963,1399,0,3,1,3,0,1,0,76.14,68.83 ,33.33
03,003,01,001,0034,77 ,918,10,928,1483,0,3,1,3,0,1,0,76.14,62.58 ,33.33
03,003,01,001,0035,78 ,846,14,860,1238,0,3,1,3,0,1,0,76.14,69.47 ,33.33
03,003,01,001,0035,79 ,1125,13,1138,1623,0,3,1,3,0,1,0,76.14,70.12 ,33.33
03,003,01,001,0036,80 ,1047,12,1059,1486,0,3,1,3,0,1,0,76.14,71.27 ,33.33
03,003,01,001,0036,81 ,1131,14,1145,1691,0,3,1,3,0,1,0,76.14,67.71 ,33.33
03,003,01,001,0037,82 ,682,9,691,1102,0,3,1,3,0,1,0,76.14,62.70 ,33.33
03,003,01,001,0037,83 ,703,7,710,1018,0,3,1,3,0,1,0,76.14,69.74 ,33.33
03,003,01,001,0038,84 ,899,5,904,1332,0,3,1,3,0,1,0,76.14,67.87 ,33.33
03,003,01,001,0038,85 ,729,13,742,1145,0,3,1,3,0,1,0,76.14,64.80 ,33.33
03,003,01,001,0038,86 ,838,13,851,1344,0,3,1,3,0,1,0,76.14,63.32 ,33.33
03,003,01,001,0039,87 ,834,7,841,1249,0,3,1,3,0,1,0,76.14,67.33 ,33.33
03,003,01,001,0039,88 ,805,16,821,1164,0,3,1,3,0,1,0,76.14,70.53 ,33.33
03,003,01,001,0039,89 ,804,8,812,1442,0,3,1,3,0,1,0,76.14,56.31 ,33.33
03,003,01,001,0039,90 ,824,15,839,1225,0,3,1,3,0,1,0,76.14,68.49 ,33.33
03,003,01,001,0040,91 ,624,8,632,917,0,3,1,3,0,1,0,76.14,68.92 ,33.33
03,003,01,001,0040,92 ,579,5,584,913,0,3,1,3,0,1,0,76.14,63.96 ,33.33
03,003,01,001,0040,93 ,1061,5,1066,1515,0,3,1,3,0,1,0,76.14,70.36 ,33.33
03,003,01,001,0041,94 ,906,19,925,1366,0,3,1,3,0,1,0,76.14,67.72 ,33.33
03,003,01,001,0041,95 ,826,14,840,1265,0,3,1,3,0,1,0,76.14,66.40 ,33.33
03,003,01,001,0041,96 ,867,11,878,1283,0,3,1,3,0,1,0,76.14,68.43 ,33.33
03,003,01,001,0042,97 ,803,9,812,1210,0,3,1,3,0,1,0,76.14,67.11 ,33.33
03,003,01,001,0042,98 ,721,9,730,1085,0,3,1,3,0,1,0,76.14,67.28 ,33.33
03,003,01,001,0042,99 ,1068,13,1081,1668,0,3,1,3,0,1,0,76.14,64.81 ,33.33
03,003,01,001,0043,100 ,784,11,795,1153,0,3,1,3,0,1,0,76.14,68.95 ,33.33
03,003,01,001,0043,101 ,786,9,795,1222,0,3,1,3,0,1,0,76.14,65.06 ,33.33
03,003,01,001,0043,102 ,946,12,958,1389,0,3,1,3,0,1,0,76.14,68.97 ,33.33
03,003,01,001,0044,103 ,971,12,983,1517,0,3,1,3,0,1,0,76.14,64.80 ,33.33
03,003,01,001,0044,104 ,892,14,906,1369,0,3,1,3,0,1,0,76.14,66.18 ,33.33
03,003,01,001,0044,105 ,958,7,965,1489,0,3,1,3,0,1,0,76.14,64.81 ,33.33
03,003,01,001,0044,106 ,873,17,890,1336,0,3,1,3,0,1,0,76.14,66.62 ,33.33
03,003,01,001,0045,107 ,716,11,727,1023,0,3,1,3,0,1,0,76.14,71.07 ,33.33
03,003,01,001,0045,108 ,669,8,677,905,0,3,1,3,0,1,0,76.14,74.81 ,33.33
03,003,01,001,0046,109 ,887,10,897,1415,0,3,1,3,0,1,0,76.14,63.39 ,33.33
03,003,01,001,0046,110 ,796,13,809,1190,0,3,1,3,0,1,0,76.14,67.98 ,33.33
03,003,01,001,0047,111 ,1050,7,1057,1560,0,3,1,3,0,1,0,76.14,67.76 ,33.33
03,003,01,001,0047,112 ,1135,15,1150,1819,0,3,1,3,0,1,0,76.14,63.22 ,33.33
03,003,01,001,0047,113 ,634,9,643,1026,0,3,1,3,0,1,0,76.14,62.67 ,33.33
03,003,01,001,0048,114 ,1117,12,1129,1856,0,3,1,3,0,1,0,76.14,60.83 ,33.33
03,003,01,001,0048,115 ,679,8,687,1067,0,3,1,3,0,1,0,76.14,64.39 ,33.33
03,003,01,001,0048,116 ,1508,14,1522,2429,0,3,1,3,0,1,0,76.14,62.66 ,33.33
03,003,01,001,0049,117 ,913,16,929,1264,0,3,1,3,0,1,0,76.14,73.50 ,33.33
03,003,01,001,0049,118 ,787,8,795,1011,0,3,1,3,0,1,0,76.14,78.64 ,33.33
03,003,01,001,0050,119 ,811,9,820,1244,0,3,1,3,0,1,0,76.14,65.92 ,33.33
03,003,01,001,0050,120 ,887,7,894,1326,0,3,1,3,0,1,0,76.14,67.42 ,33.33
03,003,01,001,0050,121 ,1001,8,1009,1584,0,3,1,3,0,1,0,76.14,63.70 ,33.33
03,003,01,001,0051,122 ,806,3,809,1136,0,3,1,3,0,1,0,76.14,71.21 ,33.33
03,003,01,001,0051,123 ,1171,19,1190,1887,0,3,1,3,0,1,0,76.14,63.06 ,33.33
03,003,01,001,0051,124 ,1282,19,1301,1740,0,3,1,3,0,1,0,76.14,74.77 ,33.33
03,003,01,001,0052,125 ,851,5,856,1274,0,3,1,3,0,1,0,76.14,67.19 ,33.33
03,003,01,001,0052,126 ,856,12,868,1178,0,3,1,3,0,1,0,76.14,73.68 ,33.33
03,003,01,001,0052,127 ,912,11,923,1432,0,3,1,3,0,1,0,76.14,64.46 ,33.33
03,003,01,001,0053,128 ,873,16,889,1387,0,3,1,3,0,1,0,76.14,64.10 ,33.33
03,003,01,001,0053,129 ,812,8,820,1157,0,3,1,3,0,1,0,76.14,70.87 ,33.33
03,003,01,001,0053,130 ,832,6,838,1377,0,3,1,3,0,1,0,76.14,60.86 ,33.33
03,003,01,001,0054,131 ,1014,16,1030,1593,0,3,1,3,0,1,0,76.14,64.66 ,33.33
03,003,01,001,0054,132 ,1021,9,1030,1517,0,3,1,3,0,1,0,76.14,67.90 ,33.33
03,003,01,001,0054,133 ,724,7,731,1053,0,3,1,3,0,1,0,76.14,69.42 ,33.33
03,003,01,001,0055,134 ,865,10,875,1330,0,3,1,3,0,1,0,76.14,65.79 ,33.33
03,003,01,001,0055,135 ,887,12,899,1357,0,3,1,3,0,1,0,76.14,66.25 ,33.33
03,003,01,001,0056,136 ,1014,12,1026,1558,0,3,1,3,0,1,0,76.14,65.85 ,33.33
03,003,01,001,0056,137 ,1004,8,1012,1456,0,3,1,3,0,1,0,76.14,69.51 ,33.33
03,003,01,001,0057,138 ,992,10,1002,1367,0,3,1,3,0,1,0,76.14,73.30 ,33.33
03,003,01,001,0058,139 ,1066,15,1081,1614,0,3,1,3,0,1,0,76.14,66.98 ,33.33
03,003,01,001,0059,140 ,1151,15,1166,1738,0,3,1,3,0,1,0,76.14,67.09 ,33.33
03,003,01,001,0060,141 ,982,15,997,1453,0,3,1,3,0,1,0,76.14,68.62 ,33.33
03,003,01,001,0060,142 ,836,10,846,1194,0,3,1,3,0,1,0,76.14,70.85 ,33.33
03,003,01,001,0060,143 ,1032,11,1043,1540,0,3,1,3,0,1,0,76.14,67.73 ,33.33
03,003,01,001,0061,144 ,1097,16,1113,1547,0,3,1,3,0,1,0,76.14,71.95 ,33.33
03,003,01,001,0061,145 ,1140,9,1149,1670,0,3,1,3,0,1,0,76.14,68.80 ,33.33
03,003,01,001,0062,146 ,1145,10,1155,1654,0,3,1,3,0,1,0,76.14,69.83 ,33.33
03,003,01,001,0062,147 ,1191,15,1206,1763,0,3,1,3,0,1,0,76.14,68.41 ,33.33
03,003,01,001,0063,148 ,766,10,776,1206,0,3,1,3,0,1,0,76.14,64.34 ,33.33
03,003,01,001,0063,149 ,962,19,981,1508,0,3,1,3,0,1,0,76.14,65.05 ,33.33
03,003,01,001,0063,150 ,928,12,940,1436,0,3,1,3,0,1,0,76.14,65.46 ,33.33
03,003,01,001,0063,151 ,970,9,979,1484,0,3,1,3,0,1,0,76.14,65.97 ,33.33
03,003,01,001,0064,152 ,813,8,821,1217,0,3,1,3,0,1,0,76.14,67.46 ,33.33
03,003,01,001,0064,153 ,754,12,766,1183,0,3,1,3,0,1,0,76.14,64.75 ,33.33
03,003,01,001,0064,154 ,955,3,958,1531,0,3,1,3,0,1,0,76.14,62.57 ,33.33
03,003,01,001,0064,155 ,655,13,668,1043,0,3,1,3,0,1,0,76.14,64.05 ,33.33
03,003,01,001,0065,156 ,925,12,937,1603,0,3,1,3,0,1,0,76.14,58.45 ,33.33
03,003,01,001,0065,157 ,952,13,965,1546,0,3,1,3,0,1,0,76.14,62.42 ,33.33
03,003,01,001,0065,158 ,839,9,848,1403,0,3,1,3,0,1,0,76.14,60.44 ,33.33
03,003,01,001,0066,159 ,846,6,852,1333,0,3,1,3,0,1,0,76.14,63.92 ,33.33
03,003,01,001,0066,160 ,449,4,453,888,0,3,1,3,0,1,0,76.14,51.01 ,33.33
03,003,01,001,0067,161 ,1126,18,1144,1743,0,3,1,3,0,1,0,76.14,65.63 ,33.33
03,003,01,001,0067,162 ,1017,12,1029,1694,0,3,1,3,0,1,0,76.14,60.74 ,33.33
03,003,01,001,0068,163 ,834,8,842,1208,0,3,1,3,0,1,0,76.14,69.70 ,33.33
03,003,01,001,0068,164 ,759,12,771,1203,0,3,1,3,0,1,0,76.14,64.09 ,33.33
03,003,01,001,0068,165 ,648,6,654,1142,0,3,1,3,0,1,0,76.14,57.27 ,33.33
03,003,01,001,0069,166 ,999,9,1008,1385,0,3,1,3,0,1,0,76.14,72.78 ,33.33
03,003,01,001,0069,167 ,1200,27,1227,1753,0,3,1,3,0,1,0,76.14,69.99 ,33.33
03,003,01,002,0070,168 ,942,19,961,1340,0,3,1,3,0,1,0,76.14,71.72 ,33.33
03,003,01,002,0070,169 ,1128,17,1145,1649,0,3,1,3,0,1,0,76.14,69.44 ,33.33
03,003,01,002,0070,170 ,1106,22,1128,1685,0,3,1,3,0,1,0,76.14,66.94 ,33.33
03,003,01,002,0071,171 ,1078,19,1097,1471,0,3,1,3,0,1,0,76.14,74.58 ,33.33
03,003,01,002,0071,172 ,792,9,801,1099,0,3,1,3,0,1,0,76.14,72.88 ,33.33
03,003,01,002,0071,173 ,855,6,861,1313,0,3,1,3,0,1,0,76.14,65.58 ,33.33
03,003,01,002,0071,174 ,882,12,894,1266,0,3,1,3,0,1,0,76.14,70.62 ,33.33
03,003,01,002,0072,175 ,957,18,975,1453,0,3,1,3,0,1,0,76.14,67.10 ,33.33
03,003,01,002,0072,176 ,889,20,909,1359,0,3,1,3,0,1,0,76.14,66.89 ,33.33
03,003,01,002,0072,177 ,869,12,881,1243,0,3,1,3,0,1,0,76.14,70.88 ,33.33
03,003,01,002,0073,178 ,981,19,1000,1489,0,3,1,3,0,1,0,76.14,67.16 ,33.33
03,003,01,002,0073,179 ,863,13,876,1256,0,3,1,3,0,1,0,76.14,69.75 ,33.33
03,003,01,002,0073,180 ,747,19,766,1109,0,3,1,3,0,1,0,76.14,69.07 ,33.33
03,003,01,002,0073,181 ,653,10,663,1134,0,3,1,3,0,1,0,76.14,58.47 ,33.33
03,003,01,002,0074,182 ,547,8,555,812,0,3,1,3,0,1,0,76.14,68.35 ,33.33
03,003,01,002,0075,183 ,817,6,823,1115,0,3,1,3,0,1,0,76.14,73.81 ,33.33
03,003,01,002,0075,184 ,473,3,476,629,0,3,1,3,0,1,0,76.14,75.68 ,33.33
03,003,01,002,0076,185 ,1088,20,1108,1705,0,3,1,3,0,1,0,76.14,64.99 ,33.33
03,003,01,002,0077,186 ,624,9,633,1086,0,3,1,3,0,1,0,76.14,58.29 ,33.33
03,003,01,002,0077,187 ,487,7,494,926,0,3,1,3,0,1,0,76.14,53.35 ,33.33
03,003,01,002,0078,188 ,865,12,877,1436,0,3,1,3,0,1,0,76.14,61.07 ,33.33
03,003,01,002,0078,189 ,667,8,675,1117,0,3,1,3,0,1,0,76.14,60.43 ,33.33
03,003,01,002,0078,190 ,659,15,674,1249,0,3,1,3,0,1,0,76.14,53.96 ,33.33
03,003,01,002,0079,191 ,688,15,703,1144,0,3,1,3,0,1,0,76.14,61.45 ,33.33
03,003,01,002,0079,192 ,752,14,766,1262,0,3,1,3,0,1,0,76.14,60.70 ,33.33
03,003,01,002,0080,193 ,312,9,321,548,0,3,1,3,0,1,0,76.14,58.58 ,33.33
03,003,01,002,0080,194 ,612,6,618,911,0,3,1,3,0,1,0,76.14,67.84 ,33.33
03,003,01,002,0081,195 ,906,14,920,1502,0,3,1,3,0,1,0,76.14,61.25 ,33.33
03,003,01,002,0081,196 ,854,14,868,1475,0,3,1,3,0,1,0,76.14,58.85 ,33.33
03,003,01,002,0082,197 ,718,14,732,1255,0,3,1,3,0,1,0,76.14,58.33 ,33.33
03,003,01,002,0082,198 ,876,25,901,1541,0,3,1,3,0,1,0,76.14,58.47 ,33.33
03,003,01,002,0083,199 ,641,15,656,971,0,3,1,3,0,1,0,76.14,67.56 ,33.33
03,003,01,002,0083,200 ,566,3,569,866,0,3,1,3,0,1,0,76.14,65.70 ,33.33
03,003,01,002,0084,201 ,973,13,986,1548,0,3,1,3,0,1,0,76.14,63.70 ,33.33
03,003,01,002,0084,202 ,980,9,989,1463,0,3,1,3,0,1,0,76.14,67.60 ,33.33
03,003,01,002,0084,203 ,1093,14,1107,1677,0,3,1,3,0,1,0,76.14,66.01 ,33.33
03,003,01,002,0085,204 ,1104,18,1122,1648,0,3,1,3,0,1,0,76.14,68.08 ,33.33
03,003,01,002,0085,205 ,1139,11,1150,2187,0,3,1,3,0,1,0,76.14,52.58 ,33.33
03,003,01,002,0086,206 ,914,18,932,1408,0,3,1,3,0,1,0,76.14,66.19 ,33.33
03,003,01,002,0086,207 ,843,14,857,1334,0,3,1,3,0,1,0,76.14,64.24 ,33.33
03,003,01,002,0087,208 ,833,19,852,1356,0,3,1,3,0,1,0,76.14,62.83 ,33.33
03,003,01,002,0087,209 ,870,19,889,1388,0,3,1,3,0,1,0,76.14,64.05 ,33.33
03,003,01,002,0087,210 ,779,13,792,1263,0,3,1,3,0,1,0,76.14,62.71 ,33.33
03,003,01,002,0088,211 ,472,3,475,898,0,3,1,3,0,1,0,76.14,52.90 ,33.33
03,003,01,002,0088,212 ,927,9,936,1624,0,3,1,3,0,1,0,76.14,57.64 ,33.33
03,003,01,002,0088,213 ,550,4,554,981,0,3,1,3,0,1,0,76.14,56.47 ,33.33
03,003,01,002,0088,214 ,903,8,911,1444,0,3,1,3,0,1,0,76.14,63.09 ,33.33
03,003,01,002,0088,215 ,945,15,960,1400,0,3,1,3,0,1,0,76.14,68.57 ,33.33
03,003,01,002,0089,216 ,634,16,650,881,0,3,1,3,0,1,0,76.14,73.78 ,33.33
03,003,01,002,0089,217 ,774,16,790,1394,0,3,1,3,0,1,0,76.14,56.67 ,33.33
03,003,01,002,0090,218 ,662,8,670,1185,0,3,1,3,0,1,0,76.14,56.54 ,33.33
03,003,01,002,0090,219 ,652,12,664,1173,0,3,1,3,0,1,0,76.14,56.61 ,33.33
03,003,01,002,0091,220 ,819,12,831,1408,0,3,1,3,0,1,0,76.14,59.02 ,33.33
03,003,01,002,0091,221 ,656,10,666,1192,0,3,1,3,0,1,0,76.14,55.87 ,33.33
03,003,01,002,0091,222 ,524,8,532,872,0,3,1,3,0,1,0,76.14,61.01 ,33.33
03,003,01,002,0091,223 ,762,30,792,1195,0,3,1,3,0,1,0,76.14,66.28 ,33.33
03,003,01,002,0092,224 ,832,8,840,1289,0,3,1,3,0,1,0,76.14,65.17 ,33.33
03,003,01,002,0093,225 ,822,12,834,1248,0,3,1,3,0,1,0,76.14,66.83 ,33.33
03,003,01,002,0094,226 ,786,10,796,1226,0,3,1,3,0,1,0,76.14,64.93 ,33.33
03,003,01,002,0095,227 ,941,12,953,1414,0,3,1,3,0,1,0,76.14,67.40 ,33.33
03,003,01,002,0095,228 ,881,19,900,1335,0,3,1,3,0,1,0,76.14,67.42 ,33.33
03,003,01,003,0096,229 ,989,25,1014,1515,0,3,1,3,0,1,0,76.14,66.93 ,33.33
03,003,01,003,0096,230 ,1086,10,1096,1723,0,3,1,3,0,1,0,76.14,63.61 ,33.33
03,003,01,003,0097,231 ,1021,25,1046,1468,0,3,1,3,0,1,0,76.14,71.25 ,33.33
03,003,01,003,0097,232 ,887,31,918,1271,0,3,1,3,0,1,0,76.14,72.23 ,33.33
03,003,01,003,0098,233 ,1136,26,1162,1736,0,3,1,3,0,1,0,76.14,66.94 ,33.33
03,003,01,003,0098,234 ,1044,33,1077,1454,0,3,1,3,0,1,0,76.14,74.07 ,33.33
03,003,01,003,0099,235 ,927,12,939,1413,0,3,1,3,0,1,0,76.14,66.45 ,33.33
03,003,01,003,0099,236 ,903,18,921,1366,0,3,1,3,0,1,0,76.14,67.42 ,33.33
03,003,01,003,0100,237 ,1001,24,1025,1454,0,3,1,3,0,1,0,76.14,70.50 ,33.33
03,003,01,003,0100,238 ,1096,22,1118,1622,0,3,1,3,0,1,0,76.14,68.93 ,33.33
03,003,01,003,0101,239 ,1119,14,1133,1533,0,3,1,3,0,1,0,76.14,73.91 ,33.33
03,003,01,003,0101,240 ,1038,22,1060,1427,0,3,1,3,0,1,0,76.14,74.28 ,33.33
03,003,01,003,0102,241 ,918,13,931,1346,0,3,1,3,0,1,0,76.14,69.17 ,33.33
03,003,01,003,0102,242 ,1031,25,1056,1457,0,3,1,3,0,1,0,76.14,72.48 ,33.33
03,003,01,003,0103,243 ,1184,26,1210,1823,0,3,1,3,0,1,0,76.14,66.37 ,33.33
03,003,01,003,0103,244 ,1135,26,1161,1665,0,3,1,3,0,1,0,76.14,69.73 ,33.33
03,003,01,003,0103,245 ,777,15,792,1093,0,3,1,3,0,1,0,76.14,72.46 ,33.33
03,003,01,003,0104,246 ,1359,31,1390,1898,0,3,1,3,0,1,0,76.14,73.23 ,33.33
03,003,01,003,0104,247 ,640,9,649,912,0,3,1,3,0,1,0,76.14,71.16 ,33.33
03,003,01,003,0105,248 ,911,19,930,1392,0,3,1,3,0,1,0,76.14,66.81 ,33.33
03,003,01,003,0105,249 ,871,21,892,1299,0,3,1,3,0,1,0,76.14,68.67 ,33.33
03,003,01,003,0106,250 ,1140,25,1165,1679,0,3,1,3,0,1,0,76.14,69.39 ,33.33
03,003,01,003,0106,251 ,633,18,651,887,0,3,1,3,0,1,0,76.14,73.39 ,33.33
03,003,01,003,0106,252 ,883,16,899,1167,0,3,1,3,0,1,0,76.14,77.04 ,33.33
03,003,01,003,0107,253 ,1008,16,1024,1524,0,3,1,3,0,1,0,76.14,67.19 ,33.33
03,003,01,003,0107,254 ,725,8,733,1225,0,3,1,3,0,1,0,76.14,59.84 ,33.33
03,003,01,003,0108,255 ,1416,15,1431,2045,0,3,1,3,0,1,0,76.14,69.98 ,33.33
03,003,01,003,0108,256 ,1239,29,1268,1944,0,3,1,3,0,1,0,76.14,65.23 ,33.33
03,003,01,003,0109,257 ,1082,21,1103,1686,0,3,1,3,0,1,0,76.14,65.42 ,33.33
03,003,01,003,0109,258 ,805,18,823,1234,0,3,1,3,0,1,0,76.14,66.69 ,33.33
03,003,01,003,0110,259 ,1306,23,1329,1919,0,3,1,3,0,1,0,76.14,69.25 ,33.33
03,003,01,003,0111,260 ,1535,24,1559,2285,0,3,1,3,0,1,0,76.14,68.23 ,33.33
03,003,01,003,0112,261 ,731,9,740,1116,0,3,1,3,0,1,0,76.14,66.31 ,33.33
03,003,01,003,0112,262 ,823,19,842,1391,0,3,1,3,0,1,0,76.14,60.53 ,33.33
03,003,01,003,0113,263 ,1047,35,1082,1584,0,3,1,3,0,1,0,76.14,68.31 ,33.33
03,003,01,003,0114,264 ,1139,24,1163,1709,0,3,1,3,0,1,0,76.14,68.05 ,33.33
03,003,01,003,0114,265 ,899,18,917,1312,0,3,1,3,0,1,0,76.14,69.89 ,33.33
03,003,01,003,0115,266 ,1105,23,1128,1660,0,3,1,3,0,1,0,76.14,67.95 ,33.33
03,003,01,003,0115,267 ,208,3,211,326,0,3,1,3,0,1,0,76.14,64.72 ,33.33
03,003,01,003,0116,268 ,709,11,720,1076,0,3,1,3,0,1,0,76.14,66.91 ,33.33
03,003,01,003,0116,269 ,805,10,815,1197,0,3,1,3,0,1,0,76.14,68.09 ,33.33
03,003,01,003,0117,270 ,969,14,983,1424,0,3,1,3,0,1,0,76.14,69.03 ,33.33
03,003,01,003,0118,271 ,965,30,995,1471,0,3,1,3,0,1,0,76.14,67.64 ,33.33
03,003,01,003,0118,272 ,754,7,761,1115,0,3,1,3,0,1,0,76.14,68.25 ,33.33
03,003,01,003,0118,273 ,968,18,986,1363,0,3,1,3,0,1,0,76.14,72.34 ,33.33
03,003,01,003,0119,274 ,886,13,899,1324,0,3,1,3,0,1,0,76.14,67.90 ,33.33
03,003,01,003,0119,275 ,683,14,697,1012,0,3,1,3,0,1,0,76.14,68.87 ,33.33
03,003,01,003,0119,276 ,936,14,950,1378,0,3,1,3,0,1,0,76.14,68.94 ,33.33
03,003,01,003,0120,277 ,1180,18,1198,1800,0,3,1,3,0,1,0,76.14,66.56 ,33.33
03,003,01,003,0120,278 ,510,4,514,727,0,3,1,3,0,1,0,76.14,70.70 ,33.33
03,003,01,003,0121,279 ,646,9,655,890,0,3,1,3,0,1,0,76.14,73.60 ,33.33
03,003,01,003,0121,280 ,1129,16,1145,1684,0,3,1,3,0,1,0,76.14,67.99 ,33.33
03,003,01,003,0122,281 ,780,10,790,954,0,3,1,3,0,1,0,76.14,82.81 ,33.33
03,003,01,003,0122,282 ,1011,19,1030,1461,0,3,1,3,0,1,0,76.14,70.50 ,33.33
03,003,01,003,0123,283 ,919,11,930,1336,0,3,1,3,0,1,0,76.14,69.61 ,33.33
03,003,01,003,0124,284 ,1167,23,1190,1656,0,3,1,3,0,1,0,76.14,71.86 ,33.33
03,003,01,003,0124,285 ,1184,22,1206,1687,0,3,1,3,0,1,0,76.14,71.49 ,33.33
03,003,01,003,0125,286 ,997,21,1018,1516,0,3,1,3,0,1,0,76.14,67.15 ,33.33
03,003,01,003,0125,287 ,1022,17,1039,1500,0,3,1,3,0,1,0,76.14,69.27 ,33.33
03,003,01,003,0126,288 ,675,7,682,976,0,3,1,3,0,1,0,76.14,69.88 ,33.33
03,003,01,003,0126,289 ,535,16,551,829,0,3,1,3,0,1,0,76.14,66.47 ,33.33
03,003,01,003,0127,290 ,1133,24,1157,1659,0,3,1,3,0,1,0,76.14,69.74 ,33.33
03,003,01,003,0127,291 ,708,10,718,988,0,3,1,3,0,1,0,76.14,72.67 ,33.33
03,003,01,003,0127,292 ,1133,11,1144,1620,0,3,1,3,0,1,0,76.14,70.62 ,33.33
03,003,01,003,0128,293 ,678,7,685,961,0,3,1,3,0,1,0,76.14,71.28 ,33.33
03,003,01,003,0128,294 ,1098,11,1109,1570,0,3,1,3,0,1,0,76.14,70.64 ,33.33
03,003,01,003,0129,295 ,914,10,924,1383,0,3,1,3,0,1,0,76.14,66.81 ,33.33
03,003,01,003,0129,296 ,650,9,659,956,0,3,1,3,0,1,0,76.14,68.93 ,33.33
03,003,01,003,0129,297 ,654,3,657,908,0,3,1,3,0,1,0,76.14,72.36 ,33.33
03,003,01,003,0130,298 ,956,22,978,1456,0,3,1,3,0,1,0,76.14,67.17 ,33.33
03,003,01,003,0130,299 ,664,19,683,987,0,3,1,3,0,1,0,76.14,69.20 ,33.33
03,003,01,003,0131,300 ,776,14,790,1137,0,3,1,3,0,1,0,76.14,69.48 ,33.33
03,003,01,003,0131,301 ,659,7,666,1030,0,3,1,3,0,1,0,76.14,64.66 ,33.33
03,003,01,003,0132,302 ,967,17,984,1472,0,3,1,3,0,1,0,76.14,66.85 ,33.33
03,003,01,003,0133,303 ,1029,22,1051,1512,0,3,1,3,0,1,0,76.14,69.51 ,33.33
03,003,01,003,0133,304 ,703,20,723,1111,0,3,1,3,0,1,0,76.14,65.08 ,33.33
03,003,01,003,0133,305 ,833,16,849,1243,0,3,1,3,0,1,0,76.14,68.30 ,33.33
03,003,01,003,0134,306 ,697,9,706,1095,0,3,1,3,0,1,0,76.14,64.47 ,33.33
03,003,01,003,0134,307 ,1137,22,1159,1669,0,3,1,3,0,1,0,76.14,69.44 ,33.33
03,003,01,003,0134,308 ,443,32,475,1291,0,3,1,3,0,1,0,76.14,36.79 ,33.33
03,003,01,003,0134,309 ,658,58,716,1295,0,3,1,3,0,1,0,76.14,55.29 ,33.33
03,003,01,004,0135,310 ,758,20,778,1097,0,3,1,3,0,1,0,76.14,70.92 ,33.33
03,003,01,004,0135,311 ,716,11,727,1019,0,3,1,3,0,1,0,76.14,71.34 ,33.33
03,003,01,004,0135,312 ,656,10,666,1010,0,3,1,3,0,1,0,76.14,65.94 ,33.33
03,003,01,004,0136,313 ,1026,10,1036,1582,0,3,1,3,0,1,0,76.14,65.49 ,33.33
03,003,01,004,0136,314 ,1135,22,1157,1577,0,3,1,3,0,1,0,76.14,73.37 ,33.33
03,003,01,004,0137,315 ,1169,19,1188,1674,0,3,1,3,0,1,0,76.14,70.97 ,33.33
03,003,01,004,0137,316 ,842,14,856,1165,0,3,1,3,0,1,0,76.14,73.48 ,33.33
03,003,01,004,0138,317 ,747,13,760,1122,0,3,1,3,0,1,0,76.14,67.74 ,33.33
03,003,01,004,0138,318 ,645,10,655,929,0,3,1,3,0,1,0,76.14,70.51 ,33.33
03,003,01,004,0139,319 ,750,16,766,1052,0,3,1,3,0,1,0,76.14,72.81 ,33.33
03,003,01,004,0139,320 ,703,14,717,1047,0,3,1,3,0,1,0,76.14,68.48 ,33.33
03,003,01,004,0140,321 ,958,13,971,1407,0,3,1,3,0,1,0,76.14,69.01 ,33.33
03,003,01,004,0140,322 ,793,9,802,1135,0,3,1,3,0,1,0,76.14,70.66 ,33.33
03,003,01,004,0141,323 ,744,7,751,1036,0,3,1,3,0,1,0,76.14,72.49 ,33.33
03,003,01,004,0142,324 ,546,15,561,763,0,3,1,3,0,1,0,76.14,73.53 ,33.33
03,003,01,004,0142,325 ,684,7,691,892,0,3,1,3,0,1,0,76.14,77.47 ,33.33
03,003,01,004,0143,326 ,686,5,691,981,0,3,1,3,0,1,0,76.14,70.44 ,33.33
03,003,01,004,0143,327 ,709,14,723,937,0,3,1,3,0,1,0,76.14,77.16 ,33.33
03,003,01,004,0143,328 ,696,9,705,923,0,3,1,3,0,1,0,76.14,76.38 ,33.33
03,003,01,004,0144,329 ,804,15,819,1156,0,3,1,3,0,1,0,76.14,70.85 ,33.33
03,003,01,004,0144,330 ,1470,16,1486,2483,0,3,1,3,0,1,0,76.14,59.85 ,33.33
03,003,01,004,0144,331 ,1992,31,2023,3353,0,3,1,3,0,1,0,76.14,60.33 ,33.33
03,003,01,004,0145,332 ,541,8,549,948,0,3,1,3,0,1,0,76.14,57.91 ,33.33
03,003,01,004,0145,333 ,845,15,860,1304,0,3,1,3,0,1,0,76.14,65.95 ,33.33
03,003,01,004,0146,334 ,748,19,767,1113,0,3,1,3,0,1,0,76.14,68.91 ,33.33
03,003,01,004,0146,335 ,804,13,817,1319,0,3,1,3,0,1,0,76.14,61.94 ,33.33
03,003,01,004,0147,336 ,889,13,902,1323,0,3,1,3,0,1,0,76.14,68.18 ,33.33
03,003,01,004,0147,337 ,884,11,895,1346,0,3,1,3,0,1,0,76.14,66.49 ,33.33
03,003,01,004,0148,338 ,558,9,567,837,0,3,1,3,0,1,0,76.14,67.74 ,33.33
03,003,01,004,0148,339 ,585,6,591,913,0,3,1,3,0,1,0,76.14,64.73 ,33.33
03,003,01,004,0149,340 ,1009,21,1030,1608,0,3,1,3,0,1,0,76.14,64.05 ,33.33
03,003,01,004,0150,341 ,921,9,930,1507,0,3,1,3,0,1,0,76.14,61.71 ,33.33
03,003,01,004,0150,342 ,949,8,957,1534,0,3,1,3,0,1,0,76.14,62.39 ,33.33
03,003,01,004,0151,343 ,972,11,983,1544,0,3,1,3,0,1,0,76.14,63.67 ,33.33
03,003,01,004,0151,344 ,867,10,877,1328,0,3,1,3,0,1,0,76.14,66.04 ,33.33
03,003,01,004,0151,345 ,897,1,898,1450,0,3,1,3,0,1,0,76.14,61.93 ,33.33
03,003,01,004,0152,346 ,908,12,920,1528,0,3,1,3,0,1,0,76.14,60.21 ,33.33
03,003,01,004,0152,347 ,949,14,963,1468,0,3,1,3,0,1,0,76.14,65.60 ,33.33
03,003,01,004,0153,348 ,794,10,804,1458,0,3,1,3,0,1,0,76.14,55.14 ,33.33
03,003,01,004,0154,349 ,570,10,580,859,0,3,1,3,0,1,0,76.14,67.52 ,33.33
03,003,01,004,0154,350 ,690,18,708,963,0,3,1,3,0,1,0,76.14,73.52 ,33.33
03,003,01,004,0155,351 ,954,16,970,1388,0,3,1,3,0,1,0,76.14,69.88 ,33.33
03,003,01,004,0156,352 ,718,17,735,1084,0,3,1,3,0,1,0,76.14,67.80 ,33.33
03,003,01,004,0156,353 ,699,14,713,1078,0,3,1,3,0,1,0,76.14,66.14 ,33.33
03,003,01,004,0156,354 ,707,15,722,950,0,3,1,3,0,1,0,76.14,76.00 ,33.33
03,003,01,004,0157,355 ,889,16,905,1241,0,3,1,3,0,1,0,76.14,72.93 ,33.33
03,003,01,004,0158,356 ,1109,23,1132,1568,0,3,1,3,0,1,0,76.14,72.19 ,33.33
03,003,01,004,0159,357 ,690,11,701,1008,0,3,1,3,0,1,0,76.14,69.54 ,33.33
03,003,01,004,0159,358 ,747,12,759,1077,0,3,1,3,0,1,0,76.14,70.47 ,33.33
03,003,01,004,0160,359 ,763,9,772,1287,0,3,1,3,0,1,0,76.14,59.98 ,33.33
03,003,01,004,0160,360 ,757,10,767,1189,0,3,1,3,0,1,0,76.14,64.51 ,33.33
03,003,01,004,0160,361 ,681,12,693,1122,0,3,1,3,0,1,0,76.14,61.76 ,33.33
03,003,01,005,0161,362 ,1266,22,1288,1739,0,3,1,3,0,1,0,76.14,74.07 ,33.33
03,003,01,005,0161,363 ,1124,13,1137,1522,0,3,1,3,0,1,0,76.14,74.70 ,33.33
03,003,01,005,0161,364 ,1180,20,1200,1650,0,3,1,3,0,1,0,76.14,72.73 ,33.33
03,003,01,005,0162,365 ,883,7,890,1236,0,3,1,3,0,1,0,76.14,72.01 ,33.33
03,003,01,005,0162,366 ,881,21,902,1332,0,3,1,3,0,1,0,76.14,67.72 ,33.33
03,003,01,005,0162,367 ,1017,16,1033,1481,0,3,1,3,0,1,0,76.14,69.75 ,33.33
03,003,01,005,0163,368 ,1057,22,1079,1550,0,3,1,3,0,1,0,76.14,69.61 ,33.33
03,003,01,005,0163,369 ,1031,13,1044,1508,0,3,1,3,0,1,0,76.14,69.23 ,33.33
03,003,01,005,0164,370 ,987,9,996,1383,0,3,1,3,0,1,0,76.14,72.02 ,33.33
03,003,01,005,0165,371 ,1144,15,1159,1716,0,3,1,3,0,1,0,76.14,67.54 ,33.33
03,003,01,005,0165,372 ,1151,15,1166,1749,0,3,1,3,0,1,0,76.14,66.67 ,33.33
03,003,01,005,0165,373 ,923,8,931,1292,0,3,1,3,0,1,0,76.14,72.06 ,33.33
03,003,01,005,0166,374 ,737,17,754,1070,0,3,1,3,0,1,0,76.14,70.47 ,33.33
03,003,01,005,0166,375 ,891,11,902,1284,0,3,1,3,0,1,0,76.14,70.25 ,33.33
03,003,01,005,0166,376 ,882,18,900,1274,0,3,1,3,0,1,0,76.14,70.64 ,33.33
03,003,01,005,0167,377 ,892,10,902,1192,0,3,1,3,0,1,0,76.14,75.67 ,33.33
03,003,01,005,0167,378 ,877,18,895,1353,0,3,1,3,0,1,0,76.14,66.15 ,33.33
03,003,01,005,0167,379 ,1108,13,1121,1622,0,3,1,3,0,1,0,76.14,69.11 ,33.33
03,003,01,005,0168,380 ,934,19,953,1258,0,3,1,3,0,1,0,76.14,75.76 ,33.33
03,003,01,005,0169,381 ,681,14,695,939,0,3,1,3,0,1,0,76.14,74.01 ,33.33
03,003,01,005,0170,382 ,700,14,714,1022,0,3,1,3,0,1,0,76.14,69.86 ,33.33
03,003,01,005,0170,383 ,1042,16,1058,1407,0,3,1,3,0,1,0,76.14,75.20 ,33.33
03,003,01,005,0171,384 ,1156,25,1181,1676,0,3,1,3,0,1,0,76.14,70.47 ,33.33
03,003,01,005,0171,385 ,768,11,779,1186,0,3,1,3,0,1,0,76.14,65.68 ,33.33
03,003,01,005,0171,386 ,808,21,829,1295,0,3,1,3,0,1,0,76.14,64.02 ,33.33
03,003,01,005,0172,387 ,597,7,604,822,0,3,1,3,0,1,0,76.14,73.48 ,33.33
03,003,01,005,0172,388 ,896,5,901,1384,0,3,1,3,0,1,0,76.14,65.10 ,33.33
03,003,01,005,0173,389 ,864,15,879,1333,0,3,1,3,0,1,0,76.14,65.94 ,33.33
03,003,01,005,0174,390 ,770,13,783,1192,0,3,1,3,0,1,0,76.14,65.69 ,33.33
03,003,01,005,0174,391 ,872,9,881,1300,0,3,1,3,0,1,0,76.14,67.77 ,33.33
03,003,01,005,0175,392 ,1156,12,1168,1627,0,3,1,3,0,1,0,76.14,71.79 ,33.33
03,003,01,005,0176,393 ,581,13,594,832,0,3,1,3,0,1,0,76.14,71.39 ,33.33
03,003,01,005,0176,394 ,732,7,739,1049,0,3,1,3,0,1,0,76.14,70.45 ,33.33
03,003,01,005,0177,395 ,1218,17,1235,1714,0,3,1,3,0,1,0,76.14,72.05 ,33.33
03,003,01,005,0178,396 ,818,5,823,1172,0,3,1,3,0,1,0,76.14,70.22 ,33.33
03,003,01,005,0178,397 ,649,8,657,1027,0,3,1,3,0,1,0,76.14,63.97 ,33.33
03,003,01,005,0179,398 ,761,9,770,1277,0,3,1,3,0,1,0,76.14,60.30 ,33.33
03,003,01,005,0179,399 ,673,11,684,1192,0,3,1,3,0,1,0,76.14,57.38 ,33.33
03,003,01,006,0180,400 ,619,11,630,836,0,3,1,3,0,1,0,76.14,75.36 ,33.33
03,003,01,006,0180,401 ,565,4,569,795,0,3,1,3,0,1,0,76.14,71.57 ,33.33
03,003,01,006,0181,402 ,750,4,754,1111,0,3,1,3,0,1,0,76.14,67.87 ,33.33
03,003,01,006,0182,403 ,866,14,880,1277,0,3,1,3,0,1,0,76.14,68.91 ,33.33
03,003,01,006,0182,404 ,733,7,740,1103,0,3,1,3,0,1,0,76.14,67.09 ,33.33
03,003,01,006,0182,405 ,760,10,770,1144,0,3,1,3,0,1,0,76.14,67.31 ,33.33
03,003,01,006,0183,406 ,688,7,695,1064,0,3,1,3,0,1,0,76.14,65.32 ,33.33
03,003,01,006,0183,407 ,736,8,744,1053,0,3,1,3,0,1,0,76.14,70.66 ,33.33
03,003,01,006,0183,408 ,725,7,732,1016,0,3,1,3,0,1,0,76.14,72.05 ,33.33
03,003,01,006,0184,409 ,918,13,931,1410,0,3,1,3,0,1,0,76.14,66.03 ,33.33
03,003,01,006,0184,410 ,838,6,844,1165,0,3,1,3,0,1,0,76.14,72.45 ,33.33
03,003,01,006,0184,411 ,798,13,811,1222,0,3,1,3,0,1,0,76.14,66.37 ,33.33
03,003,01,006,0185,412 ,733,12,745,1012,0,3,1,3,0,1,0,76.14,73.62 ,33.33
03,003,01,006,0186,413 ,574,19,593,898,0,3,1,3,0,1,0,76.14,66.04 ,33.33
03,003,01,006,0187,414 ,708,11,719,995,0,3,1,3,0,1,0,76.14,72.26 ,33.33
03,003,01,006,0188,415 ,696,8,704,971,0,3,1,3,0,1,0,76.14,72.50 ,33.33
03,003,01,006,0188,416 ,394,8,402,574,0,3,1,3,0,1,0,76.14,70.03 ,33.33
03,003,01,006,0189,417 ,657,6,663,958,0,3,1,3,0,1,0,76.14,69.21 ,33.33
03,003,01,006,0189,418 ,650,7,657,945,0,3,1,3,0,1,0,76.14,69.52 ,33.33
03,003,01,006,0189,419 ,508,1,509,730,0,3,1,3,0,1,0,76.14,69.73 ,33.33
03,003,01,006,0190,420 ,730,13,743,1152,0,3,1,3,0,1,0,76.14,64.50 ,33.33
03,003,01,006,0190,421 ,681,16,697,958,0,3,1,3,0,1,0,76.14,72.76 ,33.33
03,003,01,006,0191,422 ,604,12,616,916,0,3,1,3,0,1,0,76.14,67.25 ,33.33
03,003,01,006,0192,423 ,434,9,443,655,0,3,1,3,0,1,0,76.14,67.63 ,33.33
03,003,01,006,0192,424 ,173,3,176,285,0,3,1,3,0,1,0,76.14,61.75 ,33.33
03,003,01,006,0193,425 ,593,10,603,794,0,3,1,3,0,1,0,76.14,75.94 ,33.33
03,003,01,006,0193,426 ,512,13,525,748,0,3,1,3,0,1,0,76.14,70.19 ,33.33
03,003,01,006,0194,427 ,966,15,981,1388,0,3,1,3,0,1,0,76.14,70.68 ,33.33
03,003,01,006,0194,428 ,454,10,464,653,0,3,1,3,0,1,0,76.14,71.06 ,33.33
03,003,01,006,0195,429 ,984,16,1000,1492,0,3,1,3,0,1,0,76.14,67.02 ,33.33
03,003,01,006,0195,430 ,592,10,602,860,0,3,1,3,0,1,0,76.14,70.00 ,33.33
03,003,01,006,0196,431 ,580,7,587,821,0,3,1,3,0,1,0,76.14,71.50 ,33.33
03,003,01,006,0197,432 ,681,8,689,951,0,3,1,3,0,1,0,76.14,72.45 ,33.33
03,003,01,006,0197,433 ,602,17,619,832,0,3,1,3,0,1,0,76.14,74.40 ,33.33
03,003,01,006,0197,434 ,634,14,648,858,0,3,1,3,0,1,0,76.14,75.52 ,33.33
03,003,01,006,0198,435 ,488,6,494,805,0,3,1,3,0,1,0,76.14,61.37 ,33.33
03,003,01,006,0198,436 ,737,16,753,1123,0,3,1,3,0,1,0,76.14,67.05 ,33.33
03,003,01,006,0199,437 ,778,11,789,1065,0,3,1,3,0,1,0,76.14,74.08 ,33.33
03,003,01,006,0199,438 ,440,3,443,705,0,3,1,3,0,1,0,76.14,62.84 ,33.33
03,003,01,006,0200,439 ,997,11,1008,1347,0,3,1,3,0,1,0,76.14,74.83 ,33.33
03,003,01,006,0200,440 ,826,10,836,1188,0,3,1,3,0,1,0,76.14,70.37 ,33.33
03,003,01,006,0201,441 ,819,15,834,1191,0,3,1,3,0,1,0,76.14,70.03 ,33.33
03,003,01,006,0201,442 ,629,9,638,951,0,3,1,3,0,1,0,76.14,67.09 ,33.33
03,003,01,006,0201,443 ,466,10,476,677,0,3,1,3,0,1,0,76.14,70.31 ,33.33
03,003,01,006,0202,444 ,805,11,816,1175,0,3,1,3,0,1,0,76.14,69.45 ,33.33
03,003,01,006,0202,445 ,958,17,975,1399,0,3,1,3,0,1,0,76.14,69.69 ,33.33
03,003,01,006,0202,446 ,831,14,845,1191,0,3,1,3,0,1,0,76.14,70.95 ,33.33
03,003,01,006,0203,447 ,770,11,781,1127,0,3,1,3,0,1,0,76.14,69.30 ,33.33
03,003,01,006,0204,448 ,492,9,501,799,0,3,1,3,0,1,0,76.14,62.70 ,33.33
03,003,01,006,0204,449 ,635,13,648,941,0,3,1,3,0,1,0,76.14,68.86 ,33.33
03,003,01,006,0205,450 ,1028,22,1050,1514,0,3,1,3,0,1,0,76.14,69.35 ,33.33
03,003,01,006,0205,451 ,932,10,942,1349,0,3,1,3,0,1,0,76.14,69.83 ,33.33
03,003,01,006,0206,452 ,683,7,690,1010,0,3,1,3,0,1,0,76.14,68.32 ,33.33
03,003,01,006,0206,453 ,638,10,648,942,0,3,1,3,0,1,0,76.14,68.79 ,33.33
03,003,01,006,0206,454 ,683,7,690,970,0,3,1,3,0,1,0,76.14,71.13 ,33.33
03,003,01,007,0207,455 ,779,18,797,1168,0,3,1,3,0,1,0,76.14,68.24 ,33.33
03,003,01,007,0208,456 ,451,5,456,638,0,3,1,3,0,1,0,76.14,71.47 ,33.33
03,003,01,007,0209,457 ,30,2,32,45,0,3,1,3,0,1,0,76.14,71.11 ,33.33
03,003,01,007,0210,458 ,29,1,30,45,0,3,1,3,0,1,0,76.14,66.67 ,33.33
03,003,01,007,0211,459 ,191,3,194,310,0,3,1,3,0,1,0,76.14,62.58 ,33.33
03,003,01,007,0212,460 ,19,0,19,43,0,3,1,3,0,1,0,76.14,44.19 ,33.33
03,003,01,007,0213,461 ,62,2,64,95,0,3,1,3,0,1,0,76.14,67.37 ,33.33
03,003,01,007,0214,462 ,27,1,28,50,0,3,1,3,0,1,0,76.14,56.00 ,33.33
03,003,01,007,0215,463 ,22,0,22,46,0,3,1,3,0,1,0,76.14,47.83 ,33.33
03,003,01,007,0216,464 ,158,2,160,301,0,3,1,3,0,1,0,76.14,53.16 ,33.33
03,003,01,008,0217,465 ,952,11,963,1510,0,3,1,3,0,1,0,76.14,63.77 ,33.33
03,003,01,008,0217,466 ,963,12,975,1480,0,3,1,3,0,1,0,76.14,65.88 ,33.33
03,003,01,008,0218,467 ,1089,18,1107,1613,0,3,1,3,0,1,0,76.14,68.63 ,33.33
03,003,01,008,0218,468 ,1067,7,1074,1532,0,3,1,3,0,1,0,76.14,70.10 ,33.33
03,003,01,008,0219,469 ,724,10,734,1084,0,3,1,3,0,1,0,76.14,67.71 ,33.33
03,003,01,008,0219,470 ,1050,15,1065,1537,0,3,1,3,0,1,0,76.14,69.29 ,33.33
03,003,01,008,0219,471 ,874,14,888,1426,0,3,1,3,0,1,0,76.14,62.27 ,33.33
03,003,01,008,0220,472 ,813,14,827,1151,0,3,1,3,0,1,0,76.14,71.85 ,33.33
03,003,01,008,0220,473 ,732,8,740,1082,0,3,1,3,0,1,0,76.14,68.39 ,33.33
03,003,01,008,0220,474 ,793,11,804,1140,0,3,1,3,0,1,0,76.14,70.53 ,33.33
03,003,01,008,0221,475 ,1025,15,1040,1419,0,3,1,3,0,1,0,76.14,73.29 ,33.33
03,003,01,008,0221,476 ,925,16,941,1325,0,3,1,3,0,1,0,76.14,71.02 ,33.33
03,003,01,008,0222,477 ,902,14,916,1289,0,3,1,3,0,1,0,76.14,71.06 ,33.33
03,003,01,008,0222,478 ,799,11,810,1137,0,3,1,3,0,1,0,76.14,71.24 ,33.33
03,003,01,008,0222,479 ,871,15,886,1269,0,3,1,3,0,1,0,76.14,69.82 ,33.33
03,003,01,008,0223,480 ,924,8,932,1330,0,3,1,3,0,1,0,76.14,70.08 ,33.33
03,003,01,008,0223,481 ,982,29,1011,1387,0,3,1,3,0,1,0,76.14,72.89 ,33.33
03,003,01,008,0223,482 ,955,19,974,1334,0,3,1,3,0,1,0,76.14,73.01 ,33.33
03,003,01,008,0224,483 ,937,14,951,1382,0,3,1,3,0,1,0,76.14,68.81 ,33.33
03,003,01,008,0224,484 ,995,24,1019,1398,0,3,1,3,0,1,0,76.14,72.89 ,33.33
03,003,01,008,0224,485 ,1074,33,1107,1555,0,3,1,3,0,1,0,76.14,71.19 ,33.33
03,003,01,008,0225,486 ,989,12,1001,1357,0,3,1,3,0,1,0,76.14,73.77 ,33.33
03,003,01,008,0225,487 ,1062,24,1086,1489,0,3,1,3,0,1,0,76.14,72.93 ,33.33
03,003,01,008,0226,488 ,798,12,810,1065,0,3,1,3,0,1,0,76.14,76.06 ,33.33
03,003,01,008,0226,489 ,953,17,970,1331,0,3,1,3,0,1,0,76.14,72.88 ,33.33
03,003,01,008,0227,490 ,814,10,824,1168,0,3,1,3,0,1,0,76.14,70.55 ,33.33
03,003,01,008,0227,491 ,888,17,905,1271,0,3,1,3,0,1,0,76.14,71.20 ,33.33
03,003,01,008,0227,492 ,597,10,607,820,0,3,1,3,0,1,0,76.14,74.02 ,33.33
03,003,01,008,0228,493 ,747,8,755,1089,0,3,1,3,0,1,0,76.14,69.33 ,33.33
03,003,01,008,0228,494 ,817,14,831,1130,0,3,1,3,0,1,0,76.14,73.54 ,33.33
03,003,01,008,0228,495 ,846,17,863,1313,0,3,1,3,0,1,0,76.14,65.73 ,33.33
03,003,01,008,0229,496 ,775,10,785,1109,0,3,1,3,0,1,0,76.14,70.78 ,33.33
03,003,01,008,0229,497 ,865,12,877,1234,0,3,1,3,0,1,0,76.14,71.07 ,33.33
03,003,01,008,0229,498 ,974,22,996,1411,0,3,1,3,0,1,0,76.14,70.59 ,33.33
03,003,01,008,0230,499 ,924,17,941,1305,0,3,1,3,0,1,0,76.14,72.11 ,33.33
03,003,01,008,0230,500 ,1232,20,1252,1852,0,3,1,3,0,1,0,76.14,67.60 ,33.33
03,003,01,008,0230,501 ,884,13,897,1293,0,3,1,3,0,1,0,76.14,69.37 ,33.33
03,003,01,008,0231,502 ,864,16,880,1268,0,3,1,3,0,1,0,76.14,69.40 ,33.33
03,003,01,008,0231,503 ,895,11,906,1306,0,3,1,3,0,1,0,76.14,69.37 ,33.33
03,003,01,008,0232,504 ,1060,14,1074,1458,0,3,1,3,0,1,0,76.14,73.66 ,33.33
03,003,01,008,0232,505 ,917,17,934,1295,0,3,1,3,0,1,0,76.14,72.12 ,33.33
03,003,01,008,0233,506 ,856,22,878,1196,0,3,1,3,0,1,0,76.14,73.41 ,33.33
03,003,01,008,0233,507 ,718,17,735,1085,0,3,1,3,0,1,0,76.14,67.74 ,33.33
03,003,01,008,0233,508 ,599,16,615,846,0,3,1,3,0,1,0,76.14,72.70 ,33.33
03,003,01,008,0233,509 ,617,12,629,898,0,3,1,3,0,1,0,76.14,70.04 ,33.33
03,003,01,008,0234,510 ,706,12,718,1056,0,3,1,3,0,1,0,76.14,67.99 ,33.33
03,003,01,008,0234,511 ,678,10,688,1033,0,3,1,3,0,1,0,76.14,66.60 ,33.33
03,003,01,008,0234,512 ,654,14,668,1016,0,3,1,3,0,1,0,76.14,65.75 ,33.33
03,003,01,008,0235,513 ,788,9,797,1211,0,3,1,3,0,1,0,76.14,65.81 ,33.33
03,003,01,008,0235,514 ,692,7,699,1117,0,3,1,3,0,1,0,76.14,62.58 ,33.33
03,003,01,008,0236,515 ,1083,10,1093,1472,0,3,1,3,0,1,0,76.14,74.25 ,33.33
03,003,01,008,0236,516 ,898,13,911,1251,0,3,1,3,0,1,0,76.14,72.82 ,33.33
03,003,01,008,0237,517 ,930,9,939,1267,0,3,1,3,0,1,0,76.14,74.11 ,33.33
03,003,01,008,0237,518 ,1132,13,1145,1643,0,3,1,3,0,1,0,76.14,69.69 ,33.33
03,003,01,008,0238,519 ,1185,15,1200,1724,0,3,1,3,0,1,0,76.14,69.61 ,33.33
03,003,01,008,0238,520 ,1012,18,1030,1458,0,3,1,3,0,1,0,76.14,70.64 ,33.33
03,003,01,008,0239,521 ,813,11,824,1145,0,3,1,3,0,1,0,76.14,71.97 ,33.33
03,003,01,008,0239,522 ,818,10,828,1106,0,3,1,3,0,1,0,76.14,74.86 ,33.33
03,003,01,008,0240,523 ,662,10,672,936,0,3,1,3,0,1,0,76.14,71.79 ,33.33
03,003,01,008,0240,524 ,556,11,567,847,0,3,1,3,0,1,0,76.14,66.94 ,33.33
03,003,01,008,0241,525 ,686,10,696,971,0,3,1,3,0,1,0,76.14,71.68 ,33.33
03,003,01,008,0241,526 ,821,8,829,1214,0,3,1,3,0,1,0,76.14,68.29 ,33.33
03,003,01,008,0242,527 ,919,12,931,1370,0,3,1,3,0,1,0,76.14,67.96 ,33.33
03,003,01,008,0242,528 ,632,15,647,955,0,3,1,3,0,1,0,76.14,67.75 ,33.33
03,003,01,008,0243,529 ,1013,15,1028,1476,0,3,1,3,0,1,0,76.14,69.65 ,33.33
03,003,01,008,0244,530 ,910,10,920,1255,0,3,1,3,0,1,0,76.14,73.31 ,33.33
03,003,01,008,0244,531 ,768,12,780,1180,0,3,1,3,0,1,0,76.14,66.10 ,33.33
03,003,01,008,0244,532 ,865,10,875,1209,0,3,1,3,0,1,0,76.14,72.37 ,33.33
03,003,01,008,0245,533 ,1101,17,1118,1675,0,3,1,3,0,1,0,76.14,66.75 ,33.33
03,003,01,008,0245,534 ,1148,14,1162,1673,0,3,1,3,0,1,0,76.14,69.46 ,33.33
03,003,01,008,0246,535 ,829,10,839,1250,0,3,1,3,0,1,0,76.14,67.12 ,33.33
03,003,01,008,0246,536 ,970,17,987,1503,0,3,1,3,0,1,0,76.14,65.67 ,33.33
03,003,01,008,0246,537 ,1065,15,1080,1642,0,3,1,3,0,1,0,76.14,65.77 ,33.33
03,003,01,008,0247,538 ,1067,14,1081,1572,0,3,1,3,0,1,0,76.14,68.77 ,33.33
03,003,01,008,0248,539 ,893,10,903,1293,0,3,1,3,0,1,0,76.14,69.84 ,33.33
03,003,01,008,0248,540 ,762,8,770,1181,0,3,1,3,0,1,0,76.14,65.20 ,33.33
03,003,01,008,0249,541 ,931,14,945,1340,0,3,1,3,0,1,0,76.14,70.52 ,33.33
03,003,01,008,0249,542 ,960,11,971,1371,0,3,1,3,0,1,0,76.14,70.82 ,33.33
03,003,01,008,0249,543 ,1182,18,1200,1843,0,3,1,3,0,1,0,76.14,65.11 ,33.33
03,003,01,008,0250,544 ,825,13,838,1222,0,3,1,3,0,1,0,76.14,68.58 ,33.33
03,003,01,008,0250,545 ,793,14,807,1184,0,3,1,3,0,1,0,76.14,68.16 ,33.33
03,003,01,008,0251,546 ,843,12,855,1206,0,3,1,3,0,1,0,76.14,70.90 ,33.33
03,003,01,008,0251,547 ,1031,9,1040,1555,0,3,1,3,0,1,0,76.14,66.88 ,33.33
03,003,01,008,0252,548 ,890,7,897,1223,0,3,1,3,0,1,0,76.14,73.34 ,33.33
03,003,01,008,0252,549 ,849,14,863,1238,0,3,1,3,0,1,0,76.14,69.71 ,33.33
03,003,01,008,0253,550 ,749,14,763,1016,0,3,1,3,0,1,0,76.14,75.10 ,33.33
03,003,01,008,0253,551 ,745,9,754,1050,0,3,1,3,0,1,0,76.14,71.81 ,33.33
03,003,01,008,0253,552 ,1040,21,1061,1531,0,3,1,3,0,1,0,76.14,69.30 ,33.33
03,003,01,008,0254,553 ,679,9,688,950,0,3,1,3,0,1,0,76.14,72.42 ,33.33
03,003,01,008,0254,554 ,658,16,674,995,0,3,1,3,0,1,0,76.14,67.74 ,33.33
03,003,01,008,0255,555 ,768,11,779,1131,0,3,1,3,0,1,0,76.14,68.88 ,33.33
03,003,01,008,0255,556 ,718,8,726,1103,0,3,1,3,0,1,0,76.14,65.82 ,33.33
03,003,01,008,0255,557 ,1130,17,1147,1806,0,3,1,3,0,1,0,76.14,63.51 ,33.33
03,003,01,008,0256,558 ,1169,16,1185,1661,0,3,1,3,0,1,0,76.14,71.34 ,33.33
03,003,01,008,0256,559 ,1185,16,1201,1647,0,3,1,3,0,1,0,76.14,72.92 ,33.33
03,003,01,008,0257,560 ,1035,13,1048,1483,0,3,1,3,0,1,0,76.14,70.67 ,33.33
03,003,01,008,0257,561 ,1180,16,1196,1709,0,3,1,3,0,1,0,76.14,69.98 ,33.33
03,003,01,008,0257,562 ,843,18,861,1285,0,3,1,3,0,1,0,76.14,67.00 ,33.33
03,003,01,008,0258,563 ,631,13,644,921,0,3,1,3,0,1,0,76.14,69.92 ,33.33
03,003,01,008,0258,564 ,671,11,682,963,0,3,1,3,0,1,0,76.14,70.82 ,33.33
03,003,01,008,0259,565 ,1175,18,1193,1652,0,3,1,3,0,1,0,76.14,72.22 ,33.33
03,003,01,008,0259,566 ,988,7,995,1425,0,3,1,3,0,1,0,76.14,69.82 ,33.33
03,003,01,008,0260,567 ,644,7,651,1022,0,3,1,3,0,1,0,76.14,63.70 ,33.33
03,003,01,008,0260,568 ,502,7,509,1001,0,3,1,3,0,1,0,76.14,50.85 ,33.33
03,003,01,008,0261,569 ,890,11,901,1314,0,3,1,3,0,1,0,76.14,68.57 ,33.33
03,003,01,008,0261,570 ,602,9,611,930,0,3,1,3,0,1,0,76.14,65.70 ,33.33
03,003,01,008,0261,571 ,784,7,791,1068,0,3,1,3,0,1,0,76.14,74.06 ,33.33
03,003,01,008,0262,572 ,977,19,996,1463,0,3,1,3,0,1,0,76.14,68.08 ,33.33
03,003,01,008,0262,573 ,798,10,808,1177,0,3,1,3,0,1,0,76.14,68.65 ,33.33
03,003,01,008,0262,574 ,1054,16,1070,1587,0,3,1,3,0,1,0,76.14,67.42 ,33.33
03,003,01,008,0262,575 ,918,12,930,1389,0,3,1,3,0,1,0,76.14,66.95 ,33.33
03,003,01,008,0263,576 ,972,20,992,1496,0,3,1,3,0,1,0,76.14,66.31 ,33.33
03,003,01,008,0263,577 ,978,7,985,1346,0,3,1,3,0,1,0,76.14,73.18 ,33.33
03,003,01,008,0263,578 ,696,8,704,949,0,3,1,3,0,1,0,76.14,74.18 ,33.33
03,003,01,008,0264,579 ,921,14,935,1358,0,3,1,3,0,1,0,76.14,68.85 ,33.33
03,003,01,008,0264,580 ,984,12,996,1471,0,3,1,3,0,1,0,76.14,67.71 ,33.33
03,003,01,008,0264,581 ,886,13,899,1279,0,3,1,3,0,1,0,76.14,70.29 ,33.33
03,003,01,008,0264,582 ,803,14,817,1119,0,3,1,3,0,1,0,76.14,73.01 ,33.33
03,003,01,008,0265,583 ,913,11,924,1289,0,3,1,3,0,1,0,76.14,71.68 ,33.33
03,003,01,008,0265,584 ,892,14,906,1306,0,3,1,3,0,1,0,76.14,69.37 ,33.33
03,003,01,008,0265,585 ,1585,17,1602,2273,0,3,1,3,0,1,0,76.14,70.48 ,33.33
03,003,01,008,0266,586 ,805,15,820,1146,0,3,1,3,0,1,0,76.14,71.55 ,33.33
03,003,01,008,0266,587 ,811,14,825,1057,0,3,1,3,0,1,0,76.14,78.05 ,33.33
03,003,01,008,0266,588 ,936,17,953,1339,0,3,1,3,0,1,0,76.14,71.17 ,33.33
03,003,01,008,0266,589 ,958,15,973,1476,0,3,1,3,0,1,0,76.14,65.92 ,33.33
03,003,01,008,0267,590 ,860,8,868,1264,0,3,1,3,0,1,0,76.14,68.67 ,33.33
03,003,01,008,0267,591 ,821,6,827,1269,0,3,1,3,0,1,0,76.14,65.17 ,33.33
03,003,01,008,0267,592 ,885,10,895,1373,0,3,1,3,0,1,0,76.14,65.19 ,33.33
03,003,01,008,0268,593 ,575,9,584,844,0,3,1,3,0,1,0,76.14,69.19 ,33.33
03,003,01,008,0268,594 ,1017,10,1027,1481,0,3,1,3,0,1,0,76.14,69.35 ,33.33
03,003,01,008,0268,595 ,1115,11,1126,1667,0,3,1,3,0,1,0,76.14,67.55 ,33.33
03,003,01,008,0269,596 ,762,9,771,1088,0,3,1,3,0,1,0,76.14,70.86 ,33.33
03,003,01,008,0270,597 ,1251,6,1257,1858,0,3,1,3,0,1,0,76.14,67.65 ,33.33
03,003,01,008,0271,598 ,1091,8,1099,1640,0,3,1,3,0,1,0,76.14,67.01 ,33.33
03,003,01,008,0272,599 ,883,6,889,1338,0,3,1,3,0,1,0,76.14,66.44 ,33.33
03,003,01,008,0272,600 ,1091,19,1110,1519,0,3,1,3,0,1,0,76.14,73.07 ,33.33
03,003,01,008,0272,601 ,1113,11,1124,1642,0,3,1,3,0,1,0,76.14,68.45 ,33.33
03,003,01,008,0273,602 ,768,6,774,1067,0,3,1,3,0,1,0,76.14,72.54 ,33.33
03,003,01,008,0273,603 ,979,10,989,1389,0,3,1,3,0,1,0,76.14,71.20 ,33.33
03,003,01,008,0274,604 ,707,16,723,1014,0,3,1,3,0,1,0,76.14,71.30 ,33.33
03,003,01,008,0275,605 ,590,6,596,838,0,3,1,3,0,1,0,76.14,71.12 ,33.33
03,003,01,008,0276,606 ,654,5,659,996,0,3,1,3,0,1,0,76.14,66.16 ,33.33
03,003,01,008,0277,607 ,715,6,721,1100,0,3,1,3,0,1,0,76.14,65.55 ,33.33
03,003,01,008,0278,608 ,839,8,847,1161,0,3,1,3,0,1,0,76.14,72.95 ,33.33
03,003,01,008,0278,609 ,681,10,691,966,0,3,1,3,0,1,0,76.14,71.53 ,33.33
03,003,01,008,0279,610 ,699,12,711,1001,0,3,1,3,0,1,0,76.14,71.03 ,33.33
03,003,01,008,0279,611 ,777,12,789,1100,0,3,1,3,0,1,0,76.14,71.73 ,33.33
03,003,01,008,0279,612 ,995,13,1008,1429,0,3,1,3,0,1,0,76.14,70.54 ,33.33
03,003,01,008,0280,613 ,843,16,859,1302,0,3,1,3,0,1,0,76.14,65.98 ,33.33
03,003,01,008,0280,614 ,1024,9,1033,1471,0,3,1,3,0,1,0,76.14,70.22 ,33.33
03,003,01,008,0280,615 ,1070,12,1082,1546,0,3,1,3,0,1,0,76.14,69.99 ,33.33
03,003,01,008,0281,616 ,927,13,940,1323,0,3,1,3,0,1,0,76.14,71.05 ,33.33
03,003,01,008,0281,617 ,1272,13,1285,1860,0,3,1,3,0,1,0,76.14,69.09 ,33.33
03,003,01,008,0282,618 ,878,16,894,1247,0,3,1,3,0,1,0,76.14,71.69 ,33.33
03,003,01,008,0282,619 ,869,18,887,1254,0,3,1,3,0,1,0,76.14,70.73 ,33.33
03,003,01,008,0283,620 ,705,17,722,1132,0,3,1,3,0,1,0,76.14,63.78 ,33.33
03,003,01,008,0283,621 ,939,13,952,1376,0,3,1,3,0,1,0,76.14,69.19 ,33.33
03,003,01,008,0283,622 ,960,14,974,1422,0,3,1,3,0,1,0,76.14,68.50 ,33.33
03,003,01,008,0284,623 ,1178,15,1193,1731,0,3,1,3,0,1,0,76.14,68.92 ,33.33
03,003,01,008,0284,624 ,1004,10,1014,1482,0,3,1,3,0,1,0,76.14,68.42 ,33.33
03,003,01,008,0285,625 ,597,8,605,812,0,3,1,3,0,1,0,76.14,74.51 ,33.33
03,003,01,008,0285,626 ,808,13,821,1149,0,3,1,3,0,1,0,76.14,71.45 ,33.33
03,003,01,008,0286,627 ,818,12,830,1216,0,3,1,3,0,1,0,76.14,68.26 ,33.33
03,003,01,008,0287,628 ,1185,13,1198,1771,0,3,1,3,0,1,0,76.14,67.65 ,33.33
03,003,01,008,0287,629 ,1156,9,1165,1624,0,3,1,3,0,1,0,76.14,71.74 ,33.33
03,003,01,008,0288,630 ,1166,13,1179,1567,0,3,1,3,0,1,0,76.14,75.24 ,33.33
03,003,01,008,0288,631 ,1006,16,1022,1420,0,3,1,3,0,1,0,76.14,71.97 ,33.33
03,003,01,008,0289,632 ,918,22,940,1309,0,3,1,3,0,1,0,76.14,71.81 ,33.33
03,003,01,008,0289,633 ,1038,16,1054,1428,0,3,1,3,0,1,0,76.14,73.81 ,33.33
03,003,01,008,0290,634 ,882,13,895,1179,0,3,1,3,0,1,0,76.14,75.91 ,33.33
03,003,01,008,0290,635 ,829,7,836,1143,0,3,1,3,0,1,0,76.14,73.14 ,33.33
03,003,01,009,0291,636 ,1056,19,1075,1590,0,3,1,3,0,1,0,76.14,67.61 ,33.33
03,003,01,009,0291,637 ,1244,20,1264,1782,0,3,1,3,0,1,0,76.14,70.93 ,33.33
03,003,01,009,0292,638 ,853,12,865,1230,0,3,1,3,0,1,0,76.14,70.33 ,33.33
03,003,01,009,0292,639 ,954,13,967,1445,0,3,1,3,0,1,0,76.14,66.92 ,33.33
03,003,01,009,0292,640 ,680,13,693,1074,0,3,1,3,0,1,0,76.14,64.53 ,33.33
03,003,01,009,0293,641 ,789,12,801,1185,0,3,1,3,0,1,0,76.14,67.59 ,33.33
03,003,01,009,0293,642 ,1247,14,1261,1908,0,3,1,3,0,1,0,76.14,66.09 ,33.33
03,003,01,009,0293,643 ,1108,8,1116,1631,0,3,1,3,0,1,0,76.14,68.42 ,33.33
03,003,01,009,0294,644 ,926,16,942,1365,0,3,1,3,0,1,0,76.14,69.01 ,33.33
03,003,01,009,0294,645 ,858,10,868,1158,0,3,1,3,0,1,0,76.14,74.96 ,33.33
03,003,01,009,0295,646 ,1116,13,1129,1574,0,3,1,3,0,1,0,76.14,71.73 ,33.33
03,003,01,009,0296,647 ,821,15,836,1206,0,3,1,3,0,1,0,76.14,69.32 ,33.33
03,003,01,009,0296,648 ,743,14,757,1079,0,3,1,3,0,1,0,76.14,70.16 ,33.33
03,003,01,009,0297,649 ,870,12,882,1280,0,3,1,3,0,1,0,76.14,68.91 ,33.33
03,003,01,009,0297,650 ,668,13,681,937,0,3,1,3,0,1,0,76.14,72.68 ,33.33
03,003,01,009,0298,651 ,1166,17,1183,1597,0,3,1,3,0,1,0,76.14,74.08 ,33.33
03,003,01,009,0299,652 ,655,7,662,899,0,3,1,3,0,1,0,76.14,73.64 ,33.33
03,003,01,009,0299,653 ,792,10,802,1136,0,3,1,3,0,1,0,76.14,70.60 ,33.33
03,003,01,009,0299,654 ,971,19,990,1427,0,3,1,3,0,1,0,76.14,69.38 ,33.33
03,003,01,009,0300,655 ,940,16,956,1335,0,3,1,3,0,1,0,76.14,71.61 ,33.33
03,003,01,009,0300,656 ,1077,21,1098,1543,0,3,1,3,0,1,0,76.14,71.16 ,33.33
03,003,01,009,0301,657 ,1142,17,1159,1679,0,3,1,3,0,1,0,76.14,69.03 ,33.33
03,003,01,009,0301,658 ,912,13,925,1263,0,3,1,3,0,1,0,76.14,73.24 ,33.33
03,003,01,009,0302,659 ,692,12,704,1049,0,3,1,3,0,1,0,76.14,67.11 ,33.33
03,003,01,009,0302,660 ,1001,20,1021,1471,0,3,1,3,0,1,0,76.14,69.41 ,33.33
03,003,01,009,0303,661 ,1066,15,1081,1506,0,3,1,3,0,1,0,76.14,71.78 ,33.33
03,003,01,009,0303,662 ,1081,9,1090,1537,0,3,1,3,0,1,0,76.14,70.92 ,33.33
03,003,01,009,0304,663 ,730,13,743,1066,0,3,1,3,0,1,0,76.14,69.70 ,33.33
03,003,01,009,0304,664 ,767,19,786,1091,0,3,1,3,0,1,0,76.14,72.04 ,33.33
03,003,01,009,0305,665 ,893,26,919,1282,0,3,1,3,0,1,0,76.14,71.68 ,33.33
03,003,01,009,0306,666 ,899,16,915,1264,0,3,1,3,0,1,0,76.14,72.39 ,33.33
03,003,01,009,0307,667 ,972,7,979,1285,0,3,1,3,0,1,0,76.14,76.19 ,33.33
03,003,01,009,0307,668 ,683,8,691,938,0,3,1,3,0,1,0,76.14,73.67 ,33.33
03,003,01,009,0308,669 ,826,19,845,1212,0,3,1,3,0,1,0,76.14,69.72 ,33.33
03,003,01,009,0308,670 ,740,13,753,1085,0,3,1,3,0,1,0,76.14,69.40 ,33.33
03,003,01,009,0308,671 ,706,13,719,980,0,3,1,3,0,1,0,76.14,73.37 ,33.33
03,003,01,009,0309,672 ,1124,16,1140,1625,0,3,1,3,0,1,0,76.14,70.15 ,33.33
03,003,01,009,0309,673 ,1033,11,1044,1428,0,3,1,3,0,1,0,76.14,73.11 ,33.33
03,003,01,009,0310,674 ,927,17,944,1418,0,3,1,3,0,1,0,76.14,66.57 ,33.33
03,003,01,009,0310,675 ,960,13,973,1391,0,3,1,3,0,1,0,76.14,69.95 ,33.33
03,003,01,009,0311,676 ,783,18,801,1073,0,3,1,3,0,1,0,76.14,74.65 ,33.33
03,003,01,009,0311,677 ,724,13,737,1072,0,3,1,3,0,1,0,76.14,68.75 ,33.33
03,003,01,009,0312,678 ,909,15,924,1296,0,3,1,3,0,1,0,76.14,71.30 ,33.33
03,003,01,009,0312,679 ,883,16,899,1214,0,3,1,3,0,1,0,76.14,74.05 ,33.33
03,003,01,009,0312,680 ,764,16,780,1173,0,3,1,3,0,1,0,76.14,66.50 ,33.33
03,003,01,009,0313,681 ,941,20,961,1326,0,3,1,3,0,1,0,76.14,72.47 ,33.33
03,003,01,009,0313,682 ,892,15,907,1248,0,3,1,3,0,1,0,76.14,72.68 ,33.33
03,003,01,009,0313,683 ,862,14,876,1301,0,3,1,3,0,1,0,76.14,67.33 ,33.33
03,003,01,009,0314,684 ,568,12,580,799,0,3,1,3,0,1,0,76.14,72.59 ,33.33
03,003,01,009,0314,685 ,805,8,813,1143,0,3,1,3,0,1,0,76.14,71.13 ,33.33
03,003,01,009,0315,686 ,755,10,765,1084,0,3,1,3,0,1,0,76.14,70.57 ,33.33
03,003,01,009,0315,687 ,818,18,836,1125,0,3,1,3,0,1,0,76.14,74.31 ,33.33
03,003,01,009,0316,688 ,936,16,952,1365,0,3,1,3,0,1,0,76.14,69.74 ,33.33
03,003,01,009,0317,689 ,1026,10,1036,1435,0,3,1,3,0,1,0,76.14,72.20 ,33.33
03,003,01,009,0317,690 ,979,15,994,1477,0,3,1,3,0,1,0,76.14,67.30 ,33.33
03,003,01,009,0317,691 ,1030,12,1042,1457,0,3,1,3,0,1,0,76.14,71.52 ,33.33
03,003,01,009,0318,692 ,832,22,854,1277,0,3,1,3,0,1,0,76.14,66.88 ,33.33
03,003,01,009,0318,693 ,953,26,979,1452,0,3,1,3,0,1,0,76.14,67.42 ,33.33
03,003,01,009,0319,694 ,811,13,824,1166,0,3,1,3,0,1,0,76.14,70.67 ,33.33
03,003,01,009,0319,695 ,915,13,928,1352,0,3,1,3,0,1,0,76.14,68.64 ,33.33
03,003,01,009,0319,696 ,777,9,786,1177,0,3,1,3,0,1,0,76.14,66.78 ,33.33
03,003,01,009,0320,697 ,934,14,948,1414,0,3,1,3,0,1,0,76.14,67.04 ,33.33
03,003,01,009,0320,698 ,1082,15,1097,1538,0,3,1,3,0,1,0,76.14,71.33 ,33.33
03,003,01,009,0321,699 ,1087,9,1096,1559,0,3,1,3,0,1,0,76.14,70.30 ,33.33
03,003,01,009,0321,700 ,1132,15,1147,1671,0,3,1,3,0,1,0,76.14,68.64 ,33.33
03,003,01,009,0321,701 ,1009,10,1019,1530,0,3,1,3,0,1,0,76.14,66.60 ,33.33
03,003,01,009,0321,702 ,854,13,867,1209,0,3,1,3,0,1,0,76.14,71.71 ,33.33
03,003,01,009,0322,703 ,1201,14,1215,1690,0,3,1,3,0,1,0,76.14,71.89 ,33.33
03,003,01,009,0322,704 ,1112,19,1131,1602,0,3,1,3,0,1,0,76.14,70.60 ,33.33
03,003,01,009,0322,705 ,991,16,1007,1394,0,3,1,3,0,1,0,76.14,72.24 ,33.33
03,003,01,009,0323,706 ,1032,19,1051,1531,0,3,1,3,0,1,0,76.14,68.65 ,33.33
03,003,01,009,0323,707 ,1055,7,1062,1652,0,3,1,3,0,1,0,76.14,64.29 ,33.33
03,003,01,009,0324,708 ,902,15,917,1385,0,3,1,3,0,1,0,76.14,66.21 ,33.33
03,003,01,009,0324,709 ,1076,18,1094,1692,0,3,1,3,0,1,0,76.14,64.66 ,33.33
03,003,01,009,0324,710 ,1186,28,1214,2007,0,3,1,3,0,1,0,76.14,60.49 ,33.33
03,003,01,009,0325,711 ,734,14,748,1113,0,3,1,3,0,1,0,76.14,67.21 ,33.33
03,003,01,009,0325,712 ,693,16,709,1076,0,3,1,3,0,1,0,76.14,65.89 ,33.33
03,003,01,009,0325,713 ,774,14,788,1222,0,3,1,3,0,1,0,76.14,64.48 ,33.33
03,003,01,009,0326,714 ,972,15,987,1338,0,3,1,3,0,1,0,76.14,73.77 ,33.33
03,003,01,009,0326,715 ,819,8,827,1187,0,3,1,3,0,1,0,76.14,69.67 ,33.33
03,003,01,009,0326,716 ,699,26,725,1076,0,3,1,3,0,1,0,76.14,67.38 ,33.33
03,003,01,009,0327,717 ,821,19,840,1153,0,3,1,3,0,1,0,76.14,72.85 ,33.33
03,003,01,009,0327,718 ,1026,11,1037,1480,0,3,1,3,0,1,0,76.14,70.07 ,33.33
03,003,01,009,0328,719 ,617,14,631,950,0,3,1,3,0,1,0,76.14,66.42 ,33.33
03,003,01,009,0328,720 ,838,18,856,1197,0,3,1,3,0,1,0,76.14,71.51 ,33.33
03,003,01,009,0328,721 ,697,12,709,978,0,3,1,3,0,1,0,76.14,72.49 ,33.33
03,003,01,009,0329,722 ,817,12,829,1164,0,3,1,3,0,1,0,76.14,71.22 ,33.33
03,003,01,009,0329,723 ,722,21,743,1042,0,3,1,3,0,1,0,76.14,71.31 ,33.33
03,003,01,009,0330,724 ,871,16,887,1390,0,3,1,3,0,1,0,76.14,63.81 ,33.33
03,003,01,009,0330,725 ,846,20,866,1282,0,3,1,3,0,1,0,76.14,67.55 ,33.33
03,003,01,009,0330,726 ,694,20,714,1063,0,3,1,3,0,1,0,76.14,67.17 ,33.33
03,003,01,009,0330,727 ,966,21,987,1438,0,3,1,3,0,1,0,76.14,68.64 ,33.33
03,003,01,009,0330,728 ,943,15,958,1377,0,3,1,3,0,1,0,76.14,69.57 ,33.33
03,003,01,009,0330,729 ,975,13,988,1424,0,3,1,3,0,1,0,76.14,69.38 ,33.33
03,003,01,009,0331,730 ,738,10,748,1080,0,3,1,3,0,1,0,76.14,69.26 ,33.33
03,003,01,009,0331,731 ,871,15,886,1260,0,3,1,3,0,1,0,76.14,70.32 ,33.33
03,003,01,009,0331,732 ,675,13,688,1031,0,3,1,3,0,1,0,76.14,66.73 ,33.33
03,003,01,010,0332,733 ,729,14,743,1129,0,3,1,3,0,1,0,76.14,65.81 ,33.33
03,003,01,010,0332,734 ,1069,24,1093,1544,0,3,1,3,0,1,0,76.14,70.79 ,33.33
03,003,01,010,0332,735 ,804,15,819,1109,0,3,1,3,0,1,0,76.14,73.85 ,33.33
03,003,01,010,0333,736 ,1049,13,1062,1479,0,3,1,3,0,1,0,76.14,71.81 ,33.33
03,003,01,010,0334,737 ,803,16,819,1107,0,3,1,3,0,1,0,76.14,73.98 ,33.33
03,003,01,010,0334,738 ,1044,12,1056,1460,0,3,1,3,0,1,0,76.14,72.33 ,33.33
03,003,01,010,0335,739 ,997,11,1008,1317,0,3,1,3,0,1,0,76.14,76.54 ,33.33
03,003,01,010,0336,740 ,604,6,610,839,0,3,1,3,0,1,0,76.14,72.71 ,33.33
03,003,01,010,0336,741 ,735,13,748,1030,0,3,1,3,0,1,0,76.14,72.62 ,33.33
03,003,01,010,0337,742 ,815,23,838,1330,0,3,1,3,0,1,0,76.14,63.01 ,33.33
03,003,01,010,0338,743 ,830,11,841,1228,0,3,1,3,0,1,0,76.14,68.49 ,33.33
03,003,01,010,0338,744 ,658,12,670,1079,0,3,1,3,0,1,0,76.14,62.09 ,33.33
03,003,01,010,0338,745 ,822,15,837,1261,0,3,1,3,0,1,0,76.14,66.38 ,33.33
03,003,01,010,0339,746 ,714,11,725,1076,0,3,1,3,0,1,0,76.14,67.38 ,33.33
03,003,01,010,0339,747 ,742,14,756,1234,0,3,1,3,0,1,0,76.14,61.26 ,33.33
03,003,01,010,0340,748 ,888,12,900,1305,0,3,1,3,0,1,0,76.14,68.97 ,33.33
03,003,01,010,0340,749 ,768,17,785,1322,0,3,1,3,0,1,0,76.14,59.38 ,33.33
03,003,01,010,0341,750 ,718,7,725,1148,0,3,1,3,0,1,0,76.14,63.15 ,33.33
03,003,01,010,0341,751 ,568,7,575,997,0,3,1,3,0,1,0,76.14,57.67 ,33.33
03,003,01,010,0341,752 ,773,9,782,1199,0,3,1,3,0,1,0,76.14,65.22 ,33.33
03,003,01,010,0342,753 ,724,11,735,1049,0,3,1,3,0,1,0,76.14,70.07 ,33.33
03,003,01,010,0342,754 ,1003,15,1018,1521,0,3,1,3,0,1,0,76.14,66.93 ,33.33
03,003,01,010,0343,755 ,1165,15,1180,1788,0,3,1,3,0,1,0,76.14,66.00 ,33.33
03,003,01,010,0343,756 ,640,6,646,1237,0,3,1,3,0,1,0,76.14,52.22 ,33.33
03,003,01,010,0344,757 ,901,12,913,1317,0,3,1,3,0,1,0,76.14,69.32 ,33.33
03,003,01,010,0344,758 ,1010,19,1029,1498,0,3,1,3,0,1,0,76.14,68.69 ,33.33
03,003,01,010,0345,759 ,653,4,657,967,0,3,1,3,0,1,0,76.14,67.94 ,33.33
03,003,01,010,0345,760 ,667,7,674,1031,0,3,1,3,0,1,0,76.14,65.37 ,33.33
03,003,01,010,0346,761 ,1108,16,1124,1516,0,3,1,3,0,1,0,76.14,74.14 ,33.33
03,003,01,010,0346,762 ,918,9,927,1286,0,3,1,3,0,1,0,76.14,72.08 ,33.33
03,003,01,010,0347,763 ,807,7,814,1206,0,3,1,3,0,1,0,76.14,67.50 ,33.33
03,003,01,010,0348,764 ,1073,21,1094,1561,0,3,1,3,0,1,0,76.14,70.08 ,33.33
03,003,01,010,0349,765 ,652,13,665,966,0,3,1,3,0,1,0,76.14,68.84 ,33.33
03,003,01,010,0349,766 ,801,8,809,1149,0,3,1,3,0,1,0,76.14,70.41 ,33.33
03,003,01,010,0350,767 ,1159,18,1177,1653,0,3,1,3,0,1,0,76.14,71.20 ,33.33
03,003,01,010,0350,768 ,1168,39,1207,1755,0,3,1,3,0,1,0,76.14,68.77 ,33.33
03,003,01,010,0351,769 ,1010,21,1031,1471,0,3,1,3,0,1,0,76.14,70.09 ,33.33
03,003,01,010,0351,770 ,945,12,957,1412,0,3,1,3,0,1,0,76.14,67.78 ,33.33
03,003,01,010,0352,771 ,936,18,954,1338,0,3,1,3,0,1,0,76.14,71.30 ,33.33
03,003,01,010,0352,772 ,877,20,897,1339,0,3,1,3,0,1,0,76.14,66.99 ,33.33
03,003,01,010,0353,773 ,965,23,988,1441,0,3,1,3,0,1,0,76.14,68.56 ,33.33
03,003,01,010,0353,774 ,473,10,483,735,0,3,1,3,0,1,0,76.14,65.71 ,33.33
03,003,01,010,0354,775 ,1124,19,1143,1617,0,3,1,3,0,1,0,76.14,70.69 ,33.33
03,003,01,010,0354,776 ,902,20,922,1294,0,3,1,3,0,1,0,76.14,71.25 ,33.33
03,003,01,010,0355,777 ,980,11,991,1336,0,3,1,3,0,1,0,76.14,74.18 ,33.33
03,003,01,010,0355,778 ,895,15,910,1254,0,3,1,3,0,1,0,76.14,72.57 ,33.33
03,003,01,010,0355,779 ,940,14,954,1432,0,3,1,3,0,1,0,76.14,66.62 ,33.33
03,003,01,010,0356,780 ,620,12,632,907,0,3,1,3,0,1,0,76.14,69.68 ,33.33
03,003,01,010,0356,781 ,590,11,601,829,0,3,1,3,0,1,0,76.14,72.50 ,33.33
03,003,01,010,0357,782 ,908,15,923,1663,0,3,1,3,0,1,0,76.14,55.50 ,33.33
03,003,01,010,0357,783 ,910,17,927,1303,0,3,1,3,0,1,0,76.14,71.14 ,33.33
03,003,01,010,0358,784 ,1045,24,1069,1578,0,3,1,3,0,1,0,76.14,67.74 ,33.33
03,003,01,010,0358,785 ,931,17,948,1483,0,3,1,3,0,1,0,76.14,63.92 ,33.33
03,003,01,010,0359,786 ,755,8,763,1065,0,3,1,3,0,1,0,76.14,71.64 ,33.33
03,003,01,010,0359,787 ,752,10,762,1114,0,3,1,3,0,1,0,76.14,68.40 ,33.33
03,003,01,010,0360,788 ,761,9,770,1124,0,3,1,3,0,1,0,76.14,68.51 ,33.33
03,003,01,010,0360,789 ,745,18,763,1213,0,3,1,3,0,1,0,76.14,62.90 ,33.33
03,003,01,010,0360,790 ,834,15,849,1206,0,3,1,3,0,1,0,76.14,70.40 ,33.33
03,003,01,010,0361,791 ,915,26,941,1622,0,3,1,3,0,1,0,76.14,58.01 ,33.33
03,003,01,010,0362,792 ,860,19,879,1257,0,3,1,3,0,1,0,76.14,69.93 ,33.33
03,003,01,010,0362,793 ,533,3,536,788,0,3,1,3,0,1,0,76.14,68.02 ,33.33
03,003,01,010,0363,794 ,1044,15,1059,1449,0,3,1,3,0,1,0,76.14,73.08 ,33.33
03,003,01,010,0364,795 ,772,13,785,1091,0,3,1,3,0,1,0,76.14,71.95 ,33.33
03,003,01,010,0364,796 ,651,9,660,1006,0,3,1,3,0,1,0,76.14,65.61 ,33.33
03,003,01,010,0365,797 ,1072,16,1088,1539,0,3,1,3,0,1,0,76.14,70.70 ,33.33
03,003,01,010,0365,798 ,984,18,1002,1492,0,3,1,3,0,1,0,76.14,67.16 ,33.33
03,003,01,010,0366,799 ,970,19,989,1329,0,3,1,3,0,1,0,76.14,74.42 ,33.33
03,003,01,010,0366,800 ,983,19,1002,1580,0,3,1,3,0,1,0,76.14,63.42 ,33.33
03,003,01,011,0367,801 ,1218,25,1243,1899,0,3,1,3,0,1,0,76.14,65.46 ,33.33
03,003,01,011,0367,802 ,1373,24,1397,2108,0,3,1,3,0,1,0,76.14,66.27 ,33.33
03,003,01,011,0367,803 ,1073,27,1100,1650,0,3,1,3,0,1,0,76.14,66.67 ,33.33
03,003,01,011,0368,804 ,800,9,809,1113,0,3,1,3,0,1,0,76.14,72.69 ,33.33
03,003,01,011,0368,805 ,1046,16,1062,1500,0,3,1,3,0,1,0,76.14,70.80 ,33.33
03,003,01,011,0368,806 ,781,13,794,1074,0,3,1,3,0,1,0,76.14,73.93 ,33.33
03,003,01,011,0369,807 ,1085,20,1105,1634,0,3,1,3,0,1,0,76.14,67.63 ,33.33
03,003,01,011,0369,808 ,1268,9,1277,2074,0,3,1,3,0,1,0,76.14,61.57 ,33.33
03,003,01,011,0369,809 ,911,15,926,1368,0,3,1,3,0,1,0,76.14,67.69 ,33.33
03,003,01,011,0369,810 ,1029,19,1048,1549,0,3,1,3,0,1,0,76.14,67.66 ,33.33
03,003,01,011,0370,811 ,460,15,475,628,0,3,1,3,0,1,0,76.14,75.64 ,33.33
03,003,01,011,0371,812 ,1275,20,1295,1826,0,3,1,3,0,1,0,76.14,70.92 ,33.33
03,003,01,011,0371,813 ,1122,18,1140,1742,0,3,1,3,0,1,0,76.14,65.44 ,33.33
03,003,01,011,0371,814 ,978,15,993,1475,0,3,1,3,0,1,0,76.14,67.32 ,33.33
03,003,01,011,0372,815 ,860,12,872,1315,0,3,1,3,0,1,0,76.14,66.31 ,33.33
03,003,01,011,0372,816 ,670,8,678,1022,0,3,1,3,0,1,0,76.14,66.34 ,33.33
03,003,01,011,0372,817 ,844,12,856,1287,0,3,1,3,0,1,0,76.14,66.51 ,33.33
03,003,01,011,0372,818 ,1019,17,1036,1470,0,3,1,3,0,1,0,76.14,70.48 ,33.33
03,003,01,011,0373,819 ,707,18,725,1098,0,3,1,3,0,1,0,76.14,66.03 ,33.33
03,003,01,011,0373,820 ,1034,16,1050,1582,0,3,1,3,0,1,0,76.14,66.37 ,33.33
03,003,01,011,0374,821 ,804,11,815,1087,0,3,1,3,0,1,0,76.14,74.98 ,33.33
03,003,01,011,0374,822 ,646,7,653,908,0,3,1,3,0,1,0,76.14,71.92 ,33.33
03,003,01,011,0375,823 ,1294,24,1318,1843,0,3,1,3,0,1,0,76.14,71.51 ,33.33
03,003,01,011,0375,824 ,1229,23,1252,1790,0,3,1,3,0,1,0,76.14,69.94 ,33.33
03,003,01,011,0375,825 ,1179,16,1195,1755,0,3,1,3,0,1,0,76.14,68.09 ,33.33
03,003,01,011,0375,826 ,1302,23,1325,1885,0,3,1,3,0,1,0,76.14,70.29 ,33.33
03,003,01,011,0376,827 ,677,12,689,1091,0,3,1,3,0,1,0,76.14,63.15 ,33.33
03,003,01,011,0376,828 ,797,15,812,1191,0,3,1,3,0,1,0,76.14,68.18 ,33.33
03,003,01,011,0376,829 ,751,14,765,1193,0,3,1,3,0,1,0,76.14,64.12 ,33.33
03,003,01,011,0376,830 ,607,7,614,1044,0,3,1,3,0,1,0,76.14,58.81 ,33.33
03,003,01,011,0377,831 ,961,11,972,1461,0,3,1,3,0,1,0,76.14,66.53 ,33.33
03,003,01,011,0377,832 ,963,14,977,1392,0,3,1,3,0,1,0,76.14,70.19 ,33.33
03,003,01,011,0377,833 ,992,24,1016,1473,0,3,1,3,0,1,0,76.14,68.97 ,33.33
03,003,01,011,0377,834 ,1258,33,1291,1889,0,3,1,3,0,1,0,76.14,68.34 ,33.33
03,003,01,011,0377,835 ,1135,28,1163,1769,0,3,1,3,0,1,0,76.14,65.74 ,33.33
03,003,01,011,0378,836 ,721,10,731,1058,0,3,1,3,0,1,0,76.14,69.09 ,33.33
03,003,01,011,0378,837 ,775,11,786,1105,0,3,1,3,0,1,0,76.14,71.13 ,33.33
03,003,01,011,0378,838 ,705,10,715,934,0,3,1,3,0,1,0,76.14,76.55 ,33.33
03,003,01,011,0379,839 ,879,12,891,1293,0,3,1,3,0,1,0,76.14,68.91 ,33.33
03,003,01,011,0380,840 ,665,3,668,964,0,3,1,3,0,1,0,76.14,69.29 ,33.33
03,003,01,011,0381,841 ,1054,9,1063,1482,0,3,1,3,0,1,0,76.14,71.73 ,33.33
03,003,01,011,0381,842 ,964,12,976,1374,0,3,1,3,0,1,0,76.14,71.03 ,33.33
03,003,01,011,0381,843 ,1042,3,1045,1509,0,3,1,3,0,1,0,76.14,69.25 ,33.33
03,003,01,011,0381,844 ,1145,12,1157,1654,0,3,1,3,0,1,0,76.14,69.95 ,33.33
03,003,01,011,0381,845 ,987,22,1009,1444,0,3,1,3,0,1,0,76.14,69.88 ,33.33
03,003,01,011,0382,846 ,808,18,826,1199,0,3,1,3,0,1,0,76.14,68.89 ,33.33
03,003,01,011,0382,847 ,766,16,782,1199,0,3,1,3,0,1,0,76.14,65.22 ,33.33
03,003,01,011,0383,848 ,742,8,750,1155,0,3,1,3,0,1,0,76.14,64.94 ,33.33
03,003,01,011,0383,849 ,953,14,967,1516,0,3,1,3,0,1,0,76.14,63.79 ,33.33
03,003,01,011,0384,850 ,710,8,718,1035,0,3,1,3,0,1,0,76.14,69.37 ,33.33
03,003,01,011,0385,851 ,488,12,500,659,0,3,1,3,0,1,0,76.14,75.87 ,33.33
03,003,01,012,0386,852 ,876,7,883,1173,0,3,1,3,0,1,0,76.14,75.28 ,33.33
03,003,01,012,0386,853 ,821,12,833,1130,0,3,1,3,0,1,0,76.14,73.72 ,33.33
03,003,01,012,0387,854 ,1019,16,1035,1345,0,3,1,3,0,1,0,76.14,76.95 ,33.33
03,003,01,012,0387,855 ,1181,6,1187,1565,0,3,1,3,0,1,0,76.14,75.85 ,33.33
03,003,01,012,0388,856 ,887,8,895,1194,0,3,1,3,0,1,0,76.14,74.96 ,33.33
03,003,01,012,0389,857 ,1061,14,1075,1466,0,3,1,3,0,1,0,76.14,73.33 ,33.33
03,003,01,012,0389,858 ,961,17,978,1394,0,3,1,3,0,1,0,76.14,70.16 ,33.33
03,003,01,012,0390,859 ,1221,12,1233,1644,0,3,1,3,0,1,0,76.14,75.00 ,33.33
03,003,01,012,0391,860 ,831,14,845,1120,0,3,1,3,0,1,0,76.14,75.45 ,33.33
03,003,01,012,0392,861 ,1023,12,1035,1341,0,3,1,3,0,1,0,76.14,77.18 ,33.33
03,003,01,012,0393,862 ,1454,26,1480,1990,0,3,1,3,0,1,0,76.14,74.37 ,33.33
03,003,01,012,0394,863 ,1202,21,1223,1744,0,3,1,3,0,1,0,76.14,70.13 ,33.33
03,003,01,012,0395,864 ,1227,15,1242,1665,0,3,1,3,0,1,0,76.14,74.59 ,33.33
03,003,01,012,0395,865 ,749,11,760,1061,0,3,1,3,0,1,0,76.14,71.63 ,33.33
03,003,01,012,0396,866 ,964,12,976,1329,0,3,1,3,0,1,0,76.14,73.44 ,33.33
03,003,01,012,0397,867 ,1110,8,1118,1452,0,3,1,3,0,1,0,76.14,77.00 ,33.33
03,003,01,012,0398,868 ,758,14,772,1126,0,3,1,3,0,1,0,76.14,68.56 ,33.33
03,003,01,012,0399,869 ,549,2,551,835,0,3,1,3,0,1,0,76.14,65.99 ,33.33
03,003,01,012,0400,870 ,467,6,473,667,0,3,1,3,0,1,0,76.14,70.91 ,33.33
03,003,01,012,0401,871 ,795,13,808,1070,0,3,1,3,0,1,0,76.14,75.51 ,33.33
03,003,01,012,0402,872 ,768,16,784,1032,0,3,1,3,0,1,0,76.14,75.97 ,33.33
03,003,01,012,0403,873 ,678,12,690,889,0,3,1,3,0,1,0,76.14,77.62 ,33.33
03,003,01,012,0403,874 ,970,10,980,1295,0,3,1,3,0,1,0,76.14,75.68 ,33.33
03,003,01,012,0404,875 ,653,6,659,910,0,3,1,3,0,1,0,76.14,72.42 ,33.33
03,003,01,012,0405,876 ,538,8,546,697,0,3,1,3,0,1,0,76.14,78.34 ,33.33
03,003,01,012,0406,877 ,626,6,632,811,0,3,1,3,0,1,0,76.14,77.93 ,33.33
03,003,01,012,0407,878 ,1124,11,1135,1512,0,3,1,3,0,1,0,76.14,75.07 ,33.33
03,003,01,012,0408,879 ,775,11,786,1036,0,3,1,3,0,1,0,76.14,75.87 ,33.33
03,003,01,013,0409,880 ,826,9,835,1175,0,3,1,3,0,1,0,76.14,71.06 ,33.33
03,003,01,013,0409,881 ,905,16,921,1227,0,3,1,3,0,1,0,76.14,75.06 ,33.33
03,003,01,013,0410,882 ,860,11,871,1140,0,3,1,3,0,1,0,76.14,76.40 ,33.33
03,003,01,013,0411,883 ,897,22,919,1291,0,3,1,3,0,1,0,76.14,71.19 ,33.33
03,003,01,013,0412,884 ,794,9,803,1073,0,3,1,3,0,1,0,76.14,74.84 ,33.33
03,003,01,013,0413,885 ,1036,9,1045,1401,0,3,1,3,0,1,0,76.14,74.59 ,33.33
03,003,01,013,0414,886 ,469,10,479,643,0,3,1,3,0,1,0,76.14,74.49 ,33.33
03,003,01,013,0415,887 ,562,4,566,745,0,3,1,3,0,1,0,76.14,75.97 ,33.33
03,003,01,013,0416,888 ,502,11,513,670,0,3,1,3,0,1,0,76.14,76.57 ,33.33
03,003,01,013,0417,889 ,836,25,861,1181,0,3,1,3,0,1,0,76.14,72.90 ,33.33
03,003,01,013,0418,890 ,1263,31,1294,1842,0,3,1,3,0,1,0,76.14,70.25 ,33.33
03,003,01,013,0419,891 ,1350,14,1364,1869,0,3,1,3,0,1,0,76.14,72.98 ,33.33
03,003,01,013,0420,892 ,1204,17,1221,1663,0,3,1,3,0,1,0,76.14,73.42 ,33.33
03,003,01,013,0421,893 ,687,5,692,979,0,3,1,3,0,1,0,76.14,70.68 ,33.33
03,003,01,013,0422,894 ,1150,23,1173,1636,0,3,1,3,0,1,0,76.14,71.70 ,33.33
03,003,01,013,0422,895 ,1192,19,1211,1760,0,3,1,3,0,1,0,76.14,68.81 ,33.33
03,003,01,013,0423,896 ,1232,13,1245,1771,0,3,1,3,0,1,0,76.14,70.30 ,33.33
03,003,01,013,0424,897 ,1131,14,1145,1663,0,3,1,3,0,1,0,76.14,68.85 ,33.33
03,003,01,013,0425,898 ,963,9,972,1270,0,3,1,3,0,1,0,76.14,76.54 ,33.33
03,003,01,013,0425,899 ,886,8,894,1264,0,3,1,3,0,1,0,76.14,70.73 ,33.33
03,003,01,013,0426,900 ,1343,14,1357,1758,0,3,1,3,0,1,0,76.14,77.19 ,33.33
03,003,01,013,0427,901 ,686,9,695,949,0,3,1,3,0,1,0,76.14,73.23 ,33.33
03,003,01,013,0428,902 ,1216,21,1237,1752,0,3,1,3,0,1,0,76.14,70.61 ,33.33
03,003,01,013,0429,903 ,1073,16,1089,1435,0,3,1,3,0,1,0,76.14,75.89 ,33.33
03,003,01,013,0429,904 ,1112,19,1131,1644,0,3,1,3,0,1,0,76.14,68.80 ,33.33
03,003,01,013,0430,905 ,1063,12,1075,1555,0,3,1,3,0,1,0,76.14,69.13 ,33.33
03,003,01,013,0431,906 ,947,14,961,1332,0,3,1,3,0,1,0,76.14,72.15 ,33.33
03,004,01,001,0001,1 ,653,14,667,890,0,3,1,3,0,1,0,76.14,74.94 ,33.33
03,004,01,001,0002,2 ,249,10,259,310,0,3,1,3,0,1,0,76.14,83.55 ,33.33
03,004,01,001,0003,3 ,775,22,797,1174,0,3,1,3,0,1,0,76.14,67.89 ,33.33
03,004,01,001,0004,4 ,414,6,420,560,0,3,1,3,0,1,0,76.14,75.00 ,33.33
03,004,01,001,0005,5 ,866,21,887,1217,0,3,1,3,0,1,0,76.14,72.88 ,33.33
03,004,01,001,0005,6 ,860,10,870,1189,0,3,1,3,0,1,0,76.14,73.17 ,33.33
03,004,01,001,0006,7 ,731,13,744,1068,0,3,1,3,0,1,0,76.14,69.66 ,33.33
03,004,01,001,0006,8 ,848,13,861,1229,0,3,1,3,0,1,0,76.14,70.06 ,33.33
03,004,01,001,0006,9 ,550,10,560,848,0,3,1,3,0,1,0,76.14,66.04 ,33.33
03,004,01,001,0006,10 ,833,19,852,1190,0,3,1,3,0,1,0,76.14,71.60 ,33.33
03,004,01,001,0007,11 ,820,13,833,1237,0,3,1,3,0,1,0,76.14,67.34 ,33.33
03,004,01,001,0007,12 ,894,12,906,1347,0,3,1,3,0,1,0,76.14,67.26 ,33.33
03,004,01,001,0007,13 ,826,18,844,1215,0,3,1,3,0,1,0,76.14,69.47 ,33.33
03,004,01,001,0008,14 ,660,12,672,964,0,3,1,3,0,1,0,76.14,69.71 ,33.33
03,004,01,001,0008,15 ,771,12,783,1152,0,3,1,3,0,1,0,76.14,67.97 ,33.33
03,004,01,001,0009,16 ,1037,14,1051,1687,0,3,1,3,0,1,0,76.14,62.30 ,33.33
03,004,01,001,0009,17 ,1161,18,1179,1658,0,3,1,3,0,1,0,76.14,71.11 ,33.33
03,004,01,001,0010,18 ,678,12,690,1027,0,3,1,3,0,1,0,76.14,67.19 ,33.33
03,004,01,001,0010,19 ,740,8,748,1072,0,3,1,3,0,1,0,76.14,69.78 ,33.33
03,004,01,001,0010,20 ,598,7,605,911,0,3,1,3,0,1,0,76.14,66.41 ,33.33
03,004,01,001,0011,21 ,947,19,966,1495,0,3,1,3,0,1,0,76.14,64.62 ,33.33
03,004,01,001,0011,22 ,774,18,792,1182,0,3,1,3,0,1,0,76.14,67.01 ,33.33
03,004,01,001,0011,23 ,775,19,794,1161,0,3,1,3,0,1,0,76.14,68.39 ,33.33
03,004,01,001,0011,24 ,728,10,738,1169,0,3,1,3,0,1,0,76.14,63.13 ,33.33
03,004,01,001,0011,25 ,784,15,799,1100,0,3,1,3,0,1,0,76.14,72.64 ,33.33
03,004,01,001,0012,26 ,520,9,529,764,0,3,1,3,0,1,0,76.14,69.24 ,33.33
03,004,01,001,0012,27 ,693,13,706,1006,0,3,1,3,0,1,0,76.14,70.18 ,33.33
03,004,01,001,0012,28 ,640,22,662,1036,0,3,1,3,0,1,0,76.14,63.90 ,33.33
03,004,01,001,0013,29 ,486,5,491,752,0,3,1,3,0,1,0,76.14,65.29 ,33.33
03,004,01,001,0013,30 ,452,5,457,683,0,3,1,3,0,1,0,76.14,66.91 ,33.33
03,004,01,001,0013,31 ,718,13,731,1115,0,3,1,3,0,1,0,76.14,65.56 ,33.33
03,004,01,001,0013,32 ,751,11,762,1142,0,3,1,3,0,1,0,76.14,66.73 ,33.33
03,004,01,001,0014,33 ,888,17,905,1285,0,3,1,3,0,1,0,76.14,70.43 ,33.33
03,004,01,001,0014,34 ,700,13,713,1102,0,3,1,3,0,1,0,76.14,64.70 ,33.33
03,004,01,001,0014,35 ,625,5,630,964,0,3,1,3,0,1,0,76.14,65.35 ,33.33
03,004,01,001,0015,36 ,769,12,781,1205,0,3,1,3,0,1,0,76.14,64.81 ,33.33
03,004,01,001,0015,37 ,761,14,775,1292,0,3,1,3,0,1,0,76.14,59.98 ,33.33
03,004,01,001,0015,38 ,839,21,860,1318,0,3,1,3,0,1,0,76.14,65.25 ,33.33
03,004,01,001,0015,39 ,701,9,710,1171,0,3,1,3,0,1,0,76.14,60.63 ,33.33
03,004,01,001,0016,40 ,684,12,696,1100,0,3,1,3,0,1,0,76.14,63.27 ,33.33
03,004,01,001,0016,41 ,737,16,753,1258,0,3,1,3,0,1,0,76.14,59.86 ,33.33
03,004,01,001,0016,42 ,588,14,602,930,0,3,1,3,0,1,0,76.14,64.73 ,33.33
03,004,01,001,0017,43 ,706,13,719,1080,0,3,1,3,0,1,0,76.14,66.57 ,33.33
03,004,01,001,0017,44 ,606,10,616,909,0,3,1,3,0,1,0,76.14,67.77 ,33.33
03,004,01,001,0017,45 ,641,18,659,969,0,3,1,3,0,1,0,76.14,68.01 ,33.33
03,004,01,001,0018,46 ,757,12,769,1144,0,3,1,3,0,1,0,76.14,67.22 ,33.33
03,004,01,001,0019,47 ,532,9,541,758,0,3,1,3,0,1,0,76.14,71.37 ,33.33
03,004,01,001,0019,48 ,567,15,582,878,0,3,1,3,0,1,0,76.14,66.29 ,33.33
03,004,01,001,0020,49 ,559,5,564,898,0,3,1,3,0,1,0,76.14,62.81 ,33.33
03,004,01,001,0021,50 ,483,12,495,701,0,3,1,3,0,1,0,76.14,70.61 ,33.33
03,004,01,001,0021,51 ,588,13,601,924,0,3,1,3,0,1,0,76.14,65.04 ,33.33
03,004,01,001,0022,52 ,682,23,705,1030,0,3,1,3,0,1,0,76.14,68.45 ,33.33
03,004,01,001,0023,53 ,779,15,794,1243,0,3,1,3,0,1,0,76.14,63.88 ,33.33
03,004,01,001,0024,54 ,541,13,554,790,0,3,1,3,0,1,0,76.14,70.13 ,33.33
03,004,01,001,0024,55 ,376,6,382,533,0,3,1,3,0,1,0,76.14,71.67 ,33.33
03,004,01,001,0025,56 ,485,9,494,676,0,3,1,3,0,1,0,76.14,73.08 ,33.33
03,004,01,001,0025,57 ,483,5,488,652,0,3,1,3,0,1,0,76.14,74.85 ,33.33
03,004,01,001,0026,58 ,578,10,588,844,0,3,1,3,0,1,0,76.14,69.67 ,33.33
03,004,01,001,0026,59 ,549,6,555,787,0,3,1,3,0,1,0,76.14,70.52 ,33.33
03,004,01,002,0027,60 ,285,6,291,405,0,3,1,3,0,1,0,76.14,71.85 ,33.33
03,004,01,002,0028,61 ,228,2,230,330,0,3,1,3,0,1,0,76.14,69.70 ,33.33
03,004,01,002,0029,62 ,265,8,273,362,0,3,1,3,0,1,0,76.14,75.41 ,33.33
03,004,01,002,0030,63 ,561,15,576,766,0,3,1,3,0,1,0,76.14,75.20 ,33.33
03,004,01,002,0030,64 ,666,6,672,992,0,3,1,3,0,1,0,76.14,67.74 ,33.33
03,004,01,002,0031,65 ,855,17,872,1250,0,3,1,3,0,1,0,76.14,69.76 ,33.33
03,004,01,002,0031,66 ,890,21,911,1356,0,3,1,3,0,1,0,76.14,67.18 ,33.33
03,004,01,002,0031,67 ,802,15,817,1253,0,3,1,3,0,1,0,76.14,65.20 ,33.33
03,004,01,002,0031,68 ,877,12,889,1180,0,3,1,3,0,1,0,76.14,75.34 ,33.33
03,004,01,002,0031,69 ,756,16,772,1043,0,3,1,3,0,1,0,76.14,74.02 ,33.33
03,004,01,002,0032,70 ,630,16,646,908,0,3,1,3,0,1,0,76.14,71.15 ,33.33
03,004,01,002,0032,71 ,599,8,607,863,0,3,1,3,0,1,0,76.14,70.34 ,33.33
03,004,01,002,0032,72 ,666,12,678,925,0,3,1,3,0,1,0,76.14,73.30 ,33.33
03,004,01,002,0033,73 ,468,8,476,680,0,3,1,3,0,1,0,76.14,70.00 ,33.33
03,004,01,002,0033,74 ,576,6,582,782,0,3,1,3,0,1,0,76.14,74.42 ,33.33
03,004,01,002,0034,75 ,674,10,684,992,0,3,1,3,0,1,0,76.14,68.95 ,33.33
03,004,01,002,0034,76 ,793,12,805,1076,0,3,1,3,0,1,0,76.14,74.81 ,33.33
03,004,01,002,0034,77 ,847,16,863,1206,0,3,1,3,0,1,0,76.14,71.56 ,33.33
03,004,01,002,0035,78 ,650,10,660,906,0,3,1,3,0,1,0,76.14,72.85 ,33.33
03,004,01,002,0035,79 ,645,8,653,857,0,3,1,3,0,1,0,76.14,76.20 ,33.33
03,004,01,002,0036,80 ,857,18,875,1171,0,3,1,3,0,1,0,76.14,74.72 ,33.33
03,004,01,002,0037,81 ,589,9,598,778,0,3,1,3,0,1,0,76.14,76.86 ,33.33
03,004,01,002,0038,82 ,766,12,778,1134,0,3,1,3,0,1,0,76.14,68.61 ,33.33
03,004,01,002,0038,83 ,743,14,757,1037,0,3,1,3,0,1,0,76.14,73.00 ,33.33
03,004,01,002,0039,84 ,659,13,672,965,0,3,1,3,0,1,0,76.14,69.64 ,33.33
03,004,01,002,0039,85 ,906,15,921,1288,0,3,1,3,0,1,0,76.14,71.51 ,33.33
03,004,01,002,0039,86 ,744,12,756,1035,0,3,1,3,0,1,0,76.14,73.04 ,33.33
03,004,01,002,0040,87 ,1073,14,1087,1516,0,3,1,3,0,1,0,76.14,71.70 ,33.33
03,004,01,002,0040,88 ,874,15,889,1161,0,3,1,3,0,1,0,76.14,76.57 ,33.33
03,004,01,002,0041,89 ,493,4,497,640,0,3,1,3,0,1,0,76.14,77.66 ,33.33
03,004,01,002,0041,90 ,583,7,590,806,0,3,1,3,0,1,0,76.14,73.20 ,33.33
03,004,01,002,0042,91 ,920,10,930,1360,0,3,1,3,0,1,0,76.14,68.38 ,33.33
03,004,01,002,0043,92 ,546,7,553,728,0,3,1,3,0,1,0,76.14,75.96 ,33.33
03,004,01,002,0043,93 ,536,7,543,724,0,3,1,3,0,1,0,76.14,75.00 ,33.33
03,004,01,002,0044,94 ,811,7,818,1090,0,3,1,3,0,1,0,76.14,75.05 ,33.33
03,004,01,002,0044,95 ,755,17,772,1008,0,3,1,3,0,1,0,76.14,76.59 ,33.33
03,004,01,002,0044,96 ,626,15,641,850,0,3,1,3,0,1,0,76.14,75.41 ,33.33
03,004,01,002,0044,97 ,908,10,918,1223,0,3,1,3,0,1,0,76.14,75.06 ,33.33
03,004,01,002,0044,98 ,691,13,704,977,0,3,1,3,0,1,0,76.14,72.06 ,33.33
03,004,01,002,0045,99 ,1036,19,1055,1643,0,3,1,3,0,1,0,76.14,64.21 ,33.33
03,004,01,002,0045,100 ,659,10,669,942,0,3,1,3,0,1,0,76.14,71.02 ,33.33
03,004,01,002,0045,101 ,527,9,536,718,0,3,1,3,0,1,0,76.14,74.65 ,33.33
03,004,01,002,0045,102 ,714,8,722,1059,0,3,1,3,0,1,0,76.14,68.18 ,33.33
03,004,01,002,0045,103 ,529,8,537,754,0,3,1,3,0,1,0,76.14,71.22 ,33.33
03,004,01,002,0046,104 ,347,5,352,484,0,3,1,3,0,1,0,76.14,72.73 ,33.33
03,004,01,002,0047,105 ,815,14,829,1301,0,3,1,3,0,1,0,76.14,63.72 ,33.33
03,004,01,002,0047,106 ,555,7,562,835,0,3,1,3,0,1,0,76.14,67.31 ,33.33
03,004,01,002,0047,107 ,632,12,644,934,0,3,1,3,0,1,0,76.14,68.95 ,33.33
03,004,01,002,0047,108 ,492,14,506,701,0,3,1,3,0,1,0,76.14,72.18 ,33.33
03,004,01,002,0047,109 ,605,9,614,919,0,3,1,3,0,1,0,76.14,66.81 ,33.33
03,004,01,002,0048,110 ,766,14,780,1031,0,3,1,3,0,1,0,76.14,75.65 ,33.33
03,004,01,002,0048,111 ,719,6,725,1005,0,3,1,3,0,1,0,76.14,72.14 ,33.33
03,004,01,002,0048,112 ,1024,17,1041,1539,0,3,1,3,0,1,0,76.14,67.64 ,33.33
03,004,01,002,0048,113 ,861,19,880,1297,0,3,1,3,0,1,0,76.14,67.85 ,33.33
03,004,01,002,0048,114 ,671,16,687,962,0,3,1,3,0,1,0,76.14,71.41 ,33.33
03,004,01,002,0049,115 ,711,16,727,1104,0,3,1,3,0,1,0,76.14,65.85 ,33.33
03,004,01,002,0049,116 ,723,14,737,1026,0,3,1,3,0,1,0,76.14,71.83 ,33.33
03,004,01,002,0049,117 ,887,10,897,1233,0,3,1,3,0,1,0,76.14,72.75 ,33.33
03,004,01,002,0050,118 ,1032,15,1047,1410,0,3,1,3,0,1,0,76.14,74.26 ,33.33
03,004,01,002,0051,119 ,460,3,463,645,0,3,1,3,0,1,0,76.14,71.78 ,33.33
03,004,01,003,0052,120 ,762,8,770,1012,0,3,1,3,0,1,0,76.14,76.09 ,33.33
03,004,01,003,0053,121 ,500,9,509,681,0,3,1,3,0,1,0,76.14,74.74 ,33.33
03,004,01,003,0054,122 ,776,18,794,1043,0,3,1,3,0,1,0,76.14,76.13 ,33.33
03,004,01,003,0055,123 ,601,6,607,812,0,3,1,3,0,1,0,76.14,74.75 ,33.33
03,004,01,003,0055,124 ,512,14,526,723,0,3,1,3,0,1,0,76.14,72.75 ,33.33
03,004,01,003,0055,125 ,541,7,548,755,0,3,1,3,0,1,0,76.14,72.58 ,33.33
03,004,01,003,0056,126 ,602,13,615,904,0,3,1,3,0,1,0,76.14,68.03 ,33.33
03,004,01,003,0056,127 ,531,6,537,786,0,3,1,3,0,1,0,76.14,68.32 ,33.33
03,004,01,003,0057,128 ,644,18,662,895,0,3,1,3,0,1,0,76.14,73.97 ,33.33
03,004,01,003,0057,129 ,672,13,685,926,0,3,1,3,0,1,0,76.14,73.97 ,33.33
03,004,01,003,0058,130 ,667,13,680,912,0,3,1,3,0,1,0,76.14,74.56 ,33.33
03,004,01,003,0058,131 ,612,17,629,884,0,3,1,3,0,1,0,76.14,71.15 ,33.33
03,004,01,003,0058,132 ,699,19,718,976,0,3,1,3,0,1,0,76.14,73.57 ,33.33
03,004,01,003,0059,133 ,991,21,1012,1356,0,3,1,3,0,1,0,76.14,74.63 ,33.33
03,004,01,003,0060,134 ,330,4,334,438,0,3,1,3,0,1,0,76.14,76.26 ,33.33
03,004,01,003,0061,135 ,540,7,547,713,0,3,1,3,0,1,0,76.14,76.72 ,33.33
03,004,01,003,0062,136 ,451,7,458,604,0,3,1,3,0,1,0,76.14,75.83 ,33.33
03,004,01,003,0063,137 ,820,10,830,1066,0,3,1,3,0,1,0,76.14,77.86 ,33.33
03,004,01,003,0064,138 ,787,19,806,1080,0,3,1,3,0,1,0,76.14,74.63 ,33.33
03,004,01,003,0065,139 ,608,11,619,799,0,3,1,3,0,1,0,76.14,77.47 ,33.33
03,004,01,003,0066,140 ,899,19,918,1338,0,3,1,3,0,1,0,76.14,68.61 ,33.33
03,004,01,003,0066,141 ,808,11,819,1129,0,3,1,3,0,1,0,76.14,72.54 ,33.33
03,004,01,003,0066,142 ,887,12,899,1332,0,3,1,3,0,1,0,76.14,67.49 ,33.33
03,004,01,003,0067,143 ,1157,13,1170,1658,0,3,1,3,0,1,0,76.14,70.57 ,33.33
03,004,01,003,0068,144 ,673,12,685,895,0,3,1,3,0,1,0,76.14,76.54 ,33.33
03,004,01,003,0068,145 ,564,14,578,833,0,3,1,3,0,1,0,76.14,69.39 ,33.33
03,004,01,003,0069,146 ,723,19,742,974,0,3,1,3,0,1,0,76.14,76.18 ,33.33
03,004,01,003,0070,147 ,496,2,498,665,0,3,1,3,0,1,0,76.14,74.89 ,33.33
03,004,01,004,0071,148 ,420,5,425,550,0,3,1,3,0,1,0,76.14,77.27 ,33.33
03,004,01,004,0072,149 ,519,10,529,698,0,3,1,3,0,1,0,76.14,75.79 ,33.33
03,004,01,004,0072,150 ,685,8,693,971,0,3,1,3,0,1,0,76.14,71.37 ,33.33
03,004,01,004,0073,151 ,530,10,540,747,0,3,1,3,0,1,0,76.14,72.29 ,33.33
03,004,01,004,0074,152 ,760,13,773,1100,0,3,1,3,0,1,0,76.14,70.27 ,33.33
03,004,01,004,0074,153 ,807,13,820,1119,0,3,1,3,0,1,0,76.14,73.28 ,33.33
03,004,01,004,0074,154 ,897,10,907,1271,0,3,1,3,0,1,0,76.14,71.36 ,33.33
03,004,01,004,0075,155 ,543,12,555,725,0,3,1,3,0,1,0,76.14,76.55 ,33.33
03,004,01,004,0076,156 ,761,8,769,1067,0,3,1,3,0,1,0,76.14,72.07 ,33.33
03,004,01,004,0077,157 ,674,14,688,1016,0,3,1,3,0,1,0,76.14,67.72 ,33.33
03,004,01,004,0078,158 ,952,16,968,1383,0,3,1,3,0,1,0,76.14,69.99 ,33.33
03,004,01,004,0078,159 ,968,11,979,1416,0,3,1,3,0,1,0,76.14,69.14 ,33.33
03,004,01,004,0079,160 ,559,11,570,760,0,3,1,3,0,1,0,76.14,75.00 ,33.33
03,004,01,004,0080,161 ,823,15,838,1118,0,3,1,3,0,1,0,76.14,74.96 ,33.33
03,004,01,004,0081,162 ,701,5,706,975,0,3,1,3,0,1,0,76.14,72.41 ,33.33
03,004,01,004,0082,163 ,414,12,426,591,0,3,1,3,0,1,0,76.14,72.08 ,33.33
03,004,01,004,0083,164 ,372,10,382,522,0,3,1,3,0,1,0,76.14,73.18 ,33.33
03,004,01,004,0084,165 ,417,4,421,637,0,3,1,3,0,1,0,76.14,66.09 ,33.33
03,004,01,004,0085,166 ,596,12,608,879,0,3,1,3,0,1,0,76.14,69.17 ,33.33
03,004,01,004,0086,167 ,535,11,546,713,0,3,1,3,0,1,0,76.14,76.58 ,33.33
03,004,01,004,0087,168 ,669,15,684,871,0,3,1,3,0,1,0,76.14,78.53 ,33.33
03,004,01,004,0087,169 ,682,17,699,914,0,3,1,3,0,1,0,76.14,76.48 ,33.33
03,004,01,004,0088,170 ,675,9,684,934,0,3,1,3,0,1,0,76.14,73.23 ,33.33
03,004,01,004,0089,171 ,632,4,636,812,0,3,1,3,0,1,0,76.14,78.33 ,33.33
03,004,01,004,0090,172 ,488,7,495,620,0,3,1,3,0,1,0,76.14,79.84 ,33.33
03,004,01,004,0091,173 ,612,9,621,775,0,3,1,3,0,1,0,76.14,80.13 ,33.33
03,004,01,005,0092,174 ,873,13,886,1204,0,3,1,3,0,1,0,76.14,73.59 ,33.33
03,004,01,005,0092,175 ,838,13,851,1134,0,3,1,3,0,1,0,76.14,75.04 ,33.33
03,004,01,005,0093,176 ,815,9,824,1218,0,3,1,3,0,1,0,76.14,67.65 ,33.33
03,004,01,005,0093,177 ,816,9,825,1141,0,3,1,3,0,1,0,76.14,72.30 ,33.33
03,004,01,005,0094,178 ,791,15,806,1076,0,3,1,3,0,1,0,76.14,74.91 ,33.33
03,004,01,005,0094,179 ,779,14,793,1137,0,3,1,3,0,1,0,76.14,69.74 ,33.33
03,004,01,005,0094,180 ,748,14,762,1116,0,3,1,3,0,1,0,76.14,68.28 ,33.33
03,004,01,005,0095,181 ,796,12,808,1119,0,3,1,3,0,1,0,76.14,72.21 ,33.33
03,004,01,005,0095,182 ,878,12,890,1270,0,3,1,3,0,1,0,76.14,70.08 ,33.33
03,004,01,005,0095,183 ,896,18,914,1326,0,3,1,3,0,1,0,76.14,68.93 ,33.33
03,004,01,005,0096,184 ,580,10,590,850,0,3,1,3,0,1,0,76.14,69.41 ,33.33
03,004,01,005,0097,185 ,838,20,858,1222,0,3,1,3,0,1,0,76.14,70.21 ,33.33
03,004,01,005,0098,186 ,715,13,728,1017,0,3,1,3,0,1,0,76.14,71.58 ,33.33
03,004,01,005,0098,187 ,898,13,911,1257,0,3,1,3,0,1,0,76.14,72.47 ,33.33
03,004,01,005,0099,188 ,804,9,813,1121,0,3,1,3,0,1,0,76.14,72.52 ,33.33
03,004,01,005,0099,189 ,682,12,694,937,0,3,1,3,0,1,0,76.14,74.07 ,33.33
03,004,01,005,0100,190 ,730,8,738,969,0,3,1,3,0,1,0,76.14,76.16 ,33.33
03,004,01,005,0100,191 ,693,7,700,1006,0,3,1,3,0,1,0,76.14,69.58 ,33.33
03,004,01,005,0100,192 ,858,15,873,1277,0,3,1,3,0,1,0,76.14,68.36 ,33.33
03,004,01,005,0101,193 ,769,9,778,1101,0,3,1,3,0,1,0,76.14,70.66 ,33.33
03,004,01,005,0101,194 ,711,9,720,1004,0,3,1,3,0,1,0,76.14,71.71 ,33.33
03,004,01,005,0102,195 ,1023,14,1037,1677,0,3,1,3,0,1,0,76.14,61.84 ,33.33
03,004,01,005,0103,196 ,690,21,711,1004,0,3,1,3,0,1,0,76.14,70.82 ,33.33
03,004,01,005,0103,197 ,1005,20,1025,1439,0,3,1,3,0,1,0,76.14,71.23 ,33.33
03,004,01,005,0104,198 ,724,5,729,995,0,3,1,3,0,1,0,76.14,73.27 ,33.33
03,004,01,005,0105,199 ,828,12,840,1218,0,3,1,3,0,1,0,76.14,68.97 ,33.33
03,004,01,005,0105,200 ,676,13,689,1005,0,3,1,3,0,1,0,76.14,68.56 ,33.33
03,004,01,005,0106,201 ,817,11,828,1155,0,3,1,3,0,1,0,76.14,71.69 ,33.33
03,004,01,005,0106,202 ,649,8,657,930,0,3,1,3,0,1,0,76.14,70.65 ,33.33
03,004,01,005,0107,203 ,845,25,870,1280,0,3,1,3,0,1,0,76.14,67.97 ,33.33
03,004,01,005,0108,204 ,712,15,727,1028,0,3,1,3,0,1,0,76.14,70.72 ,33.33
03,004,01,005,0108,205 ,733,15,748,1073,0,3,1,3,0,1,0,76.14,69.71 ,33.33
03,004,01,005,0108,206 ,782,17,799,1329,0,3,1,3,0,1,0,76.14,60.12 ,33.33
03,004,01,005,0109,207 ,605,9,614,940,0,3,1,3,0,1,0,76.14,65.32 ,33.33
03,004,01,005,0109,208 ,753,13,766,1195,0,3,1,3,0,1,0,76.14,64.10 ,33.33
03,004,01,005,0109,209 ,570,18,588,934,0,3,1,3,0,1,0,76.14,62.96 ,33.33
03,004,01,005,0110,210 ,663,20,683,1092,0,3,1,3,0,1,0,76.14,62.55 ,33.33
03,004,01,005,0110,211 ,781,20,801,1072,0,3,1,3,0,1,0,76.14,74.72 ,33.33
03,004,01,005,0111,212 ,847,25,872,1376,0,3,1,3,0,1,0,76.14,63.37 ,33.33
03,004,01,005,0111,213 ,781,13,794,1140,0,3,1,3,0,1,0,76.14,69.65 ,33.33
03,004,01,006,0112,214 ,635,16,651,865,0,3,1,3,0,1,0,76.14,75.26 ,33.33
03,004,01,006,0113,215 ,572,16,588,788,0,3,1,3,0,1,0,76.14,74.62 ,33.33
03,004,01,006,0113,216 ,575,21,596,851,0,3,1,3,0,1,0,76.14,70.04 ,33.33
03,004,01,006,0114,217 ,959,12,971,1338,0,3,1,3,0,1,0,76.14,72.57 ,33.33
03,004,01,006,0115,218 ,862,16,878,1249,0,3,1,3,0,1,0,76.14,70.30 ,33.33
03,004,01,006,0115,219 ,604,10,614,904,0,3,1,3,0,1,0,76.14,67.92 ,33.33
03,004,01,006,0116,220 ,547,18,565,771,0,3,1,3,0,1,0,76.14,73.28 ,33.33
03,004,01,006,0117,221 ,707,9,716,1033,0,3,1,3,0,1,0,76.14,69.31 ,33.33
03,004,01,006,0117,222 ,706,13,719,1003,0,3,1,3,0,1,0,76.14,71.68 ,33.33
03,004,01,006,0118,223 ,908,10,918,1316,0,3,1,3,0,1,0,76.14,69.76 ,33.33
03,004,01,006,0119,224 ,1416,22,1438,2116,0,3,1,3,0,1,0,76.14,67.96 ,33.33
03,004,01,006,0120,225 ,984,18,1002,1432,0,3,1,3,0,1,0,76.14,69.97 ,33.33
03,004,01,006,0120,226 ,915,10,925,1384,0,3,1,3,0,1,0,76.14,66.84 ,33.33
03,004,01,006,0120,227 ,1087,11,1098,1708,0,3,1,3,0,1,0,76.14,64.29 ,33.33
03,004,01,006,0120,228 ,717,19,736,1086,0,3,1,3,0,1,0,76.14,67.77 ,33.33
03,004,01,006,0121,229 ,814,10,824,1226,0,3,1,3,0,1,0,76.14,67.21 ,33.33
03,004,01,006,0122,230 ,623,17,640,902,0,3,1,3,0,1,0,76.14,70.95 ,33.33
03,004,01,006,0123,231 ,967,12,979,1468,0,3,1,3,0,1,0,76.14,66.69 ,33.33
03,004,01,006,0123,232 ,1356,13,1369,2022,0,3,1,3,0,1,0,76.14,67.71 ,33.33
03,004,01,006,0123,233 ,969,14,983,1433,0,3,1,3,0,1,0,76.14,68.60 ,33.33
03,004,01,006,0123,234 ,1066,18,1084,1686,0,3,1,3,0,1,0,76.14,64.29 ,33.33
03,004,01,006,0124,235 ,843,16,859,1243,0,3,1,3,0,1,0,76.14,69.11 ,33.33
03,004,01,006,0124,236 ,794,16,810,1350,0,3,1,3,0,1,0,76.14,60.00 ,33.33
03,004,01,006,0124,237 ,929,15,944,1496,0,3,1,3,0,1,0,76.14,63.10 ,33.33
03,004,01,007,0125,238 ,350,5,355,435,0,3,1,3,0,1,0,76.14,81.61 ,33.33
03,004,01,007,0126,239 ,368,7,375,494,0,3,1,3,0,1,0,76.14,75.91 ,33.33
03,004,01,007,0127,240 ,602,12,614,829,0,3,1,3,0,1,0,76.14,74.07 ,33.33
03,004,01,007,0128,241 ,315,1,316,397,0,3,1,3,0,1,0,76.14,79.60 ,33.33
03,004,01,007,0129,242 ,673,14,687,911,0,3,1,3,0,1,0,76.14,75.41 ,33.33
03,004,01,007,0129,243 ,1016,12,1028,1399,0,3,1,3,0,1,0,76.14,73.48 ,33.33
03,004,01,007,0130,244 ,1019,29,1048,1370,0,3,1,3,0,1,0,76.14,76.50 ,33.33
03,004,01,007,0131,245 ,408,8,416,542,0,3,1,3,0,1,0,76.14,76.75 ,33.33
03,004,01,007,0132,246 ,457,4,461,618,0,3,1,3,0,1,0,76.14,74.60 ,33.33
03,004,01,007,0133,247 ,869,11,880,1227,0,3,1,3,0,1,0,76.14,71.72 ,33.33
03,004,01,007,0133,248 ,605,10,615,800,0,3,1,3,0,1,0,76.14,76.88 ,33.33
03,004,01,007,0134,249 ,1092,26,1118,1458,0,3,1,3,0,1,0,76.14,76.68 ,33.33
03,004,01,007,0135,250 ,1121,13,1134,1599,0,3,1,3,0,1,0,76.14,70.92 ,33.33
03,004,01,007,0135,251 ,877,13,890,1339,0,3,1,3,0,1,0,76.14,66.47 ,33.33
03,004,01,007,0136,252 ,782,7,789,1041,0,3,1,3,0,1,0,76.14,75.79 ,33.33
03,004,01,008,0137,253 ,833,7,840,1161,0,3,1,3,0,1,0,76.14,72.35 ,33.33
03,004,01,008,0137,254 ,670,9,679,951,0,3,1,3,0,1,0,76.14,71.40 ,33.33
03,004,01,008,0137,255 ,743,12,755,1085,0,3,1,3,0,1,0,76.14,69.59 ,33.33
03,004,01,008,0138,256 ,626,9,635,832,0,3,1,3,0,1,0,76.14,76.32 ,33.33
03,004,01,008,0139,257 ,124,3,127,156,0,3,1,3,0,1,0,76.14,81.41 ,33.33
03,004,01,008,0140,258 ,107,2,109,144,0,3,1,3,0,1,0,76.14,75.69 ,33.33
03,004,01,008,0141,259 ,259,3,262,334,0,3,1,3,0,1,0,76.14,78.44 ,33.33
03,004,01,008,0142,260 ,752,15,767,1041,0,3,1,3,0,1,0,76.14,73.68 ,33.33
03,004,01,008,0143,261 ,425,7,432,578,0,3,1,3,0,1,0,76.14,74.74 ,33.33
03,004,01,008,0143,262 ,188,8,196,259,0,3,1,3,0,1,0,76.14,75.68 ,33.33
03,004,01,008,0144,263 ,345,4,349,456,0,3,1,3,0,1,0,76.14,76.54 ,33.33
03,004,01,008,0145,264 ,572,13,585,757,0,3,1,3,0,1,0,76.14,77.28 ,33.33
03,004,01,008,0145,265 ,275,3,278,358,0,3,1,3,0,1,0,76.14,77.65 ,33.33
03,004,01,008,0146,266 ,551,10,561,720,0,3,1,3,0,1,0,76.14,77.92 ,33.33
03,004,01,008,0146,267 ,587,4,591,772,0,3,1,3,0,1,0,76.14,76.55 ,33.33
03,004,01,008,0147,268 ,994,22,1016,1335,0,3,1,3,0,1,0,76.14,76.10 ,33.33
03,004,01,009,0148,269 ,775,12,787,1111,0,3,1,3,0,1,0,76.14,70.84 ,33.33
03,004,01,009,0149,270 ,948,22,970,1297,0,3,1,3,0,1,0,76.14,74.79 ,33.33
03,004,01,009,0150,271 ,356,5,361,485,0,3,1,3,0,1,0,76.14,74.43 ,33.33
03,004,01,009,0151,272 ,679,11,690,901,0,3,1,3,0,1,0,76.14,76.58 ,33.33
03,004,01,009,0151,273 ,1051,17,1068,1435,0,3,1,3,0,1,0,76.14,74.43 ,33.33
03,004,01,009,0152,274 ,527,11,538,744,0,3,1,3,0,1,0,76.14,72.31 ,33.33
03,004,01,009,0153,275 ,260,2,262,339,0,3,1,3,0,1,0,76.14,77.29 ,33.33
03,004,01,009,0154,276 ,447,8,455,623,0,3,1,3,0,1,0,76.14,73.03 ,33.33
03,004,01,009,0155,277 ,227,4,231,328,0,3,1,3,0,1,0,76.14,70.43 ,33.33
03,004,01,009,0156,278 ,226,5,231,330,0,3,1,3,0,1,0,76.14,70.00 ,33.33
03,004,01,010,0157,279 ,1263,17,1280,1843,0,3,1,3,0,1,0,76.14,69.45 ,33.33
03,004,01,010,0157,280 ,1008,20,1028,1674,0,3,1,3,0,1,0,76.14,61.41 ,33.33
03,004,01,010,0158,281 ,576,13,589,839,0,3,1,3,0,1,0,76.14,70.20 ,33.33
03,004,01,010,0159,282 ,544,9,553,731,0,3,1,3,0,1,0,76.14,75.65 ,33.33
03,004,01,010,0160,283 ,770,12,782,1057,0,3,1,3,0,1,0,76.14,73.98 ,33.33
03,004,01,010,0161,284 ,479,8,487,625,0,3,1,3,0,1,0,76.14,77.92 ,33.33
03,004,01,010,0162,285 ,519,5,524,693,0,3,1,3,0,1,0,76.14,75.61 ,33.33
03,004,01,010,0163,286 ,460,5,465,613,0,3,1,3,0,1,0,76.14,75.86 ,33.33
03,004,01,010,0164,287 ,408,4,412,539,0,3,1,3,0,1,0,76.14,76.44 ,33.33
03,004,01,010,0165,288 ,354,5,359,505,0,3,1,3,0,1,0,76.14,71.09 ,33.33
03,004,01,011,0166,289 ,665,7,672,889,0,3,1,3,0,1,0,76.14,75.59 ,33.33
03,004,01,011,0167,290 ,550,4,554,717,0,3,1,3,0,1,0,76.14,77.27 ,33.33
03,004,01,011,0168,291 ,454,6,460,602,0,3,1,3,0,1,0,76.14,76.41 ,33.33
03,004,01,011,0169,292 ,258,0,258,334,0,3,1,3,0,1,0,76.14,77.25 ,33.33
03,004,01,011,0169,293 ,200,7,207,277,0,3,1,3,0,1,0,76.14,74.73 ,33.33
03,004,01,011,0170,294 ,859,19,878,1220,0,3,1,3,0,1,0,76.14,71.97 ,33.33
03,004,01,011,0171,295 ,358,4,362,489,0,3,1,3,0,1,0,76.14,74.03 ,33.33
03,004,01,011,0171,296 ,289,6,295,385,0,3,1,3,0,1,0,76.14,76.62 ,33.33
03,004,01,012,0172,297 ,288,4,292,413,0,3,1,3,0,1,0,76.14,70.70 ,33.33
03,004,01,012,0173,298 ,24,0,24,34,0,3,1,3,0,1,0,76.14,70.59 ,33.33
03,004,01,012,0174,299 ,78,2,80,119,0,3,1,3,0,1,0,76.14,67.23 ,33.33
03,004,01,012,0175,300 ,113,3,116,179,0,3,1,3,0,1,0,76.14,64.80 ,33.33
03,004,01,012,0176,301 ,26,0,26,50,0,3,1,3,0,1,0,76.14,52.00 ,33.33
03,004,01,012,0176,302 ,39,0,39,66,0,3,1,3,0,1,0,76.14,59.09 ,33.33
03,004,01,012,0177,303 ,23,3,26,39,0,3,1,3,0,1,0,76.14,66.67 ,33.33
03,004,01,012,0178,304 ,14,0,14,24,0,3,1,3,0,1,0,76.14,58.33 ,33.33
03,004,01,012,0178,305 ,2,0,2,7,0,3,1,3,0,1,0,76.14,28.57 ,33.33
03,004,01,012,0179,306 ,10,1,11,16,0,3,1,3,0,1,0,76.14,68.75 ,33.33
03,004,01,012,0179,307 ,16,2,18,33,0,3,1,3,0,1,0,76.14,54.55 ,33.33
03,004,01,012,0179,308 ,5,0,5,9,0,3,1,3,0,1,0,76.14,55.56 ,33.33
03,004,01,013,0180,309 ,78,1,79,112,0,3,1,3,0,1,0,76.14,70.54 ,33.33
03,004,01,013,0180,310 ,12,0,12,34,0,3,1,3,0,1,0,76.14,35.29 ,33.33
03,004,01,013,0181,311 ,43,0,43,82,0,3,1,3,0,1,0,76.14,52.44 ,33.33
03,004,01,013,0182,312 ,12,0,12,17,0,3,1,3,0,1,0,76.14,70.59 ,33.33
03,004,01,013,0183,313 ,28,1,29,51,0,3,1,3,0,1,0,76.14,56.86 ,33.33
03,004,01,013,0183,314 ,76,0,76,139,0,3,1,3,0,1,0,76.14,54.68 ,33.33
03,005,01,001,0001,1 ,620,8,628,915,0,3,1,3,0,1,0,76.14,68.63 ,33.33
03,005,01,001,0002,2 ,647,8,655,1014,0,3,1,3,0,1,0,76.14,64.60 ,33.33
03,005,01,001,0003,3 ,989,16,1005,1534,0,3,1,3,0,1,0,76.14,65.51 ,33.33
03,005,01,001,0003,4 ,984,20,1004,1466,0,3,1,3,0,1,0,76.14,68.49 ,33.33
03,005,01,001,0004,5 ,773,19,792,1196,0,3,1,3,0,1,0,76.14,66.22 ,33.33
03,005,01,001,0004,6 ,853,11,864,1242,0,3,1,3,0,1,0,76.14,69.57 ,33.33
03,005,01,001,0004,7 ,760,11,771,1229,0,3,1,3,0,1,0,76.14,62.73 ,33.33
03,005,01,001,0005,8 ,758,14,772,1137,0,3,1,3,0,1,0,76.14,67.90 ,33.33
03,005,01,001,0005,9 ,722,8,730,1135,0,3,1,3,0,1,0,76.14,64.32 ,33.33
03,005,01,001,0006,10 ,732,13,745,1132,0,3,1,3,0,1,0,76.14,65.81 ,33.33
03,005,01,001,0006,11 ,674,7,681,1044,0,3,1,3,0,1,0,76.14,65.23 ,33.33
03,005,01,001,0006,12 ,740,19,759,1089,0,3,1,3,0,1,0,76.14,69.70 ,33.33
03,005,01,001,0007,13 ,583,16,599,905,0,3,1,3,0,1,0,76.14,66.19 ,33.33
03,005,01,001,0008,14 ,783,10,793,1203,0,3,1,3,0,1,0,76.14,65.92 ,33.33
03,005,01,001,0008,15 ,820,14,834,1343,0,3,1,3,0,1,0,76.14,62.10 ,33.33
03,005,01,001,0009,16 ,653,16,669,962,0,3,1,3,0,1,0,76.14,69.54 ,33.33
03,005,01,001,0010,17 ,696,13,709,1064,0,3,1,3,0,1,0,76.14,66.64 ,33.33
03,005,01,001,0011,18 ,391,6,397,647,0,3,1,3,0,1,0,76.14,61.36 ,33.33
03,005,01,001,0012,19 ,1089,16,1105,1556,0,3,1,3,0,1,0,76.14,71.02 ,33.33
03,005,01,001,0013,20 ,898,16,914,1413,0,3,1,3,0,1,0,76.14,64.69 ,33.33
03,005,01,001,0013,21 ,651,5,656,902,0,3,1,3,0,1,0,76.14,72.73 ,33.33
03,005,01,001,0014,22 ,851,15,866,1263,0,3,1,3,0,1,0,76.14,68.57 ,33.33
03,005,01,001,0014,23 ,922,15,937,1368,0,3,1,3,0,1,0,76.14,68.49 ,33.33
03,005,01,001,0014,24 ,538,6,544,808,0,3,1,3,0,1,0,76.14,67.33 ,33.33
03,005,01,001,0015,25 ,581,5,586,872,0,3,1,3,0,1,0,76.14,67.20 ,33.33
03,005,01,001,0015,26 ,814,11,825,1201,0,3,1,3,0,1,0,76.14,68.69 ,33.33
03,005,01,001,0015,27 ,636,7,643,910,0,3,1,3,0,1,0,76.14,70.66 ,33.33
03,005,01,001,0016,28 ,556,9,565,787,0,3,1,3,0,1,0,76.14,71.79 ,33.33
03,005,01,001,0016,29 ,664,10,674,948,0,3,1,3,0,1,0,76.14,71.10 ,33.33
03,005,01,001,0017,30 ,842,15,857,1207,0,3,1,3,0,1,0,76.14,71.00 ,33.33
03,005,01,001,0017,31 ,1044,16,1060,1581,0,3,1,3,0,1,0,76.14,67.05 ,33.33
03,005,01,001,0017,32 ,916,10,926,1364,0,3,1,3,0,1,0,76.14,67.89 ,33.33
03,005,01,001,0018,33 ,1106,12,1118,1614,0,3,1,3,0,1,0,76.14,69.27 ,33.33
03,005,01,001,0018,34 ,810,12,822,1181,0,3,1,3,0,1,0,76.14,69.60 ,33.33
03,005,01,001,0018,35 ,884,12,896,1265,0,3,1,3,0,1,0,76.14,70.83 ,33.33
03,005,01,001,0018,36 ,965,11,976,1350,0,3,1,3,0,1,0,76.14,72.30 ,33.33
03,005,01,001,0019,37 ,783,12,795,1229,0,3,1,3,0,1,0,76.14,64.69 ,33.33
03,005,01,001,0019,38 ,883,15,898,1392,0,3,1,3,0,1,0,76.14,64.51 ,33.33
03,005,01,001,0019,39 ,951,10,961,1405,0,3,1,3,0,1,0,76.14,68.40 ,33.33
03,005,01,001,0019,40 ,1000,17,1017,1546,0,3,1,3,0,1,0,76.14,65.78 ,33.33
03,005,01,001,0020,41 ,556,4,560,806,0,3,1,3,0,1,0,76.14,69.48 ,33.33
03,005,01,001,0020,42 ,899,13,912,1259,0,3,1,3,0,1,0,76.14,72.44 ,33.33
03,005,01,001,0020,43 ,912,16,928,1402,0,3,1,3,0,1,0,76.14,66.19 ,33.33
03,005,01,001,0021,44 ,824,17,841,1299,0,3,1,3,0,1,0,76.14,64.74 ,33.33
03,005,01,001,0021,45 ,942,13,955,1455,0,3,1,3,0,1,0,76.14,65.64 ,33.33
03,005,01,001,0021,46 ,826,17,843,1301,0,3,1,3,0,1,0,76.14,64.80 ,33.33
03,005,01,001,0022,47 ,1041,22,1063,1571,0,3,1,3,0,1,0,76.14,67.66 ,33.33
03,005,01,001,0022,48 ,891,14,905,1401,0,3,1,3,0,1,0,76.14,64.60 ,33.33
03,005,01,001,0022,49 ,1060,27,1087,1632,0,3,1,3,0,1,0,76.14,66.61 ,33.33
03,005,01,001,0023,50 ,703,7,710,1098,0,3,1,3,0,1,0,76.14,64.66 ,33.33
03,005,01,001,0024,51 ,871,26,897,1420,0,3,1,3,0,1,0,76.14,63.17 ,33.33
03,005,01,001,0024,52 ,497,13,510,792,0,3,1,3,0,1,0,76.14,64.39 ,33.33
03,005,01,001,0024,53 ,606,12,618,944,0,3,1,3,0,1,0,76.14,65.47 ,33.33
03,005,01,002,0025,54 ,465,6,471,696,0,3,1,3,0,1,0,76.14,67.67 ,33.33
03,005,01,002,0025,55 ,672,4,676,1060,0,3,1,3,0,1,0,76.14,63.77 ,33.33
03,005,01,002,0026,56 ,626,6,632,908,0,3,1,3,0,1,0,76.14,69.60 ,33.33
03,005,01,002,0026,57 ,441,6,447,694,0,3,1,3,0,1,0,76.14,64.41 ,33.33
03,005,01,002,0027,58 ,611,9,620,892,0,3,1,3,0,1,0,76.14,69.51 ,33.33
03,005,01,002,0028,59 ,804,13,817,1268,0,3,1,3,0,1,0,76.14,64.43 ,33.33
03,005,01,002,0029,60 ,752,9,761,1120,0,3,1,3,0,1,0,76.14,67.95 ,33.33
03,005,01,002,0030,61 ,564,5,569,874,0,3,1,3,0,1,0,76.14,65.10 ,33.33
03,005,01,002,0030,62 ,511,3,514,760,0,3,1,3,0,1,0,76.14,67.63 ,33.33
03,005,01,002,0031,63 ,651,12,663,991,0,3,1,3,0,1,0,76.14,66.90 ,33.33
03,005,01,002,0032,64 ,659,10,669,995,0,3,1,3,0,1,0,76.14,67.24 ,33.33
03,005,01,002,0032,65 ,675,13,688,1099,0,3,1,3,0,1,0,76.14,62.60 ,33.33
03,005,01,002,0033,66 ,693,6,699,1051,0,3,1,3,0,1,0,76.14,66.51 ,33.33
03,005,01,002,0033,67 ,707,9,716,1061,0,3,1,3,0,1,0,76.14,67.48 ,33.33
03,005,01,002,0033,68 ,692,6,698,1043,0,3,1,3,0,1,0,76.14,66.92 ,33.33
03,005,01,002,0034,69 ,593,7,600,897,0,3,1,3,0,1,0,76.14,66.89 ,33.33
03,005,01,002,0034,70 ,578,5,583,869,0,3,1,3,0,1,0,76.14,67.09 ,33.33
03,005,01,002,0035,71 ,618,9,627,997,0,3,1,3,0,1,0,76.14,62.89 ,33.33
03,005,01,002,0036,72 ,374,4,378,597,0,3,1,3,0,1,0,76.14,63.32 ,33.33
03,005,01,002,0037,73 ,747,4,751,1107,0,3,1,3,0,1,0,76.14,67.84 ,33.33
03,005,01,002,0038,74 ,519,6,525,814,0,3,1,3,0,1,0,76.14,64.50 ,33.33
03,005,01,002,0038,75 ,474,3,477,714,0,3,1,3,0,1,0,76.14,66.81 ,33.33
03,005,01,002,0039,76 ,586,8,594,899,0,3,1,3,0,1,0,76.14,66.07 ,33.33
03,005,01,002,0039,77 ,463,4,467,725,0,3,1,3,0,1,0,76.14,64.41 ,33.33
03,005,01,002,0040,78 ,772,13,785,1224,0,3,1,3,0,1,0,76.14,64.13 ,33.33
03,005,01,002,0041,79 ,444,4,448,616,0,3,1,3,0,1,0,76.14,72.73 ,33.33
03,005,01,002,0042,80 ,617,14,631,896,0,3,1,3,0,1,0,76.14,70.42 ,33.33
03,005,01,002,0043,81 ,464,12,476,718,0,3,1,3,0,1,0,76.14,66.30 ,33.33
03,005,01,002,0044,82 ,933,7,940,1447,0,3,1,3,0,1,0,76.14,64.96 ,33.33
03,005,01,002,0045,83 ,960,23,983,1501,0,3,1,3,0,1,0,76.14,65.49 ,33.33
03,005,01,002,0046,84 ,986,15,1001,1548,0,3,1,3,0,1,0,76.14,64.66 ,33.33
03,005,01,002,0047,85 ,606,11,617,975,0,3,1,3,0,1,0,76.14,63.28 ,33.33
03,005,01,002,0047,86 ,613,4,617,986,0,3,1,3,0,1,0,76.14,62.58 ,33.33
03,005,01,002,0048,87 ,771,6,777,1157,0,3,1,3,0,1,0,76.14,67.16 ,33.33
03,005,01,002,0049,88 ,858,7,865,1313,0,3,1,3,0,1,0,76.14,65.88 ,33.33
03,005,01,003,0050,89 ,873,10,883,1262,0,3,1,3,0,1,0,76.14,69.97 ,33.33
03,005,01,003,0051,90 ,848,6,854,1193,0,3,1,3,0,1,0,76.14,71.58 ,33.33
03,005,01,003,0051,91 ,697,2,699,958,0,3,1,3,0,1,0,76.14,72.96 ,33.33
03,005,01,003,0052,92 ,897,5,902,1321,0,3,1,3,0,1,0,76.14,68.28 ,33.33
03,005,01,003,0052,93 ,823,5,828,1154,0,3,1,3,0,1,0,76.14,71.75 ,33.33
03,005,01,003,0052,94 ,699,10,709,1116,0,3,1,3,0,1,0,76.14,63.53 ,33.33
03,005,01,003,0053,95 ,926,7,933,1296,0,3,1,3,0,1,0,76.14,71.99 ,33.33
03,005,01,003,0054,96 ,462,4,466,661,0,3,1,3,0,1,0,76.14,70.50 ,33.33
03,005,01,003,0054,97 ,551,1,552,774,0,3,1,3,0,1,0,76.14,71.32 ,33.33
03,005,01,003,0055,98 ,561,4,565,816,0,3,1,3,0,1,0,76.14,69.24 ,33.33
03,005,01,003,0055,99 ,462,5,467,663,0,3,1,3,0,1,0,76.14,70.44 ,33.33
03,005,01,003,0056,100 ,804,4,808,1187,0,3,1,3,0,1,0,76.14,68.07 ,33.33
03,005,01,003,0056,101 ,821,8,829,1315,0,3,1,3,0,1,0,76.14,63.04 ,33.33
03,005,01,003,0057,102 ,824,5,829,1184,0,3,1,3,0,1,0,76.14,70.02 ,33.33
03,005,01,003,0058,103 ,440,9,449,647,0,3,1,3,0,1,0,76.14,69.40 ,33.33
03,005,01,003,0059,104 ,612,5,617,827,0,3,1,3,0,1,0,76.14,74.61 ,33.33
03,005,01,003,0060,105 ,665,11,676,1016,0,3,1,3,0,1,0,76.14,66.54 ,33.33
03,005,01,003,0061,106 ,446,10,456,695,0,3,1,3,0,1,0,76.14,65.61 ,33.33
03,005,01,003,0062,107 ,543,1,544,753,0,3,1,3,0,1,0,76.14,72.24 ,33.33
03,005,01,003,0063,108 ,715,7,722,1013,0,3,1,3,0,1,0,76.14,71.27 ,33.33
03,005,01,003,0063,109 ,516,4,520,736,0,3,1,3,0,1,0,76.14,70.65 ,33.33
03,005,01,003,0064,110 ,386,5,391,560,0,3,1,3,0,1,0,76.14,69.82 ,33.33
03,005,01,003,0065,111 ,645,11,656,937,0,3,1,3,0,1,0,76.14,70.01 ,33.33
03,005,01,003,0066,112 ,342,1,343,509,0,3,1,3,0,1,0,76.14,67.39 ,33.33
03,005,01,003,0067,113 ,514,5,519,779,0,3,1,3,0,1,0,76.14,66.62 ,33.33
03,005,01,003,0068,114 ,744,11,755,1113,0,3,1,3,0,1,0,76.14,67.83 ,33.33
03,005,01,003,0068,115 ,670,5,675,1015,0,3,1,3,0,1,0,76.14,66.50 ,33.33
03,005,01,003,0069,116 ,872,19,891,1254,0,3,1,3,0,1,0,76.14,71.05 ,33.33
03,005,01,003,0070,117 ,495,9,504,759,0,3,1,3,0,1,0,76.14,66.40 ,33.33
03,005,01,003,0071,118 ,400,8,408,649,0,3,1,3,0,1,0,76.14,62.87 ,33.33
03,005,01,003,0071,119 ,405,4,409,666,0,3,1,3,0,1,0,76.14,61.41 ,33.33
03,005,01,003,0072,120 ,529,5,534,813,0,3,1,3,0,1,0,76.14,65.68 ,33.33
03,005,01,004,0073,121 ,718,8,726,1070,0,3,1,3,0,1,0,76.14,67.85 ,33.33
03,005,01,004,0073,122 ,531,7,538,788,0,3,1,3,0,1,0,76.14,68.27 ,33.33
03,005,01,004,0074,123 ,842,5,847,1238,0,3,1,3,0,1,0,76.14,68.42 ,33.33
03,005,01,004,0074,124 ,744,6,750,1080,0,3,1,3,0,1,0,76.14,69.44 ,33.33
03,005,01,004,0075,125 ,624,8,632,921,0,3,1,3,0,1,0,76.14,68.62 ,33.33
03,005,01,004,0075,126 ,807,12,819,1297,0,3,1,3,0,1,0,76.14,63.15 ,33.33
03,005,01,004,0076,127 ,511,6,517,825,0,3,1,3,0,1,0,76.14,62.67 ,33.33
03,005,01,004,0076,128 ,542,2,544,799,0,3,1,3,0,1,0,76.14,68.09 ,33.33
03,005,01,004,0076,129 ,732,9,741,1077,0,3,1,3,0,1,0,76.14,68.80 ,33.33
03,005,01,004,0077,130 ,818,10,828,1184,0,3,1,3,0,1,0,76.14,69.93 ,33.33
03,005,01,004,0077,131 ,654,19,673,1014,0,3,1,3,0,1,0,76.14,66.37 ,33.33
03,005,01,004,0077,132 ,591,4,595,868,0,3,1,3,0,1,0,76.14,68.55 ,33.33
03,005,01,004,0078,133 ,814,13,827,1213,0,3,1,3,0,1,0,76.14,68.18 ,33.33
03,005,01,004,0078,134 ,834,4,838,1256,0,3,1,3,0,1,0,76.14,66.72 ,33.33
03,005,01,004,0079,135 ,657,7,664,986,0,3,1,3,0,1,0,76.14,67.34 ,33.33
03,005,01,004,0079,136 ,734,8,742,1189,0,3,1,3,0,1,0,76.14,62.41 ,33.33
03,005,01,004,0080,137 ,530,13,543,849,0,3,1,3,0,1,0,76.14,63.96 ,33.33
03,005,01,004,0080,138 ,574,12,586,910,0,3,1,3,0,1,0,76.14,64.40 ,33.33
03,005,01,004,0080,139 ,614,21,635,949,0,3,1,3,0,1,0,76.14,66.91 ,33.33
03,005,01,004,0081,140 ,576,6,582,831,0,3,1,3,0,1,0,76.14,70.04 ,33.33
03,005,01,004,0081,141 ,495,9,504,774,0,3,1,3,0,1,0,76.14,65.12 ,33.33
03,005,01,004,0081,142 ,883,5,888,1337,0,3,1,3,0,1,0,76.14,66.42 ,33.33
03,005,01,004,0081,143 ,833,8,841,1218,0,3,1,3,0,1,0,76.14,69.05 ,33.33
03,005,01,004,0082,144 ,775,10,785,1167,0,3,1,3,0,1,0,76.14,67.27 ,33.33
03,005,01,004,0082,145 ,902,9,911,1600,0,3,1,3,0,1,0,76.14,56.94 ,33.33
03,005,01,004,0082,146 ,683,7,690,1052,0,3,1,3,0,1,0,76.14,65.59 ,33.33
03,005,01,004,0082,147 ,670,0,670,1041,0,3,1,3,0,1,0,76.14,64.36 ,33.33
03,005,01,004,0083,148 ,598,10,608,883,0,3,1,3,0,1,0,76.14,68.86 ,33.33
03,005,01,004,0084,149 ,568,13,581,809,0,3,1,3,0,1,0,76.14,71.82 ,33.33
03,005,01,004,0084,150 ,882,10,892,1385,0,3,1,3,0,1,0,76.14,64.40 ,33.33
03,005,01,004,0085,151 ,796,12,808,1150,0,3,1,3,0,1,0,76.14,70.26 ,33.33
03,005,01,004,0086,152 ,1002,17,1019,1547,0,3,1,3,0,1,0,76.14,65.87 ,33.33
03,005,01,004,0087,153 ,366,6,372,526,0,3,1,3,0,1,0,76.14,70.72 ,33.33
03,005,01,004,0088,154 ,672,5,677,1095,0,3,1,3,0,1,0,76.14,61.83 ,33.33
03,005,01,004,0088,155 ,585,11,596,951,0,3,1,3,0,1,0,76.14,62.67 ,33.33
03,005,01,004,0089,156 ,987,11,998,1382,0,3,1,3,0,1,0,76.14,72.21 ,33.33
03,005,01,004,0090,157 ,687,13,700,1087,0,3,1,3,0,1,0,76.14,64.40 ,33.33
03,005,01,004,0091,158 ,557,14,571,794,0,3,1,3,0,1,0,76.14,71.91 ,33.33
03,005,01,004,0091,159 ,756,17,773,1236,0,3,1,3,0,1,0,76.14,62.54 ,33.33
03,005,01,004,0091,160 ,591,15,606,943,0,3,1,3,0,1,0,76.14,64.26 ,33.33
03,005,01,004,0092,161 ,733,10,743,1126,0,3,1,3,0,1,0,76.14,65.99 ,33.33
03,005,01,004,0092,162 ,633,14,647,990,0,3,1,3,0,1,0,76.14,65.35 ,33.33
03,005,01,004,0093,163 ,827,16,843,1365,0,3,1,3,0,1,0,76.14,61.76 ,33.33
03,005,01,004,0093,164 ,733,5,738,1093,0,3,1,3,0,1,0,76.14,67.52 ,33.33
03,005,01,004,0094,165 ,552,7,559,896,0,3,1,3,0,1,0,76.14,62.39 ,33.33
03,005,01,005,0095,166 ,549,6,555,740,0,3,1,3,0,1,0,76.14,75.00 ,33.33
03,005,01,005,0095,167 ,807,18,825,1263,0,3,1,3,0,1,0,76.14,65.32 ,33.33
03,005,01,005,0096,168 ,621,7,628,895,0,3,1,3,0,1,0,76.14,70.17 ,33.33
03,005,01,005,0096,169 ,614,7,621,876,0,3,1,3,0,1,0,76.14,70.89 ,33.33
03,005,01,005,0097,170 ,671,6,677,976,0,3,1,3,0,1,0,76.14,69.36 ,33.33
03,005,01,005,0097,171 ,585,4,589,836,0,3,1,3,0,1,0,76.14,70.45 ,33.33
03,005,01,005,0097,172 ,607,6,613,923,0,3,1,3,0,1,0,76.14,66.41 ,33.33
03,005,01,005,0098,173 ,724,7,731,1022,0,3,1,3,0,1,0,76.14,71.53 ,33.33
03,005,01,005,0098,174 ,728,8,736,1140,0,3,1,3,0,1,0,76.14,64.56 ,33.33
03,005,01,005,0098,175 ,811,11,822,1253,0,3,1,3,0,1,0,76.14,65.60 ,33.33
03,005,01,005,0099,176 ,1017,10,1027,1600,0,3,1,3,0,1,0,76.14,64.19 ,33.33
03,005,01,005,0099,177 ,768,9,777,1209,0,3,1,3,0,1,0,76.14,64.27 ,33.33
03,005,01,005,0100,178 ,883,12,895,1324,0,3,1,3,0,1,0,76.14,67.60 ,33.33
03,005,01,005,0100,179 ,677,10,687,981,0,3,1,3,0,1,0,76.14,70.03 ,33.33
03,005,01,005,0101,180 ,524,5,529,780,0,3,1,3,0,1,0,76.14,67.82 ,33.33
03,005,01,005,0102,181 ,871,10,881,1412,0,3,1,3,0,1,0,76.14,62.39 ,33.33
03,005,01,005,0102,182 ,780,8,788,1226,0,3,1,3,0,1,0,76.14,64.27 ,33.33
03,005,01,005,0103,183 ,842,9,851,1344,0,3,1,3,0,1,0,76.14,63.32 ,33.33
03,005,01,005,0103,184 ,1064,8,1072,1560,0,3,1,3,0,1,0,76.14,68.72 ,33.33
03,005,01,005,0103,185 ,862,7,869,1330,0,3,1,3,0,1,0,76.14,65.34 ,33.33
03,005,01,005,0104,186 ,955,28,983,1510,0,3,1,3,0,1,0,76.14,65.10 ,33.33
03,005,01,005,0105,187 ,532,7,539,736,0,3,1,3,0,1,0,76.14,73.23 ,33.33
03,005,01,005,0106,188 ,679,5,684,983,0,3,1,3,0,1,0,76.14,69.58 ,33.33
03,005,01,005,0107,189 ,756,8,764,1098,0,3,1,3,0,1,0,76.14,69.58 ,33.33
03,005,01,005,0108,190 ,601,5,606,967,0,3,1,3,0,1,0,76.14,62.67 ,33.33
03,005,01,005,0108,191 ,692,11,703,1031,0,3,1,3,0,1,0,76.14,68.19 ,33.33
03,005,01,005,0109,192 ,854,13,867,1251,0,3,1,3,0,1,0,76.14,69.30 ,33.33
03,005,01,005,0109,193 ,620,6,626,933,0,3,1,3,0,1,0,76.14,67.10 ,33.33
03,005,01,005,0110,194 ,1010,12,1022,1537,0,3,1,3,0,1,0,76.14,66.49 ,33.33
03,005,01,005,0110,195 ,1007,13,1020,1627,0,3,1,3,0,1,0,76.14,62.69 ,33.33
03,005,01,005,0110,196 ,891,14,905,1337,0,3,1,3,0,1,0,76.14,67.69 ,33.33
03,005,01,005,0111,197 ,736,15,751,1190,0,3,1,3,0,1,0,76.14,63.11 ,33.33
03,005,01,005,0111,198 ,800,7,807,1225,0,3,1,3,0,1,0,76.14,65.88 ,33.33
03,005,01,005,0112,199 ,862,9,871,1344,0,3,1,3,0,1,0,76.14,64.81 ,33.33
03,005,01,005,0112,200 ,735,11,746,1174,0,3,1,3,0,1,0,76.14,63.54 ,33.33
03,005,01,005,0113,201 ,664,8,672,984,0,3,1,3,0,1,0,76.14,68.29 ,33.33
03,005,01,005,0113,202 ,667,10,677,1134,0,3,1,3,0,1,0,76.14,59.70 ,33.33
03,005,01,005,0114,203 ,710,7,717,1095,0,3,1,3,0,1,0,76.14,65.48 ,33.33
03,005,01,005,0114,204 ,752,14,766,1218,0,3,1,3,0,1,0,76.14,62.89 ,33.33
03,005,01,005,0115,205 ,990,18,1008,1543,0,3,1,3,0,1,0,76.14,65.33 ,33.33
03,005,01,005,0116,206 ,550,8,558,864,0,3,1,3,0,1,0,76.14,64.58 ,33.33
03,005,01,005,0116,207 ,488,6,494,768,0,3,1,3,0,1,0,76.14,64.32 ,33.33
03,005,01,005,0117,208 ,577,7,584,916,0,3,1,3,0,1,0,76.14,63.76 ,33.33
03,005,01,005,0117,209 ,620,13,633,974,0,3,1,3,0,1,0,76.14,64.99 ,33.33
03,005,01,005,0118,210 ,932,9,941,1400,0,3,1,3,0,1,0,76.14,67.21 ,33.33
03,005,01,005,0118,211 ,795,13,808,1257,0,3,1,3,0,1,0,76.14,64.28 ,33.33
03,005,01,005,0119,212 ,915,11,926,1293,0,3,1,3,0,1,0,76.14,71.62 ,33.33
03,005,01,005,0120,213 ,897,15,912,1269,0,3,1,3,0,1,0,76.14,71.87 ,33.33
03,005,01,005,0121,214 ,613,7,620,866,0,3,1,3,0,1,0,76.14,71.59 ,33.33
03,005,01,005,0122,215 ,702,6,708,1050,0,3,1,3,0,1,0,76.14,67.43 ,33.33
03,005,01,005,0122,216 ,820,16,836,1321,0,3,1,3,0,1,0,76.14,63.29 ,33.33
03,005,01,005,0123,217 ,676,5,681,1046,0,3,1,3,0,1,0,76.14,65.11 ,33.33
03,005,01,005,0123,218 ,607,6,613,884,0,3,1,3,0,1,0,76.14,69.34 ,33.33
03,005,01,006,0124,219 ,409,9,418,626,0,3,1,3,0,1,0,76.14,66.77 ,33.33
03,005,01,006,0124,220 ,538,10,548,823,0,3,1,3,0,1,0,76.14,66.59 ,33.33
03,005,01,006,0125,221 ,716,7,723,955,0,3,1,3,0,1,0,76.14,75.71 ,33.33
03,005,01,006,0126,222 ,929,16,945,1403,0,3,1,3,0,1,0,76.14,67.36 ,33.33
03,005,01,006,0127,223 ,892,11,903,1223,0,3,1,3,0,1,0,76.14,73.83 ,33.33
03,005,01,006,0127,224 ,747,10,757,1131,0,3,1,3,0,1,0,76.14,66.93 ,33.33
03,005,01,006,0127,225 ,619,6,625,932,0,3,1,3,0,1,0,76.14,67.06 ,33.33
03,005,01,006,0128,226 ,656,12,668,1051,0,3,1,3,0,1,0,76.14,63.56 ,33.33
03,005,01,006,0128,227 ,712,12,724,1126,0,3,1,3,0,1,0,76.14,64.30 ,33.33
03,005,01,006,0129,228 ,890,8,898,1264,0,3,1,3,0,1,0,76.14,71.04 ,33.33
03,005,01,006,0130,229 ,873,13,886,1180,0,3,1,3,0,1,0,76.14,75.08 ,33.33
03,005,01,006,0131,230 ,732,16,748,1048,0,3,1,3,0,1,0,76.14,71.37 ,33.33
03,005,01,006,0131,231 ,763,11,774,1185,0,3,1,3,0,1,0,76.14,65.32 ,33.33
03,005,01,006,0132,232 ,916,17,933,1307,0,3,1,3,0,1,0,76.14,71.38 ,33.33
03,005,01,006,0133,233 ,450,5,455,649,0,3,1,3,0,1,0,76.14,70.11 ,33.33
03,005,01,006,0134,234 ,870,6,876,1399,0,3,1,3,0,1,0,76.14,62.62 ,33.33
03,005,01,006,0135,235 ,469,9,478,783,0,3,1,3,0,1,0,76.14,61.05 ,33.33
03,005,01,006,0135,236 ,500,5,505,826,0,3,1,3,0,1,0,76.14,61.14 ,33.33
03,005,01,006,0136,237 ,802,15,817,1319,0,3,1,3,0,1,0,76.14,61.94 ,33.33
03,005,01,006,0137,238 ,607,17,624,999,0,3,1,3,0,1,0,76.14,62.46 ,33.33
03,005,01,006,0138,239 ,657,13,670,1157,0,3,1,3,0,1,0,76.14,57.91 ,33.33
03,005,01,006,0139,240 ,600,13,613,1033,0,3,1,3,0,1,0,76.14,59.34 ,33.33
03,005,01,006,0140,241 ,471,9,480,721,0,3,1,3,0,1,0,76.14,66.57 ,33.33
03,005,01,006,0141,242 ,677,20,697,1108,0,3,1,3,0,1,0,76.14,62.91 ,33.33
03,005,01,006,0142,243 ,417,6,423,644,0,3,1,3,0,1,0,76.14,65.68 ,33.33
03,005,01,006,0143,244 ,805,12,817,1250,0,3,1,3,0,1,0,76.14,65.36 ,33.33
03,005,01,006,0144,245 ,528,3,531,816,0,3,1,3,0,1,0,76.14,65.07 ,33.33
03,005,01,006,0145,246 ,641,10,651,1224,0,3,1,3,0,1,0,76.14,53.19 ,33.33
03,005,01,006,0146,247 ,716,19,735,1272,0,3,1,3,0,1,0,76.14,57.78 ,33.33
03,005,01,007,0147,248 ,749,7,756,1045,0,3,1,3,0,1,0,76.14,72.34 ,33.33
03,005,01,007,0147,249 ,761,10,771,1065,0,3,1,3,0,1,0,76.14,72.39 ,33.33
03,005,01,007,0148,250 ,845,5,850,1168,0,3,1,3,0,1,0,76.14,72.77 ,33.33
03,005,01,007,0149,251 ,598,8,606,814,0,3,1,3,0,1,0,76.14,74.45 ,33.33
03,005,01,007,0150,252 ,524,3,527,803,0,3,1,3,0,1,0,76.14,65.63 ,33.33
03,005,01,007,0150,253 ,549,6,555,762,0,3,1,3,0,1,0,76.14,72.83 ,33.33
03,005,01,007,0151,254 ,733,14,747,1011,0,3,1,3,0,1,0,76.14,73.89 ,33.33
03,005,01,007,0152,255 ,373,8,381,564,0,3,1,3,0,1,0,76.14,67.55 ,33.33
03,005,01,007,0153,256 ,507,17,524,723,0,3,1,3,0,1,0,76.14,72.48 ,33.33
03,005,01,007,0154,257 ,487,10,497,757,0,3,1,3,0,1,0,76.14,65.65 ,33.33
03,005,01,007,0154,258 ,558,4,562,804,0,3,1,3,0,1,0,76.14,69.90 ,33.33
03,005,01,007,0154,259 ,308,10,318,438,0,3,1,3,0,1,0,76.14,72.60 ,33.33
03,005,01,007,0155,260 ,476,5,481,675,0,3,1,3,0,1,0,76.14,71.26 ,33.33
03,005,01,007,0155,261 ,523,6,529,732,0,3,1,3,0,1,0,76.14,72.27 ,33.33
03,005,01,007,0155,262 ,487,7,494,668,0,3,1,3,0,1,0,76.14,73.95 ,33.33
03,005,01,007,0156,263 ,607,12,619,968,0,3,1,3,0,1,0,76.14,63.95 ,33.33
03,005,01,007,0156,264 ,326,6,332,473,0,3,1,3,0,1,0,76.14,70.19 ,33.33
03,005,01,007,0157,265 ,446,11,457,693,0,3,1,3,0,1,0,76.14,65.95 ,33.33
03,005,01,008,0158,266 ,543,10,553,794,0,3,1,3,0,1,0,76.14,69.65 ,33.33
03,005,01,008,0158,267 ,594,8,602,907,0,3,1,3,0,1,0,76.14,66.37 ,33.33
03,005,01,008,0159,268 ,508,3,511,673,0,3,1,3,0,1,0,76.14,75.93 ,33.33
03,005,01,008,0160,269 ,534,8,542,849,0,3,1,3,0,1,0,76.14,63.84 ,33.33
03,005,01,008,0160,270 ,543,3,546,787,0,3,1,3,0,1,0,76.14,69.38 ,33.33
03,005,01,008,0161,271 ,874,24,898,1364,0,3,1,3,0,1,0,76.14,65.84 ,33.33
03,005,01,008,0162,272 ,403,9,412,662,0,3,1,3,0,1,0,76.14,62.24 ,33.33
03,005,01,008,0163,273 ,800,11,811,1238,0,3,1,3,0,1,0,76.14,65.51 ,33.33
03,005,01,008,0164,274 ,497,10,507,749,0,3,1,3,0,1,0,76.14,67.69 ,33.33
03,005,01,008,0165,275 ,430,3,433,689,0,3,1,3,0,1,0,76.14,62.84 ,33.33
03,005,01,008,0165,276 ,527,8,535,827,0,3,1,3,0,1,0,76.14,64.69 ,33.33
03,005,01,008,0166,277 ,503,3,506,745,0,3,1,3,0,1,0,76.14,67.92 ,33.33
03,005,01,008,0167,278 ,356,3,359,528,0,3,1,3,0,1,0,76.14,67.99 ,33.33
03,005,01,008,0168,279 ,575,7,582,910,0,3,1,3,0,1,0,76.14,63.96 ,33.33
03,005,01,008,0169,280 ,546,10,556,888,0,3,1,3,0,1,0,76.14,62.61 ,33.33
03,005,01,009,0170,281 ,608,6,614,814,0,3,1,3,0,1,0,76.14,75.43 ,33.33
03,005,01,009,0170,282 ,495,13,508,708,0,3,1,3,0,1,0,76.14,71.75 ,33.33
03,005,01,009,0171,283 ,727,20,747,1059,0,3,1,3,0,1,0,76.14,70.54 ,33.33
03,005,01,009,0171,284 ,726,19,745,1070,0,3,1,3,0,1,0,76.14,69.63 ,33.33
03,005,01,009,0172,285 ,889,5,894,1258,0,3,1,3,0,1,0,76.14,71.07 ,33.33
03,005,01,009,0172,286 ,931,17,948,1416,0,3,1,3,0,1,0,76.14,66.95 ,33.33
03,005,01,009,0173,287 ,656,15,671,997,0,3,1,3,0,1,0,76.14,67.30 ,33.33
03,005,01,009,0173,288 ,625,13,638,944,0,3,1,3,0,1,0,76.14,67.58 ,33.33
03,005,01,009,0174,289 ,629,12,641,893,0,3,1,3,0,1,0,76.14,71.78 ,33.33
03,005,01,009,0174,290 ,512,10,522,763,0,3,1,3,0,1,0,76.14,68.41 ,33.33
03,005,01,009,0175,291 ,654,21,675,963,0,3,1,3,0,1,0,76.14,70.09 ,33.33
03,005,01,009,0176,292 ,736,14,750,1062,0,3,1,3,0,1,0,76.14,70.62 ,33.33
03,005,01,009,0177,293 ,278,5,283,406,0,3,1,3,0,1,0,76.14,69.70 ,33.33
03,005,01,009,0178,294 ,485,11,496,732,0,3,1,3,0,1,0,76.14,67.76 ,33.33
03,005,01,009,0178,295 ,596,10,606,902,0,3,1,3,0,1,0,76.14,67.18 ,33.33
03,005,01,009,0179,296 ,522,8,530,717,0,3,1,3,0,1,0,76.14,73.92 ,33.33
03,005,01,009,0179,297 ,459,13,472,699,0,3,1,3,0,1,0,76.14,67.53 ,33.33
03,005,01,009,0180,298 ,250,2,252,318,0,3,1,3,0,1,0,76.14,79.25 ,33.33
03,005,01,009,0181,299 ,600,11,611,891,0,3,1,3,0,1,0,76.14,68.57 ,33.33
03,005,01,009,0181,300 ,597,12,609,865,0,3,1,3,0,1,0,76.14,70.40 ,33.33
03,005,01,009,0182,301 ,763,12,775,1078,0,3,1,3,0,1,0,76.14,71.89 ,33.33
03,005,01,009,0183,302 ,1029,14,1043,1401,0,3,1,3,0,1,0,76.14,74.45 ,33.33
03,005,01,009,0184,303 ,929,14,943,1325,0,3,1,3,0,1,0,76.14,71.17 ,33.33
03,005,01,009,0185,304 ,897,17,914,1367,0,3,1,3,0,1,0,76.14,66.86 ,33.33
03,005,01,009,0186,305 ,815,12,827,1159,0,3,1,3,0,1,0,76.14,71.35 ,33.33
03,005,01,009,0187,306 ,160,4,164,233,0,3,1,3,0,1,0,76.14,70.39 ,33.33
03,005,01,009,0188,307 ,235,5,240,305,0,3,1,3,0,1,0,76.14,78.69 ,33.33
03,005,01,010,0189,308 ,723,7,730,1046,0,3,1,3,0,1,0,76.14,69.79 ,33.33
03,005,01,010,0190,309 ,583,12,595,883,0,3,1,3,0,1,0,76.14,67.38 ,33.33
03,005,01,010,0190,310 ,523,13,536,756,0,3,1,3,0,1,0,76.14,70.90 ,33.33
03,005,01,010,0191,311 ,698,9,707,1078,0,3,1,3,0,1,0,76.14,65.58 ,33.33
03,005,01,010,0192,312 ,996,5,1001,1444,0,3,1,3,0,1,0,76.14,69.32 ,33.33
03,005,01,010,0192,313 ,1197,16,1213,1698,0,3,1,3,0,1,0,76.14,71.44 ,33.33
03,005,01,010,0192,314 ,623,7,630,988,0,3,1,3,0,1,0,76.14,63.77 ,33.33
03,005,01,010,0193,315 ,879,16,895,1263,0,3,1,3,0,1,0,76.14,70.86 ,33.33
03,005,01,010,0194,316 ,840,11,851,1244,0,3,1,3,0,1,0,76.14,68.41 ,33.33
03,005,01,010,0195,317 ,805,12,817,1212,0,3,1,3,0,1,0,76.14,67.41 ,33.33
03,005,01,010,0195,318 ,962,16,978,1525,0,3,1,3,0,1,0,76.14,64.13 ,33.33
03,005,01,010,0196,319 ,432,7,439,634,0,3,1,3,0,1,0,76.14,69.24 ,33.33
03,005,01,010,0197,320 ,318,9,327,499,0,3,1,3,0,1,0,76.14,65.53 ,33.33
03,005,01,010,0198,321 ,364,5,369,566,0,3,1,3,0,1,0,76.14,65.19 ,33.33
03,005,01,011,0199,322 ,370,4,374,540,0,3,1,3,0,1,0,76.14,69.26 ,33.33
03,005,01,011,0199,323 ,477,7,484,728,0,3,1,3,0,1,0,76.14,66.48 ,33.33
03,005,01,011,0200,324 ,447,7,454,674,0,3,1,3,0,1,0,76.14,67.36 ,33.33
03,005,01,011,0201,325 ,453,7,460,666,0,3,1,3,0,1,0,76.14,69.07 ,33.33
03,005,01,011,0201,326 ,263,5,268,397,0,3,1,3,0,1,0,76.14,67.51 ,33.33
03,005,01,011,0202,327 ,521,8,529,865,0,3,1,3,0,1,0,76.14,61.16 ,33.33
03,005,01,011,0203,328 ,318,2,320,484,0,3,1,3,0,1,0,76.14,66.12 ,33.33
03,005,01,011,0203,329 ,307,3,310,517,0,3,1,3,0,1,0,76.14,59.96 ,33.33
03,005,01,011,0204,330 ,750,10,760,1066,0,3,1,3,0,1,0,76.14,71.29 ,33.33
03,005,01,011,0205,331 ,683,6,689,1059,0,3,1,3,0,1,0,76.14,65.06 ,33.33
03,005,01,011,0206,332 ,274,3,277,450,0,3,1,3,0,1,0,76.14,61.56 ,33.33
03,005,01,011,0207,333 ,167,1,168,286,0,3,1,3,0,1,0,76.14,58.74 ,33.33
03,005,01,012,0208,334 ,895,9,904,1280,0,3,1,3,0,1,0,76.14,70.63 ,33.33
03,005,01,012,0208,335 ,779,4,783,1087,0,3,1,3,0,1,0,76.14,72.03 ,33.33
03,005,01,012,0209,336 ,512,8,520,790,0,3,1,3,0,1,0,76.14,65.82 ,33.33
03,005,01,012,0209,337 ,567,7,574,796,0,3,1,3,0,1,0,76.14,72.11 ,33.33
03,005,01,012,0210,338 ,440,9,449,658,0,3,1,3,0,1,0,76.14,68.24 ,33.33
03,005,01,012,0211,339 ,623,4,627,851,0,3,1,3,0,1,0,76.14,73.68 ,33.33
03,005,01,012,0212,340 ,246,0,246,344,0,3,1,3,0,1,0,76.14,71.51 ,33.33
03,005,01,012,0213,341 ,611,10,621,899,0,3,1,3,0,1,0,76.14,69.08 ,33.33
03,005,01,012,0213,342 ,599,17,616,957,0,3,1,3,0,1,0,76.14,64.37 ,33.33
03,005,01,012,0214,343 ,646,10,656,900,0,3,1,3,0,1,0,76.14,72.89 ,33.33
03,005,01,012,0214,344 ,150,2,152,204,0,3,1,3,0,1,0,76.14,74.51 ,33.33
03,005,01,012,0215,345 ,225,1,226,332,0,3,1,3,0,1,0,76.14,68.07 ,33.33
03,005,01,013,0216,346 ,676,4,680,982,0,3,1,3,0,1,0,76.14,69.25 ,33.33
03,005,01,013,0216,347 ,625,8,633,936,0,3,1,3,0,1,0,76.14,67.63 ,33.33
03,005,01,013,0216,348 ,685,24,709,1018,0,3,1,3,0,1,0,76.14,69.65 ,33.33
03,005,01,013,0216,349 ,675,9,684,945,0,3,1,3,0,1,0,76.14,72.38 ,33.33
03,005,01,013,0217,350 ,657,13,670,955,0,3,1,3,0,1,0,76.14,70.16 ,33.33
03,005,01,013,0217,351 ,441,7,448,710,0,3,1,3,0,1,0,76.14,63.10 ,33.33
03,005,01,013,0217,352 ,707,7,714,1210,0,3,1,3,0,1,0,76.14,59.01 ,33.33
03,005,01,013,0218,353 ,631,10,641,921,0,3,1,3,0,1,0,76.14,69.60 ,33.33
03,005,01,013,0218,354 ,520,6,526,706,0,3,1,3,0,1,0,76.14,74.50 ,33.33
03,005,01,013,0219,355 ,474,15,489,688,0,3,1,3,0,1,0,76.14,71.08 ,33.33
03,005,01,013,0219,356 ,474,9,483,664,0,3,1,3,0,1,0,76.14,72.74 ,33.33
03,005,01,013,0220,357 ,402,6,408,554,0,3,1,3,0,1,0,76.14,73.65 ,33.33
03,005,01,013,0220,358 ,493,9,502,728,0,3,1,3,0,1,0,76.14,68.96 ,33.33
03,005,01,013,0221,359 ,304,7,311,403,0,3,1,3,0,1,0,76.14,77.17 ,33.33
03,005,01,013,0222,360 ,576,7,583,818,0,3,1,3,0,1,0,76.14,71.27 ,33.33
03,005,01,013,0222,361 ,259,3,262,354,0,3,1,3,0,1,0,76.14,74.01 ,33.33
03,005,01,014,0223,362 ,418,7,425,606,0,3,1,3,0,1,0,76.14,70.13 ,33.33
03,005,01,014,0224,363 ,407,0,407,560,0,3,1,3,0,1,0,76.14,72.68 ,33.33
03,005,01,014,0225,364 ,603,9,612,915,0,3,1,3,0,1,0,76.14,66.89 ,33.33
03,005,01,014,0226,365 ,448,6,454,645,0,3,1,3,0,1,0,76.14,70.39 ,33.33
03,005,01,014,0227,366 ,630,13,643,971,0,3,1,3,0,1,0,76.14,66.22 ,33.33
03,005,01,014,0228,367 ,353,4,357,540,0,3,1,3,0,1,0,76.14,66.11 ,33.33
03,005,01,014,0229,368 ,338,8,346,538,0,3,1,3,0,1,0,76.14,64.31 ,33.33
03,005,01,014,0230,369 ,734,21,755,1145,0,3,1,3,0,1,0,76.14,65.94 ,33.33
03,005,01,014,0231,370 ,417,7,424,650,0,3,1,3,0,1,0,76.14,65.23 ,33.33
03,005,01,015,0232,371 ,1132,13,1145,1669,0,3,1,3,0,1,0,76.14,68.60 ,33.33
03,005,01,015,0233,372 ,340,9,349,477,0,3,1,3,0,1,0,76.14,73.17 ,33.33
03,005,01,015,0234,373 ,678,7,685,971,0,3,1,3,0,1,0,76.14,70.55 ,33.33
03,005,01,015,0235,374 ,1070,10,1080,1576,0,3,1,3,0,1,0,76.14,68.53 ,33.33
03,005,01,015,0235,375 ,910,17,927,1388,0,3,1,3,0,1,0,76.14,66.79 ,33.33
03,005,01,015,0236,376 ,373,7,380,538,0,3,1,3,0,1,0,76.14,70.63 ,33.33
03,005,01,015,0237,377 ,380,2,382,506,0,3,1,3,0,1,0,76.14,75.49 ,33.33
03,005,01,015,0238,378 ,886,10,896,1363,0,3,1,3,0,1,0,76.14,65.74 ,33.33
03,005,01,015,0239,379 ,485,8,493,712,0,3,1,3,0,1,0,76.14,69.24 ,33.33
03,005,01,015,0240,380 ,676,12,688,1003,0,3,1,3,0,1,0,76.14,68.59 ,33.33
03,005,01,016,0241,381 ,734,6,740,1027,0,3,1,3,0,1,0,76.14,72.05 ,33.33
03,005,01,016,0241,382 ,674,4,678,1072,0,3,1,3,0,1,0,76.14,63.25 ,33.33
03,005,01,016,0242,383 ,428,4,432,598,0,3,1,3,0,1,0,76.14,72.24 ,33.33
03,005,01,016,0243,384 ,562,7,569,840,0,3,1,3,0,1,0,76.14,67.74 ,33.33
03,005,01,016,0244,385 ,162,3,165,231,0,3,1,3,0,1,0,76.14,71.43 ,33.33
03,005,01,016,0245,386 ,367,4,371,546,0,3,1,3,0,1,0,76.14,67.95 ,33.33
03,005,01,016,0246,387 ,411,2,413,622,0,3,1,3,0,1,0,76.14,66.40 ,33.33
03,005,01,016,0247,388 ,316,4,320,484,0,3,1,3,0,1,0,76.14,66.12 ,33.33
03,005,01,016,0248,389 ,249,2,251,352,0,3,1,3,0,1,0,76.14,71.31 ,33.33
03,005,01,017,0249,390 ,176,4,180,272,0,3,1,3,0,1,0,76.14,66.18 ,33.33
03,005,01,017,0250,391 ,398,8,406,643,0,3,1,3,0,1,0,76.14,63.14 ,33.33
03,005,01,017,0251,392 ,666,5,671,958,0,3,1,3,0,1,0,76.14,70.04 ,33.33
03,005,01,017,0252,393 ,416,5,421,628,0,3,1,3,0,1,0,76.14,67.04 ,33.33
03,005,01,017,0253,394 ,425,8,433,641,0,3,1,3,0,1,0,76.14,67.55 ,33.33
03,005,01,017,0254,395 ,223,4,227,352,0,3,1,3,0,1,0,76.14,64.49 ,33.33
03,005,01,017,0255,396 ,509,7,516,763,0,3,1,3,0,1,0,76.14,67.63 ,33.33
03,005,01,018,0256,397 ,99,3,102,137,0,3,1,3,0,1,0,76.14,74.45 ,33.33
03,005,01,018,0257,398 ,236,3,239,391,0,3,1,3,0,1,0,76.14,61.13 ,33.33
03,005,01,018,0258,399 ,190,3,193,282,0,3,1,3,0,1,0,76.14,68.44 ,33.33
03,005,01,018,0258,400 ,222,3,225,340,0,3,1,3,0,1,0,76.14,66.18 ,33.33
03,005,01,018,0259,401 ,67,0,67,104,0,3,1,3,0,1,0,76.14,64.42 ,33.33
03,005,01,018,0260,402 ,85,1,86,120,0,3,1,3,0,1,0,76.14,71.67 ,33.33
03,005,01,018,0261,403 ,17,0,17,26,0,3,1,3,0,1,0,76.14,65.38 ,33.33
03,005,01,018,0262,404 ,30,0,30,49,0,3,1,3,0,1,0,76.14,61.22 ,33.33
03,005,01,018,0263,405 ,15,1,16,31,0,3,1,3,0,1,0,76.14,51.61 ,33.33
03,006,01,001,0001,1 ,601,8,609,935,0,3,1,3,0,1,0,76.14,65.13 ,33.33
03,006,01,001,0001,2 ,647,11,658,985,0,3,1,3,0,1,0,76.14,66.80 ,33.33
03,006,01,001,0002,3 ,664,8,672,1033,0,3,1,3,0,1,0,76.14,65.05 ,33.33
03,006,01,001,0003,4 ,561,3,564,880,0,3,1,3,0,1,0,76.14,64.09 ,33.33
03,006,01,001,0004,5 ,675,6,681,945,0,3,1,3,0,1,0,76.14,72.06 ,33.33
03,006,01,001,0005,6 ,549,5,554,801,0,3,1,3,0,1,0,76.14,69.16 ,33.33
03,006,01,001,0006,7 ,951,9,960,1438,0,3,1,3,0,1,0,76.14,66.76 ,33.33
03,006,01,001,0006,8 ,890,11,901,1372,0,3,1,3,0,1,0,76.14,65.67 ,33.33
03,006,01,001,0006,9 ,1140,14,1154,1637,0,3,1,3,0,1,0,76.14,70.49 ,33.33
03,006,01,001,0007,10 ,641,5,646,958,0,3,1,3,0,1,0,76.14,67.43 ,33.33
03,006,01,001,0007,11 ,746,6,752,1107,0,3,1,3,0,1,0,76.14,67.93 ,33.33
03,006,01,001,0008,12 ,808,13,821,1254,0,3,1,3,0,1,0,76.14,65.47 ,33.33
03,006,01,001,0008,13 ,780,10,790,1177,0,3,1,3,0,1,0,76.14,67.12 ,33.33
03,006,01,001,0009,14 ,803,13,816,1202,0,3,1,3,0,1,0,76.14,67.89 ,33.33
03,006,01,001,0009,15 ,839,16,855,1323,0,3,1,3,0,1,0,76.14,64.63 ,33.33
03,006,01,001,0009,16 ,768,16,784,1096,0,3,1,3,0,1,0,76.14,71.53 ,33.33
03,006,01,001,0010,17 ,1163,27,1190,1792,0,3,1,3,0,1,0,76.14,66.41 ,33.33
03,006,01,001,0010,18 ,1168,24,1192,1865,0,3,1,3,0,1,0,76.14,63.91 ,33.33
03,006,01,001,0010,19 ,844,13,857,1266,0,3,1,3,0,1,0,76.14,67.69 ,33.33
03,006,01,001,0010,20 ,746,9,755,1218,0,3,1,3,0,1,0,76.14,61.99 ,33.33
03,006,01,001,0011,21 ,1174,14,1188,1732,0,3,1,3,0,1,0,76.14,68.59 ,33.33
03,006,01,001,0012,22 ,851,13,864,1208,0,3,1,3,0,1,0,76.14,71.52 ,33.33
03,006,01,001,0013,23 ,853,10,863,1263,0,3,1,3,0,1,0,76.14,68.33 ,33.33
03,006,01,001,0013,24 ,906,14,920,1422,0,3,1,3,0,1,0,76.14,64.70 ,33.33
03,006,01,001,0014,25 ,660,6,666,880,0,3,1,3,0,1,0,76.14,75.68 ,33.33
03,006,01,001,0015,26 ,566,6,572,808,0,3,1,3,0,1,0,76.14,70.79 ,33.33
03,006,01,001,0016,27 ,1022,13,1035,1458,0,3,1,3,0,1,0,76.14,70.99 ,33.33
03,006,01,001,0016,28 ,1091,9,1100,1668,0,3,1,3,0,1,0,76.14,65.95 ,33.33
03,006,01,001,0016,29 ,1044,12,1056,1541,0,3,1,3,0,1,0,76.14,68.53 ,33.33
03,006,01,001,0017,30 ,761,8,769,1159,0,3,1,3,0,1,0,76.14,66.35 ,33.33
03,006,01,001,0017,31 ,696,9,705,984,0,3,1,3,0,1,0,76.14,71.65 ,33.33
03,006,01,001,0018,32 ,827,12,839,1234,0,3,1,3,0,1,0,76.14,67.99 ,33.33
03,006,01,001,0018,33 ,983,28,1011,1485,0,3,1,3,0,1,0,76.14,68.08 ,33.33
03,006,01,001,0019,34 ,947,13,960,1485,0,3,1,3,0,1,0,76.14,64.65 ,33.33
03,006,01,001,0019,35 ,913,12,925,1421,0,3,1,3,0,1,0,76.14,65.10 ,33.33
03,006,01,001,0019,36 ,892,9,901,1479,0,3,1,3,0,1,0,76.14,60.92 ,33.33
03,006,01,001,0019,37 ,824,14,838,1364,0,3,1,3,0,1,0,76.14,61.44 ,33.33
03,006,01,001,0019,38 ,962,13,975,1544,0,3,1,3,0,1,0,76.14,63.15 ,33.33
03,006,01,001,0020,39 ,1055,21,1076,1624,0,3,1,3,0,1,0,76.14,66.26 ,33.33
03,006,01,001,0020,40 ,899,11,910,1424,0,3,1,3,0,1,0,76.14,63.90 ,33.33
03,006,01,001,0020,41 ,1061,17,1078,1627,0,3,1,3,0,1,0,76.14,66.26 ,33.33
03,006,01,001,0021,42 ,969,17,986,1420,0,3,1,3,0,1,0,76.14,69.44 ,33.33
03,006,01,001,0022,43 ,664,7,671,1052,0,3,1,3,0,1,0,76.14,63.78 ,33.33
03,006,01,001,0023,44 ,1076,23,1099,1705,0,3,1,3,0,1,0,76.14,64.46 ,33.33
03,006,01,001,0023,45 ,955,11,966,1404,0,3,1,3,0,1,0,76.14,68.80 ,33.33
03,006,01,001,0023,46 ,895,10,905,1401,0,3,1,3,0,1,0,76.14,64.60 ,33.33
03,006,01,001,0024,47 ,1136,26,1162,1727,0,3,1,3,0,1,0,76.14,67.28 ,33.33
03,006,01,001,0024,48 ,1136,16,1152,1755,0,3,1,3,0,1,0,76.14,65.64 ,33.33
03,006,01,001,0024,49 ,1034,31,1065,1657,0,3,1,3,0,1,0,76.14,64.27 ,33.33
03,006,01,001,0024,50 ,1040,17,1057,1579,0,3,1,3,0,1,0,76.14,66.94 ,33.33
03,006,01,001,0024,51 ,1019,23,1042,1563,0,3,1,3,0,1,0,76.14,66.67 ,33.33
03,006,01,001,0025,52 ,1201,19,1220,1794,0,3,1,3,0,1,0,76.14,68.00 ,33.33
03,006,01,001,0025,53 ,1052,20,1072,1600,0,3,1,3,0,1,0,76.14,67.00 ,33.33
03,006,01,001,0026,54 ,775,19,794,1149,0,3,1,3,0,1,0,76.14,69.10 ,33.33
03,006,01,001,0026,55 ,809,10,819,1223,0,3,1,3,0,1,0,76.14,66.97 ,33.33
03,006,01,001,0027,56 ,967,12,979,1476,0,3,1,3,0,1,0,76.14,66.33 ,33.33
03,006,01,001,0027,57 ,1234,24,1258,1979,0,3,1,3,0,1,0,76.14,63.57 ,33.33
03,006,01,001,0027,58 ,986,11,997,1478,0,3,1,3,0,1,0,76.14,67.46 ,33.33
03,006,01,001,0027,59 ,1049,19,1068,1597,0,3,1,3,0,1,0,76.14,66.88 ,33.33
03,006,01,001,0028,60 ,975,13,988,1521,0,3,1,3,0,1,0,76.14,64.96 ,33.33
03,006,01,001,0028,61 ,1146,13,1159,1666,0,3,1,3,0,1,0,76.14,69.57 ,33.33
03,006,01,001,0028,62 ,1208,16,1224,1824,0,3,1,3,0,1,0,76.14,67.11 ,33.33
03,006,01,001,0028,63 ,973,5,978,1454,0,3,1,3,0,1,0,76.14,67.26 ,33.33
03,006,01,001,0028,64 ,933,14,947,1461,0,3,1,3,0,1,0,76.14,64.82 ,33.33
03,006,01,001,0028,65 ,1014,13,1027,1549,0,3,1,3,0,1,0,76.14,66.30 ,33.33
03,006,01,001,0029,66 ,950,10,960,1433,0,3,1,3,0,1,0,76.14,66.99 ,33.33
03,006,01,001,0030,67 ,825,12,837,1177,0,3,1,3,0,1,0,76.14,71.11 ,33.33
03,006,01,001,0030,68 ,770,8,778,1260,0,3,1,3,0,1,0,76.14,61.75 ,33.33
03,006,01,001,0030,69 ,956,10,966,1467,0,3,1,3,0,1,0,76.14,65.85 ,33.33
03,006,01,001,0031,70 ,1029,15,1044,1565,0,3,1,3,0,1,0,76.14,66.71 ,33.33
03,006,01,001,0031,71 ,930,6,936,1342,0,3,1,3,0,1,0,76.14,69.75 ,33.33
03,006,01,001,0032,72 ,944,15,959,1473,0,3,1,3,0,1,0,76.14,65.11 ,33.33
03,006,01,001,0032,73 ,846,9,855,1224,0,3,1,3,0,1,0,76.14,69.85 ,33.33
03,006,01,001,0033,74 ,1115,19,1134,1636,0,3,1,3,0,1,0,76.14,69.32 ,33.33
03,006,01,001,0034,75 ,799,12,811,1195,0,3,1,3,0,1,0,76.14,67.87 ,33.33
03,006,01,001,0034,76 ,751,14,765,1124,0,3,1,3,0,1,0,76.14,68.06 ,33.33
03,006,01,001,0035,77 ,531,12,543,762,0,3,1,3,0,1,0,76.14,71.26 ,33.33
03,006,01,001,0035,78 ,697,15,712,1037,0,3,1,3,0,1,0,76.14,68.66 ,33.33
03,006,01,001,0036,79 ,1041,20,1061,1554,0,3,1,3,0,1,0,76.14,68.28 ,33.33
03,006,01,001,0036,80 ,802,9,811,1263,0,3,1,3,0,1,0,76.14,64.21 ,33.33
03,006,01,002,0037,81 ,757,11,768,1137,0,3,1,3,0,1,0,76.14,67.55 ,33.33
03,006,01,002,0038,82 ,568,11,579,830,0,3,1,3,0,1,0,76.14,69.76 ,33.33
03,006,01,002,0039,83 ,857,19,876,1341,0,3,1,3,0,1,0,76.14,65.32 ,33.33
03,006,01,002,0040,84 ,552,8,560,815,0,3,1,3,0,1,0,76.14,68.71 ,33.33
03,006,01,002,0040,85 ,705,11,716,1000,0,3,1,3,0,1,0,76.14,71.60 ,33.33
03,006,01,002,0041,86 ,783,12,795,1156,0,3,1,3,0,1,0,76.14,68.77 ,33.33
03,006,01,002,0041,87 ,698,12,710,1072,0,3,1,3,0,1,0,76.14,66.23 ,33.33
03,006,01,002,0042,88 ,640,10,650,964,0,3,1,3,0,1,0,76.14,67.43 ,33.33
03,006,01,002,0043,89 ,1009,19,1028,1538,0,3,1,3,0,1,0,76.14,66.84 ,33.33
03,006,01,002,0044,90 ,829,17,846,1286,0,3,1,3,0,1,0,76.14,65.79 ,33.33
03,006,01,002,0044,91 ,648,8,656,980,0,3,1,3,0,1,0,76.14,66.94 ,33.33
03,006,01,002,0044,92 ,512,3,515,794,0,3,1,3,0,1,0,76.14,64.86 ,33.33
03,006,01,002,0045,93 ,580,12,592,922,0,3,1,3,0,1,0,76.14,64.21 ,33.33
03,006,01,002,0045,94 ,549,2,551,898,0,3,1,3,0,1,0,76.14,61.36 ,33.33
03,006,01,002,0046,95 ,810,7,817,1294,0,3,1,3,0,1,0,76.14,63.14 ,33.33
03,006,01,002,0046,96 ,1154,27,1181,1728,0,3,1,3,0,1,0,76.14,68.34 ,33.33
03,006,01,002,0047,97 ,852,14,866,1347,0,3,1,3,0,1,0,76.14,64.29 ,33.33
03,006,01,002,0048,98 ,993,20,1013,1511,0,3,1,3,0,1,0,76.14,67.04 ,33.33
03,006,01,002,0048,99 ,999,29,1028,1528,0,3,1,3,0,1,0,76.14,67.28 ,33.33
03,006,01,002,0048,100 ,1065,15,1080,1579,0,3,1,3,0,1,0,76.14,68.40 ,33.33
03,006,01,002,0049,101 ,932,13,945,1447,0,3,1,3,0,1,0,76.14,65.31 ,33.33
03,006,01,002,0050,102 ,658,11,669,977,0,3,1,3,0,1,0,76.14,68.47 ,33.33
03,006,01,002,0051,103 ,644,3,647,887,0,3,1,3,0,1,0,76.14,72.94 ,33.33
03,006,01,002,0052,104 ,701,7,708,1063,0,3,1,3,0,1,0,76.14,66.60 ,33.33
03,006,01,002,0052,105 ,581,3,584,855,0,3,1,3,0,1,0,76.14,68.30 ,33.33
03,006,01,002,0053,106 ,814,16,830,1390,0,3,1,3,0,1,0,76.14,59.71 ,33.33
03,006,01,002,0054,107 ,550,5,555,805,0,3,1,3,0,1,0,76.14,68.94 ,33.33
03,006,01,002,0054,108 ,768,9,777,1176,0,3,1,3,0,1,0,76.14,66.07 ,33.33
03,006,01,002,0055,109 ,700,15,715,1070,0,3,1,3,0,1,0,76.14,66.82 ,33.33
03,006,01,002,0055,110 ,395,3,398,624,0,3,1,3,0,1,0,76.14,63.78 ,33.33
03,006,01,002,0056,111 ,1037,17,1054,1580,0,3,1,3,0,1,0,76.14,66.71 ,33.33
03,006,01,002,0057,112 ,759,10,769,1221,0,3,1,3,0,1,0,76.14,62.98 ,33.33
03,006,01,002,0058,113 ,989,17,1006,1684,0,3,1,3,0,1,0,76.14,59.74 ,33.33
03,006,01,002,0059,114 ,473,10,483,734,0,3,1,3,0,1,0,76.14,65.80 ,33.33
03,006,01,002,0060,115 ,487,9,496,657,0,3,1,3,0,1,0,76.14,75.49 ,33.33
03,006,01,002,0061,116 ,923,23,946,1380,0,3,1,3,0,1,0,76.14,68.55 ,33.33
03,006,01,003,0062,117 ,859,12,871,1249,0,3,1,3,0,1,0,76.14,69.74 ,33.33
03,006,01,003,0063,118 ,762,12,774,1161,0,3,1,3,0,1,0,76.14,66.67 ,33.33
03,006,01,003,0064,119 ,552,7,559,819,0,3,1,3,0,1,0,76.14,68.25 ,33.33
03,006,01,003,0064,120 ,536,6,542,825,0,3,1,3,0,1,0,76.14,65.70 ,33.33
03,006,01,003,0065,121 ,516,8,524,745,0,3,1,3,0,1,0,76.14,70.34 ,33.33
03,006,01,003,0066,122 ,579,11,590,845,0,3,1,3,0,1,0,76.14,69.82 ,33.33
03,006,01,003,0066,123 ,657,10,667,1041,0,3,1,3,0,1,0,76.14,64.07 ,33.33
03,006,01,003,0067,124 ,646,7,653,943,0,3,1,3,0,1,0,76.14,69.25 ,33.33
03,006,01,003,0067,125 ,660,7,667,980,0,3,1,3,0,1,0,76.14,68.06 ,33.33
03,006,01,003,0068,126 ,672,13,685,1029,0,3,1,3,0,1,0,76.14,66.57 ,33.33
03,006,01,003,0068,127 ,709,9,718,1052,0,3,1,3,0,1,0,76.14,68.25 ,33.33
03,006,01,003,0068,128 ,699,12,711,1009,0,3,1,3,0,1,0,76.14,70.47 ,33.33
03,006,01,003,0069,129 ,565,9,574,822,0,3,1,3,0,1,0,76.14,69.83 ,33.33
03,006,01,003,0069,130 ,579,9,588,867,0,3,1,3,0,1,0,76.14,67.82 ,33.33
03,006,01,003,0070,131 ,613,8,621,963,0,3,1,3,0,1,0,76.14,64.49 ,33.33
03,006,01,003,0070,132 ,630,9,639,1019,0,3,1,3,0,1,0,76.14,62.71 ,33.33
03,006,01,003,0070,133 ,758,19,777,1194,0,3,1,3,0,1,0,76.14,65.08 ,33.33
03,006,01,003,0071,134 ,570,5,575,845,0,3,1,3,0,1,0,76.14,68.05 ,33.33
03,006,01,003,0072,135 ,585,5,590,892,0,3,1,3,0,1,0,76.14,66.14 ,33.33
03,006,01,003,0073,136 ,807,20,827,1244,0,3,1,3,0,1,0,76.14,66.48 ,33.33
03,006,01,003,0073,137 ,843,15,858,1297,0,3,1,3,0,1,0,76.14,66.15 ,33.33
03,006,01,003,0074,138 ,797,18,815,1056,0,3,1,3,0,1,0,76.14,77.18 ,33.33
03,006,01,003,0075,139 ,709,19,728,1068,0,3,1,3,0,1,0,76.14,68.16 ,33.33
03,006,01,003,0076,140 ,541,11,552,753,0,3,1,3,0,1,0,76.14,73.31 ,33.33
03,006,01,003,0076,141 ,490,7,497,740,0,3,1,3,0,1,0,76.14,67.16 ,33.33
03,006,01,003,0077,142 ,695,5,700,1089,0,3,1,3,0,1,0,76.14,64.28 ,33.33
03,006,01,003,0077,143 ,714,10,724,1034,0,3,1,3,0,1,0,76.14,70.02 ,33.33
03,006,01,003,0077,144 ,703,7,710,1071,0,3,1,3,0,1,0,76.14,66.29 ,33.33
03,006,01,003,0077,145 ,686,6,692,1110,0,3,1,3,0,1,0,76.14,62.34 ,33.33
03,006,01,003,0078,146 ,825,20,845,1234,0,3,1,3,0,1,0,76.14,68.48 ,33.33
03,006,01,003,0079,147 ,517,8,525,776,0,3,1,3,0,1,0,76.14,67.65 ,33.33
03,006,01,003,0079,148 ,491,5,496,775,0,3,1,3,0,1,0,76.14,64.00 ,33.33
03,006,01,003,0080,149 ,669,9,678,979,0,3,1,3,0,1,0,76.14,69.25 ,33.33
03,006,01,003,0081,150 ,631,11,642,972,0,3,1,3,0,1,0,76.14,66.05 ,33.33
03,006,01,003,0081,151 ,689,11,700,1035,0,3,1,3,0,1,0,76.14,67.63 ,33.33
03,006,01,003,0081,152 ,790,11,801,1217,0,3,1,3,0,1,0,76.14,65.82 ,33.33
03,006,01,003,0082,153 ,736,10,746,1193,0,3,1,3,0,1,0,76.14,62.53 ,33.33
03,006,01,003,0083,154 ,752,3,755,1111,0,3,1,3,0,1,0,76.14,67.96 ,33.33
03,006,01,003,0083,155 ,604,7,611,999,0,3,1,3,0,1,0,76.14,61.16 ,33.33
03,006,01,003,0083,156 ,577,9,586,959,0,3,1,3,0,1,0,76.14,61.11 ,33.33
03,006,01,003,0084,157 ,702,8,710,1101,0,3,1,3,0,1,0,76.14,64.49 ,33.33
03,006,01,003,0084,158 ,750,12,762,1199,0,3,1,3,0,1,0,76.14,63.55 ,33.33
03,006,01,003,0085,159 ,579,9,588,939,0,3,1,3,0,1,0,76.14,62.62 ,33.33
03,006,01,003,0085,160 ,528,3,531,871,0,3,1,3,0,1,0,76.14,60.96 ,33.33
03,006,01,003,0085,161 ,592,7,599,979,0,3,1,3,0,1,0,76.14,61.18 ,33.33
03,006,01,003,0085,162 ,652,9,661,1016,0,3,1,3,0,1,0,76.14,65.06 ,33.33
03,006,01,003,0086,163 ,408,7,415,605,0,3,1,3,0,1,0,76.14,68.60 ,33.33
03,006,01,003,0086,164 ,505,10,515,753,0,3,1,3,0,1,0,76.14,68.39 ,33.33
03,006,01,003,0087,165 ,512,8,520,733,0,3,1,3,0,1,0,76.14,70.94 ,33.33
03,006,01,003,0087,166 ,479,12,491,691,0,3,1,3,0,1,0,76.14,71.06 ,33.33
03,006,01,003,0088,167 ,763,24,787,1186,0,3,1,3,0,1,0,76.14,66.36 ,33.33
03,006,01,003,0089,168 ,752,12,764,1048,0,3,1,3,0,1,0,76.14,72.90 ,33.33
03,006,01,003,0090,169 ,876,8,884,1257,0,3,1,3,0,1,0,76.14,70.33 ,33.33
03,006,01,004,0091,170 ,776,5,781,1183,0,3,1,3,0,1,0,76.14,66.02 ,33.33
03,006,01,004,0092,171 ,732,12,744,1063,0,3,1,3,0,1,0,76.14,69.99 ,33.33
03,006,01,004,0093,172 ,634,5,639,976,0,3,1,3,0,1,0,76.14,65.47 ,33.33
03,006,01,004,0093,173 ,706,6,712,1051,0,3,1,3,0,1,0,76.14,67.75 ,33.33
03,006,01,004,0094,174 ,473,6,479,731,0,3,1,3,0,1,0,76.14,65.53 ,33.33
03,006,01,004,0095,175 ,609,6,615,886,0,3,1,3,0,1,0,76.14,69.41 ,33.33
03,006,01,004,0095,176 ,636,6,642,954,0,3,1,3,0,1,0,76.14,67.30 ,33.33
03,006,01,004,0096,177 ,944,12,956,1438,0,3,1,3,0,1,0,76.14,66.48 ,33.33
03,006,01,004,0097,178 ,509,8,517,736,0,3,1,3,0,1,0,76.14,70.24 ,33.33
03,006,01,004,0098,179 ,302,6,308,450,0,3,1,3,0,1,0,76.14,68.44 ,33.33
03,006,01,004,0099,180 ,929,22,951,1434,0,3,1,3,0,1,0,76.14,66.32 ,33.33
03,006,01,004,0099,181 ,643,14,657,974,0,3,1,3,0,1,0,76.14,67.45 ,33.33
03,006,01,004,0100,182 ,704,10,714,1097,0,3,1,3,0,1,0,76.14,65.09 ,33.33
03,006,01,004,0100,183 ,790,6,796,1198,0,3,1,3,0,1,0,76.14,66.44 ,33.33
03,006,01,004,0100,184 ,829,12,841,1249,0,3,1,3,0,1,0,76.14,67.33 ,33.33
03,006,01,004,0100,185 ,828,18,846,1208,0,3,1,3,0,1,0,76.14,70.03 ,33.33
03,006,01,004,0101,186 ,733,17,750,1158,0,3,1,3,0,1,0,76.14,64.77 ,33.33
03,006,01,004,0102,187 ,929,19,948,1434,0,3,1,3,0,1,0,76.14,66.11 ,33.33
03,006,01,004,0103,188 ,756,11,767,1185,0,3,1,3,0,1,0,76.14,64.73 ,33.33
03,006,01,004,0103,189 ,802,13,815,1283,0,3,1,3,0,1,0,76.14,63.52 ,33.33
03,006,01,004,0103,190 ,622,9,631,903,0,3,1,3,0,1,0,76.14,69.88 ,33.33
03,006,01,004,0104,191 ,857,12,869,1317,0,3,1,3,0,1,0,76.14,65.98 ,33.33
03,006,01,004,0104,192 ,866,17,883,1317,0,3,1,3,0,1,0,76.14,67.05 ,33.33
03,006,01,004,0105,193 ,728,16,744,1081,0,3,1,3,0,1,0,76.14,68.83 ,33.33
03,006,01,004,0105,194 ,486,10,496,761,0,3,1,3,0,1,0,76.14,65.18 ,33.33
03,006,01,004,0106,195 ,802,12,814,1259,0,3,1,3,0,1,0,76.14,64.65 ,33.33
03,006,01,004,0106,196 ,647,13,660,1016,0,3,1,3,0,1,0,76.14,64.96 ,33.33
03,006,01,004,0106,197 ,718,15,733,1102,0,3,1,3,0,1,0,76.14,66.52 ,33.33
03,006,01,004,0107,198 ,472,6,478,702,0,3,1,3,0,1,0,76.14,68.09 ,33.33
03,006,01,004,0107,199 ,511,3,514,751,0,3,1,3,0,1,0,76.14,68.44 ,33.33
03,006,01,004,0108,200 ,830,21,851,1315,0,3,1,3,0,1,0,76.14,64.71 ,33.33
03,006,01,004,0109,201 ,836,15,851,1285,0,3,1,3,0,1,0,76.14,66.23 ,33.33
03,006,01,004,0110,202 ,750,13,763,1263,0,3,1,3,0,1,0,76.14,60.41 ,33.33
03,006,01,004,0111,203 ,677,21,698,1061,0,3,1,3,0,1,0,76.14,65.79 ,33.33
03,006,01,004,0112,204 ,804,6,810,1222,0,3,1,3,0,1,0,76.14,66.28 ,33.33
03,006,01,004,0113,205 ,646,8,654,1095,0,3,1,3,0,1,0,76.14,59.73 ,33.33
03,006,01,004,0113,206 ,553,7,560,872,0,3,1,3,0,1,0,76.14,64.22 ,33.33
03,006,01,004,0114,207 ,677,12,689,1035,0,3,1,3,0,1,0,76.14,66.57 ,33.33
03,006,01,004,0114,208 ,671,14,685,1117,0,3,1,3,0,1,0,76.14,61.32 ,33.33
03,006,01,004,0115,209 ,496,5,501,805,0,3,1,3,0,1,0,76.14,62.24 ,33.33
03,006,01,004,0115,210 ,573,8,581,903,0,3,1,3,0,1,0,76.14,64.34 ,33.33
03,006,01,004,0116,211 ,694,14,708,1120,0,3,1,3,0,1,0,76.14,63.21 ,33.33
03,006,01,004,0116,212 ,551,7,558,952,0,3,1,3,0,1,0,76.14,58.61 ,33.33
03,006,01,004,0117,213 ,954,10,964,1488,0,3,1,3,0,1,0,76.14,64.78 ,33.33
03,006,01,004,0117,214 ,946,14,960,1600,0,3,1,3,0,1,0,76.14,60.00 ,33.33
03,006,01,004,0117,215 ,930,6,936,1506,0,3,1,3,0,1,0,76.14,62.15 ,33.33
03,006,01,004,0117,216 ,539,9,548,835,0,3,1,3,0,1,0,76.14,65.63 ,33.33
03,006,01,004,0118,217 ,517,5,522,794,0,3,1,3,0,1,0,76.14,65.74 ,33.33
03,006,01,004,0118,218 ,507,4,511,797,0,3,1,3,0,1,0,76.14,64.12 ,33.33
03,006,01,004,0118,219 ,803,10,813,1249,0,3,1,3,0,1,0,76.14,65.09 ,33.33
03,006,01,004,0119,220 ,712,17,729,1102,0,3,1,3,0,1,0,76.14,66.15 ,33.33
03,006,01,004,0120,221 ,899,17,916,1244,0,3,1,3,0,1,0,76.14,73.63 ,33.33
03,006,01,004,0121,222 ,649,10,659,1004,0,3,1,3,0,1,0,76.14,65.64 ,33.33
03,006,01,004,0122,223 ,677,11,688,1174,0,3,1,3,0,1,0,76.14,58.60 ,33.33
03,006,01,005,0123,224 ,936,11,947,1384,0,3,1,3,0,1,0,76.14,68.42 ,33.33
03,006,01,005,0124,225 ,632,8,640,963,0,3,1,3,0,1,0,76.14,66.46 ,33.33
03,006,01,005,0124,226 ,875,16,891,1213,0,3,1,3,0,1,0,76.14,73.45 ,33.33
03,006,01,005,0125,227 ,789,6,795,1164,0,3,1,3,0,1,0,76.14,68.30 ,33.33
03,006,01,005,0126,228 ,413,4,417,557,0,3,1,3,0,1,0,76.14,74.87 ,33.33
03,006,01,005,0127,229 ,842,15,857,1257,0,3,1,3,0,1,0,76.14,68.18 ,33.33
03,006,01,005,0127,230 ,651,13,664,992,0,3,1,3,0,1,0,76.14,66.94 ,33.33
03,006,01,005,0128,231 ,624,22,646,933,0,3,1,3,0,1,0,76.14,69.24 ,33.33
03,006,01,005,0128,232 ,1116,9,1125,1576,0,3,1,3,0,1,0,76.14,71.38 ,33.33
03,006,01,005,0129,233 ,675,16,691,994,0,3,1,3,0,1,0,76.14,69.52 ,33.33
03,006,01,005,0129,234 ,929,17,946,1434,0,3,1,3,0,1,0,76.14,65.97 ,33.33
03,006,01,005,0129,235 ,776,12,788,1105,0,3,1,3,0,1,0,76.14,71.31 ,33.33
03,006,01,005,0130,236 ,759,11,770,1237,0,3,1,3,0,1,0,76.14,62.25 ,33.33
03,006,01,005,0130,237 ,786,14,800,1230,0,3,1,3,0,1,0,76.14,65.04 ,33.33
03,006,01,005,0130,238 ,815,16,831,1244,0,3,1,3,0,1,0,76.14,66.80 ,33.33
03,006,01,005,0131,239 ,984,14,998,1513,0,3,1,3,0,1,0,76.14,65.96 ,33.33
03,006,01,005,0131,240 ,708,9,717,1055,0,3,1,3,0,1,0,76.14,67.96 ,33.33
03,006,01,005,0131,241 ,657,9,666,1070,0,3,1,3,0,1,0,76.14,62.24 ,33.33
03,006,01,005,0131,242 ,853,15,868,1260,0,3,1,3,0,1,0,76.14,68.89 ,33.33
03,006,01,005,0132,243 ,867,14,881,1231,0,3,1,3,0,1,0,76.14,71.57 ,33.33
03,006,01,005,0132,244 ,835,20,855,1327,0,3,1,3,0,1,0,76.14,64.43 ,33.33
03,006,01,005,0132,245 ,929,15,944,1390,0,3,1,3,0,1,0,76.14,67.91 ,33.33
03,006,01,005,0132,246 ,817,11,828,1235,0,3,1,3,0,1,0,76.14,67.04 ,33.33
03,006,01,005,0133,247 ,587,7,594,843,0,3,1,3,0,1,0,76.14,70.46 ,33.33
03,006,01,005,0134,248 ,889,9,898,1304,0,3,1,3,0,1,0,76.14,68.87 ,33.33
03,006,01,005,0134,249 ,555,7,562,803,0,3,1,3,0,1,0,76.14,69.99 ,33.33
03,006,01,005,0135,250 ,631,6,637,923,0,3,1,3,0,1,0,76.14,69.01 ,33.33
03,006,01,005,0135,251 ,651,19,670,978,0,3,1,3,0,1,0,76.14,68.51 ,33.33
03,006,01,005,0135,252 ,800,15,815,1181,0,3,1,3,0,1,0,76.14,69.01 ,33.33
03,006,01,005,0136,253 ,849,18,867,1189,0,3,1,3,0,1,0,76.14,72.92 ,33.33
03,006,01,005,0137,254 ,626,16,642,944,0,3,1,3,0,1,0,76.14,68.01 ,33.33
03,006,01,005,0137,255 ,731,11,742,1100,0,3,1,3,0,1,0,76.14,67.45 ,33.33
03,006,01,005,0138,256 ,648,11,659,902,0,3,1,3,0,1,0,76.14,73.06 ,33.33
03,006,01,005,0138,257 ,623,14,637,862,0,3,1,3,0,1,0,76.14,73.90 ,33.33
03,006,01,005,0139,258 ,995,15,1010,1406,0,3,1,3,0,1,0,76.14,71.83 ,33.33
03,006,01,005,0139,259 ,742,15,757,1043,0,3,1,3,0,1,0,76.14,72.58 ,33.33
03,006,01,005,0139,260 ,1107,17,1124,1474,0,3,1,3,0,1,0,76.14,76.26 ,33.33
03,006,01,005,0140,261 ,786,10,796,1247,0,3,1,3,0,1,0,76.14,63.83 ,33.33
03,006,01,005,0140,262 ,578,9,587,886,0,3,1,3,0,1,0,76.14,66.25 ,33.33
03,006,01,005,0140,263 ,837,12,849,1237,0,3,1,3,0,1,0,76.14,68.63 ,33.33
03,006,01,005,0141,264 ,1198,17,1215,1750,0,3,1,3,0,1,0,76.14,69.43 ,33.33
03,006,01,005,0142,265 ,722,22,744,1053,0,3,1,3,0,1,0,76.14,70.66 ,33.33
03,006,01,005,0142,266 ,612,9,621,932,0,3,1,3,0,1,0,76.14,66.63 ,33.33
03,006,01,006,0143,267 ,718,20,738,1021,0,3,1,3,0,1,0,76.14,72.28 ,33.33
03,006,01,006,0143,268 ,975,5,980,1395,0,3,1,3,0,1,0,76.14,70.25 ,33.33
03,006,01,006,0144,269 ,666,15,681,908,0,3,1,3,0,1,0,76.14,75.00 ,33.33
03,006,01,006,0144,270 ,721,18,739,1039,0,3,1,3,0,1,0,76.14,71.13 ,33.33
03,006,01,006,0145,271 ,745,10,755,1055,0,3,1,3,0,1,0,76.14,71.56 ,33.33
03,006,01,006,0145,272 ,712,11,723,1034,0,3,1,3,0,1,0,76.14,69.92 ,33.33
03,006,01,006,0145,273 ,720,17,737,1093,0,3,1,3,0,1,0,76.14,67.43 ,33.33
03,006,01,006,0146,274 ,414,5,419,554,0,3,1,3,0,1,0,76.14,75.63 ,33.33
03,006,01,006,0147,275 ,888,19,907,1151,0,3,1,3,0,1,0,76.14,78.80 ,33.33
03,006,01,006,0148,276 ,537,10,547,741,0,3,1,3,0,1,0,76.14,73.82 ,33.33
03,006,01,006,0149,277 ,741,21,762,1073,0,3,1,3,0,1,0,76.14,71.02 ,33.33
03,006,01,006,0149,278 ,867,15,882,1268,0,3,1,3,0,1,0,76.14,69.56 ,33.33
03,006,01,006,0149,279 ,820,10,830,1172,0,3,1,3,0,1,0,76.14,70.82 ,33.33
03,006,01,006,0149,280 ,977,15,992,1320,0,3,1,3,0,1,0,76.14,75.15 ,33.33
03,006,01,006,0150,281 ,890,22,912,1172,0,3,1,3,0,1,0,76.14,77.82 ,33.33
03,006,01,006,0150,282 ,743,13,756,1111,0,3,1,3,0,1,0,76.14,68.05 ,33.33
03,006,01,006,0151,283 ,936,15,951,1339,0,3,1,3,0,1,0,76.14,71.02 ,33.33
03,006,01,006,0151,284 ,913,17,930,1301,0,3,1,3,0,1,0,76.14,71.48 ,33.33
03,006,01,006,0152,285 ,741,16,757,1077,0,3,1,3,0,1,0,76.14,70.29 ,33.33
03,006,01,006,0152,286 ,592,14,606,916,0,3,1,3,0,1,0,76.14,66.16 ,33.33
03,006,01,006,0152,287 ,879,15,894,1273,0,3,1,3,0,1,0,76.14,70.23 ,33.33
03,006,01,006,0152,288 ,1036,28,1064,1464,0,3,1,3,0,1,0,76.14,72.68 ,33.33
03,006,01,006,0153,289 ,857,16,873,1252,0,3,1,3,0,1,0,76.14,69.73 ,33.33
03,006,01,006,0153,290 ,794,15,809,1156,0,3,1,3,0,1,0,76.14,69.98 ,33.33
03,006,01,006,0153,291 ,630,14,644,893,0,3,1,3,0,1,0,76.14,72.12 ,33.33
03,006,01,006,0154,292 ,689,19,708,991,0,3,1,3,0,1,0,76.14,71.44 ,33.33
03,006,01,006,0154,293 ,550,8,558,721,0,3,1,3,0,1,0,76.14,77.39 ,33.33
03,006,01,006,0155,294 ,736,19,755,971,0,3,1,3,0,1,0,76.14,77.75 ,33.33
03,006,01,006,0155,295 ,791,13,804,1081,0,3,1,3,0,1,0,76.14,74.38 ,33.33
03,006,01,006,0156,296 ,833,12,845,1119,0,3,1,3,0,1,0,76.14,75.51 ,33.33
03,006,01,006,0156,297 ,736,20,756,1059,0,3,1,3,0,1,0,76.14,71.39 ,33.33
03,006,01,007,0157,298 ,637,14,651,911,0,3,1,3,0,1,0,76.14,71.46 ,33.33
03,006,01,007,0157,299 ,658,18,676,930,0,3,1,3,0,1,0,76.14,72.69 ,33.33
03,006,01,007,0158,300 ,623,6,629,894,0,3,1,3,0,1,0,76.14,70.36 ,33.33
03,006,01,007,0158,301 ,995,16,1011,1364,0,3,1,3,0,1,0,76.14,74.12 ,33.33
03,006,01,007,0159,302 ,746,10,756,1115,0,3,1,3,0,1,0,76.14,67.80 ,33.33
03,006,01,007,0159,303 ,937,6,943,1341,0,3,1,3,0,1,0,76.14,70.32 ,33.33
03,006,01,007,0159,304 ,697,14,711,1068,0,3,1,3,0,1,0,76.14,66.57 ,33.33
03,006,01,007,0159,305 ,995,22,1017,1525,0,3,1,3,0,1,0,76.14,66.69 ,33.33
03,006,01,007,0160,306 ,849,17,866,1205,0,3,1,3,0,1,0,76.14,71.87 ,33.33
03,006,01,007,0160,307 ,877,8,885,1245,0,3,1,3,0,1,0,76.14,71.08 ,33.33
03,006,01,007,0160,308 ,598,14,612,868,0,3,1,3,0,1,0,76.14,70.51 ,33.33
03,006,01,007,0161,309 ,1233,19,1252,1777,0,3,1,3,0,1,0,76.14,70.46 ,33.33
03,006,01,007,0162,310 ,950,17,967,1397,0,3,1,3,0,1,0,76.14,69.22 ,33.33
03,006,01,007,0162,311 ,856,16,872,1281,0,3,1,3,0,1,0,76.14,68.07 ,33.33
03,006,01,007,0162,312 ,940,15,955,1225,0,3,1,3,0,1,0,76.14,77.96 ,33.33
03,006,01,007,0163,313 ,636,7,643,879,0,3,1,3,0,1,0,76.14,73.15 ,33.33
03,006,01,007,0163,314 ,670,14,684,932,0,3,1,3,0,1,0,76.14,73.39 ,33.33
03,006,01,007,0164,315 ,776,12,788,1123,0,3,1,3,0,1,0,76.14,70.17 ,33.33
03,006,01,007,0164,316 ,899,12,911,1335,0,3,1,3,0,1,0,76.14,68.24 ,33.33
03,006,01,007,0165,317 ,871,15,886,1242,0,3,1,3,0,1,0,76.14,71.34 ,33.33
03,006,01,007,0165,318 ,1039,21,1060,1460,0,3,1,3,0,1,0,76.14,72.60 ,33.33
03,006,01,007,0166,319 ,682,13,695,945,0,3,1,3,0,1,0,76.14,73.54 ,33.33
03,006,01,007,0166,320 ,645,9,654,921,0,3,1,3,0,1,0,76.14,71.01 ,33.33
03,006,01,007,0167,321 ,863,29,892,1226,0,3,1,3,0,1,0,76.14,72.76 ,33.33
03,006,01,007,0168,322 ,988,23,1011,1461,0,3,1,3,0,1,0,76.14,69.20 ,33.33
03,006,01,007,0169,323 ,587,13,600,877,0,3,1,3,0,1,0,76.14,68.42 ,33.33
03,006,01,007,0169,324 ,746,12,758,1038,0,3,1,3,0,1,0,76.14,73.03 ,33.33
03,006,01,007,0170,325 ,862,14,876,1226,0,3,1,3,0,1,0,76.14,71.45 ,33.33
03,006,01,007,0170,326 ,745,11,756,1156,0,3,1,3,0,1,0,76.14,65.40 ,33.33
03,006,01,007,0171,327 ,234,8,242,331,0,3,1,3,0,1,0,76.14,73.11 ,33.33
03,006,01,007,0172,328 ,1081,24,1105,1538,0,3,1,3,0,1,0,76.14,71.85 ,33.33
03,006,01,007,0173,329 ,1141,22,1163,1687,0,3,1,3,0,1,0,76.14,68.94 ,33.33
03,006,01,007,0174,330 ,844,18,862,1231,0,3,1,3,0,1,0,76.14,70.02 ,33.33
03,006,01,008,0175,331 ,811,8,819,1169,0,3,1,3,0,1,0,76.14,70.06 ,33.33
03,006,01,008,0175,332 ,819,8,827,1184,0,3,1,3,0,1,0,76.14,69.85 ,33.33
03,006,01,008,0176,333 ,1012,9,1021,1468,0,3,1,3,0,1,0,76.14,69.55 ,33.33
03,006,01,008,0177,334 ,634,10,644,905,0,3,1,3,0,1,0,76.14,71.16 ,33.33
03,006,01,008,0177,335 ,775,10,785,1120,0,3,1,3,0,1,0,76.14,70.09 ,33.33
03,006,01,008,0178,336 ,709,13,722,1055,0,3,1,3,0,1,0,76.14,68.44 ,33.33
03,006,01,008,0178,337 ,579,14,593,865,0,3,1,3,0,1,0,76.14,68.55 ,33.33
03,006,01,008,0179,338 ,823,17,840,1221,0,3,1,3,0,1,0,76.14,68.80 ,33.33
03,006,01,008,0179,339 ,583,12,595,837,0,3,1,3,0,1,0,76.14,71.09 ,33.33
03,006,01,008,0180,340 ,602,8,610,803,0,3,1,3,0,1,0,76.14,75.97 ,33.33
03,006,01,008,0180,341 ,762,14,776,1114,0,3,1,3,0,1,0,76.14,69.66 ,33.33
03,006,01,008,0181,342 ,842,10,852,1182,0,3,1,3,0,1,0,76.14,72.08 ,33.33
03,006,01,008,0181,343 ,761,8,769,1158,0,3,1,3,0,1,0,76.14,66.41 ,33.33
03,006,01,008,0181,344 ,659,20,679,1092,0,3,1,3,0,1,0,76.14,62.18 ,33.33
03,006,01,008,0182,345 ,645,11,656,897,0,3,1,3,0,1,0,76.14,73.13 ,33.33
03,006,01,008,0183,346 ,918,10,928,1281,0,3,1,3,0,1,0,76.14,72.44 ,33.33
03,006,01,008,0183,347 ,751,8,759,1130,0,3,1,3,0,1,0,76.14,67.17 ,33.33
03,006,01,008,0183,348 ,787,9,796,1241,0,3,1,3,0,1,0,76.14,64.14 ,33.33
03,006,01,008,0183,349 ,880,8,888,1279,0,3,1,3,0,1,0,76.14,69.43 ,33.33
03,006,01,008,0184,350 ,818,23,841,1266,0,3,1,3,0,1,0,76.14,66.43 ,33.33
03,006,01,008,0184,351 ,863,15,878,1285,0,3,1,3,0,1,0,76.14,68.33 ,33.33
03,006,01,008,0184,352 ,822,12,834,1265,0,3,1,3,0,1,0,76.14,65.93 ,33.33
03,006,01,008,0185,353 ,851,12,863,1264,0,3,1,3,0,1,0,76.14,68.28 ,33.33
03,006,01,008,0185,354 ,506,9,515,763,0,3,1,3,0,1,0,76.14,67.50 ,33.33
03,006,01,008,0186,355 ,1047,19,1066,1587,0,3,1,3,0,1,0,76.14,67.17 ,33.33
03,006,01,008,0186,356 ,814,9,823,1351,0,3,1,3,0,1,0,76.14,60.92 ,33.33
03,006,01,008,0187,357 ,866,7,873,1159,0,3,1,3,0,1,0,76.14,75.32 ,33.33
03,006,01,008,0187,358 ,793,17,810,1219,0,3,1,3,0,1,0,76.14,66.45 ,33.33
03,006,01,008,0188,359 ,975,20,995,1484,0,3,1,3,0,1,0,76.14,67.05 ,33.33
03,006,01,008,0188,360 ,1008,24,1032,1559,0,3,1,3,0,1,0,76.14,66.20 ,33.33
03,006,01,008,0188,361 ,988,20,1008,1497,0,3,1,3,0,1,0,76.14,67.33 ,33.33
03,006,01,008,0188,362 ,899,12,911,1401,0,3,1,3,0,1,0,76.14,65.02 ,33.33
03,006,01,008,0189,363 ,753,21,774,1085,0,3,1,3,0,1,0,76.14,71.34 ,33.33
03,006,01,008,0189,364 ,737,16,753,1118,0,3,1,3,0,1,0,76.14,67.35 ,33.33
03,006,01,008,0190,365 ,902,15,917,1217,0,3,1,3,0,1,0,76.14,75.35 ,33.33
03,006,01,008,0190,366 ,806,25,831,1201,0,3,1,3,0,1,0,76.14,69.19 ,33.33
03,006,01,009,0191,367 ,923,8,931,1357,0,3,1,3,0,1,0,76.14,68.61 ,33.33
03,006,01,009,0192,368 ,1279,26,1305,1998,0,3,1,3,0,1,0,76.14,65.32 ,33.33
03,006,01,009,0193,369 ,868,18,886,1519,0,3,1,3,0,1,0,76.14,58.33 ,33.33
03,006,01,009,0193,370 ,1246,18,1264,1919,0,3,1,3,0,1,0,76.14,65.87 ,33.33
03,006,01,009,0193,371 ,890,6,896,1493,0,3,1,3,0,1,0,76.14,60.01 ,33.33
03,006,01,009,0193,372 ,1167,13,1180,1837,0,3,1,3,0,1,0,76.14,64.24 ,33.33
03,006,01,009,0193,373 ,928,9,937,1391,0,3,1,3,0,1,0,76.14,67.36 ,33.33
03,006,01,009,0194,374 ,1149,26,1175,1741,0,3,1,3,0,1,0,76.14,67.49 ,33.33
03,006,01,009,0194,375 ,1055,13,1068,1844,0,3,1,3,0,1,0,76.14,57.92 ,33.33
03,006,01,009,0194,376 ,858,14,872,1411,0,3,1,3,0,1,0,76.14,61.80 ,33.33
03,006,01,009,0194,377 ,1038,19,1057,1701,0,3,1,3,0,1,0,76.14,62.14 ,33.33
03,006,01,009,0195,378 ,1282,15,1297,2378,0,3,1,3,0,1,0,76.14,54.54 ,33.33
03,006,01,009,0195,379 ,791,12,803,1325,0,3,1,3,0,1,0,76.14,60.60 ,33.33
03,006,01,009,0195,380 ,1134,20,1154,1797,0,3,1,3,0,1,0,76.14,64.22 ,33.33
03,006,01,009,0195,381 ,1287,25,1312,2064,0,3,1,3,0,1,0,76.14,63.57 ,33.33
03,006,01,009,0195,382 ,1012,9,1021,1533,0,3,1,3,0,1,0,76.14,66.60 ,33.33
03,006,01,009,0195,383 ,1140,17,1157,1940,0,3,1,3,0,1,0,76.14,59.64 ,33.33
03,006,01,009,0195,384 ,589,10,599,938,0,3,1,3,0,1,0,76.14,63.86 ,33.33
03,006,01,009,0196,385 ,1306,27,1333,2065,0,3,1,3,0,1,0,76.14,64.55 ,33.33
03,006,01,009,0196,386 ,1088,13,1101,1761,0,3,1,3,0,1,0,76.14,62.52 ,33.33
03,006,01,009,0196,387 ,1225,11,1236,2047,0,3,1,3,0,1,0,76.14,60.38 ,33.33
03,006,01,009,0197,388 ,687,12,699,1088,0,3,1,3,0,1,0,76.14,64.25 ,33.33
03,006,01,009,0197,389 ,686,13,699,1038,0,3,1,3,0,1,0,76.14,67.34 ,33.33
03,006,01,009,0197,390 ,718,9,727,1163,0,3,1,3,0,1,0,76.14,62.51 ,33.33
03,006,01,009,0197,391 ,1081,19,1100,1679,0,3,1,3,0,1,0,76.14,65.52 ,33.33
03,006,01,009,0197,392 ,1328,18,1346,1980,0,3,1,3,0,1,0,76.14,67.98 ,33.33
03,006,01,009,0197,393 ,858,9,867,1371,0,3,1,3,0,1,0,76.14,63.24 ,33.33
03,006,01,009,0198,394 ,1042,22,1064,1678,0,3,1,3,0,1,0,76.14,63.41 ,33.33
03,006,01,009,0199,395 ,786,10,796,1174,0,3,1,3,0,1,0,76.14,67.80 ,33.33
03,006,01,009,0199,396 ,1091,17,1108,1786,0,3,1,3,0,1,0,76.14,62.04 ,33.33
03,006,01,009,0200,397 ,1076,14,1090,1647,0,3,1,3,0,1,0,76.14,66.18 ,33.33
03,006,01,009,0200,398 ,833,18,851,1264,0,3,1,3,0,1,0,76.14,67.33 ,33.33
03,006,01,009,0200,399 ,759,4,763,1106,0,3,1,3,0,1,0,76.14,68.99 ,33.33
03,006,01,009,0201,400 ,1012,26,1038,1596,0,3,1,3,0,1,0,76.14,65.04 ,33.33
03,006,01,009,0201,401 ,1100,21,1121,1639,0,3,1,3,0,1,0,76.14,68.40 ,33.33
03,006,01,009,0202,402 ,861,18,879,1442,0,3,1,3,0,1,0,76.14,60.96 ,33.33
03,006,01,009,0203,403 ,895,14,909,1410,0,3,1,3,0,1,0,76.14,64.47 ,33.33
03,006,01,009,0203,404 ,836,20,856,1392,0,3,1,3,0,1,0,76.14,61.49 ,33.33
03,006,01,010,0204,405 ,1123,19,1142,1822,0,3,1,3,0,1,0,76.14,62.68 ,33.33
03,006,01,010,0204,406 ,1056,17,1073,1747,0,3,1,3,0,1,0,76.14,61.42 ,33.33
03,006,01,010,0205,407 ,1172,11,1183,1796,0,3,1,3,0,1,0,76.14,65.87 ,33.33
03,006,01,010,0205,408 ,1164,13,1177,1853,0,3,1,3,0,1,0,76.14,63.52 ,33.33
03,006,01,010,0206,409 ,904,15,919,1563,0,3,1,3,0,1,0,76.14,58.80 ,33.33
03,006,01,010,0206,410 ,925,16,941,1383,0,3,1,3,0,1,0,76.14,68.04 ,33.33
03,006,01,010,0206,411 ,716,22,738,1199,0,3,1,3,0,1,0,76.14,61.55 ,33.33
03,006,01,010,0207,412 ,1186,21,1207,1925,0,3,1,3,0,1,0,76.14,62.70 ,33.33
03,006,01,010,0207,413 ,970,18,988,1556,0,3,1,3,0,1,0,76.14,63.50 ,33.33
03,006,01,010,0208,414 ,992,13,1005,1670,0,3,1,3,0,1,0,76.14,60.18 ,33.33
03,006,01,010,0208,415 ,1086,16,1102,1745,0,3,1,3,0,1,0,76.14,63.15 ,33.33
03,006,01,010,0209,416 ,775,11,786,1241,0,3,1,3,0,1,0,76.14,63.34 ,33.33
03,006,01,010,0209,417 ,949,9,958,1544,0,3,1,3,0,1,0,76.14,62.05 ,33.33
03,006,01,010,0210,418 ,785,11,796,1209,0,3,1,3,0,1,0,76.14,65.84 ,33.33
03,006,01,010,0210,419 ,1068,16,1084,1701,0,3,1,3,0,1,0,76.14,63.73 ,33.33
03,006,01,010,0211,420 ,989,24,1013,1598,0,3,1,3,0,1,0,76.14,63.39 ,33.33
03,006,01,010,0211,421 ,868,14,882,1549,0,3,1,3,0,1,0,76.14,56.94 ,33.33
03,006,01,010,0211,422 ,650,14,664,1177,0,3,1,3,0,1,0,76.14,56.41 ,33.33
03,006,01,010,0211,423 ,880,19,899,1385,0,3,1,3,0,1,0,76.14,64.91 ,33.33
03,006,01,010,0211,424 ,864,10,874,1329,0,3,1,3,0,1,0,76.14,65.76 ,33.33
03,006,01,010,0211,425 ,716,13,729,1120,0,3,1,3,0,1,0,76.14,65.09 ,33.33
03,006,01,010,0211,426 ,572,13,585,1095,0,3,1,3,0,1,0,76.14,53.42 ,33.33
03,006,01,010,0212,427 ,1123,14,1137,1663,0,3,1,3,0,1,0,76.14,68.37 ,33.33
03,006,01,010,0212,428 ,1198,17,1215,1832,0,3,1,3,0,1,0,76.14,66.32 ,33.33
03,006,01,010,0212,429 ,1225,22,1247,1925,0,3,1,3,0,1,0,76.14,64.78 ,33.33
03,006,01,010,0213,430 ,896,13,909,1333,0,3,1,3,0,1,0,76.14,68.19 ,33.33
03,006,01,010,0213,431 ,906,15,921,1392,0,3,1,3,0,1,0,76.14,66.16 ,33.33
03,006,01,010,0213,432 ,753,14,767,1136,0,3,1,3,0,1,0,76.14,67.52 ,33.33
03,006,01,010,0213,433 ,795,6,801,1255,0,3,1,3,0,1,0,76.14,63.82 ,33.33
03,006,01,010,0214,434 ,1052,24,1076,1589,0,3,1,3,0,1,0,76.14,67.72 ,33.33
03,006,01,010,0214,435 ,734,8,742,1043,0,3,1,3,0,1,0,76.14,71.14 ,33.33
03,006,01,010,0215,436 ,1139,24,1163,1736,0,3,1,3,0,1,0,76.14,66.99 ,33.33
03,006,01,010,0215,437 ,938,9,947,1403,0,3,1,3,0,1,0,76.14,67.50 ,33.33
03,006,01,010,0216,438 ,1099,14,1113,1564,0,3,1,3,0,1,0,76.14,71.16 ,33.33
03,006,01,010,0216,439 ,1059,18,1077,1598,0,3,1,3,0,1,0,76.14,67.40 ,33.33
03,006,01,011,0217,440 ,894,16,910,1268,0,3,1,3,0,1,0,76.14,71.77 ,33.33
03,006,01,011,0217,441 ,1055,12,1067,1509,0,3,1,3,0,1,0,76.14,70.71 ,33.33
03,006,01,011,0218,442 ,1126,20,1146,1675,0,3,1,3,0,1,0,76.14,68.42 ,33.33
03,006,01,011,0219,443 ,843,18,861,1208,0,3,1,3,0,1,0,76.14,71.27 ,33.33
03,006,01,011,0220,444 ,606,12,618,911,0,3,1,3,0,1,0,76.14,67.84 ,33.33
03,006,01,011,0221,445 ,806,21,827,1194,0,3,1,3,0,1,0,76.14,69.26 ,33.33
03,006,01,011,0222,446 ,1309,25,1334,1939,0,3,1,3,0,1,0,76.14,68.80 ,33.33
03,006,01,011,0223,447 ,1242,60,1302,1876,0,3,1,3,0,1,0,76.14,69.40 ,33.33
03,006,01,011,0223,448 ,481,1,482,688,0,3,1,3,0,1,0,76.14,70.06 ,33.33
03,006,01,011,0224,449 ,547,10,557,770,0,3,1,3,0,1,0,76.14,72.34 ,33.33
03,006,01,011,0225,450 ,774,11,785,1151,0,3,1,3,0,1,0,76.14,68.20 ,33.33
03,006,01,011,0225,451 ,961,13,974,1349,0,3,1,3,0,1,0,76.14,72.20 ,33.33
03,006,01,011,0226,452 ,870,14,884,1269,0,3,1,3,0,1,0,76.14,69.66 ,33.33
03,006,01,011,0227,453 ,193,5,198,248,0,3,1,3,0,1,0,76.14,79.84 ,33.33
03,006,01,011,0227,454 ,394,6,400,613,0,3,1,3,0,1,0,76.14,65.25 ,33.33
03,006,01,011,0228,455 ,378,7,385,584,0,3,1,3,0,1,0,76.14,65.92 ,33.33
03,006,01,011,0229,456 ,650,12,662,1004,0,3,1,3,0,1,0,76.14,65.94 ,33.33
03,006,01,011,0229,457 ,171,6,177,265,0,3,1,3,0,1,0,76.14,66.79 ,33.33
03,006,01,012,0230,458 ,661,14,675,975,0,3,1,3,0,1,0,76.14,69.23 ,33.33
03,006,01,012,0231,459 ,761,8,769,1070,0,3,1,3,0,1,0,76.14,71.87 ,33.33
03,006,01,012,0232,460 ,722,19,741,1037,0,3,1,3,0,1,0,76.14,71.46 ,33.33
03,006,01,012,0233,461 ,758,22,780,1185,0,3,1,3,0,1,0,76.14,65.82 ,33.33
03,006,01,012,0234,462 ,461,3,464,649,0,3,1,3,0,1,0,76.14,71.49 ,33.33
03,006,01,012,0235,463 ,921,12,933,1264,0,3,1,3,0,1,0,76.14,73.81 ,33.33
03,006,01,012,0236,464 ,1084,13,1097,1677,0,3,1,3,0,1,0,76.14,65.41 ,33.33
03,006,01,012,0237,465 ,606,11,617,920,0,3,1,3,0,1,0,76.14,67.07 ,33.33
03,006,01,012,0238,466 ,832,18,850,1236,0,3,1,3,0,1,0,76.14,68.77 ,33.33
03,006,01,012,0239,467 ,843,17,860,1215,0,3,1,3,0,1,0,76.14,70.78 ,33.33
03,006,01,013,0240,468 ,697,18,715,982,0,3,1,3,0,1,0,76.14,72.81 ,33.33
03,006,01,013,0241,469 ,993,17,1010,1471,0,3,1,3,0,1,0,76.14,68.66 ,33.33
03,006,01,013,0242,470 ,1062,17,1079,1675,0,3,1,3,0,1,0,76.14,64.42 ,33.33
03,006,01,013,0243,471 ,822,9,831,1150,0,3,1,3,0,1,0,76.14,72.26 ,33.33
03,006,01,013,0243,472 ,766,10,776,1116,0,3,1,3,0,1,0,76.14,69.53 ,33.33
03,006,01,013,0243,473 ,763,10,773,1148,0,3,1,3,0,1,0,76.14,67.33 ,33.33
03,006,01,013,0244,474 ,965,16,981,1552,0,3,1,3,0,1,0,76.14,63.21 ,33.33
03,006,01,013,0244,475 ,768,15,783,1138,0,3,1,3,0,1,0,76.14,68.80 ,33.33
03,006,01,013,0245,476 ,921,15,936,1379,0,3,1,3,0,1,0,76.14,67.88 ,33.33
03,006,01,013,0245,477 ,961,13,974,1518,0,3,1,3,0,1,0,76.14,64.16 ,33.33
03,006,01,013,0245,478 ,936,20,956,1540,0,3,1,3,0,1,0,76.14,62.08 ,33.33
03,006,01,013,0246,479 ,893,12,905,1323,0,3,1,3,0,1,0,76.14,68.41 ,33.33
03,006,01,013,0247,480 ,761,8,769,1004,0,3,1,3,0,1,0,76.14,76.59 ,33.33
03,006,01,013,0248,481 ,710,16,726,1045,0,3,1,3,0,1,0,76.14,69.47 ,33.33
03,006,01,013,0248,482 ,685,10,695,937,0,3,1,3,0,1,0,76.14,74.17 ,33.33
03,006,01,013,0249,483 ,1063,17,1080,1516,0,3,1,3,0,1,0,76.14,71.24 ,33.33
03,006,01,013,0250,484 ,809,17,826,1163,0,3,1,3,0,1,0,76.14,71.02 ,33.33
03,006,01,014,0251,485 ,785,10,795,1061,0,3,1,3,0,1,0,76.14,74.93 ,33.33
03,006,01,014,0252,486 ,781,15,796,1104,0,3,1,3,0,1,0,76.14,72.10 ,33.33
03,006,01,014,0253,487 ,757,11,768,1109,0,3,1,3,0,1,0,76.14,69.25 ,33.33
03,006,01,014,0253,488 ,814,13,827,1229,0,3,1,3,0,1,0,76.14,67.29 ,33.33
03,006,01,014,0254,489 ,857,11,868,1172,0,3,1,3,0,1,0,76.14,74.06 ,33.33
03,006,01,014,0255,490 ,762,8,770,1115,0,3,1,3,0,1,0,76.14,69.06 ,33.33
03,006,01,014,0256,491 ,642,14,656,813,0,3,1,3,0,1,0,76.14,80.69 ,33.33
03,006,01,014,0256,492 ,532,12,544,750,0,3,1,3,0,1,0,76.14,72.53 ,33.33
03,006,01,014,0257,493 ,602,10,612,856,0,3,1,3,0,1,0,76.14,71.50 ,33.33
03,006,01,014,0258,494 ,703,8,711,1055,0,3,1,3,0,1,0,76.14,67.39 ,33.33
03,006,01,014,0258,495 ,402,5,407,526,0,3,1,3,0,1,0,76.14,77.38 ,33.33
03,006,01,014,0259,496 ,652,7,659,985,0,3,1,3,0,1,0,76.14,66.90 ,33.33
03,006,01,014,0260,497 ,982,12,994,1353,0,3,1,3,0,1,0,76.14,73.47 ,33.33
03,006,01,014,0261,498 ,896,8,904,1333,0,3,1,3,0,1,0,76.14,67.82 ,33.33
03,006,01,014,0262,499 ,567,3,570,728,0,3,1,3,0,1,0,76.14,78.30 ,33.33
03,006,01,015,0263,500 ,884,15,899,1322,0,3,1,3,0,1,0,76.14,68.00 ,33.33
03,006,01,015,0263,501 ,920,15,935,1388,0,3,1,3,0,1,0,76.14,67.36 ,33.33
03,006,01,015,0263,502 ,888,11,899,1359,0,3,1,3,0,1,0,76.14,66.15 ,33.33
03,006,01,015,0263,503 ,938,18,956,1356,0,3,1,3,0,1,0,76.14,70.50 ,33.33
03,006,01,015,0264,504 ,785,15,800,1164,0,3,1,3,0,1,0,76.14,68.73 ,33.33
03,006,01,015,0264,505 ,637,4,641,1012,0,3,1,3,0,1,0,76.14,63.34 ,33.33
03,006,01,015,0265,506 ,1115,12,1127,1668,0,3,1,3,0,1,0,76.14,67.57 ,33.33
03,006,01,015,0265,507 ,1176,27,1203,1704,0,3,1,3,0,1,0,76.14,70.60 ,33.33
03,006,01,015,0266,508 ,1084,16,1100,1513,0,3,1,3,0,1,0,76.14,72.70 ,33.33
03,006,01,015,0266,509 ,703,18,721,1075,0,3,1,3,0,1,0,76.14,67.07 ,33.33
03,006,01,015,0267,510 ,674,11,685,1009,0,3,1,3,0,1,0,76.14,67.89 ,33.33
03,006,01,015,0267,511 ,639,12,651,921,0,3,1,3,0,1,0,76.14,70.68 ,33.33
03,006,01,015,0268,512 ,1019,16,1035,1600,0,3,1,3,0,1,0,76.14,64.69 ,33.33
03,006,01,015,0268,513 ,1031,13,1044,1586,0,3,1,3,0,1,0,76.14,65.83 ,33.33
03,006,01,015,0268,514 ,911,7,918,1483,0,3,1,3,0,1,0,76.14,61.90 ,33.33
03,006,01,015,0268,515 ,1009,14,1023,1498,0,3,1,3,0,1,0,76.14,68.29 ,33.33
03,006,01,015,0268,516 ,960,11,971,1426,0,3,1,3,0,1,0,76.14,68.09 ,33.33
03,006,01,015,0268,517 ,828,16,844,1360,0,3,1,3,0,1,0,76.14,62.06 ,33.33
03,006,01,015,0269,518 ,989,22,1011,1602,0,3,1,3,0,1,0,76.14,63.11 ,33.33
03,006,01,015,0269,519 ,956,15,971,1565,0,3,1,3,0,1,0,76.14,62.04 ,33.33
03,006,01,015,0269,520 ,974,12,986,1560,0,3,1,3,0,1,0,76.14,63.21 ,33.33
03,006,01,015,0270,521 ,672,10,682,997,0,3,1,3,0,1,0,76.14,68.41 ,33.33
03,006,01,015,0270,522 ,711,17,728,1013,0,3,1,3,0,1,0,76.14,71.87 ,33.33
03,006,01,015,0271,523 ,1010,12,1022,1426,0,3,1,3,0,1,0,76.14,71.67 ,33.33
03,006,01,015,0272,524 ,620,8,628,872,0,3,1,3,0,1,0,76.14,72.02 ,33.33
03,006,01,015,0272,525 ,766,6,772,1134,0,3,1,3,0,1,0,76.14,68.08 ,33.33
03,006,01,015,0273,526 ,1128,18,1146,1575,0,3,1,3,0,1,0,76.14,72.76 ,33.33
03,006,01,015,0274,527 ,1216,20,1236,1727,0,3,1,3,0,1,0,76.14,71.57 ,33.33
03,006,01,015,0274,528 ,1102,10,1112,1714,0,3,1,3,0,1,0,76.14,64.88 ,33.33
03,006,01,015,0275,529 ,1038,20,1058,1487,0,3,1,3,0,1,0,76.14,71.15 ,33.33
03,006,01,015,0276,530 ,867,14,881,1292,0,3,1,3,0,1,0,76.14,68.19 ,33.33
03,006,01,015,0277,531 ,752,13,765,1065,0,3,1,3,0,1,0,76.14,71.83 ,33.33
03,006,01,015,0278,532 ,509,18,527,811,0,3,1,3,0,1,0,76.14,64.98 ,33.33
03,006,01,016,0279,533 ,1217,20,1237,1768,0,3,1,3,0,1,0,76.14,69.97 ,33.33
03,006,01,016,0279,534 ,1146,20,1166,1721,0,3,1,3,0,1,0,76.14,67.75 ,33.33
03,006,01,016,0280,535 ,602,7,609,786,0,3,1,3,0,1,0,76.14,77.48 ,33.33
03,006,01,016,0281,536 ,651,6,657,979,0,3,1,3,0,1,0,76.14,67.11 ,33.33
03,006,01,016,0281,537 ,716,17,733,1100,0,3,1,3,0,1,0,76.14,66.64 ,33.33
03,006,01,016,0281,538 ,705,9,714,1044,0,3,1,3,0,1,0,76.14,68.39 ,33.33
03,006,01,016,0282,539 ,916,17,933,1251,0,3,1,3,0,1,0,76.14,74.58 ,33.33
03,006,01,016,0283,540 ,801,17,818,1059,0,3,1,3,0,1,0,76.14,77.24 ,33.33
03,006,01,016,0283,541 ,752,8,760,1105,0,3,1,3,0,1,0,76.14,68.78 ,33.33
03,006,01,016,0284,542 ,769,4,773,1111,0,3,1,3,0,1,0,76.14,69.58 ,33.33
03,006,01,016,0284,543 ,615,9,624,1001,0,3,1,3,0,1,0,76.14,62.34 ,33.33
03,006,01,016,0285,544 ,862,8,870,1289,0,3,1,3,0,1,0,76.14,67.49 ,33.33
03,006,01,016,0285,545 ,864,15,879,1245,0,3,1,3,0,1,0,76.14,70.60 ,33.33
03,006,01,016,0286,546 ,582,5,587,811,0,3,1,3,0,1,0,76.14,72.38 ,33.33
03,006,01,016,0286,547 ,720,5,725,975,0,3,1,3,0,1,0,76.14,74.36 ,33.33
03,006,01,016,0287,548 ,642,4,646,840,0,3,1,3,0,1,0,76.14,76.90 ,33.33
03,006,01,016,0288,549 ,921,9,930,1296,0,3,1,3,0,1,0,76.14,71.76 ,33.33
03,006,01,016,0289,550 ,1031,14,1045,1475,0,3,1,3,0,1,0,76.14,70.85 ,33.33
03,006,01,016,0290,551 ,597,4,601,856,0,3,1,3,0,1,0,76.14,70.21 ,33.33
03,006,01,016,0291,552 ,884,20,904,1308,0,3,1,3,0,1,0,76.14,69.11 ,33.33
03,006,01,016,0292,553 ,991,15,1006,1450,0,3,1,3,0,1,0,76.14,69.38 ,33.33
03,006,01,016,0292,554 ,1026,9,1035,1534,0,3,1,3,0,1,0,76.14,67.47 ,33.33
03,006,01,016,0292,555 ,738,13,751,1154,0,3,1,3,0,1,0,76.14,65.08 ,33.33
03,006,01,016,0293,556 ,909,7,916,1237,0,3,1,3,0,1,0,76.14,74.05 ,33.33
03,006,01,016,0293,557 ,861,21,882,1277,0,3,1,3,0,1,0,76.14,69.07 ,33.33
03,006,01,016,0293,558 ,699,12,711,1085,0,3,1,3,0,1,0,76.14,65.53 ,33.33
03,006,01,016,0294,559 ,1061,16,1077,1635,0,3,1,3,0,1,0,76.14,65.87 ,33.33
03,006,01,016,0294,560 ,937,22,959,1386,0,3,1,3,0,1,0,76.14,69.19 ,33.33
03,006,01,016,0294,561 ,941,11,952,1502,0,3,1,3,0,1,0,76.14,63.38 ,33.33
03,006,01,016,0294,562 ,1114,19,1133,1592,0,3,1,3,0,1,0,76.14,71.17 ,33.33
03,006,01,017,0295,563 ,830,10,840,1274,0,3,1,3,0,1,0,76.14,65.93 ,33.33
03,006,01,017,0295,564 ,562,12,574,846,0,3,1,3,0,1,0,76.14,67.85 ,33.33
03,006,01,017,0296,565 ,787,10,797,1184,0,3,1,3,0,1,0,76.14,67.31 ,33.33
03,006,01,017,0296,566 ,671,10,681,1036,0,3,1,3,0,1,0,76.14,65.73 ,33.33
03,006,01,017,0297,567 ,1069,17,1086,1495,0,3,1,3,0,1,0,76.14,72.64 ,33.33
03,006,01,017,0298,568 ,881,9,890,1297,0,3,1,3,0,1,0,76.14,68.62 ,33.33
03,006,01,017,0298,569 ,754,16,770,1120,0,3,1,3,0,1,0,76.14,68.75 ,33.33
03,006,01,017,0299,570 ,668,23,691,970,0,3,1,3,0,1,0,76.14,71.24 ,33.33
03,006,01,017,0300,571 ,778,17,795,1144,0,3,1,3,0,1,0,76.14,69.49 ,33.33
03,006,01,017,0300,572 ,598,11,609,808,0,3,1,3,0,1,0,76.14,75.37 ,33.33
03,006,01,017,0301,573 ,956,19,975,1397,0,3,1,3,0,1,0,76.14,69.79 ,33.33
03,006,01,017,0301,574 ,857,17,874,1240,0,3,1,3,0,1,0,76.14,70.48 ,33.33
03,006,01,017,0301,575 ,462,8,470,672,0,3,1,3,0,1,0,76.14,69.94 ,33.33
03,006,01,017,0301,576 ,547,10,557,811,0,3,1,3,0,1,0,76.14,68.68 ,33.33
03,006,01,017,0302,577 ,892,24,916,1355,0,3,1,3,0,1,0,76.14,67.60 ,33.33
03,006,01,017,0302,578 ,690,11,701,1024,0,3,1,3,0,1,0,76.14,68.46 ,33.33
03,006,01,017,0303,579 ,798,10,808,1121,0,3,1,3,0,1,0,76.14,72.08 ,33.33
03,006,01,017,0303,580 ,900,19,919,1318,0,3,1,3,0,1,0,76.14,69.73 ,33.33
03,006,01,017,0303,581 ,864,11,875,1247,0,3,1,3,0,1,0,76.14,70.17 ,33.33
03,006,01,017,0304,582 ,558,11,569,896,0,3,1,3,0,1,0,76.14,63.50 ,33.33
03,006,01,017,0304,583 ,855,11,866,1383,0,3,1,3,0,1,0,76.14,62.62 ,33.33
03,006,01,017,0304,584 ,866,6,872,1305,0,3,1,3,0,1,0,76.14,66.82 ,33.33
03,006,01,017,0305,585 ,737,7,744,1123,0,3,1,3,0,1,0,76.14,66.25 ,33.33
03,006,01,017,0305,586 ,773,15,788,1201,0,3,1,3,0,1,0,76.14,65.61 ,33.33
03,006,01,017,0305,587 ,732,9,741,1059,0,3,1,3,0,1,0,76.14,69.97 ,33.33
03,006,01,017,0305,588 ,422,8,430,673,0,3,1,3,0,1,0,76.14,63.89 ,33.33
03,006,01,017,0306,589 ,747,17,764,1189,0,3,1,3,0,1,0,76.14,64.26 ,33.33
03,006,01,017,0306,590 ,523,13,536,751,0,3,1,3,0,1,0,76.14,71.37 ,33.33
03,006,01,017,0307,591 ,875,18,893,1313,0,3,1,3,0,1,0,76.14,68.01 ,33.33
03,006,01,017,0307,592 ,994,11,1005,1467,0,3,1,3,0,1,0,76.14,68.51 ,33.33
03,006,01,017,0307,593 ,939,17,956,1452,0,3,1,3,0,1,0,76.14,65.84 ,33.33
03,006,01,017,0308,594 ,923,13,936,1307,0,3,1,3,0,1,0,76.14,71.61 ,33.33
03,006,01,017,0309,595 ,884,11,895,1480,0,3,1,3,0,1,0,76.14,60.47 ,33.33
03,006,01,017,0309,596 ,732,8,740,1191,0,3,1,3,0,1,0,76.14,62.13 ,33.33
03,006,01,017,0309,597 ,889,11,900,1571,0,3,1,3,0,1,0,76.14,57.29 ,33.33
03,006,01,017,0309,598 ,540,5,545,872,0,3,1,3,0,1,0,76.14,62.50 ,33.33
03,006,01,017,0310,599 ,941,13,954,1495,0,3,1,3,0,1,0,76.14,63.81 ,33.33
03,006,01,017,0310,600 ,898,6,904,1518,0,3,1,3,0,1,0,76.14,59.55 ,33.33
03,006,01,018,0311,601 ,811,11,822,1141,0,3,1,3,0,1,0,76.14,72.04 ,33.33
03,006,01,018,0312,602 ,959,7,966,1515,0,3,1,3,0,1,0,76.14,63.76 ,33.33
03,006,01,018,0312,603 ,954,9,963,1541,0,3,1,3,0,1,0,76.14,62.49 ,33.33
03,006,01,018,0312,604 ,787,10,797,1247,0,3,1,3,0,1,0,76.14,63.91 ,33.33
03,006,01,018,0312,605 ,882,9,891,1441,0,3,1,3,0,1,0,76.14,61.83 ,33.33
03,006,01,018,0312,606 ,877,11,888,1420,0,3,1,3,0,1,0,76.14,62.54 ,33.33
03,006,01,018,0313,607 ,968,10,978,1437,0,3,1,3,0,1,0,76.14,68.06 ,33.33
03,006,01,018,0313,608 ,848,17,865,1383,0,3,1,3,0,1,0,76.14,62.55 ,33.33
03,006,01,018,0313,609 ,666,14,680,1120,0,3,1,3,0,1,0,76.14,60.71 ,33.33
03,006,01,018,0314,610 ,1210,18,1228,1824,0,3,1,3,0,1,0,76.14,67.32 ,33.33
03,006,01,018,0315,611 ,1035,8,1043,1551,0,3,1,3,0,1,0,76.14,67.25 ,33.33
03,006,01,018,0316,612 ,617,5,622,927,0,3,1,3,0,1,0,76.14,67.10 ,33.33
03,006,01,018,0317,613 ,639,10,649,1026,0,3,1,3,0,1,0,76.14,63.26 ,33.33
03,006,01,018,0318,614 ,1075,14,1089,1634,0,3,1,3,0,1,0,76.14,66.65 ,33.33
03,006,01,018,0318,615 ,1050,18,1068,1704,0,3,1,3,0,1,0,76.14,62.68 ,33.33
03,006,01,018,0318,616 ,919,12,931,1456,0,3,1,3,0,1,0,76.14,63.94 ,33.33
03,006,01,018,0319,617 ,954,12,966,1428,0,3,1,3,0,1,0,76.14,67.65 ,33.33
03,006,01,018,0319,618 ,978,13,991,1447,0,3,1,3,0,1,0,76.14,68.49 ,33.33
03,006,01,018,0320,619 ,918,18,936,1324,0,3,1,3,0,1,0,76.14,70.69 ,33.33
03,006,01,018,0321,620 ,648,12,660,996,0,3,1,3,0,1,0,76.14,66.27 ,33.33
03,006,01,018,0321,621 ,676,13,689,962,0,3,1,3,0,1,0,76.14,71.62 ,33.33
03,006,01,018,0322,622 ,850,11,861,1116,0,3,1,3,0,1,0,76.14,77.15 ,33.33
03,006,01,018,0322,623 ,801,15,816,1177,0,3,1,3,0,1,0,76.14,69.33 ,33.33
03,006,01,018,0323,624 ,1285,14,1299,1817,0,3,1,3,0,1,0,76.14,71.49 ,33.33
03,006,01,018,0324,625 ,1062,18,1080,1585,0,3,1,3,0,1,0,76.14,68.14 ,33.33
03,006,01,018,0325,626 ,744,12,756,1142,0,3,1,3,0,1,0,76.14,66.20 ,33.33
03,006,01,018,0326,627 ,811,14,825,1232,0,3,1,3,0,1,0,76.14,66.96 ,33.33
03,006,01,018,0326,628 ,716,9,725,1145,0,3,1,3,0,1,0,76.14,63.32 ,33.33
03,006,01,018,0327,629 ,708,9,717,1051,0,3,1,3,0,1,0,76.14,68.22 ,33.33
03,006,01,018,0327,630 ,687,8,695,961,0,3,1,3,0,1,0,76.14,72.32 ,33.33
03,006,01,018,0328,631 ,704,16,720,994,0,3,1,3,0,1,0,76.14,72.43 ,33.33
03,006,01,018,0328,632 ,575,13,588,895,0,3,1,3,0,1,0,76.14,65.70 ,33.33
03,006,01,018,0328,633 ,616,9,625,953,0,3,1,3,0,1,0,76.14,65.58 ,33.33
03,006,01,018,0329,634 ,677,9,686,1037,0,3,1,3,0,1,0,76.14,66.15 ,33.33
03,006,01,018,0330,635 ,800,19,819,1181,0,3,1,3,0,1,0,76.14,69.35 ,33.33
03,006,01,018,0330,636 ,623,14,637,921,0,3,1,3,0,1,0,76.14,69.16 ,33.33
03,006,01,019,0331,637 ,1184,11,1195,1891,0,3,1,3,0,1,0,76.14,63.19 ,33.33
03,006,01,019,0331,638 ,1016,16,1032,1549,0,3,1,3,0,1,0,76.14,66.62 ,33.33
03,006,01,019,0331,639 ,1000,25,1025,1532,0,3,1,3,0,1,0,76.14,66.91 ,33.33
03,006,01,019,0332,640 ,1026,9,1035,1626,0,3,1,3,0,1,0,76.14,63.65 ,33.33
03,006,01,019,0332,641 ,828,11,839,1352,0,3,1,3,0,1,0,76.14,62.06 ,33.33
03,006,01,019,0332,642 ,653,8,661,1077,0,3,1,3,0,1,0,76.14,61.37 ,33.33
03,006,01,019,0332,643 ,1091,10,1101,1775,0,3,1,3,0,1,0,76.14,62.03 ,33.33
03,006,01,019,0332,644 ,992,11,1003,1604,0,3,1,3,0,1,0,76.14,62.53 ,33.33
03,006,01,019,0333,645 ,931,18,949,1503,0,3,1,3,0,1,0,76.14,63.14 ,33.33
03,006,01,019,0333,646 ,897,16,913,1429,0,3,1,3,0,1,0,76.14,63.89 ,33.33
03,006,01,019,0333,647 ,948,5,953,1541,0,3,1,3,0,1,0,76.14,61.84 ,33.33
03,006,01,019,0333,648 ,911,19,930,1513,0,3,1,3,0,1,0,76.14,61.47 ,33.33
03,006,01,019,0334,649 ,790,8,798,1400,0,3,1,3,0,1,0,76.14,57.00 ,33.33
03,006,01,019,0334,650 ,1198,19,1217,2064,0,3,1,3,0,1,0,76.14,58.96 ,33.33
03,006,01,019,0334,651 ,910,15,925,1494,0,3,1,3,0,1,0,76.14,61.91 ,33.33
03,006,01,019,0334,652 ,974,7,981,1521,0,3,1,3,0,1,0,76.14,64.50 ,33.33
03,006,01,019,0335,653 ,1153,20,1173,1765,0,3,1,3,0,1,0,76.14,66.46 ,33.33
03,006,01,019,0335,654 ,1135,23,1158,1681,0,3,1,3,0,1,0,76.14,68.89 ,33.33
03,006,01,019,0335,655 ,1116,19,1135,1693,0,3,1,3,0,1,0,76.14,67.04 ,33.33
03,006,01,019,0335,656 ,1033,11,1044,1634,0,3,1,3,0,1,0,76.14,63.89 ,33.33
03,006,01,019,0335,657 ,1241,16,1257,1988,0,3,1,3,0,1,0,76.14,63.23 ,33.33
03,006,01,019,0336,658 ,872,7,879,1480,0,3,1,3,0,1,0,76.14,59.39 ,33.33
03,006,01,019,0336,659 ,936,20,956,1422,0,3,1,3,0,1,0,76.14,67.23 ,33.33
03,006,01,019,0336,660 ,1154,22,1176,1841,0,3,1,3,0,1,0,76.14,63.88 ,33.33
03,006,01,019,0337,661 ,710,11,721,1067,0,3,1,3,0,1,0,76.14,67.57 ,33.33
03,006,01,019,0337,662 ,506,12,518,819,0,3,1,3,0,1,0,76.14,63.25 ,33.33
03,006,01,019,0337,663 ,773,10,783,1202,0,3,1,3,0,1,0,76.14,65.14 ,33.33
03,006,01,019,0337,664 ,848,7,855,1229,0,3,1,3,0,1,0,76.14,69.57 ,33.33
03,006,01,019,0337,665 ,830,18,848,1172,0,3,1,3,0,1,0,76.14,72.35 ,33.33
03,006,01,019,0337,666 ,1103,18,1121,1738,0,3,1,3,0,1,0,76.14,64.50 ,33.33
03,006,01,019,0338,667 ,1003,15,1018,1495,0,3,1,3,0,1,0,76.14,68.09 ,33.33
03,006,01,019,0338,668 ,1228,15,1243,1939,0,3,1,3,0,1,0,76.14,64.11 ,33.33
03,006,01,019,0338,669 ,1137,18,1155,1784,0,3,1,3,0,1,0,76.14,64.74 ,33.33
03,006,01,019,0338,670 ,1235,24,1259,1920,0,3,1,3,0,1,0,76.14,65.57 ,33.33
03,006,01,019,0339,671 ,990,18,1008,1542,0,3,1,3,0,1,0,76.14,65.37 ,33.33
03,006,01,019,0339,672 ,760,9,769,1158,0,3,1,3,0,1,0,76.14,66.41 ,33.33
03,006,01,019,0339,673 ,973,20,993,1514,0,3,1,3,0,1,0,76.14,65.59 ,33.33
03,006,01,019,0339,674 ,1195,25,1220,1887,0,3,1,3,0,1,0,76.14,64.65 ,33.33
03,006,01,019,0340,675 ,855,18,873,1437,0,3,1,3,0,1,0,76.14,60.75 ,33.33
03,006,01,019,0340,676 ,1025,18,1043,1711,0,3,1,3,0,1,0,76.14,60.96 ,33.33
03,006,01,019,0340,677 ,1079,18,1097,1967,0,3,1,3,0,1,0,76.14,55.77 ,33.33
03,006,01,019,0340,678 ,1018,14,1032,1803,0,3,1,3,0,1,0,76.14,57.24 ,33.33
03,006,01,019,0340,679 ,1064,15,1079,1684,0,3,1,3,0,1,0,76.14,64.07 ,33.33
03,006,01,019,0340,680 ,925,15,940,1472,0,3,1,3,0,1,0,76.14,63.86 ,33.33
03,006,01,019,0340,681 ,944,16,960,1603,0,3,1,3,0,1,0,76.14,59.89 ,33.33
03,006,01,019,0341,682 ,662,17,679,1239,0,3,1,3,0,1,0,76.14,54.80 ,33.33
03,006,01,019,0341,683 ,751,7,758,1289,0,3,1,3,0,1,0,76.14,58.81 ,33.33
03,006,01,019,0341,684 ,734,13,747,1404,0,3,1,3,0,1,0,76.14,53.21 ,33.33
03,006,01,019,0341,685 ,840,8,848,1492,0,3,1,3,0,1,0,76.14,56.84 ,33.33
03,006,01,019,0341,686 ,772,14,786,1312,0,3,1,3,0,1,0,76.14,59.91 ,33.33
03,006,01,019,0341,687 ,690,12,702,1158,0,3,1,3,0,1,0,76.14,60.62 ,33.33
03,006,01,019,0341,688 ,597,12,609,1091,0,3,1,3,0,1,0,76.14,55.82 ,33.33
03,006,01,019,0341,689 ,842,8,850,1446,0,3,1,3,0,1,0,76.14,58.78 ,33.33
03,006,01,019,0342,690 ,1175,27,1202,1914,0,3,1,3,0,1,0,76.14,62.80 ,33.33
03,006,01,019,0342,691 ,1126,20,1146,1827,0,3,1,3,0,1,0,76.14,62.73 ,33.33
03,006,01,019,0342,692 ,1021,20,1041,1657,0,3,1,3,0,1,0,76.14,62.82 ,33.33
03,006,01,019,0342,693 ,1024,18,1042,1655,0,3,1,3,0,1,0,76.14,62.96 ,33.33
03,006,01,019,0342,694 ,952,5,957,1547,0,3,1,3,0,1,0,76.14,61.86 ,33.33
03,006,01,019,0343,695 ,870,13,883,1262,0,3,1,3,0,1,0,76.14,69.97 ,33.33
03,006,01,019,0343,696 ,556,16,572,935,0,3,1,3,0,1,0,76.14,61.18 ,33.33
03,006,01,019,0343,697 ,996,15,1011,1621,0,3,1,3,0,1,0,76.14,62.37 ,33.33
03,006,01,019,0344,698 ,682,12,694,1085,0,3,1,3,0,1,0,76.14,63.96 ,33.33
03,006,01,019,0344,699 ,722,7,729,1147,0,3,1,3,0,1,0,76.14,63.56 ,33.33
03,006,01,019,0344,700 ,726,10,736,1075,0,3,1,3,0,1,0,76.14,68.47 ,33.33
03,006,01,019,0345,701 ,784,11,795,1202,0,3,1,3,0,1,0,76.14,66.14 ,33.33
03,006,01,019,0346,702 ,1034,12,1046,1583,0,3,1,3,0,1,0,76.14,66.08 ,33.33
03,006,01,019,0346,703 ,955,22,977,1569,0,3,1,3,0,1,0,76.14,62.27 ,33.33
03,006,01,019,0346,704 ,832,11,843,1316,0,3,1,3,0,1,0,76.14,64.06 ,33.33
03,006,01,019,0346,705 ,665,10,675,1027,0,3,1,3,0,1,0,76.14,65.73 ,33.33
03,006,01,019,0347,706 ,634,13,647,879,0,3,1,3,0,1,0,76.14,73.61 ,33.33
03,006,01,019,0348,707 ,993,16,1009,1485,0,3,1,3,0,1,0,76.14,67.95 ,33.33
03,006,01,019,0348,708 ,1036,24,1060,1725,0,3,1,3,0,1,0,76.14,61.45 ,33.33
03,006,01,019,0348,709 ,787,18,805,1229,0,3,1,3,0,1,0,76.14,65.50 ,33.33
03,006,01,019,0349,710 ,1095,13,1108,1694,0,3,1,3,0,1,0,76.14,65.41 ,33.33
03,006,01,019,0349,711 ,934,17,951,1598,0,3,1,3,0,1,0,76.14,59.51 ,33.33
03,006,01,020,0350,712 ,1183,16,1199,1779,0,3,1,3,0,1,0,76.14,67.40 ,33.33
03,006,01,020,0350,713 ,875,10,885,1309,0,3,1,3,0,1,0,76.14,67.61 ,33.33
03,006,01,020,0351,714 ,1118,12,1130,1751,0,3,1,3,0,1,0,76.14,64.53 ,33.33
03,006,01,020,0351,715 ,1034,6,1040,1654,0,3,1,3,0,1,0,76.14,62.88 ,33.33
03,006,01,020,0351,716 ,1031,9,1040,1689,0,3,1,3,0,1,0,76.14,61.57 ,33.33
03,006,01,020,0351,717 ,1008,8,1016,1577,0,3,1,3,0,1,0,76.14,64.43 ,33.33
03,006,01,020,0351,718 ,630,6,636,919,0,3,1,3,0,1,0,76.14,69.21 ,33.33
03,006,01,020,0351,719 ,900,7,907,1385,0,3,1,3,0,1,0,76.14,65.49 ,33.33
03,006,01,020,0352,720 ,863,15,878,1332,0,3,1,3,0,1,0,76.14,65.92 ,33.33
03,006,01,020,0352,721 ,925,6,931,1347,0,3,1,3,0,1,0,76.14,69.12 ,33.33
03,006,01,020,0353,722 ,548,6,554,944,0,3,1,3,0,1,0,76.14,58.69 ,33.33
03,006,01,020,0353,723 ,642,10,652,1117,0,3,1,3,0,1,0,76.14,58.37 ,33.33
03,006,01,020,0353,724 ,700,10,710,1221,0,3,1,3,0,1,0,76.14,58.15 ,33.33
03,006,01,020,0353,725 ,654,5,659,1130,0,3,1,3,0,1,0,76.14,58.32 ,33.33
03,006,01,020,0353,726 ,539,9,548,889,0,3,1,3,0,1,0,76.14,61.64 ,33.33
03,006,01,020,0354,727 ,1017,18,1035,1666,0,3,1,3,0,1,0,76.14,62.12 ,33.33
03,006,01,020,0354,728 ,926,9,935,1476,0,3,1,3,0,1,0,76.14,63.35 ,33.33
03,006,01,020,0354,729 ,877,12,889,1409,0,3,1,3,0,1,0,76.14,63.09 ,33.33
03,006,01,020,0354,730 ,997,13,1010,1573,0,3,1,3,0,1,0,76.14,64.21 ,33.33
03,006,01,020,0354,731 ,787,10,797,1237,0,3,1,3,0,1,0,76.14,64.43 ,33.33
03,006,01,020,0354,732 ,667,8,675,1149,0,3,1,3,0,1,0,76.14,58.75 ,33.33
03,006,01,020,0355,733 ,717,4,721,1173,0,3,1,3,0,1,0,76.14,61.47 ,33.33
03,006,01,020,0355,734 ,919,10,929,1392,0,3,1,3,0,1,0,76.14,66.74 ,33.33
03,006,01,020,0356,735 ,575,9,584,872,0,3,1,3,0,1,0,76.14,66.97 ,33.33
03,006,01,020,0356,736 ,904,8,912,1325,0,3,1,3,0,1,0,76.14,68.83 ,33.33
03,006,01,020,0356,737 ,705,6,711,1077,0,3,1,3,0,1,0,76.14,66.02 ,33.33
03,006,01,020,0357,738 ,661,14,675,1016,0,3,1,3,0,1,0,76.14,66.44 ,33.33
03,006,01,020,0357,739 ,674,7,681,987,0,3,1,3,0,1,0,76.14,69.00 ,33.33
03,006,01,020,0358,740 ,668,13,681,926,0,3,1,3,0,1,0,76.14,73.54 ,33.33
03,006,01,020,0359,741 ,914,6,920,1584,0,3,1,3,0,1,0,76.14,58.08 ,33.33
03,006,01,020,0359,742 ,955,14,969,1557,0,3,1,3,0,1,0,76.14,62.24 ,33.33
03,006,01,020,0359,743 ,995,10,1005,1562,0,3,1,3,0,1,0,76.14,64.34 ,33.33
03,006,01,020,0359,744 ,943,11,954,1600,0,3,1,3,0,1,0,76.14,59.62 ,33.33
03,006,01,020,0359,745 ,979,9,988,1654,0,3,1,3,0,1,0,76.14,59.73 ,33.33
03,006,01,020,0359,746 ,928,6,934,1444,0,3,1,3,0,1,0,76.14,64.68 ,33.33
03,006,01,020,0360,747 ,901,13,914,1457,0,3,1,3,0,1,0,76.14,62.73 ,33.33
03,006,01,020,0360,748 ,775,17,792,1236,0,3,1,3,0,1,0,76.14,64.08 ,33.33
03,006,01,020,0360,749 ,983,18,1001,1563,0,3,1,3,0,1,0,76.14,64.04 ,33.33
03,006,01,020,0361,750 ,1001,10,1011,1619,0,3,1,3,0,1,0,76.14,62.45 ,33.33
03,006,01,020,0361,751 ,1006,16,1022,1505,0,3,1,3,0,1,0,76.14,67.91 ,33.33
03,006,01,020,0361,752 ,1017,11,1028,1598,0,3,1,3,0,1,0,76.14,64.33 ,33.33
03,006,01,020,0361,753 ,986,11,997,1624,0,3,1,3,0,1,0,76.14,61.39 ,33.33
03,006,01,020,0362,754 ,792,17,809,1361,0,3,1,3,0,1,0,76.14,59.44 ,33.33
03,006,01,020,0362,755 ,707,9,716,1247,0,3,1,3,0,1,0,76.14,57.42 ,33.33
03,006,01,020,0362,756 ,705,12,717,1104,0,3,1,3,0,1,0,76.14,64.95 ,33.33
03,006,01,020,0362,757 ,624,7,631,998,0,3,1,3,0,1,0,76.14,63.23 ,33.33
03,006,01,020,0362,758 ,681,9,690,1211,0,3,1,3,0,1,0,76.14,56.98 ,33.33
03,006,01,020,0363,759 ,511,13,524,856,0,3,1,3,0,1,0,76.14,61.21 ,33.33
03,006,01,020,0363,760 ,875,7,882,1409,0,3,1,3,0,1,0,76.14,62.60 ,33.33
03,006,01,020,0363,761 ,1038,9,1047,1668,0,3,1,3,0,1,0,76.14,62.77 ,33.33
03,006,01,020,0363,762 ,807,9,816,1235,0,3,1,3,0,1,0,76.14,66.07 ,33.33
03,006,01,020,0363,763 ,1153,10,1163,1813,0,3,1,3,0,1,0,76.14,64.15 ,33.33
03,006,01,020,0363,764 ,1077,11,1088,1671,0,3,1,3,0,1,0,76.14,65.11 ,33.33
03,006,01,020,0363,765 ,731,8,739,1141,0,3,1,3,0,1,0,76.14,64.77 ,33.33
03,006,01,020,0364,766 ,1033,16,1049,1658,0,3,1,3,0,1,0,76.14,63.27 ,33.33
03,006,01,020,0364,767 ,941,20,961,1463,0,3,1,3,0,1,0,76.14,65.69 ,33.33
03,006,01,020,0365,768 ,790,7,797,1311,0,3,1,3,0,1,0,76.14,60.79 ,33.33
03,006,01,020,0365,769 ,1032,8,1040,1601,0,3,1,3,0,1,0,76.14,64.96 ,33.33
03,006,01,020,0365,770 ,956,17,973,1514,0,3,1,3,0,1,0,76.14,64.27 ,33.33
03,006,01,020,0365,771 ,949,17,966,1641,0,3,1,3,0,1,0,76.14,58.87 ,33.33
03,006,01,020,0365,772 ,1099,19,1118,1746,0,3,1,3,0,1,0,76.14,64.03 ,33.33
03,006,01,020,0365,773 ,1021,16,1037,1610,0,3,1,3,0,1,0,76.14,64.41 ,33.33
03,006,01,020,0365,774 ,1050,6,1056,1623,0,3,1,3,0,1,0,76.14,65.06 ,33.33
03,006,01,020,0366,775 ,931,8,939,1511,0,3,1,3,0,1,0,76.14,62.14 ,33.33
03,006,01,020,0366,776 ,805,11,816,1422,0,3,1,3,0,1,0,76.14,57.38 ,33.33
03,006,01,020,0366,777 ,968,11,979,1597,0,3,1,3,0,1,0,76.14,61.30 ,33.33
03,006,01,020,0366,778 ,995,9,1004,1646,0,3,1,3,0,1,0,76.14,61.00 ,33.33
03,006,01,020,0366,779 ,930,11,941,1549,0,3,1,3,0,1,0,76.14,60.75 ,33.33
03,006,01,020,0367,780 ,970,18,988,1608,0,3,1,3,0,1,0,76.14,61.44 ,33.33
03,006,01,020,0367,781 ,1092,18,1110,1772,0,3,1,3,0,1,0,76.14,62.64 ,33.33
03,006,01,020,0367,782 ,952,9,961,1567,0,3,1,3,0,1,0,76.14,61.33 ,33.33
03,006,01,020,0367,783 ,764,8,772,1163,0,3,1,3,0,1,0,76.14,66.38 ,33.33
03,006,01,020,0367,784 ,747,11,758,1221,0,3,1,3,0,1,0,76.14,62.08 ,33.33
03,006,01,020,0368,785 ,881,14,895,1397,0,3,1,3,0,1,0,76.14,64.07 ,33.33
03,006,01,020,0368,786 ,973,11,984,1629,0,3,1,3,0,1,0,76.14,60.41 ,33.33
03,006,01,020,0368,787 ,917,12,929,1455,0,3,1,3,0,1,0,76.14,63.85 ,33.33
03,006,01,020,0368,788 ,809,13,822,1344,0,3,1,3,0,1,0,76.14,61.16 ,33.33
03,006,01,020,0369,789 ,859,11,870,1492,0,3,1,3,0,1,0,76.14,58.31 ,33.33
03,006,01,020,0369,790 ,991,14,1005,1559,0,3,1,3,0,1,0,76.14,64.46 ,33.33
03,006,01,020,0369,791 ,1002,8,1010,1648,0,3,1,3,0,1,0,76.14,61.29 ,33.33
03,006,01,020,0369,792 ,895,8,903,1451,0,3,1,3,0,1,0,76.14,62.23 ,33.33
03,006,01,020,0369,793 ,1080,11,1091,1821,0,3,1,3,0,1,0,76.14,59.91 ,33.33
03,006,01,021,0370,794 ,90,1,91,146,0,3,1,3,0,1,0,76.14,62.33 ,33.33
03,006,01,021,0370,795 ,457,7,464,732,0,3,1,3,0,1,0,76.14,63.39 ,33.33
03,006,01,021,0370,796 ,326,6,332,519,0,3,1,3,0,1,0,76.14,63.97 ,33.33
03,006,01,021,0371,797 ,268,4,272,454,0,3,1,3,0,1,0,76.14,59.91 ,33.33
03,006,01,021,0372,798 ,386,7,393,622,0,3,1,3,0,1,0,76.14,63.18 ,33.33
03,006,01,021,0372,799 ,266,4,270,452,0,3,1,3,0,1,0,76.14,59.73 ,33.33
03,006,01,021,0373,800 ,62,0,62,102,0,3,1,3,0,1,0,76.14,60.78 ,33.33
03,006,01,021,0373,801 ,73,3,76,132,0,3,1,3,0,1,0,76.14,57.58 ,33.33
03,006,01,021,0373,802 ,166,1,167,295,0,3,1,3,0,1,0,76.14,56.61 ,33.33
03,006,01,021,0374,803 ,256,2,258,439,0,3,1,3,0,1,0,76.14,58.77 ,33.33
03,006,01,021,0374,804 ,76,0,76,106,0,3,1,3,0,1,0,76.14,71.70 ,33.33
03,006,01,021,0375,805 ,233,3,236,309,0,3,1,3,0,1,0,76.14,76.38 ,33.33
03,006,01,021,0376,806 ,89,4,93,191,0,3,1,3,0,1,0,76.14,48.69 ,33.33
03,006,01,021,0376,807 ,369,3,372,815,0,3,1,3,0,1,0,76.14,45.64 ,33.33
03,006,01,021,0376,808 ,70,0,70,251,0,3,1,3,0,1,0,76.14,27.89 ,33.33
03,006,01,021,0376,809 ,29,0,29,90,0,3,1,3,0,1,0,76.14,32.22 ,33.33
03,006,01,021,0377,810 ,99,1,100,217,0,3,1,3,0,1,0,76.14,46.08 ,33.33
03,006,01,021,0377,811 ,94,5,99,197,0,3,1,3,0,1,0,76.14,50.25 ,33.33
03,007,01,001,0001,1 ,824,12,836,1250,0,3,1,3,0,1,0,76.14,66.88 ,33.33
03,007,01,001,0001,2 ,1000,20,1020,1548,0,3,1,3,0,1,0,76.14,65.89 ,33.33
03,007,01,001,0002,3 ,737,7,744,1069,0,3,1,3,0,1,0,76.14,69.60 ,33.33
03,007,01,001,0002,4 ,733,12,745,1161,0,3,1,3,0,1,0,76.14,64.17 ,33.33
03,007,01,001,0003,5 ,1090,17,1107,1580,0,3,1,3,0,1,0,76.14,70.06 ,33.33
03,007,01,001,0004,6 ,1035,7,1042,1539,0,3,1,3,0,1,0,76.14,67.71 ,33.33
03,007,01,001,0005,7 ,198,81,279,300,0,3,1,3,0,1,0,76.14,93.00 ,33.33
03,007,01,001,0005,8 ,669,6,675,993,0,3,1,3,0,1,0,76.14,67.98 ,33.33
03,007,01,001,0005,9 ,723,12,735,1123,0,3,1,3,0,1,0,76.14,65.45 ,33.33
03,007,01,001,0006,10 ,780,9,789,1077,0,3,1,3,0,1,0,76.14,73.26 ,33.33
03,007,01,001,0006,11 ,877,14,891,1232,0,3,1,3,0,1,0,76.14,72.32 ,33.33
03,007,01,001,0007,12 ,936,9,945,1357,0,3,1,3,0,1,0,76.14,69.64 ,33.33
03,007,01,001,0008,13 ,725,6,731,1020,0,3,1,3,0,1,0,76.14,71.67 ,33.33
03,007,01,001,0008,14 ,564,12,576,889,0,3,1,3,0,1,0,76.14,64.79 ,33.33
03,007,01,001,0009,15 ,1107,14,1121,1697,0,3,1,3,0,1,0,76.14,66.06 ,33.33
03,007,01,001,0009,16 ,892,11,903,1337,0,3,1,3,0,1,0,76.14,67.54 ,33.33
03,007,01,001,0009,17 ,1217,16,1233,1847,0,3,1,3,0,1,0,76.14,66.76 ,33.33
03,007,01,001,0009,18 ,604,5,609,883,0,3,1,3,0,1,0,76.14,68.97 ,33.33
03,007,01,001,0010,19 ,1090,18,1108,1629,0,3,1,3,0,1,0,76.14,68.02 ,33.33
03,007,01,001,0010,20 ,1161,11,1172,1687,0,3,1,3,0,1,0,76.14,69.47 ,33.33
03,007,01,001,0011,21 ,1159,13,1172,1688,0,3,1,3,0,1,0,76.14,69.43 ,33.33
03,007,01,001,0011,22 ,1033,21,1054,1577,0,3,1,3,0,1,0,76.14,66.84 ,33.33
03,007,01,001,0011,23 ,1025,19,1044,1543,0,3,1,3,0,1,0,76.14,67.66 ,33.33
03,007,01,001,0012,24 ,1192,11,1203,1735,0,3,1,3,0,1,0,76.14,69.34 ,33.33
03,007,01,001,0012,25 ,919,15,934,1490,0,3,1,3,0,1,0,76.14,62.68 ,33.33
03,007,01,001,0012,26 ,916,15,931,1460,0,3,1,3,0,1,0,76.14,63.77 ,33.33
03,007,01,001,0012,27 ,949,11,960,1473,0,3,1,3,0,1,0,76.14,65.17 ,33.33
03,007,01,001,0013,28 ,987,16,1003,1458,0,3,1,3,0,1,0,76.14,68.79 ,33.33
03,007,01,001,0014,29 ,740,15,755,1085,0,3,1,3,0,1,0,76.14,69.59 ,33.33
03,007,01,001,0015,30 ,1011,17,1028,1445,0,3,1,3,0,1,0,76.14,71.14 ,33.33
03,007,01,001,0016,31 ,734,9,743,1046,0,3,1,3,0,1,0,76.14,71.03 ,33.33
03,007,01,001,0017,32 ,818,9,827,1199,0,3,1,3,0,1,0,76.14,68.97 ,33.33
03,007,01,001,0017,33 ,976,12,988,1490,0,3,1,3,0,1,0,76.14,66.31 ,33.33
03,007,01,001,0018,34 ,981,11,992,1488,0,3,1,3,0,1,0,76.14,66.67 ,33.33
03,007,01,001,0018,35 ,1043,8,1051,1557,0,3,1,3,0,1,0,76.14,67.50 ,33.33
03,007,01,001,0019,36 ,653,3,656,918,0,3,1,3,0,1,0,76.14,71.46 ,33.33
03,007,01,001,0020,37 ,692,10,702,1012,0,3,1,3,0,1,0,76.14,69.37 ,33.33
03,007,01,001,0021,38 ,849,8,857,1238,0,3,1,3,0,1,0,76.14,69.22 ,33.33
03,007,01,001,0022,39 ,845,10,855,1210,0,3,1,3,0,1,0,76.14,70.66 ,33.33
03,007,01,001,0023,40 ,679,8,687,976,0,3,1,3,0,1,0,76.14,70.39 ,33.33
03,007,01,001,0024,41 ,616,9,625,834,0,3,1,3,0,1,0,76.14,74.94 ,33.33
03,007,01,001,0024,42 ,855,3,858,1363,0,3,1,3,0,1,0,76.14,62.95 ,33.33
03,007,01,001,0025,43 ,1048,8,1056,1574,0,3,1,3,0,1,0,76.14,67.09 ,33.33
03,007,01,001,0025,44 ,1183,16,1199,1799,0,3,1,3,0,1,0,76.14,66.65 ,33.33
03,007,01,001,0026,45 ,935,13,948,1361,0,3,1,3,0,1,0,76.14,69.65 ,33.33
03,007,01,001,0026,46 ,811,14,825,1222,0,3,1,3,0,1,0,76.14,67.51 ,33.33
03,007,01,001,0026,47 ,1013,12,1025,1546,0,3,1,3,0,1,0,76.14,66.30 ,33.33
03,007,01,001,0027,48 ,909,13,922,1385,0,3,1,3,0,1,0,76.14,66.57 ,33.33
03,007,01,001,0027,49 ,847,9,856,1287,0,3,1,3,0,1,0,76.14,66.51 ,33.33
03,007,01,001,0028,50 ,767,14,781,1126,0,3,1,3,0,1,0,76.14,69.36 ,33.33
03,007,01,001,0028,51 ,845,9,854,1221,0,3,1,3,0,1,0,76.14,69.94 ,33.33
03,007,01,001,0029,52 ,990,12,1002,1460,0,3,1,3,0,1,0,76.14,68.63 ,33.33
03,007,01,001,0030,53 ,1182,14,1196,1680,0,3,1,3,0,1,0,76.14,71.19 ,33.33
03,007,01,001,0031,54 ,838,14,852,1277,0,3,1,3,0,1,0,76.14,66.72 ,33.33
03,007,01,001,0031,55 ,987,12,999,1480,0,3,1,3,0,1,0,76.14,67.50 ,33.33
03,007,01,001,0032,56 ,718,11,729,1123,0,3,1,3,0,1,0,76.14,64.92 ,33.33
03,007,01,001,0032,57 ,993,25,1018,1425,0,3,1,3,0,1,0,76.14,71.44 ,33.33
03,007,01,001,0033,58 ,809,18,827,1137,0,3,1,3,0,1,0,76.14,72.74 ,33.33
03,007,01,001,0033,59 ,854,18,872,1243,0,3,1,3,0,1,0,76.14,70.15 ,33.33
03,007,01,001,0034,60 ,791,8,799,1205,0,3,1,3,0,1,0,76.14,66.31 ,33.33
03,007,01,001,0034,61 ,902,8,910,1249,0,3,1,3,0,1,0,76.14,72.86 ,33.33
03,007,01,001,0035,62 ,803,7,810,1159,0,3,1,3,0,1,0,76.14,69.89 ,33.33
03,007,01,001,0036,63 ,1031,19,1050,1555,0,3,1,3,0,1,0,76.14,67.52 ,33.33
03,007,01,001,0036,64 ,1002,12,1014,1539,0,3,1,3,0,1,0,76.14,65.89 ,33.33
03,007,01,001,0037,65 ,800,11,811,1173,0,3,1,3,0,1,0,76.14,69.14 ,33.33
03,007,01,001,0037,66 ,998,11,1009,1434,0,3,1,3,0,1,0,76.14,70.36 ,33.33
03,007,01,001,0037,67 ,793,11,804,1179,0,3,1,3,0,1,0,76.14,68.19 ,33.33
03,007,01,001,0038,68 ,557,11,568,869,0,3,1,3,0,1,0,76.14,65.36 ,33.33
03,007,01,001,0038,69 ,651,7,658,959,0,3,1,3,0,1,0,76.14,68.61 ,33.33
03,007,01,001,0039,70 ,946,9,955,1404,0,3,1,3,0,1,0,76.14,68.02 ,33.33
03,007,01,001,0040,71 ,609,8,617,898,0,3,1,3,0,1,0,76.14,68.71 ,33.33
03,007,01,001,0041,72 ,939,12,951,1401,0,3,1,3,0,1,0,76.14,67.88 ,33.33
03,007,01,001,0042,73 ,499,7,506,765,0,3,1,3,0,1,0,76.14,66.14 ,33.33
03,007,01,001,0043,74 ,618,3,621,948,0,3,1,3,0,1,0,76.14,65.51 ,33.33
03,007,01,001,0044,75 ,598,7,605,874,0,3,1,3,0,1,0,76.14,69.22 ,33.33
03,007,01,001,0045,76 ,897,14,911,1354,0,3,1,3,0,1,0,76.14,67.28 ,33.33
03,007,01,001,0046,77 ,574,8,582,835,0,3,1,3,0,1,0,76.14,69.70 ,33.33
03,007,01,001,0047,78 ,748,15,763,1133,0,3,1,3,0,1,0,76.14,67.34 ,33.33
03,007,01,001,0047,79 ,699,9,708,1052,0,3,1,3,0,1,0,76.14,67.30 ,33.33
03,007,01,001,0048,80 ,948,14,962,1428,0,3,1,3,0,1,0,76.14,67.37 ,33.33
03,007,01,001,0049,81 ,586,6,592,838,0,3,1,3,0,1,0,76.14,70.64 ,33.33
03,007,01,001,0049,82 ,595,9,604,919,0,3,1,3,0,1,0,76.14,65.72 ,33.33
03,007,01,001,0050,83 ,1189,12,1201,1757,0,3,1,3,0,1,0,76.14,68.36 ,33.33
03,007,01,001,0050,84 ,1193,15,1208,1820,0,3,1,3,0,1,0,76.14,66.37 ,33.33
03,007,01,001,0051,85 ,1283,15,1298,1854,0,3,1,3,0,1,0,76.14,70.01 ,33.33
03,007,01,001,0051,86 ,1107,23,1130,1673,0,3,1,3,0,1,0,76.14,67.54 ,33.33
03,007,01,001,0052,87 ,527,15,542,775,0,3,1,3,0,1,0,76.14,69.94 ,33.33
03,007,01,001,0053,88 ,723,10,733,1090,0,3,1,3,0,1,0,76.14,67.25 ,33.33
03,007,01,001,0053,89 ,659,12,671,971,0,3,1,3,0,1,0,76.14,69.10 ,33.33
03,007,01,001,0054,90 ,710,13,723,994,0,3,1,3,0,1,0,76.14,72.74 ,33.33
03,007,01,001,0055,91 ,667,19,686,1007,0,3,1,3,0,1,0,76.14,68.12 ,33.33
03,007,01,001,0055,92 ,693,10,703,1143,0,3,1,3,0,1,0,76.14,61.50 ,33.33
03,007,01,001,0056,93 ,1029,19,1048,1590,0,3,1,3,0,1,0,76.14,65.91 ,33.33
03,007,01,001,0056,94 ,896,14,910,1403,0,3,1,3,0,1,0,76.14,64.86 ,33.33
03,007,01,001,0056,95 ,1264,23,1287,2000,0,3,1,3,0,1,0,76.14,64.35 ,33.33
03,007,01,001,0057,96 ,715,19,734,1069,0,3,1,3,0,1,0,76.14,68.66 ,33.33
03,007,01,001,0057,97 ,749,18,767,1126,0,3,1,3,0,1,0,76.14,68.12 ,33.33
03,007,01,001,0058,98 ,1119,13,1132,1692,0,3,1,3,0,1,0,76.14,66.90 ,33.33
03,007,01,001,0058,99 ,1024,12,1036,1537,0,3,1,3,0,1,0,76.14,67.40 ,33.33
03,007,01,001,0058,100 ,425,9,434,640,0,3,1,3,0,1,0,76.14,67.81 ,33.33
03,007,01,001,0059,101 ,780,8,788,1174,0,3,1,3,0,1,0,76.14,67.12 ,33.33
03,007,01,001,0059,102 ,552,16,568,886,0,3,1,3,0,1,0,76.14,64.11 ,33.33
03,007,01,001,0060,103 ,976,15,991,1404,0,3,1,3,0,1,0,76.14,70.58 ,33.33
03,007,01,001,0060,104 ,607,15,622,811,0,3,1,3,0,1,0,76.14,76.70 ,33.33
03,007,01,001,0061,105 ,890,12,902,1298,0,3,1,3,0,1,0,76.14,69.49 ,33.33
03,007,01,001,0061,106 ,971,27,998,1450,0,3,1,3,0,1,0,76.14,68.83 ,33.33
03,007,01,001,0061,107 ,868,19,887,1412,0,3,1,3,0,1,0,76.14,62.82 ,33.33
03,007,01,001,0061,108 ,978,13,991,1485,0,3,1,3,0,1,0,76.14,66.73 ,33.33
03,007,01,001,0062,109 ,630,13,643,930,0,3,1,3,0,1,0,76.14,69.14 ,33.33
03,007,01,001,0063,110 ,1032,15,1047,1589,0,3,1,3,0,1,0,76.14,65.89 ,33.33
03,007,01,001,0064,111 ,698,10,708,961,0,3,1,3,0,1,0,76.14,73.67 ,33.33
03,007,01,001,0065,112 ,761,10,771,1141,0,3,1,3,0,1,0,76.14,67.57 ,33.33
03,007,01,001,0065,113 ,914,14,928,1423,0,3,1,3,0,1,0,76.14,65.21 ,33.33
03,007,01,001,0066,114 ,899,17,916,1374,0,3,1,3,0,1,0,76.14,66.67 ,33.33
03,007,01,001,0066,115 ,805,14,819,1074,0,3,1,3,0,1,0,76.14,76.26 ,33.33
03,007,01,001,0067,116 ,1107,24,1131,1504,0,3,1,3,0,1,0,76.14,75.20 ,33.33
03,007,01,001,0067,117 ,772,6,778,1206,0,3,1,3,0,1,0,76.14,64.51 ,33.33
03,007,01,001,0068,118 ,1124,7,1131,1800,0,3,1,3,0,1,0,76.14,62.83 ,33.33
03,007,01,001,0068,119 ,936,15,951,1450,0,3,1,3,0,1,0,76.14,65.59 ,33.33
03,007,01,001,0069,120 ,560,6,566,798,0,3,1,3,0,1,0,76.14,70.93 ,33.33
03,007,01,001,0070,121 ,639,10,649,978,0,3,1,3,0,1,0,76.14,66.36 ,33.33
03,007,01,001,0071,122 ,560,4,564,778,0,3,1,3,0,1,0,76.14,72.49 ,33.33
03,007,01,001,0072,123 ,833,13,846,1151,0,3,1,3,0,1,0,76.14,73.50 ,33.33
03,007,01,001,0073,124 ,767,16,783,1093,0,3,1,3,0,1,0,76.14,71.64 ,33.33
03,007,01,002,0074,125 ,783,12,795,1147,0,3,1,3,0,1,0,76.14,69.31 ,33.33
03,007,01,002,0074,126 ,1149,17,1166,1583,0,3,1,3,0,1,0,76.14,73.66 ,33.33
03,007,01,002,0075,127 ,1074,16,1090,1569,0,3,1,3,0,1,0,76.14,69.47 ,33.33
03,007,01,002,0076,128 ,639,11,650,934,0,3,1,3,0,1,0,76.14,69.59 ,33.33
03,007,01,002,0076,129 ,815,11,826,1221,0,3,1,3,0,1,0,76.14,67.65 ,33.33
03,007,01,002,0077,130 ,739,9,748,1000,0,3,1,3,0,1,0,76.14,74.80 ,33.33
03,007,01,002,0078,131 ,930,17,947,1339,0,3,1,3,0,1,0,76.14,70.72 ,33.33
03,007,01,002,0079,132 ,961,18,979,1374,0,3,1,3,0,1,0,76.14,71.25 ,33.33
03,007,01,002,0080,133 ,487,6,493,656,0,3,1,3,0,1,0,76.14,75.15 ,33.33
03,007,01,002,0081,134 ,625,5,630,829,0,3,1,3,0,1,0,76.14,76.00 ,33.33
03,007,01,002,0081,135 ,503,6,509,693,0,3,1,3,0,1,0,76.14,73.45 ,33.33
03,007,01,002,0082,136 ,878,16,894,1229,0,3,1,3,0,1,0,76.14,72.74 ,33.33
03,007,01,002,0082,137 ,842,15,857,1188,0,3,1,3,0,1,0,76.14,72.14 ,33.33
03,007,01,002,0082,138 ,818,11,829,1194,0,3,1,3,0,1,0,76.14,69.43 ,33.33
03,007,01,002,0083,139 ,796,20,816,1182,0,3,1,3,0,1,0,76.14,69.04 ,33.33
03,007,01,002,0083,140 ,710,12,722,1022,0,3,1,3,0,1,0,76.14,70.65 ,33.33
03,007,01,002,0084,141 ,1029,18,1047,1574,0,3,1,3,0,1,0,76.14,66.52 ,33.33
03,007,01,002,0084,142 ,1167,22,1189,1829,0,3,1,3,0,1,0,76.14,65.01 ,33.33
03,007,01,002,0085,143 ,871,13,884,1283,0,3,1,3,0,1,0,76.14,68.90 ,33.33
03,007,01,002,0086,144 ,1158,17,1175,1763,0,3,1,3,0,1,0,76.14,66.65 ,33.33
03,007,01,002,0086,145 ,737,12,749,1072,0,3,1,3,0,1,0,76.14,69.87 ,33.33
03,007,01,002,0087,146 ,538,11,549,824,0,3,1,3,0,1,0,76.14,66.63 ,33.33
03,007,01,002,0088,147 ,614,5,619,936,0,3,1,3,0,1,0,76.14,66.13 ,33.33
03,007,01,002,0089,148 ,966,11,977,1559,0,3,1,3,0,1,0,76.14,62.67 ,33.33
03,007,01,002,0090,149 ,924,15,939,1400,0,3,1,3,0,1,0,76.14,67.07 ,33.33
03,007,01,002,0091,150 ,941,14,955,1375,0,3,1,3,0,1,0,76.14,69.45 ,33.33
03,007,01,003,0092,151 ,1059,20,1079,1663,0,3,1,3,0,1,0,76.14,64.88 ,33.33
03,007,01,003,0093,152 ,920,7,927,1302,0,3,1,3,0,1,0,76.14,71.20 ,33.33
03,007,01,003,0094,153 ,1040,24,1064,1561,0,3,1,3,0,1,0,76.14,68.16 ,33.33
03,007,01,003,0095,154 ,386,8,394,565,0,3,1,3,0,1,0,76.14,69.73 ,33.33
03,007,01,003,0096,155 ,609,10,619,903,0,3,1,3,0,1,0,76.14,68.55 ,33.33
03,007,01,003,0096,156 ,849,14,863,1332,0,3,1,3,0,1,0,76.14,64.79 ,33.33
03,007,01,003,0097,157 ,726,13,739,1158,0,3,1,3,0,1,0,76.14,63.82 ,33.33
03,007,01,003,0097,158 ,667,11,678,970,0,3,1,3,0,1,0,76.14,69.90 ,33.33
03,007,01,003,0098,159 ,987,14,1001,1452,0,3,1,3,0,1,0,76.14,68.94 ,33.33
03,007,01,003,0099,160 ,581,6,587,872,0,3,1,3,0,1,0,76.14,67.32 ,33.33
03,007,01,003,0100,161 ,595,14,609,898,0,3,1,3,0,1,0,76.14,67.82 ,33.33
03,007,01,003,0101,162 ,694,11,705,1056,0,3,1,3,0,1,0,76.14,66.76 ,33.33
03,007,01,003,0102,163 ,476,4,480,688,0,3,1,3,0,1,0,76.14,69.77 ,33.33
03,007,01,003,0103,164 ,962,22,984,1456,0,3,1,3,0,1,0,76.14,67.58 ,33.33
03,007,01,003,0104,165 ,856,10,866,1260,0,3,1,3,0,1,0,76.14,68.73 ,33.33
03,007,01,003,0105,166 ,612,9,621,986,0,3,1,3,0,1,0,76.14,62.98 ,33.33
03,007,01,003,0106,167 ,617,9,626,1066,0,3,1,3,0,1,0,76.14,58.72 ,33.33
03,007,01,004,0107,168 ,779,9,788,1155,0,3,1,3,0,1,0,76.14,68.23 ,33.33
03,007,01,004,0108,169 ,374,5,379,556,0,3,1,3,0,1,0,76.14,68.17 ,33.33
03,007,01,004,0109,170 ,683,4,687,1061,0,3,1,3,0,1,0,76.14,64.75 ,33.33
03,007,01,004,0110,171 ,608,12,620,870,0,3,1,3,0,1,0,76.14,71.26 ,33.33
03,007,01,004,0111,172 ,706,8,714,1019,0,3,1,3,0,1,0,76.14,70.07 ,33.33
03,007,01,004,0112,173 ,1253,16,1269,1859,0,3,1,3,0,1,0,76.14,68.26 ,33.33
03,007,01,004,0113,174 ,815,15,830,1182,0,3,1,3,0,1,0,76.14,70.22 ,33.33
03,007,01,004,0114,175 ,203,3,206,315,0,3,1,3,0,1,0,76.14,65.40 ,33.33
03,007,01,004,0115,176 ,489,6,495,686,0,3,1,3,0,1,0,76.14,72.16 ,33.33
03,007,01,004,0116,177 ,540,10,550,760,0,3,1,3,0,1,0,76.14,72.37 ,33.33
03,007,01,004,0117,178 ,785,12,797,1123,0,3,1,3,0,1,0,76.14,70.97 ,33.33
03,007,01,004,0118,179 ,376,3,379,580,0,3,1,3,0,1,0,76.14,65.34 ,33.33
03,007,01,004,0119,180 ,646,8,654,926,0,3,1,3,0,1,0,76.14,70.63 ,33.33
03,007,01,004,0120,181 ,859,14,873,1288,0,3,1,3,0,1,0,76.14,67.78 ,33.33
03,007,01,004,0121,182 ,948,24,972,1391,0,3,1,3,0,1,0,76.14,69.88 ,33.33
03,007,01,004,0121,183 ,1114,10,1124,1662,0,3,1,3,0,1,0,76.14,67.63 ,33.33
03,007,01,004,0122,184 ,1206,20,1226,1757,0,3,1,3,0,1,0,76.14,69.78 ,33.33
03,007,01,004,0122,185 ,1173,14,1187,1760,0,3,1,3,0,1,0,76.14,67.44 ,33.33
03,007,01,004,0123,186 ,1053,22,1075,1575,0,3,1,3,0,1,0,76.14,68.25 ,33.33
03,007,01,004,0123,187 ,967,16,983,1467,0,3,1,3,0,1,0,76.14,67.01 ,33.33
03,007,01,004,0124,188 ,1187,13,1200,1721,0,3,1,3,0,1,0,76.14,69.73 ,33.33
03,007,01,004,0124,189 ,905,18,923,1359,0,3,1,3,0,1,0,76.14,67.92 ,33.33
03,007,01,004,0124,190 ,1216,13,1229,1767,0,3,1,3,0,1,0,76.14,69.55 ,33.33
03,007,01,004,0125,191 ,1217,21,1238,1803,0,3,1,3,0,1,0,76.14,68.66 ,33.33
03,007,01,004,0125,192 ,1326,18,1344,2130,0,3,1,3,0,1,0,76.14,63.10 ,33.33
03,007,01,004,0126,193 ,919,12,931,1410,0,3,1,3,0,1,0,76.14,66.03 ,33.33
03,007,01,004,0126,194 ,1145,16,1161,1584,0,3,1,3,0,1,0,76.14,73.30 ,33.33
03,007,01,004,0127,195 ,979,17,996,1579,0,3,1,3,0,1,0,76.14,63.08 ,33.33
03,007,01,004,0128,196 ,927,14,941,1432,0,3,1,3,0,1,0,76.14,65.71 ,33.33
03,007,01,004,0128,197 ,862,14,876,1307,0,3,1,3,0,1,0,76.14,67.02 ,33.33
03,007,01,004,0129,198 ,553,9,562,859,0,3,1,3,0,1,0,76.14,65.42 ,33.33
03,007,01,004,0129,199 ,1006,11,1017,1448,0,3,1,3,0,1,0,76.14,70.23 ,33.33
03,007,01,004,0130,200 ,899,20,919,1354,0,3,1,3,0,1,0,76.14,67.87 ,33.33
03,007,01,004,0130,201 ,947,19,966,1421,0,3,1,3,0,1,0,76.14,67.98 ,33.33
03,007,01,004,0131,202 ,625,10,635,993,0,3,1,3,0,1,0,76.14,63.95 ,33.33
03,007,01,004,0131,203 ,1315,16,1331,1839,0,3,1,3,0,1,0,76.14,72.38 ,33.33
03,007,01,004,0132,204 ,1172,26,1198,1750,0,3,1,3,0,1,0,76.14,68.46 ,33.33
03,007,01,004,0133,205 ,941,15,956,1329,0,3,1,3,0,1,0,76.14,71.93 ,33.33
03,007,01,004,0133,206 ,587,4,591,768,0,3,1,3,0,1,0,76.14,76.95 ,33.33
03,007,01,004,0134,207 ,898,15,913,1296,0,3,1,3,0,1,0,76.14,70.45 ,33.33
03,007,01,004,0134,208 ,1138,15,1153,1651,0,3,1,3,0,1,0,76.14,69.84 ,33.33
03,007,01,004,0135,209 ,908,11,919,1281,0,3,1,3,0,1,0,76.14,71.74 ,33.33
03,007,01,004,0135,210 ,799,12,811,1228,0,3,1,3,0,1,0,76.14,66.04 ,33.33
03,007,01,004,0135,211 ,506,12,518,738,0,3,1,3,0,1,0,76.14,70.19 ,33.33
03,007,01,005,0136,212 ,803,16,819,1141,0,3,1,3,0,1,0,76.14,71.78 ,33.33
03,007,01,005,0136,213 ,588,13,601,871,0,3,1,3,0,1,0,76.14,69.00 ,33.33
03,007,01,005,0137,214 ,800,5,805,1077,0,3,1,3,0,1,0,76.14,74.74 ,33.33
03,007,01,005,0138,215 ,756,8,764,1023,0,3,1,3,0,1,0,76.14,74.68 ,33.33
03,007,01,005,0139,216 ,892,14,906,1167,0,3,1,3,0,1,0,76.14,77.63 ,33.33
03,007,01,005,0140,217 ,509,9,518,697,0,3,1,3,0,1,0,76.14,74.32 ,33.33
03,007,01,005,0141,218 ,898,8,906,1144,0,3,1,3,0,1,0,76.14,79.20 ,33.33
03,007,01,005,0142,219 ,756,14,770,1064,0,3,1,3,0,1,0,76.14,72.37 ,33.33
03,007,01,005,0143,220 ,698,10,708,955,0,3,1,3,0,1,0,76.14,74.14 ,33.33
03,007,01,005,0143,221 ,787,7,794,1108,0,3,1,3,0,1,0,76.14,71.66 ,33.33
03,007,01,005,0144,222 ,1062,10,1072,1331,0,3,1,3,0,1,0,76.14,80.54 ,33.33
03,007,01,005,0145,223 ,936,8,944,1245,0,3,1,3,0,1,0,76.14,75.82 ,33.33
03,007,01,005,0146,224 ,701,23,724,960,0,3,1,3,0,1,0,76.14,75.42 ,33.33
03,007,01,005,0146,225 ,672,3,675,1033,0,3,1,3,0,1,0,76.14,65.34 ,33.33
03,007,01,005,0147,226 ,663,13,676,919,0,3,1,3,0,1,0,76.14,73.56 ,33.33
03,007,01,005,0147,227 ,470,6,476,690,0,3,1,3,0,1,0,76.14,68.99 ,33.33
03,007,01,005,0148,228 ,633,7,640,879,0,3,1,3,0,1,0,76.14,72.81 ,33.33
03,007,01,005,0148,229 ,774,13,787,1083,0,3,1,3,0,1,0,76.14,72.67 ,33.33
03,007,01,005,0149,230 ,784,15,799,1095,0,3,1,3,0,1,0,76.14,72.97 ,33.33
03,007,01,005,0150,231 ,710,13,723,1018,0,3,1,3,0,1,0,76.14,71.02 ,33.33
03,007,01,005,0151,232 ,702,12,714,998,0,3,1,3,0,1,0,76.14,71.54 ,33.33
03,007,01,005,0151,233 ,650,15,665,1023,0,3,1,3,0,1,0,76.14,65.00 ,33.33
03,007,01,005,0152,234 ,610,6,616,853,0,3,1,3,0,1,0,76.14,72.22 ,33.33
03,007,01,005,0152,235 ,653,18,671,914,0,3,1,3,0,1,0,76.14,73.41 ,33.33
03,007,01,005,0153,236 ,669,9,678,870,0,3,1,3,0,1,0,76.14,77.93 ,33.33
03,007,01,005,0153,237 ,800,13,813,1109,0,3,1,3,0,1,0,76.14,73.31 ,33.33
03,007,01,005,0154,238 ,849,14,863,1147,0,3,1,3,0,1,0,76.14,75.24 ,33.33
03,007,01,005,0155,239 ,935,13,948,1241,0,3,1,3,0,1,0,76.14,76.39 ,33.33
03,007,01,005,0156,240 ,995,13,1008,1472,0,3,1,3,0,1,0,76.14,68.48 ,33.33
03,007,01,005,0156,241 ,790,6,796,1136,0,3,1,3,0,1,0,76.14,70.07 ,33.33
03,007,01,005,0157,242 ,707,8,715,980,0,3,1,3,0,1,0,76.14,72.96 ,33.33
03,007,01,005,0157,243 ,761,11,772,1084,0,3,1,3,0,1,0,76.14,71.22 ,33.33
03,007,01,006,0158,244 ,661,7,668,983,0,3,1,3,0,1,0,76.14,67.96 ,33.33
03,007,01,006,0158,245 ,421,5,426,584,0,3,1,3,0,1,0,76.14,72.95 ,33.33
03,007,01,006,0159,246 ,972,21,993,1432,0,3,1,3,0,1,0,76.14,69.34 ,33.33
03,007,01,006,0160,247 ,832,7,839,1216,0,3,1,3,0,1,0,76.14,69.00 ,33.33
03,007,01,006,0160,248 ,522,9,531,767,0,3,1,3,0,1,0,76.14,69.23 ,33.33
03,007,01,006,0161,249 ,832,6,838,1165,0,3,1,3,0,1,0,76.14,71.93 ,33.33
03,007,01,006,0162,250 ,589,12,601,850,0,3,1,3,0,1,0,76.14,70.71 ,33.33
03,007,01,006,0162,251 ,563,7,570,784,0,3,1,3,0,1,0,76.14,72.70 ,33.33
03,007,01,006,0163,252 ,819,10,829,1174,0,3,1,3,0,1,0,76.14,70.61 ,33.33
03,007,01,006,0163,253 ,619,7,626,854,0,3,1,3,0,1,0,76.14,73.30 ,33.33
03,007,01,006,0163,254 ,699,14,713,1095,0,3,1,3,0,1,0,76.14,65.11 ,33.33
03,007,01,006,0164,255 ,1033,15,1048,1434,0,3,1,3,0,1,0,76.14,73.08 ,33.33
03,007,01,006,0164,256 ,768,14,782,1105,0,3,1,3,0,1,0,76.14,70.77 ,33.33
03,007,01,006,0165,257 ,826,10,836,1089,0,3,1,3,0,1,0,76.14,76.77 ,33.33
03,007,01,006,0165,258 ,602,15,617,815,0,3,1,3,0,1,0,76.14,75.71 ,33.33
03,007,01,006,0166,259 ,759,14,773,1090,0,3,1,3,0,1,0,76.14,70.92 ,33.33
03,007,01,006,0167,260 ,1030,20,1050,1540,0,3,1,3,0,1,0,76.14,68.18 ,33.33
03,007,01,006,0167,261 ,1146,14,1160,1655,0,3,1,3,0,1,0,76.14,70.09 ,33.33
03,007,01,006,0168,262 ,447,9,456,621,0,3,1,3,0,1,0,76.14,73.43 ,33.33
03,007,01,006,0168,263 ,771,10,781,1073,0,3,1,3,0,1,0,76.14,72.79 ,33.33
03,007,01,006,0169,264 ,944,13,957,1303,0,3,1,3,0,1,0,76.14,73.45 ,33.33
03,007,01,006,0170,265 ,984,16,1000,1364,0,3,1,3,0,1,0,76.14,73.31 ,33.33
03,007,01,006,0171,266 ,845,13,858,1123,0,3,1,3,0,1,0,76.14,76.40 ,33.33
03,007,01,006,0171,267 ,523,4,527,706,0,3,1,3,0,1,0,76.14,74.65 ,33.33
03,007,01,007,0172,268 ,1204,14,1218,1757,0,3,1,3,0,1,0,76.14,69.32 ,33.33
03,007,01,007,0172,269 ,1302,25,1327,1997,0,3,1,3,0,1,0,76.14,66.45 ,33.33
03,007,01,007,0173,270 ,1197,23,1220,1814,0,3,1,3,0,1,0,76.14,67.25 ,33.33
03,007,01,007,0173,271 ,993,13,1006,1489,0,3,1,3,0,1,0,76.14,67.56 ,33.33
03,007,01,007,0174,272 ,348,5,353,465,0,3,1,3,0,1,0,76.14,75.91 ,33.33
03,007,01,007,0175,273 ,936,13,949,1338,0,3,1,3,0,1,0,76.14,70.93 ,33.33
03,007,01,007,0176,274 ,959,15,974,1412,0,3,1,3,0,1,0,76.14,68.98 ,33.33
03,007,01,007,0176,275 ,1025,18,1043,1583,0,3,1,3,0,1,0,76.14,65.89 ,33.33
03,007,01,007,0177,276 ,677,8,685,998,0,3,1,3,0,1,0,76.14,68.64 ,33.33
03,007,01,007,0177,277 ,775,15,790,1190,0,3,1,3,0,1,0,76.14,66.39 ,33.33
03,007,01,007,0178,278 ,894,23,917,1257,0,3,1,3,0,1,0,76.14,72.95 ,33.33
03,007,01,007,0179,279 ,563,11,574,767,0,3,1,3,0,1,0,76.14,74.84 ,33.33
03,007,01,007,0180,280 ,432,5,437,549,0,3,1,3,0,1,0,76.14,79.60 ,33.33
03,007,01,007,0180,281 ,761,11,772,1068,0,3,1,3,0,1,0,76.14,72.28 ,33.33
03,007,01,007,0181,282 ,804,11,815,1121,0,3,1,3,0,1,0,76.14,72.70 ,33.33
03,007,01,007,0181,283 ,775,5,780,1154,0,3,1,3,0,1,0,76.14,67.59 ,33.33
03,007,01,007,0182,284 ,864,16,880,1235,0,3,1,3,0,1,0,76.14,71.26 ,33.33
03,007,01,007,0183,285 ,1057,14,1071,1510,0,3,1,3,0,1,0,76.14,70.93 ,33.33
03,007,01,007,0184,286 ,1090,24,1114,1615,0,3,1,3,0,1,0,76.14,68.98 ,33.33
03,007,01,007,0185,287 ,870,12,882,1224,0,3,1,3,0,1,0,76.14,72.06 ,33.33
03,007,01,007,0186,288 ,1143,19,1162,1705,0,3,1,3,0,1,0,76.14,68.15 ,33.33
03,007,01,007,0186,289 ,1294,17,1311,1954,0,3,1,3,0,1,0,76.14,67.09 ,33.33
03,007,01,007,0186,290 ,895,10,905,1385,0,3,1,3,0,1,0,76.14,65.34 ,33.33
03,007,01,007,0187,291 ,972,21,993,1527,0,3,1,3,0,1,0,76.14,65.03 ,33.33
03,007,01,007,0188,292 ,1062,19,1081,1599,0,3,1,3,0,1,0,76.14,67.60 ,33.33
03,007,01,007,0189,293 ,825,21,846,1273,0,3,1,3,0,1,0,76.14,66.46 ,33.33
03,007,01,007,0189,294 ,607,9,616,1016,0,3,1,3,0,1,0,76.14,60.63 ,33.33
03,007,01,007,0190,295 ,895,19,914,1329,0,3,1,3,0,1,0,76.14,68.77 ,33.33
03,007,01,007,0190,296 ,911,18,929,1284,0,3,1,3,0,1,0,76.14,72.35 ,33.33
03,007,01,007,0191,297 ,615,6,621,779,0,3,1,3,0,1,0,76.14,79.72 ,33.33
03,007,01,007,0192,298 ,817,21,838,1293,0,3,1,3,0,1,0,76.14,64.81 ,33.33
03,007,01,007,0192,299 ,644,8,652,887,0,3,1,3,0,1,0,76.14,73.51 ,33.33
03,007,01,007,0193,300 ,724,16,740,1035,0,3,1,3,0,1,0,76.14,71.50 ,33.33
03,007,01,007,0193,301 ,721,18,739,973,0,3,1,3,0,1,0,76.14,75.95 ,33.33
03,007,01,007,0194,302 ,712,14,726,1051,0,3,1,3,0,1,0,76.14,69.08 ,33.33
03,007,01,007,0195,303 ,668,10,678,992,0,3,1,3,0,1,0,76.14,68.35 ,33.33
03,007,01,007,0195,304 ,943,22,965,1490,0,3,1,3,0,1,0,76.14,64.77 ,33.33
03,007,01,007,0196,305 ,820,6,826,1223,0,3,1,3,0,1,0,76.14,67.54 ,33.33
03,007,01,007,0196,306 ,776,10,786,1145,0,3,1,3,0,1,0,76.14,68.65 ,33.33
03,007,01,007,0197,307 ,1061,19,1080,1602,0,3,1,3,0,1,0,76.14,67.42 ,33.33
03,007,01,007,0198,308 ,548,10,558,834,0,3,1,3,0,1,0,76.14,66.91 ,33.33
03,007,01,007,0199,309 ,885,7,892,1227,0,3,1,3,0,1,0,76.14,72.70 ,33.33
03,007,01,007,0200,310 ,1119,30,1149,1683,0,3,1,3,0,1,0,76.14,68.27 ,33.33
03,007,01,007,0201,311 ,1033,24,1057,1554,0,3,1,3,0,1,0,76.14,68.02 ,33.33
03,007,01,007,0201,312 ,821,11,832,1191,0,3,1,3,0,1,0,76.14,69.86 ,33.33
03,007,01,007,0202,313 ,440,9,449,695,0,3,1,3,0,1,0,76.14,64.60 ,33.33
03,007,01,007,0202,314 ,654,15,669,930,0,3,1,3,0,1,0,76.14,71.94 ,33.33
03,007,01,008,0203,315 ,1212,27,1239,1840,0,3,1,3,0,1,0,76.14,67.34 ,33.33
03,007,01,008,0204,316 ,761,7,768,1115,0,3,1,3,0,1,0,76.14,68.88 ,33.33
03,007,01,008,0205,317 ,1217,21,1238,1882,0,3,1,3,0,1,0,76.14,65.78 ,33.33
03,007,01,008,0206,318 ,796,9,805,1143,0,3,1,3,0,1,0,76.14,70.43 ,33.33
03,007,01,008,0207,319 ,666,14,680,976,0,3,1,3,0,1,0,76.14,69.67 ,33.33
03,007,01,008,0208,320 ,1072,24,1096,1574,0,3,1,3,0,1,0,76.14,69.63 ,33.33
03,007,01,008,0209,321 ,688,10,698,977,0,3,1,3,0,1,0,76.14,71.44 ,33.33
03,007,01,008,0209,322 ,726,11,737,1109,0,3,1,3,0,1,0,76.14,66.46 ,33.33
03,007,01,008,0210,323 ,719,10,729,1023,0,3,1,3,0,1,0,76.14,71.26 ,33.33
03,007,01,009,0211,324 ,779,7,786,1196,0,3,1,3,0,1,0,76.14,65.72 ,33.33
03,007,01,009,0211,325 ,834,10,844,1328,0,3,1,3,0,1,0,76.14,63.55 ,33.33
03,007,01,009,0211,326 ,890,17,907,1403,0,3,1,3,0,1,0,76.14,64.65 ,33.33
03,007,01,009,0212,327 ,953,16,969,1448,0,3,1,3,0,1,0,76.14,66.92 ,33.33
03,007,01,009,0213,328 ,851,16,867,1206,0,3,1,3,0,1,0,76.14,71.89 ,33.33
03,007,01,009,0214,329 ,1137,16,1153,1564,0,3,1,3,0,1,0,76.14,73.72 ,33.33
03,007,01,009,0215,330 ,919,14,933,1418,0,3,1,3,0,1,0,76.14,65.80 ,33.33
03,007,01,009,0216,331 ,1031,11,1042,1505,0,3,1,3,0,1,0,76.14,69.24 ,33.33
03,007,01,009,0217,332 ,662,9,671,971,0,3,1,3,0,1,0,76.14,69.10 ,33.33
03,007,01,009,0217,333 ,679,13,692,1122,0,3,1,3,0,1,0,76.14,61.68 ,33.33
03,007,01,009,0218,334 ,1090,18,1108,1590,0,3,1,3,0,1,0,76.14,69.69 ,33.33
03,007,01,009,0219,335 ,744,14,758,1122,0,3,1,3,0,1,0,76.14,67.56 ,33.33
03,007,01,009,0220,336 ,955,12,967,1459,0,3,1,3,0,1,0,76.14,66.28 ,33.33
03,007,01,009,0221,337 ,746,8,754,1121,0,3,1,3,0,1,0,76.14,67.26 ,33.33
03,007,01,009,0222,338 ,580,11,591,886,0,3,1,3,0,1,0,76.14,66.70 ,33.33
03,007,01,009,0223,339 ,1240,17,1257,1786,0,3,1,3,0,1,0,76.14,70.38 ,33.33
03,007,01,009,0224,340 ,1306,12,1318,1880,0,3,1,3,0,1,0,76.14,70.11 ,33.33
03,007,01,010,0225,341 ,694,13,707,1064,0,3,1,3,0,1,0,76.14,66.45 ,33.33
03,007,01,010,0226,342 ,982,18,1000,1508,0,3,1,3,0,1,0,76.14,66.31 ,33.33
03,007,01,010,0226,343 ,676,5,681,1039,0,3,1,3,0,1,0,76.14,65.54 ,33.33
03,007,01,010,0227,344 ,764,11,775,1150,0,3,1,3,0,1,0,76.14,67.39 ,33.33
03,007,01,010,0227,345 ,1074,7,1081,1682,0,3,1,3,0,1,0,76.14,64.27 ,33.33
03,007,01,010,0228,346 ,740,5,745,1103,0,3,1,3,0,1,0,76.14,67.54 ,33.33
03,007,01,010,0228,347 ,1096,10,1106,1608,0,3,1,3,0,1,0,76.14,68.78 ,33.33
03,007,01,010,0229,348 ,574,3,577,816,0,3,1,3,0,1,0,76.14,70.71 ,33.33
03,007,01,010,0230,349 ,689,7,696,1051,0,3,1,3,0,1,0,76.14,66.22 ,33.33
03,007,01,010,0230,350 ,996,13,1009,1535,0,3,1,3,0,1,0,76.14,65.73 ,33.33
03,007,01,010,0231,351 ,675,6,681,948,0,3,1,3,0,1,0,76.14,71.84 ,33.33
03,007,01,010,0232,352 ,499,4,503,718,0,3,1,3,0,1,0,76.14,70.06 ,33.33
03,007,01,010,0233,353 ,582,10,592,870,0,3,1,3,0,1,0,76.14,68.05 ,33.33
03,007,01,010,0233,354 ,596,10,606,892,0,3,1,3,0,1,0,76.14,67.94 ,33.33
03,007,01,010,0234,355 ,1046,10,1056,1607,0,3,1,3,0,1,0,76.14,65.71 ,33.33
03,007,01,010,0234,356 ,843,5,848,1275,0,3,1,3,0,1,0,76.14,66.51 ,33.33
03,007,01,010,0234,357 ,869,15,884,1330,0,3,1,3,0,1,0,76.14,66.47 ,33.33
03,007,01,010,0235,358 ,627,11,638,980,0,3,1,3,0,1,0,76.14,65.10 ,33.33
03,007,01,010,0235,359 ,830,12,842,1243,0,3,1,3,0,1,0,76.14,67.74 ,33.33
03,007,01,010,0236,360 ,690,9,699,1051,0,3,1,3,0,1,0,76.14,66.51 ,33.33
03,007,01,010,0236,361 ,678,8,686,1018,0,3,1,3,0,1,0,76.14,67.39 ,33.33
03,007,01,010,0236,362 ,558,4,562,760,0,3,1,3,0,1,0,76.14,73.95 ,33.33
03,007,01,010,0236,363 ,537,8,545,816,0,3,1,3,0,1,0,76.14,66.79 ,33.33
03,007,01,010,0237,364 ,617,7,624,1010,0,3,1,3,0,1,0,76.14,61.78 ,33.33
03,007,01,010,0237,365 ,720,10,730,1081,0,3,1,3,0,1,0,76.14,67.53 ,33.33
03,007,01,010,0237,366 ,913,8,921,1300,0,3,1,3,0,1,0,76.14,70.85 ,33.33
03,007,01,010,0238,367 ,965,13,978,1465,0,3,1,3,0,1,0,76.14,66.76 ,33.33
03,007,01,010,0238,368 ,940,21,961,1362,0,3,1,3,0,1,0,76.14,70.56 ,33.33
03,007,01,010,0238,369 ,839,8,847,1249,0,3,1,3,0,1,0,76.14,67.81 ,33.33
03,007,01,010,0239,370 ,969,8,977,1424,0,3,1,3,0,1,0,76.14,68.61 ,33.33
03,007,01,010,0240,371 ,1154,16,1170,1688,0,3,1,3,0,1,0,76.14,69.31 ,33.33
03,007,01,010,0241,372 ,707,9,716,1108,0,3,1,3,0,1,0,76.14,64.62 ,33.33
03,007,01,010,0241,373 ,863,14,877,1300,0,3,1,3,0,1,0,76.14,67.46 ,33.33
03,007,01,010,0241,374 ,771,9,780,1188,0,3,1,3,0,1,0,76.14,65.66 ,33.33
03,007,01,010,0241,375 ,928,11,939,1392,0,3,1,3,0,1,0,76.14,67.46 ,33.33
03,007,01,010,0242,376 ,970,7,977,1431,0,3,1,3,0,1,0,76.14,68.27 ,33.33
03,007,01,010,0242,377 ,989,8,997,1482,0,3,1,3,0,1,0,76.14,67.27 ,33.33
03,007,01,010,0242,378 ,1095,16,1111,1750,0,3,1,3,0,1,0,76.14,63.49 ,33.33
03,007,01,010,0243,379 ,780,11,791,1141,0,3,1,3,0,1,0,76.14,69.33 ,33.33
03,007,01,010,0243,380 ,840,15,855,1303,0,3,1,3,0,1,0,76.14,65.62 ,33.33
03,007,01,010,0244,381 ,804,5,809,1259,0,3,1,3,0,1,0,76.14,64.26 ,33.33
03,007,01,010,0244,382 ,694,6,700,1058,0,3,1,3,0,1,0,76.14,66.16 ,33.33
03,007,01,010,0245,383 ,605,11,616,930,0,3,1,3,0,1,0,76.14,66.24 ,33.33
03,007,01,010,0245,384 ,637,5,642,934,0,3,1,3,0,1,0,76.14,68.74 ,33.33
03,007,01,010,0246,385 ,666,6,672,1031,0,3,1,3,0,1,0,76.14,65.18 ,33.33
03,007,01,010,0246,386 ,569,8,577,859,0,3,1,3,0,1,0,76.14,67.17 ,33.33
03,007,01,010,0247,387 ,960,15,975,1435,0,3,1,3,0,1,0,76.14,67.94 ,33.33
03,007,01,010,0248,388 ,686,10,696,1038,0,3,1,3,0,1,0,76.14,67.05 ,33.33
03,007,01,010,0248,389 ,639,4,643,953,0,3,1,3,0,1,0,76.14,67.47 ,33.33
03,007,01,010,0249,390 ,769,8,777,1138,0,3,1,3,0,1,0,76.14,68.28 ,33.33
03,007,01,010,0249,391 ,856,9,865,1298,0,3,1,3,0,1,0,76.14,66.64 ,33.33
03,007,01,010,0250,392 ,694,18,712,1052,0,3,1,3,0,1,0,76.14,67.68 ,33.33
03,007,01,010,0250,393 ,596,11,607,896,0,3,1,3,0,1,0,76.14,67.75 ,33.33
03,007,01,010,0251,394 ,526,6,532,817,0,3,1,3,0,1,0,76.14,65.12 ,33.33
03,007,01,010,0251,395 ,636,16,652,966,0,3,1,3,0,1,0,76.14,67.49 ,33.33
03,007,01,010,0251,396 ,803,7,810,1162,0,3,1,3,0,1,0,76.14,69.71 ,33.33
03,007,01,010,0252,397 ,746,8,754,1050,0,3,1,3,0,1,0,76.14,71.81 ,33.33
03,007,01,010,0252,398 ,804,8,812,1141,0,3,1,3,0,1,0,76.14,71.17 ,33.33
03,007,01,010,0253,399 ,693,11,704,1066,0,3,1,3,0,1,0,76.14,66.04 ,33.33
03,007,01,010,0253,400 ,714,13,727,1103,0,3,1,3,0,1,0,76.14,65.91 ,33.33
03,007,01,010,0254,401 ,655,13,668,1016,0,3,1,3,0,1,0,76.14,65.75 ,33.33
03,007,01,010,0254,402 ,731,13,744,1202,0,3,1,3,0,1,0,76.14,61.90 ,33.33
03,007,01,010,0255,403 ,1015,17,1032,1677,0,3,1,3,0,1,0,76.14,61.54 ,33.33
03,007,01,010,0256,404 ,814,9,823,1272,0,3,1,3,0,1,0,76.14,64.70 ,33.33
03,007,01,010,0257,405 ,438,6,444,730,0,3,1,3,0,1,0,76.14,60.82 ,33.33
03,007,01,010,0258,406 ,582,9,591,935,0,3,1,3,0,1,0,76.14,63.21 ,33.33
03,007,01,010,0258,407 ,548,8,556,808,0,3,1,3,0,1,0,76.14,68.81 ,33.33
03,007,01,010,0259,408 ,763,6,769,1095,0,3,1,3,0,1,0,76.14,70.23 ,33.33
03,007,01,010,0259,409 ,574,3,577,885,0,3,1,3,0,1,0,76.14,65.20 ,33.33
03,007,01,010,0260,410 ,1094,15,1109,1568,0,3,1,3,0,1,0,76.14,70.73 ,33.33
03,007,01,010,0261,411 ,606,13,619,931,0,3,1,3,0,1,0,76.14,66.49 ,33.33
03,007,01,010,0261,412 ,441,4,445,676,0,3,1,3,0,1,0,76.14,65.83 ,33.33
03,007,01,010,0262,413 ,917,13,930,1412,0,3,1,3,0,1,0,76.14,65.86 ,33.33
03,007,01,010,0263,414 ,694,9,703,959,0,3,1,3,0,1,0,76.14,73.31 ,33.33
03,007,01,010,0263,415 ,633,10,643,999,0,3,1,3,0,1,0,76.14,64.36 ,33.33
03,007,01,011,0264,416 ,762,15,777,1046,0,3,1,3,0,1,0,76.14,74.28 ,33.33
03,007,01,011,0264,417 ,596,10,606,884,0,3,1,3,0,1,0,76.14,68.55 ,33.33
03,007,01,011,0265,418 ,1067,16,1083,1526,0,3,1,3,0,1,0,76.14,70.97 ,33.33
03,007,01,011,0266,419 ,619,11,630,871,0,3,1,3,0,1,0,76.14,72.33 ,33.33
03,007,01,011,0267,420 ,893,11,904,1299,0,3,1,3,0,1,0,76.14,69.59 ,33.33
03,007,01,011,0268,421 ,837,6,843,1217,0,3,1,3,0,1,0,76.14,69.27 ,33.33
03,007,01,011,0269,422 ,990,15,1005,1406,0,3,1,3,0,1,0,76.14,71.48 ,33.33
03,007,01,011,0270,423 ,782,5,787,1130,0,3,1,3,0,1,0,76.14,69.65 ,33.33
03,007,01,011,0271,424 ,781,19,800,1173,0,3,1,3,0,1,0,76.14,68.20 ,33.33
03,007,01,011,0272,425 ,862,7,869,1212,0,3,1,3,0,1,0,76.14,71.70 ,33.33
03,007,01,011,0272,426 ,570,10,580,870,0,3,1,3,0,1,0,76.14,66.67 ,33.33
03,007,01,011,0273,427 ,1322,11,1333,1882,0,3,1,3,0,1,0,76.14,70.83 ,33.33
03,007,01,011,0274,428 ,1119,12,1131,1769,0,3,1,3,0,1,0,76.14,63.93 ,33.33
03,007,01,011,0275,429 ,863,11,874,1182,0,3,1,3,0,1,0,76.14,73.94 ,33.33
03,007,01,011,0276,430 ,927,10,937,1414,0,3,1,3,0,1,0,76.14,66.27 ,33.33
03,007,01,011,0276,431 ,665,13,678,1055,0,3,1,3,0,1,0,76.14,64.27 ,33.33
03,007,01,011,0277,432 ,1154,16,1170,1705,0,3,1,3,0,1,0,76.14,68.62 ,33.33
03,007,01,011,0278,433 ,1096,16,1112,1711,0,3,1,3,0,1,0,76.14,64.99 ,33.33
03,007,01,011,0279,434 ,708,12,720,1093,0,3,1,3,0,1,0,76.14,65.87 ,33.33
03,007,01,011,0279,435 ,505,13,518,846,0,3,1,3,0,1,0,76.14,61.23 ,33.33
03,007,01,012,0280,436 ,601,8,609,812,0,3,1,3,0,1,0,76.14,75.00 ,33.33
03,007,01,012,0281,437 ,1012,12,1024,1446,0,3,1,3,0,1,0,76.14,70.82 ,33.33
03,007,01,012,0282,438 ,1215,17,1232,1788,0,3,1,3,0,1,0,76.14,68.90 ,33.33
03,007,01,012,0283,439 ,1216,19,1235,1810,0,3,1,3,0,1,0,76.14,68.23 ,33.33
03,007,01,012,0284,440 ,1092,24,1116,1591,0,3,1,3,0,1,0,76.14,70.14 ,33.33
03,007,01,012,0285,441 ,848,16,864,1275,0,3,1,3,0,1,0,76.14,67.76 ,33.33
03,007,01,012,0286,442 ,651,12,663,906,0,3,1,3,0,1,0,76.14,73.18 ,33.33
03,007,01,012,0287,443 ,570,8,578,835,0,3,1,3,0,1,0,76.14,69.22 ,33.33
03,007,01,012,0288,444 ,715,4,719,1008,0,3,1,3,0,1,0,76.14,71.33 ,33.33
03,007,01,012,0288,445 ,698,10,708,973,0,3,1,3,0,1,0,76.14,72.76 ,33.33
03,007,01,012,0289,446 ,913,7,920,1268,0,3,1,3,0,1,0,76.14,72.56 ,33.33
03,007,01,012,0290,447 ,779,16,795,1055,0,3,1,3,0,1,0,76.14,75.36 ,33.33
03,007,01,012,0291,448 ,1022,20,1042,1487,0,3,1,3,0,1,0,76.14,70.07 ,33.33
03,007,01,012,0292,449 ,1055,10,1065,1608,0,3,1,3,0,1,0,76.14,66.23 ,33.33
03,007,01,012,0293,450 ,1058,8,1066,1487,0,3,1,3,0,1,0,76.14,71.69 ,33.33
03,007,01,012,0294,451 ,797,16,813,1149,0,3,1,3,0,1,0,76.14,70.76 ,33.33
03,007,01,012,0295,452 ,579,9,588,834,0,3,1,3,0,1,0,76.14,70.50 ,33.33
03,007,01,012,0296,453 ,483,5,488,690,0,3,1,3,0,1,0,76.14,70.72 ,33.33
03,007,01,012,0297,454 ,540,5,545,726,0,3,1,3,0,1,0,76.14,75.07 ,33.33
03,007,01,012,0298,455 ,487,8,495,664,0,3,1,3,0,1,0,76.14,74.55 ,33.33
03,007,01,012,0299,456 ,658,10,668,931,0,3,1,3,0,1,0,76.14,71.75 ,33.33
03,007,01,012,0300,457 ,610,11,621,834,0,3,1,3,0,1,0,76.14,74.46 ,33.33
03,007,01,012,0301,458 ,488,7,495,657,0,3,1,3,0,1,0,76.14,75.34 ,33.33
03,007,01,012,0302,459 ,823,10,833,1119,0,3,1,3,0,1,0,76.14,74.44 ,33.33
03,007,01,012,0303,460 ,948,10,958,1335,0,3,1,3,0,1,0,76.14,71.76 ,33.33
03,007,01,013,0304,461 ,848,7,855,1208,0,3,1,3,0,1,0,76.14,70.78 ,33.33
03,007,01,013,0305,462 ,569,3,572,759,0,3,1,3,0,1,0,76.14,75.36 ,33.33
03,007,01,013,0306,463 ,923,8,931,1317,0,3,1,3,0,1,0,76.14,70.69 ,33.33
03,007,01,013,0307,464 ,350,5,355,485,0,3,1,3,0,1,0,76.14,73.20 ,33.33
03,007,01,013,0308,465 ,836,6,842,1278,0,3,1,3,0,1,0,76.14,65.88 ,33.33
03,007,01,013,0308,466 ,954,12,966,1467,0,3,1,3,0,1,0,76.14,65.85 ,33.33
03,007,01,013,0309,467 ,574,6,580,854,0,3,1,3,0,1,0,76.14,67.92 ,33.33
03,007,01,013,0309,468 ,653,10,663,956,0,3,1,3,0,1,0,76.14,69.35 ,33.33
03,007,01,013,0310,469 ,743,12,755,1063,0,3,1,3,0,1,0,76.14,71.03 ,33.33
03,007,01,013,0310,470 ,636,8,644,928,0,3,1,3,0,1,0,76.14,69.40 ,33.33
03,007,01,013,0311,471 ,876,10,886,1241,0,3,1,3,0,1,0,76.14,71.39 ,33.33
03,007,01,013,0312,472 ,867,8,875,1218,0,3,1,3,0,1,0,76.14,71.84 ,33.33
03,007,01,013,0312,473 ,642,9,651,964,0,3,1,3,0,1,0,76.14,67.53 ,33.33
03,007,01,013,0313,474 ,703,5,708,1035,0,3,1,3,0,1,0,76.14,68.41 ,33.33
03,007,01,013,0313,475 ,788,5,793,1134,0,3,1,3,0,1,0,76.14,69.93 ,33.33
03,007,01,013,0314,476 ,634,5,639,904,0,3,1,3,0,1,0,76.14,70.69 ,33.33
03,007,01,013,0314,477 ,595,5,600,932,0,3,1,3,0,1,0,76.14,64.38 ,33.33
03,007,01,013,0315,478 ,513,11,524,746,0,3,1,3,0,1,0,76.14,70.24 ,33.33
03,007,01,013,0316,479 ,1067,16,1083,1577,0,3,1,3,0,1,0,76.14,68.67 ,33.33
03,007,01,013,0317,480 ,738,8,746,1080,0,3,1,3,0,1,0,76.14,69.07 ,33.33
03,007,01,013,0317,481 ,750,7,757,1080,0,3,1,3,0,1,0,76.14,70.09 ,33.33
03,007,01,013,0318,482 ,508,9,517,781,0,3,1,3,0,1,0,76.14,66.20 ,33.33
03,007,01,013,0319,483 ,791,14,805,1214,0,3,1,3,0,1,0,76.14,66.31 ,33.33
03,007,01,013,0320,484 ,983,13,996,1452,0,3,1,3,0,1,0,76.14,68.60 ,33.33
03,007,01,013,0321,485 ,811,11,822,1173,0,3,1,3,0,1,0,76.14,70.08 ,33.33
03,007,01,013,0321,486 ,793,14,807,1200,0,3,1,3,0,1,0,76.14,67.25 ,33.33
03,007,01,013,0321,487 ,726,7,733,1076,0,3,1,3,0,1,0,76.14,68.12 ,33.33
03,007,01,013,0322,488 ,448,9,457,661,0,3,1,3,0,1,0,76.14,69.14 ,33.33
03,007,01,013,0323,489 ,790,11,801,1184,0,3,1,3,0,1,0,76.14,67.65 ,33.33
03,007,01,013,0324,490 ,494,7,501,701,0,3,1,3,0,1,0,76.14,71.47 ,33.33
03,007,01,013,0325,491 ,782,8,790,1211,0,3,1,3,0,1,0,76.14,65.24 ,33.33
03,007,01,013,0326,492 ,827,12,839,1312,0,3,1,3,0,1,0,76.14,63.95 ,33.33
03,007,01,013,0327,493 ,487,10,497,738,0,3,1,3,0,1,0,76.14,67.34 ,33.33
03,007,01,013,0327,494 ,665,5,670,1095,0,3,1,3,0,1,0,76.14,61.19 ,33.33
03,007,01,013,0328,495 ,881,15,896,1483,0,3,1,3,0,1,0,76.14,60.42 ,33.33
03,007,01,014,0329,496 ,1060,24,1084,1461,0,3,1,3,0,1,0,76.14,74.20 ,33.33
03,007,01,014,0330,497 ,980,23,1003,1449,0,3,1,3,0,1,0,76.14,69.22 ,33.33
03,007,01,014,0331,498 ,788,15,803,1092,0,3,1,3,0,1,0,76.14,73.53 ,33.33
03,007,01,014,0332,499 ,600,10,610,787,0,3,1,3,0,1,0,76.14,77.51 ,33.33
03,007,01,014,0333,500 ,1180,15,1195,1579,0,3,1,3,0,1,0,76.14,75.68 ,33.33
03,007,01,014,0334,501 ,645,8,653,917,0,3,1,3,0,1,0,76.14,71.21 ,33.33
03,007,01,014,0335,502 ,840,14,854,1258,0,3,1,3,0,1,0,76.14,67.89 ,33.33
03,007,01,014,0336,503 ,714,10,724,1001,0,3,1,3,0,1,0,76.14,72.33 ,33.33
03,007,01,014,0337,504 ,519,5,524,676,0,3,1,3,0,1,0,76.14,77.51 ,33.33
03,007,01,014,0338,505 ,814,15,829,1141,0,3,1,3,0,1,0,76.14,72.66 ,33.33
03,007,01,014,0339,506 ,911,11,922,1259,0,3,1,3,0,1,0,76.14,73.23 ,33.33
03,007,01,014,0340,507 ,1328,35,1363,1921,0,3,1,3,0,1,0,76.14,70.95 ,33.33
03,007,01,014,0341,508 ,877,14,891,1226,0,3,1,3,0,1,0,76.14,72.68 ,33.33
03,007,01,014,0342,509 ,275,1,276,392,0,3,1,3,0,1,0,76.14,70.41 ,33.33
03,007,01,014,0343,510 ,677,8,685,1007,0,3,1,3,0,1,0,76.14,68.02 ,33.33
03,007,01,014,0344,511 ,557,4,561,750,0,3,1,3,0,1,0,76.14,74.80 ,33.33
03,007,01,014,0345,512 ,884,14,898,1301,0,3,1,3,0,1,0,76.14,69.02 ,33.33
03,007,01,014,0346,513 ,620,3,623,809,0,3,1,3,0,1,0,76.14,77.01 ,33.33
03,007,01,014,0347,514 ,925,7,932,1454,0,3,1,3,0,1,0,76.14,64.10 ,33.33
03,007,01,014,0348,515 ,914,16,930,1301,0,3,1,3,0,1,0,76.14,71.48 ,33.33
03,007,01,014,0349,516 ,848,17,865,1258,0,3,1,3,0,1,0,76.14,68.76 ,33.33
03,007,01,014,0350,517 ,861,11,872,1232,0,3,1,3,0,1,0,76.14,70.78 ,33.33
03,007,01,015,0351,518 ,794,13,807,1149,0,3,1,3,0,1,0,76.14,70.23 ,33.33
03,007,01,015,0351,519 ,871,8,879,1327,0,3,1,3,0,1,0,76.14,66.24 ,33.33
03,007,01,015,0352,520 ,821,9,830,1195,0,3,1,3,0,1,0,76.14,69.46 ,33.33
03,007,01,015,0353,521 ,981,14,995,1401,0,3,1,3,0,1,0,76.14,71.02 ,33.33
03,007,01,015,0354,522 ,761,18,779,1090,0,3,1,3,0,1,0,76.14,71.47 ,33.33
03,007,01,015,0355,523 ,1044,16,1060,1540,0,3,1,3,0,1,0,76.14,68.83 ,33.33
03,007,01,015,0356,524 ,1116,17,1133,1591,0,3,1,3,0,1,0,76.14,71.21 ,33.33
03,007,01,015,0357,525 ,937,13,950,1307,0,3,1,3,0,1,0,76.14,72.69 ,33.33
03,007,01,015,0358,526 ,1046,7,1053,1528,0,3,1,3,0,1,0,76.14,68.91 ,33.33
03,007,01,015,0359,527 ,1187,19,1206,1688,0,3,1,3,0,1,0,76.14,71.45 ,33.33
03,007,01,015,0360,528 ,414,4,418,590,0,3,1,3,0,1,0,76.14,70.85 ,33.33
03,007,01,015,0361,529 ,678,13,691,1022,0,3,1,3,0,1,0,76.14,67.61 ,33.33
03,007,01,015,0362,530 ,782,12,794,1124,0,3,1,3,0,1,0,76.14,70.64 ,33.33
03,007,01,015,0363,531 ,483,10,493,705,0,3,1,3,0,1,0,76.14,69.93 ,33.33
03,007,01,015,0364,532 ,567,13,580,849,0,3,1,3,0,1,0,76.14,68.32 ,33.33
03,007,01,015,0365,533 ,1101,22,1123,1608,0,3,1,3,0,1,0,76.14,69.84 ,33.33
03,007,01,015,0366,534 ,901,8,909,1285,0,3,1,3,0,1,0,76.14,70.74 ,33.33
03,007,01,015,0367,535 ,590,6,596,861,0,3,1,3,0,1,0,76.14,69.22 ,33.33
03,007,01,015,0368,536 ,805,8,813,1174,0,3,1,3,0,1,0,76.14,69.25 ,33.33
03,007,01,015,0369,537 ,539,17,556,757,0,3,1,3,0,1,0,76.14,73.45 ,33.33
03,007,01,015,0370,538 ,608,10,618,830,0,3,1,3,0,1,0,76.14,74.46 ,33.33
03,007,01,016,0371,539 ,606,5,611,884,0,3,1,3,0,1,0,76.14,69.12 ,33.33
03,007,01,016,0372,540 ,414,9,423,644,0,3,1,3,0,1,0,76.14,65.68 ,33.33
03,007,01,016,0372,541 ,828,72,900,1704,0,3,1,3,0,1,0,76.14,52.82 ,33.33
03,007,01,016,0373,542 ,415,5,420,644,0,3,1,3,0,1,0,76.14,65.22 ,33.33
03,007,01,016,0374,543 ,1008,18,1026,1459,0,3,1,3,0,1,0,76.14,70.32 ,33.33
03,007,01,016,0375,544 ,964,24,988,1448,0,3,1,3,0,1,0,76.14,68.23 ,33.33
03,007,01,016,0376,545 ,850,11,861,1202,0,3,1,3,0,1,0,76.14,71.63 ,33.33
03,007,01,016,0377,546 ,1119,9,1128,1642,0,3,1,3,0,1,0,76.14,68.70 ,33.33
03,007,01,016,0378,547 ,449,6,455,638,0,3,1,3,0,1,0,76.14,71.32 ,33.33
03,007,01,016,0379,548 ,1052,12,1064,1591,0,3,1,3,0,1,0,76.14,66.88 ,33.33
03,007,01,016,0379,549 ,840,6,846,1127,0,3,1,3,0,1,0,76.14,75.07 ,33.33
03,007,01,016,0380,550 ,606,6,612,867,0,3,1,3,0,1,0,76.14,70.59 ,33.33
03,007,01,016,0380,551 ,838,14,852,1234,0,3,1,3,0,1,0,76.14,69.04 ,33.33
03,007,01,016,0381,552 ,798,10,808,1070,0,3,1,3,0,1,0,76.14,75.51 ,33.33
03,007,01,016,0382,553 ,893,9,902,1258,0,3,1,3,0,1,0,76.14,71.70 ,33.33
03,007,01,016,0383,554 ,634,4,638,894,0,3,1,3,0,1,0,76.14,71.36 ,33.33
03,007,01,016,0383,555 ,755,8,763,1069,0,3,1,3,0,1,0,76.14,71.38 ,33.33
03,007,01,016,0384,556 ,594,12,606,963,0,3,1,3,0,1,0,76.14,62.93 ,33.33
03,007,01,016,0384,557 ,711,17,728,1050,0,3,1,3,0,1,0,76.14,69.33 ,33.33
03,007,01,016,0385,558 ,1062,18,1080,1608,0,3,1,3,0,1,0,76.14,67.16 ,33.33
03,007,01,016,0386,559 ,876,6,882,1272,0,3,1,3,0,1,0,76.14,69.34 ,33.33
03,007,01,016,0387,560 ,983,13,996,1540,0,3,1,3,0,1,0,76.14,64.68 ,33.33
03,007,01,016,0388,561 ,1084,16,1100,1629,0,3,1,3,0,1,0,76.14,67.53 ,33.33
03,007,01,016,0388,562 ,1039,16,1055,1621,0,3,1,3,0,1,0,76.14,65.08 ,33.33
03,007,01,016,0389,563 ,844,14,858,1295,0,3,1,3,0,1,0,76.14,66.25 ,33.33
03,007,01,016,0390,564 ,1017,14,1031,1482,0,3,1,3,0,1,0,76.14,69.57 ,33.33
03,007,01,016,0391,565 ,573,9,582,861,0,3,1,3,0,1,0,76.14,67.60 ,33.33
03,007,01,016,0392,566 ,541,3,544,766,0,3,1,3,0,1,0,76.14,71.02 ,33.33
03,007,01,017,0393,567 ,839,10,849,1248,0,3,1,3,0,1,0,76.14,68.03 ,33.33
03,007,01,017,0393,568 ,902,6,908,1319,0,3,1,3,0,1,0,76.14,68.84 ,33.33
03,007,01,017,0394,569 ,752,8,760,1061,0,3,1,3,0,1,0,76.14,71.63 ,33.33
03,007,01,017,0394,570 ,901,23,924,1341,0,3,1,3,0,1,0,76.14,68.90 ,33.33
03,007,01,017,0394,571 ,828,8,836,1155,0,3,1,3,0,1,0,76.14,72.38 ,33.33
03,007,01,017,0395,572 ,727,3,730,1011,0,3,1,3,0,1,0,76.14,72.21 ,33.33
03,007,01,017,0395,573 ,932,9,941,1396,0,3,1,3,0,1,0,76.14,67.41 ,33.33
03,007,01,017,0396,574 ,523,11,534,770,0,3,1,3,0,1,0,76.14,69.35 ,33.33
03,007,01,017,0397,575 ,701,10,711,994,0,3,1,3,0,1,0,76.14,71.53 ,33.33
03,007,01,017,0398,576 ,693,13,706,990,0,3,1,3,0,1,0,76.14,71.31 ,33.33
03,007,01,017,0399,577 ,937,15,952,1341,0,3,1,3,0,1,0,76.14,70.99 ,33.33
03,007,01,017,0400,578 ,636,7,643,881,0,3,1,3,0,1,0,76.14,72.99 ,33.33
03,007,01,017,0401,579 ,844,20,864,1215,0,3,1,3,0,1,0,76.14,71.11 ,33.33
03,007,01,017,0402,580 ,575,12,587,826,0,3,1,3,0,1,0,76.14,71.07 ,33.33
03,007,01,017,0403,581 ,1319,17,1336,1836,0,3,1,3,0,1,0,76.14,72.77 ,33.33
03,007,01,017,0404,582 ,1026,10,1036,1436,0,3,1,3,0,1,0,76.14,72.14 ,33.33
03,007,01,017,0405,583 ,985,13,998,1375,0,3,1,3,0,1,0,76.14,72.58 ,33.33
03,007,01,017,0406,584 ,750,20,770,1065,0,3,1,3,0,1,0,76.14,72.30 ,33.33
03,007,01,017,0407,585 ,712,10,722,978,0,3,1,3,0,1,0,76.14,73.82 ,33.33
03,007,01,017,0408,586 ,770,9,779,1046,0,3,1,3,0,1,0,76.14,74.47 ,33.33
03,007,01,017,0409,587 ,680,8,688,921,0,3,1,3,0,1,0,76.14,74.70 ,33.33
03,007,01,017,0410,588 ,713,12,725,1020,0,3,1,3,0,1,0,76.14,71.08 ,33.33
03,007,01,017,0411,589 ,456,12,468,669,0,3,1,3,0,1,0,76.14,69.96 ,33.33
03,007,01,017,0412,590 ,580,8,588,827,0,3,1,3,0,1,0,76.14,71.10 ,33.33
03,007,01,017,0413,591 ,682,10,692,958,0,3,1,3,0,1,0,76.14,72.23 ,33.33
03,007,01,017,0414,592 ,537,5,542,782,0,3,1,3,0,1,0,76.14,69.31 ,33.33
03,007,01,017,0415,593 ,898,17,915,1340,0,3,1,3,0,1,0,76.14,68.28 ,33.33
03,007,01,017,0416,594 ,1308,29,1337,1873,0,3,1,3,0,1,0,76.14,71.38 ,33.33
03,007,01,018,0417,595 ,724,11,735,1018,0,3,1,3,0,1,0,76.14,72.20 ,33.33
03,007,01,018,0418,596 ,487,7,494,704,0,3,1,3,0,1,0,76.14,70.17 ,33.33
03,007,01,018,0419,597 ,590,9,599,879,0,3,1,3,0,1,0,76.14,68.15 ,33.33
03,007,01,018,0420,598 ,711,10,721,1017,0,3,1,3,0,1,0,76.14,70.89 ,33.33
03,007,01,018,0421,599 ,465,4,469,631,0,3,1,3,0,1,0,76.14,74.33 ,33.33
03,007,01,018,0422,600 ,492,1,493,660,0,3,1,3,0,1,0,76.14,74.70 ,33.33
03,007,01,018,0423,601 ,716,10,726,965,0,3,1,3,0,1,0,76.14,75.23 ,33.33
03,007,01,018,0424,602 ,730,5,735,1012,0,3,1,3,0,1,0,76.14,72.63 ,33.33
03,007,01,018,0425,603 ,612,8,620,877,0,3,1,3,0,1,0,76.14,70.70 ,33.33
03,007,01,018,0426,604 ,371,1,372,513,0,3,1,3,0,1,0,76.14,72.51 ,33.33
03,007,01,018,0427,605 ,592,8,600,910,0,3,1,3,0,1,0,76.14,65.93 ,33.33
03,007,01,018,0428,606 ,606,10,616,862,0,3,1,3,0,1,0,76.14,71.46 ,33.33
03,007,01,018,0429,607 ,589,2,591,758,0,3,1,3,0,1,0,76.14,77.97 ,33.33
03,007,01,018,0430,608 ,577,7,584,811,0,3,1,3,0,1,0,76.14,72.01 ,33.33
03,007,01,018,0431,609 ,552,4,556,768,0,3,1,3,0,1,0,76.14,72.40 ,33.33
03,007,01,018,0432,610 ,454,6,460,688,0,3,1,3,0,1,0,76.14,66.86 ,33.33
03,007,01,018,0433,611 ,426,5,431,620,0,3,1,3,0,1,0,76.14,69.52 ,33.33
03,007,01,019,0434,612 ,786,14,800,1133,0,3,1,3,0,1,0,76.14,70.61 ,33.33
03,007,01,019,0434,613 ,732,17,749,1154,0,3,1,3,0,1,0,76.14,64.90 ,33.33
03,007,01,019,0435,614 ,1192,7,1199,1680,0,3,1,3,0,1,0,76.14,71.37 ,33.33
03,007,01,019,0436,615 ,907,18,925,1311,0,3,1,3,0,1,0,76.14,70.56 ,33.33
03,007,01,019,0436,616 ,774,3,777,1127,0,3,1,3,0,1,0,76.14,68.94 ,33.33
03,007,01,019,0436,617 ,895,25,920,1357,0,3,1,3,0,1,0,76.14,67.80 ,33.33
03,007,01,019,0437,618 ,984,15,999,1555,0,3,1,3,0,1,0,76.14,64.24 ,33.33
03,007,01,019,0438,619 ,915,5,920,1360,0,3,1,3,0,1,0,76.14,67.65 ,33.33
03,007,01,019,0439,620 ,566,5,571,783,0,3,1,3,0,1,0,76.14,72.92 ,33.33
03,007,01,019,0440,621 ,452,11,463,632,0,3,1,3,0,1,0,76.14,73.26 ,33.33
03,007,01,019,0441,622 ,521,8,529,767,0,3,1,3,0,1,0,76.14,68.97 ,33.33
03,007,01,019,0442,623 ,891,11,902,1395,0,3,1,3,0,1,0,76.14,64.66 ,33.33
03,007,01,019,0443,624 ,882,14,896,1288,0,3,1,3,0,1,0,76.14,69.57 ,33.33
03,007,01,019,0444,625 ,1094,16,1110,1686,0,3,1,3,0,1,0,76.14,65.84 ,33.33
03,007,01,019,0445,626 ,668,9,677,978,0,3,1,3,0,1,0,76.14,69.22 ,33.33
03,007,01,019,0445,627 ,781,6,787,1221,0,3,1,3,0,1,0,76.14,64.46 ,33.33
03,007,01,019,0446,628 ,702,9,711,1033,0,3,1,3,0,1,0,76.14,68.83 ,33.33
03,007,01,019,0447,629 ,1106,25,1131,1653,0,3,1,3,0,1,0,76.14,68.42 ,33.33
03,007,01,019,0448,630 ,915,27,942,1478,0,3,1,3,0,1,0,76.14,63.73 ,33.33
03,007,01,020,0449,631 ,481,10,491,771,0,3,1,3,0,1,0,76.14,63.68 ,33.33
03,007,01,020,0449,632 ,526,19,545,948,0,3,1,3,0,1,0,76.14,57.49 ,33.33
03,007,01,020,0450,633 ,441,13,454,675,0,3,1,3,0,1,0,76.14,67.26 ,33.33
03,007,01,020,0451,634 ,593,12,605,922,0,3,1,3,0,1,0,76.14,65.62 ,33.33
03,007,01,020,0452,635 ,518,11,529,762,0,3,1,3,0,1,0,76.14,69.42 ,33.33
03,007,01,020,0452,636 ,529,12,541,825,0,3,1,3,0,1,0,76.14,65.58 ,33.33
03,007,01,020,0453,637 ,866,14,880,1314,0,3,1,3,0,1,0,76.14,66.97 ,33.33
03,007,01,020,0454,638 ,548,13,561,818,0,3,1,3,0,1,0,76.14,68.58 ,33.33
03,007,01,020,0454,639 ,594,7,601,900,0,3,1,3,0,1,0,76.14,66.78 ,33.33
03,007,01,020,0455,640 ,826,9,835,1246,0,3,1,3,0,1,0,76.14,67.01 ,33.33
03,007,01,020,0456,641 ,845,14,859,1417,0,3,1,3,0,1,0,76.14,60.62 ,33.33
03,007,01,020,0457,642 ,700,11,711,1077,0,3,1,3,0,1,0,76.14,66.02 ,33.33
03,007,01,020,0457,643 ,567,7,574,920,0,3,1,3,0,1,0,76.14,62.39 ,33.33
03,007,01,020,0458,644 ,574,11,585,937,0,3,1,3,0,1,0,76.14,62.43 ,33.33
03,007,01,020,0458,645 ,539,6,545,864,0,3,1,3,0,1,0,76.14,63.08 ,33.33
03,007,01,020,0459,646 ,582,3,585,935,0,3,1,3,0,1,0,76.14,62.57 ,33.33
03,007,01,020,0459,647 ,593,12,605,952,0,3,1,3,0,1,0,76.14,63.55 ,33.33
03,007,01,020,0460,648 ,495,18,513,793,0,3,1,3,0,1,0,76.14,64.69 ,33.33
03,007,01,020,0461,649 ,721,14,735,1091,0,3,1,3,0,1,0,76.14,67.37 ,33.33
03,007,01,020,0462,650 ,546,2,548,946,0,3,1,3,0,1,0,76.14,57.93 ,33.33
03,007,01,020,0463,651 ,411,10,421,750,0,3,1,3,0,1,0,76.14,56.13 ,33.33
03,007,01,020,0464,652 ,578,7,585,865,0,3,1,3,0,1,0,76.14,67.63 ,33.33
03,007,01,020,0465,653 ,766,14,780,1219,0,3,1,3,0,1,0,76.14,63.99 ,33.33
03,007,01,020,0466,654 ,610,10,620,901,0,3,1,3,0,1,0,76.14,68.81 ,33.33
03,007,01,020,0467,655 ,695,21,716,1210,0,3,1,3,0,1,0,76.14,59.17 ,33.33
03,007,01,021,0468,656 ,767,9,776,1208,0,3,1,3,0,1,0,76.14,64.24 ,33.33
03,007,01,021,0469,657 ,465,6,471,678,0,3,1,3,0,1,0,76.14,69.47 ,33.33
03,007,01,021,0470,658 ,1308,24,1332,1911,0,3,1,3,0,1,0,76.14,69.70 ,33.33
03,007,01,021,0471,659 ,753,16,769,1198,0,3,1,3,0,1,0,76.14,64.19 ,33.33
03,007,01,021,0472,660 ,807,13,820,1159,0,3,1,3,0,1,0,76.14,70.75 ,33.33
03,007,01,021,0473,661 ,664,15,679,1005,0,3,1,3,0,1,0,76.14,67.56 ,33.33
03,007,01,021,0474,662 ,819,8,827,1132,0,3,1,3,0,1,0,76.14,73.06 ,33.33
03,007,01,021,0475,663 ,637,10,647,959,0,3,1,3,0,1,0,76.14,67.47 ,33.33
03,007,01,021,0476,664 ,449,14,463,669,0,3,1,3,0,1,0,76.14,69.21 ,33.33
03,007,01,021,0477,665 ,588,9,597,842,0,3,1,3,0,1,0,76.14,70.90 ,33.33
03,007,01,021,0478,666 ,710,15,725,1004,0,3,1,3,0,1,0,76.14,72.21 ,33.33
03,007,01,021,0479,667 ,831,17,848,1211,0,3,1,3,0,1,0,76.14,70.02 ,33.33
03,007,01,021,0480,668 ,1137,20,1157,1700,0,3,1,3,0,1,0,76.14,68.06 ,33.33
03,007,01,021,0481,669 ,587,5,592,810,0,3,1,3,0,1,0,76.14,73.09 ,33.33
03,007,01,021,0482,670 ,593,6,599,845,0,3,1,3,0,1,0,76.14,70.89 ,33.33
03,007,01,021,0483,671 ,947,21,968,1465,0,3,1,3,0,1,0,76.14,66.08 ,33.33
03,007,01,021,0484,672 ,1015,15,1030,1504,0,3,1,3,0,1,0,76.14,68.48 ,33.33
03,007,01,021,0485,673 ,208,6,214,298,0,3,1,3,0,1,0,76.14,71.81 ,33.33
03,007,01,021,0486,674 ,400,8,408,608,0,3,1,3,0,1,0,76.14,67.11 ,33.33
03,007,01,021,0487,675 ,493,9,502,696,0,3,1,3,0,1,0,76.14,72.13 ,33.33
03,007,01,022,0488,676 ,604,19,623,1001,0,3,1,3,0,1,0,76.14,62.24 ,33.33
03,007,01,022,0488,677 ,759,22,781,1216,0,3,1,3,0,1,0,76.14,64.23 ,33.33
03,007,01,022,0489,678 ,982,26,1008,1493,0,3,1,3,0,1,0,76.14,67.52 ,33.33
03,007,01,022,0490,679 ,992,13,1005,1556,0,3,1,3,0,1,0,76.14,64.59 ,33.33
03,007,01,022,0491,680 ,611,13,624,961,0,3,1,3,0,1,0,76.14,64.93 ,33.33
03,007,01,022,0491,681 ,690,9,699,1124,0,3,1,3,0,1,0,76.14,62.19 ,33.33
03,007,01,022,0492,682 ,706,22,728,1119,0,3,1,3,0,1,0,76.14,65.06 ,33.33
03,007,01,022,0493,683 ,946,13,959,1431,0,3,1,3,0,1,0,76.14,67.02 ,33.33
03,007,01,022,0494,684 ,944,14,958,1352,0,3,1,3,0,1,0,76.14,70.86 ,33.33
03,007,01,022,0494,685 ,1021,28,1049,1565,0,3,1,3,0,1,0,76.14,67.03 ,33.33
03,007,01,022,0495,686 ,1046,19,1065,1603,0,3,1,3,0,1,0,76.14,66.44 ,33.33
03,007,01,022,0496,687 ,453,10,463,683,0,3,1,3,0,1,0,76.14,67.79 ,33.33
03,007,01,022,0497,688 ,382,3,385,594,0,3,1,3,0,1,0,76.14,64.81 ,33.33
03,007,01,022,0498,689 ,1030,25,1055,1649,0,3,1,3,0,1,0,76.14,63.98 ,33.33
03,007,01,022,0499,690 ,710,8,718,1159,0,3,1,3,0,1,0,76.14,61.95 ,33.33
03,007,01,022,0500,691 ,532,17,549,831,0,3,1,3,0,1,0,76.14,66.06 ,33.33
03,007,01,022,0501,692 ,547,15,562,853,0,3,1,3,0,1,0,76.14,65.89 ,33.33
03,007,01,022,0502,693 ,790,12,802,1293,0,3,1,3,0,1,0,76.14,62.03 ,33.33
03,007,01,022,0503,694 ,547,13,560,928,0,3,1,3,0,1,0,76.14,60.34 ,33.33
03,007,01,022,0504,695 ,628,9,637,985,0,3,1,3,0,1,0,76.14,64.67 ,33.33
03,007,01,023,0505,696 ,619,5,624,865,0,3,1,3,0,1,0,76.14,72.14 ,33.33
03,007,01,023,0505,697 ,774,8,782,1201,0,3,1,3,0,1,0,76.14,65.11 ,33.33
03,007,01,023,0506,698 ,809,19,828,1204,0,3,1,3,0,1,0,76.14,68.77 ,33.33
03,007,01,023,0506,699 ,1028,14,1042,1556,0,3,1,3,0,1,0,76.14,66.97 ,33.33
03,007,01,023,0507,700 ,879,13,892,1296,0,3,1,3,0,1,0,76.14,68.83 ,33.33
03,007,01,023,0508,701 ,673,10,683,1034,0,3,1,3,0,1,0,76.14,66.05 ,33.33
03,007,01,023,0508,702 ,942,29,971,1528,0,3,1,3,0,1,0,76.14,63.55 ,33.33
03,007,01,023,0509,703 ,934,18,952,1573,0,3,1,3,0,1,0,76.14,60.52 ,33.33
03,007,01,023,0510,704 ,876,21,897,1453,0,3,1,3,0,1,0,76.14,61.73 ,33.33
03,007,01,023,0511,705 ,722,20,742,1181,0,3,1,3,0,1,0,76.14,62.83 ,33.33
03,007,01,023,0512,706 ,709,18,727,1087,0,3,1,3,0,1,0,76.14,66.88 ,33.33
03,007,01,023,0513,707 ,686,14,700,1085,0,3,1,3,0,1,0,76.14,64.52 ,33.33
03,007,01,023,0514,708 ,778,10,788,1179,0,3,1,3,0,1,0,76.14,66.84 ,33.33
03,007,01,023,0515,709 ,691,13,704,1217,0,3,1,3,0,1,0,76.14,57.85 ,33.33
03,007,01,023,0515,710 ,716,11,727,1103,0,3,1,3,0,1,0,76.14,65.91 ,33.33
03,007,01,023,0516,711 ,428,10,438,710,0,3,1,3,0,1,0,76.14,61.69 ,33.33
03,007,01,023,0516,712 ,893,16,909,1377,0,3,1,3,0,1,0,76.14,66.01 ,33.33
03,007,01,023,0517,713 ,819,14,833,1363,0,3,1,3,0,1,0,76.14,61.12 ,33.33
03,007,01,023,0518,714 ,1081,31,1112,1637,0,3,1,3,0,1,0,76.14,67.93 ,33.33
03,007,01,023,0519,715 ,812,22,834,1281,0,3,1,3,0,1,0,76.14,65.11 ,33.33
03,007,01,023,0520,716 ,535,12,547,786,0,3,1,3,0,1,0,76.14,69.59 ,33.33
03,007,01,023,0521,717 ,960,8,968,1501,0,3,1,3,0,1,0,76.14,64.49 ,33.33
03,007,01,023,0522,718 ,790,9,799,1222,0,3,1,3,0,1,0,76.14,65.38 ,33.33
03,007,01,023,0523,719 ,689,20,709,1065,0,3,1,3,0,1,0,76.14,66.57 ,33.33
03,007,01,023,0524,720 ,779,11,790,1173,0,3,1,3,0,1,0,76.14,67.35 ,33.33
03,007,01,023,0524,721 ,710,9,719,1109,0,3,1,3,0,1,0,76.14,64.83 ,33.33
03,007,01,023,0524,722 ,749,11,760,1187,0,3,1,3,0,1,0,76.14,64.03 ,33.33
03,007,01,023,0525,723 ,808,17,825,1309,0,3,1,3,0,1,0,76.14,63.03 ,33.33
03,007,01,023,0526,724 ,641,9,650,1002,0,3,1,3,0,1,0,76.14,64.87 ,33.33
03,007,01,023,0527,725 ,573,11,584,864,0,3,1,3,0,1,0,76.14,67.59 ,33.33
03,007,01,023,0528,726 ,798,8,806,1206,0,3,1,3,0,1,0,76.14,66.83 ,33.33
03,007,01,023,0529,727 ,663,11,674,1011,0,3,1,3,0,1,0,76.14,66.67 ,33.33
03,007,01,023,0530,728 ,673,10,683,1010,0,3,1,3,0,1,0,76.14,67.62 ,33.33
03,007,01,023,0531,729 ,507,7,514,745,0,3,1,3,0,1,0,76.14,68.99 ,33.33
03,007,01,024,0532,730 ,595,12,607,1035,0,3,1,3,0,1,0,76.14,58.65 ,33.33
03,007,01,024,0533,731 ,317,7,324,537,0,3,1,3,0,1,0,76.14,60.34 ,33.33
03,007,01,024,0534,732 ,553,14,567,898,0,3,1,3,0,1,0,76.14,63.14 ,33.33
03,007,01,024,0535,733 ,398,4,402,673,0,3,1,3,0,1,0,76.14,59.73 ,33.33
03,007,01,024,0536,734 ,589,14,603,934,0,3,1,3,0,1,0,76.14,64.56 ,33.33
03,007,01,024,0537,735 ,1161,23,1184,1812,0,3,1,3,0,1,0,76.14,65.34 ,33.33
03,007,01,024,0538,736 ,875,16,891,1399,0,3,1,3,0,1,0,76.14,63.69 ,33.33
03,007,01,024,0539,737 ,543,5,548,1062,0,3,1,3,0,1,0,76.14,51.60 ,33.33
03,007,01,024,0540,738 ,467,8,475,763,0,3,1,3,0,1,0,76.14,62.25 ,33.33
03,007,01,024,0541,739 ,495,8,503,768,0,3,1,3,0,1,0,76.14,65.49 ,33.33
03,007,01,024,0542,740 ,644,15,659,1020,0,3,1,3,0,1,0,76.14,64.61 ,33.33
03,007,01,024,0543,741 ,392,13,405,679,0,3,1,3,0,1,0,76.14,59.65 ,33.33
03,007,01,024,0544,742 ,382,8,390,645,0,3,1,3,0,1,0,76.14,60.47 ,33.33
03,007,01,024,0545,743 ,698,12,710,1174,0,3,1,3,0,1,0,76.14,60.48 ,33.33
03,007,01,024,0545,744 ,555,11,566,891,0,3,1,3,0,1,0,76.14,63.52 ,33.33
03,007,01,024,0546,745 ,526,5,531,792,0,3,1,3,0,1,0,76.14,67.05 ,33.33
03,007,01,024,0547,746 ,519,9,528,809,0,3,1,3,0,1,0,76.14,65.27 ,33.33
03,007,01,024,0548,747 ,799,9,808,1369,0,3,1,3,0,1,0,76.14,59.02 ,33.33
03,007,01,024,0549,748 ,475,9,484,789,0,3,1,3,0,1,0,76.14,61.34 ,33.33
03,007,01,024,0550,749 ,931,8,939,1330,0,3,1,3,0,1,0,76.14,70.60 ,33.33
03,007,01,024,0551,750 ,309,6,315,578,0,3,1,3,0,1,0,76.14,54.50 ,33.33
03,007,01,024,0552,751 ,882,13,895,1420,0,3,1,3,0,1,0,76.14,63.03 ,33.33
03,007,01,024,0553,752 ,571,12,583,895,0,3,1,3,0,1,0,76.14,65.14 ,33.33
03,007,01,024,0553,753 ,713,8,721,1134,0,3,1,3,0,1,0,76.14,63.58 ,33.33
03,007,01,024,0554,754 ,514,4,518,728,0,3,1,3,0,1,0,76.14,71.15 ,33.33
03,007,01,024,0555,755 ,682,16,698,1019,0,3,1,3,0,1,0,76.14,68.50 ,33.33
03,007,01,024,0556,756 ,824,16,840,1368,0,3,1,3,0,1,0,76.14,61.40 ,33.33
03,007,01,024,0557,757 ,1032,20,1052,1508,0,3,1,3,0,1,0,76.14,69.76 ,33.33
03,007,01,024,0557,758 ,850,12,862,1276,0,3,1,3,0,1,0,76.14,67.55 ,33.33
03,007,01,025,0558,759 ,832,15,847,1371,0,3,1,3,0,1,0,76.14,61.78 ,33.33
03,007,01,025,0559,760 ,829,18,847,1422,0,3,1,3,0,1,0,76.14,59.56 ,33.33
03,007,01,025,0560,761 ,568,11,579,908,0,3,1,3,0,1,0,76.14,63.77 ,33.33
03,007,01,025,0561,762 ,827,9,836,1289,0,3,1,3,0,1,0,76.14,64.86 ,33.33
03,007,01,025,0562,763 ,666,6,672,1068,0,3,1,3,0,1,0,76.14,62.92 ,33.33
03,007,01,025,0563,764 ,370,3,373,647,0,3,1,3,0,1,0,76.14,57.65 ,33.33
03,007,01,025,0563,765 ,342,8,350,559,0,3,1,3,0,1,0,76.14,62.61 ,33.33
03,007,01,025,0564,766 ,470,6,476,761,0,3,1,3,0,1,0,76.14,62.55 ,33.33
03,007,01,025,0565,767 ,284,7,291,469,0,3,1,3,0,1,0,76.14,62.05 ,33.33
03,007,01,025,0565,768 ,456,3,459,765,0,3,1,3,0,1,0,76.14,60.00 ,33.33
03,007,01,025,0566,769 ,539,7,546,919,0,3,1,3,0,1,0,76.14,59.41 ,33.33
03,007,01,025,0567,770 ,411,12,423,760,0,3,1,3,0,1,0,76.14,55.66 ,33.33
03,007,01,025,0568,771 ,765,10,775,1206,0,3,1,3,0,1,0,76.14,64.26 ,33.33
03,007,01,025,0569,772 ,821,12,833,1351,0,3,1,3,0,1,0,76.14,61.66 ,33.33
03,007,01,025,0570,773 ,663,9,672,1138,0,3,1,3,0,1,0,76.14,59.05 ,33.33
03,007,01,025,0571,774 ,465,7,472,811,0,3,1,3,0,1,0,76.14,58.20 ,33.33
03,007,01,025,0572,775 ,644,8,652,1076,0,3,1,3,0,1,0,76.14,60.59 ,33.33
03,007,01,026,0573,776 ,680,5,685,1081,0,3,1,3,0,1,0,76.14,63.37 ,33.33
03,007,01,026,0574,777 ,1082,8,1090,1651,0,3,1,3,0,1,0,76.14,66.02 ,33.33
03,007,01,026,0575,778 ,529,9,538,831,0,3,1,3,0,1,0,76.14,64.74 ,33.33
03,007,01,026,0576,779 ,497,5,502,796,0,3,1,3,0,1,0,76.14,63.07 ,33.33
03,007,01,026,0577,780 ,904,15,919,1525,0,3,1,3,0,1,0,76.14,60.26 ,33.33
03,007,01,026,0578,781 ,420,8,428,628,0,3,1,3,0,1,0,76.14,68.15 ,33.33
03,007,01,026,0579,782 ,603,8,611,957,0,3,1,3,0,1,0,76.14,63.85 ,33.33
03,007,01,026,0580,783 ,769,3,772,1183,0,3,1,3,0,1,0,76.14,65.26 ,33.33
03,007,01,026,0581,784 ,352,7,359,570,0,3,1,3,0,1,0,76.14,62.98 ,33.33
03,007,01,026,0582,785 ,546,9,555,888,0,3,1,3,0,1,0,76.14,62.50 ,33.33
03,007,01,026,0583,786 ,431,5,436,723,0,3,1,3,0,1,0,76.14,60.30 ,33.33
03,007,01,026,0584,787 ,377,5,382,669,0,3,1,3,0,1,0,76.14,57.10 ,33.33
03,007,01,026,0585,788 ,474,6,480,774,0,3,1,3,0,1,0,76.14,62.02 ,33.33
03,007,01,026,0586,789 ,374,5,379,707,0,3,1,3,0,1,0,76.14,53.61 ,33.33
03,008,01,001,0001,1 ,635,5,640,949,0,3,1,3,0,1,0,76.14,67.44 ,33.33
03,008,01,001,0002,2 ,924,8,932,1347,0,3,1,3,0,1,0,76.14,69.19 ,33.33
03,008,01,001,0003,3 ,535,3,538,704,0,3,1,3,0,1,0,76.14,76.42 ,33.33
03,008,01,001,0004,4 ,412,1,413,527,0,3,1,3,0,1,0,76.14,78.37 ,33.33
03,008,01,001,0005,5 ,493,6,499,701,0,3,1,3,0,1,0,76.14,71.18 ,33.33
03,008,01,001,0006,6 ,326,1,327,437,0,3,1,3,0,1,0,76.14,74.83 ,33.33
03,008,01,001,0007,7 ,751,8,759,1042,0,3,1,3,0,1,0,76.14,72.84 ,33.33
03,008,01,001,0008,8 ,771,9,780,1144,0,3,1,3,0,1,0,76.14,68.18 ,33.33
03,008,01,001,0008,9 ,1116,12,1128,1643,0,3,1,3,0,1,0,76.14,68.65 ,33.33
03,008,01,001,0008,10 ,907,11,918,1371,0,3,1,3,0,1,0,76.14,66.96 ,33.33
03,008,01,001,0009,11 ,934,1,935,1305,0,3,1,3,0,1,0,76.14,71.65 ,33.33
03,008,01,001,0009,12 ,1063,7,1070,1467,0,3,1,3,0,1,0,76.14,72.94 ,33.33
03,008,01,001,0010,13 ,1174,8,1182,1712,0,3,1,3,0,1,0,76.14,69.04 ,33.33
03,008,01,001,0011,14 ,1133,8,1141,1575,0,3,1,3,0,1,0,76.14,72.44 ,33.33
03,008,01,001,0011,15 ,886,8,894,1282,0,3,1,3,0,1,0,76.14,69.73 ,33.33
03,008,01,001,0012,16 ,749,7,756,1137,0,3,1,3,0,1,0,76.14,66.49 ,33.33
03,008,01,001,0012,17 ,898,5,903,1288,0,3,1,3,0,1,0,76.14,70.11 ,33.33
03,008,01,001,0012,18 ,847,2,849,1224,0,3,1,3,0,1,0,76.14,69.36 ,33.33
03,008,01,001,0012,19 ,916,2,918,1312,0,3,1,3,0,1,0,76.14,69.97 ,33.33
03,008,01,001,0013,20 ,397,3,400,529,0,3,1,3,0,1,0,76.14,75.61 ,33.33
03,008,01,001,0013,21 ,964,3,967,1388,0,3,1,3,0,1,0,76.14,69.67 ,33.33
03,008,01,001,0014,22 ,557,6,563,857,0,3,1,3,0,1,0,76.14,65.69 ,33.33
03,008,01,001,0015,23 ,1167,13,1180,1707,0,3,1,3,0,1,0,76.14,69.13 ,33.33
03,008,01,001,0015,24 ,1085,10,1095,1632,0,3,1,3,0,1,0,76.14,67.10 ,33.33
03,008,01,001,0015,25 ,255,0,255,325,0,3,1,3,0,1,0,76.14,78.46 ,33.33
03,008,01,001,0016,26 ,250,3,253,384,0,3,1,3,0,1,0,76.14,65.89 ,33.33
03,008,01,001,0017,27 ,741,11,752,1023,0,3,1,3,0,1,0,76.14,73.51 ,33.33
03,008,01,001,0017,28 ,644,3,647,866,0,3,1,3,0,1,0,76.14,74.71 ,33.33
03,008,01,001,0018,29 ,1105,11,1116,1584,0,3,1,3,0,1,0,76.14,70.45 ,33.33
03,008,01,001,0018,30 ,1086,8,1094,1537,0,3,1,3,0,1,0,76.14,71.18 ,33.33
03,008,01,001,0018,31 ,1035,2,1037,1449,0,3,1,3,0,1,0,76.14,71.57 ,33.33
03,008,01,001,0019,32 ,784,7,791,1074,0,3,1,3,0,1,0,76.14,73.65 ,33.33
03,008,01,001,0019,33 ,926,6,932,1388,0,3,1,3,0,1,0,76.14,67.15 ,33.33
03,008,01,001,0019,34 ,1198,4,1202,1782,0,3,1,3,0,1,0,76.14,67.45 ,33.33
03,008,01,001,0019,35 ,426,5,431,543,0,3,1,3,0,1,0,76.14,79.37 ,33.33
03,008,01,001,0020,36 ,941,5,946,1299,0,3,1,3,0,1,0,76.14,72.83 ,33.33
03,008,01,001,0021,37 ,372,5,377,561,0,3,1,3,0,1,0,76.14,67.20 ,33.33
03,008,01,001,0022,38 ,548,5,553,788,0,3,1,3,0,1,0,76.14,70.18 ,33.33
03,008,01,001,0022,39 ,717,3,720,1056,0,3,1,3,0,1,0,76.14,68.18 ,33.33
03,008,01,001,0023,40 ,661,4,665,936,0,3,1,3,0,1,0,76.14,71.05 ,33.33
03,008,01,001,0023,41 ,722,4,726,1004,0,3,1,3,0,1,0,76.14,72.31 ,33.33
03,008,01,001,0024,42 ,471,3,474,688,0,3,1,3,0,1,0,76.14,68.90 ,33.33
03,008,01,001,0024,43 ,569,3,572,794,0,3,1,3,0,1,0,76.14,72.04 ,33.33
03,008,01,001,0025,44 ,797,8,805,1089,0,3,1,3,0,1,0,76.14,73.92 ,33.33
03,008,01,001,0025,45 ,863,3,866,1212,0,3,1,3,0,1,0,76.14,71.45 ,33.33
03,008,01,001,0026,46 ,846,6,852,1211,0,3,1,3,0,1,0,76.14,70.36 ,33.33
03,008,01,001,0026,47 ,1118,14,1132,1580,0,3,1,3,0,1,0,76.14,71.65 ,33.33
03,008,01,001,0026,48 ,844,5,849,1182,0,3,1,3,0,1,0,76.14,71.83 ,33.33
03,008,01,001,0026,49 ,1030,7,1037,1489,0,3,1,3,0,1,0,76.14,69.64 ,33.33
03,008,01,001,0027,50 ,1048,8,1056,1553,0,3,1,3,0,1,0,76.14,68.00 ,33.33
03,008,01,001,0027,51 ,862,4,866,1237,0,3,1,3,0,1,0,76.14,70.01 ,33.33
03,008,01,001,0027,52 ,726,9,735,1115,0,3,1,3,0,1,0,76.14,65.92 ,33.33
03,008,01,001,0028,53 ,1104,12,1116,1668,0,3,1,3,0,1,0,76.14,66.91 ,33.33
03,008,01,001,0028,54 ,1188,11,1199,1720,0,3,1,3,0,1,0,76.14,69.71 ,33.33
03,008,01,001,0029,55 ,831,13,844,1218,0,3,1,3,0,1,0,76.14,69.29 ,33.33
03,008,01,001,0029,56 ,677,4,681,1044,0,3,1,3,0,1,0,76.14,65.23 ,33.33
03,008,01,001,0030,57 ,946,11,957,1333,0,3,1,3,0,1,0,76.14,71.79 ,33.33
03,008,01,001,0030,58 ,731,8,739,1170,0,3,1,3,0,1,0,76.14,63.16 ,33.33
03,008,01,001,0031,59 ,741,6,747,1269,0,3,1,3,0,1,0,76.14,58.87 ,33.33
03,008,01,001,0032,60 ,525,4,529,752,0,3,1,3,0,1,0,76.14,70.35 ,33.33
03,008,01,001,0033,61 ,510,5,515,763,0,3,1,3,0,1,0,76.14,67.50 ,33.33
03,008,01,001,0034,62 ,1078,11,1089,1730,0,3,1,3,0,1,0,76.14,62.95 ,33.33
03,008,01,002,0035,63 ,577,5,582,900,0,3,1,3,0,1,0,76.14,64.67 ,33.33
03,008,01,002,0035,64 ,714,7,721,1071,0,3,1,3,0,1,0,76.14,67.32 ,33.33
03,008,01,002,0035,65 ,608,2,610,909,0,3,1,3,0,1,0,76.14,67.11 ,33.33
03,008,01,002,0036,66 ,604,7,611,980,0,3,1,3,0,1,0,76.14,62.35 ,33.33
03,008,01,002,0036,67 ,620,2,622,1026,0,3,1,3,0,1,0,76.14,60.62 ,33.33
03,008,01,002,0036,68 ,683,3,686,1020,0,3,1,3,0,1,0,76.14,67.25 ,33.33
03,008,01,002,0037,69 ,621,8,629,943,0,3,1,3,0,1,0,76.14,66.70 ,33.33
03,008,01,002,0038,70 ,762,13,775,1175,0,3,1,3,0,1,0,76.14,65.96 ,33.33
03,008,01,002,0038,71 ,701,12,713,1099,0,3,1,3,0,1,0,76.14,64.88 ,33.33
03,008,01,002,0039,72 ,1022,6,1028,1563,0,3,1,3,0,1,0,76.14,65.77 ,33.33
03,008,01,002,0039,73 ,945,8,953,1424,0,3,1,3,0,1,0,76.14,66.92 ,33.33
03,008,01,002,0040,74 ,656,9,665,961,0,3,1,3,0,1,0,76.14,69.20 ,33.33
03,008,01,002,0040,75 ,594,6,600,917,0,3,1,3,0,1,0,76.14,65.43 ,33.33
03,008,01,002,0041,76 ,620,1,621,991,0,3,1,3,0,1,0,76.14,62.66 ,33.33
03,008,01,002,0041,77 ,712,11,723,1109,0,3,1,3,0,1,0,76.14,65.19 ,33.33
03,008,01,002,0042,78 ,745,17,762,1112,0,3,1,3,0,1,0,76.14,68.53 ,33.33
03,008,01,002,0042,79 ,675,13,688,1057,0,3,1,3,0,1,0,76.14,65.09 ,33.33
03,008,01,002,0043,80 ,678,8,686,1050,0,3,1,3,0,1,0,76.14,65.33 ,33.33
03,008,01,002,0043,81 ,647,6,653,1001,0,3,1,3,0,1,0,76.14,65.23 ,33.33
03,008,01,002,0043,82 ,849,9,858,1392,0,3,1,3,0,1,0,76.14,61.64 ,33.33
03,008,01,002,0044,83 ,863,11,874,1250,0,3,1,3,0,1,0,76.14,69.92 ,33.33
03,008,01,002,0045,84 ,862,14,876,1361,0,3,1,3,0,1,0,76.14,64.36 ,33.33
03,008,01,002,0045,85 ,937,11,948,1382,0,3,1,3,0,1,0,76.14,68.60 ,33.33
03,008,01,002,0045,86 ,783,6,789,1245,0,3,1,3,0,1,0,76.14,63.37 ,33.33
03,008,01,002,0045,87 ,971,7,978,1544,0,3,1,3,0,1,0,76.14,63.34 ,33.33
03,008,01,002,0046,88 ,619,6,625,913,0,3,1,3,0,1,0,76.14,68.46 ,33.33
03,008,01,002,0047,89 ,712,10,722,1063,0,3,1,3,0,1,0,76.14,67.92 ,33.33
03,008,01,002,0047,90 ,756,4,760,1147,0,3,1,3,0,1,0,76.14,66.26 ,33.33
03,008,01,002,0048,91 ,762,7,769,1192,0,3,1,3,0,1,0,76.14,64.51 ,33.33
03,008,01,002,0048,92 ,443,4,447,676,0,3,1,3,0,1,0,76.14,66.12 ,33.33
03,008,01,002,0048,93 ,734,18,752,1168,0,3,1,3,0,1,0,76.14,64.38 ,33.33
03,008,01,002,0048,94 ,840,10,850,1278,0,3,1,3,0,1,0,76.14,66.51 ,33.33
03,008,01,002,0048,95 ,613,7,620,1008,0,3,1,3,0,1,0,76.14,61.51 ,33.33
03,008,01,002,0049,96 ,1090,18,1108,1820,0,3,1,3,0,1,0,76.14,60.88 ,33.33
03,008,01,002,0049,97 ,756,11,767,1213,0,3,1,3,0,1,0,76.14,63.23 ,33.33
03,008,01,002,0050,98 ,607,6,613,963,0,3,1,3,0,1,0,76.14,63.66 ,33.33
03,008,01,002,0051,99 ,651,6,657,956,0,3,1,3,0,1,0,76.14,68.72 ,33.33
03,008,01,002,0052,100 ,522,3,525,765,0,3,1,3,0,1,0,76.14,68.63 ,33.33
03,008,01,002,0053,101 ,594,4,598,938,0,3,1,3,0,1,0,76.14,63.75 ,33.33
03,008,01,002,0054,102 ,200,2,202,347,0,3,1,3,0,1,0,76.14,58.21 ,33.33
03,008,01,002,0055,103 ,815,13,828,1299,0,3,1,3,0,1,0,76.14,63.74 ,33.33
03,008,01,002,0056,104 ,820,15,835,1315,0,3,1,3,0,1,0,76.14,63.50 ,33.33
03,008,01,002,0057,105 ,999,7,1006,1530,0,3,1,3,0,1,0,76.14,65.75 ,33.33
03,008,01,002,0058,106 ,567,6,573,865,0,3,1,3,0,1,0,76.14,66.24 ,33.33
03,008,01,002,0058,107 ,212,4,216,324,0,3,1,3,0,1,0,76.14,66.67 ,33.33
03,008,01,002,0059,108 ,481,4,485,664,0,3,1,3,0,1,0,76.14,73.04 ,33.33
03,008,01,002,0060,109 ,889,15,904,1196,0,3,1,3,0,1,0,76.14,75.59 ,33.33
03,008,01,002,0061,110 ,904,5,909,1274,0,3,1,3,0,1,0,76.14,71.35 ,33.33
03,008,01,002,0061,111 ,157,1,158,262,0,3,1,3,0,1,0,76.14,60.31 ,33.33
03,008,01,002,0062,112 ,673,9,682,1140,0,3,1,3,0,1,0,76.14,59.82 ,33.33
03,008,01,002,0063,113 ,382,2,384,633,0,3,1,3,0,1,0,76.14,60.66 ,33.33
03,008,01,002,0064,114 ,603,9,612,981,0,3,1,3,0,1,0,76.14,62.39 ,33.33
03,008,01,002,0065,115 ,699,8,707,1073,0,3,1,3,0,1,0,76.14,65.89 ,33.33
03,008,01,002,0065,116 ,905,10,915,1298,0,3,1,3,0,1,0,76.14,70.49 ,33.33
03,008,01,002,0066,117 ,805,8,813,1187,0,3,1,3,0,1,0,76.14,68.49 ,33.33
03,008,01,002,0067,118 ,636,7,643,1007,0,3,1,3,0,1,0,76.14,63.85 ,33.33
03,008,01,002,0067,119 ,594,10,604,877,0,3,1,3,0,1,0,76.14,68.87 ,33.33
03,008,01,002,0067,120 ,389,5,394,568,0,3,1,3,0,1,0,76.14,69.37 ,33.33
03,008,01,003,0068,121 ,594,7,601,850,0,3,1,3,0,1,0,76.14,70.71 ,33.33
03,008,01,003,0068,122 ,723,9,732,1028,0,3,1,3,0,1,0,76.14,71.21 ,33.33
03,008,01,003,0069,123 ,1149,8,1157,1625,0,3,1,3,0,1,0,76.14,71.20 ,33.33
03,008,01,003,0069,124 ,1140,4,1144,1693,0,3,1,3,0,1,0,76.14,67.57 ,33.33
03,008,01,003,0070,125 ,689,4,693,942,0,3,1,3,0,1,0,76.14,73.57 ,33.33
03,008,01,003,0070,126 ,783,7,790,1106,0,3,1,3,0,1,0,76.14,71.43 ,33.33
03,008,01,003,0071,127 ,541,8,549,726,0,3,1,3,0,1,0,76.14,75.62 ,33.33
03,008,01,003,0072,128 ,919,7,926,1262,0,3,1,3,0,1,0,76.14,73.38 ,33.33
03,008,01,003,0073,129 ,654,4,658,962,0,3,1,3,0,1,0,76.14,68.40 ,33.33
03,008,01,003,0073,130 ,879,10,889,1271,0,3,1,3,0,1,0,76.14,69.94 ,33.33
03,008,01,003,0074,131 ,814,8,822,1167,0,3,1,3,0,1,0,76.14,70.44 ,33.33
03,008,01,003,0074,132 ,887,12,899,1297,0,3,1,3,0,1,0,76.14,69.31 ,33.33
03,008,01,003,0074,133 ,881,10,891,1282,0,3,1,3,0,1,0,76.14,69.50 ,33.33
03,008,01,003,0074,134 ,1003,7,1010,1443,0,3,1,3,0,1,0,76.14,69.99 ,33.33
03,008,01,003,0075,135 ,1073,8,1081,1553,0,3,1,3,0,1,0,76.14,69.61 ,33.33
03,008,01,003,0075,136 ,1069,12,1081,1526,0,3,1,3,0,1,0,76.14,70.84 ,33.33
03,008,01,003,0075,137 ,870,5,875,1236,0,3,1,3,0,1,0,76.14,70.79 ,33.33
03,008,01,003,0075,138 ,1077,5,1082,1499,0,3,1,3,0,1,0,76.14,72.18 ,33.33
03,008,01,003,0076,139 ,939,10,949,1320,0,3,1,3,0,1,0,76.14,71.89 ,33.33
03,008,01,003,0076,140 ,960,10,970,1374,0,3,1,3,0,1,0,76.14,70.60 ,33.33
03,008,01,003,0077,141 ,1005,13,1018,1376,0,3,1,3,0,1,0,76.14,73.98 ,33.33
03,008,01,003,0077,142 ,648,7,655,924,0,3,1,3,0,1,0,76.14,70.89 ,33.33
03,008,01,003,0078,143 ,741,7,748,1082,0,3,1,3,0,1,0,76.14,69.13 ,33.33
03,008,01,003,0078,144 ,783,6,789,1151,0,3,1,3,0,1,0,76.14,68.55 ,33.33
03,008,01,003,0078,145 ,647,5,652,1025,0,3,1,3,0,1,0,76.14,63.61 ,33.33
03,008,01,003,0079,146 ,753,4,757,992,0,3,1,3,0,1,0,76.14,76.31 ,33.33
03,008,01,003,0079,147 ,440,5,445,628,0,3,1,3,0,1,0,76.14,70.86 ,33.33
03,008,01,003,0080,148 ,872,16,888,1259,0,3,1,3,0,1,0,76.14,70.53 ,33.33
03,008,01,003,0080,149 ,973,11,984,1437,0,3,1,3,0,1,0,76.14,68.48 ,33.33
03,008,01,003,0081,150 ,981,8,989,1395,0,3,1,3,0,1,0,76.14,70.90 ,33.33
03,008,01,003,0081,151 ,1009,11,1020,1539,0,3,1,3,0,1,0,76.14,66.28 ,33.33
03,008,01,003,0081,152 ,516,5,521,822,0,3,1,3,0,1,0,76.14,63.38 ,33.33
03,008,01,003,0081,153 ,804,8,812,1195,0,3,1,3,0,1,0,76.14,67.95 ,33.33
03,008,01,003,0082,154 ,1043,9,1052,1491,0,3,1,3,0,1,0,76.14,70.56 ,33.33
03,008,01,003,0082,155 ,1271,15,1286,1800,0,3,1,3,0,1,0,76.14,71.44 ,33.33
03,008,01,003,0083,156 ,1003,10,1013,1416,0,3,1,3,0,1,0,76.14,71.54 ,33.33
03,008,01,003,0083,157 ,953,12,965,1378,0,3,1,3,0,1,0,76.14,70.03 ,33.33
03,008,01,003,0084,158 ,508,6,514,688,0,3,1,3,0,1,0,76.14,74.71 ,33.33
03,008,01,003,0084,159 ,912,9,921,1228,0,3,1,3,0,1,0,76.14,75.00 ,33.33
03,008,01,003,0085,160 ,859,4,863,1203,0,3,1,3,0,1,0,76.14,71.74 ,33.33
03,008,01,003,0086,161 ,838,4,842,1134,0,3,1,3,0,1,0,76.14,74.25 ,33.33
03,008,01,003,0086,162 ,808,8,816,1188,0,3,1,3,0,1,0,76.14,68.69 ,33.33
03,008,01,003,0087,163 ,1022,11,1033,1427,0,3,1,3,0,1,0,76.14,72.39 ,33.33
03,008,01,003,0087,164 ,926,11,937,1404,0,3,1,3,0,1,0,76.14,66.74 ,33.33
03,008,01,003,0087,165 ,632,7,639,939,0,3,1,3,0,1,0,76.14,68.05 ,33.33
03,008,01,003,0087,166 ,330,3,333,502,0,3,1,3,0,1,0,76.14,66.33 ,33.33
03,008,01,003,0088,167 ,946,17,963,1380,0,3,1,3,0,1,0,76.14,69.78 ,33.33
03,008,01,003,0088,168 ,313,1,314,460,0,3,1,3,0,1,0,76.14,68.26 ,33.33
03,008,01,003,0089,169 ,700,10,710,984,0,3,1,3,0,1,0,76.14,72.15 ,33.33
03,008,01,003,0089,170 ,561,5,566,780,0,3,1,3,0,1,0,76.14,72.56 ,33.33
03,008,01,003,0090,171 ,933,10,943,1349,0,3,1,3,0,1,0,76.14,69.90 ,33.33
03,008,01,003,0090,172 ,688,8,696,984,0,3,1,3,0,1,0,76.14,70.73 ,33.33
03,008,01,003,0090,173 ,620,6,626,859,0,3,1,3,0,1,0,76.14,72.88 ,33.33
03,008,01,003,0091,174 ,684,4,688,943,0,3,1,3,0,1,0,76.14,72.96 ,33.33
03,008,01,003,0092,175 ,416,5,421,630,0,3,1,3,0,1,0,76.14,66.83 ,33.33
03,008,01,003,0092,176 ,636,10,646,1009,0,3,1,3,0,1,0,76.14,64.02 ,33.33
03,008,01,003,0093,177 ,717,4,721,994,0,3,1,3,0,1,0,76.14,72.54 ,33.33
03,008,01,003,0094,178 ,762,8,770,1144,0,3,1,3,0,1,0,76.14,67.31 ,33.33
03,008,01,003,0094,179 ,782,3,785,1160,0,3,1,3,0,1,0,76.14,67.67 ,33.33
03,008,01,004,0095,180 ,818,6,824,1215,0,3,1,3,0,1,0,76.14,67.82 ,33.33
03,008,01,004,0095,181 ,615,4,619,906,0,3,1,3,0,1,0,76.14,68.32 ,33.33
03,008,01,004,0096,182 ,527,7,534,745,0,3,1,3,0,1,0,76.14,71.68 ,33.33
03,008,01,004,0097,183 ,728,6,734,1070,0,3,1,3,0,1,0,76.14,68.60 ,33.33
03,008,01,004,0097,184 ,997,8,1005,1477,0,3,1,3,0,1,0,76.14,68.04 ,33.33
03,008,01,004,0097,185 ,1159,13,1172,1744,0,3,1,3,0,1,0,76.14,67.20 ,33.33
03,008,01,004,0098,186 ,926,9,935,1395,0,3,1,3,0,1,0,76.14,67.03 ,33.33
03,008,01,004,0098,187 ,1180,9,1189,1778,0,3,1,3,0,1,0,76.14,66.87 ,33.33
03,008,01,004,0099,188 ,484,7,491,703,0,3,1,3,0,1,0,76.14,69.84 ,33.33
03,008,01,004,0099,189 ,896,17,913,1489,0,3,1,3,0,1,0,76.14,61.32 ,33.33
03,008,01,004,0100,190 ,1130,9,1139,1705,0,3,1,3,0,1,0,76.14,66.80 ,33.33
03,008,01,004,0100,191 ,1036,8,1044,1572,0,3,1,3,0,1,0,76.14,66.41 ,33.33
03,008,01,004,0101,192 ,367,2,369,513,0,3,1,3,0,1,0,76.14,71.93 ,33.33
03,008,01,004,0101,193 ,336,5,341,542,0,3,1,3,0,1,0,76.14,62.92 ,33.33
03,008,01,004,0102,194 ,729,10,739,1028,0,3,1,3,0,1,0,76.14,71.89 ,33.33
03,008,01,004,0103,195 ,803,8,811,1274,0,3,1,3,0,1,0,76.14,63.66 ,33.33
03,008,01,004,0104,196 ,171,0,171,257,0,3,1,3,0,1,0,76.14,66.54 ,33.33
03,008,01,004,0104,197 ,340,4,344,511,0,3,1,3,0,1,0,76.14,67.32 ,33.33
03,008,01,004,0105,198 ,277,4,281,368,0,3,1,3,0,1,0,76.14,76.36 ,33.33
03,008,01,004,0106,199 ,882,4,886,1385,0,3,1,3,0,1,0,76.14,63.97 ,33.33
03,008,01,004,0106,200 ,883,9,892,1406,0,3,1,3,0,1,0,76.14,63.44 ,33.33
03,008,01,004,0106,201 ,799,2,801,1223,0,3,1,3,0,1,0,76.14,65.49 ,33.33
03,008,01,004,0107,202 ,1140,14,1154,1714,0,3,1,3,0,1,0,76.14,67.33 ,33.33
03,008,01,004,0107,203 ,894,6,900,1466,0,3,1,3,0,1,0,76.14,61.39 ,33.33
03,008,01,004,0108,204 ,451,10,461,678,0,3,1,3,0,1,0,76.14,67.99 ,33.33
03,008,01,004,0108,205 ,634,10,644,963,0,3,1,3,0,1,0,76.14,66.87 ,33.33
03,008,01,004,0109,206 ,703,18,721,1206,0,3,1,3,0,1,0,76.14,59.78 ,33.33
03,008,01,004,0109,207 ,621,3,624,908,0,3,1,3,0,1,0,76.14,68.72 ,33.33
03,008,01,004,0109,208 ,404,5,409,576,0,3,1,3,0,1,0,76.14,71.01 ,33.33
03,008,01,004,0110,209 ,389,5,394,666,0,3,1,3,0,1,0,76.14,59.16 ,33.33
03,008,01,004,0111,210 ,740,10,750,1211,0,3,1,3,0,1,0,76.14,61.93 ,33.33
03,008,01,004,0111,211 ,424,4,428,662,0,3,1,3,0,1,0,76.14,64.65 ,33.33
03,008,01,004,0112,212 ,648,2,650,916,0,3,1,3,0,1,0,76.14,70.96 ,33.33
03,008,01,004,0113,213 ,946,10,956,1377,0,3,1,3,0,1,0,76.14,69.43 ,33.33
03,008,01,004,0114,214 ,434,11,445,705,0,3,1,3,0,1,0,76.14,63.12 ,33.33
03,008,01,004,0115,215 ,290,5,295,436,0,3,1,3,0,1,0,76.14,67.66 ,33.33
03,008,01,004,0115,216 ,119,1,120,198,0,3,1,3,0,1,0,76.14,60.61 ,33.33
03,008,01,004,0116,217 ,914,5,919,1366,0,3,1,3,0,1,0,76.14,67.28 ,33.33
03,008,01,004,0117,218 ,269,6,275,412,0,3,1,3,0,1,0,76.14,66.75 ,33.33
03,008,01,004,0117,219 ,365,4,369,511,0,3,1,3,0,1,0,76.14,72.21 ,33.33
03,008,01,004,0118,220 ,118,1,119,206,0,3,1,3,0,1,0,76.14,57.77 ,33.33
03,008,01,004,0118,221 ,258,5,263,359,0,3,1,3,0,1,0,76.14,73.26 ,33.33
03,008,01,004,0119,222 ,335,6,341,543,0,3,1,3,0,1,0,76.14,62.80 ,33.33
03,008,01,004,0119,223 ,218,4,222,348,0,3,1,3,0,1,0,76.14,63.79 ,33.33
03,008,01,004,0120,224 ,345,4,349,571,0,3,1,3,0,1,0,76.14,61.12 ,33.33
03,008,01,004,0121,225 ,487,7,494,769,0,3,1,3,0,1,0,76.14,64.24 ,33.33
03,008,01,004,0122,226 ,352,4,356,618,0,3,1,3,0,1,0,76.14,57.61 ,33.33
03,008,01,004,0122,227 ,298,5,303,463,0,3,1,3,0,1,0,76.14,65.44 ,33.33
03,008,01,005,0123,228 ,628,8,636,890,0,3,1,3,0,1,0,76.14,71.46 ,33.33
03,008,01,005,0124,229 ,637,10,647,950,0,3,1,3,0,1,0,76.14,68.11 ,33.33
03,008,01,005,0125,230 ,376,2,378,556,0,3,1,3,0,1,0,76.14,67.99 ,33.33
03,008,01,005,0126,231 ,732,10,742,1121,0,3,1,3,0,1,0,76.14,66.19 ,33.33
03,008,01,005,0127,232 ,389,5,394,554,0,3,1,3,0,1,0,76.14,71.12 ,33.33
03,008,01,005,0128,233 ,330,5,335,464,0,3,1,3,0,1,0,76.14,72.20 ,33.33
03,008,01,005,0129,234 ,627,8,635,896,0,3,1,3,0,1,0,76.14,70.87 ,33.33
03,008,01,005,0130,235 ,902,13,915,1357,0,3,1,3,0,1,0,76.14,67.43 ,33.33
03,008,01,005,0131,236 ,646,10,656,915,0,3,1,3,0,1,0,76.14,71.69 ,33.33
03,008,01,005,0132,237 ,424,1,425,624,0,3,1,3,0,1,0,76.14,68.11 ,33.33
03,008,01,005,0132,238 ,257,1,258,393,0,3,1,3,0,1,0,76.14,65.65 ,33.33
03,008,01,005,0133,239 ,252,3,255,409,0,3,1,3,0,1,0,76.14,62.35 ,33.33
03,008,01,006,0134,240 ,706,3,709,1012,0,3,1,3,0,1,0,76.14,70.06 ,33.33
03,008,01,006,0135,241 ,807,8,815,1259,0,3,1,3,0,1,0,76.14,64.73 ,33.33
03,008,01,006,0135,242 ,1075,11,1086,1604,0,3,1,3,0,1,0,76.14,67.71 ,33.33
03,008,01,006,0136,243 ,443,7,450,736,0,3,1,3,0,1,0,76.14,61.14 ,33.33
03,008,01,006,0136,244 ,829,14,843,1217,0,3,1,3,0,1,0,76.14,69.27 ,33.33
03,008,01,006,0137,245 ,1029,14,1043,1550,0,3,1,3,0,1,0,76.14,67.29 ,33.33
03,008,01,006,0138,246 ,714,10,724,1031,0,3,1,3,0,1,0,76.14,70.22 ,33.33
03,008,01,006,0139,247 ,640,13,653,1002,0,3,1,3,0,1,0,76.14,65.17 ,33.33
03,008,01,006,0140,248 ,1134,15,1149,1556,0,3,1,3,0,1,0,76.14,73.84 ,33.33
03,008,01,006,0140,249 ,618,6,624,917,0,3,1,3,0,1,0,76.14,68.05 ,33.33
03,008,01,006,0140,250 ,616,2,618,959,0,3,1,3,0,1,0,76.14,64.44 ,33.33
03,008,01,006,0141,251 ,515,3,518,778,0,3,1,3,0,1,0,76.14,66.58 ,33.33
03,008,01,006,0141,252 ,526,5,531,847,0,3,1,3,0,1,0,76.14,62.69 ,33.33
03,008,01,006,0142,253 ,584,6,590,848,0,3,1,3,0,1,0,76.14,69.58 ,33.33
03,008,01,006,0143,254 ,731,8,739,989,0,3,1,3,0,1,0,76.14,74.72 ,33.33
03,008,01,006,0144,255 ,688,8,696,1022,0,3,1,3,0,1,0,76.14,68.10 ,33.33
03,008,01,006,0144,256 ,556,4,560,850,0,3,1,3,0,1,0,76.14,65.88 ,33.33
03,008,01,006,0144,257 ,676,11,687,1024,0,3,1,3,0,1,0,76.14,67.09 ,33.33
03,008,01,006,0144,258 ,628,9,637,918,0,3,1,3,0,1,0,76.14,69.39 ,33.33
03,008,01,006,0144,259 ,484,0,484,746,0,3,1,3,0,1,0,76.14,64.88 ,33.33
03,008,01,006,0147,260 ,469,9,478,686,0,3,1,3,0,1,0,76.14,69.68 ,33.33
03,008,01,006,0147,261 ,371,5,376,569,0,3,1,3,0,1,0,76.14,66.08 ,33.33
03,008,01,006,0148,262 ,622,8,630,918,0,3,1,3,0,1,0,76.14,68.63 ,33.33
03,008,01,006,0149,263 ,663,10,673,1011,0,3,1,3,0,1,0,76.14,66.57 ,33.33
03,008,01,006,0149,264 ,270,2,272,444,0,3,1,3,0,1,0,76.14,61.26 ,33.33
03,008,01,006,0150,265 ,889,11,900,1410,0,3,1,3,0,1,0,76.14,63.83 ,33.33
03,008,01,006,0151,266 ,717,8,725,1093,0,3,1,3,0,1,0,76.14,66.33 ,33.33
03,008,01,006,0152,267 ,559,5,564,799,0,3,1,3,0,1,0,76.14,70.59 ,33.33
03,008,01,006,0153,268 ,551,11,562,849,0,3,1,3,0,1,0,76.14,66.20 ,33.33
03,008,01,006,0154,269 ,533,6,539,819,0,3,1,3,0,1,0,76.14,65.81 ,33.33
03,008,01,006,0155,270 ,473,6,479,735,0,3,1,3,0,1,0,76.14,65.17 ,33.33
03,008,01,006,0155,271 ,546,5,551,848,0,3,1,3,0,1,0,76.14,64.98 ,33.33
03,008,01,007,0156,272 ,950,15,965,1553,0,3,1,3,0,1,0,76.14,62.14 ,33.33
03,008,01,007,0157,273 ,1094,10,1104,1648,0,3,1,3,0,1,0,76.14,66.99 ,33.33
03,008,01,007,0158,274 ,508,6,514,722,0,3,1,3,0,1,0,76.14,71.19 ,33.33
03,008,01,007,0158,275 ,262,4,266,403,0,3,1,3,0,1,0,76.14,66.00 ,33.33
03,008,01,007,0159,276 ,548,4,552,798,0,3,1,3,0,1,0,76.14,69.17 ,33.33
03,008,01,007,0159,277 ,733,3,736,1052,0,3,1,3,0,1,0,76.14,69.96 ,33.33
03,008,01,007,0160,278 ,364,5,369,573,0,3,1,3,0,1,0,76.14,64.40 ,33.33
03,008,01,007,0160,279 ,308,4,312,446,0,3,1,3,0,1,0,76.14,69.96 ,33.33
03,008,01,007,0161,280 ,405,6,411,623,0,3,1,3,0,1,0,76.14,65.97 ,33.33
03,008,01,007,0162,281 ,928,9,937,1522,0,3,1,3,0,1,0,76.14,61.56 ,33.33
03,008,01,007,0163,282 ,557,1,558,882,0,3,1,3,0,1,0,76.14,63.27 ,33.33
03,008,01,007,0164,283 ,913,9,922,1325,0,3,1,3,0,1,0,76.14,69.58 ,33.33
03,008,01,007,0165,284 ,883,9,892,1276,0,3,1,3,0,1,0,76.14,69.91 ,33.33
03,008,01,007,0166,285 ,251,3,254,443,0,3,1,3,0,1,0,76.14,57.34 ,33.33
03,008,01,007,0166,286 ,358,5,363,642,0,3,1,3,0,1,0,76.14,56.54 ,33.33
03,008,01,007,0167,287 ,438,3,441,751,0,3,1,3,0,1,0,76.14,58.72 ,33.33
03,008,01,007,0168,288 ,470,10,480,802,0,3,1,3,0,1,0,76.14,59.85 ,33.33
03,008,01,008,0169,289 ,543,7,550,856,0,3,1,3,0,1,0,76.14,64.25 ,33.33
03,008,01,008,0170,290 ,195,3,198,277,0,3,1,3,0,1,0,76.14,71.48 ,33.33
03,008,01,008,0170,291 ,157,2,159,236,0,3,1,3,0,1,0,76.14,67.37 ,33.33
03,008,01,008,0171,292 ,259,2,261,378,0,3,1,3,0,1,0,76.14,69.05 ,33.33
03,008,01,008,0171,293 ,243,3,246,378,0,3,1,3,0,1,0,76.14,65.08 ,33.33
03,008,01,008,0172,294 ,288,2,290,444,0,3,1,3,0,1,0,76.14,65.32 ,33.33
03,008,01,008,0172,295 ,200,2,202,368,0,3,1,3,0,1,0,76.14,54.89 ,33.33
03,008,01,008,0173,296 ,400,3,403,691,0,3,1,3,0,1,0,76.14,58.32 ,33.33
03,008,01,008,0174,297 ,717,6,723,1007,0,3,1,3,0,1,0,76.14,71.80 ,33.33
03,008,01,008,0175,298 ,571,5,576,798,0,3,1,3,0,1,0,76.14,72.18 ,33.33
03,008,01,008,0175,299 ,167,0,167,271,0,3,1,3,0,1,0,76.14,61.62 ,33.33
03,008,01,008,0176,300 ,465,8,473,698,0,3,1,3,0,1,0,76.14,67.77 ,33.33
03,008,01,008,0177,301 ,332,6,338,542,0,3,1,3,0,1,0,76.14,62.36 ,33.33
03,008,01,008,0178,302 ,257,1,258,377,0,3,1,3,0,1,0,76.14,68.44 ,33.33
03,008,01,008,0178,303 ,477,6,483,713,0,3,1,3,0,1,0,76.14,67.74 ,33.33
03,008,01,008,0179,304 ,328,1,329,470,0,3,1,3,0,1,0,76.14,70.00 ,33.33
03,008,01,008,0179,305 ,459,5,464,643,0,3,1,3,0,1,0,76.14,72.16 ,33.33
03,008,01,008,0180,306 ,599,12,611,993,0,3,1,3,0,1,0,76.14,61.53 ,33.33
03,008,01,008,0181,307 ,309,3,312,463,0,3,1,3,0,1,0,76.14,67.39 ,33.33
03,008,01,008,0182,308 ,466,7,473,703,0,3,1,3,0,1,0,76.14,67.28 ,33.33
03,008,01,008,0183,309 ,377,6,383,590,0,3,1,3,0,1,0,76.14,64.92 ,33.33
03,008,01,008,0184,310 ,416,7,423,676,0,3,1,3,0,1,0,76.14,62.57 ,33.33
03,008,01,008,0185,311 ,289,4,293,435,0,3,1,3,0,1,0,76.14,67.36 ,33.33
03,008,01,008,0186,312 ,358,6,364,553,0,3,1,3,0,1,0,76.14,65.82 ,33.33
03,008,01,009,0187,313 ,1135,8,1143,1842,0,3,1,3,0,1,0,76.14,62.05 ,33.33
03,008,01,009,0188,314 ,933,7,940,1525,0,3,1,3,0,1,0,76.14,61.64 ,33.33
03,008,01,009,0189,315 ,307,0,307,496,0,3,1,3,0,1,0,76.14,61.90 ,33.33
03,008,01,009,0189,316 ,336,1,337,541,0,3,1,3,0,1,0,76.14,62.29 ,33.33
03,008,01,009,0190,317 ,728,8,736,1183,0,3,1,3,0,1,0,76.14,62.21 ,33.33
03,008,01,009,0191,318 ,134,8,142,218,0,3,1,3,0,1,0,76.14,65.14 ,33.33
03,008,01,009,0191,319 ,342,4,346,517,0,3,1,3,0,1,0,76.14,66.92 ,33.33
03,008,01,009,0191,320 ,132,1,133,220,0,3,1,3,0,1,0,76.14,60.45 ,33.33
03,008,01,009,0192,321 ,504,8,512,731,0,3,1,3,0,1,0,76.14,70.04 ,33.33
03,008,01,009,0192,322 ,187,2,189,287,0,3,1,3,0,1,0,76.14,65.85 ,33.33
03,008,01,009,0192,323 ,193,0,193,300,0,3,1,3,0,1,0,76.14,64.33 ,33.33
03,008,01,009,0193,324 ,177,0,177,277,0,3,1,3,0,1,0,76.14,63.90 ,33.33
03,008,01,009,0193,325 ,245,1,246,379,0,3,1,3,0,1,0,76.14,64.91 ,33.33
03,008,01,009,0194,326 ,364,2,366,550,0,3,1,3,0,1,0,76.14,66.55 ,33.33
03,008,01,009,0194,327 ,109,3,112,157,0,3,1,3,0,1,0,76.14,71.34 ,33.33
03,008,01,009,0195,328 ,386,2,388,606,0,3,1,3,0,1,0,76.14,64.03 ,33.33
03,008,01,009,0195,329 ,236,4,240,371,0,3,1,3,0,1,0,76.14,64.69 ,33.33
03,008,01,009,0196,330 ,489,7,496,771,0,3,1,3,0,1,0,76.14,64.33 ,33.33
03,008,01,009,0197,331 ,326,3,329,539,0,3,1,3,0,1,0,76.14,61.04 ,33.33
03,008,01,009,0198,332 ,252,4,256,442,0,3,1,3,0,1,0,76.14,57.92 ,33.33
03,008,01,009,0198,333 ,337,1,338,550,0,3,1,3,0,1,0,76.14,61.45 ,33.33
03,008,01,009,0199,334 ,255,2,257,465,0,3,1,3,0,1,0,76.14,55.27 ,33.33
03,008,01,009,0199,335 ,191,5,196,325,0,3,1,3,0,1,0,76.14,60.31 ,33.33
03,008,01,010,0200,336 ,1073,16,1089,1668,0,3,1,3,0,1,0,76.14,65.29 ,33.33
03,008,01,010,0201,337 ,1027,10,1037,1641,0,3,1,3,0,1,0,76.14,63.19 ,33.33
03,008,01,010,0202,338 ,492,5,497,765,0,3,1,3,0,1,0,76.14,64.97 ,33.33
03,008,01,010,0203,339 ,908,9,917,1540,0,3,1,3,0,1,0,76.14,59.55 ,33.33
03,008,01,010,0204,340 ,427,8,435,717,0,3,1,3,0,1,0,76.14,60.67 ,33.33
03,008,01,010,0205,341 ,492,5,497,860,0,3,1,3,0,1,0,76.14,57.79 ,33.33
03,008,01,010,0206,342 ,665,6,671,1124,0,3,1,3,0,1,0,76.14,59.70 ,33.33
03,008,01,010,0206,343 ,554,3,557,928,0,3,1,3,0,1,0,76.14,60.02 ,33.33
03,008,01,010,0207,344 ,601,10,611,888,0,3,1,3,0,1,0,76.14,68.81 ,33.33
03,008,01,010,0207,345 ,673,6,679,952,0,3,1,3,0,1,0,76.14,71.32 ,33.33
03,008,01,010,0208,346 ,582,3,585,881,0,3,1,3,0,1,0,76.14,66.40 ,33.33
03,008,01,010,0209,347 ,812,4,816,1205,0,3,1,3,0,1,0,76.14,67.72 ,33.33
03,008,01,010,0210,348 ,465,3,468,757,0,3,1,3,0,1,0,76.14,61.82 ,33.33
03,008,01,010,0211,349 ,732,5,737,1143,0,3,1,3,0,1,0,76.14,64.48 ,33.33
03,008,01,010,0211,350 ,302,9,311,497,0,3,1,3,0,1,0,76.14,62.58 ,33.33
03,008,01,010,0212,351 ,800,15,815,1387,0,3,1,3,0,1,0,76.14,58.76 ,33.33
03,008,01,010,0212,352 ,351,4,355,529,0,3,1,3,0,1,0,76.14,67.11 ,33.33
03,008,01,011,0213,353 ,536,10,546,893,0,3,1,3,0,1,0,76.14,61.14 ,33.33
03,008,01,011,0214,354 ,359,2,361,586,0,3,1,3,0,1,0,76.14,61.60 ,33.33
03,008,01,011,0214,355 ,672,13,685,1095,0,3,1,3,0,1,0,76.14,62.56 ,33.33
03,008,01,011,0215,356 ,478,6,484,718,0,3,1,3,0,1,0,76.14,67.41 ,33.33
03,008,01,011,0216,357 ,721,6,727,1069,0,3,1,3,0,1,0,76.14,68.01 ,33.33
03,008,01,011,0217,358 ,379,9,388,553,0,3,1,3,0,1,0,76.14,70.16 ,33.33
03,008,01,011,0218,359 ,653,5,658,986,0,3,1,3,0,1,0,76.14,66.73 ,33.33
03,008,01,011,0219,360 ,844,4,848,1288,0,3,1,3,0,1,0,76.14,65.84 ,33.33
03,008,01,011,0220,361 ,755,7,762,1062,0,3,1,3,0,1,0,76.14,71.75 ,33.33
03,008,01,011,0221,362 ,916,12,928,1382,0,3,1,3,0,1,0,76.14,67.15 ,33.33
03,008,01,011,0222,363 ,638,6,644,1044,0,3,1,3,0,1,0,76.14,61.69 ,33.33
03,008,01,011,0223,364 ,714,10,724,1111,0,3,1,3,0,1,0,76.14,65.17 ,33.33
03,008,01,011,0224,365 ,226,4,230,371,0,3,1,3,0,1,0,76.14,61.99 ,33.33
03,008,01,011,0225,366 ,249,2,251,392,0,3,1,3,0,1,0,76.14,64.03 ,33.33
03,008,01,011,0226,367 ,733,8,741,1183,0,3,1,3,0,1,0,76.14,62.64 ,33.33
03,008,01,011,0227,368 ,206,0,206,357,0,3,1,3,0,1,0,76.14,57.70 ,33.33
03,008,01,011,0228,369 ,254,1,255,387,0,3,1,3,0,1,0,76.14,65.89 ,33.33
03,008,01,011,0229,370 ,665,6,671,914,0,3,1,3,0,1,0,76.14,73.41 ,33.33
03,008,01,011,0230,371 ,356,5,361,558,0,3,1,3,0,1,0,76.14,64.70 ,33.33
03,008,01,011,0231,372 ,446,8,454,691,0,3,1,3,0,1,0,76.14,65.70 ,33.33
03,008,01,012,0232,373 ,503,5,508,728,0,3,1,3,0,1,0,76.14,69.78 ,33.33
03,008,01,012,0232,374 ,246,0,246,388,0,3,1,3,0,1,0,76.14,63.40 ,33.33
03,008,01,012,0233,375 ,374,2,376,527,0,3,1,3,0,1,0,76.14,71.35 ,33.33
03,008,01,012,0234,376 ,297,5,302,411,0,3,1,3,0,1,0,76.14,73.48 ,33.33
03,008,01,012,0234,377 ,213,2,215,320,0,3,1,3,0,1,0,76.14,67.19 ,33.33
03,008,01,012,0235,378 ,224,2,226,329,0,3,1,3,0,1,0,76.14,68.69 ,33.33
03,008,01,012,0236,379 ,47,0,47,74,0,3,1,3,0,1,0,76.14,63.51 ,33.33
03,008,01,012,0237,380 ,142,3,145,241,0,3,1,3,0,1,0,76.14,60.17 ,33.33
03,008,01,012,0238,381 ,19,0,19,36,0,3,1,3,0,1,0,76.14,52.78 ,33.33
03,008,01,012,0238,382 ,170,0,170,260,0,3,1,3,0,1,0,76.14,65.38 ,33.33
03,008,01,012,0239,383 ,173,3,176,260,0,3,1,3,0,1,0,76.14,67.69 ,33.33
03,008,01,012,0240,384 ,283,1,284,474,0,3,1,3,0,1,0,76.14,59.92 ,33.33
03,008,01,012,0240,385 ,167,3,170,276,0,3,1,3,0,1,0,76.14,61.59 ,33.33
03,008,01,012,0241,386 ,604,4,608,891,0,3,1,3,0,1,0,76.14,68.24 ,33.33
03,008,01,012,0241,387 ,293,1,294,443,0,3,1,3,0,1,0,76.14,66.37 ,33.33
03,008,01,012,0242,388 ,36,0,36,65,0,3,1,3,0,1,0,76.14,55.38 ,33.33
03,008,01,012,0242,389 ,90,0,90,165,0,3,1,3,0,1,0,76.14,54.55 ,33.33
03,008,01,012,0243,390 ,8,0,8,12,0,3,1,3,0,1,0,76.14,66.67 ,33.33
03,008,01,012,0244,391 ,61,0,61,94,0,3,1,3,0,1,0,76.14,64.89 ,33.33
03,008,01,012,0245,392 ,28,0,28,48,0,3,1,3,0,1,0,76.14,58.33 ,33.33
03,008,01,013,0246,393 ,140,1,141,226,0,3,1,3,0,1,0,76.14,62.39 ,33.33
03,008,01,013,0246,394 ,184,4,188,307,0,3,1,3,0,1,0,76.14,61.24 ,33.33
03,008,01,013,0247,395 ,315,2,317,516,0,3,1,3,0,1,0,76.14,61.43 ,33.33
03,008,01,013,0247,396 ,194,11,205,307,0,3,1,3,0,1,0,76.14,66.78 ,33.33
03,008,01,013,0247,397 ,144,1,145,214,0,3,1,3,0,1,0,76.14,67.76 ,33.33
03,008,01,013,0248,398 ,53,2,55,85,0,3,1,3,0,1,0,76.14,64.71 ,33.33
03,008,01,013,0249,399 ,34,1,35,63,0,3,1,3,0,1,0,76.14,55.56 ,33.33
03,008,01,013,0250,400 ,60,1,61,126,0,3,1,3,0,1,0,76.14,48.41 ,33.33
03,008,01,013,0250,401 ,11,0,11,21,0,3,1,3,0,1,0,76.14,52.38 ,33.33
03,008,01,013,0251,402 ,13,1,14,24,0,3,1,3,0,1,0,76.14,58.33 ,33.33
03,008,01,013,0252,403 ,10,0,10,20,0,3,1,3,0,1,0,76.14,50.00 ,33.33
03,008,01,013,0253,404 ,9,1,10,24,0,3,1,3,0,1,0,76.14,41.67 ,33.33
03,008,01,013,0253,405 ,97,6,103,230,0,3,1,3,0,1,0,76.14,44.78 ,33.33
03,008,01,013,0254,406 ,11,0,11,18,0,3,1,3,0,1,0,76.14,61.11 ,33.33
03,008,01,013,0254,407 ,5,0,5,13,0,3,1,3,0,1,0,76.14,38.46 ,33.33
03,008,01,013,0254,408 ,16,1,17,33,0,3,1,3,0,1,0,76.14,51.52 ,33.33
03,008,01,013,0255,409 ,16,0,16,35,0,3,1,3,0,1,0,76.14,45.71 ,33.33
03,008,01,013,0255,410 ,7,0,7,10,0,3,1,3,0,1,0,76.14,70.00 ,33.33
03,008,01,013,0255,411 ,23,0,23,45,0,3,1,3,0,1,0,76.14,51.11 ,33.33
03,008,01,013,0256,412 ,25,0,25,50,0,3,1,3,0,1,0,76.14,50.00 ,33.33
03,008,01,013,0257,413 ,9,1,10,26,0,3,1,3,0,1,0,76.14,38.46 ,33.33
03,008,01,013,0258,414 ,44,0,44,83,0,3,1,3,0,1,0,76.14,53.01 ,33.33
03,008,01,013,0259,415 ,48,0,48,93,0,3,1,3,0,1,0,76.14,51.61 ,33.33
03,008,01,013,0259,416 ,20,1,21,32,0,3,1,3,0,1,0,76.14,65.63 ,33.33
03,008,01,013,0260,417 ,38,0,38,56,0,3,1,3,0,1,0,76.14,67.86 ,33.33
03,009,01,001,0001,1 ,654,6,660,952,0,3,1,3,0,1,0,76.14,69.33 ,33.33
03,009,01,001,0002,2 ,505,9,514,727,0,3,1,3,0,1,0,76.14,70.70 ,33.33
03,009,01,001,0003,3 ,527,5,532,762,0,3,1,3,0,1,0,76.14,69.82 ,33.33
03,009,01,001,0004,4 ,432,6,438,600,0,3,1,3,0,1,0,76.14,73.00 ,33.33
03,009,01,001,0005,5 ,571,3,574,909,0,3,1,3,0,1,0,76.14,63.15 ,33.33
03,009,01,001,0006,6 ,759,10,769,1160,0,3,1,3,0,1,0,76.14,66.29 ,33.33
03,009,01,001,0006,7 ,867,9,876,1405,0,3,1,3,0,1,0,76.14,62.35 ,33.33
03,009,01,001,0007,8 ,673,8,681,1032,0,3,1,3,0,1,0,76.14,65.99 ,33.33
03,009,01,001,0007,9 ,720,9,729,1110,0,3,1,3,0,1,0,76.14,65.68 ,33.33
03,009,01,001,0007,10 ,865,13,878,1313,0,3,1,3,0,1,0,76.14,66.87 ,33.33
03,009,01,001,0008,11 ,1130,19,1149,1769,0,3,1,3,0,1,0,76.14,64.95 ,33.33
03,009,01,001,0008,12 ,1004,16,1020,1497,0,3,1,3,0,1,0,76.14,68.14 ,33.33
03,009,01,001,0009,13 ,1081,18,1099,1725,0,3,1,3,0,1,0,76.14,63.71 ,33.33
03,009,01,001,0009,14 ,755,6,761,1136,0,3,1,3,0,1,0,76.14,66.99 ,33.33
03,009,01,001,0009,15 ,1053,11,1064,1608,0,3,1,3,0,1,0,76.14,66.17 ,33.33
03,009,01,001,0009,16 ,901,13,914,1463,0,3,1,3,0,1,0,76.14,62.47 ,33.33
03,009,01,001,0010,17 ,523,8,531,804,0,3,1,3,0,1,0,76.14,66.04 ,33.33
03,009,01,001,0010,18 ,469,4,473,676,0,3,1,3,0,1,0,76.14,69.97 ,33.33
03,009,01,001,0011,19 ,736,14,750,1142,0,3,1,3,0,1,0,76.14,65.67 ,33.33
03,009,01,001,0012,20 ,737,11,748,1079,0,3,1,3,0,1,0,76.14,69.32 ,33.33
03,009,01,001,0012,21 ,898,12,910,1389,0,3,1,3,0,1,0,76.14,65.51 ,33.33
03,009,01,001,0013,22 ,731,8,739,1165,0,3,1,3,0,1,0,76.14,63.43 ,33.33
03,009,01,001,0013,23 ,821,14,835,1190,0,3,1,3,0,1,0,76.14,70.17 ,33.33
03,009,01,001,0014,24 ,618,11,629,926,0,3,1,3,0,1,0,76.14,67.93 ,33.33
03,009,01,001,0014,25 ,683,13,696,1072,0,3,1,3,0,1,0,76.14,64.93 ,33.33
03,009,01,001,0015,26 ,1029,18,1047,1631,0,3,1,3,0,1,0,76.14,64.19 ,33.33
03,009,01,001,0015,27 ,846,12,858,1278,0,3,1,3,0,1,0,76.14,67.14 ,33.33
03,009,01,001,0015,28 ,969,11,980,1469,0,3,1,3,0,1,0,76.14,66.71 ,33.33
03,009,01,001,0015,29 ,661,16,677,944,0,3,1,3,0,1,0,76.14,71.72 ,33.33
03,009,01,001,0016,30 ,962,14,976,1419,0,3,1,3,0,1,0,76.14,68.78 ,33.33
03,009,01,001,0016,31 ,1072,9,1081,1770,0,3,1,3,0,1,0,76.14,61.07 ,33.33
03,009,01,001,0017,32 ,614,8,622,948,0,3,1,3,0,1,0,76.14,65.61 ,33.33
03,009,01,001,0017,33 ,780,14,794,1178,0,3,1,3,0,1,0,76.14,67.40 ,33.33
03,009,01,001,0018,34 ,654,10,664,989,0,3,1,3,0,1,0,76.14,67.14 ,33.33
03,009,01,001,0019,35 ,510,11,521,715,0,3,1,3,0,1,0,76.14,72.87 ,33.33
03,009,01,001,0020,36 ,663,12,675,990,0,3,1,3,0,1,0,76.14,68.18 ,33.33
03,009,01,001,0020,37 ,441,4,445,669,0,3,1,3,0,1,0,76.14,66.52 ,33.33
03,009,01,001,0021,38 ,376,7,383,564,0,3,1,3,0,1,0,76.14,67.91 ,33.33
03,009,01,001,0022,39 ,809,14,823,1232,0,3,1,3,0,1,0,76.14,66.80 ,33.33
03,009,01,001,0023,40 ,384,1,385,569,0,3,1,3,0,1,0,76.14,67.66 ,33.33
03,009,01,001,0024,41 ,823,11,834,1171,0,3,1,3,0,1,0,76.14,71.22 ,33.33
03,009,01,001,0024,42 ,431,10,441,613,0,3,1,3,0,1,0,76.14,71.94 ,33.33
03,009,01,001,0025,43 ,806,9,815,1230,0,3,1,3,0,1,0,76.14,66.26 ,33.33
03,009,01,001,0025,44 ,883,11,894,1488,0,3,1,3,0,1,0,76.14,60.08 ,33.33
03,009,01,001,0025,45 ,940,12,952,1483,0,3,1,3,0,1,0,76.14,64.19 ,33.33
03,009,01,001,0026,46 ,1081,9,1090,1585,0,3,1,3,0,1,0,76.14,68.77 ,33.33
03,009,01,001,0026,47 ,880,7,887,1338,0,3,1,3,0,1,0,76.14,66.29 ,33.33
03,009,01,001,0027,48 ,1078,13,1091,1509,0,3,1,3,0,1,0,76.14,72.30 ,33.33
03,009,01,001,0028,49 ,833,8,841,1175,0,3,1,3,0,1,0,76.14,71.57 ,33.33
03,009,01,001,0028,50 ,798,11,809,1176,0,3,1,3,0,1,0,76.14,68.79 ,33.33
03,009,01,001,0028,51 ,811,7,818,1273,0,3,1,3,0,1,0,76.14,64.26 ,33.33
03,009,01,001,0029,52 ,649,8,657,918,0,3,1,3,0,1,0,76.14,71.57 ,33.33
03,009,01,001,0030,53 ,623,17,640,917,0,3,1,3,0,1,0,76.14,69.79 ,33.33
03,009,01,001,0031,54 ,523,15,538,756,0,3,1,3,0,1,0,76.14,71.16 ,33.33
03,009,01,001,0031,55 ,636,5,641,984,0,3,1,3,0,1,0,76.14,65.14 ,33.33
03,009,01,001,0032,56 ,910,24,934,1304,0,3,1,3,0,1,0,76.14,71.63 ,33.33
03,009,01,001,0033,57 ,720,13,733,1023,0,3,1,3,0,1,0,76.14,71.65 ,33.33
03,009,01,001,0033,58 ,914,19,933,1412,0,3,1,3,0,1,0,76.14,66.08 ,33.33
03,009,01,001,0034,59 ,663,8,671,953,0,3,1,3,0,1,0,76.14,70.41 ,33.33
03,009,01,001,0034,60 ,939,15,954,1408,0,3,1,3,0,1,0,76.14,67.76 ,33.33
03,009,01,001,0035,61 ,773,13,786,1118,0,3,1,3,0,1,0,76.14,70.30 ,33.33
03,009,01,002,0036,62 ,761,19,780,1140,0,3,1,3,0,1,0,76.14,68.42 ,33.33
03,009,01,002,0037,63 ,954,12,966,1517,0,3,1,3,0,1,0,76.14,63.68 ,33.33
03,009,01,002,0037,64 ,899,16,915,1379,0,3,1,3,0,1,0,76.14,66.35 ,33.33
03,009,01,002,0037,65 ,801,14,815,1300,0,3,1,3,0,1,0,76.14,62.69 ,33.33
03,009,01,002,0038,66 ,691,4,695,1159,0,3,1,3,0,1,0,76.14,59.97 ,33.33
03,009,01,002,0038,67 ,561,7,568,849,0,3,1,3,0,1,0,76.14,66.90 ,33.33
03,009,01,002,0039,68 ,857,5,862,1269,0,3,1,3,0,1,0,76.14,67.93 ,33.33
03,009,01,002,0040,69 ,854,9,863,1255,0,3,1,3,0,1,0,76.14,68.76 ,33.33
03,009,01,002,0041,70 ,790,10,800,1194,0,3,1,3,0,1,0,76.14,67.00 ,33.33
03,009,01,002,0042,71 ,583,13,596,863,0,3,1,3,0,1,0,76.14,69.06 ,33.33
03,009,01,002,0043,72 ,597,10,607,905,0,3,1,3,0,1,0,76.14,67.07 ,33.33
03,009,01,002,0044,73 ,611,10,621,876,0,3,1,3,0,1,0,76.14,70.89 ,33.33
03,009,01,002,0045,74 ,480,6,486,738,0,3,1,3,0,1,0,76.14,65.85 ,33.33
03,009,01,002,0046,75 ,850,14,864,1160,0,3,1,3,0,1,0,76.14,74.48 ,33.33
03,009,01,002,0047,76 ,929,9,938,1413,0,3,1,3,0,1,0,76.14,66.38 ,33.33
03,009,01,002,0048,77 ,1129,17,1146,1781,0,3,1,3,0,1,0,76.14,64.35 ,33.33
03,009,01,002,0049,78 ,943,9,952,1424,0,3,1,3,0,1,0,76.14,66.85 ,33.33
03,009,01,002,0049,79 ,886,10,896,1385,0,3,1,3,0,1,0,76.14,64.69 ,33.33
03,009,01,002,0049,80 ,942,17,959,1434,0,3,1,3,0,1,0,76.14,66.88 ,33.33
03,009,01,002,0050,81 ,699,13,712,982,0,3,1,3,0,1,0,76.14,72.51 ,33.33
03,009,01,002,0051,82 ,592,6,598,851,0,3,1,3,0,1,0,76.14,70.27 ,33.33
03,009,01,002,0052,83 ,638,7,645,932,0,3,1,3,0,1,0,76.14,69.21 ,33.33
03,009,01,002,0053,84 ,581,6,587,835,0,3,1,3,0,1,0,76.14,70.30 ,33.33
03,009,01,002,0053,85 ,517,2,519,769,0,3,1,3,0,1,0,76.14,67.49 ,33.33
03,009,01,002,0054,86 ,688,10,698,995,0,3,1,3,0,1,0,76.14,70.15 ,33.33
03,009,01,002,0055,87 ,655,5,660,935,0,3,1,3,0,1,0,76.14,70.59 ,33.33
03,009,01,002,0055,88 ,956,12,968,1449,0,3,1,3,0,1,0,76.14,66.80 ,33.33
03,009,01,002,0056,89 ,729,5,734,1018,0,3,1,3,0,1,0,76.14,72.10 ,33.33
03,009,01,002,0056,90 ,708,7,715,1010,0,3,1,3,0,1,0,76.14,70.79 ,33.33
03,009,01,002,0057,91 ,1018,14,1032,1552,0,3,1,3,0,1,0,76.14,66.49 ,33.33
03,009,01,003,0058,92 ,688,4,692,1070,0,3,1,3,0,1,0,76.14,64.67 ,33.33
03,009,01,003,0058,93 ,763,6,769,1158,0,3,1,3,0,1,0,76.14,66.41 ,33.33
03,009,01,003,0059,94 ,442,3,445,705,0,3,1,3,0,1,0,76.14,63.12 ,33.33
03,009,01,003,0059,95 ,645,11,656,1004,0,3,1,3,0,1,0,76.14,65.34 ,33.33
03,009,01,003,0060,96 ,796,4,800,1244,0,3,1,3,0,1,0,76.14,64.31 ,33.33
03,009,01,003,0060,97 ,848,10,858,1372,0,3,1,3,0,1,0,76.14,62.54 ,33.33
03,009,01,003,0061,98 ,574,11,585,944,0,3,1,3,0,1,0,76.14,61.97 ,33.33
03,009,01,003,0061,99 ,792,7,799,1388,0,3,1,3,0,1,0,76.14,57.56 ,33.33
03,009,01,003,0062,100 ,706,8,714,1130,0,3,1,3,0,1,0,76.14,63.19 ,33.33
03,009,01,003,0063,101 ,831,12,843,1384,0,3,1,3,0,1,0,76.14,60.91 ,33.33
03,009,01,003,0063,102 ,890,9,899,1499,0,3,1,3,0,1,0,76.14,59.97 ,33.33
03,009,01,003,0064,103 ,973,18,991,1537,0,3,1,3,0,1,0,76.14,64.48 ,33.33
03,009,01,003,0064,104 ,1038,7,1045,1782,0,3,1,3,0,1,0,76.14,58.64 ,33.33
03,009,01,003,0065,105 ,888,14,902,1328,0,3,1,3,0,1,0,76.14,67.92 ,33.33
03,009,01,003,0066,106 ,721,15,736,1120,0,3,1,3,0,1,0,76.14,65.71 ,33.33
03,009,01,003,0067,107 ,1040,20,1060,1672,0,3,1,3,0,1,0,76.14,63.40 ,33.33
03,009,01,003,0068,108 ,729,20,749,1241,0,3,1,3,0,1,0,76.14,60.35 ,33.33
03,009,01,003,0068,109 ,562,5,567,896,0,3,1,3,0,1,0,76.14,63.28 ,33.33
03,009,01,003,0069,110 ,1022,7,1029,1618,0,3,1,3,0,1,0,76.14,63.60 ,33.33
03,009,01,003,0070,111 ,563,10,573,881,0,3,1,3,0,1,0,76.14,65.04 ,33.33
03,009,01,003,0071,112 ,470,1,471,717,0,3,1,3,0,1,0,76.14,65.69 ,33.33
03,009,01,003,0072,113 ,774,17,791,1202,0,3,1,3,0,1,0,76.14,65.81 ,33.33
03,009,01,003,0072,114 ,703,10,713,1083,0,3,1,3,0,1,0,76.14,65.84 ,33.33
03,009,01,003,0073,115 ,549,7,556,790,0,3,1,3,0,1,0,76.14,70.38 ,33.33
03,009,01,003,0074,116 ,1008,24,1032,1670,0,3,1,3,0,1,0,76.14,61.80 ,33.33
03,009,01,003,0075,117 ,1006,26,1032,1515,0,3,1,3,0,1,0,76.14,68.12 ,33.33
03,009,01,003,0076,118 ,839,12,851,1343,0,3,1,3,0,1,0,76.14,63.37 ,33.33
03,009,01,003,0076,119 ,945,12,957,1500,0,3,1,3,0,1,0,76.14,63.80 ,33.33
03,009,01,003,0077,120 ,732,14,746,1209,0,3,1,3,0,1,0,76.14,61.70 ,33.33
03,009,01,003,0077,121 ,644,16,660,1042,0,3,1,3,0,1,0,76.14,63.34 ,33.33
03,009,01,003,0078,122 ,787,8,795,1154,0,3,1,3,0,1,0,76.14,68.89 ,33.33
03,009,01,003,0078,123 ,764,14,778,1202,0,3,1,3,0,1,0,76.14,64.73 ,33.33
03,009,01,003,0079,124 ,799,12,811,1283,0,3,1,3,0,1,0,76.14,63.21 ,33.33
03,009,01,003,0080,125 ,817,16,833,1294,0,3,1,3,0,1,0,76.14,64.37 ,33.33
03,009,01,003,0081,126 ,754,11,765,1143,0,3,1,3,0,1,0,76.14,66.93 ,33.33
03,009,01,003,0082,127 ,994,23,1017,1475,0,3,1,3,0,1,0,76.14,68.95 ,33.33
03,009,01,003,0083,128 ,535,9,544,864,0,3,1,3,0,1,0,76.14,62.96 ,33.33
03,009,01,003,0084,129 ,551,10,561,948,0,3,1,3,0,1,0,76.14,59.18 ,33.33
03,009,01,003,0085,130 ,504,7,511,766,0,3,1,3,0,1,0,76.14,66.71 ,33.33
03,009,01,003,0086,131 ,660,9,669,1011,0,3,1,3,0,1,0,76.14,66.17 ,33.33
03,009,01,004,0087,132 ,959,10,969,1567,0,3,1,3,0,1,0,76.14,61.84 ,33.33
03,009,01,004,0088,133 ,907,13,920,1440,0,3,1,3,0,1,0,76.14,63.89 ,33.33
03,009,01,004,0089,134 ,952,8,960,1608,0,3,1,3,0,1,0,76.14,59.70 ,33.33
03,009,01,004,0090,135 ,855,8,863,1326,0,3,1,3,0,1,0,76.14,65.08 ,33.33
03,009,01,004,0090,136 ,910,9,919,1533,0,3,1,3,0,1,0,76.14,59.95 ,33.33
03,009,01,004,0091,137 ,280,7,287,450,0,3,1,3,0,1,0,76.14,63.78 ,33.33
03,009,01,004,0092,138 ,491,1,492,734,0,3,1,3,0,1,0,76.14,67.03 ,33.33
03,009,01,004,0093,139 ,399,7,406,671,0,3,1,3,0,1,0,76.14,60.51 ,33.33
03,009,01,004,0094,140 ,618,8,626,986,0,3,1,3,0,1,0,76.14,63.49 ,33.33
03,009,01,004,0095,141 ,622,7,629,1001,0,3,1,3,0,1,0,76.14,62.84 ,33.33
03,009,01,004,0095,142 ,716,7,723,1152,0,3,1,3,0,1,0,76.14,62.76 ,33.33
03,009,01,004,0096,143 ,984,10,994,1648,0,3,1,3,0,1,0,76.14,60.32 ,33.33
03,009,01,004,0096,144 ,1010,13,1023,1652,0,3,1,3,0,1,0,76.14,61.92 ,33.33
03,009,01,004,0097,145 ,753,12,765,1274,0,3,1,3,0,1,0,76.14,60.05 ,33.33
03,009,01,004,0098,146 ,901,15,916,1422,0,3,1,3,0,1,0,76.14,64.42 ,33.33
03,009,01,004,0099,147 ,570,4,574,914,0,3,1,3,0,1,0,76.14,62.80 ,33.33
03,009,01,004,0099,148 ,525,4,529,815,0,3,1,3,0,1,0,76.14,64.91 ,33.33
03,009,01,004,0100,149 ,533,11,544,904,0,3,1,3,0,1,0,76.14,60.18 ,33.33
03,009,01,004,0101,150 ,685,6,691,1119,0,3,1,3,0,1,0,76.14,61.75 ,33.33
03,009,01,004,0102,151 ,885,11,896,1481,0,3,1,3,0,1,0,76.14,60.50 ,33.33
03,009,01,004,0103,152 ,533,8,541,871,0,3,1,3,0,1,0,76.14,62.11 ,33.33
03,009,01,004,0104,153 ,645,9,654,974,0,3,1,3,0,1,0,76.14,67.15 ,33.33
03,009,01,004,0105,154 ,842,13,855,1374,0,3,1,3,0,1,0,76.14,62.23 ,33.33
03,009,01,004,0106,155 ,458,8,466,742,0,3,1,3,0,1,0,76.14,62.80 ,33.33
03,009,01,004,0107,156 ,539,5,544,796,0,3,1,3,0,1,0,76.14,68.34 ,33.33
03,009,01,004,0108,157 ,612,6,618,1005,0,3,1,3,0,1,0,76.14,61.49 ,33.33
03,009,01,004,0109,158 ,791,14,805,1389,0,3,1,3,0,1,0,76.14,57.96 ,33.33
03,009,01,004,0110,159 ,557,10,567,955,0,3,1,3,0,1,0,76.14,59.37 ,33.33
03,009,01,004,0111,160 ,516,10,526,927,0,3,1,3,0,1,0,76.14,56.74 ,33.33
03,009,01,004,0112,161 ,527,5,532,930,0,3,1,3,0,1,0,76.14,57.20 ,33.33
03,009,01,004,0112,162 ,506,4,510,865,0,3,1,3,0,1,0,76.14,58.96 ,33.33
03,009,01,004,0113,163 ,891,10,901,1392,0,3,1,3,0,1,0,76.14,64.73 ,33.33
03,009,01,005,0114,164 ,657,5,662,967,0,3,1,3,0,1,0,76.14,68.46 ,33.33
03,009,01,005,0115,165 ,685,8,693,1003,0,3,1,3,0,1,0,76.14,69.09 ,33.33
03,009,01,005,0116,166 ,870,5,875,1320,0,3,1,3,0,1,0,76.14,66.29 ,33.33
03,009,01,005,0117,167 ,620,14,634,874,0,3,1,3,0,1,0,76.14,72.54 ,33.33
03,009,01,005,0118,168 ,476,6,482,707,0,3,1,3,0,1,0,76.14,68.18 ,33.33
03,009,01,005,0118,169 ,323,4,327,440,0,3,1,3,0,1,0,76.14,74.32 ,33.33
03,009,01,005,0119,170 ,941,11,952,1524,0,3,1,3,0,1,0,76.14,62.47 ,33.33
03,009,01,005,0120,171 ,387,7,394,612,0,3,1,3,0,1,0,76.14,64.38 ,33.33
03,009,01,005,0120,172 ,407,10,417,694,0,3,1,3,0,1,0,76.14,60.09 ,33.33
03,009,01,005,0121,173 ,469,11,480,843,0,3,1,3,0,1,0,76.14,56.94 ,33.33
03,009,01,005,0121,174 ,388,4,392,619,0,3,1,3,0,1,0,76.14,63.33 ,33.33
03,009,01,005,0122,175 ,560,9,569,898,0,3,1,3,0,1,0,76.14,63.36 ,33.33
03,009,01,005,0122,176 ,395,7,402,567,0,3,1,3,0,1,0,76.14,70.90 ,33.33
03,009,01,005,0123,177 ,807,14,821,1299,0,3,1,3,0,1,0,76.14,63.20 ,33.33
03,009,01,005,0123,178 ,662,9,671,1010,0,3,1,3,0,1,0,76.14,66.44 ,33.33
03,009,01,005,0124,179 ,561,7,568,804,0,3,1,3,0,1,0,76.14,70.65 ,33.33
03,009,01,005,0124,180 ,464,9,473,698,0,3,1,3,0,1,0,76.14,67.77 ,33.33
03,009,01,005,0125,181 ,554,9,563,850,0,3,1,3,0,1,0,76.14,66.24 ,33.33
03,009,01,005,0126,182 ,664,14,678,1021,0,3,1,3,0,1,0,76.14,66.41 ,33.33
03,009,01,005,0126,183 ,530,7,537,833,0,3,1,3,0,1,0,76.14,64.47 ,33.33
03,009,01,005,0127,184 ,669,12,681,971,0,3,1,3,0,1,0,76.14,70.13 ,33.33
03,009,01,005,0127,185 ,531,8,539,802,0,3,1,3,0,1,0,76.14,67.21 ,33.33
03,009,01,005,0128,186 ,608,17,625,926,0,3,1,3,0,1,0,76.14,67.49 ,33.33
03,009,01,005,0128,187 ,580,7,587,867,0,3,1,3,0,1,0,76.14,67.70 ,33.33
03,009,01,005,0129,188 ,674,12,686,974,0,3,1,3,0,1,0,76.14,70.43 ,33.33
03,009,01,005,0130,189 ,924,26,950,1442,0,3,1,3,0,1,0,76.14,65.88 ,33.33
03,009,01,006,0131,190 ,603,14,617,818,0,3,1,3,0,1,0,76.14,75.43 ,33.33
03,009,01,006,0132,191 ,584,10,594,797,0,3,1,3,0,1,0,76.14,74.53 ,33.33
03,009,01,006,0133,192 ,376,3,379,511,0,3,1,3,0,1,0,76.14,74.17 ,33.33
03,009,01,006,0134,193 ,733,8,741,1049,0,3,1,3,0,1,0,76.14,70.64 ,33.33
03,009,01,006,0135,194 ,281,5,286,412,0,3,1,3,0,1,0,76.14,69.42 ,33.33
03,009,01,006,0136,195 ,298,4,302,447,0,3,1,3,0,1,0,76.14,67.56 ,33.33
03,009,01,006,0137,196 ,317,6,323,467,0,3,1,3,0,1,0,76.14,69.16 ,33.33
03,009,01,006,0138,197 ,612,7,619,922,0,3,1,3,0,1,0,76.14,67.14 ,33.33
03,009,01,006,0139,198 ,408,7,415,551,0,3,1,3,0,1,0,76.14,75.32 ,33.33
03,009,01,006,0140,199 ,275,6,281,398,0,3,1,3,0,1,0,76.14,70.60 ,33.33
03,009,01,006,0141,200 ,431,9,440,651,0,3,1,3,0,1,0,76.14,67.59 ,33.33
03,009,01,006,0142,201 ,394,4,398,557,0,3,1,3,0,1,0,76.14,71.45 ,33.33
03,009,01,006,0142,202 ,482,9,491,786,0,3,1,3,0,1,0,76.14,62.47 ,33.33
03,009,01,006,0143,203 ,321,8,329,485,0,3,1,3,0,1,0,76.14,67.84 ,33.33
03,009,01,006,0144,204 ,727,8,735,1124,0,3,1,3,0,1,0,76.14,65.39 ,33.33
03,009,01,006,0144,205 ,905,13,918,1401,0,3,1,3,0,1,0,76.14,65.52 ,33.33
03,009,01,006,0144,206 ,695,10,705,1056,0,3,1,3,0,1,0,76.14,66.76 ,33.33
03,009,01,006,0144,207 ,891,15,906,1345,0,3,1,3,0,1,0,76.14,67.36 ,33.33
03,009,01,006,0145,208 ,820,11,831,1271,0,3,1,3,0,1,0,76.14,65.38 ,33.33
03,009,01,006,0146,209 ,922,9,931,1423,0,3,1,3,0,1,0,76.14,65.43 ,33.33
03,009,01,006,0146,210 ,652,8,660,1018,0,3,1,3,0,1,0,76.14,64.83 ,33.33
03,009,01,006,0146,211 ,842,13,855,1302,0,3,1,3,0,1,0,76.14,65.67 ,33.33
03,009,01,006,0146,212 ,670,12,682,1055,0,3,1,3,0,1,0,76.14,64.64 ,33.33
03,009,01,006,0147,213 ,722,11,733,1148,0,3,1,3,0,1,0,76.14,63.85 ,33.33
03,009,01,006,0148,214 ,378,9,387,627,0,3,1,3,0,1,0,76.14,61.72 ,33.33
03,009,01,006,0148,215 ,230,2,232,387,0,3,1,3,0,1,0,76.14,59.95 ,33.33
03,009,01,006,0149,216 ,259,3,262,411,0,3,1,3,0,1,0,76.14,63.75 ,33.33
03,009,01,006,0150,217 ,505,5,510,849,0,3,1,3,0,1,0,76.14,60.07 ,33.33
03,009,01,006,0151,218 ,881,16,897,1407,0,3,1,3,0,1,0,76.14,63.75 ,33.33
03,009,01,006,0152,219 ,709,11,720,1255,0,3,1,3,0,1,0,76.14,57.37 ,33.33
03,009,01,006,0153,220 ,522,16,538,1049,0,3,1,3,0,1,0,76.14,51.29 ,33.33
03,009,01,006,0154,221 ,342,12,354,639,0,3,1,3,0,1,0,76.14,55.40 ,33.33
03,009,01,006,0155,222 ,707,17,724,1011,0,3,1,3,0,1,0,76.14,71.61 ,33.33
03,009,01,006,0155,223 ,400,5,405,604,0,3,1,3,0,1,0,76.14,67.05 ,33.33
03,009,01,006,0156,224 ,742,9,751,1231,0,3,1,3,0,1,0,76.14,61.01 ,33.33
03,009,01,006,0156,225 ,920,6,926,1503,0,3,1,3,0,1,0,76.14,61.61 ,33.33
03,009,01,006,0157,226 ,675,7,682,1067,0,3,1,3,0,1,0,76.14,63.92 ,33.33
03,009,01,006,0158,227 ,369,5,374,592,0,3,1,3,0,1,0,76.14,63.18 ,33.33
03,009,01,007,0159,228 ,780,15,795,1130,0,3,1,3,0,1,0,76.14,70.35 ,33.33
03,009,01,007,0159,229 ,652,8,660,945,0,3,1,3,0,1,0,76.14,69.84 ,33.33
03,009,01,007,0160,230 ,1013,15,1028,1509,0,3,1,3,0,1,0,76.14,68.12 ,33.33
03,009,01,007,0161,231 ,818,10,828,1295,0,3,1,3,0,1,0,76.14,63.94 ,33.33
03,009,01,007,0161,232 ,887,20,907,1501,0,3,1,3,0,1,0,76.14,60.43 ,33.33
03,009,01,007,0162,233 ,743,13,756,1159,0,3,1,3,0,1,0,76.14,65.23 ,33.33
03,009,01,007,0162,234 ,215,4,219,302,0,3,1,3,0,1,0,76.14,72.52 ,33.33
03,009,01,007,0163,235 ,813,7,820,1142,0,3,1,3,0,1,0,76.14,71.80 ,33.33
03,009,01,007,0164,236 ,784,13,797,1200,0,3,1,3,0,1,0,76.14,66.42 ,33.33
03,009,01,007,0165,237 ,657,2,659,946,0,3,1,3,0,1,0,76.14,69.66 ,33.33
03,009,01,007,0166,238 ,628,5,633,922,0,3,1,3,0,1,0,76.14,68.66 ,33.33
03,009,01,007,0166,239 ,690,12,702,1089,0,3,1,3,0,1,0,76.14,64.46 ,33.33
03,009,01,007,0167,240 ,625,6,631,906,0,3,1,3,0,1,0,76.14,69.65 ,33.33
03,009,01,007,0167,241 ,679,9,688,1044,0,3,1,3,0,1,0,76.14,65.90 ,33.33
03,009,01,007,0168,242 ,951,11,962,1383,0,3,1,3,0,1,0,76.14,69.56 ,33.33
03,009,01,007,0169,243 ,501,6,507,686,0,3,1,3,0,1,0,76.14,73.91 ,33.33
03,009,01,007,0170,244 ,609,6,615,951,0,3,1,3,0,1,0,76.14,64.67 ,33.33
03,009,01,007,0170,245 ,562,4,566,923,0,3,1,3,0,1,0,76.14,61.32 ,33.33
03,009,01,007,0171,246 ,674,11,685,1068,0,3,1,3,0,1,0,76.14,64.14 ,33.33
03,009,01,007,0171,247 ,609,6,615,941,0,3,1,3,0,1,0,76.14,65.36 ,33.33
03,009,01,007,0172,248 ,473,6,479,650,0,3,1,3,0,1,0,76.14,73.69 ,33.33
03,009,01,007,0173,249 ,886,17,903,1302,0,3,1,3,0,1,0,76.14,69.35 ,33.33
03,009,01,007,0174,250 ,213,3,216,335,0,3,1,3,0,1,0,76.14,64.48 ,33.33
03,009,01,007,0175,251 ,465,7,472,785,0,3,1,3,0,1,0,76.14,60.13 ,33.33
03,009,01,007,0176,252 ,738,6,744,1153,0,3,1,3,0,1,0,76.14,64.53 ,33.33
03,009,01,007,0177,253 ,320,9,329,519,0,3,1,3,0,1,0,76.14,63.39 ,33.33
03,009,01,007,0178,254 ,428,6,434,659,0,3,1,3,0,1,0,76.14,65.86 ,33.33
03,009,01,008,0179,255 ,530,7,537,785,0,3,1,3,0,1,0,76.14,68.41 ,33.33
03,009,01,008,0180,256 ,960,10,970,1467,0,3,1,3,0,1,0,76.14,66.12 ,33.33
03,009,01,008,0180,257 ,414,5,419,577,0,3,1,3,0,1,0,76.14,72.62 ,33.33
03,009,01,008,0181,258 ,709,8,717,1125,0,3,1,3,0,1,0,76.14,63.73 ,33.33
03,009,01,008,0182,259 ,669,8,677,1037,0,3,1,3,0,1,0,76.14,65.28 ,33.33
03,009,01,008,0183,260 ,856,3,859,1325,0,3,1,3,0,1,0,76.14,64.83 ,33.33
03,009,01,008,0183,261 ,318,0,318,471,0,3,1,3,0,1,0,76.14,67.52 ,33.33
03,009,01,008,0184,262 ,881,17,898,1306,0,3,1,3,0,1,0,76.14,68.76 ,33.33
03,009,01,008,0184,263 ,336,4,340,482,0,3,1,3,0,1,0,76.14,70.54 ,33.33
03,009,01,008,0185,264 ,824,12,836,1291,0,3,1,3,0,1,0,76.14,64.76 ,33.33
03,009,01,008,0186,265 ,835,9,844,1247,0,3,1,3,0,1,0,76.14,67.68 ,33.33
03,009,01,008,0187,266 ,500,14,514,807,0,3,1,3,0,1,0,76.14,63.69 ,33.33
03,009,01,008,0188,267 ,494,10,504,700,0,3,1,3,0,1,0,76.14,72.00 ,33.33
03,009,01,008,0189,268 ,750,10,760,1227,0,3,1,3,0,1,0,76.14,61.94 ,33.33
03,009,01,008,0190,269 ,543,11,554,836,0,3,1,3,0,1,0,76.14,66.27 ,33.33
03,009,01,008,0191,270 ,436,7,443,723,0,3,1,3,0,1,0,76.14,61.27 ,33.33
03,009,01,008,0192,271 ,537,6,543,838,0,3,1,3,0,1,0,76.14,64.80 ,33.33
03,009,01,008,0193,272 ,559,4,563,811,0,3,1,3,0,1,0,76.14,69.42 ,33.33
03,009,01,009,0194,273 ,921,21,942,1403,0,3,1,3,0,1,0,76.14,67.14 ,33.33
03,009,01,009,0194,274 ,860,10,870,1308,0,3,1,3,0,1,0,76.14,66.51 ,33.33
03,009,01,009,0194,275 ,501,8,509,709,0,3,1,3,0,1,0,76.14,71.79 ,33.33
03,009,01,009,0195,276 ,623,9,632,914,0,3,1,3,0,1,0,76.14,69.15 ,33.33
03,009,01,009,0196,277 ,990,7,997,1601,0,3,1,3,0,1,0,76.14,62.27 ,33.33
03,009,01,009,0197,278 ,379,3,382,575,0,3,1,3,0,1,0,76.14,66.43 ,33.33
03,009,01,009,0197,279 ,485,7,492,698,0,3,1,3,0,1,0,76.14,70.49 ,33.33
03,009,01,009,0198,280 ,767,4,771,1145,0,3,1,3,0,1,0,76.14,67.34 ,33.33
03,009,01,009,0199,281 ,595,5,600,847,0,3,1,3,0,1,0,76.14,70.84 ,33.33
03,009,01,009,0199,282 ,569,2,571,894,0,3,1,3,0,1,0,76.14,63.87 ,33.33
03,009,01,009,0200,283 ,832,15,847,1277,0,3,1,3,0,1,0,76.14,66.33 ,33.33
03,009,01,009,0200,284 ,708,16,724,1104,0,3,1,3,0,1,0,76.14,65.58 ,33.33
03,009,01,009,0201,285 ,844,12,856,1223,0,3,1,3,0,1,0,76.14,69.99 ,33.33
03,009,01,009,0202,286 ,612,10,622,900,0,3,1,3,0,1,0,76.14,69.11 ,33.33
03,009,01,009,0202,287 ,650,12,662,960,0,3,1,3,0,1,0,76.14,68.96 ,33.33
03,009,01,009,0203,288 ,826,10,836,1149,0,3,1,3,0,1,0,76.14,72.76 ,33.33
03,009,01,009,0204,289 ,1129,18,1147,1755,0,3,1,3,0,1,0,76.14,65.36 ,33.33
03,009,01,009,0205,290 ,1027,9,1036,1570,0,3,1,3,0,1,0,76.14,65.99 ,33.33
03,009,01,009,0206,291 ,866,14,880,1331,0,3,1,3,0,1,0,76.14,66.12 ,33.33
03,009,01,009,0207,292 ,1128,13,1141,1752,0,3,1,3,0,1,0,76.14,65.13 ,33.33
03,009,01,010,0208,293 ,723,15,738,1036,0,3,1,3,0,1,0,76.14,71.24 ,33.33
03,009,01,010,0209,294 ,1041,19,1060,1616,0,3,1,3,0,1,0,76.14,65.59 ,33.33
03,009,01,010,0209,295 ,1115,25,1140,1683,0,3,1,3,0,1,0,76.14,67.74 ,33.33
03,009,01,010,0210,296 ,941,17,958,1391,0,3,1,3,0,1,0,76.14,68.87 ,33.33
03,009,01,010,0210,297 ,463,6,469,720,0,3,1,3,0,1,0,76.14,65.14 ,33.33
03,009,01,010,0211,298 ,464,3,467,626,0,3,1,3,0,1,0,76.14,74.60 ,33.33
03,009,01,010,0212,299 ,632,11,643,934,0,3,1,3,0,1,0,76.14,68.84 ,33.33
03,009,01,010,0213,300 ,724,9,733,1025,0,3,1,3,0,1,0,76.14,71.51 ,33.33
03,009,01,010,0213,301 ,975,9,984,1477,0,3,1,3,0,1,0,76.14,66.62 ,33.33
03,009,01,010,0214,302 ,451,8,459,640,0,3,1,3,0,1,0,76.14,71.72 ,33.33
03,009,01,010,0215,303 ,776,13,789,1129,0,3,1,3,0,1,0,76.14,69.88 ,33.33
03,009,01,010,0216,304 ,724,6,730,1054,0,3,1,3,0,1,0,76.14,69.26 ,33.33
03,009,01,010,0217,305 ,612,13,625,894,0,3,1,3,0,1,0,76.14,69.91 ,33.33
03,009,01,010,0217,306 ,575,11,586,845,0,3,1,3,0,1,0,76.14,69.35 ,33.33
03,009,01,011,0218,307 ,902,11,913,1405,0,3,1,3,0,1,0,76.14,64.98 ,33.33
03,009,01,011,0219,308 ,1019,12,1031,1633,0,3,1,3,0,1,0,76.14,63.14 ,33.33
03,009,01,011,0220,309 ,453,3,456,719,0,3,1,3,0,1,0,76.14,63.42 ,33.33
03,009,01,011,0220,310 ,681,5,686,1092,0,3,1,3,0,1,0,76.14,62.82 ,33.33
03,009,01,011,0221,311 ,325,3,328,499,0,3,1,3,0,1,0,76.14,65.73 ,33.33
03,009,01,011,0221,312 ,702,8,710,1154,0,3,1,3,0,1,0,76.14,61.53 ,33.33
03,009,01,011,0222,313 ,813,14,827,1226,0,3,1,3,0,1,0,76.14,67.46 ,33.33
03,009,01,011,0223,314 ,621,6,627,1012,0,3,1,3,0,1,0,76.14,61.96 ,33.33
03,009,01,011,0223,315 ,647,5,652,981,0,3,1,3,0,1,0,76.14,66.46 ,33.33
03,009,01,011,0224,316 ,577,9,586,964,0,3,1,3,0,1,0,76.14,60.79 ,33.33
03,009,01,011,0225,317 ,786,8,794,1336,0,3,1,3,0,1,0,76.14,59.43 ,33.33
03,009,01,011,0226,318 ,544,9,553,958,0,3,1,3,0,1,0,76.14,57.72 ,33.33
03,009,01,011,0227,319 ,455,6,461,785,0,3,1,3,0,1,0,76.14,58.73 ,33.33
03,009,01,011,0228,320 ,951,9,960,1534,0,3,1,3,0,1,0,76.14,62.58 ,33.33
03,009,01,011,0229,321 ,656,9,665,1200,0,3,1,3,0,1,0,76.14,55.42 ,33.33
03,009,01,011,0229,322 ,445,8,453,714,0,3,1,3,0,1,0,76.14,63.45 ,33.33
03,009,01,011,0230,323 ,558,9,567,903,0,3,1,3,0,1,0,76.14,62.79 ,33.33
03,009,01,011,0231,324 ,712,9,721,1118,0,3,1,3,0,1,0,76.14,64.49 ,33.33
03,009,01,011,0231,325 ,389,4,393,685,0,3,1,3,0,1,0,76.14,57.37 ,33.33
03,009,01,011,0232,326 ,804,13,817,1417,0,3,1,3,0,1,0,76.14,57.66 ,33.33
03,009,01,011,0233,327 ,585,7,592,1012,0,3,1,3,0,1,0,76.14,58.50 ,33.33
03,009,01,011,0234,328 ,544,1,545,851,0,3,1,3,0,1,0,76.14,64.04 ,33.33
03,009,01,011,0235,329 ,668,7,675,1059,0,3,1,3,0,1,0,76.14,63.74 ,33.33
03,009,01,012,0236,330 ,805,6,811,1284,0,3,1,3,0,1,0,76.14,63.16 ,33.33
03,009,01,012,0237,331 ,866,12,878,1414,0,3,1,3,0,1,0,76.14,62.09 ,33.33
03,009,01,012,0238,332 ,591,17,608,983,0,3,1,3,0,1,0,76.14,61.85 ,33.33
03,009,01,012,0238,333 ,823,7,830,1245,0,3,1,3,0,1,0,76.14,66.67 ,33.33
03,009,01,012,0239,334 ,659,12,671,1053,0,3,1,3,0,1,0,76.14,63.72 ,33.33
03,009,01,012,0239,335 ,564,8,572,970,0,3,1,3,0,1,0,76.14,58.97 ,33.33
03,009,01,012,0240,336 ,586,8,594,954,0,3,1,3,0,1,0,76.14,62.26 ,33.33
03,009,01,012,0240,337 ,686,15,701,1053,0,3,1,3,0,1,0,76.14,66.57 ,33.33
03,009,01,012,0241,338 ,847,19,866,1358,0,3,1,3,0,1,0,76.14,63.77 ,33.33
03,009,01,012,0242,339 ,661,12,673,1045,0,3,1,3,0,1,0,76.14,64.40 ,33.33
03,009,01,012,0242,340 ,635,5,640,943,0,3,1,3,0,1,0,76.14,67.87 ,33.33
03,009,01,012,0243,341 ,564,5,569,883,0,3,1,3,0,1,0,76.14,64.44 ,33.33
03,009,01,012,0244,342 ,516,8,524,831,0,3,1,3,0,1,0,76.14,63.06 ,33.33
03,009,01,012,0244,343 ,548,4,552,960,0,3,1,3,0,1,0,76.14,57.50 ,33.33
03,009,01,012,0245,344 ,570,5,575,969,0,3,1,3,0,1,0,76.14,59.34 ,33.33
03,009,01,012,0245,345 ,562,2,564,1080,0,3,1,3,0,1,0,76.14,52.22 ,33.33
03,009,01,012,0246,346 ,803,17,820,1472,0,3,1,3,0,1,0,76.14,55.71 ,33.33
03,009,01,012,0247,347 ,710,17,727,1196,0,3,1,3,0,1,0,76.14,60.79 ,33.33
03,009,01,012,0248,348 ,802,7,809,1279,0,3,1,3,0,1,0,76.14,63.25 ,33.33
03,009,01,012,0249,349 ,521,7,528,869,0,3,1,3,0,1,0,76.14,60.76 ,33.33
03,009,01,013,0250,350 ,409,5,414,596,0,3,1,3,0,1,0,76.14,69.46 ,33.33
03,009,01,013,0250,351 ,906,8,914,1458,0,3,1,3,0,1,0,76.14,62.69 ,33.33
03,009,01,013,0250,352 ,687,7,694,1094,0,3,1,3,0,1,0,76.14,63.44 ,33.33
03,009,01,013,0251,353 ,716,6,722,1162,0,3,1,3,0,1,0,76.14,62.13 ,33.33
03,009,01,013,0251,354 ,885,17,902,1414,0,3,1,3,0,1,0,76.14,63.79 ,33.33
03,009,01,013,0252,355 ,296,3,299,501,0,3,1,3,0,1,0,76.14,59.68 ,33.33
03,009,01,013,0252,356 ,557,6,563,871,0,3,1,3,0,1,0,76.14,64.64 ,33.33
03,009,01,013,0253,357 ,446,10,456,735,0,3,1,3,0,1,0,76.14,62.04 ,33.33
03,009,01,013,0253,358 ,669,10,679,1111,0,3,1,3,0,1,0,76.14,61.12 ,33.33
03,009,01,013,0254,359 ,505,10,515,834,0,3,1,3,0,1,0,76.14,61.75 ,33.33
03,009,01,013,0254,360 ,375,7,382,612,0,3,1,3,0,1,0,76.14,62.42 ,33.33
03,009,01,013,0255,361 ,568,6,574,992,0,3,1,3,0,1,0,76.14,57.86 ,33.33
03,009,01,013,0255,362 ,613,12,625,1106,0,3,1,3,0,1,0,76.14,56.51 ,33.33
03,009,01,013,0256,363 ,590,7,597,933,0,3,1,3,0,1,0,76.14,63.99 ,33.33
03,009,01,013,0256,364 ,734,12,746,1221,0,3,1,3,0,1,0,76.14,61.10 ,33.33
03,009,01,013,0257,365 ,456,10,466,901,0,3,1,3,0,1,0,76.14,51.72 ,33.33
03,009,01,013,0257,366 ,535,5,540,945,0,3,1,3,0,1,0,76.14,57.14 ,33.33
03,009,01,013,0258,367 ,581,10,591,982,0,3,1,3,0,1,0,76.14,60.18 ,33.33
03,009,01,013,0258,368 ,957,15,972,1553,0,3,1,3,0,1,0,76.14,62.59 ,33.33
03,009,01,013,0259,369 ,446,9,455,793,0,3,1,3,0,1,0,76.14,57.38 ,33.33
03,009,01,013,0260,370 ,623,10,633,1140,0,3,1,3,0,1,0,76.14,55.53 ,33.33
03,009,01,013,0260,371 ,540,8,548,1027,0,3,1,3,0,1,0,76.14,53.36 ,33.33
03,009,01,013,0261,372 ,772,17,789,1502,0,3,1,3,0,1,0,76.14,52.53 ,33.33
03,009,01,014,0262,373 ,676,8,684,1291,0,3,1,3,0,1,0,76.14,52.98 ,33.33
03,009,01,014,0263,374 ,272,1,273,492,0,3,1,3,0,1,0,76.14,55.49 ,33.33
03,009,01,014,0264,375 ,574,12,586,1027,0,3,1,3,0,1,0,76.14,57.06 ,33.33
03,009,01,014,0264,376 ,448,4,452,765,0,3,1,3,0,1,0,76.14,59.08 ,33.33
03,009,01,014,0265,377 ,910,15,925,1442,0,3,1,3,0,1,0,76.14,64.15 ,33.33
03,009,01,014,0266,378 ,715,7,722,1210,0,3,1,3,0,1,0,76.14,59.67 ,33.33
03,009,01,014,0267,379 ,591,9,600,976,0,3,1,3,0,1,0,76.14,61.48 ,33.33
03,009,01,014,0268,380 ,617,15,632,1053,0,3,1,3,0,1,0,76.14,60.02 ,33.33
03,009,01,014,0268,381 ,697,21,718,1137,0,3,1,3,0,1,0,76.14,63.15 ,33.33
03,009,01,014,0269,382 ,451,5,456,850,0,3,1,3,0,1,0,76.14,53.65 ,33.33
03,009,01,014,0269,383 ,267,4,271,468,0,3,1,3,0,1,0,76.14,57.91 ,33.33
03,009,01,014,0270,384 ,777,16,793,1284,0,3,1,3,0,1,0,76.14,61.76 ,33.33
03,009,01,014,0271,385 ,495,14,509,949,0,3,1,3,0,1,0,76.14,53.64 ,33.33
03,009,01,014,0272,386 ,508,14,522,1036,0,3,1,3,0,1,0,76.14,50.39 ,33.33
03,009,01,014,0273,387 ,357,3,360,582,0,3,1,3,0,1,0,76.14,61.86 ,33.33
03,009,01,015,0274,388 ,658,8,666,958,0,3,1,3,0,1,0,76.14,69.52 ,33.33
03,009,01,015,0274,389 ,580,11,591,884,0,3,1,3,0,1,0,76.14,66.86 ,33.33
03,009,01,015,0275,390 ,900,16,916,1378,0,3,1,3,0,1,0,76.14,66.47 ,33.33
03,009,01,015,0276,391 ,867,12,879,1385,0,3,1,3,0,1,0,76.14,63.47 ,33.33
03,009,01,015,0277,392 ,282,2,284,412,0,3,1,3,0,1,0,76.14,68.93 ,33.33
03,009,01,015,0277,393 ,617,9,626,964,0,3,1,3,0,1,0,76.14,64.94 ,33.33
03,009,01,015,0278,394 ,352,4,356,526,0,3,1,3,0,1,0,76.14,67.68 ,33.33
03,009,01,015,0278,395 ,499,9,508,794,0,3,1,3,0,1,0,76.14,63.98 ,33.33
03,009,01,015,0279,396 ,587,7,594,970,0,3,1,3,0,1,0,76.14,61.24 ,33.33
03,009,01,015,0280,397 ,542,8,550,830,0,3,1,3,0,1,0,76.14,66.27 ,33.33
03,009,01,015,0281,398 ,847,14,861,1259,0,3,1,3,0,1,0,76.14,68.39 ,33.33
03,009,01,015,0282,399 ,578,7,585,973,0,3,1,3,0,1,0,76.14,60.12 ,33.33
03,009,01,016,0283,400 ,818,8,826,1312,0,3,1,3,0,1,0,76.14,62.96 ,33.33
03,009,01,016,0284,401 ,623,7,630,1032,0,3,1,3,0,1,0,76.14,61.05 ,33.33
03,009,01,016,0285,402 ,589,9,598,1062,0,3,1,3,0,1,0,76.14,56.31 ,33.33
03,009,01,016,0286,403 ,593,8,601,1030,0,3,1,3,0,1,0,76.14,58.35 ,33.33
03,009,01,016,0286,404 ,522,8,530,928,0,3,1,3,0,1,0,76.14,57.11 ,33.33
03,009,01,016,0287,405 ,482,8,490,931,0,3,1,3,0,1,0,76.14,52.63 ,33.33
03,009,01,016,0288,406 ,781,19,800,1552,0,3,1,3,0,1,0,76.14,51.55 ,33.33
03,009,01,016,0289,407 ,647,6,653,1264,0,3,1,3,0,1,0,76.14,51.66 ,33.33
03,009,01,016,0289,408 ,398,11,409,715,0,3,1,3,0,1,0,76.14,57.20 ,33.33
03,009,01,016,0290,409 ,296,15,311,635,0,3,1,3,0,1,0,76.14,48.98 ,33.33
03,009,01,016,0291,410 ,259,3,262,539,0,3,1,3,0,1,0,76.14,48.61 ,33.33
03,009,01,016,0292,411 ,382,11,393,671,0,3,1,3,0,1,0,76.14,58.57 ,33.33
03,009,01,016,0293,412 ,722,7,729,1279,0,3,1,3,0,1,0,76.14,57.00 ,33.33
03,009,01,016,0293,413 ,393,5,398,638,0,3,1,3,0,1,0,76.14,62.38 ,33.33
03,009,01,016,0294,414 ,622,10,632,1033,0,3,1,3,0,1,0,76.14,61.18 ,33.33
03,009,01,016,0294,415 ,287,10,297,518,0,3,1,3,0,1,0,76.14,57.34 ,33.33
03,009,01,016,0295,416 ,873,9,882,1418,0,3,1,3,0,1,0,76.14,62.20 ,33.33
03,009,01,016,0296,417 ,631,2,633,1071,0,3,1,3,0,1,0,76.14,59.10 ,33.33
03,009,01,016,0296,418 ,593,4,597,1037,0,3,1,3,0,1,0,76.14,57.57 ,33.33
03,009,01,016,0296,419 ,600,15,615,1140,0,3,1,3,0,1,0,76.14,53.95 ,33.33
03,009,01,016,0297,420 ,900,21,921,1307,0,3,1,3,0,1,0,76.14,70.47 ,33.33
03,009,01,016,0297,421 ,560,5,565,718,0,3,1,3,0,1,0,76.14,78.69 ,33.33
03,009,01,017,0298,422 ,1066,17,1083,1714,0,3,1,3,0,1,0,76.14,63.19 ,33.33
03,009,01,017,0298,423 ,765,13,778,1381,0,3,1,3,0,1,0,76.14,56.34 ,33.33
03,009,01,017,0299,424 ,467,8,475,826,0,3,1,3,0,1,0,76.14,57.51 ,33.33
03,009,01,017,0299,425 ,428,6,434,793,0,3,1,3,0,1,0,76.14,54.73 ,33.33
03,009,01,017,0300,426 ,831,10,841,1506,0,3,1,3,0,1,0,76.14,55.84 ,33.33
03,009,01,017,0301,427 ,484,4,488,780,0,3,1,3,0,1,0,76.14,62.56 ,33.33
03,009,01,017,0302,428 ,601,9,610,1049,0,3,1,3,0,1,0,76.14,58.15 ,33.33
03,009,01,017,0303,429 ,629,11,640,1211,0,3,1,3,0,1,0,76.14,52.85 ,33.33
03,009,01,017,0304,430 ,603,7,610,1034,0,3,1,3,0,1,0,76.14,58.99 ,33.33
03,009,01,017,0305,431 ,460,8,468,938,0,3,1,3,0,1,0,76.14,49.89 ,33.33
03,009,01,017,0306,432 ,405,1,406,706,0,3,1,3,0,1,0,76.14,57.51 ,33.33
03,009,01,017,0307,433 ,516,7,523,876,0,3,1,3,0,1,0,76.14,59.70 ,33.33
03,009,01,017,0308,434 ,262,2,264,470,0,3,1,3,0,1,0,76.14,56.17 ,33.33
03,009,01,017,0309,435 ,712,9,721,1256,0,3,1,3,0,1,0,76.14,57.40 ,33.33
03,009,01,017,0310,436 ,903,15,918,1586,0,3,1,3,0,1,0,76.14,57.88 ,33.33
03,009,01,017,0311,437 ,649,5,654,1113,0,3,1,3,0,1,0,76.14,58.76 ,33.33
03,009,01,017,0312,438 ,568,11,579,942,0,3,1,3,0,1,0,76.14,61.46 ,33.33
03,009,01,017,0313,439 ,805,7,812,1359,0,3,1,3,0,1,0,76.14,59.75 ,33.33
03,009,01,017,0314,440 ,616,6,622,1060,0,3,1,3,0,1,0,76.14,58.68 ,33.33
03,009,01,017,0315,441 ,434,7,441,781,0,3,1,3,0,1,0,76.14,56.47 ,33.33
03,009,01,017,0315,442 ,554,4,558,905,0,3,1,3,0,1,0,76.14,61.66 ,33.33
03,009,01,017,0316,443 ,416,4,420,687,0,3,1,3,0,1,0,76.14,61.14 ,33.33
03,009,01,017,0317,444 ,545,17,562,945,0,3,1,3,0,1,0,76.14,59.47 ,33.33
03,009,01,017,0318,445 ,472,5,477,733,0,3,1,3,0,1,0,76.14,65.08 ,33.33
03,009,01,018,0319,446 ,564,15,579,1033,0,3,1,3,0,1,0,76.14,56.05 ,33.33
03,009,01,018,0319,447 ,433,6,439,703,0,3,1,3,0,1,0,76.14,62.45 ,33.33
03,009,01,018,0320,448 ,943,11,954,1502,0,3,1,3,0,1,0,76.14,63.52 ,33.33
03,009,01,018,0320,449 ,335,10,345,585,0,3,1,3,0,1,0,76.14,58.97 ,33.33
03,009,01,018,0321,450 ,398,6,404,709,0,3,1,3,0,1,0,76.14,56.98 ,33.33
03,009,01,018,0322,451 ,624,17,641,1112,0,3,1,3,0,1,0,76.14,57.64 ,33.33
03,009,01,018,0323,452 ,598,9,607,1136,0,3,1,3,0,1,0,76.14,53.43 ,33.33
03,009,01,018,0324,453 ,506,5,511,979,0,3,1,3,0,1,0,76.14,52.20 ,33.33
03,009,01,018,0325,454 ,492,10,502,922,0,3,1,3,0,1,0,76.14,54.45 ,33.33
03,009,01,018,0326,455 ,655,11,666,1227,0,3,1,3,0,1,0,76.14,54.28 ,33.33
03,009,01,018,0327,456 ,583,13,596,1143,0,3,1,3,0,1,0,76.14,52.14 ,33.33
03,009,01,018,0328,457 ,442,4,446,982,0,3,1,3,0,1,0,76.14,45.42 ,33.33
03,009,01,018,0329,458 ,367,5,372,682,0,3,1,3,0,1,0,76.14,54.55 ,33.33
03,009,01,018,0330,459 ,509,12,521,993,0,3,1,3,0,1,0,76.14,52.47 ,33.33
03,009,01,018,0331,460 ,236,2,238,411,0,3,1,3,0,1,0,76.14,57.91 ,33.33
03,009,01,018,0332,461 ,462,8,470,968,0,3,1,3,0,1,0,76.14,48.55 ,33.33
03,009,01,018,0332,462 ,450,8,458,802,0,3,1,3,0,1,0,76.14,57.11 ,33.33
03,009,01,018,0333,463 ,471,12,483,911,0,3,1,3,0,1,0,76.14,53.02 ,33.33
03,009,01,018,0334,464 ,389,9,398,814,0,3,1,3,0,1,0,76.14,48.89 ,33.33
03,009,01,018,0335,465 ,465,8,473,1004,0,3,1,3,0,1,0,76.14,47.11 ,33.33
03,009,01,018,0336,466 ,533,10,543,1138,0,3,1,3,0,1,0,76.14,47.72 ,33.33
03,009,01,018,0337,467 ,649,10,659,1299,0,3,1,3,0,1,0,76.14,50.73 ,33.33
03,009,01,018,0338,468 ,503,12,515,1088,0,3,1,3,0,1,0,76.14,47.33 ,33.33
03,009,01,018,0339,469 ,368,4,372,836,0,3,1,3,0,1,0,76.14,44.50 ,33.33
03,009,01,019,0340,470 ,654,3,657,1033,0,3,1,3,0,1,0,76.14,63.60 ,33.33
03,009,01,019,0341,471 ,831,16,847,1255,0,3,1,3,0,1,0,76.14,67.49 ,33.33
03,009,01,019,0342,472 ,372,8,380,708,0,3,1,3,0,1,0,76.14,53.67 ,33.33
03,009,01,019,0343,473 ,383,2,385,649,0,3,1,3,0,1,0,76.14,59.32 ,33.33
03,009,01,019,0344,474 ,453,5,458,927,0,3,1,3,0,1,0,76.14,49.41 ,33.33
03,009,01,019,0345,475 ,591,11,602,997,0,3,1,3,0,1,0,76.14,60.38 ,33.33
03,009,01,019,0346,476 ,888,13,901,1435,0,3,1,3,0,1,0,76.14,62.79 ,33.33
03,009,01,019,0347,477 ,414,5,419,888,0,3,1,3,0,1,0,76.14,47.18 ,33.33
03,009,01,019,0347,478 ,605,6,611,1108,0,3,1,3,0,1,0,76.14,55.14 ,33.33
03,009,01,019,0348,479 ,430,11,441,855,0,3,1,3,0,1,0,76.14,51.58 ,33.33
03,009,01,019,0348,480 ,455,7,462,877,0,3,1,3,0,1,0,76.14,52.68 ,33.33
03,009,01,019,0349,481 ,843,13,856,1517,0,3,1,3,0,1,0,76.14,56.43 ,33.33
03,009,01,019,0350,482 ,291,8,299,543,0,3,1,3,0,1,0,76.14,55.06 ,33.33
03,009,01,019,0351,483 ,845,19,864,1439,0,3,1,3,0,1,0,76.14,60.04 ,33.33
03,009,01,019,0352,484 ,447,0,447,743,0,3,1,3,0,1,0,76.14,60.16 ,33.33
03,009,01,019,0353,485 ,224,2,226,336,0,3,1,3,0,1,0,76.14,67.26 ,33.33
03,009,01,019,0353,486 ,772,16,788,1285,0,3,1,3,0,1,0,76.14,61.32 ,33.33
03,009,01,019,0354,487 ,622,6,628,1019,0,3,1,3,0,1,0,76.14,61.63 ,33.33
03,009,01,019,0355,488 ,600,12,612,916,0,3,1,3,0,1,0,76.14,66.81 ,33.33
03,009,01,019,0355,489 ,559,7,566,950,0,3,1,3,0,1,0,76.14,59.58 ,33.33
03,009,01,019,0356,490 ,782,9,791,1323,0,3,1,3,0,1,0,76.14,59.79 ,33.33
03,009,01,019,0357,491 ,635,12,647,1049,0,3,1,3,0,1,0,76.14,61.68 ,33.33
03,009,01,019,0358,492 ,468,8,476,812,0,3,1,3,0,1,0,76.14,58.62 ,33.33
03,009,01,019,0359,493 ,602,12,614,1036,0,3,1,3,0,1,0,76.14,59.27 ,33.33
03,009,01,019,0360,494 ,440,9,449,758,0,3,1,3,0,1,0,76.14,59.23 ,33.33
03,009,01,020,0361,495 ,877,16,893,1380,0,3,1,3,0,1,0,76.14,64.71 ,33.33
03,009,01,020,0361,496 ,630,9,639,903,0,3,1,3,0,1,0,76.14,70.76 ,33.33
03,009,01,020,0362,497 ,749,8,757,1100,0,3,1,3,0,1,0,76.14,68.82 ,33.33
03,009,01,020,0362,498 ,483,7,490,791,0,3,1,3,0,1,0,76.14,61.95 ,33.33
03,009,01,020,0363,499 ,478,6,484,785,0,3,1,3,0,1,0,76.14,61.66 ,33.33
03,009,01,020,0364,500 ,441,16,457,765,0,3,1,3,0,1,0,76.14,59.74 ,33.33
03,009,01,020,0365,501 ,675,16,691,1083,0,3,1,3,0,1,0,76.14,63.80 ,33.33
03,009,01,020,0366,502 ,532,13,545,948,0,3,1,3,0,1,0,76.14,57.49 ,33.33
03,009,01,020,0367,503 ,708,14,722,1222,0,3,1,3,0,1,0,76.14,59.08 ,33.33
03,009,01,020,0368,504 ,483,9,492,808,0,3,1,3,0,1,0,76.14,60.89 ,33.33
03,009,01,020,0369,505 ,608,6,614,1067,0,3,1,3,0,1,0,76.14,57.54 ,33.33
03,009,01,020,0370,506 ,433,12,445,770,0,3,1,3,0,1,0,76.14,57.79 ,33.33
03,009,01,020,0371,507 ,416,4,420,693,0,3,1,3,0,1,0,76.14,60.61 ,33.33
03,009,01,020,0372,508 ,666,8,674,1235,0,3,1,3,0,1,0,76.14,54.57 ,33.33
03,009,01,020,0373,509 ,456,10,466,759,0,3,1,3,0,1,0,76.14,61.40 ,33.33
03,009,01,020,0374,510 ,651,9,660,1073,0,3,1,3,0,1,0,76.14,61.51 ,33.33
03,009,01,020,0375,511 ,658,9,667,1060,0,3,1,3,0,1,0,76.14,62.92 ,33.33
03,009,01,020,0376,512 ,555,14,569,904,0,3,1,3,0,1,0,76.14,62.94 ,33.33
03,009,01,020,0377,513 ,899,9,908,1267,0,3,1,3,0,1,0,76.14,71.67 ,33.33
03,009,01,020,0378,514 ,401,5,406,634,0,3,1,3,0,1,0,76.14,64.04 ,33.33
03,009,01,020,0379,515 ,524,9,533,834,0,3,1,3,0,1,0,76.14,63.91 ,33.33
03,009,01,020,0380,516 ,516,10,526,878,0,3,1,3,0,1,0,76.14,59.91 ,33.33
03,009,01,020,0381,517 ,440,7,447,811,0,3,1,3,0,1,0,76.14,55.12 ,33.33
03,009,01,020,0382,518 ,703,9,712,1099,0,3,1,3,0,1,0,76.14,64.79 ,33.33
03,009,01,020,0383,519 ,762,14,776,1269,0,3,1,3,0,1,0,76.14,61.15 ,33.33
03,009,01,020,0384,520 ,539,8,547,826,0,3,1,3,0,1,0,76.14,66.22 ,33.33
03,010,01,001,0001,1 ,1100,28,1128,1704,0,3,1,3,0,1,0,76.14,66.20 ,33.33
03,010,01,001,0002,2 ,298,7,305,486,0,3,1,3,0,1,0,76.14,62.76 ,33.33
03,010,01,001,0003,3 ,895,14,909,1367,0,3,1,3,0,1,0,76.14,66.50 ,33.33
03,010,01,001,0004,4 ,1009,23,1032,1503,0,3,1,3,0,1,0,76.14,68.66 ,33.33
03,010,01,001,0005,5 ,514,14,528,714,0,3,1,3,0,1,0,76.14,73.95 ,33.33
03,010,01,001,0005,6 ,266,3,269,368,0,3,1,3,0,1,0,76.14,73.10 ,33.33
03,010,01,001,0006,7 ,560,17,577,804,0,3,1,3,0,1,0,76.14,71.77 ,33.33
03,010,01,001,0007,8 ,568,7,575,800,0,3,1,3,0,1,0,76.14,71.88 ,33.33
03,010,01,001,0008,9 ,149,8,157,210,0,3,1,3,0,1,0,76.14,74.76 ,33.33
03,010,01,001,0008,10 ,535,8,543,725,0,3,1,3,0,1,0,76.14,74.90 ,33.33
03,010,01,001,0009,11 ,583,11,594,890,0,3,1,3,0,1,0,76.14,66.74 ,33.33
03,010,01,001,0010,12 ,750,17,767,1183,0,3,1,3,0,1,0,76.14,64.84 ,33.33
03,010,01,001,0011,13 ,430,12,442,664,0,3,1,3,0,1,0,76.14,66.57 ,33.33
03,010,01,001,0011,14 ,638,7,645,1026,0,3,1,3,0,1,0,76.14,62.87 ,33.33
03,010,01,001,0012,15 ,288,12,300,498,0,3,1,3,0,1,0,76.14,60.24 ,33.33
03,010,01,001,0012,16 ,150,2,152,217,0,3,1,3,0,1,0,76.14,70.05 ,33.33
03,010,01,001,0013,17 ,206,5,211,316,0,3,1,3,0,1,0,76.14,66.77 ,33.33
03,010,01,001,0013,18 ,156,2,158,260,0,3,1,3,0,1,0,76.14,60.77 ,33.33
03,010,01,001,0014,19 ,388,7,395,593,0,3,1,3,0,1,0,76.14,66.61 ,33.33
03,010,01,001,0014,20 ,850,26,876,1376,0,3,1,3,0,1,0,76.14,63.66 ,33.33
03,010,01,001,0015,21 ,913,26,939,1480,0,3,1,3,0,1,0,76.14,63.45 ,33.33
03,010,01,001,0015,22 ,691,15,706,1150,0,3,1,3,0,1,0,76.14,61.39 ,33.33
03,010,01,001,0016,23 ,1086,30,1116,1686,0,3,1,3,0,1,0,76.14,66.19 ,33.33
03,010,01,001,0017,24 ,645,16,661,1067,0,3,1,3,0,1,0,76.14,61.95 ,33.33
03,010,01,001,0017,25 ,625,11,636,1118,0,3,1,3,0,1,0,76.14,56.89 ,33.33
03,010,01,001,0018,26 ,457,8,465,707,0,3,1,3,0,1,0,76.14,65.77 ,33.33
03,010,01,002,0019,27 ,579,10,589,946,0,3,1,3,0,1,0,76.14,62.26 ,33.33
03,010,01,002,0019,28 ,578,6,584,862,0,3,1,3,0,1,0,76.14,67.75 ,33.33
03,010,01,002,0020,29 ,1224,16,1240,1827,0,3,1,3,0,1,0,76.14,67.87 ,33.33
03,010,01,002,0021,30 ,731,9,740,1103,0,3,1,3,0,1,0,76.14,67.09 ,33.33
03,010,01,002,0022,31 ,326,3,329,503,0,3,1,3,0,1,0,76.14,65.41 ,33.33
03,010,01,002,0023,32 ,464,5,469,754,0,3,1,3,0,1,0,76.14,62.20 ,33.33
03,010,01,002,0024,33 ,535,4,539,758,0,3,1,3,0,1,0,76.14,71.11 ,33.33
03,010,01,002,0025,34 ,511,5,516,748,0,3,1,3,0,1,0,76.14,68.98 ,33.33
03,010,01,002,0026,35 ,575,9,584,836,0,3,1,3,0,1,0,76.14,69.86 ,33.33
03,010,01,002,0026,36 ,680,6,686,985,0,3,1,3,0,1,0,76.14,69.64 ,33.33
03,010,01,002,0027,37 ,602,9,611,938,0,3,1,3,0,1,0,76.14,65.14 ,33.33
03,010,01,002,0027,38 ,930,19,949,1497,0,3,1,3,0,1,0,76.14,63.39 ,33.33
03,010,01,002,0028,39 ,1280,21,1301,2001,0,3,1,3,0,1,0,76.14,65.02 ,33.33
03,010,01,002,0028,40 ,1099,10,1109,1648,0,3,1,3,0,1,0,76.14,67.29 ,33.33
03,010,01,002,0029,41 ,448,8,456,652,0,3,1,3,0,1,0,76.14,69.94 ,33.33
03,010,01,002,0030,42 ,427,7,434,684,0,3,1,3,0,1,0,76.14,63.45 ,33.33
03,010,01,002,0031,43 ,545,14,559,810,0,3,1,3,0,1,0,76.14,69.01 ,33.33
03,010,01,002,0032,44 ,726,8,734,1016,0,3,1,3,0,1,0,76.14,72.24 ,33.33
03,010,01,002,0033,45 ,398,7,405,571,0,3,1,3,0,1,0,76.14,70.93 ,33.33
03,010,01,002,0034,46 ,914,13,927,1311,0,3,1,3,0,1,0,76.14,70.71 ,33.33
03,010,01,002,0034,47 ,833,26,859,1261,0,3,1,3,0,1,0,76.14,68.12 ,33.33
03,010,01,002,0035,48 ,1137,36,1173,1710,0,3,1,3,0,1,0,76.14,68.60 ,33.33
03,010,01,002,0036,49 ,393,6,399,596,0,3,1,3,0,1,0,76.14,66.95 ,33.33
03,010,01,002,0037,50 ,600,14,614,975,0,3,1,3,0,1,0,76.14,62.97 ,33.33
03,010,01,002,0038,51 ,649,20,669,989,0,3,1,3,0,1,0,76.14,67.64 ,33.33
03,010,01,002,0039,52 ,529,14,543,875,0,3,1,3,0,1,0,76.14,62.06 ,33.33
03,010,01,002,0040,53 ,207,3,210,296,0,3,1,3,0,1,0,76.14,70.95 ,33.33
03,010,01,002,0041,54 ,519,18,537,821,0,3,1,3,0,1,0,76.14,65.41 ,33.33
03,010,01,002,0042,55 ,375,7,382,597,0,3,1,3,0,1,0,76.14,63.99 ,33.33
03,010,01,002,0043,56 ,722,12,734,1153,0,3,1,3,0,1,0,76.14,63.66 ,33.33
03,010,01,002,0044,57 ,910,17,927,1428,0,3,1,3,0,1,0,76.14,64.92 ,33.33
03,010,01,002,0045,58 ,364,3,367,561,0,3,1,3,0,1,0,76.14,65.42 ,33.33
03,010,01,003,0046,59 ,412,13,425,748,0,3,1,3,0,1,0,76.14,56.82 ,33.33
03,010,01,003,0047,60 ,268,4,272,438,0,3,1,3,0,1,0,76.14,62.10 ,33.33
03,010,01,003,0048,61 ,256,3,259,410,0,3,1,3,0,1,0,76.14,63.17 ,33.33
03,010,01,003,0048,62 ,762,9,771,1176,0,3,1,3,0,1,0,76.14,65.56 ,33.33
03,010,01,003,0049,63 ,801,17,818,1285,0,3,1,3,0,1,0,76.14,63.66 ,33.33
03,010,01,003,0050,64 ,711,6,717,1113,0,3,1,3,0,1,0,76.14,64.42 ,33.33
03,010,01,003,0050,65 ,468,8,476,710,0,3,1,3,0,1,0,76.14,67.04 ,33.33
03,010,01,003,0051,66 ,565,9,574,925,0,3,1,3,0,1,0,76.14,62.05 ,33.33
03,010,01,003,0052,67 ,475,16,491,817,0,3,1,3,0,1,0,76.14,60.10 ,33.33
03,010,01,003,0053,68 ,532,12,544,849,0,3,1,3,0,1,0,76.14,64.08 ,33.33
03,010,01,003,0054,69 ,912,12,924,1432,0,3,1,3,0,1,0,76.14,64.53 ,33.33
03,010,01,003,0055,70 ,955,17,972,1599,0,3,1,3,0,1,0,76.14,60.79 ,33.33
03,010,01,003,0056,71 ,945,11,956,1548,0,3,1,3,0,1,0,76.14,61.76 ,33.33
03,010,01,003,0057,72 ,211,4,215,306,0,3,1,3,0,1,0,76.14,70.26 ,33.33
03,010,01,003,0057,73 ,177,2,179,266,0,3,1,3,0,1,0,76.14,67.29 ,33.33
03,010,01,003,0058,74 ,296,8,304,492,0,3,1,3,0,1,0,76.14,61.79 ,33.33
03,010,01,003,0058,75 ,184,5,189,260,0,3,1,3,0,1,0,76.14,72.69 ,33.33
03,010,01,003,0059,76 ,734,11,745,1192,0,3,1,3,0,1,0,76.14,62.50 ,33.33
03,010,01,003,0060,77 ,581,11,592,949,0,3,1,3,0,1,0,76.14,62.38 ,33.33
03,010,01,003,0060,78 ,599,11,610,983,0,3,1,3,0,1,0,76.14,62.05 ,33.33
03,010,01,003,0061,79 ,235,8,243,362,0,3,1,3,0,1,0,76.14,67.13 ,33.33
03,010,01,003,0062,80 ,125,1,126,213,0,3,1,3,0,1,0,76.14,59.15 ,33.33
03,010,01,003,0062,81 ,160,3,163,252,0,3,1,3,0,1,0,76.14,64.68 ,33.33
03,010,01,003,0063,82 ,80,2,82,133,0,3,1,3,0,1,0,76.14,61.65 ,33.33
03,010,01,003,0063,83 ,130,1,131,217,0,3,1,3,0,1,0,76.14,60.37 ,33.33
03,010,01,003,0064,84 ,539,9,548,794,0,3,1,3,0,1,0,76.14,69.02 ,33.33
03,010,01,003,0065,85 ,654,10,664,1029,0,3,1,3,0,1,0,76.14,64.53 ,33.33
03,010,01,003,0066,86 ,833,16,849,1236,0,3,1,3,0,1,0,76.14,68.69 ,33.33
03,010,01,003,0067,87 ,732,15,747,1121,0,3,1,3,0,1,0,76.14,66.64 ,33.33
03,010,01,003,0067,88 ,852,16,868,1308,0,3,1,3,0,1,0,76.14,66.36 ,33.33
03,010,01,003,0068,89 ,717,20,737,1102,0,3,1,3,0,1,0,76.14,66.88 ,33.33
03,010,01,004,0069,90 ,314,5,319,500,0,3,1,3,0,1,0,76.14,63.80 ,33.33
03,010,01,004,0070,91 ,1173,12,1185,1906,0,3,1,3,0,1,0,76.14,62.17 ,33.33
03,010,01,004,0071,92 ,609,10,619,988,0,3,1,3,0,1,0,76.14,62.65 ,33.33
03,010,01,004,0072,93 ,1103,14,1117,1722,0,3,1,3,0,1,0,76.14,64.87 ,33.33
03,010,01,004,0072,94 ,811,11,822,1323,0,3,1,3,0,1,0,76.14,62.13 ,33.33
03,010,01,004,0072,95 ,1069,16,1085,1777,0,3,1,3,0,1,0,76.14,61.06 ,33.33
03,010,01,004,0073,96 ,730,12,742,1146,0,3,1,3,0,1,0,76.14,64.75 ,33.33
03,010,01,004,0074,97 ,844,12,856,1340,0,3,1,3,0,1,0,76.14,63.88 ,33.33
03,010,01,004,0075,98 ,448,2,450,695,0,3,1,3,0,1,0,76.14,64.75 ,33.33
03,010,01,004,0076,99 ,496,9,505,838,0,3,1,3,0,1,0,76.14,60.26 ,33.33
03,010,01,004,0077,100 ,473,15,488,684,0,3,1,3,0,1,0,76.14,71.35 ,33.33
03,010,01,004,0078,101 ,191,8,199,319,0,3,1,3,0,1,0,76.14,62.38 ,33.33
03,010,01,004,0079,102 ,1107,25,1132,1748,0,3,1,3,0,1,0,76.14,64.76 ,33.33
03,010,01,004,0080,103 ,937,35,972,1461,0,3,1,3,0,1,0,76.14,66.53 ,33.33
03,010,01,004,0081,104 ,749,13,762,1101,0,3,1,3,0,1,0,76.14,69.21 ,33.33
03,010,01,004,0081,105 ,261,5,266,427,0,3,1,3,0,1,0,76.14,62.30 ,33.33
03,010,01,004,0082,106 ,532,14,546,815,0,3,1,3,0,1,0,76.14,66.99 ,33.33
03,010,01,004,0083,107 ,1011,13,1024,1525,0,3,1,3,0,1,0,76.14,67.15 ,33.33
03,010,01,004,0084,108 ,1186,12,1198,1885,0,3,1,3,0,1,0,76.14,63.55 ,33.33
03,010,01,004,0085,109 ,658,9,667,987,0,3,1,3,0,1,0,76.14,67.58 ,33.33
03,010,01,004,0086,110 ,489,6,495,693,0,3,1,3,0,1,0,76.14,71.43 ,33.33
03,010,01,004,0087,111 ,540,5,545,773,0,3,1,3,0,1,0,76.14,70.50 ,33.33
03,010,01,004,0088,112 ,679,14,693,1093,0,3,1,3,0,1,0,76.14,63.40 ,33.33
03,010,01,004,0089,113 ,492,8,500,754,0,3,1,3,0,1,0,76.14,66.31 ,33.33
03,010,01,005,0090,114 ,734,9,743,1080,0,3,1,3,0,1,0,76.14,68.80 ,33.33
03,010,01,005,0090,115 ,613,4,617,912,0,3,1,3,0,1,0,76.14,67.65 ,33.33
03,010,01,005,0091,116 ,1026,10,1036,1554,0,3,1,3,0,1,0,76.14,66.67 ,33.33
03,010,01,005,0092,117 ,909,13,922,1471,0,3,1,3,0,1,0,76.14,62.68 ,33.33
03,010,01,005,0092,118 ,992,11,1003,1492,0,3,1,3,0,1,0,76.14,67.23 ,33.33
03,010,01,005,0093,119 ,655,10,665,940,0,3,1,3,0,1,0,76.14,70.74 ,33.33
03,010,01,005,0093,120 ,633,6,639,1021,0,3,1,3,0,1,0,76.14,62.59 ,33.33
03,010,01,005,0094,121 ,852,12,864,1258,0,3,1,3,0,1,0,76.14,68.68 ,33.33
03,010,01,005,0095,122 ,1210,17,1227,1799,0,3,1,3,0,1,0,76.14,68.20 ,33.33
03,010,01,005,0096,123 ,834,13,847,1321,0,3,1,3,0,1,0,76.14,64.12 ,33.33
03,010,01,005,0097,124 ,1159,22,1181,1629,0,3,1,3,0,1,0,76.14,72.50 ,33.33
03,010,01,005,0098,125 ,479,0,479,731,0,3,1,3,0,1,0,76.14,65.53 ,33.33
03,010,01,005,0099,126 ,485,7,492,734,0,3,1,3,0,1,0,76.14,67.03 ,33.33
03,010,01,005,0100,127 ,500,11,511,776,0,3,1,3,0,1,0,76.14,65.85 ,33.33
03,010,01,005,0101,128 ,922,18,940,1454,0,3,1,3,0,1,0,76.14,64.65 ,33.33
03,010,01,005,0101,129 ,286,3,289,402,0,3,1,3,0,1,0,76.14,71.89 ,33.33
03,010,01,005,0102,130 ,519,8,527,827,0,3,1,3,0,1,0,76.14,63.72 ,33.33
03,010,01,005,0103,131 ,348,4,352,584,0,3,1,3,0,1,0,76.14,60.27 ,33.33
03,010,01,005,0104,132 ,553,10,563,880,0,3,1,3,0,1,0,76.14,63.98 ,33.33
03,010,01,005,0105,133 ,1274,11,1285,1901,0,3,1,3,0,1,0,76.14,67.60 ,33.33
03,010,01,005,0105,134 ,447,11,458,716,0,3,1,3,0,1,0,76.14,63.97 ,33.33
03,010,01,005,0105,135 ,334,8,342,451,0,3,1,3,0,1,0,76.14,75.83 ,33.33
03,010,01,005,0106,136 ,1063,14,1077,1692,0,3,1,3,0,1,0,76.14,63.65 ,33.33
03,010,01,005,0107,137 ,1460,17,1477,2390,0,3,1,3,0,1,0,76.14,61.80 ,33.33
03,010,01,005,0107,138 ,902,17,919,1449,0,3,1,3,0,1,0,76.14,63.42 ,33.33
03,010,01,005,0108,139 ,593,12,605,953,0,3,1,3,0,1,0,76.14,63.48 ,33.33
03,010,01,005,0108,140 ,637,10,647,1025,0,3,1,3,0,1,0,76.14,63.12 ,33.33
03,010,01,005,0109,141 ,1269,19,1288,2092,0,3,1,3,0,1,0,76.14,61.57 ,33.33
03,010,01,005,0110,142 ,913,13,926,1588,0,3,1,3,0,1,0,76.14,58.31 ,33.33
03,010,01,005,0111,143 ,1090,24,1114,1694,0,3,1,3,0,1,0,76.14,65.76 ,33.33
03,010,01,005,0112,144 ,697,17,714,1149,0,3,1,3,0,1,0,76.14,62.14 ,33.33
03,010,01,005,0112,145 ,531,9,540,1003,0,3,1,3,0,1,0,76.14,53.84 ,33.33
03,010,01,005,0113,146 ,723,11,734,1139,0,3,1,3,0,1,0,76.14,64.44 ,33.33
03,010,01,005,0113,147 ,801,22,823,1360,0,3,1,3,0,1,0,76.14,60.51 ,33.33
03,010,01,005,0114,148 ,1066,22,1088,1667,0,3,1,3,0,1,0,76.14,65.27 ,33.33
03,010,01,005,0115,149 ,1216,26,1242,1945,0,3,1,3,0,1,0,76.14,63.86 ,33.33
03,010,01,005,0116,150 ,1155,17,1172,1632,0,3,1,3,0,1,0,76.14,71.81 ,33.33
03,010,01,005,0116,151 ,1095,22,1117,1738,0,3,1,3,0,1,0,76.14,64.27 ,33.33
03,010,01,005,0117,152 ,779,9,788,1203,0,3,1,3,0,1,0,76.14,65.50 ,33.33
03,010,01,006,0118,153 ,882,11,893,1383,0,3,1,3,0,1,0,76.14,64.57 ,33.33
03,010,01,006,0119,154 ,479,5,484,738,0,3,1,3,0,1,0,76.14,65.58 ,33.33
03,010,01,006,0120,155 ,234,9,243,413,0,3,1,3,0,1,0,76.14,58.84 ,33.33
03,010,01,006,0120,156 ,197,2,199,307,0,3,1,3,0,1,0,76.14,64.82 ,33.33
03,010,01,006,0121,157 ,542,6,548,848,0,3,1,3,0,1,0,76.14,64.62 ,33.33
03,010,01,006,0122,158 ,584,12,596,880,0,3,1,3,0,1,0,76.14,67.73 ,33.33
03,010,01,006,0123,159 ,784,10,794,1246,0,3,1,3,0,1,0,76.14,63.72 ,33.33
03,010,01,006,0124,160 ,624,5,629,984,0,3,1,3,0,1,0,76.14,63.92 ,33.33
03,010,01,006,0125,161 ,380,4,384,571,0,3,1,3,0,1,0,76.14,67.25 ,33.33
03,010,01,006,0125,162 ,308,6,314,406,0,3,1,3,0,1,0,76.14,77.34 ,33.33
03,010,01,006,0126,163 ,646,8,654,1108,0,3,1,3,0,1,0,76.14,59.03 ,33.33
03,010,01,006,0127,164 ,460,8,468,785,0,3,1,3,0,1,0,76.14,59.62 ,33.33
03,010,01,006,0128,165 ,621,11,632,906,0,3,1,3,0,1,0,76.14,69.76 ,33.33
03,010,01,006,0128,166 ,251,4,255,373,0,3,1,3,0,1,0,76.14,68.36 ,33.33
03,010,01,006,0129,167 ,598,7,605,997,0,3,1,3,0,1,0,76.14,60.68 ,33.33
03,010,01,006,0130,168 ,442,7,449,736,0,3,1,3,0,1,0,76.14,61.01 ,33.33
03,010,01,006,0131,169 ,600,15,615,900,0,3,1,3,0,1,0,76.14,68.33 ,33.33
03,010,01,007,0132,170 ,531,5,536,843,0,3,1,3,0,1,0,76.14,63.58 ,33.33
03,010,01,007,0132,171 ,583,8,591,873,0,3,1,3,0,1,0,76.14,67.70 ,33.33
03,010,01,007,0133,172 ,496,6,502,815,0,3,1,3,0,1,0,76.14,61.60 ,33.33
03,010,01,007,0133,173 ,523,9,532,859,0,3,1,3,0,1,0,76.14,61.93 ,33.33
03,010,01,007,0134,174 ,834,15,849,1408,0,3,1,3,0,1,0,76.14,60.30 ,33.33
03,010,01,007,0135,175 ,882,15,897,1471,0,3,1,3,0,1,0,76.14,60.98 ,33.33
03,010,01,007,0136,176 ,689,7,696,1186,0,3,1,3,0,1,0,76.14,58.68 ,33.33
03,010,01,007,0137,177 ,495,4,499,793,0,3,1,3,0,1,0,76.14,62.93 ,33.33
03,010,01,007,0137,178 ,438,9,447,737,0,3,1,3,0,1,0,76.14,60.65 ,33.33
03,010,01,007,0138,179 ,441,7,448,735,0,3,1,3,0,1,0,76.14,60.95 ,33.33
03,010,01,007,0138,180 ,580,8,588,870,0,3,1,3,0,1,0,76.14,67.59 ,33.33
03,010,01,007,0139,181 ,591,8,599,968,0,3,1,3,0,1,0,76.14,61.88 ,33.33
03,010,01,007,0140,182 ,507,5,512,862,0,3,1,3,0,1,0,76.14,59.40 ,33.33
03,010,01,007,0140,183 ,535,10,545,820,0,3,1,3,0,1,0,76.14,66.46 ,33.33
03,010,01,007,0141,184 ,906,14,920,1457,0,3,1,3,0,1,0,76.14,63.14 ,33.33
03,010,01,007,0142,185 ,848,18,866,1419,0,3,1,3,0,1,0,76.14,61.03 ,33.33
03,010,01,007,0143,186 ,541,7,548,891,0,3,1,3,0,1,0,76.14,61.50 ,33.33
03,010,01,007,0144,187 ,620,9,629,1021,0,3,1,3,0,1,0,76.14,61.61 ,33.33
03,010,01,007,0145,188 ,543,15,558,911,0,3,1,3,0,1,0,76.14,61.25 ,33.33
03,010,01,007,0146,189 ,680,16,696,1109,0,3,1,3,0,1,0,76.14,62.76 ,33.33
03,010,01,007,0147,190 ,660,14,674,1135,0,3,1,3,0,1,0,76.14,59.38 ,33.33
03,010,01,007,0148,191 ,626,6,632,1089,0,3,1,3,0,1,0,76.14,58.03 ,33.33
03,010,01,007,0149,192 ,391,3,394,594,0,3,1,3,0,1,0,76.14,66.33 ,33.33
03,010,01,007,0150,193 ,479,5,484,834,0,3,1,3,0,1,0,76.14,58.03 ,33.33
03,010,01,007,0151,194 ,370,8,378,591,0,3,1,3,0,1,0,76.14,63.96 ,33.33
03,010,01,007,0152,195 ,604,10,614,936,0,3,1,3,0,1,0,76.14,65.60 ,33.33
03,010,01,007,0153,196 ,326,8,334,604,0,3,1,3,0,1,0,76.14,55.30 ,33.33
03,010,01,007,0154,197 ,324,7,331,501,0,3,1,3,0,1,0,76.14,66.07 ,33.33
03,010,01,008,0155,198 ,832,7,839,1292,0,3,1,3,0,1,0,76.14,64.94 ,33.33
03,010,01,008,0156,199 ,532,15,547,950,0,3,1,3,0,1,0,76.14,57.58 ,33.33
03,010,01,008,0157,200 ,553,12,565,877,0,3,1,3,0,1,0,76.14,64.42 ,33.33
03,010,01,008,0158,201 ,210,4,214,317,0,3,1,3,0,1,0,76.14,67.51 ,33.33
03,010,01,008,0159,202 ,777,15,792,1261,0,3,1,3,0,1,0,76.14,62.81 ,33.33
03,010,01,008,0160,203 ,777,18,795,1316,0,3,1,3,0,1,0,76.14,60.41 ,33.33
03,010,01,008,0161,204 ,521,10,531,894,0,3,1,3,0,1,0,76.14,59.40 ,33.33
03,010,01,008,0162,205 ,449,8,457,740,0,3,1,3,0,1,0,76.14,61.76 ,33.33
03,010,01,008,0163,206 ,333,10,343,604,0,3,1,3,0,1,0,76.14,56.79 ,33.33
03,010,01,008,0163,207 ,96,2,98,193,0,3,1,3,0,1,0,76.14,50.78 ,33.33
03,010,01,008,0164,208 ,145,1,146,252,0,3,1,3,0,1,0,76.14,57.94 ,33.33
03,010,01,008,0164,209 ,172,2,174,305,0,3,1,3,0,1,0,76.14,57.05 ,33.33
03,010,01,008,0164,210 ,237,3,240,392,0,3,1,3,0,1,0,76.14,61.22 ,33.33
03,010,01,008,0164,211 ,337,3,340,493,0,3,1,3,0,1,0,76.14,68.97 ,33.33
03,010,01,008,0165,212 ,368,10,378,634,0,3,1,3,0,1,0,76.14,59.62 ,33.33
03,010,01,008,0166,213 ,475,8,483,770,0,3,1,3,0,1,0,76.14,62.73 ,33.33
03,010,01,008,0167,214 ,627,10,637,1065,0,3,1,3,0,1,0,76.14,59.81 ,33.33
03,010,01,008,0168,215 ,559,7,566,883,0,3,1,3,0,1,0,76.14,64.10 ,33.33
03,010,01,008,0169,216 ,628,13,641,1033,0,3,1,3,0,1,0,76.14,62.05 ,33.33
03,010,01,008,0170,217 ,858,20,878,1431,0,3,1,3,0,1,0,76.14,61.36 ,33.33
03,010,01,008,0171,218 ,409,5,414,730,0,3,1,3,0,1,0,76.14,56.71 ,33.33
03,010,01,008,0172,219 ,319,6,325,573,0,3,1,3,0,1,0,76.14,56.72 ,33.33
03,010,01,008,0173,220 ,411,7,418,807,0,3,1,3,0,1,0,76.14,51.80 ,33.33
03,010,01,008,0174,221 ,508,15,523,961,0,3,1,3,0,1,0,76.14,54.42 ,33.33
03,010,01,008,0175,222 ,508,9,517,905,0,3,1,3,0,1,0,76.14,57.13 ,33.33
03,010,01,008,0176,223 ,365,15,380,645,0,3,1,3,0,1,0,76.14,58.91 ,33.33
03,010,01,008,0177,224 ,483,8,491,812,0,3,1,3,0,1,0,76.14,60.47 ,33.33
03,010,01,008,0178,225 ,523,10,533,872,0,3,1,3,0,1,0,76.14,61.12 ,33.33
03,010,01,008,0179,226 ,239,6,245,408,0,3,1,3,0,1,0,76.14,60.05 ,33.33
03,010,01,008,0179,227 ,106,7,113,217,0,3,1,3,0,1,0,76.14,52.07 ,33.33
03,010,01,009,0180,228 ,1138,28,1166,1726,0,3,1,3,0,1,0,76.14,67.56 ,33.33
03,010,01,009,0181,229 ,602,19,621,1001,0,3,1,3,0,1,0,76.14,62.04 ,33.33
03,010,01,009,0182,230 ,997,23,1020,1564,0,3,1,3,0,1,0,76.14,65.22 ,33.33
03,010,01,009,0183,231 ,985,19,1004,1475,0,3,1,3,0,1,0,76.14,68.07 ,33.33
03,010,01,009,0184,232 ,805,26,831,1247,0,3,1,3,0,1,0,76.14,66.64 ,33.33
03,010,01,009,0185,233 ,482,13,495,724,0,3,1,3,0,1,0,76.14,68.37 ,33.33
03,010,01,009,0186,234 ,279,3,282,461,0,3,1,3,0,1,0,76.14,61.17 ,33.33
03,010,01,009,0187,235 ,591,12,603,1002,0,3,1,3,0,1,0,76.14,60.18 ,33.33
03,010,01,009,0188,236 ,661,14,675,1133,0,3,1,3,0,1,0,76.14,59.58 ,33.33
03,010,01,009,0189,237 ,554,15,569,885,0,3,1,3,0,1,0,76.14,64.29 ,33.33
03,010,01,009,0190,238 ,117,2,119,187,0,3,1,3,0,1,0,76.14,63.64 ,33.33
03,010,01,009,0190,239 ,126,4,130,254,0,3,1,3,0,1,0,76.14,51.18 ,33.33
03,010,01,009,0191,240 ,712,13,725,1113,0,3,1,3,0,1,0,76.14,65.14 ,33.33
03,010,01,009,0192,241 ,255,4,259,394,0,3,1,3,0,1,0,76.14,65.74 ,33.33
03,010,01,009,0193,242 ,763,18,781,1099,0,3,1,3,0,1,0,76.14,71.06 ,33.33
03,010,01,009,0193,243 ,209,10,219,313,0,3,1,3,0,1,0,76.14,69.97 ,33.33
03,010,01,009,0194,244 ,869,14,883,1301,0,3,1,3,0,1,0,76.14,67.87 ,33.33
03,010,01,009,0195,245 ,614,27,641,933,0,3,1,3,0,1,0,76.14,68.70 ,33.33
03,010,01,009,0196,246 ,474,7,481,780,0,3,1,3,0,1,0,76.14,61.67 ,33.33
03,010,01,009,0197,247 ,633,19,652,966,0,3,1,3,0,1,0,76.14,67.49 ,33.33
03,010,01,009,0198,248 ,236,7,243,387,0,3,1,3,0,1,0,76.14,62.79 ,33.33
03,010,01,009,0198,249 ,253,5,258,412,0,3,1,3,0,1,0,76.14,62.62 ,33.33
03,010,01,009,0199,250 ,661,15,676,1096,0,3,1,3,0,1,0,76.14,61.68 ,33.33
03,010,01,009,0200,251 ,731,15,746,1017,0,3,1,3,0,1,0,76.14,73.35 ,33.33
03,010,01,009,0201,252 ,843,11,854,1304,0,3,1,3,0,1,0,76.14,65.49 ,33.33
03,010,01,009,0202,253 ,291,3,294,453,0,3,1,3,0,1,0,76.14,64.90 ,33.33
03,010,01,009,0202,254 ,283,2,285,373,0,3,1,3,0,1,0,76.14,76.41 ,33.33
03,010,01,010,0203,255 ,644,19,663,898,0,3,1,3,0,1,0,76.14,73.83 ,33.33
03,010,01,010,0204,256 ,1158,27,1185,1608,0,3,1,3,0,1,0,76.14,73.69 ,33.33
03,010,01,010,0205,257 ,1042,21,1063,1451,0,3,1,3,0,1,0,76.14,73.26 ,33.33
03,010,01,010,0206,258 ,818,13,831,1033,0,3,1,3,0,1,0,76.14,80.45 ,33.33
03,010,01,010,0207,259 ,508,23,531,767,0,3,1,3,0,1,0,76.14,69.23 ,33.33
03,010,01,010,0208,260 ,1013,13,1026,1378,0,3,1,3,0,1,0,76.14,74.46 ,33.33
03,010,01,010,0209,261 ,288,7,295,437,0,3,1,3,0,1,0,76.14,67.51 ,33.33
03,010,01,010,0210,262 ,260,9,269,367,0,3,1,3,0,1,0,76.14,73.30 ,33.33
03,010,01,010,0210,263 ,89,4,93,133,0,3,1,3,0,1,0,76.14,69.92 ,33.33
03,010,01,010,0211,264 ,625,13,638,842,0,3,1,3,0,1,0,76.14,75.77 ,33.33
03,010,01,010,0212,265 ,324,7,331,464,0,3,1,3,0,1,0,76.14,71.34 ,33.33
03,010,01,010,0213,266 ,366,8,374,527,0,3,1,3,0,1,0,76.14,70.97 ,33.33
03,010,01,010,0214,267 ,412,11,423,612,0,3,1,3,0,1,0,76.14,69.12 ,33.33
03,010,01,010,0215,268 ,1104,24,1128,1552,0,3,1,3,0,1,0,76.14,72.68 ,33.33
03,010,01,010,0216,269 ,592,11,603,871,0,3,1,3,0,1,0,76.14,69.23 ,33.33
03,010,01,010,0217,270 ,632,15,647,933,0,3,1,3,0,1,0,76.14,69.35 ,33.33
03,010,01,010,0218,271 ,596,10,606,878,0,3,1,3,0,1,0,76.14,69.02 ,33.33
03,010,01,010,0219,272 ,351,11,362,556,0,3,1,3,0,1,0,76.14,65.11 ,33.33
03,010,01,010,0220,273 ,441,8,449,583,0,3,1,3,0,1,0,76.14,77.02 ,33.33
03,010,01,010,0221,274 ,533,8,541,734,0,3,1,3,0,1,0,76.14,73.71 ,33.33
03,010,01,010,0221,275 ,129,5,134,177,0,3,1,3,0,1,0,76.14,75.71 ,33.33
03,010,01,010,0222,276 ,337,5,342,517,0,3,1,3,0,1,0,76.14,66.15 ,33.33
03,010,01,010,0223,277 ,484,9,493,744,0,3,1,3,0,1,0,76.14,66.26 ,33.33
03,010,01,010,0224,278 ,511,15,526,772,0,3,1,3,0,1,0,76.14,68.13 ,33.33
03,010,01,011,0225,279 ,312,6,318,492,0,3,1,3,0,1,0,76.14,64.63 ,33.33
03,010,01,011,0226,280 ,452,7,459,646,0,3,1,3,0,1,0,76.14,71.05 ,33.33
03,010,01,011,0227,281 ,843,14,857,1315,0,3,1,3,0,1,0,76.14,65.17 ,33.33
03,010,01,011,0228,282 ,763,16,779,1150,0,3,1,3,0,1,0,76.14,67.74 ,33.33
03,010,01,011,0229,283 ,197,2,199,291,0,3,1,3,0,1,0,76.14,68.38 ,33.33
03,010,01,011,0229,284 ,83,3,86,139,0,3,1,3,0,1,0,76.14,61.87 ,33.33
03,010,01,011,0230,285 ,683,9,692,1147,0,3,1,3,0,1,0,76.14,60.33 ,33.33
03,010,01,011,0231,286 ,304,7,311,528,0,3,1,3,0,1,0,76.14,58.90 ,33.33
03,010,01,011,0232,287 ,551,6,557,905,0,3,1,3,0,1,0,76.14,61.55 ,33.33
03,010,01,011,0233,288 ,685,10,695,1130,0,3,1,3,0,1,0,76.14,61.50 ,33.33
03,010,01,011,0234,289 ,644,21,665,1117,0,3,1,3,0,1,0,76.14,59.53 ,33.33
03,010,01,011,0235,290 ,563,12,575,931,0,3,1,3,0,1,0,76.14,61.76 ,33.33
03,010,01,011,0236,291 ,388,4,392,679,0,3,1,3,0,1,0,76.14,57.73 ,33.33
03,010,01,011,0236,292 ,142,5,147,233,0,3,1,3,0,1,0,76.14,63.09 ,33.33
03,010,01,011,0237,293 ,696,12,708,971,0,3,1,3,0,1,0,76.14,72.91 ,33.33
03,010,01,011,0237,294 ,217,4,221,320,0,3,1,3,0,1,0,76.14,69.06 ,33.33
03,010,01,011,0238,295 ,789,25,814,1153,0,3,1,3,0,1,0,76.14,70.60 ,33.33
03,010,01,011,0238,296 ,264,7,271,387,0,3,1,3,0,1,0,76.14,70.03 ,33.33
03,010,01,011,0239,297 ,197,5,202,295,0,3,1,3,0,1,0,76.14,68.47 ,33.33
03,010,01,011,0239,298 ,201,1,202,283,0,3,1,3,0,1,0,76.14,71.38 ,33.33
03,010,01,012,0240,299 ,392,9,401,555,0,3,1,3,0,1,0,76.14,72.25 ,33.33
03,010,01,012,0240,300 ,521,7,528,755,0,3,1,3,0,1,0,76.14,69.93 ,33.33
03,010,01,012,0240,301 ,1066,16,1082,1646,0,3,1,3,0,1,0,76.14,65.74 ,33.33
03,010,01,012,0241,302 ,1040,11,1051,1559,0,3,1,3,0,1,0,76.14,67.42 ,33.33
03,010,01,012,0241,303 ,367,5,372,512,0,3,1,3,0,1,0,76.14,72.66 ,33.33
03,010,01,012,0242,304 ,687,26,713,1107,0,3,1,3,0,1,0,76.14,64.41 ,33.33
03,010,01,012,0242,305 ,265,5,270,367,0,3,1,3,0,1,0,76.14,73.57 ,33.33
03,010,01,012,0243,306 ,273,9,282,455,0,3,1,3,0,1,0,76.14,61.98 ,33.33
03,010,01,012,0243,307 ,705,10,715,1126,0,3,1,3,0,1,0,76.14,63.50 ,33.33
03,010,01,012,0244,308 ,668,18,686,1098,0,3,1,3,0,1,0,76.14,62.48 ,33.33
03,010,01,012,0244,309 ,470,8,478,665,0,3,1,3,0,1,0,76.14,71.88 ,33.33
03,010,01,012,0245,310 ,471,12,483,664,0,3,1,3,0,1,0,76.14,72.74 ,33.33
03,010,01,012,0246,311 ,360,6,366,501,0,3,1,3,0,1,0,76.14,73.05 ,33.33
03,010,01,012,0246,312 ,403,6,409,558,0,3,1,3,0,1,0,76.14,73.30 ,33.33
03,010,01,012,0246,313 ,269,1,270,352,0,3,1,3,0,1,0,76.14,76.70 ,33.33
03,010,01,012,0247,314 ,1265,18,1283,1874,0,3,1,3,0,1,0,76.14,68.46 ,33.33
03,010,01,012,0248,315 ,576,15,591,823,0,3,1,3,0,1,0,76.14,71.81 ,33.33
03,010,01,012,0249,316 ,1215,27,1242,1780,0,3,1,3,0,1,0,76.14,69.78 ,33.33
03,010,01,012,0250,317 ,731,12,743,1094,0,3,1,3,0,1,0,76.14,67.92 ,33.33
03,010,01,012,0251,318 ,440,9,449,616,0,3,1,3,0,1,0,76.14,72.89 ,33.33
03,010,01,012,0252,319 ,396,5,401,531,0,3,1,3,0,1,0,76.14,75.52 ,33.33
03,010,01,012,0253,320 ,566,10,576,790,0,3,1,3,0,1,0,76.14,72.91 ,33.33
03,010,01,012,0253,321 ,279,6,285,448,0,3,1,3,0,1,0,76.14,63.62 ,33.33
03,010,01,012,0254,322 ,901,18,919,1372,0,3,1,3,0,1,0,76.14,66.98 ,33.33
03,010,01,012,0254,323 ,493,12,505,791,0,3,1,3,0,1,0,76.14,63.84 ,33.33
03,010,01,012,0255,324 ,1095,21,1116,1770,0,3,1,3,0,1,0,76.14,63.05 ,33.33
03,010,01,012,0256,325 ,1186,24,1210,1802,0,3,1,3,0,1,0,76.14,67.15 ,33.33
03,010,01,012,0257,326 ,605,9,614,990,0,3,1,3,0,1,0,76.14,62.02 ,33.33
03,010,01,012,0258,327 ,998,24,1022,1707,0,3,1,3,0,1,0,76.14,59.87 ,33.33
03,010,01,012,0258,328 ,977,17,994,1758,0,3,1,3,0,1,0,76.14,56.54 ,33.33
03,010,01,012,0259,329 ,774,17,791,1292,0,3,1,3,0,1,0,76.14,61.22 ,33.33
03,010,01,012,0259,330 ,913,13,926,1540,0,3,1,3,0,1,0,76.14,60.13 ,33.33
03,010,01,012,0260,331 ,524,8,532,755,0,3,1,3,0,1,0,76.14,70.46 ,33.33
03,010,01,012,0261,332 ,1165,25,1190,1822,0,3,1,3,0,1,0,76.14,65.31 ,33.33
03,010,01,012,0262,333 ,1165,26,1191,1831,0,3,1,3,0,1,0,76.14,65.05 ,33.33
03,010,01,012,0263,334 ,545,15,560,801,0,3,1,3,0,1,0,76.14,69.91 ,33.33
03,010,01,012,0264,335 ,727,17,744,1055,0,3,1,3,0,1,0,76.14,70.52 ,33.33
03,010,01,012,0265,336 ,769,17,786,1301,0,3,1,3,0,1,0,76.14,60.42 ,33.33
03,010,01,013,0266,337 ,997,21,1018,1606,0,3,1,3,0,1,0,76.14,63.39 ,33.33
03,010,01,013,0267,338 ,561,11,572,816,0,3,1,3,0,1,0,76.14,70.10 ,33.33
03,010,01,013,0268,339 ,466,13,479,734,0,3,1,3,0,1,0,76.14,65.26 ,33.33
03,010,01,013,0269,340 ,524,7,531,850,0,3,1,3,0,1,0,76.14,62.47 ,33.33
03,010,01,013,0270,341 ,792,9,801,1347,0,3,1,3,0,1,0,76.14,59.47 ,33.33
03,010,01,013,0271,342 ,631,15,646,1043,0,3,1,3,0,1,0,76.14,61.94 ,33.33
03,010,01,013,0271,343 ,862,10,872,1501,0,3,1,3,0,1,0,76.14,58.09 ,33.33
03,010,01,013,0272,344 ,664,16,680,1118,0,3,1,3,0,1,0,76.14,60.82 ,33.33
03,010,01,013,0272,345 ,874,13,887,1418,0,3,1,3,0,1,0,76.14,62.55 ,33.33
03,010,01,013,0273,346 ,1087,14,1101,1728,0,3,1,3,0,1,0,76.14,63.72 ,33.33
03,010,01,013,0273,347 ,944,11,955,1669,0,3,1,3,0,1,0,76.14,57.22 ,33.33
03,010,01,013,0273,348 ,1205,15,1220,1901,0,3,1,3,0,1,0,76.14,64.18 ,33.33
03,010,01,013,0274,349 ,1225,26,1251,2169,0,3,1,3,0,1,0,76.14,57.68 ,33.33
03,010,01,013,0274,350 ,818,14,832,1496,0,3,1,3,0,1,0,76.14,55.61 ,33.33
03,010,01,013,0274,351 ,634,22,656,1097,0,3,1,3,0,1,0,76.14,59.80 ,33.33
03,010,01,013,0275,352 ,1046,13,1059,1698,0,3,1,3,0,1,0,76.14,62.37 ,33.33
03,010,01,013,0276,353 ,847,7,854,1295,0,3,1,3,0,1,0,76.14,65.95 ,33.33
03,010,01,013,0277,354 ,961,15,976,1588,0,3,1,3,0,1,0,76.14,61.46 ,33.33
03,010,01,013,0277,355 ,289,3,292,472,0,3,1,3,0,1,0,76.14,61.86 ,33.33
03,010,01,013,0278,356 ,662,12,674,1068,0,3,1,3,0,1,0,76.14,63.11 ,33.33
03,010,01,013,0279,357 ,567,6,573,876,0,3,1,3,0,1,0,76.14,65.41 ,33.33
03,010,01,013,0279,358 ,212,1,213,309,0,3,1,3,0,1,0,76.14,68.93 ,33.33
03,010,01,013,0280,359 ,663,9,672,938,0,3,1,3,0,1,0,76.14,71.64 ,33.33
03,010,01,013,0281,360 ,812,10,822,1267,0,3,1,3,0,1,0,76.14,64.88 ,33.33
03,010,01,013,0281,361 ,414,4,418,674,0,3,1,3,0,1,0,76.14,62.02 ,33.33
03,010,01,013,0282,362 ,532,10,542,736,0,3,1,3,0,1,0,76.14,73.64 ,33.33
03,010,01,013,0283,363 ,419,6,425,627,0,3,1,3,0,1,0,76.14,67.78 ,33.33
03,010,01,013,0284,364 ,498,4,502,707,0,3,1,3,0,1,0,76.14,71.00 ,33.33
03,010,01,013,0285,365 ,378,2,380,539,0,3,1,3,0,1,0,76.14,70.50 ,33.33
03,010,01,013,0285,366 ,376,6,382,578,0,3,1,3,0,1,0,76.14,66.09 ,33.33
03,010,01,013,0286,367 ,207,3,210,331,0,3,1,3,0,1,0,76.14,63.44 ,33.33
03,010,01,013,0287,368 ,234,0,234,323,0,3,1,3,0,1,0,76.14,72.45 ,33.33
03,010,01,014,0288,369 ,727,13,740,1157,0,3,1,3,0,1,0,76.14,63.96 ,33.33
03,010,01,014,0288,370 ,692,14,706,1043,0,3,1,3,0,1,0,76.14,67.69 ,33.33
03,010,01,014,0289,371 ,1153,23,1176,1866,0,3,1,3,0,1,0,76.14,63.02 ,33.33
03,010,01,014,0290,372 ,522,6,528,764,0,3,1,3,0,1,0,76.14,69.11 ,33.33
03,010,01,014,0291,373 ,587,6,593,868,0,3,1,3,0,1,0,76.14,68.32 ,33.33
03,010,01,014,0292,374 ,840,12,852,1293,0,3,1,3,0,1,0,76.14,65.89 ,33.33
03,010,01,014,0293,375 ,416,5,421,545,0,3,1,3,0,1,0,76.14,77.25 ,33.33
03,010,01,014,0294,376 ,652,4,656,1049,0,3,1,3,0,1,0,76.14,62.54 ,33.33
03,010,01,014,0295,377 ,753,9,762,1174,0,3,1,3,0,1,0,76.14,64.91 ,33.33
03,010,01,014,0295,378 ,1095,12,1107,1788,0,3,1,3,0,1,0,76.14,61.91 ,33.33
03,010,01,014,0295,379 ,981,21,1002,1679,0,3,1,3,0,1,0,76.14,59.68 ,33.33
03,010,01,014,0296,380 ,802,14,816,1265,0,3,1,3,0,1,0,76.14,64.51 ,33.33
03,010,01,014,0297,381 ,830,7,837,1296,0,3,1,3,0,1,0,76.14,64.58 ,33.33
03,010,01,014,0298,382 ,1008,12,1020,1591,0,3,1,3,0,1,0,76.14,64.11 ,33.33
03,010,01,014,0299,383 ,478,5,483,688,0,3,1,3,0,1,0,76.14,70.20 ,33.33
03,010,01,014,0299,384 ,662,9,671,1036,0,3,1,3,0,1,0,76.14,64.77 ,33.33
03,010,01,014,0300,385 ,474,9,483,705,0,3,1,3,0,1,0,76.14,68.51 ,33.33
03,010,01,014,0300,386 ,246,1,247,363,0,3,1,3,0,1,0,76.14,68.04 ,33.33
03,010,01,014,0301,387 ,470,10,480,773,0,3,1,3,0,1,0,76.14,62.10 ,33.33
03,010,01,014,0302,388 ,334,4,338,518,0,3,1,3,0,1,0,76.14,65.25 ,33.33
03,010,01,014,0302,389 ,264,2,266,386,0,3,1,3,0,1,0,76.14,68.91 ,33.33
03,010,01,014,0303,390 ,403,4,407,586,0,3,1,3,0,1,0,76.14,69.45 ,33.33
03,010,01,014,0304,391 ,156,0,156,244,0,3,1,3,0,1,0,76.14,63.93 ,33.33
03,010,01,014,0304,392 ,917,9,926,1401,0,3,1,3,0,1,0,76.14,66.10 ,33.33
03,010,01,014,0305,393 ,476,5,481,751,0,3,1,3,0,1,0,76.14,64.05 ,33.33
03,010,01,014,0306,394 ,321,0,321,480,0,3,1,3,0,1,0,76.14,66.88 ,33.33
03,010,01,014,0307,395 ,616,9,625,924,0,3,1,3,0,1,0,76.14,67.64 ,33.33
03,010,01,014,0307,396 ,583,5,588,906,0,3,1,3,0,1,0,76.14,64.90 ,33.33
03,010,01,014,0308,397 ,557,8,565,890,0,3,1,3,0,1,0,76.14,63.48 ,33.33
03,010,01,014,0308,398 ,85,0,85,126,0,3,1,3,0,1,0,76.14,67.46 ,33.33
03,010,01,014,0309,399 ,163,2,165,298,0,3,1,3,0,1,0,76.14,55.37 ,33.33
03,010,01,014,0310,400 ,225,5,230,397,0,3,1,3,0,1,0,76.14,57.93 ,33.33
03,010,01,014,0310,401 ,275,5,280,383,0,3,1,3,0,1,0,76.14,73.11 ,33.33
03,010,01,014,0311,402 ,292,4,296,444,0,3,1,3,0,1,0,76.14,66.67 ,33.33
03,010,01,014,0311,403 ,169,1,170,300,0,3,1,3,0,1,0,76.14,56.67 ,33.33
03,010,01,015,0312,404 ,720,14,734,1130,0,3,1,3,0,1,0,76.14,64.96 ,33.33
03,010,01,015,0312,405 ,746,7,753,1241,0,3,1,3,0,1,0,76.14,60.68 ,33.33
03,010,01,015,0313,406 ,667,9,676,997,0,3,1,3,0,1,0,76.14,67.80 ,33.33
03,010,01,015,0314,407 ,751,6,757,1163,0,3,1,3,0,1,0,76.14,65.09 ,33.33
03,010,01,015,0314,408 ,781,15,796,1233,0,3,1,3,0,1,0,76.14,64.56 ,33.33
03,010,01,015,0314,409 ,817,7,824,1336,0,3,1,3,0,1,0,76.14,61.68 ,33.33
03,010,01,015,0315,410 ,402,5,407,620,0,3,1,3,0,1,0,76.14,65.65 ,33.33
03,010,01,015,0316,411 ,325,4,329,501,0,3,1,3,0,1,0,76.14,65.67 ,33.33
03,010,01,015,0317,412 ,435,6,441,669,0,3,1,3,0,1,0,76.14,65.92 ,33.33
03,010,01,015,0318,413 ,433,1,434,573,0,3,1,3,0,1,0,76.14,75.74 ,33.33
03,010,01,015,0319,414 ,1080,24,1104,1707,0,3,1,3,0,1,0,76.14,64.67 ,33.33
03,010,01,015,0320,415 ,541,5,546,934,0,3,1,3,0,1,0,76.14,58.46 ,33.33
03,010,01,015,0321,416 ,292,7,299,503,0,3,1,3,0,1,0,76.14,59.44 ,33.33
03,010,01,015,0322,417 ,281,3,284,456,0,3,1,3,0,1,0,76.14,62.28 ,33.33
03,010,01,015,0323,418 ,315,4,319,497,0,3,1,3,0,1,0,76.14,64.19 ,33.33
03,010,01,015,0324,419 ,278,6,284,395,0,3,1,3,0,1,0,76.14,71.90 ,33.33
03,010,01,015,0325,420 ,264,6,270,478,0,3,1,3,0,1,0,76.14,56.49 ,33.33
03,010,01,015,0326,421 ,187,0,187,291,0,3,1,3,0,1,0,76.14,64.26 ,33.33
03,010,01,015,0327,422 ,454,7,461,743,0,3,1,3,0,1,0,76.14,62.05 ,33.33
03,010,01,015,0328,423 ,493,8,501,736,0,3,1,3,0,1,0,76.14,68.07 ,33.33
03,010,01,015,0329,424 ,366,11,377,580,0,3,1,3,0,1,0,76.14,65.00 ,33.33
03,010,01,015,0329,425 ,307,1,308,441,0,3,1,3,0,1,0,76.14,69.84 ,33.33
03,010,01,016,0330,426 ,669,13,682,994,0,3,1,3,0,1,0,76.14,68.61 ,33.33
03,010,01,016,0331,427 ,236,4,240,389,0,3,1,3,0,1,0,76.14,61.70 ,33.33
03,010,01,016,0332,428 ,532,6,538,799,0,3,1,3,0,1,0,76.14,67.33 ,33.33
03,010,01,016,0333,429 ,1011,24,1035,1604,0,3,1,3,0,1,0,76.14,64.53 ,33.33
03,010,01,016,0334,430 ,551,13,564,815,0,3,1,3,0,1,0,76.14,69.20 ,33.33
03,010,01,016,0335,431 ,466,13,479,773,0,3,1,3,0,1,0,76.14,61.97 ,33.33
03,010,01,016,0336,432 ,595,10,605,834,0,3,1,3,0,1,0,76.14,72.54 ,33.33
03,010,01,016,0337,433 ,462,4,466,821,0,3,1,3,0,1,0,76.14,56.76 ,33.33
03,010,01,016,0338,434 ,241,0,241,407,0,3,1,3,0,1,0,76.14,59.21 ,33.33
03,010,01,016,0338,435 ,326,15,341,542,0,3,1,3,0,1,0,76.14,62.92 ,33.33
03,010,01,016,0339,436 ,304,6,310,581,0,3,1,3,0,1,0,76.14,53.36 ,33.33
03,010,01,016,0340,437 ,105,1,106,164,0,3,1,3,0,1,0,76.14,64.63 ,33.33
03,010,01,016,0340,438 ,135,1,136,230,0,3,1,3,0,1,0,76.14,59.13 ,33.33
03,010,01,017,0341,439 ,568,9,577,1043,0,3,1,3,0,1,0,76.14,55.32 ,33.33
03,010,01,017,0342,440 ,131,3,134,243,0,3,1,3,0,1,0,76.14,55.14 ,33.33
03,010,01,017,0342,441 ,132,2,134,227,0,3,1,3,0,1,0,76.14,59.03 ,33.33
03,010,01,017,0343,442 ,116,3,119,173,0,3,1,3,0,1,0,76.14,68.79 ,33.33
03,010,01,017,0343,443 ,121,1,122,169,0,3,1,3,0,1,0,76.14,72.19 ,33.33
03,010,01,017,0344,444 ,209,3,212,361,0,3,1,3,0,1,0,76.14,58.73 ,33.33
03,010,01,017,0344,445 ,92,2,94,155,0,3,1,3,0,1,0,76.14,60.65 ,33.33
03,010,01,017,0344,446 ,103,1,104,244,0,3,1,3,0,1,0,76.14,42.62 ,33.33
03,010,01,017,0345,447 ,204,0,204,368,0,3,1,3,0,1,0,76.14,55.43 ,33.33
03,010,01,018,0346,448 ,187,4,191,333,0,3,1,3,0,1,0,76.14,57.36 ,33.33
03,010,01,018,0347,449 ,95,1,96,163,0,3,1,3,0,1,0,76.14,58.90 ,33.33
03,010,01,018,0348,450 ,102,1,103,216,0,3,1,3,0,1,0,76.14,47.69 ,33.33
03,010,01,018,0349,451 ,120,3,123,227,0,3,1,3,0,1,0,76.14,54.19 ,33.33
03,010,01,018,0349,452 ,29,2,31,72,0,3,1,3,0,1,0,76.14,43.06 ,33.33
03,010,01,018,0350,453 ,165,3,168,254,0,3,1,3,0,1,0,76.14,66.14 ,33.33
03,010,01,018,0351,454 ,17,1,18,25,0,3,1,3,0,1,0,76.14,72.00 ,33.33
03,010,01,018,0352,455 ,170,5,175,254,0,3,1,3,0,1,0,76.14,68.90 ,33.33
03,010,01,018,0353,456 ,59,0,59,116,0,3,1,3,0,1,0,76.14,50.86 ,33.33
03,010,01,018,0354,457 ,6,0,6,18,0,3,1,3,0,1,0,76.14,33.33 ,33.33
03,010,01,018,0355,458 ,9,2,11,26,0,3,1,3,0,1,0,76.14,42.31 ,33.33
03,010,01,018,0356,459 ,10,0,10,22,0,3,1,3,0,1,0,76.14,45.45 ,33.33
03,010,01,018,0357,460 ,56,1,57,94,0,3,1,3,0,1,0,76.14,60.64 ,33.33
03,011,01,001,0001,1 ,896,6,902,1419,0,3,1,3,0,1,0,76.14,63.57 ,33.33
03,011,01,001,0001,2 ,880,10,890,1333,0,3,1,3,0,1,0,76.14,66.77 ,33.33
03,011,01,001,0001,3 ,955,7,962,1481,0,3,1,3,0,1,0,76.14,64.96 ,33.33
03,011,01,001,0002,4 ,791,6,797,1228,0,3,1,3,0,1,0,76.14,64.90 ,33.33
03,011,01,001,0002,5 ,786,8,794,1220,0,3,1,3,0,1,0,76.14,65.08 ,33.33
03,011,01,001,0003,6 ,834,5,839,1317,0,3,1,3,0,1,0,76.14,63.71 ,33.33
03,011,01,001,0003,7 ,848,8,856,1367,0,3,1,3,0,1,0,76.14,62.62 ,33.33
03,011,01,001,0004,8 ,518,6,524,900,0,3,1,3,0,1,0,76.14,58.22 ,33.33
03,011,01,001,0005,9 ,783,10,793,1260,0,3,1,3,0,1,0,76.14,62.94 ,33.33
03,011,01,001,0006,10 ,651,7,658,966,0,3,1,3,0,1,0,76.14,68.12 ,33.33
03,011,01,001,0007,11 ,620,9,629,1060,0,3,1,3,0,1,0,76.14,59.34 ,33.33
03,011,01,001,0007,12 ,624,7,631,998,0,3,1,3,0,1,0,76.14,63.23 ,33.33
03,011,01,001,0007,13 ,719,7,726,1174,0,3,1,3,0,1,0,76.14,61.84 ,33.33
03,011,01,001,0008,14 ,742,8,750,1149,0,3,1,3,0,1,0,76.14,65.27 ,33.33
03,011,01,001,0008,15 ,696,12,708,1182,0,3,1,3,0,1,0,76.14,59.90 ,33.33
03,011,01,001,0008,16 ,752,9,761,1167,0,3,1,3,0,1,0,76.14,65.21 ,33.33
03,011,01,001,0008,17 ,663,12,675,1061,0,3,1,3,0,1,0,76.14,63.62 ,33.33
03,011,01,001,0008,18 ,950,9,959,1430,0,3,1,3,0,1,0,76.14,67.06 ,33.33
03,011,01,001,0009,19 ,628,8,636,1010,0,3,1,3,0,1,0,76.14,62.97 ,33.33
03,011,01,001,0010,20 ,886,16,902,1422,0,3,1,3,0,1,0,76.14,63.43 ,33.33
03,011,01,001,0011,21 ,309,4,313,470,0,3,1,3,0,1,0,76.14,66.60 ,33.33
03,011,01,001,0012,22 ,783,10,793,1165,0,3,1,3,0,1,0,76.14,68.07 ,33.33
03,011,01,001,0012,23 ,751,13,764,1241,0,3,1,3,0,1,0,76.14,61.56 ,33.33
03,011,01,001,0013,24 ,979,5,984,1535,0,3,1,3,0,1,0,76.14,64.10 ,33.33
03,011,01,001,0014,25 ,896,10,906,1490,0,3,1,3,0,1,0,76.14,60.81 ,33.33
03,011,01,001,0014,26 ,905,10,915,1485,0,3,1,3,0,1,0,76.14,61.62 ,33.33
03,011,01,001,0015,27 ,956,3,959,1526,0,3,1,3,0,1,0,76.14,62.84 ,33.33
03,011,01,001,0015,28 ,1007,13,1020,1661,0,3,1,3,0,1,0,76.14,61.41 ,33.33
03,011,01,001,0016,29 ,773,10,783,1181,0,3,1,3,0,1,0,76.14,66.30 ,33.33
03,011,01,001,0016,30 ,774,9,783,1285,0,3,1,3,0,1,0,76.14,60.93 ,33.33
03,011,01,001,0017,31 ,637,11,648,1040,0,3,1,3,0,1,0,76.14,62.31 ,33.33
03,011,01,001,0017,32 ,698,14,712,1185,0,3,1,3,0,1,0,76.14,60.08 ,33.33
03,011,01,001,0017,33 ,958,13,971,1572,0,3,1,3,0,1,0,76.14,61.77 ,33.33
03,011,01,001,0018,34 ,993,12,1005,1583,0,3,1,3,0,1,0,76.14,63.49 ,33.33
03,011,01,001,0019,35 ,796,11,807,1239,0,3,1,3,0,1,0,76.14,65.13 ,33.33
03,011,01,001,0020,36 ,889,14,903,1464,0,3,1,3,0,1,0,76.14,61.68 ,33.33
03,011,01,001,0021,37 ,1007,16,1023,1508,0,3,1,3,0,1,0,76.14,67.84 ,33.33
03,011,01,001,0022,38 ,884,12,896,1356,0,3,1,3,0,1,0,76.14,66.08 ,33.33
03,011,01,001,0022,39 ,875,12,887,1435,0,3,1,3,0,1,0,76.14,61.81 ,33.33
03,011,01,001,0023,40 ,935,17,952,1466,0,3,1,3,0,1,0,76.14,64.94 ,33.33
03,011,01,001,0024,41 ,232,1,233,359,0,3,1,3,0,1,0,76.14,64.90 ,33.33
03,011,01,001,0025,42 ,322,5,327,457,0,3,1,3,0,1,0,76.14,71.55 ,33.33
03,011,01,001,0026,43 ,490,4,494,743,0,3,1,3,0,1,0,76.14,66.49 ,33.33
03,011,01,001,0027,44 ,630,9,639,996,0,3,1,3,0,1,0,76.14,64.16 ,33.33
03,011,01,001,0028,45 ,388,5,393,584,0,3,1,3,0,1,0,76.14,67.29 ,33.33
03,011,01,002,0029,46 ,536,7,543,878,0,3,1,3,0,1,0,76.14,61.85 ,33.33
03,011,01,002,0029,47 ,307,8,315,463,0,3,1,3,0,1,0,76.14,68.03 ,33.33
03,011,01,002,0030,48 ,367,0,367,549,0,3,1,3,0,1,0,76.14,66.85 ,33.33
03,011,01,002,0031,49 ,259,2,261,386,0,3,1,3,0,1,0,76.14,67.62 ,33.33
03,011,01,002,0032,50 ,378,4,382,556,0,3,1,3,0,1,0,76.14,68.71 ,33.33
03,011,01,002,0033,51 ,376,3,379,541,0,3,1,3,0,1,0,76.14,70.06 ,33.33
03,011,01,002,0034,52 ,239,4,243,392,0,3,1,3,0,1,0,76.14,61.99 ,33.33
03,011,01,002,0035,53 ,519,7,526,785,0,3,1,3,0,1,0,76.14,67.01 ,33.33
03,011,01,002,0036,54 ,402,8,410,682,0,3,1,3,0,1,0,76.14,60.12 ,33.33
03,011,01,002,0036,55 ,741,10,751,1205,0,3,1,3,0,1,0,76.14,62.32 ,33.33
03,011,01,002,0036,56 ,713,9,722,1231,0,3,1,3,0,1,0,76.14,58.65 ,33.33
03,011,01,002,0037,57 ,477,3,480,753,0,3,1,3,0,1,0,76.14,63.75 ,33.33
03,011,01,002,0038,58 ,611,10,621,1000,0,3,1,3,0,1,0,76.14,62.10 ,33.33
03,011,01,002,0039,59 ,602,7,609,1009,0,3,1,3,0,1,0,76.14,60.36 ,33.33
03,011,01,002,0039,60 ,773,10,783,1160,0,3,1,3,0,1,0,76.14,67.50 ,33.33
03,011,01,002,0039,61 ,708,8,716,1038,0,3,1,3,0,1,0,76.14,68.98 ,33.33
03,011,01,002,0040,62 ,414,1,415,696,0,3,1,3,0,1,0,76.14,59.63 ,33.33
03,011,01,002,0041,63 ,483,11,494,787,0,3,1,3,0,1,0,76.14,62.77 ,33.33
03,011,01,002,0042,64 ,560,3,563,854,0,3,1,3,0,1,0,76.14,65.93 ,33.33
03,011,01,002,0042,65 ,480,5,485,766,0,3,1,3,0,1,0,76.14,63.32 ,33.33
03,011,01,002,0043,66 ,339,6,345,512,0,3,1,3,0,1,0,76.14,67.38 ,33.33
03,011,01,002,0044,67 ,216,5,221,284,0,3,1,3,0,1,0,76.14,77.82 ,33.33
03,011,01,002,0045,68 ,420,8,428,702,0,3,1,3,0,1,0,76.14,60.97 ,33.33
03,011,01,002,0046,69 ,298,5,303,497,0,3,1,3,0,1,0,76.14,60.97 ,33.33
03,011,01,002,0047,70 ,562,8,570,805,0,3,1,3,0,1,0,76.14,70.81 ,33.33
03,011,01,002,0048,71 ,288,4,292,437,0,3,1,3,0,1,0,76.14,66.82 ,33.33
03,011,01,002,0049,72 ,192,3,195,274,0,3,1,3,0,1,0,76.14,71.17 ,33.33
03,011,01,002,0050,73 ,277,4,281,375,0,3,1,3,0,1,0,76.14,74.93 ,33.33
03,011,01,002,0051,74 ,251,3,254,412,0,3,1,3,0,1,0,76.14,61.65 ,33.33
03,011,01,002,0052,75 ,367,8,375,573,0,3,1,3,0,1,0,76.14,65.45 ,33.33
03,011,01,002,0053,76 ,661,5,666,941,0,3,1,3,0,1,0,76.14,70.78 ,33.33
03,011,01,003,0054,77 ,815,10,825,1266,0,3,1,3,0,1,0,76.14,65.17 ,33.33
03,011,01,003,0054,78 ,397,5,402,610,0,3,1,3,0,1,0,76.14,65.90 ,33.33
03,011,01,003,0055,79 ,952,10,962,1564,0,3,1,3,0,1,0,76.14,61.51 ,33.33
03,011,01,003,0055,80 ,781,3,784,1188,0,3,1,3,0,1,0,76.14,65.99 ,33.33
03,011,01,003,0056,81 ,910,13,923,1455,0,3,1,3,0,1,0,76.14,63.44 ,33.33
03,011,01,003,0057,82 ,964,11,975,1514,0,3,1,3,0,1,0,76.14,64.40 ,33.33
03,011,01,003,0058,83 ,530,11,541,864,0,3,1,3,0,1,0,76.14,62.62 ,33.33
03,011,01,003,0059,84 ,824,16,840,1369,0,3,1,3,0,1,0,76.14,61.36 ,33.33
03,011,01,003,0060,85 ,298,4,302,477,0,3,1,3,0,1,0,76.14,63.31 ,33.33
03,011,01,003,0061,86 ,369,7,376,621,0,3,1,3,0,1,0,76.14,60.55 ,33.33
03,011,01,003,0062,87 ,321,2,323,479,0,3,1,3,0,1,0,76.14,67.43 ,33.33
03,011,01,003,0063,88 ,362,9,371,658,0,3,1,3,0,1,0,76.14,56.38 ,33.33
03,011,01,003,0064,89 ,721,7,728,1238,0,3,1,3,0,1,0,76.14,58.80 ,33.33
03,011,01,003,0065,90 ,441,5,446,737,0,3,1,3,0,1,0,76.14,60.52 ,33.33
03,011,01,003,0065,91 ,316,9,325,570,0,3,1,3,0,1,0,76.14,57.02 ,33.33
03,011,01,003,0065,92 ,368,30,398,693,0,3,1,3,0,1,0,76.14,57.43 ,33.33
03,011,01,003,0066,93 ,827,11,838,1242,0,3,1,3,0,1,0,76.14,67.47 ,33.33
03,011,01,003,0067,94 ,876,14,890,1356,0,3,1,3,0,1,0,76.14,65.63 ,33.33
03,011,01,003,0068,95 ,602,10,612,883,0,3,1,3,0,1,0,76.14,69.31 ,33.33
03,011,01,003,0069,96 ,443,8,451,684,0,3,1,3,0,1,0,76.14,65.94 ,33.33
03,011,01,003,0070,97 ,612,10,622,904,0,3,1,3,0,1,0,76.14,68.81 ,33.33
03,011,01,003,0071,98 ,608,8,616,931,0,3,1,3,0,1,0,76.14,66.17 ,33.33
03,011,01,003,0072,99 ,512,8,520,781,0,3,1,3,0,1,0,76.14,66.58 ,33.33
03,011,01,003,0073,100 ,825,13,838,1275,0,3,1,3,0,1,0,76.14,65.73 ,33.33
03,011,01,003,0074,101 ,507,9,516,751,0,3,1,3,0,1,0,76.14,68.71 ,33.33
03,011,01,003,0075,102 ,496,9,505,785,0,3,1,3,0,1,0,76.14,64.33 ,33.33
03,011,01,003,0076,103 ,609,7,616,936,0,3,1,3,0,1,0,76.14,65.81 ,33.33
03,011,01,003,0077,104 ,416,5,421,675,0,3,1,3,0,1,0,76.14,62.37 ,33.33
03,011,01,004,0078,105 ,970,14,984,1481,0,3,1,3,0,1,0,76.14,66.44 ,33.33
03,011,01,004,0079,106 ,529,7,536,796,0,3,1,3,0,1,0,76.14,67.34 ,33.33
03,011,01,004,0079,107 ,666,4,670,945,0,3,1,3,0,1,0,76.14,70.90 ,33.33
03,011,01,004,0080,108 ,482,7,489,702,0,3,1,3,0,1,0,76.14,69.66 ,33.33
03,011,01,004,0081,109 ,794,19,813,1177,0,3,1,3,0,1,0,76.14,69.07 ,33.33
03,011,01,004,0081,110 ,815,16,831,1251,0,3,1,3,0,1,0,76.14,66.43 ,33.33
03,011,01,004,0082,111 ,867,4,871,1253,0,3,1,3,0,1,0,76.14,69.51 ,33.33
03,011,01,004,0083,112 ,309,4,313,466,0,3,1,3,0,1,0,76.14,67.17 ,33.33
03,011,01,004,0083,113 ,230,4,234,314,0,3,1,3,0,1,0,76.14,74.52 ,33.33
03,011,01,004,0084,114 ,567,5,572,760,0,3,1,3,0,1,0,76.14,75.26 ,33.33
03,011,01,004,0084,115 ,493,10,503,721,0,3,1,3,0,1,0,76.14,69.76 ,33.33
03,011,01,004,0085,116 ,1063,15,1078,1486,0,3,1,3,0,1,0,76.14,72.54 ,33.33
03,011,01,004,0085,117 ,222,1,223,297,0,3,1,3,0,1,0,76.14,75.08 ,33.33
03,011,01,004,0086,118 ,924,13,937,1398,0,3,1,3,0,1,0,76.14,67.02 ,33.33
03,011,01,004,0087,119 ,465,4,469,666,0,3,1,3,0,1,0,76.14,70.42 ,33.33
03,011,01,004,0088,120 ,743,10,753,1175,0,3,1,3,0,1,0,76.14,64.09 ,33.33
03,011,01,004,0088,121 ,151,3,154,219,0,3,1,3,0,1,0,76.14,70.32 ,33.33
03,011,01,004,0089,122 ,720,10,730,1086,0,3,1,3,0,1,0,76.14,67.22 ,33.33
03,011,01,004,0089,123 ,114,2,116,156,0,3,1,3,0,1,0,76.14,74.36 ,33.33
03,011,01,004,0090,124 ,626,10,636,972,0,3,1,3,0,1,0,76.14,65.43 ,33.33
03,011,01,004,0090,125 ,331,1,332,495,0,3,1,3,0,1,0,76.14,67.07 ,33.33
03,011,01,004,0090,126 ,134,1,135,196,0,3,1,3,0,1,0,76.14,68.88 ,33.33
03,011,01,005,0091,127 ,464,10,474,699,0,3,1,3,0,1,0,76.14,67.81 ,33.33
03,011,01,005,0091,128 ,549,5,554,809,0,3,1,3,0,1,0,76.14,68.48 ,33.33
03,011,01,005,0092,129 ,507,2,509,747,0,3,1,3,0,1,0,76.14,68.14 ,33.33
03,011,01,005,0092,130 ,358,4,362,535,0,3,1,3,0,1,0,76.14,67.66 ,33.33
03,011,01,005,0093,131 ,653,8,661,1028,0,3,1,3,0,1,0,76.14,64.30 ,33.33
03,011,01,005,0093,132 ,168,1,169,251,0,3,1,3,0,1,0,76.14,67.33 ,33.33
03,011,01,005,0094,133 ,389,5,394,593,0,3,1,3,0,1,0,76.14,66.44 ,33.33
03,011,01,005,0094,134 ,466,13,479,716,0,3,1,3,0,1,0,76.14,66.90 ,33.33
03,011,01,005,0095,135 ,787,12,799,1173,0,3,1,3,0,1,0,76.14,68.12 ,33.33
03,011,01,005,0096,136 ,813,7,820,1240,0,3,1,3,0,1,0,76.14,66.13 ,33.33
03,011,01,005,0097,137 ,481,8,489,806,0,3,1,3,0,1,0,76.14,60.67 ,33.33
03,011,01,005,0098,138 ,350,8,358,499,0,3,1,3,0,1,0,76.14,71.74 ,33.33
03,011,01,005,0099,139 ,306,18,324,565,0,3,1,3,0,1,0,76.14,57.35 ,33.33
03,011,01,005,0100,140 ,519,9,528,809,0,3,1,3,0,1,0,76.14,65.27 ,33.33
03,011,01,005,0101,141 ,305,1,306,450,0,3,1,3,0,1,0,76.14,68.00 ,33.33
03,011,01,005,0102,142 ,389,5,394,592,0,3,1,3,0,1,0,76.14,66.55 ,33.33
03,011,01,005,0102,143 ,354,6,360,547,0,3,1,3,0,1,0,76.14,65.81 ,33.33
03,011,01,005,0103,144 ,351,4,355,538,0,3,1,3,0,1,0,76.14,65.99 ,33.33
03,011,01,005,0104,145 ,673,7,680,1046,0,3,1,3,0,1,0,76.14,65.01 ,33.33
03,011,01,005,0105,146 ,367,4,371,568,0,3,1,3,0,1,0,76.14,65.32 ,33.33
03,011,01,005,0106,147 ,724,9,733,1001,0,3,1,3,0,1,0,76.14,73.23 ,33.33
03,011,01,005,0106,148 ,298,6,304,425,0,3,1,3,0,1,0,76.14,71.53 ,33.33
03,011,01,005,0107,149 ,454,6,460,662,0,3,1,3,0,1,0,76.14,69.49 ,33.33
03,011,01,005,0107,150 ,521,4,525,824,0,3,1,3,0,1,0,76.14,63.71 ,33.33
03,011,01,005,0108,151 ,748,16,764,1195,0,3,1,3,0,1,0,76.14,63.93 ,33.33
03,011,01,005,0109,152 ,483,2,485,697,0,3,1,3,0,1,0,76.14,69.58 ,33.33
03,011,01,005,0109,153 ,444,6,450,673,0,3,1,3,0,1,0,76.14,66.86 ,33.33
03,011,01,005,0110,154 ,758,9,767,1147,0,3,1,3,0,1,0,76.14,66.87 ,33.33
03,011,01,005,0111,155 ,527,13,540,845,0,3,1,3,0,1,0,76.14,63.91 ,33.33
03,011,01,006,0112,156 ,864,11,875,1459,0,3,1,3,0,1,0,76.14,59.97 ,33.33
03,011,01,006,0113,157 ,749,4,753,1164,0,3,1,3,0,1,0,76.14,64.69 ,33.33
03,011,01,006,0113,158 ,734,8,742,1163,0,3,1,3,0,1,0,76.14,63.80 ,33.33
03,011,01,006,0114,159 ,952,14,966,1571,0,3,1,3,0,1,0,76.14,61.49 ,33.33
03,011,01,006,0115,160 ,595,9,604,945,0,3,1,3,0,1,0,76.14,63.92 ,33.33
03,011,01,006,0116,161 ,656,4,660,1175,0,3,1,3,0,1,0,76.14,56.17 ,33.33
03,011,01,006,0117,162 ,517,9,526,780,0,3,1,3,0,1,0,76.14,67.44 ,33.33
03,011,01,006,0117,163 ,424,4,428,604,0,3,1,3,0,1,0,76.14,70.86 ,33.33
03,011,01,006,0118,164 ,561,7,568,908,0,3,1,3,0,1,0,76.14,62.56 ,33.33
03,011,01,006,0119,165 ,559,4,563,808,0,3,1,3,0,1,0,76.14,69.68 ,33.33
03,011,01,006,0119,166 ,718,4,722,1066,0,3,1,3,0,1,0,76.14,67.73 ,33.33
03,011,01,006,0120,167 ,349,6,355,517,0,3,1,3,0,1,0,76.14,68.67 ,33.33
03,011,01,006,0121,168 ,280,1,281,499,0,3,1,3,0,1,0,76.14,56.31 ,33.33
03,011,01,006,0122,169 ,249,3,252,396,0,3,1,3,0,1,0,76.14,63.64 ,33.33
03,011,01,006,0123,170 ,582,7,589,986,0,3,1,3,0,1,0,76.14,59.74 ,33.33
03,011,01,006,0123,171 ,782,7,789,1273,0,3,1,3,0,1,0,76.14,61.98 ,33.33
03,011,01,006,0124,172 ,414,1,415,776,0,3,1,3,0,1,0,76.14,53.48 ,33.33
03,011,01,006,0125,173 ,668,4,672,1130,0,3,1,3,0,1,0,76.14,59.47 ,33.33
03,011,01,006,0126,174 ,679,7,686,1116,0,3,1,3,0,1,0,76.14,61.47 ,33.33
03,011,01,006,0127,175 ,584,3,587,949,0,3,1,3,0,1,0,76.14,61.85 ,33.33
03,011,01,007,0128,176 ,466,2,468,632,0,3,1,3,0,1,0,76.14,74.05 ,33.33
03,011,01,007,0129,177 ,422,2,424,614,0,3,1,3,0,1,0,76.14,69.06 ,33.33
03,011,01,007,0130,178 ,801,11,812,1112,0,3,1,3,0,1,0,76.14,73.02 ,33.33
03,011,01,007,0130,179 ,612,1,613,910,0,3,1,3,0,1,0,76.14,67.36 ,33.33
03,011,01,007,0131,180 ,765,9,774,1108,0,3,1,3,0,1,0,76.14,69.86 ,33.33
03,011,01,007,0131,181 ,748,12,760,1187,0,3,1,3,0,1,0,76.14,64.03 ,33.33
03,011,01,007,0132,182 ,965,7,972,1393,0,3,1,3,0,1,0,76.14,69.78 ,33.33
03,011,01,007,0133,183 ,624,3,627,933,0,3,1,3,0,1,0,76.14,67.20 ,33.33
03,011,01,007,0133,184 ,618,6,624,932,0,3,1,3,0,1,0,76.14,66.95 ,33.33
03,011,01,007,0134,185 ,915,14,929,1320,0,3,1,3,0,1,0,76.14,70.38 ,33.33
03,011,01,007,0135,186 ,699,4,703,1013,0,3,1,3,0,1,0,76.14,69.40 ,33.33
03,011,01,007,0136,187 ,950,11,961,1432,0,3,1,3,0,1,0,76.14,67.11 ,33.33
03,011,01,007,0136,188 ,995,4,999,1450,0,3,1,3,0,1,0,76.14,68.90 ,33.33
03,011,01,007,0137,189 ,825,9,834,1151,0,3,1,3,0,1,0,76.14,72.46 ,33.33
03,011,01,007,0138,190 ,891,9,900,1359,0,3,1,3,0,1,0,76.14,66.23 ,33.33
03,011,01,007,0138,191 ,743,8,751,1079,0,3,1,3,0,1,0,76.14,69.60 ,33.33
03,011,01,007,0139,192 ,469,3,472,645,0,3,1,3,0,1,0,76.14,73.18 ,33.33
03,011,01,007,0140,193 ,551,9,560,722,0,3,1,3,0,1,0,76.14,77.56 ,33.33
03,011,01,007,0141,194 ,465,7,472,675,0,3,1,3,0,1,0,76.14,69.93 ,33.33
03,011,01,007,0141,195 ,1082,13,1095,1570,0,3,1,3,0,1,0,76.14,69.75 ,33.33
03,011,01,007,0142,196 ,1040,9,1049,1466,0,3,1,3,0,1,0,76.14,71.56 ,33.33
03,011,01,007,0143,197 ,662,6,668,912,0,3,1,3,0,1,0,76.14,73.25 ,33.33
03,011,01,007,0144,198 ,966,14,980,1298,0,3,1,3,0,1,0,76.14,75.50 ,33.33
03,011,01,007,0145,199 ,395,4,399,514,0,3,1,3,0,1,0,76.14,77.63 ,33.33
03,011,01,007,0146,200 ,739,6,745,977,0,3,1,3,0,1,0,76.14,76.25 ,33.33
03,011,01,007,0147,201 ,404,3,407,537,0,3,1,3,0,1,0,76.14,75.79 ,33.33
03,011,01,007,0148,202 ,740,12,752,1104,0,3,1,3,0,1,0,76.14,68.12 ,33.33
03,011,01,007,0149,203 ,731,5,736,1021,0,3,1,3,0,1,0,76.14,72.09 ,33.33
03,011,01,007,0150,204 ,433,4,437,602,0,3,1,3,0,1,0,76.14,72.59 ,33.33
03,011,01,007,0151,205 ,464,4,468,673,0,3,1,3,0,1,0,76.14,69.54 ,33.33
03,011,01,007,0152,206 ,496,6,502,710,0,3,1,3,0,1,0,76.14,70.70 ,33.33
03,011,01,007,0153,207 ,666,9,675,895,0,3,1,3,0,1,0,76.14,75.42 ,33.33
03,011,01,007,0154,208 ,619,7,626,813,0,3,1,3,0,1,0,76.14,77.00 ,33.33
03,011,01,007,0155,209 ,578,8,586,802,0,3,1,3,0,1,0,76.14,73.07 ,33.33
03,011,01,007,0156,210 ,818,12,830,1120,0,3,1,3,0,1,0,76.14,74.11 ,33.33
03,011,01,008,0157,211 ,680,2,682,980,0,3,1,3,0,1,0,76.14,69.59 ,33.33
03,011,01,008,0158,212 ,877,10,887,1295,0,3,1,3,0,1,0,76.14,68.49 ,33.33
03,011,01,008,0158,213 ,840,8,848,1287,0,3,1,3,0,1,0,76.14,65.89 ,33.33
03,011,01,008,0159,214 ,756,10,766,1149,0,3,1,3,0,1,0,76.14,66.67 ,33.33
03,011,01,008,0160,215 ,1032,14,1046,1514,0,3,1,3,0,1,0,76.14,69.09 ,33.33
03,011,01,008,0161,216 ,692,8,700,1023,0,3,1,3,0,1,0,76.14,68.43 ,33.33
03,011,01,008,0161,217 ,699,6,705,1056,0,3,1,3,0,1,0,76.14,66.76 ,33.33
03,011,01,008,0162,218 ,710,4,714,1066,0,3,1,3,0,1,0,76.14,66.98 ,33.33
03,011,01,008,0162,219 ,711,9,720,1073,0,3,1,3,0,1,0,76.14,67.10 ,33.33
03,011,01,008,0163,220 ,570,3,573,785,0,3,1,3,0,1,0,76.14,72.99 ,33.33
03,011,01,008,0164,221 ,550,10,560,766,0,3,1,3,0,1,0,76.14,73.11 ,33.33
03,011,01,008,0165,222 ,830,13,843,1189,0,3,1,3,0,1,0,76.14,70.90 ,33.33
03,011,01,008,0166,223 ,790,10,800,1107,0,3,1,3,0,1,0,76.14,72.27 ,33.33
03,011,01,008,0167,224 ,718,3,721,993,0,3,1,3,0,1,0,76.14,72.61 ,33.33
03,011,01,008,0167,225 ,553,10,563,823,0,3,1,3,0,1,0,76.14,68.41 ,33.33
03,011,01,008,0168,226 ,640,8,648,893,0,3,1,3,0,1,0,76.14,72.56 ,33.33
03,011,01,008,0169,227 ,883,9,892,1317,0,3,1,3,0,1,0,76.14,67.73 ,33.33
03,011,01,008,0170,228 ,836,10,846,1181,0,3,1,3,0,1,0,76.14,71.63 ,33.33
03,011,01,008,0171,229 ,852,15,867,1245,0,3,1,3,0,1,0,76.14,69.64 ,33.33
03,011,01,009,0172,230 ,956,13,969,1422,0,3,1,3,0,1,0,76.14,68.14 ,33.33
03,011,01,009,0172,231 ,893,8,901,1325,0,3,1,3,0,1,0,76.14,68.00 ,33.33
03,011,01,009,0173,232 ,856,12,868,1303,0,3,1,3,0,1,0,76.14,66.62 ,33.33
03,011,01,009,0173,233 ,723,6,729,1160,0,3,1,3,0,1,0,76.14,62.84 ,33.33
03,011,01,009,0174,234 ,900,7,907,1336,0,3,1,3,0,1,0,76.14,67.89 ,33.33
03,011,01,009,0175,235 ,696,6,702,1040,0,3,1,3,0,1,0,76.14,67.50 ,33.33
03,011,01,009,0176,236 ,595,8,603,863,0,3,1,3,0,1,0,76.14,69.87 ,33.33
03,011,01,009,0177,237 ,857,12,869,1304,0,3,1,3,0,1,0,76.14,66.64 ,33.33
03,011,01,009,0177,238 ,992,16,1008,1495,0,3,1,3,0,1,0,76.14,67.42 ,33.33
03,011,01,009,0178,239 ,665,7,672,954,0,3,1,3,0,1,0,76.14,70.44 ,33.33
03,011,01,009,0178,240 ,606,12,618,902,0,3,1,3,0,1,0,76.14,68.51 ,33.33
03,011,01,009,0179,241 ,515,8,523,751,0,3,1,3,0,1,0,76.14,69.64 ,33.33
03,011,01,009,0179,242 ,515,9,524,800,0,3,1,3,0,1,0,76.14,65.50 ,33.33
03,011,01,009,0180,243 ,737,12,749,1087,0,3,1,3,0,1,0,76.14,68.91 ,33.33
03,011,01,009,0181,244 ,392,6,398,583,0,3,1,3,0,1,0,76.14,68.27 ,33.33
03,011,01,009,0182,245 ,565,6,571,881,0,3,1,3,0,1,0,76.14,64.81 ,33.33
03,011,01,009,0183,246 ,476,7,483,736,0,3,1,3,0,1,0,76.14,65.63 ,33.33
03,011,01,010,0184,247 ,635,9,644,953,0,3,1,3,0,1,0,76.14,67.58 ,33.33
03,011,01,010,0184,248 ,630,9,639,972,0,3,1,3,0,1,0,76.14,65.74 ,33.33
03,011,01,010,0185,249 ,835,5,840,1231,0,3,1,3,0,1,0,76.14,68.24 ,33.33
03,011,01,010,0185,250 ,746,4,750,1105,0,3,1,3,0,1,0,76.14,67.87 ,33.33
03,011,01,010,0186,251 ,727,13,740,1040,0,3,1,3,0,1,0,76.14,71.15 ,33.33
03,011,01,010,0187,252 ,204,4,208,316,0,3,1,3,0,1,0,76.14,65.82 ,33.33
03,011,01,010,0188,253 ,324,1,325,500,0,3,1,3,0,1,0,76.14,65.00 ,33.33
03,011,01,010,0189,254 ,606,7,613,905,0,3,1,3,0,1,0,76.14,67.73 ,33.33
03,011,01,010,0189,255 ,651,3,654,929,0,3,1,3,0,1,0,76.14,70.40 ,33.33
03,011,01,010,0190,256 ,497,9,506,797,0,3,1,3,0,1,0,76.14,63.49 ,33.33
03,011,01,010,0190,257 ,746,9,755,1018,0,3,1,3,0,1,0,76.14,74.17 ,33.33
03,011,01,010,0190,258 ,698,9,707,984,0,3,1,3,0,1,0,76.14,71.85 ,33.33
03,011,01,010,0191,259 ,711,12,723,1095,0,3,1,3,0,1,0,76.14,66.03 ,33.33
03,011,01,010,0192,260 ,1008,11,1019,1387,0,3,1,3,0,1,0,76.14,73.47 ,33.33
03,011,01,010,0193,261 ,474,7,481,671,0,3,1,3,0,1,0,76.14,71.68 ,33.33
03,011,01,010,0194,262 ,448,5,453,601,0,3,1,3,0,1,0,76.14,75.37 ,33.33
03,011,01,010,0195,263 ,562,5,567,797,0,3,1,3,0,1,0,76.14,71.14 ,33.33
03,011,01,010,0195,264 ,621,8,629,827,0,3,1,3,0,1,0,76.14,76.06 ,33.33
03,011,01,010,0195,265 ,377,10,387,578,0,3,1,3,0,1,0,76.14,66.96 ,33.33
03,011,01,010,0196,266 ,607,8,615,913,0,3,1,3,0,1,0,76.14,67.36 ,33.33
03,011,01,011,0197,267 ,725,11,736,1105,0,3,1,3,0,1,0,76.14,66.61 ,33.33
03,011,01,011,0198,268 ,502,2,504,760,0,3,1,3,0,1,0,76.14,66.32 ,33.33
03,011,01,011,0199,269 ,978,6,984,1524,0,3,1,3,0,1,0,76.14,64.57 ,33.33
03,011,01,011,0200,270 ,746,12,758,1110,0,3,1,3,0,1,0,76.14,68.29 ,33.33
03,011,01,011,0201,271 ,576,8,584,847,0,3,1,3,0,1,0,76.14,68.95 ,33.33
03,011,01,011,0202,272 ,434,6,440,690,0,3,1,3,0,1,0,76.14,63.77 ,33.33
03,011,01,011,0203,273 ,655,4,659,1057,0,3,1,3,0,1,0,76.14,62.35 ,33.33
03,011,01,011,0204,274 ,590,4,594,915,0,3,1,3,0,1,0,76.14,64.92 ,33.33
03,011,01,011,0205,275 ,557,9,566,954,0,3,1,3,0,1,0,76.14,59.33 ,33.33
03,011,01,011,0206,276 ,454,1,455,650,0,3,1,3,0,1,0,76.14,70.00 ,33.33
03,011,01,012,0207,277 ,601,8,609,887,0,3,1,3,0,1,0,76.14,68.66 ,33.33
03,011,01,012,0207,278 ,630,5,635,921,0,3,1,3,0,1,0,76.14,68.95 ,33.33
03,011,01,012,0208,279 ,816,10,826,1194,0,3,1,3,0,1,0,76.14,69.18 ,33.33
03,011,01,012,0208,280 ,1004,12,1016,1443,0,3,1,3,0,1,0,76.14,70.41 ,33.33
03,011,01,012,0209,281 ,724,9,733,1049,0,3,1,3,0,1,0,76.14,69.88 ,33.33
03,011,01,012,0209,282 ,791,5,796,1130,0,3,1,3,0,1,0,76.14,70.44 ,33.33
03,011,01,012,0209,283 ,768,5,773,1079,0,3,1,3,0,1,0,76.14,71.64 ,33.33
03,011,01,012,0209,284 ,850,6,856,1296,0,3,1,3,0,1,0,76.14,66.05 ,33.33
03,011,01,012,0210,285 ,929,9,938,1384,0,3,1,3,0,1,0,76.14,67.77 ,33.33
03,011,01,012,0210,286 ,940,8,948,1377,0,3,1,3,0,1,0,76.14,68.85 ,33.33
03,011,01,012,0210,287 ,827,6,833,1214,0,3,1,3,0,1,0,76.14,68.62 ,33.33
03,011,01,012,0210,288 ,1122,15,1137,1704,0,3,1,3,0,1,0,76.14,66.73 ,33.33
03,011,01,012,0211,289 ,831,12,843,1245,0,3,1,3,0,1,0,76.14,67.71 ,33.33
03,011,01,012,0211,290 ,817,8,825,1202,0,3,1,3,0,1,0,76.14,68.64 ,33.33
03,011,01,012,0211,291 ,839,7,846,1277,0,3,1,3,0,1,0,76.14,66.25 ,33.33
03,011,01,012,0211,292 ,1008,11,1019,1534,0,3,1,3,0,1,0,76.14,66.43 ,33.33
03,011,01,012,0211,293 ,816,5,821,1147,0,3,1,3,0,1,0,76.14,71.58 ,33.33
03,011,01,012,0211,294 ,1203,13,1216,1865,0,3,1,3,0,1,0,76.14,65.20 ,33.33
03,011,01,012,0212,295 ,741,13,754,1021,0,3,1,3,0,1,0,76.14,73.85 ,33.33
03,011,01,012,0212,296 ,722,6,728,1053,0,3,1,3,0,1,0,76.14,69.14 ,33.33
03,011,01,012,0212,297 ,720,3,723,1039,0,3,1,3,0,1,0,76.14,69.59 ,33.33
03,011,01,012,0213,298 ,673,8,681,941,0,3,1,3,0,1,0,76.14,72.37 ,33.33
03,011,01,012,0213,299 ,650,11,661,892,0,3,1,3,0,1,0,76.14,74.10 ,33.33
03,011,01,012,0214,300 ,634,4,638,848,0,3,1,3,0,1,0,76.14,75.24 ,33.33
03,011,01,012,0215,301 ,1059,9,1068,1339,0,3,1,3,0,1,0,76.14,79.76 ,33.33
03,011,01,012,0216,302 ,491,2,493,691,0,3,1,3,0,1,0,76.14,71.35 ,33.33
03,011,01,012,0217,303 ,293,2,295,395,0,3,1,3,0,1,0,76.14,74.68 ,33.33
03,011,01,012,0218,304 ,907,12,919,1355,0,3,1,3,0,1,0,76.14,67.82 ,33.33
03,011,01,012,0219,305 ,474,1,475,644,0,3,1,3,0,1,0,76.14,73.76 ,33.33
03,011,01,012,0220,306 ,588,10,598,830,0,3,1,3,0,1,0,76.14,72.05 ,33.33
03,011,01,012,0221,307 ,684,5,689,970,0,3,1,3,0,1,0,76.14,71.03 ,33.33
03,011,01,012,0222,308 ,757,10,767,1093,0,3,1,3,0,1,0,76.14,70.17 ,33.33
03,011,01,012,0223,309 ,611,6,617,813,0,3,1,3,0,1,0,76.14,75.89 ,33.33
03,011,01,012,0224,310 ,764,6,770,995,0,3,1,3,0,1,0,76.14,77.39 ,33.33
03,011,01,012,0225,311 ,894,11,905,1255,0,3,1,3,0,1,0,76.14,72.11 ,33.33
03,011,01,012,0226,312 ,540,6,546,766,0,3,1,3,0,1,0,76.14,71.28 ,33.33
03,011,01,012,0226,313 ,528,7,535,768,0,3,1,3,0,1,0,76.14,69.66 ,33.33
03,011,01,012,0227,314 ,593,6,599,863,0,3,1,3,0,1,0,76.14,69.41 ,33.33
03,011,01,013,0228,315 ,467,6,473,710,0,3,1,3,0,1,0,76.14,66.62 ,33.33
03,011,01,013,0228,316 ,330,2,332,467,0,3,1,3,0,1,0,76.14,71.09 ,33.33
03,011,01,013,0229,317 ,854,7,861,1307,0,3,1,3,0,1,0,76.14,65.88 ,33.33
03,011,01,013,0230,318 ,350,4,354,503,0,3,1,3,0,1,0,76.14,70.38 ,33.33
03,011,01,013,0231,319 ,607,6,613,870,0,3,1,3,0,1,0,76.14,70.46 ,33.33
03,011,01,013,0232,320 ,432,4,436,625,0,3,1,3,0,1,0,76.14,69.76 ,33.33
03,011,01,013,0233,321 ,794,6,800,1186,0,3,1,3,0,1,0,76.14,67.45 ,33.33
03,011,01,013,0233,322 ,709,4,713,1012,0,3,1,3,0,1,0,76.14,70.45 ,33.33
03,011,01,013,0233,323 ,850,6,856,1326,0,3,1,3,0,1,0,76.14,64.56 ,33.33
03,011,01,013,0234,324 ,958,14,972,1481,0,3,1,3,0,1,0,76.14,65.63 ,33.33
03,011,01,013,0235,325 ,540,7,547,785,0,3,1,3,0,1,0,76.14,69.68 ,33.33
03,011,01,013,0235,326 ,373,2,375,537,0,3,1,3,0,1,0,76.14,69.83 ,33.33
03,011,01,013,0236,327 ,439,5,444,641,0,3,1,3,0,1,0,76.14,69.27 ,33.33
03,011,01,013,0236,328 ,483,5,488,768,0,3,1,3,0,1,0,76.14,63.54 ,33.33
03,011,01,013,0237,329 ,404,2,406,559,0,3,1,3,0,1,0,76.14,72.63 ,33.33
03,011,01,013,0238,330 ,363,1,364,521,0,3,1,3,0,1,0,76.14,69.87 ,33.33
03,011,01,013,0239,331 ,566,3,569,834,0,3,1,3,0,1,0,76.14,68.23 ,33.33
03,011,01,013,0240,332 ,211,5,216,327,0,3,1,3,0,1,0,76.14,66.06 ,33.33
03,011,01,013,0241,333 ,446,6,452,662,0,3,1,3,0,1,0,76.14,68.28 ,33.33
03,011,01,013,0242,334 ,210,4,214,336,0,3,1,3,0,1,0,76.14,63.69 ,33.33
03,011,01,013,0243,335 ,298,3,301,423,0,3,1,3,0,1,0,76.14,71.16 ,33.33
03,011,01,013,0244,336 ,324,3,327,505,0,3,1,3,0,1,0,76.14,64.75 ,33.33
03,011,01,013,0245,337 ,217,1,218,332,0,3,1,3,0,1,0,76.14,65.66 ,33.33
03,011,01,013,0246,338 ,377,4,381,570,0,3,1,3,0,1,0,76.14,66.84 ,33.33
03,011,01,013,0246,339 ,210,0,210,315,0,3,1,3,0,1,0,76.14,66.67 ,33.33
03,011,01,013,0247,340 ,291,2,293,444,0,3,1,3,0,1,0,76.14,65.99 ,33.33
03,011,01,013,0248,341 ,694,5,699,1093,0,3,1,3,0,1,0,76.14,63.95 ,33.33
03,011,01,013,0249,342 ,332,7,339,505,0,3,1,3,0,1,0,76.14,67.13 ,33.33
03,011,01,013,0250,343 ,450,10,460,710,0,3,1,3,0,1,0,76.14,64.79 ,33.33
03,011,01,013,0251,344 ,467,4,471,684,0,3,1,3,0,1,0,76.14,68.86 ,33.33
03,011,01,013,0252,345 ,313,3,316,489,0,3,1,3,0,1,0,76.14,64.62 ,33.33
03,011,01,013,0253,346 ,299,3,302,461,0,3,1,3,0,1,0,76.14,65.51 ,33.33
03,011,01,014,0254,347 ,563,4,567,825,0,3,1,3,0,1,0,76.14,68.73 ,33.33
03,011,01,014,0254,348 ,589,13,602,819,0,3,1,3,0,1,0,76.14,73.50 ,33.33
03,011,01,014,0254,349 ,781,6,787,1100,0,3,1,3,0,1,0,76.14,71.55 ,33.33
03,011,01,014,0255,350 ,828,5,833,1223,0,3,1,3,0,1,0,76.14,68.11 ,33.33
03,011,01,014,0255,351 ,672,2,674,930,0,3,1,3,0,1,0,76.14,72.47 ,33.33
03,011,01,014,0255,352 ,906,8,914,1300,0,3,1,3,0,1,0,76.14,70.31 ,33.33
03,011,01,014,0256,353 ,928,19,947,1284,0,3,1,3,0,1,0,76.14,73.75 ,33.33
03,011,01,014,0256,354 ,476,5,481,626,0,3,1,3,0,1,0,76.14,76.84 ,33.33
03,011,01,014,0257,355 ,671,4,675,929,0,3,1,3,0,1,0,76.14,72.66 ,33.33
03,011,01,014,0257,356 ,268,5,273,382,0,3,1,3,0,1,0,76.14,71.47 ,33.33
03,011,01,014,0258,357 ,527,8,535,758,0,3,1,3,0,1,0,76.14,70.58 ,33.33
03,011,01,014,0258,358 ,566,13,579,804,0,3,1,3,0,1,0,76.14,72.01 ,33.33
03,011,01,014,0259,359 ,922,10,932,1316,0,3,1,3,0,1,0,76.14,70.82 ,33.33
03,011,01,014,0260,360 ,891,5,896,1285,0,3,1,3,0,1,0,76.14,69.73 ,33.33
03,011,01,014,0261,361 ,590,9,599,827,0,3,1,3,0,1,0,76.14,72.43 ,33.33
03,011,01,014,0262,362 ,850,9,859,1152,0,3,1,3,0,1,0,76.14,74.57 ,33.33
03,011,01,014,0263,363 ,845,10,855,1171,0,3,1,3,0,1,0,76.14,73.01 ,33.33
03,011,01,014,0264,364 ,665,5,670,876,0,3,1,3,0,1,0,76.14,76.48 ,33.33
03,011,01,014,0265,365 ,531,6,537,727,0,3,1,3,0,1,0,76.14,73.87 ,33.33
03,011,01,014,0266,366 ,284,4,288,407,0,3,1,3,0,1,0,76.14,70.76 ,33.33
03,011,01,015,0267,367 ,370,5,375,537,0,3,1,3,0,1,0,76.14,69.83 ,33.33
03,011,01,015,0268,368 ,463,4,467,743,0,3,1,3,0,1,0,76.14,62.85 ,33.33
03,011,01,015,0269,369 ,411,4,415,511,0,3,1,3,0,1,0,76.14,81.21 ,33.33
03,011,01,015,0270,370 ,548,9,557,817,0,3,1,3,0,1,0,76.14,68.18 ,33.33
03,011,01,015,0271,371 ,663,3,666,939,0,3,1,3,0,1,0,76.14,70.93 ,33.33
03,011,01,015,0272,372 ,375,6,381,550,0,3,1,3,0,1,0,76.14,69.27 ,33.33
03,011,01,015,0273,373 ,301,5,306,458,0,3,1,3,0,1,0,76.14,66.81 ,33.33
03,011,01,015,0274,374 ,544,11,555,784,0,3,1,3,0,1,0,76.14,70.79 ,33.33
03,011,01,015,0275,375 ,531,4,535,796,0,3,1,3,0,1,0,76.14,67.21 ,33.33
03,011,01,015,0275,376 ,620,15,635,884,0,3,1,3,0,1,0,76.14,71.83 ,33.33
03,011,01,015,0276,377 ,284,7,291,382,0,3,1,3,0,1,0,76.14,76.18 ,33.33
03,011,01,015,0277,378 ,563,7,570,882,0,3,1,3,0,1,0,76.14,64.63 ,33.33
03,011,01,015,0278,379 ,550,5,555,822,0,3,1,3,0,1,0,76.14,67.52 ,33.33
03,011,01,015,0279,380 ,885,15,900,1359,0,3,1,3,0,1,0,76.14,66.23 ,33.33
03,011,01,015,0280,381 ,655,7,662,949,0,3,1,3,0,1,0,76.14,69.76 ,33.33
03,011,01,015,0281,382 ,363,5,368,580,0,3,1,3,0,1,0,76.14,63.45 ,33.33
03,011,01,015,0282,383 ,699,4,703,1026,0,3,1,3,0,1,0,76.14,68.52 ,33.33
03,011,01,015,0283,384 ,439,2,441,586,0,3,1,3,0,1,0,76.14,75.26 ,33.33
03,011,01,015,0284,385 ,552,8,560,751,0,3,1,3,0,1,0,76.14,74.57 ,33.33
03,011,01,015,0285,386 ,664,3,667,995,0,3,1,3,0,1,0,76.14,67.04 ,33.33
03,011,01,015,0286,387 ,462,12,474,641,0,3,1,3,0,1,0,76.14,73.95 ,33.33
03,011,01,015,0287,388 ,575,7,582,878,0,3,1,3,0,1,0,76.14,66.29 ,33.33
03,011,01,015,0288,389 ,823,12,835,1170,0,3,1,3,0,1,0,76.14,71.37 ,33.33
03,011,01,015,0288,390 ,402,27,429,639,0,3,1,3,0,1,0,76.14,67.14 ,33.33
03,011,01,015,0289,391 ,881,12,893,1326,0,3,1,3,0,1,0,76.14,67.35 ,33.33
03,011,01,016,0290,392 ,640,3,643,921,0,3,1,3,0,1,0,76.14,69.82 ,33.33
03,011,01,016,0291,393 ,892,6,898,1296,0,3,1,3,0,1,0,76.14,69.29 ,33.33
03,011,01,016,0292,394 ,716,12,728,1038,0,3,1,3,0,1,0,76.14,70.13 ,33.33
03,011,01,016,0293,395 ,352,1,353,514,0,3,1,3,0,1,0,76.14,68.68 ,33.33
03,011,01,016,0293,396 ,629,4,633,963,0,3,1,3,0,1,0,76.14,65.73 ,33.33
03,011,01,016,0294,397 ,409,8,417,594,0,3,1,3,0,1,0,76.14,70.20 ,33.33
03,011,01,016,0294,398 ,233,4,237,326,0,3,1,3,0,1,0,76.14,72.70 ,33.33
03,011,01,016,0295,399 ,426,4,430,582,0,3,1,3,0,1,0,76.14,73.88 ,33.33
03,011,01,016,0295,400 ,316,8,324,447,0,3,1,3,0,1,0,76.14,72.48 ,33.33
03,011,01,016,0296,401 ,437,2,439,659,0,3,1,3,0,1,0,76.14,66.62 ,33.33
03,011,01,016,0296,402 ,258,1,259,388,0,3,1,3,0,1,0,76.14,66.75 ,33.33
03,011,01,016,0297,403 ,509,3,512,793,0,3,1,3,0,1,0,76.14,64.56 ,33.33
03,011,01,016,0298,404 ,441,1,442,644,0,3,1,3,0,1,0,76.14,68.63 ,33.33
03,011,01,016,0299,405 ,450,5,455,718,0,3,1,3,0,1,0,76.14,63.37 ,33.33
03,011,01,016,0300,406 ,254,4,258,390,0,3,1,3,0,1,0,76.14,66.15 ,33.33
03,011,01,016,0300,407 ,161,1,162,219,0,3,1,3,0,1,0,76.14,73.97 ,33.33
03,011,01,016,0301,408 ,301,1,302,426,0,3,1,3,0,1,0,76.14,70.89 ,33.33
03,011,01,016,0302,409 ,577,7,584,895,0,3,1,3,0,1,0,76.14,65.25 ,33.33
03,011,01,016,0303,410 ,476,7,483,715,0,3,1,3,0,1,0,76.14,67.55 ,33.33
03,011,01,016,0304,411 ,512,2,514,789,0,3,1,3,0,1,0,76.14,65.15 ,33.33
03,011,01,016,0304,412 ,386,11,397,655,0,3,1,3,0,1,0,76.14,60.61 ,33.33
03,011,01,016,0305,413 ,810,5,815,1307,0,3,1,3,0,1,0,76.14,62.36 ,33.33
03,011,01,016,0306,414 ,557,4,561,859,0,3,1,3,0,1,0,76.14,65.31 ,33.33
03,011,01,016,0306,415 ,739,5,744,1162,0,3,1,3,0,1,0,76.14,64.03 ,33.33
03,011,01,016,0307,416 ,610,8,618,1012,0,3,1,3,0,1,0,76.14,61.07 ,33.33
03,011,01,017,0308,417 ,361,2,363,527,0,3,1,3,0,1,0,76.14,68.88 ,33.33
03,011,01,017,0308,418 ,262,5,267,379,0,3,1,3,0,1,0,76.14,70.45 ,33.33
03,011,01,017,0309,419 ,347,2,349,509,0,3,1,3,0,1,0,76.14,68.57 ,33.33
03,011,01,017,0310,420 ,268,7,275,405,0,3,1,3,0,1,0,76.14,67.90 ,33.33
03,011,01,017,0311,421 ,315,5,320,467,0,3,1,3,0,1,0,76.14,68.52 ,33.33
03,011,01,017,0311,422 ,207,2,209,318,0,3,1,3,0,1,0,76.14,65.72 ,33.33
03,011,01,017,0312,423 ,520,6,526,797,0,3,1,3,0,1,0,76.14,66.00 ,33.33
03,011,01,017,0312,424 ,364,1,365,537,0,3,1,3,0,1,0,76.14,67.97 ,33.33
03,011,01,017,0313,425 ,456,10,466,749,0,3,1,3,0,1,0,76.14,62.22 ,33.33
03,011,01,017,0314,426 ,263,2,265,396,0,3,1,3,0,1,0,76.14,66.92 ,33.33
03,011,01,017,0314,427 ,253,1,254,365,0,3,1,3,0,1,0,76.14,69.59 ,33.33
03,011,01,017,0315,428 ,383,3,386,594,0,3,1,3,0,1,0,76.14,64.98 ,33.33
03,011,01,017,0316,429 ,679,7,686,1087,0,3,1,3,0,1,0,76.14,63.11 ,33.33
03,011,01,017,0317,430 ,424,6,430,653,0,3,1,3,0,1,0,76.14,65.85 ,33.33
03,011,01,017,0318,431 ,424,4,428,644,0,3,1,3,0,1,0,76.14,66.46 ,33.33
03,011,01,017,0318,432 ,343,3,346,512,0,3,1,3,0,1,0,76.14,67.58 ,33.33
03,011,01,017,0319,433 ,418,4,422,707,0,3,1,3,0,1,0,76.14,59.69 ,33.33
03,011,01,017,0320,434 ,482,6,488,712,0,3,1,3,0,1,0,76.14,68.54 ,33.33
03,011,01,018,0321,435 ,492,3,495,707,0,3,1,3,0,1,0,76.14,70.01 ,33.33
03,011,01,018,0321,436 ,616,7,623,895,0,3,1,3,0,1,0,76.14,69.61 ,33.33
03,011,01,018,0322,437 ,838,9,847,1316,0,3,1,3,0,1,0,76.14,64.36 ,33.33
03,011,01,018,0322,438 ,861,9,870,1285,0,3,1,3,0,1,0,76.14,67.70 ,33.33
03,011,01,018,0322,439 ,734,3,737,1114,0,3,1,3,0,1,0,76.14,66.16 ,33.33
03,011,01,018,0323,440 ,528,7,535,787,0,3,1,3,0,1,0,76.14,67.98 ,33.33
03,011,01,018,0323,441 ,505,15,520,818,0,3,1,3,0,1,0,76.14,63.57 ,33.33
03,011,01,018,0324,442 ,685,8,693,1018,0,3,1,3,0,1,0,76.14,68.07 ,33.33
03,011,01,018,0324,443 ,592,4,596,838,0,3,1,3,0,1,0,76.14,71.12 ,33.33
03,011,01,018,0324,444 ,645,6,651,988,0,3,1,3,0,1,0,76.14,65.89 ,33.33
03,011,01,018,0324,445 ,559,7,566,809,0,3,1,3,0,1,0,76.14,69.96 ,33.33
03,011,01,018,0325,446 ,301,1,302,438,0,3,1,3,0,1,0,76.14,68.95 ,33.33
03,011,01,018,0326,447 ,430,2,432,633,0,3,1,3,0,1,0,76.14,68.25 ,33.33
03,011,01,018,0327,448 ,317,5,322,435,0,3,1,3,0,1,0,76.14,74.02 ,33.33
03,011,01,018,0328,449 ,694,7,701,1008,0,3,1,3,0,1,0,76.14,69.54 ,33.33
03,011,01,018,0329,450 ,583,7,590,837,0,3,1,3,0,1,0,76.14,70.49 ,33.33
03,011,01,018,0329,451 ,717,13,730,1096,0,3,1,3,0,1,0,76.14,66.61 ,33.33
03,011,01,018,0329,452 ,666,10,676,999,0,3,1,3,0,1,0,76.14,67.67 ,33.33
03,011,01,018,0330,453 ,517,8,525,783,0,3,1,3,0,1,0,76.14,67.05 ,33.33
03,011,01,018,0330,454 ,574,6,580,817,0,3,1,3,0,1,0,76.14,70.99 ,33.33
03,011,01,018,0331,455 ,546,1,547,726,0,3,1,3,0,1,0,76.14,75.34 ,33.33
03,011,01,018,0331,456 ,263,1,264,421,0,3,1,3,0,1,0,76.14,62.71 ,33.33
03,011,01,018,0332,457 ,649,9,658,925,0,3,1,3,0,1,0,76.14,71.14 ,33.33
03,011,01,018,0332,458 ,406,5,411,587,0,3,1,3,0,1,0,76.14,70.02 ,33.33
03,011,01,018,0332,459 ,602,6,608,885,0,3,1,3,0,1,0,76.14,68.70 ,33.33
03,011,01,018,0333,460 ,332,4,336,512,0,3,1,3,0,1,0,76.14,65.63 ,33.33
03,011,01,018,0333,461 ,368,4,372,520,0,3,1,3,0,1,0,76.14,71.54 ,33.33
03,011,01,018,0333,462 ,607,1,608,887,0,3,1,3,0,1,0,76.14,68.55 ,33.33
03,011,01,018,0334,463 ,647,9,656,922,0,3,1,3,0,1,0,76.14,71.15 ,33.33
03,011,01,018,0334,464 ,558,13,571,800,0,3,1,3,0,1,0,76.14,71.38 ,33.33
03,011,01,018,0335,465 ,750,15,765,1034,0,3,1,3,0,1,0,76.14,73.98 ,33.33
03,011,01,018,0335,466 ,664,20,684,1038,0,3,1,3,0,1,0,76.14,65.90 ,33.33
03,011,01,018,0336,467 ,861,5,866,1268,0,3,1,3,0,1,0,76.14,68.30 ,33.33
03,011,01,018,0337,468 ,337,5,342,499,0,3,1,3,0,1,0,76.14,68.54 ,33.33
03,011,01,018,0338,469 ,646,10,656,1000,0,3,1,3,0,1,0,76.14,65.60 ,33.33
03,011,01,018,0338,470 ,707,10,717,1002,0,3,1,3,0,1,0,76.14,71.56 ,33.33
03,011,01,018,0339,471 ,549,5,554,838,0,3,1,3,0,1,0,76.14,66.11 ,33.33
03,011,01,018,0340,472 ,727,8,735,1042,0,3,1,3,0,1,0,76.14,70.54 ,33.33
03,011,01,019,0341,473 ,620,4,624,926,0,3,1,3,0,1,0,76.14,67.39 ,33.33
03,011,01,019,0342,474 ,812,15,827,1176,0,3,1,3,0,1,0,76.14,70.32 ,33.33
03,011,01,019,0342,475 ,937,10,947,1388,0,3,1,3,0,1,0,76.14,68.23 ,33.33
03,011,01,019,0343,476 ,750,16,766,1110,0,3,1,3,0,1,0,76.14,69.01 ,33.33
03,011,01,019,0343,477 ,922,12,934,1417,0,3,1,3,0,1,0,76.14,65.91 ,33.33
03,011,01,019,0343,478 ,995,10,1005,1442,0,3,1,3,0,1,0,76.14,69.69 ,33.33
03,011,01,019,0344,479 ,607,2,609,936,0,3,1,3,0,1,0,76.14,65.06 ,33.33
03,011,01,019,0344,480 ,751,5,756,1122,0,3,1,3,0,1,0,76.14,67.38 ,33.33
03,011,01,019,0345,481 ,853,9,862,1306,0,3,1,3,0,1,0,76.14,66.00 ,33.33
03,011,01,019,0346,482 ,439,7,446,663,0,3,1,3,0,1,0,76.14,67.27 ,33.33
03,011,01,019,0347,483 ,324,3,327,470,0,3,1,3,0,1,0,76.14,69.57 ,33.33
03,011,01,019,0348,484 ,761,12,773,1160,0,3,1,3,0,1,0,76.14,66.64 ,33.33
03,011,01,019,0349,485 ,966,12,978,1274,0,3,1,3,0,1,0,76.14,76.77 ,33.33
03,011,01,019,0350,486 ,894,8,902,1238,0,3,1,3,0,1,0,76.14,72.86 ,33.33
03,011,01,019,0350,487 ,414,23,437,607,0,3,1,3,0,1,0,76.14,71.99 ,33.33
03,011,01,019,0351,488 ,625,15,640,879,0,3,1,3,0,1,0,76.14,72.81 ,33.33
03,011,01,019,0352,489 ,626,6,632,890,0,3,1,3,0,1,0,76.14,71.01 ,33.33
03,011,01,019,0352,490 ,526,2,528,718,0,3,1,3,0,1,0,76.14,73.54 ,33.33
03,011,01,019,0353,491 ,477,4,481,667,0,3,1,3,0,1,0,76.14,72.11 ,33.33
03,011,01,019,0354,492 ,736,8,744,1070,0,3,1,3,0,1,0,76.14,69.53 ,33.33
03,011,01,019,0355,493 ,506,7,513,719,0,3,1,3,0,1,0,76.14,71.35 ,33.33
03,011,01,019,0355,494 ,724,9,733,1029,0,3,1,3,0,1,0,76.14,71.23 ,33.33
03,011,01,019,0356,495 ,633,9,642,860,0,3,1,3,0,1,0,76.14,74.65 ,33.33
03,011,01,019,0357,496 ,658,5,663,1006,0,3,1,3,0,1,0,76.14,65.90 ,33.33
03,011,01,019,0358,497 ,917,13,930,1368,0,3,1,3,0,1,0,76.14,67.98 ,33.33
03,011,01,019,0359,498 ,958,10,968,1351,0,3,1,3,0,1,0,76.14,71.65 ,33.33
03,011,01,019,0360,499 ,692,6,698,1038,0,3,1,3,0,1,0,76.14,67.24 ,33.33
03,011,01,019,0361,500 ,838,10,848,1237,0,3,1,3,0,1,0,76.14,68.55 ,33.33
03,011,01,019,0361,501 ,932,12,944,1441,0,3,1,3,0,1,0,76.14,65.51 ,33.33
03,011,01,020,0362,502 ,602,9,611,897,0,3,1,3,0,1,0,76.14,68.12 ,33.33
03,011,01,020,0362,503 ,463,6,469,675,0,3,1,3,0,1,0,76.14,69.48 ,33.33
03,011,01,020,0362,504 ,524,8,532,823,0,3,1,3,0,1,0,76.14,64.64 ,33.33
03,011,01,020,0363,505 ,691,7,698,1028,0,3,1,3,0,1,0,76.14,67.90 ,33.33
03,011,01,020,0363,506 ,717,7,724,1074,0,3,1,3,0,1,0,76.14,67.41 ,33.33
03,011,01,020,0363,507 ,499,10,509,742,0,3,1,3,0,1,0,76.14,68.60 ,33.33
03,011,01,020,0363,508 ,742,3,745,1091,0,3,1,3,0,1,0,76.14,68.29 ,33.33
03,011,01,020,0363,509 ,792,14,806,1204,0,3,1,3,0,1,0,76.14,66.94 ,33.33
03,011,01,020,0364,510 ,518,4,522,789,0,3,1,3,0,1,0,76.14,66.16 ,33.33
03,011,01,020,0364,511 ,735,6,741,1017,0,3,1,3,0,1,0,76.14,72.86 ,33.33
03,011,01,020,0365,512 ,436,9,445,603,0,3,1,3,0,1,0,76.14,73.80 ,33.33
03,011,01,020,0366,513 ,571,7,578,881,0,3,1,3,0,1,0,76.14,65.61 ,33.33
03,011,01,020,0367,514 ,730,4,734,1003,0,3,1,3,0,1,0,76.14,73.18 ,33.33
03,011,01,020,0368,515 ,714,7,721,1030,0,3,1,3,0,1,0,76.14,70.00 ,33.33
03,011,01,020,0368,516 ,463,6,469,636,0,3,1,3,0,1,0,76.14,73.74 ,33.33
03,011,01,020,0368,517 ,484,7,491,649,0,3,1,3,0,1,0,76.14,75.65 ,33.33
03,011,01,020,0369,518 ,689,12,701,991,0,3,1,3,0,1,0,76.14,70.74 ,33.33
03,011,01,020,0369,519 ,714,4,718,1050,0,3,1,3,0,1,0,76.14,68.38 ,33.33
03,011,01,020,0369,520 ,813,12,825,1171,0,3,1,3,0,1,0,76.14,70.45 ,33.33
03,011,01,020,0370,521 ,535,7,542,735,0,3,1,3,0,1,0,76.14,73.74 ,33.33
03,011,01,020,0370,522 ,525,7,532,765,0,3,1,3,0,1,0,76.14,69.54 ,33.33
03,011,01,020,0371,523 ,509,10,519,745,0,3,1,3,0,1,0,76.14,69.66 ,33.33
03,011,01,020,0371,524 ,719,5,724,1063,0,3,1,3,0,1,0,76.14,68.11 ,33.33
03,011,01,020,0371,525 ,687,6,693,998,0,3,1,3,0,1,0,76.14,69.44 ,33.33
03,011,01,020,0372,526 ,326,4,330,450,0,3,1,3,0,1,0,76.14,73.33 ,33.33
03,011,01,020,0372,527 ,545,2,547,873,0,3,1,3,0,1,0,76.14,62.66 ,33.33
03,011,01,020,0372,528 ,595,13,608,839,0,3,1,3,0,1,0,76.14,72.47 ,33.33
03,011,01,021,0373,529 ,816,6,822,1178,0,3,1,3,0,1,0,76.14,69.78 ,33.33
03,011,01,021,0373,530 ,600,12,612,852,0,3,1,3,0,1,0,76.14,71.83 ,33.33
03,011,01,021,0374,531 ,632,7,639,949,0,3,1,3,0,1,0,76.14,67.33 ,33.33
03,011,01,021,0374,532 ,549,7,556,801,0,3,1,3,0,1,0,76.14,69.41 ,33.33
03,011,01,021,0375,533 ,958,8,966,1336,0,3,1,3,0,1,0,76.14,72.31 ,33.33
03,011,01,021,0376,534 ,858,7,865,1150,0,3,1,3,0,1,0,76.14,75.22 ,33.33
03,011,01,021,0377,535 ,547,7,554,718,0,3,1,3,0,1,0,76.14,77.16 ,33.33
03,011,01,021,0378,536 ,619,7,626,767,0,3,1,3,0,1,0,76.14,81.62 ,33.33
03,011,01,021,0378,537 ,581,8,589,734,0,3,1,3,0,1,0,76.14,80.25 ,33.33
03,011,01,021,0379,538 ,681,11,692,961,0,3,1,3,0,1,0,76.14,72.01 ,33.33
03,011,01,021,0380,539 ,708,14,722,1014,0,3,1,3,0,1,0,76.14,71.20 ,33.33
03,011,01,021,0380,540 ,818,8,826,1100,0,3,1,3,0,1,0,76.14,75.09 ,33.33
03,011,01,021,0381,541 ,839,13,852,1195,0,3,1,3,0,1,0,76.14,71.30 ,33.33
03,011,01,021,0381,542 ,677,9,686,953,0,3,1,3,0,1,0,76.14,71.98 ,33.33
03,011,01,021,0382,543 ,470,7,477,643,0,3,1,3,0,1,0,76.14,74.18 ,33.33
03,011,01,021,0383,544 ,917,10,927,1348,0,3,1,3,0,1,0,76.14,68.77 ,33.33
03,011,01,021,0384,545 ,496,2,498,697,0,3,1,3,0,1,0,76.14,71.45 ,33.33
03,011,01,021,0385,546 ,630,7,637,898,0,3,1,3,0,1,0,76.14,70.94 ,33.33
03,011,01,021,0385,547 ,581,13,594,812,0,3,1,3,0,1,0,76.14,73.15 ,33.33
03,011,01,021,0386,548 ,823,8,831,1090,0,3,1,3,0,1,0,76.14,76.24 ,33.33
03,011,01,021,0386,549 ,751,9,760,1078,0,3,1,3,0,1,0,76.14,70.50 ,33.33
03,011,01,021,0387,550 ,659,2,661,908,0,3,1,3,0,1,0,76.14,72.80 ,33.33
03,011,01,021,0388,551 ,393,7,400,490,0,3,1,3,0,1,0,76.14,81.63 ,33.33
03,011,01,022,0389,552 ,584,6,590,876,0,3,1,3,0,1,0,76.14,67.35 ,33.33
03,011,01,022,0389,553 ,574,12,586,865,0,3,1,3,0,1,0,76.14,67.75 ,33.33
03,011,01,022,0390,554 ,527,4,531,736,0,3,1,3,0,1,0,76.14,72.15 ,33.33
03,011,01,022,0390,555 ,573,1,574,780,0,3,1,3,0,1,0,76.14,73.59 ,33.33
03,011,01,022,0391,556 ,590,13,603,886,0,3,1,3,0,1,0,76.14,68.06 ,33.33
03,011,01,022,0392,557 ,491,5,496,746,0,3,1,3,0,1,0,76.14,66.49 ,33.33
03,011,01,022,0393,558 ,387,5,392,576,0,3,1,3,0,1,0,76.14,68.06 ,33.33
03,011,01,022,0394,559 ,259,5,264,352,0,3,1,3,0,1,0,76.14,75.00 ,33.33
03,011,01,022,0395,560 ,236,3,239,354,0,3,1,3,0,1,0,76.14,67.51 ,33.33
03,011,01,023,0396,561 ,641,4,645,914,0,3,1,3,0,1,0,76.14,70.57 ,33.33
03,011,01,023,0397,562 ,897,8,905,1343,0,3,1,3,0,1,0,76.14,67.39 ,33.33
03,011,01,023,0397,563 ,852,12,864,1321,0,3,1,3,0,1,0,76.14,65.40 ,33.33
03,011,01,023,0397,564 ,928,11,939,1387,0,3,1,3,0,1,0,76.14,67.70 ,33.33
03,011,01,023,0398,565 ,890,12,902,1279,0,3,1,3,0,1,0,76.14,70.52 ,33.33
03,011,01,023,0399,566 ,875,4,879,1370,0,3,1,3,0,1,0,76.14,64.16 ,33.33
03,011,01,023,0400,567 ,346,6,352,496,0,3,1,3,0,1,0,76.14,70.97 ,33.33
03,011,01,023,0401,568 ,310,1,311,489,0,3,1,3,0,1,0,76.14,63.60 ,33.33
03,011,01,023,0402,569 ,553,5,558,776,0,3,1,3,0,1,0,76.14,71.91 ,33.33
03,011,01,023,0403,570 ,521,10,531,684,0,3,1,3,0,1,0,76.14,77.63 ,33.33
03,011,01,023,0403,571 ,583,11,594,895,0,3,1,3,0,1,0,76.14,66.37 ,33.33
03,011,01,023,0404,572 ,526,4,530,682,0,3,1,3,0,1,0,76.14,77.71 ,33.33
03,011,01,023,0405,573 ,685,9,694,1021,0,3,1,3,0,1,0,76.14,67.97 ,33.33
03,011,01,024,0406,574 ,665,4,669,995,0,3,1,3,0,1,0,76.14,67.24 ,33.33
03,011,01,024,0406,575 ,608,15,623,940,0,3,1,3,0,1,0,76.14,66.28 ,33.33
03,011,01,024,0407,576 ,784,17,801,1261,0,3,1,3,0,1,0,76.14,63.52 ,33.33
03,011,01,024,0408,577 ,599,3,602,856,0,3,1,3,0,1,0,76.14,70.33 ,33.33
03,011,01,024,0409,578 ,696,13,709,1066,0,3,1,3,0,1,0,76.14,66.51 ,33.33
03,011,01,024,0410,579 ,737,3,740,1040,0,3,1,3,0,1,0,76.14,71.15 ,33.33
03,011,01,024,0411,580 ,513,9,522,720,0,3,1,3,0,1,0,76.14,72.50 ,33.33
03,011,01,024,0412,581 ,756,1,757,1039,0,3,1,3,0,1,0,76.14,72.86 ,33.33
03,011,01,024,0412,582 ,812,11,823,1212,0,3,1,3,0,1,0,76.14,67.90 ,33.33
03,011,01,025,0413,583 ,506,4,510,710,0,3,1,3,0,1,0,76.14,71.83 ,33.33
03,011,01,025,0413,584 ,476,6,482,678,0,3,1,3,0,1,0,76.14,71.09 ,33.33
03,011,01,025,0414,585 ,558,4,562,801,0,3,1,3,0,1,0,76.14,70.16 ,33.33
03,011,01,025,0415,586 ,451,1,452,673,0,3,1,3,0,1,0,76.14,67.16 ,33.33
03,011,01,025,0416,587 ,339,3,342,495,0,3,1,3,0,1,0,76.14,69.09 ,33.33
03,011,01,025,0417,588 ,431,1,432,585,0,3,1,3,0,1,0,76.14,73.85 ,33.33
03,011,01,025,0418,589 ,552,7,559,825,0,3,1,3,0,1,0,76.14,67.76 ,33.33
03,011,01,025,0419,590 ,805,9,814,1222,0,3,1,3,0,1,0,76.14,66.61 ,33.33
03,011,01,025,0420,591 ,638,6,644,917,0,3,1,3,0,1,0,76.14,70.23 ,33.33
03,011,01,025,0421,592 ,298,4,302,549,0,3,1,3,0,1,0,76.14,55.01 ,33.33
03,011,01,026,0422,593 ,267,4,271,429,0,3,1,3,0,1,0,76.14,63.17 ,33.33
03,011,01,026,0423,594 ,502,8,510,720,0,3,1,3,0,1,0,76.14,70.83 ,33.33
03,011,01,026,0424,595 ,342,2,344,530,0,3,1,3,0,1,0,76.14,64.91 ,33.33
03,011,01,026,0425,596 ,651,3,654,904,0,3,1,3,0,1,0,76.14,72.35 ,33.33
03,011,01,026,0426,597 ,264,3,267,370,0,3,1,3,0,1,0,76.14,72.16 ,33.33
03,011,01,026,0427,598 ,311,8,319,463,0,3,1,3,0,1,0,76.14,68.90 ,33.33
03,011,01,026,0428,599 ,288,2,290,430,0,3,1,3,0,1,0,76.14,67.44 ,33.33
03,011,01,026,0429,600 ,209,3,212,328,0,3,1,3,0,1,0,76.14,64.63 ,33.33
03,011,01,026,0430,601 ,172,1,173,244,0,3,1,3,0,1,0,76.14,70.90 ,33.33
03,011,01,026,0431,602 ,384,2,386,585,0,3,1,3,0,1,0,76.14,65.98 ,33.33
03,011,01,027,0432,603 ,1025,6,1031,1462,0,3,1,3,0,1,0,76.14,70.52 ,33.33
03,011,01,027,0432,604 ,907,10,917,1268,0,3,1,3,0,1,0,76.14,72.32 ,33.33
03,011,01,027,0432,605 ,797,6,803,1216,0,3,1,3,0,1,0,76.14,66.04 ,33.33
03,011,01,027,0433,606 ,737,5,742,1028,0,3,1,3,0,1,0,76.14,72.18 ,33.33
03,011,01,027,0433,607 ,865,8,873,1193,0,3,1,3,0,1,0,76.14,73.18 ,33.33
03,011,01,027,0434,608 ,571,4,575,831,0,3,1,3,0,1,0,76.14,69.19 ,33.33
03,011,01,027,0434,609 ,656,9,665,999,0,3,1,3,0,1,0,76.14,66.57 ,33.33
03,011,01,027,0435,610 ,955,8,963,1477,0,3,1,3,0,1,0,76.14,65.20 ,33.33
03,011,01,027,0435,611 ,658,8,666,1121,0,3,1,3,0,1,0,76.14,59.41 ,33.33
03,011,01,027,0435,612 ,741,7,748,1267,0,3,1,3,0,1,0,76.14,59.04 ,33.33
03,011,01,027,0436,613 ,935,6,941,1307,0,3,1,3,0,1,0,76.14,72.00 ,33.33
03,011,01,027,0436,614 ,764,10,774,1120,0,3,1,3,0,1,0,76.14,69.11 ,33.33
03,011,01,027,0436,615 ,1110,17,1127,1859,0,3,1,3,0,1,0,76.14,60.62 ,33.33
03,011,01,027,0436,616 ,541,10,551,798,0,3,1,3,0,1,0,76.14,69.05 ,33.33
03,011,01,027,0436,617 ,845,10,855,1274,0,3,1,3,0,1,0,76.14,67.11 ,33.33
03,011,01,027,0437,618 ,1047,15,1062,1647,0,3,1,3,0,1,0,76.14,64.48 ,33.33
03,011,01,027,0437,619 ,577,4,581,862,0,3,1,3,0,1,0,76.14,67.40 ,33.33
03,011,01,027,0438,620 ,951,7,958,1413,0,3,1,3,0,1,0,76.14,67.80 ,33.33
03,011,01,027,0438,621 ,1082,9,1091,1783,0,3,1,3,0,1,0,76.14,61.19 ,33.33
03,011,01,027,0438,622 ,909,19,928,1355,0,3,1,3,0,1,0,76.14,68.49 ,33.33
03,011,01,027,0438,623 ,970,19,989,1682,0,3,1,3,0,1,0,76.14,58.80 ,33.33
03,011,01,027,0439,624 ,864,12,876,1482,0,3,1,3,0,1,0,76.14,59.11 ,33.33
03,011,01,027,0439,625 ,1070,9,1079,1702,0,3,1,3,0,1,0,76.14,63.40 ,33.33
03,011,01,027,0439,626 ,456,6,462,744,0,3,1,3,0,1,0,76.14,62.10 ,33.33
03,011,01,027,0440,627 ,974,14,988,1303,0,3,1,3,0,1,0,76.14,75.83 ,33.33
03,011,01,027,0441,628 ,472,2,474,697,0,3,1,3,0,1,0,76.14,68.01 ,33.33
03,011,01,027,0442,629 ,551,9,560,854,0,3,1,3,0,1,0,76.14,65.57 ,33.33
03,011,01,027,0442,630 ,856,12,868,1291,0,3,1,3,0,1,0,76.14,67.23 ,33.33
03,011,01,027,0443,631 ,796,10,806,1237,0,3,1,3,0,1,0,76.14,65.16 ,33.33
03,011,01,027,0443,632 ,637,16,653,1005,0,3,1,3,0,1,0,76.14,64.98 ,33.33
03,011,01,027,0443,633 ,687,5,692,970,0,3,1,3,0,1,0,76.14,71.34 ,33.33
03,011,01,027,0443,634 ,219,2,221,342,0,3,1,3,0,1,0,76.14,64.62 ,33.33
03,011,01,027,0444,635 ,755,19,774,1123,0,3,1,3,0,1,0,76.14,68.92 ,33.33
03,011,01,027,0445,636 ,617,17,634,921,0,3,1,3,0,1,0,76.14,68.84 ,33.33
03,011,01,027,0445,637 ,662,14,676,1068,0,3,1,3,0,1,0,76.14,63.30 ,33.33
03,011,01,027,0446,638 ,790,19,809,1184,0,3,1,3,0,1,0,76.14,68.33 ,33.33
03,011,01,027,0446,639 ,567,11,578,812,0,3,1,3,0,1,0,76.14,71.18 ,33.33
03,011,01,027,0447,640 ,651,11,662,853,0,3,1,3,0,1,0,76.14,77.61 ,33.33
03,011,01,027,0447,641 ,745,16,761,1075,0,3,1,3,0,1,0,76.14,70.79 ,33.33
03,011,01,027,0448,642 ,859,6,865,1242,0,3,1,3,0,1,0,76.14,69.65 ,33.33
03,011,01,027,0449,643 ,983,12,995,1393,0,3,1,3,0,1,0,76.14,71.43 ,33.33
03,011,01,028,0450,644 ,887,9,896,1318,0,3,1,3,0,1,0,76.14,67.98 ,33.33
03,011,01,028,0450,645 ,907,10,917,1390,0,3,1,3,0,1,0,76.14,65.97 ,33.33
03,011,01,028,0450,646 ,532,5,537,862,0,3,1,3,0,1,0,76.14,62.30 ,33.33
03,011,01,028,0450,647 ,639,7,646,963,0,3,1,3,0,1,0,76.14,67.08 ,33.33
03,011,01,028,0451,648 ,890,3,893,1381,0,3,1,3,0,1,0,76.14,64.66 ,33.33
03,011,01,028,0451,649 ,838,8,846,1301,0,3,1,3,0,1,0,76.14,65.03 ,33.33
03,011,01,028,0452,650 ,650,10,660,979,0,3,1,3,0,1,0,76.14,67.42 ,33.33
03,011,01,028,0452,651 ,661,12,673,1013,0,3,1,3,0,1,0,76.14,66.44 ,33.33
03,011,01,028,0452,652 ,655,10,665,1005,0,3,1,3,0,1,0,76.14,66.17 ,33.33
03,011,01,028,0453,653 ,674,7,681,1033,0,3,1,3,0,1,0,76.14,65.92 ,33.33
03,011,01,028,0453,654 ,609,12,621,921,0,3,1,3,0,1,0,76.14,67.43 ,33.33
03,011,01,028,0454,655 ,825,5,830,1192,0,3,1,3,0,1,0,76.14,69.63 ,33.33
03,011,01,028,0454,656 ,629,8,637,872,0,3,1,3,0,1,0,76.14,73.05 ,33.33
03,011,01,028,0454,657 ,559,6,565,851,0,3,1,3,0,1,0,76.14,66.39 ,33.33
03,011,01,028,0455,658 ,834,10,844,1313,0,3,1,3,0,1,0,76.14,64.28 ,33.33
03,011,01,028,0455,659 ,596,11,607,961,0,3,1,3,0,1,0,76.14,63.16 ,33.33
03,011,01,028,0456,660 ,506,7,513,792,0,3,1,3,0,1,0,76.14,64.77 ,33.33
03,011,01,028,0456,661 ,537,8,545,810,0,3,1,3,0,1,0,76.14,67.28 ,33.33
03,011,01,028,0456,662 ,642,8,650,981,0,3,1,3,0,1,0,76.14,66.26 ,33.33
03,011,01,028,0457,663 ,660,4,664,975,0,3,1,3,0,1,0,76.14,68.10 ,33.33
03,011,01,028,0457,664 ,713,3,716,1035,0,3,1,3,0,1,0,76.14,69.18 ,33.33
03,011,01,028,0458,665 ,994,9,1003,1455,0,3,1,3,0,1,0,76.14,68.93 ,33.33
03,011,01,028,0458,666 ,888,4,892,1275,0,3,1,3,0,1,0,76.14,69.96 ,33.33
03,011,01,028,0459,667 ,968,11,979,1334,0,3,1,3,0,1,0,76.14,73.39 ,33.33
03,011,01,028,0460,668 ,876,7,883,1305,0,3,1,3,0,1,0,76.14,67.66 ,33.33
03,011,01,028,0461,669 ,782,3,785,1053,0,3,1,3,0,1,0,76.14,74.55 ,33.33
03,011,01,028,0461,670 ,569,6,575,825,0,3,1,3,0,1,0,76.14,69.70 ,33.33
03,011,01,028,0462,671 ,395,5,400,568,0,3,1,3,0,1,0,76.14,70.42 ,33.33
03,011,01,028,0463,672 ,608,10,618,890,0,3,1,3,0,1,0,76.14,69.44 ,33.33
03,011,01,028,0463,673 ,526,6,532,788,0,3,1,3,0,1,0,76.14,67.51 ,33.33
03,011,01,028,0464,674 ,728,10,738,1173,0,3,1,3,0,1,0,76.14,62.92 ,33.33
03,011,01,028,0465,675 ,724,2,726,1013,0,3,1,3,0,1,0,76.14,71.67 ,33.33
03,011,01,028,0465,676 ,592,8,600,931,0,3,1,3,0,1,0,76.14,64.45 ,33.33
03,011,01,028,0466,677 ,858,10,868,1239,0,3,1,3,0,1,0,76.14,70.06 ,33.33
03,011,01,028,0466,678 ,592,3,595,831,0,3,1,3,0,1,0,76.14,71.60 ,33.33
03,011,01,028,0467,679 ,746,4,750,1045,0,3,1,3,0,1,0,76.14,71.77 ,33.33
03,011,01,028,0467,680 ,651,5,656,997,0,3,1,3,0,1,0,76.14,65.80 ,33.33
03,011,01,028,0468,681 ,665,0,665,969,0,3,1,3,0,1,0,76.14,68.63 ,33.33
03,011,01,028,0468,682 ,570,5,575,835,0,3,1,3,0,1,0,76.14,68.86 ,33.33
03,011,01,028,0469,683 ,504,6,510,724,0,3,1,3,0,1,0,76.14,70.44 ,33.33
03,011,01,028,0469,684 ,427,6,433,583,0,3,1,3,0,1,0,76.14,74.27 ,33.33
03,011,01,028,0470,685 ,667,7,674,1060,0,3,1,3,0,1,0,76.14,63.58 ,33.33
03,011,01,028,0470,686 ,796,17,813,1147,0,3,1,3,0,1,0,76.14,70.88 ,33.33
03,011,01,029,0471,687 ,601,2,603,855,0,3,1,3,0,1,0,76.14,70.53 ,33.33
03,011,01,029,0471,688 ,778,2,780,1048,0,3,1,3,0,1,0,76.14,74.43 ,33.33
03,011,01,029,0472,689 ,613,4,617,822,0,3,1,3,0,1,0,76.14,75.06 ,33.33
03,011,01,029,0472,690 ,753,4,757,1016,0,3,1,3,0,1,0,76.14,74.51 ,33.33
03,011,01,029,0473,691 ,753,5,758,1038,0,3,1,3,0,1,0,76.14,73.03 ,33.33
03,011,01,029,0473,692 ,798,5,803,1064,0,3,1,3,0,1,0,76.14,75.47 ,33.33
03,011,01,029,0473,693 ,950,8,958,1307,0,3,1,3,0,1,0,76.14,73.30 ,33.33
03,011,01,029,0474,694 ,968,5,973,1253,0,3,1,3,0,1,0,76.14,77.65 ,33.33
03,011,01,029,0474,695 ,937,5,942,1247,0,3,1,3,0,1,0,76.14,75.54 ,33.33
03,011,01,029,0475,696 ,615,6,621,840,0,3,1,3,0,1,0,76.14,73.93 ,33.33
03,011,01,029,0476,697 ,533,4,537,745,0,3,1,3,0,1,0,76.14,72.08 ,33.33
03,011,01,029,0477,698 ,923,11,934,1346,0,3,1,3,0,1,0,76.14,69.39 ,33.33
03,011,01,029,0477,699 ,938,5,943,1271,0,3,1,3,0,1,0,76.14,74.19 ,33.33
03,011,01,029,0478,700 ,1102,16,1118,1550,0,3,1,3,0,1,0,76.14,72.13 ,33.33
03,011,01,029,0478,701 ,936,8,944,1393,0,3,1,3,0,1,0,76.14,67.77 ,33.33
03,011,01,029,0479,702 ,608,2,610,846,0,3,1,3,0,1,0,76.14,72.10 ,33.33
03,011,01,029,0479,703 ,759,8,767,1028,0,3,1,3,0,1,0,76.14,74.61 ,33.33
03,011,01,029,0480,704 ,1045,5,1050,1425,0,3,1,3,0,1,0,76.14,73.68 ,33.33
03,011,01,029,0481,705 ,638,4,642,863,0,3,1,3,0,1,0,76.14,74.39 ,33.33
03,011,01,029,0481,706 ,851,15,866,1213,0,3,1,3,0,1,0,76.14,71.39 ,33.33
03,011,01,029,0482,707 ,538,5,543,725,0,3,1,3,0,1,0,76.14,74.90 ,33.33
03,011,01,029,0482,708 ,589,6,595,786,0,3,1,3,0,1,0,76.14,75.70 ,33.33
03,011,01,029,0483,709 ,794,9,803,1196,0,3,1,3,0,1,0,76.14,67.14 ,33.33
03,011,01,029,0484,710 ,532,4,536,730,0,3,1,3,0,1,0,76.14,73.42 ,33.33
03,011,01,029,0485,711 ,566,3,569,761,0,3,1,3,0,1,0,76.14,74.77 ,33.33
03,011,01,029,0486,712 ,548,2,550,786,0,3,1,3,0,1,0,76.14,69.97 ,33.33
03,011,01,029,0486,713 ,503,6,509,708,0,3,1,3,0,1,0,76.14,71.89 ,33.33
03,011,01,029,0487,714 ,290,2,292,376,0,3,1,3,0,1,0,76.14,77.66 ,33.33
03,011,01,030,0488,715 ,838,7,845,1145,0,3,1,3,0,1,0,76.14,73.80 ,33.33
03,011,01,030,0489,716 ,498,2,500,694,0,3,1,3,0,1,0,76.14,72.05 ,33.33
03,011,01,030,0490,717 ,115,1,116,197,0,3,1,3,0,1,0,76.14,58.88 ,33.33
03,011,01,030,0491,718 ,224,4,228,306,0,3,1,3,0,1,0,76.14,74.51 ,33.33
03,011,01,030,0492,719 ,204,1,205,270,0,3,1,3,0,1,0,76.14,75.93 ,33.33
03,011,01,030,0493,720 ,207,2,209,297,0,3,1,3,0,1,0,76.14,70.37 ,33.33
03,011,01,030,0494,721 ,324,1,325,425,0,3,1,3,0,1,0,76.14,76.47 ,33.33
03,011,01,030,0495,722 ,268,4,272,383,0,3,1,3,0,1,0,76.14,71.02 ,33.33
03,011,01,031,0496,723 ,716,8,724,1199,0,3,1,3,0,1,0,76.14,60.38 ,33.33
03,011,01,031,0496,724 ,734,8,742,1247,0,3,1,3,0,1,0,76.14,59.50 ,33.33
03,011,01,031,0496,725 ,768,6,774,1378,0,3,1,3,0,1,0,76.14,56.17 ,33.33
03,011,01,031,0497,726 ,832,8,840,1312,0,3,1,3,0,1,0,76.14,64.02 ,33.33
03,011,01,031,0497,727 ,860,9,869,1475,0,3,1,3,0,1,0,76.14,58.92 ,33.33
03,011,01,031,0498,728 ,419,6,425,673,0,3,1,3,0,1,0,76.14,63.15 ,33.33
03,011,01,031,0498,729 ,438,6,444,729,0,3,1,3,0,1,0,76.14,60.91 ,33.33
03,011,01,031,0498,730 ,511,5,516,937,0,3,1,3,0,1,0,76.14,55.07 ,33.33
03,011,01,031,0498,731 ,488,8,496,946,0,3,1,3,0,1,0,76.14,52.43 ,33.33
03,011,01,031,0499,732 ,807,6,813,1292,0,3,1,3,0,1,0,76.14,62.93 ,33.33
03,011,01,031,0499,733 ,748,4,752,1199,0,3,1,3,0,1,0,76.14,62.72 ,33.33
03,011,01,031,0499,734 ,877,8,885,1438,0,3,1,3,0,1,0,76.14,61.54 ,33.33
03,011,01,031,0500,735 ,688,13,701,1091,0,3,1,3,0,1,0,76.14,64.25 ,33.33
03,011,01,031,0500,736 ,795,9,804,1385,0,3,1,3,0,1,0,76.14,58.05 ,33.33
03,011,01,031,0500,737 ,548,6,554,847,0,3,1,3,0,1,0,76.14,65.41 ,33.33
03,011,01,031,0500,738 ,591,5,596,967,0,3,1,3,0,1,0,76.14,61.63 ,33.33
03,011,01,031,0500,739 ,720,13,733,1191,0,3,1,3,0,1,0,76.14,61.54 ,33.33
03,011,01,031,0501,740 ,724,15,739,1072,0,3,1,3,0,1,0,76.14,68.94 ,33.33
03,011,01,031,0501,741 ,703,6,709,1079,0,3,1,3,0,1,0,76.14,65.71 ,33.33
03,011,01,031,0501,742 ,683,7,690,1099,0,3,1,3,0,1,0,76.14,62.78 ,33.33
03,011,01,031,0501,743 ,757,8,765,1333,0,3,1,3,0,1,0,76.14,57.39 ,33.33
03,011,01,031,0501,744 ,608,3,611,1152,0,3,1,3,0,1,0,76.14,53.04 ,33.33
03,011,01,031,0502,745 ,769,10,779,1241,0,3,1,3,0,1,0,76.14,62.77 ,33.33
03,011,01,031,0502,746 ,803,7,810,1353,0,3,1,3,0,1,0,76.14,59.87 ,33.33
03,011,01,031,0502,747 ,828,11,839,1347,0,3,1,3,0,1,0,76.14,62.29 ,33.33
03,011,01,031,0502,748 ,796,8,804,1335,0,3,1,3,0,1,0,76.14,60.22 ,33.33
03,011,01,031,0503,749 ,800,9,809,1192,0,3,1,3,0,1,0,76.14,67.87 ,33.33
03,011,01,031,0503,750 ,714,8,722,1152,0,3,1,3,0,1,0,76.14,62.67 ,33.33
03,011,01,031,0503,751 ,663,8,671,1031,0,3,1,3,0,1,0,76.14,65.08 ,33.33
03,011,01,031,0503,752 ,675,4,679,1112,0,3,1,3,0,1,0,76.14,61.06 ,33.33
03,011,01,031,0503,753 ,615,6,621,1019,0,3,1,3,0,1,0,76.14,60.94 ,33.33
03,011,01,031,0504,754 ,836,4,840,1412,0,3,1,3,0,1,0,76.14,59.49 ,33.33
03,011,01,031,0504,755 ,824,6,830,1319,0,3,1,3,0,1,0,76.14,62.93 ,33.33
03,011,01,031,0504,756 ,765,3,768,1232,0,3,1,3,0,1,0,76.14,62.34 ,33.33
03,011,01,031,0505,757 ,452,6,458,749,0,3,1,3,0,1,0,76.14,61.15 ,33.33
03,011,01,031,0505,758 ,491,5,496,760,0,3,1,3,0,1,0,76.14,65.26 ,33.33
03,011,01,031,0505,759 ,457,6,463,695,0,3,1,3,0,1,0,76.14,66.62 ,33.33
03,011,01,031,0506,760 ,691,8,699,1161,0,3,1,3,0,1,0,76.14,60.21 ,33.33
03,011,01,031,0506,761 ,701,11,712,1164,0,3,1,3,0,1,0,76.14,61.17 ,33.33
03,011,01,031,0507,762 ,662,7,669,1164,0,3,1,3,0,1,0,76.14,57.47 ,33.33
03,011,01,031,0507,763 ,757,3,760,1210,0,3,1,3,0,1,0,76.14,62.81 ,33.33
03,011,01,031,0507,764 ,538,4,542,978,0,3,1,3,0,1,0,76.14,55.42 ,33.33
03,011,01,031,0508,765 ,540,5,545,794,0,3,1,3,0,1,0,76.14,68.64 ,33.33
03,011,01,031,0508,766 ,476,11,487,662,0,3,1,3,0,1,0,76.14,73.56 ,33.33
03,011,01,031,0509,767 ,747,13,760,1067,0,3,1,3,0,1,0,76.14,71.23 ,33.33
03,011,01,031,0510,768 ,720,6,726,1182,0,3,1,3,0,1,0,76.14,61.42 ,33.33
03,011,01,031,0510,769 ,794,9,803,1197,0,3,1,3,0,1,0,76.14,67.08 ,33.33
03,011,01,031,0510,770 ,754,8,762,1198,0,3,1,3,0,1,0,76.14,63.61 ,33.33
03,011,01,031,0510,771 ,688,3,691,1231,0,3,1,3,0,1,0,76.14,56.13 ,33.33
03,011,01,031,0510,772 ,691,9,700,1126,0,3,1,3,0,1,0,76.14,62.17 ,33.33
03,011,01,031,0511,773 ,609,9,618,939,0,3,1,3,0,1,0,76.14,65.81 ,33.33
03,011,01,031,0511,774 ,706,3,709,1110,0,3,1,3,0,1,0,76.14,63.87 ,33.33
03,011,01,031,0511,775 ,628,14,642,978,0,3,1,3,0,1,0,76.14,65.64 ,33.33
03,011,01,031,0511,776 ,813,10,823,1232,0,3,1,3,0,1,0,76.14,66.80 ,33.33
03,011,01,031,0512,777 ,447,4,451,730,0,3,1,3,0,1,0,76.14,61.78 ,33.33
03,011,01,031,0512,778 ,617,5,622,882,0,3,1,3,0,1,0,76.14,70.52 ,33.33
03,011,01,031,0512,779 ,384,7,391,552,0,3,1,3,0,1,0,76.14,70.83 ,33.33
03,011,01,031,0513,780 ,717,7,724,1075,0,3,1,3,0,1,0,76.14,67.35 ,33.33
03,011,01,031,0513,781 ,684,9,693,1044,0,3,1,3,0,1,0,76.14,66.38 ,33.33
03,011,01,031,0513,782 ,683,8,691,1154,0,3,1,3,0,1,0,76.14,59.88 ,33.33
03,011,01,031,0514,783 ,621,12,633,964,0,3,1,3,0,1,0,76.14,65.66 ,33.33
03,011,01,031,0514,784 ,648,4,652,956,0,3,1,3,0,1,0,76.14,68.20 ,33.33
03,011,01,031,0514,785 ,661,8,669,1079,0,3,1,3,0,1,0,76.14,62.00 ,33.33
03,011,01,031,0514,786 ,687,13,700,1090,0,3,1,3,0,1,0,76.14,64.22 ,33.33
03,011,01,031,0514,787 ,659,6,665,1088,0,3,1,3,0,1,0,76.14,61.12 ,33.33
03,011,01,031,0514,788 ,602,4,606,1026,0,3,1,3,0,1,0,76.14,59.06 ,33.33
03,011,01,031,0515,789 ,852,8,860,1282,0,3,1,3,0,1,0,76.14,67.08 ,33.33
03,011,01,031,0515,790 ,389,5,394,532,0,3,1,3,0,1,0,76.14,74.06 ,33.33
03,011,01,031,0516,791 ,1007,16,1023,1558,0,3,1,3,0,1,0,76.14,65.66 ,33.33
03,011,01,031,0517,792 ,662,9,671,929,0,3,1,3,0,1,0,76.14,72.23 ,33.33
03,011,01,031,0517,793 ,591,6,597,915,0,3,1,3,0,1,0,76.14,65.25 ,33.33
03,011,01,031,0517,794 ,627,8,635,956,0,3,1,3,0,1,0,76.14,66.42 ,33.33
03,011,01,031,0517,795 ,658,8,666,1046,0,3,1,3,0,1,0,76.14,63.67 ,33.33
03,011,01,031,0518,796 ,794,4,798,1253,0,3,1,3,0,1,0,76.14,63.69 ,33.33
03,011,01,031,0519,797 ,709,5,714,1020,0,3,1,3,0,1,0,76.14,70.00 ,33.33
03,011,01,031,0519,798 ,536,6,542,754,0,3,1,3,0,1,0,76.14,71.88 ,33.33
03,011,01,031,0519,799 ,760,5,765,1108,0,3,1,3,0,1,0,76.14,69.04 ,33.33
03,011,01,031,0520,800 ,567,9,576,811,0,3,1,3,0,1,0,76.14,71.02 ,33.33
03,011,01,031,0520,801 ,675,8,683,997,0,3,1,3,0,1,0,76.14,68.51 ,33.33
03,011,01,031,0520,802 ,802,12,814,1225,0,3,1,3,0,1,0,76.14,66.45 ,33.33
03,011,01,031,0521,803 ,715,22,737,1097,0,3,1,3,0,1,0,76.14,67.18 ,33.33
03,011,01,031,0521,804 ,924,6,930,1411,0,3,1,3,0,1,0,76.14,65.91 ,33.33
03,011,01,031,0521,805 ,801,8,809,1277,0,3,1,3,0,1,0,76.14,63.35 ,33.33
03,011,01,031,0521,806 ,749,8,757,1141,0,3,1,3,0,1,0,76.14,66.35 ,33.33
03,011,01,031,0522,807 ,793,8,801,1262,0,3,1,3,0,1,0,76.14,63.47 ,33.33
03,011,01,031,0522,808 ,807,9,816,1153,0,3,1,3,0,1,0,76.14,70.77 ,33.33
03,011,01,031,0522,809 ,687,8,695,1010,0,3,1,3,0,1,0,76.14,68.81 ,33.33
03,011,01,031,0523,810 ,723,8,731,1152,0,3,1,3,0,1,0,76.14,63.45 ,33.33
03,011,01,031,0523,811 ,846,8,854,1313,0,3,1,3,0,1,0,76.14,65.04 ,33.33
03,011,01,031,0523,812 ,805,9,814,1253,0,3,1,3,0,1,0,76.14,64.96 ,33.33
03,011,01,031,0523,813 ,883,11,894,1353,0,3,1,3,0,1,0,76.14,66.08 ,33.33
03,011,01,031,0524,814 ,685,10,695,1053,0,3,1,3,0,1,0,76.14,66.00 ,33.33
03,011,01,031,0524,815 ,682,7,689,1003,0,3,1,3,0,1,0,76.14,68.69 ,33.33
03,011,01,031,0524,816 ,695,5,700,1052,0,3,1,3,0,1,0,76.14,66.54 ,33.33
03,011,01,031,0524,817 ,615,5,620,1003,0,3,1,3,0,1,0,76.14,61.81 ,33.33
03,011,01,031,0524,818 ,743,9,752,1117,0,3,1,3,0,1,0,76.14,67.32 ,33.33
03,011,01,031,0525,819 ,521,15,536,812,0,3,1,3,0,1,0,76.14,66.01 ,33.33
03,011,01,031,0525,820 ,641,16,657,929,0,3,1,3,0,1,0,76.14,70.72 ,33.33
03,011,01,031,0526,821 ,765,13,778,1122,0,3,1,3,0,1,0,76.14,69.34 ,33.33
03,011,01,031,0527,822 ,698,16,714,1089,0,3,1,3,0,1,0,76.14,65.56 ,33.33
03,011,01,031,0527,823 ,622,14,636,893,0,3,1,3,0,1,0,76.14,71.22 ,33.33
03,011,01,031,0528,824 ,651,6,657,974,0,3,1,3,0,1,0,76.14,67.45 ,33.33
03,011,01,031,0528,825 ,674,6,680,1028,0,3,1,3,0,1,0,76.14,66.15 ,33.33
03,011,01,031,0529,826 ,598,7,605,1130,0,3,1,3,0,1,0,76.14,53.54 ,33.33
03,011,01,031,0529,827 ,782,6,788,1401,0,3,1,3,0,1,0,76.14,56.25 ,33.33
03,011,01,031,0529,828 ,680,9,689,1056,0,3,1,3,0,1,0,76.14,65.25 ,33.33
03,011,01,031,0529,829 ,581,4,585,1016,0,3,1,3,0,1,0,76.14,57.58 ,33.33
03,011,01,031,0529,830 ,637,6,643,1028,0,3,1,3,0,1,0,76.14,62.55 ,33.33
03,011,01,031,0529,831 ,628,3,631,1078,0,3,1,3,0,1,0,76.14,58.53 ,33.33
03,011,01,031,0529,832 ,577,4,581,989,0,3,1,3,0,1,0,76.14,58.75 ,33.33
03,011,01,031,0529,833 ,534,7,541,834,0,3,1,3,0,1,0,76.14,64.87 ,33.33
03,011,01,031,0529,834 ,691,9,700,1109,0,3,1,3,0,1,0,76.14,63.12 ,33.33
03,011,01,031,0530,835 ,621,9,630,899,0,3,1,3,0,1,0,76.14,70.08 ,33.33
03,011,01,031,0530,836 ,487,7,494,800,0,3,1,3,0,1,0,76.14,61.75 ,33.33
03,011,01,031,0531,837 ,704,7,711,1003,0,3,1,3,0,1,0,76.14,70.89 ,33.33
03,011,01,031,0531,838 ,661,14,675,1123,0,3,1,3,0,1,0,76.14,60.11 ,33.33
03,011,01,031,0532,839 ,629,2,631,935,0,3,1,3,0,1,0,76.14,67.49 ,33.33
03,011,01,031,0532,840 ,625,3,628,1033,0,3,1,3,0,1,0,76.14,60.79 ,33.33
03,011,01,031,0533,841 ,785,7,792,1284,0,3,1,3,0,1,0,76.14,61.68 ,33.33
03,011,01,031,0533,842 ,902,9,911,1399,0,3,1,3,0,1,0,76.14,65.12 ,33.33
03,011,01,031,0534,843 ,750,8,758,1389,0,3,1,3,0,1,0,76.14,54.57 ,33.33
03,011,01,031,0534,844 ,581,6,587,1043,0,3,1,3,0,1,0,76.14,56.28 ,33.33
03,011,01,031,0534,845 ,532,3,535,850,0,3,1,3,0,1,0,76.14,62.94 ,33.33
03,011,01,031,0534,846 ,545,8,553,869,0,3,1,3,0,1,0,76.14,63.64 ,33.33
03,011,01,031,0534,847 ,520,3,523,904,0,3,1,3,0,1,0,76.14,57.85 ,33.33
03,012,01,001,0001,1 ,357,6,363,561,0,3,1,3,0,1,0,76.14,64.71 ,33.33
03,012,01,001,0001,2 ,435,3,438,702,0,3,1,3,0,1,0,76.14,62.39 ,33.33
03,012,01,001,0002,3 ,560,4,564,862,0,3,1,3,0,1,0,76.14,65.43 ,33.33
03,012,01,001,0003,4 ,771,5,776,1203,0,3,1,3,0,1,0,76.14,64.51 ,33.33
03,012,01,001,0003,5 ,736,11,747,1079,0,3,1,3,0,1,0,76.14,69.23 ,33.33
03,012,01,001,0004,6 ,903,10,913,1415,0,3,1,3,0,1,0,76.14,64.52 ,33.33
03,012,01,001,0004,7 ,786,7,793,1249,0,3,1,3,0,1,0,76.14,63.49 ,33.33
03,012,01,001,0004,8 ,731,11,742,1167,0,3,1,3,0,1,0,76.14,63.58 ,33.33
03,012,01,001,0004,9 ,744,10,754,1177,0,3,1,3,0,1,0,76.14,64.06 ,33.33
03,012,01,001,0005,10 ,661,5,666,1038,0,3,1,3,0,1,0,76.14,64.16 ,33.33
03,012,01,001,0005,11 ,585,8,593,930,0,3,1,3,0,1,0,76.14,63.76 ,33.33
03,012,01,001,0005,12 ,533,4,537,895,0,3,1,3,0,1,0,76.14,60.00 ,33.33
03,012,01,001,0005,13 ,576,5,581,871,0,3,1,3,0,1,0,76.14,66.70 ,33.33
03,012,01,001,0006,14 ,630,5,635,1013,0,3,1,3,0,1,0,76.14,62.69 ,33.33
03,012,01,001,0006,15 ,800,9,809,1237,0,3,1,3,0,1,0,76.14,65.40 ,33.33
03,012,01,001,0006,16 ,484,4,488,800,0,3,1,3,0,1,0,76.14,61.00 ,33.33
03,012,01,001,0006,17 ,757,3,760,1163,0,3,1,3,0,1,0,76.14,65.35 ,33.33
03,012,01,001,0007,18 ,772,6,778,1270,0,3,1,3,0,1,0,76.14,61.26 ,33.33
03,012,01,001,0007,19 ,706,5,711,1074,0,3,1,3,0,1,0,76.14,66.20 ,33.33
03,012,01,001,0008,20 ,885,10,895,1368,0,3,1,3,0,1,0,76.14,65.42 ,33.33
03,012,01,001,0008,21 ,1010,16,1026,1579,0,3,1,3,0,1,0,76.14,64.98 ,33.33
03,012,01,001,0009,22 ,867,11,878,1296,0,3,1,3,0,1,0,76.14,67.75 ,33.33
03,012,01,001,0009,23 ,960,8,968,1542,0,3,1,3,0,1,0,76.14,62.78 ,33.33
03,012,01,001,0010,24 ,712,10,722,1057,0,3,1,3,0,1,0,76.14,68.31 ,33.33
03,012,01,001,0010,25 ,634,6,640,976,0,3,1,3,0,1,0,76.14,65.57 ,33.33
03,012,01,001,0010,26 ,670,11,681,1083,0,3,1,3,0,1,0,76.14,62.88 ,33.33
03,012,01,001,0010,27 ,701,9,710,1036,0,3,1,3,0,1,0,76.14,68.53 ,33.33
03,012,01,001,0011,28 ,579,6,585,927,0,3,1,3,0,1,0,76.14,63.11 ,33.33
03,012,01,001,0011,29 ,899,8,907,1426,0,3,1,3,0,1,0,76.14,63.60 ,33.33
03,012,01,001,0011,30 ,666,7,673,1018,0,3,1,3,0,1,0,76.14,66.11 ,33.33
03,012,01,001,0011,31 ,590,7,597,881,0,3,1,3,0,1,0,76.14,67.76 ,33.33
03,012,01,001,0011,32 ,422,6,428,681,0,3,1,3,0,1,0,76.14,62.85 ,33.33
03,012,01,001,0012,33 ,685,5,690,1193,0,3,1,3,0,1,0,76.14,57.84 ,33.33
03,012,01,001,0012,34 ,721,7,728,1245,0,3,1,3,0,1,0,76.14,58.47 ,33.33
03,012,01,001,0012,35 ,645,3,648,1098,0,3,1,3,0,1,0,76.14,59.02 ,33.33
03,012,01,001,0012,36 ,793,7,800,1372,0,3,1,3,0,1,0,76.14,58.31 ,33.33
03,012,01,001,0013,37 ,636,7,643,947,0,3,1,3,0,1,0,76.14,67.90 ,33.33
03,012,01,001,0013,38 ,677,2,679,1094,0,3,1,3,0,1,0,76.14,62.07 ,33.33
03,012,01,001,0014,39 ,730,3,733,1207,0,3,1,3,0,1,0,76.14,60.73 ,33.33
03,012,01,001,0014,40 ,647,12,659,1110,0,3,1,3,0,1,0,76.14,59.37 ,33.33
03,012,01,001,0014,41 ,574,4,578,983,0,3,1,3,0,1,0,76.14,58.80 ,33.33
03,012,01,001,0014,42 ,607,11,618,1098,0,3,1,3,0,1,0,76.14,56.28 ,33.33
03,012,01,001,0014,43 ,578,8,586,979,0,3,1,3,0,1,0,76.14,59.86 ,33.33
03,012,01,001,0015,44 ,526,6,532,761,0,3,1,3,0,1,0,76.14,69.91 ,33.33
03,012,01,001,0016,45 ,324,1,325,497,0,3,1,3,0,1,0,76.14,65.39 ,33.33
03,012,01,001,0017,46 ,368,4,372,570,0,3,1,3,0,1,0,76.14,65.26 ,33.33
03,012,01,001,0017,47 ,571,3,574,811,0,3,1,3,0,1,0,76.14,70.78 ,33.33
03,012,01,001,0018,48 ,530,4,534,798,0,3,1,3,0,1,0,76.14,66.92 ,33.33
03,012,01,001,0018,49 ,529,5,534,836,0,3,1,3,0,1,0,76.14,63.88 ,33.33
03,012,01,001,0019,50 ,747,6,753,1109,0,3,1,3,0,1,0,76.14,67.90 ,33.33
03,012,01,001,0019,51 ,765,14,779,1155,0,3,1,3,0,1,0,76.14,67.45 ,33.33
03,012,01,001,0019,52 ,740,5,745,1133,0,3,1,3,0,1,0,76.14,65.75 ,33.33
03,012,01,001,0019,53 ,776,5,781,1138,0,3,1,3,0,1,0,76.14,68.63 ,33.33
03,012,01,001,0020,54 ,724,12,736,1082,0,3,1,3,0,1,0,76.14,68.02 ,33.33
03,012,01,001,0021,55 ,734,10,744,1082,0,3,1,3,0,1,0,76.14,68.76 ,33.33
03,012,01,001,0022,56 ,819,9,828,1250,0,3,1,3,0,1,0,76.14,66.24 ,33.33
03,012,01,001,0023,57 ,689,6,695,1047,0,3,1,3,0,1,0,76.14,66.38 ,33.33
03,012,01,001,0023,58 ,488,7,495,795,0,3,1,3,0,1,0,76.14,62.26 ,33.33
03,012,01,001,0023,59 ,587,4,591,884,0,3,1,3,0,1,0,76.14,66.86 ,33.33
03,012,01,001,0023,60 ,578,7,585,891,0,3,1,3,0,1,0,76.14,65.66 ,33.33
03,012,01,001,0024,61 ,503,6,509,777,0,3,1,3,0,1,0,76.14,65.51 ,33.33
03,012,01,001,0025,62 ,780,5,785,1197,0,3,1,3,0,1,0,76.14,65.58 ,33.33
03,012,01,001,0025,63 ,842,10,852,1308,0,3,1,3,0,1,0,76.14,65.14 ,33.33
03,012,01,001,0025,64 ,756,8,764,1092,0,3,1,3,0,1,0,76.14,69.96 ,33.33
03,012,01,001,0026,65 ,641,6,647,942,0,3,1,3,0,1,0,76.14,68.68 ,33.33
03,012,01,001,0026,66 ,486,3,489,863,0,3,1,3,0,1,0,76.14,56.66 ,33.33
03,012,01,001,0026,67 ,490,2,492,887,0,3,1,3,0,1,0,76.14,55.47 ,33.33
03,012,01,001,0026,68 ,874,10,884,1316,0,3,1,3,0,1,0,76.14,67.17 ,33.33
03,012,01,001,0027,69 ,695,6,701,1108,0,3,1,3,0,1,0,76.14,63.27 ,33.33
03,012,01,001,0027,70 ,670,6,676,1065,0,3,1,3,0,1,0,76.14,63.47 ,33.33
03,012,01,001,0027,71 ,639,6,645,1058,0,3,1,3,0,1,0,76.14,60.96 ,33.33
03,012,01,001,0027,72 ,805,14,819,1189,0,3,1,3,0,1,0,76.14,68.88 ,33.33
03,012,01,001,0027,73 ,624,5,629,965,0,3,1,3,0,1,0,76.14,65.18 ,33.33
03,012,01,001,0028,74 ,754,10,764,1122,0,3,1,3,0,1,0,76.14,68.09 ,33.33
03,012,01,001,0028,75 ,663,12,675,1006,0,3,1,3,0,1,0,76.14,67.10 ,33.33
03,012,01,001,0028,76 ,750,11,761,1127,0,3,1,3,0,1,0,76.14,67.52 ,33.33
03,012,01,001,0029,77 ,315,2,317,476,0,3,1,3,0,1,0,76.14,66.60 ,33.33
03,012,01,001,0029,78 ,355,5,360,504,0,3,1,3,0,1,0,76.14,71.43 ,33.33
03,012,01,001,0030,79 ,382,4,386,574,0,3,1,3,0,1,0,76.14,67.25 ,33.33
03,012,01,001,0031,80 ,1000,2,1002,1436,0,3,1,3,0,1,0,76.14,69.78 ,33.33
03,012,01,001,0032,81 ,699,6,705,1091,0,3,1,3,0,1,0,76.14,64.62 ,33.33
03,012,01,001,0032,82 ,645,4,649,1033,0,3,1,3,0,1,0,76.14,62.83 ,33.33
03,012,01,001,0033,83 ,701,8,709,1026,0,3,1,3,0,1,0,76.14,69.10 ,33.33
03,012,01,001,0033,84 ,593,8,601,862,0,3,1,3,0,1,0,76.14,69.72 ,33.33
03,012,01,001,0033,85 ,674,5,679,1025,0,3,1,3,0,1,0,76.14,66.24 ,33.33
03,012,01,001,0033,86 ,571,9,580,892,0,3,1,3,0,1,0,76.14,65.02 ,33.33
03,012,01,001,0033,87 ,696,5,701,1048,0,3,1,3,0,1,0,76.14,66.89 ,33.33
03,012,01,001,0034,88 ,771,6,777,1245,0,3,1,3,0,1,0,76.14,62.41 ,33.33
03,012,01,001,0034,89 ,766,9,775,1297,0,3,1,3,0,1,0,76.14,59.75 ,33.33
03,012,01,001,0034,90 ,796,12,808,1234,0,3,1,3,0,1,0,76.14,65.48 ,33.33
03,012,01,001,0035,91 ,814,15,829,1270,0,3,1,3,0,1,0,76.14,65.28 ,33.33
03,012,01,001,0035,92 ,784,4,788,1232,0,3,1,3,0,1,0,76.14,63.96 ,33.33
03,012,01,001,0035,93 ,831,4,835,1267,0,3,1,3,0,1,0,76.14,65.90 ,33.33
03,012,01,001,0036,94 ,639,3,642,972,0,3,1,3,0,1,0,76.14,66.05 ,33.33
03,012,01,001,0036,95 ,667,8,675,1058,0,3,1,3,0,1,0,76.14,63.80 ,33.33
03,012,01,001,0037,96 ,558,5,563,868,0,3,1,3,0,1,0,76.14,64.86 ,33.33
03,012,01,001,0037,97 ,508,4,512,839,0,3,1,3,0,1,0,76.14,61.03 ,33.33
03,012,01,001,0038,98 ,720,12,732,1235,0,3,1,3,0,1,0,76.14,59.27 ,33.33
03,012,01,001,0038,99 ,640,12,652,1016,0,3,1,3,0,1,0,76.14,64.17 ,33.33
03,012,01,001,0039,100 ,812,6,818,1275,0,3,1,3,0,1,0,76.14,64.16 ,33.33
03,012,01,001,0039,101 ,815,9,824,1210,0,3,1,3,0,1,0,76.14,68.10 ,33.33
03,012,01,001,0039,102 ,902,11,913,1392,0,3,1,3,0,1,0,76.14,65.59 ,33.33
03,012,01,001,0040,103 ,682,6,688,985,0,3,1,3,0,1,0,76.14,69.85 ,33.33
03,012,01,001,0040,104 ,741,9,750,1092,0,3,1,3,0,1,0,76.14,68.68 ,33.33
03,012,01,001,0040,105 ,695,5,700,1039,0,3,1,3,0,1,0,76.14,67.37 ,33.33
03,012,01,001,0040,106 ,822,12,834,1268,0,3,1,3,0,1,0,76.14,65.77 ,33.33
03,012,01,001,0041,107 ,575,6,581,849,0,3,1,3,0,1,0,76.14,68.43 ,33.33
03,012,01,001,0042,108 ,595,5,600,904,0,3,1,3,0,1,0,76.14,66.37 ,33.33
03,012,01,001,0042,109 ,650,12,662,1069,0,3,1,3,0,1,0,76.14,61.93 ,33.33
03,012,01,001,0043,110 ,598,7,605,824,0,3,1,3,0,1,0,76.14,73.42 ,33.33
03,012,01,001,0043,111 ,503,5,508,731,0,3,1,3,0,1,0,76.14,69.49 ,33.33
03,012,01,001,0043,112 ,647,8,655,1003,0,3,1,3,0,1,0,76.14,65.30 ,33.33
03,012,01,001,0043,113 ,821,10,831,1304,0,3,1,3,0,1,0,76.14,63.73 ,33.33
03,012,01,001,0044,114 ,477,5,482,686,0,3,1,3,0,1,0,76.14,70.26 ,33.33
03,012,01,001,0044,115 ,583,1,584,782,0,3,1,3,0,1,0,76.14,74.68 ,33.33
03,012,01,001,0044,116 ,641,8,649,876,0,3,1,3,0,1,0,76.14,74.09 ,33.33
03,012,01,001,0045,117 ,608,6,614,941,0,3,1,3,0,1,0,76.14,65.25 ,33.33
03,012,01,001,0045,118 ,517,7,524,827,0,3,1,3,0,1,0,76.14,63.36 ,33.33
03,012,01,001,0045,119 ,543,5,548,874,0,3,1,3,0,1,0,76.14,62.70 ,33.33
03,012,01,001,0045,120 ,805,7,812,1238,0,3,1,3,0,1,0,76.14,65.59 ,33.33
03,012,01,001,0046,121 ,757,7,764,1196,0,3,1,3,0,1,0,76.14,63.88 ,33.33
03,012,01,001,0046,122 ,729,9,738,1238,0,3,1,3,0,1,0,76.14,59.61 ,33.33
03,012,01,001,0046,123 ,698,5,703,1122,0,3,1,3,0,1,0,76.14,62.66 ,33.33
03,012,01,001,0047,124 ,587,10,597,1034,0,3,1,3,0,1,0,76.14,57.74 ,33.33
03,012,01,001,0047,125 ,551,6,557,874,0,3,1,3,0,1,0,76.14,63.73 ,33.33
03,012,01,001,0047,126 ,424,1,425,699,0,3,1,3,0,1,0,76.14,60.80 ,33.33
03,012,01,001,0048,127 ,665,12,677,1056,0,3,1,3,0,1,0,76.14,64.11 ,33.33
03,012,01,001,0048,128 ,624,12,636,1004,0,3,1,3,0,1,0,76.14,63.35 ,33.33
03,012,01,001,0049,129 ,628,8,636,986,0,3,1,3,0,1,0,76.14,64.50 ,33.33
03,012,01,001,0049,130 ,634,8,642,982,0,3,1,3,0,1,0,76.14,65.38 ,33.33
03,012,01,001,0050,131 ,555,8,563,882,0,3,1,3,0,1,0,76.14,63.83 ,33.33
03,012,01,001,0050,132 ,543,11,554,864,0,3,1,3,0,1,0,76.14,64.12 ,33.33
03,012,01,001,0050,133 ,594,7,601,961,0,3,1,3,0,1,0,76.14,62.54 ,33.33
03,012,01,001,0050,134 ,602,7,609,1005,0,3,1,3,0,1,0,76.14,60.60 ,33.33
03,012,01,001,0051,135 ,570,3,573,856,0,3,1,3,0,1,0,76.14,66.94 ,33.33
03,012,01,001,0051,136 ,505,7,512,816,0,3,1,3,0,1,0,76.14,62.75 ,33.33
03,012,01,001,0051,137 ,391,1,392,618,0,3,1,3,0,1,0,76.14,63.43 ,33.33
03,012,01,001,0052,138 ,585,9,594,983,0,3,1,3,0,1,0,76.14,60.43 ,33.33
03,012,01,001,0052,139 ,556,7,563,904,0,3,1,3,0,1,0,76.14,62.28 ,33.33
03,012,01,001,0053,140 ,495,5,500,793,0,3,1,3,0,1,0,76.14,63.05 ,33.33
03,012,01,001,0053,141 ,465,4,469,817,0,3,1,3,0,1,0,76.14,57.41 ,33.33
03,012,01,001,0053,142 ,568,7,575,957,0,3,1,3,0,1,0,76.14,60.08 ,33.33
03,012,01,001,0054,143 ,627,6,633,1062,0,3,1,3,0,1,0,76.14,59.60 ,33.33
03,012,01,001,0054,144 ,717,7,724,1100,0,3,1,3,0,1,0,76.14,65.82 ,33.33
03,012,01,001,0054,145 ,617,6,623,1056,0,3,1,3,0,1,0,76.14,59.00 ,33.33
03,012,01,001,0055,146 ,785,6,791,1175,0,3,1,3,0,1,0,76.14,67.32 ,33.33
03,012,01,001,0055,147 ,733,6,739,1077,0,3,1,3,0,1,0,76.14,68.62 ,33.33
03,012,01,001,0055,148 ,780,5,785,1231,0,3,1,3,0,1,0,76.14,63.77 ,33.33
03,012,01,001,0056,149 ,536,10,546,839,0,3,1,3,0,1,0,76.14,65.08 ,33.33
03,012,01,001,0056,150 ,542,6,548,911,0,3,1,3,0,1,0,76.14,60.15 ,33.33
03,012,01,001,0056,151 ,727,3,730,1109,0,3,1,3,0,1,0,76.14,65.83 ,33.33
03,012,01,001,0057,152 ,641,8,649,1037,0,3,1,3,0,1,0,76.14,62.58 ,33.33
03,012,01,001,0057,153 ,611,6,617,1018,0,3,1,3,0,1,0,76.14,60.61 ,33.33
03,012,01,001,0057,154 ,779,9,788,1292,0,3,1,3,0,1,0,76.14,60.99 ,33.33
03,012,01,001,0058,155 ,759,6,765,1253,0,3,1,3,0,1,0,76.14,61.05 ,33.33
03,012,01,001,0058,156 ,796,9,805,1296,0,3,1,3,0,1,0,76.14,62.11 ,33.33
03,012,01,001,0058,157 ,804,8,812,1282,0,3,1,3,0,1,0,76.14,63.34 ,33.33
03,012,01,001,0058,158 ,636,11,647,1058,0,3,1,3,0,1,0,76.14,61.15 ,33.33
03,012,01,001,0058,159 ,568,9,577,962,0,3,1,3,0,1,0,76.14,59.98 ,33.33
03,012,01,001,0059,160 ,700,4,704,1172,0,3,1,3,0,1,0,76.14,60.07 ,33.33
03,012,01,001,0059,161 ,599,6,605,1041,0,3,1,3,0,1,0,76.14,58.12 ,33.33
03,012,01,001,0059,162 ,580,4,584,1041,0,3,1,3,0,1,0,76.14,56.10 ,33.33
03,012,01,001,0060,163 ,541,9,550,810,0,3,1,3,0,1,0,76.14,67.90 ,33.33
03,012,01,001,0060,164 ,665,13,678,1053,0,3,1,3,0,1,0,76.14,64.39 ,33.33
03,012,01,001,0061,165 ,614,9,623,1028,0,3,1,3,0,1,0,76.14,60.60 ,33.33
03,012,01,001,0061,166 ,523,12,535,901,0,3,1,3,0,1,0,76.14,59.38 ,33.33
03,012,01,001,0061,167 ,617,7,624,990,0,3,1,3,0,1,0,76.14,63.03 ,33.33
03,012,01,001,0061,168 ,623,5,628,985,0,3,1,3,0,1,0,76.14,63.76 ,33.33
03,012,01,001,0062,169 ,536,6,542,835,0,3,1,3,0,1,0,76.14,64.91 ,33.33
03,012,01,001,0062,170 ,495,9,504,860,0,3,1,3,0,1,0,76.14,58.60 ,33.33
03,012,01,001,0062,171 ,621,7,628,1015,0,3,1,3,0,1,0,76.14,61.87 ,33.33
03,012,01,001,0063,172 ,918,10,928,1556,0,3,1,3,0,1,0,76.14,59.64 ,33.33
03,012,01,001,0063,173 ,680,7,687,1100,0,3,1,3,0,1,0,76.14,62.45 ,33.33
03,012,01,001,0063,174 ,697,6,703,1103,0,3,1,3,0,1,0,76.14,63.74 ,33.33
03,012,01,001,0063,175 ,677,5,682,1113,0,3,1,3,0,1,0,76.14,61.28 ,33.33
03,012,01,001,0063,176 ,667,9,676,1107,0,3,1,3,0,1,0,76.14,61.07 ,33.33
03,012,01,001,0064,177 ,726,9,735,1245,0,3,1,3,0,1,0,76.14,59.04 ,33.33
03,012,01,001,0064,178 ,601,6,607,988,0,3,1,3,0,1,0,76.14,61.44 ,33.33
03,012,01,001,0064,179 ,578,7,585,922,0,3,1,3,0,1,0,76.14,63.45 ,33.33
03,012,01,001,0065,180 ,912,13,925,1549,0,3,1,3,0,1,0,76.14,59.72 ,33.33
03,012,01,001,0065,181 ,941,11,952,1542,0,3,1,3,0,1,0,76.14,61.74 ,33.33
03,012,01,001,0066,182 ,863,19,882,1408,0,3,1,3,0,1,0,76.14,62.64 ,33.33
03,012,01,001,0066,183 ,691,12,703,1191,0,3,1,3,0,1,0,76.14,59.03 ,33.33
03,012,01,001,0067,184 ,661,10,671,1012,0,3,1,3,0,1,0,76.14,66.30 ,33.33
03,012,01,001,0067,185 ,471,5,476,747,0,3,1,3,0,1,0,76.14,63.72 ,33.33
03,012,01,001,0067,186 ,689,11,700,1127,0,3,1,3,0,1,0,76.14,62.11 ,33.33
03,012,01,001,0067,187 ,634,6,640,1023,0,3,1,3,0,1,0,76.14,62.56 ,33.33
03,012,01,001,0068,188 ,449,5,454,713,0,3,1,3,0,1,0,76.14,63.67 ,33.33
03,012,01,001,0068,189 ,434,9,443,632,0,3,1,3,0,1,0,76.14,70.09 ,33.33
03,012,01,001,0068,190 ,384,5,389,601,0,3,1,3,0,1,0,76.14,64.73 ,33.33
03,012,01,001,0069,191 ,605,6,611,1028,0,3,1,3,0,1,0,76.14,59.44 ,33.33
03,012,01,001,0069,192 ,612,12,624,1007,0,3,1,3,0,1,0,76.14,61.97 ,33.33
03,012,01,001,0069,193 ,588,6,594,1075,0,3,1,3,0,1,0,76.14,55.26 ,33.33
03,012,01,001,0069,194 ,627,6,633,1247,0,3,1,3,0,1,0,76.14,50.76 ,33.33
03,012,01,001,0070,195 ,538,6,544,867,0,3,1,3,0,1,0,76.14,62.75 ,33.33
03,012,01,001,0070,196 ,623,2,625,1027,0,3,1,3,0,1,0,76.14,60.86 ,33.33
03,012,01,001,0071,197 ,464,8,472,744,0,3,1,3,0,1,0,76.14,63.44 ,33.33
03,012,01,001,0071,198 ,534,5,539,857,0,3,1,3,0,1,0,76.14,62.89 ,33.33
03,012,01,001,0071,199 ,580,6,586,946,0,3,1,3,0,1,0,76.14,61.95 ,33.33
03,012,01,001,0072,200 ,821,8,829,1349,0,3,1,3,0,1,0,76.14,61.45 ,33.33
03,012,01,001,0072,201 ,684,9,693,1084,0,3,1,3,0,1,0,76.14,63.93 ,33.33
03,012,01,001,0072,202 ,711,9,720,1055,0,3,1,3,0,1,0,76.14,68.25 ,33.33
03,012,01,001,0073,203 ,505,6,511,809,0,3,1,3,0,1,0,76.14,63.16 ,33.33
03,012,01,001,0073,204 ,582,9,591,907,0,3,1,3,0,1,0,76.14,65.16 ,33.33
03,012,01,001,0073,205 ,556,12,568,893,0,3,1,3,0,1,0,76.14,63.61 ,33.33
03,012,01,001,0073,206 ,520,5,525,793,0,3,1,3,0,1,0,76.14,66.20 ,33.33
03,012,01,001,0074,207 ,622,11,633,1029,0,3,1,3,0,1,0,76.14,61.52 ,33.33
03,012,01,001,0074,208 ,612,4,616,988,0,3,1,3,0,1,0,76.14,62.35 ,33.33
03,012,01,001,0074,209 ,776,10,786,1173,0,3,1,3,0,1,0,76.14,67.01 ,33.33
03,012,01,001,0075,210 ,646,6,652,935,0,3,1,3,0,1,0,76.14,69.73 ,33.33
03,012,01,001,0075,211 ,663,10,673,975,0,3,1,3,0,1,0,76.14,69.03 ,33.33
03,012,01,001,0075,212 ,705,7,712,1085,0,3,1,3,0,1,0,76.14,65.62 ,33.33
03,012,01,001,0076,213 ,705,10,715,1077,0,3,1,3,0,1,0,76.14,66.39 ,33.33
03,012,01,001,0076,214 ,659,10,669,986,0,3,1,3,0,1,0,76.14,67.85 ,33.33
03,012,01,001,0076,215 ,622,7,629,1064,0,3,1,3,0,1,0,76.14,59.12 ,33.33
03,012,01,001,0076,216 ,586,3,589,973,0,3,1,3,0,1,0,76.14,60.53 ,33.33
03,012,01,001,0076,217 ,676,8,684,1123,0,3,1,3,0,1,0,76.14,60.91 ,33.33
03,012,01,001,0077,218 ,612,8,620,1064,0,3,1,3,0,1,0,76.14,58.27 ,33.33
03,012,01,001,0077,219 ,816,9,825,1377,0,3,1,3,0,1,0,76.14,59.91 ,33.33
03,012,01,001,0078,220 ,544,11,555,892,0,3,1,3,0,1,0,76.14,62.22 ,33.33
03,012,01,001,0078,221 ,468,7,475,769,0,3,1,3,0,1,0,76.14,61.77 ,33.33
03,012,01,001,0078,222 ,637,4,641,1079,0,3,1,3,0,1,0,76.14,59.41 ,33.33
03,012,01,002,0079,223 ,916,10,926,1310,0,3,1,3,0,1,0,76.14,70.69 ,33.33
03,012,01,002,0079,224 ,852,7,859,1215,0,3,1,3,0,1,0,76.14,70.70 ,33.33
03,012,01,002,0080,225 ,729,10,739,1057,0,3,1,3,0,1,0,76.14,69.91 ,33.33
03,012,01,002,0080,226 ,653,9,662,970,0,3,1,3,0,1,0,76.14,68.25 ,33.33
03,012,01,002,0080,227 ,647,6,653,914,0,3,1,3,0,1,0,76.14,71.44 ,33.33
03,012,01,002,0081,228 ,779,3,782,1137,0,3,1,3,0,1,0,76.14,68.78 ,33.33
03,012,01,002,0081,229 ,629,10,639,941,0,3,1,3,0,1,0,76.14,67.91 ,33.33
03,012,01,002,0082,230 ,806,8,814,1191,0,3,1,3,0,1,0,76.14,68.35 ,33.33
03,012,01,002,0082,231 ,822,8,830,1284,0,3,1,3,0,1,0,76.14,64.64 ,33.33
03,012,01,002,0083,232 ,771,10,781,1147,0,3,1,3,0,1,0,76.14,68.09 ,33.33
03,012,01,002,0083,233 ,698,4,702,1026,0,3,1,3,0,1,0,76.14,68.42 ,33.33
03,012,01,002,0083,234 ,643,6,649,1036,0,3,1,3,0,1,0,76.14,62.64 ,33.33
03,012,01,002,0084,235 ,613,8,621,950,0,3,1,3,0,1,0,76.14,65.37 ,33.33
03,012,01,002,0084,236 ,510,10,520,857,0,3,1,3,0,1,0,76.14,60.68 ,33.33
03,012,01,002,0085,237 ,784,6,790,1222,0,3,1,3,0,1,0,76.14,64.65 ,33.33
03,012,01,002,0085,238 ,711,14,725,1115,0,3,1,3,0,1,0,76.14,65.02 ,33.33
03,012,01,002,0086,239 ,913,16,929,1389,0,3,1,3,0,1,0,76.14,66.88 ,33.33
03,012,01,002,0086,240 ,814,5,819,1166,0,3,1,3,0,1,0,76.14,70.24 ,33.33
03,012,01,002,0087,241 ,597,4,601,893,0,3,1,3,0,1,0,76.14,67.30 ,33.33
03,012,01,002,0087,242 ,608,12,620,845,0,3,1,3,0,1,0,76.14,73.37 ,33.33
03,012,01,002,0088,243 ,670,2,672,997,0,3,1,3,0,1,0,76.14,67.40 ,33.33
03,012,01,002,0088,244 ,691,8,699,1024,0,3,1,3,0,1,0,76.14,68.26 ,33.33
03,012,01,002,0088,245 ,679,8,687,922,0,3,1,3,0,1,0,76.14,74.51 ,33.33
03,012,01,002,0089,246 ,616,8,624,874,0,3,1,3,0,1,0,76.14,71.40 ,33.33
03,012,01,002,0089,247 ,764,4,768,1098,0,3,1,3,0,1,0,76.14,69.95 ,33.33
03,012,01,002,0089,248 ,590,10,600,871,0,3,1,3,0,1,0,76.14,68.89 ,33.33
03,012,01,002,0090,249 ,908,11,919,1224,0,3,1,3,0,1,0,76.14,75.08 ,33.33
03,012,01,002,0091,250 ,551,3,554,795,0,3,1,3,0,1,0,76.14,69.69 ,33.33
03,012,01,002,0091,251 ,602,9,611,828,0,3,1,3,0,1,0,76.14,73.79 ,33.33
03,012,01,002,0092,252 ,576,9,585,827,0,3,1,3,0,1,0,76.14,70.74 ,33.33
03,012,01,002,0092,253 ,764,5,769,1123,0,3,1,3,0,1,0,76.14,68.48 ,33.33
03,012,01,002,0093,254 ,601,3,604,957,0,3,1,3,0,1,0,76.14,63.11 ,33.33
03,012,01,002,0093,255 ,734,11,745,1081,0,3,1,3,0,1,0,76.14,68.92 ,33.33
03,012,01,002,0093,256 ,921,15,936,1376,0,3,1,3,0,1,0,76.14,68.02 ,33.33
03,012,01,002,0094,257 ,590,6,596,869,0,3,1,3,0,1,0,76.14,68.58 ,33.33
03,012,01,002,0094,258 ,539,6,545,771,0,3,1,3,0,1,0,76.14,70.69 ,33.33
03,012,01,002,0095,259 ,929,18,947,1282,0,3,1,3,0,1,0,76.14,73.87 ,33.33
03,012,01,002,0096,260 ,566,4,570,875,0,3,1,3,0,1,0,76.14,65.14 ,33.33
03,012,01,002,0096,261 ,550,7,557,844,0,3,1,3,0,1,0,76.14,66.00 ,33.33
03,012,01,002,0096,262 ,694,7,701,978,0,3,1,3,0,1,0,76.14,71.68 ,33.33
03,012,01,002,0097,263 ,634,7,641,925,0,3,1,3,0,1,0,76.14,69.30 ,33.33
03,012,01,002,0097,264 ,530,5,535,779,0,3,1,3,0,1,0,76.14,68.68 ,33.33
03,012,01,002,0098,265 ,568,6,574,779,0,3,1,3,0,1,0,76.14,73.68 ,33.33
03,012,01,002,0098,266 ,622,6,628,913,0,3,1,3,0,1,0,76.14,68.78 ,33.33
03,012,01,002,0099,267 ,614,10,624,917,0,3,1,3,0,1,0,76.14,68.05 ,33.33
03,012,01,002,0100,268 ,449,15,464,704,0,3,1,3,0,1,0,76.14,65.91 ,33.33
03,012,01,002,0101,269 ,708,9,717,1105,0,3,1,3,0,1,0,76.14,64.89 ,33.33
03,012,01,002,0101,270 ,631,8,639,1025,0,3,1,3,0,1,0,76.14,62.34 ,33.33
03,012,01,002,0102,271 ,347,3,350,617,0,3,1,3,0,1,0,76.14,56.73 ,33.33
03,012,01,002,0102,272 ,521,6,527,844,0,3,1,3,0,1,0,76.14,62.44 ,33.33
03,012,01,003,0103,273 ,656,7,663,931,0,3,1,3,0,1,0,76.14,71.21 ,33.33
03,012,01,003,0103,274 ,678,12,690,1044,0,3,1,3,0,1,0,76.14,66.09 ,33.33
03,012,01,003,0104,275 ,1011,13,1024,1386,0,3,1,3,0,1,0,76.14,73.88 ,33.33
03,012,01,003,0105,276 ,453,4,457,664,0,3,1,3,0,1,0,76.14,68.83 ,33.33
03,012,01,003,0105,277 ,616,4,620,828,0,3,1,3,0,1,0,76.14,74.88 ,33.33
03,012,01,003,0106,278 ,652,10,662,1062,0,3,1,3,0,1,0,76.14,62.34 ,33.33
03,012,01,003,0106,279 ,639,3,642,992,0,3,1,3,0,1,0,76.14,64.72 ,33.33
03,012,01,003,0106,280 ,546,7,553,859,0,3,1,3,0,1,0,76.14,64.38 ,33.33
03,012,01,003,0106,281 ,717,7,724,1113,0,3,1,3,0,1,0,76.14,65.05 ,33.33
03,012,01,003,0106,282 ,626,9,635,952,0,3,1,3,0,1,0,76.14,66.70 ,33.33
03,012,01,003,0106,283 ,683,7,690,1016,0,3,1,3,0,1,0,76.14,67.91 ,33.33
03,012,01,003,0106,284 ,644,4,648,1030,0,3,1,3,0,1,0,76.14,62.91 ,33.33
03,012,01,003,0106,285 ,735,10,745,1100,0,3,1,3,0,1,0,76.14,67.73 ,33.33
03,012,01,003,0107,286 ,727,32,759,1144,0,3,1,3,0,1,0,76.14,66.35 ,33.33
03,012,01,003,0107,287 ,801,7,808,1237,0,3,1,3,0,1,0,76.14,65.32 ,33.33
03,012,01,003,0107,288 ,754,12,766,1212,0,3,1,3,0,1,0,76.14,63.20 ,33.33
03,012,01,003,0107,289 ,837,11,848,1396,0,3,1,3,0,1,0,76.14,60.74 ,33.33
03,012,01,003,0108,290 ,673,10,683,956,0,3,1,3,0,1,0,76.14,71.44 ,33.33
03,012,01,003,0108,291 ,643,4,647,1009,0,3,1,3,0,1,0,76.14,64.12 ,33.33
03,012,01,003,0109,292 ,939,15,954,1419,0,3,1,3,0,1,0,76.14,67.23 ,33.33
03,012,01,003,0109,293 ,770,8,778,1188,0,3,1,3,0,1,0,76.14,65.49 ,33.33
03,012,01,003,0109,294 ,689,7,696,1077,0,3,1,3,0,1,0,76.14,64.62 ,33.33
03,012,01,003,0109,295 ,664,8,672,958,0,3,1,3,0,1,0,76.14,70.15 ,33.33
03,012,01,003,0109,296 ,611,12,623,888,0,3,1,3,0,1,0,76.14,70.16 ,33.33
03,012,01,003,0110,297 ,862,11,873,1224,0,3,1,3,0,1,0,76.14,71.32 ,33.33
03,012,01,003,0110,298 ,807,9,816,1133,0,3,1,3,0,1,0,76.14,72.02 ,33.33
03,012,01,003,0111,299 ,710,9,719,1015,0,3,1,3,0,1,0,76.14,70.84 ,33.33
03,012,01,003,0111,300 ,712,11,723,986,0,3,1,3,0,1,0,76.14,73.33 ,33.33
03,012,01,003,0112,301 ,593,8,601,816,0,3,1,3,0,1,0,76.14,73.65 ,33.33
03,012,01,003,0112,302 ,624,12,636,901,0,3,1,3,0,1,0,76.14,70.59 ,33.33
03,012,01,003,0112,303 ,715,5,720,977,0,3,1,3,0,1,0,76.14,73.69 ,33.33
03,012,01,003,0112,304 ,631,12,643,872,0,3,1,3,0,1,0,76.14,73.74 ,33.33
03,012,01,003,0113,305 ,996,13,1009,1414,0,3,1,3,0,1,0,76.14,71.36 ,33.33
03,012,01,003,0113,306 ,784,8,792,1182,0,3,1,3,0,1,0,76.14,67.01 ,33.33
03,012,01,003,0114,307 ,532,10,542,830,0,3,1,3,0,1,0,76.14,65.30 ,33.33
03,012,01,003,0114,308 ,596,7,603,932,0,3,1,3,0,1,0,76.14,64.70 ,33.33
03,012,01,003,0114,309 ,879,4,883,1196,0,3,1,3,0,1,0,76.14,73.83 ,33.33
03,012,01,003,0115,310 ,613,4,617,924,0,3,1,3,0,1,0,76.14,66.77 ,33.33
03,012,01,003,0115,311 ,593,6,599,919,0,3,1,3,0,1,0,76.14,65.18 ,33.33
03,012,01,003,0115,312 ,614,10,624,1032,0,3,1,3,0,1,0,76.14,60.47 ,33.33
03,012,01,003,0115,313 ,551,4,555,834,0,3,1,3,0,1,0,76.14,66.55 ,33.33
03,012,01,003,0115,314 ,755,6,761,1160,0,3,1,3,0,1,0,76.14,65.60 ,33.33
03,012,01,003,0115,315 ,661,6,667,989,0,3,1,3,0,1,0,76.14,67.44 ,33.33
03,012,01,003,0116,316 ,915,7,922,1295,0,3,1,3,0,1,0,76.14,71.20 ,33.33
03,012,01,003,0116,317 ,901,8,909,1344,0,3,1,3,0,1,0,76.14,67.63 ,33.33
03,012,01,003,0116,318 ,736,9,745,1279,0,3,1,3,0,1,0,76.14,58.25 ,33.33
03,012,01,003,0116,319 ,991,9,1000,1578,0,3,1,3,0,1,0,76.14,63.37 ,33.33
03,012,01,003,0117,320 ,610,6,616,944,0,3,1,3,0,1,0,76.14,65.25 ,33.33
03,012,01,003,0117,321 ,740,4,744,1028,0,3,1,3,0,1,0,76.14,72.37 ,33.33
03,012,01,003,0117,322 ,879,8,887,1367,0,3,1,3,0,1,0,76.14,64.89 ,33.33
03,012,01,003,0117,323 ,728,2,730,1071,0,3,1,3,0,1,0,76.14,68.16 ,33.33
03,012,01,003,0118,324 ,885,7,892,1278,0,3,1,3,0,1,0,76.14,69.80 ,33.33
03,012,01,003,0118,325 ,842,9,851,1291,0,3,1,3,0,1,0,76.14,65.92 ,33.33
03,012,01,003,0118,326 ,813,7,820,1284,0,3,1,3,0,1,0,76.14,63.86 ,33.33
03,012,01,003,0119,327 ,713,3,716,1077,0,3,1,3,0,1,0,76.14,66.48 ,33.33
03,012,01,003,0119,328 ,672,3,675,954,0,3,1,3,0,1,0,76.14,70.75 ,33.33
03,012,01,003,0120,329 ,773,11,784,1276,0,3,1,3,0,1,0,76.14,61.44 ,33.33
03,012,01,003,0120,330 ,900,6,906,1484,0,3,1,3,0,1,0,76.14,61.05 ,33.33
03,012,01,003,0120,331 ,867,4,871,1346,0,3,1,3,0,1,0,76.14,64.71 ,33.33
03,012,01,003,0120,332 ,741,9,750,1225,0,3,1,3,0,1,0,76.14,61.22 ,33.33
03,012,01,003,0121,333 ,500,8,508,705,0,3,1,3,0,1,0,76.14,72.06 ,33.33
03,012,01,003,0121,334 ,377,4,381,567,0,3,1,3,0,1,0,76.14,67.20 ,33.33
03,012,01,003,0122,335 ,672,12,684,1223,0,3,1,3,0,1,0,76.14,55.93 ,33.33
03,012,01,003,0122,336 ,584,6,590,901,0,3,1,3,0,1,0,76.14,65.48 ,33.33
03,012,01,003,0122,337 ,442,2,444,863,0,3,1,3,0,1,0,76.14,51.45 ,33.33
03,012,01,003,0122,338 ,293,3,296,435,0,3,1,3,0,1,0,76.14,68.05 ,33.33
03,012,01,003,0123,339 ,872,18,890,1367,0,3,1,3,0,1,0,76.14,65.11 ,33.33
03,012,01,003,0124,340 ,706,8,714,1069,0,3,1,3,0,1,0,76.14,66.79 ,33.33
03,012,01,003,0124,341 ,446,9,455,658,0,3,1,3,0,1,0,76.14,69.15 ,33.33
03,012,01,003,0125,342 ,891,11,902,1278,0,3,1,3,0,1,0,76.14,70.58 ,33.33
03,012,01,003,0125,343 ,912,5,917,1262,0,3,1,3,0,1,0,76.14,72.66 ,33.33
03,012,01,003,0126,344 ,867,13,880,1219,0,3,1,3,0,1,0,76.14,72.19 ,33.33
03,012,01,003,0127,345 ,698,5,703,1026,0,3,1,3,0,1,0,76.14,68.52 ,33.33
03,012,01,003,0127,346 ,671,7,678,979,0,3,1,3,0,1,0,76.14,69.25 ,33.33
03,012,01,003,0127,347 ,558,3,561,915,0,3,1,3,0,1,0,76.14,61.31 ,33.33
03,012,01,003,0128,348 ,633,2,635,973,0,3,1,3,0,1,0,76.14,65.26 ,33.33
03,012,01,003,0128,349 ,543,9,552,785,0,3,1,3,0,1,0,76.14,70.32 ,33.33
03,012,01,004,0129,350 ,679,9,688,1017,0,3,1,3,0,1,0,76.14,67.65 ,33.33
03,012,01,004,0129,351 ,652,6,658,1033,0,3,1,3,0,1,0,76.14,63.70 ,33.33
03,012,01,004,0130,352 ,980,17,997,1633,0,3,1,3,0,1,0,76.14,61.05 ,33.33
03,012,01,004,0130,353 ,864,9,873,1237,0,3,1,3,0,1,0,76.14,70.57 ,33.33
03,012,01,004,0130,354 ,733,14,747,1152,0,3,1,3,0,1,0,76.14,64.84 ,33.33
03,012,01,004,0131,355 ,977,16,993,1426,0,3,1,3,0,1,0,76.14,69.64 ,33.33
03,012,01,004,0131,356 ,778,9,787,1092,0,3,1,3,0,1,0,76.14,72.07 ,33.33
03,012,01,004,0131,357 ,1015,13,1028,1493,0,3,1,3,0,1,0,76.14,68.85 ,33.33
03,012,01,004,0132,358 ,777,7,784,1088,0,3,1,3,0,1,0,76.14,72.06 ,33.33
03,012,01,004,0132,359 ,715,5,720,1058,0,3,1,3,0,1,0,76.14,68.05 ,33.33
03,012,01,004,0133,360 ,773,9,782,1078,0,3,1,3,0,1,0,76.14,72.54 ,33.33
03,012,01,004,0133,361 ,813,6,819,1155,0,3,1,3,0,1,0,76.14,70.91 ,33.33
03,012,01,004,0134,362 ,552,6,558,760,0,3,1,3,0,1,0,76.14,73.42 ,33.33
03,012,01,004,0134,363 ,537,7,544,791,0,3,1,3,0,1,0,76.14,68.77 ,33.33
03,012,01,004,0135,364 ,874,9,883,1226,0,3,1,3,0,1,0,76.14,72.02 ,33.33
03,012,01,004,0136,365 ,531,6,537,725,0,3,1,3,0,1,0,76.14,74.07 ,33.33
03,012,01,004,0136,366 ,622,5,627,841,0,3,1,3,0,1,0,76.14,74.55 ,33.33
03,012,01,004,0137,367 ,812,6,818,1125,0,3,1,3,0,1,0,76.14,72.71 ,33.33
03,012,01,004,0137,368 ,761,9,770,1043,0,3,1,3,0,1,0,76.14,73.83 ,33.33
03,012,01,004,0138,369 ,773,6,779,1107,0,3,1,3,0,1,0,76.14,70.37 ,33.33
03,012,01,004,0138,370 ,623,4,627,922,0,3,1,3,0,1,0,76.14,68.00 ,33.33
03,012,01,004,0138,371 ,715,6,721,1068,0,3,1,3,0,1,0,76.14,67.51 ,33.33
03,012,01,004,0139,372 ,721,6,727,1061,0,3,1,3,0,1,0,76.14,68.52 ,33.33
03,012,01,004,0140,373 ,674,4,678,952,0,3,1,3,0,1,0,76.14,71.22 ,33.33
03,012,01,004,0141,374 ,689,12,701,988,0,3,1,3,0,1,0,76.14,70.95 ,33.33
03,012,01,004,0142,375 ,557,4,561,831,0,3,1,3,0,1,0,76.14,67.51 ,33.33
03,012,01,004,0143,376 ,916,7,923,1328,0,3,1,3,0,1,0,76.14,69.50 ,33.33
03,012,01,004,0144,377 ,569,2,571,812,0,3,1,3,0,1,0,76.14,70.32 ,33.33
03,012,01,004,0144,378 ,651,8,659,953,0,3,1,3,0,1,0,76.14,69.15 ,33.33
03,012,01,004,0145,379 ,672,2,674,988,0,3,1,3,0,1,0,76.14,68.22 ,33.33
03,012,01,004,0145,380 ,492,3,495,917,0,3,1,3,0,1,0,76.14,53.98 ,33.33
03,012,01,004,0146,381 ,450,6,456,631,0,3,1,3,0,1,0,76.14,72.27 ,33.33
03,012,01,005,0147,382 ,623,15,638,965,0,3,1,3,0,1,0,76.14,66.11 ,33.33
03,012,01,005,0148,383 ,757,12,769,1087,0,3,1,3,0,1,0,76.14,70.75 ,33.33
03,012,01,005,0148,384 ,545,9,554,931,0,3,1,3,0,1,0,76.14,59.51 ,33.33
03,012,01,005,0149,385 ,627,8,635,986,0,3,1,3,0,1,0,76.14,64.40 ,33.33
03,012,01,005,0149,386 ,600,7,607,922,0,3,1,3,0,1,0,76.14,65.84 ,33.33
03,012,01,005,0149,387 ,736,6,742,1079,0,3,1,3,0,1,0,76.14,68.77 ,33.33
03,012,01,005,0149,388 ,676,9,685,990,0,3,1,3,0,1,0,76.14,69.19 ,33.33
03,012,01,005,0150,389 ,815,7,822,1196,0,3,1,3,0,1,0,76.14,68.73 ,33.33
03,012,01,005,0150,390 ,882,5,887,1305,0,3,1,3,0,1,0,76.14,67.97 ,33.33
03,012,01,005,0151,391 ,1019,10,1029,1522,0,3,1,3,0,1,0,76.14,67.61 ,33.33
03,012,01,005,0151,392 ,698,7,705,1011,0,3,1,3,0,1,0,76.14,69.73 ,33.33
03,012,01,005,0152,393 ,699,4,703,960,0,3,1,3,0,1,0,76.14,73.23 ,33.33
03,012,01,005,0152,394 ,914,9,923,1378,0,3,1,3,0,1,0,76.14,66.98 ,33.33
03,012,01,005,0152,395 ,742,11,753,1124,0,3,1,3,0,1,0,76.14,66.99 ,33.33
03,012,01,005,0152,396 ,685,10,695,1074,0,3,1,3,0,1,0,76.14,64.71 ,33.33
03,012,01,005,0153,397 ,740,9,749,1196,0,3,1,3,0,1,0,76.14,62.63 ,33.33
03,012,01,005,0153,398 ,772,8,780,1196,0,3,1,3,0,1,0,76.14,65.22 ,33.33
03,012,01,005,0153,399 ,711,8,719,1096,0,3,1,3,0,1,0,76.14,65.60 ,33.33
03,012,01,005,0154,400 ,1003,11,1014,1429,0,3,1,3,0,1,0,76.14,70.96 ,33.33
03,012,01,005,0154,401 ,824,12,836,1311,0,3,1,3,0,1,0,76.14,63.77 ,33.33
03,012,01,005,0155,402 ,1030,18,1048,1449,0,3,1,3,0,1,0,76.14,72.33 ,33.33
03,012,01,006,0156,403 ,902,7,909,1379,0,3,1,3,0,1,0,76.14,65.92 ,33.33
03,012,01,006,0156,404 ,846,14,860,1285,0,3,1,3,0,1,0,76.14,66.93 ,33.33
03,012,01,006,0156,405 ,929,10,939,1358,0,3,1,3,0,1,0,76.14,69.15 ,33.33
03,012,01,006,0157,406 ,773,9,782,1180,0,3,1,3,0,1,0,76.14,66.27 ,33.33
03,012,01,006,0157,407 ,877,10,887,1463,0,3,1,3,0,1,0,76.14,60.63 ,33.33
03,012,01,006,0157,408 ,647,9,656,981,0,3,1,3,0,1,0,76.14,66.87 ,33.33
03,012,01,006,0157,409 ,541,1,542,897,0,3,1,3,0,1,0,76.14,60.42 ,33.33
03,012,01,006,0158,410 ,641,9,650,987,0,3,1,3,0,1,0,76.14,65.86 ,33.33
03,012,01,006,0158,411 ,676,6,682,1077,0,3,1,3,0,1,0,76.14,63.32 ,33.33
03,012,01,006,0159,412 ,780,13,793,1109,0,3,1,3,0,1,0,76.14,71.51 ,33.33
03,012,01,006,0159,413 ,694,9,703,1056,0,3,1,3,0,1,0,76.14,66.57 ,33.33
03,012,01,006,0160,414 ,780,12,792,1264,0,3,1,3,0,1,0,76.14,62.66 ,33.33
03,012,01,006,0161,415 ,739,8,747,1115,0,3,1,3,0,1,0,76.14,67.00 ,33.33
03,012,01,006,0161,416 ,871,10,881,1448,0,3,1,3,0,1,0,76.14,60.84 ,33.33
03,012,01,006,0161,417 ,672,14,686,1109,0,3,1,3,0,1,0,76.14,61.86 ,33.33
03,012,01,006,0161,418 ,667,10,677,1222,0,3,1,3,0,1,0,76.14,55.40 ,33.33
03,012,01,006,0162,419 ,690,10,700,1151,0,3,1,3,0,1,0,76.14,60.82 ,33.33
03,012,01,006,0162,420 ,657,14,671,975,0,3,1,3,0,1,0,76.14,68.82 ,33.33
03,012,01,006,0163,421 ,594,8,602,886,0,3,1,3,0,1,0,76.14,67.95 ,33.33
03,012,01,006,0163,422 ,581,18,599,812,0,3,1,3,0,1,0,76.14,73.77 ,33.33
03,012,01,006,0164,423 ,994,14,1008,1622,0,3,1,3,0,1,0,76.14,62.15 ,33.33
03,012,01,006,0165,424 ,644,14,658,974,0,3,1,3,0,1,0,76.14,67.56 ,33.33
03,012,01,006,0165,425 ,523,9,532,842,0,3,1,3,0,1,0,76.14,63.18 ,33.33
03,012,01,006,0166,426 ,657,9,666,991,0,3,1,3,0,1,0,76.14,67.20 ,33.33
03,012,01,006,0166,427 ,478,4,482,803,0,3,1,3,0,1,0,76.14,60.02 ,33.33
03,012,01,006,0167,428 ,945,6,951,1473,0,3,1,3,0,1,0,76.14,64.56 ,33.33
03,012,01,006,0167,429 ,894,12,906,1406,0,3,1,3,0,1,0,76.14,64.44 ,33.33
03,012,01,006,0168,430 ,767,7,774,1217,0,3,1,3,0,1,0,76.14,63.60 ,33.33
03,012,01,006,0169,431 ,822,10,832,1303,0,3,1,3,0,1,0,76.14,63.85 ,33.33
03,012,01,006,0169,432 ,811,15,826,1218,0,3,1,3,0,1,0,76.14,67.82 ,33.33
03,012,01,006,0170,433 ,1062,11,1073,1590,0,3,1,3,0,1,0,76.14,67.48 ,33.33
03,012,01,006,0170,434 ,683,9,692,1081,0,3,1,3,0,1,0,76.14,64.01 ,33.33
03,012,01,006,0171,435 ,412,6,418,571,0,3,1,3,0,1,0,76.14,73.20 ,33.33
03,012,01,007,0172,436 ,1054,7,1061,1702,0,3,1,3,0,1,0,76.14,62.34 ,33.33
03,012,01,007,0172,437 ,918,11,929,1366,0,3,1,3,0,1,0,76.14,68.01 ,33.33
03,012,01,007,0172,438 ,782,5,787,1420,0,3,1,3,0,1,0,76.14,55.42 ,33.33
03,012,01,007,0172,439 ,705,9,714,1190,0,3,1,3,0,1,0,76.14,60.00 ,33.33
03,012,01,007,0172,440 ,906,17,923,1387,0,3,1,3,0,1,0,76.14,66.55 ,33.33
03,012,01,007,0173,441 ,805,14,819,1121,0,3,1,3,0,1,0,76.14,73.06 ,33.33
03,012,01,007,0173,442 ,817,9,826,1335,0,3,1,3,0,1,0,76.14,61.87 ,33.33
03,012,01,007,0174,443 ,1037,19,1056,1498,0,3,1,3,0,1,0,76.14,70.49 ,33.33
03,012,01,007,0174,444 ,967,11,978,1595,0,3,1,3,0,1,0,76.14,61.32 ,33.33
03,012,01,007,0174,445 ,736,6,742,1297,0,3,1,3,0,1,0,76.14,57.21 ,33.33
03,012,01,007,0174,446 ,762,10,772,1314,0,3,1,3,0,1,0,76.14,58.75 ,33.33
03,012,01,007,0174,447 ,806,7,813,1328,0,3,1,3,0,1,0,76.14,61.22 ,33.33
03,012,01,007,0175,448 ,903,11,914,1276,0,3,1,3,0,1,0,76.14,71.63 ,33.33
03,012,01,007,0175,449 ,1029,18,1047,1486,0,3,1,3,0,1,0,76.14,70.46 ,33.33
03,012,01,007,0176,450 ,875,14,889,1279,0,3,1,3,0,1,0,76.14,69.51 ,33.33
03,012,01,007,0176,451 ,996,7,1003,1305,0,3,1,3,0,1,0,76.14,76.86 ,33.33
03,012,01,007,0176,452 ,1055,15,1070,1623,0,3,1,3,0,1,0,76.14,65.93 ,33.33
03,012,01,007,0176,453 ,839,10,849,1364,0,3,1,3,0,1,0,76.14,62.24 ,33.33
03,012,01,007,0177,454 ,1084,9,1093,1540,0,3,1,3,0,1,0,76.14,70.97 ,33.33
03,012,01,007,0177,455 ,1041,17,1058,1539,0,3,1,3,0,1,0,76.14,68.75 ,33.33
03,012,01,007,0178,456 ,451,5,456,657,0,3,1,3,0,1,0,76.14,69.41 ,33.33
03,012,01,008,0179,457 ,905,7,912,1342,0,3,1,3,0,1,0,76.14,67.96 ,33.33
03,012,01,008,0179,458 ,718,6,724,1163,0,3,1,3,0,1,0,76.14,62.25 ,33.33
03,012,01,008,0179,459 ,719,6,725,1131,0,3,1,3,0,1,0,76.14,64.10 ,33.33
03,012,01,008,0180,460 ,865,7,872,1273,0,3,1,3,0,1,0,76.14,68.50 ,33.33
03,012,01,008,0181,461 ,734,8,742,1197,0,3,1,3,0,1,0,76.14,61.99 ,33.33
03,012,01,008,0181,462 ,708,16,724,1080,0,3,1,3,0,1,0,76.14,67.04 ,33.33
03,012,01,008,0181,463 ,431,1,432,655,0,3,1,3,0,1,0,76.14,65.95 ,33.33
03,012,01,008,0182,464 ,391,2,393,604,0,3,1,3,0,1,0,76.14,65.07 ,33.33
03,012,01,008,0182,465 ,431,5,436,631,0,3,1,3,0,1,0,76.14,69.10 ,33.33
03,012,01,008,0183,466 ,830,11,841,1219,0,3,1,3,0,1,0,76.14,68.99 ,33.33
03,012,01,008,0184,467 ,853,9,862,1212,0,3,1,3,0,1,0,76.14,71.12 ,33.33
03,012,01,008,0185,468 ,788,11,799,1212,0,3,1,3,0,1,0,76.14,65.92 ,33.33
03,012,01,008,0185,469 ,1031,5,1036,1679,0,3,1,3,0,1,0,76.14,61.70 ,33.33
03,012,01,008,0186,470 ,977,14,991,1540,0,3,1,3,0,1,0,76.14,64.35 ,33.33
03,012,01,008,0186,471 ,834,4,838,1325,0,3,1,3,0,1,0,76.14,63.25 ,33.33
03,012,01,008,0187,472 ,1051,12,1063,1511,0,3,1,3,0,1,0,76.14,70.35 ,33.33
03,012,01,008,0187,473 ,788,6,794,1233,0,3,1,3,0,1,0,76.14,64.40 ,33.33
03,012,01,008,0188,474 ,871,8,879,1404,0,3,1,3,0,1,0,76.14,62.61 ,33.33
03,012,01,008,0188,475 ,863,12,875,1346,0,3,1,3,0,1,0,76.14,65.01 ,33.33
03,012,01,008,0188,476 ,813,11,824,1226,0,3,1,3,0,1,0,76.14,67.21 ,33.33
03,012,01,008,0189,477 ,1110,16,1126,1676,0,3,1,3,0,1,0,76.14,67.18 ,33.33
03,012,01,008,0189,478 ,1098,10,1108,1673,0,3,1,3,0,1,0,76.14,66.23 ,33.33
03,012,01,008,0190,479 ,415,3,418,572,0,3,1,3,0,1,0,76.14,73.08 ,33.33
03,012,01,008,0191,480 ,726,16,742,1125,0,3,1,3,0,1,0,76.14,65.96 ,33.33
03,012,01,008,0191,481 ,870,14,884,1324,0,3,1,3,0,1,0,76.14,66.77 ,33.33
03,012,01,008,0192,482 ,611,13,624,941,0,3,1,3,0,1,0,76.14,66.31 ,33.33
03,012,01,008,0192,483 ,571,7,578,802,0,3,1,3,0,1,0,76.14,72.07 ,33.33
03,012,01,008,0193,484 ,708,6,714,1042,0,3,1,3,0,1,0,76.14,68.52 ,33.33
03,012,01,008,0193,485 ,653,3,656,955,0,3,1,3,0,1,0,76.14,68.69 ,33.33
03,012,01,008,0193,486 ,872,8,880,1263,0,3,1,3,0,1,0,76.14,69.68 ,33.33
03,012,01,008,0194,487 ,775,11,786,1244,0,3,1,3,0,1,0,76.14,63.18 ,33.33
03,012,01,008,0194,488 ,856,6,862,1310,0,3,1,3,0,1,0,76.14,65.80 ,33.33
03,012,01,008,0194,489 ,382,6,388,530,0,3,1,3,0,1,0,76.14,73.21 ,33.33
03,012,01,008,0195,490 ,973,6,979,1360,0,3,1,3,0,1,0,76.14,71.99 ,33.33
03,012,01,008,0196,491 ,640,4,644,1088,0,3,1,3,0,1,0,76.14,59.19 ,33.33
03,012,01,008,0196,492 ,711,5,716,1041,0,3,1,3,0,1,0,76.14,68.78 ,33.33
03,012,01,008,0196,493 ,739,10,749,1124,0,3,1,3,0,1,0,76.14,66.64 ,33.33
03,012,01,008,0196,494 ,850,17,867,1396,0,3,1,3,0,1,0,76.14,62.11 ,33.33
03,012,01,008,0197,495 ,760,7,767,1134,0,3,1,3,0,1,0,76.14,67.64 ,33.33
03,012,01,008,0197,496 ,525,7,532,791,0,3,1,3,0,1,0,76.14,67.26 ,33.33
03,012,01,008,0198,497 ,934,9,943,1357,0,3,1,3,0,1,0,76.14,69.49 ,33.33
03,012,01,008,0199,498 ,658,5,663,872,0,3,1,3,0,1,0,76.14,76.03 ,33.33
03,012,01,008,0200,499 ,874,7,881,1215,0,3,1,3,0,1,0,76.14,72.51 ,33.33
03,012,01,008,0201,500 ,747,8,755,1035,0,3,1,3,0,1,0,76.14,72.95 ,33.33
03,012,01,008,0202,501 ,731,11,742,1071,0,3,1,3,0,1,0,76.14,69.28 ,33.33
03,012,01,008,0202,502 ,692,4,696,1032,0,3,1,3,0,1,0,76.14,67.44 ,33.33
03,012,01,008,0202,503 ,705,12,717,1077,0,3,1,3,0,1,0,76.14,66.57 ,33.33
03,012,01,008,0203,504 ,949,14,963,1334,0,3,1,3,0,1,0,76.14,72.19 ,33.33
03,012,01,008,0203,505 ,228,1,229,290,0,3,1,3,0,1,0,76.14,78.97 ,33.33
03,012,01,008,0204,506 ,555,18,573,737,0,3,1,3,0,1,0,76.14,77.75 ,33.33
03,012,01,008,0205,507 ,1077,11,1088,1341,0,3,1,3,0,1,0,76.14,81.13 ,33.33
03,012,01,008,0206,508 ,539,6,545,731,0,3,1,3,0,1,0,76.14,74.56 ,33.33
03,012,01,008,0207,509 ,594,12,606,869,0,3,1,3,0,1,0,76.14,69.74 ,33.33
03,012,01,008,0208,510 ,286,2,288,430,0,3,1,3,0,1,0,76.14,66.98 ,33.33
03,012,01,008,0209,511 ,613,11,624,916,0,3,1,3,0,1,0,76.14,68.12 ,33.33
03,012,01,008,0210,512 ,648,7,655,944,0,3,1,3,0,1,0,76.14,69.39 ,33.33
03,012,01,008,0210,513 ,785,12,797,1180,0,3,1,3,0,1,0,76.14,67.54 ,33.33
03,012,01,008,0211,514 ,394,3,397,603,0,3,1,3,0,1,0,76.14,65.84 ,33.33
03,012,01,008,0211,515 ,535,9,544,758,0,3,1,3,0,1,0,76.14,71.77 ,33.33
03,012,01,008,0212,516 ,395,4,399,546,0,3,1,3,0,1,0,76.14,73.08 ,33.33
03,012,01,008,0212,517 ,474,9,483,648,0,3,1,3,0,1,0,76.14,74.54 ,33.33
03,012,01,008,0213,518 ,286,9,295,450,0,3,1,3,0,1,0,76.14,65.56 ,33.33
03,012,01,009,0214,519 ,644,11,655,976,0,3,1,3,0,1,0,76.14,67.11 ,33.33
03,012,01,009,0214,520 ,463,4,467,644,0,3,1,3,0,1,0,76.14,72.52 ,33.33
03,012,01,009,0215,521 ,592,15,607,881,0,3,1,3,0,1,0,76.14,68.90 ,33.33
03,012,01,009,0216,522 ,186,1,187,258,0,3,1,3,0,1,0,76.14,72.48 ,33.33
03,012,01,009,0217,523 ,624,4,628,904,0,3,1,3,0,1,0,76.14,69.47 ,33.33
03,012,01,009,0217,524 ,828,8,836,1233,0,3,1,3,0,1,0,76.14,67.80 ,33.33
03,012,01,009,0218,525 ,670,10,680,1032,0,3,1,3,0,1,0,76.14,65.89 ,33.33
03,012,01,009,0218,526 ,740,7,747,1102,0,3,1,3,0,1,0,76.14,67.79 ,33.33
03,012,01,009,0219,527 ,746,9,755,1117,0,3,1,3,0,1,0,76.14,67.59 ,33.33
03,012,01,009,0219,528 ,737,8,745,1088,0,3,1,3,0,1,0,76.14,68.47 ,33.33
03,012,01,009,0219,529 ,657,7,664,962,0,3,1,3,0,1,0,76.14,69.02 ,33.33
03,012,01,009,0220,530 ,584,7,591,779,0,3,1,3,0,1,0,76.14,75.87 ,33.33
03,012,01,009,0220,531 ,234,6,240,313,0,3,1,3,0,1,0,76.14,76.68 ,33.33
03,012,01,009,0220,532 ,142,1,143,190,0,3,1,3,0,1,0,76.14,75.26 ,33.33
03,012,01,009,0221,533 ,757,14,771,1081,0,3,1,3,0,1,0,76.14,71.32 ,33.33
03,012,01,009,0221,534 ,538,11,549,826,0,3,1,3,0,1,0,76.14,66.46 ,33.33
03,012,01,009,0222,535 ,714,13,727,1033,0,3,1,3,0,1,0,76.14,70.38 ,33.33
03,012,01,009,0222,536 ,748,11,759,1001,0,3,1,3,0,1,0,76.14,75.82 ,33.33
03,012,01,009,0223,537 ,781,10,791,1069,0,3,1,3,0,1,0,76.14,73.99 ,33.33
03,012,01,009,0224,538 ,864,7,871,1325,0,3,1,3,0,1,0,76.14,65.74 ,33.33
03,012,01,009,0224,539 ,671,11,682,988,0,3,1,3,0,1,0,76.14,69.03 ,33.33
03,012,01,009,0224,540 ,255,10,265,316,0,3,1,3,0,1,0,76.14,83.86 ,33.33
03,012,01,009,0225,541 ,841,7,848,1133,0,3,1,3,0,1,0,76.14,74.85 ,33.33
03,012,01,009,0225,542 ,481,7,488,713,0,3,1,3,0,1,0,76.14,68.44 ,33.33
03,012,01,009,0226,543 ,535,8,543,729,0,3,1,3,0,1,0,76.14,74.49 ,33.33
03,012,01,009,0226,544 ,536,12,548,738,0,3,1,3,0,1,0,76.14,74.25 ,33.33
03,012,01,009,0227,545 ,723,11,734,1046,0,3,1,3,0,1,0,76.14,70.17 ,33.33
03,012,01,009,0227,546 ,806,12,818,1070,0,3,1,3,0,1,0,76.14,76.45 ,33.33
03,012,01,009,0228,547 ,726,9,735,1023,0,3,1,3,0,1,0,76.14,71.85 ,33.33
03,012,01,009,0229,548 ,413,5,418,549,0,3,1,3,0,1,0,76.14,76.14 ,33.33
03,012,01,009,0229,549 ,654,12,666,864,0,3,1,3,0,1,0,76.14,77.08 ,33.33
03,012,01,009,0230,550 ,432,2,434,647,0,3,1,3,0,1,0,76.14,67.08 ,33.33
03,012,01,010,0231,551 ,317,1,318,432,0,3,1,3,0,1,0,76.14,73.61 ,33.33
03,012,01,010,0232,552 ,802,16,818,1113,0,3,1,3,0,1,0,76.14,73.50 ,33.33
03,012,01,010,0233,553 ,990,8,998,1325,0,3,1,3,0,1,0,76.14,75.32 ,33.33
03,012,01,010,0233,554 ,664,8,672,883,0,3,1,3,0,1,0,76.14,76.10 ,33.33
03,012,01,010,0234,555 ,748,4,752,1035,0,3,1,3,0,1,0,76.14,72.66 ,33.33
03,012,01,010,0234,556 ,654,3,657,919,0,3,1,3,0,1,0,76.14,71.49 ,33.33
03,012,01,010,0234,557 ,711,4,715,1015,0,3,1,3,0,1,0,76.14,70.44 ,33.33
03,012,01,010,0235,558 ,966,13,979,1347,0,3,1,3,0,1,0,76.14,72.68 ,33.33
03,012,01,010,0235,559 ,923,9,932,1274,0,3,1,3,0,1,0,76.14,73.16 ,33.33
03,012,01,010,0236,560 ,546,8,554,786,0,3,1,3,0,1,0,76.14,70.48 ,33.33
03,012,01,010,0236,561 ,667,5,672,938,0,3,1,3,0,1,0,76.14,71.64 ,33.33
03,012,01,010,0237,562 ,958,17,975,1324,0,3,1,3,0,1,0,76.14,73.64 ,33.33
03,012,01,010,0237,563 ,1030,21,1051,1408,0,3,1,3,0,1,0,76.14,74.64 ,33.33
03,012,01,010,0237,564 ,162,6,168,290,0,3,1,3,0,1,0,76.14,57.93 ,33.33
03,012,01,010,0237,565 ,238,5,243,376,0,3,1,3,0,1,0,76.14,64.63 ,33.33
03,012,01,010,0237,566 ,364,13,377,639,0,3,1,3,0,1,0,76.14,59.00 ,33.33
03,012,01,010,0238,567 ,603,8,611,823,0,3,1,3,0,1,0,76.14,74.24 ,33.33
03,012,01,010,0238,568 ,435,12,447,554,0,3,1,3,0,1,0,76.14,80.69 ,33.33
03,012,01,010,0238,569 ,483,9,492,758,0,3,1,3,0,1,0,76.14,64.91 ,33.33
03,012,01,010,0239,570 ,689,11,700,1009,0,3,1,3,0,1,0,76.14,69.38 ,33.33
03,012,01,010,0239,571 ,878,15,893,1243,0,3,1,3,0,1,0,76.14,71.84 ,33.33
03,012,01,010,0240,572 ,648,13,661,918,0,3,1,3,0,1,0,76.14,72.00 ,33.33
03,012,01,010,0240,573 ,558,3,561,846,0,3,1,3,0,1,0,76.14,66.31 ,33.33
03,012,01,010,0241,574 ,887,12,899,1245,0,3,1,3,0,1,0,76.14,72.21 ,33.33
03,012,01,010,0241,575 ,814,18,832,1184,0,3,1,3,0,1,0,76.14,70.27 ,33.33
03,012,01,011,0242,576 ,243,1,244,356,0,3,1,3,0,1,0,76.14,68.54 ,33.33
03,012,01,011,0243,577 ,428,6,434,672,0,3,1,3,0,1,0,76.14,64.58 ,33.33
03,012,01,011,0244,578 ,718,10,728,966,0,3,1,3,0,1,0,76.14,75.36 ,33.33
03,012,01,011,0245,579 ,278,5,283,437,0,3,1,3,0,1,0,76.14,64.76 ,33.33
03,012,01,011,0246,580 ,570,14,584,898,0,3,1,3,0,1,0,76.14,65.03 ,33.33
03,012,01,011,0247,581 ,541,6,547,795,0,3,1,3,0,1,0,76.14,68.81 ,33.33
03,012,01,011,0247,582 ,378,8,386,557,0,3,1,3,0,1,0,76.14,69.30 ,33.33
03,012,01,011,0248,583 ,299,1,300,417,0,3,1,3,0,1,0,76.14,71.94 ,33.33
03,012,01,011,0249,584 ,295,2,297,452,0,3,1,3,0,1,0,76.14,65.71 ,33.33
03,012,01,011,0250,585 ,639,4,643,921,0,3,1,3,0,1,0,76.14,69.82 ,33.33
03,012,01,011,0251,586 ,984,17,1001,1332,0,3,1,3,0,1,0,76.14,75.15 ,33.33
03,012,01,012,0252,587 ,973,4,977,1517,0,3,1,3,0,1,0,76.14,64.40 ,33.33
03,012,01,012,0252,588 ,798,3,801,1185,0,3,1,3,0,1,0,76.14,67.59 ,33.33
03,012,01,012,0252,589 ,868,13,881,1319,0,3,1,3,0,1,0,76.14,66.79 ,33.33
03,012,01,012,0253,590 ,976,13,989,1430,0,3,1,3,0,1,0,76.14,69.16 ,33.33
03,012,01,012,0253,591 ,817,9,826,1217,0,3,1,3,0,1,0,76.14,67.87 ,33.33
03,012,01,012,0254,592 ,936,11,947,1433,0,3,1,3,0,1,0,76.14,66.09 ,33.33
03,012,01,012,0254,593 ,712,7,719,1075,0,3,1,3,0,1,0,76.14,66.88 ,33.33
03,012,01,012,0255,594 ,628,8,636,883,0,3,1,3,0,1,0,76.14,72.03 ,33.33
03,012,01,012,0255,595 ,706,6,712,1107,0,3,1,3,0,1,0,76.14,64.32 ,33.33
03,012,01,012,0256,596 ,875,11,886,1289,0,3,1,3,0,1,0,76.14,68.74 ,33.33
03,012,01,012,0257,597 ,804,14,818,1279,0,3,1,3,0,1,0,76.14,63.96 ,33.33
03,012,01,012,0258,598 ,654,12,666,1006,0,3,1,3,0,1,0,76.14,66.20 ,33.33
03,012,01,012,0258,599 ,564,3,567,905,0,3,1,3,0,1,0,76.14,62.65 ,33.33
03,012,01,012,0259,600 ,837,11,848,1125,0,3,1,3,0,1,0,76.14,75.38 ,33.33
03,012,01,012,0260,601 ,928,15,943,1303,0,3,1,3,0,1,0,76.14,72.37 ,33.33
03,012,01,012,0260,602 ,368,1,369,506,0,3,1,3,0,1,0,76.14,72.92 ,33.33
03,012,01,012,0261,603 ,481,7,488,701,0,3,1,3,0,1,0,76.14,69.61 ,33.33
03,012,01,012,0262,604 ,590,11,601,796,0,3,1,3,0,1,0,76.14,75.50 ,33.33
03,012,01,012,0262,605 ,532,6,538,779,0,3,1,3,0,1,0,76.14,69.06 ,33.33
03,012,01,012,0263,606 ,686,12,698,967,0,3,1,3,0,1,0,76.14,72.18 ,33.33
03,012,01,013,0264,607 ,560,6,566,789,0,3,1,3,0,1,0,76.14,71.74 ,33.33
03,012,01,013,0264,608 ,616,10,626,915,0,3,1,3,0,1,0,76.14,68.42 ,33.33
03,012,01,013,0265,609 ,880,10,890,1207,0,3,1,3,0,1,0,76.14,73.74 ,33.33
03,012,01,013,0265,610 ,921,12,933,1258,0,3,1,3,0,1,0,76.14,74.17 ,33.33
03,012,01,013,0266,611 ,683,10,693,936,0,3,1,3,0,1,0,76.14,74.04 ,33.33
03,012,01,013,0266,612 ,705,7,712,920,0,3,1,3,0,1,0,76.14,77.39 ,33.33
03,012,01,013,0266,613 ,697,29,726,1056,0,3,1,3,0,1,0,76.14,68.75 ,33.33
03,012,01,013,0267,614 ,628,8,636,941,0,3,1,3,0,1,0,76.14,67.59 ,33.33
03,012,01,013,0267,615 ,690,2,692,996,0,3,1,3,0,1,0,76.14,69.48 ,33.33
03,012,01,013,0268,616 ,542,6,548,789,0,3,1,3,0,1,0,76.14,69.46 ,33.33
03,012,01,013,0268,617 ,537,6,543,810,0,3,1,3,0,1,0,76.14,67.04 ,33.33
03,012,01,013,0269,618 ,641,5,646,897,0,3,1,3,0,1,0,76.14,72.02 ,33.33
03,012,01,013,0270,619 ,763,8,771,1069,0,3,1,3,0,1,0,76.14,72.12 ,33.33
03,012,01,013,0270,620 ,755,13,768,1148,0,3,1,3,0,1,0,76.14,66.90 ,33.33
03,012,01,013,0271,621 ,742,9,751,1088,0,3,1,3,0,1,0,76.14,69.03 ,33.33
03,012,01,013,0271,622 ,732,6,738,1107,0,3,1,3,0,1,0,76.14,66.67 ,33.33
03,012,01,013,0271,623 ,709,11,720,1198,0,3,1,3,0,1,0,76.14,60.10 ,33.33
03,012,01,013,0272,624 ,866,8,874,1379,0,3,1,3,0,1,0,76.14,63.38 ,33.33
03,012,01,013,0272,625 ,847,7,854,1332,0,3,1,3,0,1,0,76.14,64.11 ,33.33
03,012,01,013,0273,626 ,982,0,982,1475,0,3,1,3,0,1,0,76.14,66.58 ,33.33
03,012,01,013,0273,627 ,795,5,800,1146,0,3,1,3,0,1,0,76.14,69.81 ,33.33
03,012,01,013,0274,628 ,652,8,660,890,0,3,1,3,0,1,0,76.14,74.16 ,33.33
03,012,01,013,0274,629 ,777,13,790,1137,0,3,1,3,0,1,0,76.14,69.48 ,33.33
03,012,01,013,0275,630 ,720,7,727,1066,0,3,1,3,0,1,0,76.14,68.20 ,33.33
03,012,01,013,0275,631 ,671,7,678,1007,0,3,1,3,0,1,0,76.14,67.33 ,33.33
03,012,01,013,0276,632 ,835,10,845,1203,0,3,1,3,0,1,0,76.14,70.24 ,33.33
03,012,01,013,0276,633 ,962,13,975,1381,0,3,1,3,0,1,0,76.14,70.60 ,33.33
03,012,01,013,0277,634 ,708,3,711,1143,0,3,1,3,0,1,0,76.14,62.20 ,33.33
03,012,01,013,0277,635 ,818,8,826,1305,0,3,1,3,0,1,0,76.14,63.30 ,33.33
03,012,01,013,0278,636 ,826,7,833,1165,0,3,1,3,0,1,0,76.14,71.50 ,33.33
03,012,01,013,0279,637 ,761,11,772,1153,0,3,1,3,0,1,0,76.14,66.96 ,33.33
03,012,01,013,0280,638 ,664,8,672,916,0,3,1,3,0,1,0,76.14,73.36 ,33.33
03,012,01,013,0281,639 ,796,7,803,1061,0,3,1,3,0,1,0,76.14,75.68 ,33.33
03,012,01,013,0282,640 ,629,6,635,852,0,3,1,3,0,1,0,76.14,74.53 ,33.33
03,012,01,013,0283,641 ,975,10,985,1425,0,3,1,3,0,1,0,76.14,69.12 ,33.33
03,012,01,014,0284,642 ,437,7,444,666,0,3,1,3,0,1,0,76.14,66.67 ,33.33
03,012,01,014,0284,643 ,530,6,536,787,0,3,1,3,0,1,0,76.14,68.11 ,33.33
03,012,01,014,0284,644 ,704,4,708,1044,0,3,1,3,0,1,0,76.14,67.82 ,33.33
03,012,01,014,0285,645 ,723,16,739,1048,0,3,1,3,0,1,0,76.14,70.52 ,33.33
03,012,01,014,0286,646 ,628,11,639,924,0,3,1,3,0,1,0,76.14,69.16 ,33.33
03,012,01,014,0286,647 ,984,14,998,1651,0,3,1,3,0,1,0,76.14,60.45 ,33.33
03,012,01,014,0286,648 ,468,3,471,714,0,3,1,3,0,1,0,76.14,65.97 ,33.33
03,012,01,014,0286,649 ,705,9,714,1183,0,3,1,3,0,1,0,76.14,60.36 ,33.33
03,012,01,014,0287,650 ,510,5,515,764,0,3,1,3,0,1,0,76.14,67.41 ,33.33
03,012,01,014,0287,651 ,587,11,598,946,0,3,1,3,0,1,0,76.14,63.21 ,33.33
03,012,01,014,0288,652 ,790,12,802,1167,0,3,1,3,0,1,0,76.14,68.72 ,33.33
03,012,01,014,0289,653 ,679,5,684,1081,0,3,1,3,0,1,0,76.14,63.27 ,33.33
03,012,01,014,0290,654 ,549,8,557,838,0,3,1,3,0,1,0,76.14,66.47 ,33.33
03,012,01,014,0291,655 ,446,8,454,695,0,3,1,3,0,1,0,76.14,65.32 ,33.33
03,012,01,014,0291,656 ,515,7,522,878,0,3,1,3,0,1,0,76.14,59.45 ,33.33
03,012,01,014,0292,657 ,548,13,561,860,0,3,1,3,0,1,0,76.14,65.23 ,33.33
03,012,01,014,0292,658 ,573,7,580,912,0,3,1,3,0,1,0,76.14,63.60 ,33.33
03,012,01,014,0293,659 ,783,13,796,1157,0,3,1,3,0,1,0,76.14,68.80 ,33.33
03,012,01,014,0294,660 ,594,13,607,911,0,3,1,3,0,1,0,76.14,66.63 ,33.33
03,012,01,014,0294,661 ,682,7,689,1108,0,3,1,3,0,1,0,76.14,62.18 ,33.33
03,012,01,014,0295,662 ,551,15,566,992,0,3,1,3,0,1,0,76.14,57.06 ,33.33
03,012,01,014,0296,663 ,478,4,482,739,0,3,1,3,0,1,0,76.14,65.22 ,33.33
03,012,01,015,0297,664 ,736,13,749,1056,0,3,1,3,0,1,0,76.14,70.93 ,33.33
03,012,01,015,0298,665 ,606,6,612,878,0,3,1,3,0,1,0,76.14,69.70 ,33.33
03,012,01,015,0299,666 ,1053,12,1065,1563,0,3,1,3,0,1,0,76.14,68.14 ,33.33
03,012,01,015,0300,667 ,766,8,774,1247,0,3,1,3,0,1,0,76.14,62.07 ,33.33
03,012,01,015,0300,668 ,954,8,962,1543,0,3,1,3,0,1,0,76.14,62.35 ,33.33
03,012,01,015,0301,669 ,910,5,915,1392,0,3,1,3,0,1,0,76.14,65.73 ,33.33
03,012,01,015,0302,670 ,1168,9,1177,1853,0,3,1,3,0,1,0,76.14,63.52 ,33.33
03,012,01,015,0303,671 ,755,8,763,1194,0,3,1,3,0,1,0,76.14,63.90 ,33.33
03,012,01,015,0304,672 ,659,5,664,1006,0,3,1,3,0,1,0,76.14,66.00 ,33.33
03,012,01,015,0305,673 ,791,10,801,1270,0,3,1,3,0,1,0,76.14,63.07 ,33.33
03,012,01,015,0306,674 ,868,18,886,1304,0,3,1,3,0,1,0,76.14,67.94 ,33.33
03,012,01,015,0307,675 ,776,7,783,1275,0,3,1,3,0,1,0,76.14,61.41 ,33.33
03,012,01,015,0307,676 ,1006,14,1020,1628,0,3,1,3,0,1,0,76.14,62.65 ,33.33
03,012,01,015,0308,677 ,766,8,774,1205,0,3,1,3,0,1,0,76.14,64.23 ,33.33
03,012,01,015,0309,678 ,680,5,685,1053,0,3,1,3,0,1,0,76.14,65.05 ,33.33
03,012,01,015,0310,679 ,774,7,781,1239,0,3,1,3,0,1,0,76.14,63.03 ,33.33
03,012,01,015,0311,680 ,1056,12,1068,1492,0,3,1,3,0,1,0,76.14,71.58 ,33.33
03,012,01,015,0311,681 ,1095,14,1109,1867,0,3,1,3,0,1,0,76.14,59.40 ,33.33
03,012,01,016,0312,682 ,508,5,513,723,0,3,1,3,0,1,0,76.14,70.95 ,33.33
03,012,01,016,0312,683 ,547,11,558,805,0,3,1,3,0,1,0,76.14,69.32 ,33.33
03,012,01,016,0313,684 ,581,4,585,868,0,3,1,3,0,1,0,76.14,67.40 ,33.33
03,012,01,016,0313,685 ,584,4,588,863,0,3,1,3,0,1,0,76.14,68.13 ,33.33
03,012,01,016,0314,686 ,717,4,721,945,0,3,1,3,0,1,0,76.14,76.30 ,33.33
03,012,01,016,0314,687 ,478,3,481,731,0,3,1,3,0,1,0,76.14,65.80 ,33.33
03,012,01,016,0314,688 ,439,5,444,694,0,3,1,3,0,1,0,76.14,63.98 ,33.33
03,012,01,016,0315,689 ,255,1,256,416,0,3,1,3,0,1,0,76.14,61.54 ,33.33
03,012,01,016,0316,690 ,837,16,853,1099,0,3,1,3,0,1,0,76.14,77.62 ,33.33
03,012,01,016,0316,691 ,613,2,615,990,0,3,1,3,0,1,0,76.14,62.12 ,33.33
03,012,01,016,0317,692 ,873,9,882,1225,0,3,1,3,0,1,0,76.14,72.00 ,33.33
03,012,01,016,0317,693 ,829,10,839,1310,0,3,1,3,0,1,0,76.14,64.05 ,33.33
03,012,01,017,0318,694 ,1144,12,1156,1472,0,3,1,3,0,1,0,76.14,78.53 ,33.33
03,012,01,017,0319,695 ,1316,12,1328,1788,0,3,1,3,0,1,0,76.14,74.27 ,33.33
03,012,01,017,0320,696 ,1385,29,1414,1878,0,3,1,3,0,1,0,76.14,75.29 ,33.33
03,012,01,017,0321,697 ,736,8,744,961,0,3,1,3,0,1,0,76.14,77.42 ,33.33
03,012,01,017,0322,698 ,773,11,784,1051,0,3,1,3,0,1,0,76.14,74.60 ,33.33
03,012,01,017,0323,699 ,1357,8,1365,1841,0,3,1,3,0,1,0,76.14,74.14 ,33.33
03,012,01,017,0324,700 ,420,6,426,574,0,3,1,3,0,1,0,76.14,74.22 ,33.33
03,012,01,017,0325,701 ,556,3,559,728,0,3,1,3,0,1,0,76.14,76.79 ,33.33
03,012,01,017,0326,702 ,1125,6,1131,1553,0,3,1,3,0,1,0,76.14,72.83 ,33.33
03,012,01,017,0327,703 ,582,19,601,842,0,3,1,3,0,1,0,76.14,71.38 ,33.33
03,012,01,017,0328,704 ,775,6,781,964,0,3,1,3,0,1,0,76.14,81.02 ,33.33
03,012,01,017,0329,705 ,1499,15,1514,1991,0,3,1,3,0,1,0,76.14,76.04 ,33.33
03,012,01,018,0330,706 ,644,14,658,964,0,3,1,3,0,1,0,76.14,68.26 ,33.33
03,012,01,018,0330,707 ,627,6,633,939,0,3,1,3,0,1,0,76.14,67.41 ,33.33
03,012,01,018,0331,708 ,647,3,650,934,0,3,1,3,0,1,0,76.14,69.59 ,33.33
03,012,01,018,0331,709 ,695,10,705,1048,0,3,1,3,0,1,0,76.14,67.27 ,33.33
03,012,01,018,0332,710 ,950,8,958,1393,0,3,1,3,0,1,0,76.14,68.77 ,33.33
03,012,01,018,0332,711 ,622,8,630,877,0,3,1,3,0,1,0,76.14,71.84 ,33.33
03,012,01,018,0333,712 ,790,4,794,1058,0,3,1,3,0,1,0,76.14,75.05 ,33.33
03,012,01,018,0334,713 ,718,15,733,1055,0,3,1,3,0,1,0,76.14,69.48 ,33.33
03,012,01,018,0335,714 ,699,5,704,936,0,3,1,3,0,1,0,76.14,75.21 ,33.33
03,012,01,018,0336,715 ,809,10,819,1153,0,3,1,3,0,1,0,76.14,71.03 ,33.33
03,012,01,018,0336,716 ,790,13,803,1164,0,3,1,3,0,1,0,76.14,68.99 ,33.33
03,012,01,018,0336,717 ,668,6,674,1054,0,3,1,3,0,1,0,76.14,63.95 ,33.33
03,012,01,018,0337,718 ,776,3,779,1169,0,3,1,3,0,1,0,76.14,66.64 ,33.33
03,012,01,018,0337,719 ,511,6,517,736,0,3,1,3,0,1,0,76.14,70.24 ,33.33
03,012,01,018,0338,720 ,919,6,925,1380,0,3,1,3,0,1,0,76.14,67.03 ,33.33
03,012,01,018,0338,721 ,634,11,645,977,0,3,1,3,0,1,0,76.14,66.02 ,33.33
03,012,01,018,0339,722 ,427,5,432,660,0,3,1,3,0,1,0,76.14,65.45 ,33.33
03,012,01,018,0340,723 ,772,3,775,1144,0,3,1,3,0,1,0,76.14,67.74 ,33.33
03,012,01,018,0340,724 ,823,10,833,1205,0,3,1,3,0,1,0,76.14,69.13 ,33.33
03,012,01,018,0341,725 ,694,8,702,1129,0,3,1,3,0,1,0,76.14,62.18 ,33.33
03,012,01,018,0341,726 ,781,10,791,1235,0,3,1,3,0,1,0,76.14,64.05 ,33.33
03,012,01,018,0342,727 ,937,13,950,1526,0,3,1,3,0,1,0,76.14,62.25 ,33.33
03,012,01,018,0343,728 ,801,13,814,1192,0,3,1,3,0,1,0,76.14,68.29 ,33.33
03,012,01,018,0343,729 ,639,6,645,979,0,3,1,3,0,1,0,76.14,65.88 ,33.33
03,012,01,018,0344,730 ,793,9,802,1101,0,3,1,3,0,1,0,76.14,72.84 ,33.33
03,012,01,018,0344,731 ,850,14,864,1295,0,3,1,3,0,1,0,76.14,66.72 ,33.33
03,012,01,019,0345,732 ,716,11,727,1136,0,3,1,3,0,1,0,76.14,64.00 ,33.33
03,012,01,019,0345,733 ,681,5,686,1160,0,3,1,3,0,1,0,76.14,59.14 ,33.33
03,012,01,019,0346,734 ,888,6,894,1316,0,3,1,3,0,1,0,76.14,67.93 ,33.33
03,012,01,019,0346,735 ,733,11,744,1118,0,3,1,3,0,1,0,76.14,66.55 ,33.33
03,012,01,019,0347,736 ,581,3,584,885,0,3,1,3,0,1,0,76.14,65.99 ,33.33
03,012,01,019,0348,737 ,417,5,422,605,0,3,1,3,0,1,0,76.14,69.75 ,33.33
03,012,01,019,0349,738 ,561,6,567,807,0,3,1,3,0,1,0,76.14,70.26 ,33.33
03,012,01,019,0350,739 ,496,6,502,736,0,3,1,3,0,1,0,76.14,68.21 ,33.33
03,012,01,019,0351,740 ,350,1,351,527,0,3,1,3,0,1,0,76.14,66.60 ,33.33
03,012,01,019,0352,741 ,554,4,558,885,0,3,1,3,0,1,0,76.14,63.05 ,33.33
03,012,01,019,0352,742 ,633,6,639,1003,0,3,1,3,0,1,0,76.14,63.71 ,33.33
03,012,01,019,0353,743 ,941,8,949,1552,0,3,1,3,0,1,0,76.14,61.15 ,33.33
03,012,01,019,0353,744 ,923,7,930,1403,0,3,1,3,0,1,0,76.14,66.29 ,33.33
03,012,01,019,0354,745 ,618,11,629,1062,0,3,1,3,0,1,0,76.14,59.23 ,33.33
03,012,01,019,0354,746 ,363,3,366,552,0,3,1,3,0,1,0,76.14,66.30 ,33.33
03,012,01,019,0354,747 ,197,1,198,312,0,3,1,3,0,1,0,76.14,63.46 ,33.33
03,012,01,019,0355,748 ,654,9,663,1047,0,3,1,3,0,1,0,76.14,63.32 ,33.33
03,012,01,019,0355,749 ,535,6,541,872,0,3,1,3,0,1,0,76.14,62.04 ,33.33
03,012,01,019,0356,750 ,715,7,722,1073,0,3,1,3,0,1,0,76.14,67.29 ,33.33
03,012,01,019,0356,751 ,324,6,330,460,0,3,1,3,0,1,0,76.14,71.74 ,33.33
03,012,01,019,0357,752 ,652,9,661,999,0,3,1,3,0,1,0,76.14,66.17 ,33.33
03,012,01,019,0357,753 ,353,3,356,539,0,3,1,3,0,1,0,76.14,66.05 ,33.33
03,012,01,019,0358,754 ,703,8,711,984,0,3,1,3,0,1,0,76.14,72.26 ,33.33
03,012,01,019,0359,755 ,634,8,642,903,0,3,1,3,0,1,0,76.14,71.10 ,33.33
03,012,01,019,0360,756 ,950,13,963,1346,0,3,1,3,0,1,0,76.14,71.55 ,33.33
03,012,01,019,0361,757 ,708,3,711,931,0,3,1,3,0,1,0,76.14,76.37 ,33.33
03,012,01,019,0362,758 ,1019,14,1033,1371,0,3,1,3,0,1,0,76.14,75.35 ,33.33
03,012,01,019,0363,759 ,669,12,681,896,0,3,1,3,0,1,0,76.14,76.00 ,33.33
03,012,01,019,0364,760 ,870,8,878,1239,0,3,1,3,0,1,0,76.14,70.86 ,33.33
03,012,01,019,0364,761 ,793,15,808,1138,0,3,1,3,0,1,0,76.14,71.00 ,33.33
03,012,01,019,0365,762 ,629,6,635,914,0,3,1,3,0,1,0,76.14,69.47 ,33.33
03,012,01,019,0365,763 ,592,7,599,967,0,3,1,3,0,1,0,76.14,61.94 ,33.33
03,012,01,019,0366,764 ,453,1,454,655,0,3,1,3,0,1,0,76.14,69.31 ,33.33
03,012,01,019,0367,765 ,281,0,281,376,0,3,1,3,0,1,0,76.14,74.73 ,33.33
03,012,01,019,0368,766 ,431,3,434,602,0,3,1,3,0,1,0,76.14,72.09 ,33.33
03,012,01,019,0369,767 ,147,0,147,205,0,3,1,3,0,1,0,76.14,71.71 ,33.33
03,012,01,020,0370,768 ,621,12,633,945,0,3,1,3,0,1,0,76.14,66.98 ,33.33
03,012,01,020,0370,769 ,520,5,525,818,0,3,1,3,0,1,0,76.14,64.18 ,33.33
03,012,01,020,0371,770 ,899,11,910,1397,0,3,1,3,0,1,0,76.14,65.14 ,33.33
03,012,01,020,0372,771 ,934,6,940,1438,0,3,1,3,0,1,0,76.14,65.37 ,33.33
03,012,01,020,0373,772 ,627,9,636,975,0,3,1,3,0,1,0,76.14,65.23 ,33.33
03,012,01,020,0373,773 ,801,11,812,1273,0,3,1,3,0,1,0,76.14,63.79 ,33.33
03,012,01,020,0374,774 ,747,15,762,1201,0,3,1,3,0,1,0,76.14,63.45 ,33.33
03,012,01,020,0374,775 ,655,4,659,1010,0,3,1,3,0,1,0,76.14,65.25 ,33.33
03,012,01,020,0375,776 ,749,8,757,1134,0,3,1,3,0,1,0,76.14,66.75 ,33.33
03,012,01,020,0375,777 ,814,10,824,1343,0,3,1,3,0,1,0,76.14,61.36 ,33.33
03,012,01,020,0376,778 ,801,8,809,1271,0,3,1,3,0,1,0,76.14,63.65 ,33.33
03,012,01,020,0376,779 ,808,7,815,1238,0,3,1,3,0,1,0,76.14,65.83 ,33.33
03,012,01,020,0377,780 ,569,9,578,875,0,3,1,3,0,1,0,76.14,66.06 ,33.33
03,012,01,020,0377,781 ,728,7,735,1170,0,3,1,3,0,1,0,76.14,62.82 ,33.33
03,012,01,020,0378,782 ,1046,13,1059,1492,0,3,1,3,0,1,0,76.14,70.98 ,33.33
03,012,01,020,0379,783 ,621,8,629,985,0,3,1,3,0,1,0,76.14,63.86 ,33.33
03,012,01,020,0379,784 ,503,4,507,734,0,3,1,3,0,1,0,76.14,69.07 ,33.33
03,012,01,020,0380,785 ,923,8,931,1423,0,3,1,3,0,1,0,76.14,65.43 ,33.33
03,012,01,020,0381,786 ,644,11,655,991,0,3,1,3,0,1,0,76.14,66.09 ,33.33
03,012,01,020,0381,787 ,624,10,634,998,0,3,1,3,0,1,0,76.14,63.53 ,33.33
03,012,01,020,0382,788 ,517,6,523,825,0,3,1,3,0,1,0,76.14,63.39 ,33.33
03,012,01,020,0382,789 ,538,6,544,838,0,3,1,3,0,1,0,76.14,64.92 ,33.33
03,012,01,020,0383,790 ,736,12,748,1143,0,3,1,3,0,1,0,76.14,65.44 ,33.33
03,012,01,020,0383,791 ,668,10,678,1048,0,3,1,3,0,1,0,76.14,64.69 ,33.33
03,012,01,020,0384,792 ,906,11,917,1360,0,3,1,3,0,1,0,76.14,67.43 ,33.33
03,012,01,020,0384,793 ,675,8,683,992,0,3,1,3,0,1,0,76.14,68.85 ,33.33
03,012,01,020,0385,794 ,533,1,534,742,0,3,1,3,0,1,0,76.14,71.97 ,33.33
03,012,01,020,0385,795 ,559,9,568,878,0,3,1,3,0,1,0,76.14,64.69 ,33.33
03,012,01,020,0386,796 ,921,9,930,1426,0,3,1,3,0,1,0,76.14,65.22 ,33.33
03,012,01,020,0387,797 ,777,10,787,1212,0,3,1,3,0,1,0,76.14,64.93 ,33.33
03,012,01,020,0388,798 ,550,6,556,885,0,3,1,3,0,1,0,76.14,62.82 ,33.33
03,012,01,020,0388,799 ,499,0,499,873,0,3,1,3,0,1,0,76.14,57.16 ,33.33
03,012,01,021,0389,800 ,642,18,660,1073,0,3,1,3,0,1,0,76.14,61.51 ,33.33
03,012,01,021,0390,801 ,795,12,807,1187,0,3,1,3,0,1,0,76.14,67.99 ,33.33
03,012,01,021,0391,802 ,867,15,882,1612,0,3,1,3,0,1,0,76.14,54.71 ,33.33
03,012,01,021,0392,803 ,818,13,831,1346,0,3,1,3,0,1,0,76.14,61.74 ,33.33
03,012,01,021,0393,804 ,558,11,569,926,0,3,1,3,0,1,0,76.14,61.45 ,33.33
03,012,01,021,0394,805 ,507,2,509,841,0,3,1,3,0,1,0,76.14,60.52 ,33.33
03,012,01,021,0395,806 ,439,8,447,759,0,3,1,3,0,1,0,76.14,58.89 ,33.33
03,012,01,021,0396,807 ,416,10,426,650,0,3,1,3,0,1,0,76.14,65.54 ,33.33
03,012,01,021,0397,808 ,241,2,243,359,0,3,1,3,0,1,0,76.14,67.69 ,33.33
03,012,01,021,0398,809 ,735,9,744,1390,0,3,1,3,0,1,0,76.14,53.53 ,33.33
03,012,01,021,0399,810 ,799,26,825,1537,0,3,1,3,0,1,0,76.14,53.68 ,33.33
03,012,01,021,0400,811 ,679,14,693,1090,0,3,1,3,0,1,0,76.14,63.58 ,33.33
03,012,01,022,0401,812 ,398,2,400,628,0,3,1,3,0,1,0,76.14,63.69 ,33.33
03,012,01,022,0402,813 ,787,9,796,1084,0,3,1,3,0,1,0,76.14,73.43 ,33.33
03,012,01,022,0403,814 ,550,9,559,849,0,3,1,3,0,1,0,76.14,65.84 ,33.33
03,012,01,022,0404,815 ,1009,28,1037,1601,0,3,1,3,0,1,0,76.14,64.77 ,33.33
03,012,01,022,0405,816 ,481,7,488,733,0,3,1,3,0,1,0,76.14,66.58 ,33.33
03,012,01,022,0406,817 ,472,4,476,726,0,3,1,3,0,1,0,76.14,65.56 ,33.33
03,012,01,022,0407,818 ,673,12,685,1129,0,3,1,3,0,1,0,76.14,60.67 ,33.33
03,012,01,023,0408,819 ,509,8,517,811,0,3,1,3,0,1,0,76.14,63.75 ,33.33
03,012,01,023,0409,820 ,439,5,444,788,0,3,1,3,0,1,0,76.14,56.35 ,33.33
03,012,01,023,0410,821 ,647,8,655,1146,0,3,1,3,0,1,0,76.14,57.16 ,33.33
03,012,01,023,0410,822 ,388,7,395,784,0,3,1,3,0,1,0,76.14,50.38 ,33.33
03,012,01,023,0411,823 ,752,10,762,1227,0,3,1,3,0,1,0,76.14,62.10 ,33.33
03,012,01,023,0411,824 ,362,6,368,596,0,3,1,3,0,1,0,76.14,61.74 ,33.33
03,012,01,023,0412,825 ,939,14,953,1531,0,3,1,3,0,1,0,76.14,62.25 ,33.33
03,012,01,023,0413,826 ,1080,8,1088,1819,0,3,1,3,0,1,0,76.14,59.81 ,33.33
03,012,01,023,0414,827 ,716,6,722,1348,0,3,1,3,0,1,0,76.14,53.56 ,33.33
03,012,01,024,0415,828 ,526,4,530,790,0,3,1,3,0,1,0,76.14,67.09 ,33.33
03,012,01,024,0416,829 ,623,15,638,1051,0,3,1,3,0,1,0,76.14,60.70 ,33.33
03,012,01,024,0417,830 ,317,5,322,492,0,3,1,3,0,1,0,76.14,65.45 ,33.33
03,012,01,024,0418,831 ,348,4,352,494,0,3,1,3,0,1,0,76.14,71.26 ,33.33
03,012,01,024,0419,832 ,699,12,711,1051,0,3,1,3,0,1,0,76.14,67.65 ,33.33
03,012,01,024,0420,833 ,510,4,514,764,0,3,1,3,0,1,0,76.14,67.28 ,33.33
03,012,01,024,0420,834 ,702,6,708,1032,0,3,1,3,0,1,0,76.14,68.60 ,33.33
03,012,01,024,0421,835 ,455,6,461,609,0,3,1,3,0,1,0,76.14,75.70 ,33.33
03,012,01,024,0422,836 ,252,3,255,363,0,3,1,3,0,1,0,76.14,70.25 ,33.33
03,012,01,024,0423,837 ,279,2,281,382,0,3,1,3,0,1,0,76.14,73.56 ,33.33
03,012,01,024,0424,838 ,602,6,608,773,0,3,1,3,0,1,0,76.14,78.65 ,33.33
03,012,01,024,0425,839 ,448,6,454,643,0,3,1,3,0,1,0,76.14,70.61 ,33.33
03,012,01,024,0426,840 ,312,4,316,500,0,3,1,3,0,1,0,76.14,63.20 ,33.33
03,012,01,024,0427,841 ,772,6,778,1126,0,3,1,3,0,1,0,76.14,69.09 ,33.33
03,012,01,024,0428,842 ,666,3,669,977,0,3,1,3,0,1,0,76.14,68.47 ,33.33
03,012,01,024,0429,843 ,339,1,340,512,0,3,1,3,0,1,0,76.14,66.41 ,33.33
03,012,01,024,0430,844 ,473,5,478,688,0,3,1,3,0,1,0,76.14,69.48 ,33.33
03,012,01,024,0431,845 ,408,7,415,680,0,3,1,3,0,1,0,76.14,61.03 ,33.33
03,012,01,024,0432,846 ,404,3,407,623,0,3,1,3,0,1,0,76.14,65.33 ,33.33
03,012,01,025,0433,847 ,35,0,35,81,0,3,1,3,0,1,0,76.14,43.21 ,33.33
03,012,01,025,0434,848 ,11,0,11,23,0,3,1,3,0,1,0,76.14,47.83 ,33.33
03,012,01,025,0435,849 ,14,1,15,27,0,3,1,3,0,1,0,76.14,55.56 ,33.33
03,012,01,026,0436,850 ,21,1,22,40,0,3,1,3,0,1,0,76.14,55.00 ,33.33
03,012,01,026,0436,851 ,7,0,7,13,0,3,1,3,0,1,0,76.14,53.85 ,33.33
03,012,01,026,0437,852 ,53,0,53,75,0,3,1,3,0,1,0,76.14,70.67 ,33.33
03,012,01,026,0438,853 ,33,3,36,71,0,3,1,3,0,1,0,76.14,50.70 ,33.33
03,012,01,026,0439,854 ,68,2,70,128,0,3,1,3,0,1,0,76.14,54.69 ,33.33
03,012,01,026,0440,855 ,7,0,7,14,0,3,1,3,0,1,0,76.14,50.00 ,33.33
03,012,01,026,0441,856 ,8,0,8,15,0,3,1,3,0,1,0,76.14,53.33 ,33.33
03,012,01,026,0442,857 ,6,0,6,12,0,3,1,3,0,1,0,76.14,50.00 ,33.33
03,012,01,026,0443,858 ,8,0,8,20,0,3,1,3,0,1,0,76.14,40.00 ,33.33
03,012,01,027,0444,859 ,54,0,54,171,0,3,1,3,0,1,0,76.14,31.58 ,33.33
03,012,01,027,0445,860 ,23,0,23,49,0,3,1,3,0,1,0,76.14,46.94 ,33.33
03,012,01,027,0446,861 ,63,1,64,113,0,3,1,3,0,1,0,76.14,56.64 ,33.33
03,013,01,001,0001,1 ,769,6,775,1186,0,3,1,3,0,1,0,76.14,65.35 ,33.33
03,013,01,001,0002,2 ,982,12,994,1488,0,3,1,3,0,1,0,76.14,66.80 ,33.33
03,013,01,001,0003,3 ,549,5,554,756,0,3,1,3,0,1,0,76.14,73.28 ,33.33
03,013,01,001,0004,4 ,901,8,909,1392,0,3,1,3,0,1,0,76.14,65.30 ,33.33
03,013,01,001,0005,5 ,983,6,989,1455,0,3,1,3,0,1,0,76.14,67.97 ,33.33
03,013,01,001,0005,6 ,948,13,961,1434,0,3,1,3,0,1,0,76.14,67.02 ,33.33
03,013,01,001,0006,7 ,952,10,962,1424,0,3,1,3,0,1,0,76.14,67.56 ,33.33
03,013,01,001,0007,8 ,621,6,627,890,0,3,1,3,0,1,0,76.14,70.45 ,33.33
03,013,01,001,0008,9 ,607,4,611,815,0,3,1,3,0,1,0,76.14,74.97 ,33.33
03,013,01,001,0009,10 ,832,10,842,1249,0,3,1,3,0,1,0,76.14,67.41 ,33.33
03,013,01,001,0010,11 ,597,5,602,890,0,3,1,3,0,1,0,76.14,67.64 ,33.33
03,013,01,001,0011,12 ,772,7,779,1088,0,3,1,3,0,1,0,76.14,71.60 ,33.33
03,013,01,001,0012,13 ,979,6,985,1524,0,3,1,3,0,1,0,76.14,64.63 ,33.33
03,013,01,001,0013,14 ,637,4,641,920,0,3,1,3,0,1,0,76.14,69.67 ,33.33
03,013,01,001,0014,15 ,698,10,708,1113,0,3,1,3,0,1,0,76.14,63.61 ,33.33
03,013,01,001,0014,16 ,605,6,611,992,0,3,1,3,0,1,0,76.14,61.59 ,33.33
03,013,01,001,0015,17 ,809,3,812,1210,0,3,1,3,0,1,0,76.14,67.11 ,33.33
03,013,01,001,0015,18 ,804,10,814,1223,0,3,1,3,0,1,0,76.14,66.56 ,33.33
03,013,01,001,0016,19 ,693,6,699,1066,0,3,1,3,0,1,0,76.14,65.57 ,33.33
03,013,01,001,0016,20 ,887,7,894,1368,0,3,1,3,0,1,0,76.14,65.35 ,33.33
03,013,01,001,0016,21 ,927,6,933,1388,0,3,1,3,0,1,0,76.14,67.22 ,33.33
03,013,01,001,0017,22 ,1039,9,1048,1598,0,3,1,3,0,1,0,76.14,65.58 ,33.33
03,013,01,001,0017,23 ,1084,5,1089,1595,0,3,1,3,0,1,0,76.14,68.28 ,33.33
03,013,01,001,0017,24 ,1066,9,1075,1600,0,3,1,3,0,1,0,76.14,67.19 ,33.33
03,013,01,001,0017,25 ,1059,8,1067,1618,0,3,1,3,0,1,0,76.14,65.95 ,33.33
03,013,01,001,0017,26 ,1085,8,1093,1657,0,3,1,3,0,1,0,76.14,65.96 ,33.33
03,013,01,001,0018,27 ,794,10,804,1222,0,3,1,3,0,1,0,76.14,65.79 ,33.33
03,013,01,001,0018,28 ,846,10,856,1257,0,3,1,3,0,1,0,76.14,68.10 ,33.33
03,013,01,001,0018,29 ,782,6,788,1141,0,3,1,3,0,1,0,76.14,69.06 ,33.33
03,013,01,001,0019,30 ,670,5,675,973,0,3,1,3,0,1,0,76.14,69.37 ,33.33
03,013,01,001,0020,31 ,923,3,926,1375,0,3,1,3,0,1,0,76.14,67.35 ,33.33
03,013,01,001,0021,32 ,737,8,745,1127,0,3,1,3,0,1,0,76.14,66.10 ,33.33
03,013,01,001,0022,33 ,1068,7,1075,1674,0,3,1,3,0,1,0,76.14,64.22 ,33.33
03,013,01,001,0022,34 ,872,29,901,1389,0,3,1,3,0,1,0,76.14,64.87 ,33.33
03,013,01,001,0022,35 ,850,8,858,1371,0,3,1,3,0,1,0,76.14,62.58 ,33.33
03,013,01,001,0022,36 ,1044,5,1049,1641,0,3,1,3,0,1,0,76.14,63.92 ,33.33
03,013,01,001,0023,37 ,811,6,817,1149,0,3,1,3,0,1,0,76.14,71.11 ,33.33
03,013,01,001,0024,38 ,648,8,656,953,0,3,1,3,0,1,0,76.14,68.84 ,33.33
03,013,01,001,0024,39 ,614,6,620,940,0,3,1,3,0,1,0,76.14,65.96 ,33.33
03,013,01,001,0025,40 ,841,6,847,1269,0,3,1,3,0,1,0,76.14,66.75 ,33.33
03,013,01,001,0026,41 ,682,12,694,1050,0,3,1,3,0,1,0,76.14,66.10 ,33.33
03,013,01,001,0026,42 ,614,11,625,967,0,3,1,3,0,1,0,76.14,64.63 ,33.33
03,013,01,001,0027,43 ,1112,9,1121,1723,0,3,1,3,0,1,0,76.14,65.06 ,33.33
03,013,01,001,0028,44 ,835,9,844,1280,0,3,1,3,0,1,0,76.14,65.94 ,33.33
03,013,01,001,0028,45 ,1072,13,1085,1618,0,3,1,3,0,1,0,76.14,67.06 ,33.33
03,013,01,001,0028,46 ,1099,11,1110,1703,0,3,1,3,0,1,0,76.14,65.18 ,33.33
03,013,01,001,0029,47 ,1077,13,1090,1571,0,3,1,3,0,1,0,76.14,69.38 ,33.33
03,013,01,001,0029,48 ,781,15,796,1252,0,3,1,3,0,1,0,76.14,63.58 ,33.33
03,013,01,001,0029,49 ,867,3,870,1364,0,3,1,3,0,1,0,76.14,63.78 ,33.33
03,013,01,001,0030,50 ,832,16,848,1196,0,3,1,3,0,1,0,76.14,70.90 ,33.33
03,013,01,001,0031,51 ,723,9,732,1034,0,3,1,3,0,1,0,76.14,70.79 ,33.33
03,013,01,001,0032,52 ,947,9,956,1406,0,3,1,3,0,1,0,76.14,67.99 ,33.33
03,013,01,001,0033,53 ,947,15,962,1358,0,3,1,3,0,1,0,76.14,70.84 ,33.33
03,013,01,001,0034,54 ,1034,11,1045,1590,0,3,1,3,0,1,0,76.14,65.72 ,33.33
03,013,01,001,0035,55 ,1031,11,1042,1645,0,3,1,3,0,1,0,76.14,63.34 ,33.33
03,013,01,001,0036,56 ,474,9,483,771,0,3,1,3,0,1,0,76.14,62.65 ,33.33
03,013,01,001,0037,57 ,527,3,530,787,0,3,1,3,0,1,0,76.14,67.34 ,33.33
03,013,01,001,0038,58 ,883,10,893,1409,0,3,1,3,0,1,0,76.14,63.38 ,33.33
03,013,01,001,0038,59 ,1105,4,1109,1713,0,3,1,3,0,1,0,76.14,64.74 ,33.33
03,013,01,001,0039,60 ,907,14,921,1429,0,3,1,3,0,1,0,76.14,64.45 ,33.33
03,013,01,001,0039,61 ,986,12,998,1589,0,3,1,3,0,1,0,76.14,62.81 ,33.33
03,013,01,001,0039,62 ,1075,17,1092,1783,0,3,1,3,0,1,0,76.14,61.25 ,33.33
03,013,01,001,0039,63 ,1112,6,1118,1746,0,3,1,3,0,1,0,76.14,64.03 ,33.33
03,013,01,001,0040,64 ,824,3,827,1198,0,3,1,3,0,1,0,76.14,69.03 ,33.33
03,013,01,001,0040,65 ,1262,12,1274,1971,0,3,1,3,0,1,0,76.14,64.64 ,33.33
03,013,01,001,0040,66 ,928,11,939,1395,0,3,1,3,0,1,0,76.14,67.31 ,33.33
03,013,01,001,0041,67 ,372,4,376,516,0,3,1,3,0,1,0,76.14,72.87 ,33.33
03,013,01,001,0042,68 ,715,7,722,980,0,3,1,3,0,1,0,76.14,73.67 ,33.33
03,013,01,001,0043,69 ,981,8,989,1393,0,3,1,3,0,1,0,76.14,71.00 ,33.33
03,013,01,001,0043,70 ,652,3,655,998,0,3,1,3,0,1,0,76.14,65.63 ,33.33
03,013,01,001,0044,71 ,1003,19,1022,1424,0,3,1,3,0,1,0,76.14,71.77 ,33.33
03,013,01,001,0045,72 ,965,4,969,1331,0,3,1,3,0,1,0,76.14,72.80 ,33.33
03,013,01,001,0045,73 ,535,8,543,846,0,3,1,3,0,1,0,76.14,64.18 ,33.33
03,013,01,001,0046,74 ,1069,19,1088,1473,0,3,1,3,0,1,0,76.14,73.86 ,33.33
03,013,01,001,0047,75 ,965,10,975,1318,0,3,1,3,0,1,0,76.14,73.98 ,33.33
03,013,01,001,0048,76 ,735,8,743,1151,0,3,1,3,0,1,0,76.14,64.55 ,33.33
03,013,01,001,0048,77 ,920,2,922,1520,0,3,1,3,0,1,0,76.14,60.66 ,33.33
03,013,01,001,0048,78 ,982,12,994,1525,0,3,1,3,0,1,0,76.14,65.18 ,33.33
03,013,01,001,0049,79 ,669,3,672,1056,0,3,1,3,0,1,0,76.14,63.64 ,33.33
03,013,01,001,0049,80 ,780,9,789,1266,0,3,1,3,0,1,0,76.14,62.32 ,33.33
03,013,01,001,0050,81 ,959,12,971,1428,0,3,1,3,0,1,0,76.14,68.00 ,33.33
03,013,01,001,0050,82 ,1209,12,1221,1856,0,3,1,3,0,1,0,76.14,65.79 ,33.33
03,013,01,001,0050,83 ,985,13,998,1525,0,3,1,3,0,1,0,76.14,65.44 ,33.33
03,013,01,001,0050,84 ,1186,9,1195,1817,0,3,1,3,0,1,0,76.14,65.77 ,33.33
03,013,01,001,0051,85 ,1225,7,1232,1787,0,3,1,3,0,1,0,76.14,68.94 ,33.33
03,013,01,001,0052,86 ,1048,13,1061,1587,0,3,1,3,0,1,0,76.14,66.86 ,33.33
03,013,01,001,0053,87 ,444,10,454,700,0,3,1,3,0,1,0,76.14,64.86 ,33.33
03,013,01,001,0054,88 ,1048,20,1068,1720,0,3,1,3,0,1,0,76.14,62.09 ,33.33
03,013,01,001,0054,89 ,973,9,982,1596,0,3,1,3,0,1,0,76.14,61.53 ,33.33
03,013,01,001,0054,90 ,1041,8,1049,1671,0,3,1,3,0,1,0,76.14,62.78 ,33.33
03,013,01,001,0054,91 ,1339,10,1349,2220,0,3,1,3,0,1,0,76.14,60.77 ,33.33
03,013,01,001,0055,92 ,649,4,653,967,0,3,1,3,0,1,0,76.14,67.53 ,33.33
03,013,01,001,0056,93 ,627,6,633,905,0,3,1,3,0,1,0,76.14,69.94 ,33.33
03,013,01,001,0056,94 ,715,6,721,1048,0,3,1,3,0,1,0,76.14,68.80 ,33.33
03,013,01,001,0057,95 ,672,6,678,1028,0,3,1,3,0,1,0,76.14,65.95 ,33.33
03,013,01,001,0058,96 ,941,4,945,1362,0,3,1,3,0,1,0,76.14,69.38 ,33.33
03,013,01,001,0058,97 ,918,10,928,1390,0,3,1,3,0,1,0,76.14,66.76 ,33.33
03,013,01,001,0058,98 ,1056,8,1064,1598,0,3,1,3,0,1,0,76.14,66.58 ,33.33
03,013,01,001,0059,99 ,803,8,811,1266,0,3,1,3,0,1,0,76.14,64.06 ,33.33
03,013,01,001,0059,100 ,839,11,850,1282,0,3,1,3,0,1,0,76.14,66.30 ,33.33
03,013,01,001,0060,101 ,1083,6,1089,1641,0,3,1,3,0,1,0,76.14,66.36 ,33.33
03,013,01,001,0060,102 ,994,12,1006,1570,0,3,1,3,0,1,0,76.14,64.08 ,33.33
03,013,01,001,0061,103 ,683,6,689,1074,0,3,1,3,0,1,0,76.14,64.15 ,33.33
03,013,01,001,0061,104 ,688,3,691,1041,0,3,1,3,0,1,0,76.14,66.38 ,33.33
03,013,01,001,0062,105 ,810,12,822,1201,0,3,1,3,0,1,0,76.14,68.44 ,33.33
03,013,01,001,0062,106 ,791,12,803,1331,0,3,1,3,0,1,0,76.14,60.33 ,33.33
03,013,01,001,0062,107 ,965,10,975,1501,0,3,1,3,0,1,0,76.14,64.96 ,33.33
03,013,01,001,0062,108 ,805,12,817,1253,0,3,1,3,0,1,0,76.14,65.20 ,33.33
03,013,01,001,0063,109 ,752,3,755,1110,0,3,1,3,0,1,0,76.14,68.02 ,33.33
03,013,01,001,0063,110 ,915,9,924,1270,0,3,1,3,0,1,0,76.14,72.76 ,33.33
03,013,01,001,0064,111 ,849,9,858,1216,0,3,1,3,0,1,0,76.14,70.56 ,33.33
03,013,01,001,0065,112 ,596,5,601,839,0,3,1,3,0,1,0,76.14,71.63 ,33.33
03,013,01,001,0066,113 ,688,5,693,1005,0,3,1,3,0,1,0,76.14,68.96 ,33.33
03,013,01,001,0067,114 ,1004,9,1013,1440,0,3,1,3,0,1,0,76.14,70.35 ,33.33
03,013,01,001,0068,115 ,621,3,624,935,0,3,1,3,0,1,0,76.14,66.74 ,33.33
03,013,01,002,0069,116 ,413,1,414,627,0,3,1,3,0,1,0,76.14,66.03 ,33.33
03,013,01,002,0070,117 ,1317,12,1329,2116,0,3,1,3,0,1,0,76.14,62.81 ,33.33
03,013,01,002,0070,118 ,1025,13,1038,1658,0,3,1,3,0,1,0,76.14,62.61 ,33.33
03,013,01,002,0071,119 ,514,4,518,736,0,3,1,3,0,1,0,76.14,70.38 ,33.33
03,013,01,002,0072,120 ,761,10,771,1170,0,3,1,3,0,1,0,76.14,65.90 ,33.33
03,013,01,002,0073,121 ,957,15,972,1484,0,3,1,3,0,1,0,76.14,65.50 ,33.33
03,013,01,002,0074,122 ,584,5,589,791,0,3,1,3,0,1,0,76.14,74.46 ,33.33
03,013,01,002,0075,123 ,815,6,821,1246,0,3,1,3,0,1,0,76.14,65.89 ,33.33
03,013,01,002,0075,124 ,859,14,873,1338,0,3,1,3,0,1,0,76.14,65.25 ,33.33
03,013,01,002,0075,125 ,1056,9,1065,1585,0,3,1,3,0,1,0,76.14,67.19 ,33.33
03,013,01,002,0076,126 ,1102,4,1106,1685,0,3,1,3,0,1,0,76.14,65.64 ,33.33
03,013,01,002,0076,127 ,1180,7,1187,1828,0,3,1,3,0,1,0,76.14,64.93 ,33.33
03,013,01,002,0076,128 ,1135,9,1144,1813,0,3,1,3,0,1,0,76.14,63.10 ,33.33
03,013,01,002,0077,129 ,1149,13,1162,1769,0,3,1,3,0,1,0,76.14,65.69 ,33.33
03,013,01,002,0078,130 ,701,10,711,1133,0,3,1,3,0,1,0,76.14,62.75 ,33.33
03,013,01,002,0079,131 ,1140,12,1152,1776,0,3,1,3,0,1,0,76.14,64.86 ,33.33
03,013,01,002,0080,132 ,1239,15,1254,1978,0,3,1,3,0,1,0,76.14,63.40 ,33.33
03,013,01,002,0081,133 ,1101,14,1115,1786,0,3,1,3,0,1,0,76.14,62.43 ,33.33
03,013,01,002,0081,134 ,927,6,933,1452,0,3,1,3,0,1,0,76.14,64.26 ,33.33
03,013,01,002,0081,135 ,987,9,996,1548,0,3,1,3,0,1,0,76.14,64.34 ,33.33
03,013,01,002,0082,136 ,880,8,888,1434,0,3,1,3,0,1,0,76.14,61.92 ,33.33
03,013,01,002,0083,137 ,831,11,842,1307,0,3,1,3,0,1,0,76.14,64.42 ,33.33
03,013,01,002,0084,138 ,569,6,575,825,0,3,1,3,0,1,0,76.14,69.70 ,33.33
03,013,01,002,0085,139 ,379,2,381,591,0,3,1,3,0,1,0,76.14,64.47 ,33.33
03,013,01,002,0086,140 ,997,10,1007,1559,0,3,1,3,0,1,0,76.14,64.59 ,33.33
03,013,01,002,0087,141 ,1019,15,1034,1514,0,3,1,3,0,1,0,76.14,68.30 ,33.33
03,013,01,002,0088,142 ,1244,17,1261,1925,0,3,1,3,0,1,0,76.14,65.51 ,33.33
03,013,01,002,0089,143 ,1007,15,1022,1588,0,3,1,3,0,1,0,76.14,64.36 ,33.33
03,013,01,003,0090,144 ,758,7,765,1126,0,3,1,3,0,1,0,76.14,67.94 ,33.33
03,013,01,003,0090,145 ,840,8,848,1203,0,3,1,3,0,1,0,76.14,70.49 ,33.33
03,013,01,003,0091,146 ,376,3,379,565,0,3,1,3,0,1,0,76.14,67.08 ,33.33
03,013,01,003,0092,147 ,349,6,355,479,0,3,1,3,0,1,0,76.14,74.11 ,33.33
03,013,01,003,0093,148 ,445,9,454,724,0,3,1,3,0,1,0,76.14,62.71 ,33.33
03,013,01,003,0094,149 ,363,4,367,565,0,3,1,3,0,1,0,76.14,64.96 ,33.33
03,013,01,003,0095,150 ,791,10,801,1208,0,3,1,3,0,1,0,76.14,66.31 ,33.33
03,013,01,003,0095,151 ,519,5,524,810,0,3,1,3,0,1,0,76.14,64.69 ,33.33
03,013,01,003,0095,152 ,1097,14,1111,1859,0,3,1,3,0,1,0,76.14,59.76 ,33.33
03,013,01,003,0095,153 ,1056,12,1068,1635,0,3,1,3,0,1,0,76.14,65.32 ,33.33
03,013,01,003,0096,154 ,516,3,519,732,0,3,1,3,0,1,0,76.14,70.90 ,33.33
03,013,01,003,0097,155 ,513,8,521,770,0,3,1,3,0,1,0,76.14,67.66 ,33.33
03,013,01,003,0098,156 ,783,10,793,1214,0,3,1,3,0,1,0,76.14,65.32 ,33.33
03,013,01,003,0098,157 ,396,3,399,584,0,3,1,3,0,1,0,76.14,68.32 ,33.33
03,013,01,003,0099,158 ,560,3,563,855,0,3,1,3,0,1,0,76.14,65.85 ,33.33
03,013,01,003,0100,159 ,870,7,877,1359,0,3,1,3,0,1,0,76.14,64.53 ,33.33
03,013,01,003,0101,160 ,452,4,456,724,0,3,1,3,0,1,0,76.14,62.98 ,33.33
03,013,01,003,0102,161 ,746,10,756,1304,0,3,1,3,0,1,0,76.14,57.98 ,33.33
03,013,01,003,0103,162 ,479,4,483,749,0,3,1,3,0,1,0,76.14,64.49 ,33.33
03,013,01,003,0103,163 ,698,9,707,1121,0,3,1,3,0,1,0,76.14,63.07 ,33.33
03,013,01,003,0104,164 ,773,10,783,1199,0,3,1,3,0,1,0,76.14,65.30 ,33.33
03,013,01,003,0104,165 ,780,7,787,1308,0,3,1,3,0,1,0,76.14,60.17 ,33.33
03,013,01,003,0105,166 ,966,10,976,1540,0,3,1,3,0,1,0,76.14,63.38 ,33.33
03,013,01,003,0106,167 ,334,4,338,491,0,3,1,3,0,1,0,76.14,68.84 ,33.33
03,013,01,003,0106,168 ,750,8,758,1279,0,3,1,3,0,1,0,76.14,59.27 ,33.33
03,013,01,003,0107,169 ,632,7,639,1027,0,3,1,3,0,1,0,76.14,62.22 ,33.33
03,013,01,003,0107,170 ,725,6,731,1159,0,3,1,3,0,1,0,76.14,63.07 ,33.33
03,013,01,003,0107,171 ,852,6,858,1445,0,3,1,3,0,1,0,76.14,59.38 ,33.33
03,013,01,003,0108,172 ,1209,10,1219,1783,0,3,1,3,0,1,0,76.14,68.37 ,33.33
03,013,01,003,0109,173 ,1056,12,1068,1557,0,3,1,3,0,1,0,76.14,68.59 ,33.33
03,013,01,003,0110,174 ,612,7,619,874,0,3,1,3,0,1,0,76.14,70.82 ,33.33
03,013,01,003,0111,175 ,454,4,458,700,0,3,1,3,0,1,0,76.14,65.43 ,33.33
03,013,01,003,0112,176 ,193,4,197,296,0,3,1,3,0,1,0,76.14,66.55 ,33.33
03,013,01,004,0113,177 ,614,5,619,973,0,3,1,3,0,1,0,76.14,63.62 ,33.33
03,013,01,004,0114,178 ,537,15,552,878,0,3,1,3,0,1,0,76.14,62.87 ,33.33
03,013,01,004,0114,179 ,619,8,627,1017,0,3,1,3,0,1,0,76.14,61.65 ,33.33
03,013,01,004,0115,180 ,725,5,730,1143,0,3,1,3,0,1,0,76.14,63.87 ,33.33
03,013,01,004,0116,181 ,646,12,658,1164,0,3,1,3,0,1,0,76.14,56.53 ,33.33
03,013,01,004,0116,182 ,576,10,586,1061,0,3,1,3,0,1,0,76.14,55.23 ,33.33
03,013,01,004,0116,183 ,611,6,617,1160,0,3,1,3,0,1,0,76.14,53.19 ,33.33
03,013,01,004,0117,184 ,775,14,789,1379,0,3,1,3,0,1,0,76.14,57.22 ,33.33
03,013,01,004,0117,185 ,669,8,677,1203,0,3,1,3,0,1,0,76.14,56.28 ,33.33
03,013,01,004,0118,186 ,423,10,433,789,0,3,1,3,0,1,0,76.14,54.88 ,33.33
03,013,01,004,0119,187 ,286,4,290,493,0,3,1,3,0,1,0,76.14,58.82 ,33.33
03,013,01,004,0120,188 ,244,5,249,472,0,3,1,3,0,1,0,76.14,52.75 ,33.33
03,013,01,004,0121,189 ,528,10,538,916,0,3,1,3,0,1,0,76.14,58.73 ,33.33
03,013,01,004,0122,190 ,391,12,403,663,0,3,1,3,0,1,0,76.14,60.78 ,33.33
03,013,01,004,0123,191 ,576,6,582,928,0,3,1,3,0,1,0,76.14,62.72 ,33.33
03,013,01,004,0124,192 ,491,3,494,756,0,3,1,3,0,1,0,76.14,65.34 ,33.33
03,013,01,004,0124,193 ,428,5,433,742,0,3,1,3,0,1,0,76.14,58.36 ,33.33
03,013,01,004,0125,194 ,518,12,530,879,0,3,1,3,0,1,0,76.14,60.30 ,33.33
03,013,01,004,0125,195 ,495,10,505,915,0,3,1,3,0,1,0,76.14,55.19 ,33.33
03,013,01,004,0126,196 ,355,6,361,695,0,3,1,3,0,1,0,76.14,51.94 ,33.33
03,013,01,004,0126,197 ,357,4,361,676,0,3,1,3,0,1,0,76.14,53.40 ,33.33
03,013,01,004,0127,198 ,365,2,367,651,0,3,1,3,0,1,0,76.14,56.37 ,33.33
03,013,01,004,0127,199 ,404,11,415,692,0,3,1,3,0,1,0,76.14,59.97 ,33.33
03,013,01,004,0128,200 ,754,10,764,1173,0,3,1,3,0,1,0,76.14,65.13 ,33.33
03,013,01,004,0129,201 ,635,12,647,1050,0,3,1,3,0,1,0,76.14,61.62 ,33.33
03,013,01,005,0130,202 ,968,8,976,1414,0,3,1,3,0,1,0,76.14,69.02 ,33.33
03,013,01,005,0131,203 ,955,15,970,1392,0,3,1,3,0,1,0,76.14,69.68 ,33.33
03,013,01,005,0132,204 ,593,3,596,813,0,3,1,3,0,1,0,76.14,73.31 ,33.33
03,013,01,005,0132,205 ,675,9,684,962,0,3,1,3,0,1,0,76.14,71.10 ,33.33
03,013,01,005,0133,206 ,664,6,670,887,0,3,1,3,0,1,0,76.14,75.54 ,33.33
03,013,01,005,0134,207 ,879,5,884,1144,0,3,1,3,0,1,0,76.14,77.27 ,33.33
03,013,01,005,0135,208 ,803,9,812,1092,0,3,1,3,0,1,0,76.14,74.36 ,33.33
03,013,01,005,0136,209 ,516,2,518,655,0,3,1,3,0,1,0,76.14,79.08 ,33.33
03,013,01,005,0137,210 ,1156,18,1174,1573,0,3,1,3,0,1,0,76.14,74.63 ,33.33
03,013,01,005,0138,211 ,975,8,983,1357,0,3,1,3,0,1,0,76.14,72.44 ,33.33
03,013,01,005,0139,212 ,1099,9,1108,1563,0,3,1,3,0,1,0,76.14,70.89 ,33.33
03,013,01,005,0140,213 ,624,10,634,855,0,3,1,3,0,1,0,76.14,74.15 ,33.33
03,013,01,005,0141,214 ,811,6,817,1011,0,3,1,3,0,1,0,76.14,80.81 ,33.33
03,013,01,005,0142,215 ,881,9,890,1226,0,3,1,3,0,1,0,76.14,72.59 ,33.33
03,013,01,005,0143,216 ,1014,6,1020,1389,0,3,1,3,0,1,0,76.14,73.43 ,33.33
03,013,01,005,0144,217 ,1300,14,1314,1810,0,3,1,3,0,1,0,76.14,72.60 ,33.33
03,013,01,005,0145,218 ,650,7,657,928,0,3,1,3,0,1,0,76.14,70.80 ,33.33
03,013,01,005,0145,219 ,686,6,692,901,0,3,1,3,0,1,0,76.14,76.80 ,33.33
03,013,01,005,0146,220 ,407,3,410,513,0,3,1,3,0,1,0,76.14,79.92 ,33.33
03,013,01,005,0147,221 ,581,6,587,802,0,3,1,3,0,1,0,76.14,73.19 ,33.33
03,013,01,005,0148,222 ,840,7,847,1111,0,3,1,3,0,1,0,76.14,76.24 ,33.33
03,013,01,005,0149,223 ,252,1,253,347,0,3,1,3,0,1,0,76.14,72.91 ,33.33
03,013,01,005,0150,224 ,894,11,905,1276,0,3,1,3,0,1,0,76.14,70.92 ,33.33
03,013,01,005,0151,225 ,1063,13,1076,1463,0,3,1,3,0,1,0,76.14,73.55 ,33.33
03,013,01,005,0152,226 ,635,8,643,885,0,3,1,3,0,1,0,76.14,72.66 ,33.33
03,013,01,005,0152,227 ,699,10,709,976,0,3,1,3,0,1,0,76.14,72.64 ,33.33
03,013,01,005,0153,228 ,1183,22,1205,1734,0,3,1,3,0,1,0,76.14,69.49 ,33.33
03,013,01,005,0154,229 ,667,9,676,980,0,3,1,3,0,1,0,76.14,68.98 ,33.33
03,013,01,005,0154,230 ,711,2,713,994,0,3,1,3,0,1,0,76.14,71.73 ,33.33
03,013,01,005,0155,231 ,884,10,894,1233,0,3,1,3,0,1,0,76.14,72.51 ,33.33
03,013,01,005,0156,232 ,541,2,543,715,0,3,1,3,0,1,0,76.14,75.94 ,33.33
03,013,01,005,0157,233 ,403,1,404,563,0,3,1,3,0,1,0,76.14,71.76 ,33.33
03,013,01,005,0158,234 ,353,1,354,465,0,3,1,3,0,1,0,76.14,76.13 ,33.33
03,013,01,005,0159,235 ,1225,7,1232,1723,0,3,1,3,0,1,0,76.14,71.50 ,33.33
03,013,01,005,0159,236 ,1100,3,1103,1513,0,3,1,3,0,1,0,76.14,72.90 ,33.33
03,013,01,006,0160,237 ,651,4,655,916,0,3,1,3,0,1,0,76.14,71.51 ,33.33
03,013,01,006,0160,238 ,817,13,830,1195,0,3,1,3,0,1,0,76.14,69.46 ,33.33
03,013,01,006,0161,239 ,818,3,821,1184,0,3,1,3,0,1,0,76.14,69.34 ,33.33
03,013,01,006,0161,240 ,993,15,1008,1424,0,3,1,3,0,1,0,76.14,70.79 ,33.33
03,013,01,006,0162,241 ,1038,8,1046,1452,0,3,1,3,0,1,0,76.14,72.04 ,33.33
03,013,01,006,0163,242 ,419,3,422,591,0,3,1,3,0,1,0,76.14,71.40 ,33.33
03,013,01,006,0163,243 ,714,9,723,1098,0,3,1,3,0,1,0,76.14,65.85 ,33.33
03,013,01,006,0164,244 ,732,5,737,998,0,3,1,3,0,1,0,76.14,73.85 ,33.33
03,013,01,006,0165,245 ,1058,17,1075,1441,0,3,1,3,0,1,0,76.14,74.60 ,33.33
03,013,01,006,0166,246 ,786,8,794,1066,0,3,1,3,0,1,0,76.14,74.48 ,33.33
03,013,01,006,0167,247 ,543,10,553,772,0,3,1,3,0,1,0,76.14,71.63 ,33.33
03,013,01,006,0168,248 ,1008,8,1016,1383,0,3,1,3,0,1,0,76.14,73.46 ,33.33
03,013,01,006,0169,249 ,642,5,647,848,0,3,1,3,0,1,0,76.14,76.30 ,33.33
03,013,01,006,0170,250 ,786,10,796,1091,0,3,1,3,0,1,0,76.14,72.96 ,33.33
03,013,01,006,0171,251 ,917,11,928,1314,0,3,1,3,0,1,0,76.14,70.62 ,33.33
03,013,01,006,0172,252 ,1236,17,1253,1644,0,3,1,3,0,1,0,76.14,76.22 ,33.33
03,013,01,006,0173,253 ,800,16,816,1057,0,3,1,3,0,1,0,76.14,77.20 ,33.33
03,013,01,006,0174,254 ,893,10,903,1222,0,3,1,3,0,1,0,76.14,73.90 ,33.33
03,013,01,006,0174,255 ,708,11,719,1009,0,3,1,3,0,1,0,76.14,71.26 ,33.33
03,013,01,006,0175,256 ,318,6,324,495,0,3,1,3,0,1,0,76.14,65.45 ,33.33
03,013,01,007,0176,257 ,478,4,482,677,0,3,1,3,0,1,0,76.14,71.20 ,33.33
03,013,01,007,0176,258 ,713,6,719,1014,0,3,1,3,0,1,0,76.14,70.91 ,33.33
03,013,01,007,0177,259 ,651,5,656,898,0,3,1,3,0,1,0,76.14,73.05 ,33.33
03,013,01,007,0178,260 ,1090,10,1100,1559,0,3,1,3,0,1,0,76.14,70.56 ,33.33
03,013,01,007,0179,261 ,707,4,711,1034,0,3,1,3,0,1,0,76.14,68.76 ,33.33
03,013,01,007,0179,262 ,774,9,783,1131,0,3,1,3,0,1,0,76.14,69.23 ,33.33
03,013,01,007,0180,263 ,800,7,807,1067,0,3,1,3,0,1,0,76.14,75.63 ,33.33
03,013,01,007,0181,264 ,576,8,584,823,0,3,1,3,0,1,0,76.14,70.96 ,33.33
03,013,01,007,0182,265 ,500,5,505,674,0,3,1,3,0,1,0,76.14,74.93 ,33.33
03,013,01,008,0183,266 ,1098,13,1111,1541,0,3,1,3,0,1,0,76.14,72.10 ,33.33
03,013,01,008,0184,267 ,898,8,906,1262,0,3,1,3,0,1,0,76.14,71.79 ,33.33
03,013,01,008,0185,268 ,974,15,989,1381,0,3,1,3,0,1,0,76.14,71.61 ,33.33
03,013,01,008,0186,269 ,707,8,715,972,0,3,1,3,0,1,0,76.14,73.56 ,33.33
03,013,01,008,0187,270 ,898,18,916,1220,0,3,1,3,0,1,0,76.14,75.08 ,33.33
03,013,01,008,0188,271 ,982,20,1002,1439,0,3,1,3,0,1,0,76.14,69.63 ,33.33
03,013,01,008,0189,272 ,471,7,478,623,0,3,1,3,0,1,0,76.14,76.73 ,33.33
03,013,01,008,0189,273 ,1145,8,1153,1663,0,3,1,3,0,1,0,76.14,69.33 ,33.33
03,013,01,008,0189,274 ,779,8,787,1188,0,3,1,3,0,1,0,76.14,66.25 ,33.33
03,013,01,008,0190,275 ,929,9,938,1290,0,3,1,3,0,1,0,76.14,72.71 ,33.33
03,013,01,008,0191,276 ,852,12,864,1234,0,3,1,3,0,1,0,76.14,70.02 ,33.33
03,013,01,008,0192,277 ,1254,17,1271,1644,0,3,1,3,0,1,0,76.14,77.31 ,33.33
03,013,01,008,0193,278 ,942,11,953,1279,0,3,1,3,0,1,0,76.14,74.51 ,33.33
03,013,01,009,0194,279 ,618,6,624,883,0,3,1,3,0,1,0,76.14,70.67 ,33.33
03,013,01,009,0194,280 ,786,8,794,1163,0,3,1,3,0,1,0,76.14,68.27 ,33.33
03,013,01,009,0195,281 ,938,8,946,1362,0,3,1,3,0,1,0,76.14,69.46 ,33.33
03,013,01,009,0196,282 ,940,8,948,1359,0,3,1,3,0,1,0,76.14,69.76 ,33.33
03,013,01,009,0197,283 ,803,6,809,1116,0,3,1,3,0,1,0,76.14,72.49 ,33.33
03,013,01,009,0198,284 ,561,5,566,785,0,3,1,3,0,1,0,76.14,72.10 ,33.33
03,013,01,009,0199,285 ,819,11,830,1189,0,3,1,3,0,1,0,76.14,69.81 ,33.33
03,013,01,009,0200,286 ,598,11,609,859,0,3,1,3,0,1,0,76.14,70.90 ,33.33
03,013,01,009,0200,287 ,530,6,536,795,0,3,1,3,0,1,0,76.14,67.42 ,33.33
03,013,01,009,0201,288 ,861,6,867,1232,0,3,1,3,0,1,0,76.14,70.37 ,33.33
03,013,01,009,0202,289 ,308,2,310,407,0,3,1,3,0,1,0,76.14,76.17 ,33.33
03,013,01,009,0202,290 ,904,7,911,1164,0,3,1,3,0,1,0,76.14,78.26 ,33.33
03,013,01,009,0203,291 ,735,11,746,1007,0,3,1,3,0,1,0,76.14,74.08 ,33.33
03,013,01,009,0203,292 ,905,10,915,1290,0,3,1,3,0,1,0,76.14,70.93 ,33.33
03,013,01,009,0204,293 ,955,16,971,1475,0,3,1,3,0,1,0,76.14,65.83 ,33.33
03,013,01,009,0204,294 ,360,9,369,514,0,3,1,3,0,1,0,76.14,71.79 ,33.33
03,013,01,009,0205,295 ,592,13,605,847,0,3,1,3,0,1,0,76.14,71.43 ,33.33
03,013,01,009,0205,296 ,620,8,628,870,0,3,1,3,0,1,0,76.14,72.18 ,33.33
03,013,01,009,0206,297 ,541,3,544,805,0,3,1,3,0,1,0,76.14,67.58 ,33.33
03,013,01,009,0207,298 ,324,4,328,453,0,3,1,3,0,1,0,76.14,72.41 ,33.33
03,013,01,010,0208,299 ,1233,13,1246,1703,0,3,1,3,0,1,0,76.14,73.17 ,33.33
03,013,01,010,0209,300 ,753,9,762,1041,0,3,1,3,0,1,0,76.14,73.20 ,33.33
03,013,01,010,0209,301 ,855,18,873,1170,0,3,1,3,0,1,0,76.14,74.62 ,33.33
03,013,01,010,0210,302 ,1083,14,1097,1600,0,3,1,3,0,1,0,76.14,68.56 ,33.33
03,013,01,010,0211,303 ,743,11,754,911,0,3,1,3,0,1,0,76.14,82.77 ,33.33
03,013,01,010,0212,304 ,921,16,937,1310,0,3,1,3,0,1,0,76.14,71.53 ,33.33
03,013,01,010,0212,305 ,970,9,979,1348,0,3,1,3,0,1,0,76.14,72.63 ,33.33
03,013,01,010,0213,306 ,1271,24,1295,1878,0,3,1,3,0,1,0,76.14,68.96 ,33.33
03,013,01,010,0214,307 ,625,17,642,850,0,3,1,3,0,1,0,76.14,75.53 ,33.33
03,013,01,010,0215,308 ,893,15,908,1398,0,3,1,3,0,1,0,76.14,64.95 ,33.33
03,013,01,010,0215,309 ,900,12,912,1384,0,3,1,3,0,1,0,76.14,65.90 ,33.33
03,013,01,010,0216,310 ,860,10,870,1285,0,3,1,3,0,1,0,76.14,67.70 ,33.33
03,013,01,010,0216,311 ,1040,11,1051,1672,0,3,1,3,0,1,0,76.14,62.86 ,33.33
03,013,01,010,0217,312 ,639,9,648,958,0,3,1,3,0,1,0,76.14,67.64 ,33.33
03,013,01,010,0218,313 ,1002,13,1015,1443,0,3,1,3,0,1,0,76.14,70.34 ,33.33
03,013,01,010,0219,314 ,412,3,415,571,0,3,1,3,0,1,0,76.14,72.68 ,33.33
03,013,01,011,0220,315 ,655,4,659,978,0,3,1,3,0,1,0,76.14,67.38 ,33.33
03,013,01,011,0220,316 ,749,6,755,1203,0,3,1,3,0,1,0,76.14,62.76 ,33.33
03,013,01,011,0221,317 ,922,15,937,1380,0,3,1,3,0,1,0,76.14,67.90 ,33.33
03,013,01,011,0222,318 ,580,10,590,828,0,3,1,3,0,1,0,76.14,71.26 ,33.33
03,013,01,011,0223,319 ,392,3,395,630,0,3,1,3,0,1,0,76.14,62.70 ,33.33
03,013,01,011,0224,320 ,675,4,679,1025,0,3,1,3,0,1,0,76.14,66.24 ,33.33
03,013,01,011,0225,321 ,738,8,746,1185,0,3,1,3,0,1,0,76.14,62.95 ,33.33
03,013,01,011,0226,322 ,419,9,428,675,0,3,1,3,0,1,0,76.14,63.41 ,33.33
03,013,01,011,0227,323 ,564,10,574,824,0,3,1,3,0,1,0,76.14,69.66 ,33.33
03,013,01,011,0228,324 ,504,5,509,751,0,3,1,3,0,1,0,76.14,67.78 ,33.33
03,013,01,011,0229,325 ,793,12,805,1314,0,3,1,3,0,1,0,76.14,61.26 ,33.33
03,013,01,011,0230,326 ,925,13,938,1518,0,3,1,3,0,1,0,76.14,61.79 ,33.33
03,013,01,011,0231,327 ,566,11,577,959,0,3,1,3,0,1,0,76.14,60.17 ,33.33
03,013,01,011,0231,328 ,626,11,637,1024,0,3,1,3,0,1,0,76.14,62.21 ,33.33
03,013,01,011,0232,329 ,770,11,781,1239,0,3,1,3,0,1,0,76.14,63.03 ,33.33
03,013,01,011,0233,330 ,643,9,652,968,0,3,1,3,0,1,0,76.14,67.36 ,33.33
03,013,01,011,0234,331 ,674,9,683,1046,0,3,1,3,0,1,0,76.14,65.30 ,33.33
03,013,01,011,0235,332 ,692,14,706,1037,0,3,1,3,0,1,0,76.14,68.08 ,33.33
03,013,01,011,0236,333 ,767,10,777,1126,0,3,1,3,0,1,0,76.14,69.01 ,33.33
03,013,01,011,0237,334 ,505,6,511,753,0,3,1,3,0,1,0,76.14,67.86 ,33.33
03,013,01,011,0237,335 ,404,4,408,613,0,3,1,3,0,1,0,76.14,66.56 ,33.33
03,013,01,011,0238,336 ,926,9,935,1438,0,3,1,3,0,1,0,76.14,65.02 ,33.33
03,013,01,012,0239,337 ,854,12,866,1263,0,3,1,3,0,1,0,76.14,68.57 ,33.33
03,013,01,012,0240,338 ,560,3,563,782,0,3,1,3,0,1,0,76.14,71.99 ,33.33
03,013,01,012,0241,339 ,981,14,995,1421,0,3,1,3,0,1,0,76.14,70.02 ,33.33
03,013,01,012,0242,340 ,648,3,651,899,0,3,1,3,0,1,0,76.14,72.41 ,33.33
03,013,01,012,0243,341 ,375,8,383,542,0,3,1,3,0,1,0,76.14,70.66 ,33.33
03,013,01,012,0244,342 ,866,13,879,1264,0,3,1,3,0,1,0,76.14,69.54 ,33.33
03,013,01,012,0245,343 ,836,15,851,1144,0,3,1,3,0,1,0,76.14,74.39 ,33.33
03,013,01,012,0246,344 ,960,14,974,1372,0,3,1,3,0,1,0,76.14,70.99 ,33.33
03,013,01,012,0247,345 ,504,7,511,878,0,3,1,3,0,1,0,76.14,58.20 ,33.33
03,013,01,012,0247,346 ,487,10,497,795,0,3,1,3,0,1,0,76.14,62.52 ,33.33
03,013,01,012,0248,347 ,660,11,671,987,0,3,1,3,0,1,0,76.14,67.98 ,33.33
03,013,01,012,0248,348 ,594,15,609,904,0,3,1,3,0,1,0,76.14,67.37 ,33.33
03,013,01,012,0249,349 ,1105,7,1112,1535,0,3,1,3,0,1,0,76.14,72.44 ,33.33
03,013,01,012,0250,350 ,1092,12,1104,1493,0,3,1,3,0,1,0,76.14,73.95 ,33.33
03,013,01,012,0251,351 ,741,7,748,1075,0,3,1,3,0,1,0,76.14,69.58 ,33.33
03,013,01,012,0252,352 ,402,3,405,571,0,3,1,3,0,1,0,76.14,70.93 ,33.33
03,013,01,012,0252,353 ,390,9,399,613,0,3,1,3,0,1,0,76.14,65.09 ,33.33
03,013,01,013,0253,354 ,841,6,847,1239,0,3,1,3,0,1,0,76.14,68.36 ,33.33
03,013,01,013,0253,355 ,1295,6,1301,1922,0,3,1,3,0,1,0,76.14,67.69 ,33.33
03,013,01,013,0254,356 ,713,6,719,1078,0,3,1,3,0,1,0,76.14,66.70 ,33.33
03,013,01,013,0254,357 ,1074,8,1082,1662,0,3,1,3,0,1,0,76.14,65.10 ,33.33
03,013,01,013,0255,358 ,945,6,951,1314,0,3,1,3,0,1,0,76.14,72.37 ,33.33
03,013,01,013,0256,359 ,397,8,405,590,0,3,1,3,0,1,0,76.14,68.64 ,33.33
03,013,01,013,0257,360 ,696,6,702,1023,0,3,1,3,0,1,0,76.14,68.62 ,33.33
03,013,01,013,0257,361 ,714,8,722,1060,0,3,1,3,0,1,0,76.14,68.11 ,33.33
03,013,01,013,0258,362 ,590,6,596,853,0,3,1,3,0,1,0,76.14,69.87 ,33.33
03,013,01,013,0258,363 ,674,5,679,995,0,3,1,3,0,1,0,76.14,68.24 ,33.33
03,013,01,013,0259,364 ,690,11,701,1001,0,3,1,3,0,1,0,76.14,70.03 ,33.33
03,013,01,013,0259,365 ,921,10,931,1336,0,3,1,3,0,1,0,76.14,69.69 ,33.33
03,013,01,013,0259,366 ,1086,9,1095,1625,0,3,1,3,0,1,0,76.14,67.38 ,33.33
03,013,01,013,0260,367 ,704,5,709,1197,0,3,1,3,0,1,0,76.14,59.23 ,33.33
03,013,01,013,0260,368 ,792,6,798,1239,0,3,1,3,0,1,0,76.14,64.41 ,33.33
03,013,01,013,0261,369 ,657,2,659,870,0,3,1,3,0,1,0,76.14,75.75 ,33.33
03,013,01,013,0261,370 ,530,5,535,774,0,3,1,3,0,1,0,76.14,69.12 ,33.33
03,013,01,013,0262,371 ,563,4,567,815,0,3,1,3,0,1,0,76.14,69.57 ,33.33
03,013,01,013,0262,372 ,769,5,774,1090,0,3,1,3,0,1,0,76.14,71.01 ,33.33
03,013,01,013,0263,373 ,996,16,1012,1532,0,3,1,3,0,1,0,76.14,66.06 ,33.33
03,013,01,013,0264,374 ,771,5,776,1123,0,3,1,3,0,1,0,76.14,69.10 ,33.33
03,013,01,013,0264,375 ,1134,14,1148,1752,0,3,1,3,0,1,0,76.14,65.53 ,33.33
03,013,01,013,0265,376 ,658,9,667,948,0,3,1,3,0,1,0,76.14,70.36 ,33.33
03,013,01,013,0266,377 ,740,6,746,1068,0,3,1,3,0,1,0,76.14,69.85 ,33.33
03,013,01,013,0267,378 ,663,8,671,1146,0,3,1,3,0,1,0,76.14,58.55 ,33.33
03,013,01,013,0267,379 ,725,9,734,1213,0,3,1,3,0,1,0,76.14,60.51 ,33.33
03,013,01,013,0268,380 ,896,18,914,1453,0,3,1,3,0,1,0,76.14,62.90 ,33.33
03,013,01,013,0269,381 ,873,5,878,1338,0,3,1,3,0,1,0,76.14,65.62 ,33.33
03,013,01,013,0269,382 ,711,12,723,1126,0,3,1,3,0,1,0,76.14,64.21 ,33.33
03,013,01,013,0270,383 ,109,3,112,179,0,3,1,3,0,1,0,76.14,62.57 ,33.33
03,013,01,013,0270,384 ,868,8,876,1363,0,3,1,3,0,1,0,76.14,64.27 ,33.33
03,013,01,013,0270,385 ,664,10,674,1017,0,3,1,3,0,1,0,76.14,66.27 ,33.33
03,013,01,013,0271,386 ,399,2,401,586,0,3,1,3,0,1,0,76.14,68.43 ,33.33
03,013,01,013,0271,387 ,642,47,689,1259,0,3,1,3,0,1,0,76.14,54.73 ,33.33
03,013,01,013,0272,388 ,880,12,892,1329,0,3,1,3,0,1,0,76.14,67.12 ,33.33
03,013,01,013,0272,389 ,251,1,252,397,0,3,1,3,0,1,0,76.14,63.48 ,33.33
03,013,01,013,0273,390 ,747,5,752,1159,0,3,1,3,0,1,0,76.14,64.88 ,33.33
03,013,01,013,0273,391 ,677,8,685,1042,0,3,1,3,0,1,0,76.14,65.74 ,33.33
03,013,01,013,0274,392 ,680,18,698,1146,0,3,1,3,0,1,0,76.14,60.91 ,33.33
03,013,01,013,0275,393 ,493,8,501,784,0,3,1,3,0,1,0,76.14,63.90 ,33.33
03,013,01,014,0276,394 ,1036,16,1052,1437,0,3,1,3,0,1,0,76.14,73.21 ,33.33
03,013,01,014,0277,395 ,573,3,576,843,0,3,1,3,0,1,0,76.14,68.33 ,33.33
03,013,01,014,0278,396 ,509,3,512,676,0,3,1,3,0,1,0,76.14,75.74 ,33.33
03,013,01,014,0279,397 ,427,1,428,596,0,3,1,3,0,1,0,76.14,71.81 ,33.33
03,013,01,014,0280,398 ,920,9,929,1315,0,3,1,3,0,1,0,76.14,70.65 ,33.33
03,013,01,014,0281,399 ,718,7,725,960,0,3,1,3,0,1,0,76.14,75.52 ,33.33
03,013,01,014,0282,400 ,439,6,445,606,0,3,1,3,0,1,0,76.14,73.43 ,33.33
03,013,01,014,0283,401 ,345,4,349,464,0,3,1,3,0,1,0,76.14,75.22 ,33.33
03,013,01,014,0284,402 ,926,11,937,1320,0,3,1,3,0,1,0,76.14,70.98 ,33.33
03,013,01,014,0284,403 ,860,9,869,1218,0,3,1,3,0,1,0,76.14,71.35 ,33.33
03,013,01,014,0285,404 ,355,1,356,442,0,3,1,3,0,1,0,76.14,80.54 ,33.33
03,013,01,014,0286,405 ,420,3,423,608,0,3,1,3,0,1,0,76.14,69.57 ,33.33
03,013,01,014,0287,406 ,501,6,507,673,0,3,1,3,0,1,0,76.14,75.33 ,33.33
03,013,01,014,0288,407 ,714,12,726,1089,0,3,1,3,0,1,0,76.14,66.67 ,33.33
03,013,01,014,0289,408 ,812,4,816,1171,0,3,1,3,0,1,0,76.14,69.68 ,33.33
03,013,01,014,0290,409 ,678,10,688,983,0,3,1,3,0,1,0,76.14,69.99 ,33.33
03,013,01,015,0291,410 ,1033,9,1042,1570,0,3,1,3,0,1,0,76.14,66.37 ,33.33
03,013,01,015,0291,411 ,246,2,248,339,0,3,1,3,0,1,0,76.14,73.16 ,33.33
03,013,01,015,0292,412 ,598,1,599,831,0,3,1,3,0,1,0,76.14,72.08 ,33.33
03,013,01,015,0292,413 ,274,2,276,396,0,3,1,3,0,1,0,76.14,69.70 ,33.33
03,013,01,015,0293,414 ,739,6,745,1014,0,3,1,3,0,1,0,76.14,73.47 ,33.33
03,013,01,015,0294,415 ,519,5,524,758,0,3,1,3,0,1,0,76.14,69.13 ,33.33
03,013,01,015,0295,416 ,447,5,452,692,0,3,1,3,0,1,0,76.14,65.32 ,33.33
03,013,01,015,0295,417 ,246,4,250,354,0,3,1,3,0,1,0,76.14,70.62 ,33.33
03,013,01,015,0295,418 ,391,5,396,640,0,3,1,3,0,1,0,76.14,61.88 ,33.33
03,013,01,015,0296,419 ,792,8,800,1345,0,3,1,3,0,1,0,76.14,59.48 ,33.33
03,013,01,015,0297,420 ,342,8,350,549,0,3,1,3,0,1,0,76.14,63.75 ,33.33
03,013,01,015,0297,421 ,365,4,369,541,0,3,1,3,0,1,0,76.14,68.21 ,33.33
03,013,01,016,0298,422 ,758,10,768,1282,0,3,1,3,0,1,0,76.14,59.91 ,33.33
03,013,01,016,0299,423 ,543,6,549,839,0,3,1,3,0,1,0,76.14,65.44 ,33.33
03,013,01,016,0300,424 ,624,5,629,937,0,3,1,3,0,1,0,76.14,67.13 ,33.33
03,013,01,016,0301,425 ,429,5,434,684,0,3,1,3,0,1,0,76.14,63.45 ,33.33
03,013,01,016,0302,426 ,1130,15,1145,1819,0,3,1,3,0,1,0,76.14,62.95 ,33.33
03,013,01,016,0303,427 ,1041,11,1052,1849,0,3,1,3,0,1,0,76.14,56.90 ,33.33
03,013,01,016,0303,428 ,1049,13,1062,1819,0,3,1,3,0,1,0,76.14,58.38 ,33.33
03,013,01,016,0304,429 ,639,3,642,960,0,3,1,3,0,1,0,76.14,66.88 ,33.33
03,013,01,016,0304,430 ,701,5,706,1068,0,3,1,3,0,1,0,76.14,66.10 ,33.33
03,013,01,016,0305,431 ,1175,9,1184,1678,0,3,1,3,0,1,0,76.14,70.56 ,33.33
03,013,01,016,0306,432 ,677,10,687,1049,0,3,1,3,0,1,0,76.14,65.49 ,33.33
03,013,01,016,0306,433 ,752,8,760,1146,0,3,1,3,0,1,0,76.14,66.32 ,33.33
03,013,01,016,0307,434 ,410,6,416,741,0,3,1,3,0,1,0,76.14,56.14 ,33.33
03,013,01,016,0308,435 ,562,20,582,974,0,3,1,3,0,1,0,76.14,59.75 ,33.33
03,013,01,016,0309,436 ,747,6,753,1147,0,3,1,3,0,1,0,76.14,65.65 ,33.33
03,013,01,016,0309,437 ,1032,8,1040,1617,0,3,1,3,0,1,0,76.14,64.32 ,33.33
03,013,01,016,0310,438 ,406,2,408,608,0,3,1,3,0,1,0,76.14,67.11 ,33.33
03,013,01,016,0311,439 ,598,11,609,948,0,3,1,3,0,1,0,76.14,64.24 ,33.33
03,013,01,016,0312,440 ,293,2,295,441,0,3,1,3,0,1,0,76.14,66.89 ,33.33
03,013,01,017,0313,441 ,1163,7,1170,1595,0,3,1,3,0,1,0,76.14,73.35 ,33.33
03,013,01,017,0314,442 ,760,2,762,1075,0,3,1,3,0,1,0,76.14,70.88 ,33.33
03,013,01,017,0314,443 ,877,11,888,1276,0,3,1,3,0,1,0,76.14,69.59 ,33.33
03,013,01,017,0315,444 ,686,7,693,999,0,3,1,3,0,1,0,76.14,69.37 ,33.33
03,013,01,017,0315,445 ,715,9,724,1018,0,3,1,3,0,1,0,76.14,71.12 ,33.33
03,013,01,017,0316,446 ,497,12,509,774,0,3,1,3,0,1,0,76.14,65.76 ,33.33
03,013,01,017,0317,447 ,588,5,593,789,0,3,1,3,0,1,0,76.14,75.16 ,33.33
03,013,01,017,0318,448 ,830,16,846,1219,0,3,1,3,0,1,0,76.14,69.40 ,33.33
03,013,01,017,0318,449 ,691,20,711,1008,0,3,1,3,0,1,0,76.14,70.54 ,33.33
03,013,01,017,0319,450 ,623,7,630,870,0,3,1,3,0,1,0,76.14,72.41 ,33.33
03,013,01,017,0319,451 ,755,7,762,1057,0,3,1,3,0,1,0,76.14,72.09 ,33.33
03,013,01,017,0320,452 ,822,4,826,1047,0,3,1,3,0,1,0,76.14,78.89 ,33.33
03,013,01,017,0320,453 ,848,12,860,1117,0,3,1,3,0,1,0,76.14,76.99 ,33.33
03,013,01,017,0321,454 ,657,12,669,968,0,3,1,3,0,1,0,76.14,69.11 ,33.33
03,013,01,017,0321,455 ,531,6,537,756,0,3,1,3,0,1,0,76.14,71.03 ,33.33
03,013,01,017,0321,456 ,678,20,698,1085,0,3,1,3,0,1,0,76.14,64.33 ,33.33
03,013,01,017,0322,457 ,935,11,946,1265,0,3,1,3,0,1,0,76.14,74.78 ,33.33
03,013,01,017,0323,458 ,627,11,638,894,0,3,1,3,0,1,0,76.14,71.36 ,33.33
03,013,01,017,0323,459 ,800,9,809,1190,0,3,1,3,0,1,0,76.14,67.98 ,33.33
03,013,01,017,0324,460 ,1132,13,1145,1713,0,3,1,3,0,1,0,76.14,66.84 ,33.33
03,013,01,017,0325,461 ,947,10,957,1405,0,3,1,3,0,1,0,76.14,68.11 ,33.33
03,013,01,017,0326,462 ,859,7,866,1398,0,3,1,3,0,1,0,76.14,61.95 ,33.33
03,013,01,017,0326,463 ,817,17,834,1259,0,3,1,3,0,1,0,76.14,66.24 ,33.33
03,013,01,017,0326,464 ,719,5,724,1241,0,3,1,3,0,1,0,76.14,58.34 ,33.33
03,013,01,017,0327,465 ,661,19,680,1080,0,3,1,3,0,1,0,76.14,62.96 ,33.33
03,013,01,017,0327,466 ,744,11,755,1135,0,3,1,3,0,1,0,76.14,66.52 ,33.33
03,013,01,018,0328,467 ,1405,15,1420,2009,0,3,1,3,0,1,0,76.14,70.68 ,33.33
03,013,01,018,0329,468 ,1074,4,1078,1654,0,3,1,3,0,1,0,76.14,65.18 ,33.33
03,013,01,018,0330,469 ,777,16,793,1100,0,3,1,3,0,1,0,76.14,72.09 ,33.33
03,013,01,018,0331,470 ,779,7,786,1118,0,3,1,3,0,1,0,76.14,70.30 ,33.33
03,013,01,018,0332,471 ,570,6,576,874,0,3,1,3,0,1,0,76.14,65.90 ,33.33
03,013,01,018,0333,472 ,1036,12,1048,1497,0,3,1,3,0,1,0,76.14,70.01 ,33.33
03,013,01,018,0334,473 ,544,10,554,774,0,3,1,3,0,1,0,76.14,71.58 ,33.33
03,013,01,018,0335,474 ,1196,20,1216,1737,0,3,1,3,0,1,0,76.14,70.01 ,33.33
03,013,01,019,0336,475 ,1023,11,1034,1460,0,3,1,3,0,1,0,76.14,70.82 ,33.33
03,013,01,019,0337,476 ,1070,13,1083,1625,0,3,1,3,0,1,0,76.14,66.65 ,33.33
03,013,01,019,0338,477 ,581,5,586,843,0,3,1,3,0,1,0,76.14,69.51 ,33.33
03,013,01,019,0339,478 ,1111,6,1117,1588,0,3,1,3,0,1,0,76.14,70.34 ,33.33
03,013,01,019,0340,479 ,1081,15,1096,1509,0,3,1,3,0,1,0,76.14,72.63 ,33.33
03,013,01,019,0340,480 ,1212,6,1218,1687,0,3,1,3,0,1,0,76.14,72.20 ,33.33
03,013,01,019,0341,481 ,632,2,634,905,0,3,1,3,0,1,0,76.14,70.06 ,33.33
03,013,01,019,0342,482 ,815,9,824,1329,0,3,1,3,0,1,0,76.14,62.00 ,33.33
03,013,01,019,0343,483 ,1178,10,1188,1864,0,3,1,3,0,1,0,76.14,63.73 ,33.33
03,013,01,019,0344,484 ,1020,6,1026,1505,0,3,1,3,0,1,0,76.14,68.17 ,33.33
03,013,01,019,0344,485 ,886,12,898,1371,0,3,1,3,0,1,0,76.14,65.50 ,33.33
03,013,01,019,0345,486 ,775,9,784,1130,0,3,1,3,0,1,0,76.14,69.38 ,33.33
03,013,01,020,0346,487 ,1256,12,1268,1778,0,3,1,3,0,1,0,76.14,71.32 ,33.33
03,013,01,020,0347,488 ,695,2,697,1003,0,3,1,3,0,1,0,76.14,69.49 ,33.33
03,013,01,020,0348,489 ,380,5,385,574,0,3,1,3,0,1,0,76.14,67.07 ,33.33
03,013,01,020,0349,490 ,555,12,567,777,0,3,1,3,0,1,0,76.14,72.97 ,33.33
03,013,01,020,0350,491 ,720,9,729,1040,0,3,1,3,0,1,0,76.14,70.10 ,33.33
03,013,01,020,0351,492 ,706,6,712,1002,0,3,1,3,0,1,0,76.14,71.06 ,33.33
03,013,01,020,0352,493 ,742,9,751,1019,0,3,1,3,0,1,0,76.14,73.70 ,33.33
03,013,01,020,0353,494 ,728,13,741,1105,0,3,1,3,0,1,0,76.14,67.06 ,33.33
03,013,01,020,0354,495 ,645,5,650,949,0,3,1,3,0,1,0,76.14,68.49 ,33.33
03,013,01,020,0355,496 ,418,4,422,582,0,3,1,3,0,1,0,76.14,72.51 ,33.33
03,013,01,021,0356,497 ,1027,9,1036,1510,0,3,1,3,0,1,0,76.14,68.61 ,33.33
03,013,01,021,0357,498 ,1109,14,1123,1625,0,3,1,3,0,1,0,76.14,69.11 ,33.33
03,013,01,021,0358,499 ,641,7,648,959,0,3,1,3,0,1,0,76.14,67.57 ,33.33
03,013,01,021,0359,500 ,1156,8,1164,1687,0,3,1,3,0,1,0,76.14,69.00 ,33.33
03,013,01,021,0360,501 ,1273,21,1294,1920,0,3,1,3,0,1,0,76.14,67.40 ,33.33
03,013,01,021,0361,502 ,631,7,638,958,0,3,1,3,0,1,0,76.14,66.60 ,33.33
03,013,01,021,0361,503 ,782,9,791,1227,0,3,1,3,0,1,0,76.14,64.47 ,33.33
03,013,01,021,0362,504 ,818,9,827,1126,0,3,1,3,0,1,0,76.14,73.45 ,33.33
03,013,01,021,0363,505 ,629,7,636,840,0,3,1,3,0,1,0,76.14,75.71 ,33.33
03,013,01,021,0364,506 ,868,13,881,1215,0,3,1,3,0,1,0,76.14,72.51 ,33.33
03,013,01,021,0365,507 ,717,11,728,1037,0,3,1,3,0,1,0,76.14,70.20 ,33.33
03,013,01,021,0366,508 ,711,8,719,1103,0,3,1,3,0,1,0,76.14,65.19 ,33.33
03,013,01,021,0367,509 ,703,7,710,1065,0,3,1,3,0,1,0,76.14,66.67 ,33.33
03,013,01,021,0367,510 ,784,5,789,1171,0,3,1,3,0,1,0,76.14,67.38 ,33.33
03,013,01,022,0368,511 ,1036,19,1055,1968,0,3,1,3,0,1,0,76.14,53.61 ,33.33
03,013,01,022,0369,512 ,599,10,609,1108,0,3,1,3,0,1,0,76.14,54.96 ,33.33
03,013,01,022,0370,513 ,485,9,494,1018,0,3,1,3,0,1,0,76.14,48.53 ,33.33
03,013,01,022,0371,514 ,750,9,759,1587,0,3,1,3,0,1,0,76.14,47.83 ,33.33
03,013,01,022,0372,515 ,492,9,501,1231,0,3,1,3,0,1,0,76.14,40.70 ,33.33
03,013,01,022,0373,516 ,432,10,442,1083,0,3,1,3,0,1,0,76.14,40.81 ,33.33
03,013,01,022,0374,517 ,626,11,637,1477,0,3,1,3,0,1,0,76.14,43.13 ,33.33
03,013,01,022,0375,518 ,347,3,350,779,0,3,1,3,0,1,0,76.14,44.93 ,33.33
03,013,01,023,0376,519 ,296,10,306,446,0,3,1,3,0,1,0,76.14,68.61 ,33.33
03,013,01,023,0376,520 ,578,7,585,904,0,3,1,3,0,1,0,76.14,64.71 ,33.33
03,013,01,023,0377,521 ,390,3,393,564,0,3,1,3,0,1,0,76.14,69.68 ,33.33
03,013,01,023,0378,522 ,440,6,446,743,0,3,1,3,0,1,0,76.14,60.03 ,33.33
03,013,01,023,0379,523 ,478,6,484,810,0,3,1,3,0,1,0,76.14,59.75 ,33.33
03,013,01,023,0380,524 ,255,4,259,429,0,3,1,3,0,1,0,76.14,60.37 ,33.33
03,013,01,023,0381,525 ,543,13,556,997,0,3,1,3,0,1,0,76.14,55.77 ,33.33
03,013,01,023,0382,526 ,420,3,423,690,0,3,1,3,0,1,0,76.14,61.30 ,33.33
03,013,01,023,0382,527 ,364,11,375,687,0,3,1,3,0,1,0,76.14,54.59 ,33.33
03,013,01,023,0383,528 ,287,2,289,427,0,3,1,3,0,1,0,76.14,67.68 ,33.33
03,013,01,023,0384,529 ,242,7,249,455,0,3,1,3,0,1,0,76.14,54.73 ,33.33
03,013,01,023,0385,530 ,327,2,329,537,0,3,1,3,0,1,0,76.14,61.27 ,33.33
03,013,01,023,0386,531 ,275,10,285,488,0,3,1,3,0,1,0,76.14,58.40 ,33.33
03,013,01,024,0387,532 ,742,9,751,1346,0,3,1,3,0,1,0,76.14,55.79 ,33.33
03,013,01,024,0388,533 ,136,5,141,271,0,3,1,3,0,1,0,76.14,52.03 ,33.33
03,013,01,024,0389,534 ,650,14,664,1170,0,3,1,3,0,1,0,76.14,56.75 ,33.33
03,013,01,024,0390,535 ,666,5,671,1108,0,3,1,3,0,1,0,76.14,60.56 ,33.33
03,013,01,024,0391,536 ,217,3,220,412,0,3,1,3,0,1,0,76.14,53.40 ,33.33
03,013,01,024,0392,537 ,313,8,321,646,0,3,1,3,0,1,0,76.14,49.69 ,33.33
03,013,01,024,0393,538 ,112,0,112,227,0,3,1,3,0,1,0,76.14,49.34 ,33.33
03,013,01,024,0394,539 ,165,0,165,302,0,3,1,3,0,1,0,76.14,54.64 ,33.33
03,013,01,025,0395,540 ,597,10,607,921,0,3,1,3,0,1,0,76.14,65.91 ,33.33
03,013,01,025,0395,541 ,635,5,640,917,0,3,1,3,0,1,0,76.14,69.79 ,33.33
03,013,01,025,0396,542 ,382,4,386,591,0,3,1,3,0,1,0,76.14,65.31 ,33.33
03,013,01,025,0396,543 ,301,4,305,468,0,3,1,3,0,1,0,76.14,65.17 ,33.33
03,013,01,025,0397,544 ,537,10,547,1067,0,3,1,3,0,1,0,76.14,51.27 ,33.33
03,013,01,025,0398,545 ,461,3,464,985,0,3,1,3,0,1,0,76.14,47.11 ,33.33
03,013,01,026,0399,546 ,79,2,81,122,0,3,1,3,0,1,0,76.14,66.39 ,33.33
03,013,01,026,0400,547 ,9,0,9,17,0,3,1,3,0,1,0,76.14,52.94 ,33.33
03,013,01,026,0401,548 ,6,0,6,15,0,3,1,3,0,1,0,76.14,40.00 ,33.33
03,013,01,026,0402,549 ,6,0,6,20,0,3,1,3,0,1,0,76.14,30.00 ,33.33
03,013,01,026,0403,550 ,25,3,28,49,0,3,1,3,0,1,0,76.14,57.14 ,33.33
03,013,01,026,0404,551 ,30,0,30,42,0,3,1,3,0,1,0,76.14,71.43 ,33.33
03,013,01,026,0405,552 ,9,0,9,15,0,3,1,3,0,1,0,76.14,60.00 ,33.33
03,013,01,026,0406,553 ,21,0,21,38,0,3,1,3,0,1,0,76.14,55.26 ,33.33
03,013,01,026,0407,554 ,49,1,50,79,0,3,1,3,0,1,0,76.14,63.29 ,33.33
03,013,01,026,0408,555 ,15,1,16,39,0,3,1,3,0,1,0,76.14,41.03 ,33.33
03,013,01,027,0409,556 ,3,0,3,10,0,3,1,3,0,1,0,76.14,30.00 ,33.33
03,013,01,027,0409,557 ,7,1,8,12,0,3,1,3,0,1,0,76.14,66.67 ,33.33
03,013,01,027,0409,558 ,0,0,0,2,0,3,1,3,0,1,0,76.14,0.00 ,33.33
03,013,01,027,0410,559 ,7,0,7,15,0,3,1,3,0,1,0,76.14,46.67 ,33.33
03,013,01,027,0411,560 ,2,0,2,3,0,3,1,3,0,1,0,76.14,66.67 ,33.33
03,013,01,027,0412,561 ,2,0,2,3,0,3,1,3,0,1,0,76.14,66.67 ,33.33
03,013,01,027,0413,562 ,6,0,6,17,0,3,1,3,0,1,0,76.14,35.29 ,33.33
03,013,01,027,0414,563 ,1,0,1,4,0,3,1,3,0,1,0,76.14,25.00 ,33.33
03,013,01,028,0415,564 ,10,0,10,18,0,3,1,3,0,1,0,76.14,55.56 ,33.33
03,013,01,028,0416,565 ,57,0,57,86,0,3,1,3,0,1,0,76.14,66.28 ,33.33
03,013,01,028,0417,566 ,34,0,34,59,0,3,1,3,0,1,0,76.14,57.63 ,33.33
03,013,01,028,0418,567 ,27,2,29,53,0,3,1,3,0,1,0,76.14,54.72 ,33.33
03,013,01,028,0419,568 ,5,0,5,12,0,3,1,3,0,1,0,76.14,41.67 ,33.33
03,013,01,028,0420,569 ,19,2,21,36,0,3,1,3,0,1,0,76.14,58.33 ,33.33
03,013,01,028,0420,570 ,21,3,24,39,0,3,1,3,0,1,0,76.14,61.54 ,33.33
03,013,01,028,0420,571 ,29,3,32,47,0,3,1,3,0,1,0,76.14,68.09 ,33.33
03,013,01,029,0421,572 ,19,0,19,27,0,3,1,3,0,1,0,76.14,70.37 ,33.33
03,013,01,029,0421,573 ,9,0,9,12,0,3,1,3,0,1,0,76.14,75.00 ,33.33
03,013,01,029,0422,574 ,17,0,17,42,0,3,1,3,0,1,0,76.14,40.48 ,33.33
03,013,01,029,0423,575 ,10,0,10,22,0,3,1,3,0,1,0,76.14,45.45 ,33.33
03,013,01,029,0424,576 ,7,0,7,12,0,3,1,3,0,1,0,76.14,58.33 ,33.33
03,013,01,029,0425,577 ,2,0,2,6,0,3,1,3,0,1,0,76.14,33.33 ,33.33
03,013,01,029,0426,578 ,14,0,14,29,0,3,1,3,0,1,0,76.14,48.28 ,33.33
03,013,01,030,0427,579 ,15,0,15,26,0,3,1,3,0,1,0,76.14,57.69 ,33.33
03,013,01,030,0428,580 ,13,0,13,21,0,3,1,3,0,1,0,76.14,61.90 ,33.33
03,013,01,030,0428,581 ,2,0,2,6,0,3,1,3,0,1,0,76.14,33.33 ,33.33
03,013,01,030,0429,582 ,24,0,24,41,0,3,1,3,0,1,0,76.14,58.54 ,33.33
03,013,01,030,0429,583 ,11,0,11,19,0,3,1,3,0,1,0,76.14,57.89 ,33.33
03,013,01,030,0430,584 ,42,2,44,73,0,3,1,3,0,1,0,76.14,60.27 ,33.33
03,013,01,030,0431,585 ,26,1,27,45,0,3,1,3,0,1,0,76.14,60.00 ,33.33
03,013,01,030,0432,586 ,39,2,41,53,0,3,1,3,0,1,0,76.14,77.36 ,33.33
03,013,01,030,0433,587 ,31,3,34,60,0,3,1,3,0,1,0,76.14,56.67 ,33.33
03,013,01,031,0434,588 ,20,3,23,54,0,3,1,3,0,1,0,76.14,42.59 ,33.33
03,013,01,031,0435,589 ,27,1,28,45,0,3,1,3,0,1,0,76.14,62.22 ,33.33
03,013,01,031,0436,590 ,2,0,2,9,0,3,1,3,0,1,0,76.14,22.22 ,33.33
03,013,01,031,0437,591 ,64,0,64,125,0,3,1,3,0,1,0,76.14,51.20 ,33.33
03,013,01,031,0438,592 ,78,1,79,113,0,3,1,3,0,1,0,76.14,69.91 ,33.33
03,013,01,031,0439,593 ,6,0,6,16,0,3,1,3,0,1,0,76.14,37.50 ,33.33
03,013,01,032,0440,594 ,30,1,31,50,0,3,1,3,0,1,0,76.14,62.00 ,33.33
03,013,01,032,0441,595 ,37,1,38,75,0,3,1,3,0,1,0,76.14,50.67 ,33.33
03,013,01,032,0442,596 ,20,1,21,48,0,3,1,3,0,1,0,76.14,43.75 ,33.33
03,013,01,032,0443,597 ,7,0,7,22,0,3,1,3,0,1,0,76.14,31.82 ,33.33
03,013,01,032,0444,598 ,15,2,17,29,0,3,1,3,0,1,0,76.14,58.62 ,33.33
03,013,01,032,0445,599 ,9,0,9,17,0,3,1,3,0,1,0,76.14,52.94 ,33.33
03,013,01,032,0446,600 ,21,1,22,35,0,3,1,3,0,1,0,76.14,62.86 ,33.33
03,013,01,032,0447,601 ,8,0,8,23,0,3,1,3,0,1,0,76.14,34.78 ,33.33
03,013,01,033,0448,602 ,72,2,74,118,0,3,1,3,0,1,0,76.14,62.71 ,33.33
03,013,01,033,0448,603 ,26,2,28,43,0,3,1,3,0,1,0,76.14,65.12 ,33.33
03,013,01,033,0449,604 ,16,1,17,31,0,3,1,3,0,1,0,76.14,54.84 ,33.33
03,013,01,033,0450,605 ,13,1,14,23,0,3,1,3,0,1,0,76.14,60.87 ,33.33
03,013,01,033,0451,606 ,44,3,47,108,0,3,1,3,0,1,0,76.14,43.52 ,33.33
03,013,01,033,0452,607 ,14,0,14,37,0,3,1,3,0,1,0,76.14,37.84 ,33.33
03,013,01,033,0453,608 ,7,2,9,26,0,3,1,3,0,1,0,76.14,34.62 ,33.33
03,014,01,001,0001,1 ,682,9,691,1054,0,3,1,3,0,1,0,76.14,65.56 ,33.33
03,014,01,001,0002,2 ,471,5,476,739,0,3,1,3,0,1,0,76.14,64.41 ,33.33
03,014,01,001,0002,3 ,529,3,532,718,0,3,1,3,0,1,0,76.14,74.09 ,33.33
03,014,01,001,0003,4 ,882,6,888,1423,0,3,1,3,0,1,0,76.14,62.40 ,33.33
03,014,01,001,0003,5 ,1132,11,1143,1842,0,3,1,3,0,1,0,76.14,62.05 ,33.33
03,014,01,001,0004,6 ,924,13,937,1506,0,3,1,3,0,1,0,76.14,62.22 ,33.33
03,014,01,001,0004,7 ,795,13,808,1235,0,3,1,3,0,1,0,76.14,65.43 ,33.33
03,014,01,001,0005,8 ,442,5,447,765,0,3,1,3,0,1,0,76.14,58.43 ,33.33
03,014,01,001,0006,9 ,639,7,646,1086,0,3,1,3,0,1,0,76.14,59.48 ,33.33
03,014,01,001,0007,10 ,264,5,269,462,0,3,1,3,0,1,0,76.14,58.23 ,33.33
03,014,01,001,0008,11 ,555,10,565,881,0,3,1,3,0,1,0,76.14,64.13 ,33.33
03,014,01,001,0008,12 ,434,7,441,773,0,3,1,3,0,1,0,76.14,57.05 ,33.33
03,014,01,001,0009,13 ,463,9,472,733,0,3,1,3,0,1,0,76.14,64.39 ,33.33
03,014,01,001,0010,14 ,392,4,396,637,0,3,1,3,0,1,0,76.14,62.17 ,33.33
03,014,01,001,0011,15 ,458,5,463,771,0,3,1,3,0,1,0,76.14,60.05 ,33.33
03,014,01,001,0012,16 ,524,9,533,867,0,3,1,3,0,1,0,76.14,61.48 ,33.33
03,014,01,001,0013,17 ,805,14,819,1355,0,3,1,3,0,1,0,76.14,60.44 ,33.33
03,014,01,001,0014,18 ,551,7,558,887,0,3,1,3,0,1,0,76.14,62.91 ,33.33
03,014,01,001,0015,19 ,640,6,646,998,0,3,1,3,0,1,0,76.14,64.73 ,33.33
03,014,01,001,0016,20 ,444,6,450,721,0,3,1,3,0,1,0,76.14,62.41 ,33.33
03,014,01,001,0017,21 ,302,2,304,441,0,3,1,3,0,1,0,76.14,68.93 ,33.33
03,014,01,001,0018,22 ,683,13,696,1165,0,3,1,3,0,1,0,76.14,59.74 ,33.33
03,014,01,001,0018,23 ,1068,5,1073,1679,0,3,1,3,0,1,0,76.14,63.91 ,33.33
03,014,01,001,0019,24 ,397,7,404,701,0,3,1,3,0,1,0,76.14,57.63 ,33.33
03,014,01,001,0020,25 ,267,6,273,474,0,3,1,3,0,1,0,76.14,57.59 ,33.33
03,014,01,001,0021,26 ,678,8,686,1173,0,3,1,3,0,1,0,76.14,58.48 ,33.33
03,014,01,001,0022,27 ,673,5,678,1141,0,3,1,3,0,1,0,76.14,59.42 ,33.33
03,014,01,001,0022,28 ,1032,13,1045,1663,0,3,1,3,0,1,0,76.14,62.84 ,33.33
03,014,01,001,0022,29 ,975,9,984,1636,0,3,1,3,0,1,0,76.14,60.15 ,33.33
03,014,01,001,0023,30 ,512,4,516,825,0,3,1,3,0,1,0,76.14,62.55 ,33.33
03,014,01,001,0023,31 ,785,10,795,1313,0,3,1,3,0,1,0,76.14,60.55 ,33.33
03,014,01,001,0024,32 ,602,4,606,915,0,3,1,3,0,1,0,76.14,66.23 ,33.33
03,014,01,001,0024,33 ,566,7,573,871,0,3,1,3,0,1,0,76.14,65.79 ,33.33
03,014,01,001,0024,34 ,606,5,611,957,0,3,1,3,0,1,0,76.14,63.85 ,33.33
03,014,01,001,0025,35 ,846,12,858,1420,0,3,1,3,0,1,0,76.14,60.42 ,33.33
03,014,01,001,0026,36 ,317,7,324,543,0,3,1,3,0,1,0,76.14,59.67 ,33.33
03,014,01,001,0026,37 ,632,11,643,1114,0,3,1,3,0,1,0,76.14,57.72 ,33.33
03,014,01,001,0027,38 ,561,4,565,865,0,3,1,3,0,1,0,76.14,65.32 ,33.33
03,014,01,001,0028,39 ,720,9,729,1092,0,3,1,3,0,1,0,76.14,66.76 ,33.33
03,014,01,001,0029,40 ,686,13,699,1078,0,3,1,3,0,1,0,76.14,64.84 ,33.33
03,014,01,001,0030,41 ,713,7,720,1221,0,3,1,3,0,1,0,76.14,58.97 ,33.33
03,014,01,001,0030,42 ,661,3,664,1205,0,3,1,3,0,1,0,76.14,55.10 ,33.33
03,014,01,001,0030,43 ,798,10,808,1355,0,3,1,3,0,1,0,76.14,59.63 ,33.33
03,014,01,001,0030,44 ,1053,9,1062,1710,0,3,1,3,0,1,0,76.14,62.11 ,33.33
03,014,01,001,0031,45 ,621,12,633,1047,0,3,1,3,0,1,0,76.14,60.46 ,33.33
03,014,01,001,0031,46 ,366,8,374,650,0,3,1,3,0,1,0,76.14,57.54 ,33.33
03,014,01,001,0031,47 ,762,9,771,1332,0,3,1,3,0,1,0,76.14,57.88 ,33.33
03,014,01,001,0032,48 ,907,13,920,1578,0,3,1,3,0,1,0,76.14,58.30 ,33.33
03,014,01,001,0033,49 ,557,11,568,939,0,3,1,3,0,1,0,76.14,60.49 ,33.33
03,014,01,001,0034,50 ,680,22,702,1108,0,3,1,3,0,1,0,76.14,63.36 ,33.33
03,014,01,001,0035,51 ,274,7,281,479,0,3,1,3,0,1,0,76.14,58.66 ,33.33
03,014,01,001,0036,52 ,546,26,572,929,0,3,1,3,0,1,0,76.14,61.57 ,33.33
03,014,01,001,0036,53 ,270,2,272,439,0,3,1,3,0,1,0,76.14,61.96 ,33.33
03,014,01,001,0036,54 ,139,2,141,228,0,3,1,3,0,1,0,76.14,61.84 ,33.33
03,014,01,001,0037,55 ,643,4,647,1080,0,3,1,3,0,1,0,76.14,59.91 ,33.33
03,014,01,001,0038,56 ,1224,15,1239,1791,0,3,1,3,0,1,0,76.14,69.18 ,33.33
03,014,01,001,0039,57 ,508,7,515,839,0,3,1,3,0,1,0,76.14,61.38 ,33.33
03,014,01,001,0039,58 ,341,5,346,600,0,3,1,3,0,1,0,76.14,57.67 ,33.33
03,014,01,001,0040,59 ,549,5,554,864,0,3,1,3,0,1,0,76.14,64.12 ,33.33
03,014,01,001,0040,60 ,548,9,557,916,0,3,1,3,0,1,0,76.14,60.81 ,33.33
03,014,01,001,0041,61 ,569,5,574,993,0,3,1,3,0,1,0,76.14,57.80 ,33.33
03,014,01,001,0042,62 ,499,5,504,866,0,3,1,3,0,1,0,76.14,58.20 ,33.33
03,014,01,001,0043,63 ,516,6,522,831,0,3,1,3,0,1,0,76.14,62.82 ,33.33
03,014,01,001,0044,64 ,531,4,535,836,0,3,1,3,0,1,0,76.14,64.00 ,33.33
03,014,01,001,0045,65 ,519,10,529,870,0,3,1,3,0,1,0,76.14,60.80 ,33.33
03,014,01,001,0046,66 ,623,23,646,1113,0,3,1,3,0,1,0,76.14,58.04 ,33.33
03,014,01,002,0047,67 ,103,1,104,204,0,3,1,3,0,1,0,76.14,50.98 ,33.33
03,014,01,002,0047,68 ,86,2,88,158,0,3,1,3,0,1,0,76.14,55.70 ,33.33
03,014,01,002,0047,69 ,49,0,49,104,0,3,1,3,0,1,0,76.14,47.12 ,33.33
03,014,01,002,0048,70 ,84,3,87,163,0,3,1,3,0,1,0,76.14,53.37 ,33.33
03,014,01,002,0049,71 ,43,2,45,103,0,3,1,3,0,1,0,76.14,43.69 ,33.33
03,014,01,002,0049,72 ,597,5,602,1003,0,3,1,3,0,1,0,76.14,60.02 ,33.33
03,014,01,002,0049,73 ,815,14,829,1337,0,3,1,3,0,1,0,76.14,62.00 ,33.33
03,014,01,002,0050,74 ,680,7,687,1048,0,3,1,3,0,1,0,76.14,65.55 ,33.33
03,014,01,002,0051,75 ,212,2,214,409,0,3,1,3,0,1,0,76.14,52.32 ,33.33
03,014,01,002,0051,76 ,390,5,395,678,0,3,1,3,0,1,0,76.14,58.26 ,33.33
03,014,01,002,0052,77 ,93,1,94,191,0,3,1,3,0,1,0,76.14,49.21 ,33.33
03,014,01,002,0052,78 ,199,7,206,400,0,3,1,3,0,1,0,76.14,51.50 ,33.33
03,014,01,002,0053,79 ,125,2,127,238,0,3,1,3,0,1,0,76.14,53.36 ,33.33
03,014,01,002,0053,80 ,129,0,129,256,0,3,1,3,0,1,0,76.14,50.39 ,33.33
03,014,01,002,0054,81 ,28,2,30,67,0,3,1,3,0,1,0,76.14,44.78 ,33.33
03,014,01,002,0054,82 ,19,0,19,42,0,3,1,3,0,1,0,76.14,45.24 ,33.33
03,014,01,003,0055,83 ,561,6,567,921,0,3,1,3,0,1,0,76.14,61.56 ,33.33
03,014,01,003,0055,84 ,410,8,418,697,0,3,1,3,0,1,0,76.14,59.97 ,33.33
03,014,01,003,0056,85 ,547,8,555,863,0,3,1,3,0,1,0,76.14,64.31 ,33.33
03,014,01,003,0057,86 ,394,5,399,670,0,3,1,3,0,1,0,76.14,59.55 ,33.33
03,014,01,003,0058,87 ,622,4,626,957,0,3,1,3,0,1,0,76.14,65.41 ,33.33
03,014,01,003,0059,88 ,363,3,366,682,0,3,1,3,0,1,0,76.14,53.67 ,33.33
03,014,01,003,0060,89 ,285,3,288,495,0,3,1,3,0,1,0,76.14,58.18 ,33.33
03,014,01,003,0060,90 ,442,7,449,738,0,3,1,3,0,1,0,76.14,60.84 ,33.33
03,014,01,003,0061,91 ,101,1,102,229,0,3,1,3,0,1,0,76.14,44.54 ,33.33
03,014,01,004,0062,92 ,547,7,554,893,0,3,1,3,0,1,0,76.14,62.04 ,33.33
03,014,01,004,0062,93 ,538,11,549,906,0,3,1,3,0,1,0,76.14,60.60 ,33.33
03,014,01,004,0063,94 ,142,1,143,231,0,3,1,3,0,1,0,76.14,61.90 ,33.33
03,014,01,004,0063,95 ,259,4,263,421,0,3,1,3,0,1,0,76.14,62.47 ,33.33
03,014,01,004,0063,96 ,160,0,160,304,0,3,1,3,0,1,0,76.14,52.63 ,33.33
03,014,01,004,0064,97 ,322,6,328,599,0,3,1,3,0,1,0,76.14,54.76 ,33.33
03,014,01,004,0064,98 ,297,6,303,493,0,3,1,3,0,1,0,76.14,61.46 ,33.33
03,014,01,004,0065,99 ,398,3,401,733,0,3,1,3,0,1,0,76.14,54.71 ,33.33
03,014,01,004,0065,100 ,164,5,169,318,0,3,1,3,0,1,0,76.14,53.14 ,33.33
03,014,01,004,0066,101 ,108,4,112,195,0,3,1,3,0,1,0,76.14,57.44 ,33.33
03,014,01,004,0066,102 ,16,0,16,38,0,3,1,3,0,1,0,76.14,42.11 ,33.33
03,014,01,004,0067,103 ,794,9,803,1254,0,3,1,3,0,1,0,76.14,64.04 ,33.33
03,014,01,004,0067,104 ,456,27,483,839,0,3,1,3,0,1,0,76.14,57.57 ,33.33
03,014,01,004,0067,105 ,456,8,464,748,0,3,1,3,0,1,0,76.14,62.03 ,33.33
03,014,01,004,0068,106 ,394,10,404,697,0,3,1,3,0,1,0,76.14,57.96 ,33.33
03,014,01,004,0069,107 ,242,6,248,423,0,3,1,3,0,1,0,76.14,58.63 ,33.33
03,014,01,004,0070,108 ,154,6,160,268,0,3,1,3,0,1,0,76.14,59.70 ,33.33
03,014,01,004,0071,109 ,521,5,526,869,0,3,1,3,0,1,0,76.14,60.53 ,33.33
03,014,01,004,0071,110 ,107,2,109,195,0,3,1,3,0,1,0,76.14,55.90 ,33.33
03,014,01,004,0072,111 ,261,7,268,448,0,3,1,3,0,1,0,76.14,59.82 ,33.33
03,014,01,004,0073,112 ,236,3,239,373,0,3,1,3,0,1,0,76.14,64.08 ,33.33
03,014,01,004,0074,113 ,135,6,141,245,0,3,1,3,0,1,0,76.14,57.55 ,33.33
03,014,01,005,0075,114 ,99,2,101,194,0,3,1,3,0,1,0,76.14,52.06 ,33.33
03,014,01,005,0075,115 ,341,8,349,577,0,3,1,3,0,1,0,76.14,60.49 ,33.33
03,014,01,005,0076,116 ,564,12,576,1046,0,3,1,3,0,1,0,76.14,55.07 ,33.33
03,014,01,005,0077,117 ,383,6,389,776,0,3,1,3,0,1,0,76.14,50.13 ,33.33
03,014,01,005,0077,118 ,131,0,131,270,0,3,1,3,0,1,0,76.14,48.52 ,33.33
03,014,01,005,0078,119 ,392,10,402,782,0,3,1,3,0,1,0,76.14,51.41 ,33.33
03,014,01,005,0079,120 ,320,10,330,633,0,3,1,3,0,1,0,76.14,52.13 ,33.33
03,014,01,005,0080,121 ,193,4,197,361,0,3,1,3,0,1,0,76.14,54.57 ,33.33
03,014,01,005,0081,122 ,239,4,243,449,0,3,1,3,0,1,0,76.14,54.12 ,33.33
03,014,01,005,0081,123 ,306,2,308,535,0,3,1,3,0,1,0,76.14,57.57 ,33.33
03,014,01,006,0082,124 ,537,12,549,962,0,3,1,3,0,1,0,76.14,57.07 ,33.33
03,014,01,006,0082,125 ,507,1,508,903,0,3,1,3,0,1,0,76.14,56.26 ,33.33
03,014,01,006,0083,126 ,320,4,324,616,0,3,1,3,0,1,0,76.14,52.60 ,33.33
03,014,01,006,0083,127 ,326,7,333,691,0,3,1,3,0,1,0,76.14,48.19 ,33.33
03,014,01,006,0084,128 ,307,2,309,679,0,3,1,3,0,1,0,76.14,45.51 ,33.33
03,014,01,006,0085,129 ,47,2,49,109,0,3,1,3,0,1,0,76.14,44.95 ,33.33
03,014,01,006,0086,130 ,239,3,242,410,0,3,1,3,0,1,0,76.14,59.02 ,33.33
03,014,01,006,0087,131 ,406,11,417,809,0,3,1,3,0,1,0,76.14,51.55 ,33.33
03,014,01,006,0088,132 ,208,2,210,426,0,3,1,3,0,1,0,76.14,49.30 ,33.33
03,014,01,006,0089,133 ,181,8,189,374,0,3,1,3,0,1,0,76.14,50.53 ,33.33
03,014,01,006,0090,134 ,185,5,190,354,0,3,1,3,0,1,0,76.14,53.67 ,33.33
03,014,01,006,0091,135 ,67,5,72,161,0,3,1,3,0,1,0,76.14,44.72 ,33.33
03,014,01,007,0092,136 ,128,4,132,293,0,3,1,3,0,1,0,76.14,45.05 ,33.33
03,014,01,007,0092,137 ,253,1,254,406,0,3,1,3,0,1,0,76.14,62.56 ,33.33
03,014,01,007,0092,138 ,286,5,291,530,0,3,1,3,0,1,0,76.14,54.91 ,33.33
03,014,01,007,0093,139 ,323,8,331,606,0,3,1,3,0,1,0,76.14,54.62 ,33.33
03,014,01,007,0094,140 ,110,2,112,219,0,3,1,3,0,1,0,76.14,51.14 ,33.33
03,014,01,007,0095,141 ,155,4,159,315,0,3,1,3,0,1,0,76.14,50.48 ,33.33
03,014,01,007,0096,142 ,346,6,352,652,0,3,1,3,0,1,0,76.14,53.99 ,33.33
03,014,01,007,0097,143 ,169,2,171,420,0,3,1,3,0,1,0,76.14,40.71 ,33.33
03,014,01,007,0097,144 ,101,4,105,215,0,3,1,3,0,1,0,76.14,48.84 ,33.33
03,014,01,007,0097,145 ,173,4,177,310,0,3,1,3,0,1,0,76.14,57.10 ,33.33
03,014,01,007,0098,146 ,78,1,79,179,0,3,1,3,0,1,0,76.14,44.13 ,33.33
03,014,01,008,0099,147 ,57,2,59,104,0,3,1,3,0,1,0,76.14,56.73 ,33.33
03,014,01,008,0099,148 ,115,1,116,273,0,3,1,3,0,1,0,76.14,42.49 ,33.33
03,014,01,008,0100,149 ,182,3,185,406,0,3,1,3,0,1,0,76.14,45.57 ,33.33
03,014,01,008,0101,150 ,587,7,594,1104,0,3,1,3,0,1,0,76.14,53.80 ,33.33
03,014,01,008,0102,151 ,252,12,264,537,0,3,1,3,0,1,0,76.14,49.16 ,33.33
03,014,01,008,0103,152 ,103,2,105,215,0,3,1,3,0,1,0,76.14,48.84 ,33.33
03,014,01,008,0104,153 ,90,5,95,197,0,3,1,3,0,1,0,76.14,48.22 ,33.33
03,014,01,008,0104,154 ,55,2,57,105,0,3,1,3,0,1,0,76.14,54.29 ,33.33
03,014,01,008,0104,155 ,64,2,66,135,0,3,1,3,0,1,0,76.14,48.89 ,33.33
03,014,01,008,0105,156 ,167,0,167,276,0,3,1,3,0,1,0,76.14,60.51 ,33.33
03,014,01,009,0106,157 ,514,10,524,924,0,3,1,3,0,1,0,76.14,56.71 ,33.33
03,014,01,009,0107,158 ,347,11,358,614,0,3,1,3,0,1,0,76.14,58.31 ,33.33
03,014,01,009,0108,159 ,376,8,384,701,0,3,1,3,0,1,0,76.14,54.78 ,33.33
03,014,01,009,0109,160 ,227,5,232,380,0,3,1,3,0,1,0,76.14,61.05 ,33.33
03,014,01,009,0110,161 ,291,3,294,502,0,3,1,3,0,1,0,76.14,58.57 ,33.33
03,014,01,009,0110,162 ,389,6,395,688,0,3,1,3,0,1,0,76.14,57.41 ,33.33
03,014,01,009,0111,163 ,501,5,506,767,0,3,1,3,0,1,0,76.14,65.97 ,33.33
03,014,01,009,0111,164 ,284,4,288,498,0,3,1,3,0,1,0,76.14,57.83 ,33.33
03,014,01,009,0112,165 ,211,3,214,375,0,3,1,3,0,1,0,76.14,57.07 ,33.33
03,014,01,009,0112,166 ,59,4,63,118,0,3,1,3,0,1,0,76.14,53.39 ,33.33
03,014,01,009,0113,167 ,107,2,109,200,0,3,1,3,0,1,0,76.14,54.50 ,33.33
03,014,01,009,0113,168 ,133,1,134,250,0,3,1,3,0,1,0,76.14,53.60 ,33.33
03,014,01,009,0113,169 ,24,0,24,59,0,3,1,3,0,1,0,76.14,40.68 ,33.33
03,014,01,009,0114,170 ,6,0,6,18,0,3,1,3,0,1,0,76.14,33.33 ,33.33
03,014,01,009,0114,171 ,119,5,124,229,0,3,1,3,0,1,0,76.14,54.15 ,33.33
03,014,01,010,0115,172 ,128,0,128,248,0,3,1,3,0,1,0,76.14,51.61 ,33.33
03,014,01,010,0116,173 ,597,9,606,1178,0,3,1,3,0,1,0,76.14,51.44 ,33.33
03,014,01,010,0117,174 ,481,10,491,861,0,3,1,3,0,1,0,76.14,57.03 ,33.33
03,014,01,010,0118,175 ,47,0,47,104,0,3,1,3,0,1,0,76.14,45.19 ,33.33
03,014,01,010,0119,176 ,26,0,26,49,0,3,1,3,0,1,0,76.14,53.06 ,33.33
03,014,01,010,0119,177 ,19,0,19,39,0,3,1,3,0,1,0,76.14,48.72 ,33.33
03,014,01,011,0120,178 ,356,7,363,663,0,3,1,3,0,1,0,76.14,54.75 ,33.33
03,014,01,011,0121,179 ,341,7,348,738,0,3,1,3,0,1,0,76.14,47.15 ,33.33
03,014,01,011,0122,180 ,247,6,253,468,0,3,1,3,0,1,0,76.14,54.06 ,33.33
03,014,01,011,0122,181 ,86,1,87,130,0,3,1,3,0,1,0,76.14,66.92 ,33.33
03,014,01,012,0123,182 ,13,1,14,27,0,3,1,3,0,1,0,76.14,51.85 ,33.33
03,014,01,012,0124,183 ,34,0,34,55,0,3,1,3,0,1,0,76.14,61.82 ,33.33
03,014,01,012,0125,184 ,71,2,73,125,0,3,1,3,0,1,0,76.14,58.40 ,33.33
03,014,01,012,0126,185 ,44,1,45,75,0,3,1,3,0,1,0,76.14,60.00 ,33.33
03,014,01,012,0127,186 ,14,0,14,22,0,3,1,3,0,1,0,76.14,63.64 ,33.33
03,014,01,012,0128,187 ,19,0,19,29,0,3,1,3,0,1,0,76.14,65.52 ,33.33
03,014,01,013,0129,188 ,58,1,59,95,0,3,1,3,0,1,0,76.14,62.11 ,33.33
03,014,01,013,0130,189 ,14,0,14,24,0,3,1,3,0,1,0,76.14,58.33 ,33.33
03,014,01,013,0131,190 ,13,0,13,22,0,3,1,3,0,1,0,76.14,59.09 ,33.33
03,014,01,013,0132,191 ,19,0,19,40,0,3,1,3,0,1,0,76.14,47.50 ,33.33
03,014,01,013,0133,192 ,14,0,14,24,0,3,1,3,0,1,0,76.14,58.33 ,33.33
03,014,01,013,0133,193 ,42,1,43,78,0,3,1,3,0,1,0,76.14,55.13 ,33.33
03,014,01,014,0134,194 ,46,1,47,77,0,3,1,3,0,1,0,76.14,61.04 ,33.33
03,014,01,014,0135,195 ,31,0,31,46,0,3,1,3,0,1,0,76.14,67.39 ,33.33
03,014,01,014,0136,196 ,16,0,16,31,0,3,1,3,0,1,0,76.14,51.61 ,33.33
03,014,01,014,0137,197 ,5,0,5,8,0,3,1,3,0,1,0,76.14,62.50 ,33.33
03,014,01,014,0138,198 ,8,0,8,15,0,3,1,3,0,1,0,76.14,53.33 ,33.33
03,014,01,015,0139,199 ,63,0,63,112,0,3,1,3,0,1,0,76.14,56.25 ,33.33
03,014,01,015,0139,200 ,20,0,20,51,0,3,1,3,0,1,0,76.14,39.22 ,33.33
03,014,01,015,0140,201 ,19,1,20,55,0,3,1,3,0,1,0,76.14,36.36 ,33.33
03,014,01,015,0141,202 ,30,2,32,67,0,3,1,3,0,1,0,76.14,47.76 ,33.33
03,014,01,015,0142,203 ,3,0,3,12,0,3,1,3,0,1,0,76.14,25.00 ,33.33
03,014,01,015,0143,204 ,13,0,13,35,0,3,1,3,0,1,0,76.14,37.14 ,33.33
03,014,01,015,0144,205 ,9,0,9,24,0,3,1,3,0,1,0,76.14,37.50 ,33.33
03,014,01,016,0145,206 ,37,0,37,80,0,3,1,3,0,1,0,76.14,46.25 ,33.33
03,014,01,016,0146,207 ,42,0,42,79,0,3,1,3,0,1,0,76.14,53.16 ,33.33
03,014,01,016,0147,208 ,6,0,6,20,0,3,1,3,0,1,0,76.14,30.00 ,33.33
03,014,01,016,0148,209 ,10,0,10,15,0,3,1,3,0,1,0,76.14,66.67 ,33.33
03,015,01,001,0001,1 ,954,8,962,1412,0,3,1,3,0,1,0,76.14,68.13 ,33.33
03,015,01,001,0002,2 ,799,8,807,1216,0,3,1,3,0,1,0,76.14,66.37 ,33.33
03,015,01,001,0002,3 ,520,8,528,832,0,3,1,3,0,1,0,76.14,63.46 ,33.33
03,015,01,001,0002,4 ,736,12,748,1105,0,3,1,3,0,1,0,76.14,67.69 ,33.33
03,015,01,001,0003,5 ,517,8,525,856,0,3,1,3,0,1,0,76.14,61.33 ,33.33
03,015,01,001,0003,6 ,486,30,516,998,0,3,1,3,0,1,0,76.14,51.70 ,33.33
03,015,01,001,0003,7 ,471,11,482,768,0,3,1,3,0,1,0,76.14,62.76 ,33.33
03,015,01,001,0004,8 ,430,4,434,748,0,3,1,3,0,1,0,76.14,58.02 ,33.33
03,015,01,001,0005,9 ,455,6,461,716,0,3,1,3,0,1,0,76.14,64.39 ,33.33
03,015,01,001,0005,10 ,607,11,618,1023,0,3,1,3,0,1,0,76.14,60.41 ,33.33
03,015,01,001,0005,11 ,845,9,854,1313,0,3,1,3,0,1,0,76.14,65.04 ,33.33
03,015,01,001,0006,12 ,624,20,644,958,0,3,1,3,0,1,0,76.14,67.22 ,33.33
03,015,01,001,0006,13 ,526,10,536,808,0,3,1,3,0,1,0,76.14,66.34 ,33.33
03,015,01,001,0007,14 ,755,11,766,1219,0,3,1,3,0,1,0,76.14,62.84 ,33.33
03,015,01,001,0007,15 ,920,9,929,1377,0,3,1,3,0,1,0,76.14,67.47 ,33.33
03,015,01,001,0008,16 ,863,16,879,1326,0,3,1,3,0,1,0,76.14,66.29 ,33.33
03,015,01,001,0009,17 ,289,7,296,511,0,3,1,3,0,1,0,76.14,57.93 ,33.33
03,015,01,001,0010,18 ,406,5,411,626,0,3,1,3,0,1,0,76.14,65.65 ,33.33
03,015,01,001,0011,19 ,392,10,402,592,0,3,1,3,0,1,0,76.14,67.91 ,33.33
03,015,01,001,0012,20 ,256,5,261,379,0,3,1,3,0,1,0,76.14,68.87 ,33.33
03,015,01,001,0013,21 ,370,5,375,577,0,3,1,3,0,1,0,76.14,64.99 ,33.33
03,015,01,001,0014,22 ,838,7,845,1294,0,3,1,3,0,1,0,76.14,65.30 ,33.33
03,015,01,001,0015,23 ,267,4,271,435,0,3,1,3,0,1,0,76.14,62.30 ,33.33
03,015,01,001,0016,24 ,501,1,502,741,0,3,1,3,0,1,0,76.14,67.75 ,33.33
03,015,01,001,0017,25 ,643,11,654,966,0,3,1,3,0,1,0,76.14,67.70 ,33.33
03,015,01,001,0018,26 ,419,5,424,632,0,3,1,3,0,1,0,76.14,67.09 ,33.33
03,015,01,001,0019,27 ,441,8,449,731,0,3,1,3,0,1,0,76.14,61.42 ,33.33
03,015,01,001,0020,28 ,657,10,667,1016,0,3,1,3,0,1,0,76.14,65.65 ,33.33
03,015,01,001,0021,29 ,472,7,479,818,0,3,1,3,0,1,0,76.14,58.56 ,33.33
03,015,01,001,0022,30 ,762,12,774,1206,0,3,1,3,0,1,0,76.14,64.18 ,33.33
03,015,01,001,0022,31 ,922,17,939,1487,0,3,1,3,0,1,0,76.14,63.15 ,33.33
03,015,01,001,0023,32 ,515,8,523,815,0,3,1,3,0,1,0,76.14,64.17 ,33.33
03,015,01,001,0023,33 ,542,2,544,863,0,3,1,3,0,1,0,76.14,63.04 ,33.33
03,015,01,001,0024,34 ,984,10,994,1507,0,3,1,3,0,1,0,76.14,65.96 ,33.33
03,015,01,001,0024,35 ,728,10,738,1145,0,3,1,3,0,1,0,76.14,64.45 ,33.33
03,015,01,001,0024,36 ,721,11,732,1126,0,3,1,3,0,1,0,76.14,65.01 ,33.33
03,015,01,001,0024,37 ,809,10,819,1284,0,3,1,3,0,1,0,76.14,63.79 ,33.33
03,015,01,001,0025,38 ,739,13,752,1191,0,3,1,3,0,1,0,76.14,63.14 ,33.33
03,015,01,001,0025,39 ,853,10,863,1461,0,3,1,3,0,1,0,76.14,59.07 ,33.33
03,015,01,001,0025,40 ,814,11,825,1279,0,3,1,3,0,1,0,76.14,64.50 ,33.33
03,015,01,001,0026,41 ,782,10,792,1224,0,3,1,3,0,1,0,76.14,64.71 ,33.33
03,015,01,001,0026,42 ,711,5,716,1123,0,3,1,3,0,1,0,76.14,63.76 ,33.33
03,015,01,001,0027,43 ,985,11,996,1546,0,3,1,3,0,1,0,76.14,64.42 ,33.33
03,015,01,001,0027,44 ,916,12,928,1503,0,3,1,3,0,1,0,76.14,61.74 ,33.33
03,015,01,001,0028,45 ,966,7,973,1630,0,3,1,3,0,1,0,76.14,59.69 ,33.33
03,015,01,001,0029,46 ,678,12,690,1078,0,3,1,3,0,1,0,76.14,64.01 ,33.33
03,015,01,001,0030,47 ,272,10,282,439,0,3,1,3,0,1,0,76.14,64.24 ,33.33
03,015,01,001,0031,48 ,919,17,936,1396,0,3,1,3,0,1,0,76.14,67.05 ,33.33
03,015,01,001,0032,49 ,475,7,482,772,0,3,1,3,0,1,0,76.14,62.44 ,33.33
03,015,01,001,0033,50 ,727,6,733,1186,0,3,1,3,0,1,0,76.14,61.80 ,33.33
03,015,01,001,0033,51 ,562,6,568,845,0,3,1,3,0,1,0,76.14,67.22 ,33.33
03,015,01,001,0034,52 ,656,13,669,1040,0,3,1,3,0,1,0,76.14,64.33 ,33.33
03,015,01,001,0034,53 ,464,4,468,697,0,3,1,3,0,1,0,76.14,67.14 ,33.33
03,015,01,001,0035,54 ,649,11,660,1044,0,3,1,3,0,1,0,76.14,63.22 ,33.33
03,015,01,001,0035,55 ,650,8,658,1085,0,3,1,3,0,1,0,76.14,60.65 ,33.33
03,015,01,001,0035,56 ,692,9,701,1209,0,3,1,3,0,1,0,76.14,57.98 ,33.33
03,015,01,001,0035,57 ,595,7,602,1105,0,3,1,3,0,1,0,76.14,54.48 ,33.33
03,015,01,001,0036,58 ,739,10,749,1148,0,3,1,3,0,1,0,76.14,65.24 ,33.33
03,015,01,001,0037,59 ,857,5,862,1336,0,3,1,3,0,1,0,76.14,64.52 ,33.33
03,015,01,001,0037,60 ,965,8,973,1514,0,3,1,3,0,1,0,76.14,64.27 ,33.33
03,015,01,001,0037,61 ,901,8,909,1419,0,3,1,3,0,1,0,76.14,64.06 ,33.33
03,015,01,001,0038,62 ,598,6,604,1008,0,3,1,3,0,1,0,76.14,59.92 ,33.33
03,015,01,001,0038,63 ,714,9,723,1090,0,3,1,3,0,1,0,76.14,66.33 ,33.33
03,015,01,001,0038,64 ,625,10,635,1008,0,3,1,3,0,1,0,76.14,63.00 ,33.33
03,015,01,001,0039,65 ,531,4,535,833,0,3,1,3,0,1,0,76.14,64.23 ,33.33
03,015,01,001,0039,66 ,736,8,744,1263,0,3,1,3,0,1,0,76.14,58.91 ,33.33
03,015,01,001,0039,67 ,783,12,795,1282,0,3,1,3,0,1,0,76.14,62.01 ,33.33
03,015,01,001,0040,68 ,475,10,485,858,0,3,1,3,0,1,0,76.14,56.53 ,33.33
03,015,01,002,0041,69 ,214,2,216,347,0,3,1,3,0,1,0,76.14,62.25 ,33.33
03,015,01,002,0041,70 ,547,10,557,918,0,3,1,3,0,1,0,76.14,60.68 ,33.33
03,015,01,002,0042,71 ,323,5,328,601,0,3,1,3,0,1,0,76.14,54.58 ,33.33
03,015,01,002,0042,72 ,166,5,171,243,0,3,1,3,0,1,0,76.14,70.37 ,33.33
03,015,01,002,0043,73 ,184,1,185,304,0,3,1,3,0,1,0,76.14,60.86 ,33.33
03,015,01,002,0043,74 ,905,17,922,1631,0,3,1,3,0,1,0,76.14,56.53 ,33.33
03,015,01,002,0044,75 ,718,22,740,1260,0,3,1,3,0,1,0,76.14,58.73 ,33.33
03,015,01,002,0044,76 ,266,6,272,432,0,3,1,3,0,1,0,76.14,62.96 ,33.33
03,015,01,002,0045,77 ,669,10,679,1128,0,3,1,3,0,1,0,76.14,60.20 ,33.33
03,015,01,002,0045,78 ,748,9,757,1277,0,3,1,3,0,1,0,76.14,59.28 ,33.33
03,015,01,002,0046,79 ,329,5,334,555,0,3,1,3,0,1,0,76.14,60.18 ,33.33
03,015,01,002,0047,80 ,789,16,805,1338,0,3,1,3,0,1,0,76.14,60.16 ,33.33
03,015,01,002,0047,81 ,789,25,814,1294,0,3,1,3,0,1,0,76.14,62.91 ,33.33
03,015,01,002,0048,82 ,419,15,434,612,0,3,1,3,0,1,0,76.14,70.92 ,33.33
03,015,01,002,0048,83 ,217,7,224,430,0,3,1,3,0,1,0,76.14,52.09 ,33.33
03,015,01,003,0049,84 ,122,3,125,255,0,3,1,3,0,1,0,76.14,49.02 ,33.33
03,015,01,003,0049,85 ,65,2,67,124,0,3,1,3,0,1,0,76.14,54.03 ,33.33
03,015,01,003,0050,86 ,222,3,225,367,0,3,1,3,0,1,0,76.14,61.31 ,33.33
03,015,01,003,0051,87 ,136,3,139,235,0,3,1,3,0,1,0,76.14,59.15 ,33.33
03,015,01,003,0051,88 ,95,0,95,197,0,3,1,3,0,1,0,76.14,48.22 ,33.33
03,015,01,003,0052,89 ,69,1,70,137,0,3,1,3,0,1,0,76.14,51.09 ,33.33
03,015,01,003,0053,90 ,42,2,44,85,0,3,1,3,0,1,0,76.14,51.76 ,33.33
03,015,01,003,0053,91 ,32,2,34,64,0,3,1,3,0,1,0,76.14,53.13 ,33.33
03,015,01,003,0054,92 ,87,2,89,141,0,3,1,3,0,1,0,76.14,63.12 ,33.33
03,015,01,003,0055,93 ,83,5,88,112,0,3,1,3,0,1,0,76.14,78.57 ,33.33
03,015,01,003,0056,94 ,56,1,57,87,0,3,1,3,0,1,0,76.14,65.52 ,33.33
03,015,01,003,0057,95 ,33,3,36,69,0,3,1,3,0,1,0,76.14,52.17 ,33.33
03,015,01,003,0057,96 ,13,1,14,23,0,3,1,3,0,1,0,76.14,60.87 ,33.33
03,015,01,004,0058,97 ,872,6,878,1456,0,3,1,3,0,1,0,76.14,60.30 ,33.33
03,015,01,004,0058,98 ,919,14,933,1563,0,3,1,3,0,1,0,76.14,59.69 ,33.33
03,015,01,004,0059,99 ,889,13,902,1474,0,3,1,3,0,1,0,76.14,61.19 ,33.33
03,015,01,004,0059,100 ,565,17,582,933,0,3,1,3,0,1,0,76.14,62.38 ,33.33
03,015,01,004,0060,101 ,903,14,917,1440,0,3,1,3,0,1,0,76.14,63.68 ,33.33
03,015,01,004,0060,102 ,912,12,924,1407,0,3,1,3,0,1,0,76.14,65.67 ,33.33
03,015,01,004,0060,103 ,828,13,841,1326,0,3,1,3,0,1,0,76.14,63.42 ,33.33
03,015,01,004,0061,104 ,746,11,757,1236,0,3,1,3,0,1,0,76.14,61.25 ,33.33
03,015,01,004,0061,105 ,1047,23,1070,1763,0,3,1,3,0,1,0,76.14,60.69 ,33.33
03,015,01,004,0062,106 ,499,5,504,806,0,3,1,3,0,1,0,76.14,62.53 ,33.33
03,015,01,004,0062,107 ,748,13,761,1135,0,3,1,3,0,1,0,76.14,67.05 ,33.33
03,015,01,004,0063,108 ,708,21,729,1108,0,3,1,3,0,1,0,76.14,65.79 ,33.33
03,015,01,004,0064,109 ,475,14,489,833,0,3,1,3,0,1,0,76.14,58.70 ,33.33
03,015,01,004,0065,110 ,908,13,921,1487,0,3,1,3,0,1,0,76.14,61.94 ,33.33
03,015,01,004,0065,111 ,328,3,331,556,0,3,1,3,0,1,0,76.14,59.53 ,33.33
03,015,01,004,0066,112 ,697,7,704,1085,0,3,1,3,0,1,0,76.14,64.88 ,33.33
03,015,01,004,0066,113 ,813,22,835,1287,0,3,1,3,0,1,0,76.14,64.88 ,33.33
03,015,01,004,0067,114 ,470,6,476,780,0,3,1,3,0,1,0,76.14,61.03 ,33.33
03,015,01,004,0067,115 ,732,5,737,1210,0,3,1,3,0,1,0,76.14,60.91 ,33.33
03,015,01,004,0068,116 ,817,13,830,1331,0,3,1,3,0,1,0,76.14,62.36 ,33.33
03,015,01,004,0068,117 ,768,11,779,1255,0,3,1,3,0,1,0,76.14,62.07 ,33.33
03,015,01,004,0069,118 ,879,19,898,1476,0,3,1,3,0,1,0,76.14,60.84 ,33.33
03,015,01,004,0069,119 ,958,9,967,1449,0,3,1,3,0,1,0,76.14,66.74 ,33.33
03,015,01,004,0069,120 ,912,10,922,1381,0,3,1,3,0,1,0,76.14,66.76 ,33.33
03,015,01,004,0069,121 ,860,15,875,1354,0,3,1,3,0,1,0,76.14,64.62 ,33.33
03,015,01,004,0070,122 ,944,14,958,1535,0,3,1,3,0,1,0,76.14,62.41 ,33.33
03,015,01,004,0070,123 ,1106,17,1123,1782,0,3,1,3,0,1,0,76.14,63.02 ,33.33
03,015,01,004,0071,124 ,536,6,542,857,0,3,1,3,0,1,0,76.14,63.24 ,33.33
03,015,01,004,0071,125 ,862,8,870,1381,0,3,1,3,0,1,0,76.14,63.00 ,33.33
03,015,01,004,0071,126 ,619,10,629,990,0,3,1,3,0,1,0,76.14,63.54 ,33.33
03,015,01,004,0071,127 ,701,5,706,1170,0,3,1,3,0,1,0,76.14,60.34 ,33.33
03,015,01,004,0072,128 ,646,5,651,1042,0,3,1,3,0,1,0,76.14,62.48 ,33.33
03,015,01,004,0072,129 ,753,7,760,1214,0,3,1,3,0,1,0,76.14,62.60 ,33.33
03,015,01,004,0072,130 ,454,10,464,787,0,3,1,3,0,1,0,76.14,58.96 ,33.33
03,015,01,004,0073,131 ,812,16,828,1389,0,3,1,3,0,1,0,76.14,59.61 ,33.33
03,015,01,004,0074,132 ,768,7,775,1255,0,3,1,3,0,1,0,76.14,61.75 ,33.33
03,015,01,004,0074,133 ,610,17,627,1022,0,3,1,3,0,1,0,76.14,61.35 ,33.33
03,015,01,004,0074,134 ,543,14,557,994,0,3,1,3,0,1,0,76.14,56.04 ,33.33
03,015,01,004,0075,135 ,532,19,551,889,0,3,1,3,0,1,0,76.14,61.98 ,33.33
03,015,01,005,0076,136 ,416,10,426,704,0,3,1,3,0,1,0,76.14,60.51 ,33.33
03,015,01,005,0077,137 ,199,7,206,320,0,3,1,3,0,1,0,76.14,64.38 ,33.33
03,015,01,005,0078,138 ,1104,21,1125,1825,0,3,1,3,0,1,0,76.14,61.64 ,33.33
03,015,01,005,0079,139 ,683,9,692,1166,0,3,1,3,0,1,0,76.14,59.35 ,33.33
03,015,01,005,0080,140 ,396,9,405,635,0,3,1,3,0,1,0,76.14,63.78 ,33.33
03,015,01,005,0081,141 ,649,3,652,1050,0,3,1,3,0,1,0,76.14,62.10 ,33.33
03,015,01,005,0082,142 ,338,12,350,530,0,3,1,3,0,1,0,76.14,66.04 ,33.33
03,015,01,005,0083,143 ,87,3,90,152,0,3,1,3,0,1,0,76.14,59.21 ,33.33
03,015,01,005,0084,144 ,328,6,334,565,0,3,1,3,0,1,0,76.14,59.12 ,33.33
03,015,01,005,0085,145 ,446,4,450,726,0,3,1,3,0,1,0,76.14,61.98 ,33.33
03,015,01,005,0085,146 ,184,4,188,309,0,3,1,3,0,1,0,76.14,60.84 ,33.33
03,015,01,005,0086,147 ,1073,19,1092,1822,0,3,1,3,0,1,0,76.14,59.93 ,33.33
03,015,01,005,0086,148 ,230,5,235,381,0,3,1,3,0,1,0,76.14,61.68 ,33.33
03,015,01,005,0087,149 ,55,0,55,88,0,3,1,3,0,1,0,76.14,62.50 ,33.33
03,015,01,005,0087,150 ,23,3,26,43,0,3,1,3,0,1,0,76.14,60.47 ,33.33
03,015,01,005,0088,151 ,132,2,134,249,0,3,1,3,0,1,0,76.14,53.82 ,33.33
03,015,01,005,0089,152 ,183,2,185,349,0,3,1,3,0,1,0,76.14,53.01 ,33.33
03,015,01,005,0090,153 ,178,5,183,384,0,3,1,3,0,1,0,76.14,47.66 ,33.33
03,015,01,005,0090,154 ,36,0,36,55,0,3,1,3,0,1,0,76.14,65.45 ,33.33
03,015,01,006,0091,155 ,730,20,750,1127,0,3,1,3,0,1,0,76.14,66.55 ,33.33
03,015,01,006,0092,156 ,433,9,442,640,0,3,1,3,0,1,0,76.14,69.06 ,33.33
03,015,01,006,0093,157 ,494,2,496,698,0,3,1,3,0,1,0,76.14,71.06 ,33.33
03,015,01,006,0094,158 ,730,15,745,1129,0,3,1,3,0,1,0,76.14,65.99 ,33.33
03,015,01,006,0095,159 ,440,10,450,659,0,3,1,3,0,1,0,76.14,68.29 ,33.33
03,015,01,006,0095,160 ,123,5,128,205,0,3,1,3,0,1,0,76.14,62.44 ,33.33
03,015,01,006,0096,161 ,95,2,97,166,0,3,1,3,0,1,0,76.14,58.43 ,33.33
03,015,01,006,0096,162 ,46,1,47,75,0,3,1,3,0,1,0,76.14,62.67 ,33.33
03,015,01,006,0097,163 ,371,16,387,670,0,3,1,3,0,1,0,76.14,57.76 ,33.33
03,015,01,006,0097,164 ,363,8,371,606,0,3,1,3,0,1,0,76.14,61.22 ,33.33
03,015,01,006,0098,165 ,365,14,379,631,0,3,1,3,0,1,0,76.14,60.06 ,33.33
03,015,01,006,0099,166 ,385,4,389,689,0,3,1,3,0,1,0,76.14,56.46 ,33.33
03,015,01,006,0100,167 ,554,18,572,853,0,3,1,3,0,1,0,76.14,67.06 ,33.33
03,015,01,006,0101,168 ,602,19,621,1042,0,3,1,3,0,1,0,76.14,59.60 ,33.33
03,015,01,006,0102,169 ,86,0,86,129,0,3,1,3,0,1,0,76.14,66.67 ,33.33
03,015,01,007,0103,170 ,608,8,616,993,0,3,1,3,0,1,0,76.14,62.03 ,33.33
03,015,01,007,0104,171 ,559,6,565,861,0,3,1,3,0,1,0,76.14,65.62 ,33.33
03,015,01,007,0105,172 ,227,10,237,399,0,3,1,3,0,1,0,76.14,59.40 ,33.33
03,015,01,007,0106,173 ,155,6,161,300,0,3,1,3,0,1,0,76.14,53.67 ,33.33
03,015,01,007,0107,174 ,427,3,430,713,0,3,1,3,0,1,0,76.14,60.31 ,33.33
03,015,01,007,0108,175 ,44,0,44,93,0,3,1,3,0,1,0,76.14,47.31 ,33.33
03,015,01,007,0108,176 ,66,0,66,136,0,3,1,3,0,1,0,76.14,48.53 ,33.33
03,015,01,007,0109,177 ,77,1,78,122,0,3,1,3,0,1,0,76.14,63.93 ,33.33
03,015,01,007,0110,178 ,55,2,57,110,0,3,1,3,0,1,0,76.14,51.82 ,33.33
03,015,01,007,0111,179 ,103,2,105,189,0,3,1,3,0,1,0,76.14,55.56 ,33.33
03,015,01,007,0112,180 ,132,2,134,227,0,3,1,3,0,1,0,76.14,59.03 ,33.33
03,015,01,007,0113,181 ,331,5,336,469,0,3,1,3,0,1,0,76.14,71.64 ,33.33
03,015,01,007,0114,182 ,300,13,313,517,0,3,1,3,0,1,0,76.14,60.54 ,33.33
03,015,01,007,0114,183 ,74,4,78,124,0,3,1,3,0,1,0,76.14,62.90 ,33.33
03,015,01,007,0115,184 ,179,6,185,328,0,3,1,3,0,1,0,76.14,56.40 ,33.33
03,015,01,007,0116,185 ,218,9,227,367,0,3,1,3,0,1,0,76.14,61.85 ,33.33
03,015,01,007,0117,186 ,322,8,330,589,0,3,1,3,0,1,0,76.14,56.03 ,33.33
03,015,01,008,0118,187 ,43,3,46,113,0,3,1,3,0,1,0,76.14,40.71 ,33.33
03,015,01,008,0119,188 ,70,4,74,146,0,3,1,3,0,1,0,76.14,50.68 ,33.33
03,015,01,008,0120,189 ,35,2,37,59,0,3,1,3,0,1,0,76.14,62.71 ,33.33
03,015,01,008,0120,190 ,307,4,311,589,0,3,1,3,0,1,0,76.14,52.80 ,33.33
03,015,01,008,0120,191 ,31,1,32,59,0,3,1,3,0,1,0,76.14,54.24 ,33.33
03,015,01,008,0121,192 ,44,2,46,107,0,3,1,3,0,1,0,76.14,42.99 ,33.33
03,015,01,008,0122,193 ,57,2,59,100,0,3,1,3,0,1,0,76.14,59.00 ,33.33
03,015,01,009,0123,194 ,26,3,29,60,0,3,1,3,0,1,0,76.14,48.33 ,33.33
03,015,01,009,0124,195 ,9,2,11,31,0,3,1,3,0,1,0,76.14,35.48 ,33.33
03,015,01,009,0125,196 ,31,0,31,61,0,3,1,3,0,1,0,76.14,50.82 ,33.33
03,015,01,009,0126,197 ,37,1,38,60,0,3,1,3,0,1,0,76.14,63.33 ,33.33
03,015,01,009,0127,198 ,5,1,6,13,0,3,1,3,0,1,0,76.14,46.15 ,33.33
03,015,01,009,0127,199 ,8,0,8,25,0,3,1,3,0,1,0,76.14,32.00 ,33.33
03,015,01,009,0128,200 ,56,0,56,104,0,3,1,3,0,1,0,76.14,53.85 ,33.33
03,015,01,010,0129,201 ,472,3,475,745,0,3,1,3,0,1,0,76.14,63.76 ,33.33
03,015,01,010,0129,202 ,637,8,645,1068,0,3,1,3,0,1,0,76.14,60.39 ,33.33
03,015,01,010,0130,203 ,462,3,465,787,0,3,1,3,0,1,0,76.14,59.09 ,33.33
03,015,01,010,0130,204 ,439,10,449,799,0,3,1,3,0,1,0,76.14,56.20 ,33.33
03,015,01,010,0131,205 ,246,1,247,395,0,3,1,3,0,1,0,76.14,62.53 ,33.33
03,015,01,010,0132,206 ,475,12,487,857,0,3,1,3,0,1,0,76.14,56.83 ,33.33
03,015,01,010,0133,207 ,244,0,244,422,0,3,1,3,0,1,0,76.14,57.82 ,33.33
03,015,01,010,0134,208 ,272,7,279,505,0,3,1,3,0,1,0,76.14,55.25 ,33.33
03,015,01,010,0135,209 ,140,4,144,285,0,3,1,3,0,1,0,76.14,50.53 ,33.33
03,015,01,010,0136,210 ,24,0,24,51,0,3,1,3,0,1,0,76.14,47.06 ,33.33
03,015,01,010,0137,211 ,383,11,394,619,0,3,1,3,0,1,0,76.14,63.65 ,33.33
03,015,01,010,0138,212 ,143,3,146,305,0,3,1,3,0,1,0,76.14,47.87 ,33.33
03,015,01,010,0139,213 ,266,6,272,462,0,3,1,3,0,1,0,76.14,58.87 ,33.33
03,015,01,011,0140,214 ,999,16,1015,1695,0,3,1,3,0,1,0,76.14,59.88 ,33.33
03,015,01,011,0140,215 ,874,9,883,1460,0,3,1,3,0,1,0,76.14,60.48 ,33.33
03,015,01,011,0140,216 ,665,10,675,1061,0,3,1,3,0,1,0,76.14,63.62 ,33.33
03,015,01,011,0141,217 ,837,9,846,1338,0,3,1,3,0,1,0,76.14,63.23 ,33.33
03,015,01,011,0142,218 ,498,4,502,849,0,3,1,3,0,1,0,76.14,59.13 ,33.33
03,015,01,011,0142,219 ,496,13,509,852,0,3,1,3,0,1,0,76.14,59.74 ,33.33
03,015,01,011,0143,220 ,662,11,673,1093,0,3,1,3,0,1,0,76.14,61.57 ,33.33
03,015,01,011,0143,221 ,380,40,420,1046,0,3,1,3,0,1,0,76.14,40.15 ,33.33
03,015,01,011,0143,222 ,132,22,154,747,0,3,1,3,0,1,0,76.14,20.62 ,33.33
03,015,01,011,0144,223 ,624,17,641,1078,0,3,1,3,0,1,0,76.14,59.46 ,33.33
03,015,01,011,0145,224 ,619,15,634,1100,0,3,1,3,0,1,0,76.14,57.64 ,33.33
03,015,01,011,0146,225 ,286,21,307,619,0,3,1,3,0,1,0,76.14,49.60 ,33.33
03,015,01,011,0147,226 ,198,6,204,401,0,3,1,3,0,1,0,76.14,50.87 ,33.33
03,015,01,011,0148,227 ,189,1,190,334,0,3,1,3,0,1,0,76.14,56.89 ,33.33
03,015,01,011,0149,228 ,355,9,364,694,0,3,1,3,0,1,0,76.14,52.45 ,33.33
03,015,01,011,0149,229 ,155,3,158,317,0,3,1,3,0,1,0,76.14,49.84 ,33.33
03,015,01,011,0150,230 ,253,8,261,532,0,3,1,3,0,1,0,76.14,49.06 ,33.33
03,015,01,011,0151,231 ,232,7,239,474,0,3,1,3,0,1,0,76.14,50.42 ,33.33
03,015,01,011,0152,232 ,29,1,30,81,0,3,1,3,0,1,0,76.14,37.04 ,33.33
03,015,01,011,0153,233 ,556,13,569,974,0,3,1,3,0,1,0,76.14,58.42 ,33.33
03,015,01,011,0154,234 ,586,8,594,1034,0,3,1,3,0,1,0,76.14,57.45 ,33.33
03,015,01,012,0155,235 ,225,7,232,435,0,3,1,3,0,1,0,76.14,53.33 ,33.33
03,015,01,012,0156,236 ,593,16,609,1199,0,3,1,3,0,1,0,76.14,50.79 ,33.33
03,015,01,012,0157,237 ,287,7,294,623,0,3,1,3,0,1,0,76.14,47.19 ,33.33
03,015,01,012,0158,238 ,289,9,298,571,0,3,1,3,0,1,0,76.14,52.19 ,33.33
03,015,01,012,0159,239 ,554,19,573,1012,0,3,1,3,0,1,0,76.14,56.62 ,33.33
03,015,01,012,0160,240 ,219,5,224,457,0,3,1,3,0,1,0,76.14,49.02 ,33.33
03,015,01,012,0161,241 ,482,15,497,855,0,3,1,3,0,1,0,76.14,58.13 ,33.33
03,015,01,012,0162,242 ,245,5,250,400,0,3,1,3,0,1,0,76.14,62.50 ,33.33
03,015,01,012,0163,243 ,880,24,904,1578,0,3,1,3,0,1,0,76.14,57.29 ,33.33
03,015,01,012,0164,244 ,255,2,257,519,0,3,1,3,0,1,0,76.14,49.52 ,33.33
03,015,01,012,0165,245 ,167,4,171,345,0,3,1,3,0,1,0,76.14,49.57 ,33.33
03,015,01,012,0166,246 ,270,6,276,523,0,3,1,3,0,1,0,76.14,52.77 ,33.33
03,015,01,012,0167,247 ,320,5,325,550,0,3,1,3,0,1,0,76.14,59.09 ,33.33
03,015,01,013,0168,248 ,13,2,15,27,0,3,1,3,0,1,0,76.14,55.56 ,33.33
03,015,01,013,0169,249 ,8,0,8,18,0,3,1,3,0,1,0,76.14,44.44 ,33.33
03,015,01,013,0169,250 ,7,0,7,22,0,3,1,3,0,1,0,76.14,31.82 ,33.33
03,015,01,013,0170,251 ,11,0,11,15,0,3,1,3,0,1,0,76.14,73.33 ,33.33
03,015,01,013,0170,252 ,14,0,14,19,0,3,1,3,0,1,0,76.14,73.68 ,33.33
03,015,01,013,0171,253 ,38,0,38,78,0,3,1,3,0,1,0,76.14,48.72 ,33.33
03,015,01,013,0172,254 ,30,1,31,58,0,3,1,3,0,1,0,76.14,53.45 ,33.33
03,015,01,013,0172,255 ,17,1,18,30,0,3,1,3,0,1,0,76.14,60.00 ,33.33
03,015,01,013,0173,256 ,25,0,25,43,0,3,1,3,0,1,0,76.14,58.14 ,33.33
03,015,01,013,0173,257 ,16,2,18,25,0,3,1,3,0,1,0,76.14,72.00 ,33.33
03,015,01,013,0173,258 ,13,0,13,16,0,3,1,3,0,1,0,76.14,81.25 ,33.33
03,016,01,001,0001,1 ,210,3,213,341,0,3,1,3,0,1,0,76.14,62.46 ,33.33
03,016,01,001,0002,2 ,232,5,237,333,0,3,1,3,0,1,0,76.14,71.17 ,33.33
03,016,01,001,0003,3 ,346,4,350,534,0,3,1,3,0,1,0,76.14,65.54 ,33.33
03,016,01,001,0004,4 ,322,5,327,484,0,3,1,3,0,1,0,76.14,67.56 ,33.33
03,016,01,001,0005,5 ,534,5,539,855,0,3,1,3,0,1,0,76.14,63.04 ,33.33
03,016,01,001,0006,6 ,657,8,665,988,0,3,1,3,0,1,0,76.14,67.31 ,33.33
03,016,01,001,0007,7 ,509,10,519,755,0,3,1,3,0,1,0,76.14,68.74 ,33.33
03,016,01,001,0008,8 ,579,4,583,927,0,3,1,3,0,1,0,76.14,62.89 ,33.33
03,016,01,001,0008,9 ,601,9,610,899,0,3,1,3,0,1,0,76.14,67.85 ,33.33
03,016,01,001,0009,10 ,363,4,367,557,0,3,1,3,0,1,0,76.14,65.89 ,33.33
03,016,01,001,0009,11 ,405,15,420,632,0,3,1,3,0,1,0,76.14,66.46 ,33.33
03,016,01,001,0010,12 ,759,8,767,1147,0,3,1,3,0,1,0,76.14,66.87 ,33.33
03,016,01,001,0010,13 ,689,11,700,1049,0,3,1,3,0,1,0,76.14,66.73 ,33.33
03,016,01,001,0011,14 ,778,6,784,1275,0,3,1,3,0,1,0,76.14,61.49 ,33.33
03,016,01,001,0011,15 ,754,8,762,1208,0,3,1,3,0,1,0,76.14,63.08 ,33.33
03,016,01,001,0011,16 ,1169,9,1178,1795,0,3,1,3,0,1,0,76.14,65.63 ,33.33
03,016,01,001,0012,17 ,686,8,694,1130,0,3,1,3,0,1,0,76.14,61.42 ,33.33
03,016,01,001,0012,18 ,719,6,725,1103,0,3,1,3,0,1,0,76.14,65.73 ,33.33
03,016,01,001,0013,19 ,702,6,708,1069,0,3,1,3,0,1,0,76.14,66.23 ,33.33
03,016,01,001,0014,20 ,815,20,835,1250,0,3,1,3,0,1,0,76.14,66.80 ,33.33
03,016,01,001,0014,21 ,925,8,933,1360,0,3,1,3,0,1,0,76.14,68.60 ,33.33
03,016,01,001,0015,22 ,719,13,732,1080,0,3,1,3,0,1,0,76.14,67.78 ,33.33
03,016,01,001,0015,23 ,506,10,516,822,0,3,1,3,0,1,0,76.14,62.77 ,33.33
03,016,01,001,0016,24 ,659,7,666,993,0,3,1,3,0,1,0,76.14,67.07 ,33.33
03,016,01,001,0016,25 ,529,9,538,848,0,3,1,3,0,1,0,76.14,63.44 ,33.33
03,016,01,001,0017,26 ,822,20,842,1207,0,3,1,3,0,1,0,76.14,69.76 ,33.33
03,016,01,001,0018,27 ,359,7,366,584,0,3,1,3,0,1,0,76.14,62.67 ,33.33
03,016,01,001,0019,28 ,358,5,363,519,0,3,1,3,0,1,0,76.14,69.94 ,33.33
03,016,01,001,0020,29 ,889,10,899,1392,0,3,1,3,0,1,0,76.14,64.58 ,33.33
03,016,01,001,0021,30 ,223,1,224,313,0,3,1,3,0,1,0,76.14,71.57 ,33.33
03,016,01,001,0022,31 ,871,10,881,1290,0,3,1,3,0,1,0,76.14,68.29 ,33.33
03,016,01,001,0023,32 ,282,7,289,427,0,3,1,3,0,1,0,76.14,67.68 ,33.33
03,016,01,001,0024,33 ,372,5,377,550,0,3,1,3,0,1,0,76.14,68.55 ,33.33
03,016,01,001,0025,34 ,523,10,533,791,0,3,1,3,0,1,0,76.14,67.38 ,33.33
03,016,01,001,0026,35 ,262,2,264,365,0,3,1,3,0,1,0,76.14,72.33 ,33.33
03,016,01,001,0027,36 ,623,12,635,1025,0,3,1,3,0,1,0,76.14,61.95 ,33.33
03,016,01,001,0027,37 ,555,7,562,957,0,3,1,3,0,1,0,76.14,58.73 ,33.33
03,016,01,001,0028,38 ,732,10,742,1310,0,3,1,3,0,1,0,76.14,56.64 ,33.33
03,016,01,001,0029,39 ,114,3,117,175,0,3,1,3,0,1,0,76.14,66.86 ,33.33
03,016,01,001,0030,40 ,208,5,213,332,0,3,1,3,0,1,0,76.14,64.16 ,33.33
03,016,01,001,0031,41 ,661,10,671,1016,0,3,1,3,0,1,0,76.14,66.04 ,33.33
03,016,01,001,0032,42 ,626,12,638,1126,0,3,1,3,0,1,0,76.14,56.66 ,33.33
03,016,01,001,0033,43 ,194,8,202,691,0,3,1,3,0,1,0,76.14,29.23 ,33.33
03,016,01,001,0034,44 ,90,0,90,194,0,3,1,3,0,1,0,76.14,46.39 ,33.33
03,016,01,002,0035,45 ,549,6,555,824,0,3,1,3,0,1,0,76.14,67.35 ,33.33
03,016,01,002,0036,46 ,202,1,203,295,0,3,1,3,0,1,0,76.14,68.81 ,33.33
03,016,01,002,0037,47 ,120,1,121,203,0,3,1,3,0,1,0,76.14,59.61 ,33.33
03,016,01,002,0038,48 ,147,3,150,236,0,3,1,3,0,1,0,76.14,63.56 ,33.33
03,016,01,002,0039,49 ,359,6,365,599,0,3,1,3,0,1,0,76.14,60.93 ,33.33
03,016,01,002,0040,50 ,193,2,195,268,0,3,1,3,0,1,0,76.14,72.76 ,33.33
03,016,01,002,0041,51 ,354,6,360,540,0,3,1,3,0,1,0,76.14,66.67 ,33.33
03,016,01,002,0042,52 ,271,6,277,441,0,3,1,3,0,1,0,76.14,62.81 ,33.33
03,016,01,002,0043,53 ,253,3,256,402,0,3,1,3,0,1,0,76.14,63.68 ,33.33
03,016,01,002,0044,54 ,73,0,73,130,0,3,1,3,0,1,0,76.14,56.15 ,33.33
03,016,01,002,0045,55 ,462,4,466,695,0,3,1,3,0,1,0,76.14,67.05 ,33.33
03,016,01,002,0046,56 ,100,3,103,162,0,3,1,3,0,1,0,76.14,63.58 ,33.33
03,016,01,002,0047,57 ,185,2,187,277,0,3,1,3,0,1,0,76.14,67.51 ,33.33
03,016,01,002,0048,58 ,165,2,167,217,0,3,1,3,0,1,0,76.14,76.96 ,33.33
03,016,01,002,0049,59 ,126,1,127,182,0,3,1,3,0,1,0,76.14,69.78 ,33.33
03,016,01,002,0050,60 ,127,3,130,178,0,3,1,3,0,1,0,76.14,73.03 ,33.33
03,016,01,002,0051,61 ,70,1,71,120,0,3,1,3,0,1,0,76.14,59.17 ,33.33
03,016,01,002,0052,62 ,410,3,413,615,0,3,1,3,0,1,0,76.14,67.15 ,33.33
03,016,01,002,0053,63 ,490,10,500,814,0,3,1,3,0,1,0,76.14,61.43 ,33.33
03,016,01,002,0054,64 ,316,7,323,510,0,3,1,3,0,1,0,76.14,63.33 ,33.33
03,016,01,002,0055,65 ,484,3,487,758,0,3,1,3,0,1,0,76.14,64.25 ,33.33
03,016,01,002,0055,66 ,464,7,471,727,0,3,1,3,0,1,0,76.14,64.79 ,33.33
03,016,01,002,0056,67 ,372,4,376,616,0,3,1,3,0,1,0,76.14,61.04 ,33.33
03,016,01,003,0057,68 ,287,1,288,435,0,3,1,3,0,1,0,76.14,66.21 ,33.33
03,016,01,003,0058,69 ,339,2,341,522,0,3,1,3,0,1,0,76.14,65.33 ,33.33
03,016,01,003,0059,70 ,60,0,60,91,0,3,1,3,0,1,0,76.14,65.93 ,33.33
03,016,01,003,0060,71 ,70,1,71,102,0,3,1,3,0,1,0,76.14,69.61 ,33.33
03,016,01,003,0061,72 ,144,3,147,249,0,3,1,3,0,1,0,76.14,59.04 ,33.33
03,016,01,003,0062,73 ,109,2,111,207,0,3,1,3,0,1,0,76.14,53.62 ,33.33
03,016,01,003,0063,74 ,104,2,106,152,0,3,1,3,0,1,0,76.14,69.74 ,33.33
03,016,01,003,0064,75 ,851,6,857,1339,0,3,1,3,0,1,0,76.14,64.00 ,33.33
03,016,01,003,0065,76 ,169,0,169,281,0,3,1,3,0,1,0,76.14,60.14 ,33.33
03,016,01,003,0066,77 ,376,1,377,637,0,3,1,3,0,1,0,76.14,59.18 ,33.33
03,016,01,003,0067,78 ,396,6,402,666,0,3,1,3,0,1,0,76.14,60.36 ,33.33
03,016,01,003,0068,79 ,476,7,483,1142,0,3,1,3,0,1,0,76.14,42.29 ,33.33
03,016,01,003,0069,80 ,375,2,377,929,0,3,1,3,0,1,0,76.14,40.58 ,33.33
03,016,01,003,0070,81 ,105,1,106,209,0,3,1,3,0,1,0,76.14,50.72 ,33.33
03,016,01,003,0071,82 ,73,4,77,158,0,3,1,3,0,1,0,76.14,48.73 ,33.33
03,016,01,004,0072,83 ,142,7,149,237,0,3,1,3,0,1,0,76.14,62.87 ,33.33
03,016,01,004,0073,84 ,256,5,261,404,0,3,1,3,0,1,0,76.14,64.60 ,33.33
03,016,01,004,0074,85 ,422,19,441,760,0,3,1,3,0,1,0,76.14,58.03 ,33.33
03,016,01,004,0075,86 ,139,1,140,251,0,3,1,3,0,1,0,76.14,55.78 ,33.33
03,016,01,004,0076,87 ,329,11,340,588,0,3,1,3,0,1,0,76.14,57.82 ,33.33
03,016,01,004,0077,88 ,61,1,62,103,0,3,1,3,0,1,0,76.14,60.19 ,33.33
03,016,01,004,0078,89 ,299,12,311,486,0,3,1,3,0,1,0,76.14,63.99 ,33.33
03,016,01,004,0079,90 ,112,2,114,195,0,3,1,3,0,1,0,76.14,58.46 ,33.33
03,016,01,004,0080,91 ,321,8,329,605,0,3,1,3,0,1,0,76.14,54.38 ,33.33
03,016,01,004,0081,92 ,660,14,674,1147,0,3,1,3,0,1,0,76.14,58.76 ,33.33
03,016,01,004,0082,93 ,404,7,411,782,0,3,1,3,0,1,0,76.14,52.56 ,33.33
03,016,01,004,0082,94 ,523,8,531,948,0,3,1,3,0,1,0,76.14,56.01 ,33.33
03,016,01,005,0083,95 ,215,6,221,492,0,3,1,3,0,1,0,76.14,44.92 ,33.33
03,016,01,005,0084,96 ,166,2,168,322,0,3,1,3,0,1,0,76.14,52.17 ,33.33
03,016,01,005,0085,97 ,82,5,87,234,0,3,1,3,0,1,0,76.14,37.18 ,33.33
03,016,01,005,0086,98 ,133,2,135,285,0,3,1,3,0,1,0,76.14,47.37 ,33.33
03,016,01,005,0087,99 ,198,8,206,643,0,3,1,3,0,1,0,76.14,32.04 ,33.33
03,016,01,005,0087,100 ,212,3,215,685,0,3,1,3,0,1,0,76.14,31.39 ,33.33
03,016,01,005,0088,101 ,75,2,77,233,0,3,1,3,0,1,0,76.14,33.05 ,33.33
03,016,01,005,0089,102 ,76,0,76,316,0,3,1,3,0,1,0,76.14,24.05 ,33.33
03,016,01,005,0090,103 ,29,0,29,170,0,3,1,3,0,1,0,76.14,17.06 ,33.33
03,016,01,005,0091,104 ,103,3,106,253,0,3,1,3,0,1,0,76.14,41.90 ,33.33
03,016,01,006,0092,105 ,83,6,89,218,0,3,1,3,0,1,0,76.14,40.83 ,33.33
03,016,01,006,0093,106 ,154,4,158,448,0,3,1,3,0,1,0,76.14,35.27 ,33.33
03,016,01,006,0094,107 ,169,16,185,427,0,3,1,3,0,1,0,76.14,43.33 ,33.33
03,016,01,006,0095,108 ,97,6,103,277,0,3,1,3,0,1,0,76.14,37.18 ,33.33
03,016,01,006,0096,109 ,90,4,94,244,0,3,1,3,0,1,0,76.14,38.52 ,33.33
03,016,01,006,0097,110 ,315,7,322,789,0,3,1,3,0,1,0,76.14,40.81 ,33.33
03,017,01,001,0001,1 ,420,4,424,557,0,3,1,3,0,1,0,76.14,76.12 ,33.33
03,017,01,001,0002,2 ,1022,14,1036,1741,0,3,1,3,0,1,0,76.14,59.51 ,33.33
03,017,01,001,0002,3 ,386,12,398,625,0,3,1,3,0,1,0,76.14,63.68 ,33.33
03,017,01,001,0003,4 ,974,8,982,1546,0,3,1,3,0,1,0,76.14,63.52 ,33.33
03,017,01,001,0004,5 ,771,8,779,1308,0,3,1,3,0,1,0,76.14,59.56 ,33.33
03,017,01,001,0005,6 ,720,17,737,1519,0,3,1,3,0,1,0,76.14,48.52 ,33.33
03,017,01,001,0005,7 ,958,20,978,2015,0,3,1,3,0,1,0,76.14,48.54 ,33.33
03,017,01,001,0005,8 ,1121,11,1132,2142,0,3,1,3,0,1,0,76.14,52.85 ,33.33
03,017,01,001,0006,9 ,939,20,959,1524,0,3,1,3,0,1,0,76.14,62.93 ,33.33
03,017,01,001,0007,10 ,593,10,603,972,0,3,1,3,0,1,0,76.14,62.04 ,33.33
03,017,01,001,0007,11 ,614,9,623,956,0,3,1,3,0,1,0,76.14,65.17 ,33.33
03,017,01,001,0008,12 ,561,14,575,918,0,3,1,3,0,1,0,76.14,62.64 ,33.33
03,017,01,001,0009,13 ,576,13,589,995,0,3,1,3,0,1,0,76.14,59.20 ,33.33
03,017,01,001,0010,14 ,744,21,765,1269,0,3,1,3,0,1,0,76.14,60.28 ,33.33
03,017,01,001,0011,15 ,585,15,600,937,0,3,1,3,0,1,0,76.14,64.03 ,33.33
03,017,01,001,0011,16 ,608,14,622,1034,0,3,1,3,0,1,0,76.14,60.15 ,33.33
03,017,01,001,0012,17 ,875,13,888,1423,0,3,1,3,0,1,0,76.14,62.40 ,33.33
03,017,01,001,0013,18 ,749,4,753,1181,0,3,1,3,0,1,0,76.14,63.76 ,33.33
03,017,01,001,0013,19 ,582,10,592,925,0,3,1,3,0,1,0,76.14,64.00 ,33.33
03,017,01,001,0014,20 ,672,9,681,1104,0,3,1,3,0,1,0,76.14,61.68 ,33.33
03,017,01,001,0014,21 ,598,9,607,983,0,3,1,3,0,1,0,76.14,61.75 ,33.33
03,017,01,001,0015,22 ,900,12,912,1484,0,3,1,3,0,1,0,76.14,61.46 ,33.33
03,017,01,001,0016,23 ,926,10,936,1492,0,3,1,3,0,1,0,76.14,62.73 ,33.33
03,017,01,001,0016,24 ,561,4,565,899,0,3,1,3,0,1,0,76.14,62.85 ,33.33
03,017,01,001,0017,25 ,874,5,879,1367,0,3,1,3,0,1,0,76.14,64.30 ,33.33
03,017,01,001,0018,26 ,832,14,846,1316,0,3,1,3,0,1,0,76.14,64.29 ,33.33
03,017,01,001,0019,27 ,997,7,1004,1535,0,3,1,3,0,1,0,76.14,65.41 ,33.33
03,017,01,001,0020,28 ,849,6,855,1363,0,3,1,3,0,1,0,76.14,62.73 ,33.33
03,017,01,001,0021,29 ,755,9,764,1210,0,3,1,3,0,1,0,76.14,63.14 ,33.33
03,017,01,001,0022,30 ,773,23,796,1224,0,3,1,3,0,1,0,76.14,65.03 ,33.33
03,017,01,001,0023,31 ,707,12,719,1072,0,3,1,3,0,1,0,76.14,67.07 ,33.33
03,017,01,001,0024,32 ,953,17,970,1488,0,3,1,3,0,1,0,76.14,65.19 ,33.33
03,017,01,001,0025,33 ,575,4,579,837,0,3,1,3,0,1,0,76.14,69.18 ,33.33
03,017,01,002,0026,34 ,796,13,809,1188,0,3,1,3,0,1,0,76.14,68.10 ,33.33
03,017,01,002,0027,35 ,792,14,806,1202,0,3,1,3,0,1,0,76.14,67.05 ,33.33
03,017,01,002,0028,36 ,670,6,676,1034,0,3,1,3,0,1,0,76.14,65.38 ,33.33
03,017,01,002,0029,37 ,805,9,814,1177,0,3,1,3,0,1,0,76.14,69.16 ,33.33
03,017,01,002,0029,38 ,770,15,785,1140,0,3,1,3,0,1,0,76.14,68.86 ,33.33
03,017,01,002,0030,39 ,610,7,617,861,0,3,1,3,0,1,0,76.14,71.66 ,33.33
03,017,01,002,0031,40 ,877,7,884,1312,0,3,1,3,0,1,0,76.14,67.38 ,33.33
03,017,01,002,0032,41 ,495,7,502,707,0,3,1,3,0,1,0,76.14,71.00 ,33.33
03,017,01,002,0033,42 ,464,3,467,691,0,3,1,3,0,1,0,76.14,67.58 ,33.33
03,017,01,002,0033,43 ,695,8,703,1054,0,3,1,3,0,1,0,76.14,66.70 ,33.33
03,017,01,002,0034,44 ,1009,8,1017,1527,0,3,1,3,0,1,0,76.14,66.60 ,33.33
03,017,01,002,0035,45 ,972,10,982,1527,0,3,1,3,0,1,0,76.14,64.31 ,33.33
03,017,01,002,0036,46 ,844,13,857,1262,0,3,1,3,0,1,0,76.14,67.91 ,33.33
03,017,01,002,0036,47 ,665,10,675,1091,0,3,1,3,0,1,0,76.14,61.87 ,33.33
03,017,01,002,0037,48 ,552,8,560,898,0,3,1,3,0,1,0,76.14,62.36 ,33.33
03,017,01,002,0037,49 ,1371,19,1390,2214,0,3,1,3,0,1,0,76.14,62.78 ,33.33
03,017,01,002,0038,50 ,1141,15,1156,1833,0,3,1,3,0,1,0,76.14,63.07 ,33.33
03,017,01,002,0039,51 ,926,8,934,1472,0,3,1,3,0,1,0,76.14,63.45 ,33.33
03,017,01,002,0039,52 ,1126,16,1142,1841,0,3,1,3,0,1,0,76.14,62.03 ,33.33
03,017,01,002,0040,53 ,904,14,918,1417,0,3,1,3,0,1,0,76.14,64.78 ,33.33
03,017,01,002,0040,54 ,831,16,847,1257,0,3,1,3,0,1,0,76.14,67.38 ,33.33
03,017,01,002,0041,55 ,1934,17,1951,3073,0,3,1,3,0,1,0,76.14,63.49 ,33.33
03,017,01,002,0042,56 ,1004,11,1015,1574,0,3,1,3,0,1,0,76.14,64.49 ,33.33
03,017,01,002,0042,57 ,1039,12,1051,1887,0,3,1,3,0,1,0,76.14,55.70 ,33.33
03,017,01,002,0042,58 ,1289,19,1308,2282,0,3,1,3,0,1,0,76.14,57.32 ,33.33
03,017,01,002,0043,59 ,538,4,542,887,0,3,1,3,0,1,0,76.14,61.10 ,33.33
03,017,01,003,0044,60 ,473,9,482,770,0,3,1,3,0,1,0,76.14,62.60 ,33.33
03,017,01,003,0044,61 ,664,13,677,1018,0,3,1,3,0,1,0,76.14,66.50 ,33.33
03,017,01,003,0045,62 ,635,5,640,910,0,3,1,3,0,1,0,76.14,70.33 ,33.33
03,017,01,003,0046,63 ,999,16,1015,1526,0,3,1,3,0,1,0,76.14,66.51 ,33.33
03,017,01,003,0047,64 ,1125,19,1144,1725,0,3,1,3,0,1,0,76.14,66.32 ,33.33
03,017,01,003,0048,65 ,731,11,742,1148,0,3,1,3,0,1,0,76.14,64.63 ,33.33
03,017,01,003,0048,66 ,702,12,714,1095,0,3,1,3,0,1,0,76.14,65.21 ,33.33
03,017,01,003,0049,67 ,722,8,730,1112,0,3,1,3,0,1,0,76.14,65.65 ,33.33
03,017,01,003,0050,68 ,623,15,638,1032,0,3,1,3,0,1,0,76.14,61.82 ,33.33
03,017,01,003,0051,69 ,778,8,786,1157,0,3,1,3,0,1,0,76.14,67.93 ,33.33
03,017,01,003,0052,70 ,653,12,665,1011,0,3,1,3,0,1,0,76.14,65.78 ,33.33
03,017,01,003,0053,71 ,784,7,791,1160,0,3,1,3,0,1,0,76.14,68.19 ,33.33
03,017,01,003,0053,72 ,375,4,379,531,0,3,1,3,0,1,0,76.14,71.37 ,33.33
03,017,01,003,0054,73 ,517,7,524,842,0,3,1,3,0,1,0,76.14,62.23 ,33.33
03,017,01,003,0055,74 ,664,16,680,1061,0,3,1,3,0,1,0,76.14,64.09 ,33.33
03,017,01,003,0056,75 ,954,18,972,1513,0,3,1,3,0,1,0,76.14,64.24 ,33.33
03,017,01,003,0056,76 ,890,20,910,1431,0,3,1,3,0,1,0,76.14,63.59 ,33.33
03,017,01,003,0057,77 ,519,13,532,871,0,3,1,3,0,1,0,76.14,61.08 ,33.33
03,017,01,003,0058,78 ,508,6,514,785,0,3,1,3,0,1,0,76.14,65.48 ,33.33
03,017,01,003,0058,79 ,433,4,437,691,0,3,1,3,0,1,0,76.14,63.24 ,33.33
03,017,01,003,0059,80 ,546,11,557,886,0,3,1,3,0,1,0,76.14,62.87 ,33.33
03,017,01,003,0060,81 ,866,18,884,1356,0,3,1,3,0,1,0,76.14,65.19 ,33.33
03,017,01,003,0061,82 ,626,8,634,981,0,3,1,3,0,1,0,76.14,64.63 ,33.33
03,017,01,003,0062,83 ,609,14,623,971,0,3,1,3,0,1,0,76.14,64.16 ,33.33
03,017,01,003,0063,84 ,700,20,720,1095,0,3,1,3,0,1,0,76.14,65.75 ,33.33
03,017,01,003,0064,85 ,405,5,410,655,0,3,1,3,0,1,0,76.14,62.60 ,33.33
03,017,01,003,0065,86 ,739,7,746,1164,0,3,1,3,0,1,0,76.14,64.09 ,33.33
03,017,01,003,0066,87 ,719,20,739,1126,0,3,1,3,0,1,0,76.14,65.63 ,33.33
03,017,01,003,0067,88 ,857,18,875,1259,0,3,1,3,0,1,0,76.14,69.50 ,33.33
03,017,01,003,0067,89 ,1024,13,1037,1636,0,3,1,3,0,1,0,76.14,63.39 ,33.33
03,017,01,003,0068,90 ,766,9,775,1185,0,3,1,3,0,1,0,76.14,65.40 ,33.33
03,017,01,003,0068,91 ,721,7,728,1108,0,3,1,3,0,1,0,76.14,65.70 ,33.33
03,017,01,003,0069,92 ,519,4,523,761,0,3,1,3,0,1,0,76.14,68.73 ,33.33
03,017,01,003,0070,93 ,477,4,481,663,0,3,1,3,0,1,0,76.14,72.55 ,33.33
03,017,01,003,0071,94 ,567,6,573,852,0,3,1,3,0,1,0,76.14,67.25 ,33.33
03,017,01,003,0072,95 ,496,8,504,735,0,3,1,3,0,1,0,76.14,68.57 ,33.33
03,017,01,004,0073,96 ,554,13,567,803,0,3,1,3,0,1,0,76.14,70.61 ,33.33
03,017,01,004,0074,97 ,742,15,757,1106,0,3,1,3,0,1,0,76.14,68.44 ,33.33
03,017,01,004,0075,98 ,686,8,694,994,0,3,1,3,0,1,0,76.14,69.82 ,33.33
03,017,01,004,0076,99 ,750,8,758,1124,0,3,1,3,0,1,0,76.14,67.44 ,33.33
03,017,01,004,0077,100 ,648,8,656,987,0,3,1,3,0,1,0,76.14,66.46 ,33.33
03,017,01,004,0078,101 ,872,16,888,1312,0,3,1,3,0,1,0,76.14,67.68 ,33.33
03,017,01,004,0079,102 ,532,15,547,836,0,3,1,3,0,1,0,76.14,65.43 ,33.33
03,017,01,004,0080,103 ,1014,27,1041,1558,0,3,1,3,0,1,0,76.14,66.82 ,33.33
03,017,01,004,0081,104 ,801,18,819,1268,0,3,1,3,0,1,0,76.14,64.59 ,33.33
03,017,01,004,0082,105 ,403,8,411,716,0,3,1,3,0,1,0,76.14,57.40 ,33.33
03,017,01,004,0082,106 ,503,6,509,810,0,3,1,3,0,1,0,76.14,62.84 ,33.33
03,017,01,004,0083,107 ,706,12,718,1087,0,3,1,3,0,1,0,76.14,66.05 ,33.33
03,017,01,004,0083,108 ,617,10,627,964,0,3,1,3,0,1,0,76.14,65.04 ,33.33
03,017,01,004,0084,109 ,440,9,449,707,0,3,1,3,0,1,0,76.14,63.51 ,33.33
03,017,01,004,0085,110 ,479,6,485,772,0,3,1,3,0,1,0,76.14,62.82 ,33.33
03,017,01,004,0086,111 ,612,15,627,973,0,3,1,3,0,1,0,76.14,64.44 ,33.33
03,017,01,004,0087,112 ,512,9,521,833,0,3,1,3,0,1,0,76.14,62.55 ,33.33
03,017,01,004,0087,113 ,522,11,533,766,0,3,1,3,0,1,0,76.14,69.58 ,33.33
03,017,01,004,0088,114 ,653,17,670,1109,0,3,1,3,0,1,0,76.14,60.41 ,33.33
03,017,01,004,0089,115 ,656,13,669,979,0,3,1,3,0,1,0,76.14,68.34 ,33.33
03,017,01,004,0089,116 ,1279,27,1306,2100,0,3,1,3,0,1,0,76.14,62.19 ,33.33
03,017,01,004,0090,117 ,1917,27,1944,2934,0,3,1,3,0,1,0,76.14,66.26 ,33.33
03,017,01,004,0090,118 ,1014,7,1021,1555,0,3,1,3,0,1,0,76.14,65.66 ,33.33
03,017,01,004,0091,119 ,855,14,869,1353,0,3,1,3,0,1,0,76.14,64.23 ,33.33
03,017,01,004,0091,120 ,1120,12,1132,1962,0,3,1,3,0,1,0,76.14,57.70 ,33.33
03,017,01,004,0091,121 ,1442,12,1454,2639,0,3,1,3,0,1,0,76.14,55.10 ,33.33
03,017,01,004,0091,122 ,1321,12,1333,2289,0,3,1,3,0,1,0,76.14,58.24 ,33.33
03,017,01,004,0092,123 ,462,11,473,753,0,3,1,3,0,1,0,76.14,62.82 ,33.33
03,017,01,004,0092,124 ,601,13,614,938,0,3,1,3,0,1,0,76.14,65.46 ,33.33
03,017,01,004,0093,125 ,637,5,642,988,0,3,1,3,0,1,0,76.14,64.98 ,33.33
03,017,01,004,0094,126 ,657,16,673,1014,0,3,1,3,0,1,0,76.14,66.37 ,33.33
03,017,01,004,0095,127 ,538,9,547,863,0,3,1,3,0,1,0,76.14,63.38 ,33.33
03,017,01,005,0096,128 ,925,21,946,1485,0,3,1,3,0,1,0,76.14,63.70 ,33.33
03,017,01,005,0097,129 ,872,16,888,1377,0,3,1,3,0,1,0,76.14,64.49 ,33.33
03,017,01,005,0098,130 ,786,18,804,1273,0,3,1,3,0,1,0,76.14,63.16 ,33.33
03,017,01,005,0099,131 ,839,20,859,1331,0,3,1,3,0,1,0,76.14,64.54 ,33.33
03,017,01,005,0100,132 ,973,11,984,1507,0,3,1,3,0,1,0,76.14,65.30 ,33.33
03,017,01,005,0100,133 ,510,19,529,820,0,3,1,3,0,1,0,76.14,64.51 ,33.33
03,017,01,005,0101,134 ,925,22,947,1536,0,3,1,3,0,1,0,76.14,61.65 ,33.33
03,017,01,005,0101,135 ,296,10,306,479,0,3,1,3,0,1,0,76.14,63.88 ,33.33
03,017,01,005,0102,136 ,651,11,662,1057,0,3,1,3,0,1,0,76.14,62.63 ,33.33
03,017,01,005,0103,137 ,581,9,590,896,0,3,1,3,0,1,0,76.14,65.85 ,33.33
03,017,01,005,0104,138 ,467,8,475,704,0,3,1,3,0,1,0,76.14,67.47 ,33.33
03,017,01,005,0105,139 ,1206,7,1213,1916,0,3,1,3,0,1,0,76.14,63.31 ,33.33
03,017,01,005,0105,140 ,863,19,882,1366,0,3,1,3,0,1,0,76.14,64.57 ,33.33
03,017,01,005,0106,141 ,857,9,866,1376,0,3,1,3,0,1,0,76.14,62.94 ,33.33
03,017,01,005,0106,142 ,875,11,886,1434,0,3,1,3,0,1,0,76.14,61.79 ,33.33
03,017,01,005,0106,143 ,1220,14,1234,2024,0,3,1,3,0,1,0,76.14,60.97 ,33.33
03,017,01,005,0107,144 ,922,11,933,1451,0,3,1,3,0,1,0,76.14,64.30 ,33.33
03,017,01,005,0107,145 ,852,10,862,1389,0,3,1,3,0,1,0,76.14,62.06 ,33.33
03,017,01,005,0108,146 ,954,16,970,1535,0,3,1,3,0,1,0,76.14,63.19 ,33.33
03,017,01,005,0108,147 ,931,12,943,1564,0,3,1,3,0,1,0,76.14,60.29 ,33.33
03,017,01,005,0108,148 ,617,9,626,1056,0,3,1,3,0,1,0,76.14,59.28 ,33.33
03,017,01,005,0109,149 ,1052,14,1066,1554,0,3,1,3,0,1,0,76.14,68.60 ,33.33
03,017,01,005,0109,150 ,797,9,806,1300,0,3,1,3,0,1,0,76.14,62.00 ,33.33
03,017,01,005,0109,151 ,585,14,599,885,0,3,1,3,0,1,0,76.14,67.68 ,33.33
03,017,01,005,0110,152 ,1192,21,1213,1903,0,3,1,3,0,1,0,76.14,63.74 ,33.33
03,017,01,005,0110,153 ,880,14,894,1414,0,3,1,3,0,1,0,76.14,63.22 ,33.33
03,017,01,005,0111,154 ,1057,6,1063,1731,0,3,1,3,0,1,0,76.14,61.41 ,33.33
03,017,01,005,0111,155 ,363,3,366,578,0,3,1,3,0,1,0,76.14,63.32 ,33.33
03,017,01,005,0112,156 ,1051,17,1068,1635,0,3,1,3,0,1,0,76.14,65.32 ,33.33
03,017,01,005,0112,157 ,1133,11,1144,1747,0,3,1,3,0,1,0,76.14,65.48 ,33.33
03,017,01,005,0113,158 ,1623,17,1640,2741,0,3,1,3,0,1,0,76.14,59.83 ,33.33
03,017,01,005,0113,159 ,1184,13,1197,2085,0,3,1,3,0,1,0,76.14,57.41 ,33.33
03,017,01,005,0113,160 ,882,21,903,1498,0,3,1,3,0,1,0,76.14,60.28 ,33.33
03,017,01,005,0114,161 ,1116,8,1124,1901,0,3,1,3,0,1,0,76.14,59.13 ,33.33
03,017,01,005,0114,162 ,592,17,609,999,0,3,1,3,0,1,0,76.14,60.96 ,33.33
03,017,01,005,0115,163 ,1658,19,1677,2912,0,3,1,3,0,1,0,76.14,57.59 ,33.33
03,017,01,005,0116,164 ,725,12,737,1211,0,3,1,3,0,1,0,76.14,60.86 ,33.33
03,017,01,005,0117,165 ,930,16,946,1742,0,3,1,3,0,1,0,76.14,54.31 ,33.33
03,017,01,005,0117,166 ,893,14,907,1592,0,3,1,3,0,1,0,76.14,56.97 ,33.33
03,017,01,006,0118,167 ,733,8,741,1177,0,3,1,3,0,1,0,76.14,62.96 ,33.33
03,017,01,006,0119,168 ,401,5,406,636,0,3,1,3,0,1,0,76.14,63.84 ,33.33
03,017,01,006,0120,169 ,488,6,494,746,0,3,1,3,0,1,0,76.14,66.22 ,33.33
03,017,01,006,0121,170 ,408,6,414,650,0,3,1,3,0,1,0,76.14,63.69 ,33.33
03,017,01,006,0122,171 ,970,10,980,1637,0,3,1,3,0,1,0,76.14,59.87 ,33.33
03,017,01,006,0122,172 ,962,13,975,1521,0,3,1,3,0,1,0,76.14,64.10 ,33.33
03,017,01,006,0123,173 ,749,15,764,1190,0,3,1,3,0,1,0,76.14,64.20 ,33.33
03,017,01,006,0123,174 ,601,6,607,936,0,3,1,3,0,1,0,76.14,64.85 ,33.33
03,017,01,006,0124,175 ,628,10,638,956,0,3,1,3,0,1,0,76.14,66.74 ,33.33
03,017,01,006,0124,176 ,695,13,708,1164,0,3,1,3,0,1,0,76.14,60.82 ,33.33
03,017,01,006,0125,177 ,257,8,265,389,0,3,1,3,0,1,0,76.14,68.12 ,33.33
03,017,01,006,0126,178 ,1115,24,1139,1897,0,3,1,3,0,1,0,76.14,60.04 ,33.33
03,017,01,006,0126,179 ,948,15,963,1602,0,3,1,3,0,1,0,76.14,60.11 ,33.33
03,017,01,006,0127,180 ,559,6,565,908,0,3,1,3,0,1,0,76.14,62.22 ,33.33
03,017,01,006,0127,181 ,787,12,799,1369,0,3,1,3,0,1,0,76.14,58.36 ,33.33
03,017,01,006,0128,182 ,567,11,578,800,0,3,1,3,0,1,0,76.14,72.25 ,33.33
03,017,01,006,0128,183 ,862,6,868,1508,0,3,1,3,0,1,0,76.14,57.56 ,33.33
03,017,01,006,0129,184 ,666,9,675,1430,0,3,1,3,0,1,0,76.14,47.20 ,33.33
03,017,01,006,0129,185 ,984,8,992,1758,0,3,1,3,0,1,0,76.14,56.43 ,33.33
03,017,01,006,0130,186 ,1416,28,1444,2380,0,3,1,3,0,1,0,76.14,60.67 ,33.33
03,017,01,006,0130,187 ,1014,19,1033,1829,0,3,1,3,0,1,0,76.14,56.48 ,33.33
03,017,01,007,0131,188 ,947,16,963,1483,0,3,1,3,0,1,0,76.14,64.94 ,33.33
03,017,01,007,0131,189 ,681,16,697,1093,0,3,1,3,0,1,0,76.14,63.77 ,33.33
03,017,01,007,0131,190 ,760,17,777,1112,0,3,1,3,0,1,0,76.14,69.87 ,33.33
03,017,01,007,0132,191 ,781,20,801,1156,0,3,1,3,0,1,0,76.14,69.29 ,33.33
03,017,01,007,0132,192 ,593,7,600,884,0,3,1,3,0,1,0,76.14,67.87 ,33.33
03,017,01,007,0133,193 ,863,9,872,1281,0,3,1,3,0,1,0,76.14,68.07 ,33.33
03,017,01,007,0133,194 ,496,9,505,719,0,3,1,3,0,1,0,76.14,70.24 ,33.33
03,017,01,007,0134,195 ,1210,11,1221,1808,0,3,1,3,0,1,0,76.14,67.53 ,33.33
03,017,01,007,0134,196 ,1183,11,1194,1773,0,3,1,3,0,1,0,76.14,67.34 ,33.33
03,017,01,007,0135,197 ,712,11,723,1034,0,3,1,3,0,1,0,76.14,69.92 ,33.33
03,017,01,007,0135,198 ,675,8,683,1037,0,3,1,3,0,1,0,76.14,65.86 ,33.33
03,017,01,007,0136,199 ,782,19,801,1147,0,3,1,3,0,1,0,76.14,69.83 ,33.33
03,017,01,007,0136,200 ,599,12,611,887,0,3,1,3,0,1,0,76.14,68.88 ,33.33
03,017,01,007,0137,201 ,198,6,204,303,0,3,1,3,0,1,0,76.14,67.33 ,33.33
03,017,01,007,0137,202 ,802,13,815,1217,0,3,1,3,0,1,0,76.14,66.97 ,33.33
03,017,01,007,0138,203 ,595,13,608,932,0,3,1,3,0,1,0,76.14,65.24 ,33.33
03,017,01,007,0139,204 ,601,12,613,922,0,3,1,3,0,1,0,76.14,66.49 ,33.33
03,017,01,007,0139,205 ,766,8,774,1270,0,3,1,3,0,1,0,76.14,60.94 ,33.33
03,017,01,007,0139,206 ,627,11,638,920,0,3,1,3,0,1,0,76.14,69.35 ,33.33
03,017,01,007,0140,207 ,871,16,887,1396,0,3,1,3,0,1,0,76.14,63.54 ,33.33
03,017,01,007,0141,208 ,858,18,876,1434,0,3,1,3,0,1,0,76.14,61.09 ,33.33
03,017,01,007,0141,209 ,908,13,921,1655,0,3,1,3,0,1,0,76.14,55.65 ,33.33
03,017,01,007,0142,210 ,823,8,831,1337,0,3,1,3,0,1,0,76.14,62.15 ,33.33
03,017,01,007,0142,211 ,971,14,985,1598,0,3,1,3,0,1,0,76.14,61.64 ,33.33
03,017,01,007,0143,212 ,763,9,772,1275,0,3,1,3,0,1,0,76.14,60.55 ,33.33
03,017,01,007,0143,213 ,986,17,1003,1549,0,3,1,3,0,1,0,76.14,64.75 ,33.33
03,017,01,007,0143,214 ,887,3,890,1485,0,3,1,3,0,1,0,76.14,59.93 ,33.33
03,017,01,007,0144,215 ,707,9,716,1168,0,3,1,3,0,1,0,76.14,61.30 ,33.33
03,017,01,007,0144,216 ,515,10,525,887,0,3,1,3,0,1,0,76.14,59.19 ,33.33
03,017,01,007,0144,217 ,654,11,665,1156,0,3,1,3,0,1,0,76.14,57.53 ,33.33
03,017,01,007,0145,218 ,287,4,291,457,0,3,1,3,0,1,0,76.14,63.68 ,33.33
03,017,01,007,0146,219 ,223,6,229,315,0,3,1,3,0,1,0,76.14,72.70 ,33.33
03,017,01,007,0147,220 ,235,6,241,360,0,3,1,3,0,1,0,76.14,66.94 ,33.33
03,017,01,007,0148,221 ,746,9,755,1171,0,3,1,3,0,1,0,76.14,64.47 ,33.33
03,017,01,007,0149,222 ,304,11,315,443,0,3,1,3,0,1,0,76.14,71.11 ,33.33
03,018,01,001,0001,1 ,592,6,598,1093,0,3,1,3,0,1,0,76.14,54.71 ,33.33
03,018,01,001,0002,2 ,574,2,576,930,0,3,1,3,0,1,0,76.14,61.94 ,33.33
03,018,01,001,0002,3 ,518,8,526,856,0,3,1,3,0,1,0,76.14,61.45 ,33.33
03,018,01,001,0003,4 ,483,6,489,766,0,3,1,3,0,1,0,76.14,63.84 ,33.33
03,018,01,001,0004,5 ,483,9,492,783,0,3,1,3,0,1,0,76.14,62.84 ,33.33
03,018,01,001,0005,6 ,262,5,267,468,0,3,1,3,0,1,0,76.14,57.05 ,33.33
03,018,01,001,0006,7 ,311,5,316,523,0,3,1,3,0,1,0,76.14,60.42 ,33.33
03,018,01,001,0007,8 ,693,6,699,1078,0,3,1,3,0,1,0,76.14,64.84 ,33.33
03,018,01,001,0007,9 ,492,7,499,747,0,3,1,3,0,1,0,76.14,66.80 ,33.33
03,018,01,001,0008,10 ,679,6,685,1084,0,3,1,3,0,1,0,76.14,63.19 ,33.33
03,018,01,001,0008,11 ,637,8,645,937,0,3,1,3,0,1,0,76.14,68.84 ,33.33
03,018,01,001,0008,12 ,779,12,791,1270,0,3,1,3,0,1,0,76.14,62.28 ,33.33
03,018,01,001,0009,13 ,1089,14,1103,1710,0,3,1,3,0,1,0,76.14,64.50 ,33.33
03,018,01,001,0009,14 ,1169,15,1184,1907,0,3,1,3,0,1,0,76.14,62.09 ,33.33
03,018,01,001,0010,15 ,970,10,980,1549,0,3,1,3,0,1,0,76.14,63.27 ,33.33
03,018,01,001,0010,16 ,1149,10,1159,1791,0,3,1,3,0,1,0,76.14,64.71 ,33.33
03,018,01,001,0011,17 ,769,11,780,1199,0,3,1,3,0,1,0,76.14,65.05 ,33.33
03,018,01,001,0011,18 ,908,8,916,1363,0,3,1,3,0,1,0,76.14,67.20 ,33.33
03,018,01,001,0011,19 ,735,4,739,1160,0,3,1,3,0,1,0,76.14,63.71 ,33.33
03,018,01,001,0012,20 ,545,10,555,911,0,3,1,3,0,1,0,76.14,60.92 ,33.33
03,018,01,001,0012,21 ,987,14,1001,1541,0,3,1,3,0,1,0,76.14,64.96 ,33.33
03,018,01,001,0013,22 ,588,12,600,1014,0,3,1,3,0,1,0,76.14,59.17 ,33.33
03,018,01,001,0013,23 ,764,10,774,1162,0,3,1,3,0,1,0,76.14,66.61 ,33.33
03,018,01,001,0014,24 ,726,16,742,1141,0,3,1,3,0,1,0,76.14,65.03 ,33.33
03,018,01,001,0014,25 ,573,11,584,920,0,3,1,3,0,1,0,76.14,63.48 ,33.33
03,018,01,001,0015,26 ,589,6,595,933,0,3,1,3,0,1,0,76.14,63.77 ,33.33
03,018,01,001,0015,27 ,666,2,668,988,0,3,1,3,0,1,0,76.14,67.61 ,33.33
03,018,01,001,0015,28 ,606,4,610,974,0,3,1,3,0,1,0,76.14,62.63 ,33.33
03,018,01,001,0016,29 ,771,13,784,1207,0,3,1,3,0,1,0,76.14,64.95 ,33.33
03,018,01,001,0016,30 ,872,14,886,1385,0,3,1,3,0,1,0,76.14,63.97 ,33.33
03,018,01,001,0016,31 ,900,9,909,1377,0,3,1,3,0,1,0,76.14,66.01 ,33.33
03,018,01,001,0017,32 ,596,12,608,943,0,3,1,3,0,1,0,76.14,64.48 ,33.33
03,018,01,001,0017,33 ,524,6,530,843,0,3,1,3,0,1,0,76.14,62.87 ,33.33
03,018,01,001,0018,34 ,656,23,679,1037,0,3,1,3,0,1,0,76.14,65.48 ,33.33
03,018,01,001,0019,35 ,870,9,879,1400,0,3,1,3,0,1,0,76.14,62.79 ,33.33
03,018,01,001,0019,36 ,592,12,604,931,0,3,1,3,0,1,0,76.14,64.88 ,33.33
03,018,01,001,0020,37 ,885,8,893,1407,0,3,1,3,0,1,0,76.14,63.47 ,33.33
03,018,01,001,0020,38 ,974,18,992,1535,0,3,1,3,0,1,0,76.14,64.63 ,33.33
03,018,01,001,0021,39 ,562,8,570,824,0,3,1,3,0,1,0,76.14,69.17 ,33.33
03,018,01,001,0021,40 ,594,14,608,837,0,3,1,3,0,1,0,76.14,72.64 ,33.33
03,018,01,001,0022,41 ,795,9,804,1279,0,3,1,3,0,1,0,76.14,62.86 ,33.33
03,018,01,001,0022,42 ,744,10,754,1187,0,3,1,3,0,1,0,76.14,63.52 ,33.33
03,018,01,001,0023,43 ,174,2,176,335,0,3,1,3,0,1,0,76.14,52.54 ,33.33
03,018,01,001,0024,44 ,1075,16,1091,1520,0,3,1,3,0,1,0,76.14,71.78 ,33.33
03,018,01,001,0025,45 ,947,15,962,1487,0,3,1,3,0,1,0,76.14,64.69 ,33.33
03,018,01,001,0025,46 ,1057,13,1070,1615,0,3,1,3,0,1,0,76.14,66.25 ,33.33
03,018,01,001,0026,47 ,511,8,519,763,0,3,1,3,0,1,0,76.14,68.02 ,33.33
03,018,01,001,0027,48 ,860,10,870,1290,0,3,1,3,0,1,0,76.14,67.44 ,33.33
03,018,01,001,0027,49 ,562,7,569,797,0,3,1,3,0,1,0,76.14,71.39 ,33.33
03,018,01,001,0027,50 ,564,7,571,816,0,3,1,3,0,1,0,76.14,69.98 ,33.33
03,018,01,001,0028,51 ,737,7,744,1176,0,3,1,3,0,1,0,76.14,63.27 ,33.33
03,018,01,001,0028,52 ,333,1,334,508,0,3,1,3,0,1,0,76.14,65.75 ,33.33
03,018,01,001,0028,53 ,853,12,865,1371,0,3,1,3,0,1,0,76.14,63.09 ,33.33
03,018,01,001,0029,54 ,598,5,603,888,0,3,1,3,0,1,0,76.14,67.91 ,33.33
03,018,01,001,0029,55 ,526,7,533,843,0,3,1,3,0,1,0,76.14,63.23 ,33.33
03,018,01,001,0029,56 ,698,10,708,1001,0,3,1,3,0,1,0,76.14,70.73 ,33.33
03,018,01,001,0030,57 ,970,14,984,1511,0,3,1,3,0,1,0,76.14,65.12 ,33.33
03,018,01,001,0030,58 ,1128,18,1146,1762,0,3,1,3,0,1,0,76.14,65.04 ,33.33
03,018,01,001,0030,59 ,970,8,978,1408,0,3,1,3,0,1,0,76.14,69.46 ,33.33
03,018,01,001,0031,60 ,748,12,760,1167,0,3,1,3,0,1,0,76.14,65.12 ,33.33
03,018,01,001,0031,61 ,622,9,631,995,0,3,1,3,0,1,0,76.14,63.42 ,33.33
03,018,01,001,0032,62 ,894,30,924,1378,0,3,1,3,0,1,0,76.14,67.05 ,33.33
03,018,01,001,0032,63 ,875,22,897,1388,0,3,1,3,0,1,0,76.14,64.63 ,33.33
03,018,01,001,0032,64 ,716,10,726,1085,0,3,1,3,0,1,0,76.14,66.91 ,33.33
03,018,01,001,0033,65 ,651,16,667,1077,0,3,1,3,0,1,0,76.14,61.93 ,33.33
03,018,01,001,0033,66 ,749,16,765,1179,0,3,1,3,0,1,0,76.14,64.89 ,33.33
03,018,01,001,0033,67 ,784,11,795,1274,0,3,1,3,0,1,0,76.14,62.40 ,33.33
03,018,01,001,0034,68 ,863,13,876,1490,0,3,1,3,0,1,0,76.14,58.79 ,33.33
03,018,01,001,0034,69 ,679,16,695,995,0,3,1,3,0,1,0,76.14,69.85 ,33.33
03,018,01,001,0034,70 ,819,9,828,1333,0,3,1,3,0,1,0,76.14,62.12 ,33.33
03,018,01,001,0035,71 ,1001,9,1010,1551,0,3,1,3,0,1,0,76.14,65.12 ,33.33
03,018,01,001,0035,72 ,904,7,911,1417,0,3,1,3,0,1,0,76.14,64.29 ,33.33
03,018,01,001,0036,73 ,500,4,504,808,0,3,1,3,0,1,0,76.14,62.38 ,33.33
03,018,01,001,0037,74 ,346,7,353,590,0,3,1,3,0,1,0,76.14,59.83 ,33.33
03,018,01,001,0038,75 ,426,1,427,654,0,3,1,3,0,1,0,76.14,65.29 ,33.33
03,018,01,001,0039,76 ,599,4,603,904,0,3,1,3,0,1,0,76.14,66.70 ,33.33
03,018,01,001,0040,77 ,765,9,774,1223,0,3,1,3,0,1,0,76.14,63.29 ,33.33
03,018,01,001,0041,78 ,759,12,771,1215,0,3,1,3,0,1,0,76.14,63.46 ,33.33
03,018,01,001,0041,79 ,954,7,961,1605,0,3,1,3,0,1,0,76.14,59.88 ,33.33
03,018,01,001,0041,80 ,836,11,847,1464,0,3,1,3,0,1,0,76.14,57.86 ,33.33
03,018,01,001,0042,81 ,616,8,624,960,0,3,1,3,0,1,0,76.14,65.00 ,33.33
03,018,01,001,0042,82 ,710,8,718,1099,0,3,1,3,0,1,0,76.14,65.33 ,33.33
03,018,01,001,0042,83 ,630,11,641,956,0,3,1,3,0,1,0,76.14,67.05 ,33.33
03,018,01,001,0043,84 ,503,13,516,820,0,3,1,3,0,1,0,76.14,62.93 ,33.33
03,018,01,001,0044,85 ,538,5,543,809,0,3,1,3,0,1,0,76.14,67.12 ,33.33
03,018,01,001,0045,86 ,763,19,782,1185,0,3,1,3,0,1,0,76.14,65.99 ,33.33
03,018,01,001,0046,87 ,577,17,594,959,0,3,1,3,0,1,0,76.14,61.94 ,33.33
03,018,01,001,0046,88 ,610,9,619,977,0,3,1,3,0,1,0,76.14,63.36 ,33.33
03,018,01,001,0046,89 ,648,15,663,1040,0,3,1,3,0,1,0,76.14,63.75 ,33.33
03,018,01,001,0047,90 ,381,3,384,662,0,3,1,3,0,1,0,76.14,58.01 ,33.33
03,018,01,001,0047,91 ,562,8,570,868,0,3,1,3,0,1,0,76.14,65.67 ,33.33
03,018,01,001,0048,92 ,385,6,391,560,0,3,1,3,0,1,0,76.14,69.82 ,33.33
03,018,01,001,0048,93 ,858,22,880,1403,0,3,1,3,0,1,0,76.14,62.72 ,33.33
03,018,01,001,0048,94 ,700,11,711,1125,0,3,1,3,0,1,0,76.14,63.20 ,33.33
03,018,01,001,0049,95 ,826,19,845,1401,0,3,1,3,0,1,0,76.14,60.31 ,33.33
03,018,01,001,0049,96 ,919,14,933,1464,0,3,1,3,0,1,0,76.14,63.73 ,33.33
03,018,01,001,0050,97 ,1037,12,1049,1580,0,3,1,3,0,1,0,76.14,66.39 ,33.33
03,018,01,001,0050,98 ,699,14,713,1177,0,3,1,3,0,1,0,76.14,60.58 ,33.33
03,018,01,001,0050,99 ,1074,10,1084,1747,0,3,1,3,0,1,0,76.14,62.05 ,33.33
03,018,01,001,0051,100 ,1042,12,1054,1593,0,3,1,3,0,1,0,76.14,66.16 ,33.33
03,018,01,001,0051,101 ,690,14,704,1088,0,3,1,3,0,1,0,76.14,64.71 ,33.33
03,018,01,001,0052,102 ,1177,22,1199,1850,0,3,1,3,0,1,0,76.14,64.81 ,33.33
03,018,01,001,0052,103 ,703,14,717,1155,0,3,1,3,0,1,0,76.14,62.08 ,33.33
03,018,01,001,0053,104 ,537,8,545,955,0,3,1,3,0,1,0,76.14,57.07 ,33.33
03,018,01,001,0053,105 ,1042,15,1057,1930,0,3,1,3,0,1,0,76.14,54.77 ,33.33
03,018,01,002,0054,106 ,326,1,327,500,0,3,1,3,0,1,0,76.14,65.40 ,33.33
03,018,01,002,0055,107 ,563,4,567,838,0,3,1,3,0,1,0,76.14,67.66 ,33.33
03,018,01,002,0056,108 ,356,4,360,525,0,3,1,3,0,1,0,76.14,68.57 ,33.33
03,018,01,002,0057,109 ,327,3,330,537,0,3,1,3,0,1,0,76.14,61.45 ,33.33
03,018,01,002,0058,110 ,478,4,482,751,0,3,1,3,0,1,0,76.14,64.18 ,33.33
03,018,01,002,0059,111 ,767,13,780,1130,0,3,1,3,0,1,0,76.14,69.03 ,33.33
03,018,01,002,0060,112 ,831,10,841,1265,0,3,1,3,0,1,0,76.14,66.48 ,33.33
03,018,01,002,0061,113 ,533,5,538,836,0,3,1,3,0,1,0,76.14,64.35 ,33.33
03,018,01,002,0061,114 ,687,9,696,1119,0,3,1,3,0,1,0,76.14,62.20 ,33.33
03,018,01,002,0061,115 ,955,13,968,1500,0,3,1,3,0,1,0,76.14,64.53 ,33.33
03,018,01,002,0062,116 ,704,8,712,1163,0,3,1,3,0,1,0,76.14,61.22 ,33.33
03,018,01,002,0063,117 ,533,18,551,832,0,3,1,3,0,1,0,76.14,66.23 ,33.33
03,018,01,002,0063,118 ,1069,27,1096,1744,0,3,1,3,0,1,0,76.14,62.84 ,33.33
03,018,01,002,0063,119 ,504,22,526,753,0,3,1,3,0,1,0,76.14,69.85 ,33.33
03,018,01,002,0063,120 ,851,7,858,1328,0,3,1,3,0,1,0,76.14,64.61 ,33.33
03,018,01,002,0064,121 ,836,9,845,1293,0,3,1,3,0,1,0,76.14,65.35 ,33.33
03,018,01,002,0064,122 ,770,11,781,1131,0,3,1,3,0,1,0,76.14,69.05 ,33.33
03,018,01,002,0065,123 ,582,7,589,884,0,3,1,3,0,1,0,76.14,66.63 ,33.33
03,018,01,002,0065,124 ,611,9,620,961,0,3,1,3,0,1,0,76.14,64.52 ,33.33
03,018,01,002,0065,125 ,764,9,773,1249,0,3,1,3,0,1,0,76.14,61.89 ,33.33
03,018,01,002,0066,126 ,625,11,636,913,0,3,1,3,0,1,0,76.14,69.66 ,33.33
03,018,01,002,0066,127 ,863,8,871,1314,0,3,1,3,0,1,0,76.14,66.29 ,33.33
03,018,01,002,0066,128 ,629,16,645,960,0,3,1,3,0,1,0,76.14,67.19 ,33.33
03,018,01,002,0067,129 ,554,9,563,833,0,3,1,3,0,1,0,76.14,67.59 ,33.33
03,018,01,002,0067,130 ,505,11,516,680,0,3,1,3,0,1,0,76.14,75.88 ,33.33
03,018,01,002,0068,131 ,501,4,505,796,0,3,1,3,0,1,0,76.14,63.44 ,33.33
03,018,01,002,0069,132 ,436,3,439,669,0,3,1,3,0,1,0,76.14,65.62 ,33.33
03,018,01,002,0070,133 ,345,5,350,598,0,3,1,3,0,1,0,76.14,58.53 ,33.33
03,018,01,002,0071,134 ,845,19,864,1323,0,3,1,3,0,1,0,76.14,65.31 ,33.33
03,018,01,002,0072,135 ,767,12,779,1183,0,3,1,3,0,1,0,76.14,65.85 ,33.33
03,018,01,002,0073,136 ,567,4,571,899,0,3,1,3,0,1,0,76.14,63.52 ,33.33
03,018,01,002,0074,137 ,742,13,755,1173,0,3,1,3,0,1,0,76.14,64.36 ,33.33
03,018,01,002,0074,138 ,832,11,843,1363,0,3,1,3,0,1,0,76.14,61.85 ,33.33
03,018,01,002,0074,139 ,787,10,797,1348,0,3,1,3,0,1,0,76.14,59.12 ,33.33
03,018,01,002,0075,140 ,792,10,802,1291,0,3,1,3,0,1,0,76.14,62.12 ,33.33
03,018,01,002,0075,141 ,868,19,887,1382,0,3,1,3,0,1,0,76.14,64.18 ,33.33
03,018,01,002,0075,142 ,763,6,769,1153,0,3,1,3,0,1,0,76.14,66.70 ,33.33
03,018,01,002,0076,143 ,954,10,964,1508,0,3,1,3,0,1,0,76.14,63.93 ,33.33
03,018,01,002,0076,144 ,776,15,791,1235,0,3,1,3,0,1,0,76.14,64.05 ,33.33
03,018,01,002,0076,145 ,556,9,565,867,0,3,1,3,0,1,0,76.14,65.17 ,33.33
03,018,01,002,0077,146 ,950,16,966,1441,0,3,1,3,0,1,0,76.14,67.04 ,33.33
03,018,01,002,0077,147 ,1077,14,1091,1689,0,3,1,3,0,1,0,76.14,64.59 ,33.33
03,018,01,002,0078,148 ,794,10,804,1238,0,3,1,3,0,1,0,76.14,64.94 ,33.33
03,018,01,002,0078,149 ,819,11,830,1276,0,3,1,3,0,1,0,76.14,65.05 ,33.33
03,018,01,002,0079,150 ,601,10,611,951,0,3,1,3,0,1,0,76.14,64.25 ,33.33
03,018,01,002,0079,151 ,689,11,700,1084,0,3,1,3,0,1,0,76.14,64.58 ,33.33
03,018,01,002,0080,152 ,650,12,662,1238,0,3,1,3,0,1,0,76.14,53.47 ,33.33
03,018,01,002,0080,153 ,956,16,972,1539,0,3,1,3,0,1,0,76.14,63.16 ,33.33
03,018,01,002,0081,154 ,974,16,990,1634,0,3,1,3,0,1,0,76.14,60.59 ,33.33
03,018,01,002,0081,155 ,1125,12,1137,1763,0,3,1,3,0,1,0,76.14,64.49 ,33.33
03,018,01,002,0082,156 ,641,10,651,967,0,3,1,3,0,1,0,76.14,67.32 ,33.33
03,018,01,002,0082,157 ,785,12,797,1289,0,3,1,3,0,1,0,76.14,61.83 ,33.33
03,018,01,002,0083,158 ,846,14,860,1246,0,3,1,3,0,1,0,76.14,69.02 ,33.33
03,018,01,002,0084,159 ,898,5,903,1400,0,3,1,3,0,1,0,76.14,64.50 ,33.33
03,018,01,002,0084,160 ,678,6,684,1101,0,3,1,3,0,1,0,76.14,62.13 ,33.33
03,018,01,002,0084,161 ,647,11,658,1037,0,3,1,3,0,1,0,76.14,63.45 ,33.33
03,018,01,002,0085,162 ,882,12,894,1433,0,3,1,3,0,1,0,76.14,62.39 ,33.33
03,018,01,002,0085,163 ,762,8,770,1319,0,3,1,3,0,1,0,76.14,58.38 ,33.33
03,018,01,002,0085,164 ,945,10,955,1478,0,3,1,3,0,1,0,76.14,64.61 ,33.33
03,018,01,002,0086,165 ,831,10,841,1333,0,3,1,3,0,1,0,76.14,63.09 ,33.33
03,018,01,002,0086,166 ,856,19,875,1390,0,3,1,3,0,1,0,76.14,62.95 ,33.33
03,018,01,002,0086,167 ,727,8,735,1204,0,3,1,3,0,1,0,76.14,61.05 ,33.33
03,018,01,002,0087,168 ,822,7,829,1207,0,3,1,3,0,1,0,76.14,68.68 ,33.33
03,018,01,002,0088,169 ,821,12,833,1269,0,3,1,3,0,1,0,76.14,65.64 ,33.33
03,018,01,002,0088,170 ,1007,16,1023,1582,0,3,1,3,0,1,0,76.14,64.66 ,33.33
03,018,01,002,0089,171 ,642,7,649,1018,0,3,1,3,0,1,0,76.14,63.75 ,33.33
03,018,01,002,0089,172 ,595,8,603,979,0,3,1,3,0,1,0,76.14,61.59 ,33.33
03,018,01,002,0089,173 ,960,20,980,1509,0,3,1,3,0,1,0,76.14,64.94 ,33.33
03,018,01,002,0090,174 ,807,12,819,1222,0,3,1,3,0,1,0,76.14,67.02 ,33.33
03,018,01,002,0090,175 ,537,10,547,786,0,3,1,3,0,1,0,76.14,69.59 ,33.33
03,018,01,002,0090,176 ,616,12,628,873,0,3,1,3,0,1,0,76.14,71.94 ,33.33
03,018,01,002,0091,177 ,506,12,518,855,0,3,1,3,0,1,0,76.14,60.58 ,33.33
03,018,01,002,0092,178 ,606,9,615,1008,0,3,1,3,0,1,0,76.14,61.01 ,33.33
03,018,01,002,0092,179 ,581,14,595,970,0,3,1,3,0,1,0,76.14,61.34 ,33.33
03,018,01,002,0092,180 ,897,11,908,1578,0,3,1,3,0,1,0,76.14,57.54 ,33.33
03,018,01,002,0093,181 ,1049,25,1074,1690,0,3,1,3,0,1,0,76.14,63.55 ,33.33
03,018,01,002,0094,182 ,826,9,835,1318,0,3,1,3,0,1,0,76.14,63.35 ,33.33
03,018,01,002,0095,183 ,843,14,857,1400,0,3,1,3,0,1,0,76.14,61.21 ,33.33
03,018,01,002,0096,184 ,707,19,726,1122,0,3,1,3,0,1,0,76.14,64.71 ,33.33
03,018,01,002,0097,185 ,313,3,316,501,0,3,1,3,0,1,0,76.14,63.07 ,33.33
03,018,01,003,0098,186 ,1039,8,1047,1640,0,3,1,3,0,1,0,76.14,63.84 ,33.33
03,018,01,003,0098,187 ,783,13,796,1293,0,3,1,3,0,1,0,76.14,61.56 ,33.33
03,018,01,003,0099,188 ,607,10,617,965,0,3,1,3,0,1,0,76.14,63.94 ,33.33
03,018,01,003,0099,189 ,919,12,931,1521,0,3,1,3,0,1,0,76.14,61.21 ,33.33
03,018,01,003,0100,190 ,731,10,741,1146,0,3,1,3,0,1,0,76.14,64.66 ,33.33
03,018,01,003,0100,191 ,661,10,671,1070,0,3,1,3,0,1,0,76.14,62.71 ,33.33
03,018,01,003,0101,192 ,521,5,526,871,0,3,1,3,0,1,0,76.14,60.39 ,33.33
03,018,01,003,0101,193 ,751,9,760,1315,0,3,1,3,0,1,0,76.14,57.79 ,33.33
03,018,01,003,0102,194 ,750,3,753,1169,0,3,1,3,0,1,0,76.14,64.41 ,33.33
03,018,01,003,0102,195 ,712,10,722,1107,0,3,1,3,0,1,0,76.14,65.22 ,33.33
03,018,01,003,0103,196 ,578,5,583,958,0,3,1,3,0,1,0,76.14,60.86 ,33.33
03,018,01,003,0103,197 ,475,14,489,788,0,3,1,3,0,1,0,76.14,62.06 ,33.33
03,018,01,003,0104,198 ,957,22,979,1525,0,3,1,3,0,1,0,76.14,64.20 ,33.33
03,018,01,003,0105,199 ,758,14,772,1147,0,3,1,3,0,1,0,76.14,67.31 ,33.33
03,018,01,003,0105,200 ,508,8,516,767,0,3,1,3,0,1,0,76.14,67.28 ,33.33
03,018,01,003,0106,201 ,797,12,809,1262,0,3,1,3,0,1,0,76.14,64.10 ,33.33
03,018,01,003,0106,202 ,767,12,779,1417,0,3,1,3,0,1,0,76.14,54.98 ,33.33
03,018,01,003,0106,203 ,1047,18,1065,1754,0,3,1,3,0,1,0,76.14,60.72 ,33.33
03,018,01,003,0107,204 ,584,8,592,888,0,3,1,3,0,1,0,76.14,66.67 ,33.33
03,018,01,003,0107,205 ,498,15,513,802,0,3,1,3,0,1,0,76.14,63.97 ,33.33
03,018,01,003,0108,206 ,665,11,676,1142,0,3,1,3,0,1,0,76.14,59.19 ,33.33
03,018,01,003,0108,207 ,479,8,487,725,0,3,1,3,0,1,0,76.14,67.17 ,33.33
03,018,01,003,0109,208 ,491,16,507,798,0,3,1,3,0,1,0,76.14,63.53 ,33.33
03,018,01,003,0109,209 ,683,13,696,1122,0,3,1,3,0,1,0,76.14,62.03 ,33.33
03,018,01,003,0110,210 ,957,12,969,1527,0,3,1,3,0,1,0,76.14,63.46 ,33.33
03,018,01,003,0110,211 ,729,6,735,1194,0,3,1,3,0,1,0,76.14,61.56 ,33.33
03,018,01,003,0111,212 ,671,9,680,961,0,3,1,3,0,1,0,76.14,70.76 ,33.33
03,018,01,003,0111,213 ,616,9,625,963,0,3,1,3,0,1,0,76.14,64.90 ,33.33
03,018,01,003,0112,214 ,585,8,593,960,0,3,1,3,0,1,0,76.14,61.77 ,33.33
03,018,01,003,0113,215 ,1101,18,1119,1687,0,3,1,3,0,1,0,76.14,66.33 ,33.33
03,018,01,003,0114,216 ,667,10,677,941,0,3,1,3,0,1,0,76.14,71.94 ,33.33
03,018,01,003,0114,217 ,463,12,475,779,0,3,1,3,0,1,0,76.14,60.98 ,33.33
03,018,01,003,0115,218 ,740,16,756,1131,0,3,1,3,0,1,0,76.14,66.84 ,33.33
03,018,01,003,0116,219 ,1197,21,1218,1920,0,3,1,3,0,1,0,76.14,63.44 ,33.33
03,018,01,003,0116,220 ,750,9,759,1350,0,3,1,3,0,1,0,76.14,56.22 ,33.33
03,018,01,003,0117,221 ,478,8,486,755,0,3,1,3,0,1,0,76.14,64.37 ,33.33
03,018,01,003,0118,222 ,761,15,776,1250,0,3,1,3,0,1,0,76.14,62.08 ,33.33
03,018,01,003,0119,223 ,381,8,389,623,0,3,1,3,0,1,0,76.14,62.44 ,33.33
03,018,01,003,0120,224 ,471,8,479,680,0,3,1,3,0,1,0,76.14,70.44 ,33.33
03,018,01,003,0121,225 ,467,10,477,722,0,3,1,3,0,1,0,76.14,66.07 ,33.33
03,019,01,001,0001,1 ,595,12,607,926,0,3,1,3,0,1,0,76.14,65.55 ,33.33
03,019,01,001,0002,2 ,729,10,739,1051,0,3,1,3,0,1,0,76.14,70.31 ,33.33
03,019,01,001,0003,3 ,710,8,718,1116,0,3,1,3,0,1,0,76.14,64.34 ,33.33
03,019,01,001,0004,4 ,862,15,877,1409,0,3,1,3,0,1,0,76.14,62.24 ,33.33
03,019,01,001,0005,5 ,557,8,565,868,0,3,1,3,0,1,0,76.14,65.09 ,33.33
03,019,01,001,0006,6 ,839,14,853,1271,0,3,1,3,0,1,0,76.14,67.11 ,33.33
03,019,01,001,0007,7 ,703,11,714,1137,0,3,1,3,0,1,0,76.14,62.80 ,33.33
03,019,01,001,0008,8 ,920,16,936,1406,0,3,1,3,0,1,0,76.14,66.57 ,33.33
03,019,01,001,0009,9 ,706,12,718,1119,0,3,1,3,0,1,0,76.14,64.16 ,33.33
03,019,01,001,0010,10 ,721,14,735,1123,0,3,1,3,0,1,0,76.14,65.45 ,33.33
03,019,01,001,0011,11 ,643,15,658,1028,0,3,1,3,0,1,0,76.14,64.01 ,33.33
03,019,01,001,0012,12 ,774,16,790,1248,0,3,1,3,0,1,0,76.14,63.30 ,33.33
03,019,01,001,0013,13 ,776,13,789,1163,0,3,1,3,0,1,0,76.14,67.84 ,33.33
03,019,01,001,0014,14 ,701,10,711,1109,0,3,1,3,0,1,0,76.14,64.11 ,33.33
03,019,01,002,0015,15 ,710,15,725,1053,0,3,1,3,0,1,0,76.14,68.85 ,33.33
03,019,01,002,0016,16 ,405,13,418,651,0,3,1,3,0,1,0,76.14,64.21 ,33.33
03,019,01,002,0017,17 ,522,5,527,838,0,3,1,3,0,1,0,76.14,62.89 ,33.33
03,019,01,002,0018,18 ,617,7,624,897,0,3,1,3,0,1,0,76.14,69.57 ,33.33
03,019,01,002,0019,19 ,873,6,879,1298,0,3,1,3,0,1,0,76.14,67.72 ,33.33
03,019,01,002,0019,20 ,728,16,744,1087,0,3,1,3,0,1,0,76.14,68.45 ,33.33
03,019,01,002,0020,21 ,841,16,857,1286,0,3,1,3,0,1,0,76.14,66.64 ,33.33
03,019,01,002,0021,22 ,634,6,640,972,0,3,1,3,0,1,0,76.14,65.84 ,33.33
03,019,01,002,0022,23 ,816,13,829,1182,0,3,1,3,0,1,0,76.14,70.14 ,33.33
03,019,01,002,0022,24 ,864,12,876,1269,0,3,1,3,0,1,0,76.14,69.03 ,33.33
03,019,01,002,0022,25 ,855,13,868,1298,0,3,1,3,0,1,0,76.14,66.87 ,33.33
03,019,01,002,0023,26 ,688,7,695,975,0,3,1,3,0,1,0,76.14,71.28 ,33.33
03,019,01,002,0023,27 ,663,11,674,964,0,3,1,3,0,1,0,76.14,69.92 ,33.33
03,019,01,002,0024,28 ,512,12,524,818,0,3,1,3,0,1,0,76.14,64.06 ,33.33
03,019,01,002,0025,29 ,535,6,541,828,0,3,1,3,0,1,0,76.14,65.34 ,33.33
03,019,01,002,0026,30 ,741,2,743,1102,0,3,1,3,0,1,0,76.14,67.42 ,33.33
03,019,01,002,0027,31 ,429,7,436,644,0,3,1,3,0,1,0,76.14,67.70 ,33.33
03,019,01,002,0028,32 ,665,10,675,996,0,3,1,3,0,1,0,76.14,67.77 ,33.33
03,019,01,002,0029,33 ,974,9,983,1417,0,3,1,3,0,1,0,76.14,69.37 ,33.33
03,019,01,002,0030,34 ,897,23,920,1354,0,3,1,3,0,1,0,76.14,67.95 ,33.33
03,019,01,002,0031,35 ,883,22,905,1332,0,3,1,3,0,1,0,76.14,67.94 ,33.33
03,019,01,002,0031,36 ,835,17,852,1219,0,3,1,3,0,1,0,76.14,69.89 ,33.33
03,019,01,002,0031,37 ,914,15,929,1303,0,3,1,3,0,1,0,76.14,71.30 ,33.33
03,019,01,002,0031,38 ,726,6,732,1096,0,3,1,3,0,1,0,76.14,66.79 ,33.33
03,019,01,002,0032,39 ,740,18,758,1133,0,3,1,3,0,1,0,76.14,66.90 ,33.33
03,019,01,002,0032,40 ,883,5,888,1319,0,3,1,3,0,1,0,76.14,67.32 ,33.33
03,019,01,002,0032,41 ,748,13,761,1195,0,3,1,3,0,1,0,76.14,63.68 ,33.33
03,019,01,002,0032,42 ,743,15,758,1184,0,3,1,3,0,1,0,76.14,64.02 ,33.33
03,019,01,002,0032,43 ,748,13,761,1187,0,3,1,3,0,1,0,76.14,64.11 ,33.33
03,019,01,002,0033,44 ,840,12,852,1300,0,3,1,3,0,1,0,76.14,65.54 ,33.33
03,019,01,002,0033,45 ,867,13,880,1329,0,3,1,3,0,1,0,76.14,66.22 ,33.33
03,019,01,002,0033,46 ,526,11,537,771,0,3,1,3,0,1,0,76.14,69.65 ,33.33
03,019,01,002,0034,47 ,489,7,496,751,0,3,1,3,0,1,0,76.14,66.05 ,33.33
03,019,01,002,0034,48 ,473,11,484,768,0,3,1,3,0,1,0,76.14,63.02 ,33.33
03,019,01,002,0035,49 ,660,4,664,928,0,3,1,3,0,1,0,76.14,71.55 ,33.33
03,019,01,002,0035,50 ,662,7,669,992,0,3,1,3,0,1,0,76.14,67.44 ,33.33
03,019,01,002,0036,51 ,860,15,875,1335,0,3,1,3,0,1,0,76.14,65.54 ,33.33
03,019,01,002,0037,52 ,490,7,497,802,0,3,1,3,0,1,0,76.14,61.97 ,33.33
03,019,01,002,0038,53 ,869,22,891,1346,0,3,1,3,0,1,0,76.14,66.20 ,33.33
03,019,01,002,0039,54 ,494,7,501,732,0,3,1,3,0,1,0,76.14,68.44 ,33.33
03,019,01,002,0039,55 ,494,10,504,743,0,3,1,3,0,1,0,76.14,67.83 ,33.33
03,019,01,002,0040,56 ,925,19,944,1418,0,3,1,3,0,1,0,76.14,66.57 ,33.33
03,019,01,002,0041,57 ,904,15,919,1356,0,3,1,3,0,1,0,76.14,67.77 ,33.33
03,019,01,002,0041,58 ,868,9,877,1228,0,3,1,3,0,1,0,76.14,71.42 ,33.33
03,019,01,002,0041,59 ,842,18,860,1281,0,3,1,3,0,1,0,76.14,67.14 ,33.33
03,019,01,002,0041,60 ,660,10,670,977,0,3,1,3,0,1,0,76.14,68.58 ,33.33
03,019,01,003,0042,61 ,448,2,450,674,0,3,1,3,0,1,0,76.14,66.77 ,33.33
03,019,01,003,0043,62 ,459,4,463,710,0,3,1,3,0,1,0,76.14,65.21 ,33.33
03,019,01,003,0044,63 ,555,8,563,790,0,3,1,3,0,1,0,76.14,71.27 ,33.33
03,019,01,003,0045,64 ,1151,16,1167,1711,0,3,1,3,0,1,0,76.14,68.21 ,33.33
03,019,01,003,0046,65 ,634,17,651,968,0,3,1,3,0,1,0,76.14,67.25 ,33.33
03,019,01,003,0047,66 ,745,13,758,1064,0,3,1,3,0,1,0,76.14,71.24 ,33.33
03,019,01,003,0048,67 ,920,17,937,1392,0,3,1,3,0,1,0,76.14,67.31 ,33.33
03,019,01,003,0049,68 ,673,8,681,1026,0,3,1,3,0,1,0,76.14,66.37 ,33.33
03,019,01,003,0050,69 ,1224,18,1242,1887,0,3,1,3,0,1,0,76.14,65.82 ,33.33
03,019,01,003,0050,70 ,1057,17,1074,1531,0,3,1,3,0,1,0,76.14,70.15 ,33.33
03,019,01,003,0051,71 ,1022,25,1047,1582,0,3,1,3,0,1,0,76.14,66.18 ,33.33
03,019,01,003,0051,72 ,1034,15,1049,1575,0,3,1,3,0,1,0,76.14,66.60 ,33.33
03,019,01,003,0052,73 ,730,12,742,1111,0,3,1,3,0,1,0,76.14,66.79 ,33.33
03,019,01,003,0052,74 ,895,11,906,1331,0,3,1,3,0,1,0,76.14,68.07 ,33.33
03,019,01,003,0053,75 ,744,14,758,1187,0,3,1,3,0,1,0,76.14,63.86 ,33.33
03,019,01,003,0053,76 ,1001,20,1021,1511,0,3,1,3,0,1,0,76.14,67.57 ,33.33
03,019,01,003,0054,77 ,1241,17,1258,1814,0,3,1,3,0,1,0,76.14,69.35 ,33.33
03,019,01,003,0055,78 ,897,13,910,1534,0,3,1,3,0,1,0,76.14,59.32 ,33.33
03,019,01,003,0055,79 ,763,13,776,1410,0,3,1,3,0,1,0,76.14,55.04 ,33.33
03,019,01,003,0056,80 ,845,15,860,1268,0,3,1,3,0,1,0,76.14,67.82 ,33.33
03,019,01,003,0056,81 ,981,16,997,1479,0,3,1,3,0,1,0,76.14,67.41 ,33.33
03,019,01,003,0057,82 ,1105,16,1121,1768,0,3,1,3,0,1,0,76.14,63.40 ,33.33
03,019,01,003,0057,83 ,1125,23,1148,1774,0,3,1,3,0,1,0,76.14,64.71 ,33.33
03,019,01,003,0057,84 ,1121,18,1139,1800,0,3,1,3,0,1,0,76.14,63.28 ,33.33
03,019,01,003,0057,85 ,1133,26,1159,1819,0,3,1,3,0,1,0,76.14,63.72 ,33.33
03,019,01,003,0058,86 ,1283,16,1299,2095,0,3,1,3,0,1,0,76.14,62.00 ,33.33
03,019,01,003,0058,87 ,1081,11,1092,1811,0,3,1,3,0,1,0,76.14,60.30 ,33.33
03,019,01,003,0058,88 ,915,22,937,1399,0,3,1,3,0,1,0,76.14,66.98 ,33.33
03,019,01,003,0058,89 ,914,16,930,1404,0,3,1,3,0,1,0,76.14,66.24 ,33.33
03,019,01,003,0058,90 ,1316,24,1340,2063,0,3,1,3,0,1,0,76.14,64.95 ,33.33
03,019,01,003,0059,91 ,925,10,935,1419,0,3,1,3,0,1,0,76.14,65.89 ,33.33
03,019,01,003,0059,92 ,993,17,1010,1547,0,3,1,3,0,1,0,76.14,65.29 ,33.33
03,019,01,003,0059,93 ,894,15,909,1508,0,3,1,3,0,1,0,76.14,60.28 ,33.33
03,019,01,003,0059,94 ,764,11,775,1253,0,3,1,3,0,1,0,76.14,61.85 ,33.33
03,019,01,003,0059,95 ,943,14,957,1479,0,3,1,3,0,1,0,76.14,64.71 ,33.33
03,019,01,003,0060,96 ,1002,15,1017,1576,0,3,1,3,0,1,0,76.14,64.53 ,33.33
03,019,01,003,0060,97 ,1062,19,1081,1655,0,3,1,3,0,1,0,76.14,65.32 ,33.33
03,019,01,003,0060,98 ,1031,20,1051,1663,0,3,1,3,0,1,0,76.14,63.20 ,33.33
03,019,01,003,0060,99 ,906,10,916,1528,0,3,1,3,0,1,0,76.14,59.95 ,33.33
03,019,01,003,0060,100 ,1080,28,1108,1738,0,3,1,3,0,1,0,76.14,63.75 ,33.33
03,019,01,003,0061,101 ,1159,20,1179,1952,0,3,1,3,0,1,0,76.14,60.40 ,33.33
03,019,01,003,0061,102 ,1033,22,1055,1694,0,3,1,3,0,1,0,76.14,62.28 ,33.33
03,019,01,003,0062,103 ,948,13,961,1361,0,3,1,3,0,1,0,76.14,70.61 ,33.33
03,019,01,003,0062,104 ,1218,22,1240,1891,0,3,1,3,0,1,0,76.14,65.57 ,33.33
03,019,01,003,0062,105 ,925,13,938,1350,0,3,1,3,0,1,0,76.14,69.48 ,33.33
03,019,01,003,0062,106 ,957,13,970,1442,0,3,1,3,0,1,0,76.14,67.27 ,33.33
03,019,01,004,0063,107 ,973,13,986,1425,0,3,1,3,0,1,0,76.14,69.19 ,33.33
03,019,01,004,0064,108 ,439,6,445,627,0,3,1,3,0,1,0,76.14,70.97 ,33.33
03,019,01,004,0065,109 ,617,9,626,929,0,3,1,3,0,1,0,76.14,67.38 ,33.33
03,019,01,004,0065,110 ,671,10,681,1111,0,3,1,3,0,1,0,76.14,61.30 ,33.33
03,019,01,004,0066,111 ,966,9,975,1542,0,3,1,3,0,1,0,76.14,63.23 ,33.33
03,019,01,004,0067,112 ,964,12,976,1430,0,3,1,3,0,1,0,76.14,68.25 ,33.33
03,019,01,004,0067,113 ,842,19,861,1257,0,3,1,3,0,1,0,76.14,68.50 ,33.33
03,019,01,004,0067,114 ,866,17,883,1318,0,3,1,3,0,1,0,76.14,67.00 ,33.33
03,019,01,004,0068,115 ,787,11,798,1096,0,3,1,3,0,1,0,76.14,72.81 ,33.33
03,019,01,004,0068,116 ,565,7,572,809,0,3,1,3,0,1,0,76.14,70.70 ,33.33
03,019,01,004,0069,117 ,732,19,751,1056,0,3,1,3,0,1,0,76.14,71.12 ,33.33
03,019,01,004,0069,118 ,911,9,920,1325,0,3,1,3,0,1,0,76.14,69.43 ,33.33
03,019,01,004,0070,119 ,955,18,973,1413,0,3,1,3,0,1,0,76.14,68.86 ,33.33
03,019,01,004,0070,120 ,1158,18,1176,1665,0,3,1,3,0,1,0,76.14,70.63 ,33.33
03,019,01,004,0070,121 ,886,16,902,1458,0,3,1,3,0,1,0,76.14,61.87 ,33.33
03,019,01,004,0071,122 ,508,11,519,772,0,3,1,3,0,1,0,76.14,67.23 ,33.33
03,019,01,004,0072,123 ,1022,12,1034,1606,0,3,1,3,0,1,0,76.14,64.38 ,33.33
03,019,01,004,0073,124 ,778,8,786,1201,0,3,1,3,0,1,0,76.14,65.45 ,33.33
03,019,01,004,0074,125 ,752,7,759,1136,0,3,1,3,0,1,0,76.14,66.81 ,33.33
03,019,01,004,0075,126 ,883,9,892,1322,0,3,1,3,0,1,0,76.14,67.47 ,33.33
03,019,01,004,0076,127 ,742,9,751,1143,0,3,1,3,0,1,0,76.14,65.70 ,33.33
03,019,01,004,0077,128 ,665,16,681,1073,0,3,1,3,0,1,0,76.14,63.47 ,33.33
03,019,01,004,0077,129 ,668,11,679,979,0,3,1,3,0,1,0,76.14,69.36 ,33.33
03,019,01,004,0078,130 ,774,13,787,1209,0,3,1,3,0,1,0,76.14,65.10 ,33.33
03,019,01,004,0079,131 ,560,5,565,918,0,3,1,3,0,1,0,76.14,61.55 ,33.33
03,019,01,004,0079,132 ,595,6,601,911,0,3,1,3,0,1,0,76.14,65.97 ,33.33
03,019,01,004,0080,133 ,626,5,631,943,0,3,1,3,0,1,0,76.14,66.91 ,33.33
03,019,01,004,0080,134 ,633,8,641,966,0,3,1,3,0,1,0,76.14,66.36 ,33.33
03,019,01,004,0081,135 ,671,6,677,984,0,3,1,3,0,1,0,76.14,68.80 ,33.33
03,019,01,004,0082,136 ,798,13,811,1187,0,3,1,3,0,1,0,76.14,68.32 ,33.33
03,019,01,004,0082,137 ,620,15,635,995,0,3,1,3,0,1,0,76.14,63.82 ,33.33
03,019,01,004,0083,138 ,861,10,871,1234,0,3,1,3,0,1,0,76.14,70.58 ,33.33
03,019,01,004,0083,139 ,999,10,1009,1485,0,3,1,3,0,1,0,76.14,67.95 ,33.33
03,019,01,004,0083,140 ,1013,18,1031,1501,0,3,1,3,0,1,0,76.14,68.69 ,33.33
03,019,01,004,0083,141 ,907,13,920,1326,0,3,1,3,0,1,0,76.14,69.38 ,33.33
03,019,01,004,0084,142 ,846,10,856,1227,0,3,1,3,0,1,0,76.14,69.76 ,33.33
03,019,01,004,0084,143 ,796,10,806,1236,0,3,1,3,0,1,0,76.14,65.21 ,33.33
03,019,01,004,0084,144 ,843,14,857,1344,0,3,1,3,0,1,0,76.14,63.76 ,33.33
03,019,01,004,0085,145 ,889,9,898,1398,0,3,1,3,0,1,0,76.14,64.23 ,33.33
03,019,01,004,0085,146 ,915,13,928,1381,0,3,1,3,0,1,0,76.14,67.20 ,33.33
03,019,01,004,0085,147 ,1020,12,1032,1563,0,3,1,3,0,1,0,76.14,66.03 ,33.33
03,019,01,004,0086,148 ,785,12,797,1265,0,3,1,3,0,1,0,76.14,63.00 ,33.33
03,019,01,004,0086,149 ,902,11,913,1373,0,3,1,3,0,1,0,76.14,66.50 ,33.33
03,019,01,004,0086,150 ,705,9,714,1064,0,3,1,3,0,1,0,76.14,67.11 ,33.33
03,019,01,004,0086,151 ,789,10,799,1177,0,3,1,3,0,1,0,76.14,67.88 ,33.33
03,019,01,004,0087,152 ,1076,19,1095,1620,0,3,1,3,0,1,0,76.14,67.59 ,33.33
03,019,01,004,0087,153 ,887,5,892,1332,0,3,1,3,0,1,0,76.14,66.97 ,33.33
03,019,01,004,0087,154 ,728,12,740,1192,0,3,1,3,0,1,0,76.14,62.08 ,33.33
03,019,01,004,0087,155 ,631,10,641,960,0,3,1,3,0,1,0,76.14,66.77 ,33.33
03,019,01,004,0087,156 ,867,8,875,1383,0,3,1,3,0,1,0,76.14,63.27 ,33.33
03,019,01,004,0087,157 ,1038,9,1047,1559,0,3,1,3,0,1,0,76.14,67.16 ,33.33
03,019,01,004,0087,158 ,1017,8,1025,1517,0,3,1,3,0,1,0,76.14,67.57 ,33.33
03,019,01,004,0087,159 ,731,8,739,1146,0,3,1,3,0,1,0,76.14,64.49 ,33.33
03,019,01,004,0088,160 ,885,12,897,1267,0,3,1,3,0,1,0,76.14,70.80 ,33.33
03,019,01,004,0088,161 ,908,19,927,1314,0,3,1,3,0,1,0,76.14,70.55 ,33.33
03,019,01,004,0089,162 ,950,10,960,1420,0,3,1,3,0,1,0,76.14,67.61 ,33.33
03,019,01,004,0089,163 ,1136,23,1159,1668,0,3,1,3,0,1,0,76.14,69.48 ,33.33
03,019,01,004,0090,164 ,913,11,924,1349,0,3,1,3,0,1,0,76.14,68.50 ,33.33
03,019,01,004,0090,165 ,1047,16,1063,1605,0,3,1,3,0,1,0,76.14,66.23 ,33.33
03,019,01,004,0090,166 ,839,10,849,1266,0,3,1,3,0,1,0,76.14,67.06 ,33.33
03,019,01,004,0090,167 ,950,17,967,1449,0,3,1,3,0,1,0,76.14,66.74 ,33.33
03,019,01,004,0090,168 ,951,21,972,1479,0,3,1,3,0,1,0,76.14,65.72 ,33.33
03,019,01,005,0091,169 ,609,10,619,926,0,3,1,3,0,1,0,76.14,66.85 ,33.33
03,019,01,005,0092,170 ,547,9,556,841,0,3,1,3,0,1,0,76.14,66.11 ,33.33
03,019,01,005,0093,171 ,598,9,607,923,0,3,1,3,0,1,0,76.14,65.76 ,33.33
03,019,01,005,0094,172 ,534,11,545,856,0,3,1,3,0,1,0,76.14,63.67 ,33.33
03,019,01,005,0095,173 ,569,12,581,858,0,3,1,3,0,1,0,76.14,67.72 ,33.33
03,019,01,005,0095,174 ,615,10,625,969,0,3,1,3,0,1,0,76.14,64.50 ,33.33
03,019,01,005,0096,175 ,673,12,685,1004,0,3,1,3,0,1,0,76.14,68.23 ,33.33
03,019,01,005,0096,176 ,638,6,644,1020,0,3,1,3,0,1,0,76.14,63.14 ,33.33
03,019,01,005,0097,177 ,560,7,567,931,0,3,1,3,0,1,0,76.14,60.90 ,33.33
03,019,01,005,0098,178 ,784,8,792,1281,0,3,1,3,0,1,0,76.14,61.83 ,33.33
03,019,01,005,0099,179 ,789,9,798,1221,0,3,1,3,0,1,0,76.14,65.36 ,33.33
03,019,01,005,0100,180 ,1062,12,1074,1678,0,3,1,3,0,1,0,76.14,64.00 ,33.33
03,019,01,005,0101,181 ,493,6,499,721,0,3,1,3,0,1,0,76.14,69.21 ,33.33
03,019,01,005,0102,182 ,765,7,772,1187,0,3,1,3,0,1,0,76.14,65.04 ,33.33
03,019,01,005,0103,183 ,510,5,515,824,0,3,1,3,0,1,0,76.14,62.50 ,33.33
03,019,01,005,0104,184 ,852,19,871,1346,0,3,1,3,0,1,0,76.14,64.71 ,33.33
03,019,01,005,0104,185 ,536,6,542,923,0,3,1,3,0,1,0,76.14,58.72 ,33.33
03,019,01,005,0105,186 ,724,11,735,1036,0,3,1,3,0,1,0,76.14,70.95 ,33.33
03,019,01,005,0105,187 ,823,14,837,1196,0,3,1,3,0,1,0,76.14,69.98 ,33.33
03,019,01,005,0105,188 ,454,15,469,766,0,3,1,3,0,1,0,76.14,61.23 ,33.33
03,019,01,005,0106,189 ,622,8,630,918,0,3,1,3,0,1,0,76.14,68.63 ,33.33
03,019,01,005,0106,190 ,599,7,606,903,0,3,1,3,0,1,0,76.14,67.11 ,33.33
03,019,01,005,0106,191 ,776,15,791,1134,0,3,1,3,0,1,0,76.14,69.75 ,33.33
03,019,01,005,0107,192 ,1132,17,1149,1688,0,3,1,3,0,1,0,76.14,68.07 ,33.33
03,019,01,005,0107,193 ,1011,11,1022,1501,0,3,1,3,0,1,0,76.14,68.09 ,33.33
03,019,01,005,0107,194 ,616,15,631,1081,0,3,1,3,0,1,0,76.14,58.37 ,33.33
03,019,01,005,0107,195 ,770,9,779,1227,0,3,1,3,0,1,0,76.14,63.49 ,33.33
03,019,01,005,0107,196 ,883,15,898,1340,0,3,1,3,0,1,0,76.14,67.01 ,33.33
03,019,01,005,0108,197 ,906,19,925,1347,0,3,1,3,0,1,0,76.14,68.67 ,33.33
03,019,01,005,0108,198 ,1079,7,1086,1617,0,3,1,3,0,1,0,76.14,67.16 ,33.33
03,019,01,005,0109,199 ,841,11,852,1425,0,3,1,3,0,1,0,76.14,59.79 ,33.33
03,019,01,005,0109,200 ,979,12,991,1589,0,3,1,3,0,1,0,76.14,62.37 ,33.33
03,019,01,005,0110,201 ,1023,19,1042,1664,0,3,1,3,0,1,0,76.14,62.62 ,33.33
03,019,01,005,0111,202 ,868,7,875,1357,0,3,1,3,0,1,0,76.14,64.48 ,33.33
03,019,01,005,0111,203 ,863,13,876,1398,0,3,1,3,0,1,0,76.14,62.66 ,33.33
03,019,01,005,0111,204 ,810,11,821,1312,0,3,1,3,0,1,0,76.14,62.58 ,33.33
03,019,01,005,0112,205 ,748,10,758,1201,0,3,1,3,0,1,0,76.14,63.11 ,33.33
03,019,01,005,0112,206 ,497,4,501,901,0,3,1,3,0,1,0,76.14,55.60 ,33.33
03,019,01,005,0113,207 ,834,7,841,1364,0,3,1,3,0,1,0,76.14,61.66 ,33.33
03,019,01,005,0113,208 ,721,17,738,1134,0,3,1,3,0,1,0,76.14,65.08 ,33.33
03,019,01,005,0113,209 ,776,11,787,1222,0,3,1,3,0,1,0,76.14,64.40 ,33.33
03,019,01,005,0113,210 ,794,8,802,1274,0,3,1,3,0,1,0,76.14,62.95 ,33.33
03,019,01,005,0114,211 ,779,8,787,1184,0,3,1,3,0,1,0,76.14,66.47 ,33.33
03,019,01,005,0114,212 ,957,11,968,1515,0,3,1,3,0,1,0,76.14,63.89 ,33.33
03,019,01,005,0114,213 ,931,5,936,1469,0,3,1,3,0,1,0,76.14,63.72 ,33.33
03,019,01,005,0114,214 ,1077,19,1096,1742,0,3,1,3,0,1,0,76.14,62.92 ,33.33
03,019,01,005,0115,215 ,1119,22,1141,1807,0,3,1,3,0,1,0,76.14,63.14 ,33.33
03,019,01,005,0115,216 ,734,9,743,1097,0,3,1,3,0,1,0,76.14,67.73 ,33.33
03,019,01,005,0115,217 ,1248,11,1259,2152,0,3,1,3,0,1,0,76.14,58.50 ,33.33
03,019,01,005,0116,218 ,982,11,993,1597,0,3,1,3,0,1,0,76.14,62.18 ,33.33
03,019,01,005,0116,219 ,968,17,985,1562,0,3,1,3,0,1,0,76.14,63.06 ,33.33
03,019,01,005,0116,220 ,1152,18,1170,1850,0,3,1,3,0,1,0,76.14,63.24 ,33.33
03,019,01,005,0117,221 ,856,12,868,1484,0,3,1,3,0,1,0,76.14,58.49 ,33.33
03,019,01,005,0117,222 ,942,13,955,1565,0,3,1,3,0,1,0,76.14,61.02 ,33.33
03,019,01,005,0117,223 ,913,9,922,1486,0,3,1,3,0,1,0,76.14,62.05 ,33.33
03,019,01,005,0117,224 ,988,3,991,1450,0,3,1,3,0,1,0,76.14,68.34 ,33.33
03,019,01,005,0118,225 ,828,18,846,1263,0,3,1,3,0,1,0,76.14,66.98 ,33.33
03,019,01,005,0118,226 ,803,11,814,1332,0,3,1,3,0,1,0,76.14,61.11 ,33.33
03,019,01,005,0118,227 ,798,4,802,1196,0,3,1,3,0,1,0,76.14,67.06 ,33.33
03,019,01,005,0119,228 ,1023,17,1040,1588,0,3,1,3,0,1,0,76.14,65.49 ,33.33
03,019,01,005,0119,229 ,1017,10,1027,1573,0,3,1,3,0,1,0,76.14,65.29 ,33.33
03,019,01,005,0120,230 ,890,16,906,1349,0,3,1,3,0,1,0,76.14,67.16 ,33.33
03,019,01,005,0120,231 ,766,18,784,1155,0,3,1,3,0,1,0,76.14,67.88 ,33.33
03,019,01,005,0120,232 ,771,6,777,1116,0,3,1,3,0,1,0,76.14,69.62 ,33.33
03,019,01,005,0121,233 ,801,11,812,1138,0,3,1,3,0,1,0,76.14,71.35 ,33.33
03,019,01,005,0121,234 ,893,13,906,1290,0,3,1,3,0,1,0,76.14,70.23 ,33.33
03,019,01,005,0121,235 ,1034,18,1052,1560,0,3,1,3,0,1,0,76.14,67.44 ,33.33
03,019,01,005,0121,236 ,908,6,914,1449,0,3,1,3,0,1,0,76.14,63.08 ,33.33
03,019,01,005,0122,237 ,619,10,629,961,0,3,1,3,0,1,0,76.14,65.45 ,33.33
03,019,01,005,0122,238 ,1073,14,1087,1607,0,3,1,3,0,1,0,76.14,67.64 ,33.33
03,019,01,005,0122,239 ,814,14,828,1338,0,3,1,3,0,1,0,76.14,61.88 ,33.33
03,019,01,005,0122,240 ,873,16,889,1351,0,3,1,3,0,1,0,76.14,65.80 ,33.33
03,019,01,005,0122,241 ,816,13,829,1231,0,3,1,3,0,1,0,76.14,67.34 ,33.33
03,019,01,005,0123,242 ,909,17,926,1438,0,3,1,3,0,1,0,76.14,64.39 ,33.33
03,019,01,005,0123,243 ,1088,21,1109,1773,0,3,1,3,0,1,0,76.14,62.55 ,33.33
03,019,01,005,0123,244 ,842,12,854,1374,0,3,1,3,0,1,0,76.14,62.15 ,33.33
03,019,01,005,0123,245 ,1048,18,1066,1578,0,3,1,3,0,1,0,76.14,67.55 ,33.33
03,019,01,005,0123,246 ,838,11,849,1336,0,3,1,3,0,1,0,76.14,63.55 ,33.33
03,019,01,005,0124,247 ,844,13,857,1263,0,3,1,3,0,1,0,76.14,67.85 ,33.33
03,019,01,005,0124,248 ,874,15,889,1256,0,3,1,3,0,1,0,76.14,70.78 ,33.33
03,019,01,006,0125,249 ,1285,14,1299,1923,0,3,1,3,0,1,0,76.14,67.55 ,33.33
03,019,01,006,0125,250 ,871,14,885,1372,0,3,1,3,0,1,0,76.14,64.50 ,33.33
03,019,01,006,0125,251 ,968,15,983,1452,0,3,1,3,0,1,0,76.14,67.70 ,33.33
03,019,01,006,0125,252 ,834,11,845,1321,0,3,1,3,0,1,0,76.14,63.97 ,33.33
03,019,01,006,0126,253 ,934,10,944,1457,0,3,1,3,0,1,0,76.14,64.79 ,33.33
03,019,01,006,0126,254 ,900,19,919,1448,0,3,1,3,0,1,0,76.14,63.47 ,33.33
03,019,01,006,0126,255 ,1027,9,1036,1447,0,3,1,3,0,1,0,76.14,71.60 ,33.33
03,019,01,006,0127,256 ,1186,23,1209,1865,0,3,1,3,0,1,0,76.14,64.83 ,33.33
03,019,01,006,0127,257 ,1145,15,1160,1787,0,3,1,3,0,1,0,76.14,64.91 ,33.33
03,019,01,006,0128,258 ,1339,11,1350,1886,0,3,1,3,0,1,0,76.14,71.58 ,33.33
03,019,01,006,0129,259 ,734,11,745,1001,0,3,1,3,0,1,0,76.14,74.43 ,33.33
03,019,01,006,0130,260 ,1156,18,1174,1728,0,3,1,3,0,1,0,76.14,67.94 ,33.33
03,019,01,006,0130,261 ,719,14,733,1080,0,3,1,3,0,1,0,76.14,67.87 ,33.33
03,019,01,006,0130,262 ,1037,12,1049,1559,0,3,1,3,0,1,0,76.14,67.29 ,33.33
03,019,01,006,0131,263 ,985,10,995,1424,0,3,1,3,0,1,0,76.14,69.87 ,33.33
03,019,01,006,0131,264 ,929,22,951,1576,0,3,1,3,0,1,0,76.14,60.34 ,33.33
03,019,01,006,0131,265 ,1203,23,1226,1991,0,3,1,3,0,1,0,76.14,61.58 ,33.33
03,019,01,006,0131,266 ,1123,19,1142,1865,0,3,1,3,0,1,0,76.14,61.23 ,33.33
03,019,01,006,0131,267 ,1105,19,1124,1676,0,3,1,3,0,1,0,76.14,67.06 ,33.33
03,019,01,006,0132,268 ,969,11,980,1527,0,3,1,3,0,1,0,76.14,64.18 ,33.33
03,019,01,006,0132,269 ,951,16,967,1459,0,3,1,3,0,1,0,76.14,66.28 ,33.33
03,019,01,006,0132,270 ,1047,26,1073,1572,0,3,1,3,0,1,0,76.14,68.26 ,33.33
03,019,01,006,0132,271 ,835,12,847,1342,0,3,1,3,0,1,0,76.14,63.11 ,33.33
03,019,01,006,0132,272 ,957,14,971,1425,0,3,1,3,0,1,0,76.14,68.14 ,33.33
03,019,01,006,0133,273 ,688,8,696,1133,0,3,1,3,0,1,0,76.14,61.43 ,33.33
03,019,01,006,0133,274 ,1027,17,1044,1523,0,3,1,3,0,1,0,76.14,68.55 ,33.33
03,019,01,006,0133,275 ,941,9,950,1438,0,3,1,3,0,1,0,76.14,66.06 ,33.33
03,019,01,006,0133,276 ,830,8,838,1346,0,3,1,3,0,1,0,76.14,62.26 ,33.33
03,019,01,006,0134,277 ,1063,13,1076,1598,0,3,1,3,0,1,0,76.14,67.33 ,33.33
03,019,01,006,0134,278 ,969,12,981,1462,0,3,1,3,0,1,0,76.14,67.10 ,33.33
03,019,01,006,0134,279 ,959,8,967,1477,0,3,1,3,0,1,0,76.14,65.47 ,33.33
03,019,01,006,0134,280 ,855,7,862,1263,0,3,1,3,0,1,0,76.14,68.25 ,33.33
03,019,01,006,0134,281 ,1347,21,1368,2096,0,3,1,3,0,1,0,76.14,65.27 ,33.33
03,019,01,006,0135,282 ,775,8,783,1155,0,3,1,3,0,1,0,76.14,67.79 ,33.33
03,019,01,006,0135,283 ,818,4,822,1272,0,3,1,3,0,1,0,76.14,64.62 ,33.33
03,019,01,006,0135,284 ,785,13,798,1219,0,3,1,3,0,1,0,76.14,65.46 ,33.33
03,019,01,006,0136,285 ,987,18,1005,1555,0,3,1,3,0,1,0,76.14,64.63 ,33.33
03,019,01,006,0136,286 ,959,10,969,1503,0,3,1,3,0,1,0,76.14,64.47 ,33.33
03,019,01,006,0136,287 ,951,14,965,1596,0,3,1,3,0,1,0,76.14,60.46 ,33.33
03,019,01,006,0137,288 ,1023,11,1034,1539,0,3,1,3,0,1,0,76.14,67.19 ,33.33
03,019,01,006,0137,289 ,1132,17,1149,1767,0,3,1,3,0,1,0,76.14,65.03 ,33.33
03,019,01,006,0137,290 ,1001,10,1011,1480,0,3,1,3,0,1,0,76.14,68.31 ,33.33
03,019,01,006,0137,291 ,838,17,855,1301,0,3,1,3,0,1,0,76.14,65.72 ,33.33
03,019,01,006,0138,292 ,1085,16,1101,1637,0,3,1,3,0,1,0,76.14,67.26 ,33.33
03,019,01,006,0138,293 ,1022,12,1034,1534,0,3,1,3,0,1,0,76.14,67.41 ,33.33
03,019,01,006,0138,294 ,827,19,846,1306,0,3,1,3,0,1,0,76.14,64.78 ,33.33
03,019,01,006,0139,295 ,1243,25,1268,1840,0,3,1,3,0,1,0,76.14,68.91 ,33.33
03,019,01,006,0139,296 ,878,19,897,1280,0,3,1,3,0,1,0,76.14,70.08 ,33.33
03,019,01,006,0140,297 ,698,7,705,983,0,3,1,3,0,1,0,76.14,71.72 ,33.33
03,019,01,006,0141,298 ,937,19,956,1405,0,3,1,3,0,1,0,76.14,68.04 ,33.33
03,019,01,006,0141,299 ,803,10,813,1264,0,3,1,3,0,1,0,76.14,64.32 ,33.33
03,019,01,006,0142,300 ,875,11,886,1253,0,3,1,3,0,1,0,76.14,70.71 ,33.33
03,019,01,006,0142,301 ,791,17,808,1214,0,3,1,3,0,1,0,76.14,66.56 ,33.33
03,019,01,006,0142,302 ,825,10,835,1304,0,3,1,3,0,1,0,76.14,64.03 ,33.33
03,019,01,006,0143,303 ,655,13,668,939,0,3,1,3,0,1,0,76.14,71.14 ,33.33
03,019,01,006,0143,304 ,909,14,923,1379,0,3,1,3,0,1,0,76.14,66.93 ,33.33
03,019,01,006,0143,305 ,917,11,928,1391,0,3,1,3,0,1,0,76.14,66.71 ,33.33
03,019,01,006,0143,306 ,588,7,595,772,0,3,1,3,0,1,0,76.14,77.07 ,33.33
03,019,01,006,0144,307 ,654,13,667,955,0,3,1,3,0,1,0,76.14,69.84 ,33.33
03,019,01,006,0144,308 ,683,15,698,1011,0,3,1,3,0,1,0,76.14,69.04 ,33.33
03,019,01,006,0145,309 ,735,22,757,1168,0,3,1,3,0,1,0,76.14,64.81 ,33.33
03,019,01,006,0145,310 ,757,11,768,1182,0,3,1,3,0,1,0,76.14,64.97 ,33.33
03,019,01,006,0146,311 ,1068,19,1087,1629,0,3,1,3,0,1,0,76.14,66.73 ,33.33
03,019,01,006,0146,312 ,1115,16,1131,1677,0,3,1,3,0,1,0,76.14,67.44 ,33.33
03,019,01,006,0146,313 ,1033,23,1056,1644,0,3,1,3,0,1,0,76.14,64.23 ,33.33
03,019,01,006,0147,314 ,950,18,968,1532,0,3,1,3,0,1,0,76.14,63.19 ,33.33
03,019,01,006,0147,315 ,936,15,951,1491,0,3,1,3,0,1,0,76.14,63.78 ,33.33
03,019,01,006,0147,316 ,900,7,907,1427,0,3,1,3,0,1,0,76.14,63.56 ,33.33
03,019,01,006,0147,317 ,914,20,934,1382,0,3,1,3,0,1,0,76.14,67.58 ,33.33
03,019,01,006,0147,318 ,828,13,841,1297,0,3,1,3,0,1,0,76.14,64.84 ,33.33
03,019,01,006,0147,319 ,876,12,888,1606,0,3,1,3,0,1,0,76.14,55.29 ,33.33
03,019,01,006,0147,320 ,1030,13,1043,1745,0,3,1,3,0,1,0,76.14,59.77 ,33.33
03,019,01,006,0147,321 ,1032,8,1040,1659,0,3,1,3,0,1,0,76.14,62.69 ,33.33
03,019,01,006,0147,322 ,896,14,910,1460,0,3,1,3,0,1,0,76.14,62.33 ,33.33
03,019,01,006,0147,323 ,1017,10,1027,1491,0,3,1,3,0,1,0,76.14,68.88 ,33.33
03,019,01,006,0147,324 ,1017,12,1029,1653,0,3,1,3,0,1,0,76.14,62.25 ,33.33
03,019,01,006,0147,325 ,954,13,967,1524,0,3,1,3,0,1,0,76.14,63.45 ,33.33
03,019,01,006,0147,326 ,797,9,806,1206,0,3,1,3,0,1,0,76.14,66.83 ,33.33
03,019,01,006,0148,327 ,589,11,600,909,0,3,1,3,0,1,0,76.14,66.01 ,33.33
03,019,01,006,0148,328 ,653,15,668,940,0,3,1,3,0,1,0,76.14,71.06 ,33.33
03,019,01,006,0148,329 ,644,16,660,1009,0,3,1,3,0,1,0,76.14,65.41 ,33.33
03,019,01,007,0149,330 ,943,16,959,1413,0,3,1,3,0,1,0,76.14,67.87 ,33.33
03,019,01,007,0149,331 ,1049,21,1070,1663,0,3,1,3,0,1,0,76.14,64.34 ,33.33
03,019,01,007,0149,332 ,1130,20,1150,1682,0,3,1,3,0,1,0,76.14,68.37 ,33.33
03,019,01,007,0150,333 ,1113,15,1128,1617,0,3,1,3,0,1,0,76.14,69.76 ,33.33
03,019,01,007,0150,334 ,1097,14,1111,1658,0,3,1,3,0,1,0,76.14,67.01 ,33.33
03,019,01,007,0150,335 ,1259,19,1278,1932,0,3,1,3,0,1,0,76.14,66.15 ,33.33
03,019,01,007,0151,336 ,801,19,820,1186,0,3,1,3,0,1,0,76.14,69.14 ,33.33
03,019,01,007,0151,337 ,946,18,964,1344,0,3,1,3,0,1,0,76.14,71.73 ,33.33
03,019,01,007,0151,338 ,852,15,867,1224,0,3,1,3,0,1,0,76.14,70.83 ,33.33
03,019,01,007,0152,339 ,751,14,765,1150,0,3,1,3,0,1,0,76.14,66.52 ,33.33
03,019,01,007,0152,340 ,770,13,783,1136,0,3,1,3,0,1,0,76.14,68.93 ,33.33
03,019,01,007,0152,341 ,818,16,834,1176,0,3,1,3,0,1,0,76.14,70.92 ,33.33
03,019,01,007,0153,342 ,453,15,468,638,0,3,1,3,0,1,0,76.14,73.35 ,33.33
03,019,01,007,0153,343 ,669,15,684,924,0,3,1,3,0,1,0,76.14,74.03 ,33.33
03,019,01,007,0154,344 ,991,14,1005,1525,0,3,1,3,0,1,0,76.14,65.90 ,33.33
03,019,01,007,0154,345 ,885,21,906,1363,0,3,1,3,0,1,0,76.14,66.47 ,33.33
03,019,01,007,0155,346 ,1073,19,1092,1610,0,3,1,3,0,1,0,76.14,67.83 ,33.33
03,019,01,007,0155,347 ,1158,26,1184,1722,0,3,1,3,0,1,0,76.14,68.76 ,33.33
03,019,01,007,0155,348 ,652,18,670,929,0,3,1,3,0,1,0,76.14,72.12 ,33.33
03,019,01,007,0155,349 ,446,8,454,750,0,3,1,3,0,1,0,76.14,60.53 ,33.33
03,019,01,007,0156,350 ,644,11,655,862,0,3,1,3,0,1,0,76.14,75.99 ,33.33
03,019,01,007,0156,351 ,707,9,716,966,0,3,1,3,0,1,0,76.14,74.12 ,33.33
03,019,01,007,0157,352 ,841,12,853,1432,0,3,1,3,0,1,0,76.14,59.57 ,33.33
03,019,01,007,0157,353 ,911,15,926,1447,0,3,1,3,0,1,0,76.14,63.99 ,33.33
03,019,01,007,0157,354 ,1129,13,1142,1754,0,3,1,3,0,1,0,76.14,65.11 ,33.33
03,019,01,007,0157,355 ,803,12,815,1229,0,3,1,3,0,1,0,76.14,66.31 ,33.33
03,019,01,007,0157,356 ,855,19,874,1277,0,3,1,3,0,1,0,76.14,68.44 ,33.33
03,019,01,007,0158,357 ,830,17,847,1217,0,3,1,3,0,1,0,76.14,69.60 ,33.33
03,019,01,007,0159,358 ,803,15,818,1196,0,3,1,3,0,1,0,76.14,68.39 ,33.33
03,019,01,007,0159,359 ,678,9,687,1047,0,3,1,3,0,1,0,76.14,65.62 ,33.33
03,019,01,007,0159,360 ,705,6,711,1067,0,3,1,3,0,1,0,76.14,66.64 ,33.33
03,019,01,007,0159,361 ,735,12,747,1190,0,3,1,3,0,1,0,76.14,62.77 ,33.33
03,019,01,007,0159,362 ,674,15,689,1032,0,3,1,3,0,1,0,76.14,66.76 ,33.33
03,019,01,007,0159,363 ,823,18,841,1252,0,3,1,3,0,1,0,76.14,67.17 ,33.33
03,019,01,007,0159,364 ,960,10,970,1357,0,3,1,3,0,1,0,76.14,71.48 ,33.33
03,019,01,007,0159,365 ,801,9,810,1227,0,3,1,3,0,1,0,76.14,66.01 ,33.33
03,019,01,007,0159,366 ,1029,10,1039,1523,0,3,1,3,0,1,0,76.14,68.22 ,33.33
03,019,01,007,0160,367 ,939,13,952,1362,0,3,1,3,0,1,0,76.14,69.90 ,33.33
03,019,01,007,0161,368 ,883,8,891,1277,0,3,1,3,0,1,0,76.14,69.77 ,33.33
03,019,01,007,0161,369 ,853,18,871,1302,0,3,1,3,0,1,0,76.14,66.90 ,33.33
03,019,01,007,0162,370 ,898,14,912,1349,0,3,1,3,0,1,0,76.14,67.61 ,33.33
03,019,01,007,0162,371 ,786,4,790,1285,0,3,1,3,0,1,0,76.14,61.48 ,33.33
03,019,01,007,0162,372 ,848,15,863,1331,0,3,1,3,0,1,0,76.14,64.84 ,33.33
03,019,01,007,0162,373 ,742,9,751,1059,0,3,1,3,0,1,0,76.14,70.92 ,33.33
03,019,01,007,0162,374 ,979,21,1000,1409,0,3,1,3,0,1,0,76.14,70.97 ,33.33
03,019,01,007,0162,375 ,818,15,833,1321,0,3,1,3,0,1,0,76.14,63.06 ,33.33
03,019,01,007,0162,376 ,912,15,927,1419,0,3,1,3,0,1,0,76.14,65.33 ,33.33
03,019,01,007,0162,377 ,701,14,715,1090,0,3,1,3,0,1,0,76.14,65.60 ,33.33
03,019,01,007,0162,378 ,988,10,998,1606,0,3,1,3,0,1,0,76.14,62.14 ,33.33
03,019,01,007,0163,379 ,794,12,806,1210,0,3,1,3,0,1,0,76.14,66.61 ,33.33
03,019,01,007,0163,380 ,812,11,823,1191,0,3,1,3,0,1,0,76.14,69.10 ,33.33
03,019,01,007,0163,381 ,607,15,622,1034,0,3,1,3,0,1,0,76.14,60.15 ,33.33
03,019,01,007,0163,382 ,840,18,858,1316,0,3,1,3,0,1,0,76.14,65.20 ,33.33
03,019,01,007,0163,383 ,831,9,840,1308,0,3,1,3,0,1,0,76.14,64.22 ,33.33
03,019,01,007,0163,384 ,866,12,878,1327,0,3,1,3,0,1,0,76.14,66.16 ,33.33
03,019,01,007,0163,385 ,706,13,719,1024,0,3,1,3,0,1,0,76.14,70.21 ,33.33
03,019,01,007,0164,386 ,962,12,974,1429,0,3,1,3,0,1,0,76.14,68.16 ,33.33
03,019,01,007,0164,387 ,884,12,896,1393,0,3,1,3,0,1,0,76.14,64.32 ,33.33
03,019,01,007,0164,388 ,912,19,931,1403,0,3,1,3,0,1,0,76.14,66.36 ,33.33
03,019,01,007,0164,389 ,715,9,724,1120,0,3,1,3,0,1,0,76.14,64.64 ,33.33
03,019,01,007,0164,390 ,817,7,824,1226,0,3,1,3,0,1,0,76.14,67.21 ,33.33
03,019,01,007,0164,391 ,1215,6,1221,1683,0,3,1,3,0,1,0,76.14,72.55 ,33.33
03,019,01,007,0164,392 ,885,9,894,1323,0,3,1,3,0,1,0,76.14,67.57 ,33.33
03,019,01,007,0164,393 ,801,11,812,1225,0,3,1,3,0,1,0,76.14,66.29 ,33.33
03,019,01,008,0165,394 ,944,15,959,1455,0,3,1,3,0,1,0,76.14,65.91 ,33.33
03,019,01,008,0165,395 ,767,8,775,1235,0,3,1,3,0,1,0,76.14,62.75 ,33.33
03,019,01,008,0165,396 ,1037,18,1055,1661,0,3,1,3,0,1,0,76.14,63.52 ,33.33
03,019,01,008,0165,397 ,1036,9,1045,1558,0,3,1,3,0,1,0,76.14,67.07 ,33.33
03,019,01,008,0166,398 ,1119,17,1136,1832,0,3,1,3,0,1,0,76.14,62.01 ,33.33
03,019,01,008,0166,399 ,999,15,1014,1457,0,3,1,3,0,1,0,76.14,69.60 ,33.33
03,019,01,008,0167,400 ,1076,11,1087,1773,0,3,1,3,0,1,0,76.14,61.31 ,33.33
03,019,01,008,0167,401 ,851,6,857,1312,0,3,1,3,0,1,0,76.14,65.32 ,33.33
03,019,01,008,0167,402 ,734,7,741,1088,0,3,1,3,0,1,0,76.14,68.11 ,33.33
03,019,01,008,0167,403 ,927,16,943,1454,0,3,1,3,0,1,0,76.14,64.86 ,33.33
03,019,01,008,0167,404 ,1090,12,1102,1668,0,3,1,3,0,1,0,76.14,66.07 ,33.33
03,019,01,008,0167,405 ,980,14,994,1517,0,3,1,3,0,1,0,76.14,65.52 ,33.33
03,019,01,008,0167,406 ,918,6,924,1435,0,3,1,3,0,1,0,76.14,64.39 ,33.33
03,019,01,008,0168,407 ,712,10,722,1205,0,3,1,3,0,1,0,76.14,59.92 ,33.33
03,019,01,008,0168,408 ,918,15,933,1406,0,3,1,3,0,1,0,76.14,66.36 ,33.33
03,019,01,008,0168,409 ,1051,13,1064,1618,0,3,1,3,0,1,0,76.14,65.76 ,33.33
03,019,01,008,0168,410 ,912,14,926,1442,0,3,1,3,0,1,0,76.14,64.22 ,33.33
03,019,01,008,0168,411 ,1062,21,1083,1669,0,3,1,3,0,1,0,76.14,64.89 ,33.33
03,019,01,008,0168,412 ,911,6,917,1422,0,3,1,3,0,1,0,76.14,64.49 ,33.33
03,019,01,008,0168,413 ,1044,19,1063,1671,0,3,1,3,0,1,0,76.14,63.61 ,33.33
03,019,01,008,0169,414 ,1203,9,1212,1874,0,3,1,3,0,1,0,76.14,64.67 ,33.33
03,019,01,008,0169,415 ,1126,20,1146,1869,0,3,1,3,0,1,0,76.14,61.32 ,33.33
03,019,01,008,0169,416 ,893,15,908,1442,0,3,1,3,0,1,0,76.14,62.97 ,33.33
03,019,01,008,0169,417 ,922,18,940,1501,0,3,1,3,0,1,0,76.14,62.62 ,33.33
03,019,01,008,0170,418 ,912,14,926,1279,0,3,1,3,0,1,0,76.14,72.40 ,33.33
03,019,01,008,0170,419 ,890,19,909,1369,0,3,1,3,0,1,0,76.14,66.40 ,33.33
03,019,01,008,0170,420 ,967,13,980,1566,0,3,1,3,0,1,0,76.14,62.58 ,33.33
03,019,01,008,0171,421 ,904,14,918,1411,0,3,1,3,0,1,0,76.14,65.06 ,33.33
03,019,01,008,0171,422 ,887,14,901,1522,0,3,1,3,0,1,0,76.14,59.20 ,33.33
03,019,01,008,0171,423 ,926,18,944,1504,0,3,1,3,0,1,0,76.14,62.77 ,33.33
03,019,01,008,0171,424 ,943,13,956,1504,0,3,1,3,0,1,0,76.14,63.56 ,33.33
03,019,01,008,0171,425 ,1063,11,1074,1535,0,3,1,3,0,1,0,76.14,69.97 ,33.33
03,019,01,008,0172,426 ,833,11,844,1341,0,3,1,3,0,1,0,76.14,62.94 ,33.33
03,019,01,008,0172,427 ,947,11,958,1475,0,3,1,3,0,1,0,76.14,64.95 ,33.33
03,019,01,008,0172,428 ,963,16,979,1444,0,3,1,3,0,1,0,76.14,67.80 ,33.33
03,019,01,008,0173,429 ,877,10,887,1354,0,3,1,3,0,1,0,76.14,65.51 ,33.33
03,019,01,008,0173,430 ,927,21,948,1368,0,3,1,3,0,1,0,76.14,69.30 ,33.33
03,019,01,008,0173,431 ,478,11,489,931,0,3,1,3,0,1,0,76.14,52.52 ,33.33
03,019,01,008,0174,432 ,946,18,964,1332,0,3,1,3,0,1,0,76.14,72.37 ,33.33
03,019,01,008,0174,433 ,781,11,792,1280,0,3,1,3,0,1,0,76.14,61.88 ,33.33
03,019,01,008,0174,434 ,595,7,602,940,0,3,1,3,0,1,0,76.14,64.04 ,33.33
03,019,01,008,0174,435 ,709,11,720,1113,0,3,1,3,0,1,0,76.14,64.69 ,33.33
03,019,01,008,0175,436 ,1134,12,1146,1646,0,3,1,3,0,1,0,76.14,69.62 ,33.33
03,019,01,008,0175,437 ,1212,26,1238,1781,0,3,1,3,0,1,0,76.14,69.51 ,33.33
03,019,01,008,0175,438 ,1121,19,1140,1713,0,3,1,3,0,1,0,76.14,66.55 ,33.33
03,019,01,008,0176,439 ,1076,10,1086,1537,0,3,1,3,0,1,0,76.14,70.66 ,33.33
03,019,01,008,0176,440 ,895,23,918,1303,0,3,1,3,0,1,0,76.14,70.45 ,33.33
03,019,01,008,0176,441 ,950,19,969,1394,0,3,1,3,0,1,0,76.14,69.51 ,33.33
03,019,01,008,0176,442 ,1036,18,1054,1620,0,3,1,3,0,1,0,76.14,65.06 ,33.33
03,019,01,008,0177,443 ,1262,11,1273,1803,0,3,1,3,0,1,0,76.14,70.60 ,33.33
03,019,01,008,0177,444 ,1121,19,1140,1683,0,3,1,3,0,1,0,76.14,67.74 ,33.33
03,019,01,008,0177,445 ,479,10,489,729,0,3,1,3,0,1,0,76.14,67.08 ,33.33
03,019,01,008,0178,446 ,1089,15,1104,1544,0,3,1,3,0,1,0,76.14,71.50 ,33.33
03,019,01,008,0179,447 ,476,7,483,724,0,3,1,3,0,1,0,76.14,66.71 ,33.33
03,019,01,008,0179,448 ,561,8,569,852,0,3,1,3,0,1,0,76.14,66.78 ,33.33
03,019,01,008,0180,449 ,552,15,567,883,0,3,1,3,0,1,0,76.14,64.21 ,33.33
03,019,01,008,0181,450 ,487,2,489,723,0,3,1,3,0,1,0,76.14,67.63 ,33.33
03,019,01,008,0182,451 ,1060,12,1072,1512,0,3,1,3,0,1,0,76.14,70.90 ,33.33
03,019,01,008,0183,452 ,723,6,729,1079,0,3,1,3,0,1,0,76.14,67.56 ,33.33
03,019,01,008,0183,453 ,1315,20,1335,2094,0,3,1,3,0,1,0,76.14,63.75 ,33.33
03,019,01,008,0183,454 ,1120,16,1136,1666,0,3,1,3,0,1,0,76.14,68.19 ,33.33
03,019,01,008,0184,455 ,790,15,805,1208,0,3,1,3,0,1,0,76.14,66.64 ,33.33
03,019,01,008,0184,456 ,742,15,757,1182,0,3,1,3,0,1,0,76.14,64.04 ,33.33
03,019,01,008,0184,457 ,854,8,862,1407,0,3,1,3,0,1,0,76.14,61.27 ,33.33
03,019,01,008,0184,458 ,856,11,867,1313,0,3,1,3,0,1,0,76.14,66.03 ,33.33
03,019,01,008,0184,459 ,784,9,793,1264,0,3,1,3,0,1,0,76.14,62.74 ,33.33
03,019,01,008,0184,460 ,922,9,931,1460,0,3,1,3,0,1,0,76.14,63.77 ,33.33
03,019,01,008,0185,461 ,660,9,669,1151,0,3,1,3,0,1,0,76.14,58.12 ,33.33
03,019,01,008,0185,462 ,854,7,861,1301,0,3,1,3,0,1,0,76.14,66.18 ,33.33
03,019,01,008,0185,463 ,839,16,855,1322,0,3,1,3,0,1,0,76.14,64.67 ,33.33
03,019,01,008,0185,464 ,996,14,1010,1470,0,3,1,3,0,1,0,76.14,68.71 ,33.33
03,019,01,008,0185,465 ,776,10,786,1209,0,3,1,3,0,1,0,76.14,65.01 ,33.33
03,019,01,008,0185,466 ,824,10,834,1241,0,3,1,3,0,1,0,76.14,67.20 ,33.33
03,019,01,008,0185,467 ,806,11,817,1261,0,3,1,3,0,1,0,76.14,64.79 ,33.33
03,019,01,008,0185,468 ,930,14,944,1434,0,3,1,3,0,1,0,76.14,65.83 ,33.33
03,019,01,008,0186,469 ,1092,21,1113,1644,0,3,1,3,0,1,0,76.14,67.70 ,33.33
03,019,01,008,0186,470 ,969,19,988,1389,0,3,1,3,0,1,0,76.14,71.13 ,33.33
03,019,01,008,0186,471 ,1169,20,1189,1669,0,3,1,3,0,1,0,76.14,71.24 ,33.33
03,019,01,008,0186,472 ,868,17,885,1305,0,3,1,3,0,1,0,76.14,67.82 ,33.33
03,019,01,008,0187,473 ,516,2,518,739,0,3,1,3,0,1,0,76.14,70.09 ,33.33
03,019,01,008,0187,474 ,912,11,923,1337,0,3,1,3,0,1,0,76.14,69.04 ,33.33
03,019,01,008,0187,475 ,1025,18,1043,1472,0,3,1,3,0,1,0,76.14,70.86 ,33.33
03,019,01,008,0187,476 ,591,12,603,831,0,3,1,3,0,1,0,76.14,72.56 ,33.33
03,019,01,008,0187,477 ,491,18,509,720,0,3,1,3,0,1,0,76.14,70.69 ,33.33
03,019,01,008,0188,478 ,730,9,739,1018,0,3,1,3,0,1,0,76.14,72.59 ,33.33
03,019,01,008,0189,479 ,1155,21,1176,1706,0,3,1,3,0,1,0,76.14,68.93 ,33.33
03,019,01,008,0189,480 ,1009,21,1030,1438,0,3,1,3,0,1,0,76.14,71.63 ,33.33
03,019,01,008,0189,481 ,1248,16,1264,1946,0,3,1,3,0,1,0,76.14,64.95 ,33.33
03,019,01,008,0190,482 ,1307,14,1321,1985,0,3,1,3,0,1,0,76.14,66.55 ,33.33
03,019,01,008,0190,483 ,1007,14,1021,1477,0,3,1,3,0,1,0,76.14,69.13 ,33.33
03,019,01,008,0190,484 ,1076,21,1097,1573,0,3,1,3,0,1,0,76.14,69.74 ,33.33
03,019,01,008,0191,485 ,830,10,840,1397,0,3,1,3,0,1,0,76.14,60.13 ,33.33
03,019,01,008,0191,486 ,904,15,919,1401,0,3,1,3,0,1,0,76.14,65.60 ,33.33
03,019,01,008,0191,487 ,1129,8,1137,1646,0,3,1,3,0,1,0,76.14,69.08 ,33.33
03,019,01,008,0191,488 ,820,6,826,1315,0,3,1,3,0,1,0,76.14,62.81 ,33.33
03,019,01,008,0191,489 ,860,11,871,1320,0,3,1,3,0,1,0,76.14,65.98 ,33.33
03,019,01,008,0192,490 ,854,7,861,1329,0,3,1,3,0,1,0,76.14,64.79 ,33.33
03,019,01,008,0192,491 ,747,12,759,1144,0,3,1,3,0,1,0,76.14,66.35 ,33.33
03,019,01,008,0192,492 ,1050,14,1064,1583,0,3,1,3,0,1,0,76.14,67.21 ,33.33
03,019,01,008,0193,493 ,1111,15,1126,1718,0,3,1,3,0,1,0,76.14,65.54 ,33.33
03,019,01,008,0193,494 ,909,16,925,1325,0,3,1,3,0,1,0,76.14,69.81 ,33.33
03,019,01,008,0193,495 ,803,14,817,1317,0,3,1,3,0,1,0,76.14,62.03 ,33.33
03,019,01,008,0194,496 ,574,4,578,778,0,3,1,3,0,1,0,76.14,74.29 ,33.33
03,019,01,008,0195,497 ,893,16,909,1352,0,3,1,3,0,1,0,76.14,67.23 ,33.33
03,019,01,008,0195,498 ,829,19,848,1206,0,3,1,3,0,1,0,76.14,70.32 ,33.33
03,019,01,008,0195,499 ,1220,21,1241,1815,0,3,1,3,0,1,0,76.14,68.37 ,33.33
03,019,01,008,0195,500 ,946,7,953,1398,0,3,1,3,0,1,0,76.14,68.17 ,33.33
03,020,01,001,0001,1 ,813,12,825,1307,0,3,1,3,0,1,0,76.14,63.12 ,33.33
03,020,01,001,0001,2 ,804,12,816,1291,0,3,1,3,0,1,0,76.14,63.21 ,33.33
03,020,01,001,0001,3 ,834,12,846,1321,0,3,1,3,0,1,0,76.14,64.04 ,33.33
03,020,01,001,0002,4 ,598,5,603,842,0,3,1,3,0,1,0,76.14,71.62 ,33.33
03,020,01,001,0002,5 ,613,9,622,926,0,3,1,3,0,1,0,76.14,67.17 ,33.33
03,020,01,001,0003,6 ,391,9,400,608,0,3,1,3,0,1,0,76.14,65.79 ,33.33
03,020,01,001,0004,7 ,654,8,662,1033,0,3,1,3,0,1,0,76.14,64.09 ,33.33
03,020,01,001,0004,8 ,548,2,550,871,0,3,1,3,0,1,0,76.14,63.15 ,33.33
03,020,01,001,0004,9 ,726,8,734,1215,0,3,1,3,0,1,0,76.14,60.41 ,33.33
03,020,01,001,0005,10 ,568,4,572,877,0,3,1,3,0,1,0,76.14,65.22 ,33.33
03,020,01,001,0006,11 ,799,10,809,1210,0,3,1,3,0,1,0,76.14,66.86 ,33.33
03,020,01,001,0006,12 ,555,10,565,837,0,3,1,3,0,1,0,76.14,67.50 ,33.33
03,020,01,001,0006,13 ,431,3,434,667,0,3,1,3,0,1,0,76.14,65.07 ,33.33
03,020,01,001,0006,14 ,612,5,617,878,0,3,1,3,0,1,0,76.14,70.27 ,33.33
03,020,01,001,0007,15 ,788,7,795,1174,0,3,1,3,0,1,0,76.14,67.72 ,33.33
03,020,01,001,0007,16 ,676,8,684,1104,0,3,1,3,0,1,0,76.14,61.96 ,33.33
03,020,01,001,0008,17 ,863,13,876,1268,0,3,1,3,0,1,0,76.14,69.09 ,33.33
03,020,01,001,0008,18 ,810,10,820,1269,0,3,1,3,0,1,0,76.14,64.62 ,33.33
03,020,01,001,0009,19 ,924,17,941,1395,0,3,1,3,0,1,0,76.14,67.46 ,33.33
03,020,01,001,0009,20 ,689,4,693,1032,0,3,1,3,0,1,0,76.14,67.15 ,33.33
03,020,01,001,0009,21 ,683,9,692,1030,0,3,1,3,0,1,0,76.14,67.18 ,33.33
03,020,01,001,0010,22 ,811,12,823,1238,0,3,1,3,0,1,0,76.14,66.48 ,33.33
03,020,01,001,0010,23 ,570,7,577,908,0,3,1,3,0,1,0,76.14,63.55 ,33.33
03,020,01,001,0010,24 ,588,10,598,946,0,3,1,3,0,1,0,76.14,63.21 ,33.33
03,020,01,001,0011,25 ,526,3,529,830,0,3,1,3,0,1,0,76.14,63.73 ,33.33
03,020,01,001,0011,26 ,396,5,401,646,0,3,1,3,0,1,0,76.14,62.07 ,33.33
03,020,01,001,0011,27 ,1017,12,1029,1602,0,3,1,3,0,1,0,76.14,64.23 ,33.33
03,020,01,001,0012,28 ,746,11,757,1161,0,3,1,3,0,1,0,76.14,65.20 ,33.33
03,020,01,001,0013,29 ,224,1,225,337,0,3,1,3,0,1,0,76.14,66.77 ,33.33
03,020,01,001,0014,30 ,301,3,304,455,0,3,1,3,0,1,0,76.14,66.81 ,33.33
03,020,01,001,0015,31 ,364,5,369,542,0,3,1,3,0,1,0,76.14,68.08 ,33.33
03,020,01,001,0016,32 ,327,4,331,493,0,3,1,3,0,1,0,76.14,67.14 ,33.33
03,020,01,001,0017,33 ,426,6,432,638,0,3,1,3,0,1,0,76.14,67.71 ,33.33
03,020,01,001,0018,34 ,355,1,356,523,0,3,1,3,0,1,0,76.14,68.07 ,33.33
03,020,01,001,0019,35 ,305,2,307,441,0,3,1,3,0,1,0,76.14,69.61 ,33.33
03,020,01,001,0020,36 ,448,7,455,667,0,3,1,3,0,1,0,76.14,68.22 ,33.33
03,020,01,001,0020,37 ,420,1,421,649,0,3,1,3,0,1,0,76.14,64.87 ,33.33
03,020,01,001,0021,38 ,391,4,395,610,0,3,1,3,0,1,0,76.14,64.75 ,33.33
03,020,01,001,0022,39 ,634,6,640,1005,0,3,1,3,0,1,0,76.14,63.68 ,33.33
03,020,01,001,0023,40 ,255,4,259,384,0,3,1,3,0,1,0,76.14,67.45 ,33.33
03,020,01,001,0024,41 ,672,10,682,1023,0,3,1,3,0,1,0,76.14,66.67 ,33.33
03,020,01,001,0025,42 ,433,5,438,629,0,3,1,3,0,1,0,76.14,69.63 ,33.33
03,020,01,001,0026,43 ,483,4,487,736,0,3,1,3,0,1,0,76.14,66.17 ,33.33
03,020,01,001,0027,44 ,486,5,491,730,0,3,1,3,0,1,0,76.14,67.26 ,33.33
03,020,01,001,0028,45 ,445,5,450,671,0,3,1,3,0,1,0,76.14,67.06 ,33.33
03,020,01,001,0029,46 ,811,9,820,1175,0,3,1,3,0,1,0,76.14,69.79 ,33.33
03,020,01,001,0030,47 ,398,3,401,630,0,3,1,3,0,1,0,76.14,63.65 ,33.33
03,020,01,001,0031,48 ,735,2,737,1095,0,3,1,3,0,1,0,76.14,67.31 ,33.33
03,020,01,001,0032,49 ,843,5,848,1268,0,3,1,3,0,1,0,76.14,66.88 ,33.33
03,020,01,001,0033,50 ,572,7,579,852,0,3,1,3,0,1,0,76.14,67.96 ,33.33
03,020,01,001,0034,51 ,442,4,446,651,0,3,1,3,0,1,0,76.14,68.51 ,33.33
03,020,01,001,0034,52 ,450,7,457,718,0,3,1,3,0,1,0,76.14,63.65 ,33.33
03,020,01,001,0035,53 ,610,11,621,1025,0,3,1,3,0,1,0,76.14,60.59 ,33.33
03,020,01,001,0035,54 ,562,7,569,889,0,3,1,3,0,1,0,76.14,64.00 ,33.33
03,020,01,001,0036,55 ,842,10,852,1325,0,3,1,3,0,1,0,76.14,64.30 ,33.33
03,020,01,001,0037,56 ,475,8,483,720,0,3,1,3,0,1,0,76.14,67.08 ,33.33
03,020,01,001,0037,57 ,508,10,518,820,0,3,1,3,0,1,0,76.14,63.17 ,33.33
03,020,01,001,0038,58 ,772,17,789,1192,0,3,1,3,0,1,0,76.14,66.19 ,33.33
03,020,01,001,0038,59 ,557,7,564,918,0,3,1,3,0,1,0,76.14,61.44 ,33.33
03,020,01,001,0038,60 ,671,9,680,1155,0,3,1,3,0,1,0,76.14,58.87 ,33.33
03,020,01,001,0039,61 ,886,9,895,1354,0,3,1,3,0,1,0,76.14,66.10 ,33.33
03,020,01,001,0039,62 ,511,6,517,717,0,3,1,3,0,1,0,76.14,72.11 ,33.33
03,020,01,001,0040,63 ,629,8,637,985,0,3,1,3,0,1,0,76.14,64.67 ,33.33
03,020,01,001,0040,64 ,630,5,635,978,0,3,1,3,0,1,0,76.14,64.93 ,33.33
03,020,01,001,0041,65 ,575,6,581,919,0,3,1,3,0,1,0,76.14,63.22 ,33.33
03,020,01,001,0041,66 ,617,7,624,1019,0,3,1,3,0,1,0,76.14,61.24 ,33.33
03,020,01,001,0041,67 ,706,3,709,1164,0,3,1,3,0,1,0,76.14,60.91 ,33.33
03,020,01,001,0041,68 ,882,12,894,1449,0,3,1,3,0,1,0,76.14,61.70 ,33.33
03,020,01,001,0042,69 ,857,6,863,1333,0,3,1,3,0,1,0,76.14,64.74 ,33.33
03,020,01,001,0042,70 ,949,10,959,1621,0,3,1,3,0,1,0,76.14,59.16 ,33.33
03,020,01,001,0043,71 ,666,7,673,1113,0,3,1,3,0,1,0,76.14,60.47 ,33.33
03,020,01,001,0043,72 ,634,11,645,981,0,3,1,3,0,1,0,76.14,65.75 ,33.33
03,020,01,001,0044,73 ,968,10,978,1436,0,3,1,3,0,1,0,76.14,68.11 ,33.33
03,020,01,001,0044,74 ,965,12,977,1567,0,3,1,3,0,1,0,76.14,62.35 ,33.33
03,020,01,001,0045,75 ,543,3,546,858,0,3,1,3,0,1,0,76.14,63.64 ,33.33
03,020,01,001,0046,76 ,438,9,447,647,0,3,1,3,0,1,0,76.14,69.09 ,33.33
03,020,01,001,0047,77 ,693,6,699,1093,0,3,1,3,0,1,0,76.14,63.95 ,33.33
03,020,01,001,0048,78 ,516,4,520,800,0,3,1,3,0,1,0,76.14,65.00 ,33.33
03,020,01,001,0048,79 ,400,2,402,620,0,3,1,3,0,1,0,76.14,64.84 ,33.33
03,020,01,001,0049,80 ,591,4,595,884,0,3,1,3,0,1,0,76.14,67.31 ,33.33
03,020,01,001,0050,81 ,312,4,316,505,0,3,1,3,0,1,0,76.14,62.57 ,33.33
03,020,01,001,0051,82 ,768,11,779,1288,0,3,1,3,0,1,0,76.14,60.48 ,33.33
03,020,01,001,0051,83 ,765,14,779,1279,0,3,1,3,0,1,0,76.14,60.91 ,33.33
03,020,01,001,0052,84 ,716,9,725,1112,0,3,1,3,0,1,0,76.14,65.20 ,33.33
03,020,01,001,0052,85 ,540,8,548,931,0,3,1,3,0,1,0,76.14,58.86 ,33.33
03,020,01,001,0053,86 ,1005,10,1015,1601,0,3,1,3,0,1,0,76.14,63.40 ,33.33
03,020,01,001,0053,87 ,881,14,895,1346,0,3,1,3,0,1,0,76.14,66.49 ,33.33
03,020,01,001,0054,88 ,632,11,643,874,0,3,1,3,0,1,0,76.14,73.57 ,33.33
03,020,01,001,0054,89 ,451,5,456,684,0,3,1,3,0,1,0,76.14,66.67 ,33.33
03,020,01,001,0054,90 ,414,2,416,723,0,3,1,3,0,1,0,76.14,57.54 ,33.33
03,020,01,001,0055,91 ,758,8,766,1199,0,3,1,3,0,1,0,76.14,63.89 ,33.33
03,020,01,001,0055,92 ,814,10,824,1281,0,3,1,3,0,1,0,76.14,64.32 ,33.33
03,020,01,001,0055,93 ,571,5,576,926,0,3,1,3,0,1,0,76.14,62.20 ,33.33
03,020,01,001,0055,94 ,736,7,743,1109,0,3,1,3,0,1,0,76.14,67.00 ,33.33
03,020,01,002,0056,95 ,677,8,685,1007,0,3,1,3,0,1,0,76.14,68.02 ,33.33
03,020,01,002,0057,96 ,426,6,432,654,0,3,1,3,0,1,0,76.14,66.06 ,33.33
03,020,01,002,0058,97 ,323,3,326,509,0,3,1,3,0,1,0,76.14,64.05 ,33.33
03,020,01,002,0059,98 ,440,5,445,673,0,3,1,3,0,1,0,76.14,66.12 ,33.33
03,020,01,002,0060,99 ,350,6,356,543,0,3,1,3,0,1,0,76.14,65.56 ,33.33
03,020,01,002,0061,100 ,587,4,591,827,0,3,1,3,0,1,0,76.14,71.46 ,33.33
03,020,01,002,0062,101 ,373,6,379,577,0,3,1,3,0,1,0,76.14,65.68 ,33.33
03,020,01,002,0063,102 ,739,5,744,1115,0,3,1,3,0,1,0,76.14,66.73 ,33.33
03,020,01,002,0064,103 ,570,2,572,888,0,3,1,3,0,1,0,76.14,64.41 ,33.33
03,020,01,002,0065,104 ,540,4,544,818,0,3,1,3,0,1,0,76.14,66.50 ,33.33
03,020,01,002,0066,105 ,330,3,333,494,0,3,1,3,0,1,0,76.14,67.41 ,33.33
03,020,01,002,0067,106 ,512,7,519,783,0,3,1,3,0,1,0,76.14,66.28 ,33.33
03,020,01,002,0068,107 ,358,5,363,518,0,3,1,3,0,1,0,76.14,70.08 ,33.33
03,020,01,002,0069,108 ,372,3,375,523,0,3,1,3,0,1,0,76.14,71.70 ,33.33
03,020,01,002,0070,109 ,266,6,272,420,0,3,1,3,0,1,0,76.14,64.76 ,33.33
03,020,01,002,0071,110 ,243,4,247,404,0,3,1,3,0,1,0,76.14,61.14 ,33.33
03,020,01,002,0072,111 ,391,6,397,618,0,3,1,3,0,1,0,76.14,64.24 ,33.33
03,020,01,002,0073,112 ,491,5,496,723,0,3,1,3,0,1,0,76.14,68.60 ,33.33
03,020,01,002,0074,113 ,420,4,424,628,0,3,1,3,0,1,0,76.14,67.52 ,33.33
03,020,01,002,0075,114 ,659,14,673,1035,0,3,1,3,0,1,0,76.14,65.02 ,33.33
03,020,01,002,0075,115 ,673,13,686,1103,0,3,1,3,0,1,0,76.14,62.19 ,33.33
03,020,01,002,0075,116 ,752,8,760,1196,0,3,1,3,0,1,0,76.14,63.55 ,33.33
03,020,01,002,0075,117 ,756,8,764,1186,0,3,1,3,0,1,0,76.14,64.42 ,33.33
03,020,01,002,0075,118 ,797,20,817,1310,0,3,1,3,0,1,0,76.14,62.37 ,33.33
03,020,01,002,0076,119 ,616,6,622,949,0,3,1,3,0,1,0,76.14,65.54 ,33.33
03,020,01,002,0077,120 ,682,9,691,1048,0,3,1,3,0,1,0,76.14,65.94 ,33.33
03,020,01,002,0077,121 ,836,6,842,1428,0,3,1,3,0,1,0,76.14,58.96 ,33.33
03,020,01,002,0077,122 ,438,6,444,667,0,3,1,3,0,1,0,76.14,66.57 ,33.33
03,020,01,002,0078,123 ,622,7,629,919,0,3,1,3,0,1,0,76.14,68.44 ,33.33
03,020,01,002,0078,124 ,573,8,581,893,0,3,1,3,0,1,0,76.14,65.06 ,33.33
03,020,01,002,0079,125 ,779,10,789,1246,0,3,1,3,0,1,0,76.14,63.32 ,33.33
03,020,01,002,0080,126 ,853,10,863,1283,0,3,1,3,0,1,0,76.14,67.26 ,33.33
03,020,01,002,0081,127 ,581,11,592,900,0,3,1,3,0,1,0,76.14,65.78 ,33.33
03,020,01,002,0081,128 ,514,5,519,799,0,3,1,3,0,1,0,76.14,64.96 ,33.33
03,020,01,002,0082,129 ,813,19,832,1289,0,3,1,3,0,1,0,76.14,64.55 ,33.33
03,020,01,002,0082,130 ,584,6,590,925,0,3,1,3,0,1,0,76.14,63.78 ,33.33
03,020,01,002,0082,131 ,550,7,557,880,0,3,1,3,0,1,0,76.14,63.30 ,33.33
03,020,01,002,0083,132 ,577,8,585,896,0,3,1,3,0,1,0,76.14,65.29 ,33.33
03,020,01,002,0083,133 ,727,23,750,1197,0,3,1,3,0,1,0,76.14,62.66 ,33.33
03,020,01,002,0084,134 ,507,5,512,790,0,3,1,3,0,1,0,76.14,64.81 ,33.33
03,020,01,002,0085,135 ,354,6,360,566,0,3,1,3,0,1,0,76.14,63.60 ,33.33
03,020,01,002,0085,136 ,462,3,465,707,0,3,1,3,0,1,0,76.14,65.77 ,33.33
03,020,01,002,0086,137 ,718,5,723,1091,0,3,1,3,0,1,0,76.14,66.27 ,33.33
03,020,01,002,0087,138 ,518,8,526,879,0,3,1,3,0,1,0,76.14,59.84 ,33.33
03,020,01,002,0087,139 ,608,9,617,1057,0,3,1,3,0,1,0,76.14,58.37 ,33.33
03,020,01,002,0088,140 ,963,9,972,1465,0,3,1,3,0,1,0,76.14,66.35 ,33.33
03,020,01,002,0088,141 ,800,11,811,1264,0,3,1,3,0,1,0,76.14,64.16 ,33.33
03,020,01,002,0088,142 ,928,9,937,1464,0,3,1,3,0,1,0,76.14,64.00 ,33.33
03,020,01,002,0089,143 ,927,9,936,1359,0,3,1,3,0,1,0,76.14,68.87 ,33.33
03,020,01,002,0089,144 ,820,9,829,1280,0,3,1,3,0,1,0,76.14,64.77 ,33.33
03,020,01,002,0089,145 ,829,7,836,1286,0,3,1,3,0,1,0,76.14,65.01 ,33.33
03,020,01,002,0090,146 ,709,7,716,1107,0,3,1,3,0,1,0,76.14,64.68 ,33.33
03,020,01,002,0090,147 ,860,8,868,1267,0,3,1,3,0,1,0,76.14,68.51 ,33.33
03,020,01,002,0090,148 ,939,12,951,1647,0,3,1,3,0,1,0,76.14,57.74 ,33.33
03,020,01,002,0090,149 ,734,9,743,1227,0,3,1,3,0,1,0,76.14,60.55 ,33.33
03,020,01,002,0090,150 ,781,10,791,1226,0,3,1,3,0,1,0,76.14,64.52 ,33.33
03,020,01,002,0091,151 ,648,6,654,1024,0,3,1,3,0,1,0,76.14,63.87 ,33.33
03,020,01,002,0091,152 ,838,6,844,1330,0,3,1,3,0,1,0,76.14,63.46 ,33.33
03,020,01,002,0091,153 ,528,7,535,904,0,3,1,3,0,1,0,76.14,59.18 ,33.33
03,020,01,002,0092,154 ,860,8,868,1274,0,3,1,3,0,1,0,76.14,68.13 ,33.33
03,020,01,002,0092,155 ,875,14,889,1346,0,3,1,3,0,1,0,76.14,66.05 ,33.33
03,020,01,002,0092,156 ,833,8,841,1359,0,3,1,3,0,1,0,76.14,61.88 ,33.33
03,020,01,002,0093,157 ,697,14,711,1115,0,3,1,3,0,1,0,76.14,63.77 ,33.33
03,020,01,002,0093,158 ,751,3,754,1138,0,3,1,3,0,1,0,76.14,66.26 ,33.33
03,020,01,002,0094,159 ,822,9,831,1253,0,3,1,3,0,1,0,76.14,66.32 ,33.33
03,020,01,002,0095,160 ,857,13,870,1267,0,3,1,3,0,1,0,76.14,68.67 ,33.33
03,020,01,002,0096,161 ,619,5,624,911,0,3,1,3,0,1,0,76.14,68.50 ,33.33
03,020,01,002,0096,162 ,643,8,651,973,0,3,1,3,0,1,0,76.14,66.91 ,33.33
03,020,01,002,0097,163 ,661,13,674,1144,0,3,1,3,0,1,0,76.14,58.92 ,33.33
03,020,01,002,0097,164 ,574,11,585,893,0,3,1,3,0,1,0,76.14,65.51 ,33.33
03,020,01,002,0098,165 ,350,8,358,525,0,3,1,3,0,1,0,76.14,68.19 ,33.33
03,020,01,002,0099,166 ,419,6,425,655,0,3,1,3,0,1,0,76.14,64.89 ,33.33
03,020,01,002,0100,167 ,457,6,463,719,0,3,1,3,0,1,0,76.14,64.39 ,33.33
03,020,01,002,0100,168 ,416,4,420,651,0,3,1,3,0,1,0,76.14,64.52 ,33.33
03,020,01,002,0101,169 ,861,18,879,1355,0,3,1,3,0,1,0,76.14,64.87 ,33.33
03,020,01,002,0102,170 ,580,14,594,895,0,3,1,3,0,1,0,76.14,66.37 ,33.33
03,020,01,002,0102,171 ,607,7,614,910,0,3,1,3,0,1,0,76.14,67.47 ,33.33
03,020,01,002,0103,172 ,684,11,695,1018,0,3,1,3,0,1,0,76.14,68.27 ,33.33
03,020,01,002,0103,173 ,678,4,682,1062,0,3,1,3,0,1,0,76.14,64.22 ,33.33
03,020,01,002,0103,174 ,580,15,595,902,0,3,1,3,0,1,0,76.14,65.96 ,33.33
03,020,01,002,0103,175 ,654,10,664,1028,0,3,1,3,0,1,0,76.14,64.59 ,33.33
03,020,01,002,0104,176 ,923,16,939,1440,0,3,1,3,0,1,0,76.14,65.21 ,33.33
03,020,01,002,0104,177 ,952,15,967,1354,0,3,1,3,0,1,0,76.14,71.42 ,33.33
03,020,01,002,0104,178 ,919,13,932,1396,0,3,1,3,0,1,0,76.14,66.76 ,33.33
03,020,01,002,0104,179 ,1046,13,1059,1538,0,3,1,3,0,1,0,76.14,68.86 ,33.33
03,020,01,002,0104,180 ,898,7,905,1427,0,3,1,3,0,1,0,76.14,63.42 ,33.33
03,020,01,002,0104,181 ,953,17,970,1551,0,3,1,3,0,1,0,76.14,62.54 ,33.33
03,020,01,002,0105,182 ,714,9,723,1082,0,3,1,3,0,1,0,76.14,66.82 ,33.33
03,020,01,002,0105,183 ,695,8,703,1101,0,3,1,3,0,1,0,76.14,63.85 ,33.33
03,020,01,002,0105,184 ,694,12,706,1080,0,3,1,3,0,1,0,76.14,65.37 ,33.33
03,020,01,002,0106,185 ,735,8,743,1090,0,3,1,3,0,1,0,76.14,68.17 ,33.33
03,020,01,002,0106,186 ,764,7,771,1136,0,3,1,3,0,1,0,76.14,67.87 ,33.33
03,020,01,002,0107,187 ,846,17,863,1231,0,3,1,3,0,1,0,76.14,70.11 ,33.33
03,020,01,002,0108,188 ,823,11,834,1049,0,3,1,3,0,1,0,76.14,79.50 ,33.33
03,021,01,001,0001,1 ,890,16,906,1457,0,3,1,3,0,1,0,76.14,62.18 ,33.33
03,021,01,001,0001,2 ,812,9,821,1539,0,3,1,3,0,1,0,76.14,53.35 ,33.33
03,021,01,001,0001,3 ,849,12,861,1476,0,3,1,3,0,1,0,76.14,58.33 ,33.33
03,021,01,001,0001,4 ,923,8,931,1466,0,3,1,3,0,1,0,76.14,63.51 ,33.33
03,021,01,001,0002,5 ,935,21,956,1450,0,3,1,3,0,1,0,76.14,65.93 ,33.33
03,021,01,001,0002,6 ,781,18,799,1261,0,3,1,3,0,1,0,76.14,63.36 ,33.33
03,021,01,001,0002,7 ,745,15,760,1177,0,3,1,3,0,1,0,76.14,64.57 ,33.33
03,021,01,001,0003,8 ,861,8,869,1372,0,3,1,3,0,1,0,76.14,63.34 ,33.33
03,021,01,001,0003,9 ,1109,15,1124,1883,0,3,1,3,0,1,0,76.14,59.69 ,33.33
03,021,01,001,0004,10 ,1005,10,1015,1624,0,3,1,3,0,1,0,76.14,62.50 ,33.33
03,021,01,001,0004,11 ,909,8,917,1548,0,3,1,3,0,1,0,76.14,59.24 ,33.33
03,021,01,001,0004,12 ,839,11,850,1284,0,3,1,3,0,1,0,76.14,66.20 ,33.33
03,021,01,001,0004,13 ,1171,11,1182,1758,0,3,1,3,0,1,0,76.14,67.24 ,33.33
03,021,01,001,0005,14 ,1273,11,1284,1997,0,3,1,3,0,1,0,76.14,64.30 ,33.33
03,021,01,001,0006,15 ,918,14,932,1471,0,3,1,3,0,1,0,76.14,63.36 ,33.33
03,021,01,001,0006,16 ,865,4,869,1405,0,3,1,3,0,1,0,76.14,61.85 ,33.33
03,021,01,001,0006,17 ,959,5,964,1544,0,3,1,3,0,1,0,76.14,62.44 ,33.33
03,021,01,001,0007,18 ,657,22,679,1055,0,3,1,3,0,1,0,76.14,64.36 ,33.33
03,021,01,001,0007,19 ,883,13,896,1442,0,3,1,3,0,1,0,76.14,62.14 ,33.33
03,021,01,001,0008,20 ,1225,15,1240,2165,0,3,1,3,0,1,0,76.14,57.27 ,33.33
03,021,01,001,0008,21 ,851,10,861,1465,0,3,1,3,0,1,0,76.14,58.77 ,33.33
03,021,01,001,0009,22 ,707,2,709,1211,0,3,1,3,0,1,0,76.14,58.55 ,33.33
03,021,01,001,0009,23 ,857,8,865,1309,0,3,1,3,0,1,0,76.14,66.08 ,33.33
03,021,01,001,0010,24 ,956,13,969,1412,0,3,1,3,0,1,0,76.14,68.63 ,33.33
03,021,01,001,0010,25 ,982,11,993,1504,0,3,1,3,0,1,0,76.14,66.02 ,33.33
03,021,01,001,0010,26 ,813,8,821,1393,0,3,1,3,0,1,0,76.14,58.94 ,33.33
03,021,01,001,0010,27 ,1073,7,1080,1760,0,3,1,3,0,1,0,76.14,61.36 ,33.33
03,021,01,001,0011,28 ,1343,16,1359,2323,0,3,1,3,0,1,0,76.14,58.50 ,33.33
03,021,01,001,0011,29 ,1232,15,1247,2064,0,3,1,3,0,1,0,76.14,60.42 ,33.33
03,021,01,001,0011,30 ,1139,13,1152,1885,0,3,1,3,0,1,0,76.14,61.11 ,33.33
03,021,01,001,0012,31 ,747,6,753,1158,0,3,1,3,0,1,0,76.14,65.03 ,33.33
03,021,01,001,0012,32 ,622,11,633,1004,0,3,1,3,0,1,0,76.14,63.05 ,33.33
03,021,01,001,0013,33 ,889,13,902,1388,0,3,1,3,0,1,0,76.14,64.99 ,33.33
03,021,01,001,0013,34 ,984,10,994,1527,0,3,1,3,0,1,0,76.14,65.09 ,33.33
03,021,01,001,0013,35 ,946,10,956,1476,0,3,1,3,0,1,0,76.14,64.77 ,33.33
03,021,01,001,0014,36 ,817,11,828,1227,0,3,1,3,0,1,0,76.14,67.48 ,33.33
03,021,01,001,0014,37 ,958,14,972,1456,0,3,1,3,0,1,0,76.14,66.76 ,33.33
03,021,01,001,0015,38 ,640,11,651,928,0,3,1,3,0,1,0,76.14,70.15 ,33.33
03,021,01,001,0015,39 ,700,13,713,1003,0,3,1,3,0,1,0,76.14,71.09 ,33.33
03,021,01,001,0016,40 ,1195,15,1210,1712,0,3,1,3,0,1,0,76.14,70.68 ,33.33
03,021,01,001,0017,41 ,1294,19,1313,2129,0,3,1,3,0,1,0,76.14,61.67 ,33.33
03,021,01,001,0017,42 ,1217,19,1236,1814,0,3,1,3,0,1,0,76.14,68.14 ,33.33
03,021,01,001,0018,43 ,940,10,950,1520,0,3,1,3,0,1,0,76.14,62.50 ,33.33
03,021,01,001,0018,44 ,992,5,997,1615,0,3,1,3,0,1,0,76.14,61.73 ,33.33
03,021,01,001,0019,45 ,1008,11,1019,1518,0,3,1,3,0,1,0,76.14,67.13 ,33.33
03,021,01,001,0019,46 ,927,8,935,1465,0,3,1,3,0,1,0,76.14,63.82 ,33.33
03,021,01,001,0020,47 ,815,12,827,1352,0,3,1,3,0,1,0,76.14,61.17 ,33.33
03,021,01,001,0020,48 ,799,8,807,1249,0,3,1,3,0,1,0,76.14,64.61 ,33.33
03,021,01,001,0020,49 ,754,2,756,1195,0,3,1,3,0,1,0,76.14,63.26 ,33.33
03,021,01,001,0021,50 ,963,5,968,1466,0,3,1,3,0,1,0,76.14,66.03 ,33.33
03,021,01,001,0022,51 ,520,12,532,852,0,3,1,3,0,1,0,76.14,62.44 ,33.33
03,021,01,001,0023,52 ,454,2,456,734,0,3,1,3,0,1,0,76.14,62.13 ,33.33
03,021,01,001,0024,53 ,723,8,731,1128,0,3,1,3,0,1,0,76.14,64.80 ,33.33
03,021,01,001,0025,54 ,705,6,711,1132,0,3,1,3,0,1,0,76.14,62.81 ,33.33
03,021,01,001,0026,55 ,493,13,506,766,0,3,1,3,0,1,0,76.14,66.06 ,33.33
03,021,01,001,0027,56 ,778,5,783,1137,0,3,1,3,0,1,0,76.14,68.87 ,33.33
03,021,01,001,0027,57 ,515,6,521,808,0,3,1,3,0,1,0,76.14,64.48 ,33.33
03,021,01,001,0028,58 ,1006,9,1015,1558,0,3,1,3,0,1,0,76.14,65.15 ,33.33
03,021,01,001,0028,59 ,803,7,810,1360,0,3,1,3,0,1,0,76.14,59.56 ,33.33
03,021,01,001,0029,60 ,980,20,1000,1659,0,3,1,3,0,1,0,76.14,60.28 ,33.33
03,021,01,001,0030,61 ,819,17,836,1330,0,3,1,3,0,1,0,76.14,62.86 ,33.33
03,021,01,001,0030,62 ,740,10,750,1168,0,3,1,3,0,1,0,76.14,64.21 ,33.33
03,021,01,001,0031,63 ,967,17,984,1479,0,3,1,3,0,1,0,76.14,66.53 ,33.33
03,021,01,001,0031,64 ,763,7,770,1257,0,3,1,3,0,1,0,76.14,61.26 ,33.33
03,021,01,001,0032,65 ,965,16,981,1608,0,3,1,3,0,1,0,76.14,61.01 ,33.33
03,021,01,001,0033,66 ,961,8,969,1511,0,3,1,3,0,1,0,76.14,64.13 ,33.33
03,021,01,001,0033,67 ,821,13,834,1266,0,3,1,3,0,1,0,76.14,65.88 ,33.33
03,021,01,001,0034,68 ,1388,22,1410,2099,0,3,1,3,0,1,0,76.14,67.17 ,33.33
03,021,01,001,0034,69 ,1161,18,1179,1775,0,3,1,3,0,1,0,76.14,66.42 ,33.33
03,021,01,001,0035,70 ,706,11,717,1115,0,3,1,3,0,1,0,76.14,64.30 ,33.33
03,021,01,001,0035,71 ,613,6,619,1002,0,3,1,3,0,1,0,76.14,61.78 ,33.33
03,021,01,001,0036,72 ,875,7,882,1413,0,3,1,3,0,1,0,76.14,62.42 ,33.33
03,021,01,001,0036,73 ,594,3,597,935,0,3,1,3,0,1,0,76.14,63.85 ,33.33
03,021,01,001,0037,74 ,1322,21,1343,2189,0,3,1,3,0,1,0,76.14,61.35 ,33.33
03,021,01,001,0037,75 ,1129,15,1144,1836,0,3,1,3,0,1,0,76.14,62.31 ,33.33
03,021,01,001,0037,76 ,501,23,524,777,0,3,1,3,0,1,0,76.14,67.44 ,33.33
03,021,01,001,0038,77 ,1216,18,1234,1856,0,3,1,3,0,1,0,76.14,66.49 ,33.33
03,021,01,001,0039,78 ,1028,13,1041,1687,0,3,1,3,0,1,0,76.14,61.71 ,33.33
03,021,01,001,0040,79 ,828,7,835,1392,0,3,1,3,0,1,0,76.14,59.99 ,33.33
03,021,01,001,0041,80 ,665,9,674,1028,0,3,1,3,0,1,0,76.14,65.56 ,33.33
03,021,01,001,0042,81 ,772,10,782,1177,0,3,1,3,0,1,0,76.14,66.44 ,33.33
03,021,01,001,0043,82 ,488,8,496,766,0,3,1,3,0,1,0,76.14,64.75 ,33.33
03,021,01,001,0044,83 ,1268,12,1280,2016,0,3,1,3,0,1,0,76.14,63.49 ,33.33
03,021,01,001,0044,84 ,1275,15,1290,2068,0,3,1,3,0,1,0,76.14,62.38 ,33.33
03,021,01,001,0045,85 ,1102,13,1115,1720,0,3,1,3,0,1,0,76.14,64.83 ,33.33
03,021,01,001,0045,86 ,655,1,656,998,0,3,1,3,0,1,0,76.14,65.73 ,33.33
03,021,01,001,0045,87 ,921,7,928,1480,0,3,1,3,0,1,0,76.14,62.70 ,33.33
03,021,01,001,0045,88 ,912,13,925,1477,0,3,1,3,0,1,0,76.14,62.63 ,33.33
03,021,01,002,0046,89 ,951,6,957,1529,0,3,1,3,0,1,0,76.14,62.59 ,33.33
03,021,01,002,0046,90 ,1002,15,1017,1561,0,3,1,3,0,1,0,76.14,65.15 ,33.33
03,021,01,002,0047,91 ,666,4,670,1050,0,3,1,3,0,1,0,76.14,63.81 ,33.33
03,021,01,002,0047,92 ,582,16,598,926,0,3,1,3,0,1,0,76.14,64.58 ,33.33
03,021,01,002,0048,93 ,677,10,687,1132,0,3,1,3,0,1,0,76.14,60.69 ,33.33
03,021,01,002,0048,94 ,864,11,875,1470,0,3,1,3,0,1,0,76.14,59.52 ,33.33
03,021,01,002,0048,95 ,973,10,983,1521,0,3,1,3,0,1,0,76.14,64.63 ,33.33
03,021,01,002,0049,96 ,666,9,675,1006,0,3,1,3,0,1,0,76.14,67.10 ,33.33
03,021,01,002,0050,97 ,840,9,849,1330,0,3,1,3,0,1,0,76.14,63.83 ,33.33
03,021,01,002,0051,98 ,682,13,695,1033,0,3,1,3,0,1,0,76.14,67.28 ,33.33
03,021,01,002,0052,99 ,756,7,763,1175,0,3,1,3,0,1,0,76.14,64.94 ,33.33
03,021,01,002,0053,100 ,802,16,818,1322,0,3,1,3,0,1,0,76.14,61.88 ,33.33
03,021,01,002,0054,101 ,583,7,590,944,0,3,1,3,0,1,0,76.14,62.50 ,33.33
03,021,01,002,0055,102 ,478,2,480,750,0,3,1,3,0,1,0,76.14,64.00 ,33.33
03,021,01,002,0055,103 ,687,8,695,1072,0,3,1,3,0,1,0,76.14,64.83 ,33.33
03,021,01,002,0055,104 ,989,9,998,1483,0,3,1,3,0,1,0,76.14,67.30 ,33.33
03,021,01,002,0056,105 ,870,8,878,1365,0,3,1,3,0,1,0,76.14,64.32 ,33.33
03,021,01,002,0056,106 ,791,9,800,1255,0,3,1,3,0,1,0,76.14,63.75 ,33.33
03,021,01,002,0057,107 ,737,8,745,1145,0,3,1,3,0,1,0,76.14,65.07 ,33.33
03,021,01,002,0057,108 ,685,5,690,1067,0,3,1,3,0,1,0,76.14,64.67 ,33.33
03,021,01,002,0058,109 ,864,6,870,1255,0,3,1,3,0,1,0,76.14,69.32 ,33.33
03,021,01,002,0058,110 ,848,13,861,1290,0,3,1,3,0,1,0,76.14,66.74 ,33.33
03,021,01,002,0059,111 ,751,7,758,1163,0,3,1,3,0,1,0,76.14,65.18 ,33.33
03,021,01,002,0059,112 ,742,6,748,1190,0,3,1,3,0,1,0,76.14,62.86 ,33.33
03,021,01,002,0060,113 ,906,12,918,1473,0,3,1,3,0,1,0,76.14,62.32 ,33.33
03,021,01,002,0060,114 ,1035,12,1047,1597,0,3,1,3,0,1,0,76.14,65.56 ,33.33
03,021,01,002,0061,115 ,1074,13,1087,1604,0,3,1,3,0,1,0,76.14,67.77 ,33.33
03,021,01,002,0061,116 ,1198,8,1206,1975,0,3,1,3,0,1,0,76.14,61.06 ,33.33
03,021,01,002,0062,117 ,868,14,882,1383,0,3,1,3,0,1,0,76.14,63.77 ,33.33
03,021,01,002,0062,118 ,1017,9,1026,1709,0,3,1,3,0,1,0,76.14,60.04 ,33.33
03,021,01,002,0062,119 ,968,12,980,1531,0,3,1,3,0,1,0,76.14,64.01 ,33.33
03,021,01,002,0063,120 ,1025,15,1040,1575,0,3,1,3,0,1,0,76.14,66.03 ,33.33
03,021,01,002,0063,121 ,856,11,867,1389,0,3,1,3,0,1,0,76.14,62.42 ,33.33
03,021,01,002,0064,122 ,624,12,636,921,0,3,1,3,0,1,0,76.14,69.06 ,33.33
03,021,01,002,0064,123 ,627,11,638,1075,0,3,1,3,0,1,0,76.14,59.35 ,33.33
03,021,01,002,0065,124 ,997,11,1008,1556,0,3,1,3,0,1,0,76.14,64.78 ,33.33
03,021,01,002,0065,125 ,774,8,782,1326,0,3,1,3,0,1,0,76.14,58.97 ,33.33
03,021,01,002,0065,126 ,743,1,744,1214,0,3,1,3,0,1,0,76.14,61.29 ,33.33
03,021,01,002,0066,127 ,459,4,463,758,0,3,1,3,0,1,0,76.14,61.08 ,33.33
03,021,01,002,0066,128 ,756,12,768,1159,0,3,1,3,0,1,0,76.14,66.26 ,33.33
03,021,01,002,0067,129 ,895,10,905,1587,0,3,1,3,0,1,0,76.14,57.03 ,33.33
03,021,01,002,0067,130 ,1142,18,1160,1836,0,3,1,3,0,1,0,76.14,63.18 ,33.33
03,021,01,002,0068,131 ,854,11,865,1429,0,3,1,3,0,1,0,76.14,60.53 ,33.33
03,021,01,002,0068,132 ,725,11,736,1195,0,3,1,3,0,1,0,76.14,61.59 ,33.33
03,021,01,002,0068,133 ,780,10,790,1276,0,3,1,3,0,1,0,76.14,61.91 ,33.33
03,021,01,002,0069,134 ,992,13,1005,1514,0,3,1,3,0,1,0,76.14,66.38 ,33.33
03,021,01,002,0069,135 ,967,7,974,1598,0,3,1,3,0,1,0,76.14,60.95 ,33.33
03,021,01,002,0070,136 ,1080,17,1097,1671,0,3,1,3,0,1,0,76.14,65.65 ,33.33
03,021,01,002,0070,137 ,929,19,948,1592,0,3,1,3,0,1,0,76.14,59.55 ,33.33
03,021,01,002,0071,138 ,1114,16,1130,1747,0,3,1,3,0,1,0,76.14,64.68 ,33.33
03,021,01,002,0071,139 ,1241,16,1257,1958,0,3,1,3,0,1,0,76.14,64.20 ,33.33
03,021,01,002,0072,140 ,813,9,822,1523,0,3,1,3,0,1,0,76.14,53.97 ,33.33
03,021,01,002,0072,141 ,862,8,870,1484,0,3,1,3,0,1,0,76.14,58.63 ,33.33
03,021,01,002,0072,142 ,811,12,823,1438,0,3,1,3,0,1,0,76.14,57.23 ,33.33
03,021,01,002,0073,143 ,1037,12,1049,1892,0,3,1,3,0,1,0,76.14,55.44 ,33.33
03,021,01,002,0073,144 ,1086,17,1103,1962,0,3,1,3,0,1,0,76.14,56.22 ,33.33
03,021,01,002,0074,145 ,553,8,561,938,0,3,1,3,0,1,0,76.14,59.81 ,33.33
03,021,01,002,0074,146 ,567,14,581,948,0,3,1,3,0,1,0,76.14,61.29 ,33.33
03,021,01,002,0075,147 ,675,14,689,1012,0,3,1,3,0,1,0,76.14,68.08 ,33.33
03,021,01,002,0076,148 ,597,7,604,900,0,3,1,3,0,1,0,76.14,67.11 ,33.33
03,021,01,002,0077,149 ,667,6,673,1084,0,3,1,3,0,1,0,76.14,62.08 ,33.33
03,021,01,002,0077,150 ,722,6,728,1075,0,3,1,3,0,1,0,76.14,67.72 ,33.33
03,021,01,002,0078,151 ,907,11,918,1430,0,3,1,3,0,1,0,76.14,64.20 ,33.33
03,021,01,002,0079,152 ,947,7,954,1502,0,3,1,3,0,1,0,76.14,63.52 ,33.33
03,021,01,002,0080,153 ,845,10,855,1341,0,3,1,3,0,1,0,76.14,63.76 ,33.33
03,021,01,002,0080,154 ,779,9,788,1290,0,3,1,3,0,1,0,76.14,61.09 ,33.33
03,021,01,002,0081,155 ,450,10,460,650,0,3,1,3,0,1,0,76.14,70.77 ,33.33
03,021,01,002,0082,156 ,407,7,414,605,0,3,1,3,0,1,0,76.14,68.43 ,33.33
03,021,01,002,0083,157 ,606,6,612,962,0,3,1,3,0,1,0,76.14,63.62 ,33.33
03,021,01,002,0084,158 ,492,3,495,760,0,3,1,3,0,1,0,76.14,65.13 ,33.33
03,021,01,002,0085,159 ,1116,14,1130,1746,0,3,1,3,0,1,0,76.14,64.72 ,33.33
03,021,01,002,0086,160 ,1189,16,1205,1937,0,3,1,3,0,1,0,76.14,62.21 ,33.33
03,021,01,002,0087,161 ,504,7,511,740,0,3,1,3,0,1,0,76.14,69.05 ,33.33
03,021,01,002,0088,162 ,1163,14,1177,1791,0,3,1,3,0,1,0,76.14,65.72 ,33.33
03,021,01,003,0089,163 ,1016,9,1025,1657,0,3,1,3,0,1,0,76.14,61.86 ,33.33
03,021,01,003,0089,164 ,939,11,950,1432,0,3,1,3,0,1,0,76.14,66.34 ,33.33
03,021,01,003,0090,165 ,587,5,592,916,0,3,1,3,0,1,0,76.14,64.63 ,33.33
03,021,01,003,0090,166 ,1140,6,1146,1765,0,3,1,3,0,1,0,76.14,64.93 ,33.33
03,021,01,003,0091,167 ,945,8,953,1502,0,3,1,3,0,1,0,76.14,63.45 ,33.33
03,021,01,003,0091,168 ,681,12,693,1004,0,3,1,3,0,1,0,76.14,69.02 ,33.33
03,021,01,003,0092,169 ,793,13,806,1223,0,3,1,3,0,1,0,76.14,65.90 ,33.33
03,021,01,003,0093,170 ,702,9,711,1077,0,3,1,3,0,1,0,76.14,66.02 ,33.33
03,021,01,003,0093,171 ,612,11,623,893,0,3,1,3,0,1,0,76.14,69.76 ,33.33
03,021,01,003,0094,172 ,377,5,382,589,0,3,1,3,0,1,0,76.14,64.86 ,33.33
03,021,01,003,0095,173 ,488,3,491,683,0,3,1,3,0,1,0,76.14,71.89 ,33.33
03,021,01,003,0096,174 ,494,10,504,735,0,3,1,3,0,1,0,76.14,68.57 ,33.33
03,021,01,003,0097,175 ,469,8,477,697,0,3,1,3,0,1,0,76.14,68.44 ,33.33
03,021,01,003,0098,176 ,376,9,385,558,0,3,1,3,0,1,0,76.14,69.00 ,33.33
03,021,01,003,0099,177 ,614,5,619,959,0,3,1,3,0,1,0,76.14,64.55 ,33.33
03,021,01,003,0100,178 ,558,10,568,889,0,3,1,3,0,1,0,76.14,63.89 ,33.33
03,021,01,003,0101,179 ,705,5,710,1045,0,3,1,3,0,1,0,76.14,67.94 ,33.33
03,021,01,003,0101,180 ,975,8,983,1564,0,3,1,3,0,1,0,76.14,62.85 ,33.33
03,021,01,003,0102,181 ,668,10,678,1045,0,3,1,3,0,1,0,76.14,64.88 ,33.33
03,021,01,003,0103,182 ,560,14,574,805,0,3,1,3,0,1,0,76.14,71.30 ,33.33
03,021,01,003,0104,183 ,327,3,330,473,0,3,1,3,0,1,0,76.14,69.77 ,33.33
03,021,01,003,0105,184 ,547,9,556,835,0,3,1,3,0,1,0,76.14,66.59 ,33.33
03,021,01,003,0106,185 ,370,7,377,569,0,3,1,3,0,1,0,76.14,66.26 ,33.33
03,021,01,003,0107,186 ,640,8,648,1114,0,3,1,3,0,1,0,76.14,58.17 ,33.33
03,021,01,003,0108,187 ,565,8,573,921,0,3,1,3,0,1,0,76.14,62.21 ,33.33
03,021,01,003,0108,188 ,800,13,813,1295,0,3,1,3,0,1,0,76.14,62.78 ,33.33
03,021,01,003,0109,189 ,454,6,460,796,0,3,1,3,0,1,0,76.14,57.79 ,33.33
03,021,01,003,0110,190 ,326,6,332,520,0,3,1,3,0,1,0,76.14,63.85 ,33.33
03,021,01,003,0111,191 ,168,1,169,237,0,3,1,3,0,1,0,76.14,71.31 ,33.33
03,021,01,003,0112,192 ,280,3,283,406,0,3,1,3,0,1,0,76.14,69.70 ,33.33
03,021,01,003,0113,193 ,285,3,288,420,0,3,1,3,0,1,0,76.14,68.57 ,33.33
03,021,01,003,0114,194 ,202,0,202,291,0,3,1,3,0,1,0,76.14,69.42 ,33.33
03,021,01,003,0115,195 ,605,13,618,937,0,3,1,3,0,1,0,76.14,65.96 ,33.33
03,021,01,003,0116,196 ,723,8,731,1068,0,3,1,3,0,1,0,76.14,68.45 ,33.33
03,021,01,003,0117,197 ,547,8,555,771,0,3,1,3,0,1,0,76.14,71.98 ,33.33
03,021,01,003,0118,198 ,835,12,847,1364,0,3,1,3,0,1,0,76.14,62.10 ,33.33
03,021,01,004,0119,199 ,595,6,601,946,0,3,1,3,0,1,0,76.14,63.53 ,33.33
03,021,01,004,0120,200 ,589,12,601,1090,0,3,1,3,0,1,0,76.14,55.14 ,33.33
03,021,01,004,0121,201 ,619,7,626,1084,0,3,1,3,0,1,0,76.14,57.75 ,33.33
03,021,01,004,0122,202 ,740,6,746,1243,0,3,1,3,0,1,0,76.14,60.02 ,33.33
03,021,01,004,0123,203 ,581,7,588,922,0,3,1,3,0,1,0,76.14,63.77 ,33.33
03,021,01,004,0124,204 ,622,6,628,996,0,3,1,3,0,1,0,76.14,63.05 ,33.33
03,021,01,004,0125,205 ,684,8,692,1129,0,3,1,3,0,1,0,76.14,61.29 ,33.33
03,021,01,004,0126,206 ,523,9,532,854,0,3,1,3,0,1,0,76.14,62.30 ,33.33
03,021,01,004,0127,207 ,748,15,763,1157,0,3,1,3,0,1,0,76.14,65.95 ,33.33
03,021,01,004,0128,208 ,572,7,579,913,0,3,1,3,0,1,0,76.14,63.42 ,33.33
03,021,01,004,0129,209 ,479,7,486,758,0,3,1,3,0,1,0,76.14,64.12 ,33.33
03,021,01,004,0129,210 ,609,6,615,962,0,3,1,3,0,1,0,76.14,63.93 ,33.33
03,021,01,004,0130,211 ,539,6,545,920,0,3,1,3,0,1,0,76.14,59.24 ,33.33
03,021,01,004,0130,212 ,637,2,639,966,0,3,1,3,0,1,0,76.14,66.15 ,33.33
03,021,01,004,0131,213 ,584,8,592,922,0,3,1,3,0,1,0,76.14,64.21 ,33.33
03,021,01,004,0131,214 ,648,8,656,1009,0,3,1,3,0,1,0,76.14,65.01 ,33.33
03,021,01,004,0132,215 ,900,8,908,1446,0,3,1,3,0,1,0,76.14,62.79 ,33.33
03,021,01,004,0132,216 ,906,9,915,1347,0,3,1,3,0,1,0,76.14,67.93 ,33.33
03,021,01,004,0133,217 ,639,6,645,1024,0,3,1,3,0,1,0,76.14,62.99 ,33.33
03,021,01,004,0133,218 ,654,5,659,1007,0,3,1,3,0,1,0,76.14,65.44 ,33.33
03,021,01,004,0134,219 ,624,5,629,1023,0,3,1,3,0,1,0,76.14,61.49 ,33.33
03,021,01,004,0134,220 ,754,9,763,1153,0,3,1,3,0,1,0,76.14,66.18 ,33.33
03,021,01,004,0135,221 ,937,17,954,1400,0,3,1,3,0,1,0,76.14,68.14 ,33.33
03,021,01,004,0136,222 ,525,11,536,870,0,3,1,3,0,1,0,76.14,61.61 ,33.33
03,021,01,004,0136,223 ,580,12,592,958,0,3,1,3,0,1,0,76.14,61.80 ,33.33
03,021,01,004,0137,224 ,887,10,897,1421,0,3,1,3,0,1,0,76.14,63.12 ,33.33
03,021,01,004,0137,225 ,806,13,819,1290,0,3,1,3,0,1,0,76.14,63.49 ,33.33
03,021,01,004,0137,226 ,615,9,624,1276,0,3,1,3,0,1,0,76.14,48.90 ,33.33
03,021,01,004,0138,227 ,573,7,580,896,0,3,1,3,0,1,0,76.14,64.73 ,33.33
03,021,01,004,0139,228 ,763,9,772,1242,0,3,1,3,0,1,0,76.14,62.16 ,33.33
03,021,01,004,0140,229 ,685,6,691,1075,0,3,1,3,0,1,0,76.14,64.28 ,33.33
03,021,01,004,0141,230 ,829,15,844,1300,0,3,1,3,0,1,0,76.14,64.92 ,33.33
03,021,01,004,0142,231 ,655,4,659,1086,0,3,1,3,0,1,0,76.14,60.68 ,33.33
03,021,01,004,0143,232 ,880,12,892,1467,0,3,1,3,0,1,0,76.14,60.80 ,33.33
03,021,01,004,0144,233 ,781,7,788,1222,0,3,1,3,0,1,0,76.14,64.48 ,33.33
03,021,01,004,0144,234 ,744,12,756,1154,0,3,1,3,0,1,0,76.14,65.51 ,33.33
03,021,01,004,0144,235 ,784,9,793,1255,0,3,1,3,0,1,0,76.14,63.19 ,33.33
03,021,01,004,0144,236 ,828,9,837,1279,0,3,1,3,0,1,0,76.14,65.44 ,33.33
03,021,01,004,0145,237 ,967,16,983,1533,0,3,1,3,0,1,0,76.14,64.12 ,33.33
03,021,01,004,0146,238 ,517,6,523,862,0,3,1,3,0,1,0,76.14,60.67 ,33.33
03,021,01,004,0146,239 ,576,8,584,961,0,3,1,3,0,1,0,76.14,60.77 ,33.33
03,021,01,004,0147,240 ,996,25,1021,1577,0,3,1,3,0,1,0,76.14,64.74 ,33.33
03,021,01,004,0148,241 ,796,9,805,1353,0,3,1,3,0,1,0,76.14,59.50 ,33.33
03,021,01,004,0149,242 ,1001,9,1010,1550,0,3,1,3,0,1,0,76.14,65.16 ,33.33
03,021,01,004,0150,243 ,644,11,655,1114,0,3,1,3,0,1,0,76.14,58.80 ,33.33
03,021,01,004,0150,244 ,665,6,671,1157,0,3,1,3,0,1,0,76.14,57.99 ,33.33
03,021,01,004,0151,245 ,774,6,780,1216,0,3,1,3,0,1,0,76.14,64.14 ,33.33
03,021,01,004,0151,246 ,642,15,657,1026,0,3,1,3,0,1,0,76.14,64.04 ,33.33
03,021,01,004,0151,247 ,631,6,637,993,0,3,1,3,0,1,0,76.14,64.15 ,33.33
03,021,01,004,0152,248 ,774,9,783,1288,0,3,1,3,0,1,0,76.14,60.79 ,33.33
03,021,01,004,0152,249 ,713,3,716,1241,0,3,1,3,0,1,0,76.14,57.70 ,33.33
03,021,01,004,0152,250 ,797,11,808,1289,0,3,1,3,0,1,0,76.14,62.68 ,33.33
03,021,01,004,0152,251 ,654,5,659,1147,0,3,1,3,0,1,0,76.14,57.45 ,33.33
03,021,01,004,0152,252 ,820,9,829,1342,0,3,1,3,0,1,0,76.14,61.77 ,33.33
03,021,01,004,0153,253 ,769,8,777,1291,0,3,1,3,0,1,0,76.14,60.19 ,33.33
03,021,01,004,0153,254 ,795,7,802,1380,0,3,1,3,0,1,0,76.14,58.12 ,33.33
03,021,01,004,0153,255 ,530,3,533,849,0,3,1,3,0,1,0,76.14,62.78 ,33.33
03,021,01,004,0153,256 ,733,5,738,1131,0,3,1,3,0,1,0,76.14,65.25 ,33.33
03,021,01,004,0154,257 ,817,4,821,1195,0,3,1,3,0,1,0,76.14,68.70 ,33.33
03,021,01,004,0155,258 ,913,5,918,1412,0,3,1,3,0,1,0,76.14,65.01 ,33.33
03,021,01,004,0156,259 ,838,10,848,1327,0,3,1,3,0,1,0,76.14,63.90 ,33.33
03,021,01,004,0156,260 ,944,8,952,1531,0,3,1,3,0,1,0,76.14,62.18 ,33.33
03,021,01,004,0156,261 ,824,15,839,1242,0,3,1,3,0,1,0,76.14,67.55 ,33.33
03,021,01,004,0156,262 ,803,8,811,1252,0,3,1,3,0,1,0,76.14,64.78 ,33.33
03,021,01,004,0157,263 ,915,12,927,1398,0,3,1,3,0,1,0,76.14,66.31 ,33.33
03,021,01,004,0157,264 ,910,13,923,1436,0,3,1,3,0,1,0,76.14,64.28 ,33.33
03,021,01,004,0157,265 ,882,13,895,1335,0,3,1,3,0,1,0,76.14,67.04 ,33.33
03,021,01,004,0157,266 ,961,14,975,1443,0,3,1,3,0,1,0,76.14,67.57 ,33.33
03,021,01,004,0157,267 ,1041,10,1051,1596,0,3,1,3,0,1,0,76.14,65.85 ,33.33
03,021,01,004,0158,268 ,859,11,870,1361,0,3,1,3,0,1,0,76.14,63.92 ,33.33
03,021,01,004,0158,269 ,954,6,960,1546,0,3,1,3,0,1,0,76.14,62.10 ,33.33
03,021,01,004,0158,270 ,1070,12,1082,1701,0,3,1,3,0,1,0,76.14,63.61 ,33.33
03,021,01,004,0158,271 ,816,14,830,1326,0,3,1,3,0,1,0,76.14,62.59 ,33.33
03,021,01,005,0159,272 ,738,7,745,1153,0,3,1,3,0,1,0,76.14,64.61 ,33.33
03,021,01,005,0160,273 ,695,9,704,1020,0,3,1,3,0,1,0,76.14,69.02 ,33.33
03,021,01,005,0161,274 ,703,15,718,1121,0,3,1,3,0,1,0,76.14,64.05 ,33.33
03,021,01,005,0162,275 ,846,10,856,1350,0,3,1,3,0,1,0,76.14,63.41 ,33.33
03,021,01,005,0163,276 ,470,5,475,699,0,3,1,3,0,1,0,76.14,67.95 ,33.33
03,021,01,005,0164,277 ,438,10,448,688,0,3,1,3,0,1,0,76.14,65.12 ,33.33
03,021,01,005,0165,278 ,229,5,234,363,0,3,1,3,0,1,0,76.14,64.46 ,33.33
03,021,01,005,0166,279 ,274,0,274,424,0,3,1,3,0,1,0,76.14,64.62 ,33.33
03,021,01,005,0167,280 ,736,13,749,1162,0,3,1,3,0,1,0,76.14,64.46 ,33.33
03,021,01,005,0168,281 ,244,3,247,376,0,3,1,3,0,1,0,76.14,65.69 ,33.33
03,021,01,005,0169,282 ,312,2,314,475,0,3,1,3,0,1,0,76.14,66.11 ,33.33
03,021,01,005,0170,283 ,313,6,319,498,0,3,1,3,0,1,0,76.14,64.06 ,33.33
03,021,01,005,0171,284 ,429,4,433,634,0,3,1,3,0,1,0,76.14,68.30 ,33.33
03,021,01,005,0172,285 ,487,7,494,716,0,3,1,3,0,1,0,76.14,68.99 ,33.33
03,021,01,005,0173,286 ,655,9,664,1019,0,3,1,3,0,1,0,76.14,65.16 ,33.33
03,021,01,005,0174,287 ,293,3,296,482,0,3,1,3,0,1,0,76.14,61.41 ,33.33
03,021,01,005,0175,288 ,416,8,424,688,0,3,1,3,0,1,0,76.14,61.63 ,33.33
03,021,01,005,0176,289 ,330,3,333,477,0,3,1,3,0,1,0,76.14,69.81 ,33.33
03,021,01,005,0177,290 ,371,5,376,591,0,3,1,3,0,1,0,76.14,63.62 ,33.33
03,021,01,005,0178,291 ,458,4,462,706,0,3,1,3,0,1,0,76.14,65.44 ,33.33
03,021,01,005,0179,292 ,449,4,453,731,0,3,1,3,0,1,0,76.14,61.97 ,33.33
03,021,01,005,0180,293 ,370,1,371,533,0,3,1,3,0,1,0,76.14,69.61 ,33.33
03,021,01,005,0181,294 ,571,9,580,866,0,3,1,3,0,1,0,76.14,66.97 ,33.33
03,021,01,005,0182,295 ,310,0,310,469,0,3,1,3,0,1,0,76.14,66.10 ,33.33
03,021,01,005,0183,296 ,272,5,277,429,0,3,1,3,0,1,0,76.14,64.57 ,33.33
03,021,01,005,0184,297 ,650,5,655,1023,0,3,1,3,0,1,0,76.14,64.03 ,33.33
03,021,01,005,0185,298 ,753,4,757,1283,0,3,1,3,0,1,0,76.14,59.00 ,33.33
03,021,01,005,0185,299 ,676,10,686,1074,0,3,1,3,0,1,0,76.14,63.87 ,33.33
03,021,01,005,0186,300 ,709,6,715,1076,0,3,1,3,0,1,0,76.14,66.45 ,33.33
03,021,01,005,0187,301 ,999,7,1006,1478,0,3,1,3,0,1,0,76.14,68.06 ,33.33
03,021,01,005,0188,302 ,442,4,446,687,0,3,1,3,0,1,0,76.14,64.92 ,33.33
03,021,01,005,0189,303 ,485,4,489,734,0,3,1,3,0,1,0,76.14,66.62 ,33.33
03,021,01,005,0190,304 ,918,9,927,1450,0,3,1,3,0,1,0,76.14,63.93 ,33.33
03,021,01,005,0191,305 ,1050,9,1059,1623,0,3,1,3,0,1,0,76.14,65.25 ,33.33
03,021,01,005,0192,306 ,1084,14,1098,1665,0,3,1,3,0,1,0,76.14,65.95 ,33.33
03,021,01,005,0192,307 ,996,2,998,1566,0,3,1,3,0,1,0,76.14,63.73 ,33.33
03,021,01,006,0193,308 ,399,7,406,533,0,3,1,3,0,1,0,76.14,76.17 ,33.33
03,021,01,006,0194,309 ,1195,16,1211,2002,0,3,1,3,0,1,0,76.14,60.49 ,33.33
03,021,01,006,0194,310 ,858,11,869,1453,0,3,1,3,0,1,0,76.14,59.81 ,33.33
03,021,01,006,0195,311 ,1005,6,1011,1568,0,3,1,3,0,1,0,76.14,64.48 ,33.33
03,021,01,006,0195,312 ,846,9,855,1339,0,3,1,3,0,1,0,76.14,63.85 ,33.33
03,021,01,006,0195,313 ,742,9,751,1229,0,3,1,3,0,1,0,76.14,61.11 ,33.33
03,021,01,006,0196,314 ,732,16,748,1100,0,3,1,3,0,1,0,76.14,68.00 ,33.33
03,021,01,006,0196,315 ,843,12,855,1279,0,3,1,3,0,1,0,76.14,66.85 ,33.33
03,021,01,006,0197,316 ,892,12,904,1333,0,3,1,3,0,1,0,76.14,67.82 ,33.33
03,021,01,006,0197,317 ,1023,9,1032,1646,0,3,1,3,0,1,0,76.14,62.70 ,33.33
03,021,01,006,0198,318 ,1054,23,1077,1595,0,3,1,3,0,1,0,76.14,67.52 ,33.33
03,021,01,006,0198,319 ,841,9,850,1328,0,3,1,3,0,1,0,76.14,64.01 ,33.33
03,021,01,006,0199,320 ,786,9,795,1114,0,3,1,3,0,1,0,76.14,71.36 ,33.33
03,021,01,006,0199,321 ,873,13,886,1412,0,3,1,3,0,1,0,76.14,62.75 ,33.33
03,021,01,006,0200,322 ,1564,18,1582,2481,0,3,1,3,0,1,0,76.14,63.76 ,33.33
03,021,01,006,0200,323 ,906,13,919,1400,0,3,1,3,0,1,0,76.14,65.64 ,33.33
03,021,01,006,0201,324 ,731,6,737,1185,0,3,1,3,0,1,0,76.14,62.19 ,33.33
03,021,01,006,0201,325 ,794,8,802,1243,0,3,1,3,0,1,0,76.14,64.52 ,33.33
03,021,01,006,0202,326 ,1201,15,1216,1856,0,3,1,3,0,1,0,76.14,65.52 ,33.33
03,021,01,006,0203,327 ,658,6,664,997,0,3,1,3,0,1,0,76.14,66.60 ,33.33
03,021,01,006,0203,328 ,728,10,738,1115,0,3,1,3,0,1,0,76.14,66.19 ,33.33
03,021,01,006,0204,329 ,1134,13,1147,1830,0,3,1,3,0,1,0,76.14,62.68 ,33.33
03,021,01,006,0204,330 ,1107,22,1129,1747,0,3,1,3,0,1,0,76.14,64.63 ,33.33
03,021,01,006,0205,331 ,785,9,794,1155,0,3,1,3,0,1,0,76.14,68.74 ,33.33
03,021,01,006,0205,332 ,865,10,875,1378,0,3,1,3,0,1,0,76.14,63.50 ,33.33
03,021,01,006,0206,333 ,981,12,993,1741,0,3,1,3,0,1,0,76.14,57.04 ,33.33
03,021,01,006,0206,334 ,929,16,945,1583,0,3,1,3,0,1,0,76.14,59.70 ,33.33
03,021,01,006,0207,335 ,852,13,865,1420,0,3,1,3,0,1,0,76.14,60.92 ,33.33
03,021,01,006,0207,336 ,924,9,933,1567,0,3,1,3,0,1,0,76.14,59.54 ,33.33
03,021,01,006,0208,337 ,1056,6,1062,1681,0,3,1,3,0,1,0,76.14,63.18 ,33.33
03,021,01,006,0208,338 ,871,10,881,1393,0,3,1,3,0,1,0,76.14,63.24 ,33.33
03,021,01,006,0208,339 ,1008,14,1022,1609,0,3,1,3,0,1,0,76.14,63.52 ,33.33
03,021,01,006,0208,340 ,812,12,824,1360,0,3,1,3,0,1,0,76.14,60.59 ,33.33
03,021,01,006,0209,341 ,958,13,971,1359,0,3,1,3,0,1,0,76.14,71.45 ,33.33
03,021,01,006,0210,342 ,947,20,967,1464,0,3,1,3,0,1,0,76.14,66.05 ,33.33
03,021,01,006,0210,343 ,1060,17,1077,1639,0,3,1,3,0,1,0,76.14,65.71 ,33.33
03,021,01,006,0211,344 ,662,5,667,957,0,3,1,3,0,1,0,76.14,69.70 ,33.33
03,021,01,006,0212,345 ,773,6,779,1197,0,3,1,3,0,1,0,76.14,65.08 ,33.33
03,021,01,006,0213,346 ,1197,23,1220,1671,0,3,1,3,0,1,0,76.14,73.01 ,33.33
03,021,01,006,0214,347 ,792,7,799,1341,0,3,1,3,0,1,0,76.14,59.58 ,33.33
03,021,01,006,0215,348 ,1057,13,1070,1677,0,3,1,3,0,1,0,76.14,63.80 ,33.33
03,021,01,006,0216,349 ,608,6,614,811,0,3,1,3,0,1,0,76.14,75.71 ,33.33
03,021,01,006,0217,350 ,609,11,620,1044,0,3,1,3,0,1,0,76.14,59.39 ,33.33
03,021,01,006,0217,351 ,672,13,685,1080,0,3,1,3,0,1,0,76.14,63.43 ,33.33
03,021,01,006,0218,352 ,946,9,955,1511,0,3,1,3,0,1,0,76.14,63.20 ,33.33
03,021,01,006,0219,353 ,705,15,720,1143,0,3,1,3,0,1,0,76.14,62.99 ,33.33
03,021,01,006,0219,354 ,737,11,748,1236,0,3,1,3,0,1,0,76.14,60.52 ,33.33
03,021,01,006,0220,355 ,791,10,801,1238,0,3,1,3,0,1,0,76.14,64.70 ,33.33
03,021,01,006,0220,356 ,690,15,705,993,0,3,1,3,0,1,0,76.14,71.00 ,33.33
03,021,01,006,0221,357 ,1083,21,1104,1747,0,3,1,3,0,1,0,76.14,63.19 ,33.33
03,021,01,006,0221,358 ,807,12,819,1350,0,3,1,3,0,1,0,76.14,60.67 ,33.33
03,021,01,006,0222,359 ,1360,9,1369,2304,0,3,1,3,0,1,0,76.14,59.42 ,33.33
03,021,01,006,0222,360 ,707,8,715,1119,0,3,1,3,0,1,0,76.14,63.90 ,33.33
03,021,01,006,0223,361 ,939,12,951,1494,0,3,1,3,0,1,0,76.14,63.65 ,33.33
03,021,01,006,0223,362 ,752,12,764,1212,0,3,1,3,0,1,0,76.14,63.04 ,33.33
03,021,01,006,0224,363 ,991,15,1006,1590,0,3,1,3,0,1,0,76.14,63.27 ,33.33
03,021,01,006,0224,364 ,666,11,677,1118,0,3,1,3,0,1,0,76.14,60.55 ,33.33
03,021,01,006,0225,365 ,859,15,874,1356,0,3,1,3,0,1,0,76.14,64.45 ,33.33
03,021,01,006,0225,366 ,858,8,866,1381,0,3,1,3,0,1,0,76.14,62.71 ,33.33
03,021,01,006,0226,367 ,1156,11,1167,1847,0,3,1,3,0,1,0,76.14,63.18 ,33.33
03,021,01,006,0226,368 ,1209,18,1227,1899,0,3,1,3,0,1,0,76.14,64.61 ,33.33
03,021,01,006,0227,369 ,1035,19,1054,1572,0,3,1,3,0,1,0,76.14,67.05 ,33.33
03,021,01,006,0228,370 ,482,8,490,743,0,3,1,3,0,1,0,76.14,65.95 ,33.33
03,021,01,006,0228,371 ,1120,13,1133,1818,0,3,1,3,0,1,0,76.14,62.32 ,33.33
03,021,01,006,0229,372 ,1153,17,1170,1912,0,3,1,3,0,1,0,76.14,61.19 ,33.33
03,021,01,006,0229,373 ,1214,14,1228,2019,0,3,1,3,0,1,0,76.14,60.82 ,33.33
03,021,01,006,0230,374 ,1191,15,1206,1870,0,3,1,3,0,1,0,76.14,64.49 ,33.33
03,021,01,006,0230,375 ,923,10,933,1454,0,3,1,3,0,1,0,76.14,64.17 ,33.33
03,021,01,006,0231,376 ,594,4,598,975,0,3,1,3,0,1,0,76.14,61.33 ,33.33
03,021,01,006,0231,377 ,624,5,629,933,0,3,1,3,0,1,0,76.14,67.42 ,33.33
03,021,01,006,0232,378 ,882,13,895,1350,0,3,1,3,0,1,0,76.14,66.30 ,33.33
03,021,01,006,0233,379 ,1076,19,1095,1616,0,3,1,3,0,1,0,76.14,67.76 ,33.33
03,021,01,006,0233,380 ,501,5,506,694,0,3,1,3,0,1,0,76.14,72.91 ,33.33
03,021,01,006,0234,381 ,833,19,852,1170,0,3,1,3,0,1,0,76.14,72.82 ,33.33
03,021,01,006,0235,382 ,670,9,679,966,0,3,1,3,0,1,0,76.14,70.29 ,33.33
03,021,01,006,0236,383 ,827,9,836,1158,0,3,1,3,0,1,0,76.14,72.19 ,33.33
03,021,01,006,0237,384 ,674,7,681,828,0,3,1,3,0,1,0,76.14,82.25 ,33.33
03,021,01,006,0238,385 ,333,3,336,523,0,3,1,3,0,1,0,76.14,64.24 ,33.33
03,021,01,006,0238,386 ,307,5,312,436,0,3,1,3,0,1,0,76.14,71.56 ,33.33
03,021,01,006,0239,387 ,685,7,692,1029,0,3,1,3,0,1,0,76.14,67.25 ,33.33
03,021,01,006,0240,388 ,413,8,421,617,0,3,1,3,0,1,0,76.14,68.23 ,33.33
03,021,01,006,0241,389 ,969,11,980,1402,0,3,1,3,0,1,0,76.14,69.90 ,33.33
03,021,01,006,0242,390 ,437,5,442,597,0,3,1,3,0,1,0,76.14,74.04 ,33.33
03,021,01,007,0243,391 ,965,6,971,1549,0,3,1,3,0,1,0,76.14,62.69 ,33.33
03,021,01,007,0243,392 ,1086,13,1099,1704,0,3,1,3,0,1,0,76.14,64.50 ,33.33
03,021,01,007,0243,393 ,1049,12,1061,1688,0,3,1,3,0,1,0,76.14,62.86 ,33.33
03,021,01,007,0244,394 ,527,9,536,781,0,3,1,3,0,1,0,76.14,68.63 ,33.33
03,021,01,007,0245,395 ,282,5,287,441,0,3,1,3,0,1,0,76.14,65.08 ,33.33
03,021,01,007,0246,396 ,241,1,242,340,0,3,1,3,0,1,0,76.14,71.18 ,33.33
03,021,01,007,0247,397 ,247,1,248,331,0,3,1,3,0,1,0,76.14,74.92 ,33.33
03,021,01,007,0248,398 ,244,2,246,373,0,3,1,3,0,1,0,76.14,65.95 ,33.33
03,021,01,007,0249,399 ,569,3,572,823,0,3,1,3,0,1,0,76.14,69.50 ,33.33
03,021,01,007,0250,400 ,750,9,759,1071,0,3,1,3,0,1,0,76.14,70.87 ,33.33
03,021,01,007,0250,401 ,650,4,654,946,0,3,1,3,0,1,0,76.14,69.13 ,33.33
03,021,01,007,0251,402 ,913,14,927,1421,0,3,1,3,0,1,0,76.14,65.24 ,33.33
03,021,01,007,0252,403 ,373,9,382,522,0,3,1,3,0,1,0,76.14,73.18 ,33.33
03,021,01,007,0253,404 ,703,4,707,1151,0,3,1,3,0,1,0,76.14,61.42 ,33.33
03,021,01,007,0254,405 ,981,12,993,1818,0,3,1,3,0,1,0,76.14,54.62 ,33.33
03,021,01,007,0254,406 ,998,12,1010,1698,0,3,1,3,0,1,0,76.14,59.48 ,33.33
03,021,01,007,0255,407 ,1241,7,1248,2270,0,3,1,3,0,1,0,76.14,54.98 ,33.33
03,021,01,007,0255,408 ,1015,13,1028,1915,0,3,1,3,0,1,0,76.14,53.68 ,33.33
03,021,01,007,0256,409 ,1005,9,1014,1626,0,3,1,3,0,1,0,76.14,62.36 ,33.33
03,021,01,007,0256,410 ,994,18,1012,1669,0,3,1,3,0,1,0,76.14,60.64 ,33.33
03,021,01,007,0257,411 ,703,3,706,1208,0,3,1,3,0,1,0,76.14,58.44 ,33.33
03,021,01,007,0257,412 ,828,5,833,1590,0,3,1,3,0,1,0,76.14,52.39 ,33.33
03,021,01,007,0258,413 ,604,3,607,1094,0,3,1,3,0,1,0,76.14,55.48 ,33.33
03,021,01,007,0258,414 ,619,9,628,1002,0,3,1,3,0,1,0,76.14,62.67 ,33.33
03,021,01,007,0259,415 ,658,8,666,1145,0,3,1,3,0,1,0,76.14,58.17 ,33.33
03,021,01,007,0259,416 ,853,9,862,1379,0,3,1,3,0,1,0,76.14,62.51 ,33.33
03,021,01,007,0260,417 ,811,5,816,1294,0,3,1,3,0,1,0,76.14,63.06 ,33.33
03,021,01,007,0260,418 ,734,12,746,1184,0,3,1,3,0,1,0,76.14,63.01 ,33.33
04,001,01,001,0001,1 ,1234,24,1258,1886,0,3,1,3,0,1,0,76.14,66.70 ,33.33
04,001,01,001,0002,2 ,592,18,610,931,0,3,1,3,0,1,0,76.14,65.52 ,33.33
04,001,01,001,0002,3 ,801,18,819,1235,0,3,1,3,0,1,0,76.14,66.32 ,33.33
04,001,01,001,0003,4 ,642,11,653,1045,0,3,1,3,0,1,0,76.14,62.49 ,33.33
04,001,01,001,0003,5 ,731,20,751,1186,0,3,1,3,0,1,0,76.14,63.32 ,33.33
04,001,01,001,0003,6 ,872,14,886,1328,0,3,1,3,0,1,0,76.14,66.72 ,33.33
04,001,01,001,0004,7 ,1010,15,1025,1547,0,3,1,3,0,1,0,76.14,66.26 ,33.33
04,001,01,001,0005,8 ,764,23,787,1221,0,3,1,3,0,1,0,76.14,64.46 ,33.33
04,001,01,001,0006,9 ,443,11,454,664,0,3,1,3,0,1,0,76.14,68.37 ,33.33
04,001,01,001,0007,10 ,849,23,872,1290,0,3,1,3,0,1,0,76.14,67.60 ,33.33
04,001,01,001,0008,11 ,436,7,443,721,0,3,1,3,0,1,0,76.14,61.44 ,33.33
04,001,01,002,0009,12 ,797,18,815,1227,0,3,1,3,0,1,0,76.14,66.42 ,33.33
04,001,01,002,0010,13 ,944,33,977,1512,0,3,1,3,0,1,0,76.14,64.62 ,33.33
04,001,01,002,0011,14 ,903,22,925,1350,0,3,1,3,0,1,0,76.14,68.52 ,33.33
04,001,01,002,0012,15 ,946,29,975,1485,0,3,1,3,0,1,0,76.14,65.66 ,33.33
04,001,01,002,0013,16 ,692,19,711,1190,0,3,1,3,0,1,0,76.14,59.75 ,33.33
04,001,01,002,0014,17 ,305,11,316,516,0,3,1,3,0,1,0,76.14,61.24 ,33.33
04,001,01,003,0015,18 ,574,8,582,858,0,3,1,3,0,1,0,76.14,67.83 ,33.33
04,001,01,003,0015,19 ,604,8,612,944,0,3,1,3,0,1,0,76.14,64.83 ,33.33
04,001,01,003,0016,20 ,852,19,871,1353,0,3,1,3,0,1,0,76.14,64.38 ,33.33
04,001,01,003,0017,21 ,354,15,369,564,0,3,1,3,0,1,0,76.14,65.43 ,33.33
04,001,01,003,0018,22 ,358,7,365,571,0,3,1,3,0,1,0,76.14,63.92 ,33.33
04,001,01,003,0019,23 ,377,12,389,607,0,3,1,3,0,1,0,76.14,64.09 ,33.33
04,001,01,003,0020,24 ,1037,24,1061,1583,0,3,1,3,0,1,0,76.14,67.02 ,33.33
04,001,01,003,0021,25 ,585,28,613,863,0,3,1,3,0,1,0,76.14,71.03 ,33.33
04,001,01,003,0022,26 ,834,18,852,1193,0,3,1,3,0,1,0,76.14,71.42 ,33.33
04,001,01,004,0023,27 ,582,12,594,940,0,3,1,3,0,1,0,76.14,63.19 ,33.33
04,001,01,004,0023,28 ,611,22,633,1010,0,3,1,3,0,1,0,76.14,62.67 ,33.33
04,001,01,004,0024,29 ,486,13,499,772,0,3,1,3,0,1,0,76.14,64.64 ,33.33
04,001,01,004,0025,30 ,555,21,576,862,0,3,1,3,0,1,0,76.14,66.82 ,33.33
04,001,01,004,0026,31 ,302,13,315,558,0,3,1,3,0,1,0,76.14,56.45 ,33.33
04,001,01,004,0027,32 ,438,6,444,723,0,3,1,3,0,1,0,76.14,61.41 ,33.33
04,001,01,004,0028,33 ,433,10,443,723,0,3,1,3,0,1,0,76.14,61.27 ,33.33
04,001,01,004,0029,34 ,295,7,302,459,0,3,1,3,0,1,0,76.14,65.80 ,33.33
04,001,01,004,0030,35 ,484,13,497,804,0,3,1,3,0,1,0,76.14,61.82 ,33.33
04,001,01,005,0031,36 ,707,26,733,1148,0,3,1,3,0,1,0,76.14,63.85 ,33.33
04,001,01,005,0032,37 ,276,6,282,522,0,3,1,3,0,1,0,76.14,54.02 ,33.33
04,001,01,005,0033,38 ,400,19,419,747,0,3,1,3,0,1,0,76.14,56.09 ,33.33
04,001,01,005,0034,39 ,284,12,296,515,0,3,1,3,0,1,0,76.14,57.48 ,33.33
04,001,01,005,0035,40 ,599,22,621,987,0,3,1,3,0,1,0,76.14,62.92 ,33.33
04,001,01,006,0036,41 ,37,0,37,282,0,3,1,3,0,1,0,76.14,13.12 ,33.33
04,002,01,001,0001,1 ,1026,16,1042,1357,0,3,1,3,0,1,0,76.14,76.79 ,33.33
04,002,01,001,0002,2 ,467,12,479,578,0,3,1,3,0,1,0,76.14,82.87 ,33.33
04,002,01,001,0003,3 ,357,10,367,486,0,3,1,3,0,1,0,76.14,75.51 ,33.33
04,002,01,002,0004,4 ,1021,33,1054,1327,0,3,1,3,0,1,0,76.14,79.43 ,33.33
04,002,01,002,0005,5 ,598,13,611,846,0,3,1,3,0,1,0,76.14,72.22 ,33.33
04,002,01,003,0006,6 ,315,9,324,424,0,3,1,3,0,1,0,76.14,76.42 ,33.33
04,002,01,003,0007,7 ,227,3,230,385,0,3,1,3,0,1,0,76.14,59.74 ,33.33
04,002,01,004,0008,8 ,169,6,175,252,0,3,1,3,0,1,0,76.14,69.44 ,33.33
04,002,01,004,0009,9 ,372,17,389,554,0,3,1,3,0,1,0,76.14,70.22 ,33.33
