00,000,00,000,0000,0,9899442,150004,10049446,14712126,21441231,382,168,319,63,134,34,68.62 ,68.31 ,43.98 
01,000,00,000,0000,0,1478366,27578,1505944,1861849,2615028,48,20,35,13,13,7,71.20 ,80.88 ,41.67 
01,000,01,000,0000,0,756142,13705,769847,939731,1335813,18,10,13,5,7,3,70.35 ,81.92 ,55.56 
01,000,02,000,0000,0,722224,13873,736097,922118,1279215,30,10,22,8,6,4,72.08 ,79.83 ,33.33 
02,000,00,000,0000,0,789435,15119,804554,999907,1448440,25,11,22,3,9,2,69.03 ,80.46 ,44.00 
02,000,01,000,0000,0,439114,8169,447283,555547,804155,11,6,10,1,5,1,69.08 ,80.51 ,54.55 
02,000,02,000,0000,0,350321,6950,357271,444360,644285,14,5,12,2,4,1,68.97 ,80.40 ,35.71 
03,001,00,000,0000,0,1391092,19982,1411074,2305255,3413208,67,27,60,7,24,3,67.54 ,61.21 ,40.30 
03,001,01,000,0000,0,413786,6655,420441,673753,1025699,23,8,22,1,8,0,65.69 ,62.40 ,34.78 
03,001,02,000,0000,0,507620,7429,515049,828853,1259650,25,10,21,4,8,2,65.80 ,62.14 ,40.00 
03,001,03,000,0000,0,469686,5898,475584,802649,1127859,19,9,17,2,8,1,71.17 ,59.25 ,47.37 
03,002,00,000,0000,0,184540,1812,186352,313548,454257,6,4,6,0,4,0,69.02 ,59.43 ,66.67 
03,003,00,000,0000,0,670981,9769,680750,1058166,1600161,26,12,21,5,9,3,66.13 ,64.33 ,46.15 
03,004,00,000,0000,0,166751,2344,169095,275783,409491,7,3,6,1,3,0,67.35 ,61.31 ,42.86 
03,005,00,000,0000,0,265628,3655,269283,378177,551628,11,4,10,1,4,0,68.56 ,71.21 ,36.36 
03,006,00,000,0000,0,664314,12708,677022,949844,1445691,22,11,18,4,10,1,65.70 ,71.28 ,50.00 
03,007,00,000,0000,0,662464,10717,673181,873339,1296296,20,10,18,2,8,2,67.37 ,77.08 ,50.00 
03,008,00,000,0000,0,241112,2513,243625,362368,521303,11,4,10,1,4,0,69.51 ,67.23 ,36.36 
03,009,00,000,0000,0,356118,5341,361459,529788,750083,12,6,8,4,4,2,70.63 ,68.23 ,50.00 
03,010,00,000,0000,0,272739,4363,277102,401807,561374,10,4,9,1,3,1,71.58 ,68.96 ,40.00 
03,011,00,000,0000,0,497969,5649,503618,769171,1096023,16,9,13,3,6,3,70.18 ,65.48 ,56.25 
03,012,00,000,0000,0,585269,7621,592890,841020,1210183,15,9,12,3,8,1,69.50 ,70.50 ,60.00 
03,013,00,000,0000,0,408652,4170,412822,602121,860097,16,7,13,3,6,1,70.01 ,68.56 ,43.75 
03,014,00,000,0000,0,75180,775,75955,122617,172777,4,1,4,0,1,0,70.97 ,61.94 ,25.00 
03,015,00,000,0000,0,106566,1428,107994,192838,272398,6,2,6,0,2,0,70.79 ,56.00 ,33.33 
03,016,00,000,0000,0,35590,491,36081,64104,90004,3,1,3,0,1,0,71.22 ,56.29 ,33.33 
03,017,00,000,0000,0,138173,1621,139794,262783,374269,5,3,4,1,2,1,70.21 ,53.20 ,60.00 
03,018,00,000,0000,0,120844,2998,123842,238183,352554,7,3,5,2,2,1,67.56 ,51.99 ,42.86 
03,019,00,000,0000,0,365418,4213,369631,601470,906457,20,7,16,4,4,3,66.35 ,61.45 ,35.00 
03,020,00,000,0000,0,104286,1156,105442,178417,262614,6,2,4,2,1,1,67.94 ,59.10 ,33.33 
03,021,00,000,0000,0,295188,3328,298516,490521,718636,13,6,10,3,4,2,68.26 ,60.86 ,46.15 
04,001,00,000,0000,0,20324,341,20665,34316,51011,5,1,5,0,1,0,67.27 ,60.22 ,20.00 
04,002,00,000,0000,0,2443,312,2755,4734,7248,1,1,1,0,1,0,65.31 ,58.20 ,100.00 
03,002,01,000,0000,0,184540,1812,186352,313548,454257,6,4,6,0,4,0,69.02 ,59.43 ,66.67 
03,003,01,000,0000,0,670981,9769,680750,1058166,1600161,26,12,21,5,9,3,66.13 ,64.33 ,46.15 
03,004,01,000,0000,0,166751,2344,169095,275783,409491,7,3,6,1,3,0,67.35 ,61.31 ,42.86 
03,005,01,000,0000,0,265628,3655,269283,378177,551628,11,4,10,1,4,0,68.56 ,71.21 ,36.36 
03,006,01,000,0000,0,664314,12708,677022,949844,1445691,22,11,18,4,10,1,65.70 ,71.28 ,50.00 
03,007,01,000,0000,0,662464,10717,673181,873339,1296296,20,10,18,2,8,2,67.37 ,77.08 ,50.00 
03,008,01,000,0000,0,241112,2513,243625,362368,521303,11,4,10,1,4,0,69.51 ,67.23 ,36.36 
03,009,01,000,0000,0,356118,5341,361459,529788,750083,12,6,8,4,4,2,70.63 ,68.23 ,50.00 
03,010,01,000,0000,0,272739,4363,277102,401807,561374,10,4,9,1,3,1,71.58 ,68.96 ,40.00 
03,011,01,000,0000,0,497969,5649,503618,769171,1096023,16,9,13,3,6,3,70.18 ,65.48 ,56.25 
03,012,01,000,0000,0,585269,7621,592890,841020,1210183,15,9,12,3,8,1,69.50 ,70.50 ,60.00 
03,013,01,000,0000,0,408652,4170,412822,602121,860097,16,7,13,3,6,1,70.01 ,68.56 ,43.75 
03,014,01,000,0000,0,75180,775,75955,122617,172777,4,1,4,0,1,0,70.97 ,61.94 ,25.00 
03,015,01,000,0000,0,106566,1428,107994,192838,272398,6,2,6,0,2,0,70.79 ,56.00 ,33.33 
03,016,01,000,0000,0,35590,491,36081,64104,90004,3,1,3,0,1,0,71.22 ,56.29 ,33.33 
03,017,01,000,0000,0,138173,1621,139794,262783,374269,5,3,4,1,2,1,70.21 ,53.20 ,60.00 
03,018,01,000,0000,0,120844,2998,123842,238183,352554,7,3,5,2,2,1,67.56 ,51.99 ,42.86 
03,019,01,000,0000,0,365418,4213,369631,601470,906457,20,7,16,4,4,3,66.35 ,61.45 ,35.00 
03,020,01,000,0000,0,104286,1156,105442,178417,262614,6,2,4,2,1,1,67.94 ,59.10 ,33.33 
03,021,01,000,0000,0,295188,3328,298516,490521,718636,13,6,10,3,4,2,68.26 ,60.86 ,46.15 
04,001,01,000,0000,0,20324,341,20665,34316,51011,5,1,5,0,1,0,67.27 ,60.22 ,20.00 
04,002,01,000,0000,0,2443,312,2755,4734,7248,1,1,1,0,1,0,65.31 ,58.20 ,100.00 
01,000,01,001,0000,0,139765,2600,142365,171136,0,0,0,0,0,0,0,66.31 ,83.19 ,66.31 
01,000,01,002,0000,0,168391,3106,171497,208473,0,0,0,0,0,0,0,66.31 ,82.26 ,66.31 
01,000,01,003,0000,0,131366,2230,133596,160832,0,0,0,0,0,0,0,66.31 ,83.07 ,66.31 
01,000,01,004,0000,0,62892,1240,64132,76841,0,0,0,0,0,0,0,66.31 ,83.46 ,66.31 
01,000,01,005,0000,0,115017,1800,116817,147426,0,0,0,0,0,0,0,66.31 ,79.24 ,66.31 
01,000,01,006,0000,0,138711,2729,141440,175023,0,0,0,0,0,0,0,66.31 ,80.81 ,66.31 
01,000,02,007,0000,0,120733,2565,123298,156459,0,0,0,0,0,0,0,66.31 ,78.81 ,66.31 
01,000,02,008,0000,0,76433,1740,78173,96237,0,0,0,0,0,0,0,66.31 ,81.23 ,66.31 
01,000,02,009,0000,0,90983,1703,92686,117635,0,0,0,0,0,0,0,66.31 ,78.79 ,66.31 
01,000,02,010,0000,0,121683,2530,124213,152220,0,0,0,0,0,0,0,66.31 ,81.60 ,66.31 
01,000,02,011,0000,0,175897,2854,178751,230280,0,0,0,0,0,0,0,66.31 ,77.62 ,66.31 
01,000,02,012,0000,0,136495,2481,138976,169287,0,0,0,0,0,0,0,66.31 ,82.09 ,66.31 
02,000,01,001,0000,0,18731,326,19057,23859,0,0,0,0,0,0,0,66.31 ,79.87 ,66.31 
02,000,01,002,0000,0,61931,1139,63070,78425,0,0,0,0,0,0,0,66.31 ,80.42 ,66.31 
02,000,01,003,0000,0,78067,1419,79486,99608,0,0,0,0,0,0,0,66.31 ,79.80 ,66.31 
02,000,01,004,0000,0,78646,1455,80101,97244,0,0,0,0,0,0,0,66.31 ,82.37 ,66.31 
02,000,01,005,0000,0,183864,3353,187217,233736,0,0,0,0,0,0,0,66.31 ,80.10 ,66.31 
02,000,01,006,0000,0,17875,477,18352,22675,0,0,0,0,0,0,0,66.31 ,80.93 ,66.31 
02,000,02,007,0000,0,34907,542,35449,45343,0,0,0,0,0,0,0,66.31 ,78.18 ,66.31 
02,000,02,008,0000,0,19718,341,20059,25668,0,0,0,0,0,0,0,66.31 ,78.15 ,66.31 
02,000,02,009,0000,0,111151,2075,113226,141953,0,0,0,0,0,0,0,66.31 ,79.76 ,66.31 
02,000,02,010,0000,0,109132,2485,111617,137921,0,0,0,0,0,0,0,66.31 ,80.93 ,66.31 
02,000,02,011,0000,0,75413,1507,76920,93475,0,0,0,0,0,0,0,66.31 ,82.29 ,66.31 
03,001,01,001,0000,0,211574,3269,214843,346189,0,0,0,0,0,0,0,66.31 ,62.06 ,66.31 
03,001,01,002,0000,0,82588,1486,84074,137290,0,0,0,0,0,0,0,66.31 ,61.24 ,66.31 
03,001,01,003,0000,0,55831,925,56756,91079,0,0,0,0,0,0,0,66.31 ,62.32 ,66.31 
03,001,01,004,0000,0,31572,472,32044,48289,0,0,0,0,0,0,0,66.31 ,66.36 ,66.31 
03,001,01,005,0000,0,32221,503,32724,50906,0,0,0,0,0,0,0,66.31 ,64.28 ,66.31 
03,001,02,006,0000,0,159766,2449,162215,254699,0,0,0,0,0,0,0,66.31 ,63.69 ,66.31 
03,001,02,007,0000,0,61315,945,62260,96347,0,0,0,0,0,0,0,66.31 ,64.62 ,66.31 
03,001,02,008,0000,0,129188,1711,130899,223767,0,0,0,0,0,0,0,66.31 ,58.50 ,66.31 
03,001,02,009,0000,0,26084,369,26453,42110,0,0,0,0,0,0,0,66.31 ,62.82 ,66.31 
03,001,02,010,0000,0,23692,310,24002,39122,0,0,0,0,0,0,0,66.31 ,61.35 ,66.31 
03,001,02,011,0000,0,19321,277,19598,31152,0,0,0,0,0,0,0,66.31 ,62.91 ,66.31 
03,001,02,012,0000,0,45174,719,45893,73579,0,0,0,0,0,0,0,66.31 ,62.37 ,66.31 
03,001,02,013,0000,0,11497,225,11722,17509,0,0,0,0,0,0,0,66.31 ,66.95 ,66.31 
03,001,02,014,0000,0,9307,126,9433,15077,0,0,0,0,0,0,0,66.31 ,62.57 ,66.31 
03,001,02,015,0000,0,4998,80,5078,7494,0,0,0,0,0,0,0,66.31 ,67.76 ,66.31 
03,001,02,016,0000,0,8945,94,9039,14378,0,0,0,0,0,0,0,66.31 ,62.87 ,66.31 
03,001,02,017,0000,0,8333,124,8457,13619,0,0,0,0,0,0,0,66.31 ,62.10 ,66.31 
03,001,03,018,0000,0,158565,2250,160815,270385,0,0,0,0,0,0,0,66.31 ,59.48 ,66.31 
03,001,03,019,0000,0,93771,1108,94879,159939,0,0,0,0,0,0,0,66.31 ,59.32 ,66.31 
03,001,03,020,0000,0,109687,1248,110935,185986,0,0,0,0,0,0,0,66.31 ,59.65 ,66.31 
03,001,03,021,0000,0,7734,114,7848,13549,0,0,0,0,0,0,0,66.31 ,57.92 ,66.31 
03,001,03,022,0000,0,3867,50,3917,5931,0,0,0,0,0,0,0,66.31 ,66.04 ,66.31 
03,001,03,023,0000,0,2910,39,2949,4885,0,0,0,0,0,0,0,66.31 ,60.37 ,66.31 
03,001,03,024,0000,0,971,8,979,1610,0,0,0,0,0,0,0,66.31 ,60.81 ,66.31 
03,001,03,025,0000,0,56467,597,57064,101333,0,0,0,0,0,0,0,66.31 ,56.31 ,66.31 
03,001,03,026,0000,0,20644,325,20969,34942,0,0,0,0,0,0,0,66.31 ,60.01 ,66.31 
03,001,03,027,0000,0,3237,34,3271,5123,0,0,0,0,0,0,0,66.31 ,63.85 ,66.31 
03,001,03,028,0000,0,5556,49,5605,8387,0,0,0,0,0,0,0,66.31 ,66.83 ,66.31 
03,001,03,029,0000,0,6277,76,6353,10579,0,0,0,0,0,0,0,66.31 ,60.05 ,66.31 
03,002,01,001,0000,0,37252,383,37635,61433,0,0,0,0,0,0,0,66.31 ,61.26 ,66.31 
03,002,01,002,0000,0,26169,223,26392,45214,0,0,0,0,0,0,0,66.31 ,58.37 ,66.31 
03,002,01,003,0000,0,18792,190,18982,33514,0,0,0,0,0,0,0,66.31 ,56.64 ,66.31 
03,002,01,004,0000,0,13914,145,14059,23215,0,0,0,0,0,0,0,66.31 ,60.56 ,66.31 
03,002,01,005,0000,0,16347,175,16522,26540,0,0,0,0,0,0,0,66.31 ,62.25 ,66.31 
03,002,01,006,0000,0,11138,92,11230,18326,0,0,0,0,0,0,0,66.31 ,61.28 ,66.31 
03,002,01,007,0000,0,13374,179,13553,23792,0,0,0,0,0,0,0,66.31 ,56.96 ,66.31 
03,002,01,008,0000,0,20868,178,21046,36128,0,0,0,0,0,0,0,66.31 ,58.25 ,66.31 
03,002,01,009,0000,0,16333,133,16466,27150,0,0,0,0,0,0,0,66.31 ,60.65 ,66.31 
03,002,01,010,0000,0,9499,108,9607,16385,0,0,0,0,0,0,0,66.31 ,58.63 ,66.31 
03,002,01,011,0000,0,490,2,492,1038,0,0,0,0,0,0,0,66.31 ,47.40 ,66.31 
03,002,01,012,0000,0,364,4,368,813,0,0,0,0,0,0,0,66.31 ,45.26 ,66.31 
03,003,01,001,0000,0,115981,1521,117502,194104,0,0,0,0,0,0,0,66.31 ,60.54 ,66.31 
03,003,01,002,0000,0,40193,646,40839,71934,0,0,0,0,0,0,0,66.31 ,56.77 ,66.31 
03,003,01,003,0000,0,65963,1144,67107,101819,0,0,0,0,0,0,0,66.31 ,65.91 ,66.31 
03,003,01,004,0000,0,34305,547,34852,53442,0,0,0,0,0,0,0,66.31 ,65.21 ,66.31 
03,003,01,005,0000,0,33960,458,34418,47535,0,0,0,0,0,0,0,66.31 ,72.41 ,66.31 
03,003,01,006,0000,0,35921,547,36468,53171,0,0,0,0,0,0,0,66.31 ,68.59 ,66.31 
03,003,01,007,0000,0,1680,23,1703,2858,0,0,0,0,0,0,0,66.31 ,59.59 ,66.31 
03,003,01,008,0000,0,129964,1778,131742,205982,0,0,0,0,0,0,0,66.31 ,63.96 ,66.31 
03,003,01,009,0000,0,73884,1121,75005,115812,0,0,0,0,0,0,0,66.31 ,64.76 ,66.31 
03,003,01,010,0000,0,50144,716,50860,78938,0,0,0,0,0,0,0,66.31 ,64.43 ,66.31 
03,003,01,011,0000,0,40616,622,41238,63871,0,0,0,0,0,0,0,66.31 ,64.56 ,66.31 
03,003,01,012,0000,0,24521,294,24815,33814,0,0,0,0,0,0,0,66.31 ,73.39 ,66.31 
03,003,01,013,0000,0,23849,352,24201,34886,0,0,0,0,0,0,0,66.31 ,69.37 ,66.31 
03,004,01,001,0000,0,29593,407,30000,54682,0,0,0,0,0,0,0,66.31 ,54.86 ,66.31 
03,004,01,002,0000,0,33787,459,34246,55638,0,0,0,0,0,0,0,66.31 ,61.55 ,66.31 
03,004,01,003,0000,0,16069,226,16295,25257,0,0,0,0,0,0,0,66.31 ,64.52 ,66.31 
03,004,01,004,0000,0,14705,197,14902,22664,0,0,0,0,0,0,0,66.31 ,65.75 ,66.31 
03,004,01,005,0000,0,25511,436,25947,41717,0,0,0,0,0,0,0,66.31 ,62.20 ,66.31 
03,004,01,006,0000,0,15970,260,16230,28280,0,0,0,0,0,0,0,66.31 ,57.39 ,66.31 
03,004,01,007,0000,0,9163,105,9268,13492,0,0,0,0,0,0,0,66.31 ,68.69 ,66.31 
03,004,01,008,0000,0,7389,86,7475,10966,0,0,0,0,0,0,0,66.31 ,68.17 ,66.31 
03,004,01,009,0000,0,4868,61,4929,7548,0,0,0,0,0,0,0,66.31 ,65.30 ,66.31 
03,004,01,010,0000,0,5598,56,5654,9184,0,0,0,0,0,0,0,66.31 ,61.56 ,66.31 
03,004,01,011,0000,0,3325,30,3355,4921,0,0,0,0,0,0,0,66.31 ,68.18 ,66.31 
03,004,01,012,0000,0,588,20,608,1070,0,0,0,0,0,0,0,66.31 ,56.82 ,66.31 
03,004,01,013,0000,0,185,1,186,364,0,0,0,0,0,0,0,66.31 ,51.10 ,66.31 
03,005,01,001,0000,0,40230,716,40946,60986,0,0,0,0,0,0,0,66.31 ,67.14 ,66.31 
03,005,01,002,0000,0,22747,266,23013,33471,0,0,0,0,0,0,0,66.31 ,68.76 ,66.31 
03,005,01,003,0000,0,20979,263,21242,29119,0,0,0,0,0,0,0,66.31 ,72.95 ,66.31 
03,005,01,004,0000,0,31501,460,31961,44580,0,0,0,0,0,0,0,66.31 ,71.69 ,66.31 
03,005,01,005,0000,0,37397,509,37906,56790,0,0,0,0,0,0,0,66.31 ,66.75 ,66.31 
03,005,01,006,0000,0,22354,230,22584,30354,0,0,0,0,0,0,0,66.31 ,74.40 ,66.31 
03,005,01,007,0000,0,10679,184,10863,13959,0,0,0,0,0,0,0,66.31 ,77.82 ,66.31 
03,005,01,008,0000,0,9502,110,9612,12867,0,0,0,0,0,0,0,66.31 ,74.70 ,66.31 
03,005,01,009,0000,0,17081,221,17302,23489,0,0,0,0,0,0,0,66.31 ,73.66 ,66.31 
03,005,01,010,0000,0,10711,163,10874,14658,0,0,0,0,0,0,0,66.31 ,74.18 ,66.31 
03,005,01,011,0000,0,5279,77,5356,8066,0,0,0,0,0,0,0,66.31 ,66.40 ,66.31 
03,005,01,012,0000,0,6876,63,6939,9032,0,0,0,0,0,0,0,66.31 ,76.83 ,66.31 
03,005,01,013,0000,0,9213,130,9343,12198,0,0,0,0,0,0,0,66.31 ,76.59 ,66.31 
03,005,01,014,0000,0,4750,57,4807,6720,0,0,0,0,0,0,0,66.31 ,71.53 ,66.31 
03,005,01,015,0000,0,7775,98,7873,10056,0,0,0,0,0,0,0,66.31 ,78.29 ,66.31 
03,005,01,016,0000,0,4265,54,4319,5915,0,0,0,0,0,0,0,66.31 ,73.02 ,66.31 
03,005,01,017,0000,0,3232,37,3269,4409,0,0,0,0,0,0,0,66.31 ,74.14 ,66.31 
03,005,01,018,0000,0,1057,17,1074,1508,0,0,0,0,0,0,0,66.31 ,71.22 ,66.31 
03,006,01,001,0000,0,70517,1292,71809,104519,0,0,0,0,0,0,0,66.31 ,68.70 ,66.31 
03,006,01,002,0000,0,30320,596,30916,41491,0,0,0,0,0,0,0,66.31 ,74.51 ,66.31 
03,006,01,003,0000,0,36465,700,37165,49861,0,0,0,0,0,0,0,66.31 ,74.54 ,66.31 
03,006,01,004,0000,0,40941,712,41653,56213,0,0,0,0,0,0,0,66.31 ,74.10 ,66.31 
03,006,01,005,0000,0,34064,578,34642,46093,0,0,0,0,0,0,0,66.31 ,75.16 ,66.31 
03,006,01,006,0000,0,22729,409,23138,31275,0,0,0,0,0,0,0,66.31 ,73.98 ,66.31 
03,006,01,007,0000,0,28279,609,28888,37126,0,0,0,0,0,0,0,66.31 ,77.81 ,66.31 
03,006,01,008,0000,0,28633,568,29201,39854,0,0,0,0,0,0,0,66.31 ,73.27 ,66.31 
03,006,01,009,0000,0,35590,621,36211,54524,0,0,0,0,0,0,0,66.31 ,66.41 ,66.31 
03,006,01,010,0000,0,33382,751,34133,47626,0,0,0,0,0,0,0,66.31 ,71.67 ,66.31 
03,006,01,011,0000,0,14888,265,15153,19387,0,0,0,0,0,0,0,66.31 ,78.16 ,66.31 
03,006,01,012,0000,0,8406,160,8566,11165,0,0,0,0,0,0,0,66.31 ,76.72 ,66.31 
03,006,01,013,0000,0,15918,286,16204,20240,0,0,0,0,0,0,0,66.31 ,80.06 ,66.31 
03,006,01,014,0000,0,11432,167,11599,14758,0,0,0,0,0,0,0,66.31 ,78.59 ,66.31 
03,006,01,015,0000,0,29350,561,29911,41784,0,0,0,0,0,0,0,66.31 ,71.58 ,66.31 
03,006,01,016,0000,0,25396,522,25918,34409,0,0,0,0,0,0,0,66.31 ,75.32 ,66.31 
03,006,01,017,0000,0,28903,521,29424,40036,0,0,0,0,0,0,0,66.31 ,73.49 ,66.31 
03,006,01,018,0000,0,32141,627,32768,45165,0,0,0,0,0,0,0,66.31 ,72.55 ,66.31 
03,006,01,019,0000,0,66259,1421,67680,103235,0,0,0,0,0,0,0,66.31 ,65.56 ,66.31 
03,006,01,020,0000,0,66960,1288,68248,105154,0,0,0,0,0,0,0,66.31 ,64.90 ,66.31 
03,006,01,021,0000,0,3741,54,3795,5929,0,0,0,0,0,0,0,66.31 ,64.01 ,66.31 
03,007,01,001,0000,0,110815,1884,112699,147723,0,0,0,0,0,0,0,66.31 ,76.29 ,66.31 
03,007,01,002,0000,0,23314,357,23671,30048,0,0,0,0,0,0,0,66.31 ,78.78 ,66.31 
03,007,01,003,0000,0,14493,234,14727,18697,0,0,0,0,0,0,0,66.31 ,78.77 ,66.31 
03,007,01,004,0000,0,42400,665,43065,53953,0,0,0,0,0,0,0,66.31 ,79.82 ,66.31 
03,007,01,005,0000,0,24839,326,25165,31451,0,0,0,0,0,0,0,66.31 ,80.01 ,66.31 
03,007,01,006,0000,0,19611,317,19928,24168,0,0,0,0,0,0,0,66.31 ,82.46 ,66.31 
03,007,01,007,0000,0,43330,756,44086,54651,0,0,0,0,0,0,0,66.31 ,80.67 ,66.31 
03,007,01,008,0000,0,8854,140,8994,11042,0,0,0,0,0,0,0,66.31 ,81.45 ,66.31 
03,007,01,009,0000,0,17011,221,17232,21387,0,0,0,0,0,0,0,66.31 ,80.57 ,66.31 
03,007,01,010,0000,0,59127,1000,60127,82289,0,0,0,0,0,0,0,66.31 ,73.07 ,66.31 
03,007,01,011,0000,0,18196,268,18464,23641,0,0,0,0,0,0,0,66.31 ,78.10 ,66.31 
03,007,01,012,0000,0,20382,403,20785,27015,0,0,0,0,0,0,0,66.31 ,76.94 ,66.31 
03,007,01,013,0000,0,27764,371,28135,35714,0,0,0,0,0,0,0,66.31 ,78.78 ,66.31 
03,007,01,014,0000,0,19937,258,20195,24543,0,0,0,0,0,0,0,66.31 ,82.28 ,66.31 
03,007,01,015,0000,0,17953,303,18256,23434,0,0,0,0,0,0,0,66.31 ,77.90 ,66.31 
03,007,01,016,0000,0,23173,470,23643,32724,0,0,0,0,0,0,0,66.31 ,72.25 ,66.31 
03,007,01,017,0000,0,22838,390,23228,30177,0,0,0,0,0,0,0,66.31 ,76.97 ,66.31 
03,007,01,018,0000,0,10568,144,10712,13615,0,0,0,0,0,0,0,66.31 ,78.68 ,66.31 
03,007,01,019,0000,0,17043,272,17315,22576,0,0,0,0,0,0,0,66.31 ,76.70 ,66.31 
03,007,01,020,0000,0,17175,311,17486,23720,0,0,0,0,0,0,0,66.31 ,73.72 ,66.31 
03,007,01,021,0000,0,15513,264,15777,20159,0,0,0,0,0,0,0,66.31 ,78.26 ,66.31 
03,007,01,022,0000,0,16986,351,17337,22795,0,0,0,0,0,0,0,66.31 ,76.06 ,66.31 
03,007,01,023,0000,0,29727,454,30181,39194,0,0,0,0,0,0,0,66.31 ,77.00 ,66.31 
03,007,01,024,0000,0,20634,301,20935,29269,0,0,0,0,0,0,0,66.31 ,71.53 ,66.31 
03,007,01,025,0000,0,11213,151,11364,16530,0,0,0,0,0,0,0,66.31 ,68.75 ,66.31 
03,007,01,026,0000,0,9568,106,9674,12824,0,0,0,0,0,0,0,66.31 ,75.44 ,66.31 
03,008,01,001,0000,0,46969,446,47415,69131,0,0,0,0,0,0,0,66.31 ,68.59 ,66.31 
03,008,01,002,0000,0,38202,405,38607,60006,0,0,0,0,0,0,0,66.31 ,64.34 ,66.31 
03,008,01,003,0000,0,43726,505,44231,64901,0,0,0,0,0,0,0,66.31 ,68.15 ,66.31 
03,008,01,004,0000,0,29579,323,29902,43360,0,0,0,0,0,0,0,66.31 ,68.96 ,66.31 
03,008,01,005,0000,0,6154,49,6203,9022,0,0,0,0,0,0,0,66.31 ,68.75 ,66.31 
03,008,01,006,0000,0,21056,252,21308,30166,0,0,0,0,0,0,0,66.31 ,70.64 ,66.31 
03,008,01,007,0000,0,10399,84,10483,15398,0,0,0,0,0,0,0,66.31 ,68.08 ,66.31 
03,008,01,008,0000,0,9565,75,9640,13818,0,0,0,0,0,0,0,66.31 ,69.76 ,66.31 
03,008,01,009,0000,0,7822,62,7884,13124,0,0,0,0,0,0,0,66.31 ,60.07 ,66.31 
03,008,01,010,0000,0,11292,149,11441,17980,0,0,0,0,0,0,0,66.31 ,63.63 ,66.31 
03,008,01,011,0000,0,10980,102,11082,16754,0,0,0,0,0,0,0,66.31 ,66.15 ,66.31 
03,008,01,012,0000,0,3875,39,3914,6010,0,0,0,0,0,0,0,66.31 ,65.12 ,66.31 
03,008,01,013,0000,0,1493,22,1515,2698,0,0,0,0,0,0,0,66.31 ,56.15 ,66.31 
03,009,01,001,0000,0,46078,847,46925,65864,0,0,0,0,0,0,0,66.31 ,71.25 ,66.31 
03,009,01,002,0000,0,24158,326,24484,33045,0,0,0,0,0,0,0,66.31 ,74.09 ,66.31 
03,009,01,003,0000,0,31503,620,32123,45969,0,0,0,0,0,0,0,66.31 ,69.88 ,66.31 
03,009,01,004,0000,0,23494,315,23809,35207,0,0,0,0,0,0,0,66.31 ,67.63 ,66.31 
03,009,01,005,0000,0,15454,202,15656,22999,0,0,0,0,0,0,0,66.31 ,68.07 ,66.31 
03,009,01,006,0000,0,22481,446,22927,33266,0,0,0,0,0,0,0,66.31 ,68.92 ,66.31 
03,009,01,007,0000,0,19190,282,19472,26157,0,0,0,0,0,0,0,66.31 ,74.44 ,66.31 
03,009,01,008,0000,0,11969,162,12131,17049,0,0,0,0,0,0,0,66.31 ,71.15 ,66.31 
03,009,01,009,0000,0,15899,227,16126,22327,0,0,0,0,0,0,0,66.31 ,72.23 ,66.31 
03,009,01,010,0000,0,10551,214,10765,14754,0,0,0,0,0,0,0,66.31 ,72.96 ,66.31 
03,009,01,011,0000,0,15731,197,15928,24068,0,0,0,0,0,0,0,66.31 ,66.18 ,66.31 
03,009,01,012,0000,0,14019,200,14219,21235,0,0,0,0,0,0,0,66.31 ,66.96 ,66.31 
03,009,01,013,0000,0,14453,172,14625,22670,0,0,0,0,0,0,0,66.31 ,64.51 ,66.31 
03,009,01,014,0000,0,8878,123,9001,14589,0,0,0,0,0,0,0,66.31 ,61.70 ,66.31 
03,009,01,015,0000,0,7865,91,7956,11145,0,0,0,0,0,0,0,66.31 ,71.39 ,66.31 
03,009,01,016,0000,0,14138,140,14278,21669,0,0,0,0,0,0,0,66.31 ,65.89 ,66.31 
03,009,01,017,0000,0,15603,163,15766,24607,0,0,0,0,0,0,0,66.31 ,64.07 ,66.31 
03,009,01,018,0000,0,13146,195,13341,23509,0,0,0,0,0,0,0,66.31 ,56.75 ,66.31 
03,009,01,019,0000,0,15233,169,15402,24343,0,0,0,0,0,0,0,66.31 ,63.27 ,66.31 
03,009,01,020,0000,0,16275,250,16525,25316,0,0,0,0,0,0,0,66.31 ,65.27 ,66.31 
03,010,01,001,0000,0,15602,257,15859,21191,0,0,0,0,0,0,0,66.31 ,74.84 ,66.31 
03,010,01,002,0000,0,20652,297,20949,30999,0,0,0,0,0,0,0,66.31 ,67.58 ,66.31 
03,010,01,003,0000,0,16792,286,17078,25066,0,0,0,0,0,0,0,66.31 ,68.13 ,66.31 
03,010,01,004,0000,0,17832,273,18105,26238,0,0,0,0,0,0,0,66.31 ,69.00 ,66.31 
03,010,01,005,0000,0,33086,498,33584,46978,0,0,0,0,0,0,0,66.31 ,71.49 ,66.31 
03,010,01,006,0000,0,8761,135,8896,13672,0,0,0,0,0,0,0,66.31 ,65.07 ,66.31 
03,010,01,007,0000,0,16923,267,17190,25877,0,0,0,0,0,0,0,66.31 ,66.43 ,66.31 
03,010,01,008,0000,0,14860,220,15080,23116,0,0,0,0,0,0,0,66.31 ,65.24 ,66.31 
03,010,01,009,0000,0,15524,216,15740,23418,0,0,0,0,0,0,0,66.31 ,67.21 ,66.31 
03,010,01,010,0000,0,13186,147,13333,18363,0,0,0,0,0,0,0,66.31 ,72.61 ,66.31 
03,010,01,011,0000,0,9887,188,10075,14251,0,0,0,0,0,0,0,66.31 ,70.70 ,66.31 
03,010,01,012,0000,0,27507,575,28082,39149,0,0,0,0,0,0,0,66.31 ,71.73 ,66.31 
03,010,01,013,0000,0,21666,412,22078,33202,0,0,0,0,0,0,0,66.31 ,66.50 ,66.31 
03,010,01,014,0000,0,20031,295,20326,29378,0,0,0,0,0,0,0,66.31 ,69.19 ,66.31 
03,010,01,015,0000,0,12020,196,12216,17208,0,0,0,0,0,0,0,66.31 ,70.99 ,66.31 
03,010,01,016,0000,0,5761,68,5829,8910,0,0,0,0,0,0,0,66.31 ,65.42 ,66.31 
03,010,01,017,0000,0,1580,18,1598,2871,0,0,0,0,0,0,0,66.31 ,55.66 ,66.31 
03,010,01,018,0000,0,1069,15,1084,1920,0,0,0,0,0,0,0,66.31 ,56.46 ,66.31 
03,011,01,001,0000,0,30603,401,31004,51409,0,0,0,0,0,0,0,66.31 ,60.31 ,66.31 
03,011,01,002,0000,0,13667,183,13850,21261,0,0,0,0,0,0,0,66.31 ,65.14 ,66.31 
03,011,01,003,0000,0,16373,201,16574,26825,0,0,0,0,0,0,0,66.31 ,61.79 ,66.31 
03,011,01,004,0000,0,12056,167,12223,17870,0,0,0,0,0,0,0,66.31 ,68.40 ,66.31 
03,011,01,005,0000,0,14239,167,14406,21859,0,0,0,0,0,0,0,66.31 ,65.90 ,66.31 
03,011,01,006,0000,0,11810,125,11935,19426,0,0,0,0,0,0,0,66.31 ,61.44 ,66.31 
03,011,01,007,0000,0,23756,254,24010,33754,0,0,0,0,0,0,0,66.31 ,71.13 ,66.31 
03,011,01,008,0000,0,14183,138,14321,20392,0,0,0,0,0,0,0,66.31 ,70.23 ,66.31 
03,011,01,009,0000,0,11530,129,11659,17574,0,0,0,0,0,0,0,66.31 ,66.34 ,66.31 
03,011,01,010,0000,0,12313,134,12447,17645,0,0,0,0,0,0,0,66.31 ,70.54 ,66.31 
03,011,01,011,0000,0,6152,77,6229,9638,0,0,0,0,0,0,0,66.31 ,64.63 ,66.31 
03,011,01,012,0000,0,26027,238,26265,38797,0,0,0,0,0,0,0,66.31 ,67.70 ,66.31 
03,011,01,013,0000,0,14784,105,14889,21588,0,0,0,0,0,0,0,66.31 ,68.97 ,66.31 
03,011,01,014,0000,0,12684,150,12834,17920,0,0,0,0,0,0,0,66.31 ,71.62 ,66.31 
03,011,01,015,0000,0,14306,121,14427,19913,0,0,0,0,0,0,0,66.31 ,72.45 ,66.31 
03,011,01,016,0000,0,12105,73,12178,18143,0,0,0,0,0,0,0,66.31 ,67.12 ,66.31 
03,011,01,017,0000,0,7047,59,7106,10392,0,0,0,0,0,0,0,66.31 ,68.38 ,66.31 
03,011,01,018,0000,0,20875,325,21200,31110,0,0,0,0,0,0,0,66.31 ,68.15 ,66.31 
03,011,01,019,0000,0,19131,236,19367,29518,0,0,0,0,0,0,0,66.31 ,65.61 ,66.31 
03,011,01,020,0000,0,14307,182,14489,22140,0,0,0,0,0,0,0,66.31 ,65.44 ,66.31 
03,011,01,021,0000,0,14461,160,14621,20879,0,0,0,0,0,0,0,66.31 ,70.03 ,66.31 
03,011,01,022,0000,0,4048,54,4102,6003,0,0,0,0,0,0,0,66.31 ,68.33 ,66.31 
03,011,01,023,0000,0,8818,82,8900,12614,0,0,0,0,0,0,0,66.31 ,70.56 ,66.31 
03,011,01,024,0000,0,6462,68,6530,9286,0,0,0,0,0,0,0,66.31 ,70.32 ,66.31 
03,011,01,025,0000,0,5377,47,5424,7550,0,0,0,0,0,0,0,66.31 ,71.84 ,66.31 
03,011,01,026,0000,0,3695,42,3737,5037,0,0,0,0,0,0,0,66.31 ,74.19 ,66.31 
03,011,01,027,0000,0,28743,413,29156,45156,0,0,0,0,0,0,0,66.31 ,64.57 ,66.31 
03,011,01,028,0000,0,27032,277,27309,40807,0,0,0,0,0,0,0,66.31 ,66.92 ,66.31 
03,011,01,029,0000,0,18553,173,18726,27512,0,0,0,0,0,0,0,66.31 ,68.06 ,66.31 
03,011,01,030,0000,0,2711,13,2724,3803,0,0,0,0,0,0,0,66.31 ,71.63 ,66.31 
03,011,01,031,0000,0,70121,855,70976,123350,0,0,0,0,0,0,0,66.31 ,57.54 ,66.31 
03,012,01,001,0000,0,138203,1790,139993,214192,0,0,0,0,0,0,0,66.31 ,65.36 ,66.31 
03,012,01,002,0000,0,33821,375,34196,47627,0,0,0,0,0,0,0,66.31 ,71.80 ,66.31 
03,012,01,003,0000,0,54581,675,55256,78602,0,0,0,0,0,0,0,66.31 ,70.30 ,66.31 
03,012,01,004,0000,0,23730,239,23969,33037,0,0,0,0,0,0,0,66.31 ,72.55 ,66.31 
03,012,01,005,0000,0,15616,234,15850,22614,0,0,0,0,0,0,0,66.31 ,70.09 ,66.31 
03,012,01,006,0000,0,22280,364,22644,32692,0,0,0,0,0,0,0,66.31 ,69.26 ,66.31 
03,012,01,007,0000,0,17929,206,18135,25870,0,0,0,0,0,0,0,66.31 ,70.10 ,66.31 
03,012,01,008,0000,0,43804,561,44365,62489,0,0,0,0,0,0,0,66.31 ,71.00 ,66.31 
03,012,01,009,0000,0,19422,230,19652,26821,0,0,0,0,0,0,0,66.31 ,73.27 ,66.31 
03,012,01,010,0000,0,17407,241,17648,23339,0,0,0,0,0,0,0,66.31 ,75.62 ,66.31 
03,012,01,011,0000,0,5777,75,5852,8033,0,0,0,0,0,0,0,66.31 ,72.85 ,66.31 
03,012,01,012,0000,0,14955,269,15224,21028,0,0,0,0,0,0,0,66.31 ,72.40 ,66.31 
03,012,01,013,0000,0,27294,393,27687,36421,0,0,0,0,0,0,0,66.31 ,76.02 ,66.31 
03,012,01,014,0000,0,14194,223,14417,19985,0,0,0,0,0,0,0,66.31 ,72.14 ,66.31 
03,012,01,015,0000,0,16539,192,16731,23357,0,0,0,0,0,0,0,66.31 ,71.63 ,66.31 
03,012,01,016,0000,0,7655,70,7725,10384,0,0,0,0,0,0,0,66.31 ,74.39 ,66.31 
03,012,01,017,0000,0,11974,163,12137,15185,0,0,0,0,0,0,0,66.31 ,79.93 ,66.31 
03,012,01,018,0000,0,19986,318,20304,27208,0,0,0,0,0,0,0,66.31 ,74.63 ,66.31 
03,012,01,019,0000,0,23441,301,23742,32652,0,0,0,0,0,0,0,66.31 ,72.71 ,66.31 
03,012,01,020,0000,0,25596,281,25877,35077,0,0,0,0,0,0,0,66.31 ,73.77 ,66.31 
03,012,01,021,0000,0,8479,146,8625,13081,0,0,0,0,0,0,0,66.31 ,65.94 ,66.31 
03,012,01,022,0000,0,4684,60,4744,6597,0,0,0,0,0,0,0,66.31 ,71.91 ,66.31 
03,012,01,023,0000,0,7058,95,7153,10356,0,0,0,0,0,0,0,66.31 ,69.07 ,66.31 
03,012,01,024,0000,0,10422,117,10539,13567,0,0,0,0,0,0,0,66.31 ,77.68 ,66.31 
03,012,01,025,0000,0,63,0,63,108,0,0,0,0,0,0,0,66.31 ,58.33 ,66.31 
03,012,01,026,0000,0,226,2,228,399,0,0,0,0,0,0,0,66.31 ,57.14 ,66.31 
03,012,01,027,0000,0,133,1,134,299,0,0,0,0,0,0,0,66.31 ,44.82 ,66.31 
03,013,01,001,0000,0,95375,891,96266,145278,0,0,0,0,0,0,0,66.31 ,66.26 ,66.31 
03,013,01,002,0000,0,25893,257,26150,38900,0,0,0,0,0,0,0,66.31 ,67.22 ,66.31 
03,013,01,003,0000,0,23485,204,23689,33119,0,0,0,0,0,0,0,66.31 ,71.53 ,66.31 
03,013,01,004,0000,0,12943,221,13164,22098,0,0,0,0,0,0,0,66.31 ,59.57 ,66.31 
03,013,01,005,0000,0,27858,243,28101,36676,0,0,0,0,0,0,0,66.31 ,76.62 ,66.31 
03,013,01,006,0000,0,14808,140,14948,21256,0,0,0,0,0,0,0,66.31 ,70.32 ,66.31 
03,013,01,007,0000,0,6207,39,6246,8513,0,0,0,0,0,0,0,66.31 ,73.37 ,66.31 
03,013,01,008,0000,0,11758,103,11861,16005,0,0,0,0,0,0,0,66.31 ,74.11 ,66.31 
03,013,01,009,0000,0,13728,136,13864,19106,0,0,0,0,0,0,0,66.31 ,72.56 ,66.31 
03,013,01,010,0000,0,14279,165,14444,19914,0,0,0,0,0,0,0,66.31 ,72.53 ,66.31 
03,013,01,011,0000,0,14659,175,14834,22660,0,0,0,0,0,0,0,66.31 ,65.46 ,66.31 
03,013,01,012,0000,0,12079,140,12219,17526,0,0,0,0,0,0,0,66.31 ,69.72 ,66.31 
03,013,01,013,0000,0,28757,331,29088,43904,0,0,0,0,0,0,0,66.31 ,66.25 ,66.31 
03,013,01,014,0000,0,10412,98,10510,14244,0,0,0,0,0,0,0,66.31 ,73.79 ,66.31 
03,013,01,015,0000,0,5914,45,5959,8918,0,0,0,0,0,0,0,66.31 ,66.82 ,66.31 
03,013,01,016,0000,0,13829,140,13969,21398,0,0,0,0,0,0,0,66.31 ,65.28 ,66.31 
03,013,01,017,0000,0,20773,187,20960,28415,0,0,0,0,0,0,0,66.31 ,73.76 ,66.31 
03,013,01,018,0000,0,7174,78,7252,10235,0,0,0,0,0,0,0,66.31 ,70.85 ,66.31 
03,013,01,019,0000,0,11805,142,11947,16537,0,0,0,0,0,0,0,66.31 ,72.24 ,66.31 
03,013,01,020,0000,0,7057,75,7132,9777,0,0,0,0,0,0,0,66.31 ,72.95 ,66.31 
03,013,01,021,0000,0,12096,137,12233,17361,0,0,0,0,0,0,0,66.31 ,70.46 ,66.31 
03,013,01,022,0000,0,5252,39,5291,8833,0,0,0,0,0,0,0,66.31 ,59.90 ,66.31 
03,013,01,023,0000,0,4993,80,5073,8309,0,0,0,0,0,0,0,66.31 ,61.05 ,66.31 
03,013,01,024,0000,0,2960,37,2997,5527,0,0,0,0,0,0,0,66.31 ,54.22 ,66.31 
03,013,01,025,0000,0,3155,44,3199,5032,0,0,0,0,0,0,0,66.31 ,63.57 ,66.31 
03,013,01,026,0000,0,205,5,210,409,0,0,0,0,0,0,0,66.31 ,51.34 ,66.31 
03,013,01,027,0000,0,33,0,33,79,0,0,0,0,0,0,0,66.31 ,41.77 ,66.31 
03,013,01,028,0000,0,216,4,220,376,0,0,0,0,0,0,0,66.31 ,58.51 ,66.31 
03,013,01,029,0000,0,93,0,93,172,0,0,0,0,0,0,0,66.31 ,54.07 ,66.31 
03,013,01,030,0000,0,237,11,248,429,0,0,0,0,0,0,0,66.31 ,57.81 ,66.31 
03,013,01,031,0000,0,258,0,258,408,0,0,0,0,0,0,0,66.31 ,63.24 ,66.31 
03,013,01,032,0000,0,152,0,152,303,0,0,0,0,0,0,0,66.31 ,50.17 ,66.31 
03,013,01,033,0000,0,209,3,212,404,0,0,0,0,0,0,0,66.31 ,52.48 ,66.31 
03,014,01,001,0000,0,40974,460,41434,65196,0,0,0,0,0,0,0,66.31 ,63.55 ,66.31 
03,014,01,002,0000,0,4038,18,4056,6437,0,0,0,0,0,0,0,66.31 ,63.01 ,66.31 
03,014,01,003,0000,0,3815,37,3852,6388,0,0,0,0,0,0,0,66.31 ,60.30 ,66.31 
03,014,01,004,0000,0,7302,82,7384,11525,0,0,0,0,0,0,0,66.31 ,64.07 ,66.31 
03,014,01,005,0000,0,3429,27,3456,5766,0,0,0,0,0,0,0,66.31 ,59.94 ,66.31 
03,014,01,006,0000,0,4084,41,4125,6726,0,0,0,0,0,0,0,66.31 ,61.33 ,66.31 
03,014,01,007,0000,0,2395,25,2420,4433,0,0,0,0,0,0,0,66.31 ,54.59 ,66.31 
03,014,01,008,0000,0,1808,15,1823,3570,0,0,0,0,0,0,0,66.31 ,51.06 ,66.31 
03,014,01,009,0000,0,4045,30,4075,6547,0,0,0,0,0,0,0,66.31 ,62.24 ,66.31 
03,014,01,010,0000,0,1491,15,1506,2675,0,0,0,0,0,0,0,66.31 ,56.30 ,66.31 
03,014,01,011,0000,0,1099,11,1110,1912,0,0,0,0,0,0,0,66.31 ,58.05 ,66.31 
03,014,01,012,0000,0,178,7,185,341,0,0,0,0,0,0,0,66.31 ,54.25 ,66.31 
03,014,01,013,0000,0,166,2,168,305,0,0,0,0,0,0,0,66.31 ,55.08 ,66.31 
03,014,01,014,0000,0,106,1,107,206,0,0,0,0,0,0,0,66.31 ,51.94 ,66.31 
03,014,01,015,0000,0,176,3,179,424,0,0,0,0,0,0,0,66.31 ,42.22 ,66.31 
03,014,01,016,0000,0,74,1,75,166,0,0,0,0,0,0,0,66.31 ,45.18 ,66.31 
03,015,01,001,0000,0,39470,427,39897,69287,0,0,0,0,0,0,0,66.31 ,57.58 ,66.31 
03,015,01,002,0000,0,6690,116,6806,12130,0,0,0,0,0,0,0,66.31 ,56.11 ,66.31 
03,015,01,003,0000,0,909,12,921,1961,0,0,0,0,0,0,0,66.31 ,46.97 ,66.31 
03,015,01,004,0000,0,24452,306,24758,43775,0,0,0,0,0,0,0,66.31 ,56.56 ,66.31 
03,015,01,005,0000,0,6303,90,6393,11477,0,0,0,0,0,0,0,66.31 ,55.70 ,66.31 
03,015,01,006,0000,0,5585,75,5660,9679,0,0,0,0,0,0,0,66.31 ,58.48 ,66.31 
03,015,01,007,0000,0,3789,45,3834,6857,0,0,0,0,0,0,0,66.31 ,55.91 ,66.31 
03,015,01,008,0000,0,613,6,619,1284,0,0,0,0,0,0,0,66.31 ,48.21 ,66.31 
03,015,01,009,0000,0,156,1,157,380,0,0,0,0,0,0,0,66.31 ,41.32 ,66.31 
03,015,01,010,0000,0,4076,43,4119,7594,0,0,0,0,0,0,0,66.31 ,54.24 ,66.31 
03,015,01,011,0000,0,9542,249,9791,18567,0,0,0,0,0,0,0,66.31 ,52.73 ,66.31 
03,015,01,012,0000,0,4801,50,4851,9461,0,0,0,0,0,0,0,66.31 ,51.27 ,66.31 
03,015,01,013,0000,0,180,8,188,386,0,0,0,0,0,0,0,66.31 ,48.70 ,66.31 
03,016,01,001,0000,0,21055,271,21326,35874,0,0,0,0,0,0,0,66.31 ,59.45 ,66.31 
03,016,01,002,0000,0,5758,84,5842,9607,0,0,0,0,0,0,0,66.31 ,60.81 ,66.31 
03,016,01,003,0000,0,3586,47,3633,6847,0,0,0,0,0,0,0,66.31 ,53.06 ,66.31 
03,016,01,004,0000,0,3171,55,3226,6431,0,0,0,0,0,0,0,66.31 ,50.16 ,66.31 
03,016,01,005,0000,0,1024,14,1038,3158,0,0,0,0,0,0,0,66.31 ,32.87 ,66.31 
03,016,01,006,0000,0,996,20,1016,2187,0,0,0,0,0,0,0,66.31 ,46.46 ,66.31 
03,017,01,001,0000,0,21027,240,21267,39892,0,0,0,0,0,0,0,66.31 ,53.31 ,66.31 
03,017,01,002,0000,0,18865,195,19060,33778,0,0,0,0,0,0,0,66.31 ,56.43 ,66.31 
03,017,01,003,0000,0,20844,242,21086,38787,0,0,0,0,0,0,0,66.31 ,54.36 ,66.31 
03,017,01,004,0000,0,20325,279,20604,36706,0,0,0,0,0,0,0,66.31 ,56.13 ,66.31 
03,017,01,005,0000,0,26380,300,26680,52170,0,0,0,0,0,0,0,66.31 ,51.14 ,66.31 
03,017,01,006,0000,0,12070,141,12211,24458,0,0,0,0,0,0,0,66.31 ,49.93 ,66.31 
03,017,01,007,0000,0,18662,224,18886,36992,0,0,0,0,0,0,0,66.31 ,51.05 ,66.31 
03,018,01,001,0000,0,57824,1343,59167,112807,0,0,0,0,0,0,0,66.31 ,52.45 ,66.31 
03,018,01,002,0000,0,43322,1114,44436,85203,0,0,0,0,0,0,0,66.31 ,52.15 ,66.31 
03,018,01,003,0000,0,19698,541,20239,40173,0,0,0,0,0,0,0,66.31 ,50.38 ,66.31 
03,019,01,001,0000,0,10026,103,10129,16563,0,0,0,0,0,0,0,66.31 ,61.15 ,66.31 
03,019,01,002,0000,0,30302,380,30682,47767,0,0,0,0,0,0,0,66.31 ,64.23 ,66.31 
03,019,01,003,0000,0,35784,409,36193,60167,0,0,0,0,0,0,0,66.31 ,60.15 ,66.31 
03,019,01,004,0000,0,43597,521,44118,73173,0,0,0,0,0,0,0,66.31 ,60.29 ,66.31 
03,019,01,005,0000,0,58184,667,58851,98116,0,0,0,0,0,0,0,66.31 ,59.98 ,66.31 
03,019,01,006,0000,0,61230,625,61855,102724,0,0,0,0,0,0,0,66.31 ,60.21 ,66.31 
03,019,01,007,0000,0,43387,494,43881,69616,0,0,0,0,0,0,0,66.31 ,63.03 ,66.31 
03,019,01,008,0000,0,82908,1014,83922,133344,0,0,0,0,0,0,0,66.31 ,62.94 ,66.31 
03,020,01,001,0000,0,51284,573,51857,87650,0,0,0,0,0,0,0,66.31 ,59.16 ,66.31 
03,020,01,002,0000,0,53002,583,53585,90767,0,0,0,0,0,0,0,66.31 ,59.04 ,66.31 
03,021,01,001,0000,0,68605,748,69353,116264,0,0,0,0,0,0,0,66.31 ,59.65 ,66.31 
03,021,01,002,0000,0,56434,554,56988,94768,0,0,0,0,0,0,0,66.31 ,60.13 ,66.31 
03,021,01,003,0000,0,20725,219,20944,32791,0,0,0,0,0,0,0,66.31 ,63.87 ,66.31 
03,021,01,004,0000,0,49669,608,50277,83622,0,0,0,0,0,0,0,66.31 ,60.12 ,66.31 
03,021,01,005,0000,0,19697,202,19899,32600,0,0,0,0,0,0,0,66.31 ,61.04 ,66.31 
03,021,01,006,0000,0,64036,868,64904,102486,0,0,0,0,0,0,0,66.31 ,63.33 ,66.31 
03,021,01,007,0000,0,16022,129,16151,27990,0,0,0,0,0,0,0,66.31 ,57.70 ,66.31 
04,001,01,001,0000,0,6514,109,6623,10999,0,0,0,0,0,0,0,66.31 ,60.21 ,66.31 
04,001,01,002,0000,0,3616,60,3676,6137,0,0,0,0,0,0,0,66.31 ,59.90 ,66.31 
04,001,01,003,0000,0,4727,81,4808,7470,0,0,0,0,0,0,0,66.31 ,64.36 ,66.31 
04,001,01,004,0000,0,3488,55,3543,5987,0,0,0,0,0,0,0,66.31 ,59.18 ,66.31 
04,001,01,005,0000,0,1941,36,1977,3447,0,0,0,0,0,0,0,66.31 ,57.35 ,66.31 
04,001,01,006,0000,0,38,0,38,276,0,0,0,0,0,0,0,66.31 ,13.77 ,66.31 
04,002,01,001,0000,0,1488,150,1638,2638,0,0,0,0,0,0,0,66.31 ,62.09 ,66.31 
04,002,01,002,0000,0,399,104,503,929,0,0,0,0,0,0,0,66.31 ,54.14 ,66.31 
04,002,01,003,0000,0,253,28,281,652,0,0,0,0,0,0,0,66.31 ,43.10 ,66.31 
04,002,01,004,0000,0,303,30,333,515,0,0,0,0,0,0,0,66.31 ,64.66 ,66.31 
01,000,01,001,0001,0,3032,55,3087,3720,0,0,0,0,0,0,0,66.31 ,82.98 ,66.31 
01,000,01,001,0002,0,2699,45,2744,3270,0,0,0,0,0,0,0,66.31 ,83.91 ,66.31 
01,000,01,001,0003,0,3441,52,3493,4192,0,0,0,0,0,0,0,66.31 ,83.33 ,66.31 
01,000,01,001,0004,0,4085,80,4165,4893,0,0,0,0,0,0,0,66.31 ,85.12 ,66.31 
01,000,01,001,0005,0,4382,67,4449,5291,0,0,0,0,0,0,0,66.31 ,84.09 ,66.31 
01,000,01,001,0006,0,4336,73,4409,5385,0,0,0,0,0,0,0,66.31 ,81.88 ,66.31 
01,000,01,001,0007,0,4141,82,4223,5054,0,0,0,0,0,0,0,66.31 ,83.56 ,66.31 
01,000,01,001,0008,0,4966,79,5045,6022,0,0,0,0,0,0,0,66.31 ,83.78 ,66.31 
01,000,01,001,0009,0,4479,77,4556,5631,0,0,0,0,0,0,0,66.31 ,80.91 ,66.31 
01,000,01,001,0010,0,3744,60,3804,4743,0,0,0,0,0,0,0,66.31 ,80.20 ,66.31 
01,000,01,001,0011,0,2740,49,2789,3330,0,0,0,0,0,0,0,66.31 ,83.75 ,66.31 
01,000,01,001,0012,0,3043,56,3099,3647,0,0,0,0,0,0,0,66.31 ,84.97 ,66.31 
01,000,01,001,0013,0,3763,73,3836,4584,0,0,0,0,0,0,0,66.31 ,83.68 ,66.31 
01,000,01,001,0014,0,3178,44,3222,3823,0,0,0,0,0,0,0,66.31 ,84.28 ,66.31 
01,000,01,001,0015,0,3006,51,3057,3657,0,0,0,0,0,0,0,66.31 ,83.59 ,66.31 
01,000,01,001,0016,0,3190,60,3250,3878,0,0,0,0,0,0,0,66.31 ,83.81 ,66.31 
01,000,01,001,0017,0,5127,82,5209,6106,0,0,0,0,0,0,0,66.31 ,85.31 ,66.31 
01,000,01,001,0018,0,2768,62,2830,3398,0,0,0,0,0,0,0,66.31 ,83.28 ,66.31 
01,000,01,001,0019,0,1083,25,1108,1271,0,0,0,0,0,0,0,66.31 ,87.18 ,66.31 
01,000,01,001,0020,0,5635,100,5735,6883,0,0,0,0,0,0,0,66.31 ,83.32 ,66.31 
01,000,01,001,0021,0,4928,117,5045,5987,0,0,0,0,0,0,0,66.31 ,84.27 ,66.31 
01,000,01,001,0022,0,4670,79,4749,5670,0,0,0,0,0,0,0,66.31 ,83.76 ,66.31 
01,000,01,001,0023,0,3454,67,3521,4266,0,0,0,0,0,0,0,66.31 ,82.54 ,66.31 
01,000,01,001,0024,0,3527,59,3586,4254,0,0,0,0,0,0,0,66.31 ,84.30 ,66.31 
01,000,01,001,0025,0,3885,69,3954,4782,0,0,0,0,0,0,0,66.31 ,82.69 ,66.31 
01,000,01,001,0026,0,2058,41,2099,2681,0,0,0,0,0,0,0,66.31 ,78.29 ,66.31 
01,000,01,001,0027,0,3280,46,3326,4202,0,0,0,0,0,0,0,66.31 ,79.15 ,66.31 
01,000,01,001,0028,0,2778,42,2820,3293,0,0,0,0,0,0,0,66.31 ,85.64 ,66.31 
01,000,01,001,0029,0,4038,79,4117,5075,0,0,0,0,0,0,0,66.31 ,81.12 ,66.31 
01,000,01,001,0030,0,3534,68,3602,4381,0,0,0,0,0,0,0,66.31 ,82.22 ,66.31 
01,000,01,001,0031,0,3810,56,3866,4725,0,0,0,0,0,0,0,66.31 ,81.82 ,66.31 
01,000,01,001,0032,0,2313,53,2366,2937,0,0,0,0,0,0,0,66.31 ,80.56 ,66.31 
01,000,01,001,0033,0,2611,36,2647,3163,0,0,0,0,0,0,0,66.31 ,83.69 ,66.31 
01,000,01,001,0034,0,2700,37,2737,3224,0,0,0,0,0,0,0,66.31 ,84.89 ,66.31 
01,000,01,001,0035,0,2849,49,2898,3584,0,0,0,0,0,0,0,66.31 ,80.86 ,66.31 
01,000,01,001,0036,0,3259,50,3309,3953,0,0,0,0,0,0,0,66.31 ,83.71 ,66.31 
01,000,01,001,0037,0,3802,95,3897,4605,0,0,0,0,0,0,0,66.31 ,84.63 ,66.31 
01,000,01,001,0038,0,6027,211,6238,7363,0,0,0,0,0,0,0,66.31 ,84.72 ,66.31 
01,000,01,001,0039,0,1535,36,1571,1870,0,0,0,0,0,0,0,66.31 ,84.01 ,66.31 
01,000,01,001,0040,0,1869,38,1907,2343,0,0,0,0,0,0,0,66.31 ,81.39 ,66.31 
01,000,01,002,0041,0,3004,64,3068,3665,0,0,0,0,0,0,0,66.31 ,83.71 ,66.31 
01,000,01,002,0042,0,1914,41,1955,2327,0,0,0,0,0,0,0,66.31 ,84.01 ,66.31 
01,000,01,002,0043,0,2717,40,2757,3412,0,0,0,0,0,0,0,66.31 ,80.80 ,66.31 
01,000,01,002,0044,0,2626,31,2657,3255,0,0,0,0,0,0,0,66.31 ,81.63 ,66.31 
01,000,01,002,0045,0,4937,71,5008,6154,0,0,0,0,0,0,0,66.31 ,81.38 ,66.31 
01,000,01,002,0046,0,4332,71,4403,5334,0,0,0,0,0,0,0,66.31 ,82.55 ,66.31 
01,000,01,002,0047,0,4641,77,4718,5706,0,0,0,0,0,0,0,66.31 ,82.68 ,66.31 
01,000,01,002,0048,0,5034,110,5144,6205,0,0,0,0,0,0,0,66.31 ,82.90 ,66.31 
01,000,01,002,0049,0,3473,65,3538,4154,0,0,0,0,0,0,0,66.31 ,85.17 ,66.31 
01,000,01,002,0050,0,2670,47,2717,3195,0,0,0,0,0,0,0,66.31 ,85.04 ,66.31 
01,000,01,002,0051,0,4588,95,4683,5576,0,0,0,0,0,0,0,66.31 ,83.98 ,66.31 
01,000,01,002,0052,0,3177,71,3248,3942,0,0,0,0,0,0,0,66.31 ,82.39 ,66.31 
01,000,01,002,0053,0,4332,100,4432,5462,0,0,0,0,0,0,0,66.31 ,81.14 ,66.31 
01,000,01,002,0054,0,3136,67,3203,3999,0,0,0,0,0,0,0,66.31 ,80.10 ,66.31 
01,000,01,002,0055,0,3535,76,3611,4366,0,0,0,0,0,0,0,66.31 ,82.71 ,66.31 
01,000,01,002,0056,0,3806,93,3899,4624,0,0,0,0,0,0,0,66.31 ,84.32 ,66.31 
01,000,01,002,0057,0,2441,59,2500,2971,0,0,0,0,0,0,0,66.31 ,84.15 ,66.31 
01,000,01,002,0058,0,4690,89,4779,5651,0,0,0,0,0,0,0,66.31 ,84.57 ,66.31 
01,000,01,002,0059,0,5219,118,5337,6287,0,0,0,0,0,0,0,66.31 ,84.89 ,66.31 
01,000,01,002,0060,0,4096,108,4204,4924,0,0,0,0,0,0,0,66.31 ,85.38 ,66.31 
01,000,01,002,0061,0,4262,96,4358,5128,0,0,0,0,0,0,0,66.31 ,84.98 ,66.31 
01,000,01,002,0062,0,3210,95,3305,3795,0,0,0,0,0,0,0,66.31 ,87.09 ,66.31 
01,000,01,002,0063,0,4640,94,4734,5667,0,0,0,0,0,0,0,66.31 ,83.54 ,66.31 
01,000,01,002,0064,0,3516,99,3615,4216,0,0,0,0,0,0,0,66.31 ,85.74 ,66.31 
01,000,01,002,0065,0,2695,51,2746,3488,0,0,0,0,0,0,0,66.31 ,78.73 ,66.31 
01,000,01,002,0066,0,3976,61,4037,4939,0,0,0,0,0,0,0,66.31 ,81.74 ,66.31 
01,000,01,002,0067,0,2625,48,2673,3256,0,0,0,0,0,0,0,66.31 ,82.09 ,66.31 
01,000,01,002,0068,0,3500,47,3547,4345,0,0,0,0,0,0,0,66.31 ,81.63 ,66.31 
01,000,01,002,0069,0,3144,39,3183,3863,0,0,0,0,0,0,0,66.31 ,82.40 ,66.31 
01,000,01,002,0070,0,3632,53,3685,4402,0,0,0,0,0,0,0,66.31 ,83.71 ,66.31 
01,000,01,002,0071,0,4144,68,4212,5183,0,0,0,0,0,0,0,66.31 ,81.27 ,66.31 
01,000,01,002,0072,0,3139,54,3193,3840,0,0,0,0,0,0,0,66.31 ,83.15 ,66.31 
01,000,01,002,0073,0,3456,50,3506,4243,0,0,0,0,0,0,0,66.31 ,82.63 ,66.31 
01,000,01,002,0074,0,5267,95,5362,6511,0,0,0,0,0,0,0,66.31 ,82.35 ,66.31 
01,000,01,002,0075,0,3684,45,3729,4587,0,0,0,0,0,0,0,66.31 ,81.29 ,66.31 
01,000,01,002,0076,0,3990,62,4052,4924,0,0,0,0,0,0,0,66.31 ,82.29 ,66.31 
01,000,01,002,0077,0,3148,38,3186,3917,0,0,0,0,0,0,0,66.31 ,81.34 ,66.31 
01,000,01,002,0078,0,2744,37,2781,3559,0,0,0,0,0,0,0,66.31 ,78.14 ,66.31 
01,000,01,002,0079,0,4469,71,4540,5628,0,0,0,0,0,0,0,66.31 ,80.67 ,66.31 
01,000,01,002,0080,0,4111,48,4159,5269,0,0,0,0,0,0,0,66.31 ,78.93 ,66.31 
01,000,01,002,0081,0,4940,46,4986,6270,0,0,0,0,0,0,0,66.31 ,79.52 ,66.31 
01,000,01,002,0082,0,3867,59,3926,4980,0,0,0,0,0,0,0,66.31 ,78.84 ,66.31 
01,000,01,002,0083,0,850,21,871,1084,0,0,0,0,0,0,0,66.31 ,80.35 ,66.31 
01,000,01,002,0084,0,913,15,928,1127,0,0,0,0,0,0,0,66.31 ,82.34 ,66.31 
01,000,01,002,0085,0,1318,26,1344,1707,0,0,0,0,0,0,0,66.31 ,78.73 ,66.31 
01,000,01,002,0086,0,1984,32,2016,2664,0,0,0,0,0,0,0,66.31 ,75.68 ,66.31 
01,000,01,002,0087,0,1058,29,1087,1307,0,0,0,0,0,0,0,66.31 ,83.17 ,66.31 
01,000,01,002,0088,0,980,12,992,1166,0,0,0,0,0,0,0,66.31 ,85.08 ,66.31 
01,000,01,002,0089,0,962,28,990,1176,0,0,0,0,0,0,0,66.31 ,84.18 ,66.31 
01,000,01,002,0090,0,3799,94,3893,5023,0,0,0,0,0,0,0,66.31 ,77.50 ,66.31 
01,000,01,003,0091,0,4996,89,5085,6049,0,0,0,0,0,0,0,66.31 ,84.06 ,66.31 
01,000,01,003,0092,0,4691,99,4790,5719,0,0,0,0,0,0,0,66.31 ,83.76 ,66.31 
01,000,01,003,0093,0,3766,67,3833,4587,0,0,0,0,0,0,0,66.31 ,83.56 ,66.31 
01,000,01,003,0094,0,3258,58,3316,3941,0,0,0,0,0,0,0,66.31 ,84.14 ,66.31 
01,000,01,003,0095,0,6545,105,6650,7931,0,0,0,0,0,0,0,66.31 ,83.85 ,66.31 
01,000,01,003,0096,0,5608,74,5682,6816,0,0,0,0,0,0,0,66.31 ,83.36 ,66.31 
01,000,01,003,0097,0,4768,73,4841,5780,0,0,0,0,0,0,0,66.31 ,83.75 ,66.31 
01,000,01,003,0098,0,3154,56,3210,3900,0,0,0,0,0,0,0,66.31 ,82.31 ,66.31 
01,000,01,003,0099,0,4350,50,4400,5408,0,0,0,0,0,0,0,66.31 ,81.36 ,66.31 
01,000,01,003,0100,0,4986,80,5066,6074,0,0,0,0,0,0,0,66.31 ,83.40 ,66.31 
01,000,01,003,0101,0,6407,104,6511,8075,0,0,0,0,0,0,0,66.31 ,80.63 ,66.31 
01,000,01,003,0102,0,3497,56,3553,4265,0,0,0,0,0,0,0,66.31 ,83.31 ,66.31 
01,000,01,003,0103,0,3844,68,3912,4711,0,0,0,0,0,0,0,66.31 ,83.04 ,66.31 
01,000,01,003,0104,0,4101,45,4146,5062,0,0,0,0,0,0,0,66.31 ,81.90 ,66.31 
01,000,01,003,0105,0,3077,78,3155,3787,0,0,0,0,0,0,0,66.31 ,83.31 ,66.31 
01,000,01,003,0106,0,3197,61,3258,3979,0,0,0,0,0,0,0,66.31 ,81.88 ,66.31 
01,000,01,003,0107,0,12692,202,12894,15679,0,0,0,0,0,0,0,66.31 ,82.24 ,66.31 
01,000,01,003,0108,0,4078,54,4132,4956,0,0,0,0,0,0,0,66.31 ,83.37 ,66.31 
01,000,01,003,0109,0,5052,84,5136,6043,0,0,0,0,0,0,0,66.31 ,84.99 ,66.31 
01,000,01,003,0110,0,2948,49,2997,3539,0,0,0,0,0,0,0,66.31 ,84.68 ,66.31 
01,000,01,003,0111,0,4862,96,4958,5954,0,0,0,0,0,0,0,66.31 ,83.27 ,66.31 
01,000,01,003,0112,0,8115,133,8248,9912,0,0,0,0,0,0,0,66.31 ,83.21 ,66.31 
01,000,01,003,0113,0,4239,73,4312,5160,0,0,0,0,0,0,0,66.31 ,83.57 ,66.31 
01,000,01,003,0114,0,4870,98,4968,6032,0,0,0,0,0,0,0,66.31 ,82.36 ,66.31 
01,000,01,003,0115,0,2963,55,3018,3562,0,0,0,0,0,0,0,66.31 ,84.73 ,66.31 
01,000,01,003,0116,0,2895,66,2961,3572,0,0,0,0,0,0,0,66.31 ,82.89 ,66.31 
01,000,01,003,0117,0,1639,42,1681,2073,0,0,0,0,0,0,0,66.31 ,81.09 ,66.31 
01,000,01,003,0118,0,4032,64,4096,4902,0,0,0,0,0,0,0,66.31 ,83.56 ,66.31 
01,000,01,003,0119,0,2736,51,2787,3364,0,0,0,0,0,0,0,66.31 ,82.85 ,66.31 
01,000,01,004,0120,0,3022,65,3087,3681,0,0,0,0,0,0,0,66.31 ,83.86 ,66.31 
01,000,01,004,0121,0,3285,71,3356,3995,0,0,0,0,0,0,0,66.31 ,84.01 ,66.31 
01,000,01,004,0122,0,5090,81,5171,6272,0,0,0,0,0,0,0,66.31 ,82.45 ,66.31 
01,000,01,004,0123,0,2792,45,2837,3370,0,0,0,0,0,0,0,66.31 ,84.18 ,66.31 
01,000,01,004,0124,0,3405,63,3468,4078,0,0,0,0,0,0,0,66.31 ,85.04 ,66.31 
01,000,01,004,0125,0,2759,46,2805,3392,0,0,0,0,0,0,0,66.31 ,82.69 ,66.31 
01,000,01,004,0126,0,3995,83,4078,4818,0,0,0,0,0,0,0,66.31 ,84.64 ,66.31 
01,000,01,004,0127,0,3058,48,3106,3695,0,0,0,0,0,0,0,66.31 ,84.06 ,66.31 
01,000,01,004,0128,0,2859,58,2917,3494,0,0,0,0,0,0,0,66.31 ,83.49 ,66.31 
01,000,01,004,0129,0,4210,82,4292,5109,0,0,0,0,0,0,0,66.31 ,84.01 ,66.31 
01,000,01,004,0130,0,2754,53,2807,3471,0,0,0,0,0,0,0,66.31 ,80.87 ,66.31 
01,000,01,004,0131,0,3536,78,3614,4377,0,0,0,0,0,0,0,66.31 ,82.57 ,66.31 
01,000,01,004,0132,0,2243,57,2300,2705,0,0,0,0,0,0,0,66.31 ,85.03 ,66.31 
01,000,01,004,0133,0,2715,61,2776,3236,0,0,0,0,0,0,0,66.31 ,85.78 ,66.31 
01,000,01,004,0134,0,2713,57,2770,3341,0,0,0,0,0,0,0,66.31 ,82.91 ,66.31 
01,000,01,004,0135,0,5678,113,5791,6984,0,0,0,0,0,0,0,66.31 ,82.92 ,66.31 
01,000,01,004,0136,0,4973,101,5074,6154,0,0,0,0,0,0,0,66.31 ,82.45 ,66.31 
01,000,01,004,0137,0,3805,78,3883,4669,0,0,0,0,0,0,0,66.31 ,83.17 ,66.31 
01,000,01,005,0138,0,3829,58,3887,4748,0,0,0,0,0,0,0,66.31 ,81.87 ,66.31 
01,000,01,005,0139,0,5318,56,5374,6887,0,0,0,0,0,0,0,66.31 ,78.03 ,66.31 
01,000,01,005,0140,0,4273,66,4339,5480,0,0,0,0,0,0,0,66.31 ,79.18 ,66.31 
01,000,01,005,0141,0,3009,49,3058,3779,0,0,0,0,0,0,0,66.31 ,80.92 ,66.31 
01,000,01,005,0142,0,3345,30,3375,4274,0,0,0,0,0,0,0,66.31 ,78.97 ,66.31 
01,000,01,005,0143,0,3041,55,3096,3874,0,0,0,0,0,0,0,66.31 ,79.92 ,66.31 
01,000,01,005,0144,0,2743,34,2777,3662,0,0,0,0,0,0,0,66.31 ,75.83 ,66.31 
01,000,01,005,0145,0,2826,47,2873,3763,0,0,0,0,0,0,0,66.31 ,76.35 ,66.31 
01,000,01,005,0146,0,2805,41,2846,3739,0,0,0,0,0,0,0,66.31 ,76.12 ,66.31 
01,000,01,005,0147,0,4627,91,4718,6107,0,0,0,0,0,0,0,66.31 ,77.26 ,66.31 
01,000,01,005,0148,0,3451,41,3492,4534,0,0,0,0,0,0,0,66.31 ,77.02 ,66.31 
01,000,01,005,0149,0,2858,45,2903,3695,0,0,0,0,0,0,0,66.31 ,78.57 ,66.31 
01,000,01,005,0150,0,2033,24,2057,2623,0,0,0,0,0,0,0,66.31 ,78.42 ,66.31 
01,000,01,005,0151,0,3032,43,3075,3788,0,0,0,0,0,0,0,66.31 ,81.18 ,66.31 
01,000,01,005,0152,0,5257,68,5325,6918,0,0,0,0,0,0,0,66.31 ,76.97 ,66.31 
01,000,01,005,0153,0,4201,85,4286,5318,0,0,0,0,0,0,0,66.31 ,80.59 ,66.31 
01,000,01,005,0154,0,2283,48,2331,3000,0,0,0,0,0,0,0,66.31 ,77.70 ,66.31 
01,000,01,005,0155,0,3848,45,3893,4784,0,0,0,0,0,0,0,66.31 ,81.38 ,66.31 
01,000,01,005,0156,0,5732,118,5850,7069,0,0,0,0,0,0,0,66.31 ,82.76 ,66.31 
01,000,01,005,0157,0,3232,48,3280,3981,0,0,0,0,0,0,0,66.31 ,82.39 ,66.31 
01,000,01,005,0158,0,4545,64,4609,5794,0,0,0,0,0,0,0,66.31 ,79.55 ,66.31 
01,000,01,005,0159,0,4775,84,4859,6143,0,0,0,0,0,0,0,66.31 ,79.10 ,66.31 
01,000,01,005,0160,0,4420,73,4493,5670,0,0,0,0,0,0,0,66.31 ,79.24 ,66.31 
01,000,01,005,0161,0,4043,68,4111,5067,0,0,0,0,0,0,0,66.31 ,81.13 ,66.31 
01,000,01,005,0162,0,4591,76,4667,6060,0,0,0,0,0,0,0,66.31 ,77.01 ,66.31 
01,000,01,005,0163,0,2494,50,2544,3130,0,0,0,0,0,0,0,66.31 ,81.28 ,66.31 
01,000,01,005,0164,0,2146,26,2172,2669,0,0,0,0,0,0,0,66.31 ,81.38 ,66.31 
01,000,01,005,0165,0,2390,26,2416,3011,0,0,0,0,0,0,0,66.31 ,80.24 ,66.31 
01,000,01,005,0166,0,4360,63,4423,5476,0,0,0,0,0,0,0,66.31 ,80.77 ,66.31 
01,000,01,005,0167,0,1984,26,2010,2523,0,0,0,0,0,0,0,66.31 ,79.67 ,66.31 
01,000,01,005,0168,0,2231,35,2266,2888,0,0,0,0,0,0,0,66.31 ,78.46 ,66.31 
01,000,01,005,0169,0,3721,78,3799,4799,0,0,0,0,0,0,0,66.31 ,79.16 ,66.31 
01,000,01,005,0170,0,1574,39,1613,2173,0,0,0,0,0,0,0,66.31 ,74.23 ,66.31 
01,000,01,006,0171,0,3088,36,3124,3910,0,0,0,0,0,0,0,66.31 ,79.90 ,66.31 
01,000,01,006,0172,0,3010,61,3071,3963,0,0,0,0,0,0,0,66.31 ,77.49 ,66.31 
01,000,01,006,0173,0,1847,40,1887,2515,0,0,0,0,0,0,0,66.31 ,75.03 ,66.31 
01,000,01,006,0174,0,1645,31,1676,2269,0,0,0,0,0,0,0,66.31 ,73.87 ,66.31 
01,000,01,006,0175,0,2609,49,2658,3487,0,0,0,0,0,0,0,66.31 ,76.23 ,66.31 
01,000,01,006,0176,0,3853,64,3917,4952,0,0,0,0,0,0,0,66.31 ,79.10 ,66.31 
01,000,01,006,0177,0,2901,56,2957,3746,0,0,0,0,0,0,0,66.31 ,78.94 ,66.31 
01,000,01,006,0178,0,3820,56,3876,4873,0,0,0,0,0,0,0,66.31 ,79.54 ,66.31 
01,000,01,006,0179,0,4633,58,4691,5939,0,0,0,0,0,0,0,66.31 ,78.99 ,66.31 
01,000,01,006,0180,0,2268,54,2322,2822,0,0,0,0,0,0,0,66.31 ,82.28 ,66.31 
01,000,01,006,0181,0,2993,40,3033,3702,0,0,0,0,0,0,0,66.31 ,81.93 ,66.31 
01,000,01,006,0182,0,2403,54,2457,2986,0,0,0,0,0,0,0,66.31 ,82.28 ,66.31 
01,000,01,006,0183,0,3363,76,3439,4143,0,0,0,0,0,0,0,66.31 ,83.01 ,66.31 
01,000,01,006,0184,0,3051,75,3126,3775,0,0,0,0,0,0,0,66.31 ,82.81 ,66.31 
01,000,01,006,0185,0,2958,70,3028,3708,0,0,0,0,0,0,0,66.31 ,81.66 ,66.31 
01,000,01,006,0186,0,3697,70,3767,4500,0,0,0,0,0,0,0,66.31 ,83.71 ,66.31 
01,000,01,006,0187,0,3680,51,3731,4602,0,0,0,0,0,0,0,66.31 ,81.07 ,66.31 
01,000,01,006,0188,0,3641,55,3696,4475,0,0,0,0,0,0,0,66.31 ,82.59 ,66.31 
01,000,01,006,0189,0,2493,46,2539,3158,0,0,0,0,0,0,0,66.31 ,80.40 ,66.31 
01,000,01,006,0190,0,4281,78,4359,5371,0,0,0,0,0,0,0,66.31 ,81.16 ,66.31 
01,000,01,006,0191,0,1858,45,1903,2368,0,0,0,0,0,0,0,66.31 ,80.36 ,66.31 
01,000,01,006,0192,0,4028,93,4121,5004,0,0,0,0,0,0,0,66.31 ,82.35 ,66.31 
01,000,01,006,0193,0,3657,41,3698,4554,0,0,0,0,0,0,0,66.31 ,81.20 ,66.31 
01,000,01,006,0194,0,3060,56,3116,3751,0,0,0,0,0,0,0,66.31 ,83.07 ,66.31 
01,000,01,006,0195,0,5112,105,5217,6252,0,0,0,0,0,0,0,66.31 ,83.45 ,66.31 
01,000,01,006,0196,0,4201,92,4293,5244,0,0,0,0,0,0,0,66.31 ,81.86 ,66.31 
01,000,01,006,0197,0,3827,153,3980,4929,0,0,0,0,0,0,0,66.31 ,80.75 ,66.31 
01,000,01,006,0198,0,3131,49,3180,3983,0,0,0,0,0,0,0,66.31 ,79.84 ,66.31 
01,000,01,006,0199,0,4460,98,4558,5505,0,0,0,0,0,0,0,66.31 ,82.80 ,66.31 
01,000,01,006,0200,0,5776,94,5870,7322,0,0,0,0,0,0,0,66.31 ,80.17 ,66.31 
01,000,01,006,0201,0,3066,66,3132,3955,0,0,0,0,0,0,0,66.31 ,79.19 ,66.31 
01,000,01,006,0202,0,4038,70,4108,5193,0,0,0,0,0,0,0,66.31 ,79.11 ,66.31 
01,000,01,006,0203,0,5212,115,5327,6619,0,0,0,0,0,0,0,66.31 ,80.48 ,66.31 
01,000,01,006,0204,0,3140,65,3205,3960,0,0,0,0,0,0,0,66.31 ,80.93 ,66.31 
01,000,01,006,0205,0,3116,59,3175,3909,0,0,0,0,0,0,0,66.31 ,81.22 ,66.31 
01,000,01,006,0206,0,4388,74,4462,5478,0,0,0,0,0,0,0,66.31 ,81.45 ,66.31 
01,000,01,006,0207,0,2145,45,2190,2668,0,0,0,0,0,0,0,66.31 ,82.08 ,66.31 
01,000,01,006,0208,0,2790,48,2838,3566,0,0,0,0,0,0,0,66.31 ,79.58 ,66.31 
01,000,01,006,0209,0,4482,103,4585,5590,0,0,0,0,0,0,0,66.31 ,82.02 ,66.31 
01,000,01,006,0210,0,3076,79,3155,3804,0,0,0,0,0,0,0,66.31 ,82.94 ,66.31 
01,000,01,006,0211,0,1914,59,1973,2473,0,0,0,0,0,0,0,66.31 ,79.78 ,66.31 
01,000,02,007,0212,0,1936,37,1973,2513,0,0,0,0,0,0,0,66.31 ,78.51 ,66.31 
01,000,02,007,0213,0,2552,84,2636,3526,0,0,0,0,0,0,0,66.31 ,74.76 ,66.31 
01,000,02,007,0214,0,1841,34,1875,2565,0,0,0,0,0,0,0,66.31 ,73.10 ,66.31 
01,000,02,007,0215,0,3065,62,3127,4110,0,0,0,0,0,0,0,66.31 ,76.08 ,66.31 
01,000,02,007,0216,0,1254,47,1301,1890,0,0,0,0,0,0,0,66.31 ,68.84 ,66.31 
01,000,02,007,0217,0,2888,73,2961,3942,0,0,0,0,0,0,0,66.31 ,75.11 ,66.31 
01,000,02,007,0218,0,2003,42,2045,2786,0,0,0,0,0,0,0,66.31 ,73.40 ,66.31 
01,000,02,007,0219,0,3521,92,3613,4555,0,0,0,0,0,0,0,66.31 ,79.32 ,66.31 
01,000,02,007,0220,0,2222,60,2282,3003,0,0,0,0,0,0,0,66.31 ,75.99 ,66.31 
01,000,02,007,0221,0,1749,50,1799,2477,0,0,0,0,0,0,0,66.31 ,72.63 ,66.31 
01,000,02,007,0222,0,2299,41,2340,3259,0,0,0,0,0,0,0,66.31 ,71.80 ,66.31 
01,000,02,007,0223,0,2747,84,2831,3726,0,0,0,0,0,0,0,66.31 ,75.98 ,66.31 
01,000,02,007,0224,0,3044,58,3102,3905,0,0,0,0,0,0,0,66.31 ,79.44 ,66.31 
01,000,02,007,0225,0,1852,32,1884,2357,0,0,0,0,0,0,0,66.31 ,79.93 ,66.31 
01,000,02,007,0226,0,6242,87,6329,7761,0,0,0,0,0,0,0,66.31 ,81.55 ,66.31 
01,000,02,007,0227,0,3383,74,3457,4133,0,0,0,0,0,0,0,66.31 ,83.64 ,66.31 
01,000,02,007,0228,0,4314,58,4372,5261,0,0,0,0,0,0,0,66.31 ,83.10 ,66.31 
01,000,02,007,0229,0,726,24,750,909,0,0,0,0,0,0,0,66.31 ,82.51 ,66.31 
01,000,02,007,0230,0,3187,64,3251,3955,0,0,0,0,0,0,0,66.31 ,82.20 ,66.31 
01,000,02,007,0231,0,3151,95,3246,4110,0,0,0,0,0,0,0,66.31 ,78.98 ,66.31 
01,000,02,007,0232,0,3943,69,4012,5056,0,0,0,0,0,0,0,66.31 ,79.35 ,66.31 
01,000,02,007,0233,0,3017,73,3090,3911,0,0,0,0,0,0,0,66.31 ,79.01 ,66.31 
01,000,02,007,0234,0,3495,93,3588,4574,0,0,0,0,0,0,0,66.31 ,78.44 ,66.31 
01,000,02,007,0235,0,3233,81,3314,4162,0,0,0,0,0,0,0,66.31 ,79.63 ,66.31 
01,000,02,007,0236,0,5242,114,5356,6474,0,0,0,0,0,0,0,66.31 ,82.73 ,66.31 
01,000,02,007,0237,0,2420,61,2481,3045,0,0,0,0,0,0,0,66.31 ,81.48 ,66.31 
01,000,02,007,0238,0,4455,95,4550,5573,0,0,0,0,0,0,0,66.31 ,81.64 ,66.31 
01,000,02,007,0239,0,4059,71,4130,5168,0,0,0,0,0,0,0,66.31 ,79.91 ,66.31 
01,000,02,007,0240,0,4698,81,4779,5846,0,0,0,0,0,0,0,66.31 ,81.75 ,66.31 
01,000,02,007,0241,0,3176,60,3236,4207,0,0,0,0,0,0,0,66.31 ,76.92 ,66.31 
01,000,02,007,0242,0,2864,68,2932,3813,0,0,0,0,0,0,0,66.31 ,76.89 ,66.31 
01,000,02,007,0243,0,3084,59,3143,4172,0,0,0,0,0,0,0,66.31 ,75.34 ,66.31 
01,000,02,007,0244,0,2207,43,2250,2875,0,0,0,0,0,0,0,66.31 ,78.26 ,66.31 
01,000,02,007,0245,0,3891,83,3974,5010,0,0,0,0,0,0,0,66.31 ,79.32 ,66.31 
01,000,02,007,0246,0,3455,58,3513,4304,0,0,0,0,0,0,0,66.31 ,81.62 ,66.31 
01,000,02,007,0247,0,2663,50,2713,3418,0,0,0,0,0,0,0,66.31 ,79.37 ,66.31 
01,000,02,007,0248,0,2669,46,2715,3431,0,0,0,0,0,0,0,66.31 ,79.13 ,66.31 
01,000,02,007,0249,0,2054,38,2092,2635,0,0,0,0,0,0,0,66.31 ,79.39 ,66.31 
01,000,02,007,0250,0,3848,64,3912,5032,0,0,0,0,0,0,0,66.31 ,77.74 ,66.31 
01,000,02,007,0251,0,2284,60,2344,3010,0,0,0,0,0,0,0,66.31 ,77.87 ,66.31 
01,000,02,008,0252,0,2462,49,2511,3262,0,0,0,0,0,0,0,66.31 ,76.98 ,66.31 
01,000,02,008,0253,0,2373,50,2423,3096,0,0,0,0,0,0,0,66.31 ,78.26 ,66.31 
01,000,02,008,0254,0,2563,56,2619,3243,0,0,0,0,0,0,0,66.31 ,80.76 ,66.31 
01,000,02,008,0255,0,2194,55,2249,2886,0,0,0,0,0,0,0,66.31 ,77.93 ,66.31 
01,000,02,008,0256,0,3240,50,3290,4139,0,0,0,0,0,0,0,66.31 ,79.49 ,66.31 
01,000,02,008,0257,0,2340,46,2386,2975,0,0,0,0,0,0,0,66.31 ,80.20 ,66.31 
01,000,02,008,0258,0,2844,75,2919,3584,0,0,0,0,0,0,0,66.31 ,81.45 ,66.31 
01,000,02,008,0259,0,3439,91,3530,4262,0,0,0,0,0,0,0,66.31 ,82.82 ,66.31 
01,000,02,008,0260,0,3281,63,3344,4055,0,0,0,0,0,0,0,66.31 ,82.47 ,66.31 
01,000,02,008,0261,0,2407,60,2467,3141,0,0,0,0,0,0,0,66.31 ,78.54 ,66.31 
01,000,02,008,0262,0,5759,132,5891,7233,0,0,0,0,0,0,0,66.31 ,81.45 ,66.31 
01,000,02,008,0263,0,2573,49,2622,3269,0,0,0,0,0,0,0,66.31 ,80.21 ,66.31 
01,000,02,008,0264,0,4149,107,4256,5351,0,0,0,0,0,0,0,66.31 ,79.54 ,66.31 
01,000,02,008,0265,0,1945,53,1998,2451,0,0,0,0,0,0,0,66.31 ,81.52 ,66.31 
01,000,02,008,0266,0,2156,45,2201,2680,0,0,0,0,0,0,0,66.31 ,82.13 ,66.31 
01,000,02,008,0267,0,3051,72,3123,3877,0,0,0,0,0,0,0,66.31 ,80.55 ,66.31 
01,000,02,008,0268,0,2873,74,2947,3532,0,0,0,0,0,0,0,66.31 ,83.44 ,66.31 
01,000,02,008,0269,0,1571,36,1607,1946,0,0,0,0,0,0,0,66.31 ,82.58 ,66.31 
01,000,02,008,0270,0,2006,57,2063,2545,0,0,0,0,0,0,0,66.31 ,81.06 ,66.31 
01,000,02,008,0271,0,3553,84,3637,4454,0,0,0,0,0,0,0,66.31 ,81.66 ,66.31 
01,000,02,008,0272,0,4204,97,4301,5146,0,0,0,0,0,0,0,66.31 ,83.58 ,66.31 
01,000,02,008,0273,0,5169,107,5276,6431,0,0,0,0,0,0,0,66.31 ,82.04 ,66.31 
01,000,02,008,0274,0,857,16,873,1026,0,0,0,0,0,0,0,66.31 ,85.09 ,66.31 
01,000,02,008,0275,0,2909,67,2976,3673,0,0,0,0,0,0,0,66.31 ,81.02 ,66.31 
01,000,02,008,0276,0,2634,57,2691,3197,0,0,0,0,0,0,0,66.31 ,84.17 ,66.31 
01,000,02,008,0277,0,3881,92,3973,4783,0,0,0,0,0,0,0,66.31 ,83.07 ,66.31 
01,000,02,009,0278,0,2222,46,2268,2832,0,0,0,0,0,0,0,66.31 ,80.08 ,66.31 
01,000,02,009,0279,0,1608,44,1652,2249,0,0,0,0,0,0,0,66.31 ,73.45 ,66.31 
01,000,02,009,0280,0,1692,30,1722,2189,0,0,0,0,0,0,0,66.31 ,78.67 ,66.31 
01,000,02,009,0281,0,2976,61,3037,3822,0,0,0,0,0,0,0,66.31 ,79.46 ,66.31 
01,000,02,009,0282,0,2936,49,2985,3922,0,0,0,0,0,0,0,66.31 ,76.11 ,66.31 
01,000,02,009,0283,0,3562,56,3618,4547,0,0,0,0,0,0,0,66.31 ,79.57 ,66.31 
01,000,02,009,0284,0,3483,57,3540,4518,0,0,0,0,0,0,0,66.31 ,78.35 ,66.31 
01,000,02,009,0285,0,2176,46,2222,2823,0,0,0,0,0,0,0,66.31 ,78.71 ,66.31 
01,000,02,009,0286,0,3382,59,3441,4232,0,0,0,0,0,0,0,66.31 ,81.31 ,66.31 
01,000,02,009,0287,0,2881,54,2935,3637,0,0,0,0,0,0,0,66.31 ,80.70 ,66.31 
01,000,02,009,0288,0,3499,92,3591,4392,0,0,0,0,0,0,0,66.31 ,81.76 ,66.31 
01,000,02,009,0289,0,2996,54,3050,3725,0,0,0,0,0,0,0,66.31 ,81.88 ,66.31 
01,000,02,009,0290,0,4307,89,4396,5439,0,0,0,0,0,0,0,66.31 ,80.82 ,66.31 
01,000,02,009,0291,0,4659,143,4802,6021,0,0,0,0,0,0,0,66.31 ,79.75 ,66.31 
01,000,02,009,0292,0,2335,40,2375,2922,0,0,0,0,0,0,0,66.31 ,81.28 ,66.31 
01,000,02,009,0293,0,2062,31,2093,2660,0,0,0,0,0,0,0,66.31 ,78.68 ,66.31 
01,000,02,009,0294,0,2365,39,2404,3049,0,0,0,0,0,0,0,66.31 ,78.85 ,66.31 
01,000,02,009,0295,0,2500,33,2533,3213,0,0,0,0,0,0,0,66.31 ,78.84 ,66.31 
01,000,02,009,0296,0,4680,74,4754,5991,0,0,0,0,0,0,0,66.31 ,79.35 ,66.31 
01,000,02,009,0297,0,3610,64,3674,4582,0,0,0,0,0,0,0,66.31 ,80.18 ,66.31 
01,000,02,009,0298,0,5013,70,5083,6172,0,0,0,0,0,0,0,66.31 ,82.36 ,66.31 
01,000,02,009,0299,0,872,14,886,1293,0,0,0,0,0,0,0,66.31 ,68.52 ,66.31 
01,000,02,009,0300,0,2112,47,2159,2942,0,0,0,0,0,0,0,66.31 ,73.39 ,66.31 
01,000,02,009,0301,0,1483,35,1518,2145,0,0,0,0,0,0,0,66.31 ,70.77 ,66.31 
01,000,02,009,0302,0,2272,54,2326,2956,0,0,0,0,0,0,0,66.31 ,78.69 ,66.31 
01,000,02,009,0303,0,2609,59,2668,3463,0,0,0,0,0,0,0,66.31 ,77.04 ,66.31 
01,000,02,009,0304,0,2618,38,2656,3549,0,0,0,0,0,0,0,66.31 ,74.84 ,66.31 
01,000,02,009,0305,0,2345,51,2396,3088,0,0,0,0,0,0,0,66.31 ,77.59 ,66.31 
01,000,02,009,0306,0,3003,50,3053,4027,0,0,0,0,0,0,0,66.31 ,75.81 ,66.31 
01,000,02,009,0307,0,4161,52,4213,5192,0,0,0,0,0,0,0,66.31 ,81.14 ,66.31 
01,000,02,009,0308,0,4564,72,4636,6043,0,0,0,0,0,0,0,66.31 ,76.72 ,66.31 
01,000,02,010,0309,0,2976,57,3033,3938,0,0,0,0,0,0,0,66.31 ,77.02 ,66.31 
01,000,02,010,0310,0,1839,37,1876,2629,0,0,0,0,0,0,0,66.31 ,71.36 ,66.31 
01,000,02,010,0311,0,2098,53,2151,2865,0,0,0,0,0,0,0,66.31 ,75.08 ,66.31 
01,000,02,010,0312,0,4403,129,4532,5658,0,0,0,0,0,0,0,66.31 ,80.10 ,66.31 
01,000,02,010,0313,0,3653,71,3724,4612,0,0,0,0,0,0,0,66.31 ,80.75 ,66.31 
01,000,02,010,0314,0,3317,83,3400,4206,0,0,0,0,0,0,0,66.31 ,80.84 ,66.31 
01,000,02,010,0315,0,3315,56,3371,4164,0,0,0,0,0,0,0,66.31 ,80.96 ,66.31 
01,000,02,010,0316,0,2548,43,2591,3121,0,0,0,0,0,0,0,66.31 ,83.02 ,66.31 
01,000,02,010,0317,0,2971,52,3023,3637,0,0,0,0,0,0,0,66.31 ,83.12 ,66.31 
01,000,02,010,0318,0,3186,48,3234,3876,0,0,0,0,0,0,0,66.31 ,83.44 ,66.31 
01,000,02,010,0319,0,5462,87,5549,6676,0,0,0,0,0,0,0,66.31 ,83.12 ,66.31 
01,000,02,010,0320,0,3289,78,3367,4111,0,0,0,0,0,0,0,66.31 ,81.90 ,66.31 
01,000,02,010,0321,0,2644,58,2702,3440,0,0,0,0,0,0,0,66.31 ,78.55 ,66.31 
01,000,02,010,0322,0,5778,121,5899,7244,0,0,0,0,0,0,0,66.31 ,81.43 ,66.31 
01,000,02,010,0323,0,2852,56,2908,3579,0,0,0,0,0,0,0,66.31 ,81.25 ,66.31 
01,000,02,010,0324,0,4833,113,4946,5985,0,0,0,0,0,0,0,66.31 ,82.64 ,66.31 
01,000,02,010,0325,0,3800,82,3882,4842,0,0,0,0,0,0,0,66.31 ,80.17 ,66.31 
01,000,02,010,0326,0,5612,121,5733,7010,0,0,0,0,0,0,0,66.31 ,81.78 ,66.31 
01,000,02,010,0327,0,3664,100,3764,4623,0,0,0,0,0,0,0,66.31 ,81.42 ,66.31 
01,000,02,010,0328,0,2597,37,2634,3113,0,0,0,0,0,0,0,66.31 ,84.61 ,66.31 
01,000,02,010,0329,0,4374,87,4461,5523,0,0,0,0,0,0,0,66.31 ,80.77 ,66.31 
01,000,02,010,0330,0,2929,62,2991,3636,0,0,0,0,0,0,0,66.31 ,82.26 ,66.31 
01,000,02,010,0331,0,2176,43,2219,2682,0,0,0,0,0,0,0,66.31 ,82.74 ,66.31 
01,000,02,010,0332,0,4550,112,4662,5797,0,0,0,0,0,0,0,66.31 ,80.42 ,66.31 
01,000,02,010,0333,0,3541,77,3618,4304,0,0,0,0,0,0,0,66.31 ,84.06 ,66.31 
01,000,02,010,0334,0,2552,48,2600,3206,0,0,0,0,0,0,0,66.31 ,81.10 ,66.31 
01,000,02,010,0335,0,2065,43,2108,2532,0,0,0,0,0,0,0,66.31 ,83.25 ,66.31 
01,000,02,010,0336,0,3225,67,3292,3903,0,0,0,0,0,0,0,66.31 ,84.35 ,66.31 
01,000,02,010,0337,0,2808,72,2880,3377,0,0,0,0,0,0,0,66.31 ,85.28 ,66.31 
01,000,02,010,0338,0,3346,47,3393,4043,0,0,0,0,0,0,0,66.31 ,83.92 ,66.31 
01,000,02,010,0339,0,3117,57,3174,3871,0,0,0,0,0,0,0,66.31 ,81.99 ,66.31 
01,000,02,010,0340,0,4293,87,4380,5220,0,0,0,0,0,0,0,66.31 ,83.91 ,66.31 
01,000,02,010,0341,0,3395,83,3478,4231,0,0,0,0,0,0,0,66.31 ,82.20 ,66.31 
01,000,02,010,0342,0,3542,67,3609,4377,0,0,0,0,0,0,0,66.31 ,82.45 ,66.31 
01,000,02,010,0343,0,2894,65,2959,3626,0,0,0,0,0,0,0,66.31 ,81.61 ,66.31 
01,000,02,010,0344,0,2039,31,2070,2563,0,0,0,0,0,0,0,66.31 ,80.76 ,66.31 
01,000,02,011,0345,0,3226,58,3284,4451,0,0,0,0,0,0,0,66.31 ,73.78 ,66.31 
01,000,02,011,0346,0,2735,34,2769,3711,0,0,0,0,0,0,0,66.31 ,74.62 ,66.31 
01,000,02,011,0347,0,3938,64,4002,5118,0,0,0,0,0,0,0,66.31 ,78.19 ,66.31 
01,000,02,011,0348,0,4600,71,4671,6243,0,0,0,0,0,0,0,66.31 ,74.82 ,66.31 
01,000,02,011,0349,0,3101,50,3151,4492,0,0,0,0,0,0,0,66.31 ,70.15 ,66.31 
01,000,02,011,0350,0,4295,49,4344,5603,0,0,0,0,0,0,0,66.31 ,77.53 ,66.31 
01,000,02,011,0351,0,3515,63,3578,4724,0,0,0,0,0,0,0,66.31 ,75.74 ,66.31 
01,000,02,011,0352,0,2419,34,2453,3243,0,0,0,0,0,0,0,66.31 ,75.64 ,66.31 
01,000,02,011,0353,0,2676,35,2711,3565,0,0,0,0,0,0,0,66.31 ,76.04 ,66.31 
01,000,02,011,0354,0,4368,80,4448,6116,0,0,0,0,0,0,0,66.31 ,72.73 ,66.31 
01,000,02,011,0355,0,3248,50,3298,4224,0,0,0,0,0,0,0,66.31 ,78.08 ,66.31 
01,000,02,011,0356,0,2587,50,2637,3460,0,0,0,0,0,0,0,66.31 ,76.21 ,66.31 
01,000,02,011,0357,0,2511,39,2550,3232,0,0,0,0,0,0,0,66.31 ,78.90 ,66.31 
01,000,02,011,0358,0,3840,75,3915,4953,0,0,0,0,0,0,0,66.31 ,79.04 ,66.31 
01,000,02,011,0359,0,2938,52,2990,3891,0,0,0,0,0,0,0,66.31 ,76.84 ,66.31 
01,000,02,011,0360,0,2859,36,2895,3729,0,0,0,0,0,0,0,66.31 ,77.63 ,66.31 
01,000,02,011,0361,0,3029,42,3071,3891,0,0,0,0,0,0,0,66.31 ,78.93 ,66.31 
01,000,02,011,0362,0,2004,23,2027,2559,0,0,0,0,0,0,0,66.31 ,79.21 ,66.31 
01,000,02,011,0363,0,2216,27,2243,2817,0,0,0,0,0,0,0,66.31 ,79.62 ,66.31 
01,000,02,011,0364,0,3214,44,3258,4025,0,0,0,0,0,0,0,66.31 ,80.94 ,66.31 
01,000,02,011,0365,0,3246,47,3293,4139,0,0,0,0,0,0,0,66.31 ,79.56 ,66.31 
01,000,02,011,0366,0,4003,57,4060,5177,0,0,0,0,0,0,0,66.31 ,78.42 ,66.31 
01,000,02,011,0367,0,3871,49,3920,4934,0,0,0,0,0,0,0,66.31 ,79.45 ,66.31 
01,000,02,011,0368,0,2292,28,2320,3017,0,0,0,0,0,0,0,66.31 ,76.90 ,66.31 
01,000,02,011,0369,0,3146,47,3193,4037,0,0,0,0,0,0,0,66.31 ,79.09 ,66.31 
01,000,02,011,0370,0,3724,53,3777,4756,0,0,0,0,0,0,0,66.31 ,79.42 ,66.31 
01,000,02,011,0371,0,3452,66,3518,4499,0,0,0,0,0,0,0,66.31 ,78.20 ,66.31 
01,000,02,011,0372,0,3279,52,3331,4352,0,0,0,0,0,0,0,66.31 ,76.54 ,66.31 
01,000,02,011,0373,0,3971,80,4051,4978,0,0,0,0,0,0,0,66.31 ,81.38 ,66.31 
01,000,02,011,0374,0,3516,65,3581,4481,0,0,0,0,0,0,0,66.31 ,79.92 ,66.31 
01,000,02,011,0375,0,2801,87,2888,3560,0,0,0,0,0,0,0,66.31 ,81.12 ,66.31 
01,000,02,011,0376,0,2664,47,2711,3411,0,0,0,0,0,0,0,66.31 ,79.48 ,66.31 
01,000,02,011,0377,0,2616,31,2647,3423,0,0,0,0,0,0,0,66.31 ,77.33 ,66.31 
01,000,02,011,0378,0,3747,49,3796,4935,0,0,0,0,0,0,0,66.31 ,76.92 ,66.31 
01,000,02,011,0379,0,4647,47,4694,5829,0,0,0,0,0,0,0,66.31 ,80.53 ,66.31 
01,000,02,011,0380,0,1950,27,1977,2595,0,0,0,0,0,0,0,66.31 ,76.18 ,66.31 
01,000,02,011,0381,0,1929,32,1961,2487,0,0,0,0,0,0,0,66.31 ,78.85 ,66.31 
01,000,02,011,0382,0,5277,58,5335,6788,0,0,0,0,0,0,0,66.31 ,78.59 ,66.31 
01,000,02,011,0383,0,2866,52,2918,3844,0,0,0,0,0,0,0,66.31 ,75.91 ,66.31 
01,000,02,011,0384,0,1493,31,1524,2016,0,0,0,0,0,0,0,66.31 ,75.60 ,66.31 
01,000,02,011,0385,0,4830,69,4899,6391,0,0,0,0,0,0,0,66.31 ,76.65 ,66.31 
01,000,02,011,0386,0,3858,68,3926,4829,0,0,0,0,0,0,0,66.31 ,81.30 ,66.31 
01,000,02,011,0387,0,1310,40,1350,1829,0,0,0,0,0,0,0,66.31 ,73.81 ,66.31 
01,000,02,011,0388,0,3547,85,3632,4431,0,0,0,0,0,0,0,66.31 ,81.97 ,66.31 
01,000,02,011,0389,0,4772,73,4845,5950,0,0,0,0,0,0,0,66.31 ,81.43 ,66.31 
01,000,02,011,0390,0,2666,48,2714,3309,0,0,0,0,0,0,0,66.31 ,82.02 ,66.31 
01,000,02,011,0391,0,2861,44,2905,3990,0,0,0,0,0,0,0,66.31 ,72.81 ,66.31 
01,000,02,011,0392,0,3378,54,3432,4666,0,0,0,0,0,0,0,66.31 ,73.55 ,66.31 
01,000,02,011,0393,0,3602,73,3675,4792,0,0,0,0,0,0,0,66.31 ,76.69 ,66.31 
01,000,02,011,0394,0,2810,54,2864,3778,0,0,0,0,0,0,0,66.31 ,75.81 ,66.31 
01,000,02,011,0395,0,3534,53,3587,4599,0,0,0,0,0,0,0,66.31 ,78.00 ,66.31 
01,000,02,011,0396,0,2544,43,2587,3358,0,0,0,0,0,0,0,66.31 ,77.04 ,66.31 
01,000,02,011,0397,0,3806,91,3897,5112,0,0,0,0,0,0,0,66.31 ,76.23 ,66.31 
01,000,02,011,0398,0,4570,78,4648,5941,0,0,0,0,0,0,0,66.31 ,78.24 ,66.31 
01,000,02,012,0399,0,3162,41,3203,3885,0,0,0,0,0,0,0,66.31 ,82.45 ,66.31 
01,000,02,012,0400,0,3828,69,3897,4767,0,0,0,0,0,0,0,66.31 ,81.75 ,66.31 
01,000,02,012,0401,0,2732,46,2778,3362,0,0,0,0,0,0,0,66.31 ,82.63 ,66.31 
01,000,02,012,0402,0,3857,64,3921,4783,0,0,0,0,0,0,0,66.31 ,81.98 ,66.31 
01,000,02,012,0403,0,2982,53,3035,3649,0,0,0,0,0,0,0,66.31 ,83.17 ,66.31 
01,000,02,012,0404,0,3466,43,3509,4302,0,0,0,0,0,0,0,66.31 ,81.57 ,66.31 
01,000,02,012,0405,0,2920,39,2959,3527,0,0,0,0,0,0,0,66.31 ,83.90 ,66.31 
01,000,02,012,0406,0,2891,60,2951,3528,0,0,0,0,0,0,0,66.31 ,83.65 ,66.31 
01,000,02,012,0407,0,3516,41,3557,4331,0,0,0,0,0,0,0,66.31 ,82.13 ,66.31 
01,000,02,012,0408,0,3139,66,3205,4035,0,0,0,0,0,0,0,66.31 ,79.43 ,66.31 
01,000,02,012,0409,0,2359,51,2410,2867,0,0,0,0,0,0,0,66.31 ,84.06 ,66.31 
01,000,02,012,0410,0,2966,48,3014,3758,0,0,0,0,0,0,0,66.31 ,80.20 ,66.31 
01,000,02,012,0411,0,4643,79,4722,5742,0,0,0,0,0,0,0,66.31 ,82.24 ,66.31 
01,000,02,012,0412,0,2980,57,3037,3706,0,0,0,0,0,0,0,66.31 ,81.95 ,66.31 
01,000,02,012,0413,0,3470,49,3519,4240,0,0,0,0,0,0,0,66.31 ,83.00 ,66.31 
01,000,02,012,0414,0,3666,55,3721,4598,0,0,0,0,0,0,0,66.31 ,80.93 ,66.31 
01,000,02,012,0415,0,3424,49,3473,4219,0,0,0,0,0,0,0,66.31 ,82.32 ,66.31 
01,000,02,012,0416,0,3469,48,3517,4278,0,0,0,0,0,0,0,66.31 ,82.21 ,66.31 
01,000,02,012,0417,0,3528,71,3599,4296,0,0,0,0,0,0,0,66.31 ,83.78 ,66.31 
01,000,02,012,0418,0,3580,69,3649,4462,0,0,0,0,0,0,0,66.31 ,81.78 ,66.31 
01,000,02,012,0419,0,2340,45,2385,2867,0,0,0,0,0,0,0,66.31 ,83.19 ,66.31 
01,000,02,012,0420,0,3291,53,3344,4076,0,0,0,0,0,0,0,66.31 ,82.04 ,66.31 
01,000,02,012,0421,0,3823,64,3887,4747,0,0,0,0,0,0,0,66.31 ,81.88 ,66.31 
01,000,02,012,0422,0,4160,82,4242,5237,0,0,0,0,0,0,0,66.31 ,81.00 ,66.31 
01,000,02,012,0423,0,2628,109,2737,3588,0,0,0,0,0,0,0,66.31 ,76.28 ,66.31 
01,000,02,012,0424,0,4171,87,4258,5189,0,0,0,0,0,0,0,66.31 ,82.06 ,66.31 
01,000,02,012,0425,0,4734,97,4831,5758,0,0,0,0,0,0,0,66.31 ,83.90 ,66.31 
01,000,02,012,0426,0,5196,111,5307,6482,0,0,0,0,0,0,0,66.31 ,81.87 ,66.31 
01,000,02,012,0427,0,6104,110,6214,7540,0,0,0,0,0,0,0,66.31 ,82.41 ,66.31 
01,000,02,012,0428,0,5264,83,5347,6457,0,0,0,0,0,0,0,66.31 ,82.81 ,66.31 
01,000,02,012,0429,0,6534,118,6652,8036,0,0,0,0,0,0,0,66.31 ,82.78 ,66.31 
01,000,02,012,0430,0,5749,102,5851,7049,0,0,0,0,0,0,0,66.31 ,83.00 ,66.31 
01,000,02,012,0431,0,6617,114,6731,8183,0,0,0,0,0,0,0,66.31 ,82.26 ,66.31 
01,000,02,012,0432,0,2290,50,2340,2946,0,0,0,0,0,0,0,66.31 ,79.43 ,66.31 
01,000,02,012,0433,0,4872,100,4972,6150,0,0,0,0,0,0,0,66.31 ,80.85 ,66.31 
01,000,02,012,0434,0,1626,46,1672,2026,0,0,0,0,0,0,0,66.31 ,82.53 ,66.31 
01,000,02,012,0435,0,518,12,530,621,0,0,0,0,0,0,0,66.31 ,85.35 ,66.31 
02,000,01,001,0001,0,803,20,823,1021,0,0,0,0,0,0,0,66.31 ,80.61 ,66.31 
02,000,01,001,0002,0,523,8,531,647,0,0,0,0,0,0,0,66.31 ,82.07 ,66.31 
02,000,01,001,0003,0,804,19,823,957,0,0,0,0,0,0,0,66.31 ,86.00 ,66.31 
02,000,01,001,0004,0,1049,16,1065,1334,0,0,0,0,0,0,0,66.31 ,79.84 ,66.31 
02,000,01,001,0005,0,1059,6,1065,1316,0,0,0,0,0,0,0,66.31 ,80.93 ,66.31 
02,000,01,001,0006,0,1737,32,1769,2182,0,0,0,0,0,0,0,66.31 ,81.07 ,66.31 
02,000,01,001,0007,0,665,9,674,839,0,0,0,0,0,0,0,66.31 ,80.33 ,66.31 
02,000,01,001,0008,0,583,11,594,732,0,0,0,0,0,0,0,66.31 ,81.15 ,66.31 
02,000,01,001,0009,0,890,19,909,1128,0,0,0,0,0,0,0,66.31 ,80.59 ,66.31 
02,000,01,001,0010,0,697,9,706,896,0,0,0,0,0,0,0,66.31 ,78.79 ,66.31 
02,000,01,001,0011,0,1447,20,1467,1889,0,0,0,0,0,0,0,66.31 ,77.66 ,66.31 
02,000,01,001,0012,0,838,15,853,1110,0,0,0,0,0,0,0,66.31 ,76.85 ,66.31 
02,000,01,001,0013,0,882,19,901,1166,0,0,0,0,0,0,0,66.31 ,77.27 ,66.31 
02,000,01,001,0014,0,903,21,924,1162,0,0,0,0,0,0,0,66.31 ,79.52 ,66.31 
02,000,01,001,0015,0,975,11,986,1248,0,0,0,0,0,0,0,66.31 ,79.01 ,66.31 
02,000,01,001,0016,0,570,13,583,678,0,0,0,0,0,0,0,66.31 ,85.99 ,66.31 
02,000,01,001,0017,0,1267,28,1295,1692,0,0,0,0,0,0,0,66.31 ,76.54 ,66.31 
02,000,01,001,0018,0,1069,12,1081,1338,0,0,0,0,0,0,0,66.31 ,80.79 ,66.31 
02,000,01,001,0019,0,581,11,592,730,0,0,0,0,0,0,0,66.31 ,81.10 ,66.31 
02,000,01,001,0020,0,649,17,666,853,0,0,0,0,0,0,0,66.31 ,78.08 ,66.31 
02,000,01,001,0021,0,740,10,750,941,0,0,0,0,0,0,0,66.31 ,79.70 ,66.31 
02,000,01,002,0022,0,1573,30,1603,2022,0,0,0,0,0,0,0,66.31 ,79.28 ,66.31 
02,000,01,002,0023,0,1590,31,1621,2026,0,0,0,0,0,0,0,66.31 ,80.01 ,66.31 
02,000,01,002,0024,0,3335,36,3371,4052,0,0,0,0,0,0,0,66.31 ,83.19 ,66.31 
02,000,01,002,0025,0,3279,50,3329,4023,0,0,0,0,0,0,0,66.31 ,82.75 ,66.31 
02,000,01,002,0026,0,1133,25,1158,1417,0,0,0,0,0,0,0,66.31 ,81.72 ,66.31 
02,000,01,002,0027,0,1037,22,1059,1285,0,0,0,0,0,0,0,66.31 ,82.41 ,66.31 
02,000,01,002,0028,0,1634,35,1669,2040,0,0,0,0,0,0,0,66.31 ,81.81 ,66.31 
02,000,01,002,0029,0,3712,81,3793,4730,0,0,0,0,0,0,0,66.31 ,80.19 ,66.31 
02,000,01,002,0030,0,670,11,681,857,0,0,0,0,0,0,0,66.31 ,79.46 ,66.31 
02,000,01,002,0031,0,1264,19,1283,1584,0,0,0,0,0,0,0,66.31 ,81.00 ,66.31 
02,000,01,002,0032,0,1405,30,1435,1751,0,0,0,0,0,0,0,66.31 ,81.95 ,66.31 
02,000,01,002,0033,0,2374,38,2412,2911,0,0,0,0,0,0,0,66.31 ,82.86 ,66.31 
02,000,01,002,0034,0,1711,34,1745,2036,0,0,0,0,0,0,0,66.31 ,85.71 ,66.31 
02,000,01,002,0035,0,1612,27,1639,1990,0,0,0,0,0,0,0,66.31 ,82.36 ,66.31 
02,000,01,002,0036,0,3589,75,3664,4742,0,0,0,0,0,0,0,66.31 ,77.27 ,66.31 
02,000,01,002,0037,0,942,22,964,1268,0,0,0,0,0,0,0,66.31 ,76.03 ,66.31 
02,000,01,002,0038,0,5841,87,5928,7594,0,0,0,0,0,0,0,66.31 ,78.06 ,66.31 
02,000,01,002,0039,0,2753,37,2790,3453,0,0,0,0,0,0,0,66.31 ,80.80 ,66.31 
02,000,01,002,0040,0,1729,29,1758,2201,0,0,0,0,0,0,0,66.31 ,79.87 ,66.31 
02,000,01,002,0041,0,1776,23,1799,2248,0,0,0,0,0,0,0,66.31 ,80.03 ,66.31 
02,000,01,002,0042,0,1322,32,1354,1678,0,0,0,0,0,0,0,66.31 ,80.69 ,66.31 
02,000,01,002,0043,0,891,15,906,1083,0,0,0,0,0,0,0,66.31 ,83.66 ,66.31 
02,000,01,002,0044,0,735,17,752,935,0,0,0,0,0,0,0,66.31 ,80.43 ,66.31 
02,000,01,002,0045,0,1316,21,1337,1617,0,0,0,0,0,0,0,66.31 ,82.68 ,66.31 
02,000,01,002,0046,0,1242,25,1267,1607,0,0,0,0,0,0,0,66.31 ,78.84 ,66.31 
02,000,01,002,0047,0,1411,31,1442,1782,0,0,0,0,0,0,0,66.31 ,80.92 ,66.31 
02,000,01,002,0048,0,1204,22,1226,1523,0,0,0,0,0,0,0,66.31 ,80.50 ,66.31 
02,000,01,002,0049,0,1389,32,1421,1744,0,0,0,0,0,0,0,66.31 ,81.48 ,66.31 
02,000,01,002,0050,0,640,6,646,815,0,0,0,0,0,0,0,66.31 ,79.26 ,66.31 
02,000,01,002,0051,0,908,18,926,1146,0,0,0,0,0,0,0,66.31 ,80.80 ,66.31 
02,000,01,002,0052,0,936,17,953,1211,0,0,0,0,0,0,0,66.31 ,78.70 ,66.31 
02,000,01,002,0053,0,974,21,995,1237,0,0,0,0,0,0,0,66.31 ,80.44 ,66.31 
02,000,01,002,0054,0,810,15,825,1077,0,0,0,0,0,0,0,66.31 ,76.60 ,66.31 
02,000,01,002,0055,0,1213,27,1240,1579,0,0,0,0,0,0,0,66.31 ,78.53 ,66.31 
02,000,01,002,0056,0,1112,26,1138,1436,0,0,0,0,0,0,0,66.31 ,79.25 ,66.31 
02,000,01,002,0057,0,1233,47,1280,1670,0,0,0,0,0,0,0,66.31 ,76.65 ,66.31 
02,000,01,002,0058,0,1013,16,1029,1282,0,0,0,0,0,0,0,66.31 ,80.27 ,66.31 
02,000,01,002,0059,0,623,9,632,773,0,0,0,0,0,0,0,66.31 ,81.76 ,66.31 
02,000,01,003,0060,0,1313,33,1346,1707,0,0,0,0,0,0,0,66.31 ,78.85 ,66.31 
02,000,01,003,0061,0,1043,24,1067,1283,0,0,0,0,0,0,0,66.31 ,83.16 ,66.31 
02,000,01,003,0062,0,552,6,558,661,0,0,0,0,0,0,0,66.31 ,84.42 ,66.31 
02,000,01,003,0063,0,585,9,594,700,0,0,0,0,0,0,0,66.31 ,84.86 ,66.31 
02,000,01,003,0064,0,543,10,553,652,0,0,0,0,0,0,0,66.31 ,84.82 ,66.31 
02,000,01,003,0065,0,843,14,857,984,0,0,0,0,0,0,0,66.31 ,87.09 ,66.31 
02,000,01,003,0066,0,912,28,940,1083,0,0,0,0,0,0,0,66.31 ,86.80 ,66.31 
02,000,01,003,0067,0,883,15,898,1034,0,0,0,0,0,0,0,66.31 ,86.85 ,66.31 
02,000,01,003,0068,0,1996,36,2032,2463,0,0,0,0,0,0,0,66.31 ,82.50 ,66.31 
02,000,01,003,0069,0,1340,27,1367,1670,0,0,0,0,0,0,0,66.31 ,81.86 ,66.31 
02,000,01,003,0070,0,1349,30,1379,1727,0,0,0,0,0,0,0,66.31 ,79.85 ,66.31 
02,000,01,003,0071,0,614,15,629,745,0,0,0,0,0,0,0,66.31 ,84.43 ,66.31 
02,000,01,003,0072,0,1722,47,1769,2206,0,0,0,0,0,0,0,66.31 ,80.19 ,66.31 
02,000,01,003,0073,0,1037,19,1056,1320,0,0,0,0,0,0,0,66.31 ,80.00 ,66.31 
02,000,01,003,0074,0,1348,16,1364,1685,0,0,0,0,0,0,0,66.31 ,80.95 ,66.31 
02,000,01,003,0075,0,2035,37,2072,2530,0,0,0,0,0,0,0,66.31 ,81.90 ,66.31 
02,000,01,003,0076,0,1032,11,1043,1350,0,0,0,0,0,0,0,66.31 ,77.26 ,66.31 
02,000,01,003,0077,0,1484,27,1511,1896,0,0,0,0,0,0,0,66.31 ,79.69 ,66.31 
02,000,01,003,0078,0,1142,24,1166,1497,0,0,0,0,0,0,0,66.31 ,77.89 ,66.31 
02,000,01,003,0079,0,766,11,777,973,0,0,0,0,0,0,0,66.31 ,79.86 ,66.31 
02,000,01,003,0080,0,1136,8,1144,1340,0,0,0,0,0,0,0,66.31 ,85.37 ,66.31 
02,000,01,003,0081,0,799,20,819,1014,0,0,0,0,0,0,0,66.31 ,80.77 ,66.31 
02,000,01,003,0082,0,383,6,389,464,0,0,0,0,0,0,0,66.31 ,83.84 ,66.31 
02,000,01,003,0083,0,481,3,484,558,0,0,0,0,0,0,0,66.31 ,86.74 ,66.31 
02,000,01,003,0084,0,509,6,515,648,0,0,0,0,0,0,0,66.31 ,79.48 ,66.31 
02,000,01,003,0085,0,667,14,681,810,0,0,0,0,0,0,0,66.31 ,84.07 ,66.31 
02,000,01,003,0086,0,468,5,473,555,0,0,0,0,0,0,0,66.31 ,85.23 ,66.31 
02,000,01,003,0087,0,636,13,649,774,0,0,0,0,0,0,0,66.31 ,83.85 ,66.31 
02,000,01,003,0088,0,1005,15,1020,1221,0,0,0,0,0,0,0,66.31 ,83.54 ,66.31 
02,000,01,003,0089,0,1162,25,1187,1546,0,0,0,0,0,0,0,66.31 ,76.78 ,66.31 
02,000,01,003,0090,0,1156,25,1181,1458,0,0,0,0,0,0,0,66.31 ,81.00 ,66.31 
02,000,01,003,0091,0,1107,20,1127,1365,0,0,0,0,0,0,0,66.31 ,82.56 ,66.31 
02,000,01,003,0092,0,1429,36,1465,1777,0,0,0,0,0,0,0,66.31 ,82.44 ,66.31 
02,000,01,003,0093,0,915,10,925,1166,0,0,0,0,0,0,0,66.31 ,79.33 ,66.31 
02,000,01,003,0094,0,1958,22,1980,2523,0,0,0,0,0,0,0,66.31 ,78.48 ,66.31 
02,000,01,003,0095,0,1677,20,1697,2092,0,0,0,0,0,0,0,66.31 ,81.12 ,66.31 
02,000,01,003,0096,0,1225,17,1242,1601,0,0,0,0,0,0,0,66.31 ,77.58 ,66.31 
02,000,01,003,0097,0,1436,32,1468,1849,0,0,0,0,0,0,0,66.31 ,79.39 ,66.31 
02,000,01,003,0098,0,5099,71,5170,6371,0,0,0,0,0,0,0,66.31 ,81.15 ,66.31 
02,000,01,003,0099,0,10147,179,10326,13484,0,0,0,0,0,0,0,66.31 ,76.58 ,66.31 
02,000,01,003,0100,0,3320,70,3390,4110,0,0,0,0,0,0,0,66.31 ,82.48 ,66.31 
02,000,01,003,0101,0,4494,63,4557,5716,0,0,0,0,0,0,0,66.31 ,79.72 ,66.31 
02,000,01,003,0102,0,6850,162,7012,8924,0,0,0,0,0,0,0,66.31 ,78.57 ,66.31 
02,000,01,003,0103,0,7469,138,7607,10076,0,0,0,0,0,0,0,66.31 ,75.50 ,66.31 
02,000,01,004,0104,0,5416,119,5535,6865,0,0,0,0,0,0,0,66.31 ,80.63 ,66.31 
02,000,01,004,0105,0,1740,31,1771,2157,0,0,0,0,0,0,0,66.31 ,82.10 ,66.31 
02,000,01,004,0106,0,2848,67,2915,3652,0,0,0,0,0,0,0,66.31 ,79.82 ,66.31 
02,000,01,004,0107,0,1918,26,1944,2330,0,0,0,0,0,0,0,66.31 ,83.43 ,66.31 
02,000,01,004,0108,0,2013,41,2054,2524,0,0,0,0,0,0,0,66.31 ,81.38 ,66.31 
02,000,01,004,0109,0,1734,38,1772,2201,0,0,0,0,0,0,0,66.31 ,80.51 ,66.31 
02,000,01,004,0110,0,2300,42,2342,2858,0,0,0,0,0,0,0,66.31 ,81.95 ,66.31 
02,000,01,004,0111,0,1763,33,1796,2179,0,0,0,0,0,0,0,66.31 ,82.42 ,66.31 
02,000,01,004,0112,0,2682,46,2728,3191,0,0,0,0,0,0,0,66.31 ,85.49 ,66.31 
02,000,01,004,0113,0,1834,38,1872,2132,0,0,0,0,0,0,0,66.31 ,87.80 ,66.31 
02,000,01,004,0114,0,2444,50,2494,2937,0,0,0,0,0,0,0,66.31 ,84.92 ,66.31 
02,000,01,004,0115,0,1283,27,1310,1557,0,0,0,0,0,0,0,66.31 ,84.14 ,66.31 
02,000,01,004,0116,0,2364,49,2413,2882,0,0,0,0,0,0,0,66.31 ,83.73 ,66.31 
02,000,01,004,0117,0,7504,141,7645,9748,0,0,0,0,0,0,0,66.31 ,78.43 ,66.31 
02,000,01,004,0118,0,1315,19,1334,1651,0,0,0,0,0,0,0,66.31 ,80.80 ,66.31 
02,000,01,004,0119,0,2444,34,2478,2983,0,0,0,0,0,0,0,66.31 ,83.07 ,66.31 
02,000,01,004,0120,0,1216,15,1231,1464,0,0,0,0,0,0,0,66.31 ,84.08 ,66.31 
02,000,01,004,0121,0,2328,52,2380,2850,0,0,0,0,0,0,0,66.31 ,83.51 ,66.31 
02,000,01,004,0122,0,1632,37,1669,2051,0,0,0,0,0,0,0,66.31 ,81.37 ,66.31 
02,000,01,004,0123,0,1687,33,1720,2078,0,0,0,0,0,0,0,66.31 ,82.77 ,66.31 
02,000,01,004,0124,0,1442,16,1458,1751,0,0,0,0,0,0,0,66.31 ,83.27 ,66.31 
02,000,01,004,0125,0,2190,42,2232,2674,0,0,0,0,0,0,0,66.31 ,83.47 ,66.31 
02,000,01,004,0126,0,1208,27,1235,1456,0,0,0,0,0,0,0,66.31 ,84.82 ,66.31 
02,000,01,004,0127,0,1879,32,1911,2324,0,0,0,0,0,0,0,66.31 ,82.23 ,66.31 
02,000,01,004,0128,0,1816,20,1836,2216,0,0,0,0,0,0,0,66.31 ,82.85 ,66.31 
02,000,01,004,0129,0,1482,20,1502,1794,0,0,0,0,0,0,0,66.31 ,83.72 ,66.31 
02,000,01,004,0130,0,1692,24,1716,2047,0,0,0,0,0,0,0,66.31 ,83.83 ,66.31 
02,000,01,004,0131,0,2290,45,2335,2781,0,0,0,0,0,0,0,66.31 ,83.96 ,66.31 
02,000,01,004,0132,0,2603,46,2649,3150,0,0,0,0,0,0,0,66.31 ,84.10 ,66.31 
02,000,01,004,0133,0,1451,35,1486,1793,0,0,0,0,0,0,0,66.31 ,82.88 ,66.31 
02,000,01,004,0134,0,1594,30,1624,1947,0,0,0,0,0,0,0,66.31 ,83.41 ,66.31 
02,000,01,004,0135,0,1895,40,1935,2375,0,0,0,0,0,0,0,66.31 ,81.47 ,66.31 
02,000,01,004,0136,0,3777,55,3832,4702,0,0,0,0,0,0,0,66.31 ,81.50 ,66.31 
02,000,01,004,0137,0,2129,47,2176,2724,0,0,0,0,0,0,0,66.31 ,79.88 ,66.31 
02,000,01,004,0138,0,796,12,808,910,0,0,0,0,0,0,0,66.31 ,88.79 ,66.31 
02,000,01,004,0139,0,698,3,701,830,0,0,0,0,0,0,0,66.31 ,84.46 ,66.31 
02,000,01,004,0140,0,1239,23,1262,1480,0,0,0,0,0,0,0,66.31 ,85.27 ,66.31 
02,000,01,005,0141,0,2182,51,2233,2772,0,0,0,0,0,0,0,66.31 ,80.56 ,66.31 
02,000,01,005,0142,0,2539,40,2579,3144,0,0,0,0,0,0,0,66.31 ,82.03 ,66.31 
02,000,01,005,0143,0,3667,66,3733,4582,0,0,0,0,0,0,0,66.31 ,81.47 ,66.31 
02,000,01,005,0144,0,2366,49,2415,3037,0,0,0,0,0,0,0,66.31 ,79.52 ,66.31 
02,000,01,005,0145,0,2858,55,2913,3602,0,0,0,0,0,0,0,66.31 ,80.87 ,66.31 
02,000,01,005,0146,0,2477,42,2519,2969,0,0,0,0,0,0,0,66.31 ,84.84 ,66.31 
02,000,01,005,0147,0,8429,122,8551,11100,0,0,0,0,0,0,0,66.31 ,77.04 ,66.31 
02,000,01,005,0148,0,4955,98,5053,6187,0,0,0,0,0,0,0,66.31 ,81.67 ,66.31 
02,000,01,005,0149,0,3654,67,3721,4493,0,0,0,0,0,0,0,66.31 ,82.82 ,66.31 
02,000,01,005,0150,0,1568,29,1597,1933,0,0,0,0,0,0,0,66.31 ,82.62 ,66.31 
02,000,01,005,0151,0,1195,24,1219,1492,0,0,0,0,0,0,0,66.31 ,81.70 ,66.31 
02,000,01,005,0152,0,3115,44,3159,3943,0,0,0,0,0,0,0,66.31 ,80.12 ,66.31 
02,000,01,005,0153,0,2542,49,2591,3133,0,0,0,0,0,0,0,66.31 ,82.70 ,66.31 
02,000,01,005,0154,0,2725,51,2776,3465,0,0,0,0,0,0,0,66.31 ,80.12 ,66.31 
02,000,01,005,0155,0,4301,62,4363,5451,0,0,0,0,0,0,0,66.31 ,80.04 ,66.31 
02,000,01,005,0156,0,2463,36,2499,3141,0,0,0,0,0,0,0,66.31 ,79.56 ,66.31 
02,000,01,005,0157,0,2958,49,3007,3792,0,0,0,0,0,0,0,66.31 ,79.30 ,66.31 
02,000,01,005,0158,0,1942,25,1967,2458,0,0,0,0,0,0,0,66.31 ,80.02 ,66.31 
02,000,01,005,0159,0,3894,75,3969,4894,0,0,0,0,0,0,0,66.31 ,81.10 ,66.31 
02,000,01,005,0160,0,2029,31,2060,2479,0,0,0,0,0,0,0,66.31 ,83.10 ,66.31 
02,000,01,005,0161,0,1851,29,1880,2361,0,0,0,0,0,0,0,66.31 ,79.63 ,66.31 
02,000,01,005,0162,0,3769,55,3824,4743,0,0,0,0,0,0,0,66.31 ,80.62 ,66.31 
02,000,01,005,0163,0,1699,31,1730,2136,0,0,0,0,0,0,0,66.31 ,80.99 ,66.31 
02,000,01,005,0164,0,1728,39,1767,2184,0,0,0,0,0,0,0,66.31 ,80.91 ,66.31 
02,000,01,005,0165,0,2622,44,2666,3394,0,0,0,0,0,0,0,66.31 ,78.55 ,66.31 
02,000,01,005,0166,0,2740,49,2789,3529,0,0,0,0,0,0,0,66.31 ,79.03 ,66.31 
02,000,01,005,0167,0,3441,58,3499,4395,0,0,0,0,0,0,0,66.31 ,79.61 ,66.31 
02,000,01,005,0168,0,2742,61,2803,3417,0,0,0,0,0,0,0,66.31 ,82.03 ,66.31 
02,000,01,005,0169,0,3357,83,3440,4306,0,0,0,0,0,0,0,66.31 ,79.89 ,66.31 
02,000,01,005,0170,0,4133,66,4199,5234,0,0,0,0,0,0,0,66.31 ,80.23 ,66.31 
02,000,01,005,0171,0,2130,37,2167,2787,0,0,0,0,0,0,0,66.31 ,77.75 ,66.31 
02,000,01,005,0172,0,1839,39,1878,2424,0,0,0,0,0,0,0,66.31 ,77.48 ,66.31 
02,000,01,005,0173,0,3078,66,3144,3975,0,0,0,0,0,0,0,66.31 ,79.09 ,66.31 
02,000,01,005,0174,0,1854,41,1895,2322,0,0,0,0,0,0,0,66.31 ,81.61 ,66.31 
02,000,01,005,0175,0,1547,27,1574,1942,0,0,0,0,0,0,0,66.31 ,81.05 ,66.31 
02,000,01,005,0176,0,2736,49,2785,3330,0,0,0,0,0,0,0,66.31 ,83.63 ,66.31 
02,000,01,005,0177,0,2089,30,2119,2750,0,0,0,0,0,0,0,66.31 ,77.05 ,66.31 
02,000,01,005,0178,0,5160,83,5243,6743,0,0,0,0,0,0,0,66.31 ,77.75 ,66.31 
02,000,01,005,0179,0,2368,39,2407,3028,0,0,0,0,0,0,0,66.31 ,79.49 ,66.31 
02,000,01,005,0180,0,1164,17,1181,1465,0,0,0,0,0,0,0,66.31 ,80.61 ,66.31 
02,000,01,005,0181,0,1239,15,1254,1550,0,0,0,0,0,0,0,66.31 ,80.90 ,66.31 
02,000,01,005,0182,0,2341,47,2388,3066,0,0,0,0,0,0,0,66.31 ,77.89 ,66.31 
02,000,01,005,0183,0,1741,39,1780,2207,0,0,0,0,0,0,0,66.31 ,80.65 ,66.31 
02,000,01,005,0184,0,2690,36,2726,3565,0,0,0,0,0,0,0,66.31 ,76.47 ,66.31 
02,000,01,005,0185,0,2949,63,3012,3752,0,0,0,0,0,0,0,66.31 ,80.28 ,66.31 
02,000,01,005,0186,0,2501,39,2540,3160,0,0,0,0,0,0,0,66.31 ,80.38 ,66.31 
02,000,01,005,0187,0,2067,44,2111,2612,0,0,0,0,0,0,0,66.31 ,80.82 ,66.31 
02,000,01,005,0188,0,1240,24,1264,1542,0,0,0,0,0,0,0,66.31 ,81.97 ,66.31 
02,000,01,005,0189,0,1336,26,1362,1687,0,0,0,0,0,0,0,66.31 ,80.74 ,66.31 
02,000,01,005,0190,0,1165,12,1177,1479,0,0,0,0,0,0,0,66.31 ,79.58 ,66.31 
02,000,01,005,0191,0,917,15,932,1109,0,0,0,0,0,0,0,66.31 ,84.04 ,66.31 
02,000,01,005,0192,0,2161,37,2198,2793,0,0,0,0,0,0,0,66.31 ,78.70 ,66.31 
02,000,01,005,0193,0,1797,36,1833,2311,0,0,0,0,0,0,0,66.31 ,79.32 ,66.31 
02,000,01,005,0194,0,1461,32,1493,1879,0,0,0,0,0,0,0,66.31 ,79.46 ,66.31 
02,000,01,005,0195,0,1378,26,1404,1774,0,0,0,0,0,0,0,66.31 ,79.14 ,66.31 
02,000,01,005,0196,0,707,18,725,908,0,0,0,0,0,0,0,66.31 ,79.85 ,66.31 
02,000,01,005,0197,0,949,14,963,1188,0,0,0,0,0,0,0,66.31 ,81.06 ,66.31 
02,000,01,005,0198,0,1362,17,1379,1730,0,0,0,0,0,0,0,66.31 ,79.71 ,66.31 
02,000,01,005,0199,0,1663,32,1695,2051,0,0,0,0,0,0,0,66.31 ,82.64 ,66.31 
02,000,01,005,0200,0,2550,52,2602,3162,0,0,0,0,0,0,0,66.31 ,82.29 ,66.31 
02,000,01,005,0201,0,3105,56,3161,3942,0,0,0,0,0,0,0,66.31 ,80.19 ,66.31 
02,000,01,005,0202,0,2704,44,2748,3441,0,0,0,0,0,0,0,66.31 ,79.86 ,66.31 
02,000,01,005,0203,0,1134,24,1158,1426,0,0,0,0,0,0,0,66.31 ,81.21 ,66.31 
02,000,01,005,0204,0,1397,31,1428,1751,0,0,0,0,0,0,0,66.31 ,81.55 ,66.31 
02,000,01,005,0205,0,1745,37,1782,2228,0,0,0,0,0,0,0,66.31 ,79.98 ,66.31 
02,000,01,005,0206,0,803,13,816,1011,0,0,0,0,0,0,0,66.31 ,80.71 ,66.31 
02,000,01,005,0207,0,927,23,950,1129,0,0,0,0,0,0,0,66.31 ,84.15 ,66.31 
02,000,01,005,0208,0,1005,16,1021,1310,0,0,0,0,0,0,0,66.31 ,77.94 ,66.31 
02,000,01,005,0209,0,1088,19,1107,1481,0,0,0,0,0,0,0,66.31 ,74.75 ,66.31 
02,000,01,005,0210,0,640,13,653,886,0,0,0,0,0,0,0,66.31 ,73.70 ,66.31 
02,000,01,005,0211,0,445,8,453,547,0,0,0,0,0,0,0,66.31 ,82.82 ,66.31 
02,000,01,005,0212,0,862,20,882,1167,0,0,0,0,0,0,0,66.31 ,75.58 ,66.31 
02,000,01,005,0213,0,2989,54,3043,3886,0,0,0,0,0,0,0,66.31 ,78.31 ,66.31 
02,000,01,005,0214,0,944,20,964,1230,0,0,0,0,0,0,0,66.31 ,78.37 ,66.31 
02,000,01,005,0215,0,598,11,609,864,0,0,0,0,0,0,0,66.31 ,70.49 ,66.31 
02,000,01,005,0216,0,992,12,1004,1299,0,0,0,0,0,0,0,66.31 ,77.29 ,66.31 
02,000,01,005,0217,0,964,21,985,1207,0,0,0,0,0,0,0,66.31 ,81.61 ,66.31 
02,000,01,005,0218,0,1693,30,1723,2117,0,0,0,0,0,0,0,66.31 ,81.39 ,66.31 
02,000,01,005,0219,0,1031,29,1060,1282,0,0,0,0,0,0,0,66.31 ,82.68 ,66.31 
02,000,01,005,0220,0,342,8,350,451,0,0,0,0,0,0,0,66.31 ,77.61 ,66.31 
02,000,01,005,0221,0,2217,46,2263,2755,0,0,0,0,0,0,0,66.31 ,82.14 ,66.31 
02,000,01,005,0222,0,1494,36,1530,1926,0,0,0,0,0,0,0,66.31 ,79.44 ,66.31 
02,000,01,005,0223,0,713,21,734,863,0,0,0,0,0,0,0,66.31 ,85.05 ,66.31 
02,000,01,005,0224,0,998,15,1013,1185,0,0,0,0,0,0,0,66.31 ,85.49 ,66.31 
02,000,01,005,0225,0,926,26,952,1171,0,0,0,0,0,0,0,66.31 ,81.30 ,66.31 
02,000,01,005,0226,0,1017,23,1040,1328,0,0,0,0,0,0,0,66.31 ,78.31 ,66.31 
02,000,01,005,0227,0,1099,24,1123,1419,0,0,0,0,0,0,0,66.31 ,79.14 ,66.31 
02,000,01,005,0228,0,1872,41,1913,2377,0,0,0,0,0,0,0,66.31 ,80.48 ,66.31 
02,000,01,006,0229,0,1092,28,1120,1357,0,0,0,0,0,0,0,66.31 ,82.54 ,66.31 
02,000,01,006,0230,0,844,26,870,1128,0,0,0,0,0,0,0,66.31 ,77.13 ,66.31 
02,000,01,006,0231,0,1348,25,1373,1779,0,0,0,0,0,0,0,66.31 ,77.18 ,66.31 
02,000,01,006,0232,0,1570,73,1643,2040,0,0,0,0,0,0,0,66.31 ,80.54 ,66.31 
02,000,01,006,0233,0,2019,47,2066,2537,0,0,0,0,0,0,0,66.31 ,81.43 ,66.31 
02,000,01,006,0234,0,1022,19,1041,1260,0,0,0,0,0,0,0,66.31 ,82.62 ,66.31 
02,000,01,006,0235,0,969,29,998,1328,0,0,0,0,0,0,0,66.31 ,75.15 ,66.31 
02,000,01,006,0236,0,1830,50,1880,2359,0,0,0,0,0,0,0,66.31 ,79.69 ,66.31 
02,000,01,006,0237,0,1344,30,1374,1692,0,0,0,0,0,0,0,66.31 ,81.21 ,66.31 
02,000,01,006,0238,0,1927,56,1983,2421,0,0,0,0,0,0,0,66.31 ,81.91 ,66.31 
02,000,01,006,0239,0,1352,34,1386,1651,0,0,0,0,0,0,0,66.31 ,83.95 ,66.31 
02,000,01,006,0240,0,926,16,942,1183,0,0,0,0,0,0,0,66.31 ,79.63 ,66.31 
02,000,01,006,0241,0,1632,44,1676,1940,0,0,0,0,0,0,0,66.31 ,86.39 ,66.31 
02,000,02,007,0242,0,1578,33,1611,2087,0,0,0,0,0,0,0,66.31 ,77.19 ,66.31 
02,000,02,007,0243,0,907,13,920,1224,0,0,0,0,0,0,0,66.31 ,75.16 ,66.31 
02,000,02,007,0244,0,1569,17,1586,2092,0,0,0,0,0,0,0,66.31 ,75.81 ,66.31 
02,000,02,007,0245,0,989,16,1005,1301,0,0,0,0,0,0,0,66.31 ,77.25 ,66.31 
02,000,02,007,0246,0,1222,26,1248,1583,0,0,0,0,0,0,0,66.31 ,78.84 ,66.31 
02,000,02,007,0247,0,589,12,601,772,0,0,0,0,0,0,0,66.31 ,77.85 ,66.31 
02,000,02,007,0248,0,583,6,589,766,0,0,0,0,0,0,0,66.31 ,76.89 ,66.31 
02,000,02,007,0249,0,1361,27,1388,1855,0,0,0,0,0,0,0,66.31 ,74.82 ,66.31 
02,000,02,007,0250,0,784,12,796,1036,0,0,0,0,0,0,0,66.31 ,76.83 ,66.31 
02,000,02,007,0251,0,605,9,614,756,0,0,0,0,0,0,0,66.31 ,81.22 ,66.31 
02,000,02,007,0252,0,1126,16,1142,1458,0,0,0,0,0,0,0,66.31 ,78.33 ,66.31 
02,000,02,007,0253,0,838,13,851,1049,0,0,0,0,0,0,0,66.31 ,81.12 ,66.31 
02,000,02,007,0254,0,1683,32,1715,2185,0,0,0,0,0,0,0,66.31 ,78.49 ,66.31 
02,000,02,007,0255,0,1643,18,1661,2148,0,0,0,0,0,0,0,66.31 ,77.33 ,66.31 
02,000,02,007,0256,0,1945,20,1965,2507,0,0,0,0,0,0,0,66.31 ,78.38 ,66.31 
02,000,02,007,0257,0,701,8,709,883,0,0,0,0,0,0,0,66.31 ,80.29 ,66.31 
02,000,02,007,0258,0,732,5,737,914,0,0,0,0,0,0,0,66.31 ,80.63 ,66.31 
02,000,02,007,0259,0,2044,30,2074,2561,0,0,0,0,0,0,0,66.31 ,80.98 ,66.31 
02,000,02,007,0260,0,920,14,934,1210,0,0,0,0,0,0,0,66.31 ,77.19 ,66.31 
02,000,02,007,0261,0,895,11,906,1214,0,0,0,0,0,0,0,66.31 ,74.63 ,66.31 
02,000,02,007,0262,0,682,16,698,910,0,0,0,0,0,0,0,66.31 ,76.70 ,66.31 
02,000,02,007,0263,0,747,15,762,951,0,0,0,0,0,0,0,66.31 ,80.13 ,66.31 
02,000,02,007,0264,0,1803,23,1826,2303,0,0,0,0,0,0,0,66.31 ,79.29 ,66.31 
02,000,02,007,0265,0,1726,24,1750,2412,0,0,0,0,0,0,0,66.31 ,72.55 ,66.31 
02,000,02,007,0266,0,690,20,710,893,0,0,0,0,0,0,0,66.31 ,79.51 ,66.31 
02,000,02,007,0267,0,937,12,949,1197,0,0,0,0,0,0,0,66.31 ,79.28 ,66.31 
02,000,02,007,0268,0,933,16,949,1187,0,0,0,0,0,0,0,66.31 ,79.95 ,66.31 
02,000,02,007,0269,0,655,8,663,840,0,0,0,0,0,0,0,66.31 ,78.93 ,66.31 
02,000,02,007,0270,0,689,16,705,873,0,0,0,0,0,0,0,66.31 ,80.76 ,66.31 
02,000,02,007,0271,0,777,9,786,1015,0,0,0,0,0,0,0,66.31 ,77.44 ,66.31 
02,000,02,007,0272,0,762,16,778,935,0,0,0,0,0,0,0,66.31 ,83.21 ,66.31 
02,000,02,007,0273,0,662,14,676,819,0,0,0,0,0,0,0,66.31 ,82.54 ,66.31 
02,000,02,007,0274,0,1130,15,1145,1407,0,0,0,0,0,0,0,66.31 ,81.38 ,66.31 
02,000,02,008,0275,0,657,17,674,854,0,0,0,0,0,0,0,66.31 ,78.92 ,66.31 
02,000,02,008,0276,0,926,15,941,1204,0,0,0,0,0,0,0,66.31 ,78.16 ,66.31 
02,000,02,008,0277,0,1170,15,1185,1492,0,0,0,0,0,0,0,66.31 ,79.42 ,66.31 
02,000,02,008,0278,0,666,14,680,858,0,0,0,0,0,0,0,66.31 ,79.25 ,66.31 
02,000,02,008,0279,0,688,18,706,949,0,0,0,0,0,0,0,66.31 ,74.39 ,66.31 
02,000,02,008,0280,0,2341,45,2386,3098,0,0,0,0,0,0,0,66.31 ,77.02 ,66.31 
02,000,02,008,0281,0,822,15,837,1047,0,0,0,0,0,0,0,66.31 ,79.94 ,66.31 
02,000,02,008,0282,0,832,8,840,1120,0,0,0,0,0,0,0,66.31 ,75.00 ,66.31 
02,000,02,008,0283,0,988,19,1007,1313,0,0,0,0,0,0,0,66.31 ,76.69 ,66.31 
02,000,02,008,0284,0,558,12,570,742,0,0,0,0,0,0,0,66.31 ,76.82 ,66.31 
02,000,02,008,0285,0,753,10,763,1014,0,0,0,0,0,0,0,66.31 ,75.25 ,66.31 
02,000,02,008,0286,0,1014,26,1040,1292,0,0,0,0,0,0,0,66.31 ,80.50 ,66.31 
02,000,02,008,0287,0,941,10,951,1189,0,0,0,0,0,0,0,66.31 ,79.98 ,66.31 
02,000,02,008,0288,0,1434,21,1455,1789,0,0,0,0,0,0,0,66.31 ,81.33 ,66.31 
02,000,02,008,0289,0,824,26,850,1060,0,0,0,0,0,0,0,66.31 ,80.19 ,66.31 
02,000,02,008,0290,0,781,8,789,1018,0,0,0,0,0,0,0,66.31 ,77.50 ,66.31 
02,000,02,008,0291,0,1207,18,1225,1633,0,0,0,0,0,0,0,66.31 ,75.02 ,66.31 
02,000,02,008,0292,0,1069,16,1085,1363,0,0,0,0,0,0,0,66.31 ,79.60 ,66.31 
02,000,02,008,0293,0,884,11,895,1158,0,0,0,0,0,0,0,66.31 ,77.29 ,66.31 
02,000,02,008,0294,0,1163,17,1180,1475,0,0,0,0,0,0,0,66.31 ,80.00 ,66.31 
02,000,02,009,0295,0,598,11,609,754,0,0,0,0,0,0,0,66.31 ,80.77 ,66.31 
02,000,02,009,0296,0,1029,18,1047,1353,0,0,0,0,0,0,0,66.31 ,77.38 ,66.31 
02,000,02,009,0297,0,1123,37,1160,1439,0,0,0,0,0,0,0,66.31 ,80.61 ,66.31 
02,000,02,009,0298,0,1237,26,1263,1556,0,0,0,0,0,0,0,66.31 ,81.17 ,66.31 
02,000,02,009,0299,0,1048,20,1068,1372,0,0,0,0,0,0,0,66.31 ,77.84 ,66.31 
02,000,02,009,0300,0,1162,28,1190,1504,0,0,0,0,0,0,0,66.31 ,79.12 ,66.31 
02,000,02,009,0301,0,1190,24,1214,1533,0,0,0,0,0,0,0,66.31 ,79.19 ,66.31 
02,000,02,009,0302,0,566,10,576,692,0,0,0,0,0,0,0,66.31 ,83.24 ,66.31 
02,000,02,009,0303,0,1376,19,1395,1750,0,0,0,0,0,0,0,66.31 ,79.71 ,66.31 
02,000,02,009,0304,0,1364,31,1395,1856,0,0,0,0,0,0,0,66.31 ,75.16 ,66.31 
02,000,02,009,0305,0,1074,14,1088,1294,0,0,0,0,0,0,0,66.31 ,84.08 ,66.31 
02,000,02,009,0306,0,1189,17,1206,1481,0,0,0,0,0,0,0,66.31 ,81.43 ,66.31 
02,000,02,009,0307,0,1415,25,1440,1827,0,0,0,0,0,0,0,66.31 ,78.82 ,66.31 
02,000,02,009,0308,0,1262,34,1296,1688,0,0,0,0,0,0,0,66.31 ,76.78 ,66.31 
02,000,02,009,0309,0,1527,33,1560,1933,0,0,0,0,0,0,0,66.31 ,80.70 ,66.31 
02,000,02,009,0310,0,968,17,985,1238,0,0,0,0,0,0,0,66.31 ,79.56 ,66.31 
02,000,02,009,0311,0,2274,40,2314,3048,0,0,0,0,0,0,0,66.31 ,75.92 ,66.31 
02,000,02,009,0312,0,1883,37,1920,2428,0,0,0,0,0,0,0,66.31 ,79.08 ,66.31 
02,000,02,009,0313,0,1984,29,2013,2560,0,0,0,0,0,0,0,66.31 ,78.63 ,66.31 
02,000,02,009,0314,0,1697,28,1725,2162,0,0,0,0,0,0,0,66.31 ,79.79 ,66.31 
02,000,02,009,0315,0,733,14,747,926,0,0,0,0,0,0,0,66.31 ,80.67 ,66.31 
02,000,02,009,0316,0,2097,36,2133,2726,0,0,0,0,0,0,0,66.31 ,78.25 ,66.31 
02,000,02,009,0317,0,1219,17,1236,1534,0,0,0,0,0,0,0,66.31 ,80.57 ,66.31 
02,000,02,009,0318,0,1511,29,1540,1981,0,0,0,0,0,0,0,66.31 ,77.74 ,66.31 
02,000,02,009,0319,0,1194,17,1211,1522,0,0,0,0,0,0,0,66.31 ,79.57 ,66.31 
02,000,02,009,0320,0,618,13,631,782,0,0,0,0,0,0,0,66.31 ,80.69 ,66.31 
02,000,02,009,0321,0,1172,26,1198,1484,0,0,0,0,0,0,0,66.31 ,80.73 ,66.31 
02,000,02,009,0322,0,2374,51,2425,3010,0,0,0,0,0,0,0,66.31 ,80.56 ,66.31 
02,000,02,009,0323,0,1482,43,1525,1930,0,0,0,0,0,0,0,66.31 ,79.02 ,66.31 
02,000,02,009,0324,0,2518,53,2571,3177,0,0,0,0,0,0,0,66.31 ,80.93 ,66.31 
02,000,02,009,0325,0,1320,10,1330,1676,0,0,0,0,0,0,0,66.31 ,79.36 ,66.31 
02,000,02,009,0326,0,2040,28,2068,2724,0,0,0,0,0,0,0,66.31 ,75.92 ,66.31 
02,000,02,009,0327,0,1788,23,1811,2377,0,0,0,0,0,0,0,66.31 ,76.19 ,66.31 
02,000,02,009,0328,0,1028,23,1051,1399,0,0,0,0,0,0,0,66.31 ,75.13 ,66.31 
02,000,02,009,0329,0,1174,22,1196,1528,0,0,0,0,0,0,0,66.31 ,78.27 ,66.31 
02,000,02,009,0330,0,1523,23,1546,1948,0,0,0,0,0,0,0,66.31 ,79.36 ,66.31 
02,000,02,009,0331,0,1697,39,1736,2275,0,0,0,0,0,0,0,66.31 ,76.31 ,66.31 
02,000,02,009,0332,0,1236,21,1257,1550,0,0,0,0,0,0,0,66.31 ,81.10 ,66.31 
02,000,02,009,0333,0,1306,18,1324,1624,0,0,0,0,0,0,0,66.31 ,81.53 ,66.31 
02,000,02,009,0334,0,1852,41,1893,2269,0,0,0,0,0,0,0,66.31 ,83.43 ,66.31 
02,000,02,009,0335,0,1455,23,1478,1887,0,0,0,0,0,0,0,66.31 ,78.33 ,66.31 
02,000,02,009,0336,0,2641,43,2684,3514,0,0,0,0,0,0,0,66.31 ,76.38 ,66.31 
02,000,02,009,0337,0,1414,27,1441,1820,0,0,0,0,0,0,0,66.31 ,79.18 ,66.31 
02,000,02,009,0338,0,1080,19,1099,1335,0,0,0,0,0,0,0,66.31 ,82.32 ,66.31 
02,000,02,009,0339,0,2945,62,3007,3773,0,0,0,0,0,0,0,66.31 ,79.70 ,66.31 
02,000,02,009,0340,0,1560,29,1589,1980,0,0,0,0,0,0,0,66.31 ,80.25 ,66.31 
02,000,02,009,0341,0,1316,21,1337,1625,0,0,0,0,0,0,0,66.31 ,82.28 ,66.31 
02,000,02,009,0342,0,1191,22,1213,1537,0,0,0,0,0,0,0,66.31 ,78.92 ,66.31 
02,000,02,009,0343,0,2183,26,2209,2715,0,0,0,0,0,0,0,66.31 ,81.36 ,66.31 
02,000,02,009,0344,0,1088,11,1099,1367,0,0,0,0,0,0,0,66.31 ,80.40 ,66.31 
02,000,02,009,0345,0,806,26,832,1049,0,0,0,0,0,0,0,66.31 ,79.31 ,66.31 
02,000,02,009,0346,0,1637,20,1657,2039,0,0,0,0,0,0,0,66.31 ,81.27 ,66.31 
02,000,02,009,0347,0,1896,45,1941,2352,0,0,0,0,0,0,0,66.31 ,82.53 ,66.31 
02,000,02,009,0348,0,2321,48,2369,2881,0,0,0,0,0,0,0,66.31 ,82.23 ,66.31 
02,000,02,009,0349,0,2326,38,2364,2849,0,0,0,0,0,0,0,66.31 ,82.98 ,66.31 
02,000,02,009,0350,0,1764,39,1803,2288,0,0,0,0,0,0,0,66.31 ,78.80 ,66.31 
02,000,02,009,0351,0,1869,28,1897,2354,0,0,0,0,0,0,0,66.31 ,80.59 ,66.31 
02,000,02,009,0352,0,1776,33,1809,2239,0,0,0,0,0,0,0,66.31 ,80.79 ,66.31 
02,000,02,009,0353,0,1287,24,1311,1604,0,0,0,0,0,0,0,66.31 ,81.73 ,66.31 
02,000,02,009,0354,0,1761,29,1790,2270,0,0,0,0,0,0,0,66.31 ,78.85 ,66.31 
02,000,02,009,0355,0,3042,50,3092,3942,0,0,0,0,0,0,0,66.31 ,78.44 ,66.31 
02,000,02,009,0356,0,2899,64,2963,3778,0,0,0,0,0,0,0,66.31 ,78.43 ,66.31 
02,000,02,009,0357,0,2570,54,2624,3295,0,0,0,0,0,0,0,66.31 ,79.64 ,66.31 
02,000,02,009,0358,0,2773,48,2821,3517,0,0,0,0,0,0,0,66.31 ,80.21 ,66.31 
02,000,02,009,0359,0,1688,29,1717,2080,0,0,0,0,0,0,0,66.31 ,82.55 ,66.31 
02,000,02,009,0360,0,1791,44,1835,2278,0,0,0,0,0,0,0,66.31 ,80.55 ,66.31 
02,000,02,009,0361,0,3041,56,3097,3659,0,0,0,0,0,0,0,66.31 ,84.64 ,66.31 
02,000,02,009,0362,0,1562,34,1596,1935,0,0,0,0,0,0,0,66.31 ,82.48 ,66.31 
02,000,02,009,0363,0,1621,38,1659,2081,0,0,0,0,0,0,0,66.31 ,79.72 ,66.31 
02,000,02,010,0364,0,5833,140,5973,7378,0,0,0,0,0,0,0,66.31 ,80.96 ,66.31 
02,000,02,010,0365,0,1947,46,1993,2498,0,0,0,0,0,0,0,66.31 ,79.78 ,66.31 
02,000,02,010,0366,0,2571,51,2622,3220,0,0,0,0,0,0,0,66.31 ,81.43 ,66.31 
02,000,02,010,0367,0,1476,30,1506,1774,0,0,0,0,0,0,0,66.31 ,84.89 ,66.31 
02,000,02,010,0368,0,1228,40,1268,1551,0,0,0,0,0,0,0,66.31 ,81.75 ,66.31 
02,000,02,010,0369,0,1507,40,1547,1976,0,0,0,0,0,0,0,66.31 ,78.29 ,66.31 
02,000,02,010,0370,0,1294,43,1337,1707,0,0,0,0,0,0,0,66.31 ,78.32 ,66.31 
02,000,02,010,0371,0,668,10,678,825,0,0,0,0,0,0,0,66.31 ,82.18 ,66.31 
02,000,02,010,0372,0,1452,32,1484,1804,0,0,0,0,0,0,0,66.31 ,82.26 ,66.31 
02,000,02,010,0373,0,1348,25,1373,1664,0,0,0,0,0,0,0,66.31 ,82.51 ,66.31 
02,000,02,010,0374,0,2045,56,2101,2618,0,0,0,0,0,0,0,66.31 ,80.25 ,66.31 
02,000,02,010,0375,0,1075,18,1093,1339,0,0,0,0,0,0,0,66.31 ,81.63 ,66.31 
02,000,02,010,0376,0,574,13,587,730,0,0,0,0,0,0,0,66.31 ,80.41 ,66.31 
02,000,02,010,0377,0,806,23,829,1008,0,0,0,0,0,0,0,66.31 ,82.24 ,66.31 
02,000,02,010,0378,0,1356,24,1380,1601,0,0,0,0,0,0,0,66.31 ,86.20 ,66.31 
02,000,02,010,0379,0,1619,36,1655,1942,0,0,0,0,0,0,0,66.31 ,85.22 ,66.31 
02,000,02,010,0380,0,1972,67,2039,2499,0,0,0,0,0,0,0,66.31 ,81.59 ,66.31 
02,000,02,010,0381,0,1586,35,1621,1957,0,0,0,0,0,0,0,66.31 ,82.83 ,66.31 
02,000,02,010,0382,0,2753,84,2837,3507,0,0,0,0,0,0,0,66.31 ,80.90 ,66.31 
02,000,02,010,0383,0,997,20,1017,1172,0,0,0,0,0,0,0,66.31 ,86.77 ,66.31 
02,000,02,010,0384,0,943,26,969,1195,0,0,0,0,0,0,0,66.31 ,81.09 ,66.31 
02,000,02,010,0385,0,757,24,781,930,0,0,0,0,0,0,0,66.31 ,83.98 ,66.31 
02,000,02,010,0386,0,905,15,920,1117,0,0,0,0,0,0,0,66.31 ,82.36 ,66.31 
02,000,02,010,0387,0,2129,48,2177,2636,0,0,0,0,0,0,0,66.31 ,82.59 ,66.31 
02,000,02,010,0388,0,1629,45,1674,2019,0,0,0,0,0,0,0,66.31 ,82.91 ,66.31 
02,000,02,010,0389,0,2287,47,2334,2930,0,0,0,0,0,0,0,66.31 ,79.66 ,66.31 
02,000,02,010,0390,0,2252,37,2289,2773,0,0,0,0,0,0,0,66.31 ,82.55 ,66.31 
02,000,02,010,0391,0,751,19,770,972,0,0,0,0,0,0,0,66.31 ,79.22 ,66.31 
02,000,02,010,0392,0,1334,36,1370,1630,0,0,0,0,0,0,0,66.31 ,84.05 ,66.31 
02,000,02,010,0393,0,1770,26,1796,2329,0,0,0,0,0,0,0,66.31 ,77.11 ,66.31 
02,000,02,010,0394,0,1632,37,1669,2031,0,0,0,0,0,0,0,66.31 ,82.18 ,66.31 
02,000,02,010,0395,0,1610,32,1642,2264,0,0,0,0,0,0,0,66.31 ,72.53 ,66.31 
02,000,02,010,0396,0,2174,43,2217,2922,0,0,0,0,0,0,0,66.31 ,75.87 ,66.31 
02,000,02,010,0397,0,2280,59,2339,3104,0,0,0,0,0,0,0,66.31 ,75.35 ,66.31 
02,000,02,010,0398,0,2807,70,2877,3563,0,0,0,0,0,0,0,66.31 ,80.75 ,66.31 
02,000,02,010,0399,0,1920,35,1955,2439,0,0,0,0,0,0,0,66.31 ,80.16 ,66.31 
02,000,02,010,0400,0,2202,38,2240,2750,0,0,0,0,0,0,0,66.31 ,81.45 ,66.31 
02,000,02,010,0401,0,1962,49,2011,2549,0,0,0,0,0,0,0,66.31 ,78.89 ,66.31 
02,000,02,010,0402,0,1473,38,1511,1978,0,0,0,0,0,0,0,66.31 ,76.39 ,66.31 
02,000,02,010,0403,0,1795,95,1890,2374,0,0,0,0,0,0,0,66.31 ,79.61 ,66.31 
02,000,02,010,0404,0,1457,29,1486,1911,0,0,0,0,0,0,0,66.31 ,77.76 ,66.31 
02,000,02,010,0405,0,2426,35,2461,2995,0,0,0,0,0,0,0,66.31 ,82.17 ,66.31 
02,000,02,010,0406,0,2072,40,2112,2652,0,0,0,0,0,0,0,66.31 ,79.64 ,66.31 
02,000,02,010,0407,0,1054,26,1080,1333,0,0,0,0,0,0,0,66.31 ,81.02 ,66.31 
02,000,02,010,0408,0,3539,70,3609,4347,0,0,0,0,0,0,0,66.31 ,83.02 ,66.31 
02,000,02,010,0409,0,1786,43,1829,2210,0,0,0,0,0,0,0,66.31 ,82.76 ,66.31 
02,000,02,010,0410,0,3393,58,3451,4189,0,0,0,0,0,0,0,66.31 ,82.38 ,66.31 
02,000,02,010,0411,0,1902,30,1932,2408,0,0,0,0,0,0,0,66.31 ,80.23 ,66.31 
02,000,02,010,0412,0,1552,49,1601,1966,0,0,0,0,0,0,0,66.31 ,81.43 ,66.31 
02,000,02,010,0413,0,2414,53,2467,2957,0,0,0,0,0,0,0,66.31 ,83.43 ,66.31 
02,000,02,010,0414,0,2274,53,2327,2940,0,0,0,0,0,0,0,66.31 ,79.15 ,66.31 
02,000,02,010,0415,0,2232,40,2272,2722,0,0,0,0,0,0,0,66.31 ,83.47 ,66.31 
02,000,02,010,0416,0,2272,43,2315,2697,0,0,0,0,0,0,0,66.31 ,85.84 ,66.31 
02,000,02,010,0417,0,2058,45,2103,2605,0,0,0,0,0,0,0,66.31 ,80.73 ,66.31 
02,000,02,010,0418,0,2051,36,2087,2577,0,0,0,0,0,0,0,66.31 ,80.99 ,66.31 
02,000,02,010,0419,0,1711,39,1750,2148,0,0,0,0,0,0,0,66.31 ,81.47 ,66.31 
02,000,02,010,0420,0,1720,36,1756,2158,0,0,0,0,0,0,0,66.31 ,81.37 ,66.31 
02,000,02,010,0421,0,2644,53,2697,3388,0,0,0,0,0,0,0,66.31 ,79.60 ,66.31 
02,000,02,010,0422,0,1856,55,1911,2443,0,0,0,0,0,0,0,66.31 ,78.22 ,66.31 
02,000,02,011,0423,0,1402,39,1441,1742,0,0,0,0,0,0,0,66.31 ,82.72 ,66.31 
02,000,02,011,0424,0,2133,29,2162,2709,0,0,0,0,0,0,0,66.31 ,79.81 ,66.31 
02,000,02,011,0425,0,1507,23,1530,1865,0,0,0,0,0,0,0,66.31 ,82.04 ,66.31 
02,000,02,011,0426,0,1094,25,1119,1321,0,0,0,0,0,0,0,66.31 ,84.71 ,66.31 
02,000,02,011,0427,0,2085,52,2137,2523,0,0,0,0,0,0,0,66.31 ,84.70 ,66.31 
02,000,02,011,0428,0,1337,23,1360,1613,0,0,0,0,0,0,0,66.31 ,84.31 ,66.31 
02,000,02,011,0429,0,1031,15,1046,1295,0,0,0,0,0,0,0,66.31 ,80.77 ,66.31 
02,000,02,011,0430,0,1398,21,1419,1685,0,0,0,0,0,0,0,66.31 ,84.21 ,66.31 
02,000,02,011,0431,0,1222,24,1246,1542,0,0,0,0,0,0,0,66.31 ,80.80 ,66.31 
02,000,02,011,0432,0,3049,50,3099,3770,0,0,0,0,0,0,0,66.31 ,82.20 ,66.31 
02,000,02,011,0433,0,1549,20,1569,1904,0,0,0,0,0,0,0,66.31 ,82.41 ,66.31 
02,000,02,011,0434,0,2074,36,2110,2562,0,0,0,0,0,0,0,66.31 ,82.36 ,66.31 
02,000,02,011,0435,0,1803,32,1835,2185,0,0,0,0,0,0,0,66.31 ,83.98 ,66.31 
02,000,02,011,0436,0,2299,45,2344,2939,0,0,0,0,0,0,0,66.31 ,79.76 ,66.31 
02,000,02,011,0437,0,2226,41,2267,2816,0,0,0,0,0,0,0,66.31 ,80.50 ,66.31 
02,000,02,011,0438,0,888,19,907,1093,0,0,0,0,0,0,0,66.31 ,82.98 ,66.31 
02,000,02,011,0439,0,1496,32,1528,1856,0,0,0,0,0,0,0,66.31 ,82.33 ,66.31 
02,000,02,011,0440,0,1754,42,1796,2257,0,0,0,0,0,0,0,66.31 ,79.57 ,66.31 
02,000,02,011,0441,0,1378,35,1413,1700,0,0,0,0,0,0,0,66.31 ,83.12 ,66.31 
02,000,02,011,0442,0,1878,43,1921,2352,0,0,0,0,0,0,0,66.31 ,81.68 ,66.31 
02,000,02,011,0443,0,1421,26,1447,1712,0,0,0,0,0,0,0,66.31 ,84.52 ,66.31 
02,000,02,011,0444,0,2558,57,2615,3173,0,0,0,0,0,0,0,66.31 ,82.41 ,66.31 
02,000,02,011,0445,0,2427,45,2472,2922,0,0,0,0,0,0,0,66.31 ,84.60 ,66.31 
02,000,02,011,0446,0,1241,35,1276,1610,0,0,0,0,0,0,0,66.31 ,79.25 ,66.31 
02,000,02,011,0447,0,1050,17,1067,1272,0,0,0,0,0,0,0,66.31 ,83.88 ,66.31 
02,000,02,011,0448,0,800,13,813,950,0,0,0,0,0,0,0,66.31 ,85.58 ,66.31 
02,000,02,011,0449,0,818,13,831,958,0,0,0,0,0,0,0,66.31 ,86.74 ,66.31 
02,000,02,011,0450,0,2332,63,2395,2989,0,0,0,0,0,0,0,66.31 ,80.13 ,66.31 
02,000,02,011,0451,0,1240,23,1263,1489,0,0,0,0,0,0,0,66.31 ,84.82 ,66.31 
02,000,02,011,0452,0,1543,31,1574,1901,0,0,0,0,0,0,0,66.31 ,82.80 ,66.31 
02,000,02,011,0453,0,3731,94,3825,4748,0,0,0,0,0,0,0,66.31 ,80.56 ,66.31 
02,000,02,011,0454,0,1890,30,1920,2295,0,0,0,0,0,0,0,66.31 ,83.66 ,66.31 
02,000,02,011,0455,0,1754,28,1782,2048,0,0,0,0,0,0,0,66.31 ,87.01 ,66.31 
02,000,02,011,0456,0,1643,27,1670,1938,0,0,0,0,0,0,0,66.31 ,86.17 ,66.31 
02,000,02,011,0457,0,1229,15,1244,1470,0,0,0,0,0,0,0,66.31 ,84.63 ,66.31 
02,000,02,011,0458,0,1672,29,1701,2098,0,0,0,0,0,0,0,66.31 ,81.08 ,66.31 
02,000,02,011,0459,0,1231,19,1250,1473,0,0,0,0,0,0,0,66.31 ,84.86 ,66.31 
02,000,02,011,0460,0,1866,33,1899,2281,0,0,0,0,0,0,0,66.31 ,83.25 ,66.31 
02,000,02,011,0461,0,3471,84,3555,4304,0,0,0,0,0,0,0,66.31 ,82.60 ,66.31 
02,000,02,011,0462,0,1786,34,1820,2255,0,0,0,0,0,0,0,66.31 ,80.71 ,66.31 
02,000,02,011,0463,0,1927,36,1963,2396,0,0,0,0,0,0,0,66.31 ,81.93 ,66.31 
02,000,02,011,0464,0,2091,52,2143,2729,0,0,0,0,0,0,0,66.31 ,78.53 ,66.31 
02,000,02,011,0465,0,2089,57,2146,2735,0,0,0,0,0,0,0,66.31 ,78.46 ,66.31 
03,001,01,001,0001,0,681,9,690,1166,0,0,0,0,0,0,0,66.31 ,59.18 ,66.31 
03,001,01,001,0002,0,763,12,775,1234,0,0,0,0,0,0,0,66.31 ,62.80 ,66.31 
03,001,01,001,0003,0,417,12,429,642,0,0,0,0,0,0,0,66.31 ,66.82 ,66.31 
03,001,01,001,0004,0,701,8,709,1066,0,0,0,0,0,0,0,66.31 ,66.51 ,66.31 
03,001,01,001,0005,0,931,13,944,1499,0,0,0,0,0,0,0,66.31 ,62.98 ,66.31 
03,001,01,001,0006,0,2356,45,2401,3743,0,0,0,0,0,0,0,66.31 ,64.15 ,66.31 
03,001,01,001,0007,0,1554,24,1578,2398,0,0,0,0,0,0,0,66.31 ,65.80 ,66.31 
03,001,01,001,0008,0,2748,42,2790,4493,0,0,0,0,0,0,0,66.31 ,62.10 ,66.31 
03,001,01,001,0009,0,2064,29,2093,3204,0,0,0,0,0,0,0,66.31 ,65.32 ,66.31 
03,001,01,001,0010,0,1271,9,1280,2025,0,0,0,0,0,0,0,66.31 ,63.21 ,66.31 
03,001,01,001,0011,0,1982,26,2008,3441,0,0,0,0,0,0,0,66.31 ,58.36 ,66.31 
03,001,01,001,0012,0,2585,35,2620,4282,0,0,0,0,0,0,0,66.31 ,61.19 ,66.31 
03,001,01,001,0013,0,1564,23,1587,2323,0,0,0,0,0,0,0,66.31 ,68.32 ,66.31 
03,001,01,001,0014,0,1286,13,1299,2096,0,0,0,0,0,0,0,66.31 ,61.98 ,66.31 
03,001,01,001,0015,0,1372,18,1390,2131,0,0,0,0,0,0,0,66.31 ,65.23 ,66.31 
03,001,01,001,0016,0,2085,17,2102,3092,0,0,0,0,0,0,0,66.31 ,67.98 ,66.31 
03,001,01,001,0017,0,946,7,953,1674,0,0,0,0,0,0,0,66.31 ,56.93 ,66.31 
03,001,01,001,0018,0,1907,25,1932,3344,0,0,0,0,0,0,0,66.31 ,57.78 ,66.31 
03,001,01,001,0019,0,1708,26,1734,3101,0,0,0,0,0,0,0,66.31 ,55.92 ,66.31 
03,001,01,001,0020,0,2127,37,2164,4037,0,0,0,0,0,0,0,66.31 ,53.60 ,66.31 
03,001,01,001,0021,0,1583,15,1598,2441,0,0,0,0,0,0,0,66.31 ,65.46 ,66.31 
03,001,01,001,0022,0,1119,16,1135,1695,0,0,0,0,0,0,0,66.31 ,66.96 ,66.31 
03,001,01,001,0023,0,1985,27,2012,3092,0,0,0,0,0,0,0,66.31 ,65.07 ,66.31 
03,001,01,001,0024,0,2167,21,2188,3529,0,0,0,0,0,0,0,66.31 ,62.00 ,66.31 
03,001,01,001,0025,0,1895,23,1918,3037,0,0,0,0,0,0,0,66.31 ,63.15 ,66.31 
03,001,01,001,0026,0,2132,35,2167,3358,0,0,0,0,0,0,0,66.31 ,64.53 ,66.31 
03,001,01,001,0027,0,1964,24,1988,3214,0,0,0,0,0,0,0,66.31 ,61.85 ,66.31 
03,001,01,001,0028,0,997,20,1017,1833,0,0,0,0,0,0,0,66.31 ,55.48 ,66.31 
03,001,01,001,0029,0,1372,16,1388,2061,0,0,0,0,0,0,0,66.31 ,67.35 ,66.31 
03,001,01,001,0030,0,1389,20,1409,2263,0,0,0,0,0,0,0,66.31 ,62.26 ,66.31 
03,001,01,001,0031,0,1322,17,1339,1958,0,0,0,0,0,0,0,66.31 ,68.39 ,66.31 
03,001,01,001,0032,0,1527,24,1551,2402,0,0,0,0,0,0,0,66.31 ,64.57 ,66.31 
03,001,01,001,0033,0,1330,20,1350,2018,0,0,0,0,0,0,0,66.31 ,66.90 ,66.31 
03,001,01,001,0034,0,1835,33,1868,3019,0,0,0,0,0,0,0,66.31 ,61.87 ,66.31 
03,001,01,001,0035,0,2241,35,2276,3611,0,0,0,0,0,0,0,66.31 ,63.03 ,66.31 
03,001,01,001,0036,0,2052,34,2086,3523,0,0,0,0,0,0,0,66.31 ,59.21 ,66.31 
03,001,01,001,0037,0,2433,34,2467,4131,0,0,0,0,0,0,0,66.31 ,59.72 ,66.31 
03,001,01,001,0038,0,1196,12,1208,1967,0,0,0,0,0,0,0,66.31 ,61.41 ,66.31 
03,001,01,001,0039,0,1490,18,1508,2396,0,0,0,0,0,0,0,66.31 ,62.94 ,66.31 
03,001,01,001,0040,0,1500,30,1530,2236,0,0,0,0,0,0,0,66.31 ,68.43 ,66.31 
03,001,01,001,0041,0,1639,39,1678,2545,0,0,0,0,0,0,0,66.31 ,65.93 ,66.31 
03,001,01,001,0042,0,2671,39,2710,4504,0,0,0,0,0,0,0,66.31 ,60.17 ,66.31 
03,001,01,001,0043,0,1565,16,1581,2597,0,0,0,0,0,0,0,66.31 ,60.88 ,66.31 
03,001,01,001,0044,0,1732,34,1766,2775,0,0,0,0,0,0,0,66.31 ,63.64 ,66.31 
03,001,01,001,0045,0,1897,32,1929,3056,0,0,0,0,0,0,0,66.31 ,63.12 ,66.31 
03,001,01,001,0046,0,1586,23,1609,2624,0,0,0,0,0,0,0,66.31 ,61.32 ,66.31 
03,001,01,001,0047,0,1601,24,1625,2592,0,0,0,0,0,0,0,66.31 ,62.69 ,66.31 
03,001,01,001,0048,0,2426,32,2458,3981,0,0,0,0,0,0,0,66.31 ,61.74 ,66.31 
03,001,01,001,0049,0,1603,17,1620,2757,0,0,0,0,0,0,0,66.31 ,58.76 ,66.31 
03,001,01,001,0050,0,1451,16,1467,2422,0,0,0,0,0,0,0,66.31 ,60.57 ,66.31 
03,001,01,001,0051,0,1764,16,1780,2962,0,0,0,0,0,0,0,66.31 ,60.09 ,66.31 
03,001,01,001,0052,0,1264,19,1283,1929,0,0,0,0,0,0,0,66.31 ,66.51 ,66.31 
03,001,01,001,0053,0,1521,25,1546,2596,0,0,0,0,0,0,0,66.31 ,59.55 ,66.31 
03,001,01,001,0054,0,1390,20,1410,2335,0,0,0,0,0,0,0,66.31 ,60.39 ,66.31 
03,001,01,001,0055,0,2373,42,2415,3959,0,0,0,0,0,0,0,66.31 ,61.00 ,66.31 
03,001,01,001,0056,0,1217,22,1239,2124,0,0,0,0,0,0,0,66.31 ,58.33 ,66.31 
03,001,01,001,0057,0,1332,27,1359,2081,0,0,0,0,0,0,0,66.31 ,65.31 ,66.31 
03,001,01,001,0058,0,1887,24,1911,3103,0,0,0,0,0,0,0,66.31 ,61.59 ,66.31 
03,001,01,001,0059,0,1322,19,1341,2476,0,0,0,0,0,0,0,66.31 ,54.16 ,66.31 
03,001,01,001,0060,0,2170,30,2200,3879,0,0,0,0,0,0,0,66.31 ,56.72 ,66.31 
03,001,01,001,0061,0,1034,19,1053,1636,0,0,0,0,0,0,0,66.31 ,64.36 ,66.31 
03,001,01,001,0062,0,2359,30,2389,4106,0,0,0,0,0,0,0,66.31 ,58.18 ,66.31 
03,001,01,001,0063,0,2095,34,2129,3256,0,0,0,0,0,0,0,66.31 ,65.39 ,66.31 
03,001,01,001,0064,0,1851,31,1882,2935,0,0,0,0,0,0,0,66.31 ,64.12 ,66.31 
03,001,01,001,0065,0,1436,24,1460,2394,0,0,0,0,0,0,0,66.31 ,60.99 ,66.31 
03,001,01,001,0066,0,2320,36,2356,3828,0,0,0,0,0,0,0,66.31 ,61.55 ,66.31 
03,001,01,001,0067,0,944,7,951,1732,0,0,0,0,0,0,0,66.31 ,54.91 ,66.31 
03,001,01,001,0068,0,1483,31,1514,2166,0,0,0,0,0,0,0,66.31 ,69.90 ,66.31 
03,001,01,001,0069,0,1202,29,1231,2031,0,0,0,0,0,0,0,66.31 ,60.61 ,66.31 
03,001,01,001,0070,0,1445,32,1477,2316,0,0,0,0,0,0,0,66.31 ,63.77 ,66.31 
03,001,01,001,0071,0,2693,39,2732,4429,0,0,0,0,0,0,0,66.31 ,61.68 ,66.31 
03,001,01,001,0072,0,1370,18,1388,2310,0,0,0,0,0,0,0,66.31 ,60.09 ,66.31 
03,001,01,001,0073,0,1410,27,1437,2213,0,0,0,0,0,0,0,66.31 ,64.93 ,66.31 
03,001,01,001,0074,0,2079,45,2124,3447,0,0,0,0,0,0,0,66.31 ,61.62 ,66.31 
03,001,01,001,0075,0,1506,29,1535,2299,0,0,0,0,0,0,0,66.31 ,66.77 ,66.31 
03,001,01,001,0076,0,1655,13,1668,2678,0,0,0,0,0,0,0,66.31 ,62.29 ,66.31 
03,001,01,001,0077,0,1134,16,1150,1714,0,0,0,0,0,0,0,66.31 ,67.09 ,66.31 
03,001,01,001,0078,0,1314,21,1335,2200,0,0,0,0,0,0,0,66.31 ,60.68 ,66.31 
03,001,01,001,0079,0,1494,34,1528,2428,0,0,0,0,0,0,0,66.31 ,62.93 ,66.31 
03,001,01,001,0080,0,1720,28,1748,2813,0,0,0,0,0,0,0,66.31 ,62.14 ,66.31 
03,001,01,001,0081,0,2393,20,2413,4027,0,0,0,0,0,0,0,66.31 ,59.92 ,66.31 
03,001,01,001,0082,0,1582,18,1600,2570,0,0,0,0,0,0,0,66.31 ,62.26 ,66.31 
03,001,01,001,0083,0,1218,19,1237,1897,0,0,0,0,0,0,0,66.31 ,65.21 ,66.31 
03,001,01,001,0084,0,1983,45,2028,3246,0,0,0,0,0,0,0,66.31 ,62.48 ,66.31 
03,001,01,001,0085,0,871,13,884,1446,0,0,0,0,0,0,0,66.31 ,61.13 ,66.31 
03,001,01,001,0086,0,1489,24,1513,2500,0,0,0,0,0,0,0,66.31 ,60.52 ,66.31 
03,001,01,001,0087,0,1181,18,1199,1920,0,0,0,0,0,0,0,66.31 ,62.45 ,66.31 
03,001,01,001,0088,0,951,12,963,1521,0,0,0,0,0,0,0,66.31 ,63.31 ,66.31 
03,001,01,001,0089,0,1440,23,1463,2437,0,0,0,0,0,0,0,66.31 ,60.03 ,66.31 
03,001,01,001,0090,0,1850,22,1872,3000,0,0,0,0,0,0,0,66.31 ,62.40 ,66.31 
03,001,01,001,0091,0,1249,26,1275,2091,0,0,0,0,0,0,0,66.31 ,60.98 ,66.31 
03,001,01,001,0092,0,1568,17,1585,2565,0,0,0,0,0,0,0,66.31 ,61.79 ,66.31 
03,001,01,001,0093,0,2352,30,2382,3643,0,0,0,0,0,0,0,66.31 ,65.39 ,66.31 
03,001,01,001,0094,0,1563,22,1585,2458,0,0,0,0,0,0,0,66.31 ,64.48 ,66.31 
03,001,01,001,0095,0,1312,24,1336,2093,0,0,0,0,0,0,0,66.31 ,63.83 ,66.31 
03,001,01,001,0096,0,1503,24,1527,2376,0,0,0,0,0,0,0,66.31 ,64.27 ,66.31 
03,001,01,001,0097,0,2549,41,2590,4208,0,0,0,0,0,0,0,66.31 ,61.55 ,66.31 
03,001,01,001,0098,0,2175,19,2194,3501,0,0,0,0,0,0,0,66.31 ,62.67 ,66.31 
03,001,01,001,0099,0,3143,60,3203,5414,0,0,0,0,0,0,0,66.31 ,59.16 ,66.31 
03,001,01,001,0100,0,1694,20,1714,2676,0,0,0,0,0,0,0,66.31 ,64.05 ,66.31 
03,001,01,001,0101,0,527,8,535,848,0,0,0,0,0,0,0,66.31 ,63.09 ,66.31 
03,001,01,001,0102,0,1261,21,1282,2169,0,0,0,0,0,0,0,66.31 ,59.11 ,66.31 
03,001,01,001,0103,0,2052,21,2073,3488,0,0,0,0,0,0,0,66.31 ,59.43 ,66.31 
03,001,01,001,0104,0,1636,28,1664,2741,0,0,0,0,0,0,0,66.31 ,60.71 ,66.31 
03,001,01,001,0105,0,1432,36,1468,2163,0,0,0,0,0,0,0,66.31 ,67.87 ,66.31 
03,001,01,001,0106,0,1056,11,1067,1611,0,0,0,0,0,0,0,66.31 ,66.23 ,66.31 
03,001,01,001,0107,0,2449,52,2501,4019,0,0,0,0,0,0,0,66.31 ,62.23 ,66.31 
03,001,01,001,0108,0,2206,35,2241,3578,0,0,0,0,0,0,0,66.31 ,62.63 ,66.31 
03,001,01,001,0109,0,1887,46,1933,3063,0,0,0,0,0,0,0,66.31 ,63.11 ,66.31 
03,001,01,001,0110,0,1891,31,1922,3444,0,0,0,0,0,0,0,66.31 ,55.81 ,66.31 
03,001,01,001,0111,0,2199,41,2240,3728,0,0,0,0,0,0,0,66.31 ,60.09 ,66.31 
03,001,01,001,0112,0,1632,28,1660,2595,0,0,0,0,0,0,0,66.31 ,63.97 ,66.31 
03,001,01,001,0113,0,1479,19,1498,2401,0,0,0,0,0,0,0,66.31 ,62.39 ,66.31 
03,001,01,001,0114,0,726,11,737,1005,0,0,0,0,0,0,0,66.31 ,73.33 ,66.31 
03,001,01,001,0115,0,2310,39,2349,3917,0,0,0,0,0,0,0,66.31 ,59.97 ,66.31 
03,001,01,001,0116,0,1738,32,1770,2589,0,0,0,0,0,0,0,66.31 ,68.37 ,66.31 
03,001,01,001,0117,0,1975,35,2010,3261,0,0,0,0,0,0,0,66.31 ,61.64 ,66.31 
03,001,01,001,0118,0,1264,17,1281,2150,0,0,0,0,0,0,0,66.31 ,59.58 ,66.31 
03,001,01,001,0119,0,2302,49,2351,3723,0,0,0,0,0,0,0,66.31 ,63.15 ,66.31 
03,001,01,001,0120,0,1408,25,1433,2324,0,0,0,0,0,0,0,66.31 ,61.66 ,66.31 
03,001,01,001,0121,0,2857,51,2908,4883,0,0,0,0,0,0,0,66.31 ,59.55 ,66.31 
03,001,01,001,0122,0,1503,25,1528,2542,0,0,0,0,0,0,0,66.31 ,60.11 ,66.31 
03,001,01,001,0123,0,2208,39,2247,3649,0,0,0,0,0,0,0,66.31 ,61.58 ,66.31 
03,001,01,001,0124,0,2744,58,2802,4709,0,0,0,0,0,0,0,66.31 ,59.50 ,66.31 
03,001,01,001,0125,0,1570,28,1598,2430,0,0,0,0,0,0,0,66.31 ,65.76 ,66.31 
03,001,01,001,0126,0,1664,23,1687,2567,0,0,0,0,0,0,0,66.31 ,65.72 ,66.31 
03,001,01,002,0127,0,719,18,737,1123,0,0,0,0,0,0,0,66.31 ,65.63 ,66.31 
03,001,01,002,0128,0,742,12,754,1099,0,0,0,0,0,0,0,66.31 ,68.61 ,66.31 
03,001,01,002,0129,0,1978,46,2024,3063,0,0,0,0,0,0,0,66.31 ,66.08 ,66.31 
03,001,01,002,0130,0,1390,37,1427,2356,0,0,0,0,0,0,0,66.31 ,60.57 ,66.31 
03,001,01,002,0131,0,1440,36,1476,2303,0,0,0,0,0,0,0,66.31 ,64.09 ,66.31 
03,001,01,002,0132,0,2810,51,2861,4695,0,0,0,0,0,0,0,66.31 ,60.94 ,66.31 
03,001,01,002,0133,0,1651,32,1683,3006,0,0,0,0,0,0,0,66.31 ,55.99 ,66.31 
03,001,01,002,0134,0,2107,48,2155,3712,0,0,0,0,0,0,0,66.31 ,58.05 ,66.31 
03,001,01,002,0135,0,1259,29,1288,2033,0,0,0,0,0,0,0,66.31 ,63.35 ,66.31 
03,001,01,002,0136,0,1006,17,1023,1528,0,0,0,0,0,0,0,66.31 ,66.95 ,66.31 
03,001,01,002,0137,0,566,6,572,853,0,0,0,0,0,0,0,66.31 ,67.06 ,66.31 
03,001,01,002,0138,0,1662,31,1693,2826,0,0,0,0,0,0,0,66.31 ,59.91 ,66.31 
03,001,01,002,0139,0,2239,42,2281,3777,0,0,0,0,0,0,0,66.31 ,60.39 ,66.31 
03,001,01,002,0140,0,2251,37,2288,3783,0,0,0,0,0,0,0,66.31 ,60.48 ,66.31 
03,001,01,002,0141,0,2233,33,2266,3671,0,0,0,0,0,0,0,66.31 ,61.73 ,66.31 
03,001,01,002,0142,0,2184,42,2226,3412,0,0,0,0,0,0,0,66.31 ,65.24 ,66.31 
03,001,01,002,0143,0,2047,39,2086,3421,0,0,0,0,0,0,0,66.31 ,60.98 ,66.31 
03,001,01,002,0144,0,1779,29,1808,2850,0,0,0,0,0,0,0,66.31 ,63.44 ,66.31 
03,001,01,002,0145,0,1613,25,1638,2441,0,0,0,0,0,0,0,66.31 ,67.10 ,66.31 
03,001,01,002,0146,0,1925,26,1951,3029,0,0,0,0,0,0,0,66.31 ,64.41 ,66.31 
03,001,01,002,0147,0,2130,25,2155,3492,0,0,0,0,0,0,0,66.31 ,61.71 ,66.31 
03,001,01,002,0148,0,1450,22,1472,2220,0,0,0,0,0,0,0,66.31 ,66.31 ,66.31 
03,001,01,002,0149,0,4407,63,4470,7190,0,0,0,0,0,0,0,66.31 ,62.17 ,66.31 
03,001,01,002,0150,0,2358,40,2398,3733,0,0,0,0,0,0,0,66.31 ,64.24 ,66.31 
03,001,01,002,0151,0,1356,28,1384,2156,0,0,0,0,0,0,0,66.31 ,64.19 ,66.31 
03,001,01,002,0152,0,4510,79,4589,8769,0,0,0,0,0,0,0,66.31 ,52.33 ,66.31 
03,001,01,002,0153,0,1221,17,1238,1972,0,0,0,0,0,0,0,66.31 ,62.78 ,66.31 
03,001,01,002,0154,0,2493,32,2525,4235,0,0,0,0,0,0,0,66.31 ,59.62 ,66.31 
03,001,01,002,0155,0,711,19,730,1178,0,0,0,0,0,0,0,66.31 ,61.97 ,66.31 
03,001,01,002,0156,0,2773,54,2827,4444,0,0,0,0,0,0,0,66.31 ,63.61 ,66.31 
03,001,01,002,0157,0,4214,73,4287,6898,0,0,0,0,0,0,0,66.31 ,62.15 ,66.31 
03,001,01,002,0158,0,1331,37,1368,2130,0,0,0,0,0,0,0,66.31 ,64.23 ,66.31 
03,001,01,002,0159,0,2073,44,2117,3498,0,0,0,0,0,0,0,66.31 ,60.52 ,66.31 
03,001,01,002,0160,0,3230,45,3275,5973,0,0,0,0,0,0,0,66.31 ,54.83 ,66.31 
03,001,01,002,0161,0,2768,39,2807,4704,0,0,0,0,0,0,0,66.31 ,59.67 ,66.31 
03,001,01,002,0162,0,1748,35,1783,2869,0,0,0,0,0,0,0,66.31 ,62.15 ,66.31 
03,001,01,002,0163,0,3510,60,3570,5650,0,0,0,0,0,0,0,66.31 ,63.19 ,66.31 
03,001,01,002,0164,0,2807,51,2858,4535,0,0,0,0,0,0,0,66.31 ,63.02 ,66.31 
03,001,01,002,0165,0,1988,41,2029,3374,0,0,0,0,0,0,0,66.31 ,60.14 ,66.31 
03,001,01,002,0166,0,1909,46,1955,3289,0,0,0,0,0,0,0,66.31 ,59.44 ,66.31 
03,001,01,003,0167,0,2422,39,2461,3925,0,0,0,0,0,0,0,66.31 ,62.70 ,66.31 
03,001,01,003,0168,0,1672,30,1702,2725,0,0,0,0,0,0,0,66.31 ,62.46 ,66.31 
03,001,01,003,0169,0,865,9,874,1478,0,0,0,0,0,0,0,66.31 ,59.13 ,66.31 
03,001,01,003,0170,0,944,17,961,1657,0,0,0,0,0,0,0,66.31 ,58.00 ,66.31 
03,001,01,003,0171,0,621,6,627,1035,0,0,0,0,0,0,0,66.31 ,60.58 ,66.31 
03,001,01,003,0172,0,831,12,843,1398,0,0,0,0,0,0,0,66.31 ,60.30 ,66.31 
03,001,01,003,0173,0,1470,33,1503,2552,0,0,0,0,0,0,0,66.31 ,58.89 ,66.31 
03,001,01,003,0174,0,1804,38,1842,2931,0,0,0,0,0,0,0,66.31 ,62.85 ,66.31 
03,001,01,003,0175,0,1868,35,1903,3424,0,0,0,0,0,0,0,66.31 ,55.58 ,66.31 
03,001,01,003,0176,0,1415,21,1436,2454,0,0,0,0,0,0,0,66.31 ,58.52 ,66.31 
03,001,01,003,0177,0,1247,17,1264,2322,0,0,0,0,0,0,0,66.31 ,54.44 ,66.31 
03,001,01,003,0178,0,1429,29,1458,2464,0,0,0,0,0,0,0,66.31 ,59.17 ,66.31 
03,001,01,003,0179,0,1848,21,1869,2984,0,0,0,0,0,0,0,66.31 ,62.63 ,66.31 
03,001,01,003,0180,0,1540,29,1569,2819,0,0,0,0,0,0,0,66.31 ,55.66 ,66.31 
03,001,01,003,0181,0,648,8,656,961,0,0,0,0,0,0,0,66.31 ,68.26 ,66.31 
03,001,01,003,0182,0,614,3,617,929,0,0,0,0,0,0,0,66.31 ,66.42 ,66.31 
03,001,01,003,0183,0,1160,20,1180,1836,0,0,0,0,0,0,0,66.31 ,64.27 ,66.31 
03,001,01,003,0184,0,1629,23,1652,2585,0,0,0,0,0,0,0,66.31 ,63.91 ,66.31 
03,001,01,003,0185,0,2318,31,2349,3527,0,0,0,0,0,0,0,66.31 ,66.60 ,66.31 
03,001,01,003,0186,0,1305,28,1333,2008,0,0,0,0,0,0,0,66.31 ,66.38 ,66.31 
03,001,01,003,0187,0,1699,21,1720,2704,0,0,0,0,0,0,0,66.31 ,63.61 ,66.31 
03,001,01,003,0188,0,1445,24,1469,2330,0,0,0,0,0,0,0,66.31 ,63.05 ,66.31 
03,001,01,003,0189,0,1574,18,1592,2492,0,0,0,0,0,0,0,66.31 ,63.88 ,66.31 
03,001,01,003,0190,0,710,8,718,1065,0,0,0,0,0,0,0,66.31 ,67.42 ,66.31 
03,001,01,003,0191,0,1045,17,1062,1789,0,0,0,0,0,0,0,66.31 ,59.36 ,66.31 
03,001,01,003,0192,0,1062,21,1083,1721,0,0,0,0,0,0,0,66.31 ,62.93 ,66.31 
03,001,01,003,0193,0,911,18,929,1534,0,0,0,0,0,0,0,66.31 ,60.56 ,66.31 
03,001,01,003,0194,0,1843,23,1866,2822,0,0,0,0,0,0,0,66.31 ,66.12 ,66.31 
03,001,01,003,0195,0,2000,30,2030,3442,0,0,0,0,0,0,0,66.31 ,58.98 ,66.31 
03,001,01,003,0196,0,1595,24,1619,2587,0,0,0,0,0,0,0,66.31 ,62.58 ,66.31 
03,001,01,003,0197,0,1642,34,1676,2638,0,0,0,0,0,0,0,66.31 ,63.53 ,66.31 
03,001,01,003,0198,0,1749,27,1776,2733,0,0,0,0,0,0,0,66.31 ,64.98 ,66.31 
03,001,01,003,0199,0,2140,32,2172,3767,0,0,0,0,0,0,0,66.31 ,57.66 ,66.31 
03,001,01,003,0200,0,1491,31,1522,2286,0,0,0,0,0,0,0,66.31 ,66.58 ,66.31 
03,001,01,003,0201,0,1473,31,1504,2284,0,0,0,0,0,0,0,66.31 ,65.85 ,66.31 
03,001,01,003,0202,0,1640,36,1676,2439,0,0,0,0,0,0,0,66.31 ,68.72 ,66.31 
03,001,01,003,0203,0,750,23,773,1146,0,0,0,0,0,0,0,66.31 ,67.45 ,66.31 
03,001,01,003,0204,0,745,11,756,1113,0,0,0,0,0,0,0,66.31 ,67.92 ,66.31 
03,001,01,003,0205,0,824,15,839,1270,0,0,0,0,0,0,0,66.31 ,66.06 ,66.31 
03,001,01,003,0206,0,761,7,768,1141,0,0,0,0,0,0,0,66.31 ,67.31 ,66.31 
03,001,01,003,0207,0,420,7,427,643,0,0,0,0,0,0,0,66.31 ,66.41 ,66.31 
03,001,01,003,0208,0,662,18,680,1119,0,0,0,0,0,0,0,66.31 ,60.77 ,66.31 
03,001,01,004,0209,0,325,8,333,466,0,0,0,0,0,0,0,66.31 ,71.46 ,66.31 
03,001,01,004,0210,0,614,7,621,873,0,0,0,0,0,0,0,66.31 ,71.13 ,66.31 
03,001,01,004,0211,0,860,10,870,1209,0,0,0,0,0,0,0,66.31 ,71.96 ,66.31 
03,001,01,004,0212,0,1207,11,1218,1689,0,0,0,0,0,0,0,66.31 ,72.11 ,66.31 
03,001,01,004,0213,0,616,6,622,799,0,0,0,0,0,0,0,66.31 ,77.85 ,66.31 
03,001,01,004,0214,0,2396,26,2422,3434,0,0,0,0,0,0,0,66.31 ,70.53 ,66.31 
03,001,01,004,0215,0,2163,35,2198,3514,0,0,0,0,0,0,0,66.31 ,62.55 ,66.31 
03,001,01,004,0216,0,1677,18,1695,2438,0,0,0,0,0,0,0,66.31 ,69.52 ,66.31 
03,001,01,004,0217,0,2303,36,2339,3461,0,0,0,0,0,0,0,66.31 ,67.58 ,66.31 
03,001,01,004,0218,0,2600,45,2645,3700,0,0,0,0,0,0,0,66.31 ,71.49 ,66.31 
03,001,01,004,0219,0,529,14,543,738,0,0,0,0,0,0,0,66.31 ,73.58 ,66.31 
03,001,01,004,0220,0,728,7,735,1048,0,0,0,0,0,0,0,66.31 ,70.13 ,66.31 
03,001,01,004,0221,0,3253,48,3301,5138,0,0,0,0,0,0,0,66.31 ,64.25 ,66.31 
03,001,01,004,0222,0,2097,33,2130,3074,0,0,0,0,0,0,0,66.31 ,69.29 ,66.31 
03,001,01,004,0223,0,1752,38,1790,2832,0,0,0,0,0,0,0,66.31 ,63.21 ,66.31 
03,001,01,004,0224,0,1804,33,1837,3108,0,0,0,0,0,0,0,66.31 ,59.11 ,66.31 
03,001,01,004,0225,0,1885,24,1909,3033,0,0,0,0,0,0,0,66.31 ,62.94 ,66.31 
03,001,01,004,0226,0,2205,38,2243,3655,0,0,0,0,0,0,0,66.31 ,61.37 ,66.31 
03,001,01,004,0227,0,2405,32,2437,3849,0,0,0,0,0,0,0,66.31 ,63.32 ,66.31 
03,001,01,004,0228,0,153,3,156,231,0,0,0,0,0,0,0,66.31 ,67.53 ,66.31 
03,001,01,005,0229,0,239,1,240,356,0,0,0,0,0,0,0,66.31 ,67.42 ,66.31 
03,001,01,005,0230,0,308,4,312,442,0,0,0,0,0,0,0,66.31 ,70.59 ,66.31 
03,001,01,005,0231,0,1455,33,1488,2131,0,0,0,0,0,0,0,66.31 ,69.83 ,66.31 
03,001,01,005,0232,0,739,9,748,1199,0,0,0,0,0,0,0,66.31 ,62.39 ,66.31 
03,001,01,005,0233,0,559,4,563,823,0,0,0,0,0,0,0,66.31 ,68.41 ,66.31 
03,001,01,005,0234,0,2399,33,2432,3769,0,0,0,0,0,0,0,66.31 ,64.53 ,66.31 
03,001,01,005,0235,0,1824,34,1858,2974,0,0,0,0,0,0,0,66.31 ,62.47 ,66.31 
03,001,01,005,0236,0,1463,19,1482,2440,0,0,0,0,0,0,0,66.31 ,60.74 ,66.31 
03,001,01,005,0237,0,1770,30,1800,2914,0,0,0,0,0,0,0,66.31 ,61.77 ,66.31 
03,001,01,005,0238,0,2561,38,2599,4217,0,0,0,0,0,0,0,66.31 ,61.63 ,66.31 
03,001,01,005,0239,0,2470,47,2517,4106,0,0,0,0,0,0,0,66.31 ,61.30 ,66.31 
03,001,01,005,0240,0,2971,53,3024,4956,0,0,0,0,0,0,0,66.31 ,61.02 ,66.31 
03,001,01,005,0241,0,1911,29,1940,2989,0,0,0,0,0,0,0,66.31 ,64.90 ,66.31 
03,001,01,005,0242,0,1104,15,1119,2058,0,0,0,0,0,0,0,66.31 ,54.37 ,66.31 
03,001,01,005,0243,0,1855,27,1882,2687,0,0,0,0,0,0,0,66.31 ,70.04 ,66.31 
03,001,01,005,0244,0,612,11,623,908,0,0,0,0,0,0,0,66.31 ,68.61 ,66.31 
03,001,01,005,0245,0,611,9,620,925,0,0,0,0,0,0,0,66.31 ,67.03 ,66.31 
03,001,01,005,0246,0,282,6,288,466,0,0,0,0,0,0,0,66.31 ,61.80 ,66.31 
03,001,01,005,0247,0,573,7,580,856,0,0,0,0,0,0,0,66.31 ,67.76 ,66.31 
03,001,01,005,0248,0,506,6,512,824,0,0,0,0,0,0,0,66.31 ,62.14 ,66.31 
03,001,01,005,0249,0,838,12,850,1126,0,0,0,0,0,0,0,66.31 ,75.49 ,66.31 
03,001,01,005,0250,0,1265,13,1278,1773,0,0,0,0,0,0,0,66.31 ,72.08 ,66.31 
03,001,01,005,0251,0,1433,30,1463,2178,0,0,0,0,0,0,0,66.31 ,67.17 ,66.31 
03,001,01,005,0252,0,621,3,624,830,0,0,0,0,0,0,0,66.31 ,75.18 ,66.31 
03,001,01,005,0253,0,822,15,837,1327,0,0,0,0,0,0,0,66.31 ,63.07 ,66.31 
03,001,01,005,0254,0,1030,15,1045,1632,0,0,0,0,0,0,0,66.31 ,64.03 ,66.31 
03,001,02,006,0255,0,2028,27,2055,3114,0,0,0,0,0,0,0,66.31 ,65.99 ,66.31 
03,001,02,006,0256,0,2004,28,2032,3147,0,0,0,0,0,0,0,66.31 ,64.57 ,66.31 
03,001,02,006,0257,0,1059,22,1081,1749,0,0,0,0,0,0,0,66.31 ,61.81 ,66.31 
03,001,02,006,0258,0,940,20,960,1598,0,0,0,0,0,0,0,66.31 ,60.08 ,66.31 
03,001,02,006,0259,0,744,7,751,1121,0,0,0,0,0,0,0,66.31 ,66.99 ,66.31 
03,001,02,006,0260,0,1151,14,1165,1817,0,0,0,0,0,0,0,66.31 ,64.12 ,66.31 
03,001,02,006,0261,0,1892,29,1921,2839,0,0,0,0,0,0,0,66.31 ,67.66 ,66.31 
03,001,02,006,0262,0,281,5,286,391,0,0,0,0,0,0,0,66.31 ,73.15 ,66.31 
03,001,02,006,0263,0,1397,14,1411,2490,0,0,0,0,0,0,0,66.31 ,56.67 ,66.31 
03,001,02,006,0264,0,1705,26,1731,2640,0,0,0,0,0,0,0,66.31 ,65.57 ,66.31 
03,001,02,006,0265,0,1600,17,1617,2783,0,0,0,0,0,0,0,66.31 ,58.10 ,66.31 
03,001,02,006,0266,0,1561,18,1579,2392,0,0,0,0,0,0,0,66.31 ,66.01 ,66.31 
03,001,02,006,0267,0,2162,28,2190,3491,0,0,0,0,0,0,0,66.31 ,62.73 ,66.31 
03,001,02,006,0268,0,1149,19,1168,1782,0,0,0,0,0,0,0,66.31 ,65.54 ,66.31 
03,001,02,006,0269,0,1363,23,1386,2082,0,0,0,0,0,0,0,66.31 ,66.57 ,66.31 
03,001,02,006,0270,0,1938,31,1969,3226,0,0,0,0,0,0,0,66.31 ,61.04 ,66.31 
03,001,02,006,0271,0,2695,39,2734,4225,0,0,0,0,0,0,0,66.31 ,64.71 ,66.31 
03,001,02,006,0272,0,2063,28,2091,3388,0,0,0,0,0,0,0,66.31 ,61.72 ,66.31 
03,001,02,006,0273,0,1450,21,1471,2281,0,0,0,0,0,0,0,66.31 ,64.49 ,66.31 
03,001,02,006,0274,0,2691,29,2720,4181,0,0,0,0,0,0,0,66.31 ,65.06 ,66.31 
03,001,02,006,0275,0,2405,34,2439,4071,0,0,0,0,0,0,0,66.31 ,59.91 ,66.31 
03,001,02,006,0276,0,1315,16,1331,2010,0,0,0,0,0,0,0,66.31 ,66.22 ,66.31 
03,001,02,006,0277,0,2330,37,2367,4143,0,0,0,0,0,0,0,66.31 ,57.13 ,66.31 
03,001,02,006,0278,0,646,9,655,1188,0,0,0,0,0,0,0,66.31 ,55.13 ,66.31 
03,001,02,006,0279,0,871,17,888,1468,0,0,0,0,0,0,0,66.31 ,60.49 ,66.31 
03,001,02,006,0280,0,884,26,910,1473,0,0,0,0,0,0,0,66.31 ,61.78 ,66.31 
03,001,02,006,0281,0,1005,10,1015,1695,0,0,0,0,0,0,0,66.31 ,59.88 ,66.31 
03,001,02,006,0282,0,795,8,803,1249,0,0,0,0,0,0,0,66.31 ,64.29 ,66.31 
03,001,02,006,0283,0,731,11,742,1134,0,0,0,0,0,0,0,66.31 ,65.43 ,66.31 
03,001,02,006,0284,0,716,11,727,1292,0,0,0,0,0,0,0,66.31 ,56.27 ,66.31 
03,001,02,006,0285,0,893,9,902,1475,0,0,0,0,0,0,0,66.31 ,61.15 ,66.31 
03,001,02,006,0286,0,719,12,731,1180,0,0,0,0,0,0,0,66.31 ,61.95 ,66.31 
03,001,02,006,0287,0,944,14,958,1548,0,0,0,0,0,0,0,66.31 ,61.89 ,66.31 
03,001,02,006,0288,0,881,19,900,1422,0,0,0,0,0,0,0,66.31 ,63.29 ,66.31 
03,001,02,006,0289,0,1158,21,1179,1889,0,0,0,0,0,0,0,66.31 ,62.41 ,66.31 
03,001,02,006,0290,0,903,12,915,1601,0,0,0,0,0,0,0,66.31 ,57.15 ,66.31 
03,001,02,006,0291,0,705,6,711,1070,0,0,0,0,0,0,0,66.31 ,66.45 ,66.31 
03,001,02,006,0292,0,611,6,617,1001,0,0,0,0,0,0,0,66.31 ,61.64 ,66.31 
03,001,02,006,0293,0,1071,5,1076,1584,0,0,0,0,0,0,0,66.31 ,67.93 ,66.31 
03,001,02,006,0294,0,539,3,542,818,0,0,0,0,0,0,0,66.31 ,66.26 ,66.31 
03,001,02,006,0295,0,754,8,762,1378,0,0,0,0,0,0,0,66.31 ,55.30 ,66.31 
03,001,02,006,0296,0,1023,6,1029,1774,0,0,0,0,0,0,0,66.31 ,58.00 ,66.31 
03,001,02,006,0297,0,580,6,586,968,0,0,0,0,0,0,0,66.31 ,60.54 ,66.31 
03,001,02,006,0298,0,1154,11,1165,2014,0,0,0,0,0,0,0,66.31 ,57.85 ,66.31 
03,001,02,006,0299,0,1275,25,1300,2065,0,0,0,0,0,0,0,66.31 ,62.95 ,66.31 
03,001,02,006,0300,0,1249,20,1269,2004,0,0,0,0,0,0,0,66.31 ,63.32 ,66.31 
03,001,02,006,0301,0,1539,15,1554,2568,0,0,0,0,0,0,0,66.31 ,60.51 ,66.31 
03,001,02,006,0302,0,2104,36,2140,3428,0,0,0,0,0,0,0,66.31 ,62.43 ,66.31 
03,001,02,006,0303,0,848,13,861,1363,0,0,0,0,0,0,0,66.31 ,63.17 ,66.31 
03,001,02,006,0304,0,652,11,663,1040,0,0,0,0,0,0,0,66.31 ,63.75 ,66.31 
03,001,02,006,0305,0,915,9,924,1450,0,0,0,0,0,0,0,66.31 ,63.72 ,66.31 
03,001,02,006,0306,0,926,16,942,1555,0,0,0,0,0,0,0,66.31 ,60.58 ,66.31 
03,001,02,006,0307,0,979,12,991,1492,0,0,0,0,0,0,0,66.31 ,66.42 ,66.31 
03,001,02,006,0308,0,1276,14,1290,2180,0,0,0,0,0,0,0,66.31 ,59.17 ,66.31 
03,001,02,006,0309,0,954,17,971,1463,0,0,0,0,0,0,0,66.31 ,66.37 ,66.31 
03,001,02,006,0310,0,566,3,569,944,0,0,0,0,0,0,0,66.31 ,60.28 ,66.31 
03,001,02,006,0311,0,938,13,951,1510,0,0,0,0,0,0,0,66.31 ,62.98 ,66.31 
03,001,02,006,0312,0,1141,10,1151,1713,0,0,0,0,0,0,0,66.31 ,67.19 ,66.31 
03,001,02,006,0313,0,1076,12,1088,1844,0,0,0,0,0,0,0,66.31 ,59.00 ,66.31 
03,001,02,006,0314,0,870,11,881,1482,0,0,0,0,0,0,0,66.31 ,59.45 ,66.31 
03,001,02,006,0315,0,406,10,416,724,0,0,0,0,0,0,0,66.31 ,57.46 ,66.31 
03,001,02,006,0316,0,842,9,851,1331,0,0,0,0,0,0,0,66.31 ,63.94 ,66.31 
03,001,02,006,0317,0,398,7,405,619,0,0,0,0,0,0,0,66.31 ,65.43 ,66.31 
03,001,02,006,0318,0,1221,23,1244,1983,0,0,0,0,0,0,0,66.31 ,62.73 ,66.31 
03,001,02,006,0319,0,1056,20,1076,1563,0,0,0,0,0,0,0,66.31 ,68.84 ,66.31 
03,001,02,006,0320,0,1167,22,1189,1956,0,0,0,0,0,0,0,66.31 ,60.79 ,66.31 
03,001,02,006,0321,0,864,11,875,1404,0,0,0,0,0,0,0,66.31 ,62.32 ,66.31 
03,001,02,006,0322,0,722,14,736,1097,0,0,0,0,0,0,0,66.31 ,67.09 ,66.31 
03,001,02,006,0323,0,959,16,975,1525,0,0,0,0,0,0,0,66.31 ,63.93 ,66.31 
03,001,02,006,0324,0,1392,30,1422,2055,0,0,0,0,0,0,0,66.31 ,69.20 ,66.31 
03,001,02,006,0325,0,1552,35,1587,2327,0,0,0,0,0,0,0,66.31 ,68.20 ,66.31 
03,001,02,006,0326,0,868,14,882,1495,0,0,0,0,0,0,0,66.31 ,59.00 ,66.31 
03,001,02,006,0327,0,687,15,702,1118,0,0,0,0,0,0,0,66.31 ,62.79 ,66.31 
03,001,02,006,0328,0,860,9,869,1367,0,0,0,0,0,0,0,66.31 ,63.57 ,66.31 
03,001,02,006,0329,0,1369,22,1391,2200,0,0,0,0,0,0,0,66.31 ,63.23 ,66.31 
03,001,02,006,0330,0,1235,15,1250,2172,0,0,0,0,0,0,0,66.31 ,57.55 ,66.31 
03,001,02,006,0331,0,790,16,806,1350,0,0,0,0,0,0,0,66.31 ,59.70 ,66.31 
03,001,02,006,0332,0,1068,13,1081,1808,0,0,0,0,0,0,0,66.31 ,59.79 ,66.31 
03,001,02,006,0333,0,2055,34,2089,3521,0,0,0,0,0,0,0,66.31 ,59.33 ,66.31 
03,001,02,006,0334,0,2012,25,2037,2994,0,0,0,0,0,0,0,66.31 ,68.04 ,66.31 
03,001,02,006,0335,0,2266,23,2289,3804,0,0,0,0,0,0,0,66.31 ,60.17 ,66.31 
03,001,02,006,0336,0,1159,18,1177,1890,0,0,0,0,0,0,0,66.31 ,62.28 ,66.31 
03,001,02,006,0337,0,1027,18,1045,1639,0,0,0,0,0,0,0,66.31 ,63.76 ,66.31 
03,001,02,006,0338,0,1321,20,1341,2088,0,0,0,0,0,0,0,66.31 ,64.22 ,66.31 
03,001,02,006,0339,0,2015,38,2053,3375,0,0,0,0,0,0,0,66.31 ,60.83 ,66.31 
03,001,02,006,0340,0,1461,19,1480,2114,0,0,0,0,0,0,0,66.31 ,70.01 ,66.31 
03,001,02,006,0341,0,1378,21,1399,2209,0,0,0,0,0,0,0,66.31 ,63.33 ,66.31 
03,001,02,006,0342,0,1595,15,1610,2528,0,0,0,0,0,0,0,66.31 ,63.69 ,66.31 
03,001,02,006,0343,0,1565,26,1591,2532,0,0,0,0,0,0,0,66.31 ,62.84 ,66.31 
03,001,02,006,0344,0,1539,22,1561,2559,0,0,0,0,0,0,0,66.31 ,61.00 ,66.31 
03,001,02,006,0345,0,2409,47,2456,3854,0,0,0,0,0,0,0,66.31 ,63.73 ,66.31 
03,001,02,006,0346,0,1168,26,1194,1985,0,0,0,0,0,0,0,66.31 ,60.15 ,66.31 
03,001,02,006,0347,0,1955,23,1978,3130,0,0,0,0,0,0,0,66.31 ,63.19 ,66.31 
03,001,02,006,0348,0,1823,35,1858,2682,0,0,0,0,0,0,0,66.31 ,69.28 ,66.31 
03,001,02,006,0349,0,1331,22,1353,2135,0,0,0,0,0,0,0,66.31 ,63.37 ,66.31 
03,001,02,006,0350,0,1508,27,1535,2465,0,0,0,0,0,0,0,66.31 ,62.27 ,66.31 
03,001,02,006,0351,0,2147,33,2180,3202,0,0,0,0,0,0,0,66.31 ,68.08 ,66.31 
03,001,02,006,0352,0,2291,22,2313,3630,0,0,0,0,0,0,0,66.31 ,63.72 ,66.31 
03,001,02,006,0353,0,2391,33,2424,3935,0,0,0,0,0,0,0,66.31 ,61.60 ,66.31 
03,001,02,006,0354,0,2100,54,2154,3196,0,0,0,0,0,0,0,66.31 ,67.40 ,66.31 
03,001,02,006,0355,0,2745,42,2787,4453,0,0,0,0,0,0,0,66.31 ,62.59 ,66.31 
03,001,02,006,0356,0,1647,24,1671,2612,0,0,0,0,0,0,0,66.31 ,63.97 ,66.31 
03,001,02,006,0357,0,1814,40,1854,2717,0,0,0,0,0,0,0,66.31 ,68.24 ,66.31 
03,001,02,006,0358,0,1410,27,1437,2165,0,0,0,0,0,0,0,66.31 ,66.37 ,66.31 
03,001,02,006,0359,0,1631,37,1668,2472,0,0,0,0,0,0,0,66.31 ,67.48 ,66.31 
03,001,02,006,0360,0,1288,25,1313,1937,0,0,0,0,0,0,0,66.31 ,67.79 ,66.31 
03,001,02,006,0361,0,1331,23,1354,1967,0,0,0,0,0,0,0,66.31 ,68.84 ,66.31 
03,001,02,006,0362,0,1291,20,1311,1865,0,0,0,0,0,0,0,66.31 ,70.29 ,66.31 
03,001,02,006,0363,0,2039,48,2087,2939,0,0,0,0,0,0,0,66.31 ,71.01 ,66.31 
03,001,02,006,0364,0,1358,31,1389,1939,0,0,0,0,0,0,0,66.31 ,71.63 ,66.31 
03,001,02,006,0365,0,2069,32,2101,3187,0,0,0,0,0,0,0,66.31 ,65.92 ,66.31 
03,001,02,006,0366,0,1462,24,1486,2086,0,0,0,0,0,0,0,66.31 ,71.24 ,66.31 
03,001,02,006,0367,0,1566,37,1603,2370,0,0,0,0,0,0,0,66.31 ,67.64 ,66.31 
03,001,02,006,0368,0,1104,21,1125,1665,0,0,0,0,0,0,0,66.31 ,67.57 ,66.31 
03,001,02,006,0369,0,1780,24,1804,2536,0,0,0,0,0,0,0,66.31 ,71.14 ,66.31 
03,001,02,006,0370,0,1111,17,1128,1744,0,0,0,0,0,0,0,66.31 ,64.68 ,66.31 
03,001,02,006,0371,0,1837,29,1866,2728,0,0,0,0,0,0,0,66.31 ,68.40 ,66.31 
03,001,02,006,0372,0,1964,27,1991,2833,0,0,0,0,0,0,0,66.31 ,70.28 ,66.31 
03,001,02,006,0373,0,1533,20,1553,2640,0,0,0,0,0,0,0,66.31 ,58.83 ,66.31 
03,001,02,007,0374,0,2206,36,2242,3387,0,0,0,0,0,0,0,66.31 ,66.19 ,66.31 
03,001,02,007,0375,0,1740,22,1762,2793,0,0,0,0,0,0,0,66.31 ,63.09 ,66.31 
03,001,02,007,0376,0,1574,17,1591,2365,0,0,0,0,0,0,0,66.31 ,67.27 ,66.31 
03,001,02,007,0377,0,1430,25,1455,2156,0,0,0,0,0,0,0,66.31 ,67.49 ,66.31 
03,001,02,007,0378,0,1587,21,1608,2733,0,0,0,0,0,0,0,66.31 ,58.84 ,66.31 
03,001,02,007,0379,0,1516,22,1538,2363,0,0,0,0,0,0,0,66.31 ,65.09 ,66.31 
03,001,02,007,0380,0,1196,15,1211,1959,0,0,0,0,0,0,0,66.31 ,61.82 ,66.31 
03,001,02,007,0381,0,1570,24,1594,2554,0,0,0,0,0,0,0,66.31 ,62.41 ,66.31 
03,001,02,007,0382,0,1061,12,1073,1560,0,0,0,0,0,0,0,66.31 ,68.78 ,66.31 
03,001,02,007,0383,0,1560,12,1572,2516,0,0,0,0,0,0,0,66.31 ,62.48 ,66.31 
03,001,02,007,0384,0,1609,17,1626,2611,0,0,0,0,0,0,0,66.31 ,62.27 ,66.31 
03,001,02,007,0385,0,1340,22,1362,2317,0,0,0,0,0,0,0,66.31 ,58.78 ,66.31 
03,001,02,007,0386,0,2020,31,2051,3501,0,0,0,0,0,0,0,66.31 ,58.58 ,66.31 
03,001,02,007,0387,0,1884,30,1914,3434,0,0,0,0,0,0,0,66.31 ,55.74 ,66.31 
03,001,02,007,0388,0,1948,29,1977,3276,0,0,0,0,0,0,0,66.31 ,60.35 ,66.31 
03,001,02,007,0389,0,422,8,430,619,0,0,0,0,0,0,0,66.31 ,69.47 ,66.31 
03,001,02,007,0390,0,1957,28,1985,2994,0,0,0,0,0,0,0,66.31 ,66.30 ,66.31 
03,001,02,007,0391,0,1916,22,1938,2716,0,0,0,0,0,0,0,66.31 ,71.35 ,66.31 
03,001,02,007,0392,0,1619,22,1641,2580,0,0,0,0,0,0,0,66.31 ,63.60 ,66.31 
03,001,02,007,0393,0,1344,28,1372,2071,0,0,0,0,0,0,0,66.31 ,66.25 ,66.31 
03,001,02,007,0394,0,1274,19,1293,1887,0,0,0,0,0,0,0,66.31 ,68.52 ,66.31 
03,001,02,007,0395,0,1740,33,1773,2685,0,0,0,0,0,0,0,66.31 ,66.03 ,66.31 
03,001,02,007,0396,0,2342,36,2378,3881,0,0,0,0,0,0,0,66.31 ,61.27 ,66.31 
03,001,02,007,0397,0,1550,22,1572,2242,0,0,0,0,0,0,0,66.31 ,70.12 ,66.31 
03,001,02,007,0398,0,1552,19,1571,2324,0,0,0,0,0,0,0,66.31 ,67.60 ,66.31 
03,001,02,007,0399,0,1412,32,1444,2008,0,0,0,0,0,0,0,66.31 ,71.91 ,66.31 
03,001,02,007,0400,0,1268,21,1289,1893,0,0,0,0,0,0,0,66.31 ,68.09 ,66.31 
03,001,02,007,0401,0,1885,25,1910,2720,0,0,0,0,0,0,0,66.31 ,70.22 ,66.31 
03,001,02,007,0402,0,997,21,1018,1454,0,0,0,0,0,0,0,66.31 ,70.01 ,66.31 
03,001,02,007,0403,0,2262,45,2307,3418,0,0,0,0,0,0,0,66.31 ,67.50 ,66.31 
03,001,02,007,0404,0,1264,18,1282,1943,0,0,0,0,0,0,0,66.31 ,65.98 ,66.31 
03,001,02,007,0405,0,1243,22,1265,1820,0,0,0,0,0,0,0,66.31 ,69.51 ,66.31 
03,001,02,007,0406,0,2556,38,2594,4190,0,0,0,0,0,0,0,66.31 ,61.91 ,66.31 
03,001,02,007,0407,0,2584,52,2636,4149,0,0,0,0,0,0,0,66.31 ,63.53 ,66.31 
03,001,02,007,0408,0,1826,33,1859,3001,0,0,0,0,0,0,0,66.31 ,61.95 ,66.31 
03,001,02,007,0409,0,996,19,1015,1505,0,0,0,0,0,0,0,66.31 ,67.44 ,66.31 
03,001,02,007,0410,0,1613,17,1630,2562,0,0,0,0,0,0,0,66.31 ,63.62 ,66.31 
03,001,02,007,0411,0,1452,30,1482,2160,0,0,0,0,0,0,0,66.31 ,68.61 ,66.31 
03,001,02,008,0412,0,2029,29,2058,3240,0,0,0,0,0,0,0,66.31 ,63.52 ,66.31 
03,001,02,008,0413,0,2409,34,2443,4037,0,0,0,0,0,0,0,66.31 ,60.52 ,66.31 
03,001,02,008,0414,0,872,10,882,1424,0,0,0,0,0,0,0,66.31 ,61.94 ,66.31 
03,001,02,008,0415,0,1473,24,1497,2667,0,0,0,0,0,0,0,66.31 ,56.13 ,66.31 
03,001,02,008,0416,0,1882,22,1904,2976,0,0,0,0,0,0,0,66.31 ,63.98 ,66.31 
03,001,02,008,0417,0,967,9,976,1487,0,0,0,0,0,0,0,66.31 ,65.64 ,66.31 
03,001,02,008,0418,0,1449,15,1464,2571,0,0,0,0,0,0,0,66.31 ,56.94 ,66.31 
03,001,02,008,0419,0,2141,33,2174,3571,0,0,0,0,0,0,0,66.31 ,60.88 ,66.31 
03,001,02,008,0420,0,2188,19,2207,3905,0,0,0,0,0,0,0,66.31 ,56.52 ,66.31 
03,001,02,008,0421,0,1015,6,1021,1798,0,0,0,0,0,0,0,66.31 ,56.79 ,66.31 
03,001,02,008,0422,0,1644,20,1664,2881,0,0,0,0,0,0,0,66.31 ,57.76 ,66.31 
03,001,02,008,0423,0,2289,32,2321,3776,0,0,0,0,0,0,0,66.31 ,61.47 ,66.31 
03,001,02,008,0424,0,1369,25,1394,2279,0,0,0,0,0,0,0,66.31 ,61.17 ,66.31 
03,001,02,008,0425,0,2063,23,2086,3518,0,0,0,0,0,0,0,66.31 ,59.30 ,66.31 
03,001,02,008,0426,0,2185,25,2210,3617,0,0,0,0,0,0,0,66.31 ,61.10 ,66.31 
03,001,02,008,0427,0,2129,21,2150,3496,0,0,0,0,0,0,0,66.31 ,61.50 ,66.31 
03,001,02,008,0428,0,1854,26,1880,2901,0,0,0,0,0,0,0,66.31 ,64.81 ,66.31 
03,001,02,008,0429,0,1637,26,1663,2673,0,0,0,0,0,0,0,66.31 ,62.21 ,66.31 
03,001,02,008,0430,0,748,10,758,1146,0,0,0,0,0,0,0,66.31 ,66.14 ,66.31 
03,001,02,008,0431,0,994,10,1004,1554,0,0,0,0,0,0,0,66.31 ,64.61 ,66.31 
03,001,02,008,0432,0,1232,18,1250,1913,0,0,0,0,0,0,0,66.31 ,65.34 ,66.31 
03,001,02,008,0433,0,1243,15,1258,2197,0,0,0,0,0,0,0,66.31 ,57.26 ,66.31 
03,001,02,008,0434,0,1273,16,1289,2054,0,0,0,0,0,0,0,66.31 ,62.76 ,66.31 
03,001,02,008,0435,0,1582,26,1608,2595,0,0,0,0,0,0,0,66.31 ,61.97 ,66.31 
03,001,02,008,0436,0,1321,19,1340,2313,0,0,0,0,0,0,0,66.31 ,57.93 ,66.31 
03,001,02,008,0437,0,1418,17,1435,2478,0,0,0,0,0,0,0,66.31 ,57.91 ,66.31 
03,001,02,008,0438,0,2157,25,2182,3736,0,0,0,0,0,0,0,66.31 ,58.40 ,66.31 
03,001,02,008,0439,0,1395,22,1417,2372,0,0,0,0,0,0,0,66.31 ,59.74 ,66.31 
03,001,02,008,0440,0,2204,37,2241,3660,0,0,0,0,0,0,0,66.31 ,61.23 ,66.31 
03,001,02,008,0441,0,1065,18,1083,1746,0,0,0,0,0,0,0,66.31 ,62.03 ,66.31 
03,001,02,008,0442,0,2478,32,2510,4112,0,0,0,0,0,0,0,66.31 ,61.04 ,66.31 
03,001,02,008,0443,0,1631,22,1653,3102,0,0,0,0,0,0,0,66.31 ,53.29 ,66.31 
03,001,02,008,0444,0,2232,30,2262,3972,0,0,0,0,0,0,0,66.31 ,56.95 ,66.31 
03,001,02,008,0445,0,1166,8,1174,1977,0,0,0,0,0,0,0,66.31 ,59.38 ,66.31 
03,001,02,008,0446,0,1620,18,1638,2987,0,0,0,0,0,0,0,66.31 ,54.84 ,66.31 
03,001,02,008,0447,0,1761,24,1785,2915,0,0,0,0,0,0,0,66.31 ,61.23 ,66.31 
03,001,02,008,0448,0,1881,28,1909,3044,0,0,0,0,0,0,0,66.31 ,62.71 ,66.31 
03,001,02,008,0449,0,1754,19,1773,3055,0,0,0,0,0,0,0,66.31 ,58.04 ,66.31 
03,001,02,008,0450,0,1212,18,1230,2272,0,0,0,0,0,0,0,66.31 ,54.14 ,66.31 
03,001,02,008,0451,0,1962,32,1994,3441,0,0,0,0,0,0,0,66.31 ,57.95 ,66.31 
03,001,02,008,0452,0,835,11,846,1481,0,0,0,0,0,0,0,66.31 ,57.12 ,66.31 
03,001,02,008,0453,0,1171,7,1178,1937,0,0,0,0,0,0,0,66.31 ,60.82 ,66.31 
03,001,02,008,0454,0,1533,28,1561,2358,0,0,0,0,0,0,0,66.31 ,66.20 ,66.31 
03,001,02,008,0455,0,1808,25,1833,3353,0,0,0,0,0,0,0,66.31 ,54.67 ,66.31 
03,001,02,008,0456,0,2050,27,2077,3577,0,0,0,0,0,0,0,66.31 ,58.07 ,66.31 
03,001,02,008,0457,0,1039,18,1057,1675,0,0,0,0,0,0,0,66.31 ,63.10 ,66.31 
03,001,02,008,0458,0,1315,18,1333,2200,0,0,0,0,0,0,0,66.31 ,60.59 ,66.31 
03,001,02,008,0459,0,2409,25,2434,4030,0,0,0,0,0,0,0,66.31 ,60.40 ,66.31 
03,001,02,008,0460,0,803,11,814,1242,0,0,0,0,0,0,0,66.31 ,65.54 ,66.31 
03,001,02,008,0461,0,2156,26,2182,3559,0,0,0,0,0,0,0,66.31 ,61.31 ,66.31 
03,001,02,008,0462,0,984,11,995,1537,0,0,0,0,0,0,0,66.31 ,64.74 ,66.31 
03,001,02,008,0463,0,2480,38,2518,4307,0,0,0,0,0,0,0,66.31 ,58.46 ,66.31 
03,001,02,008,0464,0,1210,11,1221,1937,0,0,0,0,0,0,0,66.31 ,63.04 ,66.31 
03,001,02,008,0465,0,1229,19,1248,1969,0,0,0,0,0,0,0,66.31 ,63.38 ,66.31 
03,001,02,008,0466,0,1064,13,1077,1846,0,0,0,0,0,0,0,66.31 ,58.34 ,66.31 
03,001,02,008,0467,0,1739,17,1756,3180,0,0,0,0,0,0,0,66.31 ,55.22 ,66.31 
03,001,02,008,0468,0,1897,18,1915,3138,0,0,0,0,0,0,0,66.31 ,61.03 ,66.31 
03,001,02,008,0469,0,1944,25,1969,3241,0,0,0,0,0,0,0,66.31 ,60.75 ,66.31 
03,001,02,008,0470,0,927,9,936,1453,0,0,0,0,0,0,0,66.31 ,64.42 ,66.31 
03,001,02,008,0471,0,1095,15,1110,1823,0,0,0,0,0,0,0,66.31 ,60.89 ,66.31 
03,001,02,008,0472,0,1279,21,1300,2367,0,0,0,0,0,0,0,66.31 ,54.92 ,66.31 
03,001,02,008,0473,0,1828,21,1849,3261,0,0,0,0,0,0,0,66.31 ,56.70 ,66.31 
03,001,02,008,0474,0,899,6,905,1672,0,0,0,0,0,0,0,66.31 ,54.13 ,66.31 
03,001,02,008,0475,0,2240,32,2272,4034,0,0,0,0,0,0,0,66.31 ,56.32 ,66.31 
03,001,02,008,0476,0,1013,24,1037,1800,0,0,0,0,0,0,0,66.31 ,57.61 ,66.31 
03,001,02,008,0477,0,1303,14,1317,2226,0,0,0,0,0,0,0,66.31 ,59.16 ,66.31 
03,001,02,008,0478,0,1203,21,1224,2096,0,0,0,0,0,0,0,66.31 ,58.40 ,66.31 
03,001,02,008,0479,0,1117,13,1130,2118,0,0,0,0,0,0,0,66.31 ,53.35 ,66.31 
03,001,02,008,0480,0,1656,23,1679,2881,0,0,0,0,0,0,0,66.31 ,58.28 ,66.31 
03,001,02,008,0481,0,1725,27,1752,3454,0,0,0,0,0,0,0,66.31 ,50.72 ,66.31 
03,001,02,008,0482,0,1191,16,1207,2139,0,0,0,0,0,0,0,66.31 ,56.43 ,66.31 
03,001,02,008,0483,0,1679,38,1717,3281,0,0,0,0,0,0,0,66.31 ,52.33 ,66.31 
03,001,02,008,0484,0,1724,24,1748,3321,0,0,0,0,0,0,0,66.31 ,52.63 ,66.31 
03,001,02,008,0485,0,1097,9,1106,1946,0,0,0,0,0,0,0,66.31 ,56.83 ,66.31 
03,001,02,008,0486,0,1288,14,1302,2339,0,0,0,0,0,0,0,66.31 ,55.66 ,66.31 
03,001,02,008,0487,0,1816,31,1847,3707,0,0,0,0,0,0,0,66.31 ,49.82 ,66.31 
03,001,02,008,0488,0,1238,23,1261,2391,0,0,0,0,0,0,0,66.31 ,52.74 ,66.31 
03,001,02,008,0489,0,1382,18,1400,2630,0,0,0,0,0,0,0,66.31 ,53.23 ,66.31 
03,001,02,008,0490,0,560,4,564,1026,0,0,0,0,0,0,0,66.31 ,54.97 ,66.31 
03,001,02,008,0491,0,1951,36,1987,3752,0,0,0,0,0,0,0,66.31 ,52.96 ,66.31 
03,001,02,008,0492,0,1101,7,1108,2041,0,0,0,0,0,0,0,66.31 ,54.29 ,66.31 
03,001,02,008,0493,0,1126,13,1139,2052,0,0,0,0,0,0,0,66.31 ,55.51 ,66.31 
03,001,02,008,0494,0,838,12,850,1593,0,0,0,0,0,0,0,66.31 ,53.36 ,66.31 
03,001,02,008,0495,0,2322,29,2351,4339,0,0,0,0,0,0,0,66.31 ,54.18 ,66.31 
03,001,02,009,0496,0,2133,22,2155,3363,0,0,0,0,0,0,0,66.31 ,64.08 ,66.31 
03,001,02,009,0497,0,674,5,679,1073,0,0,0,0,0,0,0,66.31 ,63.28 ,66.31 
03,001,02,009,0498,0,1162,26,1188,1836,0,0,0,0,0,0,0,66.31 ,64.71 ,66.31 
03,001,02,009,0499,0,1317,15,1332,2195,0,0,0,0,0,0,0,66.31 ,60.68 ,66.31 
03,001,02,009,0500,0,781,11,792,1214,0,0,0,0,0,0,0,66.31 ,65.24 ,66.31 
03,001,02,009,0501,0,1265,28,1293,2081,0,0,0,0,0,0,0,66.31 ,62.13 ,66.31 
03,001,02,009,0502,0,2100,29,2129,3381,0,0,0,0,0,0,0,66.31 ,62.97 ,66.31 
03,001,02,009,0503,0,1321,28,1349,2295,0,0,0,0,0,0,0,66.31 ,58.78 ,66.31 
03,001,02,009,0504,0,1277,28,1305,2038,0,0,0,0,0,0,0,66.31 ,64.03 ,66.31 
03,001,02,009,0505,0,1439,17,1456,2356,0,0,0,0,0,0,0,66.31 ,61.80 ,66.31 
03,001,02,009,0506,0,1182,10,1192,1983,0,0,0,0,0,0,0,66.31 ,60.11 ,66.31 
03,001,02,009,0507,0,729,11,740,1099,0,0,0,0,0,0,0,66.31 ,67.33 ,66.31 
03,001,02,009,0508,0,1594,14,1608,2632,0,0,0,0,0,0,0,66.31 ,61.09 ,66.31 
03,001,02,009,0509,0,1252,13,1265,1918,0,0,0,0,0,0,0,66.31 ,65.95 ,66.31 
03,001,02,009,0510,0,1631,14,1645,2644,0,0,0,0,0,0,0,66.31 ,62.22 ,66.31 
03,001,02,009,0511,0,2559,47,2606,4085,0,0,0,0,0,0,0,66.31 ,63.79 ,66.31 
03,001,02,009,0512,0,1880,31,1911,3162,0,0,0,0,0,0,0,66.31 ,60.44 ,66.31 
03,001,02,009,0513,0,1347,14,1361,2037,0,0,0,0,0,0,0,66.31 ,66.81 ,66.31 
03,001,02,009,0514,0,441,6,447,718,0,0,0,0,0,0,0,66.31 ,62.26 ,66.31 
03,001,02,010,0515,0,615,6,621,853,0,0,0,0,0,0,0,66.31 ,72.80 ,66.31 
03,001,02,010,0516,0,1240,25,1265,2068,0,0,0,0,0,0,0,66.31 ,61.17 ,66.31 
03,001,02,010,0517,0,2424,26,2450,4238,0,0,0,0,0,0,0,66.31 ,57.81 ,66.31 
03,001,02,010,0518,0,2347,30,2377,3799,0,0,0,0,0,0,0,66.31 ,62.57 ,66.31 
03,001,02,010,0519,0,1479,18,1497,2421,0,0,0,0,0,0,0,66.31 ,61.83 ,66.31 
03,001,02,010,0520,0,1617,17,1634,2560,0,0,0,0,0,0,0,66.31 ,63.83 ,66.31 
03,001,02,010,0521,0,1180,16,1196,1855,0,0,0,0,0,0,0,66.31 ,64.47 ,66.31 
03,001,02,010,0522,0,1693,21,1714,2783,0,0,0,0,0,0,0,66.31 ,61.59 ,66.31 
03,001,02,010,0523,0,1943,18,1961,3413,0,0,0,0,0,0,0,66.31 ,57.46 ,66.31 
03,001,02,010,0524,0,1540,29,1569,2583,0,0,0,0,0,0,0,66.31 ,60.74 ,66.31 
03,001,02,010,0525,0,1016,10,1026,1632,0,0,0,0,0,0,0,66.31 ,62.87 ,66.31 
03,001,02,010,0526,0,1371,21,1392,2308,0,0,0,0,0,0,0,66.31 ,60.31 ,66.31 
03,001,02,010,0527,0,1604,22,1626,2614,0,0,0,0,0,0,0,66.31 ,62.20 ,66.31 
03,001,02,010,0528,0,1544,24,1568,2505,0,0,0,0,0,0,0,66.31 ,62.59 ,66.31 
03,001,02,010,0529,0,2079,27,2106,3490,0,0,0,0,0,0,0,66.31 ,60.34 ,66.31 
03,001,02,011,0530,0,1990,22,2012,3132,0,0,0,0,0,0,0,66.31 ,64.24 ,66.31 
03,001,02,011,0531,0,1908,27,1935,3188,0,0,0,0,0,0,0,66.31 ,60.70 ,66.31 
03,001,02,011,0532,0,1844,28,1872,2951,0,0,0,0,0,0,0,66.31 ,63.44 ,66.31 
03,001,02,011,0533,0,1776,18,1794,2828,0,0,0,0,0,0,0,66.31 ,63.44 ,66.31 
03,001,02,011,0534,0,1582,19,1601,2344,0,0,0,0,0,0,0,66.31 ,68.30 ,66.31 
03,001,02,011,0535,0,793,10,803,998,0,0,0,0,0,0,0,66.31 ,80.46 ,66.31 
03,001,02,011,0536,0,994,11,1005,1453,0,0,0,0,0,0,0,66.31 ,69.17 ,66.31 
03,001,02,011,0537,0,2750,56,2806,5189,0,0,0,0,0,0,0,66.31 ,54.08 ,66.31 
03,001,02,011,0538,0,3104,48,3152,5434,0,0,0,0,0,0,0,66.31 ,58.01 ,66.31 
03,001,02,011,0539,0,595,5,600,900,0,0,0,0,0,0,0,66.31 ,66.67 ,66.31 
03,001,02,011,0540,0,626,11,637,882,0,0,0,0,0,0,0,66.31 ,72.22 ,66.31 
03,001,02,011,0541,0,488,9,497,618,0,0,0,0,0,0,0,66.31 ,80.42 ,66.31 
03,001,02,011,0542,0,338,7,345,447,0,0,0,0,0,0,0,66.31 ,77.18 ,66.31 
03,001,02,011,0543,0,533,6,539,788,0,0,0,0,0,0,0,66.31 ,68.40 ,66.31 
03,001,02,012,0544,0,434,8,442,573,0,0,0,0,0,0,0,66.31 ,77.14 ,66.31 
03,001,02,012,0545,0,752,11,763,957,0,0,0,0,0,0,0,66.31 ,79.73 ,66.31 
03,001,02,012,0546,0,924,13,937,1237,0,0,0,0,0,0,0,66.31 ,75.75 ,66.31 
03,001,02,012,0547,0,961,12,973,1280,0,0,0,0,0,0,0,66.31 ,76.02 ,66.31 
03,001,02,012,0548,0,430,1,431,748,0,0,0,0,0,0,0,66.31 ,57.62 ,66.31 
03,001,02,012,0549,0,1349,28,1377,2139,0,0,0,0,0,0,0,66.31 ,64.38 ,66.31 
03,001,02,012,0550,0,631,8,639,785,0,0,0,0,0,0,0,66.31 ,81.40 ,66.31 
03,001,02,012,0551,0,1064,11,1075,1659,0,0,0,0,0,0,0,66.31 ,64.80 ,66.31 
03,001,02,012,0552,0,652,10,662,909,0,0,0,0,0,0,0,66.31 ,72.83 ,66.31 
03,001,02,012,0553,0,468,11,479,706,0,0,0,0,0,0,0,66.31 ,67.85 ,66.31 
03,001,02,012,0554,0,558,7,565,907,0,0,0,0,0,0,0,66.31 ,62.29 ,66.31 
03,001,02,012,0555,0,2190,26,2216,4132,0,0,0,0,0,0,0,66.31 ,53.63 ,66.31 
03,001,02,012,0556,0,2335,46,2381,4156,0,0,0,0,0,0,0,66.31 ,57.29 ,66.31 
03,001,02,012,0557,0,2188,41,2229,3771,0,0,0,0,0,0,0,66.31 ,59.11 ,66.31 
03,001,02,012,0558,0,545,8,553,876,0,0,0,0,0,0,0,66.31 ,63.13 ,66.31 
03,001,02,012,0559,0,1107,8,1115,2105,0,0,0,0,0,0,0,66.31 ,52.97 ,66.31 
03,001,02,012,0560,0,787,11,798,1136,0,0,0,0,0,0,0,66.31 ,70.25 ,66.31 
03,001,02,012,0561,0,809,19,828,1067,0,0,0,0,0,0,0,66.31 ,77.60 ,66.31 
03,001,02,012,0562,0,5462,65,5527,9477,0,0,0,0,0,0,0,66.31 ,58.32 ,66.31 
03,001,02,012,0563,0,4119,77,4196,7033,0,0,0,0,0,0,0,66.31 ,59.66 ,66.31 
03,001,02,012,0564,0,925,18,943,1548,0,0,0,0,0,0,0,66.31 ,60.92 ,66.31 
03,001,02,012,0565,0,4771,75,4846,7978,0,0,0,0,0,0,0,66.31 ,60.74 ,66.31 
03,001,02,012,0566,0,2279,48,2327,3573,0,0,0,0,0,0,0,66.31 ,65.13 ,66.31 
03,001,02,012,0567,0,1028,19,1047,1543,0,0,0,0,0,0,0,66.31 ,67.85 ,66.31 
03,001,02,012,0568,0,678,12,690,988,0,0,0,0,0,0,0,66.31 ,69.84 ,66.31 
03,001,02,012,0569,0,561,8,569,804,0,0,0,0,0,0,0,66.31 ,70.77 ,66.31 
03,001,02,012,0570,0,883,17,900,1385,0,0,0,0,0,0,0,66.31 ,64.98 ,66.31 
03,001,02,012,0571,0,496,13,509,731,0,0,0,0,0,0,0,66.31 ,69.63 ,66.31 
03,001,02,012,0572,0,479,4,483,748,0,0,0,0,0,0,0,66.31 ,64.57 ,66.31 
03,001,02,012,0573,0,327,10,337,498,0,0,0,0,0,0,0,66.31 ,67.67 ,66.31 
03,001,02,012,0574,0,679,9,688,1061,0,0,0,0,0,0,0,66.31 ,64.84 ,66.31 
03,001,02,012,0575,0,1970,27,1997,3214,0,0,0,0,0,0,0,66.31 ,62.13 ,66.31 
03,001,02,012,0576,0,2333,38,2371,3855,0,0,0,0,0,0,0,66.31 ,61.50 ,66.31 
03,001,02,013,0577,0,2183,50,2233,3461,0,0,0,0,0,0,0,66.31 ,64.52 ,66.31 
03,001,02,013,0578,0,1171,23,1194,1823,0,0,0,0,0,0,0,66.31 ,65.50 ,66.31 
03,001,02,013,0579,0,828,14,842,1149,0,0,0,0,0,0,0,66.31 ,73.28 ,66.31 
03,001,02,013,0580,0,1217,15,1232,1970,0,0,0,0,0,0,0,66.31 ,62.54 ,66.31 
03,001,02,013,0581,0,602,21,623,865,0,0,0,0,0,0,0,66.31 ,72.02 ,66.31 
03,001,02,013,0582,0,1891,35,1926,3267,0,0,0,0,0,0,0,66.31 ,58.95 ,66.31 
03,001,02,013,0583,0,1370,28,1398,2077,0,0,0,0,0,0,0,66.31 ,67.31 ,66.31 
03,001,02,013,0584,0,682,15,697,916,0,0,0,0,0,0,0,66.31 ,76.09 ,66.31 
03,001,02,013,0585,0,788,14,802,951,0,0,0,0,0,0,0,66.31 ,84.33 ,66.31 
03,001,02,013,0586,0,765,10,775,1030,0,0,0,0,0,0,0,66.31 ,75.24 ,66.31 
03,001,02,014,0587,0,219,1,220,335,0,0,0,0,0,0,0,66.31 ,65.67 ,66.31 
03,001,02,014,0588,0,1954,27,1981,3208,0,0,0,0,0,0,0,66.31 ,61.75 ,66.31 
03,001,02,014,0589,0,568,8,576,808,0,0,0,0,0,0,0,66.31 ,71.29 ,66.31 
03,001,02,014,0590,0,490,5,495,794,0,0,0,0,0,0,0,66.31 ,62.34 ,66.31 
03,001,02,014,0591,0,2514,32,2546,4121,0,0,0,0,0,0,0,66.31 ,61.78 ,66.31 
03,001,02,014,0592,0,228,2,230,413,0,0,0,0,0,0,0,66.31 ,55.69 ,66.31 
03,001,02,014,0593,0,369,5,374,536,0,0,0,0,0,0,0,66.31 ,69.78 ,66.31 
03,001,02,014,0594,0,469,6,475,779,0,0,0,0,0,0,0,66.31 ,60.98 ,66.31 
03,001,02,014,0595,0,729,20,749,1248,0,0,0,0,0,0,0,66.31 ,60.02 ,66.31 
03,001,02,014,0596,0,359,5,364,577,0,0,0,0,0,0,0,66.31 ,63.08 ,66.31 
03,001,02,014,0597,0,302,5,307,500,0,0,0,0,0,0,0,66.31 ,61.40 ,66.31 
03,001,02,014,0598,0,423,7,430,641,0,0,0,0,0,0,0,66.31 ,67.08 ,66.31 
03,001,02,014,0599,0,683,3,686,1117,0,0,0,0,0,0,0,66.31 ,61.41 ,66.31 
03,001,02,015,0600,0,515,3,518,752,0,0,0,0,0,0,0,66.31 ,68.88 ,66.31 
03,001,02,015,0601,0,648,6,654,1002,0,0,0,0,0,0,0,66.31 ,65.27 ,66.31 
03,001,02,015,0602,0,991,34,1025,1534,0,0,0,0,0,0,0,66.31 ,66.82 ,66.31 
03,001,02,015,0603,0,431,5,436,638,0,0,0,0,0,0,0,66.31 ,68.34 ,66.31 
03,001,02,015,0604,0,727,7,734,1046,0,0,0,0,0,0,0,66.31 ,70.17 ,66.31 
03,001,02,015,0605,0,735,10,745,1091,0,0,0,0,0,0,0,66.31 ,68.29 ,66.31 
03,001,02,015,0606,0,151,2,153,268,0,0,0,0,0,0,0,66.31 ,57.09 ,66.31 
03,001,02,015,0607,0,351,6,357,511,0,0,0,0,0,0,0,66.31 ,69.86 ,66.31 
03,001,02,015,0608,0,449,7,456,652,0,0,0,0,0,0,0,66.31 ,69.94 ,66.31 
03,001,02,016,0609,0,269,4,273,437,0,0,0,0,0,0,0,66.31 ,62.47 ,66.31 
03,001,02,016,0610,0,424,5,429,645,0,0,0,0,0,0,0,66.31 ,66.51 ,66.31 
03,001,02,016,0611,0,293,2,295,445,0,0,0,0,0,0,0,66.31 ,66.29 ,66.31 
03,001,02,016,0612,0,859,9,868,1409,0,0,0,0,0,0,0,66.31 ,61.60 ,66.31 
03,001,02,016,0613,0,3630,33,3663,5829,0,0,0,0,0,0,0,66.31 ,62.84 ,66.31 
03,001,02,016,0614,0,874,12,886,1377,0,0,0,0,0,0,0,66.31 ,64.34 ,66.31 
03,001,02,016,0615,0,469,3,472,823,0,0,0,0,0,0,0,66.31 ,57.35 ,66.31 
03,001,02,016,0616,0,242,3,245,368,0,0,0,0,0,0,0,66.31 ,66.58 ,66.31 
03,001,02,016,0617,0,336,2,338,515,0,0,0,0,0,0,0,66.31 ,65.63 ,66.31 
03,001,02,016,0618,0,343,4,347,545,0,0,0,0,0,0,0,66.31 ,63.67 ,66.31 
03,001,02,016,0619,0,469,9,478,765,0,0,0,0,0,0,0,66.31 ,62.48 ,66.31 
03,001,02,016,0620,0,147,0,147,239,0,0,0,0,0,0,0,66.31 ,61.51 ,66.31 
03,001,02,016,0621,0,273,7,280,429,0,0,0,0,0,0,0,66.31 ,65.27 ,66.31 
03,001,02,016,0622,0,317,1,318,552,0,0,0,0,0,0,0,66.31 ,57.61 ,66.31 
03,001,02,017,0623,0,1869,23,1892,2908,0,0,0,0,0,0,0,66.31 ,65.06 ,66.31 
03,001,02,017,0624,0,1081,21,1102,1911,0,0,0,0,0,0,0,66.31 ,57.67 ,66.31 
03,001,02,017,0625,0,974,11,985,1537,0,0,0,0,0,0,0,66.31 ,64.09 ,66.31 
03,001,02,017,0626,0,1261,17,1278,2130,0,0,0,0,0,0,0,66.31 ,60.00 ,66.31 
03,001,02,017,0627,0,1307,20,1327,2051,0,0,0,0,0,0,0,66.31 ,64.70 ,66.31 
03,001,02,017,0628,0,309,4,313,455,0,0,0,0,0,0,0,66.31 ,68.79 ,66.31 
03,001,02,017,0629,0,446,5,451,758,0,0,0,0,0,0,0,66.31 ,59.50 ,66.31 
03,001,02,017,0630,0,314,3,317,538,0,0,0,0,0,0,0,66.31 ,58.92 ,66.31 
03,001,02,017,0631,0,308,3,311,564,0,0,0,0,0,0,0,66.31 ,55.14 ,66.31 
03,001,02,017,0632,0,464,17,481,767,0,0,0,0,0,0,0,66.31 ,62.71 ,66.31 
03,001,03,018,0633,0,1361,18,1379,2545,0,0,0,0,0,0,0,66.31 ,54.18 ,66.31 
03,001,03,018,0634,0,779,6,785,1282,0,0,0,0,0,0,0,66.31 ,61.23 ,66.31 
03,001,03,018,0635,0,2567,32,2599,4355,0,0,0,0,0,0,0,66.31 ,59.68 ,66.31 
03,001,03,018,0636,0,1784,25,1809,3063,0,0,0,0,0,0,0,66.31 ,59.06 ,66.31 
03,001,03,018,0637,0,1039,12,1051,1883,0,0,0,0,0,0,0,66.31 ,55.82 ,66.31 
03,001,03,018,0638,0,1855,30,1885,3151,0,0,0,0,0,0,0,66.31 ,59.82 ,66.31 
03,001,03,018,0639,0,1631,18,1649,2696,0,0,0,0,0,0,0,66.31 ,61.16 ,66.31 
03,001,03,018,0640,0,1628,24,1652,2618,0,0,0,0,0,0,0,66.31 ,63.10 ,66.31 
03,001,03,018,0641,0,2127,25,2152,3582,0,0,0,0,0,0,0,66.31 ,60.08 ,66.31 
03,001,03,018,0642,0,1872,37,1909,3333,0,0,0,0,0,0,0,66.31 ,57.28 ,66.31 
03,001,03,018,0643,0,1818,18,1836,2912,0,0,0,0,0,0,0,66.31 ,63.05 ,66.31 
03,001,03,018,0644,0,2329,26,2355,3753,0,0,0,0,0,0,0,66.31 ,62.75 ,66.31 
03,001,03,018,0645,0,1927,32,1959,3255,0,0,0,0,0,0,0,66.31 ,60.18 ,66.31 
03,001,03,018,0646,0,2076,21,2097,3700,0,0,0,0,0,0,0,66.31 ,56.68 ,66.31 
03,001,03,018,0647,0,1744,18,1762,2995,0,0,0,0,0,0,0,66.31 ,58.83 ,66.31 
03,001,03,018,0648,0,2220,35,2255,3814,0,0,0,0,0,0,0,66.31 ,59.12 ,66.31 
03,001,03,018,0649,0,2342,34,2376,4140,0,0,0,0,0,0,0,66.31 ,57.39 ,66.31 
03,001,03,018,0650,0,1788,21,1809,3048,0,0,0,0,0,0,0,66.31 ,59.35 ,66.31 
03,001,03,018,0651,0,1960,31,1991,3598,0,0,0,0,0,0,0,66.31 ,55.34 ,66.31 
03,001,03,018,0652,0,1846,44,1890,3255,0,0,0,0,0,0,0,66.31 ,58.06 ,66.31 
03,001,03,018,0653,0,1985,39,2024,3294,0,0,0,0,0,0,0,66.31 ,61.45 ,66.31 
03,001,03,018,0654,0,1818,19,1837,2969,0,0,0,0,0,0,0,66.31 ,61.87 ,66.31 
03,001,03,018,0655,0,1083,15,1098,1783,0,0,0,0,0,0,0,66.31 ,61.58 ,66.31 
03,001,03,018,0656,0,2025,32,2057,3303,0,0,0,0,0,0,0,66.31 ,62.28 ,66.31 
03,001,03,018,0657,0,1240,24,1264,2268,0,0,0,0,0,0,0,66.31 ,55.73 ,66.31 
03,001,03,018,0658,0,1023,13,1036,1625,0,0,0,0,0,0,0,66.31 ,63.75 ,66.31 
03,001,03,018,0659,0,1576,22,1598,2557,0,0,0,0,0,0,0,66.31 ,62.50 ,66.31 
03,001,03,018,0660,0,1413,20,1433,2316,0,0,0,0,0,0,0,66.31 ,61.87 ,66.31 
03,001,03,018,0661,0,1933,22,1955,3227,0,0,0,0,0,0,0,66.31 ,60.58 ,66.31 
03,001,03,018,0662,0,2422,26,2448,3783,0,0,0,0,0,0,0,66.31 ,64.71 ,66.31 
03,001,03,018,0663,0,1910,21,1931,3005,0,0,0,0,0,0,0,66.31 ,64.26 ,66.31 
03,001,03,018,0664,0,1939,30,1969,3169,0,0,0,0,0,0,0,66.31 ,62.13 ,66.31 
03,001,03,018,0665,0,1965,36,2001,3351,0,0,0,0,0,0,0,66.31 ,59.71 ,66.31 
03,001,03,018,0666,0,1605,24,1629,2748,0,0,0,0,0,0,0,66.31 ,59.28 ,66.31 
03,001,03,018,0667,0,1316,29,1345,2214,0,0,0,0,0,0,0,66.31 ,60.75 ,66.31 
03,001,03,018,0668,0,2352,24,2376,3762,0,0,0,0,0,0,0,66.31 ,63.16 ,66.31 
03,001,03,018,0669,0,2659,36,2695,4513,0,0,0,0,0,0,0,66.31 ,59.72 ,66.31 
03,001,03,018,0670,0,1742,19,1761,2840,0,0,0,0,0,0,0,66.31 ,62.01 ,66.31 
03,001,03,018,0671,0,1558,14,1572,2672,0,0,0,0,0,0,0,66.31 ,58.83 ,66.31 
03,001,03,018,0672,0,1271,30,1301,2077,0,0,0,0,0,0,0,66.31 ,62.64 ,66.31 
03,001,03,018,0673,0,1995,30,2025,3360,0,0,0,0,0,0,0,66.31 ,60.27 ,66.31 
03,001,03,018,0674,0,1388,23,1411,2305,0,0,0,0,0,0,0,66.31 ,61.21 ,66.31 
03,001,03,018,0675,0,1774,36,1810,3155,0,0,0,0,0,0,0,66.31 ,57.37 ,66.31 
03,001,03,018,0676,0,1474,22,1496,2433,0,0,0,0,0,0,0,66.31 ,61.49 ,66.31 
03,001,03,018,0677,0,2110,30,2140,4009,0,0,0,0,0,0,0,66.31 ,53.38 ,66.31 
03,001,03,018,0678,0,2561,39,2600,4123,0,0,0,0,0,0,0,66.31 ,63.06 ,66.31 
03,001,03,018,0679,0,1649,25,1674,2896,0,0,0,0,0,0,0,66.31 ,57.80 ,66.31 
03,001,03,018,0680,0,2206,38,2244,4016,0,0,0,0,0,0,0,66.31 ,55.88 ,66.31 
03,001,03,018,0681,0,1714,27,1741,2773,0,0,0,0,0,0,0,66.31 ,62.78 ,66.31 
03,001,03,018,0682,0,1735,31,1766,2925,0,0,0,0,0,0,0,66.31 ,60.38 ,66.31 
03,001,03,018,0683,0,1648,22,1670,2758,0,0,0,0,0,0,0,66.31 ,60.55 ,66.31 
03,001,03,018,0684,0,1123,16,1139,1866,0,0,0,0,0,0,0,66.31 ,61.04 ,66.31 
03,001,03,018,0685,0,200,3,203,305,0,0,0,0,0,0,0,66.31 ,66.56 ,66.31 
03,001,03,018,0686,0,2422,35,2457,4045,0,0,0,0,0,0,0,66.31 ,60.74 ,66.31 
03,001,03,018,0687,0,1354,22,1376,2250,0,0,0,0,0,0,0,66.31 ,61.16 ,66.31 
03,001,03,018,0688,0,1812,46,1858,3146,0,0,0,0,0,0,0,66.31 ,59.06 ,66.31 
03,001,03,018,0689,0,1789,23,1812,3067,0,0,0,0,0,0,0,66.31 ,59.08 ,66.31 
03,001,03,018,0690,0,1965,33,1998,3388,0,0,0,0,0,0,0,66.31 ,58.97 ,66.31 
03,001,03,018,0691,0,1068,17,1085,1892,0,0,0,0,0,0,0,66.31 ,57.35 ,66.31 
03,001,03,018,0692,0,2653,29,2682,4412,0,0,0,0,0,0,0,66.31 ,60.79 ,66.31 
03,001,03,018,0693,0,1625,26,1651,2736,0,0,0,0,0,0,0,66.31 ,60.34 ,66.31 
03,001,03,018,0694,0,1984,22,2006,3490,0,0,0,0,0,0,0,66.31 ,57.48 ,66.31 
03,001,03,018,0695,0,1791,15,1806,2906,0,0,0,0,0,0,0,66.31 ,62.15 ,66.31 
03,001,03,018,0696,0,2294,36,2330,4092,0,0,0,0,0,0,0,66.31 ,56.94 ,66.31 
03,001,03,018,0697,0,2441,33,2474,3913,0,0,0,0,0,0,0,66.31 ,63.23 ,66.31 
03,001,03,018,0698,0,1455,23,1478,2406,0,0,0,0,0,0,0,66.31 ,61.43 ,66.31 
03,001,03,018,0699,0,1284,15,1299,2159,0,0,0,0,0,0,0,66.31 ,60.17 ,66.31 
03,001,03,018,0700,0,1551,17,1568,2643,0,0,0,0,0,0,0,66.31 ,59.33 ,66.31 
03,001,03,018,0701,0,842,8,850,1407,0,0,0,0,0,0,0,66.31 ,60.41 ,66.31 
03,001,03,018,0702,0,1512,22,1534,2634,0,0,0,0,0,0,0,66.31 ,58.24 ,66.31 
03,001,03,018,0703,0,300,1,301,483,0,0,0,0,0,0,0,66.31 ,62.32 ,66.31 
03,001,03,018,0704,0,2240,23,2263,3835,0,0,0,0,0,0,0,66.31 ,59.01 ,66.31 
03,001,03,018,0705,0,1368,16,1384,2026,0,0,0,0,0,0,0,66.31 ,68.31 ,66.31 
03,001,03,018,0706,0,1536,22,1558,2552,0,0,0,0,0,0,0,66.31 ,61.05 ,66.31 
03,001,03,018,0707,0,1805,24,1829,3209,0,0,0,0,0,0,0,66.31 ,57.00 ,66.31 
03,001,03,018,0708,0,919,24,943,1821,0,0,0,0,0,0,0,66.31 ,51.78 ,66.31 
03,001,03,018,0709,0,1257,17,1274,2149,0,0,0,0,0,0,0,66.31 ,59.28 ,66.31 
03,001,03,018,0710,0,1449,18,1467,2871,0,0,0,0,0,0,0,66.31 ,51.10 ,66.31 
03,001,03,018,0711,0,2339,30,2369,4266,0,0,0,0,0,0,0,66.31 ,55.53 ,66.31 
03,001,03,018,0712,0,1548,27,1575,2838,0,0,0,0,0,0,0,66.31 ,55.50 ,66.31 
03,001,03,018,0713,0,2018,28,2046,3540,0,0,0,0,0,0,0,66.31 ,57.80 ,66.31 
03,001,03,018,0714,0,1571,20,1591,2814,0,0,0,0,0,0,0,66.31 ,56.54 ,66.31 
03,001,03,018,0715,0,1092,10,1102,1797,0,0,0,0,0,0,0,66.31 ,61.32 ,66.31 
03,001,03,018,0716,0,1622,13,1635,2712,0,0,0,0,0,0,0,66.31 ,60.29 ,66.31 
03,001,03,018,0717,0,1728,25,1753,3033,0,0,0,0,0,0,0,66.31 ,57.80 ,66.31 
03,001,03,018,0718,0,1414,40,1454,2488,0,0,0,0,0,0,0,66.31 ,58.44 ,66.31 
03,001,03,018,0719,0,1923,30,1953,3468,0,0,0,0,0,0,0,66.31 ,56.31 ,66.31 
03,001,03,018,0720,0,2207,33,2240,3747,0,0,0,0,0,0,0,66.31 ,59.78 ,66.31 
03,001,03,018,0721,0,1644,23,1667,2797,0,0,0,0,0,0,0,66.31 ,59.60 ,66.31 
03,001,03,018,0722,0,1621,10,1631,2879,0,0,0,0,0,0,0,66.31 ,56.65 ,66.31 
03,001,03,018,0723,0,1255,19,1274,2369,0,0,0,0,0,0,0,66.31 ,53.78 ,66.31 
03,001,03,018,0724,0,1007,11,1018,1638,0,0,0,0,0,0,0,66.31 ,62.15 ,66.31 
03,001,03,018,0725,0,1755,20,1775,3089,0,0,0,0,0,0,0,66.31 ,57.46 ,66.31 
03,001,03,019,0726,0,912,19,931,1546,0,0,0,0,0,0,0,66.31 ,60.22 ,66.31 
03,001,03,019,0727,0,554,11,565,1045,0,0,0,0,0,0,0,66.31 ,54.07 ,66.31 
03,001,03,019,0728,0,1117,14,1131,2010,0,0,0,0,0,0,0,66.31 ,56.27 ,66.31 
03,001,03,019,0729,0,1860,28,1888,3373,0,0,0,0,0,0,0,66.31 ,55.97 ,66.31 
03,001,03,019,0730,0,1704,20,1724,3012,0,0,0,0,0,0,0,66.31 ,57.24 ,66.31 
03,001,03,019,0731,0,1862,17,1879,3227,0,0,0,0,0,0,0,66.31 ,58.23 ,66.31 
03,001,03,019,0732,0,1826,12,1838,3164,0,0,0,0,0,0,0,66.31 ,58.09 ,66.31 
03,001,03,019,0733,0,689,12,701,1226,0,0,0,0,0,0,0,66.31 ,57.18 ,66.31 
03,001,03,019,0734,0,1477,12,1489,2693,0,0,0,0,0,0,0,66.31 ,55.29 ,66.31 
03,001,03,019,0735,0,1697,20,1717,3129,0,0,0,0,0,0,0,66.31 ,54.87 ,66.31 
03,001,03,019,0736,0,1138,13,1151,2048,0,0,0,0,0,0,0,66.31 ,56.20 ,66.31 
03,001,03,019,0737,0,1658,12,1670,2918,0,0,0,0,0,0,0,66.31 ,57.23 ,66.31 
03,001,03,019,0738,0,1560,12,1572,2600,0,0,0,0,0,0,0,66.31 ,60.46 ,66.31 
03,001,03,019,0739,0,2035,22,2057,3670,0,0,0,0,0,0,0,66.31 ,56.05 ,66.31 
03,001,03,019,0740,0,2125,15,2140,3490,0,0,0,0,0,0,0,66.31 ,61.32 ,66.31 
03,001,03,019,0741,0,1748,22,1770,3037,0,0,0,0,0,0,0,66.31 ,58.28 ,66.31 
03,001,03,019,0742,0,1487,16,1503,2456,0,0,0,0,0,0,0,66.31 ,61.20 ,66.31 
03,001,03,019,0743,0,1476,18,1494,2475,0,0,0,0,0,0,0,66.31 ,60.36 ,66.31 
03,001,03,019,0744,0,1981,21,2002,3354,0,0,0,0,0,0,0,66.31 ,59.69 ,66.31 
03,001,03,019,0745,0,2226,19,2245,3801,0,0,0,0,0,0,0,66.31 ,59.06 ,66.31 
03,001,03,019,0746,0,2151,24,2175,3556,0,0,0,0,0,0,0,66.31 ,61.16 ,66.31 
03,001,03,019,0747,0,2177,15,2192,3491,0,0,0,0,0,0,0,66.31 ,62.79 ,66.31 
03,001,03,019,0748,0,1853,24,1877,3207,0,0,0,0,0,0,0,66.31 ,58.53 ,66.31 
03,001,03,019,0749,0,1389,18,1407,2251,0,0,0,0,0,0,0,66.31 ,62.51 ,66.31 
03,001,03,019,0750,0,1718,9,1727,2771,0,0,0,0,0,0,0,66.31 ,62.32 ,66.31 
03,001,03,019,0751,0,1143,10,1153,1959,0,0,0,0,0,0,0,66.31 ,58.86 ,66.31 
03,001,03,019,0752,0,1552,19,1571,2627,0,0,0,0,0,0,0,66.31 ,59.80 ,66.31 
03,001,03,019,0753,0,2006,24,2030,3402,0,0,0,0,0,0,0,66.31 ,59.67 ,66.31 
03,001,03,019,0754,0,1389,17,1406,2294,0,0,0,0,0,0,0,66.31 ,61.29 ,66.31 
03,001,03,019,0755,0,1349,18,1367,2284,0,0,0,0,0,0,0,66.31 ,59.85 ,66.31 
03,001,03,019,0756,0,1904,28,1932,3202,0,0,0,0,0,0,0,66.31 ,60.34 ,66.31 
03,001,03,019,0757,0,1443,13,1456,2549,0,0,0,0,0,0,0,66.31 ,57.12 ,66.31 
03,001,03,019,0758,0,1848,19,1867,3060,0,0,0,0,0,0,0,66.31 ,61.01 ,66.31 
03,001,03,019,0759,0,1953,22,1975,3464,0,0,0,0,0,0,0,66.31 ,57.02 ,66.31 
03,001,03,019,0760,0,1929,17,1946,3337,0,0,0,0,0,0,0,66.31 ,58.32 ,66.31 
03,001,03,019,0761,0,1703,21,1724,3056,0,0,0,0,0,0,0,66.31 ,56.41 ,66.31 
03,001,03,019,0762,0,1080,18,1098,1826,0,0,0,0,0,0,0,66.31 ,60.13 ,66.31 
03,001,03,019,0763,0,1771,19,1790,3074,0,0,0,0,0,0,0,66.31 ,58.23 ,66.31 
03,001,03,019,0764,0,1098,7,1105,1934,0,0,0,0,0,0,0,66.31 ,57.14 ,66.31 
03,001,03,019,0765,0,1979,26,2005,3258,0,0,0,0,0,0,0,66.31 ,61.54 ,66.31 
03,001,03,019,0766,0,1535,17,1552,2613,0,0,0,0,0,0,0,66.31 ,59.40 ,66.31 
03,001,03,019,0767,0,1775,23,1798,2956,0,0,0,0,0,0,0,66.31 ,60.83 ,66.31 
03,001,03,019,0768,0,1756,27,1783,2892,0,0,0,0,0,0,0,66.31 ,61.65 ,66.31 
03,001,03,019,0769,0,983,12,995,1675,0,0,0,0,0,0,0,66.31 ,59.40 ,66.31 
03,001,03,019,0770,0,1872,24,1896,3260,0,0,0,0,0,0,0,66.31 ,58.16 ,66.31 
03,001,03,019,0771,0,2011,23,2034,3187,0,0,0,0,0,0,0,66.31 ,63.82 ,66.31 
03,001,03,019,0772,0,2083,22,2105,3514,0,0,0,0,0,0,0,66.31 ,59.90 ,66.31 
03,001,03,019,0773,0,2209,26,2235,3856,0,0,0,0,0,0,0,66.31 ,57.96 ,66.31 
03,001,03,019,0774,0,1479,16,1495,2634,0,0,0,0,0,0,0,66.31 ,56.76 ,66.31 
03,001,03,019,0775,0,1684,28,1712,2885,0,0,0,0,0,0,0,66.31 ,59.34 ,66.31 
03,001,03,019,0776,0,701,15,716,1000,0,0,0,0,0,0,0,66.31 ,71.60 ,66.31 
03,001,03,019,0777,0,520,19,539,825,0,0,0,0,0,0,0,66.31 ,65.33 ,66.31 
03,001,03,019,0778,0,612,15,627,1006,0,0,0,0,0,0,0,66.31 ,62.33 ,66.31 
03,001,03,019,0779,0,472,13,485,732,0,0,0,0,0,0,0,66.31 ,66.26 ,66.31 
03,001,03,019,0780,0,1526,33,1559,2491,0,0,0,0,0,0,0,66.31 ,62.59 ,66.31 
03,001,03,019,0781,0,1154,16,1170,2060,0,0,0,0,0,0,0,66.31 ,56.80 ,66.31 
03,001,03,019,0782,0,1156,14,1170,1974,0,0,0,0,0,0,0,66.31 ,59.27 ,66.31 
03,001,03,019,0783,0,896,13,909,1522,0,0,0,0,0,0,0,66.31 ,59.72 ,66.31 
03,001,03,019,0784,0,1107,8,1115,1903,0,0,0,0,0,0,0,66.31 ,58.59 ,66.31 
03,001,03,019,0785,0,1198,19,1217,2025,0,0,0,0,0,0,0,66.31 ,60.10 ,66.31 
03,001,03,019,0786,0,1102,10,1112,1845,0,0,0,0,0,0,0,66.31 ,60.27 ,66.31 
03,001,03,019,0787,0,1373,12,1385,2208,0,0,0,0,0,0,0,66.31 ,62.73 ,66.31 
03,001,03,020,0788,0,917,9,926,1440,0,0,0,0,0,0,0,66.31 ,64.31 ,66.31 
03,001,03,020,0789,0,697,13,710,1146,0,0,0,0,0,0,0,66.31 ,61.95 ,66.31 
03,001,03,020,0790,0,1150,12,1162,2012,0,0,0,0,0,0,0,66.31 ,57.75 ,66.31 
03,001,03,020,0791,0,763,16,779,1334,0,0,0,0,0,0,0,66.31 ,58.40 ,66.31 
03,001,03,020,0792,0,510,6,516,792,0,0,0,0,0,0,0,66.31 ,65.15 ,66.31 
03,001,03,020,0793,0,1377,18,1395,2073,0,0,0,0,0,0,0,66.31 ,67.29 ,66.31 
03,001,03,020,0794,0,2131,22,2153,3714,0,0,0,0,0,0,0,66.31 ,57.97 ,66.31 
03,001,03,020,0795,0,2341,28,2369,3785,0,0,0,0,0,0,0,66.31 ,62.59 ,66.31 
03,001,03,020,0796,0,1444,19,1463,2391,0,0,0,0,0,0,0,66.31 ,61.19 ,66.31 
03,001,03,020,0797,0,3030,32,3062,5186,0,0,0,0,0,0,0,66.31 ,59.04 ,66.31 
03,001,03,020,0798,0,3064,34,3098,5367,0,0,0,0,0,0,0,66.31 ,57.72 ,66.31 
03,001,03,020,0799,0,974,6,980,1619,0,0,0,0,0,0,0,66.31 ,60.53 ,66.31 
03,001,03,020,0800,0,1747,19,1766,3039,0,0,0,0,0,0,0,66.31 ,58.11 ,66.31 
03,001,03,020,0801,0,1296,23,1319,2182,0,0,0,0,0,0,0,66.31 ,60.45 ,66.31 
03,001,03,020,0802,0,3161,37,3198,5265,0,0,0,0,0,0,0,66.31 ,60.74 ,66.31 
03,001,03,020,0803,0,1997,19,2016,3390,0,0,0,0,0,0,0,66.31 ,59.47 ,66.31 
03,001,03,020,0804,0,1362,13,1375,2253,0,0,0,0,0,0,0,66.31 ,61.03 ,66.31 
03,001,03,020,0805,0,1586,12,1598,2697,0,0,0,0,0,0,0,66.31 ,59.25 ,66.31 
03,001,03,020,0806,0,2137,26,2163,3575,0,0,0,0,0,0,0,66.31 ,60.50 ,66.31 
03,001,03,020,0807,0,1447,20,1467,2516,0,0,0,0,0,0,0,66.31 ,58.31 ,66.31 
03,001,03,020,0808,0,1988,24,2012,3296,0,0,0,0,0,0,0,66.31 ,61.04 ,66.31 
03,001,03,020,0809,0,1515,13,1528,2469,0,0,0,0,0,0,0,66.31 ,61.89 ,66.31 
03,001,03,020,0810,0,1784,19,1803,3006,0,0,0,0,0,0,0,66.31 ,59.98 ,66.31 
03,001,03,020,0811,0,693,13,706,1198,0,0,0,0,0,0,0,66.31 ,58.93 ,66.31 
03,001,03,020,0812,0,570,11,581,869,0,0,0,0,0,0,0,66.31 ,66.86 ,66.31 
03,001,03,020,0813,0,1430,10,1440,2418,0,0,0,0,0,0,0,66.31 ,59.55 ,66.31 
03,001,03,020,0814,0,1853,25,1878,3100,0,0,0,0,0,0,0,66.31 ,60.58 ,66.31 
03,001,03,020,0815,0,1979,14,1993,3357,0,0,0,0,0,0,0,66.31 ,59.37 ,66.31 
03,001,03,020,0816,0,1816,14,1830,2942,0,0,0,0,0,0,0,66.31 ,62.20 ,66.31 
03,001,03,020,0817,0,1904,15,1919,3077,0,0,0,0,0,0,0,66.31 ,62.37 ,66.31 
03,001,03,020,0818,0,2023,24,2047,3482,0,0,0,0,0,0,0,66.31 ,58.79 ,66.31 
03,001,03,020,0819,0,1315,24,1339,2391,0,0,0,0,0,0,0,66.31 ,56.00 ,66.31 
03,001,03,020,0820,0,2061,20,2081,3462,0,0,0,0,0,0,0,66.31 ,60.11 ,66.31 
03,001,03,020,0821,0,2160,32,2192,3668,0,0,0,0,0,0,0,66.31 ,59.76 ,66.31 
03,001,03,020,0822,0,2607,17,2624,4435,0,0,0,0,0,0,0,66.31 ,59.17 ,66.31 
03,001,03,020,0823,0,2448,25,2473,4242,0,0,0,0,0,0,0,66.31 ,58.30 ,66.31 
03,001,03,020,0824,0,1501,23,1524,2513,0,0,0,0,0,0,0,66.31 ,60.64 ,66.31 
03,001,03,020,0825,0,202,6,208,339,0,0,0,0,0,0,0,66.31 ,61.36 ,66.31 
03,001,03,020,0826,0,1364,22,1386,2134,0,0,0,0,0,0,0,66.31 ,64.95 ,66.31 
03,001,03,020,0827,0,1236,15,1251,2038,0,0,0,0,0,0,0,66.31 ,61.38 ,66.31 
03,001,03,020,0828,0,822,13,835,1405,0,0,0,0,0,0,0,66.31 ,59.43 ,66.31 
03,001,03,020,0829,0,1025,13,1038,1697,0,0,0,0,0,0,0,66.31 ,61.17 ,66.31 
03,001,03,020,0830,0,2656,28,2684,4700,0,0,0,0,0,0,0,66.31 ,57.11 ,66.31 
03,001,03,020,0831,0,2169,32,2201,3729,0,0,0,0,0,0,0,66.31 ,59.02 ,66.31 
03,001,03,020,0832,0,2123,19,2142,3651,0,0,0,0,0,0,0,66.31 ,58.67 ,66.31 
03,001,03,020,0833,0,1678,13,1691,2963,0,0,0,0,0,0,0,66.31 ,57.07 ,66.31 
03,001,03,020,0834,0,1738,26,1764,3006,0,0,0,0,0,0,0,66.31 ,58.68 ,66.31 
03,001,03,020,0835,0,3037,41,3078,5307,0,0,0,0,0,0,0,66.31 ,58.00 ,66.31 
03,001,03,020,0836,0,1399,6,1405,2385,0,0,0,0,0,0,0,66.31 ,58.91 ,66.31 
03,001,03,020,0837,0,3070,38,3108,5144,0,0,0,0,0,0,0,66.31 ,60.42 ,66.31 
03,001,03,020,0838,0,1319,4,1323,2168,0,0,0,0,0,0,0,66.31 ,61.02 ,66.31 
03,001,03,020,0839,0,1642,19,1661,2692,0,0,0,0,0,0,0,66.31 ,61.70 ,66.31 
03,001,03,020,0840,0,2696,18,2714,4521,0,0,0,0,0,0,0,66.31 ,60.03 ,66.31 
03,001,03,020,0841,0,1654,17,1671,3267,0,0,0,0,0,0,0,66.31 ,51.15 ,66.31 
03,001,03,020,0842,0,2298,24,2322,4016,0,0,0,0,0,0,0,66.31 ,57.82 ,66.31 
03,001,03,020,0843,0,2345,25,2370,3803,0,0,0,0,0,0,0,66.31 ,62.32 ,66.31 
03,001,03,020,0844,0,1791,15,1806,3167,0,0,0,0,0,0,0,66.31 ,57.03 ,66.31 
03,001,03,020,0845,0,733,5,738,1313,0,0,0,0,0,0,0,66.31 ,56.21 ,66.31 
03,001,03,020,0846,0,1587,17,1604,2795,0,0,0,0,0,0,0,66.31 ,57.39 ,66.31 
03,001,03,020,0847,0,2087,28,2115,3430,0,0,0,0,0,0,0,66.31 ,61.66 ,66.31 
03,001,03,020,0848,0,1496,29,1525,2454,0,0,0,0,0,0,0,66.31 ,62.14 ,66.31 
03,001,03,020,0849,0,417,4,421,828,0,0,0,0,0,0,0,66.31 ,50.85 ,66.31 
03,001,03,020,0850,0,1135,14,1149,2090,0,0,0,0,0,0,0,66.31 ,54.98 ,66.31 
03,001,03,020,0851,0,1332,23,1355,2147,0,0,0,0,0,0,0,66.31 ,63.11 ,66.31 
03,001,03,020,0852,0,807,13,820,1353,0,0,0,0,0,0,0,66.31 ,60.61 ,66.31 
03,001,03,020,0853,0,624,12,636,1046,0,0,0,0,0,0,0,66.31 ,60.80 ,66.31 
03,001,03,020,0854,0,427,2,429,697,0,0,0,0,0,0,0,66.31 ,61.55 ,66.31 
03,001,03,021,0855,0,866,14,880,1651,0,0,0,0,0,0,0,66.31 ,53.30 ,66.31 
03,001,03,021,0856,0,997,19,1016,1735,0,0,0,0,0,0,0,66.31 ,58.56 ,66.31 
03,001,03,021,0857,0,1027,15,1042,1693,0,0,0,0,0,0,0,66.31 ,61.55 ,66.31 
03,001,03,021,0858,0,636,10,646,1180,0,0,0,0,0,0,0,66.31 ,54.75 ,66.31 
03,001,03,021,0859,0,1282,19,1301,2214,0,0,0,0,0,0,0,66.31 ,58.76 ,66.31 
03,001,03,021,0860,0,1819,18,1837,3254,0,0,0,0,0,0,0,66.31 ,56.45 ,66.31 
03,001,03,021,0861,0,803,15,818,1376,0,0,0,0,0,0,0,66.31 ,59.45 ,66.31 
03,001,03,021,0862,0,304,4,308,446,0,0,0,0,0,0,0,66.31 ,69.06 ,66.31 
03,001,03,022,0863,0,293,1,294,389,0,0,0,0,0,0,0,66.31 ,75.58 ,66.31 
03,001,03,022,0864,0,381,4,385,656,0,0,0,0,0,0,0,66.31 ,58.69 ,66.31 
03,001,03,022,0865,0,371,10,381,614,0,0,0,0,0,0,0,66.31 ,62.05 ,66.31 
03,001,03,022,0866,0,173,2,175,259,0,0,0,0,0,0,0,66.31 ,67.57 ,66.31 
03,001,03,022,0867,0,267,1,268,432,0,0,0,0,0,0,0,66.31 ,62.04 ,66.31 
03,001,03,022,0868,0,448,8,456,730,0,0,0,0,0,0,0,66.31 ,62.47 ,66.31 
03,001,03,022,0869,0,178,1,179,246,0,0,0,0,0,0,0,66.31 ,72.76 ,66.31 
03,001,03,022,0870,0,569,8,577,776,0,0,0,0,0,0,0,66.31 ,74.36 ,66.31 
03,001,03,022,0871,0,380,7,387,571,0,0,0,0,0,0,0,66.31 ,67.78 ,66.31 
03,001,03,022,0872,0,144,2,146,225,0,0,0,0,0,0,0,66.31 ,64.89 ,66.31 
03,001,03,022,0873,0,250,1,251,429,0,0,0,0,0,0,0,66.31 ,58.51 ,66.31 
03,001,03,022,0874,0,413,5,418,604,0,0,0,0,0,0,0,66.31 ,69.21 ,66.31 
03,001,03,023,0875,0,655,7,662,979,0,0,0,0,0,0,0,66.31 ,67.62 ,66.31 
03,001,03,023,0876,0,331,5,336,534,0,0,0,0,0,0,0,66.31 ,62.92 ,66.31 
03,001,03,023,0877,0,491,4,495,935,0,0,0,0,0,0,0,66.31 ,52.94 ,66.31 
03,001,03,023,0878,0,238,2,240,374,0,0,0,0,0,0,0,66.31 ,64.17 ,66.31 
03,001,03,023,0879,0,428,7,435,693,0,0,0,0,0,0,0,66.31 ,62.77 ,66.31 
03,001,03,023,0880,0,347,7,354,674,0,0,0,0,0,0,0,66.31 ,52.52 ,66.31 
03,001,03,023,0881,0,420,7,427,696,0,0,0,0,0,0,0,66.31 ,61.35 ,66.31 
03,001,03,024,0882,0,253,0,253,407,0,0,0,0,0,0,0,66.31 ,62.16 ,66.31 
03,001,03,024,0883,0,539,6,545,898,0,0,0,0,0,0,0,66.31 ,60.69 ,66.31 
03,001,03,024,0884,0,63,0,63,93,0,0,0,0,0,0,0,66.31 ,67.74 ,66.31 
03,001,03,024,0885,0,89,2,91,152,0,0,0,0,0,0,0,66.31 ,59.87 ,66.31 
03,001,03,024,0886,0,27,0,27,60,0,0,0,0,0,0,0,66.31 ,45.00 ,66.31 
03,001,03,025,0887,0,912,7,919,1448,0,0,0,0,0,0,0,66.31 ,63.47 ,66.31 
03,001,03,025,0888,0,708,7,715,1237,0,0,0,0,0,0,0,66.31 ,57.80 ,66.31 
03,001,03,025,0889,0,562,5,567,985,0,0,0,0,0,0,0,66.31 ,57.56 ,66.31 
03,001,03,025,0890,0,1392,10,1402,2676,0,0,0,0,0,0,0,66.31 ,52.39 ,66.31 
03,001,03,025,0891,0,933,12,945,1649,0,0,0,0,0,0,0,66.31 ,57.31 ,66.31 
03,001,03,025,0892,0,297,2,299,527,0,0,0,0,0,0,0,66.31 ,56.74 ,66.31 
03,001,03,025,0893,0,2272,32,2304,3946,0,0,0,0,0,0,0,66.31 ,58.39 ,66.31 
03,001,03,025,0894,0,804,15,819,1396,0,0,0,0,0,0,0,66.31 ,58.67 ,66.31 
03,001,03,025,0895,0,1633,21,1654,2783,0,0,0,0,0,0,0,66.31 ,59.43 ,66.31 
03,001,03,025,0896,0,1233,9,1242,2136,0,0,0,0,0,0,0,66.31 ,58.15 ,66.31 
03,001,03,025,0897,0,1682,12,1694,3046,0,0,0,0,0,0,0,66.31 ,55.61 ,66.31 
03,001,03,025,0898,0,1718,28,1746,2876,0,0,0,0,0,0,0,66.31 ,60.71 ,66.31 
03,001,03,025,0899,0,1421,22,1443,2478,0,0,0,0,0,0,0,66.31 ,58.23 ,66.31 
03,001,03,025,0900,0,1196,13,1209,2033,0,0,0,0,0,0,0,66.31 ,59.47 ,66.31 
03,001,03,025,0901,0,1502,23,1525,2675,0,0,0,0,0,0,0,66.31 ,57.01 ,66.31 
03,001,03,025,0902,0,1375,17,1392,2504,0,0,0,0,0,0,0,66.31 ,55.59 ,66.31 
03,001,03,025,0903,0,2411,26,2437,4540,0,0,0,0,0,0,0,66.31 ,53.68 ,66.31 
03,001,03,025,0904,0,813,7,820,1447,0,0,0,0,0,0,0,66.31 ,56.67 ,66.31 
03,001,03,025,0905,0,789,5,794,1250,0,0,0,0,0,0,0,66.31 ,63.52 ,66.31 
03,001,03,025,0906,0,267,3,270,454,0,0,0,0,0,0,0,66.31 ,59.47 ,66.31 
03,001,03,025,0907,0,1572,18,1590,2614,0,0,0,0,0,0,0,66.31 ,60.83 ,66.31 
03,001,03,025,0908,0,1059,17,1076,1656,0,0,0,0,0,0,0,66.31 ,64.98 ,66.31 
03,001,03,025,0909,0,2080,21,2101,3550,0,0,0,0,0,0,0,66.31 ,59.18 ,66.31 
03,001,03,025,0910,0,1808,20,1828,3652,0,0,0,0,0,0,0,66.31 ,50.05 ,66.31 
03,001,03,025,0911,0,639,6,645,1161,0,0,0,0,0,0,0,66.31 ,55.56 ,66.31 
03,001,03,025,0912,0,499,7,506,808,0,0,0,0,0,0,0,66.31 ,62.62 ,66.31 
03,001,03,025,0913,0,552,5,557,917,0,0,0,0,0,0,0,66.31 ,60.74 ,66.31 
03,001,03,025,0914,0,1599,11,1610,2832,0,0,0,0,0,0,0,66.31 ,56.85 ,66.31 
03,001,03,025,0915,0,1328,9,1337,2652,0,0,0,0,0,0,0,66.31 ,50.41 ,66.31 
03,001,03,025,0916,0,892,8,900,1521,0,0,0,0,0,0,0,66.31 ,59.17 ,66.31 
03,001,03,025,0917,0,1956,21,1977,3609,0,0,0,0,0,0,0,66.31 ,54.78 ,66.31 
03,001,03,025,0918,0,1255,17,1272,2334,0,0,0,0,0,0,0,66.31 ,54.50 ,66.31 
03,001,03,025,0919,0,425,3,428,905,0,0,0,0,0,0,0,66.31 ,47.29 ,66.31 
03,001,03,025,0920,0,2050,16,2066,4009,0,0,0,0,0,0,0,66.31 ,51.53 ,66.31 
03,001,03,025,0921,0,941,10,951,1975,0,0,0,0,0,0,0,66.31 ,48.15 ,66.31 
03,001,03,025,0922,0,884,5,889,1901,0,0,0,0,0,0,0,66.31 ,46.76 ,66.31 
03,001,03,025,0923,0,549,9,558,1106,0,0,0,0,0,0,0,66.31 ,50.45 ,66.31 
03,001,03,025,0924,0,1026,9,1035,2108,0,0,0,0,0,0,0,66.31 ,49.10 ,66.31 
03,001,03,025,0925,0,1525,8,1533,2839,0,0,0,0,0,0,0,66.31 ,54.00 ,66.31 
03,001,03,025,0926,0,1980,18,1998,3625,0,0,0,0,0,0,0,66.31 ,55.12 ,66.31 
03,001,03,025,0927,0,1267,10,1277,2259,0,0,0,0,0,0,0,66.31 ,56.53 ,66.31 
03,001,03,025,0928,0,592,4,596,929,0,0,0,0,0,0,0,66.31 ,64.16 ,66.31 
03,001,03,025,0929,0,2372,31,2403,3948,0,0,0,0,0,0,0,66.31 ,60.87 ,66.31 
03,001,03,025,0930,0,1386,10,1396,2367,0,0,0,0,0,0,0,66.31 ,58.98 ,66.31 
03,001,03,025,0931,0,1343,16,1359,2210,0,0,0,0,0,0,0,66.31 ,61.49 ,66.31 
03,001,03,025,0932,0,968,12,980,1760,0,0,0,0,0,0,0,66.31 ,55.68 ,66.31 
03,001,03,026,0933,0,499,3,502,810,0,0,0,0,0,0,0,66.31 ,61.98 ,66.31 
03,001,03,026,0934,0,1001,5,1006,1619,0,0,0,0,0,0,0,66.31 ,62.14 ,66.31 
03,001,03,026,0935,0,842,17,859,1389,0,0,0,0,0,0,0,66.31 ,61.84 ,66.31 
03,001,03,026,0936,0,363,9,372,607,0,0,0,0,0,0,0,66.31 ,61.29 ,66.31 
03,001,03,026,0937,0,957,9,966,1584,0,0,0,0,0,0,0,66.31 ,60.98 ,66.31 
03,001,03,026,0938,0,756,21,777,1327,0,0,0,0,0,0,0,66.31 ,58.55 ,66.31 
03,001,03,026,0939,0,2159,20,2179,3734,0,0,0,0,0,0,0,66.31 ,58.36 ,66.31 
03,001,03,026,0940,0,1236,16,1252,2012,0,0,0,0,0,0,0,66.31 ,62.23 ,66.31 
03,001,03,026,0941,0,1205,22,1227,2023,0,0,0,0,0,0,0,66.31 ,60.65 ,66.31 
03,001,03,026,0942,0,786,13,799,1207,0,0,0,0,0,0,0,66.31 ,66.20 ,66.31 
03,001,03,026,0943,0,171,1,172,329,0,0,0,0,0,0,0,66.31 ,52.28 ,66.31 
03,001,03,026,0944,0,375,5,380,555,0,0,0,0,0,0,0,66.31 ,68.47 ,66.31 
03,001,03,026,0945,0,225,2,227,397,0,0,0,0,0,0,0,66.31 ,57.18 ,66.31 
03,001,03,026,0946,0,123,0,123,181,0,0,0,0,0,0,0,66.31 ,67.96 ,66.31 
03,001,03,026,0947,0,958,23,981,1709,0,0,0,0,0,0,0,66.31 ,57.40 ,66.31 
03,001,03,026,0948,0,1591,45,1636,2925,0,0,0,0,0,0,0,66.31 ,55.93 ,66.31 
03,001,03,026,0949,0,749,13,762,1308,0,0,0,0,0,0,0,66.31 ,58.26 ,66.31 
03,001,03,026,0950,0,1031,18,1049,1896,0,0,0,0,0,0,0,66.31 ,55.33 ,66.31 
03,001,03,026,0951,0,379,4,383,611,0,0,0,0,0,0,0,66.31 ,62.68 ,66.31 
03,001,03,026,0952,0,364,3,367,638,0,0,0,0,0,0,0,66.31 ,57.52 ,66.31 
03,001,03,026,0953,0,252,6,258,488,0,0,0,0,0,0,0,66.31 ,52.87 ,66.31 
03,001,03,026,0954,0,152,2,154,296,0,0,0,0,0,0,0,66.31 ,52.03 ,66.31 
03,001,03,026,0955,0,249,4,253,468,0,0,0,0,0,0,0,66.31 ,54.06 ,66.31 
03,001,03,026,0956,0,213,1,214,316,0,0,0,0,0,0,0,66.31 ,67.72 ,66.31 
03,001,03,026,0957,0,195,2,197,311,0,0,0,0,0,0,0,66.31 ,63.34 ,66.31 
03,001,03,026,0958,0,287,4,291,455,0,0,0,0,0,0,0,66.31 ,63.96 ,66.31 
03,001,03,026,0959,0,262,4,266,474,0,0,0,0,0,0,0,66.31 ,56.12 ,66.31 
03,001,03,026,0960,0,454,8,462,672,0,0,0,0,0,0,0,66.31 ,68.75 ,66.31 
03,001,03,026,0961,0,193,3,196,357,0,0,0,0,0,0,0,66.31 ,54.90 ,66.31 
03,001,03,026,0962,0,135,0,135,207,0,0,0,0,0,0,0,66.31 ,65.22 ,66.31 
03,001,03,026,0963,0,338,4,342,531,0,0,0,0,0,0,0,66.31 ,64.41 ,66.31 
03,001,03,026,0964,0,566,11,577,897,0,0,0,0,0,0,0,66.31 ,64.33 ,66.31 
03,001,03,026,0965,0,1015,18,1033,1611,0,0,0,0,0,0,0,66.31 ,64.12 ,66.31 
03,001,03,026,0966,0,563,9,572,998,0,0,0,0,0,0,0,66.31 ,57.31 ,66.31 
03,001,03,027,0967,0,283,4,287,459,0,0,0,0,0,0,0,66.31 ,62.53 ,66.31 
03,001,03,027,0968,0,238,3,241,321,0,0,0,0,0,0,0,66.31 ,75.08 ,66.31 
03,001,03,027,0969,0,237,5,242,314,0,0,0,0,0,0,0,66.31 ,77.07 ,66.31 
03,001,03,027,0970,0,342,4,346,541,0,0,0,0,0,0,0,66.31 ,63.96 ,66.31 
03,001,03,027,0971,0,189,2,191,286,0,0,0,0,0,0,0,66.31 ,66.78 ,66.31 
03,001,03,027,0972,0,457,3,460,697,0,0,0,0,0,0,0,66.31 ,66.00 ,66.31 
03,001,03,027,0973,0,231,0,231,378,0,0,0,0,0,0,0,66.31 ,61.11 ,66.31 
03,001,03,027,0974,0,647,3,650,1102,0,0,0,0,0,0,0,66.31 ,58.98 ,66.31 
03,001,03,027,0975,0,100,1,101,156,0,0,0,0,0,0,0,66.31 ,64.74 ,66.31 
03,001,03,027,0976,0,276,3,279,527,0,0,0,0,0,0,0,66.31 ,52.94 ,66.31 
03,001,03,027,0977,0,108,5,113,164,0,0,0,0,0,0,0,66.31 ,68.90 ,66.31 
03,001,03,027,0978,0,129,1,130,178,0,0,0,0,0,0,0,66.31 ,73.03 ,66.31 
03,001,03,028,0979,0,396,2,398,600,0,0,0,0,0,0,0,66.31 ,66.33 ,66.31 
03,001,03,028,0980,0,681,5,686,964,0,0,0,0,0,0,0,66.31 ,71.16 ,66.31 
03,001,03,028,0981,0,273,1,274,451,0,0,0,0,0,0,0,66.31 ,60.75 ,66.31 
03,001,03,028,0982,0,1248,15,1263,1882,0,0,0,0,0,0,0,66.31 ,67.11 ,66.31 
03,001,03,028,0983,0,207,0,207,312,0,0,0,0,0,0,0,66.31 ,66.35 ,66.31 
03,001,03,028,0984,0,606,9,615,974,0,0,0,0,0,0,0,66.31 ,63.14 ,66.31 
03,001,03,028,0985,0,468,6,474,712,0,0,0,0,0,0,0,66.31 ,66.57 ,66.31 
03,001,03,028,0986,0,322,3,325,513,0,0,0,0,0,0,0,66.31 ,63.35 ,66.31 
03,001,03,028,0987,0,276,2,278,403,0,0,0,0,0,0,0,66.31 ,68.98 ,66.31 
03,001,03,028,0988,0,351,3,354,512,0,0,0,0,0,0,0,66.31 ,69.14 ,66.31 
03,001,03,028,0989,0,465,3,468,651,0,0,0,0,0,0,0,66.31 ,71.89 ,66.31 
03,001,03,028,0990,0,263,0,263,413,0,0,0,0,0,0,0,66.31 ,63.68 ,66.31 
03,001,03,029,0991,0,585,8,593,943,0,0,0,0,0,0,0,66.31 ,62.88 ,66.31 
03,001,03,029,0992,0,249,2,251,434,0,0,0,0,0,0,0,66.31 ,57.83 ,66.31 
03,001,03,029,0993,0,266,7,273,422,0,0,0,0,0,0,0,66.31 ,64.69 ,66.31 
03,001,03,029,0994,0,487,8,495,799,0,0,0,0,0,0,0,66.31 ,61.95 ,66.31 
03,001,03,029,0995,0,897,8,905,1514,0,0,0,0,0,0,0,66.31 ,59.78 ,66.31 
03,001,03,029,0996,0,454,1,455,766,0,0,0,0,0,0,0,66.31 ,59.40 ,66.31 
03,001,03,029,0997,0,387,1,388,632,0,0,0,0,0,0,0,66.31 ,61.39 ,66.31 
03,001,03,029,0998,0,932,19,951,1524,0,0,0,0,0,0,0,66.31 ,62.40 ,66.31 
03,001,03,029,0999,0,1025,8,1033,1838,0,0,0,0,0,0,0,66.31 ,56.20 ,66.31 
03,001,03,029,1000,0,506,8,514,817,0,0,0,0,0,0,0,66.31 ,62.91 ,66.31 
03,001,03,029,1001,0,489,6,495,890,0,0,0,0,0,0,0,66.31 ,55.62 ,66.31 
03,002,01,001,0001,0,437,4,441,726,0,0,0,0,0,0,0,66.31 ,60.74 ,66.31 
03,002,01,001,0002,0,1292,15,1307,2070,0,0,0,0,0,0,0,66.31 ,63.14 ,66.31 
03,002,01,001,0003,0,1384,16,1400,2209,0,0,0,0,0,0,0,66.31 ,63.38 ,66.31 
03,002,01,001,0004,0,1336,21,1357,2291,0,0,0,0,0,0,0,66.31 ,59.23 ,66.31 
03,002,01,001,0005,0,1703,19,1722,2721,0,0,0,0,0,0,0,66.31 ,63.29 ,66.31 
03,002,01,001,0006,0,1923,19,1942,3393,0,0,0,0,0,0,0,66.31 ,57.24 ,66.31 
03,002,01,001,0007,0,1464,13,1477,2398,0,0,0,0,0,0,0,66.31 ,61.59 ,66.31 
03,002,01,001,0008,0,452,3,455,743,0,0,0,0,0,0,0,66.31 ,61.24 ,66.31 
03,002,01,001,0009,0,314,7,321,472,0,0,0,0,0,0,0,66.31 ,68.01 ,66.31 
03,002,01,001,0010,0,491,5,496,729,0,0,0,0,0,0,0,66.31 ,68.04 ,66.31 
03,002,01,001,0011,0,321,5,326,569,0,0,0,0,0,0,0,66.31 ,57.29 ,66.31 
03,002,01,001,0012,0,362,5,367,613,0,0,0,0,0,0,0,66.31 ,59.87 ,66.31 
03,002,01,001,0013,0,1186,11,1197,2003,0,0,0,0,0,0,0,66.31 ,59.76 ,66.31 
03,002,01,001,0014,0,843,10,853,1360,0,0,0,0,0,0,0,66.31 ,62.72 ,66.31 
03,002,01,001,0015,0,2548,25,2573,4083,0,0,0,0,0,0,0,66.31 ,63.02 ,66.31 
03,002,01,001,0016,0,334,2,336,597,0,0,0,0,0,0,0,66.31 ,56.28 ,66.31 
03,002,01,001,0017,0,715,4,719,1127,0,0,0,0,0,0,0,66.31 ,63.80 ,66.31 
03,002,01,001,0018,0,444,5,449,757,0,0,0,0,0,0,0,66.31 ,59.31 ,66.31 
03,002,01,001,0019,0,664,8,672,1140,0,0,0,0,0,0,0,66.31 ,58.95 ,66.31 
03,002,01,001,0020,0,677,5,682,1140,0,0,0,0,0,0,0,66.31 ,59.82 ,66.31 
03,002,01,001,0021,0,1892,19,1911,3107,0,0,0,0,0,0,0,66.31 ,61.51 ,66.31 
03,002,01,001,0022,0,1986,25,2011,3332,0,0,0,0,0,0,0,66.31 ,60.35 ,66.31 
03,002,01,001,0023,0,686,6,692,1137,0,0,0,0,0,0,0,66.31 ,60.86 ,66.31 
03,002,01,001,0024,0,2132,18,2150,3868,0,0,0,0,0,0,0,66.31 ,55.58 ,66.31 
03,002,01,001,0025,0,418,5,423,654,0,0,0,0,0,0,0,66.31 ,64.68 ,66.31 
03,002,01,001,0026,0,361,3,364,582,0,0,0,0,0,0,0,66.31 ,62.54 ,66.31 
03,002,01,001,0027,0,414,4,418,645,0,0,0,0,0,0,0,66.31 ,64.81 ,66.31 
03,002,01,001,0028,0,768,8,776,1264,0,0,0,0,0,0,0,66.31 ,61.39 ,66.31 
03,002,01,001,0029,0,787,10,797,1336,0,0,0,0,0,0,0,66.31 ,59.66 ,66.31 
03,002,01,001,0030,0,681,9,690,1070,0,0,0,0,0,0,0,66.31 ,64.49 ,66.31 
03,002,01,001,0031,0,1276,9,1285,2071,0,0,0,0,0,0,0,66.31 ,62.05 ,66.31 
03,002,01,001,0032,0,927,6,933,1671,0,0,0,0,0,0,0,66.31 ,55.83 ,66.31 
03,002,01,001,0033,0,825,10,835,1308,0,0,0,0,0,0,0,66.31 ,63.84 ,66.31 
03,002,01,001,0034,0,1491,14,1505,2351,0,0,0,0,0,0,0,66.31 ,64.02 ,66.31 
03,002,01,001,0035,0,573,6,579,896,0,0,0,0,0,0,0,66.31 ,64.62 ,66.31 
03,002,01,001,0036,0,513,5,518,816,0,0,0,0,0,0,0,66.31 ,63.48 ,66.31 
03,002,01,001,0037,0,498,2,500,812,0,0,0,0,0,0,0,66.31 ,61.58 ,66.31 
03,002,01,001,0038,0,817,6,823,1241,0,0,0,0,0,0,0,66.31 ,66.32 ,66.31 
03,002,01,001,0039,0,540,8,548,848,0,0,0,0,0,0,0,66.31 ,64.62 ,66.31 
03,002,01,001,0040,0,777,8,785,1283,0,0,0,0,0,0,0,66.31 ,61.18 ,66.31 
03,002,01,002,0041,0,304,2,306,493,0,0,0,0,0,0,0,66.31 ,62.07 ,66.31 
03,002,01,002,0042,0,366,0,366,539,0,0,0,0,0,0,0,66.31 ,67.90 ,66.31 
03,002,01,002,0043,0,302,1,303,530,0,0,0,0,0,0,0,66.31 ,57.17 ,66.31 
03,002,01,002,0044,0,633,4,637,1171,0,0,0,0,0,0,0,66.31 ,54.40 ,66.31 
03,002,01,002,0045,0,1037,15,1052,1858,0,0,0,0,0,0,0,66.31 ,56.62 ,66.31 
03,002,01,002,0046,0,1124,10,1134,1880,0,0,0,0,0,0,0,66.31 ,60.32 ,66.31 
03,002,01,002,0047,0,839,4,843,1605,0,0,0,0,0,0,0,66.31 ,52.52 ,66.31 
03,002,01,002,0048,0,1114,11,1125,2031,0,0,0,0,0,0,0,66.31 ,55.39 ,66.31 
03,002,01,002,0049,0,852,8,860,1355,0,0,0,0,0,0,0,66.31 ,63.47 ,66.31 
03,002,01,002,0050,0,709,6,715,1202,0,0,0,0,0,0,0,66.31 ,59.48 ,66.31 
03,002,01,002,0051,0,520,1,521,838,0,0,0,0,0,0,0,66.31 ,62.17 ,66.31 
03,002,01,002,0052,0,405,5,410,685,0,0,0,0,0,0,0,66.31 ,59.85 ,66.31 
03,002,01,002,0053,0,536,5,541,892,0,0,0,0,0,0,0,66.31 ,60.65 ,66.31 
03,002,01,002,0054,0,418,2,420,674,0,0,0,0,0,0,0,66.31 ,62.31 ,66.31 
03,002,01,002,0055,0,445,3,448,741,0,0,0,0,0,0,0,66.31 ,60.46 ,66.31 
03,002,01,002,0056,0,1962,19,1981,3453,0,0,0,0,0,0,0,66.31 ,57.37 ,66.31 
03,002,01,002,0057,0,2479,27,2506,4362,0,0,0,0,0,0,0,66.31 ,57.45 ,66.31 
03,002,01,002,0058,0,2659,17,2676,4523,0,0,0,0,0,0,0,66.31 ,59.16 ,66.31 
03,002,01,002,0059,0,1844,15,1859,3269,0,0,0,0,0,0,0,66.31 ,56.87 ,66.31 
03,002,01,002,0060,0,1000,8,1008,1725,0,0,0,0,0,0,0,66.31 ,58.43 ,66.31 
03,002,01,002,0061,0,557,4,561,972,0,0,0,0,0,0,0,66.31 ,57.72 ,66.31 
03,002,01,002,0062,0,1526,17,1543,2688,0,0,0,0,0,0,0,66.31 ,57.40 ,66.31 
03,002,01,002,0063,0,1771,11,1782,3055,0,0,0,0,0,0,0,66.31 ,58.33 ,66.31 
03,002,01,002,0064,0,1464,15,1479,2490,0,0,0,0,0,0,0,66.31 ,59.40 ,66.31 
03,002,01,002,0065,0,1303,13,1316,2183,0,0,0,0,0,0,0,66.31 ,60.28 ,66.31 
03,002,01,003,0066,0,1594,11,1605,2894,0,0,0,0,0,0,0,66.31 ,55.46 ,66.31 
03,002,01,003,0067,0,448,3,451,718,0,0,0,0,0,0,0,66.31 ,62.81 ,66.31 
03,002,01,003,0068,0,1632,11,1643,2778,0,0,0,0,0,0,0,66.31 ,59.14 ,66.31 
03,002,01,003,0069,0,701,4,705,1068,0,0,0,0,0,0,0,66.31 ,66.01 ,66.31 
03,002,01,003,0070,0,730,8,738,1278,0,0,0,0,0,0,0,66.31 ,57.75 ,66.31 
03,002,01,003,0071,0,135,5,140,342,0,0,0,0,0,0,0,66.31 ,40.94 ,66.31 
03,002,01,003,0072,0,1128,15,1143,1995,0,0,0,0,0,0,0,66.31 ,57.29 ,66.31 
03,002,01,003,0073,0,631,6,637,1070,0,0,0,0,0,0,0,66.31 ,59.53 ,66.31 
03,002,01,003,0074,0,2517,17,2534,4620,0,0,0,0,0,0,0,66.31 ,54.85 ,66.31 
03,002,01,003,0075,0,1249,8,1257,2225,0,0,0,0,0,0,0,66.31 ,56.49 ,66.31 
03,002,01,003,0076,0,713,9,722,1237,0,0,0,0,0,0,0,66.31 ,58.37 ,66.31 
03,002,01,003,0077,0,347,4,351,601,0,0,0,0,0,0,0,66.31 ,58.40 ,66.31 
03,002,01,003,0078,0,311,4,315,576,0,0,0,0,0,0,0,66.31 ,54.69 ,66.31 
03,002,01,003,0079,0,347,3,350,621,0,0,0,0,0,0,0,66.31 ,56.36 ,66.31 
03,002,01,003,0080,0,376,5,381,584,0,0,0,0,0,0,0,66.31 ,65.24 ,66.31 
03,002,01,003,0081,0,360,5,365,668,0,0,0,0,0,0,0,66.31 ,54.64 ,66.31 
03,002,01,003,0082,0,342,2,344,545,0,0,0,0,0,0,0,66.31 ,63.12 ,66.31 
03,002,01,003,0083,0,651,8,659,1141,0,0,0,0,0,0,0,66.31 ,57.76 ,66.31 
03,002,01,003,0084,0,629,4,633,1115,0,0,0,0,0,0,0,66.31 ,56.77 ,66.31 
03,002,01,003,0085,0,701,6,707,1260,0,0,0,0,0,0,0,66.31 ,56.11 ,66.31 
03,002,01,003,0086,0,867,7,874,1707,0,0,0,0,0,0,0,66.31 ,51.20 ,66.31 
03,002,01,003,0087,0,650,7,657,1176,0,0,0,0,0,0,0,66.31 ,55.87 ,66.31 
03,002,01,003,0088,0,674,8,682,1324,0,0,0,0,0,0,0,66.31 ,51.51 ,66.31 
03,002,01,003,0089,0,192,3,195,350,0,0,0,0,0,0,0,66.31 ,55.71 ,66.31 
03,002,01,003,0090,0,435,13,448,836,0,0,0,0,0,0,0,66.31 ,53.59 ,66.31 
03,002,01,003,0091,0,432,14,446,785,0,0,0,0,0,0,0,66.31 ,56.82 ,66.31 
03,002,01,004,0092,0,208,2,210,393,0,0,0,0,0,0,0,66.31 ,53.44 ,66.31 
03,002,01,004,0093,0,294,1,295,694,0,0,0,0,0,0,0,66.31 ,42.51 ,66.31 
03,002,01,004,0094,0,658,9,667,1495,0,0,0,0,0,0,0,66.31 ,44.62 ,66.31 
03,002,01,004,0095,0,207,6,213,392,0,0,0,0,0,0,0,66.31 ,54.34 ,66.31 
03,002,01,004,0096,0,740,12,752,1350,0,0,0,0,0,0,0,66.31 ,55.70 ,66.31 
03,002,01,004,0097,0,476,3,479,829,0,0,0,0,0,0,0,66.31 ,57.78 ,66.31 
03,002,01,004,0098,0,378,11,389,628,0,0,0,0,0,0,0,66.31 ,61.94 ,66.31 
03,002,01,004,0099,0,863,12,875,1345,0,0,0,0,0,0,0,66.31 ,65.06 ,66.31 
03,002,01,004,0100,0,699,7,706,1091,0,0,0,0,0,0,0,66.31 ,64.71 ,66.31 
03,002,01,004,0101,0,518,2,520,741,0,0,0,0,0,0,0,66.31 ,70.18 ,66.31 
03,002,01,004,0102,0,358,4,362,590,0,0,0,0,0,0,0,66.31 ,61.36 ,66.31 
03,002,01,004,0103,0,460,3,463,664,0,0,0,0,0,0,0,66.31 ,69.73 ,66.31 
03,002,01,004,0104,0,408,2,410,596,0,0,0,0,0,0,0,66.31 ,68.79 ,66.31 
03,002,01,004,0105,0,1104,9,1113,1905,0,0,0,0,0,0,0,66.31 ,58.43 ,66.31 
03,002,01,004,0106,0,1086,8,1094,1754,0,0,0,0,0,0,0,66.31 ,62.37 ,66.31 
03,002,01,004,0107,0,788,5,793,1291,0,0,0,0,0,0,0,66.31 ,61.43 ,66.31 
03,002,01,004,0108,0,591,6,597,974,0,0,0,0,0,0,0,66.31 ,61.29 ,66.31 
03,002,01,004,0109,0,977,6,983,1569,0,0,0,0,0,0,0,66.31 ,62.65 ,66.31 
03,002,01,004,0110,0,390,3,393,694,0,0,0,0,0,0,0,66.31 ,56.63 ,66.31 
03,002,01,004,0111,0,863,10,873,1303,0,0,0,0,0,0,0,66.31 ,67.00 ,66.31 
03,002,01,004,0112,0,585,2,587,915,0,0,0,0,0,0,0,66.31 ,64.15 ,66.31 
03,002,01,004,0113,0,615,12,627,949,0,0,0,0,0,0,0,66.31 ,66.07 ,66.31 
03,002,01,004,0114,0,648,10,658,1053,0,0,0,0,0,0,0,66.31 ,62.49 ,66.31 
03,002,01,005,0115,0,815,6,821,1412,0,0,0,0,0,0,0,66.31 ,58.14 ,66.31 
03,002,01,005,0116,0,1017,15,1032,1607,0,0,0,0,0,0,0,66.31 ,64.22 ,66.31 
03,002,01,005,0117,0,2007,23,2030,3369,0,0,0,0,0,0,0,66.31 ,60.26 ,66.31 
03,002,01,005,0118,0,1258,12,1270,1951,0,0,0,0,0,0,0,66.31 ,65.09 ,66.31 
03,002,01,005,0119,0,444,3,447,664,0,0,0,0,0,0,0,66.31 ,67.32 ,66.31 
03,002,01,005,0120,0,869,9,878,1341,0,0,0,0,0,0,0,66.31 ,65.47 ,66.31 
03,002,01,005,0121,0,705,5,710,1114,0,0,0,0,0,0,0,66.31 ,63.73 ,66.31 
03,002,01,005,0122,0,826,8,834,1331,0,0,0,0,0,0,0,66.31 ,62.66 ,66.31 
03,002,01,005,0123,0,1091,12,1103,1792,0,0,0,0,0,0,0,66.31 ,61.55 ,66.31 
03,002,01,005,0124,0,1379,12,1391,2237,0,0,0,0,0,0,0,66.31 ,62.18 ,66.31 
03,002,01,005,0125,0,632,11,643,1048,0,0,0,0,0,0,0,66.31 ,61.35 ,66.31 
03,002,01,005,0126,0,409,5,414,655,0,0,0,0,0,0,0,66.31 ,63.21 ,66.31 
03,002,01,005,0127,0,532,9,541,893,0,0,0,0,0,0,0,66.31 ,60.58 ,66.31 
03,002,01,005,0128,0,640,7,647,1068,0,0,0,0,0,0,0,66.31 ,60.58 ,66.31 
03,002,01,005,0129,0,1398,9,1407,2133,0,0,0,0,0,0,0,66.31 ,65.96 ,66.31 
03,002,01,005,0130,0,1549,18,1567,2630,0,0,0,0,0,0,0,66.31 ,59.58 ,66.31 
03,002,01,005,0131,0,545,7,552,889,0,0,0,0,0,0,0,66.31 ,62.09 ,66.31 
03,002,01,005,0132,0,231,4,235,406,0,0,0,0,0,0,0,66.31 ,57.88 ,66.31 
03,002,01,006,0133,0,1543,13,1556,2585,0,0,0,0,0,0,0,66.31 ,60.19 ,66.31 
03,002,01,006,0134,0,942,10,952,1573,0,0,0,0,0,0,0,66.31 ,60.52 ,66.31 
03,002,01,006,0135,0,560,4,564,852,0,0,0,0,0,0,0,66.31 ,66.20 ,66.31 
03,002,01,006,0136,0,527,3,530,948,0,0,0,0,0,0,0,66.31 ,55.91 ,66.31 
03,002,01,006,0137,0,889,9,898,1535,0,0,0,0,0,0,0,66.31 ,58.50 ,66.31 
03,002,01,006,0138,0,891,9,900,1481,0,0,0,0,0,0,0,66.31 ,60.77 ,66.31 
03,002,01,006,0139,0,472,5,477,811,0,0,0,0,0,0,0,66.31 ,58.82 ,66.31 
03,002,01,006,0140,0,1194,9,1203,1895,0,0,0,0,0,0,0,66.31 ,63.48 ,66.31 
03,002,01,006,0141,0,754,6,760,1211,0,0,0,0,0,0,0,66.31 ,62.76 ,66.31 
03,002,01,006,0142,0,605,4,609,986,0,0,0,0,0,0,0,66.31 ,61.76 ,66.31 
03,002,01,006,0143,0,1202,11,1213,1872,0,0,0,0,0,0,0,66.31 ,64.80 ,66.31 
03,002,01,006,0144,0,620,2,622,1045,0,0,0,0,0,0,0,66.31 ,59.52 ,66.31 
03,002,01,006,0145,0,939,7,946,1532,0,0,0,0,0,0,0,66.31 ,61.75 ,66.31 
03,002,01,007,0146,0,2267,19,2286,4030,0,0,0,0,0,0,0,66.31 ,56.72 ,66.31 
03,002,01,007,0147,0,1003,10,1013,1832,0,0,0,0,0,0,0,66.31 ,55.29 ,66.31 
03,002,01,007,0148,0,712,15,727,1157,0,0,0,0,0,0,0,66.31 ,62.83 ,66.31 
03,002,01,007,0149,0,530,5,535,914,0,0,0,0,0,0,0,66.31 ,58.53 ,66.31 
03,002,01,007,0150,0,743,12,755,1357,0,0,0,0,0,0,0,66.31 ,55.64 ,66.31 
03,002,01,007,0151,0,527,11,538,1084,0,0,0,0,0,0,0,66.31 ,49.63 ,66.31 
03,002,01,007,0152,0,874,15,889,1496,0,0,0,0,0,0,0,66.31 ,59.43 ,66.31 
03,002,01,007,0153,0,369,7,376,760,0,0,0,0,0,0,0,66.31 ,49.47 ,66.31 
03,002,01,007,0154,0,854,10,864,1560,0,0,0,0,0,0,0,66.31 ,55.38 ,66.31 
03,002,01,007,0155,0,604,12,616,1046,0,0,0,0,0,0,0,66.31 ,58.89 ,66.31 
03,002,01,007,0156,0,1243,14,1257,2066,0,0,0,0,0,0,0,66.31 ,60.84 ,66.31 
03,002,01,007,0157,0,1349,23,1372,2296,0,0,0,0,0,0,0,66.31 ,59.76 ,66.31 
03,002,01,007,0158,0,446,7,453,878,0,0,0,0,0,0,0,66.31 ,51.59 ,66.31 
03,002,01,007,0159,0,463,6,469,837,0,0,0,0,0,0,0,66.31 ,56.03 ,66.31 
03,002,01,007,0160,0,554,7,561,954,0,0,0,0,0,0,0,66.31 ,58.81 ,66.31 
03,002,01,007,0161,0,836,6,842,1525,0,0,0,0,0,0,0,66.31 ,55.21 ,66.31 
03,002,01,008,0162,0,670,2,672,1088,0,0,0,0,0,0,0,66.31 ,61.76 ,66.31 
03,002,01,008,0163,0,693,8,701,1165,0,0,0,0,0,0,0,66.31 ,60.17 ,66.31 
03,002,01,008,0164,0,544,5,549,946,0,0,0,0,0,0,0,66.31 ,58.03 ,66.31 
03,002,01,008,0165,0,465,6,471,804,0,0,0,0,0,0,0,66.31 ,58.58 ,66.31 
03,002,01,008,0166,0,614,4,618,924,0,0,0,0,0,0,0,66.31 ,66.88 ,66.31 
03,002,01,008,0167,0,678,3,681,1162,0,0,0,0,0,0,0,66.31 ,58.61 ,66.31 
03,002,01,008,0168,0,1106,6,1112,1830,0,0,0,0,0,0,0,66.31 ,60.77 ,66.31 
03,002,01,008,0169,0,1046,10,1056,1730,0,0,0,0,0,0,0,66.31 ,61.04 ,66.31 
03,002,01,008,0170,0,541,2,543,843,0,0,0,0,0,0,0,66.31 ,64.41 ,66.31 
03,002,01,008,0171,0,423,4,427,712,0,0,0,0,0,0,0,66.31 ,59.97 ,66.31 
03,002,01,008,0172,0,802,2,804,1290,0,0,0,0,0,0,0,66.31 ,62.33 ,66.31 
03,002,01,008,0173,0,497,1,498,813,0,0,0,0,0,0,0,66.31 ,61.25 ,66.31 
03,002,01,008,0174,0,758,6,764,1242,0,0,0,0,0,0,0,66.31 ,61.51 ,66.31 
03,002,01,008,0175,0,250,1,251,424,0,0,0,0,0,0,0,66.31 ,59.20 ,66.31 
03,002,01,008,0176,0,2134,15,2149,4072,0,0,0,0,0,0,0,66.31 ,52.78 ,66.31 
03,002,01,008,0177,0,1059,7,1066,1913,0,0,0,0,0,0,0,66.31 ,55.72 ,66.31 
03,002,01,008,0178,0,2541,27,2568,4408,0,0,0,0,0,0,0,66.31 ,58.26 ,66.31 
03,002,01,008,0179,0,1475,17,1492,2536,0,0,0,0,0,0,0,66.31 ,58.83 ,66.31 
03,002,01,008,0180,0,1178,17,1195,2130,0,0,0,0,0,0,0,66.31 ,56.10 ,66.31 
03,002,01,008,0181,0,541,12,553,1033,0,0,0,0,0,0,0,66.31 ,53.53 ,66.31 
03,002,01,008,0182,0,1199,8,1207,2163,0,0,0,0,0,0,0,66.31 ,55.80 ,66.31 
03,002,01,008,0183,0,670,8,678,1169,0,0,0,0,0,0,0,66.31 ,58.00 ,66.31 
03,002,01,008,0184,0,541,4,545,936,0,0,0,0,0,0,0,66.31 ,58.23 ,66.31 
03,002,01,008,0185,0,443,3,446,795,0,0,0,0,0,0,0,66.31 ,56.10 ,66.31 
03,002,01,009,0186,0,982,7,989,1573,0,0,0,0,0,0,0,66.31 ,62.87 ,66.31 
03,002,01,009,0187,0,859,8,867,1380,0,0,0,0,0,0,0,66.31 ,62.83 ,66.31 
03,002,01,009,0188,0,1172,13,1185,1914,0,0,0,0,0,0,0,66.31 ,61.91 ,66.31 
03,002,01,009,0189,0,859,10,869,1425,0,0,0,0,0,0,0,66.31 ,60.98 ,66.31 
03,002,01,009,0190,0,602,5,607,973,0,0,0,0,0,0,0,66.31 ,62.38 ,66.31 
03,002,01,009,0191,0,1232,8,1240,2071,0,0,0,0,0,0,0,66.31 ,59.87 ,66.31 
03,002,01,009,0192,0,926,5,931,1472,0,0,0,0,0,0,0,66.31 ,63.25 ,66.31 
03,002,01,009,0193,0,1482,5,1487,2461,0,0,0,0,0,0,0,66.31 ,60.42 ,66.31 
03,002,01,009,0194,0,1646,10,1656,2655,0,0,0,0,0,0,0,66.31 ,62.37 ,66.31 
03,002,01,009,0195,0,1276,14,1290,2133,0,0,0,0,0,0,0,66.31 ,60.48 ,66.31 
03,002,01,009,0196,0,792,7,799,1267,0,0,0,0,0,0,0,66.31 ,63.06 ,66.31 
03,002,01,009,0197,0,881,10,891,1452,0,0,0,0,0,0,0,66.31 ,61.36 ,66.31 
03,002,01,009,0198,0,1182,6,1188,1995,0,0,0,0,0,0,0,66.31 ,59.55 ,66.31 
03,002,01,009,0199,0,1243,15,1258,2305,0,0,0,0,0,0,0,66.31 ,54.58 ,66.31 
03,002,01,009,0200,0,1199,10,1209,2074,0,0,0,0,0,0,0,66.31 ,58.29 ,66.31 
03,002,01,010,0201,0,126,1,127,230,0,0,0,0,0,0,0,66.31 ,55.22 ,66.31 
03,002,01,010,0202,0,363,2,365,645,0,0,0,0,0,0,0,66.31 ,56.59 ,66.31 
03,002,01,010,0203,0,411,9,420,821,0,0,0,0,0,0,0,66.31 ,51.16 ,66.31 
03,002,01,010,0204,0,371,4,375,663,0,0,0,0,0,0,0,66.31 ,56.56 ,66.31 
03,002,01,010,0205,0,248,6,254,467,0,0,0,0,0,0,0,66.31 ,54.39 ,66.31 
03,002,01,010,0206,0,670,3,673,1108,0,0,0,0,0,0,0,66.31 ,60.74 ,66.31 
03,002,01,010,0207,0,647,10,657,1109,0,0,0,0,0,0,0,66.31 ,59.24 ,66.31 
03,002,01,010,0208,0,497,7,504,840,0,0,0,0,0,0,0,66.31 ,60.00 ,66.31 
03,002,01,010,0209,0,549,6,555,1060,0,0,0,0,0,0,0,66.31 ,52.36 ,66.31 
03,002,01,010,0210,0,1660,23,1683,2902,0,0,0,0,0,0,0,66.31 ,57.99 ,66.31 
03,002,01,010,0211,0,369,4,373,657,0,0,0,0,0,0,0,66.31 ,56.77 ,66.31 
03,002,01,010,0212,0,284,8,292,535,0,0,0,0,0,0,0,66.31 ,54.58 ,66.31 
03,002,01,010,0213,0,247,4,251,488,0,0,0,0,0,0,0,66.31 ,51.43 ,66.31 
03,002,01,010,0214,0,378,2,380,647,0,0,0,0,0,0,0,66.31 ,58.73 ,66.31 
03,002,01,010,0215,0,663,5,668,1048,0,0,0,0,0,0,0,66.31 ,63.74 ,66.31 
03,002,01,010,0216,0,477,2,479,794,0,0,0,0,0,0,0,66.31 ,60.33 ,66.31 
03,002,01,010,0217,0,857,7,864,1247,0,0,0,0,0,0,0,66.31 ,69.29 ,66.31 
03,002,01,010,0218,0,682,5,687,1124,0,0,0,0,0,0,0,66.31 ,61.12 ,66.31 
03,002,01,011,0219,0,40,0,40,113,0,0,0,0,0,0,0,66.31 ,35.40 ,66.31 
03,002,01,011,0220,0,47,0,47,101,0,0,0,0,0,0,0,66.31 ,46.53 ,66.31 
03,002,01,011,0221,0,122,0,122,241,0,0,0,0,0,0,0,66.31 ,50.62 ,66.31 
03,002,01,011,0222,0,128,1,129,238,0,0,0,0,0,0,0,66.31 ,54.20 ,66.31 
03,002,01,011,0223,0,38,0,38,84,0,0,0,0,0,0,0,66.31 ,45.24 ,66.31 
03,002,01,011,0224,0,21,0,21,61,0,0,0,0,0,0,0,66.31 ,34.43 ,66.31 
03,002,01,011,0225,0,31,1,32,54,0,0,0,0,0,0,0,66.31 ,59.26 ,66.31 
03,002,01,011,0226,0,10,0,10,16,0,0,0,0,0,0,0,66.31 ,62.50 ,66.31 
03,002,01,011,0227,0,11,0,11,54,0,0,0,0,0,0,0,66.31 ,20.37 ,66.31 
03,002,01,011,0228,0,42,0,42,76,0,0,0,0,0,0,0,66.31 ,55.26 ,66.31 
03,002,01,012,0229,0,41,0,41,83,0,0,0,0,0,0,0,66.31 ,49.40 ,66.31 
03,002,01,012,0230,0,137,1,138,251,0,0,0,0,0,0,0,66.31 ,54.98 ,66.31 
03,002,01,012,0231,0,40,0,40,92,0,0,0,0,0,0,0,66.31 ,43.48 ,66.31 
03,002,01,012,0232,0,27,0,27,66,0,0,0,0,0,0,0,66.31 ,40.91 ,66.31 
03,002,01,012,0233,0,52,0,52,128,0,0,0,0,0,0,0,66.31 ,40.63 ,66.31 
03,002,01,012,0234,0,11,2,13,31,0,0,0,0,0,0,0,66.31 ,41.94 ,66.31 
03,002,01,012,0235,0,56,1,57,162,0,0,0,0,0,0,0,66.31 ,35.19 ,66.31 
03,003,01,001,0001,0,2721,30,2751,4435,0,0,0,0,0,0,0,66.31 ,62.03 ,66.31 
03,003,01,001,0002,0,1866,27,1893,3136,0,0,0,0,0,0,0,66.31 ,60.36 ,66.31 
03,003,01,001,0003,0,2150,29,2179,3570,0,0,0,0,0,0,0,66.31 ,61.04 ,66.31 
03,003,01,001,0004,0,2683,34,2717,4144,0,0,0,0,0,0,0,66.31 ,65.56 ,66.31 
03,003,01,001,0005,0,1891,26,1917,3013,0,0,0,0,0,0,0,66.31 ,63.62 ,66.31 
03,003,01,001,0006,0,2905,39,2944,4657,0,0,0,0,0,0,0,66.31 ,63.22 ,66.31 
03,003,01,001,0007,0,2345,36,2381,3924,0,0,0,0,0,0,0,66.31 ,60.68 ,66.31 
03,003,01,001,0008,0,1378,18,1396,2269,0,0,0,0,0,0,0,66.31 ,61.52 ,66.31 
03,003,01,001,0009,0,1140,7,1147,1847,0,0,0,0,0,0,0,66.31 ,62.10 ,66.31 
03,003,01,001,0010,0,594,8,602,917,0,0,0,0,0,0,0,66.31 ,65.65 ,66.31 
03,003,01,001,0011,0,841,9,850,1472,0,0,0,0,0,0,0,66.31 ,57.74 ,66.31 
03,003,01,001,0012,0,899,9,908,1369,0,0,0,0,0,0,0,66.31 ,66.33 ,66.31 
03,003,01,001,0013,0,495,1,496,843,0,0,0,0,0,0,0,66.31 ,58.84 ,66.31 
03,003,01,001,0014,0,913,5,918,1470,0,0,0,0,0,0,0,66.31 ,62.45 ,66.31 
03,003,01,001,0015,0,668,15,683,1022,0,0,0,0,0,0,0,66.31 ,66.83 ,66.31 
03,003,01,001,0016,0,2652,33,2685,4390,0,0,0,0,0,0,0,66.31 ,61.16 ,66.31 
03,003,01,001,0017,0,944,7,951,1400,0,0,0,0,0,0,0,66.31 ,67.93 ,66.31 
03,003,01,001,0018,0,892,19,911,1426,0,0,0,0,0,0,0,66.31 ,63.88 ,66.31 
03,003,01,001,0019,0,731,10,741,1182,0,0,0,0,0,0,0,66.31 ,62.69 ,66.31 
03,003,01,001,0020,0,634,7,641,947,0,0,0,0,0,0,0,66.31 ,67.69 ,66.31 
03,003,01,001,0021,0,1198,10,1208,1810,0,0,0,0,0,0,0,66.31 ,66.74 ,66.31 
03,003,01,001,0022,0,2744,24,2768,4306,0,0,0,0,0,0,0,66.31 ,64.28 ,66.31 
03,003,01,001,0023,0,2640,25,2665,4170,0,0,0,0,0,0,0,66.31 ,63.91 ,66.31 
03,003,01,001,0024,0,1552,20,1572,2665,0,0,0,0,0,0,0,66.31 ,58.99 ,66.31 
03,003,01,001,0025,0,1851,20,1871,3179,0,0,0,0,0,0,0,66.31 ,58.85 ,66.31 
03,003,01,001,0026,0,1955,30,1985,3432,0,0,0,0,0,0,0,66.31 ,57.84 ,66.31 
03,003,01,001,0027,0,1660,16,1676,2941,0,0,0,0,0,0,0,66.31 ,56.99 ,66.31 
03,003,01,001,0028,0,869,6,875,1431,0,0,0,0,0,0,0,66.31 ,61.15 ,66.31 
03,003,01,001,0029,0,1542,23,1565,2787,0,0,0,0,0,0,0,66.31 ,56.15 ,66.31 
03,003,01,001,0030,0,2409,39,2448,3773,0,0,0,0,0,0,0,66.31 ,64.88 ,66.31 
03,003,01,001,0031,0,2241,33,2274,3679,0,0,0,0,0,0,0,66.31 ,61.81 ,66.31 
03,003,01,001,0032,0,1554,26,1580,2524,0,0,0,0,0,0,0,66.31 ,62.60 ,66.31 
03,003,01,001,0033,0,1684,21,1705,2638,0,0,0,0,0,0,0,66.31 ,64.63 ,66.31 
03,003,01,001,0034,0,2407,44,2451,4036,0,0,0,0,0,0,0,66.31 ,60.73 ,66.31 
03,003,01,001,0035,0,1780,33,1813,2797,0,0,0,0,0,0,0,66.31 ,64.82 ,66.31 
03,003,01,001,0036,0,1830,26,1856,2830,0,0,0,0,0,0,0,66.31 ,65.58 ,66.31 
03,003,01,001,0037,0,907,6,913,1521,0,0,0,0,0,0,0,66.31 ,60.03 ,66.31 
03,003,01,001,0038,0,1392,9,1401,2359,0,0,0,0,0,0,0,66.31 ,59.39 ,66.31 
03,003,01,001,0039,0,2163,30,2193,3603,0,0,0,0,0,0,0,66.31 ,60.87 ,66.31 
03,003,01,001,0040,0,2079,26,2105,3232,0,0,0,0,0,0,0,66.31 ,65.13 ,66.31 
03,003,01,001,0041,0,2247,37,2284,3779,0,0,0,0,0,0,0,66.31 ,60.44 ,66.31 
03,003,01,001,0042,0,2056,34,2090,3606,0,0,0,0,0,0,0,66.31 ,57.96 ,66.31 
03,003,01,001,0043,0,2389,21,2410,3724,0,0,0,0,0,0,0,66.31 ,64.72 ,66.31 
03,003,01,001,0044,0,2335,24,2359,4244,0,0,0,0,0,0,0,66.31 ,55.58 ,66.31 
03,003,01,001,0045,0,1261,20,1281,1820,0,0,0,0,0,0,0,66.31 ,70.38 ,66.31 
03,003,01,001,0046,0,1384,13,1397,2370,0,0,0,0,0,0,0,66.31 ,58.95 ,66.31 
03,003,01,001,0047,0,1630,14,1644,3172,0,0,0,0,0,0,0,66.31 ,51.83 ,66.31 
03,003,01,001,0048,0,1730,23,1753,3524,0,0,0,0,0,0,0,66.31 ,49.74 ,66.31 
03,003,01,001,0049,0,1398,27,1425,1984,0,0,0,0,0,0,0,66.31 ,71.82 ,66.31 
03,003,01,001,0050,0,2257,38,2295,3850,0,0,0,0,0,0,0,66.31 ,59.61 ,66.31 
03,003,01,001,0051,0,2230,32,2262,3624,0,0,0,0,0,0,0,66.31 ,62.42 ,66.31 
03,003,01,001,0052,0,1712,18,1730,3012,0,0,0,0,0,0,0,66.31 ,57.44 ,66.31 
03,003,01,001,0053,0,1380,8,1388,2793,0,0,0,0,0,0,0,66.31 ,49.70 ,66.31 
03,003,01,001,0054,0,1770,16,1786,3178,0,0,0,0,0,0,0,66.31 ,56.20 ,66.31 
03,003,01,001,0055,0,1474,18,1492,2460,0,0,0,0,0,0,0,66.31 ,60.65 ,66.31 
03,003,01,001,0056,0,1714,26,1740,2884,0,0,0,0,0,0,0,66.31 ,60.33 ,66.31 
03,003,01,001,0057,0,949,6,955,1452,0,0,0,0,0,0,0,66.31 ,65.77 ,66.31 
03,003,01,001,0058,0,1053,18,1071,1632,0,0,0,0,0,0,0,66.31 ,65.63 ,66.31 
03,003,01,001,0059,0,950,12,962,1593,0,0,0,0,0,0,0,66.31 ,60.39 ,66.31 
03,003,01,001,0060,0,2482,29,2511,4214,0,0,0,0,0,0,0,66.31 ,59.59 ,66.31 
03,003,01,001,0061,0,1831,19,1850,3093,0,0,0,0,0,0,0,66.31 ,59.81 ,66.31 
03,003,01,001,0062,0,1905,18,1923,3214,0,0,0,0,0,0,0,66.31 ,59.83 ,66.31 
03,003,01,001,0063,0,2571,57,2628,4533,0,0,0,0,0,0,0,66.31 ,57.97 ,66.31 
03,003,01,001,0064,0,2283,35,2318,4054,0,0,0,0,0,0,0,66.31 ,57.18 ,66.31 
03,003,01,001,0065,0,1623,30,1653,3248,0,0,0,0,0,0,0,66.31 ,50.89 ,66.31 
03,003,01,001,0066,0,713,11,724,1614,0,0,0,0,0,0,0,66.31 ,44.86 ,66.31 
03,003,01,001,0067,0,1345,19,1364,2385,0,0,0,0,0,0,0,66.31 ,57.19 ,66.31 
03,003,01,001,0068,0,1609,34,1643,2965,0,0,0,0,0,0,0,66.31 ,55.41 ,66.31 
03,003,01,001,0069,0,1901,28,1929,2937,0,0,0,0,0,0,0,66.31 ,65.68 ,66.31 
03,003,01,002,0070,0,2606,54,2660,4366,0,0,0,0,0,0,0,66.31 ,60.93 ,66.31 
03,003,01,002,0071,0,3064,46,3110,4903,0,0,0,0,0,0,0,66.31 ,63.43 ,66.31 
03,003,01,002,0072,0,2242,38,2280,3794,0,0,0,0,0,0,0,66.31 ,60.09 ,66.31 
03,003,01,002,0073,0,2590,46,2636,4523,0,0,0,0,0,0,0,66.31 ,58.28 ,66.31 
03,003,01,002,0074,0,1546,24,1570,2212,0,0,0,0,0,0,0,66.31 ,70.98 ,66.31 
03,003,01,002,0075,0,1310,11,1321,1909,0,0,0,0,0,0,0,66.31 ,69.20 ,66.31 
03,003,01,002,0076,0,904,23,927,1600,0,0,0,0,0,0,0,66.31 ,57.94 ,66.31 
03,003,01,002,0077,0,866,15,881,1722,0,0,0,0,0,0,0,66.31 ,51.16 ,66.31 
03,003,01,002,0078,0,1676,30,1706,3437,0,0,0,0,0,0,0,66.31 ,49.64 ,66.31 
03,003,01,002,0079,0,1158,20,1178,1985,0,0,0,0,0,0,0,66.31 ,59.35 ,66.31 
03,003,01,002,0080,0,854,19,873,1486,0,0,0,0,0,0,0,66.31 ,58.75 ,66.31 
03,003,01,002,0081,0,1307,27,1334,2770,0,0,0,0,0,0,0,66.31 ,48.16 ,66.31 
03,003,01,002,0082,0,1297,21,1318,2535,0,0,0,0,0,0,0,66.31 ,51.99 ,66.31 
03,003,01,002,0083,0,1143,30,1173,1786,0,0,0,0,0,0,0,66.31 ,65.68 ,66.31 
03,003,01,002,0084,0,2696,41,2737,4590,0,0,0,0,0,0,0,66.31 ,59.63 ,66.31 
03,003,01,002,0085,0,1911,25,1936,4102,0,0,0,0,0,0,0,66.31 ,47.20 ,66.31 
03,003,01,002,0086,0,1520,17,1537,2640,0,0,0,0,0,0,0,66.31 ,58.22 ,66.31 
03,003,01,002,0087,0,1977,28,2005,3781,0,0,0,0,0,0,0,66.31 ,53.03 ,66.31 
03,003,01,002,0088,0,2653,37,2690,5218,0,0,0,0,0,0,0,66.31 ,51.55 ,66.31 
03,003,01,002,0089,0,897,19,916,1538,0,0,0,0,0,0,0,66.31 ,59.56 ,66.31 
03,003,01,002,0090,0,881,11,892,1735,0,0,0,0,0,0,0,66.31 ,51.41 ,66.31 
03,003,01,002,0091,0,1647,13,1660,3692,0,0,0,0,0,0,0,66.31 ,44.96 ,66.31 
03,003,01,002,0092,0,721,9,730,1167,0,0,0,0,0,0,0,66.31 ,62.55 ,66.31 
03,003,01,002,0093,0,762,12,774,1160,0,0,0,0,0,0,0,66.31 ,66.72 ,66.31 
03,003,01,002,0094,0,647,5,652,1062,0,0,0,0,0,0,0,66.31 ,61.39 ,66.31 
03,003,01,002,0095,0,1318,25,1343,2221,0,0,0,0,0,0,0,66.31 ,60.47 ,66.31 
03,003,01,003,0096,0,1810,35,1845,2887,0,0,0,0,0,0,0,66.31 ,63.91 ,66.31 
03,003,01,003,0097,0,1823,28,1851,2517,0,0,0,0,0,0,0,66.31 ,73.54 ,66.31 
03,003,01,003,0098,0,2010,33,2043,2942,0,0,0,0,0,0,0,66.31 ,69.44 ,66.31 
03,003,01,003,0099,0,1669,32,1701,2668,0,0,0,0,0,0,0,66.31 ,63.76 ,66.31 
03,003,01,003,0100,0,1986,37,2023,2993,0,0,0,0,0,0,0,66.31 ,67.59 ,66.31 
03,003,01,003,0101,0,2072,41,2113,2940,0,0,0,0,0,0,0,66.31 ,71.87 ,66.31 
03,003,01,003,0102,0,1844,24,1868,2738,0,0,0,0,0,0,0,66.31 ,68.22 ,66.31 
03,003,01,003,0103,0,2787,52,2839,4156,0,0,0,0,0,0,0,66.31 ,68.31 ,66.31 
03,003,01,003,0104,0,1865,28,1893,2690,0,0,0,0,0,0,0,66.31 ,70.37 ,66.31 
03,003,01,003,0105,0,1525,37,1562,2335,0,0,0,0,0,0,0,66.31 ,66.90 ,66.31 
03,003,01,003,0106,0,2472,58,2530,3662,0,0,0,0,0,0,0,66.31 ,69.09 ,66.31 
03,003,01,003,0107,0,1352,33,1385,2256,0,0,0,0,0,0,0,66.31 ,61.39 ,66.31 
03,003,01,003,0108,0,2345,46,2391,3639,0,0,0,0,0,0,0,66.31 ,65.70 ,66.31 
03,003,01,003,0109,0,1713,41,1754,2709,0,0,0,0,0,0,0,66.31 ,64.75 ,66.31 
03,003,01,003,0110,0,1204,28,1232,1833,0,0,0,0,0,0,0,66.31 ,67.21 ,66.31 
03,003,01,003,0111,0,1332,16,1348,1924,0,0,0,0,0,0,0,66.31 ,70.06 ,66.31 
03,003,01,003,0112,0,1461,31,1492,2325,0,0,0,0,0,0,0,66.31 ,64.17 ,66.31 
03,003,01,003,0113,0,946,17,963,1337,0,0,0,0,0,0,0,66.31 ,72.03 ,66.31 
03,003,01,003,0114,0,1850,28,1878,2783,0,0,0,0,0,0,0,66.31 ,67.48 ,66.31 
03,003,01,003,0115,0,1108,15,1123,1859,0,0,0,0,0,0,0,66.31 ,60.41 ,66.31 
03,003,01,003,0116,0,972,15,987,1538,0,0,0,0,0,0,0,66.31 ,64.17 ,66.31 
03,003,01,003,0117,0,801,10,811,1245,0,0,0,0,0,0,0,66.31 ,65.14 ,66.31 
03,003,01,003,0118,0,2258,34,2292,3576,0,0,0,0,0,0,0,66.31 ,64.09 ,66.31 
03,003,01,003,0119,0,2274,38,2312,3587,0,0,0,0,0,0,0,66.31 ,64.45 ,66.31 
03,003,01,003,0120,0,3457,80,3537,5700,0,0,0,0,0,0,0,66.31 ,62.05 ,66.31 
03,003,01,003,0121,0,1130,16,1146,1815,0,0,0,0,0,0,0,66.31 ,63.14 ,66.31 
03,003,01,003,0122,0,1611,24,1635,2427,0,0,0,0,0,0,0,66.31 ,67.37 ,66.31 
03,003,01,003,0123,0,1066,14,1080,1592,0,0,0,0,0,0,0,66.31 ,67.84 ,66.31 
03,003,01,003,0124,0,831,19,850,1314,0,0,0,0,0,0,0,66.31 ,64.69 ,66.31 
03,003,01,003,0125,0,2212,35,2247,3294,0,0,0,0,0,0,0,66.31 ,68.21 ,66.31 
03,003,01,003,0126,0,1684,17,1701,2667,0,0,0,0,0,0,0,66.31 ,63.78 ,66.31 
03,003,01,003,0127,0,1130,24,1154,1789,0,0,0,0,0,0,0,66.31 ,64.51 ,66.31 
03,003,01,003,0128,0,2713,36,2749,4061,0,0,0,0,0,0,0,66.31 ,67.69 ,66.31 
03,003,01,003,0129,0,1588,25,1613,2480,0,0,0,0,0,0,0,66.31 ,65.04 ,66.31 
03,003,01,003,0130,0,1724,13,1737,2873,0,0,0,0,0,0,0,66.31 ,60.46 ,66.31 
03,003,01,003,0131,0,1448,24,1472,2177,0,0,0,0,0,0,0,66.31 ,67.62 ,66.31 
03,003,01,003,0132,0,1114,18,1132,1750,0,0,0,0,0,0,0,66.31 ,64.69 ,66.31 
03,003,01,003,0133,0,867,8,875,1428,0,0,0,0,0,0,0,66.31 ,61.27 ,66.31 
03,003,01,003,0134,0,1909,34,1943,3313,0,0,0,0,0,0,0,66.31 ,58.65 ,66.31 
03,003,01,004,0135,0,1792,27,1819,2748,0,0,0,0,0,0,0,66.31 ,66.19 ,66.31 
03,003,01,004,0136,0,1624,19,1643,2432,0,0,0,0,0,0,0,66.31 ,67.56 ,66.31 
03,003,01,004,0137,0,1654,28,1682,2536,0,0,0,0,0,0,0,66.31 ,66.32 ,66.31 
03,003,01,004,0138,0,1127,18,1145,1706,0,0,0,0,0,0,0,66.31 ,67.12 ,66.31 
03,003,01,004,0139,0,1297,17,1314,1812,0,0,0,0,0,0,0,66.31 ,72.52 ,66.31 
03,003,01,004,0140,0,1293,25,1318,2049,0,0,0,0,0,0,0,66.31 ,64.32 ,66.31 
03,003,01,004,0141,0,637,6,643,833,0,0,0,0,0,0,0,66.31 ,77.19 ,66.31 
03,003,01,004,0142,0,1231,18,1249,1746,0,0,0,0,0,0,0,66.31 ,71.53 ,66.31 
03,003,01,004,0143,0,1971,31,2002,2775,0,0,0,0,0,0,0,66.31 ,72.14 ,66.31 
03,003,01,004,0144,0,1330,17,1347,2068,0,0,0,0,0,0,0,66.31 ,65.14 ,66.31 
03,003,01,004,0145,0,2261,44,2305,4161,0,0,0,0,0,0,0,66.31 ,55.40 ,66.31 
03,003,01,004,0146,0,1191,20,1211,1978,0,0,0,0,0,0,0,66.31 ,61.22 ,66.31 
03,003,01,004,0147,0,1043,12,1055,1648,0,0,0,0,0,0,0,66.31 ,64.02 ,66.31 
03,003,01,004,0148,0,1503,33,1536,2304,0,0,0,0,0,0,0,66.31 ,66.67 ,66.31 
03,003,01,004,0149,0,864,13,877,1341,0,0,0,0,0,0,0,66.31 ,65.40 ,66.31 
03,003,01,004,0150,0,1096,15,1111,1813,0,0,0,0,0,0,0,66.31 ,61.28 ,66.31 
03,003,01,004,0151,0,1266,15,1281,2419,0,0,0,0,0,0,0,66.31 ,52.96 ,66.31 
03,003,01,004,0152,0,1192,12,1204,2067,0,0,0,0,0,0,0,66.31 ,58.25 ,66.31 
03,003,01,004,0153,0,668,18,686,1253,0,0,0,0,0,0,0,66.31 ,54.75 ,66.31 
03,003,01,004,0154,0,1175,17,1192,1690,0,0,0,0,0,0,0,66.31 ,70.53 ,66.31 
03,003,01,004,0155,0,911,15,926,1319,0,0,0,0,0,0,0,66.31 ,70.20 ,66.31 
03,003,01,004,0156,0,997,13,1010,1524,0,0,0,0,0,0,0,66.31 ,66.27 ,66.31 
03,003,01,004,0157,0,819,16,835,1204,0,0,0,0,0,0,0,66.31 ,69.35 ,66.31 
03,003,01,004,0158,0,1979,29,2008,2881,0,0,0,0,0,0,0,66.31 ,69.70 ,66.31 
03,003,01,004,0159,0,1401,29,1430,1990,0,0,0,0,0,0,0,66.31 ,71.86 ,66.31 
03,003,01,004,0160,0,1983,40,2023,3145,0,0,0,0,0,0,0,66.31 ,64.32 ,66.31 
03,003,01,005,0161,0,3558,53,3611,4804,0,0,0,0,0,0,0,66.31 ,75.17 ,66.31 
03,003,01,005,0162,0,2569,20,2589,3711,0,0,0,0,0,0,0,66.31 ,69.77 ,66.31 
03,003,01,005,0163,0,1876,32,1908,2767,0,0,0,0,0,0,0,66.31 ,68.96 ,66.31 
03,003,01,005,0164,0,970,15,985,1374,0,0,0,0,0,0,0,66.31 ,71.69 ,66.31 
03,003,01,005,0165,0,3314,46,3360,4605,0,0,0,0,0,0,0,66.31 ,72.96 ,66.31 
03,003,01,005,0166,0,2461,32,2493,3256,0,0,0,0,0,0,0,66.31 ,76.57 ,66.31 
03,003,01,005,0167,0,2895,41,2936,3907,0,0,0,0,0,0,0,66.31 ,75.15 ,66.31 
03,003,01,005,0168,0,950,21,971,1195,0,0,0,0,0,0,0,66.31 ,81.26 ,66.31 
03,003,01,005,0169,0,723,5,728,964,0,0,0,0,0,0,0,66.31 ,75.52 ,66.31 
03,003,01,005,0170,0,1731,29,1760,2311,0,0,0,0,0,0,0,66.31 ,76.16 ,66.31 
03,003,01,005,0171,0,2630,36,2666,3807,0,0,0,0,0,0,0,66.31 ,70.03 ,66.31 
03,003,01,005,0172,0,1498,15,1513,2077,0,0,0,0,0,0,0,66.31 ,72.85 ,66.31 
03,003,01,005,0173,0,870,12,882,1282,0,0,0,0,0,0,0,66.31 ,68.80 ,66.31 
03,003,01,005,0174,0,1778,30,1808,2565,0,0,0,0,0,0,0,66.31 ,70.49 ,66.31 
03,003,01,005,0175,0,1056,12,1068,1400,0,0,0,0,0,0,0,66.31 ,76.29 ,66.31 
03,003,01,005,0176,0,1292,20,1312,1849,0,0,0,0,0,0,0,66.31 ,70.96 ,66.31 
03,003,01,005,0177,0,1171,12,1183,1640,0,0,0,0,0,0,0,66.31 ,72.13 ,66.31 
03,003,01,005,0178,0,1075,8,1083,1575,0,0,0,0,0,0,0,66.31 ,68.76 ,66.31 
03,003,01,005,0179,0,1543,19,1562,2446,0,0,0,0,0,0,0,66.31 ,63.86 ,66.31 
03,003,01,006,0180,0,1168,15,1183,1667,0,0,0,0,0,0,0,66.31 ,70.97 ,66.31 
03,003,01,006,0181,0,774,10,784,1118,0,0,0,0,0,0,0,66.31 ,70.13 ,66.31 
03,003,01,006,0182,0,2085,34,2119,3228,0,0,0,0,0,0,0,66.31 ,65.64 ,66.31 
03,003,01,006,0183,0,1849,24,1873,2815,0,0,0,0,0,0,0,66.31 ,66.54 ,66.31 
03,003,01,006,0184,0,2274,25,2299,3552,0,0,0,0,0,0,0,66.31 ,64.72 ,66.31 
03,003,01,006,0185,0,712,7,719,1010,0,0,0,0,0,0,0,66.31 ,71.19 ,66.31 
03,003,01,006,0186,0,622,9,631,888,0,0,0,0,0,0,0,66.31 ,71.06 ,66.31 
03,003,01,006,0187,0,698,15,713,958,0,0,0,0,0,0,0,66.31 ,74.43 ,66.31 
03,003,01,006,0188,0,1127,14,1141,1574,0,0,0,0,0,0,0,66.31 ,72.49 ,66.31 
03,003,01,006,0189,0,1618,28,1646,2467,0,0,0,0,0,0,0,66.31 ,66.72 ,66.31 
03,003,01,006,0190,0,1349,16,1365,2056,0,0,0,0,0,0,0,66.31 ,66.39 ,66.31 
03,003,01,006,0191,0,610,7,617,931,0,0,0,0,0,0,0,66.31 ,66.27 ,66.31 
03,003,01,006,0192,0,644,10,654,974,0,0,0,0,0,0,0,66.31 ,67.15 ,66.31 
03,003,01,006,0193,0,1050,20,1070,1530,0,0,0,0,0,0,0,66.31 ,69.93 ,66.31 
03,003,01,006,0194,0,1415,21,1436,1980,0,0,0,0,0,0,0,66.31 ,72.53 ,66.31 
03,003,01,006,0195,0,1560,28,1588,2266,0,0,0,0,0,0,0,66.31 ,70.08 ,66.31 
03,003,01,006,0196,0,698,8,706,1086,0,0,0,0,0,0,0,66.31 ,65.01 ,66.31 
03,003,01,006,0197,0,1839,39,1878,2669,0,0,0,0,0,0,0,66.31 ,70.36 ,66.31 
03,003,01,006,0198,0,1135,19,1154,1761,0,0,0,0,0,0,0,66.31 ,65.53 ,66.31 
03,003,01,006,0199,0,1099,15,1114,1590,0,0,0,0,0,0,0,66.31 ,70.06 ,66.31 
03,003,01,006,0200,0,1803,26,1829,2614,0,0,0,0,0,0,0,66.31 ,69.97 ,66.31 
03,003,01,006,0201,0,1854,28,1882,2783,0,0,0,0,0,0,0,66.31 ,67.62 ,66.31 
03,003,01,006,0202,0,2467,46,2513,3482,0,0,0,0,0,0,0,66.31 ,72.17 ,66.31 
03,003,01,006,0203,0,801,10,811,1118,0,0,0,0,0,0,0,66.31 ,72.54 ,66.31 
03,003,01,006,0204,0,1065,23,1088,1606,0,0,0,0,0,0,0,66.31 ,67.75 ,66.31 
03,003,01,006,0205,0,1791,26,1817,2741,0,0,0,0,0,0,0,66.31 ,66.29 ,66.31 
03,003,01,006,0206,0,1814,24,1838,2707,0,0,0,0,0,0,0,66.31 ,67.90 ,66.31 
03,003,01,007,0207,0,780,12,792,1202,0,0,0,0,0,0,0,66.31 ,65.89 ,66.31 
03,003,01,007,0208,0,423,4,427,652,0,0,0,0,0,0,0,66.31 ,65.49 ,66.31 
03,003,01,007,0209,0,28,1,29,48,0,0,0,0,0,0,0,66.31 ,60.42 ,66.31 
03,003,01,007,0210,0,26,0,26,42,0,0,0,0,0,0,0,66.31 ,61.90 ,66.31 
03,003,01,007,0211,0,177,1,178,303,0,0,0,0,0,0,0,66.31 ,58.75 ,66.31 
03,003,01,007,0212,0,21,1,22,62,0,0,0,0,0,0,0,66.31 ,35.48 ,66.31 
03,003,01,007,0213,0,68,3,71,108,0,0,0,0,0,0,0,66.31 ,65.74 ,66.31 
03,003,01,007,0214,0,31,0,31,57,0,0,0,0,0,0,0,66.31 ,54.39 ,66.31 
03,003,01,007,0215,0,17,0,17,53,0,0,0,0,0,0,0,66.31 ,32.08 ,66.31 
03,003,01,007,0216,0,109,1,110,331,0,0,0,0,0,0,0,66.31 ,33.23 ,66.31 
03,003,01,008,0217,0,1396,29,1425,2411,0,0,0,0,0,0,0,66.31 ,59.10 ,66.31 
03,003,01,008,0218,0,1765,25,1790,2833,0,0,0,0,0,0,0,66.31 ,63.18 ,66.31 
03,003,01,008,0219,0,1700,23,1723,3116,0,0,0,0,0,0,0,66.31 ,55.30 ,66.31 
03,003,01,008,0220,0,2066,24,2090,3225,0,0,0,0,0,0,0,66.31 ,64.81 ,66.31 
03,003,01,008,0221,0,1715,26,1741,2693,0,0,0,0,0,0,0,66.31 ,64.65 ,66.31 
03,003,01,008,0222,0,2341,39,2380,3533,0,0,0,0,0,0,0,66.31 ,67.36 ,66.31 
03,003,01,008,0223,0,2651,40,2691,4044,0,0,0,0,0,0,0,66.31 ,66.54 ,66.31 
03,003,01,008,0224,0,2527,45,2572,3911,0,0,0,0,0,0,0,66.31 ,65.76 ,66.31 
03,003,01,008,0225,0,1899,30,1929,2914,0,0,0,0,0,0,0,66.31 ,66.20 ,66.31 
03,003,01,008,0226,0,1662,36,1698,2489,0,0,0,0,0,0,0,66.31 ,68.22 ,66.31 
03,003,01,008,0227,0,1914,20,1934,3066,0,0,0,0,0,0,0,66.31 ,63.08 ,66.31 
03,003,01,008,0228,0,1857,21,1878,2984,0,0,0,0,0,0,0,66.31 ,62.94 ,66.31 
03,003,01,008,0229,0,2195,42,2237,3556,0,0,0,0,0,0,0,66.31 ,62.91 ,66.31 
03,003,01,008,0230,0,2452,33,2485,3871,0,0,0,0,0,0,0,66.31 ,64.20 ,66.31 
03,003,01,008,0231,0,1535,33,1568,2478,0,0,0,0,0,0,0,66.31 ,63.28 ,66.31 
03,003,01,008,0232,0,1826,34,1860,2772,0,0,0,0,0,0,0,66.31 ,67.10 ,66.31 
03,003,01,008,0233,0,2487,48,2535,3713,0,0,0,0,0,0,0,66.31 ,68.27 ,66.31 
03,003,01,008,0234,0,1742,26,1768,2896,0,0,0,0,0,0,0,66.31 ,61.05 ,66.31 
03,003,01,008,0235,0,1211,13,1224,2234,0,0,0,0,0,0,0,66.31 ,54.79 ,66.31 
03,003,01,008,0236,0,1667,9,1676,2557,0,0,0,0,0,0,0,66.31 ,65.55 ,66.31 
03,003,01,008,0237,0,1586,13,1599,2325,0,0,0,0,0,0,0,66.31 ,68.77 ,66.31 
03,003,01,008,0238,0,1810,12,1822,2987,0,0,0,0,0,0,0,66.31 ,61.00 ,66.31 
03,003,01,008,0239,0,1350,16,1366,2037,0,0,0,0,0,0,0,66.31 ,67.06 ,66.31 
03,003,01,008,0240,0,1066,16,1082,1659,0,0,0,0,0,0,0,66.31 ,65.22 ,66.31 
03,003,01,008,0241,0,1406,24,1430,2178,0,0,0,0,0,0,0,66.31 ,65.66 ,66.31 
03,003,01,008,0242,0,1327,15,1342,2186,0,0,0,0,0,0,0,66.31 ,61.39 ,66.31 
03,003,01,008,0243,0,950,20,970,1473,0,0,0,0,0,0,0,66.31 ,65.85 ,66.31 
03,003,01,008,0244,0,2333,32,2365,3674,0,0,0,0,0,0,0,66.31 ,64.37 ,66.31 
03,003,01,008,0245,0,1850,27,1877,2953,0,0,0,0,0,0,0,66.31 ,63.56 ,66.31 
03,003,01,008,0246,0,1722,21,1743,3252,0,0,0,0,0,0,0,66.31 ,53.60 ,66.31 
03,003,01,008,0247,0,1006,26,1032,1517,0,0,0,0,0,0,0,66.31 ,68.03 ,66.31 
03,003,01,008,0248,0,1325,11,1336,2330,0,0,0,0,0,0,0,66.31 ,57.34 ,66.31 
03,003,01,008,0249,0,2208,25,2233,3482,0,0,0,0,0,0,0,66.31 ,64.13 ,66.31 
03,003,01,008,0250,0,1571,32,1603,2481,0,0,0,0,0,0,0,66.31 ,64.61 ,66.31 
03,003,01,008,0251,0,1446,23,1469,2309,0,0,0,0,0,0,0,66.31 ,63.62 ,66.31 
03,003,01,008,0252,0,1574,23,1597,2459,0,0,0,0,0,0,0,66.31 ,64.95 ,66.31 
03,003,01,008,0253,0,2341,26,2367,3584,0,0,0,0,0,0,0,66.31 ,66.04 ,66.31 
03,003,01,008,0254,0,1160,23,1183,1843,0,0,0,0,0,0,0,66.31 ,64.19 ,66.31 
03,003,01,008,0255,0,2059,26,2085,3365,0,0,0,0,0,0,0,66.31 ,61.96 ,66.31 
03,003,01,008,0256,0,2061,26,2087,3162,0,0,0,0,0,0,0,66.31 ,66.00 ,66.31 
03,003,01,008,0257,0,2282,33,2315,3682,0,0,0,0,0,0,0,66.31 ,62.87 ,66.31 
03,003,01,008,0258,0,1179,21,1200,1802,0,0,0,0,0,0,0,66.31 ,66.59 ,66.31 
03,003,01,008,0259,0,1559,29,1588,2461,0,0,0,0,0,0,0,66.31 ,64.53 ,66.31 
03,003,01,008,0260,0,1110,13,1123,2038,0,0,0,0,0,0,0,66.31 ,55.10 ,66.31 
03,003,01,008,0261,0,2169,22,2191,3392,0,0,0,0,0,0,0,66.31 ,64.59 ,66.31 
03,003,01,008,0262,0,2849,41,2890,4703,0,0,0,0,0,0,0,66.31 ,61.45 ,66.31 
03,003,01,008,0263,0,2243,32,2275,3525,0,0,0,0,0,0,0,66.31 ,64.54 ,66.31 
03,003,01,008,0264,0,3114,33,3147,4932,0,0,0,0,0,0,0,66.31 ,63.81 ,66.31 
03,003,01,008,0265,0,2351,26,2377,3700,0,0,0,0,0,0,0,66.31 ,64.24 ,66.31 
03,003,01,008,0266,0,2960,40,3000,4677,0,0,0,0,0,0,0,66.31 ,64.14 ,66.31 
03,003,01,008,0267,0,1917,22,1939,3440,0,0,0,0,0,0,0,66.31 ,56.37 ,66.31 
03,003,01,008,0268,0,2110,28,2138,3586,0,0,0,0,0,0,0,66.31 ,59.62 ,66.31 
03,003,01,008,0269,0,1032,8,1040,1487,0,0,0,0,0,0,0,66.31 ,69.94 ,66.31 
03,003,01,008,0270,0,1077,6,1083,1808,0,0,0,0,0,0,0,66.31 ,59.90 ,66.31 
03,003,01,008,0271,0,1047,7,1054,1622,0,0,0,0,0,0,0,66.31 ,64.98 ,66.31 
03,003,01,008,0272,0,2794,35,2829,4416,0,0,0,0,0,0,0,66.31 ,64.06 ,66.31 
03,003,01,008,0273,0,1564,22,1586,2311,0,0,0,0,0,0,0,66.31 ,68.63 ,66.31 
03,003,01,008,0274,0,699,4,703,1015,0,0,0,0,0,0,0,66.31 ,69.26 ,66.31 
03,003,01,008,0275,0,590,5,595,927,0,0,0,0,0,0,0,66.31 ,64.19 ,66.31 
03,003,01,008,0276,0,656,5,661,1066,0,0,0,0,0,0,0,66.31 ,62.01 ,66.31 
03,003,01,008,0277,0,722,5,727,1109,0,0,0,0,0,0,0,66.31 ,65.55 ,66.31 
03,003,01,008,0278,0,1460,16,1476,2131,0,0,0,0,0,0,0,66.31 ,69.26 ,66.31 
03,003,01,008,0279,0,2246,25,2271,3484,0,0,0,0,0,0,0,66.31 ,65.18 ,66.31 
03,003,01,008,0280,0,2477,25,2502,4176,0,0,0,0,0,0,0,66.31 ,59.91 ,66.31 
03,003,01,008,0281,0,1742,23,1765,2867,0,0,0,0,0,0,0,66.31 ,61.56 ,66.31 
03,003,01,008,0282,0,1623,27,1650,2432,0,0,0,0,0,0,0,66.31 ,67.85 ,66.31 
03,003,01,008,0283,0,2212,32,2244,3571,0,0,0,0,0,0,0,66.31 ,62.84 ,66.31 
03,003,01,008,0284,0,1932,32,1964,3115,0,0,0,0,0,0,0,66.31 ,63.05 ,66.31 
03,003,01,008,0285,0,1366,12,1378,1992,0,0,0,0,0,0,0,66.31 ,69.18 ,66.31 
03,003,01,008,0286,0,884,15,899,1384,0,0,0,0,0,0,0,66.31 ,64.96 ,66.31 
03,003,01,008,0287,0,1986,22,2008,3127,0,0,0,0,0,0,0,66.31 ,64.21 ,66.31 
03,003,01,008,0288,0,1877,26,1903,2706,0,0,0,0,0,0,0,66.31 ,70.33 ,66.31 
03,003,01,008,0289,0,1840,31,1871,2584,0,0,0,0,0,0,0,66.31 ,72.41 ,66.31 
03,003,01,008,0290,0,1536,22,1558,2162,0,0,0,0,0,0,0,66.31 ,72.06 ,66.31 
03,003,01,009,0291,0,2046,28,2074,3124,0,0,0,0,0,0,0,66.31 ,66.39 ,66.31 
03,003,01,009,0292,0,2037,33,2070,3318,0,0,0,0,0,0,0,66.31 ,62.39 ,66.31 
03,003,01,009,0293,0,2189,25,2214,3789,0,0,0,0,0,0,0,66.31 ,58.43 ,66.31 
03,003,01,009,0294,0,1208,24,1232,1828,0,0,0,0,0,0,0,66.31 ,67.40 ,66.31 
03,003,01,009,0295,0,1043,10,1053,1599,0,0,0,0,0,0,0,66.31 ,65.85 ,66.31 
03,003,01,009,0296,0,1385,17,1402,2190,0,0,0,0,0,0,0,66.31 ,64.02 ,66.31 
03,003,01,009,0297,0,1469,20,1489,2277,0,0,0,0,0,0,0,66.31 ,65.39 ,66.31 
03,003,01,009,0298,0,1055,13,1068,1500,0,0,0,0,0,0,0,66.31 ,71.20 ,66.31 
03,003,01,009,0299,0,2126,30,2156,3287,0,0,0,0,0,0,0,66.31 ,65.59 ,66.31 
03,003,01,009,0300,0,1698,23,1721,2634,0,0,0,0,0,0,0,66.31 ,65.34 ,66.31 
03,003,01,009,0301,0,1661,15,1676,2623,0,0,0,0,0,0,0,66.31 ,63.90 ,66.31 
03,003,01,009,0302,0,1551,33,1584,2422,0,0,0,0,0,0,0,66.31 ,65.40 ,66.31 
03,003,01,009,0303,0,1935,28,1963,2874,0,0,0,0,0,0,0,66.31 ,68.30 ,66.31 
03,003,01,009,0304,0,1386,30,1416,2184,0,0,0,0,0,0,0,66.31 ,64.84 ,66.31 
03,003,01,009,0305,0,894,14,908,1305,0,0,0,0,0,0,0,66.31 ,69.58 ,66.31 
03,003,01,009,0306,0,812,12,824,1296,0,0,0,0,0,0,0,66.31 ,63.58 ,66.31 
03,003,01,009,0307,0,1615,31,1646,2340,0,0,0,0,0,0,0,66.31 ,70.34 ,66.31 
03,003,01,009,0308,0,1917,35,1952,2965,0,0,0,0,0,0,0,66.31 ,65.83 ,66.31 
03,003,01,009,0309,0,1726,35,1761,2701,0,0,0,0,0,0,0,66.31 ,65.20 ,66.31 
03,003,01,009,0310,0,1324,28,1352,2051,0,0,0,0,0,0,0,66.31 ,65.92 ,66.31 
03,003,01,009,0311,0,1508,33,1541,2422,0,0,0,0,0,0,0,66.31 ,63.63 ,66.31 
03,003,01,009,0312,0,2141,25,2166,3333,0,0,0,0,0,0,0,66.31 ,64.99 ,66.31 
03,003,01,009,0313,0,2495,47,2542,3810,0,0,0,0,0,0,0,66.31 ,66.72 ,66.31 
03,003,01,009,0314,0,881,13,894,1301,0,0,0,0,0,0,0,66.31 ,68.72 ,66.31 
03,003,01,009,0315,0,2794,42,2836,4164,0,0,0,0,0,0,0,66.31 ,68.11 ,66.31 
03,003,01,009,0316,0,1607,29,1636,2470,0,0,0,0,0,0,0,66.31 ,66.23 ,66.31 
03,003,01,009,0317,0,2125,26,2151,3457,0,0,0,0,0,0,0,66.31 ,62.22 ,66.31 
03,003,01,009,0318,0,1833,19,1852,2921,0,0,0,0,0,0,0,66.31 ,63.40 ,66.31 
03,003,01,009,0319,0,3001,42,3043,4916,0,0,0,0,0,0,0,66.31 ,61.90 ,66.31 
03,003,01,009,0320,0,2785,32,2817,4309,0,0,0,0,0,0,0,66.31 ,65.37 ,66.31 
03,003,01,009,0321,0,1806,21,1827,2976,0,0,0,0,0,0,0,66.31 ,61.39 ,66.31 
03,003,01,009,0322,0,2238,37,2275,3854,0,0,0,0,0,0,0,66.31 ,59.03 ,66.31 
03,003,01,009,0323,0,1835,26,1861,3188,0,0,0,0,0,0,0,66.31 ,58.38 ,66.31 
03,003,01,009,0324,0,2119,24,2143,3209,0,0,0,0,0,0,0,66.31 ,66.78 ,66.31 
03,003,01,009,0325,0,1512,15,1527,2374,0,0,0,0,0,0,0,66.31 ,64.32 ,66.31 
03,003,01,009,0326,0,1950,49,1999,2931,0,0,0,0,0,0,0,66.31 ,68.20 ,66.31 
03,003,01,009,0327,0,1354,21,1375,2041,0,0,0,0,0,0,0,66.31 ,67.37 ,66.31 
03,003,01,009,0328,0,4166,78,4244,6694,0,0,0,0,0,0,0,66.31 ,63.40 ,66.31 
03,003,01,009,0329,0,1921,26,1947,3033,0,0,0,0,0,0,0,66.31 ,64.19 ,66.31 
03,003,01,009,0330,0,1312,12,1324,1913,0,0,0,0,0,0,0,66.31 ,69.21 ,66.31 
03,003,01,009,0331,0,1424,20,1444,2189,0,0,0,0,0,0,0,66.31 ,65.97 ,66.31 
03,003,01,010,0332,0,2395,42,2437,3684,0,0,0,0,0,0,0,66.31 ,66.15 ,66.31 
03,003,01,010,0333,0,1083,13,1096,1530,0,0,0,0,0,0,0,66.31 ,71.63 ,66.31 
03,003,01,010,0334,0,1727,22,1749,2564,0,0,0,0,0,0,0,66.31 ,68.21 ,66.31 
03,003,01,010,0335,0,995,10,1005,1417,0,0,0,0,0,0,0,66.31 ,70.92 ,66.31 
03,003,01,010,0336,0,1193,8,1201,1695,0,0,0,0,0,0,0,66.31 ,70.86 ,66.31 
03,003,01,010,0337,0,661,10,671,1109,0,0,0,0,0,0,0,66.31 ,60.50 ,66.31 
03,003,01,010,0338,0,2022,32,2054,3211,0,0,0,0,0,0,0,66.31 ,63.97 ,66.31 
03,003,01,010,0339,0,1180,8,1188,2010,0,0,0,0,0,0,0,66.31 ,59.10 ,66.31 
03,003,01,010,0340,0,1297,19,1316,2212,0,0,0,0,0,0,0,66.31 ,59.49 ,66.31 
03,003,01,010,0341,0,1348,9,1357,2606,0,0,0,0,0,0,0,66.31 ,52.07 ,66.31 
03,003,01,010,0342,0,1378,22,1400,2371,0,0,0,0,0,0,0,66.31 ,59.05 ,66.31 
03,003,01,010,0343,0,1035,15,1050,2143,0,0,0,0,0,0,0,66.31 ,49.00 ,66.31 
03,003,01,010,0344,0,1758,16,1774,2640,0,0,0,0,0,0,0,66.31 ,67.20 ,66.31 
03,003,01,010,0345,0,1022,14,1036,1760,0,0,0,0,0,0,0,66.31 ,58.86 ,66.31 
03,003,01,010,0346,0,1811,14,1825,2615,0,0,0,0,0,0,0,66.31 ,69.79 ,66.31 
03,003,01,010,0347,0,771,9,780,1122,0,0,0,0,0,0,0,66.31 ,69.52 ,66.31 
03,003,01,010,0348,0,926,20,946,1581,0,0,0,0,0,0,0,66.31 ,59.84 ,66.31 
03,003,01,010,0349,0,1367,11,1378,2043,0,0,0,0,0,0,0,66.31 ,67.45 ,66.31 
03,003,01,010,0350,0,2070,34,2104,3164,0,0,0,0,0,0,0,66.31 ,66.50 ,66.31 
03,003,01,010,0351,0,1839,42,1881,2782,0,0,0,0,0,0,0,66.31 ,67.61 ,66.31 
03,003,01,010,0352,0,1651,26,1677,2487,0,0,0,0,0,0,0,66.31 ,67.43 ,66.31 
03,003,01,010,0353,0,1051,12,1063,1635,0,0,0,0,0,0,0,66.31 ,65.02 ,66.31 
03,003,01,010,0354,0,1918,33,1951,2772,0,0,0,0,0,0,0,66.31 ,70.38 ,66.31 
03,003,01,010,0355,0,2692,38,2730,3855,0,0,0,0,0,0,0,66.31 ,70.82 ,66.31 
03,003,01,010,0356,0,1190,11,1201,1729,0,0,0,0,0,0,0,66.31 ,69.46 ,66.31 
03,003,01,010,0357,0,1410,24,1434,2491,0,0,0,0,0,0,0,66.31 ,57.57 ,66.31 
03,003,01,010,0358,0,1606,34,1640,2769,0,0,0,0,0,0,0,66.31 ,59.23 ,66.31 
03,003,01,010,0359,0,1379,11,1390,2058,0,0,0,0,0,0,0,66.31 ,67.54 ,66.31 
03,003,01,010,0360,0,2022,43,2065,3202,0,0,0,0,0,0,0,66.31 ,64.49 ,66.31 
03,003,01,010,0361,0,639,7,646,1214,0,0,0,0,0,0,0,66.31 ,53.21 ,66.31 
03,003,01,010,0362,0,1314,21,1335,2011,0,0,0,0,0,0,0,66.31 ,66.38 ,66.31 
03,003,01,010,0363,0,810,15,825,1205,0,0,0,0,0,0,0,66.31 ,68.46 ,66.31 
03,003,01,010,0364,0,985,22,1007,1675,0,0,0,0,0,0,0,66.31 ,60.12 ,66.31 
03,003,01,010,0365,0,1831,22,1853,2802,0,0,0,0,0,0,0,66.31 ,66.13 ,66.31 
03,003,01,010,0366,0,1768,27,1795,2774,0,0,0,0,0,0,0,66.31 ,64.71 ,66.31 
03,003,01,011,0367,0,3261,51,3312,5205,0,0,0,0,0,0,0,66.31 ,63.63 ,66.31 
03,003,01,011,0368,0,2298,29,2327,3368,0,0,0,0,0,0,0,66.31 ,69.09 ,66.31 
03,003,01,011,0369,0,3318,62,3380,5423,0,0,0,0,0,0,0,66.31 ,62.33 ,66.31 
03,003,01,011,0370,0,511,9,520,720,0,0,0,0,0,0,0,66.31 ,72.22 ,66.31 
03,003,01,011,0371,0,3133,59,3192,4745,0,0,0,0,0,0,0,66.31 ,67.27 ,66.31 
03,003,01,011,0372,0,2932,49,2981,4821,0,0,0,0,0,0,0,66.31 ,61.83 ,66.31 
03,003,01,011,0373,0,1524,21,1545,2390,0,0,0,0,0,0,0,66.31 ,64.64 ,66.31 
03,003,01,011,0374,0,1445,6,1451,2009,0,0,0,0,0,0,0,66.31 ,72.22 ,66.31 
03,003,01,011,0375,0,4011,63,4074,6239,0,0,0,0,0,0,0,66.31 ,65.30 ,66.31 
03,003,01,011,0376,0,2368,38,2406,4041,0,0,0,0,0,0,0,66.31 ,59.54 ,66.31 
03,003,01,011,0377,0,4454,79,4533,7342,0,0,0,0,0,0,0,66.31 ,61.74 ,66.31 
03,003,01,011,0378,0,1936,18,1954,2978,0,0,0,0,0,0,0,66.31 ,65.61 ,66.31 
03,003,01,011,0379,0,863,20,883,1290,0,0,0,0,0,0,0,66.31 ,68.45 ,66.31 
03,003,01,011,0380,0,498,9,507,782,0,0,0,0,0,0,0,66.31 ,64.83 ,66.31 
03,003,01,011,0381,0,4282,48,4330,6648,0,0,0,0,0,0,0,66.31 ,65.13 ,66.31 
03,003,01,011,0382,0,1353,22,1375,2197,0,0,0,0,0,0,0,66.31 ,62.59 ,66.31 
03,003,01,011,0383,0,1359,24,1383,2199,0,0,0,0,0,0,0,66.31 ,62.89 ,66.31 
03,003,01,011,0384,0,563,12,575,802,0,0,0,0,0,0,0,66.31 ,71.70 ,66.31 
03,003,01,011,0385,0,507,3,510,672,0,0,0,0,0,0,0,66.31 ,75.89 ,66.31 
03,003,01,012,0386,0,1686,12,1698,2268,0,0,0,0,0,0,0,66.31 ,74.87 ,66.31 
03,003,01,012,0387,0,2072,16,2088,2755,0,0,0,0,0,0,0,66.31 ,75.79 ,66.31 
03,003,01,012,0388,0,861,10,871,1168,0,0,0,0,0,0,0,66.31 ,74.57 ,66.31 
03,003,01,012,0389,0,1905,34,1939,2692,0,0,0,0,0,0,0,66.31 ,72.03 ,66.31 
03,003,01,012,0390,0,1213,13,1226,1617,0,0,0,0,0,0,0,66.31 ,75.82 ,66.31 
03,003,01,012,0391,0,789,7,796,1052,0,0,0,0,0,0,0,66.31 ,75.67 ,66.31 
03,003,01,012,0392,0,1042,15,1057,1345,0,0,0,0,0,0,0,66.31 ,78.59 ,66.31 
03,003,01,012,0393,0,1385,17,1402,1853,0,0,0,0,0,0,0,66.31 ,75.66 ,66.31 
03,003,01,012,0394,0,1213,15,1228,1686,0,0,0,0,0,0,0,66.31 ,72.84 ,66.31 
03,003,01,012,0395,0,1862,20,1882,2630,0,0,0,0,0,0,0,66.31 ,71.56 ,66.31 
03,003,01,012,0396,0,950,12,962,1328,0,0,0,0,0,0,0,66.31 ,72.44 ,66.31 
03,003,01,012,0397,0,1123,8,1131,1498,0,0,0,0,0,0,0,66.31 ,75.50 ,66.31 
03,003,01,012,0398,0,756,12,768,1144,0,0,0,0,0,0,0,66.31 ,67.13 ,66.31 
03,003,01,012,0399,0,561,8,569,802,0,0,0,0,0,0,0,66.31 ,70.95 ,66.31 
03,003,01,012,0400,0,462,5,467,672,0,0,0,0,0,0,0,66.31 ,69.49 ,66.31 
03,003,01,012,0401,0,798,14,812,1082,0,0,0,0,0,0,0,66.31 ,75.05 ,66.31 
03,003,01,012,0402,0,791,17,808,1096,0,0,0,0,0,0,0,66.31 ,73.72 ,66.31 
03,003,01,012,0403,0,1515,14,1529,2125,0,0,0,0,0,0,0,66.31 ,71.95 ,66.31 
03,003,01,012,0404,0,611,7,618,913,0,0,0,0,0,0,0,66.31 ,67.69 ,66.31 
03,003,01,012,0405,0,518,3,521,732,0,0,0,0,0,0,0,66.31 ,71.17 ,66.31 
03,003,01,012,0406,0,571,8,579,820,0,0,0,0,0,0,0,66.31 ,70.61 ,66.31 
03,003,01,012,0407,0,1065,12,1077,1482,0,0,0,0,0,0,0,66.31 ,72.67 ,66.31 
03,003,01,012,0408,0,772,15,787,1054,0,0,0,0,0,0,0,66.31 ,74.67 ,66.31 
03,003,01,013,0409,0,1610,22,1632,2243,0,0,0,0,0,0,0,66.31 ,72.76 ,66.31 
03,003,01,013,0410,0,846,15,861,1133,0,0,0,0,0,0,0,66.31 ,75.99 ,66.31 
03,003,01,013,0411,0,876,13,889,1270,0,0,0,0,0,0,0,66.31 ,70.00 ,66.31 
03,003,01,013,0412,0,774,8,782,1072,0,0,0,0,0,0,0,66.31 ,72.95 ,66.31 
03,003,01,013,0413,0,1011,13,1024,1440,0,0,0,0,0,0,0,66.31 ,71.11 ,66.31 
03,003,01,013,0414,0,482,4,486,667,0,0,0,0,0,0,0,66.31 ,72.86 ,66.31 
03,003,01,013,0415,0,553,2,555,723,0,0,0,0,0,0,0,66.31 ,76.76 ,66.31 
03,003,01,013,0416,0,522,5,527,691,0,0,0,0,0,0,0,66.31 ,76.27 ,66.31 
03,003,01,013,0417,0,788,15,803,1146,0,0,0,0,0,0,0,66.31 ,70.07 ,66.31 
03,003,01,013,0418,0,1113,15,1128,1682,0,0,0,0,0,0,0,66.31 ,67.06 ,66.31 
03,003,01,013,0419,0,1186,14,1200,1674,0,0,0,0,0,0,0,66.31 ,71.68 ,66.31 
03,003,01,013,0420,0,1052,22,1074,1546,0,0,0,0,0,0,0,66.31 ,69.47 ,66.31 
03,003,01,013,0421,0,630,5,635,955,0,0,0,0,0,0,0,66.31 ,66.49 ,66.31 
03,003,01,013,0422,0,2133,44,2177,3188,0,0,0,0,0,0,0,66.31 ,68.29 ,66.31 
03,003,01,013,0423,0,1020,18,1038,1669,0,0,0,0,0,0,0,66.31 ,62.19 ,66.31 
03,003,01,013,0424,0,1023,16,1039,1523,0,0,0,0,0,0,0,66.31 ,68.22 ,66.31 
03,003,01,013,0425,0,1651,28,1679,2460,0,0,0,0,0,0,0,66.31 ,68.25 ,66.31 
03,003,01,013,0426,0,1156,16,1172,1664,0,0,0,0,0,0,0,66.31 ,70.43 ,66.31 
03,003,01,013,0427,0,724,9,733,963,0,0,0,0,0,0,0,66.31 ,76.12 ,66.31 
03,003,01,013,0428,0,1122,13,1135,1623,0,0,0,0,0,0,0,66.31 ,69.93 ,66.31 
03,003,01,013,0429,0,1867,32,1899,2839,0,0,0,0,0,0,0,66.31 ,66.89 ,66.31 
03,003,01,013,0430,0,882,11,893,1446,0,0,0,0,0,0,0,66.31 ,61.76 ,66.31 
03,003,01,013,0431,0,828,12,840,1269,0,0,0,0,0,0,0,66.31 ,66.19 ,66.31 
03,004,01,001,0001,0,643,9,652,979,0,0,0,0,0,0,0,66.31 ,66.60 ,66.31 
03,004,01,001,0002,0,297,5,302,455,0,0,0,0,0,0,0,66.31 ,66.37 ,66.31 
03,004,01,001,0003,0,800,9,809,1423,0,0,0,0,0,0,0,66.31 ,56.85 ,66.31 
03,004,01,001,0004,0,490,5,495,812,0,0,0,0,0,0,0,66.31 ,60.96 ,66.31 
03,004,01,001,0005,0,1362,17,1379,2244,0,0,0,0,0,0,0,66.31 ,61.45 ,66.31 
03,004,01,001,0006,0,2244,41,2285,3888,0,0,0,0,0,0,0,66.31 ,58.77 ,66.31 
03,004,01,001,0007,0,3831,42,3873,7318,0,0,0,0,0,0,0,66.31 ,52.92 ,66.31 
03,004,01,001,0008,0,1527,10,1537,2719,0,0,0,0,0,0,0,66.31 ,56.53 ,66.31 
03,004,01,001,0009,0,2755,33,2788,5255,0,0,0,0,0,0,0,66.31 ,53.05 ,66.31 
03,004,01,001,0010,0,3052,35,3087,5910,0,0,0,0,0,0,0,66.31 ,52.23 ,66.31 
03,004,01,001,0011,0,1617,20,1637,2799,0,0,0,0,0,0,0,66.31 ,58.49 ,66.31 
03,004,01,001,0012,0,2067,35,2102,4405,0,0,0,0,0,0,0,66.31 ,47.72 ,66.31 
03,004,01,001,0013,0,1502,20,1522,3013,0,0,0,0,0,0,0,66.31 ,50.51 ,66.31 
03,004,01,001,0014,0,1452,26,1478,2549,0,0,0,0,0,0,0,66.31 ,57.98 ,66.31 
03,004,01,001,0015,0,604,7,611,1083,0,0,0,0,0,0,0,66.31 ,56.42 ,66.31 
03,004,01,001,0016,0,800,11,811,1464,0,0,0,0,0,0,0,66.31 ,55.40 ,66.31 
03,004,01,001,0017,0,498,6,504,831,0,0,0,0,0,0,0,66.31 ,60.65 ,66.31 
03,004,01,001,0018,0,770,21,791,1447,0,0,0,0,0,0,0,66.31 ,54.66 ,66.31 
03,004,01,001,0019,0,486,11,497,988,0,0,0,0,0,0,0,66.31 ,50.30 ,66.31 
03,004,01,001,0020,0,615,13,628,1149,0,0,0,0,0,0,0,66.31 ,54.66 ,66.31 
03,004,01,001,0021,0,738,12,750,1249,0,0,0,0,0,0,0,66.31 ,60.05 ,66.31 
03,004,01,001,0022,0,684,11,695,1255,0,0,0,0,0,0,0,66.31 ,55.38 ,66.31 
03,004,01,001,0023,0,759,8,767,1447,0,0,0,0,0,0,0,66.31 ,53.01 ,66.31 
03,004,01,002,0024,0,295,5,300,417,0,0,0,0,0,0,0,66.31 ,71.94 ,66.31 
03,004,01,002,0025,0,217,5,222,353,0,0,0,0,0,0,0,66.31 ,62.89 ,66.31 
03,004,01,002,0026,0,269,2,271,383,0,0,0,0,0,0,0,66.31 ,70.76 ,66.31 
03,004,01,002,0027,0,1035,11,1046,1728,0,0,0,0,0,0,0,66.31 ,60.53 ,66.31 
03,004,01,002,0028,0,3105,49,3154,5462,0,0,0,0,0,0,0,66.31 ,57.74 ,66.31 
03,004,01,002,0029,0,1683,14,1697,2632,0,0,0,0,0,0,0,66.31 ,64.48 ,66.31 
03,004,01,002,0030,0,861,15,876,1373,0,0,0,0,0,0,0,66.31 ,63.80 ,66.31 
03,004,01,002,0031,0,1756,29,1785,2909,0,0,0,0,0,0,0,66.31 ,61.36 ,66.31 
03,004,01,002,0032,0,1201,13,1214,1838,0,0,0,0,0,0,0,66.31 ,66.05 ,66.31 
03,004,01,002,0033,0,751,13,764,1202,0,0,0,0,0,0,0,66.31 ,63.56 ,66.31 
03,004,01,002,0034,0,525,3,528,789,0,0,0,0,0,0,0,66.31 ,66.92 ,66.31 
03,004,01,002,0035,0,1317,19,1336,2084,0,0,0,0,0,0,0,66.31 ,64.11 ,66.31 
03,004,01,002,0036,0,1937,25,1962,3216,0,0,0,0,0,0,0,66.31 ,61.01 ,66.31 
03,004,01,002,0037,0,1648,15,1663,2518,0,0,0,0,0,0,0,66.31 ,66.04 ,66.31 
03,004,01,002,0038,0,979,16,995,1488,0,0,0,0,0,0,0,66.31 ,66.87 ,66.31 
03,004,01,002,0039,0,744,11,755,1270,0,0,0,0,0,0,0,66.31 ,59.45 ,66.31 
03,004,01,002,0040,0,930,6,936,1420,0,0,0,0,0,0,0,66.31 ,65.92 ,66.31 
03,004,01,002,0041,0,3213,40,3253,5038,0,0,0,0,0,0,0,66.31 ,64.57 ,66.31 
03,004,01,002,0042,0,2554,39,2593,4552,0,0,0,0,0,0,0,66.31 ,56.96 ,66.31 
03,004,01,002,0043,0,317,2,319,464,0,0,0,0,0,0,0,66.31 ,68.75 ,66.31 
03,004,01,002,0044,0,2246,36,2282,3995,0,0,0,0,0,0,0,66.31 ,57.12 ,66.31 
03,004,01,002,0045,0,3067,43,3110,5235,0,0,0,0,0,0,0,66.31 ,59.41 ,66.31 
03,004,01,002,0046,0,1904,29,1933,3245,0,0,0,0,0,0,0,66.31 ,59.57 ,66.31 
03,004,01,002,0047,0,839,12,851,1332,0,0,0,0,0,0,0,66.31 ,63.89 ,66.31 
03,004,01,002,0048,0,394,7,401,695,0,0,0,0,0,0,0,66.31 ,57.70 ,66.31 
03,004,01,003,0049,0,630,15,645,992,0,0,0,0,0,0,0,66.31 ,65.02 ,66.31 
03,004,01,003,0050,0,431,6,437,670,0,0,0,0,0,0,0,66.31 ,65.22 ,66.31 
03,004,01,003,0051,0,632,4,636,1010,0,0,0,0,0,0,0,66.31 ,62.97 ,66.31 
03,004,01,003,0052,0,1475,21,1496,2292,0,0,0,0,0,0,0,66.31 ,65.27 ,66.31 
03,004,01,003,0053,0,964,10,974,1621,0,0,0,0,0,0,0,66.31 ,60.09 ,66.31 
03,004,01,003,0054,0,1135,14,1149,1741,0,0,0,0,0,0,0,66.31 ,66.00 ,66.31 
03,004,01,003,0055,0,1653,21,1674,2665,0,0,0,0,0,0,0,66.31 ,62.81 ,66.31 
03,004,01,003,0056,0,929,12,941,1394,0,0,0,0,0,0,0,66.31 ,67.50 ,66.31 
03,004,01,003,0057,0,303,3,306,440,0,0,0,0,0,0,0,66.31 ,69.55 ,66.31 
03,004,01,003,0058,0,439,8,447,692,0,0,0,0,0,0,0,66.31 ,64.60 ,66.31 
03,004,01,003,0059,0,422,9,431,613,0,0,0,0,0,0,0,66.31 ,70.31 ,66.31 
03,004,01,003,0060,0,776,11,787,1084,0,0,0,0,0,0,0,66.31 ,72.60 ,66.31 
03,004,01,003,0061,0,709,12,721,1074,0,0,0,0,0,0,0,66.31 ,67.13 ,66.31 
03,004,01,003,0062,0,457,3,460,701,0,0,0,0,0,0,0,66.31 ,65.62 ,66.31 
03,004,01,003,0063,0,2057,39,2096,3445,0,0,0,0,0,0,0,66.31 ,60.84 ,66.31 
03,004,01,003,0064,0,929,8,937,1524,0,0,0,0,0,0,0,66.31 ,61.48 ,66.31 
03,004,01,003,0065,0,1040,17,1057,1664,0,0,0,0,0,0,0,66.31 ,63.52 ,66.31 
03,004,01,003,0066,0,635,10,645,978,0,0,0,0,0,0,0,66.31 ,65.95 ,66.31 
03,004,01,003,0067,0,453,3,456,657,0,0,0,0,0,0,0,66.31 ,69.41 ,66.31 
03,004,01,004,0068,0,422,4,426,600,0,0,0,0,0,0,0,66.31 ,71.00 ,66.31 
03,004,01,004,0069,0,1023,21,1044,1564,0,0,0,0,0,0,0,66.31 ,66.75 ,66.31 
03,004,01,004,0070,0,490,6,496,745,0,0,0,0,0,0,0,66.31 ,66.58 ,66.31 
03,004,01,004,0071,0,2107,24,2131,3364,0,0,0,0,0,0,0,66.31 ,63.35 ,66.31 
03,004,01,004,0072,0,507,4,511,741,0,0,0,0,0,0,0,66.31 ,68.96 ,66.31 
03,004,01,004,0073,0,577,8,585,898,0,0,0,0,0,0,0,66.31 ,65.14 ,66.31 
03,004,01,004,0074,0,634,9,643,1019,0,0,0,0,0,0,0,66.31 ,63.10 ,66.31 
03,004,01,004,0075,0,1589,24,1613,2608,0,0,0,0,0,0,0,66.31 ,61.85 ,66.31 
03,004,01,004,0076,0,456,7,463,719,0,0,0,0,0,0,0,66.31 ,64.39 ,66.31 
03,004,01,004,0077,0,671,11,682,1104,0,0,0,0,0,0,0,66.31 ,61.78 ,66.31 
03,004,01,004,0078,0,668,9,677,975,0,0,0,0,0,0,0,66.31 ,69.44 ,66.31 
03,004,01,004,0079,0,400,12,412,610,0,0,0,0,0,0,0,66.31 ,67.54 ,66.31 
03,004,01,004,0080,0,342,7,349,529,0,0,0,0,0,0,0,66.31 ,65.97 ,66.31 
03,004,01,004,0081,0,404,5,409,639,0,0,0,0,0,0,0,66.31 ,64.01 ,66.31 
03,004,01,004,0082,0,527,5,532,918,0,0,0,0,0,0,0,66.31 ,57.95 ,66.31 
03,004,01,004,0083,0,474,3,477,699,0,0,0,0,0,0,0,66.31 ,68.24 ,66.31 
03,004,01,004,0084,0,1203,15,1218,1769,0,0,0,0,0,0,0,66.31 ,68.85 ,66.31 
03,004,01,004,0085,0,612,8,620,947,0,0,0,0,0,0,0,66.31 ,65.47 ,66.31 
03,004,01,004,0086,0,596,7,603,821,0,0,0,0,0,0,0,66.31 ,73.45 ,66.31 
03,004,01,004,0087,0,457,4,461,634,0,0,0,0,0,0,0,66.31 ,72.71 ,66.31 
03,004,01,004,0088,0,546,4,550,761,0,0,0,0,0,0,0,66.31 ,72.27 ,66.31 
03,004,01,005,0089,0,2723,46,2769,4453,0,0,0,0,0,0,0,66.31 ,62.18 ,66.31 
03,004,01,005,0090,0,1767,28,1795,2943,0,0,0,0,0,0,0,66.31 ,60.99 ,66.31 
03,004,01,005,0091,0,2103,42,2145,3493,0,0,0,0,0,0,0,66.31 ,61.41 ,66.31 
03,004,01,005,0092,0,551,4,555,825,0,0,0,0,0,0,0,66.31 ,67.27 ,66.31 
03,004,01,005,0093,0,733,10,743,1137,0,0,0,0,0,0,0,66.31 ,65.35 ,66.31 
03,004,01,005,0094,0,2637,38,2675,4099,0,0,0,0,0,0,0,66.31 ,65.26 ,66.31 
03,004,01,005,0095,0,2979,54,3033,4905,0,0,0,0,0,0,0,66.31 ,61.83 ,66.31 
03,004,01,005,0096,0,594,13,607,1000,0,0,0,0,0,0,0,66.31 ,60.70 ,66.31 
03,004,01,005,0097,0,1421,33,1454,2319,0,0,0,0,0,0,0,66.31 ,62.70 ,66.31 
03,004,01,005,0098,0,627,2,629,997,0,0,0,0,0,0,0,66.31 ,63.09 ,66.31 
03,004,01,005,0099,0,1332,12,1344,2142,0,0,0,0,0,0,0,66.31 ,62.75 ,66.31 
03,004,01,005,0100,0,1324,23,1347,2033,0,0,0,0,0,0,0,66.31 ,66.26 ,66.31 
03,004,01,005,0101,0,769,14,783,1264,0,0,0,0,0,0,0,66.31 ,61.95 ,66.31 
03,004,01,005,0102,0,1953,46,1999,3123,0,0,0,0,0,0,0,66.31 ,64.01 ,66.31 
03,004,01,005,0103,0,2613,41,2654,4595,0,0,0,0,0,0,0,66.31 ,57.76 ,66.31 
03,004,01,005,0104,0,1385,30,1415,2389,0,0,0,0,0,0,0,66.31 ,59.23 ,66.31 
03,004,01,006,0105,0,545,9,554,794,0,0,0,0,0,0,0,66.31 ,69.77 ,66.31 
03,004,01,006,0106,0,969,16,985,1578,0,0,0,0,0,0,0,66.31 ,62.42 ,66.31 
03,004,01,006,0107,0,821,12,833,1281,0,0,0,0,0,0,0,66.31 ,65.03 ,66.31 
03,004,01,006,0108,0,1008,8,1016,2025,0,0,0,0,0,0,0,66.31 ,50.17 ,66.31 
03,004,01,006,0109,0,482,7,489,755,0,0,0,0,0,0,0,66.31 ,64.77 ,66.31 
03,004,01,006,0110,0,1053,26,1079,1957,0,0,0,0,0,0,0,66.31 ,55.14 ,66.31 
03,004,01,006,0111,0,735,14,749,1269,0,0,0,0,0,0,0,66.31 ,59.02 ,66.31 
03,004,01,006,0112,0,1028,14,1042,1795,0,0,0,0,0,0,0,66.31 ,58.05 ,66.31 
03,004,01,006,0113,0,2809,38,2847,5163,0,0,0,0,0,0,0,66.31 ,55.14 ,66.31 
03,004,01,006,0114,0,701,11,712,1176,0,0,0,0,0,0,0,66.31 ,60.54 ,66.31 
03,004,01,006,0115,0,563,7,570,903,0,0,0,0,0,0,0,66.31 ,63.12 ,66.31 
03,004,01,006,0116,0,3308,58,3366,5811,0,0,0,0,0,0,0,66.31 ,57.92 ,66.31 
03,004,01,006,0117,0,1948,40,1988,3773,0,0,0,0,0,0,0,66.31 ,52.69 ,66.31 
03,004,01,007,0118,0,314,2,316,431,0,0,0,0,0,0,0,66.31 ,73.32 ,66.31 
03,004,01,007,0119,0,370,6,376,508,0,0,0,0,0,0,0,66.31 ,74.02 ,66.31 
03,004,01,007,0120,0,513,3,516,760,0,0,0,0,0,0,0,66.31 ,67.89 ,66.31 
03,004,01,007,0121,0,276,2,278,379,0,0,0,0,0,0,0,66.31 ,73.35 ,66.31 
03,004,01,007,0122,0,1460,14,1474,2203,0,0,0,0,0,0,0,66.31 ,66.91 ,66.31 
03,004,01,007,0123,0,974,14,988,1397,0,0,0,0,0,0,0,66.31 ,70.72 ,66.31 
03,004,01,007,0124,0,383,4,387,533,0,0,0,0,0,0,0,66.31 ,72.61 ,66.31 
03,004,01,007,0125,0,380,5,385,577,0,0,0,0,0,0,0,66.31 ,66.72 ,66.31 
03,004,01,007,0126,0,1252,18,1270,1844,0,0,0,0,0,0,0,66.31 ,68.87 ,66.31 
03,004,01,007,0127,0,966,16,982,1397,0,0,0,0,0,0,0,66.31 ,70.29 ,66.31 
03,004,01,007,0128,0,1553,12,1565,2445,0,0,0,0,0,0,0,66.31 ,64.01 ,66.31 
03,004,01,007,0129,0,722,9,731,1018,0,0,0,0,0,0,0,66.31 ,71.81 ,66.31 
03,004,01,008,0130,0,2044,19,2063,3168,0,0,0,0,0,0,0,66.31 ,65.12 ,66.31 
03,004,01,008,0131,0,560,5,565,812,0,0,0,0,0,0,0,66.31 ,69.58 ,66.31 
03,004,01,008,0132,0,102,1,103,145,0,0,0,0,0,0,0,66.31 ,71.03 ,66.31 
03,004,01,008,0133,0,90,2,92,135,0,0,0,0,0,0,0,66.31 ,68.15 ,66.31 
03,004,01,008,0134,0,214,1,215,327,0,0,0,0,0,0,0,66.31 ,65.75 ,66.31 
03,004,01,008,0135,0,705,8,713,1103,0,0,0,0,0,0,0,66.31 ,64.64 ,66.31 
03,004,01,008,0136,0,599,6,605,859,0,0,0,0,0,0,0,66.31 ,70.43 ,66.31 
03,004,01,008,0137,0,323,4,327,481,0,0,0,0,0,0,0,66.31 ,67.98 ,66.31 
03,004,01,008,0138,0,771,13,784,1131,0,0,0,0,0,0,0,66.31 ,69.32 ,66.31 
03,004,01,008,0139,0,1088,15,1103,1522,0,0,0,0,0,0,0,66.31 ,72.47 ,66.31 
03,004,01,008,0140,0,893,12,905,1283,0,0,0,0,0,0,0,66.31 ,70.54 ,66.31 
03,004,01,009,0141,0,723,2,725,1127,0,0,0,0,0,0,0,66.31 ,64.33 ,66.31 
03,004,01,009,0142,0,822,7,829,1275,0,0,0,0,0,0,0,66.31 ,65.02 ,66.31 
03,004,01,009,0143,0,327,5,332,482,0,0,0,0,0,0,0,66.31 ,68.88 ,66.31 
03,004,01,009,0144,0,1489,20,1509,2298,0,0,0,0,0,0,0,66.31 ,65.67 ,66.31 
03,004,01,009,0145,0,467,8,475,762,0,0,0,0,0,0,0,66.31 ,62.34 ,66.31 
03,004,01,009,0146,0,218,5,223,327,0,0,0,0,0,0,0,66.31 ,68.20 ,66.31 
03,004,01,009,0147,0,413,8,421,620,0,0,0,0,0,0,0,66.31 ,67.90 ,66.31 
03,004,01,009,0148,0,227,3,230,347,0,0,0,0,0,0,0,66.31 ,66.28 ,66.31 
03,004,01,009,0149,0,182,3,185,310,0,0,0,0,0,0,0,66.31 ,59.68 ,66.31 
03,004,01,010,0150,0,1759,27,1786,3317,0,0,0,0,0,0,0,66.31 ,53.84 ,66.31 
03,004,01,010,0151,0,487,2,489,902,0,0,0,0,0,0,0,66.31 ,54.21 ,66.31 
03,004,01,010,0152,0,529,4,533,763,0,0,0,0,0,0,0,66.31 ,69.86 ,66.31 
03,004,01,010,0153,0,707,5,712,1131,0,0,0,0,0,0,0,66.31 ,62.95 ,66.31 
03,004,01,010,0154,0,453,5,458,633,0,0,0,0,0,0,0,66.31 ,72.35 ,66.31 
03,004,01,010,0155,0,467,3,470,703,0,0,0,0,0,0,0,66.31 ,66.86 ,66.31 
03,004,01,010,0156,0,452,1,453,627,0,0,0,0,0,0,0,66.31 ,72.25 ,66.31 
03,004,01,010,0157,0,397,3,400,558,0,0,0,0,0,0,0,66.31 ,71.68 ,66.31 
03,004,01,010,0158,0,347,6,353,550,0,0,0,0,0,0,0,66.31 ,64.18 ,66.31 
03,004,01,011,0159,0,632,2,634,892,0,0,0,0,0,0,0,66.31 ,71.08 ,66.31 
03,004,01,011,0160,0,448,4,452,677,0,0,0,0,0,0,0,66.31 ,66.77 ,66.31 
03,004,01,011,0161,0,439,4,443,631,0,0,0,0,0,0,0,66.31 ,70.21 ,66.31 
03,004,01,011,0162,0,436,5,441,645,0,0,0,0,0,0,0,66.31 ,68.37 ,66.31 
03,004,01,011,0163,0,811,13,824,1197,0,0,0,0,0,0,0,66.31 ,68.84 ,66.31 
03,004,01,011,0164,0,559,2,561,879,0,0,0,0,0,0,0,66.31 ,63.82 ,66.31 
03,004,01,012,0165,0,272,8,280,418,0,0,0,0,0,0,0,66.31 ,66.99 ,66.31 
03,004,01,012,0166,0,15,1,16,41,0,0,0,0,0,0,0,66.31 ,39.02 ,66.31 
03,004,01,012,0167,0,75,1,76,139,0,0,0,0,0,0,0,66.31 ,54.68 ,66.31 
03,004,01,012,0168,0,90,4,94,183,0,0,0,0,0,0,0,66.31 ,51.37 ,66.31 
03,004,01,012,0169,0,70,4,74,143,0,0,0,0,0,0,0,66.31 ,51.75 ,66.31 
03,004,01,012,0170,0,19,0,19,46,0,0,0,0,0,0,0,66.31 ,41.30 ,66.31 
03,004,01,012,0171,0,18,2,20,35,0,0,0,0,0,0,0,66.31 ,57.14 ,66.31 
03,004,01,012,0172,0,29,0,29,65,0,0,0,0,0,0,0,66.31 ,44.62 ,66.31 
03,004,01,013,0173,0,85,0,85,152,0,0,0,0,0,0,0,66.31 ,55.92 ,66.31 
03,004,01,013,0174,0,40,0,40,74,0,0,0,0,0,0,0,66.31 ,54.05 ,66.31 
03,004,01,013,0175,0,7,0,7,11,0,0,0,0,0,0,0,66.31 ,63.64 ,66.31 
03,004,01,013,0176,0,53,1,54,127,0,0,0,0,0,0,0,66.31 ,42.52 ,66.31 
03,005,01,001,0001,0,567,17,584,865,0,0,0,0,0,0,0,66.31 ,67.51 ,66.31 
03,005,01,001,0002,0,680,8,688,1019,0,0,0,0,0,0,0,66.31 ,67.52 ,66.31 
03,005,01,001,0003,0,1839,40,1879,2924,0,0,0,0,0,0,0,66.31 ,64.26 ,66.31 
03,005,01,001,0004,0,2364,28,2392,3606,0,0,0,0,0,0,0,66.31 ,66.33 ,66.31 
03,005,01,001,0005,0,1377,14,1391,2123,0,0,0,0,0,0,0,66.31 ,65.52 ,66.31 
03,005,01,001,0006,0,2112,49,2161,3205,0,0,0,0,0,0,0,66.31 ,67.43 ,66.31 
03,005,01,001,0007,0,605,9,614,924,0,0,0,0,0,0,0,66.31 ,66.45 ,66.31 
03,005,01,001,0008,0,1437,64,1501,2414,0,0,0,0,0,0,0,66.31 ,62.18 ,66.31 
03,005,01,001,0009,0,667,9,676,973,0,0,0,0,0,0,0,66.31 ,69.48 ,66.31 
03,005,01,001,0010,0,744,13,757,1101,0,0,0,0,0,0,0,66.31 ,68.76 ,66.31 
03,005,01,001,0011,0,389,7,396,652,0,0,0,0,0,0,0,66.31 ,60.74 ,66.31 
03,005,01,001,0012,0,1054,21,1075,1542,0,0,0,0,0,0,0,66.31 ,69.71 ,66.31 
03,005,01,001,0013,0,1522,28,1550,2191,0,0,0,0,0,0,0,66.31 ,70.74 ,66.31 
03,005,01,001,0014,0,2273,40,2313,3399,0,0,0,0,0,0,0,66.31 ,68.05 ,66.31 
03,005,01,001,0015,0,2021,23,2044,2953,0,0,0,0,0,0,0,66.31 ,69.22 ,66.31 
03,005,01,001,0016,0,1222,20,1242,1774,0,0,0,0,0,0,0,66.31 ,70.01 ,66.31 
03,005,01,001,0017,0,2414,32,2446,3690,0,0,0,0,0,0,0,66.31 ,66.29 ,66.31 
03,005,01,001,0018,0,3612,52,3664,5252,0,0,0,0,0,0,0,66.31 ,69.76 ,66.31 
03,005,01,001,0019,0,3324,56,3380,5028,0,0,0,0,0,0,0,66.31 ,67.22 ,66.31 
03,005,01,001,0020,0,2165,46,2211,3284,0,0,0,0,0,0,0,66.31 ,67.33 ,66.31 
03,005,01,001,0021,0,2500,39,2539,3913,0,0,0,0,0,0,0,66.31 ,64.89 ,66.31 
03,005,01,001,0022,0,2761,62,2823,4189,0,0,0,0,0,0,0,66.31 ,67.39 ,66.31 
03,005,01,001,0023,0,740,8,748,1067,0,0,0,0,0,0,0,66.31 ,70.10 ,66.31 
03,005,01,001,0024,0,1841,31,1872,2898,0,0,0,0,0,0,0,66.31 ,64.60 ,66.31 
03,005,01,002,0025,0,1133,8,1141,1667,0,0,0,0,0,0,0,66.31 ,68.45 ,66.31 
03,005,01,002,0026,0,1045,14,1059,1578,0,0,0,0,0,0,0,66.31 ,67.11 ,66.31 
03,005,01,002,0027,0,596,10,606,890,0,0,0,0,0,0,0,66.31 ,68.09 ,66.31 
03,005,01,002,0028,0,857,5,862,1302,0,0,0,0,0,0,0,66.31 ,66.21 ,66.31 
03,005,01,002,0029,0,774,13,787,1106,0,0,0,0,0,0,0,66.31 ,71.16 ,66.31 
03,005,01,002,0030,0,1011,19,1030,1499,0,0,0,0,0,0,0,66.31 ,68.71 ,66.31 
03,005,01,002,0031,0,643,4,647,955,0,0,0,0,0,0,0,66.31 ,67.75 ,66.31 
03,005,01,002,0032,0,1330,18,1348,1990,0,0,0,0,0,0,0,66.31 ,67.74 ,66.31 
03,005,01,002,0033,0,1944,14,1958,2899,0,0,0,0,0,0,0,66.31 ,67.54 ,66.31 
03,005,01,002,0034,0,1150,12,1162,1725,0,0,0,0,0,0,0,66.31 ,67.36 ,66.31 
03,005,01,002,0035,0,615,4,619,976,0,0,0,0,0,0,0,66.31 ,63.42 ,66.31 
03,005,01,002,0036,0,404,3,407,611,0,0,0,0,0,0,0,66.31 ,66.61 ,66.31 
03,005,01,002,0037,0,746,1,747,1087,0,0,0,0,0,0,0,66.31 ,68.72 ,66.31 
03,005,01,002,0038,0,1038,18,1056,1587,0,0,0,0,0,0,0,66.31 ,66.54 ,66.31 
03,005,01,002,0039,0,1073,15,1088,1538,0,0,0,0,0,0,0,66.31 ,70.74 ,66.31 
03,005,01,002,0040,0,860,13,873,1252,0,0,0,0,0,0,0,66.31 ,69.73 ,66.31 
03,005,01,002,0041,0,486,3,489,630,0,0,0,0,0,0,0,66.31 ,77.62 ,66.31 
03,005,01,002,0042,0,687,12,699,945,0,0,0,0,0,0,0,66.31 ,73.97 ,66.31 
03,005,01,002,0043,0,483,7,490,737,0,0,0,0,0,0,0,66.31 ,66.49 ,66.31 
03,005,01,002,0044,0,981,10,991,1383,0,0,0,0,0,0,0,66.31 ,71.66 ,66.31 
03,005,01,002,0045,0,1025,14,1039,1503,0,0,0,0,0,0,0,66.31 ,69.13 ,66.31 
03,005,01,002,0046,0,964,11,975,1398,0,0,0,0,0,0,0,66.31 ,69.74 ,66.31 
03,005,01,002,0047,0,1289,18,1307,1925,0,0,0,0,0,0,0,66.31 ,67.90 ,66.31 
03,005,01,002,0048,0,761,9,770,1091,0,0,0,0,0,0,0,66.31 ,70.58 ,66.31 
03,005,01,002,0049,0,852,11,863,1197,0,0,0,0,0,0,0,66.31 ,72.10 ,66.31 
03,005,01,003,0050,0,851,9,860,1259,0,0,0,0,0,0,0,66.31 ,68.31 ,66.31 
03,005,01,003,0051,0,1565,11,1576,2159,0,0,0,0,0,0,0,66.31 ,73.00 ,66.31 
03,005,01,003,0052,0,2311,24,2335,3357,0,0,0,0,0,0,0,66.31 ,69.56 ,66.31 
03,005,01,003,0053,0,904,8,912,1234,0,0,0,0,0,0,0,66.31 ,73.91 ,66.31 
03,005,01,003,0054,0,1076,13,1089,1401,0,0,0,0,0,0,0,66.31 ,77.73 ,66.31 
03,005,01,003,0055,0,1066,13,1079,1433,0,0,0,0,0,0,0,66.31 ,75.30 ,66.31 
03,005,01,003,0056,0,1628,25,1653,2323,0,0,0,0,0,0,0,66.31 ,71.16 ,66.31 
03,005,01,003,0057,0,872,37,909,1211,0,0,0,0,0,0,0,66.31 ,75.06 ,66.31 
03,005,01,003,0058,0,466,3,469,663,0,0,0,0,0,0,0,66.31 ,70.74 ,66.31 
03,005,01,003,0059,0,641,12,653,843,0,0,0,0,0,0,0,66.31 ,77.46 ,66.31 
03,005,01,003,0060,0,727,16,743,1046,0,0,0,0,0,0,0,66.31 ,71.03 ,66.31 
03,005,01,003,0061,0,497,8,505,708,0,0,0,0,0,0,0,66.31 ,71.33 ,66.31 
03,005,01,003,0062,0,591,6,597,770,0,0,0,0,0,0,0,66.31 ,77.53 ,66.31 
03,005,01,003,0063,0,1331,8,1339,1708,0,0,0,0,0,0,0,66.31 ,78.40 ,66.31 
03,005,01,003,0064,0,426,2,428,578,0,0,0,0,0,0,0,66.31 ,74.05 ,66.31 
03,005,01,003,0065,0,713,6,719,947,0,0,0,0,0,0,0,66.31 ,75.92 ,66.31 
03,005,01,003,0066,0,374,2,376,542,0,0,0,0,0,0,0,66.31 ,69.37 ,66.31 
03,005,01,003,0067,0,465,8,473,727,0,0,0,0,0,0,0,66.31 ,65.06 ,66.31 
03,005,01,003,0068,0,1491,19,1510,2070,0,0,0,0,0,0,0,66.31 ,72.95 ,66.31 
03,005,01,003,0069,0,924,11,935,1240,0,0,0,0,0,0,0,66.31 ,75.40 ,66.31 
03,005,01,003,0070,0,572,11,583,768,0,0,0,0,0,0,0,66.31 ,75.91 ,66.31 
03,005,01,003,0071,0,889,8,897,1304,0,0,0,0,0,0,0,66.31 ,68.79 ,66.31 
03,005,01,003,0072,0,599,3,602,828,0,0,0,0,0,0,0,66.31 ,72.71 ,66.31 
03,005,01,004,0073,0,1156,14,1170,1687,0,0,0,0,0,0,0,66.31 ,69.35 ,66.31 
03,005,01,004,0074,0,1647,32,1679,2300,0,0,0,0,0,0,0,66.31 ,73.00 ,66.31 
03,005,01,004,0075,0,1408,23,1431,2131,0,0,0,0,0,0,0,66.31 ,67.15 ,66.31 
03,005,01,004,0076,0,1772,19,1791,2497,0,0,0,0,0,0,0,66.31 ,71.73 ,66.31 
03,005,01,004,0077,0,2098,23,2121,3020,0,0,0,0,0,0,0,66.31 ,70.23 ,66.31 
03,005,01,004,0078,0,1663,22,1685,2273,0,0,0,0,0,0,0,66.31 ,74.13 ,66.31 
03,005,01,004,0079,0,1432,16,1448,2089,0,0,0,0,0,0,0,66.31 ,69.32 ,66.31 
03,005,01,004,0080,0,1754,40,1794,2622,0,0,0,0,0,0,0,66.31 ,68.42 ,66.31 
03,005,01,004,0081,0,2725,34,2759,3706,0,0,0,0,0,0,0,66.31 ,74.45 ,66.31 
03,005,01,004,0082,0,2993,35,3028,4400,0,0,0,0,0,0,0,66.31 ,68.82 ,66.31 
03,005,01,004,0083,0,651,3,654,871,0,0,0,0,0,0,0,66.31 ,75.09 ,66.31 
03,005,01,004,0084,0,1360,16,1376,1981,0,0,0,0,0,0,0,66.31 ,69.46 ,66.31 
03,005,01,004,0085,0,735,10,745,1040,0,0,0,0,0,0,0,66.31 ,71.63 ,66.31 
03,005,01,004,0086,0,998,19,1017,1374,0,0,0,0,0,0,0,66.31 ,74.02 ,66.31 
03,005,01,004,0087,0,381,4,385,486,0,0,0,0,0,0,0,66.31 ,79.22 ,66.31 
03,005,01,004,0088,0,1300,15,1315,1810,0,0,0,0,0,0,0,66.31 ,72.65 ,66.31 
03,005,01,004,0089,0,991,9,1000,1277,0,0,0,0,0,0,0,66.31 ,78.31 ,66.31 
03,005,01,004,0090,0,701,11,712,1043,0,0,0,0,0,0,0,66.31 ,68.26 ,66.31 
03,005,01,004,0091,0,1987,56,2043,2832,0,0,0,0,0,0,0,66.31 ,72.14 ,66.31 
03,005,01,004,0092,0,1560,21,1581,2090,0,0,0,0,0,0,0,66.31 ,75.65 ,66.31 
03,005,01,004,0093,0,1560,27,1587,2156,0,0,0,0,0,0,0,66.31 ,73.61 ,66.31 
03,005,01,004,0094,0,629,11,640,895,0,0,0,0,0,0,0,66.31 ,71.51 ,66.31 
03,005,01,005,0095,0,1343,19,1362,1901,0,0,0,0,0,0,0,66.31 ,71.65 ,66.31 
03,005,01,005,0096,0,1265,16,1281,1801,0,0,0,0,0,0,0,66.31 ,71.13 ,66.31 
03,005,01,005,0097,0,1890,27,1917,2630,0,0,0,0,0,0,0,66.31 ,72.89 ,66.31 
03,005,01,005,0098,0,2235,43,2278,3339,0,0,0,0,0,0,0,66.31 ,68.22 ,66.31 
03,005,01,005,0099,0,1672,25,1697,2693,0,0,0,0,0,0,0,66.31 ,63.02 ,66.31 
03,005,01,005,0100,0,1477,18,1495,2191,0,0,0,0,0,0,0,66.31 ,68.23 ,66.31 
03,005,01,005,0101,0,499,10,509,787,0,0,0,0,0,0,0,66.31 ,64.68 ,66.31 
03,005,01,005,0102,0,1446,28,1474,2357,0,0,0,0,0,0,0,66.31 ,62.54 ,66.31 
03,005,01,005,0103,0,2572,24,2596,4016,0,0,0,0,0,0,0,66.31 ,64.64 ,66.31 
03,005,01,005,0104,0,521,10,531,727,0,0,0,0,0,0,0,66.31 ,73.04 ,66.31 
03,005,01,005,0105,0,984,7,991,1440,0,0,0,0,0,0,0,66.31 ,68.82 ,66.31 
03,005,01,005,0106,0,735,6,741,995,0,0,0,0,0,0,0,66.31 ,74.47 ,66.31 
03,005,01,005,0107,0,1221,16,1237,1924,0,0,0,0,0,0,0,66.31 ,64.29 ,66.31 
03,005,01,005,0108,0,1384,14,1398,2021,0,0,0,0,0,0,0,66.31 ,69.17 ,66.31 
03,005,01,005,0109,0,2454,34,2488,3754,0,0,0,0,0,0,0,66.31 ,66.28 ,66.31 
03,005,01,005,0110,0,1410,22,1432,2226,0,0,0,0,0,0,0,66.31 ,64.33 ,66.31 
03,005,01,005,0111,0,1391,19,1410,2275,0,0,0,0,0,0,0,66.31 ,61.98 ,66.31 
03,005,01,005,0112,0,1049,17,1066,1696,0,0,0,0,0,0,0,66.31 ,62.85 ,66.31 
03,005,01,005,0113,0,1327,12,1339,2069,0,0,0,0,0,0,0,66.31 ,64.72 ,66.31 
03,005,01,005,0114,0,724,11,735,1022,0,0,0,0,0,0,0,66.31 ,71.92 ,66.31 
03,005,01,005,0115,0,918,14,932,1449,0,0,0,0,0,0,0,66.31 ,64.32 ,66.31 
03,005,01,005,0116,0,1039,8,1047,1604,0,0,0,0,0,0,0,66.31 ,65.27 ,66.31 
03,005,01,005,0117,0,1056,24,1080,1742,0,0,0,0,0,0,0,66.31 ,62.00 ,66.31 
03,005,01,005,0118,0,1642,22,1664,2539,0,0,0,0,0,0,0,66.31 ,65.54 ,66.31 
03,005,01,005,0119,0,953,13,966,1292,0,0,0,0,0,0,0,66.31 ,74.77 ,66.31 
03,005,01,005,0120,0,913,7,920,1270,0,0,0,0,0,0,0,66.31 ,72.44 ,66.31 
03,005,01,005,0121,0,621,9,630,847,0,0,0,0,0,0,0,66.31 ,74.38 ,66.31 
03,005,01,005,0122,0,1475,20,1495,2335,0,0,0,0,0,0,0,66.31 ,64.03 ,66.31 
03,005,01,005,0123,0,1181,14,1195,1848,0,0,0,0,0,0,0,66.31 ,64.66 ,66.31 
03,005,01,006,0124,0,1104,12,1116,1468,0,0,0,0,0,0,0,66.31 ,76.02 ,66.31 
03,005,01,006,0125,0,750,0,750,945,0,0,0,0,0,0,0,66.31 ,79.37 ,66.31 
03,005,01,006,0126,0,1006,19,1025,1391,0,0,0,0,0,0,0,66.31 ,73.69 ,66.31 
03,005,01,006,0127,0,2387,24,2411,3098,0,0,0,0,0,0,0,66.31 ,77.82 ,66.31 
03,005,01,006,0128,0,1531,16,1547,2068,0,0,0,0,0,0,0,66.31 ,74.81 ,66.31 
03,005,01,006,0129,0,965,13,978,1250,0,0,0,0,0,0,0,66.31 ,78.24 ,66.31 
03,005,01,006,0130,0,922,6,928,1184,0,0,0,0,0,0,0,66.31 ,78.38 ,66.31 
03,005,01,006,0131,0,1650,14,1664,2061,0,0,0,0,0,0,0,66.31 ,80.74 ,66.31 
03,005,01,006,0132,0,1048,11,1059,1307,0,0,0,0,0,0,0,66.31 ,81.03 ,66.31 
03,005,01,006,0133,0,485,8,493,632,0,0,0,0,0,0,0,66.31 ,78.01 ,66.31 
03,005,01,006,0134,0,1005,7,1012,1401,0,0,0,0,0,0,0,66.31 ,72.23 ,66.31 
03,005,01,006,0135,0,1168,13,1181,1629,0,0,0,0,0,0,0,66.31 ,72.50 ,66.31 
03,005,01,006,0136,0,997,8,1005,1380,0,0,0,0,0,0,0,66.31 ,72.83 ,66.31 
03,005,01,006,0137,0,725,9,734,1008,0,0,0,0,0,0,0,66.31 ,72.82 ,66.31 
03,005,01,006,0138,0,858,11,869,1258,0,0,0,0,0,0,0,66.31 ,69.08 ,66.31 
03,005,01,006,0139,0,722,7,729,1062,0,0,0,0,0,0,0,66.31 ,68.64 ,66.31 
03,005,01,006,0140,0,549,1,550,755,0,0,0,0,0,0,0,66.31 ,72.85 ,66.31 
03,005,01,006,0141,0,791,6,797,1115,0,0,0,0,0,0,0,66.31 ,71.48 ,66.31 
03,005,01,006,0142,0,490,10,500,658,0,0,0,0,0,0,0,66.31 ,75.99 ,66.31 
03,005,01,006,0143,0,927,14,941,1256,0,0,0,0,0,0,0,66.31 ,74.92 ,66.31 
03,005,01,006,0144,0,601,3,604,836,0,0,0,0,0,0,0,66.31 ,72.25 ,66.31 
03,005,01,006,0145,0,810,6,816,1274,0,0,0,0,0,0,0,66.31 ,64.05 ,66.31 
03,005,01,006,0146,0,863,12,875,1318,0,0,0,0,0,0,0,66.31 ,66.39 ,66.31 
03,005,01,007,0147,0,1619,24,1643,2106,0,0,0,0,0,0,0,66.31 ,78.02 ,66.31 
03,005,01,007,0148,0,870,12,882,1134,0,0,0,0,0,0,0,66.31 ,77.78 ,66.31 
03,005,01,007,0149,0,605,9,614,798,0,0,0,0,0,0,0,66.31 ,76.94 ,66.31 
03,005,01,007,0150,0,1157,14,1171,1546,0,0,0,0,0,0,0,66.31 ,75.74 ,66.31 
03,005,01,007,0151,0,801,23,824,986,0,0,0,0,0,0,0,66.31 ,83.57 ,66.31 
03,005,01,007,0152,0,424,7,431,572,0,0,0,0,0,0,0,66.31 ,75.35 ,66.31 
03,005,01,007,0153,0,586,3,589,722,0,0,0,0,0,0,0,66.31 ,81.58 ,66.31 
03,005,01,007,0154,0,1406,29,1435,1912,0,0,0,0,0,0,0,66.31 ,75.05 ,66.31 
03,005,01,007,0155,0,1569,37,1606,2025,0,0,0,0,0,0,0,66.31 ,79.31 ,66.31 
03,005,01,007,0156,0,1112,19,1131,1440,0,0,0,0,0,0,0,66.31 ,78.54 ,66.31 
03,005,01,007,0157,0,530,7,537,718,0,0,0,0,0,0,0,66.31 ,74.79 ,66.31 
03,005,01,008,0158,0,1234,11,1245,1702,0,0,0,0,0,0,0,66.31 ,73.15 ,66.31 
03,005,01,008,0159,0,562,4,566,702,0,0,0,0,0,0,0,66.31 ,80.63 ,66.31 
03,005,01,008,0160,0,1200,14,1214,1606,0,0,0,0,0,0,0,66.31 ,75.59 ,66.31 
03,005,01,008,0161,0,1019,10,1029,1369,0,0,0,0,0,0,0,66.31 ,75.16 ,66.31 
03,005,01,008,0162,0,474,7,481,705,0,0,0,0,0,0,0,66.31 ,68.23 ,66.31 
03,005,01,008,0163,0,929,8,937,1256,0,0,0,0,0,0,0,66.31 ,74.60 ,66.31 
03,005,01,008,0164,0,559,10,569,749,0,0,0,0,0,0,0,66.31 ,75.97 ,66.31 
03,005,01,008,0165,0,1117,19,1136,1529,0,0,0,0,0,0,0,66.31 ,74.30 ,66.31 
03,005,01,008,0166,0,588,2,590,777,0,0,0,0,0,0,0,66.31 ,75.93 ,66.31 
03,005,01,008,0167,0,425,6,431,562,0,0,0,0,0,0,0,66.31 ,76.69 ,66.31 
03,005,01,008,0168,0,695,12,707,982,0,0,0,0,0,0,0,66.31 ,72.00 ,66.31 
03,005,01,008,0169,0,700,7,707,928,0,0,0,0,0,0,0,66.31 ,76.19 ,66.31 
03,005,01,009,0170,0,1112,17,1129,1517,0,0,0,0,0,0,0,66.31 ,74.42 ,66.31 
03,005,01,009,0171,0,1518,24,1542,2139,0,0,0,0,0,0,0,66.31 ,72.09 ,66.31 
03,005,01,009,0172,0,1722,24,1746,2484,0,0,0,0,0,0,0,66.31 ,70.29 ,66.31 
03,005,01,009,0173,0,1328,15,1343,1873,0,0,0,0,0,0,0,66.31 ,71.70 ,66.31 
03,005,01,009,0174,0,1088,23,1111,1548,0,0,0,0,0,0,0,66.31 ,71.77 ,66.31 
03,005,01,009,0175,0,655,7,662,934,0,0,0,0,0,0,0,66.31 ,70.88 ,66.31 
03,005,01,009,0176,0,795,7,802,1046,0,0,0,0,0,0,0,66.31 ,76.67 ,66.31 
03,005,01,009,0177,0,302,3,305,412,0,0,0,0,0,0,0,66.31 ,74.03 ,66.31 
03,005,01,009,0178,0,1029,15,1044,1456,0,0,0,0,0,0,0,66.31 ,71.70 ,66.31 
03,005,01,009,0179,0,1029,12,1041,1352,0,0,0,0,0,0,0,66.31 ,77.00 ,66.31 
03,005,01,009,0180,0,263,2,265,332,0,0,0,0,0,0,0,66.31 ,79.82 ,66.31 
03,005,01,009,0181,0,1256,19,1275,1739,0,0,0,0,0,0,0,66.31 ,73.32 ,66.31 
03,005,01,009,0182,0,751,8,759,1014,0,0,0,0,0,0,0,66.31 ,74.85 ,66.31 
03,005,01,009,0183,0,991,12,1003,1343,0,0,0,0,0,0,0,66.31 ,74.68 ,66.31 
03,005,01,009,0184,0,954,9,963,1292,0,0,0,0,0,0,0,66.31 ,74.54 ,66.31 
03,005,01,009,0185,0,992,9,1001,1330,0,0,0,0,0,0,0,66.31 ,75.26 ,66.31 
03,005,01,009,0186,0,886,10,896,1141,0,0,0,0,0,0,0,66.31 ,78.53 ,66.31 
03,005,01,009,0187,0,157,4,161,215,0,0,0,0,0,0,0,66.31 ,74.88 ,66.31 
03,005,01,009,0188,0,253,1,254,322,0,0,0,0,0,0,0,66.31 ,78.88 ,66.31 
03,005,01,010,0189,0,761,10,771,1034,0,0,0,0,0,0,0,66.31 ,74.56 ,66.31 
03,005,01,010,0190,0,1198,20,1218,1659,0,0,0,0,0,0,0,66.31 ,73.42 ,66.31 
03,005,01,010,0191,0,744,11,755,1069,0,0,0,0,0,0,0,66.31 ,70.63 ,66.31 
03,005,01,010,0192,0,2934,48,2982,3942,0,0,0,0,0,0,0,66.31 ,75.65 ,66.31 
03,005,01,010,0193,0,938,18,956,1292,0,0,0,0,0,0,0,66.31 ,73.99 ,66.31 
03,005,01,010,0194,0,964,12,976,1264,0,0,0,0,0,0,0,66.31 ,77.22 ,66.31 
03,005,01,010,0195,0,1883,30,1913,2606,0,0,0,0,0,0,0,66.31 ,73.41 ,66.31 
03,005,01,010,0196,0,478,3,481,630,0,0,0,0,0,0,0,66.31 ,76.35 ,66.31 
03,005,01,010,0197,0,378,3,381,551,0,0,0,0,0,0,0,66.31 ,69.15 ,66.31 
03,005,01,010,0198,0,433,8,441,611,0,0,0,0,0,0,0,66.31 ,72.18 ,66.31 
03,005,01,011,0199,0,864,13,877,1309,0,0,0,0,0,0,0,66.31 ,67.00 ,66.31 
03,005,01,011,0200,0,499,3,502,719,0,0,0,0,0,0,0,66.31 ,69.82 ,66.31 
03,005,01,011,0201,0,736,6,742,1121,0,0,0,0,0,0,0,66.31 ,66.19 ,66.31 
03,005,01,011,0202,0,586,8,594,910,0,0,0,0,0,0,0,66.31 ,65.27 ,66.31 
03,005,01,011,0203,0,662,15,677,1041,0,0,0,0,0,0,0,66.31 ,65.03 ,66.31 
03,005,01,011,0204,0,721,17,738,1117,0,0,0,0,0,0,0,66.31 ,66.07 ,66.31 
03,005,01,011,0205,0,734,5,739,1091,0,0,0,0,0,0,0,66.31 ,67.74 ,66.31 
03,005,01,011,0206,0,297,6,303,468,0,0,0,0,0,0,0,66.31 ,64.74 ,66.31 
03,005,01,011,0207,0,180,4,184,290,0,0,0,0,0,0,0,66.31 ,63.45 ,66.31 
03,005,01,012,0208,0,1746,15,1761,2310,0,0,0,0,0,0,0,66.31 ,76.23 ,66.31 
03,005,01,012,0209,0,1177,9,1186,1504,0,0,0,0,0,0,0,66.31 ,78.86 ,66.31 
03,005,01,012,0210,0,484,4,488,636,0,0,0,0,0,0,0,66.31 ,76.73 ,66.31 
03,005,01,012,0211,0,675,10,685,877,0,0,0,0,0,0,0,66.31 ,78.11 ,66.31 
03,005,01,012,0212,0,258,1,259,352,0,0,0,0,0,0,0,66.31 ,73.58 ,66.31 
03,005,01,012,0213,0,1369,15,1384,1834,0,0,0,0,0,0,0,66.31 ,75.46 ,66.31 
03,005,01,012,0214,0,885,7,892,1147,0,0,0,0,0,0,0,66.31 ,77.77 ,66.31 
03,005,01,012,0215,0,282,2,284,372,0,0,0,0,0,0,0,66.31 ,76.34 ,66.31 
03,005,01,013,0216,0,2834,41,2875,3827,0,0,0,0,0,0,0,66.31 ,75.12 ,66.31 
03,005,01,013,0217,0,1955,20,1975,2663,0,0,0,0,0,0,0,66.31 ,74.16 ,66.31 
03,005,01,013,0218,0,1241,20,1261,1611,0,0,0,0,0,0,0,66.31 ,78.27 ,66.31 
03,005,01,013,0219,0,1035,18,1053,1336,0,0,0,0,0,0,0,66.31 ,78.82 ,66.31 
03,005,01,013,0220,0,937,11,948,1227,0,0,0,0,0,0,0,66.31 ,77.26 ,66.31 
03,005,01,013,0221,0,310,7,317,384,0,0,0,0,0,0,0,66.31 ,82.55 ,66.31 
03,005,01,013,0222,0,901,13,914,1150,0,0,0,0,0,0,0,66.31 ,79.48 ,66.31 
03,005,01,014,0223,0,462,6,468,623,0,0,0,0,0,0,0,66.31 ,75.12 ,66.31 
03,005,01,014,0224,0,410,7,417,571,0,0,0,0,0,0,0,66.31 ,73.03 ,66.31 
03,005,01,014,0225,0,642,10,652,915,0,0,0,0,0,0,0,66.31 ,71.26 ,66.31 
03,005,01,014,0226,0,502,5,507,666,0,0,0,0,0,0,0,66.31 ,76.13 ,66.31 
03,005,01,014,0227,0,691,9,700,998,0,0,0,0,0,0,0,66.31 ,70.14 ,66.31 
03,005,01,014,0228,0,402,3,405,538,0,0,0,0,0,0,0,66.31 ,75.28 ,66.31 
03,005,01,014,0229,0,387,5,392,544,0,0,0,0,0,0,0,66.31 ,72.06 ,66.31 
03,005,01,014,0230,0,806,9,815,1171,0,0,0,0,0,0,0,66.31 ,69.60 ,66.31 
03,005,01,014,0231,0,448,3,451,694,0,0,0,0,0,0,0,66.31 ,64.99 ,66.31 
03,005,01,015,0232,0,1215,17,1232,1608,0,0,0,0,0,0,0,66.31 ,76.62 ,66.31 
03,005,01,015,0233,0,420,3,423,530,0,0,0,0,0,0,0,66.31 ,79.81 ,66.31 
03,005,01,015,0234,0,701,7,708,946,0,0,0,0,0,0,0,66.31 ,74.84 ,66.31 
03,005,01,015,0235,0,2164,29,2193,2796,0,0,0,0,0,0,0,66.31 ,78.43 ,66.31 
03,005,01,015,0236,0,445,3,448,556,0,0,0,0,0,0,0,66.31 ,80.58 ,66.31 
03,005,01,015,0237,0,442,3,445,538,0,0,0,0,0,0,0,66.31 ,82.71 ,66.31 
03,005,01,015,0238,0,1038,19,1057,1356,0,0,0,0,0,0,0,66.31 ,77.95 ,66.31 
03,005,01,015,0239,0,574,10,584,731,0,0,0,0,0,0,0,66.31 ,79.89 ,66.31 
03,005,01,015,0240,0,776,7,783,995,0,0,0,0,0,0,0,66.31 ,78.69 ,66.31 
03,005,01,016,0241,0,1488,18,1506,2078,0,0,0,0,0,0,0,66.31 ,72.47 ,66.31 
03,005,01,016,0242,0,477,8,485,609,0,0,0,0,0,0,0,66.31 ,79.64 ,66.31 
03,005,01,016,0243,0,588,4,592,862,0,0,0,0,0,0,0,66.31 ,68.68 ,66.31 
03,005,01,016,0244,0,189,7,196,247,0,0,0,0,0,0,0,66.31 ,79.35 ,66.31 
03,005,01,016,0245,0,421,4,425,592,0,0,0,0,0,0,0,66.31 ,71.79 ,66.31 
03,005,01,016,0246,0,466,5,471,672,0,0,0,0,0,0,0,66.31 ,70.09 ,66.31 
03,005,01,016,0247,0,381,4,385,520,0,0,0,0,0,0,0,66.31 ,74.04 ,66.31 
03,005,01,016,0248,0,255,4,259,335,0,0,0,0,0,0,0,66.31 ,77.31 ,66.31 
03,005,01,017,0249,0,208,0,208,293,0,0,0,0,0,0,0,66.31 ,70.99 ,66.31 
03,005,01,017,0250,0,490,7,497,668,0,0,0,0,0,0,0,66.31 ,74.40 ,66.31 
03,005,01,017,0251,0,762,6,768,980,0,0,0,0,0,0,0,66.31 ,78.37 ,66.31 
03,005,01,017,0252,0,451,4,455,638,0,0,0,0,0,0,0,66.31 ,71.32 ,66.31 
03,005,01,017,0253,0,471,4,475,676,0,0,0,0,0,0,0,66.31 ,70.27 ,66.31 
03,005,01,017,0254,0,284,6,290,376,0,0,0,0,0,0,0,66.31 ,77.13 ,66.31 
03,005,01,017,0255,0,566,10,576,778,0,0,0,0,0,0,0,66.31 ,74.04 ,66.31 
03,005,01,018,0256,0,108,1,109,132,0,0,0,0,0,0,0,66.31 ,82.58 ,66.31 
03,005,01,018,0257,0,213,3,216,353,0,0,0,0,0,0,0,66.31 ,61.19 ,66.31 
03,005,01,018,0258,0,496,11,507,681,0,0,0,0,0,0,0,66.31 ,74.45 ,66.31 
03,005,01,018,0259,0,69,1,70,102,0,0,0,0,0,0,0,66.31 ,68.63 ,66.31 
03,005,01,018,0260,0,95,1,96,128,0,0,0,0,0,0,0,66.31 ,75.00 ,66.31 
03,005,01,018,0261,0,18,0,18,27,0,0,0,0,0,0,0,66.31 ,66.67 ,66.31 
03,005,01,018,0262,0,39,0,39,53,0,0,0,0,0,0,0,66.31 ,73.58 ,66.31 
03,005,01,018,0263,0,19,0,19,32,0,0,0,0,0,0,0,66.31 ,59.38 ,66.31 
03,006,01,001,0001,0,1376,28,1404,1941,0,0,0,0,0,0,0,66.31 ,72.33 ,66.31 
03,006,01,001,0002,0,665,7,672,959,0,0,0,0,0,0,0,66.31 ,70.07 ,66.31 
03,006,01,001,0003,0,536,11,547,850,0,0,0,0,0,0,0,66.31 ,64.35 ,66.31 
03,006,01,001,0004,0,677,6,683,924,0,0,0,0,0,0,0,66.31 ,73.92 ,66.31 
03,006,01,001,0005,0,606,11,617,842,0,0,0,0,0,0,0,66.31 ,73.28 ,66.31 
03,006,01,001,0006,0,2863,46,2909,4258,0,0,0,0,0,0,0,66.31 ,68.32 ,66.31 
03,006,01,001,0007,0,1380,20,1400,1994,0,0,0,0,0,0,0,66.31 ,70.21 ,66.31 
03,006,01,001,0008,0,1549,23,1572,2183,0,0,0,0,0,0,0,66.31 ,72.01 ,66.31 
03,006,01,001,0009,0,2429,56,2485,3419,0,0,0,0,0,0,0,66.31 ,72.68 ,66.31 
03,006,01,001,0010,0,3446,85,3531,5446,0,0,0,0,0,0,0,66.31 ,64.84 ,66.31 
03,006,01,001,0011,0,1153,23,1176,1700,0,0,0,0,0,0,0,66.31 ,69.18 ,66.31 
03,006,01,001,0012,0,800,14,814,1093,0,0,0,0,0,0,0,66.31 ,74.47 ,66.31 
03,006,01,001,0013,0,1767,28,1795,2611,0,0,0,0,0,0,0,66.31 ,68.75 ,66.31 
03,006,01,001,0014,0,704,11,715,881,0,0,0,0,0,0,0,66.31 ,81.16 ,66.31 
03,006,01,001,0015,0,602,5,607,880,0,0,0,0,0,0,0,66.31 ,68.98 ,66.31 
03,006,01,001,0016,0,3003,50,3053,4557,0,0,0,0,0,0,0,66.31 ,67.00 ,66.31 
03,006,01,001,0017,0,1432,17,1449,2031,0,0,0,0,0,0,0,66.31 ,71.34 ,66.31 
03,006,01,001,0018,0,1810,15,1825,2637,0,0,0,0,0,0,0,66.31 ,69.21 ,66.31 
03,006,01,001,0019,0,4285,89,4374,6922,0,0,0,0,0,0,0,66.31 ,63.19 ,66.31 
03,006,01,001,0020,0,2752,57,2809,4098,0,0,0,0,0,0,0,66.31 ,68.55 ,66.31 
03,006,01,001,0021,0,931,21,952,1451,0,0,0,0,0,0,0,66.31 ,65.61 ,66.31 
03,006,01,001,0022,0,731,6,737,1070,0,0,0,0,0,0,0,66.31 ,68.88 ,66.31 
03,006,01,001,0023,0,2750,50,2800,4325,0,0,0,0,0,0,0,66.31 ,64.74 ,66.31 
03,006,01,001,0024,0,5023,122,5145,7823,0,0,0,0,0,0,0,66.31 ,65.77 ,66.31 
03,006,01,001,0025,0,2260,42,2302,3209,0,0,0,0,0,0,0,66.31 ,71.74 ,66.31 
03,006,01,001,0026,0,1626,22,1648,2360,0,0,0,0,0,0,0,66.31 ,69.83 ,66.31 
03,006,01,001,0027,0,3716,56,3772,5566,0,0,0,0,0,0,0,66.31 ,67.77 ,66.31 
03,006,01,001,0028,0,6110,82,6192,9279,0,0,0,0,0,0,0,66.31 ,66.73 ,66.31 
03,006,01,001,0029,0,1129,22,1151,1556,0,0,0,0,0,0,0,66.31 ,73.97 ,66.31 
03,006,01,001,0030,0,2320,28,2348,3580,0,0,0,0,0,0,0,66.31 ,65.59 ,66.31 
03,006,01,001,0031,0,2268,49,2317,3053,0,0,0,0,0,0,0,66.31 ,75.89 ,66.31 
03,006,01,001,0032,0,1993,38,2031,2772,0,0,0,0,0,0,0,66.31 ,73.27 ,66.31 
03,006,01,001,0033,0,1100,27,1127,1529,0,0,0,0,0,0,0,66.31 ,73.71 ,66.31 
03,006,01,001,0034,0,1480,22,1502,2201,0,0,0,0,0,0,0,66.31 ,68.24 ,66.31 
03,006,01,001,0035,0,1294,47,1341,1790,0,0,0,0,0,0,0,66.31 ,74.92 ,66.31 
03,006,01,001,0036,0,1951,56,2007,2729,0,0,0,0,0,0,0,66.31 ,73.54 ,66.31 
03,006,01,002,0037,0,862,27,889,1179,0,0,0,0,0,0,0,66.31 ,75.40 ,66.31 
03,006,01,002,0038,0,661,13,674,879,0,0,0,0,0,0,0,66.31 ,76.68 ,66.31 
03,006,01,002,0039,0,1057,31,1088,1502,0,0,0,0,0,0,0,66.31 ,72.44 ,66.31 
03,006,01,002,0040,0,1458,35,1493,1926,0,0,0,0,0,0,0,66.31 ,77.52 ,66.31 
03,006,01,002,0041,0,1669,36,1705,2350,0,0,0,0,0,0,0,66.31 ,72.55 ,66.31 
03,006,01,002,0042,0,763,20,783,1014,0,0,0,0,0,0,0,66.31 ,77.22 ,66.31 
03,006,01,002,0043,0,1108,15,1123,1556,0,0,0,0,0,0,0,66.31 ,72.17 ,66.31 
03,006,01,002,0044,0,2212,42,2254,3255,0,0,0,0,0,0,0,66.31 ,69.25 ,66.31 
03,006,01,002,0045,0,1300,16,1316,1842,0,0,0,0,0,0,0,66.31 ,71.44 ,66.31 
03,006,01,002,0046,0,2093,50,2143,2858,0,0,0,0,0,0,0,66.31 ,74.98 ,66.31 
03,006,01,002,0047,0,1021,11,1032,1405,0,0,0,0,0,0,0,66.31 ,73.45 ,66.31 
03,006,01,002,0048,0,3229,55,3284,4295,0,0,0,0,0,0,0,66.31 ,76.46 ,66.31 
03,006,01,002,0049,0,1052,24,1076,1443,0,0,0,0,0,0,0,66.31 ,74.57 ,66.31 
03,006,01,002,0050,0,733,10,743,984,0,0,0,0,0,0,0,66.31 ,75.51 ,66.31 
03,006,01,002,0051,0,714,14,728,896,0,0,0,0,0,0,0,66.31 ,81.25 ,66.31 
03,006,01,002,0052,0,1489,21,1510,1929,0,0,0,0,0,0,0,66.31 ,78.28 ,66.31 
03,006,01,002,0053,0,997,13,1010,1364,0,0,0,0,0,0,0,66.31 ,74.05 ,66.31 
03,006,01,002,0054,0,1265,30,1295,1853,0,0,0,0,0,0,0,66.31 ,69.89 ,66.31 
03,006,01,002,0055,0,1356,27,1383,1838,0,0,0,0,0,0,0,66.31 ,75.24 ,66.31 
03,006,01,002,0056,0,1182,23,1205,1519,0,0,0,0,0,0,0,66.31 ,79.33 ,66.31 
03,006,01,002,0057,0,851,15,866,1224,0,0,0,0,0,0,0,66.31 ,70.75 ,66.31 
03,006,01,002,0058,0,1115,21,1136,1595,0,0,0,0,0,0,0,66.31 ,71.22 ,66.31 
03,006,01,002,0059,0,561,14,575,741,0,0,0,0,0,0,0,66.31 ,77.60 ,66.31 
03,006,01,002,0060,0,554,8,562,662,0,0,0,0,0,0,0,66.31 ,84.89 ,66.31 
03,006,01,002,0061,0,1018,25,1043,1382,0,0,0,0,0,0,0,66.31 ,75.47 ,66.31 
03,006,01,003,0062,0,869,14,883,1211,0,0,0,0,0,0,0,66.31 ,72.91 ,66.31 
03,006,01,003,0063,0,841,14,855,1165,0,0,0,0,0,0,0,66.31 ,73.39 ,66.31 
03,006,01,003,0064,0,1161,25,1186,1640,0,0,0,0,0,0,0,66.31 ,72.32 ,66.31 
03,006,01,003,0065,0,544,11,555,732,0,0,0,0,0,0,0,66.31 ,75.82 ,66.31 
03,006,01,003,0066,0,1319,24,1343,1763,0,0,0,0,0,0,0,66.31 ,76.18 ,66.31 
03,006,01,003,0067,0,1330,25,1355,1861,0,0,0,0,0,0,0,66.31 ,72.81 ,66.31 
03,006,01,003,0068,0,2147,43,2190,2996,0,0,0,0,0,0,0,66.31 ,73.10 ,66.31 
03,006,01,003,0069,0,1174,18,1192,1572,0,0,0,0,0,0,0,66.31 ,75.83 ,66.31 
03,006,01,003,0070,0,2029,52,2081,2963,0,0,0,0,0,0,0,66.31 ,70.23 ,66.31 
03,006,01,003,0071,0,659,17,676,880,0,0,0,0,0,0,0,66.31 ,76.82 ,66.31 
03,006,01,003,0072,0,622,11,633,880,0,0,0,0,0,0,0,66.31 ,71.93 ,66.31 
03,006,01,003,0073,0,1703,38,1741,2401,0,0,0,0,0,0,0,66.31 ,72.51 ,66.31 
03,006,01,003,0074,0,819,22,841,991,0,0,0,0,0,0,0,66.31 ,84.86 ,66.31 
03,006,01,003,0075,0,830,15,845,1031,0,0,0,0,0,0,0,66.31 ,81.96 ,66.31 
03,006,01,003,0076,0,1052,14,1066,1390,0,0,0,0,0,0,0,66.31 ,76.69 ,66.31 
03,006,01,003,0077,0,2873,44,2917,4073,0,0,0,0,0,0,0,66.31 ,71.62 ,66.31 
03,006,01,003,0078,0,824,22,846,1089,0,0,0,0,0,0,0,66.31 ,77.69 ,66.31 
03,006,01,003,0079,0,894,11,905,1433,0,0,0,0,0,0,0,66.31 ,63.15 ,66.31 
03,006,01,003,0080,0,728,14,742,942,0,0,0,0,0,0,0,66.31 ,78.77 ,66.31 
03,006,01,003,0081,0,2232,63,2295,2995,0,0,0,0,0,0,0,66.31 ,76.63 ,66.31 
03,006,01,003,0082,0,880,23,903,1179,0,0,0,0,0,0,0,66.31 ,76.59 ,66.31 
03,006,01,003,0083,0,2043,46,2089,2798,0,0,0,0,0,0,0,66.31 ,74.66 ,66.31 
03,006,01,003,0084,0,1625,24,1649,2259,0,0,0,0,0,0,0,66.31 ,73.00 ,66.31 
03,006,01,003,0085,0,2456,34,2490,3466,0,0,0,0,0,0,0,66.31 ,71.84 ,66.31 
03,006,01,003,0086,0,1025,21,1046,1320,0,0,0,0,0,0,0,66.31 ,79.24 ,66.31 
03,006,01,003,0087,0,1104,23,1127,1441,0,0,0,0,0,0,0,66.31 ,78.21 ,66.31 
03,006,01,003,0088,0,863,13,876,1135,0,0,0,0,0,0,0,66.31 ,77.18 ,66.31 
03,006,01,003,0089,0,840,12,852,1025,0,0,0,0,0,0,0,66.31 ,83.12 ,66.31 
03,006,01,003,0090,0,979,7,986,1230,0,0,0,0,0,0,0,66.31 ,80.16 ,66.31 
03,006,01,004,0091,0,813,24,837,1229,0,0,0,0,0,0,0,66.31 ,68.10 ,66.31 
03,006,01,004,0092,0,790,10,800,1055,0,0,0,0,0,0,0,66.31 ,75.83 ,66.31 
03,006,01,004,0093,0,1330,29,1359,2025,0,0,0,0,0,0,0,66.31 ,67.11 ,66.31 
03,006,01,004,0094,0,539,4,543,741,0,0,0,0,0,0,0,66.31 ,73.28 ,66.31 
03,006,01,004,0095,0,1373,16,1389,1965,0,0,0,0,0,0,0,66.31 ,70.69 ,66.31 
03,006,01,004,0096,0,1006,19,1025,1364,0,0,0,0,0,0,0,66.31 ,75.15 ,66.31 
03,006,01,004,0097,0,520,6,526,701,0,0,0,0,0,0,0,66.31 ,75.04 ,66.31 
03,006,01,004,0098,0,332,7,339,465,0,0,0,0,0,0,0,66.31 ,72.90 ,66.31 
03,006,01,004,0099,0,1737,27,1764,2342,0,0,0,0,0,0,0,66.31 ,75.32 ,66.31 
03,006,01,004,0100,0,2713,36,2749,3762,0,0,0,0,0,0,0,66.31 ,73.07 ,66.31 
03,006,01,004,0101,0,809,21,830,1092,0,0,0,0,0,0,0,66.31 ,76.01 ,66.31 
03,006,01,004,0102,0,1067,22,1089,1370,0,0,0,0,0,0,0,66.31 ,79.49 ,66.31 
03,006,01,004,0103,0,2197,43,2240,3066,0,0,0,0,0,0,0,66.31 ,73.06 ,66.31 
03,006,01,004,0104,0,1933,29,1962,2521,0,0,0,0,0,0,0,66.31 ,77.83 ,66.31 
03,006,01,004,0105,0,1349,25,1374,1750,0,0,0,0,0,0,0,66.31 ,78.51 ,66.31 
03,006,01,004,0106,0,2097,40,2137,3007,0,0,0,0,0,0,0,66.31 ,71.07 ,66.31 
03,006,01,004,0107,0,1390,22,1412,1934,0,0,0,0,0,0,0,66.31 ,73.01 ,66.31 
03,006,01,004,0108,0,982,11,993,1274,0,0,0,0,0,0,0,66.31 ,77.94 ,66.31 
03,006,01,004,0109,0,953,20,973,1243,0,0,0,0,0,0,0,66.31 ,78.28 ,66.31 
03,006,01,004,0110,0,909,30,939,1253,0,0,0,0,0,0,0,66.31 ,74.94 ,66.31 
03,006,01,004,0111,0,757,15,772,987,0,0,0,0,0,0,0,66.31 ,78.22 ,66.31 
03,006,01,004,0112,0,981,14,995,1232,0,0,0,0,0,0,0,66.31 ,80.76 ,66.31 
03,006,01,004,0113,0,1314,17,1331,1922,0,0,0,0,0,0,0,66.31 ,69.25 ,66.31 
03,006,01,004,0114,0,1555,23,1578,2079,0,0,0,0,0,0,0,66.31 ,75.90 ,66.31 
03,006,01,004,0115,0,1254,20,1274,1707,0,0,0,0,0,0,0,66.31 ,74.63 ,66.31 
03,006,01,004,0116,0,1368,23,1391,2006,0,0,0,0,0,0,0,66.31 ,69.34 ,66.31 
03,006,01,004,0117,0,3503,72,3575,4978,0,0,0,0,0,0,0,66.31 ,71.82 ,66.31 
03,006,01,004,0118,0,2067,28,2095,2861,0,0,0,0,0,0,0,66.31 ,73.23 ,66.31 
03,006,01,004,0119,0,835,23,858,1085,0,0,0,0,0,0,0,66.31 ,79.08 ,66.31 
03,006,01,004,0120,0,865,17,882,1101,0,0,0,0,0,0,0,66.31 ,80.11 ,66.31 
03,006,01,004,0121,0,770,5,775,964,0,0,0,0,0,0,0,66.31 ,80.39 ,66.31 
03,006,01,004,0122,0,833,14,847,1132,0,0,0,0,0,0,0,66.31 ,74.82 ,66.31 
03,006,01,005,0123,0,1032,12,1044,1328,0,0,0,0,0,0,0,66.31 ,78.61 ,66.31 
03,006,01,005,0124,0,1732,20,1752,2236,0,0,0,0,0,0,0,66.31 ,78.35 ,66.31 
03,006,01,005,0125,0,843,16,859,1152,0,0,0,0,0,0,0,66.31 ,74.57 ,66.31 
03,006,01,005,0126,0,451,9,460,578,0,0,0,0,0,0,0,66.31 ,79.58 ,66.31 
03,006,01,005,0127,0,1597,26,1623,2189,0,0,0,0,0,0,0,66.31 ,74.14 ,66.31 
03,006,01,005,0128,0,1764,28,1792,2437,0,0,0,0,0,0,0,66.31 ,73.53 ,66.31 
03,006,01,005,0129,0,2528,45,2573,3325,0,0,0,0,0,0,0,66.31 ,77.38 ,66.31 
03,006,01,005,0130,0,2661,38,2699,3471,0,0,0,0,0,0,0,66.31 ,77.76 ,66.31 
03,006,01,005,0131,0,3395,37,3432,4638,0,0,0,0,0,0,0,66.31 ,74.00 ,66.31 
03,006,01,005,0132,0,3386,60,3446,4792,0,0,0,0,0,0,0,66.31 ,71.91 ,66.31 
03,006,01,005,0133,0,650,14,664,831,0,0,0,0,0,0,0,66.31 ,79.90 ,66.31 
03,006,01,005,0134,0,1397,20,1417,1961,0,0,0,0,0,0,0,66.31 ,72.26 ,66.31 
03,006,01,005,0135,0,2031,41,2072,2798,0,0,0,0,0,0,0,66.31 ,74.05 ,66.31 
03,006,01,005,0136,0,889,10,899,1129,0,0,0,0,0,0,0,66.31 ,79.63 ,66.31 
03,006,01,005,0137,0,1060,24,1084,1528,0,0,0,0,0,0,0,66.31 ,70.94 ,66.31 
03,006,01,005,0138,0,1210,16,1226,1580,0,0,0,0,0,0,0,66.31 ,77.59 ,66.31 
03,006,01,005,0139,0,2288,57,2345,3259,0,0,0,0,0,0,0,66.31 ,71.95 ,66.31 
03,006,01,005,0140,0,2452,41,2493,3315,0,0,0,0,0,0,0,66.31 ,75.20 ,66.31 
03,006,01,005,0141,0,1217,27,1244,1594,0,0,0,0,0,0,0,66.31 ,78.04 ,66.31 
03,006,01,005,0142,0,1481,37,1518,1952,0,0,0,0,0,0,0,66.31 ,77.77 ,66.31 
03,006,01,006,0143,0,1533,19,1552,2148,0,0,0,0,0,0,0,66.31 ,72.25 ,66.31 
03,006,01,006,0144,0,1439,32,1471,1972,0,0,0,0,0,0,0,66.31 ,74.59 ,66.31 
03,006,01,006,0145,0,2127,26,2153,3026,0,0,0,0,0,0,0,66.31 ,71.15 ,66.31 
03,006,01,006,0146,0,391,8,399,540,0,0,0,0,0,0,0,66.31 ,73.89 ,66.31 
03,006,01,006,0147,0,813,16,829,1101,0,0,0,0,0,0,0,66.31 ,75.30 ,66.31 
03,006,01,006,0148,0,522,5,527,719,0,0,0,0,0,0,0,66.31 ,73.30 ,66.31 
03,006,01,006,0149,0,3093,64,3157,4356,0,0,0,0,0,0,0,66.31 ,72.47 ,66.31 
03,006,01,006,0150,0,1469,26,1495,2038,0,0,0,0,0,0,0,66.31 ,73.36 ,66.31 
03,006,01,006,0151,0,1693,32,1725,2349,0,0,0,0,0,0,0,66.31 ,73.44 ,66.31 
03,006,01,006,0152,0,3133,63,3196,4381,0,0,0,0,0,0,0,66.31 ,72.95 ,66.31 
03,006,01,006,0153,0,2237,40,2277,3081,0,0,0,0,0,0,0,66.31 ,73.90 ,66.31 
03,006,01,006,0154,0,1266,22,1288,1642,0,0,0,0,0,0,0,66.31 ,78.44 ,66.31 
03,006,01,006,0155,0,1452,31,1483,1926,0,0,0,0,0,0,0,66.31 ,77.00 ,66.31 
03,006,01,006,0156,0,1561,25,1586,1996,0,0,0,0,0,0,0,66.31 ,79.46 ,66.31 
03,006,01,007,0157,0,1359,22,1381,1813,0,0,0,0,0,0,0,66.31 ,76.17 ,66.31 
03,006,01,007,0158,0,1744,41,1785,2282,0,0,0,0,0,0,0,66.31 ,78.22 ,66.31 
03,006,01,007,0159,0,3420,83,3503,4820,0,0,0,0,0,0,0,66.31 ,72.68 ,66.31 
03,006,01,007,0160,0,2424,45,2469,3141,0,0,0,0,0,0,0,66.31 ,78.61 ,66.31 
03,006,01,007,0161,0,1292,21,1313,1693,0,0,0,0,0,0,0,66.31 ,77.55 ,66.31 
03,006,01,007,0162,0,2688,57,2745,3639,0,0,0,0,0,0,0,66.31 ,75.43 ,66.31 
03,006,01,007,0163,0,1424,24,1448,1795,0,0,0,0,0,0,0,66.31 ,80.67 ,66.31 
03,006,01,007,0164,0,1756,41,1797,2271,0,0,0,0,0,0,0,66.31 ,79.13 ,66.31 
03,006,01,007,0165,0,2020,24,2044,2636,0,0,0,0,0,0,0,66.31 ,77.54 ,66.31 
03,006,01,007,0166,0,1398,38,1436,1765,0,0,0,0,0,0,0,66.31 ,81.36 ,66.31 
03,006,01,007,0167,0,909,27,936,1151,0,0,0,0,0,0,0,66.31 ,81.32 ,66.31 
03,006,01,007,0168,0,1124,35,1159,1423,0,0,0,0,0,0,0,66.31 ,81.45 ,66.31 
03,006,01,007,0169,0,1449,40,1489,1820,0,0,0,0,0,0,0,66.31 ,81.81 ,66.31 
03,006,01,007,0170,0,1659,34,1693,2192,0,0,0,0,0,0,0,66.31 ,77.24 ,66.31 
03,006,01,007,0171,0,261,6,267,329,0,0,0,0,0,0,0,66.31 ,81.16 ,66.31 
03,006,01,007,0172,0,1169,20,1189,1477,0,0,0,0,0,0,0,66.31 ,80.50 ,66.31 
03,006,01,007,0173,0,1255,32,1287,1682,0,0,0,0,0,0,0,66.31 ,76.52 ,66.31 
03,006,01,007,0174,0,928,19,947,1197,0,0,0,0,0,0,0,66.31 ,79.11 ,66.31 
03,006,01,008,0175,0,1509,29,1538,2209,0,0,0,0,0,0,0,66.31 ,69.62 ,66.31 
03,006,01,008,0176,0,1001,22,1023,1374,0,0,0,0,0,0,0,66.31 ,74.45 ,66.31 
03,006,01,008,0177,0,1362,25,1387,1927,0,0,0,0,0,0,0,66.31 ,71.98 ,66.31 
03,006,01,008,0178,0,1341,25,1366,1821,0,0,0,0,0,0,0,66.31 ,75.01 ,66.31 
03,006,01,008,0179,0,1461,34,1495,2050,0,0,0,0,0,0,0,66.31 ,72.93 ,66.31 
03,006,01,008,0180,0,1520,31,1551,1918,0,0,0,0,0,0,0,66.31 ,80.87 ,66.31 
03,006,01,008,0181,0,2459,35,2494,3298,0,0,0,0,0,0,0,66.31 ,75.62 ,66.31 
03,006,01,008,0182,0,660,10,670,873,0,0,0,0,0,0,0,66.31 ,76.75 ,66.31 
03,006,01,008,0183,0,3367,57,3424,4520,0,0,0,0,0,0,0,66.31 ,75.75 ,66.31 
03,006,01,008,0184,0,2285,65,2350,3373,0,0,0,0,0,0,0,66.31 ,69.67 ,66.31 
03,006,01,008,0185,0,1325,20,1345,1928,0,0,0,0,0,0,0,66.31 ,69.76 ,66.31 
03,006,01,008,0186,0,1622,32,1654,2414,0,0,0,0,0,0,0,66.31 ,68.52 ,66.31 
03,006,01,008,0187,0,1545,26,1571,2179,0,0,0,0,0,0,0,66.31 ,72.10 ,66.31 
03,006,01,008,0188,0,3822,83,3905,5609,0,0,0,0,0,0,0,66.31 ,69.62 ,66.31 
03,006,01,008,0189,0,1573,28,1601,2097,0,0,0,0,0,0,0,66.31 ,76.35 ,66.31 
03,006,01,008,0190,0,1781,46,1827,2264,0,0,0,0,0,0,0,66.31 ,80.70 ,66.31 
03,006,01,009,0191,0,975,18,993,1412,0,0,0,0,0,0,0,66.31 ,70.33 ,66.31 
03,006,01,009,0192,0,1271,18,1289,1969,0,0,0,0,0,0,0,66.31 ,65.46 ,66.31 
03,006,01,009,0193,0,4700,99,4799,7383,0,0,0,0,0,0,0,66.31 ,65.00 ,66.31 
03,006,01,009,0194,0,3440,66,3506,5719,0,0,0,0,0,0,0,66.31 ,61.30 ,66.31 
03,006,01,009,0195,0,6632,113,6745,10916,0,0,0,0,0,0,0,66.31 ,61.79 ,66.31 
03,006,01,009,0196,0,3015,42,3057,4729,0,0,0,0,0,0,0,66.31 ,64.64 ,66.31 
03,006,01,009,0197,0,5169,97,5266,7600,0,0,0,0,0,0,0,66.31 ,69.29 ,66.31 
03,006,01,009,0198,0,1013,13,1026,1296,0,0,0,0,0,0,0,66.31 ,79.17 ,66.31 
03,006,01,009,0199,0,1700,25,1725,2461,0,0,0,0,0,0,0,66.31 ,70.09 ,66.31 
03,006,01,009,0200,0,2771,52,2823,3822,0,0,0,0,0,0,0,66.31 ,73.86 ,66.31 
03,006,01,009,0201,0,2195,41,2236,3084,0,0,0,0,0,0,0,66.31 ,72.50 ,66.31 
03,006,01,009,0202,0,965,11,976,1424,0,0,0,0,0,0,0,66.31 ,68.54 ,66.31 
03,006,01,009,0203,0,1744,26,1770,2709,0,0,0,0,0,0,0,66.31 ,65.34 ,66.31 
03,006,01,010,0204,0,2212,45,2257,3168,0,0,0,0,0,0,0,66.31 ,71.24 ,66.31 
03,006,01,010,0205,0,2435,60,2495,3455,0,0,0,0,0,0,0,66.31 ,72.21 ,66.31 
03,006,01,010,0206,0,2620,50,2670,3865,0,0,0,0,0,0,0,66.31 ,69.08 ,66.31 
03,006,01,010,0207,0,1996,47,2043,2854,0,0,0,0,0,0,0,66.31 ,71.58 ,66.31 
03,006,01,010,0208,0,1934,29,1963,2761,0,0,0,0,0,0,0,66.31 ,71.10 ,66.31 
03,006,01,010,0209,0,1668,30,1698,2490,0,0,0,0,0,0,0,66.31 ,68.19 ,66.31 
03,006,01,010,0210,0,1853,44,1897,2596,0,0,0,0,0,0,0,66.31 ,73.07 ,66.31 
03,006,01,010,0211,0,5490,135,5625,8259,0,0,0,0,0,0,0,66.31 ,68.11 ,66.31 
03,006,01,010,0212,0,3490,108,3598,4848,0,0,0,0,0,0,0,66.31 ,74.22 ,66.31 
03,006,01,010,0213,0,3486,84,3570,4866,0,0,0,0,0,0,0,66.31 ,73.37 ,66.31 
03,006,01,010,0214,0,1936,32,1968,2471,0,0,0,0,0,0,0,66.31 ,79.64 ,66.31 
03,006,01,010,0215,0,2095,37,2132,2786,0,0,0,0,0,0,0,66.31 ,76.53 ,66.31 
03,006,01,010,0216,0,2167,50,2217,3207,0,0,0,0,0,0,0,66.31 ,69.13 ,66.31 
03,006,01,011,0217,0,1905,39,1944,2481,0,0,0,0,0,0,0,66.31 ,78.36 ,66.31 
03,006,01,011,0218,0,1255,22,1277,1647,0,0,0,0,0,0,0,66.31 ,77.53 ,66.31 
03,006,01,011,0219,0,952,11,963,1223,0,0,0,0,0,0,0,66.31 ,78.74 ,66.31 
03,006,01,011,0220,0,699,14,713,913,0,0,0,0,0,0,0,66.31 ,78.09 ,66.31 
03,006,01,011,0221,0,910,21,931,1220,0,0,0,0,0,0,0,66.31 ,76.31 ,66.31 
03,006,01,011,0222,0,1513,24,1537,1955,0,0,0,0,0,0,0,66.31 ,78.62 ,66.31 
03,006,01,011,0223,0,1951,54,2005,2481,0,0,0,0,0,0,0,66.31 ,80.81 ,66.31 
03,006,01,011,0224,0,628,9,637,818,0,0,0,0,0,0,0,66.31 ,77.87 ,66.31 
03,006,01,011,0225,0,1928,30,1958,2507,0,0,0,0,0,0,0,66.31 ,78.10 ,66.31 
03,006,01,011,0226,0,1026,5,1031,1272,0,0,0,0,0,0,0,66.31 ,81.05 ,66.31 
03,006,01,011,0227,0,711,8,719,909,0,0,0,0,0,0,0,66.31 ,79.10 ,66.31 
03,006,01,011,0228,0,452,8,460,618,0,0,0,0,0,0,0,66.31 ,74.43 ,66.31 
03,006,01,011,0229,0,958,20,978,1343,0,0,0,0,0,0,0,66.31 ,72.82 ,66.31 
03,006,01,012,0230,0,673,10,683,919,0,0,0,0,0,0,0,66.31 ,74.32 ,66.31 
03,006,01,012,0231,0,853,14,867,1099,0,0,0,0,0,0,0,66.31 ,78.89 ,66.31 
03,006,01,012,0232,0,727,24,751,957,0,0,0,0,0,0,0,66.31 ,78.47 ,66.31 
03,006,01,012,0233,0,770,13,783,1102,0,0,0,0,0,0,0,66.31 ,71.05 ,66.31 
03,006,01,012,0234,0,514,4,518,647,0,0,0,0,0,0,0,66.31 ,80.06 ,66.31 
03,006,01,012,0235,0,970,15,985,1226,0,0,0,0,0,0,0,66.31 ,80.34 ,66.31 
03,006,01,012,0236,0,1239,21,1260,1651,0,0,0,0,0,0,0,66.31 ,76.32 ,66.31 
03,006,01,012,0237,0,717,15,732,952,0,0,0,0,0,0,0,66.31 ,76.89 ,66.31 
03,006,01,012,0238,0,975,20,995,1303,0,0,0,0,0,0,0,66.31 ,76.36 ,66.31 
03,006,01,012,0239,0,968,24,992,1309,0,0,0,0,0,0,0,66.31 ,75.78 ,66.31 
03,006,01,013,0240,0,785,10,795,945,0,0,0,0,0,0,0,66.31 ,84.13 ,66.31 
03,006,01,013,0241,0,1032,25,1057,1347,0,0,0,0,0,0,0,66.31 ,78.47 ,66.31 
03,006,01,013,0242,0,1255,27,1282,1599,0,0,0,0,0,0,0,66.31 ,80.18 ,66.31 
03,006,01,013,0243,0,2608,24,2632,3257,0,0,0,0,0,0,0,66.31 ,80.81 ,66.31 
03,006,01,013,0244,0,1827,33,1860,2355,0,0,0,0,0,0,0,66.31 ,78.98 ,66.31 
03,006,01,013,0245,0,2998,74,3072,4048,0,0,0,0,0,0,0,66.31 ,75.89 ,66.31 
03,006,01,013,0246,0,1004,21,1025,1281,0,0,0,0,0,0,0,66.31 ,80.02 ,66.31 
03,006,01,013,0247,0,777,10,787,932,0,0,0,0,0,0,0,66.31 ,84.44 ,66.31 
03,006,01,013,0248,0,1534,24,1558,1927,0,0,0,0,0,0,0,66.31 ,80.85 ,66.31 
03,006,01,013,0249,0,1198,22,1220,1440,0,0,0,0,0,0,0,66.31 ,84.72 ,66.31 
03,006,01,013,0250,0,900,16,916,1109,0,0,0,0,0,0,0,66.31 ,82.60 ,66.31 
03,006,01,014,0251,0,830,14,844,1040,0,0,0,0,0,0,0,66.31 ,81.15 ,66.31 
03,006,01,014,0252,0,894,11,905,1126,0,0,0,0,0,0,0,66.31 ,80.37 ,66.31 
03,006,01,014,0253,0,1636,30,1666,2199,0,0,0,0,0,0,0,66.31 ,75.76 ,66.31 
03,006,01,014,0254,0,967,9,976,1180,0,0,0,0,0,0,0,66.31 ,82.71 ,66.31 
03,006,01,014,0255,0,817,16,833,1054,0,0,0,0,0,0,0,66.31 ,79.03 ,66.31 
03,006,01,014,0256,0,1237,19,1256,1557,0,0,0,0,0,0,0,66.31 ,80.67 ,66.31 
03,006,01,014,0257,0,623,4,627,832,0,0,0,0,0,0,0,66.31 ,75.36 ,66.31 
03,006,01,014,0258,0,1195,11,1206,1542,0,0,0,0,0,0,0,66.31 ,78.21 ,66.31 
03,006,01,014,0259,0,729,15,744,961,0,0,0,0,0,0,0,66.31 ,77.42 ,66.31 
03,006,01,014,0260,0,1032,14,1046,1332,0,0,0,0,0,0,0,66.31 ,78.53 ,66.31 
03,006,01,014,0261,0,910,12,922,1249,0,0,0,0,0,0,0,66.31 ,73.82 ,66.31 
03,006,01,014,0262,0,562,12,574,686,0,0,0,0,0,0,0,66.31 ,83.67 ,66.31 
03,006,01,015,0263,0,3526,58,3584,4910,0,0,0,0,0,0,0,66.31 ,72.99 ,66.31 
03,006,01,015,0264,0,1500,24,1524,2231,0,0,0,0,0,0,0,66.31 ,68.31 ,66.31 
03,006,01,015,0265,0,2545,72,2617,3651,0,0,0,0,0,0,0,66.31 ,71.68 ,66.31 
03,006,01,015,0266,0,1962,36,1998,2559,0,0,0,0,0,0,0,66.31 ,78.08 ,66.31 
03,006,01,015,0267,0,1464,34,1498,1975,0,0,0,0,0,0,0,66.31 ,75.85 ,66.31 
03,006,01,015,0268,0,5042,99,5141,8012,0,0,0,0,0,0,0,66.31 ,64.17 ,66.31 
03,006,01,015,0269,0,2801,54,2855,4220,0,0,0,0,0,0,0,66.31 ,67.65 ,66.31 
03,006,01,015,0270,0,1407,29,1436,1939,0,0,0,0,0,0,0,66.31 ,74.06 ,66.31 
03,006,01,015,0271,0,1042,17,1059,1368,0,0,0,0,0,0,0,66.31 ,77.41 ,66.31 
03,006,01,015,0272,0,1408,16,1424,1935,0,0,0,0,0,0,0,66.31 ,73.59 ,66.31 
03,006,01,015,0273,0,1111,6,1117,1450,0,0,0,0,0,0,0,66.31 ,77.03 ,66.31 
03,006,01,015,0274,0,2306,34,2340,3148,0,0,0,0,0,0,0,66.31 ,74.33 ,66.31 
03,006,01,015,0275,0,1052,17,1069,1409,0,0,0,0,0,0,0,66.31 ,75.87 ,66.31 
03,006,01,015,0276,0,883,22,905,1207,0,0,0,0,0,0,0,66.31 ,74.98 ,66.31 
03,006,01,015,0277,0,732,21,753,973,0,0,0,0,0,0,0,66.31 ,77.39 ,66.31 
03,006,01,015,0278,0,569,22,591,797,0,0,0,0,0,0,0,66.31 ,74.15 ,66.31 
03,006,01,016,0279,0,2351,64,2415,3288,0,0,0,0,0,0,0,66.31 ,73.45 ,66.31 
03,006,01,016,0280,0,624,9,633,740,0,0,0,0,0,0,0,66.31 ,85.54 ,66.31 
03,006,01,016,0281,0,2217,37,2254,2934,0,0,0,0,0,0,0,66.31 ,76.82 ,66.31 
03,006,01,016,0282,0,965,20,985,1191,0,0,0,0,0,0,0,66.31 ,82.70 ,66.31 
03,006,01,016,0283,0,1568,39,1607,2047,0,0,0,0,0,0,0,66.31 ,78.51 ,66.31 
03,006,01,016,0284,0,1389,31,1420,1932,0,0,0,0,0,0,0,66.31 ,73.50 ,66.31 
03,006,01,016,0285,0,1784,24,1808,2323,0,0,0,0,0,0,0,66.31 ,77.83 ,66.31 
03,006,01,016,0286,0,1290,19,1309,1729,0,0,0,0,0,0,0,66.31 ,75.71 ,66.31 
03,006,01,016,0287,0,650,14,664,820,0,0,0,0,0,0,0,66.31 ,80.98 ,66.31 
03,006,01,016,0288,0,1007,19,1026,1225,0,0,0,0,0,0,0,66.31 ,83.76 ,66.31 
03,006,01,016,0289,0,1160,19,1179,1461,0,0,0,0,0,0,0,66.31 ,80.70 ,66.31 
03,006,01,016,0290,0,693,5,698,798,0,0,0,0,0,0,0,66.31 ,87.47 ,66.31 
03,006,01,016,0291,0,1021,37,1058,1316,0,0,0,0,0,0,0,66.31 ,80.40 ,66.31 
03,006,01,016,0292,0,2551,47,2598,3497,0,0,0,0,0,0,0,66.31 ,74.29 ,66.31 
03,006,01,016,0293,0,2324,54,2378,3391,0,0,0,0,0,0,0,66.31 ,70.13 ,66.31 
03,006,01,016,0294,0,3802,84,3886,5717,0,0,0,0,0,0,0,66.31 ,67.97 ,66.31 
03,006,01,017,0295,0,1360,20,1380,1766,0,0,0,0,0,0,0,66.31 ,78.14 ,66.31 
03,006,01,017,0296,0,1550,29,1579,2029,0,0,0,0,0,0,0,66.31 ,77.82 ,66.31 
03,006,01,017,0297,0,1088,15,1103,1357,0,0,0,0,0,0,0,66.31 ,81.28 ,66.31 
03,006,01,017,0298,0,1665,33,1698,2193,0,0,0,0,0,0,0,66.31 ,77.43 ,66.31 
03,006,01,017,0299,0,692,16,708,943,0,0,0,0,0,0,0,66.31 ,75.08 ,66.31 
03,006,01,017,0300,0,1547,16,1563,1822,0,0,0,0,0,0,0,66.31 ,85.78 ,66.31 
03,006,01,017,0301,0,2968,51,3019,3861,0,0,0,0,0,0,0,66.31 ,78.19 ,66.31 
03,006,01,017,0302,0,1659,22,1681,2139,0,0,0,0,0,0,0,66.31 ,78.59 ,66.31 
03,006,01,017,0303,0,2507,47,2554,3337,0,0,0,0,0,0,0,66.31 ,76.54 ,66.31 
03,006,01,017,0304,0,2335,41,2376,3149,0,0,0,0,0,0,0,66.31 ,75.45 ,66.31 
03,006,01,017,0305,0,2607,58,2665,3650,0,0,0,0,0,0,0,66.31 ,73.01 ,66.31 
03,006,01,017,0306,0,1252,23,1275,1702,0,0,0,0,0,0,0,66.31 ,74.91 ,66.31 
03,006,01,017,0307,0,2519,42,2561,3770,0,0,0,0,0,0,0,66.31 ,67.93 ,66.31 
03,006,01,017,0308,0,896,10,906,1236,0,0,0,0,0,0,0,66.31 ,73.30 ,66.31 
03,006,01,017,0309,0,2492,51,2543,4321,0,0,0,0,0,0,0,66.31 ,58.85 ,66.31 
03,006,01,017,0310,0,1766,47,1813,2761,0,0,0,0,0,0,0,66.31 ,65.66 ,66.31 
03,006,01,018,0311,0,824,10,834,1138,0,0,0,0,0,0,0,66.31 ,73.29 ,66.31 
03,006,01,018,0312,0,4306,77,4383,6490,0,0,0,0,0,0,0,66.31 ,67.53 ,66.31 
03,006,01,018,0313,0,2777,56,2833,4152,0,0,0,0,0,0,0,66.31 ,68.23 ,66.31 
03,006,01,018,0314,0,1231,29,1260,1838,0,0,0,0,0,0,0,66.31 ,68.55 ,66.31 
03,006,01,018,0315,0,1183,24,1207,1649,0,0,0,0,0,0,0,66.31 ,73.20 ,66.31 
03,006,01,018,0316,0,650,20,670,920,0,0,0,0,0,0,0,66.31 ,72.83 ,66.31 
03,006,01,018,0317,0,774,21,795,1120,0,0,0,0,0,0,0,66.31 ,70.98 ,66.31 
03,006,01,018,0318,0,3426,75,3501,5084,0,0,0,0,0,0,0,66.31 ,68.86 ,66.31 
03,006,01,018,0319,0,1996,28,2024,2731,0,0,0,0,0,0,0,66.31 ,74.11 ,66.31 
03,006,01,018,0320,0,985,15,1000,1259,0,0,0,0,0,0,0,66.31 ,79.43 ,66.31 
03,006,01,018,0321,0,1440,26,1466,1919,0,0,0,0,0,0,0,66.31 ,76.39 ,66.31 
03,006,01,018,0322,0,1717,34,1751,2205,0,0,0,0,0,0,0,66.31 ,79.41 ,66.31 
03,006,01,018,0323,0,1329,21,1350,1708,0,0,0,0,0,0,0,66.31 ,79.04 ,66.31 
03,006,01,018,0324,0,1129,26,1155,1446,0,0,0,0,0,0,0,66.31 ,79.88 ,66.31 
03,006,01,018,0325,0,795,12,807,1054,0,0,0,0,0,0,0,66.31 ,76.57 ,66.31 
03,006,01,018,0326,0,1750,37,1787,2472,0,0,0,0,0,0,0,66.31 ,72.29 ,66.31 
03,006,01,018,0327,0,1444,22,1466,1961,0,0,0,0,0,0,0,66.31 ,74.76 ,66.31 
03,006,01,018,0328,0,2104,48,2152,2922,0,0,0,0,0,0,0,66.31 ,73.65 ,66.31 
03,006,01,018,0329,0,741,16,757,1061,0,0,0,0,0,0,0,66.31 ,71.35 ,66.31 
03,006,01,018,0330,0,1540,30,1570,2036,0,0,0,0,0,0,0,66.31 ,77.11 ,66.31 
03,006,01,019,0331,0,3301,70,3371,4803,0,0,0,0,0,0,0,66.31 ,70.19 ,66.31 
03,006,01,019,0332,0,4163,106,4269,6510,0,0,0,0,0,0,0,66.31 ,65.58 ,66.31 
03,006,01,019,0333,0,3565,84,3649,5714,0,0,0,0,0,0,0,66.31 ,63.86 ,66.31 
03,006,01,019,0334,0,3585,55,3640,5625,0,0,0,0,0,0,0,66.31 ,64.71 ,66.31 
03,006,01,019,0335,0,5652,120,5772,8055,0,0,0,0,0,0,0,66.31 ,71.66 ,66.31 
03,006,01,019,0336,0,2742,62,2804,4350,0,0,0,0,0,0,0,66.31 ,64.46 ,66.31 
03,006,01,019,0337,0,4881,91,4972,7098,0,0,0,0,0,0,0,66.31 ,70.05 ,66.31 
03,006,01,019,0338,0,4227,102,4329,6704,0,0,0,0,0,0,0,66.31 ,64.57 ,66.31 
03,006,01,019,0339,0,3800,88,3888,5905,0,0,0,0,0,0,0,66.31 ,65.84 ,66.31 
03,006,01,019,0340,0,6250,133,6383,10651,0,0,0,0,0,0,0,66.31 ,59.93 ,66.31 
03,006,01,019,0341,0,5241,120,5361,9081,0,0,0,0,0,0,0,66.31 ,59.04 ,66.31 
03,006,01,019,0342,0,4298,101,4399,7234,0,0,0,0,0,0,0,66.31 ,60.81 ,66.31 
03,006,01,019,0343,0,2298,43,2341,3519,0,0,0,0,0,0,0,66.31 ,66.52 ,66.31 
03,006,01,019,0344,0,2435,47,2482,3531,0,0,0,0,0,0,0,66.31 ,70.29 ,66.31 
03,006,01,019,0345,0,898,11,909,1238,0,0,0,0,0,0,0,66.31 ,73.42 ,66.31 
03,006,01,019,0346,0,3439,89,3528,5082,0,0,0,0,0,0,0,66.31 ,69.42 ,66.31 
03,006,01,019,0347,0,685,7,692,895,0,0,0,0,0,0,0,66.31 ,77.32 ,66.31 
03,006,01,019,0348,0,2885,51,2936,4241,0,0,0,0,0,0,0,66.31 ,69.23 ,66.31 
03,006,01,019,0349,0,1914,41,1955,2999,0,0,0,0,0,0,0,66.31 ,65.19 ,66.31 
03,006,01,020,0350,0,1840,37,1877,2547,0,0,0,0,0,0,0,66.31 ,73.69 ,66.31 
03,006,01,020,0351,0,4354,71,4425,6639,0,0,0,0,0,0,0,66.31 ,66.65 ,66.31 
03,006,01,020,0352,0,1832,37,1869,2539,0,0,0,0,0,0,0,66.31 ,73.61 ,66.31 
03,006,01,020,0353,0,3081,64,3145,5175,0,0,0,0,0,0,0,66.31 ,60.77 ,66.31 
03,006,01,020,0354,0,4787,83,4870,8199,0,0,0,0,0,0,0,66.31 ,59.40 ,66.31 
03,006,01,020,0355,0,1635,46,1681,2557,0,0,0,0,0,0,0,66.31 ,65.74 ,66.31 
03,006,01,020,0356,0,2053,41,2094,2949,0,0,0,0,0,0,0,66.31 ,71.01 ,66.31 
03,006,01,020,0357,0,1233,18,1251,1713,0,0,0,0,0,0,0,66.31 ,73.03 ,66.31 
03,006,01,020,0358,0,720,12,732,944,0,0,0,0,0,0,0,66.31 ,77.54 ,66.31 
03,006,01,020,0359,0,5106,104,5210,8149,0,0,0,0,0,0,0,66.31 ,63.93 ,66.31 
03,006,01,020,0360,0,2611,52,2663,3886,0,0,0,0,0,0,0,66.31 ,68.53 ,66.31 
03,006,01,020,0361,0,3708,73,3781,5718,0,0,0,0,0,0,0,66.31 ,66.12 ,66.31 
03,006,01,020,0362,0,3497,69,3566,5870,0,0,0,0,0,0,0,66.31 ,60.75 ,66.31 
03,006,01,020,0363,0,5113,89,5202,7997,0,0,0,0,0,0,0,66.31 ,65.05 ,66.31 
03,006,01,020,0364,0,1864,54,1918,2939,0,0,0,0,0,0,0,66.31 ,65.26 ,66.31 
03,006,01,020,0365,0,6319,111,6430,10259,0,0,0,0,0,0,0,66.31 ,62.68 ,66.31 
03,006,01,020,0366,0,5231,88,5319,7957,0,0,0,0,0,0,0,66.31 ,66.85 ,66.31 
03,006,01,020,0367,0,3929,83,4012,6546,0,0,0,0,0,0,0,66.31 ,61.29 ,66.31 
03,006,01,020,0368,0,3344,67,3411,5355,0,0,0,0,0,0,0,66.31 ,63.70 ,66.31 
03,006,01,020,0369,0,4703,89,4792,7216,0,0,0,0,0,0,0,66.31 ,66.41 ,66.31 
03,006,01,021,0370,0,955,7,962,1370,0,0,0,0,0,0,0,66.31 ,70.22 ,66.31 
03,006,01,021,0371,0,292,3,295,436,0,0,0,0,0,0,0,66.31 ,67.66 ,66.31 
03,006,01,021,0372,0,702,9,711,1089,0,0,0,0,0,0,0,66.31 ,65.29 ,66.31 
03,006,01,021,0373,0,345,9,354,491,0,0,0,0,0,0,0,66.31 ,72.10 ,66.31 
03,006,01,021,0374,0,303,5,308,468,0,0,0,0,0,0,0,66.31 ,65.81 ,66.31 
03,006,01,021,0375,0,192,3,195,256,0,0,0,0,0,0,0,66.31 ,76.17 ,66.31 
03,006,01,021,0376,0,727,15,742,1414,0,0,0,0,0,0,0,66.31 ,52.48 ,66.31 
03,006,01,021,0377,0,225,3,228,405,0,0,0,0,0,0,0,66.31 ,56.30 ,66.31 
03,007,01,001,0001,0,2018,43,2061,2780,0,0,0,0,0,0,0,66.31 ,74.14 ,66.31 
03,007,01,001,0002,0,1566,31,1597,2170,0,0,0,0,0,0,0,66.31 ,73.59 ,66.31 
03,007,01,001,0003,0,1119,17,1136,1490,0,0,0,0,0,0,0,66.31 ,76.24 ,66.31 
03,007,01,001,0004,0,1176,20,1196,1590,0,0,0,0,0,0,0,66.31 ,75.22 ,66.31 
03,007,01,001,0005,0,1557,25,1582,2101,0,0,0,0,0,0,0,66.31 ,75.30 ,66.31 
03,007,01,001,0006,0,1774,21,1795,2357,0,0,0,0,0,0,0,66.31 ,76.16 ,66.31 
03,007,01,001,0007,0,1028,20,1048,1318,0,0,0,0,0,0,0,66.31 ,79.51 ,66.31 
03,007,01,001,0008,0,1387,20,1407,1878,0,0,0,0,0,0,0,66.31 ,74.92 ,66.31 
03,007,01,001,0009,0,3425,52,3477,4831,0,0,0,0,0,0,0,66.31 ,71.97 ,66.31 
03,007,01,001,0010,0,2299,49,2348,3017,0,0,0,0,0,0,0,66.31 ,77.83 ,66.31 
03,007,01,001,0011,0,3095,60,3155,4258,0,0,0,0,0,0,0,66.31 ,74.10 ,66.31 
03,007,01,001,0012,0,4304,67,4371,5869,0,0,0,0,0,0,0,66.31 ,74.48 ,66.31 
03,007,01,001,0013,0,1063,14,1077,1419,0,0,0,0,0,0,0,66.31 ,75.90 ,66.31 
03,007,01,001,0014,0,886,10,896,1177,0,0,0,0,0,0,0,66.31 ,76.13 ,66.31 
03,007,01,001,0015,0,1128,18,1146,1467,0,0,0,0,0,0,0,66.31 ,78.12 ,66.31 
03,007,01,001,0016,0,828,16,844,1080,0,0,0,0,0,0,0,66.31 ,78.15 ,66.31 
03,007,01,001,0017,0,1755,24,1779,2413,0,0,0,0,0,0,0,66.31 ,73.73 ,66.31 
03,007,01,001,0018,0,2187,32,2219,2926,0,0,0,0,0,0,0,66.31 ,75.84 ,66.31 
03,007,01,001,0019,0,700,10,710,927,0,0,0,0,0,0,0,66.31 ,76.59 ,66.31 
03,007,01,001,0020,0,779,22,801,1044,0,0,0,0,0,0,0,66.31 ,76.72 ,66.31 
03,007,01,001,0021,0,973,16,989,1278,0,0,0,0,0,0,0,66.31 ,77.39 ,66.31 
03,007,01,001,0022,0,949,16,965,1264,0,0,0,0,0,0,0,66.31 ,76.34 ,66.31 
03,007,01,001,0023,0,772,10,782,1015,0,0,0,0,0,0,0,66.31 ,77.04 ,66.31 
03,007,01,001,0024,0,1461,28,1489,2017,0,0,0,0,0,0,0,66.31 ,73.82 ,66.31 
03,007,01,001,0025,0,2333,31,2364,3190,0,0,0,0,0,0,0,66.31 ,74.11 ,66.31 
03,007,01,001,0026,0,2806,57,2863,3836,0,0,0,0,0,0,0,66.31 ,74.64 ,66.31 
03,007,01,001,0027,0,1482,19,1501,1967,0,0,0,0,0,0,0,66.31 ,76.31 ,66.31 
03,007,01,001,0028,0,1633,21,1654,2141,0,0,0,0,0,0,0,66.31 ,77.25 ,66.31 
03,007,01,001,0029,0,1115,17,1132,1394,0,0,0,0,0,0,0,66.31 ,81.21 ,66.31 
03,007,01,001,0030,0,1278,25,1303,1560,0,0,0,0,0,0,0,66.31 ,83.53 ,66.31 
03,007,01,001,0031,0,2025,21,2046,2556,0,0,0,0,0,0,0,66.31 ,80.05 ,66.31 
03,007,01,001,0032,0,1896,41,1937,2439,0,0,0,0,0,0,0,66.31 ,79.42 ,66.31 
03,007,01,001,0033,0,1688,32,1720,2232,0,0,0,0,0,0,0,66.31 ,77.06 ,66.31 
03,007,01,001,0034,0,1673,33,1706,2268,0,0,0,0,0,0,0,66.31 ,75.22 ,66.31 
03,007,01,001,0035,0,842,14,856,1161,0,0,0,0,0,0,0,66.31 ,73.73 ,66.31 
03,007,01,001,0036,0,1957,46,2003,2866,0,0,0,0,0,0,0,66.31 ,69.89 ,66.31 
03,007,01,001,0037,0,2664,43,2707,3616,0,0,0,0,0,0,0,66.31 ,74.86 ,66.31 
03,007,01,001,0038,0,1379,33,1412,1824,0,0,0,0,0,0,0,66.31 ,77.41 ,66.31 
03,007,01,001,0039,0,1048,12,1060,1440,0,0,0,0,0,0,0,66.31 ,73.61 ,66.31 
03,007,01,001,0040,0,716,13,729,965,0,0,0,0,0,0,0,66.31 ,75.54 ,66.31 
03,007,01,001,0041,0,1011,19,1030,1379,0,0,0,0,0,0,0,66.31 ,74.69 ,66.31 
03,007,01,001,0042,0,605,8,613,797,0,0,0,0,0,0,0,66.31 ,76.91 ,66.31 
03,007,01,001,0043,0,764,8,772,979,0,0,0,0,0,0,0,66.31 ,78.86 ,66.31 
03,007,01,001,0044,0,688,10,698,920,0,0,0,0,0,0,0,66.31 ,75.87 ,66.31 
03,007,01,001,0045,0,973,6,979,1314,0,0,0,0,0,0,0,66.31 ,74.51 ,66.31 
03,007,01,001,0046,0,623,13,636,827,0,0,0,0,0,0,0,66.31 ,76.90 ,66.31 
03,007,01,001,0047,0,1581,19,1600,2116,0,0,0,0,0,0,0,66.31 ,75.61 ,66.31 
03,007,01,001,0048,0,1060,14,1074,1427,0,0,0,0,0,0,0,66.31 ,75.26 ,66.31 
03,007,01,001,0049,0,1317,30,1347,1812,0,0,0,0,0,0,0,66.31 ,74.34 ,66.31 
03,007,01,001,0050,0,2479,41,2520,3383,0,0,0,0,0,0,0,66.31 ,74.49 ,66.31 
03,007,01,001,0051,0,2464,45,2509,3141,0,0,0,0,0,0,0,66.31 ,79.88 ,66.31 
03,007,01,001,0052,0,639,14,653,748,0,0,0,0,0,0,0,66.31 ,87.30 ,66.31 
03,007,01,001,0053,0,1528,25,1553,1911,0,0,0,0,0,0,0,66.31 ,81.27 ,66.31 
03,007,01,001,0054,0,825,15,840,1006,0,0,0,0,0,0,0,66.31 ,83.50 ,66.31 
03,007,01,001,0055,0,1535,25,1560,1968,0,0,0,0,0,0,0,66.31 ,79.27 ,66.31 
03,007,01,001,0056,0,3014,64,3078,3969,0,0,0,0,0,0,0,66.31 ,77.55 ,66.31 
03,007,01,001,0057,0,1509,28,1537,2126,0,0,0,0,0,0,0,66.31 ,72.30 ,66.31 
03,007,01,001,0058,0,2683,48,2731,3695,0,0,0,0,0,0,0,66.31 ,73.91 ,66.31 
03,007,01,001,0059,0,1370,27,1397,1880,0,0,0,0,0,0,0,66.31 ,74.31 ,66.31 
03,007,01,001,0060,0,1660,23,1683,2150,0,0,0,0,0,0,0,66.31 ,78.28 ,66.31 
03,007,01,001,0061,0,3939,80,4019,5171,0,0,0,0,0,0,0,66.31 ,77.72 ,66.31 
03,007,01,001,0062,0,647,14,661,816,0,0,0,0,0,0,0,66.31 ,81.00 ,66.31 
03,007,01,001,0063,0,1127,29,1156,1533,0,0,0,0,0,0,0,66.31 ,75.41 ,66.31 
03,007,01,001,0064,0,801,8,809,953,0,0,0,0,0,0,0,66.31 ,84.89 ,66.31 
03,007,01,001,0065,0,1734,40,1774,2292,0,0,0,0,0,0,0,66.31 ,77.40 ,66.31 
03,007,01,001,0066,0,1736,29,1765,2228,0,0,0,0,0,0,0,66.31 ,79.22 ,66.31 
03,007,01,001,0067,0,1994,27,2021,2572,0,0,0,0,0,0,0,66.31 ,78.58 ,66.31 
03,007,01,001,0068,0,2042,36,2078,2854,0,0,0,0,0,0,0,66.31 ,72.81 ,66.31 
03,007,01,001,0069,0,679,7,686,789,0,0,0,0,0,0,0,66.31 ,86.95 ,66.31 
03,007,01,001,0070,0,727,7,734,927,0,0,0,0,0,0,0,66.31 ,79.18 ,66.31 
03,007,01,001,0071,0,600,7,607,735,0,0,0,0,0,0,0,66.31 ,82.59 ,66.31 
03,007,01,001,0072,0,864,9,873,1087,0,0,0,0,0,0,0,66.31 ,80.31 ,66.31 
03,007,01,001,0073,0,833,10,843,1077,0,0,0,0,0,0,0,66.31 ,78.27 ,66.31 
03,007,01,002,0074,0,2045,34,2079,2668,0,0,0,0,0,0,0,66.31 ,77.92 ,66.31 
03,007,01,002,0075,0,1207,16,1223,1521,0,0,0,0,0,0,0,66.31 ,80.41 ,66.31 
03,007,01,002,0076,0,1586,37,1623,2063,0,0,0,0,0,0,0,66.31 ,78.67 ,66.31 
03,007,01,002,0077,0,800,8,808,974,0,0,0,0,0,0,0,66.31 ,82.96 ,66.31 
03,007,01,002,0078,0,1030,12,1042,1247,0,0,0,0,0,0,0,66.31 ,83.56 ,66.31 
03,007,01,002,0079,0,1050,12,1062,1297,0,0,0,0,0,0,0,66.31 ,81.88 ,66.31 
03,007,01,002,0080,0,546,9,555,656,0,0,0,0,0,0,0,66.31 ,84.60 ,66.31 
03,007,01,002,0081,0,1238,17,1255,1487,0,0,0,0,0,0,0,66.31 ,84.40 ,66.31 
03,007,01,002,0082,0,2570,39,2609,3323,0,0,0,0,0,0,0,66.31 ,78.51 ,66.31 
03,007,01,002,0083,0,1599,24,1623,2022,0,0,0,0,0,0,0,66.31 ,80.27 ,66.31 
03,007,01,002,0084,0,2129,34,2163,2965,0,0,0,0,0,0,0,66.31 ,72.95 ,66.31 
03,007,01,002,0085,0,999,11,1010,1290,0,0,0,0,0,0,0,66.31 ,78.29 ,66.31 
03,007,01,002,0086,0,2027,47,2074,2640,0,0,0,0,0,0,0,66.31 ,78.56 ,66.31 
03,007,01,002,0087,0,634,7,641,794,0,0,0,0,0,0,0,66.31 ,80.73 ,66.31 
03,007,01,002,0088,0,738,9,747,958,0,0,0,0,0,0,0,66.31 ,77.97 ,66.31 
03,007,01,002,0089,0,1129,12,1141,1520,0,0,0,0,0,0,0,66.31 ,75.07 ,66.31 
03,007,01,002,0090,0,986,17,1003,1317,0,0,0,0,0,0,0,66.31 ,76.16 ,66.31 
03,007,01,002,0091,0,1001,12,1013,1306,0,0,0,0,0,0,0,66.31 ,77.57 ,66.31 
03,007,01,003,0092,0,1251,15,1266,1607,0,0,0,0,0,0,0,66.31 ,78.78 ,66.31 
03,007,01,003,0093,0,1001,16,1017,1286,0,0,0,0,0,0,0,66.31 ,79.08 ,66.31 
03,007,01,003,0094,0,1239,17,1256,1538,0,0,0,0,0,0,0,66.31 ,81.66 ,66.31 
03,007,01,003,0095,0,452,5,457,563,0,0,0,0,0,0,0,66.31 ,81.17 ,66.31 
03,007,01,003,0096,0,1563,36,1599,2076,0,0,0,0,0,0,0,66.31 ,77.02 ,66.31 
03,007,01,003,0097,0,1514,35,1549,2000,0,0,0,0,0,0,0,66.31 ,77.45 ,66.31 
03,007,01,003,0098,0,1085,22,1107,1388,0,0,0,0,0,0,0,66.31 ,79.76 ,66.31 
03,007,01,003,0099,0,693,10,703,855,0,0,0,0,0,0,0,66.31 ,82.22 ,66.31 
03,007,01,003,0100,0,715,13,728,903,0,0,0,0,0,0,0,66.31 ,80.62 ,66.31 
03,007,01,003,0101,0,812,11,823,1031,0,0,0,0,0,0,0,66.31 ,79.83 ,66.31 
03,007,01,003,0102,0,581,8,589,704,0,0,0,0,0,0,0,66.31 ,83.66 ,66.31 
03,007,01,003,0103,0,1127,14,1141,1441,0,0,0,0,0,0,0,66.31 ,79.18 ,66.31 
03,007,01,003,0104,0,940,10,950,1266,0,0,0,0,0,0,0,66.31 ,75.04 ,66.31 
03,007,01,003,0105,0,740,10,750,980,0,0,0,0,0,0,0,66.31 ,76.53 ,66.31 
03,007,01,003,0106,0,780,12,792,1059,0,0,0,0,0,0,0,66.31 ,74.79 ,66.31 
03,007,01,004,0107,0,928,15,943,1184,0,0,0,0,0,0,0,66.31 ,79.65 ,66.31 
03,007,01,004,0108,0,466,4,470,593,0,0,0,0,0,0,0,66.31 ,79.26 ,66.31 
03,007,01,004,0109,0,861,13,874,1111,0,0,0,0,0,0,0,66.31 ,78.67 ,66.31 
03,007,01,004,0110,0,769,9,778,942,0,0,0,0,0,0,0,66.31 ,82.59 ,66.31 
03,007,01,004,0111,0,826,8,834,1061,0,0,0,0,0,0,0,66.31 ,78.61 ,66.31 
03,007,01,004,0112,0,1402,23,1425,1854,0,0,0,0,0,0,0,66.31 ,76.86 ,66.31 
03,007,01,004,0113,0,938,18,956,1260,0,0,0,0,0,0,0,66.31 ,75.87 ,66.31 
03,007,01,004,0114,0,246,4,250,324,0,0,0,0,0,0,0,66.31 ,77.16 ,66.31 
03,007,01,004,0115,0,579,8,587,727,0,0,0,0,0,0,0,66.31 ,80.74 ,66.31 
03,007,01,004,0116,0,627,6,633,810,0,0,0,0,0,0,0,66.31 ,78.15 ,66.31 
03,007,01,004,0117,0,914,16,930,1163,0,0,0,0,0,0,0,66.31 ,79.97 ,66.31 
03,007,01,004,0118,0,447,2,449,584,0,0,0,0,0,0,0,66.31 ,76.88 ,66.31 
03,007,01,004,0119,0,770,14,784,971,0,0,0,0,0,0,0,66.31 ,80.74 ,66.31 
03,007,01,004,0120,0,1023,15,1038,1279,0,0,0,0,0,0,0,66.31 ,81.16 ,66.31 
03,007,01,004,0121,0,2125,32,2157,2783,0,0,0,0,0,0,0,66.31 ,77.51 ,66.31 
03,007,01,004,0122,0,2530,44,2574,3301,0,0,0,0,0,0,0,66.31 ,77.98 ,66.31 
03,007,01,004,0123,0,2106,44,2150,2699,0,0,0,0,0,0,0,66.31 ,79.66 ,66.31 
03,007,01,004,0124,0,3404,60,3464,4398,0,0,0,0,0,0,0,66.31 ,78.76 ,66.31 
03,007,01,004,0125,0,2338,40,2378,2996,0,0,0,0,0,0,0,66.31 ,79.37 ,66.31 
03,007,01,004,0126,0,2222,37,2259,2782,0,0,0,0,0,0,0,66.31 ,81.20 ,66.31 
03,007,01,004,0127,0,1160,16,1176,1497,0,0,0,0,0,0,0,66.31 ,78.56 ,66.31 
03,007,01,004,0128,0,2013,29,2042,2564,0,0,0,0,0,0,0,66.31 ,79.64 ,66.31 
03,007,01,004,0129,0,1706,19,1725,2189,0,0,0,0,0,0,0,66.31 ,78.80 ,66.31 
03,007,01,004,0130,0,2151,39,2190,2712,0,0,0,0,0,0,0,66.31 ,80.75 ,66.31 
03,007,01,004,0131,0,2131,32,2163,2665,0,0,0,0,0,0,0,66.31 ,81.16 ,66.31 
03,007,01,004,0132,0,1347,23,1370,1648,0,0,0,0,0,0,0,66.31 ,83.13 ,66.31 
03,007,01,004,0133,0,1652,25,1677,2020,0,0,0,0,0,0,0,66.31 ,83.02 ,66.31 
03,007,01,004,0134,0,2282,38,2320,2826,0,0,0,0,0,0,0,66.31 ,82.09 ,66.31 
03,007,01,004,0135,0,2437,32,2469,3010,0,0,0,0,0,0,0,66.31 ,82.03 ,66.31 
03,007,01,005,0136,0,1473,17,1490,1863,0,0,0,0,0,0,0,66.31 ,79.98 ,66.31 
03,007,01,005,0137,0,837,17,854,1063,0,0,0,0,0,0,0,66.31 ,80.34 ,66.31 
03,007,01,005,0138,0,756,16,772,939,0,0,0,0,0,0,0,66.31 ,82.22 ,66.31 
03,007,01,005,0139,0,892,10,902,1121,0,0,0,0,0,0,0,66.31 ,80.46 ,66.31 
03,007,01,005,0140,0,534,4,538,649,0,0,0,0,0,0,0,66.31 ,82.90 ,66.31 
03,007,01,005,0141,0,908,7,915,1120,0,0,0,0,0,0,0,66.31 ,81.70 ,66.31 
03,007,01,005,0142,0,814,18,832,1054,0,0,0,0,0,0,0,66.31 ,78.94 ,66.31 
03,007,01,005,0143,0,1492,17,1509,1886,0,0,0,0,0,0,0,66.31 ,80.01 ,66.31 
03,007,01,005,0144,0,1037,19,1056,1271,0,0,0,0,0,0,0,66.31 ,83.08 ,66.31 
03,007,01,005,0145,0,985,9,994,1205,0,0,0,0,0,0,0,66.31 ,82.49 ,66.31 
03,007,01,005,0146,0,1468,18,1486,1806,0,0,0,0,0,0,0,66.31 ,82.28 ,66.31 
03,007,01,005,0147,0,1222,19,1241,1541,0,0,0,0,0,0,0,66.31 ,80.53 ,66.31 
03,007,01,005,0148,0,1434,7,1441,1810,0,0,0,0,0,0,0,66.31 ,79.61 ,66.31 
03,007,01,005,0149,0,761,12,773,997,0,0,0,0,0,0,0,66.31 ,77.53 ,66.31 
03,007,01,005,0150,0,760,1,761,998,0,0,0,0,0,0,0,66.31 ,76.25 ,66.31 
03,007,01,005,0151,0,1435,29,1464,1898,0,0,0,0,0,0,0,66.31 ,77.13 ,66.31 
03,007,01,005,0152,0,1291,20,1311,1673,0,0,0,0,0,0,0,66.31 ,78.36 ,66.31 
03,007,01,005,0153,0,1566,18,1584,1901,0,0,0,0,0,0,0,66.31 ,83.32 ,66.31 
03,007,01,005,0154,0,848,11,859,1075,0,0,0,0,0,0,0,66.31 ,79.91 ,66.31 
03,007,01,005,0155,0,933,11,944,1199,0,0,0,0,0,0,0,66.31 ,78.73 ,66.31 
03,007,01,005,0156,0,1918,28,1946,2488,0,0,0,0,0,0,0,66.31 ,78.22 ,66.31 
03,007,01,005,0157,0,1475,18,1493,1894,0,0,0,0,0,0,0,66.31 ,78.83 ,66.31 
03,007,01,006,0158,0,1209,11,1220,1476,0,0,0,0,0,0,0,66.31 ,82.66 ,66.31 
03,007,01,006,0159,0,1062,22,1084,1364,0,0,0,0,0,0,0,66.31 ,79.47 ,66.31 
03,007,01,006,0160,0,1447,25,1472,1821,0,0,0,0,0,0,0,66.31 ,80.83 ,66.31 
03,007,01,006,0161,0,904,12,916,1083,0,0,0,0,0,0,0,66.31 ,84.58 ,66.31 
03,007,01,006,0162,0,1272,12,1284,1530,0,0,0,0,0,0,0,66.31 ,83.92 ,66.31 
03,007,01,006,0163,0,2306,43,2349,2917,0,0,0,0,0,0,0,66.31 ,80.53 ,66.31 
03,007,01,006,0164,0,1971,33,2004,2386,0,0,0,0,0,0,0,66.31 ,83.99 ,66.31 
03,007,01,006,0165,0,1491,20,1511,1796,0,0,0,0,0,0,0,66.31 ,84.13 ,66.31 
03,007,01,006,0166,0,849,21,870,1052,0,0,0,0,0,0,0,66.31 ,82.70 ,66.31 
03,007,01,006,0167,0,2280,41,2321,2894,0,0,0,0,0,0,0,66.31 ,80.20 ,66.31 
03,007,01,006,0168,0,1294,28,1322,1584,0,0,0,0,0,0,0,66.31 ,83.46 ,66.31 
03,007,01,006,0169,0,975,18,993,1192,0,0,0,0,0,0,0,66.31 ,83.31 ,66.31 
03,007,01,006,0170,0,1080,13,1093,1319,0,0,0,0,0,0,0,66.31 ,82.87 ,66.31 
03,007,01,006,0171,0,1471,18,1489,1754,0,0,0,0,0,0,0,66.31 ,84.89 ,66.31 
03,007,01,007,0172,0,2653,46,2699,3383,0,0,0,0,0,0,0,66.31 ,79.78 ,66.31 
03,007,01,007,0173,0,2276,49,2325,3021,0,0,0,0,0,0,0,66.31 ,76.96 ,66.31 
03,007,01,007,0174,0,398,2,400,453,0,0,0,0,0,0,0,66.31 ,88.30 ,66.31 
03,007,01,007,0175,0,951,21,972,1264,0,0,0,0,0,0,0,66.31 ,76.90 ,66.31 
03,007,01,007,0176,0,2246,34,2280,2928,0,0,0,0,0,0,0,66.31 ,77.87 ,66.31 
03,007,01,007,0177,0,1523,21,1544,1970,0,0,0,0,0,0,0,66.31 ,78.38 ,66.31 
03,007,01,007,0178,0,951,18,969,1141,0,0,0,0,0,0,0,66.31 ,84.93 ,66.31 
03,007,01,007,0179,0,623,12,635,735,0,0,0,0,0,0,0,66.31 ,86.39 ,66.31 
03,007,01,007,0180,0,1223,13,1236,1514,0,0,0,0,0,0,0,66.31 ,81.64 ,66.31 
03,007,01,007,0181,0,1745,23,1768,2138,0,0,0,0,0,0,0,66.31 ,82.69 ,66.31 
03,007,01,007,0182,0,1012,8,1020,1191,0,0,0,0,0,0,0,66.31 ,85.64 ,66.31 
03,007,01,007,0183,0,1186,19,1205,1461,0,0,0,0,0,0,0,66.31 ,82.48 ,66.31 
03,007,01,007,0184,0,1159,16,1175,1411,0,0,0,0,0,0,0,66.31 ,83.27 ,66.31 
03,007,01,007,0185,0,963,15,978,1166,0,0,0,0,0,0,0,66.31 ,83.88 ,66.31 
03,007,01,007,0186,0,3441,56,3497,4413,0,0,0,0,0,0,0,66.31 ,79.24 ,66.31 
03,007,01,007,0187,0,1061,20,1081,1377,0,0,0,0,0,0,0,66.31 ,78.50 ,66.31 
03,007,01,007,0188,0,1088,25,1113,1472,0,0,0,0,0,0,0,66.31 ,75.61 ,66.31 
03,007,01,007,0189,0,1620,34,1654,2118,0,0,0,0,0,0,0,66.31 ,78.09 ,66.31 
03,007,01,007,0190,0,1985,47,2032,2470,0,0,0,0,0,0,0,66.31 ,82.27 ,66.31 
03,007,01,007,0191,0,637,6,643,726,0,0,0,0,0,0,0,66.31 ,88.57 ,66.31 
03,007,01,007,0192,0,1619,38,1657,2067,0,0,0,0,0,0,0,66.31 ,80.16 ,66.31 
03,007,01,007,0193,0,1606,40,1646,1981,0,0,0,0,0,0,0,66.31 ,83.09 ,66.31 
03,007,01,007,0194,0,809,11,820,1035,0,0,0,0,0,0,0,66.31 ,79.23 ,66.31 
03,007,01,007,0195,0,1860,44,1904,2377,0,0,0,0,0,0,0,66.31 ,80.10 ,66.31 
03,007,01,007,0196,0,1022,13,1035,1351,0,0,0,0,0,0,0,66.31 ,76.61 ,66.31 
03,007,01,007,0197,0,1308,23,1331,1578,0,0,0,0,0,0,0,66.31 ,84.35 ,66.31 
03,007,01,007,0198,0,697,12,709,832,0,0,0,0,0,0,0,66.31 ,85.22 ,66.31 
03,007,01,007,0199,0,931,10,941,1210,0,0,0,0,0,0,0,66.31 ,77.77 ,66.31 
03,007,01,007,0200,0,1328,24,1352,1655,0,0,0,0,0,0,0,66.31 ,81.69 ,66.31 
03,007,01,007,0201,0,2116,40,2156,2656,0,0,0,0,0,0,0,66.31 ,81.17 ,66.31 
03,007,01,007,0202,0,1293,16,1309,1557,0,0,0,0,0,0,0,66.31 ,84.07 ,66.31 
03,007,01,008,0203,0,1434,21,1455,1767,0,0,0,0,0,0,0,66.31 ,82.34 ,66.31 
03,007,01,008,0204,0,859,17,876,1080,0,0,0,0,0,0,0,66.31 ,81.11 ,66.31 
03,007,01,008,0205,0,1313,20,1333,1720,0,0,0,0,0,0,0,66.31 ,77.50 ,66.31 
03,007,01,008,0206,0,910,9,919,1109,0,0,0,0,0,0,0,66.31 ,82.87 ,66.31 
03,007,01,008,0207,0,755,16,771,956,0,0,0,0,0,0,0,66.31 ,80.65 ,66.31 
03,007,01,008,0208,0,1211,16,1227,1520,0,0,0,0,0,0,0,66.31 ,80.72 ,66.31 
03,007,01,008,0209,0,1552,24,1576,1938,0,0,0,0,0,0,0,66.31 ,81.32 ,66.31 
03,007,01,008,0210,0,820,17,837,952,0,0,0,0,0,0,0,66.31 ,87.92 ,66.31 
03,007,01,009,0211,0,2782,35,2817,3668,0,0,0,0,0,0,0,66.31 ,76.80 ,66.31 
03,007,01,009,0212,0,1127,20,1147,1396,0,0,0,0,0,0,0,66.31 ,82.16 ,66.31 
03,007,01,009,0213,0,924,10,934,1127,0,0,0,0,0,0,0,66.31 ,82.87 ,66.31 
03,007,01,009,0214,0,1254,12,1266,1480,0,0,0,0,0,0,0,66.31 ,85.54 ,66.31 
03,007,01,009,0215,0,1074,12,1086,1330,0,0,0,0,0,0,0,66.31 ,81.65 ,66.31 
03,007,01,009,0216,0,1157,19,1176,1461,0,0,0,0,0,0,0,66.31 ,80.49 ,66.31 
03,007,01,009,0217,0,1432,24,1456,1867,0,0,0,0,0,0,0,66.31 ,77.99 ,66.31 
03,007,01,009,0218,0,1153,15,1168,1462,0,0,0,0,0,0,0,66.31 ,79.89 ,66.31 
03,007,01,009,0219,0,810,17,827,1016,0,0,0,0,0,0,0,66.31 ,81.40 ,66.31 
03,007,01,009,0220,0,1126,16,1142,1428,0,0,0,0,0,0,0,66.31 ,79.97 ,66.31 
03,007,01,009,0221,0,853,6,859,1085,0,0,0,0,0,0,0,66.31 ,79.17 ,66.31 
03,007,01,009,0222,0,651,5,656,785,0,0,0,0,0,0,0,66.31 ,83.57 ,66.31 
03,007,01,009,0223,0,1260,17,1277,1542,0,0,0,0,0,0,0,66.31 ,82.81 ,66.31 
03,007,01,009,0224,0,1408,13,1421,1740,0,0,0,0,0,0,0,66.31 ,81.67 ,66.31 
03,007,01,010,0225,0,792,10,802,1069,0,0,0,0,0,0,0,66.31 ,75.02 ,66.31 
03,007,01,010,0226,0,1754,34,1788,2483,0,0,0,0,0,0,0,66.31 ,72.01 ,66.31 
03,007,01,010,0227,0,1739,23,1762,2689,0,0,0,0,0,0,0,66.31 ,65.53 ,66.31 
03,007,01,010,0228,0,1869,27,1896,2667,0,0,0,0,0,0,0,66.31 ,71.09 ,66.31 
03,007,01,010,0229,0,615,8,623,809,0,0,0,0,0,0,0,66.31 ,77.01 ,66.31 
03,007,01,010,0230,0,1769,26,1795,2511,0,0,0,0,0,0,0,66.31 ,71.49 ,66.31 
03,007,01,010,0231,0,743,6,749,968,0,0,0,0,0,0,0,66.31 ,77.38 ,66.31 
03,007,01,010,0232,0,563,9,572,780,0,0,0,0,0,0,0,66.31 ,73.33 ,66.31 
03,007,01,010,0233,0,1296,29,1325,1756,0,0,0,0,0,0,0,66.31 ,75.46 ,66.31 
03,007,01,010,0234,0,2711,46,2757,3868,0,0,0,0,0,0,0,66.31 ,71.28 ,66.31 
03,007,01,010,0235,0,1535,35,1570,2230,0,0,0,0,0,0,0,66.31 ,70.40 ,66.31 
03,007,01,010,0236,0,2541,43,2584,3546,0,0,0,0,0,0,0,66.31 ,72.87 ,66.31 
03,007,01,010,0237,0,2232,36,2268,3110,0,0,0,0,0,0,0,66.31 ,72.93 ,66.31 
03,007,01,010,0238,0,2816,45,2861,3880,0,0,0,0,0,0,0,66.31 ,73.74 ,66.31 
03,007,01,010,0239,0,1049,17,1066,1331,0,0,0,0,0,0,0,66.31 ,80.09 ,66.31 
03,007,01,010,0240,0,1243,11,1254,1598,0,0,0,0,0,0,0,66.31 ,78.47 ,66.31 
03,007,01,010,0241,0,3355,52,3407,4876,0,0,0,0,0,0,0,66.31 ,69.87 ,66.31 
03,007,01,010,0242,0,3100,48,3148,4408,0,0,0,0,0,0,0,66.31 ,71.42 ,66.31 
03,007,01,010,0243,0,1664,32,1696,2364,0,0,0,0,0,0,0,66.31 ,71.74 ,66.31 
03,007,01,010,0244,0,1422,26,1448,2091,0,0,0,0,0,0,0,66.31 ,69.25 ,66.31 
03,007,01,010,0245,0,1259,13,1272,1785,0,0,0,0,0,0,0,66.31 ,71.26 ,66.31 
03,007,01,010,0246,0,1249,20,1269,1815,0,0,0,0,0,0,0,66.31 ,69.92 ,66.31 
03,007,01,010,0247,0,1017,18,1035,1370,0,0,0,0,0,0,0,66.31 ,75.55 ,66.31 
03,007,01,010,0248,0,1373,18,1391,1841,0,0,0,0,0,0,0,66.31 ,75.56 ,66.31 
03,007,01,010,0249,0,1603,31,1634,2216,0,0,0,0,0,0,0,66.31 ,73.74 ,66.31 
03,007,01,010,0250,0,1332,28,1360,1823,0,0,0,0,0,0,0,66.31 ,74.60 ,66.31 
03,007,01,010,0251,0,1920,38,1958,2682,0,0,0,0,0,0,0,66.31 ,73.01 ,66.31 
03,007,01,010,0252,0,1586,31,1617,2124,0,0,0,0,0,0,0,66.31 ,76.13 ,66.31 
03,007,01,010,0253,0,1454,21,1475,1966,0,0,0,0,0,0,0,66.31 ,75.03 ,66.31 
03,007,01,010,0254,0,1465,31,1496,2059,0,0,0,0,0,0,0,66.31 ,72.66 ,66.31 
03,007,01,010,0255,0,1157,29,1186,1593,0,0,0,0,0,0,0,66.31 ,74.45 ,66.31 
03,007,01,010,0256,0,962,11,973,1285,0,0,0,0,0,0,0,66.31 ,75.72 ,66.31 
03,007,01,010,0257,0,537,13,550,743,0,0,0,0,0,0,0,66.31 ,74.02 ,66.31 
03,007,01,010,0258,0,1356,20,1376,1731,0,0,0,0,0,0,0,66.31 ,79.49 ,66.31 
03,007,01,010,0259,0,1383,29,1412,1916,0,0,0,0,0,0,0,66.31 ,73.70 ,66.31 
03,007,01,010,0260,0,1071,11,1082,1470,0,0,0,0,0,0,0,66.31 ,73.61 ,66.31 
03,007,01,010,0261,0,1127,23,1150,1604,0,0,0,0,0,0,0,66.31 ,71.70 ,66.31 
03,007,01,010,0262,0,1008,14,1022,1342,0,0,0,0,0,0,0,66.31 ,76.15 ,66.31 
03,007,01,010,0263,0,1460,38,1498,1890,0,0,0,0,0,0,0,66.31 ,79.26 ,66.31 
03,007,01,011,0264,0,1287,26,1313,1728,0,0,0,0,0,0,0,66.31 ,75.98 ,66.31 
03,007,01,011,0265,0,1243,19,1262,1501,0,0,0,0,0,0,0,66.31 ,84.08 ,66.31 
03,007,01,011,0266,0,673,5,678,838,0,0,0,0,0,0,0,66.31 ,80.91 ,66.31 
03,007,01,011,0267,0,960,11,971,1214,0,0,0,0,0,0,0,66.31 ,79.98 ,66.31 
03,007,01,011,0268,0,935,8,943,1192,0,0,0,0,0,0,0,66.31 ,79.11 ,66.31 
03,007,01,011,0269,0,1120,8,1128,1420,0,0,0,0,0,0,0,66.31 ,79.44 ,66.31 
03,007,01,011,0270,0,791,17,808,1087,0,0,0,0,0,0,0,66.31 ,74.33 ,66.31 
03,007,01,011,0271,0,813,16,829,1078,0,0,0,0,0,0,0,66.31 ,76.90 ,66.31 
03,007,01,011,0272,0,1453,28,1481,1950,0,0,0,0,0,0,0,66.31 ,75.95 ,66.31 
03,007,01,011,0273,0,1142,4,1146,1395,0,0,0,0,0,0,0,66.31 ,82.15 ,66.31 
03,007,01,011,0274,0,1287,14,1301,1725,0,0,0,0,0,0,0,66.31 ,75.42 ,66.31 
03,007,01,011,0275,0,893,15,908,1127,0,0,0,0,0,0,0,66.31 ,80.57 ,66.31 
03,007,01,011,0276,0,1755,25,1780,2329,0,0,0,0,0,0,0,66.31 ,76.43 ,66.31 
03,007,01,011,0277,0,1212,20,1232,1572,0,0,0,0,0,0,0,66.31 ,78.37 ,66.31 
03,007,01,011,0278,0,1219,26,1245,1624,0,0,0,0,0,0,0,66.31 ,76.66 ,66.31 
03,007,01,011,0279,0,1413,26,1439,1861,0,0,0,0,0,0,0,66.31 ,77.32 ,66.31 
03,007,01,012,0280,0,642,10,652,800,0,0,0,0,0,0,0,66.31 ,81.50 ,66.31 
03,007,01,012,0281,0,983,19,1002,1352,0,0,0,0,0,0,0,66.31 ,74.11 ,66.31 
03,007,01,012,0282,0,1208,26,1234,1673,0,0,0,0,0,0,0,66.31 ,73.76 ,66.31 
03,007,01,012,0283,0,1196,22,1218,1630,0,0,0,0,0,0,0,66.31 ,74.72 ,66.31 
03,007,01,012,0284,0,1145,29,1174,1563,0,0,0,0,0,0,0,66.31 ,75.11 ,66.31 
03,007,01,012,0285,0,902,19,921,1221,0,0,0,0,0,0,0,66.31 ,75.43 ,66.31 
03,007,01,012,0286,0,655,12,667,853,0,0,0,0,0,0,0,66.31 ,78.19 ,66.31 
03,007,01,012,0287,0,589,7,596,778,0,0,0,0,0,0,0,66.31 ,76.61 ,66.31 
03,007,01,012,0288,0,1343,23,1366,1868,0,0,0,0,0,0,0,66.31 ,73.13 ,66.31 
03,007,01,012,0289,0,921,19,940,1210,0,0,0,0,0,0,0,66.31 ,77.69 ,66.31 
03,007,01,012,0290,0,786,14,800,1000,0,0,0,0,0,0,0,66.31 ,80.00 ,66.31 
03,007,01,012,0291,0,1068,22,1090,1368,0,0,0,0,0,0,0,66.31 ,79.68 ,66.31 
03,007,01,012,0292,0,1139,26,1165,1489,0,0,0,0,0,0,0,66.31 ,78.24 ,66.31 
03,007,01,012,0293,0,1128,11,1139,1420,0,0,0,0,0,0,0,66.31 ,80.21 ,66.31 
03,007,01,012,0294,0,818,26,844,1081,0,0,0,0,0,0,0,66.31 ,78.08 ,66.31 
03,007,01,012,0295,0,609,22,631,857,0,0,0,0,0,0,0,66.31 ,73.63 ,66.31 
03,007,01,012,0296,0,471,4,475,620,0,0,0,0,0,0,0,66.31 ,76.61 ,66.31 
03,007,01,012,0297,0,555,13,568,723,0,0,0,0,0,0,0,66.31 ,78.56 ,66.31 
03,007,01,012,0298,0,480,11,491,617,0,0,0,0,0,0,0,66.31 ,79.58 ,66.31 
03,007,01,012,0299,0,687,9,696,909,0,0,0,0,0,0,0,66.31 ,76.57 ,66.31 
03,007,01,012,0300,0,641,11,652,828,0,0,0,0,0,0,0,66.31 ,78.74 ,66.31 
03,007,01,012,0301,0,520,11,531,678,0,0,0,0,0,0,0,66.31 ,78.32 ,66.31 
03,007,01,012,0302,0,886,26,912,1137,0,0,0,0,0,0,0,66.31 ,80.21 ,66.31 
03,007,01,012,0303,0,1010,11,1021,1340,0,0,0,0,0,0,0,66.31 ,76.19 ,66.31 
03,007,01,013,0304,0,922,12,934,1149,0,0,0,0,0,0,0,66.31 ,81.29 ,66.31 
03,007,01,013,0305,0,568,6,574,736,0,0,0,0,0,0,0,66.31 ,77.99 ,66.31 
03,007,01,013,0306,0,941,18,959,1244,0,0,0,0,0,0,0,66.31 ,77.09 ,66.31 
03,007,01,013,0307,0,411,4,415,525,0,0,0,0,0,0,0,66.31 ,79.05 ,66.31 
03,007,01,013,0308,0,1952,17,1969,2633,0,0,0,0,0,0,0,66.31 ,74.78 ,66.31 
03,007,01,013,0309,0,1320,11,1331,1684,0,0,0,0,0,0,0,66.31 ,79.04 ,66.31 
03,007,01,013,0310,0,1357,17,1374,1820,0,0,0,0,0,0,0,66.31 ,75.49 ,66.31 
03,007,01,013,0311,0,952,17,969,1197,0,0,0,0,0,0,0,66.31 ,80.95 ,66.31 
03,007,01,013,0312,0,1531,18,1549,1901,0,0,0,0,0,0,0,66.31 ,81.48 ,66.31 
03,007,01,013,0313,0,1600,22,1622,2104,0,0,0,0,0,0,0,66.31 ,77.09 ,66.31 
03,007,01,013,0314,0,1332,12,1344,1747,0,0,0,0,0,0,0,66.31 ,76.93 ,66.31 
03,007,01,013,0315,0,610,1,611,732,0,0,0,0,0,0,0,66.31 ,83.47 ,66.31 
03,007,01,013,0316,0,1206,19,1225,1515,0,0,0,0,0,0,0,66.31 ,80.86 ,66.31 
03,007,01,013,0317,0,1712,26,1738,2162,0,0,0,0,0,0,0,66.31 ,80.39 ,66.31 
03,007,01,013,0318,0,605,3,608,730,0,0,0,0,0,0,0,66.31 ,83.29 ,66.31 
03,007,01,013,0319,0,910,21,931,1160,0,0,0,0,0,0,0,66.31 ,80.26 ,66.31 
03,007,01,013,0320,0,1026,22,1048,1352,0,0,0,0,0,0,0,66.31 ,77.51 ,66.31 
03,007,01,013,0321,0,2529,39,2568,3264,0,0,0,0,0,0,0,66.31 ,78.68 ,66.31 
03,007,01,013,0322,0,501,14,515,647,0,0,0,0,0,0,0,66.31 ,79.60 ,66.31 
03,007,01,013,0323,0,915,13,928,1107,0,0,0,0,0,0,0,66.31 ,83.83 ,66.31 
03,007,01,013,0324,0,560,4,564,679,0,0,0,0,0,0,0,66.31 ,83.06 ,66.31 
03,007,01,013,0325,0,901,12,913,1140,0,0,0,0,0,0,0,66.31 ,80.09 ,66.31 
03,007,01,013,0326,0,1007,12,1019,1338,0,0,0,0,0,0,0,66.31 ,76.16 ,66.31 
03,007,01,013,0327,0,1347,17,1364,1725,0,0,0,0,0,0,0,66.31 ,79.07 ,66.31 
03,007,01,013,0328,0,1049,14,1063,1423,0,0,0,0,0,0,0,66.31 ,74.70 ,66.31 
03,007,01,014,0329,0,1127,24,1151,1410,0,0,0,0,0,0,0,66.31 ,81.63 ,66.31 
03,007,01,014,0330,0,1069,22,1091,1362,0,0,0,0,0,0,0,66.31 ,80.10 ,66.31 
03,007,01,014,0331,0,904,9,913,1070,0,0,0,0,0,0,0,66.31 ,85.33 ,66.31 
03,007,01,014,0332,0,633,6,639,758,0,0,0,0,0,0,0,66.31 ,84.30 ,66.31 
03,007,01,014,0333,0,1286,21,1307,1536,0,0,0,0,0,0,0,66.31 ,85.09 ,66.31 
03,007,01,014,0334,0,761,4,765,896,0,0,0,0,0,0,0,66.31 ,85.38 ,66.31 
03,007,01,014,0335,0,918,16,934,1201,0,0,0,0,0,0,0,66.31 ,77.77 ,66.31 
03,007,01,014,0336,0,785,0,785,964,0,0,0,0,0,0,0,66.31 ,81.43 ,66.31 
03,007,01,014,0337,0,542,5,547,668,0,0,0,0,0,0,0,66.31 ,81.89 ,66.31 
03,007,01,014,0338,0,891,12,903,1066,0,0,0,0,0,0,0,66.31 ,84.71 ,66.31 
03,007,01,014,0339,0,964,17,981,1169,0,0,0,0,0,0,0,66.31 ,83.92 ,66.31 
03,007,01,014,0340,0,1534,23,1557,1899,0,0,0,0,0,0,0,66.31 ,81.99 ,66.31 
03,007,01,014,0341,0,1037,7,1044,1212,0,0,0,0,0,0,0,66.31 ,86.14 ,66.31 
03,007,01,014,0342,0,308,0,308,385,0,0,0,0,0,0,0,66.31 ,80.00 ,66.31 
03,007,01,014,0343,0,779,7,786,985,0,0,0,0,0,0,0,66.31 ,79.80 ,66.31 
03,007,01,014,0344,0,628,6,634,743,0,0,0,0,0,0,0,66.31 ,85.33 ,66.31 
03,007,01,014,0345,0,1024,18,1042,1271,0,0,0,0,0,0,0,66.31 ,81.98 ,66.31 
03,007,01,014,0346,0,641,7,648,802,0,0,0,0,0,0,0,66.31 ,80.80 ,66.31 
03,007,01,014,0347,0,1107,13,1120,1420,0,0,0,0,0,0,0,66.31 ,78.87 ,66.31 
03,007,01,014,0348,0,1026,17,1043,1273,0,0,0,0,0,0,0,66.31 ,81.93 ,66.31 
03,007,01,014,0349,0,995,7,1002,1228,0,0,0,0,0,0,0,66.31 ,81.60 ,66.31 
03,007,01,014,0350,0,978,17,995,1225,0,0,0,0,0,0,0,66.31 ,81.22 ,66.31 
03,007,01,015,0351,0,1722,16,1738,2304,0,0,0,0,0,0,0,66.31 ,75.43 ,66.31 
03,007,01,015,0352,0,888,5,893,1171,0,0,0,0,0,0,0,66.31 ,76.26 ,66.31 
03,007,01,015,0353,0,1039,15,1054,1347,0,0,0,0,0,0,0,66.31 ,78.25 ,66.31 
03,007,01,015,0354,0,824,15,839,1036,0,0,0,0,0,0,0,66.31 ,80.98 ,66.31 
03,007,01,015,0355,0,1125,18,1143,1510,0,0,0,0,0,0,0,66.31 ,75.70 ,66.31 
03,007,01,015,0356,0,1147,34,1181,1475,0,0,0,0,0,0,0,66.31 ,80.07 ,66.31 
03,007,01,015,0357,0,978,14,992,1276,0,0,0,0,0,0,0,66.31 ,77.74 ,66.31 
03,007,01,015,0358,0,969,12,981,1348,0,0,0,0,0,0,0,66.31 ,72.77 ,66.31 
03,007,01,015,0359,0,1262,26,1288,1622,0,0,0,0,0,0,0,66.31 ,79.41 ,66.31 
03,007,01,015,0360,0,460,5,465,580,0,0,0,0,0,0,0,66.31 ,80.17 ,66.31 
03,007,01,015,0361,0,700,15,715,925,0,0,0,0,0,0,0,66.31 ,77.30 ,66.31 
03,007,01,015,0362,0,777,16,793,1025,0,0,0,0,0,0,0,66.31 ,77.37 ,66.31 
03,007,01,015,0363,0,519,11,530,689,0,0,0,0,0,0,0,66.31 ,76.92 ,66.31 
03,007,01,015,0364,0,608,10,618,782,0,0,0,0,0,0,0,66.31 ,79.03 ,66.31 
03,007,01,015,0365,0,1111,23,1134,1527,0,0,0,0,0,0,0,66.31 ,74.26 ,66.31 
03,007,01,015,0366,0,983,11,994,1274,0,0,0,0,0,0,0,66.31 ,78.02 ,66.31 
03,007,01,015,0367,0,673,10,683,852,0,0,0,0,0,0,0,66.31 ,80.16 ,66.31 
03,007,01,015,0368,0,899,15,914,1136,0,0,0,0,0,0,0,66.31 ,80.46 ,66.31 
03,007,01,015,0369,0,601,12,613,713,0,0,0,0,0,0,0,66.31 ,85.97 ,66.31 
03,007,01,015,0370,0,668,20,688,842,0,0,0,0,0,0,0,66.31 ,81.71 ,66.31 
03,007,01,016,0371,0,639,10,649,863,0,0,0,0,0,0,0,66.31 ,75.20 ,66.31 
03,007,01,016,0372,0,1548,66,1614,2537,0,0,0,0,0,0,0,66.31 ,63.62 ,66.31 
03,007,01,016,0373,0,450,10,460,627,0,0,0,0,0,0,0,66.31 ,73.37 ,66.31 
03,007,01,016,0374,0,1039,18,1057,1485,0,0,0,0,0,0,0,66.31 ,71.18 ,66.31 
03,007,01,016,0375,0,1026,19,1045,1436,0,0,0,0,0,0,0,66.31 ,72.77 ,66.31 
03,007,01,016,0376,0,857,17,874,1154,0,0,0,0,0,0,0,66.31 ,75.74 ,66.31 
03,007,01,016,0377,0,1137,19,1156,1606,0,0,0,0,0,0,0,66.31 ,71.98 ,66.31 
03,007,01,016,0378,0,491,4,495,642,0,0,0,0,0,0,0,66.31 ,77.10 ,66.31 
03,007,01,016,0379,0,1788,28,1816,2529,0,0,0,0,0,0,0,66.31 ,71.81 ,66.31 
03,007,01,016,0380,0,1409,23,1432,1974,0,0,0,0,0,0,0,66.31 ,72.54 ,66.31 
03,007,01,016,0381,0,785,10,795,1056,0,0,0,0,0,0,0,66.31 ,75.28 ,66.31 
03,007,01,016,0382,0,911,13,924,1269,0,0,0,0,0,0,0,66.31 ,72.81 ,66.31 
03,007,01,016,0383,0,1432,21,1453,1984,0,0,0,0,0,0,0,66.31 ,73.24 ,66.31 
03,007,01,016,0384,0,1327,37,1364,1872,0,0,0,0,0,0,0,66.31 ,72.86 ,66.31 
03,007,01,016,0385,0,1157,31,1188,1592,0,0,0,0,0,0,0,66.31 ,74.62 ,66.31 
03,007,01,016,0386,0,872,13,885,1247,0,0,0,0,0,0,0,66.31 ,70.97 ,66.31 
03,007,01,016,0387,0,1070,24,1094,1469,0,0,0,0,0,0,0,66.31 ,74.47 ,66.31 
03,007,01,016,0388,0,2087,40,2127,3013,0,0,0,0,0,0,0,66.31 ,70.59 ,66.31 
03,007,01,016,0389,0,865,18,883,1284,0,0,0,0,0,0,0,66.31 ,68.77 ,66.31 
03,007,01,016,0390,0,1039,22,1061,1433,0,0,0,0,0,0,0,66.31 ,74.04 ,66.31 
03,007,01,016,0391,0,684,17,701,908,0,0,0,0,0,0,0,66.31 ,77.20 ,66.31 
03,007,01,016,0392,0,560,10,570,744,0,0,0,0,0,0,0,66.31 ,76.61 ,66.31 
03,007,01,017,0393,0,1756,26,1782,2436,0,0,0,0,0,0,0,66.31 ,73.15 ,66.31 
03,007,01,017,0394,0,2434,36,2470,3202,0,0,0,0,0,0,0,66.31 ,77.14 ,66.31 
03,007,01,017,0395,0,1651,23,1674,2305,0,0,0,0,0,0,0,66.31 ,72.62 ,66.31 
03,007,01,017,0396,0,555,9,564,751,0,0,0,0,0,0,0,66.31 ,75.10 ,66.31 
03,007,01,017,0397,0,735,13,748,938,0,0,0,0,0,0,0,66.31 ,79.74 ,66.31 
03,007,01,017,0398,0,772,19,791,997,0,0,0,0,0,0,0,66.31 ,79.34 ,66.31 
03,007,01,017,0399,0,962,11,973,1283,0,0,0,0,0,0,0,66.31 ,75.84 ,66.31 
03,007,01,017,0400,0,658,13,671,851,0,0,0,0,0,0,0,66.31 ,78.85 ,66.31 
03,007,01,017,0401,0,888,12,900,1214,0,0,0,0,0,0,0,66.31 ,74.14 ,66.31 
03,007,01,017,0402,0,599,7,606,769,0,0,0,0,0,0,0,66.31 ,78.80 ,66.31 
03,007,01,017,0403,0,1311,19,1330,1752,0,0,0,0,0,0,0,66.31 ,75.91 ,66.31 
03,007,01,017,0404,0,1014,24,1038,1337,0,0,0,0,0,0,0,66.31 ,77.64 ,66.31 
03,007,01,017,0405,0,1022,16,1038,1357,0,0,0,0,0,0,0,66.31 ,76.49 ,66.31 
03,007,01,017,0406,0,829,5,834,1028,0,0,0,0,0,0,0,66.31 ,81.13 ,66.31 
03,007,01,017,0407,0,792,19,811,977,0,0,0,0,0,0,0,66.31 ,83.01 ,66.31 
03,007,01,017,0408,0,810,10,820,1025,0,0,0,0,0,0,0,66.31 ,80.00 ,66.31 
03,007,01,017,0409,0,682,11,693,889,0,0,0,0,0,0,0,66.31 ,77.95 ,66.31 
03,007,01,017,0410,0,716,13,729,925,0,0,0,0,0,0,0,66.31 ,78.81 ,66.31 
03,007,01,017,0411,0,482,30,512,668,0,0,0,0,0,0,0,66.31 ,76.65 ,66.31 
03,007,01,017,0412,0,610,9,619,794,0,0,0,0,0,0,0,66.31 ,77.96 ,66.31 
03,007,01,017,0413,0,690,6,696,856,0,0,0,0,0,0,0,66.31 ,81.31 ,66.31 
03,007,01,017,0414,0,583,11,594,763,0,0,0,0,0,0,0,66.31 ,77.85 ,66.31 
03,007,01,017,0415,0,986,20,1006,1287,0,0,0,0,0,0,0,66.31 ,78.17 ,66.31 
03,007,01,017,0416,0,1301,28,1329,1773,0,0,0,0,0,0,0,66.31 ,74.96 ,66.31 
03,007,01,018,0417,0,800,6,806,1039,0,0,0,0,0,0,0,66.31 ,77.57 ,66.31 
03,007,01,018,0418,0,529,7,536,700,0,0,0,0,0,0,0,66.31 ,76.57 ,66.31 
03,007,01,018,0419,0,638,9,647,837,0,0,0,0,0,0,0,66.31 ,77.30 ,66.31 
03,007,01,018,0420,0,786,24,810,1040,0,0,0,0,0,0,0,66.31 ,77.88 ,66.31 
03,007,01,018,0421,0,518,3,521,652,0,0,0,0,0,0,0,66.31 ,79.91 ,66.31 
03,007,01,018,0422,0,543,5,548,692,0,0,0,0,0,0,0,66.31 ,79.19 ,66.31 
03,007,01,018,0423,0,745,13,758,936,0,0,0,0,0,0,0,66.31 ,80.98 ,66.31 
03,007,01,018,0424,0,735,8,743,957,0,0,0,0,0,0,0,66.31 ,77.64 ,66.31 
03,007,01,018,0425,0,701,8,709,877,0,0,0,0,0,0,0,66.31 ,80.84 ,66.31 
03,007,01,018,0426,0,402,3,405,519,0,0,0,0,0,0,0,66.31 ,78.03 ,66.31 
03,007,01,018,0427,0,648,7,655,867,0,0,0,0,0,0,0,66.31 ,75.55 ,66.31 
03,007,01,018,0428,0,646,14,660,859,0,0,0,0,0,0,0,66.31 ,76.83 ,66.31 
03,007,01,018,0429,0,582,5,587,721,0,0,0,0,0,0,0,66.31 ,81.41 ,66.31 
03,007,01,018,0430,0,632,10,642,815,0,0,0,0,0,0,0,66.31 ,78.77 ,66.31 
03,007,01,018,0431,0,625,8,633,792,0,0,0,0,0,0,0,66.31 ,79.92 ,66.31 
03,007,01,018,0432,0,542,5,547,684,0,0,0,0,0,0,0,66.31 ,79.97 ,66.31 
03,007,01,018,0433,0,496,9,505,628,0,0,0,0,0,0,0,66.31 ,80.41 ,66.31 
03,007,01,019,0434,0,1632,22,1654,2174,0,0,0,0,0,0,0,66.31 ,76.08 ,66.31 
03,007,01,019,0435,0,1239,15,1254,1604,0,0,0,0,0,0,0,66.31 ,78.18 ,66.31 
03,007,01,019,0436,0,2722,39,2761,3527,0,0,0,0,0,0,0,66.31 ,78.28 ,66.31 
03,007,01,019,0437,0,1110,13,1123,1515,0,0,0,0,0,0,0,66.31 ,74.13 ,66.31 
03,007,01,019,0438,0,957,10,967,1278,0,0,0,0,0,0,0,66.31 ,75.67 ,66.31 
03,007,01,019,0439,0,630,10,640,817,0,0,0,0,0,0,0,66.31 ,78.34 ,66.31 
03,007,01,019,0440,0,486,7,493,646,0,0,0,0,0,0,0,66.31 ,76.32 ,66.31 
03,007,01,019,0441,0,640,7,647,804,0,0,0,0,0,0,0,66.31 ,80.47 ,66.31 
03,007,01,019,0442,0,987,18,1005,1369,0,0,0,0,0,0,0,66.31 ,73.41 ,66.31 
03,007,01,019,0443,0,1039,10,1049,1299,0,0,0,0,0,0,0,66.31 ,80.75 ,66.31 
03,007,01,019,0444,0,1182,20,1202,1583,0,0,0,0,0,0,0,66.31 ,75.93 ,66.31 
03,007,01,019,0445,0,1495,25,1520,1980,0,0,0,0,0,0,0,66.31 ,76.77 ,66.31 
03,007,01,019,0446,0,795,13,808,1058,0,0,0,0,0,0,0,66.31 ,76.37 ,66.31 
03,007,01,019,0447,0,1189,32,1221,1579,0,0,0,0,0,0,0,66.31 ,77.33 ,66.31 
03,007,01,019,0448,0,940,31,971,1343,0,0,0,0,0,0,0,66.31 ,72.30 ,66.31 
03,007,01,020,0449,0,1148,31,1179,1728,0,0,0,0,0,0,0,66.31 ,68.23 ,66.31 
03,007,01,020,0450,0,460,14,474,652,0,0,0,0,0,0,0,66.31 ,72.70 ,66.31 
03,007,01,020,0451,0,678,4,682,916,0,0,0,0,0,0,0,66.31 ,74.45 ,66.31 
03,007,01,020,0452,0,1234,22,1256,1619,0,0,0,0,0,0,0,66.31 ,77.58 ,66.31 
03,007,01,020,0453,0,978,24,1002,1283,0,0,0,0,0,0,0,66.31 ,78.10 ,66.31 
03,007,01,020,0454,0,1290,14,1304,1718,0,0,0,0,0,0,0,66.31 ,75.90 ,66.31 
03,007,01,020,0455,0,955,11,966,1223,0,0,0,0,0,0,0,66.31 ,78.99 ,66.31 
03,007,01,020,0456,0,973,15,988,1375,0,0,0,0,0,0,0,66.31 ,71.85 ,66.31 
03,007,01,020,0457,0,1441,28,1469,1985,0,0,0,0,0,0,0,66.31 ,74.01 ,66.31 
03,007,01,020,0458,0,1254,31,1285,1742,0,0,0,0,0,0,0,66.31 ,73.77 ,66.31 
03,007,01,020,0459,0,1316,19,1335,1890,0,0,0,0,0,0,0,66.31 ,70.63 ,66.31 
03,007,01,020,0460,0,538,17,555,760,0,0,0,0,0,0,0,66.31 ,73.03 ,66.31 
03,007,01,020,0461,0,808,10,818,1080,0,0,0,0,0,0,0,66.31 ,75.74 ,66.31 
03,007,01,020,0462,0,642,11,653,945,0,0,0,0,0,0,0,66.31 ,69.10 ,66.31 
03,007,01,020,0463,0,508,7,515,749,0,0,0,0,0,0,0,66.31 ,68.76 ,66.31 
03,007,01,020,0464,0,620,12,632,840,0,0,0,0,0,0,0,66.31 ,75.24 ,66.31 
03,007,01,020,0465,0,861,21,882,1163,0,0,0,0,0,0,0,66.31 ,75.84 ,66.31 
03,007,01,020,0466,0,662,8,670,881,0,0,0,0,0,0,0,66.31 ,76.05 ,66.31 
03,007,01,020,0467,0,809,12,821,1171,0,0,0,0,0,0,0,66.31 ,70.11 ,66.31 
03,007,01,021,0468,0,896,12,908,1201,0,0,0,0,0,0,0,66.31 ,75.60 ,66.31 
03,007,01,021,0469,0,495,7,502,628,0,0,0,0,0,0,0,66.31 ,79.94 ,66.31 
03,007,01,021,0470,0,1271,26,1297,1691,0,0,0,0,0,0,0,66.31 ,76.70 ,66.31 
03,007,01,021,0471,0,841,14,855,1094,0,0,0,0,0,0,0,66.31 ,78.15 ,66.31 
03,007,01,021,0472,0,847,14,861,1087,0,0,0,0,0,0,0,66.31 ,79.21 ,66.31 
03,007,01,021,0473,0,779,25,804,1012,0,0,0,0,0,0,0,66.31 ,79.45 ,66.31 
03,007,01,021,0474,0,871,12,883,1120,0,0,0,0,0,0,0,66.31 ,78.84 ,66.31 
03,007,01,021,0475,0,696,12,708,860,0,0,0,0,0,0,0,66.31 ,82.33 ,66.31 
03,007,01,021,0476,0,519,16,535,648,0,0,0,0,0,0,0,66.31 ,82.56 ,66.31 
03,007,01,021,0477,0,635,17,652,842,0,0,0,0,0,0,0,66.31 ,77.43 ,66.31 
03,007,01,021,0478,0,810,12,822,981,0,0,0,0,0,0,0,66.31 ,83.79 ,66.31 
03,007,01,021,0479,0,855,18,873,1168,0,0,0,0,0,0,0,66.31 ,74.74 ,66.31 
03,007,01,021,0480,0,1290,18,1308,1662,0,0,0,0,0,0,0,66.31 ,78.70 ,66.31 
03,007,01,021,0481,0,653,5,658,779,0,0,0,0,0,0,0,66.31 ,84.47 ,66.31 
03,007,01,021,0482,0,647,5,652,839,0,0,0,0,0,0,0,66.31 ,77.71 ,66.31 
03,007,01,021,0483,0,1057,18,1075,1464,0,0,0,0,0,0,0,66.31 ,73.43 ,66.31 
03,007,01,021,0484,0,1130,18,1148,1474,0,0,0,0,0,0,0,66.31 ,77.88 ,66.31 
03,007,01,021,0485,0,253,2,255,315,0,0,0,0,0,0,0,66.31 ,80.95 ,66.31 
03,007,01,021,0486,0,468,5,473,643,0,0,0,0,0,0,0,66.31 ,73.56 ,66.31 
03,007,01,021,0487,0,500,8,508,651,0,0,0,0,0,0,0,66.31 ,78.03 ,66.31 
03,007,01,022,0488,0,1622,48,1670,2169,0,0,0,0,0,0,0,66.31 ,76.99 ,66.31 
03,007,01,022,0489,0,1061,34,1095,1442,0,0,0,0,0,0,0,66.31 ,75.94 ,66.31 
03,007,01,022,0490,0,1157,27,1184,1518,0,0,0,0,0,0,0,66.31 ,78.00 ,66.31 
03,007,01,022,0491,0,1544,23,1567,2023,0,0,0,0,0,0,0,66.31 ,77.46 ,66.31 
03,007,01,022,0492,0,802,8,810,1085,0,0,0,0,0,0,0,66.31 ,74.65 ,66.31 
03,007,01,022,0493,0,1077,22,1099,1443,0,0,0,0,0,0,0,66.31 ,76.16 ,66.31 
03,007,01,022,0494,0,2180,43,2223,2821,0,0,0,0,0,0,0,66.31 ,78.80 ,66.31 
03,007,01,022,0495,0,1153,25,1178,1557,0,0,0,0,0,0,0,66.31 ,75.66 ,66.31 
03,007,01,022,0496,0,488,7,495,662,0,0,0,0,0,0,0,66.31 ,74.77 ,66.31 
03,007,01,022,0497,0,463,7,470,601,0,0,0,0,0,0,0,66.31 ,78.20 ,66.31 
03,007,01,022,0498,0,1171,19,1190,1566,0,0,0,0,0,0,0,66.31 ,75.99 ,66.31 
03,007,01,022,0499,0,844,19,863,1173,0,0,0,0,0,0,0,66.31 ,73.57 ,66.31 
03,007,01,022,0500,0,613,7,620,829,0,0,0,0,0,0,0,66.31 ,74.79 ,66.31 
03,007,01,022,0501,0,580,10,590,788,0,0,0,0,0,0,0,66.31 ,74.87 ,66.31 
03,007,01,022,0502,0,891,19,910,1230,0,0,0,0,0,0,0,66.31 ,73.98 ,66.31 
03,007,01,022,0503,0,638,14,652,927,0,0,0,0,0,0,0,66.31 ,70.33 ,66.31 
03,007,01,022,0504,0,702,19,721,961,0,0,0,0,0,0,0,66.31 ,75.03 ,66.31 
03,007,01,023,0505,0,1498,18,1516,1992,0,0,0,0,0,0,0,66.31 ,76.10 ,66.31 
03,007,01,023,0506,0,1976,31,2007,2610,0,0,0,0,0,0,0,66.31 ,76.90 ,66.31 
03,007,01,023,0507,0,1001,19,1020,1327,0,0,0,0,0,0,0,66.31 ,76.87 ,66.31 
03,007,01,023,0508,0,1724,29,1753,2328,0,0,0,0,0,0,0,66.31 ,75.30 ,66.31 
03,007,01,023,0509,0,1188,12,1200,1607,0,0,0,0,0,0,0,66.31 ,74.67 ,66.31 
03,007,01,023,0510,0,1043,12,1055,1461,0,0,0,0,0,0,0,66.31 ,72.21 ,66.31 
03,007,01,023,0511,0,855,15,870,1218,0,0,0,0,0,0,0,66.31 ,71.43 ,66.31 
03,007,01,023,0512,0,861,14,875,1095,0,0,0,0,0,0,0,66.31 ,79.91 ,66.31 
03,007,01,023,0513,0,851,16,867,1057,0,0,0,0,0,0,0,66.31 ,82.02 ,66.31 
03,007,01,023,0514,0,879,10,889,1181,0,0,0,0,0,0,0,66.31 ,75.28 ,66.31 
03,007,01,023,0515,0,1645,29,1674,2155,0,0,0,0,0,0,0,66.31 ,77.68 ,66.31 
03,007,01,023,0516,0,1486,32,1518,2095,0,0,0,0,0,0,0,66.31 ,72.46 ,66.31 
03,007,01,023,0517,0,945,13,958,1293,0,0,0,0,0,0,0,66.31 ,74.09 ,66.31 
03,007,01,023,0518,0,1251,27,1278,1621,0,0,0,0,0,0,0,66.31 ,78.84 ,66.31 
03,007,01,023,0519,0,1012,11,1023,1253,0,0,0,0,0,0,0,66.31 ,81.64 ,66.31 
03,007,01,023,0520,0,609,10,619,769,0,0,0,0,0,0,0,66.31 ,80.49 ,66.31 
03,007,01,023,0521,0,1150,14,1164,1439,0,0,0,0,0,0,0,66.31 ,80.89 ,66.31 
03,007,01,023,0522,0,868,8,876,1119,0,0,0,0,0,0,0,66.31 ,78.28 ,66.31 
03,007,01,023,0523,0,796,19,815,1043,0,0,0,0,0,0,0,66.31 ,78.14 ,66.31 
03,007,01,023,0524,0,2645,54,2699,3386,0,0,0,0,0,0,0,66.31 ,79.71 ,66.31 
03,007,01,023,0525,0,998,8,1006,1349,0,0,0,0,0,0,0,66.31 ,74.57 ,66.31 
03,007,01,023,0526,0,748,15,763,992,0,0,0,0,0,0,0,66.31 ,76.92 ,66.31 
03,007,01,023,0527,0,676,6,682,876,0,0,0,0,0,0,0,66.31 ,77.85 ,66.31 
03,007,01,023,0528,0,850,7,857,1146,0,0,0,0,0,0,0,66.31 ,74.78 ,66.31 
03,007,01,023,0529,0,766,10,776,999,0,0,0,0,0,0,0,66.31 ,77.68 ,66.31 
03,007,01,023,0530,0,782,8,790,1002,0,0,0,0,0,0,0,66.31 ,78.84 ,66.31 
03,007,01,023,0531,0,624,7,631,781,0,0,0,0,0,0,0,66.31 ,80.79 ,66.31 
03,007,01,024,0532,0,695,11,706,1112,0,0,0,0,0,0,0,66.31 ,63.49 ,66.31 
03,007,01,024,0533,0,360,1,361,545,0,0,0,0,0,0,0,66.31 ,66.24 ,66.31 
03,007,01,024,0534,0,601,12,613,941,0,0,0,0,0,0,0,66.31 ,65.14 ,66.31 
03,007,01,024,0535,0,425,7,432,703,0,0,0,0,0,0,0,66.31 ,61.45 ,66.31 
03,007,01,024,0536,0,672,7,679,938,0,0,0,0,0,0,0,66.31 ,72.39 ,66.31 
03,007,01,024,0537,0,1318,15,1333,1720,0,0,0,0,0,0,0,66.31 ,77.50 ,66.31 
03,007,01,024,0538,0,994,13,1007,1427,0,0,0,0,0,0,0,66.31 ,70.57 ,66.31 
03,007,01,024,0539,0,666,8,674,1123,0,0,0,0,0,0,0,66.31 ,60.02 ,66.31 
03,007,01,024,0540,0,516,7,523,784,0,0,0,0,0,0,0,66.31 ,66.71 ,66.31 
03,007,01,024,0541,0,620,12,632,810,0,0,0,0,0,0,0,66.31 ,78.02 ,66.31 
03,007,01,024,0542,0,756,11,767,999,0,0,0,0,0,0,0,66.31 ,76.78 ,66.31 
03,007,01,024,0543,0,503,2,505,712,0,0,0,0,0,0,0,66.31 ,70.93 ,66.31 
03,007,01,024,0544,0,468,3,471,683,0,0,0,0,0,0,0,66.31 ,68.96 ,66.31 
03,007,01,024,0545,0,1393,23,1416,2015,0,0,0,0,0,0,0,66.31 ,70.27 ,66.31 
03,007,01,024,0546,0,588,5,593,805,0,0,0,0,0,0,0,66.31 ,73.66 ,66.31 
03,007,01,024,0547,0,523,11,534,816,0,0,0,0,0,0,0,66.31 ,65.44 ,66.31 
03,007,01,024,0548,0,916,11,927,1344,0,0,0,0,0,0,0,66.31 ,68.97 ,66.31 
03,007,01,024,0549,0,531,4,535,782,0,0,0,0,0,0,0,66.31 ,68.41 ,66.31 
03,007,01,024,0550,0,1023,14,1037,1327,0,0,0,0,0,0,0,66.31 ,78.15 ,66.31 
03,007,01,024,0551,0,387,5,392,622,0,0,0,0,0,0,0,66.31 ,63.02 ,66.31 
03,007,01,024,0552,0,1010,17,1027,1339,0,0,0,0,0,0,0,66.31 ,76.70 ,66.31 
03,007,01,024,0553,0,1488,36,1524,2013,0,0,0,0,0,0,0,66.31 ,75.71 ,66.31 
03,007,01,024,0554,0,575,6,581,749,0,0,0,0,0,0,0,66.31 ,77.57 ,66.31 
03,007,01,024,0555,0,743,9,752,991,0,0,0,0,0,0,0,66.31 ,75.88 ,66.31 
03,007,01,024,0556,0,934,17,951,1326,0,0,0,0,0,0,0,66.31 ,71.72 ,66.31 
03,007,01,024,0557,0,1929,34,1963,2643,0,0,0,0,0,0,0,66.31 ,74.27 ,66.31 
03,007,01,025,0558,0,951,13,964,1438,0,0,0,0,0,0,0,66.31 ,67.04 ,66.31 
03,007,01,025,0559,0,943,18,961,1427,0,0,0,0,0,0,0,66.31 ,67.34 ,66.31 
03,007,01,025,0560,0,636,7,643,901,0,0,0,0,0,0,0,66.31 ,71.37 ,66.31 
03,007,01,025,0561,0,898,11,909,1247,0,0,0,0,0,0,0,66.31 ,72.89 ,66.31 
03,007,01,025,0562,0,751,7,758,1075,0,0,0,0,0,0,0,66.31 ,70.51 ,66.31 
03,007,01,025,0563,0,828,14,842,1202,0,0,0,0,0,0,0,66.31 ,70.05 ,66.31 
03,007,01,025,0564,0,516,7,523,773,0,0,0,0,0,0,0,66.31 ,67.66 ,66.31 
03,007,01,025,0565,0,875,2,877,1289,0,0,0,0,0,0,0,66.31 ,68.04 ,66.31 
03,007,01,025,0566,0,627,10,637,884,0,0,0,0,0,0,0,66.31 ,72.06 ,66.31 
03,007,01,025,0567,0,481,8,489,788,0,0,0,0,0,0,0,66.31 ,62.06 ,66.31 
03,007,01,025,0568,0,887,21,908,1191,0,0,0,0,0,0,0,66.31 ,76.24 ,66.31 
03,007,01,025,0569,0,884,13,897,1327,0,0,0,0,0,0,0,66.31 ,67.60 ,66.31 
03,007,01,025,0570,0,695,7,702,1093,0,0,0,0,0,0,0,66.31 ,64.23 ,66.31 
03,007,01,025,0571,0,574,5,579,846,0,0,0,0,0,0,0,66.31 ,68.44 ,66.31 
03,007,01,025,0572,0,667,8,675,1049,0,0,0,0,0,0,0,66.31 ,64.35 ,66.31 
03,007,01,026,0573,0,790,12,802,1050,0,0,0,0,0,0,0,66.31 ,76.38 ,66.31 
03,007,01,026,0574,0,1282,10,1292,1589,0,0,0,0,0,0,0,66.31 ,81.31 ,66.31 
03,007,01,026,0575,0,633,2,635,824,0,0,0,0,0,0,0,66.31 ,77.06 ,66.31 
03,007,01,026,0576,0,584,6,590,778,0,0,0,0,0,0,0,66.31 ,75.84 ,66.31 
03,007,01,026,0577,0,1095,23,1118,1477,0,0,0,0,0,0,0,66.31 ,75.69 ,66.31 
03,007,01,026,0578,0,461,6,467,630,0,0,0,0,0,0,0,66.31 ,74.13 ,66.31 
03,007,01,026,0579,0,707,9,716,937,0,0,0,0,0,0,0,66.31 ,76.41 ,66.31 
03,007,01,026,0580,0,904,11,915,1211,0,0,0,0,0,0,0,66.31 ,75.56 ,66.31 
03,007,01,026,0581,0,395,3,398,567,0,0,0,0,0,0,0,66.31 ,70.19 ,66.31 
03,007,01,026,0582,0,634,5,639,882,0,0,0,0,0,0,0,66.31 ,72.45 ,66.31 
03,007,01,026,0583,0,539,6,545,720,0,0,0,0,0,0,0,66.31 ,75.69 ,66.31 
03,007,01,026,0584,0,472,2,474,668,0,0,0,0,0,0,0,66.31 ,70.96 ,66.31 
03,007,01,026,0585,0,567,4,571,759,0,0,0,0,0,0,0,66.31 ,75.23 ,66.31 
03,007,01,026,0586,0,505,7,512,732,0,0,0,0,0,0,0,66.31 ,69.95 ,66.31 
03,008,01,001,0001,0,589,2,591,949,0,0,0,0,0,0,0,66.31 ,62.28 ,66.31 
03,008,01,001,0002,0,891,6,897,1359,0,0,0,0,0,0,0,66.31 ,66.00 ,66.31 
03,008,01,001,0003,0,499,1,500,703,0,0,0,0,0,0,0,66.31 ,71.12 ,66.31 
03,008,01,001,0004,0,386,2,388,545,0,0,0,0,0,0,0,66.31 ,71.19 ,66.31 
03,008,01,001,0005,0,535,4,539,737,0,0,0,0,0,0,0,66.31 ,73.13 ,66.31 
03,008,01,001,0006,0,295,1,296,432,0,0,0,0,0,0,0,66.31 ,68.52 ,66.31 
03,008,01,001,0007,0,696,5,701,1022,0,0,0,0,0,0,0,66.31 ,68.59 ,66.31 
03,008,01,001,0008,0,2361,17,2378,3826,0,0,0,0,0,0,0,66.31 ,62.15 ,66.31 
03,008,01,001,0009,0,1871,13,1884,2767,0,0,0,0,0,0,0,66.31 ,68.09 ,66.31 
03,008,01,001,0010,0,1136,9,1145,1616,0,0,0,0,0,0,0,66.31 ,70.85 ,66.31 
03,008,01,001,0011,0,1783,23,1806,2484,0,0,0,0,0,0,0,66.31 ,72.71 ,66.31 
03,008,01,001,0012,0,3308,25,3333,5024,0,0,0,0,0,0,0,66.31 ,66.34 ,66.31 
03,008,01,001,0013,0,1340,7,1347,1939,0,0,0,0,0,0,0,66.31 ,69.47 ,66.31 
03,008,01,001,0014,0,561,7,568,799,0,0,0,0,0,0,0,66.31 ,71.09 ,66.31 
03,008,01,001,0015,0,2395,37,2432,3594,0,0,0,0,0,0,0,66.31 ,67.67 ,66.31 
03,008,01,001,0016,0,298,1,299,464,0,0,0,0,0,0,0,66.31 ,64.44 ,66.31 
03,008,01,001,0017,0,1302,12,1314,1851,0,0,0,0,0,0,0,66.31 ,70.99 ,66.31 
03,008,01,001,0018,0,2889,30,2919,4292,0,0,0,0,0,0,0,66.31 ,68.01 ,66.31 
03,008,01,001,0019,0,2972,36,3008,4338,0,0,0,0,0,0,0,66.31 ,69.34 ,66.31 
03,008,01,001,0020,0,1001,10,1011,1250,0,0,0,0,0,0,0,66.31 ,80.88 ,66.31 
03,008,01,001,0021,0,391,3,394,576,0,0,0,0,0,0,0,66.31 ,68.40 ,66.31 
03,008,01,001,0022,0,1218,16,1234,1924,0,0,0,0,0,0,0,66.31 ,64.14 ,66.31 
03,008,01,001,0023,0,1415,21,1436,2099,0,0,0,0,0,0,0,66.31 ,68.41 ,66.31 
03,008,01,001,0024,0,1117,12,1129,1632,0,0,0,0,0,0,0,66.31 ,69.18 ,66.31 
03,008,01,001,0025,0,1460,13,1473,2217,0,0,0,0,0,0,0,66.31 ,66.44 ,66.31 
03,008,01,001,0026,0,3498,22,3520,5233,0,0,0,0,0,0,0,66.31 ,67.27 ,66.31 
03,008,01,001,0027,0,2487,32,2519,3541,0,0,0,0,0,0,0,66.31 ,71.14 ,66.31 
03,008,01,001,0028,0,2071,17,2088,2966,0,0,0,0,0,0,0,66.31 ,70.40 ,66.31 
03,008,01,001,0029,0,1346,20,1366,2186,0,0,0,0,0,0,0,66.31 ,62.49 ,66.31 
03,008,01,001,0030,0,1685,18,1703,2403,0,0,0,0,0,0,0,66.31 ,70.87 ,66.31 
03,008,01,001,0031,0,819,8,827,1236,0,0,0,0,0,0,0,66.31 ,66.91 ,66.31 
03,008,01,001,0032,0,565,5,570,738,0,0,0,0,0,0,0,66.31 ,77.24 ,66.31 
03,008,01,001,0033,0,567,1,568,769,0,0,0,0,0,0,0,66.31 ,73.86 ,66.31 
03,008,01,001,0034,0,1222,10,1232,1620,0,0,0,0,0,0,0,66.31 ,76.05 ,66.31 
03,008,01,002,0035,0,1920,22,1942,2977,0,0,0,0,0,0,0,66.31 ,65.23 ,66.31 
03,008,01,002,0036,0,1882,12,1894,3115,0,0,0,0,0,0,0,66.31 ,60.80 ,66.31 
03,008,01,002,0037,0,652,5,657,1021,0,0,0,0,0,0,0,66.31 ,64.35 ,66.31 
03,008,01,002,0038,0,1454,14,1468,2324,0,0,0,0,0,0,0,66.31 ,63.17 ,66.31 
03,008,01,002,0039,0,1890,17,1907,2994,0,0,0,0,0,0,0,66.31 ,63.69 ,66.31 
03,008,01,002,0040,0,1238,16,1254,1888,0,0,0,0,0,0,0,66.31 ,66.42 ,66.31 
03,008,01,002,0041,0,1264,6,1270,2076,0,0,0,0,0,0,0,66.31 ,61.18 ,66.31 
03,008,01,002,0042,0,1444,26,1470,2147,0,0,0,0,0,0,0,66.31 ,68.47 ,66.31 
03,008,01,002,0043,0,2103,16,2119,3442,0,0,0,0,0,0,0,66.31 ,61.56 ,66.31 
03,008,01,002,0044,0,903,9,912,1313,0,0,0,0,0,0,0,66.31 ,69.46 ,66.31 
03,008,01,002,0045,0,3245,34,3279,5275,0,0,0,0,0,0,0,66.31 ,62.16 ,66.31 
03,008,01,002,0046,0,545,3,548,753,0,0,0,0,0,0,0,66.31 ,72.78 ,66.31 
03,008,01,002,0047,0,1435,9,1444,2194,0,0,0,0,0,0,0,66.31 ,65.82 ,66.31 
03,008,01,002,0048,0,3179,54,3233,5054,0,0,0,0,0,0,0,66.31 ,63.97 ,66.31 
03,008,01,002,0049,0,1643,25,1668,2697,0,0,0,0,0,0,0,66.31 ,61.85 ,66.31 
03,008,01,002,0050,0,621,6,627,927,0,0,0,0,0,0,0,66.31 ,67.64 ,66.31 
03,008,01,002,0051,0,639,11,650,920,0,0,0,0,0,0,0,66.31 ,70.65 ,66.31 
03,008,01,002,0052,0,451,9,460,698,0,0,0,0,0,0,0,66.31 ,65.90 ,66.31 
03,008,01,002,0053,0,577,6,583,932,0,0,0,0,0,0,0,66.31 ,62.55 ,66.31 
03,008,01,002,0054,0,201,2,203,358,0,0,0,0,0,0,0,66.31 ,56.70 ,66.31 
03,008,01,002,0055,0,782,7,789,1297,0,0,0,0,0,0,0,66.31 ,60.83 ,66.31 
03,008,01,002,0056,0,790,9,799,1259,0,0,0,0,0,0,0,66.31 ,63.46 ,66.31 
03,008,01,002,0057,0,921,5,926,1466,0,0,0,0,0,0,0,66.31 ,63.17 ,66.31 
03,008,01,002,0058,0,742,13,755,1180,0,0,0,0,0,0,0,66.31 ,63.98 ,66.31 
03,008,01,002,0059,0,468,6,474,667,0,0,0,0,0,0,0,66.31 ,71.06 ,66.31 
03,008,01,002,0060,0,662,9,671,998,0,0,0,0,0,0,0,66.31 ,67.23 ,66.31 
03,008,01,002,0061,0,991,1,992,1495,0,0,0,0,0,0,0,66.31 ,66.35 ,66.31 
03,008,01,002,0062,0,676,6,682,1090,0,0,0,0,0,0,0,66.31 ,62.57 ,66.31 
03,008,01,002,0063,0,400,2,402,620,0,0,0,0,0,0,0,66.31 ,64.84 ,66.31 
03,008,01,002,0064,0,610,6,616,945,0,0,0,0,0,0,0,66.31 ,65.19 ,66.31 
03,008,01,002,0065,0,1573,21,1594,2357,0,0,0,0,0,0,0,66.31 ,67.63 ,66.31 
03,008,01,002,0066,0,756,7,763,1116,0,0,0,0,0,0,0,66.31 ,68.37 ,66.31 
03,008,01,002,0067,0,1545,11,1556,2411,0,0,0,0,0,0,0,66.31 ,64.54 ,66.31 
03,008,01,003,0068,0,1226,23,1249,1791,0,0,0,0,0,0,0,66.31 ,69.74 ,66.31 
03,008,01,003,0069,0,1939,22,1961,3063,0,0,0,0,0,0,0,66.31 ,64.02 ,66.31 
03,008,01,003,0070,0,1323,16,1339,1989,0,0,0,0,0,0,0,66.31 ,67.32 ,66.31 
03,008,01,003,0071,0,545,3,548,721,0,0,0,0,0,0,0,66.31 ,76.01 ,66.31 
03,008,01,003,0072,0,957,7,964,1372,0,0,0,0,0,0,0,66.31 ,70.26 ,66.31 
03,008,01,003,0073,0,1482,21,1503,2227,0,0,0,0,0,0,0,66.31 ,67.49 ,66.31 
03,008,01,003,0074,0,3069,36,3105,4848,0,0,0,0,0,0,0,66.31 ,64.05 ,66.31 
03,008,01,003,0075,0,3617,45,3662,5326,0,0,0,0,0,0,0,66.31 ,68.76 ,66.31 
03,008,01,003,0076,0,1786,24,1810,2685,0,0,0,0,0,0,0,66.31 ,67.41 ,66.31 
03,008,01,003,0077,0,1567,25,1592,2163,0,0,0,0,0,0,0,66.31 ,73.60 ,66.31 
03,008,01,003,0078,0,1865,28,1893,2923,0,0,0,0,0,0,0,66.31 ,64.76 ,66.31 
03,008,01,003,0079,0,1064,9,1073,1496,0,0,0,0,0,0,0,66.31 ,71.72 ,66.31 
03,008,01,003,0080,0,1811,19,1830,2651,0,0,0,0,0,0,0,66.31 ,69.03 ,66.31 
03,008,01,003,0081,0,2990,32,3022,4623,0,0,0,0,0,0,0,66.31 ,65.37 ,66.31 
03,008,01,003,0082,0,2064,21,2085,3160,0,0,0,0,0,0,0,66.31 ,65.98 ,66.31 
03,008,01,003,0083,0,1816,25,1841,2598,0,0,0,0,0,0,0,66.31 ,70.86 ,66.31 
03,008,01,003,0084,0,1252,11,1263,1769,0,0,0,0,0,0,0,66.31 ,71.40 ,66.31 
03,008,01,003,0085,0,798,7,805,1096,0,0,0,0,0,0,0,66.31 ,73.45 ,66.31 
03,008,01,003,0086,0,1510,11,1521,2145,0,0,0,0,0,0,0,66.31 ,70.91 ,66.31 
03,008,01,003,0087,0,2686,33,2719,4063,0,0,0,0,0,0,0,66.31 ,66.92 ,66.31 
03,008,01,003,0088,0,1236,8,1244,1791,0,0,0,0,0,0,0,66.31 ,69.46 ,66.31 
03,008,01,003,0089,0,1212,12,1224,1717,0,0,0,0,0,0,0,66.31 ,71.29 ,66.31 
03,008,01,003,0090,0,1972,28,2000,2921,0,0,0,0,0,0,0,66.31 ,68.47 ,66.31 
03,008,01,003,0091,0,658,6,664,937,0,0,0,0,0,0,0,66.31 ,70.86 ,66.31 
03,008,01,003,0092,0,1025,13,1038,1568,0,0,0,0,0,0,0,66.31 ,66.20 ,66.31 
03,008,01,003,0093,0,739,6,745,966,0,0,0,0,0,0,0,66.31 ,77.12 ,66.31 
03,008,01,003,0094,0,1517,14,1531,2292,0,0,0,0,0,0,0,66.31 ,66.80 ,66.31 
03,008,01,004,0095,0,1566,15,1581,2240,0,0,0,0,0,0,0,66.31 ,70.58 ,66.31 
03,008,01,004,0096,0,554,8,562,749,0,0,0,0,0,0,0,66.31 ,75.03 ,66.31 
03,008,01,004,0097,0,2956,32,2988,4331,0,0,0,0,0,0,0,66.31 ,68.99 ,66.31 
03,008,01,004,0098,0,2119,21,2140,3133,0,0,0,0,0,0,0,66.31 ,68.31 ,66.31 
03,008,01,004,0099,0,1333,23,1356,1999,0,0,0,0,0,0,0,66.31 ,67.83 ,66.31 
03,008,01,004,0100,0,2208,20,2228,3273,0,0,0,0,0,0,0,66.31 ,68.07 ,66.31 
03,008,01,004,0101,0,670,9,679,971,0,0,0,0,0,0,0,66.31 ,69.93 ,66.31 
03,008,01,004,0102,0,647,6,653,956,0,0,0,0,0,0,0,66.31 ,68.31 ,66.31 
03,008,01,004,0103,0,848,3,851,1206,0,0,0,0,0,0,0,66.31 ,70.56 ,66.31 
03,008,01,004,0104,0,581,0,581,811,0,0,0,0,0,0,0,66.31 ,71.64 ,66.31 
03,008,01,004,0105,0,133,0,133,182,0,0,0,0,0,0,0,66.31 ,73.08 ,66.31 
03,008,01,004,0106,0,2545,30,2575,3889,0,0,0,0,0,0,0,66.31 ,66.21 ,66.31 
03,008,01,004,0107,0,1870,33,1903,3006,0,0,0,0,0,0,0,66.31 ,63.31 ,66.31 
03,008,01,004,0108,0,1122,12,1134,1611,0,0,0,0,0,0,0,66.31 ,70.39 ,66.31 
03,008,01,004,0109,0,1903,17,1920,2655,0,0,0,0,0,0,0,66.31 ,72.32 ,66.31 
03,008,01,004,0110,0,434,6,440,646,0,0,0,0,0,0,0,66.31 ,68.11 ,66.31 
03,008,01,004,0111,0,1274,16,1290,1924,0,0,0,0,0,0,0,66.31 ,67.05 ,66.31 
03,008,01,004,0112,0,623,2,625,869,0,0,0,0,0,0,0,66.31 ,71.92 ,66.31 
03,008,01,004,0113,0,1042,7,1049,1413,0,0,0,0,0,0,0,66.31 ,74.24 ,66.31 
03,008,01,004,0114,0,497,3,500,719,0,0,0,0,0,0,0,66.31 ,69.54 ,66.31 
03,008,01,004,0115,0,432,6,438,646,0,0,0,0,0,0,0,66.31 ,67.80 ,66.31 
03,008,01,004,0116,0,819,13,832,1239,0,0,0,0,0,0,0,66.31 ,67.15 ,66.31 
03,008,01,004,0117,0,642,6,648,903,0,0,0,0,0,0,0,66.31 ,71.76 ,66.31 
03,008,01,004,0118,0,428,2,430,577,0,0,0,0,0,0,0,66.31 ,74.52 ,66.31 
03,008,01,004,0119,0,640,7,647,943,0,0,0,0,0,0,0,66.31 ,68.61 ,66.31 
03,008,01,004,0120,0,428,3,431,616,0,0,0,0,0,0,0,66.31 ,69.97 ,66.31 
03,008,01,004,0121,0,540,10,550,771,0,0,0,0,0,0,0,66.31 ,71.34 ,66.31 
03,008,01,004,0122,0,725,13,738,1082,0,0,0,0,0,0,0,66.31 ,68.21 ,66.31 
03,008,01,005,0123,0,608,4,612,879,0,0,0,0,0,0,0,66.31 ,69.62 ,66.31 
03,008,01,005,0124,0,619,4,623,976,0,0,0,0,0,0,0,66.31 ,63.83 ,66.31 
03,008,01,005,0125,0,393,5,398,584,0,0,0,0,0,0,0,66.31 ,68.15 ,66.31 
03,008,01,005,0126,0,780,6,786,1091,0,0,0,0,0,0,0,66.31 ,72.04 ,66.31 
03,008,01,005,0127,0,392,0,392,542,0,0,0,0,0,0,0,66.31 ,72.32 ,66.31 
03,008,01,005,0128,0,290,2,292,440,0,0,0,0,0,0,0,66.31 ,66.36 ,66.31 
03,008,01,005,0129,0,659,5,664,917,0,0,0,0,0,0,0,66.31 ,72.41 ,66.31 
03,008,01,005,0130,0,861,11,872,1290,0,0,0,0,0,0,0,66.31 ,67.60 ,66.31 
03,008,01,005,0131,0,588,3,591,872,0,0,0,0,0,0,0,66.31 ,67.78 ,66.31 
03,008,01,005,0132,0,410,6,416,594,0,0,0,0,0,0,0,66.31 ,70.03 ,66.31 
03,008,01,005,0133,0,554,3,557,837,0,0,0,0,0,0,0,66.31 ,66.55 ,66.31 
03,008,01,006,0134,0,671,8,679,1001,0,0,0,0,0,0,0,66.31 ,67.83 ,66.31 
03,008,01,006,0135,0,1765,16,1781,2714,0,0,0,0,0,0,0,66.31 ,65.62 ,66.31 
03,008,01,006,0136,0,1323,12,1335,1857,0,0,0,0,0,0,0,66.31 ,71.89 ,66.31 
03,008,01,006,0137,0,1022,6,1028,1548,0,0,0,0,0,0,0,66.31 ,66.41 ,66.31 
03,008,01,006,0138,0,685,10,695,1015,0,0,0,0,0,0,0,66.31 ,68.47 ,66.31 
03,008,01,006,0139,0,710,4,714,979,0,0,0,0,0,0,0,66.31 ,72.93 ,66.31 
03,008,01,006,0140,0,2254,26,2280,3188,0,0,0,0,0,0,0,66.31 ,71.52 ,66.31 
03,008,01,006,0141,0,1167,12,1179,1593,0,0,0,0,0,0,0,66.31 ,74.01 ,66.31 
03,008,01,006,0142,0,590,7,597,801,0,0,0,0,0,0,0,66.31 ,74.53 ,66.31 
03,008,01,006,0143,0,799,14,813,1022,0,0,0,0,0,0,0,66.31 ,79.55 ,66.31 
03,008,01,006,0144,0,1328,12,1340,1855,0,0,0,0,0,0,0,66.31 ,72.24 ,66.31 
03,008,01,006,0145,0,1361,21,1382,1926,0,0,0,0,0,0,0,66.31 ,71.75 ,66.31 
03,008,01,006,0146,0,508,6,514,748,0,0,0,0,0,0,0,66.31 ,68.72 ,66.31 
03,008,01,006,0147,0,879,7,886,1256,0,0,0,0,0,0,0,66.31 ,70.54 ,66.31 
03,008,01,006,0148,0,623,9,632,880,0,0,0,0,0,0,0,66.31 ,71.82 ,66.31 
03,008,01,006,0149,0,988,23,1011,1428,0,0,0,0,0,0,0,66.31 ,70.80 ,66.31 
03,008,01,006,0150,0,863,10,873,1337,0,0,0,0,0,0,0,66.31 ,65.30 ,66.31 
03,008,01,006,0151,0,734,15,749,1027,0,0,0,0,0,0,0,66.31 ,72.93 ,66.31 
03,008,01,006,0152,0,554,5,559,769,0,0,0,0,0,0,0,66.31 ,72.69 ,66.31 
03,008,01,006,0153,0,587,7,594,845,0,0,0,0,0,0,0,66.31 ,70.30 ,66.31 
03,008,01,006,0154,0,572,6,578,811,0,0,0,0,0,0,0,66.31 ,71.27 ,66.31 
03,008,01,006,0155,0,1073,16,1089,1566,0,0,0,0,0,0,0,66.31 ,69.54 ,66.31 
03,008,01,007,0156,0,1000,13,1013,1497,0,0,0,0,0,0,0,66.31 ,67.67 ,66.31 
03,008,01,007,0157,0,1121,11,1132,1637,0,0,0,0,0,0,0,66.31 ,69.15 ,66.31 
03,008,01,007,0158,0,820,6,826,1118,0,0,0,0,0,0,0,66.31 ,73.88 ,66.31 
03,008,01,007,0159,0,1280,7,1287,1755,0,0,0,0,0,0,0,66.31 ,73.33 ,66.31 
03,008,01,007,0160,0,705,6,711,1054,0,0,0,0,0,0,0,66.31 ,67.46 ,66.31 
03,008,01,007,0161,0,438,3,441,636,0,0,0,0,0,0,0,66.31 ,69.34 ,66.31 
03,008,01,007,0162,0,1017,4,1021,1564,0,0,0,0,0,0,0,66.31 ,65.28 ,66.31 
03,008,01,007,0163,0,599,6,605,898,0,0,0,0,0,0,0,66.31 ,67.37 ,66.31 
03,008,01,007,0164,0,978,8,986,1306,0,0,0,0,0,0,0,66.31 ,75.50 ,66.31 
03,008,01,007,0165,0,876,5,881,1235,0,0,0,0,0,0,0,66.31 ,71.34 ,66.31 
03,008,01,007,0166,0,682,4,686,1141,0,0,0,0,0,0,0,66.31 ,60.12 ,66.31 
03,008,01,007,0167,0,443,7,450,753,0,0,0,0,0,0,0,66.31 ,59.76 ,66.31 
03,008,01,007,0168,0,440,4,444,804,0,0,0,0,0,0,0,66.31 ,55.22 ,66.31 
03,008,01,008,0169,0,573,5,578,880,0,0,0,0,0,0,0,66.31 ,65.68 ,66.31 
03,008,01,008,0170,0,375,4,379,512,0,0,0,0,0,0,0,66.31 ,74.02 ,66.31 
03,008,01,008,0171,0,547,4,551,782,0,0,0,0,0,0,0,66.31 ,70.46 ,66.31 
03,008,01,008,0172,0,523,5,528,870,0,0,0,0,0,0,0,66.31 ,60.69 ,66.31 
03,008,01,008,0173,0,444,4,448,712,0,0,0,0,0,0,0,66.31 ,62.92 ,66.31 
03,008,01,008,0174,0,188,1,189,294,0,0,0,0,0,0,0,66.31 ,64.29 ,66.31 
03,008,01,008,0175,0,1373,10,1383,1868,0,0,0,0,0,0,0,66.31 ,74.04 ,66.31 
03,008,01,008,0176,0,533,2,535,731,0,0,0,0,0,0,0,66.31 ,73.19 ,66.31 
03,008,01,008,0177,0,390,0,390,550,0,0,0,0,0,0,0,66.31 ,70.91 ,66.31 
03,008,01,008,0178,0,689,3,692,1012,0,0,0,0,0,0,0,66.31 ,68.38 ,66.31 
03,008,01,008,0179,0,836,8,844,1114,0,0,0,0,0,0,0,66.31 ,75.76 ,66.31 
03,008,01,008,0180,0,638,8,646,991,0,0,0,0,0,0,0,66.31 ,65.19 ,66.31 
03,008,01,008,0181,0,344,3,347,472,0,0,0,0,0,0,0,66.31 ,73.52 ,66.31 
03,008,01,008,0182,0,531,6,537,720,0,0,0,0,0,0,0,66.31 ,74.58 ,66.31 
03,008,01,008,0183,0,399,3,402,601,0,0,0,0,0,0,0,66.31 ,66.89 ,66.31 
03,008,01,008,0184,0,464,5,469,683,0,0,0,0,0,0,0,66.31 ,68.67 ,66.31 
03,008,01,008,0185,0,310,1,311,439,0,0,0,0,0,0,0,66.31 ,70.84 ,66.31 
03,008,01,008,0186,0,408,3,411,587,0,0,0,0,0,0,0,66.31 ,70.02 ,66.31 
03,008,01,009,0187,0,1038,8,1046,1812,0,0,0,0,0,0,0,66.31 ,57.73 ,66.31 
03,008,01,009,0188,0,889,10,899,1519,0,0,0,0,0,0,0,66.31 ,59.18 ,66.31 
03,008,01,009,0189,0,621,6,627,1023,0,0,0,0,0,0,0,66.31 ,61.29 ,66.31 
03,008,01,009,0190,0,677,10,687,1185,0,0,0,0,0,0,0,66.31 ,57.97 ,66.31 
03,008,01,009,0191,0,636,4,640,976,0,0,0,0,0,0,0,66.31 ,65.57 ,66.31 
03,008,01,009,0192,0,759,4,763,1228,0,0,0,0,0,0,0,66.31 ,62.13 ,66.31 
03,008,01,009,0193,0,388,1,389,606,0,0,0,0,0,0,0,66.31 ,64.19 ,66.31 
03,008,01,009,0194,0,472,2,474,723,0,0,0,0,0,0,0,66.31 ,65.56 ,66.31 
03,008,01,009,0195,0,597,7,604,978,0,0,0,0,0,0,0,66.31 ,61.76 ,66.31 
03,008,01,009,0196,0,450,5,455,745,0,0,0,0,0,0,0,66.31 ,61.07 ,66.31 
03,008,01,009,0197,0,332,0,332,534,0,0,0,0,0,0,0,66.31 ,62.17 ,66.31 
03,008,01,009,0198,0,533,3,536,997,0,0,0,0,0,0,0,66.31 ,53.76 ,66.31 
03,008,01,009,0199,0,430,2,432,798,0,0,0,0,0,0,0,66.31 ,54.14 ,66.31 
03,008,01,010,0200,0,1030,11,1041,1693,0,0,0,0,0,0,0,66.31 ,61.49 ,66.31 
03,008,01,010,0201,0,1002,5,1007,1635,0,0,0,0,0,0,0,66.31 ,61.59 ,66.31 
03,008,01,010,0202,0,518,8,526,793,0,0,0,0,0,0,0,66.31 ,66.33 ,66.31 
03,008,01,010,0203,0,938,17,955,1552,0,0,0,0,0,0,0,66.31 ,61.53 ,66.31 
03,008,01,010,0204,0,493,5,498,772,0,0,0,0,0,0,0,66.31 ,64.51 ,66.31 
03,008,01,010,0205,0,544,10,554,912,0,0,0,0,0,0,0,66.31 ,60.75 ,66.31 
03,008,01,010,0206,0,1237,13,1250,2113,0,0,0,0,0,0,0,66.31 ,59.16 ,66.31 
03,008,01,010,0207,0,1351,16,1367,1936,0,0,0,0,0,0,0,66.31 ,70.61 ,66.31 
03,008,01,010,0208,0,621,6,627,915,0,0,0,0,0,0,0,66.31 ,68.52 ,66.31 
03,008,01,010,0209,0,820,10,830,1206,0,0,0,0,0,0,0,66.31 ,68.82 ,66.31 
03,008,01,010,0210,0,505,3,508,784,0,0,0,0,0,0,0,66.31 ,64.80 ,66.31 
03,008,01,010,0211,0,1076,14,1090,1637,0,0,0,0,0,0,0,66.31 ,66.59 ,66.31 
03,008,01,010,0212,0,1157,31,1188,2032,0,0,0,0,0,0,0,66.31 ,58.46 ,66.31 
03,008,01,011,0213,0,550,5,555,916,0,0,0,0,0,0,0,66.31 ,60.59 ,66.31 
03,008,01,011,0214,0,1063,8,1071,1693,0,0,0,0,0,0,0,66.31 ,63.26 ,66.31 
03,008,01,011,0215,0,505,6,511,718,0,0,0,0,0,0,0,66.31 ,71.17 ,66.31 
03,008,01,011,0216,0,674,8,682,1049,0,0,0,0,0,0,0,66.31 ,65.01 ,66.31 
03,008,01,011,0217,0,356,2,358,531,0,0,0,0,0,0,0,66.31 ,67.42 ,66.31 
03,008,01,011,0218,0,683,5,688,1075,0,0,0,0,0,0,0,66.31 ,64.00 ,66.31 
03,008,01,011,0219,0,772,7,779,1224,0,0,0,0,0,0,0,66.31 ,63.64 ,66.31 
03,008,01,011,0220,0,727,5,732,1070,0,0,0,0,0,0,0,66.31 ,68.41 ,66.31 
03,008,01,011,0221,0,963,8,971,1329,0,0,0,0,0,0,0,66.31 ,73.06 ,66.31 
03,008,01,011,0222,0,656,8,664,1056,0,0,0,0,0,0,0,66.31 ,62.88 ,66.31 
03,008,01,011,0223,0,721,7,728,1111,0,0,0,0,0,0,0,66.31 ,65.53 ,66.31 
03,008,01,011,0224,0,271,3,274,407,0,0,0,0,0,0,0,66.31 ,67.32 ,66.31 
03,008,01,011,0225,0,266,3,269,397,0,0,0,0,0,0,0,66.31 ,67.76 ,66.31 
03,008,01,011,0226,0,811,6,817,1231,0,0,0,0,0,0,0,66.31 ,66.37 ,66.31 
03,008,01,011,0227,0,213,5,218,351,0,0,0,0,0,0,0,66.31 ,62.11 ,66.31 
03,008,01,011,0228,0,264,0,264,398,0,0,0,0,0,0,0,66.31 ,66.33 ,66.31 
03,008,01,011,0229,0,669,3,672,916,0,0,0,0,0,0,0,66.31 ,73.36 ,66.31 
03,008,01,011,0230,0,378,9,387,584,0,0,0,0,0,0,0,66.31 ,66.27 ,66.31 
03,008,01,011,0231,0,438,4,442,698,0,0,0,0,0,0,0,66.31 ,63.32 ,66.31 
03,008,01,012,0232,0,738,8,746,1082,0,0,0,0,0,0,0,66.31 ,68.95 ,66.31 
03,008,01,012,0233,0,378,2,380,548,0,0,0,0,0,0,0,66.31 ,69.34 ,66.31 
03,008,01,012,0234,0,519,7,526,740,0,0,0,0,0,0,0,66.31 ,71.08 ,66.31 
03,008,01,012,0235,0,235,4,239,335,0,0,0,0,0,0,0,66.31 ,71.34 ,66.31 
03,008,01,012,0236,0,49,1,50,77,0,0,0,0,0,0,0,66.31 ,64.94 ,66.31 
03,008,01,012,0237,0,137,0,137,220,0,0,0,0,0,0,0,66.31 ,62.27 ,66.31 
03,008,01,012,0238,0,171,1,172,294,0,0,0,0,0,0,0,66.31 ,58.50 ,66.31 
03,008,01,012,0239,0,152,5,157,247,0,0,0,0,0,0,0,66.31 ,63.56 ,66.31 
03,008,01,012,0240,0,458,5,463,741,0,0,0,0,0,0,0,66.31 ,62.48 ,66.31 
03,008,01,012,0241,0,838,3,841,1324,0,0,0,0,0,0,0,66.31 ,63.52 ,66.31 
03,008,01,012,0242,0,116,3,119,242,0,0,0,0,0,0,0,66.31 ,49.17 ,66.31 
03,008,01,012,0243,0,10,0,10,16,0,0,0,0,0,0,0,66.31 ,62.50 ,66.31 
03,008,01,012,0244,0,56,0,56,104,0,0,0,0,0,0,0,66.31 ,53.85 ,66.31 
03,008,01,012,0245,0,18,0,18,40,0,0,0,0,0,0,0,66.31 ,45.00 ,66.31 
03,008,01,013,0246,0,285,2,287,534,0,0,0,0,0,0,0,66.31 ,53.75 ,66.31 
03,008,01,013,0247,0,656,8,664,1078,0,0,0,0,0,0,0,66.31 ,61.60 ,66.31 
03,008,01,013,0248,0,58,0,58,86,0,0,0,0,0,0,0,66.31 ,67.44 ,66.31 
03,008,01,013,0249,0,29,0,29,58,0,0,0,0,0,0,0,66.31 ,50.00 ,66.31 
03,008,01,013,0250,0,72,2,74,143,0,0,0,0,0,0,0,66.31 ,51.75 ,66.31 
03,008,01,013,0251,0,17,0,17,27,0,0,0,0,0,0,0,66.31 ,62.96 ,66.31 
03,008,01,013,0252,0,146,4,150,257,0,0,0,0,0,0,0,66.31 ,58.37 ,66.31 
03,008,01,013,0253,0,30,1,31,73,0,0,0,0,0,0,0,66.31 ,42.47 ,66.31 
03,008,01,013,0254,0,41,2,43,81,0,0,0,0,0,0,0,66.31 ,53.09 ,66.31 
03,008,01,013,0255,0,34,1,35,64,0,0,0,0,0,0,0,66.31 ,54.69 ,66.31 
03,008,01,013,0256,0,15,0,15,43,0,0,0,0,0,0,0,66.31 ,34.88 ,66.31 
03,008,01,013,0257,0,40,1,41,85,0,0,0,0,0,0,0,66.31 ,48.24 ,66.31 
03,008,01,013,0258,0,43,1,44,112,0,0,0,0,0,0,0,66.31 ,39.29 ,66.31 
03,008,01,013,0259,0,27,0,27,57,0,0,0,0,0,0,0,66.31 ,47.37 ,66.31 
03,009,01,001,0001,0,658,8,666,977,0,0,0,0,0,0,0,66.31 ,68.17 ,66.31 
03,009,01,001,0002,0,487,8,495,682,0,0,0,0,0,0,0,66.31 ,72.58 ,66.31 
03,009,01,001,0003,0,539,12,551,739,0,0,0,0,0,0,0,66.31 ,74.56 ,66.31 
03,009,01,001,0004,0,443,10,453,622,0,0,0,0,0,0,0,66.31 ,72.83 ,66.31 
03,009,01,001,0005,0,626,11,637,924,0,0,0,0,0,0,0,66.31 ,68.94 ,66.31 
03,009,01,001,0006,0,1653,38,1691,2448,0,0,0,0,0,0,0,66.31 ,69.08 ,66.31 
03,009,01,001,0007,0,2213,42,2255,3212,0,0,0,0,0,0,0,66.31 ,70.21 ,66.31 
03,009,01,001,0008,0,2141,28,2169,3019,0,0,0,0,0,0,0,66.31 ,71.84 ,66.31 
03,009,01,001,0009,0,3602,71,3673,5443,0,0,0,0,0,0,0,66.31 ,67.48 ,66.31 
03,009,01,001,0010,0,1064,21,1085,1527,0,0,0,0,0,0,0,66.31 ,71.05 ,66.31 
03,009,01,001,0011,0,803,15,818,1142,0,0,0,0,0,0,0,66.31 ,71.63 ,66.31 
03,009,01,001,0012,0,1625,33,1658,2326,0,0,0,0,0,0,0,66.31 ,71.28 ,66.31 
03,009,01,001,0013,0,1429,35,1464,2106,0,0,0,0,0,0,0,66.31 ,69.52 ,66.31 
03,009,01,001,0014,0,1345,25,1370,1905,0,0,0,0,0,0,0,66.31 ,71.92 ,66.31 
03,009,01,001,0015,0,3410,59,3469,5044,0,0,0,0,0,0,0,66.31 ,68.77 ,66.31 
03,009,01,001,0016,0,1888,28,1916,2974,0,0,0,0,0,0,0,66.31 ,64.43 ,66.31 
03,009,01,001,0017,0,1444,30,1474,2084,0,0,0,0,0,0,0,66.31 ,70.73 ,66.31 
03,009,01,001,0018,0,680,12,692,946,0,0,0,0,0,0,0,66.31 ,73.15 ,66.31 
03,009,01,001,0019,0,478,4,482,636,0,0,0,0,0,0,0,66.31 ,75.79 ,66.31 
03,009,01,001,0020,0,1148,21,1169,1586,0,0,0,0,0,0,0,66.31 ,73.71 ,66.31 
03,009,01,001,0021,0,390,5,395,527,0,0,0,0,0,0,0,66.31 ,74.95 ,66.31 
03,009,01,001,0022,0,771,14,785,1083,0,0,0,0,0,0,0,66.31 ,72.48 ,66.31 
03,009,01,001,0023,0,441,6,447,608,0,0,0,0,0,0,0,66.31 ,73.52 ,66.31 
03,009,01,001,0024,0,1243,28,1271,1712,0,0,0,0,0,0,0,66.31 ,74.24 ,66.31 
03,009,01,001,0025,0,2702,50,2752,3899,0,0,0,0,0,0,0,66.31 ,70.58 ,66.31 
03,009,01,001,0026,0,1963,32,1995,2713,0,0,0,0,0,0,0,66.31 ,73.53 ,66.31 
03,009,01,001,0027,0,1044,17,1061,1458,0,0,0,0,0,0,0,66.31 ,72.77 ,66.31 
03,009,01,001,0028,0,2537,51,2588,3434,0,0,0,0,0,0,0,66.31 ,75.36 ,66.31 
03,009,01,001,0029,0,631,8,639,838,0,0,0,0,0,0,0,66.31 ,76.25 ,66.31 
03,009,01,001,0030,0,561,8,569,738,0,0,0,0,0,0,0,66.31 ,77.10 ,66.31 
03,009,01,001,0031,0,1291,33,1324,1720,0,0,0,0,0,0,0,66.31 ,76.98 ,66.31 
03,009,01,001,0032,0,919,18,937,1272,0,0,0,0,0,0,0,66.31 ,73.66 ,66.31 
03,009,01,001,0033,0,1592,27,1619,2250,0,0,0,0,0,0,0,66.31 ,71.96 ,66.31 
03,009,01,001,0034,0,1494,30,1524,2178,0,0,0,0,0,0,0,66.31 ,69.97 ,66.31 
03,009,01,001,0035,0,823,9,832,1092,0,0,0,0,0,0,0,66.31 ,76.19 ,66.31 
03,009,01,002,0036,0,813,18,831,1114,0,0,0,0,0,0,0,66.31 ,74.60 ,66.31 
03,009,01,002,0037,0,2681,45,2726,3792,0,0,0,0,0,0,0,66.31 ,71.89 ,66.31 
03,009,01,002,0038,0,1281,16,1297,1892,0,0,0,0,0,0,0,66.31 ,68.55 ,66.31 
03,009,01,002,0039,0,960,11,971,1225,0,0,0,0,0,0,0,66.31 ,79.27 ,66.31 
03,009,01,002,0040,0,934,13,947,1280,0,0,0,0,0,0,0,66.31 ,73.98 ,66.31 
03,009,01,002,0041,0,823,14,837,1136,0,0,0,0,0,0,0,66.31 ,73.68 ,66.31 
03,009,01,002,0042,0,637,6,643,857,0,0,0,0,0,0,0,66.31 ,75.03 ,66.31 
03,009,01,002,0043,0,611,9,620,892,0,0,0,0,0,0,0,66.31 ,69.51 ,66.31 
03,009,01,002,0044,0,673,5,678,893,0,0,0,0,0,0,0,66.31 ,75.92 ,66.31 
03,009,01,002,0045,0,507,9,516,729,0,0,0,0,0,0,0,66.31 ,70.78 ,66.31 
03,009,01,002,0046,0,927,7,934,1164,0,0,0,0,0,0,0,66.31 ,80.24 ,66.31 
03,009,01,002,0047,0,1030,15,1045,1350,0,0,0,0,0,0,0,66.31 ,77.41 ,66.31 
03,009,01,002,0048,0,1153,21,1174,1557,0,0,0,0,0,0,0,66.31 ,75.40 ,66.31 
03,009,01,002,0049,0,2934,32,2966,4035,0,0,0,0,0,0,0,66.31 ,73.51 ,66.31 
03,009,01,002,0050,0,787,11,798,1020,0,0,0,0,0,0,0,66.31 ,78.24 ,66.31 
03,009,01,002,0051,0,652,10,662,859,0,0,0,0,0,0,0,66.31 ,77.07 ,66.31 
03,009,01,002,0052,0,701,5,706,937,0,0,0,0,0,0,0,66.31 ,75.35 ,66.31 
03,009,01,002,0053,0,1166,13,1179,1576,0,0,0,0,0,0,0,66.31 ,74.81 ,66.31 
03,009,01,002,0054,0,695,12,707,968,0,0,0,0,0,0,0,66.31 ,73.04 ,66.31 
03,009,01,002,0055,0,1572,15,1587,2223,0,0,0,0,0,0,0,66.31 ,71.39 ,66.31 
03,009,01,002,0056,0,1514,26,1540,2017,0,0,0,0,0,0,0,66.31 ,76.35 ,66.31 
03,009,01,002,0057,0,1107,13,1120,1529,0,0,0,0,0,0,0,66.31 ,73.25 ,66.31 
03,009,01,003,0058,0,1558,28,1586,2256,0,0,0,0,0,0,0,66.31 ,70.30 ,66.31 
03,009,01,003,0059,0,1141,15,1156,1662,0,0,0,0,0,0,0,66.31 ,69.55 ,66.31 
03,009,01,003,0060,0,1705,26,1731,2594,0,0,0,0,0,0,0,66.31 ,66.73 ,66.31 
03,009,01,003,0061,0,1469,31,1500,2363,0,0,0,0,0,0,0,66.31 ,63.48 ,66.31 
03,009,01,003,0062,0,799,12,811,1145,0,0,0,0,0,0,0,66.31 ,70.83 ,66.31 
03,009,01,003,0063,0,1781,27,1808,2806,0,0,0,0,0,0,0,66.31 ,64.43 ,66.31 
03,009,01,003,0064,0,2027,35,2062,3076,0,0,0,0,0,0,0,66.31 ,67.04 ,66.31 
03,009,01,003,0065,0,907,11,918,1263,0,0,0,0,0,0,0,66.31 ,72.68 ,66.31 
03,009,01,003,0066,0,726,15,741,1047,0,0,0,0,0,0,0,66.31 ,70.77 ,66.31 
03,009,01,003,0067,0,970,16,986,1476,0,0,0,0,0,0,0,66.31 ,66.80 ,66.31 
03,009,01,003,0068,0,1113,20,1133,1691,0,0,0,0,0,0,0,66.31 ,67.00 ,66.31 
03,009,01,003,0069,0,1107,17,1124,1574,0,0,0,0,0,0,0,66.31 ,71.41 ,66.31 
03,009,01,003,0070,0,629,11,640,849,0,0,0,0,0,0,0,66.31 ,75.38 ,66.31 
03,009,01,003,0071,0,470,9,479,716,0,0,0,0,0,0,0,66.31 ,66.90 ,66.31 
03,009,01,003,0072,0,1551,35,1586,2174,0,0,0,0,0,0,0,66.31 ,72.95 ,66.31 
03,009,01,003,0073,0,568,9,577,741,0,0,0,0,0,0,0,66.31 ,77.87 ,66.31 
03,009,01,003,0074,0,1081,29,1110,1542,0,0,0,0,0,0,0,66.31 ,71.98 ,66.31 
03,009,01,003,0075,0,1071,16,1087,1474,0,0,0,0,0,0,0,66.31 ,73.74 ,66.31 
03,009,01,003,0076,0,1869,84,1953,2722,0,0,0,0,0,0,0,66.31 ,71.75 ,66.31 
03,009,01,003,0077,0,1492,35,1527,2144,0,0,0,0,0,0,0,66.31 ,71.22 ,66.31 
03,009,01,003,0078,0,1531,25,1556,2218,0,0,0,0,0,0,0,66.31 ,70.15 ,66.31 
03,009,01,003,0079,0,833,23,856,1153,0,0,0,0,0,0,0,66.31 ,74.24 ,66.31 
03,009,01,003,0080,0,918,17,935,1262,0,0,0,0,0,0,0,66.31 ,74.09 ,66.31 
03,009,01,003,0081,0,795,21,816,1088,0,0,0,0,0,0,0,66.31 ,75.00 ,66.31 
03,009,01,003,0082,0,1037,11,1048,1433,0,0,0,0,0,0,0,66.31 ,73.13 ,66.31 
03,009,01,003,0083,0,523,13,536,848,0,0,0,0,0,0,0,66.31 ,63.21 ,66.31 
03,009,01,003,0084,0,605,14,619,951,0,0,0,0,0,0,0,66.31 ,65.09 ,66.31 
03,009,01,003,0085,0,545,9,554,737,0,0,0,0,0,0,0,66.31 ,75.17 ,66.31 
03,009,01,003,0086,0,682,6,688,964,0,0,0,0,0,0,0,66.31 ,71.37 ,66.31 
03,009,01,004,0087,0,1025,9,1034,1502,0,0,0,0,0,0,0,66.31 ,68.84 ,66.31 
03,009,01,004,0088,0,930,18,948,1332,0,0,0,0,0,0,0,66.31 ,71.17 ,66.31 
03,009,01,004,0089,0,1083,18,1101,1561,0,0,0,0,0,0,0,66.31 ,70.53 ,66.31 
03,009,01,004,0090,0,1836,20,1856,2755,0,0,0,0,0,0,0,66.31 ,67.37 ,66.31 
03,009,01,004,0091,0,337,5,342,469,0,0,0,0,0,0,0,66.31 ,72.92 ,66.31 
03,009,01,004,0092,0,531,11,542,761,0,0,0,0,0,0,0,66.31 ,71.22 ,66.31 
03,009,01,004,0093,0,440,8,448,705,0,0,0,0,0,0,0,66.31 ,63.55 ,66.31 
03,009,01,004,0094,0,684,7,691,1019,0,0,0,0,0,0,0,66.31 ,67.81 ,66.31 
03,009,01,004,0095,0,1378,19,1397,2052,0,0,0,0,0,0,0,66.31 ,68.08 ,66.31 
03,009,01,004,0096,0,2018,26,2044,3145,0,0,0,0,0,0,0,66.31 ,64.99 ,66.31 
03,009,01,004,0097,0,803,4,807,1231,0,0,0,0,0,0,0,66.31 ,65.56 ,66.31 
03,009,01,004,0098,0,901,14,915,1347,0,0,0,0,0,0,0,66.31 ,67.93 ,66.31 
03,009,01,004,0099,0,1149,13,1162,1737,0,0,0,0,0,0,0,66.31 ,66.90 ,66.31 
03,009,01,004,0100,0,603,10,613,891,0,0,0,0,0,0,0,66.31 ,68.80 ,66.31 
03,009,01,004,0101,0,730,9,739,1136,0,0,0,0,0,0,0,66.31 ,65.05 ,66.31 
03,009,01,004,0102,0,974,16,990,1459,0,0,0,0,0,0,0,66.31 ,67.85 ,66.31 
03,009,01,004,0103,0,596,8,604,863,0,0,0,0,0,0,0,66.31 ,69.99 ,66.31 
03,009,01,004,0104,0,724,7,731,1000,0,0,0,0,0,0,0,66.31 ,73.10 ,66.31 
03,009,01,004,0105,0,884,11,895,1351,0,0,0,0,0,0,0,66.31 ,66.25 ,66.31 
03,009,01,004,0106,0,505,12,517,734,0,0,0,0,0,0,0,66.31 ,70.44 ,66.31 
03,009,01,004,0107,0,592,9,601,802,0,0,0,0,0,0,0,66.31 ,74.94 ,66.31 
03,009,01,004,0108,0,681,11,692,1005,0,0,0,0,0,0,0,66.31 ,68.86 ,66.31 
03,009,01,004,0109,0,925,11,936,1351,0,0,0,0,0,0,0,66.31 ,69.28 ,66.31 
03,009,01,004,0110,0,616,10,626,935,0,0,0,0,0,0,0,66.31 ,66.95 ,66.31 
03,009,01,004,0111,0,592,3,595,949,0,0,0,0,0,0,0,66.31 ,62.70 ,66.31 
03,009,01,004,0112,0,1052,16,1068,1761,0,0,0,0,0,0,0,66.31 ,60.65 ,66.31 
03,009,01,004,0113,0,905,10,915,1354,0,0,0,0,0,0,0,66.31 ,67.58 ,66.31 
03,009,01,005,0114,0,628,16,644,913,0,0,0,0,0,0,0,66.31 ,70.54 ,66.31 
03,009,01,005,0115,0,737,15,752,1025,0,0,0,0,0,0,0,66.31 ,73.37 ,66.31 
03,009,01,005,0116,0,898,16,914,1310,0,0,0,0,0,0,0,66.31 ,69.77 ,66.31 
03,009,01,005,0117,0,602,10,612,817,0,0,0,0,0,0,0,66.31 ,74.91 ,66.31 
03,009,01,005,0118,0,802,6,808,1118,0,0,0,0,0,0,0,66.31 ,72.27 ,66.31 
03,009,01,005,0119,0,982,19,1001,1431,0,0,0,0,0,0,0,66.31 ,69.95 ,66.31 
03,009,01,005,0120,0,760,7,767,1204,0,0,0,0,0,0,0,66.31 ,63.70 ,66.31 
03,009,01,005,0121,0,888,11,899,1453,0,0,0,0,0,0,0,66.31 ,61.87 ,66.31 
03,009,01,005,0122,0,975,20,995,1482,0,0,0,0,0,0,0,66.31 ,67.14 ,66.31 
03,009,01,005,0123,0,1515,13,1528,2250,0,0,0,0,0,0,0,66.31 ,67.91 ,66.31 
03,009,01,005,0124,0,967,8,975,1455,0,0,0,0,0,0,0,66.31 ,67.01 ,66.31 
03,009,01,005,0125,0,564,7,571,821,0,0,0,0,0,0,0,66.31 ,69.55 ,66.31 
03,009,01,005,0126,0,1130,10,1140,1782,0,0,0,0,0,0,0,66.31 ,63.97 ,66.31 
03,009,01,005,0127,0,1221,15,1236,1724,0,0,0,0,0,0,0,66.31 ,71.69 ,66.31 
03,009,01,005,0128,0,1192,13,1205,1807,0,0,0,0,0,0,0,66.31 ,66.69 ,66.31 
03,009,01,005,0129,0,641,5,646,972,0,0,0,0,0,0,0,66.31 ,66.46 ,66.31 
03,009,01,005,0130,0,952,11,963,1435,0,0,0,0,0,0,0,66.31 ,67.11 ,66.31 
03,009,01,006,0131,0,630,24,654,857,0,0,0,0,0,0,0,66.31 ,76.31 ,66.31 
03,009,01,006,0132,0,598,9,607,811,0,0,0,0,0,0,0,66.31 ,74.85 ,66.31 
03,009,01,006,0133,0,385,3,388,524,0,0,0,0,0,0,0,66.31 ,74.05 ,66.31 
03,009,01,006,0134,0,731,19,750,1032,0,0,0,0,0,0,0,66.31 ,72.67 ,66.31 
03,009,01,006,0135,0,308,6,314,417,0,0,0,0,0,0,0,66.31 ,75.30 ,66.31 
03,009,01,006,0136,0,333,8,341,467,0,0,0,0,0,0,0,66.31 ,73.02 ,66.31 
03,009,01,006,0137,0,356,5,361,487,0,0,0,0,0,0,0,66.31 ,74.13 ,66.31 
03,009,01,006,0138,0,617,7,624,885,0,0,0,0,0,0,0,66.31 ,70.51 ,66.31 
03,009,01,006,0139,0,396,8,404,556,0,0,0,0,0,0,0,66.31 ,72.66 ,66.31 
03,009,01,006,0140,0,319,2,321,426,0,0,0,0,0,0,0,66.31 ,75.35 ,66.31 
03,009,01,006,0141,0,476,14,490,666,0,0,0,0,0,0,0,66.31 ,73.57 ,66.31 
03,009,01,006,0142,0,929,15,944,1348,0,0,0,0,0,0,0,66.31 ,70.03 ,66.31 
03,009,01,006,0143,0,328,6,334,474,0,0,0,0,0,0,0,66.31 ,70.46 ,66.31 
03,009,01,006,0144,0,3279,60,3339,4792,0,0,0,0,0,0,0,66.31 ,69.68 ,66.31 
03,009,01,006,0145,0,793,13,806,1169,0,0,0,0,0,0,0,66.31 ,68.95 ,66.31 
03,009,01,006,0146,0,3086,73,3159,4551,0,0,0,0,0,0,0,66.31 ,69.41 ,66.31 
03,009,01,006,0147,0,772,16,788,1142,0,0,0,0,0,0,0,66.31 ,69.00 ,66.31 
03,009,01,006,0148,0,611,9,620,976,0,0,0,0,0,0,0,66.31 ,63.52 ,66.31 
03,009,01,006,0149,0,294,6,300,437,0,0,0,0,0,0,0,66.31 ,68.65 ,66.31 
03,009,01,006,0150,0,569,12,581,870,0,0,0,0,0,0,0,66.31 ,66.78 ,66.31 
03,009,01,006,0151,0,928,27,955,1411,0,0,0,0,0,0,0,66.31 ,67.68 ,66.31 
03,009,01,006,0152,0,733,13,746,1235,0,0,0,0,0,0,0,66.31 ,60.40 ,66.31 
03,009,01,006,0153,0,617,11,628,1087,0,0,0,0,0,0,0,66.31 ,57.77 ,66.31 
03,009,01,006,0154,0,394,9,403,667,0,0,0,0,0,0,0,66.31 ,60.42 ,66.31 
03,009,01,006,0155,0,1169,23,1192,1626,0,0,0,0,0,0,0,66.31 ,73.31 ,66.31 
03,009,01,006,0156,0,1738,32,1770,2660,0,0,0,0,0,0,0,66.31 ,66.54 ,66.31 
03,009,01,006,0157,0,703,11,714,1092,0,0,0,0,0,0,0,66.31 ,65.38 ,66.31 
03,009,01,006,0158,0,389,5,394,601,0,0,0,0,0,0,0,66.31 ,65.56 ,66.31 
03,009,01,007,0159,0,1505,21,1526,2045,0,0,0,0,0,0,0,66.31 ,74.62 ,66.31 
03,009,01,007,0160,0,1079,22,1101,1507,0,0,0,0,0,0,0,66.31 ,73.06 ,66.31 
03,009,01,007,0161,0,1908,35,1943,2691,0,0,0,0,0,0,0,66.31 ,72.20 ,66.31 
03,009,01,007,0162,0,1037,10,1047,1425,0,0,0,0,0,0,0,66.31 ,73.47 ,66.31 
03,009,01,007,0163,0,840,12,852,1113,0,0,0,0,0,0,0,66.31 ,76.55 ,66.31 
03,009,01,007,0164,0,861,18,879,1223,0,0,0,0,0,0,0,66.31 ,71.87 ,66.31 
03,009,01,007,0165,0,682,6,688,890,0,0,0,0,0,0,0,66.31 ,77.30 ,66.31 
03,009,01,007,0166,0,1456,22,1478,1969,0,0,0,0,0,0,0,66.31 ,75.06 ,66.31 
03,009,01,007,0167,0,1355,20,1375,1880,0,0,0,0,0,0,0,66.31 ,73.14 ,66.31 
03,009,01,007,0168,0,1023,12,1035,1353,0,0,0,0,0,0,0,66.31 ,76.50 ,66.31 
03,009,01,007,0169,0,565,6,571,716,0,0,0,0,0,0,0,66.31 ,79.75 ,66.31 
03,009,01,007,0170,0,1339,17,1356,1837,0,0,0,0,0,0,0,66.31 ,73.82 ,66.31 
03,009,01,007,0171,0,1449,23,1472,1949,0,0,0,0,0,0,0,66.31 ,75.53 ,66.31 
03,009,01,007,0172,0,522,5,527,651,0,0,0,0,0,0,0,66.31 ,80.95 ,66.31 
03,009,01,007,0173,0,974,20,994,1339,0,0,0,0,0,0,0,66.31 ,74.23 ,66.31 
03,009,01,007,0174,0,259,2,261,341,0,0,0,0,0,0,0,66.31 ,76.54 ,66.31 
03,009,01,007,0175,0,751,16,767,1057,0,0,0,0,0,0,0,66.31 ,72.56 ,66.31 
03,009,01,007,0176,0,674,8,682,929,0,0,0,0,0,0,0,66.31 ,73.41 ,66.31 
03,009,01,007,0177,0,385,3,388,550,0,0,0,0,0,0,0,66.31 ,70.55 ,66.31 
03,009,01,007,0178,0,526,4,530,692,0,0,0,0,0,0,0,66.31 ,76.59 ,66.31 
03,009,01,008,0179,0,540,10,550,808,0,0,0,0,0,0,0,66.31 ,68.07 ,66.31 
03,009,01,008,0180,0,1484,17,1501,2000,0,0,0,0,0,0,0,66.31 ,75.05 ,66.31 
03,009,01,008,0181,0,785,15,800,1156,0,0,0,0,0,0,0,66.31 ,69.20 ,66.31 
03,009,01,008,0182,0,734,17,751,1084,0,0,0,0,0,0,0,66.31 ,69.28 ,66.31 
03,009,01,008,0183,0,1244,13,1257,1762,0,0,0,0,0,0,0,66.31 ,71.34 ,66.31 
03,009,01,008,0184,0,1334,26,1360,1814,0,0,0,0,0,0,0,66.31 ,74.97 ,66.31 
03,009,01,008,0185,0,844,13,857,1137,0,0,0,0,0,0,0,66.31 ,75.37 ,66.31 
03,009,01,008,0186,0,895,10,905,1228,0,0,0,0,0,0,0,66.31 ,73.70 ,66.31 
03,009,01,008,0187,0,536,4,540,807,0,0,0,0,0,0,0,66.31 ,66.91 ,66.31 
03,009,01,008,0188,0,516,7,523,715,0,0,0,0,0,0,0,66.31 ,73.15 ,66.31 
03,009,01,008,0189,0,793,9,802,1244,0,0,0,0,0,0,0,66.31 ,64.47 ,66.31 
03,009,01,008,0190,0,588,4,592,853,0,0,0,0,0,0,0,66.31 ,69.40 ,66.31 
03,009,01,008,0191,0,483,6,489,730,0,0,0,0,0,0,0,66.31 ,66.99 ,66.31 
03,009,01,008,0192,0,574,5,579,865,0,0,0,0,0,0,0,66.31 ,66.94 ,66.31 
03,009,01,008,0193,0,619,6,625,846,0,0,0,0,0,0,0,66.31 ,73.88 ,66.31 
03,009,01,009,0194,0,2300,39,2339,3218,0,0,0,0,0,0,0,66.31 ,72.68 ,66.31 
03,009,01,009,0195,0,646,7,653,907,0,0,0,0,0,0,0,66.31 ,72.00 ,66.31 
03,009,01,009,0196,0,1055,11,1066,1565,0,0,0,0,0,0,0,66.31 ,68.12 ,66.31 
03,009,01,009,0197,0,933,10,943,1287,0,0,0,0,0,0,0,66.31 ,73.27 ,66.31 
03,009,01,009,0198,0,798,6,804,1112,0,0,0,0,0,0,0,66.31 ,72.30 ,66.31 
03,009,01,009,0199,0,1198,23,1221,1723,0,0,0,0,0,0,0,66.31 ,70.86 ,66.31 
03,009,01,009,0200,0,1648,30,1678,2209,0,0,0,0,0,0,0,66.31 ,75.96 ,66.31 
03,009,01,009,0201,0,936,13,949,1165,0,0,0,0,0,0,0,66.31 ,81.46 ,66.31 
03,009,01,009,0202,0,1339,19,1358,1823,0,0,0,0,0,0,0,66.31 ,74.49 ,66.31 
03,009,01,009,0203,0,829,15,844,1128,0,0,0,0,0,0,0,66.31 ,74.82 ,66.31 
03,009,01,009,0204,0,1142,17,1159,1715,0,0,0,0,0,0,0,66.31 ,67.58 ,66.31 
03,009,01,009,0205,0,1070,12,1082,1533,0,0,0,0,0,0,0,66.31 ,70.58 ,66.31 
03,009,01,009,0206,0,878,17,895,1290,0,0,0,0,0,0,0,66.31 ,69.38 ,66.31 
03,009,01,009,0207,0,1127,8,1135,1652,0,0,0,0,0,0,0,66.31 ,68.70 ,66.31 
03,009,01,010,0208,0,749,14,763,1033,0,0,0,0,0,0,0,66.31 ,73.86 ,66.31 
03,009,01,010,0209,0,2133,48,2181,3094,0,0,0,0,0,0,0,66.31 ,70.49 ,66.31 
03,009,01,010,0210,0,1444,28,1472,2052,0,0,0,0,0,0,0,66.31 ,71.73 ,66.31 
03,009,01,010,0211,0,479,5,484,633,0,0,0,0,0,0,0,66.31 ,76.46 ,66.31 
03,009,01,010,0212,0,721,13,734,997,0,0,0,0,0,0,0,66.31 ,73.62 ,66.31 
03,009,01,010,0213,0,1744,45,1789,2467,0,0,0,0,0,0,0,66.31 ,72.52 ,66.31 
03,009,01,010,0214,0,463,4,467,629,0,0,0,0,0,0,0,66.31 ,74.24 ,66.31 
03,009,01,010,0215,0,846,13,859,1122,0,0,0,0,0,0,0,66.31 ,76.56 ,66.31 
03,009,01,010,0216,0,745,24,769,1057,0,0,0,0,0,0,0,66.31 ,72.75 ,66.31 
03,009,01,010,0217,0,1227,20,1247,1670,0,0,0,0,0,0,0,66.31 ,74.67 ,66.31 
03,009,01,011,0218,0,883,11,894,1346,0,0,0,0,0,0,0,66.31 ,66.42 ,66.31 
03,009,01,011,0219,0,1042,16,1058,1560,0,0,0,0,0,0,0,66.31 ,67.82 ,66.31 
03,009,01,011,0220,0,1166,13,1179,1837,0,0,0,0,0,0,0,66.31 ,64.18 ,66.31 
03,009,01,011,0221,0,1147,12,1159,1692,0,0,0,0,0,0,0,66.31 ,68.50 ,66.31 
03,009,01,011,0222,0,845,17,862,1223,0,0,0,0,0,0,0,66.31 ,70.48 ,66.31 
03,009,01,011,0223,0,1329,25,1354,1948,0,0,0,0,0,0,0,66.31 ,69.51 ,66.31 
03,009,01,011,0224,0,623,5,628,930,0,0,0,0,0,0,0,66.31 ,67.53 ,66.31 
03,009,01,011,0225,0,853,11,864,1329,0,0,0,0,0,0,0,66.31 ,65.01 ,66.31 
03,009,01,011,0226,0,593,11,604,949,0,0,0,0,0,0,0,66.31 ,63.65 ,66.31 
03,009,01,011,0227,0,490,3,493,799,0,0,0,0,0,0,0,66.31 ,61.70 ,66.31 
03,009,01,011,0228,0,983,15,998,1491,0,0,0,0,0,0,0,66.31 ,66.93 ,66.31 
03,009,01,011,0229,0,1242,15,1257,1961,0,0,0,0,0,0,0,66.31 ,64.10 ,66.31 
03,009,01,011,0230,0,564,5,569,899,0,0,0,0,0,0,0,66.31 ,63.29 ,66.31 
03,009,01,011,0231,0,1177,13,1190,1780,0,0,0,0,0,0,0,66.31 ,66.85 ,66.31 
03,009,01,011,0232,0,887,7,894,1403,0,0,0,0,0,0,0,66.31 ,63.72 ,66.31 
03,009,01,011,0233,0,615,5,620,1034,0,0,0,0,0,0,0,66.31 ,59.96 ,66.31 
03,009,01,011,0234,0,582,8,590,836,0,0,0,0,0,0,0,66.31 ,70.57 ,66.31 
03,009,01,011,0235,0,710,5,715,1051,0,0,0,0,0,0,0,66.31 ,68.03 ,66.31 
03,009,01,012,0236,0,921,17,938,1294,0,0,0,0,0,0,0,66.31 ,72.49 ,66.31 
03,009,01,012,0237,0,932,14,946,1317,0,0,0,0,0,0,0,66.31 ,71.83 ,66.31 
03,009,01,012,0238,0,1574,36,1610,2195,0,0,0,0,0,0,0,66.31 ,73.35 ,66.31 
03,009,01,012,0239,0,1244,24,1268,1928,0,0,0,0,0,0,0,66.31 ,65.77 ,66.31 
03,009,01,012,0240,0,1224,14,1238,1873,0,0,0,0,0,0,0,66.31 ,66.10 ,66.31 
03,009,01,012,0241,0,877,16,893,1335,0,0,0,0,0,0,0,66.31 ,66.89 ,66.31 
03,009,01,012,0242,0,1345,12,1357,1909,0,0,0,0,0,0,0,66.31 ,71.08 ,66.31 
03,009,01,012,0243,0,576,7,583,876,0,0,0,0,0,0,0,66.31 ,66.55 ,66.31 
03,009,01,012,0244,0,1126,9,1135,1767,0,0,0,0,0,0,0,66.31 ,64.23 ,66.31 
03,009,01,012,0245,0,1201,14,1215,2017,0,0,0,0,0,0,0,66.31 ,60.24 ,66.31 
03,009,01,012,0246,0,805,12,817,1446,0,0,0,0,0,0,0,66.31 ,56.50 ,66.31 
03,009,01,012,0247,0,788,9,797,1144,0,0,0,0,0,0,0,66.31 ,69.67 ,66.31 
03,009,01,012,0248,0,817,7,824,1262,0,0,0,0,0,0,0,66.31 ,65.29 ,66.31 
03,009,01,012,0249,0,589,9,598,872,0,0,0,0,0,0,0,66.31 ,68.58 ,66.31 
03,009,01,013,0250,0,1975,22,1997,2905,0,0,0,0,0,0,0,66.31 ,68.74 ,66.31 
03,009,01,013,0251,0,1520,18,1538,2376,0,0,0,0,0,0,0,66.31 ,64.73 ,66.31 
03,009,01,013,0252,0,934,3,937,1342,0,0,0,0,0,0,0,66.31 ,69.82 ,66.31 
03,009,01,013,0253,0,1217,11,1228,1842,0,0,0,0,0,0,0,66.31 ,66.67 ,66.31 
03,009,01,013,0254,0,908,9,917,1434,0,0,0,0,0,0,0,66.31 ,63.95 ,66.31 
03,009,01,013,0255,0,1355,14,1369,2059,0,0,0,0,0,0,0,66.31 ,66.49 ,66.31 
03,009,01,013,0256,0,1315,14,1329,2081,0,0,0,0,0,0,0,66.31 ,63.86 ,66.31 
03,009,01,013,0257,0,1077,19,1096,1827,0,0,0,0,0,0,0,66.31 ,59.99 ,66.31 
03,009,01,013,0258,0,1476,25,1501,2422,0,0,0,0,0,0,0,66.31 ,61.97 ,66.31 
03,009,01,013,0259,0,500,10,510,804,0,0,0,0,0,0,0,66.31 ,63.43 ,66.31 
03,009,01,013,0260,0,1328,15,1343,2134,0,0,0,0,0,0,0,66.31 ,62.93 ,66.31 
03,009,01,013,0261,0,848,12,860,1444,0,0,0,0,0,0,0,66.31 ,59.56 ,66.31 
03,009,01,014,0262,0,735,8,743,1321,0,0,0,0,0,0,0,66.31 ,56.25 ,66.31 
03,009,01,014,0263,0,311,6,317,487,0,0,0,0,0,0,0,66.31 ,65.09 ,66.31 
03,009,01,014,0264,0,1121,18,1139,1792,0,0,0,0,0,0,0,66.31 ,63.56 ,66.31 
03,009,01,014,0265,0,974,14,988,1431,0,0,0,0,0,0,0,66.31 ,69.04 ,66.31 
03,009,01,014,0266,0,753,8,761,1161,0,0,0,0,0,0,0,66.31 ,65.55 ,66.31 
03,009,01,014,0267,0,627,5,632,1021,0,0,0,0,0,0,0,66.31 ,61.90 ,66.31 
03,009,01,014,0268,0,1392,23,1415,2215,0,0,0,0,0,0,0,66.31 ,63.88 ,66.31 
03,009,01,014,0269,0,748,8,756,1285,0,0,0,0,0,0,0,66.31 ,58.83 ,66.31 
03,009,01,014,0270,0,727,9,736,1269,0,0,0,0,0,0,0,66.31 ,58.00 ,66.31 
03,009,01,014,0271,0,496,8,504,971,0,0,0,0,0,0,0,66.31 ,51.91 ,66.31 
03,009,01,014,0272,0,628,6,634,1044,0,0,0,0,0,0,0,66.31 ,60.73 ,66.31 
03,009,01,014,0273,0,366,10,376,592,0,0,0,0,0,0,0,66.31 ,63.51 ,66.31 
03,009,01,015,0274,0,1290,20,1310,1807,0,0,0,0,0,0,0,66.31 ,72.50 ,66.31 
03,009,01,015,0275,0,943,8,951,1353,0,0,0,0,0,0,0,66.31 ,70.29 ,66.31 
03,009,01,015,0276,0,940,12,952,1311,0,0,0,0,0,0,0,66.31 ,72.62 ,66.31 
03,009,01,015,0277,0,957,10,967,1347,0,0,0,0,0,0,0,66.31 ,71.79 ,66.31 
03,009,01,015,0278,0,895,1,896,1288,0,0,0,0,0,0,0,66.31 ,69.57 ,66.31 
03,009,01,015,0279,0,634,5,639,909,0,0,0,0,0,0,0,66.31 ,70.30 ,66.31 
03,009,01,015,0280,0,591,5,596,865,0,0,0,0,0,0,0,66.31 ,68.90 ,66.31 
03,009,01,015,0281,0,1001,21,1022,1274,0,0,0,0,0,0,0,66.31 ,80.22 ,66.31 
03,009,01,015,0282,0,614,9,623,991,0,0,0,0,0,0,0,66.31 ,62.87 ,66.31 
03,009,01,016,0283,0,887,3,890,1302,0,0,0,0,0,0,0,66.31 ,68.36 ,66.31 
03,009,01,016,0284,0,634,4,638,997,0,0,0,0,0,0,0,66.31 ,63.99 ,66.31 
03,009,01,016,0285,0,645,11,656,1023,0,0,0,0,0,0,0,66.31 ,64.13 ,66.31 
03,009,01,016,0286,0,1188,21,1209,1875,0,0,0,0,0,0,0,66.31 ,64.48 ,66.31 
03,009,01,016,0287,0,516,6,522,949,0,0,0,0,0,0,0,66.31 ,55.01 ,66.31 
03,009,01,016,0288,0,954,6,960,1534,0,0,0,0,0,0,0,66.31 ,62.58 ,66.31 
03,009,01,016,0289,0,1273,8,1281,2087,0,0,0,0,0,0,0,66.31 ,61.38 ,66.31 
03,009,01,016,0290,0,421,5,426,661,0,0,0,0,0,0,0,66.31 ,64.45 ,66.31 
03,009,01,016,0291,0,329,4,333,558,0,0,0,0,0,0,0,66.31 ,59.68 ,66.31 
03,009,01,016,0292,0,403,5,408,661,0,0,0,0,0,0,0,66.31 ,61.72 ,66.31 
03,009,01,016,0293,0,1213,11,1224,1814,0,0,0,0,0,0,0,66.31 ,67.48 ,66.31 
03,009,01,016,0294,0,963,5,968,1570,0,0,0,0,0,0,0,66.31 ,61.66 ,66.31 
03,009,01,016,0295,0,945,14,959,1397,0,0,0,0,0,0,0,66.31 ,68.65 ,66.31 
03,009,01,016,0296,0,2159,23,2182,3224,0,0,0,0,0,0,0,66.31 ,67.68 ,66.31 
03,009,01,016,0297,0,1608,14,1622,2017,0,0,0,0,0,0,0,66.31 ,80.42 ,66.31 
03,009,01,017,0298,0,2044,27,2071,2958,0,0,0,0,0,0,0,66.31 ,70.01 ,66.31 
03,009,01,017,0299,0,1124,10,1134,1590,0,0,0,0,0,0,0,66.31 ,71.32 ,66.31 
03,009,01,017,0300,0,942,12,954,1478,0,0,0,0,0,0,0,66.31 ,64.55 ,66.31 
03,009,01,017,0301,0,480,4,484,776,0,0,0,0,0,0,0,66.31 ,62.37 ,66.31 
03,009,01,017,0302,0,664,10,674,1048,0,0,0,0,0,0,0,66.31 ,64.31 ,66.31 
03,009,01,017,0303,0,689,9,698,1177,0,0,0,0,0,0,0,66.31 ,59.30 ,66.31 
03,009,01,017,0304,0,575,7,582,1050,0,0,0,0,0,0,0,66.31 ,55.43 ,66.31 
03,009,01,017,0305,0,517,9,526,968,0,0,0,0,0,0,0,66.31 ,54.34 ,66.31 
03,009,01,017,0306,0,438,4,442,739,0,0,0,0,0,0,0,66.31 ,59.81 ,66.31 
03,009,01,017,0307,0,505,3,508,853,0,0,0,0,0,0,0,66.31 ,59.55 ,66.31 
03,009,01,017,0308,0,302,1,303,467,0,0,0,0,0,0,0,66.31 ,64.88 ,66.31 
03,009,01,017,0309,0,783,12,795,1285,0,0,0,0,0,0,0,66.31 ,61.87 ,66.31 
03,009,01,017,0310,0,922,7,929,1544,0,0,0,0,0,0,0,66.31 ,60.17 ,66.31 
03,009,01,017,0311,0,823,4,827,1134,0,0,0,0,0,0,0,66.31 ,72.93 ,66.31 
03,009,01,017,0312,0,575,5,580,926,0,0,0,0,0,0,0,66.31 ,62.63 ,66.31 
03,009,01,017,0313,0,898,8,906,1371,0,0,0,0,0,0,0,66.31 ,66.08 ,66.31 
03,009,01,017,0314,0,694,3,697,1086,0,0,0,0,0,0,0,66.31 ,64.18 ,66.31 
03,009,01,017,0315,0,1100,12,1112,1691,0,0,0,0,0,0,0,66.31 ,65.76 ,66.31 
03,009,01,017,0316,0,433,2,435,712,0,0,0,0,0,0,0,66.31 ,61.10 ,66.31 
03,009,01,017,0317,0,582,11,593,982,0,0,0,0,0,0,0,66.31 ,60.39 ,66.31 
03,009,01,017,0318,0,513,3,516,772,0,0,0,0,0,0,0,66.31 ,66.84 ,66.31 
03,009,01,018,0319,0,1064,20,1084,1735,0,0,0,0,0,0,0,66.31 ,62.48 ,66.31 
03,009,01,018,0320,0,1359,20,1379,2115,0,0,0,0,0,0,0,66.31 ,65.20 ,66.31 
03,009,01,018,0321,0,447,5,452,720,0,0,0,0,0,0,0,66.31 ,62.78 ,66.31 
03,009,01,018,0322,0,723,11,734,1147,0,0,0,0,0,0,0,66.31 ,63.99 ,66.31 
03,009,01,018,0323,0,662,9,671,1187,0,0,0,0,0,0,0,66.31 ,56.53 ,66.31 
03,009,01,018,0324,0,552,8,560,1021,0,0,0,0,0,0,0,66.31 ,54.85 ,66.31 
03,009,01,018,0325,0,478,4,482,931,0,0,0,0,0,0,0,66.31 ,51.77 ,66.31 
03,009,01,018,0326,0,701,9,710,1284,0,0,0,0,0,0,0,66.31 ,55.30 ,66.31 
03,009,01,018,0327,0,614,6,620,1169,0,0,0,0,0,0,0,66.31 ,53.04 ,66.31 
03,009,01,018,0328,0,475,13,488,996,0,0,0,0,0,0,0,66.31 ,49.00 ,66.31 
03,009,01,018,0329,0,371,5,376,670,0,0,0,0,0,0,0,66.31 ,56.12 ,66.31 
03,009,01,018,0330,0,533,5,538,1039,0,0,0,0,0,0,0,66.31 ,51.78 ,66.31 
03,009,01,018,0331,0,247,3,250,414,0,0,0,0,0,0,0,66.31 ,60.39 ,66.31 
03,009,01,018,0332,0,1049,8,1057,1816,0,0,0,0,0,0,0,66.31 ,58.20 ,66.31 
03,009,01,018,0333,0,538,9,547,915,0,0,0,0,0,0,0,66.31 ,59.78 ,66.31 
03,009,01,018,0334,0,484,10,494,812,0,0,0,0,0,0,0,66.31 ,60.84 ,66.31 
03,009,01,018,0335,0,519,10,529,1023,0,0,0,0,0,0,0,66.31 ,51.71 ,66.31 
03,009,01,018,0336,0,635,12,647,1165,0,0,0,0,0,0,0,66.31 ,55.54 ,66.31 
03,009,01,018,0337,0,708,12,720,1351,0,0,0,0,0,0,0,66.31 ,53.29 ,66.31 
03,009,01,018,0338,0,572,14,586,1095,0,0,0,0,0,0,0,66.31 ,53.52 ,66.31 
03,009,01,018,0339,0,415,2,417,904,0,0,0,0,0,0,0,66.31 ,46.13 ,66.31 
03,009,01,019,0340,0,664,3,667,971,0,0,0,0,0,0,0,66.31 ,68.69 ,66.31 
03,009,01,019,0341,0,810,12,822,1252,0,0,0,0,0,0,0,66.31 ,65.65 ,66.31 
03,009,01,019,0342,0,423,6,429,762,0,0,0,0,0,0,0,66.31 ,56.30 ,66.31 
03,009,01,019,0343,0,414,9,423,631,0,0,0,0,0,0,0,66.31 ,67.04 ,66.31 
03,009,01,019,0344,0,514,12,526,936,0,0,0,0,0,0,0,66.31 ,56.20 ,66.31 
03,009,01,019,0345,0,642,4,646,972,0,0,0,0,0,0,0,66.31 ,66.46 ,66.31 
03,009,01,019,0346,0,916,14,930,1438,0,0,0,0,0,0,0,66.31 ,64.67 ,66.31 
03,009,01,019,0347,0,1071,10,1081,2012,0,0,0,0,0,0,0,66.31 ,53.73 ,66.31 
03,009,01,019,0348,0,963,8,971,1710,0,0,0,0,0,0,0,66.31 ,56.78 ,66.31 
03,009,01,019,0349,0,911,4,915,1557,0,0,0,0,0,0,0,66.31 ,58.77 ,66.31 
03,009,01,019,0350,0,347,1,348,573,0,0,0,0,0,0,0,66.31 ,60.73 ,66.31 
03,009,01,019,0351,0,911,7,918,1344,0,0,0,0,0,0,0,66.31 ,68.30 ,66.31 
03,009,01,019,0352,0,503,10,513,776,0,0,0,0,0,0,0,66.31 ,66.11 ,66.31 
03,009,01,019,0353,0,1056,16,1072,1539,0,0,0,0,0,0,0,66.31 ,69.66 ,66.31 
03,009,01,019,0354,0,670,4,674,1046,0,0,0,0,0,0,0,66.31 ,64.44 ,66.31 
03,009,01,019,0355,0,1241,19,1260,1867,0,0,0,0,0,0,0,66.31 ,67.49 ,66.31 
03,009,01,019,0356,0,843,8,851,1314,0,0,0,0,0,0,0,66.31 ,64.76 ,66.31 
03,009,01,019,0357,0,743,3,746,1085,0,0,0,0,0,0,0,66.31 ,68.76 ,66.31 
03,009,01,019,0358,0,533,9,542,798,0,0,0,0,0,0,0,66.31 ,67.92 ,66.31 
03,009,01,019,0359,0,602,4,606,1014,0,0,0,0,0,0,0,66.31 ,59.76 ,66.31 
03,009,01,019,0360,0,456,6,462,746,0,0,0,0,0,0,0,66.31 ,61.93 ,66.31 
03,009,01,020,0361,0,1556,28,1584,2223,0,0,0,0,0,0,0,66.31 ,71.26 ,66.31 
03,009,01,020,0362,0,1326,27,1353,1849,0,0,0,0,0,0,0,66.31 ,73.17 ,66.31 
03,009,01,020,0363,0,578,13,591,821,0,0,0,0,0,0,0,66.31 ,71.99 ,66.31 
03,009,01,020,0364,0,512,6,518,751,0,0,0,0,0,0,0,66.31 ,68.97 ,66.31 
03,009,01,020,0365,0,745,7,752,1122,0,0,0,0,0,0,0,66.31 ,67.02 ,66.31 
03,009,01,020,0366,0,601,20,621,941,0,0,0,0,0,0,0,66.31 ,65.99 ,66.31 
03,009,01,020,0367,0,787,9,796,1241,0,0,0,0,0,0,0,66.31 ,64.14 ,66.31 
03,009,01,020,0368,0,528,4,532,815,0,0,0,0,0,0,0,66.31 ,65.28 ,66.31 
03,009,01,020,0369,0,659,2,661,1087,0,0,0,0,0,0,0,66.31 ,60.81 ,66.31 
03,009,01,020,0370,0,458,11,469,753,0,0,0,0,0,0,0,66.31 ,62.28 ,66.31 
03,009,01,020,0371,0,403,7,410,716,0,0,0,0,0,0,0,66.31 ,57.26 ,66.31 
03,009,01,020,0372,0,761,12,773,1301,0,0,0,0,0,0,0,66.31 ,59.42 ,66.31 
03,009,01,020,0373,0,462,8,470,762,0,0,0,0,0,0,0,66.31 ,61.68 ,66.31 
03,009,01,020,0374,0,682,10,692,1103,0,0,0,0,0,0,0,66.31 ,62.74 ,66.31 
03,009,01,020,0375,0,735,14,749,1079,0,0,0,0,0,0,0,66.31 ,69.42 ,66.31 
03,009,01,020,0376,0,614,8,622,926,0,0,0,0,0,0,0,66.31 ,67.17 ,66.31 
03,009,01,020,0377,0,793,11,804,1274,0,0,0,0,0,0,0,66.31 ,63.11 ,66.31 
03,009,01,020,0378,0,393,2,395,658,0,0,0,0,0,0,0,66.31 ,60.03 ,66.31 
03,009,01,020,0379,0,541,7,548,877,0,0,0,0,0,0,0,66.31 ,62.49 ,66.31 
03,009,01,020,0380,0,541,12,553,921,0,0,0,0,0,0,0,66.31 ,60.04 ,66.31 
03,009,01,020,0381,0,492,6,498,822,0,0,0,0,0,0,0,66.31 ,60.58 ,66.31 
03,009,01,020,0382,0,719,6,725,1133,0,0,0,0,0,0,0,66.31 ,63.99 ,66.31 
03,009,01,020,0383,0,818,13,831,1292,0,0,0,0,0,0,0,66.31 ,64.32 ,66.31 
03,009,01,020,0384,0,571,7,578,849,0,0,0,0,0,0,0,66.31 ,68.08 ,66.31 
03,010,01,001,0001,0,1174,26,1200,1608,0,0,0,0,0,0,0,66.31 ,74.63 ,66.31 
03,010,01,001,0002,0,335,4,339,457,0,0,0,0,0,0,0,66.31 ,74.18 ,66.31 
03,010,01,001,0003,0,1009,12,1021,1352,0,0,0,0,0,0,0,66.31 ,75.52 ,66.31 
03,010,01,001,0004,0,1097,21,1118,1451,0,0,0,0,0,0,0,66.31 ,77.05 ,66.31 
03,010,01,001,0005,0,826,10,836,1078,0,0,0,0,0,0,0,66.31 ,77.55 ,66.31 
03,010,01,001,0006,0,577,10,587,776,0,0,0,0,0,0,0,66.31 ,75.64 ,66.31 
03,010,01,001,0007,0,574,12,586,768,0,0,0,0,0,0,0,66.31 ,76.30 ,66.31 
03,010,01,001,0008,0,580,3,583,769,0,0,0,0,0,0,0,66.31 ,75.81 ,66.31 
03,010,01,001,0009,0,635,10,645,863,0,0,0,0,0,0,0,66.31 ,74.74 ,66.31 
03,010,01,001,0010,0,866,19,885,1183,0,0,0,0,0,0,0,66.31 ,74.81 ,66.31 
03,010,01,001,0011,0,643,9,652,947,0,0,0,0,0,0,0,66.31 ,68.85 ,66.31 
03,010,01,001,0012,0,515,11,526,726,0,0,0,0,0,0,0,66.31 ,72.45 ,66.31 
03,010,01,001,0013,0,442,2,444,561,0,0,0,0,0,0,0,66.31 ,79.14 ,66.31 
03,010,01,001,0014,0,1297,20,1317,1796,0,0,0,0,0,0,0,66.31 ,73.33 ,66.31 
03,010,01,001,0015,0,1715,26,1741,2419,0,0,0,0,0,0,0,66.31 ,71.97 ,66.31 
03,010,01,001,0016,0,1237,30,1267,1670,0,0,0,0,0,0,0,66.31 ,75.87 ,66.31 
03,010,01,001,0017,0,1512,18,1530,2052,0,0,0,0,0,0,0,66.31 ,74.56 ,66.31 
03,010,01,001,0018,0,568,14,582,715,0,0,0,0,0,0,0,66.31 ,81.40 ,66.31 
03,010,01,002,0019,0,1126,9,1135,1739,0,0,0,0,0,0,0,66.31 ,65.27 ,66.31 
03,010,01,002,0020,0,1149,14,1163,1789,0,0,0,0,0,0,0,66.31 ,65.01 ,66.31 
03,010,01,002,0021,0,729,12,741,1103,0,0,0,0,0,0,0,66.31 ,67.18 ,66.31 
03,010,01,002,0022,0,383,4,387,537,0,0,0,0,0,0,0,66.31 ,72.07 ,66.31 
03,010,01,002,0023,0,476,8,484,773,0,0,0,0,0,0,0,66.31 ,62.61 ,66.31 
03,010,01,002,0024,0,562,2,564,777,0,0,0,0,0,0,0,66.31 ,72.59 ,66.31 
03,010,01,002,0025,0,497,7,504,785,0,0,0,0,0,0,0,66.31 ,64.20 ,66.31 
03,010,01,002,0026,0,1174,16,1190,1797,0,0,0,0,0,0,0,66.31 ,66.22 ,66.31 
03,010,01,002,0027,0,1579,26,1605,2331,0,0,0,0,0,0,0,66.31 ,68.85 ,66.31 
03,010,01,002,0028,0,2232,28,2260,3409,0,0,0,0,0,0,0,66.31 ,66.30 ,66.31 
03,010,01,002,0029,0,461,4,465,634,0,0,0,0,0,0,0,66.31 ,73.34 ,66.31 
03,010,01,002,0030,0,463,7,470,729,0,0,0,0,0,0,0,66.31 ,64.47 ,66.31 
03,010,01,002,0031,0,569,2,571,816,0,0,0,0,0,0,0,66.31 ,69.98 ,66.31 
03,010,01,002,0032,0,711,5,716,987,0,0,0,0,0,0,0,66.31 ,72.54 ,66.31 
03,010,01,002,0033,0,335,9,344,468,0,0,0,0,0,0,0,66.31 ,73.50 ,66.31 
03,010,01,002,0034,0,1762,25,1787,2485,0,0,0,0,0,0,0,66.31 ,71.91 ,66.31 
03,010,01,002,0035,0,1060,30,1090,1554,0,0,0,0,0,0,0,66.31 ,70.14 ,66.31 
03,010,01,002,0036,0,408,8,416,566,0,0,0,0,0,0,0,66.31 ,73.50 ,66.31 
03,010,01,002,0037,0,565,8,573,955,0,0,0,0,0,0,0,66.31 ,60.00 ,66.31 
03,010,01,002,0038,0,703,14,717,1019,0,0,0,0,0,0,0,66.31 ,70.36 ,66.31 
03,010,01,002,0039,0,542,13,555,865,0,0,0,0,0,0,0,66.31 ,64.16 ,66.31 
03,010,01,002,0040,0,191,1,192,295,0,0,0,0,0,0,0,66.31 ,65.08 ,66.31 
03,010,01,002,0041,0,498,6,504,798,0,0,0,0,0,0,0,66.31 ,63.16 ,66.31 
03,010,01,002,0042,0,394,5,399,569,0,0,0,0,0,0,0,66.31 ,70.12 ,66.31 
03,010,01,002,0043,0,780,14,794,1184,0,0,0,0,0,0,0,66.31 ,67.06 ,66.31 
03,010,01,002,0044,0,943,15,958,1475,0,0,0,0,0,0,0,66.31 ,64.95 ,66.31 
03,010,01,002,0045,0,360,5,365,560,0,0,0,0,0,0,0,66.31 ,65.18 ,66.31 
03,010,01,003,0046,0,518,12,530,747,0,0,0,0,0,0,0,66.31 ,70.95 ,66.31 
03,010,01,003,0047,0,299,5,304,435,0,0,0,0,0,0,0,66.31 ,69.89 ,66.31 
03,010,01,003,0048,0,934,13,947,1353,0,0,0,0,0,0,0,66.31 ,69.99 ,66.31 
03,010,01,003,0049,0,799,17,816,1205,0,0,0,0,0,0,0,66.31 ,67.72 ,66.31 
03,010,01,003,0050,0,1259,17,1276,1804,0,0,0,0,0,0,0,66.31 ,70.73 ,66.31 
03,010,01,003,0051,0,645,5,650,931,0,0,0,0,0,0,0,66.31 ,69.82 ,66.31 
03,010,01,003,0052,0,588,16,604,815,0,0,0,0,0,0,0,66.31 ,74.11 ,66.31 
03,010,01,003,0053,0,633,15,648,917,0,0,0,0,0,0,0,66.31 ,70.67 ,66.31 
03,010,01,003,0054,0,955,11,966,1437,0,0,0,0,0,0,0,66.31 ,67.22 ,66.31 
03,010,01,003,0055,0,988,22,1010,1616,0,0,0,0,0,0,0,66.31 ,62.50 ,66.31 
03,010,01,003,0056,0,1039,14,1053,1604,0,0,0,0,0,0,0,66.31 ,65.65 ,66.31 
03,010,01,003,0057,0,410,4,414,618,0,0,0,0,0,0,0,66.31 ,66.99 ,66.31 
03,010,01,003,0058,0,566,5,571,793,0,0,0,0,0,0,0,66.31 ,72.01 ,66.31 
03,010,01,003,0059,0,824,23,847,1219,0,0,0,0,0,0,0,66.31 ,69.48 ,66.31 
03,010,01,003,0060,0,1263,26,1289,1951,0,0,0,0,0,0,0,66.31 ,66.07 ,66.31 
03,010,01,003,0061,0,256,6,262,381,0,0,0,0,0,0,0,66.31 ,68.77 ,66.31 
03,010,01,003,0062,0,304,7,311,483,0,0,0,0,0,0,0,66.31 ,64.39 ,66.31 
03,010,01,003,0063,0,232,1,233,375,0,0,0,0,0,0,0,66.31 ,62.13 ,66.31 
03,010,01,003,0064,0,605,5,610,845,0,0,0,0,0,0,0,66.31 ,72.19 ,66.31 
03,010,01,003,0065,0,727,8,735,995,0,0,0,0,0,0,0,66.31 ,73.87 ,66.31 
03,010,01,003,0066,0,765,12,777,1186,0,0,0,0,0,0,0,66.31 ,65.51 ,66.31 
03,010,01,003,0067,0,1472,23,1495,2318,0,0,0,0,0,0,0,66.31 ,64.50 ,66.31 
03,010,01,003,0068,0,711,19,730,1038,0,0,0,0,0,0,0,66.31 ,70.33 ,66.31 
03,010,01,004,0069,0,361,13,374,523,0,0,0,0,0,0,0,66.31 ,71.51 ,66.31 
03,010,01,004,0070,0,1170,21,1191,1837,0,0,0,0,0,0,0,66.31 ,64.83 ,66.31 
03,010,01,004,0071,0,667,10,677,958,0,0,0,0,0,0,0,66.31 ,70.67 ,66.31 
03,010,01,004,0072,0,2783,54,2837,4439,0,0,0,0,0,0,0,66.31 ,63.91 ,66.31 
03,010,01,004,0073,0,813,13,826,1156,0,0,0,0,0,0,0,66.31 ,71.45 ,66.31 
03,010,01,004,0074,0,909,15,924,1285,0,0,0,0,0,0,0,66.31 ,71.91 ,66.31 
03,010,01,004,0075,0,440,5,445,694,0,0,0,0,0,0,0,66.31 ,64.12 ,66.31 
03,010,01,004,0076,0,528,2,530,838,0,0,0,0,0,0,0,66.31 ,63.25 ,66.31 
03,010,01,004,0077,0,518,7,525,715,0,0,0,0,0,0,0,66.31 ,73.43 ,66.31 
03,010,01,004,0078,0,249,1,250,354,0,0,0,0,0,0,0,66.31 ,70.62 ,66.31 
03,010,01,004,0079,0,1169,19,1188,1784,0,0,0,0,0,0,0,66.31 ,66.59 ,66.31 
03,010,01,004,0080,0,1084,20,1104,1474,0,0,0,0,0,0,0,66.31 ,74.90 ,66.31 
03,010,01,004,0081,0,1126,13,1139,1590,0,0,0,0,0,0,0,66.31 ,71.64 ,66.31 
03,010,01,004,0082,0,646,10,656,897,0,0,0,0,0,0,0,66.31 ,73.13 ,66.31 
03,010,01,004,0083,0,1025,15,1040,1505,0,0,0,0,0,0,0,66.31 ,69.10 ,66.31 
03,010,01,004,0084,0,1202,22,1224,1831,0,0,0,0,0,0,0,66.31 ,66.85 ,66.31 
03,010,01,004,0085,0,696,2,698,1002,0,0,0,0,0,0,0,66.31 ,69.66 ,66.31 
03,010,01,004,0086,0,513,9,522,678,0,0,0,0,0,0,0,66.31 ,76.99 ,66.31 
03,010,01,004,0087,0,608,6,614,804,0,0,0,0,0,0,0,66.31 ,76.37 ,66.31 
03,010,01,004,0088,0,803,9,812,1153,0,0,0,0,0,0,0,66.31 ,70.42 ,66.31 
03,010,01,004,0089,0,522,7,529,721,0,0,0,0,0,0,0,66.31 ,73.37 ,66.31 
03,010,01,005,0090,0,1384,20,1404,1963,0,0,0,0,0,0,0,66.31 ,71.52 ,66.31 
03,010,01,005,0091,0,1156,12,1168,1572,0,0,0,0,0,0,0,66.31 ,74.30 ,66.31 
03,010,01,005,0092,0,1957,17,1974,2861,0,0,0,0,0,0,0,66.31 ,69.00 ,66.31 
03,010,01,005,0093,0,1324,14,1338,1906,0,0,0,0,0,0,0,66.31 ,70.20 ,66.31 
03,010,01,005,0094,0,759,7,766,1060,0,0,0,0,0,0,0,66.31 ,72.26 ,66.31 
03,010,01,005,0095,0,1400,15,1415,1796,0,0,0,0,0,0,0,66.31 ,78.79 ,66.31 
03,010,01,005,0096,0,919,18,937,1356,0,0,0,0,0,0,0,66.31 ,69.10 ,66.31 
03,010,01,005,0097,0,1287,9,1296,1665,0,0,0,0,0,0,0,66.31 ,77.84 ,66.31 
03,010,01,005,0098,0,494,3,497,669,0,0,0,0,0,0,0,66.31 ,74.29 ,66.31 
03,010,01,005,0099,0,512,5,517,693,0,0,0,0,0,0,0,66.31 ,74.60 ,66.31 
03,010,01,005,0100,0,547,13,560,716,0,0,0,0,0,0,0,66.31 ,78.21 ,66.31 
03,010,01,005,0101,0,1320,28,1348,1812,0,0,0,0,0,0,0,66.31 ,74.39 ,66.31 
03,010,01,005,0102,0,545,7,552,798,0,0,0,0,0,0,0,66.31 ,69.17 ,66.31 
03,010,01,005,0103,0,399,7,406,611,0,0,0,0,0,0,0,66.31 ,66.45 ,66.31 
03,010,01,005,0104,0,545,5,550,793,0,0,0,0,0,0,0,66.31 ,69.36 ,66.31 
03,010,01,005,0105,0,2078,30,2108,2970,0,0,0,0,0,0,0,66.31 ,70.98 ,66.31 
03,010,01,005,0106,0,1082,17,1099,1588,0,0,0,0,0,0,0,66.31 ,69.21 ,66.31 
03,010,01,005,0107,0,2244,38,2282,3250,0,0,0,0,0,0,0,66.31 ,70.22 ,66.31 
03,010,01,005,0108,0,1247,23,1270,1837,0,0,0,0,0,0,0,66.31 ,69.13 ,66.31 
03,010,01,005,0109,0,1321,35,1356,1976,0,0,0,0,0,0,0,66.31 ,68.62 ,66.31 
03,010,01,005,0110,0,964,5,969,1559,0,0,0,0,0,0,0,66.31 ,62.16 ,66.31 
03,010,01,005,0111,0,1201,23,1224,1604,0,0,0,0,0,0,0,66.31 ,76.31 ,66.31 
03,010,01,005,0112,0,1349,21,1370,2007,0,0,0,0,0,0,0,66.31 ,68.26 ,66.31 
03,010,01,005,0113,0,1556,49,1605,2289,0,0,0,0,0,0,0,66.31 ,70.12 ,66.31 
03,010,01,005,0114,0,1139,15,1154,1607,0,0,0,0,0,0,0,66.31 ,71.81 ,66.31 
03,010,01,005,0115,0,1268,17,1285,1871,0,0,0,0,0,0,0,66.31 ,68.68 ,66.31 
03,010,01,005,0116,0,2212,39,2251,2977,0,0,0,0,0,0,0,66.31 ,75.61 ,66.31 
03,010,01,005,0117,0,877,6,883,1172,0,0,0,0,0,0,0,66.31 ,75.34 ,66.31 
03,010,01,006,0118,0,902,21,923,1371,0,0,0,0,0,0,0,66.31 ,67.32 ,66.31 
03,010,01,006,0119,0,502,9,511,783,0,0,0,0,0,0,0,66.31 ,65.26 ,66.31 
03,010,01,006,0120,0,451,7,458,727,0,0,0,0,0,0,0,66.31 ,63.00 ,66.31 
03,010,01,006,0121,0,522,4,526,877,0,0,0,0,0,0,0,66.31 ,59.98 ,66.31 
03,010,01,006,0122,0,570,4,574,916,0,0,0,0,0,0,0,66.31 ,62.66 ,66.31 
03,010,01,006,0123,0,737,11,748,1248,0,0,0,0,0,0,0,66.31 ,59.94 ,66.31 
03,010,01,006,0124,0,621,7,628,1016,0,0,0,0,0,0,0,66.31 ,61.81 ,66.31 
03,010,01,006,0125,0,673,10,683,986,0,0,0,0,0,0,0,66.31 ,69.27 ,66.31 
03,010,01,006,0126,0,671,9,680,1090,0,0,0,0,0,0,0,66.31 ,62.39 ,66.31 
03,010,01,006,0127,0,488,11,499,782,0,0,0,0,0,0,0,66.31 ,63.81 ,66.31 
03,010,01,006,0128,0,895,14,909,1280,0,0,0,0,0,0,0,66.31 ,71.02 ,66.31 
03,010,01,006,0129,0,630,9,639,965,0,0,0,0,0,0,0,66.31 ,66.22 ,66.31 
03,010,01,006,0130,0,475,7,482,728,0,0,0,0,0,0,0,66.31 ,66.21 ,66.31 
03,010,01,006,0131,0,624,12,636,903,0,0,0,0,0,0,0,66.31 ,70.43 ,66.31 
03,010,01,007,0132,0,1099,10,1109,1645,0,0,0,0,0,0,0,66.31 ,67.42 ,66.31 
03,010,01,007,0133,0,1024,9,1033,1672,0,0,0,0,0,0,0,66.31 ,61.78 ,66.31 
03,010,01,007,0134,0,886,13,899,1380,0,0,0,0,0,0,0,66.31 ,65.14 ,66.31 
03,010,01,007,0135,0,891,13,904,1447,0,0,0,0,0,0,0,66.31 ,62.47 ,66.31 
03,010,01,007,0136,0,721,11,732,1167,0,0,0,0,0,0,0,66.31 ,62.72 ,66.31 
03,010,01,007,0137,0,931,11,942,1501,0,0,0,0,0,0,0,66.31 ,62.76 ,66.31 
03,010,01,007,0138,0,1077,14,1091,1616,0,0,0,0,0,0,0,66.31 ,67.51 ,66.31 
03,010,01,007,0139,0,603,6,609,941,0,0,0,0,0,0,0,66.31 ,64.72 ,66.31 
03,010,01,007,0140,0,1115,26,1141,1630,0,0,0,0,0,0,0,66.31 ,70.00 ,66.31 
03,010,01,007,0141,0,967,16,983,1432,0,0,0,0,0,0,0,66.31 ,68.65 ,66.31 
03,010,01,007,0142,0,963,22,985,1393,0,0,0,0,0,0,0,66.31 ,70.71 ,66.31 
03,010,01,007,0143,0,560,5,565,854,0,0,0,0,0,0,0,66.31 ,66.16 ,66.31 
03,010,01,007,0144,0,671,21,692,968,0,0,0,0,0,0,0,66.31 ,71.49 ,66.31 
03,010,01,007,0145,0,509,9,518,755,0,0,0,0,0,0,0,66.31 ,68.61 ,66.31 
03,010,01,007,0146,0,804,12,816,1156,0,0,0,0,0,0,0,66.31 ,70.59 ,66.31 
03,010,01,007,0147,0,708,10,718,1117,0,0,0,0,0,0,0,66.31 ,64.28 ,66.31 
03,010,01,007,0148,0,674,27,701,1090,0,0,0,0,0,0,0,66.31 ,64.31 ,66.31 
03,010,01,007,0149,0,432,6,438,627,0,0,0,0,0,0,0,66.31 ,69.86 ,66.31 
03,010,01,007,0150,0,493,8,501,793,0,0,0,0,0,0,0,66.31 ,63.18 ,66.31 
03,010,01,007,0151,0,408,3,411,600,0,0,0,0,0,0,0,66.31 ,68.50 ,66.31 
03,010,01,007,0152,0,648,3,651,969,0,0,0,0,0,0,0,66.31 ,67.18 ,66.31 
03,010,01,007,0153,0,397,3,400,611,0,0,0,0,0,0,0,66.31 ,65.47 ,66.31 
03,010,01,007,0154,0,342,9,351,513,0,0,0,0,0,0,0,66.31 ,68.42 ,66.31 
03,010,01,008,0155,0,888,16,904,1273,0,0,0,0,0,0,0,66.31 ,71.01 ,66.31 
03,010,01,008,0156,0,584,9,593,936,0,0,0,0,0,0,0,66.31 ,63.35 ,66.31 
03,010,01,008,0157,0,580,11,591,881,0,0,0,0,0,0,0,66.31 ,67.08 ,66.31 
03,010,01,008,0158,0,274,5,279,374,0,0,0,0,0,0,0,66.31 ,74.60 ,66.31 
03,010,01,008,0159,0,848,10,858,1251,0,0,0,0,0,0,0,66.31 ,68.59 ,66.31 
03,010,01,008,0160,0,851,20,871,1365,0,0,0,0,0,0,0,66.31 ,63.81 ,66.31 
03,010,01,008,0161,0,571,11,582,902,0,0,0,0,0,0,0,66.31 ,64.52 ,66.31 
03,010,01,008,0162,0,472,5,477,752,0,0,0,0,0,0,0,66.31 ,63.43 ,66.31 
03,010,01,008,0163,0,507,10,517,812,0,0,0,0,0,0,0,66.31 ,63.67 ,66.31 
03,010,01,008,0164,0,984,16,1000,1457,0,0,0,0,0,0,0,66.31 ,68.63 ,66.31 
03,010,01,008,0165,0,394,5,399,666,0,0,0,0,0,0,0,66.31 ,59.91 ,66.31 
03,010,01,008,0166,0,529,6,535,788,0,0,0,0,0,0,0,66.31 ,67.89 ,66.31 
03,010,01,008,0167,0,708,2,710,1106,0,0,0,0,0,0,0,66.31 ,64.20 ,66.31 
03,010,01,008,0168,0,583,8,591,851,0,0,0,0,0,0,0,66.31 ,69.45 ,66.31 
03,010,01,008,0169,0,678,14,692,1065,0,0,0,0,0,0,0,66.31 ,64.98 ,66.31 
03,010,01,008,0170,0,935,8,943,1394,0,0,0,0,0,0,0,66.31 ,67.65 ,66.31 
03,010,01,008,0171,0,449,4,453,748,0,0,0,0,0,0,0,66.31 ,60.56 ,66.31 
03,010,01,008,0172,0,361,5,366,608,0,0,0,0,0,0,0,66.31 ,60.20 ,66.31 
03,010,01,008,0173,0,481,2,483,845,0,0,0,0,0,0,0,66.31 ,57.16 ,66.31 
03,010,01,008,0174,0,591,17,608,964,0,0,0,0,0,0,0,66.31 ,63.07 ,66.31 
03,010,01,008,0175,0,608,9,617,939,0,0,0,0,0,0,0,66.31 ,65.71 ,66.31 
03,010,01,008,0176,0,442,9,451,694,0,0,0,0,0,0,0,66.31 ,64.99 ,66.31 
03,010,01,008,0177,0,520,9,529,836,0,0,0,0,0,0,0,66.31 ,63.28 ,66.31 
03,010,01,008,0178,0,599,4,603,929,0,0,0,0,0,0,0,66.31 ,64.91 ,66.31 
03,010,01,008,0179,0,423,5,428,680,0,0,0,0,0,0,0,66.31 ,62.94 ,66.31 
03,010,01,009,0180,0,1176,18,1194,1658,0,0,0,0,0,0,0,66.31 ,72.01 ,66.31 
03,010,01,009,0181,0,672,17,689,1009,0,0,0,0,0,0,0,66.31 ,68.29 ,66.31 
03,010,01,009,0182,0,1013,20,1033,1518,0,0,0,0,0,0,0,66.31 ,68.05 ,66.31 
03,010,01,009,0183,0,1125,16,1141,1486,0,0,0,0,0,0,0,66.31 ,76.78 ,66.31 
03,010,01,009,0184,0,776,10,786,1250,0,0,0,0,0,0,0,66.31 ,62.88 ,66.31 
03,010,01,009,0185,0,447,9,456,732,0,0,0,0,0,0,0,66.31 ,62.30 ,66.31 
03,010,01,009,0186,0,309,1,310,482,0,0,0,0,0,0,0,66.31 ,64.32 ,66.31 
03,010,01,009,0187,0,633,5,638,1035,0,0,0,0,0,0,0,66.31 ,61.64 ,66.31 
03,010,01,009,0188,0,768,10,778,1138,0,0,0,0,0,0,0,66.31 ,68.37 ,66.31 
03,010,01,009,0189,0,574,5,579,928,0,0,0,0,0,0,0,66.31 ,62.39 ,66.31 
03,010,01,009,0190,0,257,0,257,448,0,0,0,0,0,0,0,66.31 ,57.37 ,66.31 
03,010,01,009,0191,0,700,3,703,1107,0,0,0,0,0,0,0,66.31 ,63.50 ,66.31 
03,010,01,009,0192,0,258,1,259,400,0,0,0,0,0,0,0,66.31 ,64.75 ,66.31 
03,010,01,009,0193,0,889,14,903,1370,0,0,0,0,0,0,0,66.31 ,65.91 ,66.31 
03,010,01,009,0194,0,898,11,909,1289,0,0,0,0,0,0,0,66.31 ,70.52 ,66.31 
03,010,01,009,0195,0,618,13,631,924,0,0,0,0,0,0,0,66.31 ,68.29 ,66.31 
03,010,01,009,0196,0,508,4,512,791,0,0,0,0,0,0,0,66.31 ,64.73 ,66.31 
03,010,01,009,0197,0,605,6,611,947,0,0,0,0,0,0,0,66.31 ,64.52 ,66.31 
03,010,01,009,0198,0,506,8,514,817,0,0,0,0,0,0,0,66.31 ,62.91 ,66.31 
03,010,01,009,0199,0,690,15,705,1024,0,0,0,0,0,0,0,66.31 ,68.85 ,66.31 
03,010,01,009,0200,0,676,9,685,993,0,0,0,0,0,0,0,66.31 ,68.98 ,66.31 
03,010,01,009,0201,0,862,15,877,1236,0,0,0,0,0,0,0,66.31 ,70.95 ,66.31 
03,010,01,009,0202,0,564,6,570,836,0,0,0,0,0,0,0,66.31 ,68.18 ,66.31 
03,010,01,010,0203,0,616,15,631,872,0,0,0,0,0,0,0,66.31 ,72.36 ,66.31 
03,010,01,010,0204,0,1137,9,1146,1568,0,0,0,0,0,0,0,66.31 ,73.09 ,66.31 
03,010,01,010,0205,0,1007,18,1025,1393,0,0,0,0,0,0,0,66.31 ,73.58 ,66.31 
03,010,01,010,0206,0,705,6,711,909,0,0,0,0,0,0,0,66.31 ,78.22 ,66.31 
03,010,01,010,0207,0,504,11,515,703,0,0,0,0,0,0,0,66.31 ,73.26 ,66.31 
03,010,01,010,0208,0,952,12,964,1291,0,0,0,0,0,0,0,66.31 ,74.67 ,66.31 
03,010,01,010,0209,0,290,2,292,434,0,0,0,0,0,0,0,66.31 ,67.28 ,66.31 
03,010,01,010,0210,0,365,2,367,523,0,0,0,0,0,0,0,66.31 ,70.17 ,66.31 
03,010,01,010,0211,0,594,6,600,833,0,0,0,0,0,0,0,66.31 ,72.03 ,66.31 
03,010,01,010,0212,0,303,3,306,433,0,0,0,0,0,0,0,66.31 ,70.67 ,66.31 
03,010,01,010,0213,0,380,3,383,510,0,0,0,0,0,0,0,66.31 ,75.10 ,66.31 
03,010,01,010,0214,0,407,5,412,580,0,0,0,0,0,0,0,66.31 ,71.03 ,66.31 
03,010,01,010,0215,0,1153,6,1159,1507,0,0,0,0,0,0,0,66.31 ,76.91 ,66.31 
03,010,01,010,0216,0,617,7,624,882,0,0,0,0,0,0,0,66.31 ,70.75 ,66.31 
03,010,01,010,0217,0,632,6,638,947,0,0,0,0,0,0,0,66.31 ,67.37 ,66.31 
03,010,01,010,0218,0,623,2,625,849,0,0,0,0,0,0,0,66.31 ,73.62 ,66.31 
03,010,01,010,0219,0,377,9,386,554,0,0,0,0,0,0,0,66.31 ,69.68 ,66.31 
03,010,01,010,0220,0,439,10,449,572,0,0,0,0,0,0,0,66.31 ,78.50 ,66.31 
03,010,01,010,0221,0,659,2,661,919,0,0,0,0,0,0,0,66.31 ,71.93 ,66.31 
03,010,01,010,0222,0,359,3,362,526,0,0,0,0,0,0,0,66.31 ,68.82 ,66.31 
03,010,01,010,0223,0,515,4,519,761,0,0,0,0,0,0,0,66.31 ,68.20 ,66.31 
03,010,01,010,0224,0,552,6,558,797,0,0,0,0,0,0,0,66.31 ,70.01 ,66.31 
03,010,01,011,0225,0,364,9,373,497,0,0,0,0,0,0,0,66.31 ,75.05 ,66.31 
03,010,01,011,0226,0,471,7,478,641,0,0,0,0,0,0,0,66.31 ,74.57 ,66.31 
03,010,01,011,0227,0,902,21,923,1269,0,0,0,0,0,0,0,66.31 ,72.73 ,66.31 
03,010,01,011,0228,0,806,23,829,1166,0,0,0,0,0,0,0,66.31 ,71.10 ,66.31 
03,010,01,011,0229,0,272,4,276,412,0,0,0,0,0,0,0,66.31 ,66.99 ,66.31 
03,010,01,011,0230,0,773,11,784,1149,0,0,0,0,0,0,0,66.31 ,68.23 ,66.31 
03,010,01,011,0231,0,369,2,371,553,0,0,0,0,0,0,0,66.31 ,67.09 ,66.31 
03,010,01,011,0232,0,615,15,630,955,0,0,0,0,0,0,0,66.31 ,65.97 ,66.31 
03,010,01,011,0233,0,793,16,809,1162,0,0,0,0,0,0,0,66.31 ,69.62 ,66.31 
03,010,01,011,0234,0,713,12,725,1113,0,0,0,0,0,0,0,66.31 ,65.14 ,66.31 
03,010,01,011,0235,0,676,14,690,941,0,0,0,0,0,0,0,66.31 ,73.33 ,66.31 
03,010,01,011,0236,0,631,8,639,920,0,0,0,0,0,0,0,66.31 ,69.46 ,66.31 
03,010,01,011,0237,0,976,18,994,1337,0,0,0,0,0,0,0,66.31 ,74.35 ,66.31 
03,010,01,011,0238,0,1098,23,1121,1547,0,0,0,0,0,0,0,66.31 ,72.46 ,66.31 
03,010,01,011,0239,0,428,5,433,589,0,0,0,0,0,0,0,66.31 ,73.51 ,66.31 
03,010,01,012,0240,0,1869,40,1909,2732,0,0,0,0,0,0,0,66.31 ,69.88 ,66.31 
03,010,01,012,0241,0,1332,24,1356,1886,0,0,0,0,0,0,0,66.31 ,71.90 ,66.31 
03,010,01,012,0242,0,1009,20,1029,1427,0,0,0,0,0,0,0,66.31 ,72.11 ,66.31 
03,010,01,012,0243,0,1115,26,1141,1562,0,0,0,0,0,0,0,66.31 ,73.05 ,66.31 
03,010,01,012,0244,0,1242,26,1268,1729,0,0,0,0,0,0,0,66.31 ,73.34 ,66.31 
03,010,01,012,0245,0,508,14,522,682,0,0,0,0,0,0,0,66.31 ,76.54 ,66.31 
03,010,01,012,0246,0,1033,12,1045,1355,0,0,0,0,0,0,0,66.31 ,77.12 ,66.31 
03,010,01,012,0247,0,1286,18,1304,1828,0,0,0,0,0,0,0,66.31 ,71.33 ,66.31 
03,010,01,012,0248,0,641,7,648,797,0,0,0,0,0,0,0,66.31 ,81.30 ,66.31 
03,010,01,012,0249,0,1282,25,1307,1680,0,0,0,0,0,0,0,66.31 ,77.80 ,66.31 
03,010,01,012,0250,0,741,8,749,1030,0,0,0,0,0,0,0,66.31 ,72.72 ,66.31 
03,010,01,012,0251,0,489,7,496,635,0,0,0,0,0,0,0,66.31 ,78.11 ,66.31 
03,010,01,012,0252,0,441,5,446,558,0,0,0,0,0,0,0,66.31 ,79.93 ,66.31 
03,010,01,012,0253,0,893,17,910,1210,0,0,0,0,0,0,0,66.31 ,75.21 ,66.31 
03,010,01,012,0254,0,1529,32,1561,2149,0,0,0,0,0,0,0,66.31 ,72.64 ,66.31 
03,010,01,012,0255,0,1120,28,1148,1704,0,0,0,0,0,0,0,66.31 ,67.37 ,66.31 
03,010,01,012,0256,0,1181,33,1214,1739,0,0,0,0,0,0,0,66.31 ,69.81 ,66.31 
03,010,01,012,0257,0,693,12,705,974,0,0,0,0,0,0,0,66.31 ,72.38 ,66.31 
03,010,01,012,0258,0,2029,47,2076,3208,0,0,0,0,0,0,0,66.31 ,64.71 ,66.31 
03,010,01,012,0259,0,1873,43,1916,2826,0,0,0,0,0,0,0,66.31 ,67.80 ,66.31 
03,010,01,012,0260,0,547,15,562,759,0,0,0,0,0,0,0,66.31 ,74.04 ,66.31 
03,010,01,012,0261,0,1228,30,1258,1755,0,0,0,0,0,0,0,66.31 ,71.68 ,66.31 
03,010,01,012,0262,0,1243,30,1273,1772,0,0,0,0,0,0,0,66.31 ,71.84 ,66.31 
03,010,01,012,0263,0,583,19,602,805,0,0,0,0,0,0,0,66.31 ,74.78 ,66.31 
03,010,01,012,0264,0,746,14,760,1040,0,0,0,0,0,0,0,66.31 ,73.08 ,66.31 
03,010,01,012,0265,0,854,23,877,1307,0,0,0,0,0,0,0,66.31 ,67.10 ,66.31 
03,010,01,013,0266,0,1136,18,1154,1580,0,0,0,0,0,0,0,66.31 ,73.04 ,66.31 
03,010,01,013,0267,0,525,7,532,758,0,0,0,0,0,0,0,66.31 ,70.18 ,66.31 
03,010,01,013,0268,0,509,13,522,729,0,0,0,0,0,0,0,66.31 ,71.60 ,66.31 
03,010,01,013,0269,0,534,6,540,844,0,0,0,0,0,0,0,66.31 ,63.98 ,66.31 
03,010,01,013,0270,0,836,10,846,1317,0,0,0,0,0,0,0,66.31 ,64.24 ,66.31 
03,010,01,013,0271,0,1437,24,1461,2409,0,0,0,0,0,0,0,66.31 ,60.65 ,66.31 
03,010,01,013,0272,0,1361,36,1397,2244,0,0,0,0,0,0,0,66.31 ,62.25 ,66.31 
03,010,01,013,0273,0,3025,72,3097,5001,0,0,0,0,0,0,0,66.31 ,61.93 ,66.31 
03,010,01,013,0274,0,2676,71,2747,4566,0,0,0,0,0,0,0,66.31 ,60.16 ,66.31 
03,010,01,013,0275,0,1121,15,1136,1653,0,0,0,0,0,0,0,66.31 ,68.72 ,66.31 
03,010,01,013,0276,0,866,10,876,1240,0,0,0,0,0,0,0,66.31 ,70.65 ,66.31 
03,010,01,013,0277,0,1319,25,1344,2031,0,0,0,0,0,0,0,66.31 ,66.17 ,66.31 
03,010,01,013,0278,0,824,11,835,1099,0,0,0,0,0,0,0,66.31 ,75.98 ,66.31 
03,010,01,013,0279,0,883,6,889,1164,0,0,0,0,0,0,0,66.31 ,76.37 ,66.31 
03,010,01,013,0280,0,672,17,689,910,0,0,0,0,0,0,0,66.31 ,75.71 ,66.31 
03,010,01,013,0281,0,1264,21,1285,1861,0,0,0,0,0,0,0,66.31 ,69.05 ,66.31 
03,010,01,013,0282,0,542,11,553,738,0,0,0,0,0,0,0,66.31 ,74.93 ,66.31 
03,010,01,013,0283,0,445,10,455,612,0,0,0,0,0,0,0,66.31 ,74.35 ,66.31 
03,010,01,013,0284,0,519,7,526,687,0,0,0,0,0,0,0,66.31 ,76.56 ,66.31 
03,010,01,013,0285,0,754,12,766,1104,0,0,0,0,0,0,0,66.31 ,69.38 ,66.31 
03,010,01,013,0286,0,185,2,187,336,0,0,0,0,0,0,0,66.31 ,55.65 ,66.31 
03,010,01,013,0287,0,233,8,241,319,0,0,0,0,0,0,0,66.31 ,75.55 ,66.31 
03,010,01,014,0288,0,1420,19,1439,2095,0,0,0,0,0,0,0,66.31 ,68.69 ,66.31 
03,010,01,014,0289,0,1261,18,1279,1765,0,0,0,0,0,0,0,66.31 ,72.46 ,66.31 
03,010,01,014,0290,0,555,11,566,741,0,0,0,0,0,0,0,66.31 ,76.38 ,66.31 
03,010,01,014,0291,0,632,7,639,851,0,0,0,0,0,0,0,66.31 ,75.09 ,66.31 
03,010,01,014,0292,0,908,16,924,1261,0,0,0,0,0,0,0,66.31 ,73.28 ,66.31 
03,010,01,014,0293,0,428,5,433,566,0,0,0,0,0,0,0,66.31 ,76.50 ,66.31 
03,010,01,014,0294,0,740,11,751,1061,0,0,0,0,0,0,0,66.31 ,70.78 ,66.31 
03,010,01,014,0295,0,2707,45,2752,4296,0,0,0,0,0,0,0,66.31 ,64.06 ,66.31 
03,010,01,014,0296,0,821,12,833,1224,0,0,0,0,0,0,0,66.31 ,68.06 ,66.31 
03,010,01,014,0297,0,862,13,875,1298,0,0,0,0,0,0,0,66.31 ,67.41 ,66.31 
03,010,01,014,0298,0,1129,16,1145,1633,0,0,0,0,0,0,0,66.31 ,70.12 ,66.31 
03,010,01,014,0299,0,1243,22,1265,1686,0,0,0,0,0,0,0,66.31 ,75.03 ,66.31 
03,010,01,014,0300,0,737,9,746,1066,0,0,0,0,0,0,0,66.31 ,69.98 ,66.31 
03,010,01,014,0301,0,468,4,472,762,0,0,0,0,0,0,0,66.31 ,61.94 ,66.31 
03,010,01,014,0302,0,642,16,658,878,0,0,0,0,0,0,0,66.31 ,74.94 ,66.31 
03,010,01,014,0303,0,421,3,424,558,0,0,0,0,0,0,0,66.31 ,75.99 ,66.31 
03,010,01,014,0304,0,1159,24,1183,1611,0,0,0,0,0,0,0,66.31 ,73.43 ,66.31 
03,010,01,014,0305,0,533,10,543,783,0,0,0,0,0,0,0,66.31 ,69.35 ,66.31 
03,010,01,014,0306,0,328,3,331,501,0,0,0,0,0,0,0,66.31 ,66.07 ,66.31 
03,010,01,014,0307,0,1258,15,1273,1801,0,0,0,0,0,0,0,66.31 ,70.68 ,66.31 
03,010,01,014,0308,0,657,7,664,1084,0,0,0,0,0,0,0,66.31 ,61.25 ,66.31 
03,010,01,014,0309,0,171,1,172,312,0,0,0,0,0,0,0,66.31 ,55.13 ,66.31 
03,010,01,014,0310,0,452,2,454,790,0,0,0,0,0,0,0,66.31 ,57.47 ,66.31 
03,010,01,014,0311,0,499,6,505,755,0,0,0,0,0,0,0,66.31 ,66.89 ,66.31 
03,010,01,015,0312,0,1667,34,1701,2424,0,0,0,0,0,0,0,66.31 ,70.17 ,66.31 
03,010,01,015,0313,0,741,9,750,1005,0,0,0,0,0,0,0,66.31 ,74.63 ,66.31 
03,010,01,015,0314,0,2363,48,2411,3496,0,0,0,0,0,0,0,66.31 ,68.96 ,66.31 
03,010,01,015,0315,0,447,5,452,601,0,0,0,0,0,0,0,66.31 ,75.21 ,66.31 
03,010,01,015,0316,0,385,6,391,525,0,0,0,0,0,0,0,66.31 ,74.48 ,66.31 
03,010,01,015,0317,0,461,6,467,679,0,0,0,0,0,0,0,66.31 ,68.78 ,66.31 
03,010,01,015,0318,0,460,3,463,573,0,0,0,0,0,0,0,66.31 ,80.80 ,66.31 
03,010,01,015,0319,0,1130,15,1145,1662,0,0,0,0,0,0,0,66.31 ,68.89 ,66.31 
03,010,01,015,0320,0,685,6,691,960,0,0,0,0,0,0,0,66.31 ,71.98 ,66.31 
03,010,01,015,0321,0,358,3,361,527,0,0,0,0,0,0,0,66.31 ,68.50 ,66.31 
03,010,01,015,0322,0,378,12,390,500,0,0,0,0,0,0,0,66.31 ,78.00 ,66.31 
03,010,01,015,0323,0,353,8,361,505,0,0,0,0,0,0,0,66.31 ,71.49 ,66.31 
03,010,01,015,0324,0,296,3,299,424,0,0,0,0,0,0,0,66.31 ,70.52 ,66.31 
03,010,01,015,0325,0,316,6,322,485,0,0,0,0,0,0,0,66.31 ,66.39 ,66.31 
03,010,01,015,0326,0,198,1,199,322,0,0,0,0,0,0,0,66.31 ,61.80 ,66.31 
03,010,01,015,0327,0,520,5,525,732,0,0,0,0,0,0,0,66.31 ,71.72 ,66.31 
03,010,01,015,0328,0,556,15,571,754,0,0,0,0,0,0,0,66.31 ,75.73 ,66.31 
03,010,01,015,0329,0,706,11,717,1034,0,0,0,0,0,0,0,66.31 ,69.34 ,66.31 
03,010,01,016,0330,0,695,11,706,962,0,0,0,0,0,0,0,66.31 ,73.39 ,66.31 
03,010,01,016,0331,0,239,3,242,362,0,0,0,0,0,0,0,66.31 ,66.85 ,66.31 
03,010,01,016,0332,0,560,4,564,782,0,0,0,0,0,0,0,66.31 ,72.12 ,66.31 
03,010,01,016,0333,0,976,14,990,1569,0,0,0,0,0,0,0,66.31 ,63.10 ,66.31 
03,010,01,016,0334,0,597,7,604,799,0,0,0,0,0,0,0,66.31 ,75.59 ,66.31 
03,010,01,016,0335,0,555,4,559,786,0,0,0,0,0,0,0,66.31 ,71.12 ,66.31 
03,010,01,016,0336,0,571,8,579,856,0,0,0,0,0,0,0,66.31 ,67.64 ,66.31 
03,010,01,016,0337,0,455,5,460,865,0,0,0,0,0,0,0,66.31 ,53.18 ,66.31 
03,010,01,016,0338,0,554,9,563,921,0,0,0,0,0,0,0,66.31 ,61.13 ,66.31 
03,010,01,016,0339,0,331,2,333,617,0,0,0,0,0,0,0,66.31 ,53.97 ,66.31 
03,010,01,016,0340,0,228,1,229,391,0,0,0,0,0,0,0,66.31 ,58.57 ,66.31 
03,010,01,017,0341,0,544,4,548,992,0,0,0,0,0,0,0,66.31 ,55.24 ,66.31 
03,010,01,017,0342,0,257,2,259,474,0,0,0,0,0,0,0,66.31 ,54.64 ,66.31 
03,010,01,017,0343,0,188,3,191,294,0,0,0,0,0,0,0,66.31 ,64.97 ,66.31 
03,010,01,017,0344,0,386,7,393,729,0,0,0,0,0,0,0,66.31 ,53.91 ,66.31 
03,010,01,017,0345,0,205,2,207,382,0,0,0,0,0,0,0,66.31 ,54.19 ,66.31 
03,010,01,018,0346,0,198,3,201,362,0,0,0,0,0,0,0,66.31 ,55.52 ,66.31 
03,010,01,018,0347,0,97,0,97,186,0,0,0,0,0,0,0,66.31 ,52.15 ,66.31 
03,010,01,018,0348,0,125,0,125,221,0,0,0,0,0,0,0,66.31 ,56.56 ,66.31 
03,010,01,018,0349,0,135,0,135,300,0,0,0,0,0,0,0,66.31 ,45.00 ,66.31 
03,010,01,018,0350,0,178,4,182,263,0,0,0,0,0,0,0,66.31 ,69.20 ,66.31 
03,010,01,018,0351,0,69,1,70,141,0,0,0,0,0,0,0,66.31 ,49.65 ,66.31 
03,010,01,018,0352,0,165,6,171,260,0,0,0,0,0,0,0,66.31 ,65.77 ,66.31 
03,010,01,018,0353,0,16,0,16,22,0,0,0,0,0,0,0,66.31 ,72.73 ,66.31 
03,010,01,018,0354,0,12,0,12,23,0,0,0,0,0,0,0,66.31 ,52.17 ,66.31 
03,010,01,018,0355,0,10,1,11,27,0,0,0,0,0,0,0,66.31 ,40.74 ,66.31 
03,010,01,018,0356,0,11,0,11,20,0,0,0,0,0,0,0,66.31 ,55.00 ,66.31 
03,010,01,018,0357,0,53,0,53,95,0,0,0,0,0,0,0,66.31 ,55.79 ,66.31 
03,011,01,001,0001,0,2352,28,2380,4005,0,0,0,0,0,0,0,66.31 ,59.43 ,66.31 
03,011,01,001,0002,0,1453,16,1469,2434,0,0,0,0,0,0,0,66.31 ,60.35 ,66.31 
03,011,01,001,0003,0,1587,23,1610,2695,0,0,0,0,0,0,0,66.31 ,59.74 ,66.31 
03,011,01,001,0004,0,523,8,531,915,0,0,0,0,0,0,0,66.31 ,58.03 ,66.31 
03,011,01,001,0005,0,766,12,778,1316,0,0,0,0,0,0,0,66.31 ,59.12 ,66.31 
03,011,01,001,0006,0,668,6,674,1019,0,0,0,0,0,0,0,66.31 ,66.14 ,66.31 
03,011,01,001,0007,0,1787,22,1809,3184,0,0,0,0,0,0,0,66.31 ,56.82 ,66.31 
03,011,01,001,0008,0,2938,45,2983,5134,0,0,0,0,0,0,0,66.31 ,58.10 ,66.31 
03,011,01,001,0009,0,483,7,490,825,0,0,0,0,0,0,0,66.31 ,59.39 ,66.31 
03,011,01,001,0010,0,837,13,850,1387,0,0,0,0,0,0,0,66.31 ,61.28 ,66.31 
03,011,01,001,0011,0,339,3,342,553,0,0,0,0,0,0,0,66.31 ,61.84 ,66.31 
03,011,01,001,0012,0,1431,13,1444,2406,0,0,0,0,0,0,0,66.31 ,60.02 ,66.31 
03,011,01,001,0013,0,931,10,941,1426,0,0,0,0,0,0,0,66.31 ,65.99 ,66.31 
03,011,01,001,0014,0,1597,18,1615,2915,0,0,0,0,0,0,0,66.31 ,55.40 ,66.31 
03,011,01,001,0015,0,1612,21,1633,2813,0,0,0,0,0,0,0,66.31 ,58.05 ,66.31 
03,011,01,001,0016,0,1211,18,1229,2177,0,0,0,0,0,0,0,66.31 ,56.45 ,66.31 
03,011,01,001,0017,0,2096,26,2122,3684,0,0,0,0,0,0,0,66.31 ,57.60 ,66.31 
03,011,01,001,0018,0,967,6,973,1488,0,0,0,0,0,0,0,66.31 ,65.39 ,66.31 
03,011,01,001,0019,0,742,6,748,1210,0,0,0,0,0,0,0,66.31 ,61.82 ,66.31 
03,011,01,001,0020,0,822,14,836,1380,0,0,0,0,0,0,0,66.31 ,60.58 ,66.31 
03,011,01,001,0021,0,928,9,937,1481,0,0,0,0,0,0,0,66.31 ,63.27 ,66.31 
03,011,01,001,0022,0,1521,22,1543,2490,0,0,0,0,0,0,0,66.31 ,61.97 ,66.31 
03,011,01,001,0023,0,865,22,887,1369,0,0,0,0,0,0,0,66.31 ,64.79 ,66.31 
03,011,01,001,0024,0,241,2,243,362,0,0,0,0,0,0,0,66.31 ,67.13 ,66.31 
03,011,01,001,0025,0,344,4,348,453,0,0,0,0,0,0,0,66.31 ,76.82 ,66.31 
03,011,01,001,0026,0,508,11,519,746,0,0,0,0,0,0,0,66.31 ,69.57 ,66.31 
03,011,01,001,0027,0,657,13,670,970,0,0,0,0,0,0,0,66.31 ,69.07 ,66.31 
03,011,01,001,0028,0,397,3,400,572,0,0,0,0,0,0,0,66.31 ,69.93 ,66.31 
03,011,01,002,0029,0,830,8,838,1317,0,0,0,0,0,0,0,66.31 ,63.63 ,66.31 
03,011,01,002,0030,0,365,5,370,528,0,0,0,0,0,0,0,66.31 ,70.08 ,66.31 
03,011,01,002,0031,0,265,2,267,388,0,0,0,0,0,0,0,66.31 ,68.81 ,66.31 
03,011,01,002,0032,0,384,3,387,598,0,0,0,0,0,0,0,66.31 ,64.72 ,66.31 
03,011,01,002,0033,0,372,4,376,545,0,0,0,0,0,0,0,66.31 ,68.99 ,66.31 
03,011,01,002,0034,0,286,1,287,418,0,0,0,0,0,0,0,66.31 ,68.66 ,66.31 
03,011,01,002,0035,0,500,8,508,772,0,0,0,0,0,0,0,66.31 ,65.80 ,66.31 
03,011,01,002,0036,0,1697,30,1727,2971,0,0,0,0,0,0,0,66.31 ,58.13 ,66.31 
03,011,01,002,0037,0,422,8,430,729,0,0,0,0,0,0,0,66.31 ,58.98 ,66.31 
03,011,01,002,0038,0,637,8,645,996,0,0,0,0,0,0,0,66.31 ,64.76 ,66.31 
03,011,01,002,0039,0,2011,24,2035,3062,0,0,0,0,0,0,0,66.31 ,66.46 ,66.31 
03,011,01,002,0040,0,457,6,463,619,0,0,0,0,0,0,0,66.31 ,74.80 ,66.31 
03,011,01,002,0041,0,477,1,478,774,0,0,0,0,0,0,0,66.31 ,61.76 ,66.31 
03,011,01,002,0042,0,1002,14,1016,1574,0,0,0,0,0,0,0,66.31 ,64.55 ,66.31 
03,011,01,002,0043,0,327,7,334,543,0,0,0,0,0,0,0,66.31 ,61.51 ,66.31 
03,011,01,002,0044,0,204,3,207,292,0,0,0,0,0,0,0,66.31 ,70.89 ,66.31 
03,011,01,002,0045,0,439,5,444,695,0,0,0,0,0,0,0,66.31 ,63.88 ,66.31 
03,011,01,002,0046,0,290,6,296,480,0,0,0,0,0,0,0,66.31 ,61.67 ,66.31 
03,011,01,002,0047,0,588,10,598,855,0,0,0,0,0,0,0,66.31 ,69.94 ,66.31 
03,011,01,002,0048,0,275,6,281,424,0,0,0,0,0,0,0,66.31 ,66.27 ,66.31 
03,011,01,002,0049,0,181,2,183,290,0,0,0,0,0,0,0,66.31 ,63.10 ,66.31 
03,011,01,002,0050,0,287,3,290,382,0,0,0,0,0,0,0,66.31 ,75.92 ,66.31 
03,011,01,002,0051,0,299,2,301,437,0,0,0,0,0,0,0,66.31 ,68.88 ,66.31 
03,011,01,002,0052,0,396,7,403,628,0,0,0,0,0,0,0,66.31 ,64.17 ,66.31 
03,011,01,002,0053,0,676,10,686,944,0,0,0,0,0,0,0,66.31 ,72.67 ,66.31 
03,011,01,003,0054,0,1083,11,1094,1882,0,0,0,0,0,0,0,66.31 ,58.13 ,66.31 
03,011,01,003,0055,0,1488,18,1506,2665,0,0,0,0,0,0,0,66.31 ,56.51 ,66.31 
03,011,01,003,0056,0,887,15,902,1426,0,0,0,0,0,0,0,66.31 ,63.25 ,66.31 
03,011,01,003,0057,0,904,9,913,1460,0,0,0,0,0,0,0,66.31 ,62.53 ,66.31 
03,011,01,003,0058,0,516,6,522,850,0,0,0,0,0,0,0,66.31 ,61.41 ,66.31 
03,011,01,003,0059,0,790,15,805,1347,0,0,0,0,0,0,0,66.31 ,59.76 ,66.31 
03,011,01,003,0060,0,270,3,273,478,0,0,0,0,0,0,0,66.31 ,57.11 ,66.31 
03,011,01,003,0061,0,385,2,387,636,0,0,0,0,0,0,0,66.31 ,60.85 ,66.31 
03,011,01,003,0062,0,336,5,341,504,0,0,0,0,0,0,0,66.31 ,67.66 ,66.31 
03,011,01,003,0063,0,352,4,356,667,0,0,0,0,0,0,0,66.31 ,53.37 ,66.31 
03,011,01,003,0064,0,718,8,726,1284,0,0,0,0,0,0,0,66.31 ,56.54 ,66.31 
03,011,01,003,0065,0,1422,24,1446,2308,0,0,0,0,0,0,0,66.31 ,62.65 ,66.31 
03,011,01,003,0066,0,796,9,805,1193,0,0,0,0,0,0,0,66.31 ,67.48 ,66.31 
03,011,01,003,0067,0,879,6,885,1345,0,0,0,0,0,0,0,66.31 ,65.80 ,66.31 
03,011,01,003,0068,0,578,11,589,889,0,0,0,0,0,0,0,66.31 ,66.25 ,66.31 
03,011,01,003,0069,0,419,6,425,693,0,0,0,0,0,0,0,66.31 ,61.33 ,66.31 
03,011,01,003,0070,0,622,8,630,922,0,0,0,0,0,0,0,66.31 ,68.33 ,66.31 
03,011,01,003,0071,0,607,6,613,958,0,0,0,0,0,0,0,66.31 ,63.99 ,66.31 
03,011,01,003,0072,0,515,2,517,822,0,0,0,0,0,0,0,66.31 ,62.90 ,66.31 
03,011,01,003,0073,0,816,8,824,1282,0,0,0,0,0,0,0,66.31 ,64.27 ,66.31 
03,011,01,003,0074,0,465,6,471,771,0,0,0,0,0,0,0,66.31 ,61.09 ,66.31 
03,011,01,003,0075,0,515,7,522,792,0,0,0,0,0,0,0,66.31 ,65.91 ,66.31 
03,011,01,003,0076,0,585,7,592,932,0,0,0,0,0,0,0,66.31 ,63.52 ,66.31 
03,011,01,003,0077,0,425,5,430,719,0,0,0,0,0,0,0,66.31 ,59.81 ,66.31 
03,011,01,004,0078,0,940,11,951,1424,0,0,0,0,0,0,0,66.31 ,66.78 ,66.31 
03,011,01,004,0079,0,1171,19,1190,1753,0,0,0,0,0,0,0,66.31 ,67.88 ,66.31 
03,011,01,004,0080,0,500,5,505,704,0,0,0,0,0,0,0,66.31 ,71.73 ,66.31 
03,011,01,004,0081,0,1603,25,1628,2395,0,0,0,0,0,0,0,66.31 ,67.97 ,66.31 
03,011,01,004,0082,0,851,11,862,1203,0,0,0,0,0,0,0,66.31 ,71.65 ,66.31 
03,011,01,004,0083,0,511,5,516,754,0,0,0,0,0,0,0,66.31 ,68.44 ,66.31 
03,011,01,004,0084,0,1075,13,1088,1515,0,0,0,0,0,0,0,66.31 ,71.82 ,66.31 
03,011,01,004,0085,0,1204,14,1218,1768,0,0,0,0,0,0,0,66.31 ,68.89 ,66.31 
03,011,01,004,0086,0,911,19,930,1395,0,0,0,0,0,0,0,66.31 ,66.67 ,66.31 
03,011,01,004,0087,0,468,11,479,650,0,0,0,0,0,0,0,66.31 ,73.69 ,66.31 
03,011,01,004,0088,0,892,13,905,1389,0,0,0,0,0,0,0,66.31 ,65.15 ,66.31 
03,011,01,004,0089,0,848,9,857,1247,0,0,0,0,0,0,0,66.31 ,68.72 ,66.31 
03,011,01,004,0090,0,1082,12,1094,1673,0,0,0,0,0,0,0,66.31 ,65.39 ,66.31 
03,011,01,005,0091,0,959,10,969,1462,0,0,0,0,0,0,0,66.31 ,66.28 ,66.31 
03,011,01,005,0092,0,816,4,820,1252,0,0,0,0,0,0,0,66.31 ,65.50 ,66.31 
03,011,01,005,0093,0,820,16,836,1309,0,0,0,0,0,0,0,66.31 ,63.87 ,66.31 
03,011,01,005,0094,0,880,10,890,1311,0,0,0,0,0,0,0,66.31 ,67.89 ,66.31 
03,011,01,005,0095,0,739,12,751,1186,0,0,0,0,0,0,0,66.31 ,63.32 ,66.31 
03,011,01,005,0096,0,756,8,764,1239,0,0,0,0,0,0,0,66.31 ,61.66 ,66.31 
03,011,01,005,0097,0,523,7,530,817,0,0,0,0,0,0,0,66.31 ,64.87 ,66.31 
03,011,01,005,0098,0,356,8,364,527,0,0,0,0,0,0,0,66.31 ,69.07 ,66.31 
03,011,01,005,0099,0,324,10,334,604,0,0,0,0,0,0,0,66.31 ,55.30 ,66.31 
03,011,01,005,0100,0,540,8,548,839,0,0,0,0,0,0,0,66.31 ,65.32 ,66.31 
03,011,01,005,0101,0,337,2,339,468,0,0,0,0,0,0,0,66.31 ,72.44 ,66.31 
03,011,01,005,0102,0,750,5,755,1139,0,0,0,0,0,0,0,66.31 ,66.29 ,66.31 
03,011,01,005,0103,0,376,4,380,546,0,0,0,0,0,0,0,66.31 ,69.60 ,66.31 
03,011,01,005,0104,0,696,7,703,1066,0,0,0,0,0,0,0,66.31 ,65.95 ,66.31 
03,011,01,005,0105,0,383,3,386,584,0,0,0,0,0,0,0,66.31 ,66.10 ,66.31 
03,011,01,005,0106,0,1002,11,1013,1457,0,0,0,0,0,0,0,66.31 ,69.53 ,66.31 
03,011,01,005,0107,0,970,8,978,1507,0,0,0,0,0,0,0,66.31 ,64.90 ,66.31 
03,011,01,005,0108,0,744,10,754,1146,0,0,0,0,0,0,0,66.31 ,65.79 ,66.31 
03,011,01,005,0109,0,958,11,969,1365,0,0,0,0,0,0,0,66.31 ,70.99 ,66.31 
03,011,01,005,0110,0,760,1,761,1150,0,0,0,0,0,0,0,66.31 ,66.17 ,66.31 
03,011,01,005,0111,0,423,11,434,698,0,0,0,0,0,0,0,66.31 ,62.18 ,66.31 
03,011,01,005,0112,0,127,1,128,187,0,0,0,0,0,0,0,66.31 ,68.45 ,66.31 
03,011,01,006,0113,0,821,5,826,1423,0,0,0,0,0,0,0,66.31 ,58.05 ,66.31 
03,011,01,006,0114,0,1387,15,1402,2286,0,0,0,0,0,0,0,66.31 ,61.33 ,66.31 
03,011,01,006,0115,0,910,11,921,1549,0,0,0,0,0,0,0,66.31 ,59.46 ,66.31 
03,011,01,006,0116,0,567,5,572,970,0,0,0,0,0,0,0,66.31 ,58.97 ,66.31 
03,011,01,006,0117,0,691,10,701,1206,0,0,0,0,0,0,0,66.31 ,58.13 ,66.31 
03,011,01,006,0118,0,961,15,976,1416,0,0,0,0,0,0,0,66.31 ,68.93 ,66.31 
03,011,01,006,0119,0,538,5,543,933,0,0,0,0,0,0,0,66.31 ,58.20 ,66.31 
03,011,01,006,0120,0,1216,10,1226,1878,0,0,0,0,0,0,0,66.31 ,65.28 ,66.31 
03,011,01,006,0121,0,384,5,389,561,0,0,0,0,0,0,0,66.31 ,69.34 ,66.31 
03,011,01,006,0122,0,319,1,320,513,0,0,0,0,0,0,0,66.31 ,62.38 ,66.31 
03,011,01,006,0123,0,265,1,266,400,0,0,0,0,0,0,0,66.31 ,66.50 ,66.31 
03,011,01,006,0124,0,1411,16,1427,2270,0,0,0,0,0,0,0,66.31 ,62.86 ,66.31 
03,011,01,006,0125,0,414,8,422,777,0,0,0,0,0,0,0,66.31 ,54.31 ,66.31 
03,011,01,006,0126,0,706,9,715,1137,0,0,0,0,0,0,0,66.31 ,62.88 ,66.31 
03,011,01,006,0127,0,673,4,677,1133,0,0,0,0,0,0,0,66.31 ,59.75 ,66.31 
03,011,01,006,0128,0,547,5,552,974,0,0,0,0,0,0,0,66.31 ,56.67 ,66.31 
03,011,01,007,0129,0,461,4,465,641,0,0,0,0,0,0,0,66.31 ,72.54 ,66.31 
03,011,01,007,0130,0,435,5,440,617,0,0,0,0,0,0,0,66.31 ,71.31 ,66.31 
03,011,01,007,0131,0,1252,12,1264,1888,0,0,0,0,0,0,0,66.31 ,66.95 ,66.31 
03,011,01,007,0132,0,1503,14,1517,2254,0,0,0,0,0,0,0,66.31 ,67.30 ,66.31 
03,011,01,007,0133,0,914,11,925,1355,0,0,0,0,0,0,0,66.31 ,68.27 ,66.31 
03,011,01,007,0134,0,1210,7,1217,1764,0,0,0,0,0,0,0,66.31 ,68.99 ,66.31 
03,011,01,007,0135,0,834,12,846,1251,0,0,0,0,0,0,0,66.31 ,67.63 ,66.31 
03,011,01,007,0136,0,726,5,731,964,0,0,0,0,0,0,0,66.31 ,75.83 ,66.31 
03,011,01,007,0137,0,1847,18,1865,2757,0,0,0,0,0,0,0,66.31 ,67.65 ,66.31 
03,011,01,007,0138,0,809,3,812,1128,0,0,0,0,0,0,0,66.31 ,71.99 ,66.31 
03,011,01,007,0139,0,1571,22,1593,2379,0,0,0,0,0,0,0,66.31 ,66.96 ,66.31 
03,011,01,007,0140,0,479,9,488,632,0,0,0,0,0,0,0,66.31 ,77.22 ,66.31 
03,011,01,007,0141,0,537,9,546,729,0,0,0,0,0,0,0,66.31 ,74.90 ,66.31 
03,011,01,007,0142,0,1531,23,1554,2188,0,0,0,0,0,0,0,66.31 ,71.02 ,66.31 
03,011,01,007,0143,0,991,15,1006,1392,0,0,0,0,0,0,0,66.31 ,72.27 ,66.31 
03,011,01,007,0144,0,602,3,605,837,0,0,0,0,0,0,0,66.31 ,72.28 ,66.31 
03,011,01,007,0145,0,929,11,940,1263,0,0,0,0,0,0,0,66.31 ,74.43 ,66.31 
03,011,01,007,0146,0,408,3,411,517,0,0,0,0,0,0,0,66.31 ,79.50 ,66.31 
03,011,01,007,0147,0,698,7,705,984,0,0,0,0,0,0,0,66.31 ,71.65 ,66.31 
03,011,01,007,0148,0,429,4,433,540,0,0,0,0,0,0,0,66.31 ,80.19 ,66.31 
03,011,01,007,0149,0,763,10,773,1138,0,0,0,0,0,0,0,66.31 ,67.93 ,66.31 
03,011,01,007,0150,0,763,7,770,1016,0,0,0,0,0,0,0,66.31 ,75.79 ,66.31 
03,011,01,007,0151,0,408,4,412,584,0,0,0,0,0,0,0,66.31 ,70.55 ,66.31 
03,011,01,007,0152,0,461,6,467,645,0,0,0,0,0,0,0,66.31 ,72.40 ,66.31 
03,011,01,007,0153,0,513,6,519,687,0,0,0,0,0,0,0,66.31 ,75.55 ,66.31 
03,011,01,007,0154,0,654,11,665,868,0,0,0,0,0,0,0,66.31 ,76.61 ,66.31 
03,011,01,007,0155,0,594,3,597,805,0,0,0,0,0,0,0,66.31 ,74.16 ,66.31 
03,011,01,007,0156,0,604,4,608,809,0,0,0,0,0,0,0,66.31 ,75.15 ,66.31 
03,011,01,007,0157,0,830,6,836,1122,0,0,0,0,0,0,0,66.31 ,74.51 ,66.31 
03,011,01,008,0158,0,672,8,680,1012,0,0,0,0,0,0,0,66.31 ,67.19 ,66.31 
03,011,01,008,0159,0,1663,16,1679,2485,0,0,0,0,0,0,0,66.31 ,67.57 ,66.31 
03,011,01,008,0160,0,814,4,818,1150,0,0,0,0,0,0,0,66.31 ,71.13 ,66.31 
03,011,01,008,0161,0,1058,10,1068,1498,0,0,0,0,0,0,0,66.31 ,71.30 ,66.31 
03,011,01,008,0162,0,1373,12,1385,2033,0,0,0,0,0,0,0,66.31 ,68.13 ,66.31 
03,011,01,008,0163,0,1396,13,1409,2056,0,0,0,0,0,0,0,66.31 ,68.53 ,66.31 
03,011,01,008,0164,0,585,6,591,783,0,0,0,0,0,0,0,66.31 ,75.48 ,66.31 
03,011,01,008,0165,0,579,2,581,799,0,0,0,0,0,0,0,66.31 ,72.72 ,66.31 
03,011,01,008,0166,0,788,12,800,1164,0,0,0,0,0,0,0,66.31 ,68.73 ,66.31 
03,011,01,008,0167,0,743,5,748,1057,0,0,0,0,0,0,0,66.31 ,70.77 ,66.31 
03,011,01,008,0168,0,1193,11,1204,1769,0,0,0,0,0,0,0,66.31 ,68.06 ,66.31 
03,011,01,008,0169,0,666,7,673,893,0,0,0,0,0,0,0,66.31 ,75.36 ,66.31 
03,011,01,008,0170,0,946,14,960,1293,0,0,0,0,0,0,0,66.31 ,74.25 ,66.31 
03,011,01,008,0171,0,805,8,813,1187,0,0,0,0,0,0,0,66.31 ,68.49 ,66.31 
03,011,01,008,0172,0,902,10,912,1213,0,0,0,0,0,0,0,66.31 ,75.19 ,66.31 
03,011,01,009,0173,0,1747,25,1772,2647,0,0,0,0,0,0,0,66.31 ,66.94 ,66.31 
03,011,01,009,0174,0,1566,21,1587,2465,0,0,0,0,0,0,0,66.31 ,64.38 ,66.31 
03,011,01,009,0175,0,849,3,852,1291,0,0,0,0,0,0,0,66.31 ,66.00 ,66.31 
03,011,01,009,0176,0,706,6,712,1051,0,0,0,0,0,0,0,66.31 ,67.75 ,66.31 
03,011,01,009,0177,0,549,10,559,829,0,0,0,0,0,0,0,66.31 ,67.43 ,66.31 
03,011,01,009,0178,0,1738,22,1760,2714,0,0,0,0,0,0,0,66.31 ,64.85 ,66.31 
03,011,01,009,0179,0,1191,18,1209,1755,0,0,0,0,0,0,0,66.31 ,68.89 ,66.31 
03,011,01,009,0180,0,1026,11,1037,1538,0,0,0,0,0,0,0,66.31 ,67.43 ,66.31 
03,011,01,009,0181,0,708,4,712,1047,0,0,0,0,0,0,0,66.31 ,68.00 ,66.31 
03,011,01,009,0182,0,409,1,410,575,0,0,0,0,0,0,0,66.31 ,71.30 ,66.31 
03,011,01,009,0183,0,564,5,569,898,0,0,0,0,0,0,0,66.31 ,63.36 ,66.31 
03,011,01,009,0184,0,477,3,480,764,0,0,0,0,0,0,0,66.31 ,62.83 ,66.31 
03,011,01,010,0185,0,1318,13,1331,1923,0,0,0,0,0,0,0,66.31 ,69.21 ,66.31 
03,011,01,010,0186,0,1533,18,1551,2178,0,0,0,0,0,0,0,66.31 ,71.21 ,66.31 
03,011,01,010,0187,0,759,11,770,1045,0,0,0,0,0,0,0,66.31 ,73.68 ,66.31 
03,011,01,010,0188,0,492,3,495,635,0,0,0,0,0,0,0,66.31 ,77.95 ,66.31 
03,011,01,010,0189,0,329,1,330,496,0,0,0,0,0,0,0,66.31 ,66.53 ,66.31 
03,011,01,010,0190,0,1247,15,1262,1803,0,0,0,0,0,0,0,66.31 ,69.99 ,66.31 
03,011,01,010,0191,0,1892,20,1912,2710,0,0,0,0,0,0,0,66.31 ,70.55 ,66.31 
03,011,01,010,0192,0,648,12,660,1021,0,0,0,0,0,0,0,66.31 ,64.64 ,66.31 
03,011,01,010,0193,0,942,6,948,1380,0,0,0,0,0,0,0,66.31 ,68.70 ,66.31 
03,011,01,010,0194,0,455,5,460,696,0,0,0,0,0,0,0,66.31 ,66.09 ,66.31 
03,011,01,010,0195,0,476,3,479,607,0,0,0,0,0,0,0,66.31 ,78.91 ,66.31 
03,011,01,010,0196,0,1607,21,1628,2235,0,0,0,0,0,0,0,66.31 ,72.84 ,66.31 
03,011,01,010,0197,0,615,6,621,916,0,0,0,0,0,0,0,66.31 ,67.79 ,66.31 
03,011,01,011,0198,0,721,7,728,1145,0,0,0,0,0,0,0,66.31 ,63.58 ,66.31 
03,011,01,011,0199,0,509,8,517,781,0,0,0,0,0,0,0,66.31 ,66.20 ,66.31 
03,011,01,011,0200,0,933,9,942,1464,0,0,0,0,0,0,0,66.31 ,64.34 ,66.31 
03,011,01,011,0201,0,716,7,723,1111,0,0,0,0,0,0,0,66.31 ,65.08 ,66.31 
03,011,01,011,0202,0,576,4,580,838,0,0,0,0,0,0,0,66.31 ,69.21 ,66.31 
03,011,01,011,0203,0,452,13,465,698,0,0,0,0,0,0,0,66.31 ,66.62 ,66.31 
03,011,01,011,0204,0,614,14,628,1062,0,0,0,0,0,0,0,66.31 ,59.13 ,66.31 
03,011,01,011,0205,0,616,5,621,934,0,0,0,0,0,0,0,66.31 ,66.49 ,66.31 
03,011,01,011,0206,0,585,4,589,959,0,0,0,0,0,0,0,66.31 ,61.42 ,66.31 
03,011,01,011,0207,0,430,6,436,646,0,0,0,0,0,0,0,66.31 ,67.49 ,66.31 
03,011,01,012,0208,0,1163,11,1174,1723,0,0,0,0,0,0,0,66.31 ,68.14 ,66.31 
03,011,01,012,0209,0,1660,20,1680,2494,0,0,0,0,0,0,0,66.31 ,67.36 ,66.31 
03,011,01,012,0210,0,2887,20,2907,4171,0,0,0,0,0,0,0,66.31 ,69.70 ,66.31 
03,011,01,012,0211,0,3363,33,3396,5225,0,0,0,0,0,0,0,66.31 ,65.00 ,66.31 
03,011,01,012,0212,0,4590,33,4623,7303,0,0,0,0,0,0,0,66.31 ,63.30 ,66.31 
03,011,01,012,0213,0,1926,15,1941,2944,0,0,0,0,0,0,0,66.31 ,65.93 ,66.31 
03,011,01,012,0214,0,1258,12,1270,1749,0,0,0,0,0,0,0,66.31 ,72.61 ,66.31 
03,011,01,012,0215,0,603,7,610,837,0,0,0,0,0,0,0,66.31 ,72.88 ,66.31 
03,011,01,012,0216,0,928,7,935,1355,0,0,0,0,0,0,0,66.31 ,69.00 ,66.31 
03,011,01,012,0217,0,473,3,476,656,0,0,0,0,0,0,0,66.31 ,72.56 ,66.31 
03,011,01,012,0218,0,279,1,280,370,0,0,0,0,0,0,0,66.31 ,75.68 ,66.31 
03,011,01,012,0219,0,783,9,792,1218,0,0,0,0,0,0,0,66.31 ,65.02 ,66.31 
03,011,01,012,0220,0,417,4,421,596,0,0,0,0,0,0,0,66.31 ,70.64 ,66.31 
03,011,01,012,0221,0,516,6,522,758,0,0,0,0,0,0,0,66.31 ,68.87 ,66.31 
03,011,01,012,0222,0,664,6,670,939,0,0,0,0,0,0,0,66.31 ,71.35 ,66.31 
03,011,01,012,0223,0,733,13,746,1108,0,0,0,0,0,0,0,66.31 ,67.33 ,66.31 
03,011,01,012,0224,0,596,3,599,827,0,0,0,0,0,0,0,66.31 ,72.43 ,66.31 
03,011,01,012,0225,0,741,5,746,979,0,0,0,0,0,0,0,66.31 ,76.20 ,66.31 
03,011,01,012,0226,0,845,14,859,1232,0,0,0,0,0,0,0,66.31 ,69.72 ,66.31 
03,011,01,012,0227,0,1036,11,1047,1497,0,0,0,0,0,0,0,66.31 ,69.94 ,66.31 
03,011,01,012,0228,0,566,5,571,816,0,0,0,0,0,0,0,66.31 ,69.98 ,66.31 
03,011,01,013,0229,0,776,5,781,1124,0,0,0,0,0,0,0,66.31 ,69.48 ,66.31 
03,011,01,013,0230,0,849,6,855,1225,0,0,0,0,0,0,0,66.31 ,69.80 ,66.31 
03,011,01,013,0231,0,348,2,350,515,0,0,0,0,0,0,0,66.31 ,67.96 ,66.31 
03,011,01,013,0232,0,624,2,626,859,0,0,0,0,0,0,0,66.31 ,72.88 ,66.31 
03,011,01,013,0233,0,412,0,412,585,0,0,0,0,0,0,0,66.31 ,70.43 ,66.31 
03,011,01,013,0234,0,2334,17,2351,3315,0,0,0,0,0,0,0,66.31 ,70.92 ,66.31 
03,011,01,013,0235,0,955,5,960,1405,0,0,0,0,0,0,0,66.31 ,68.33 ,66.31 
03,011,01,013,0236,0,894,6,900,1264,0,0,0,0,0,0,0,66.31 ,71.20 ,66.31 
03,011,01,013,0237,0,907,8,915,1320,0,0,0,0,0,0,0,66.31 ,69.32 ,66.31 
03,011,01,013,0238,0,358,3,361,551,0,0,0,0,0,0,0,66.31 ,65.52 ,66.31 
03,011,01,013,0239,0,377,2,379,543,0,0,0,0,0,0,0,66.31 ,69.80 ,66.31 
03,011,01,013,0240,0,534,6,540,815,0,0,0,0,0,0,0,66.31 ,66.26 ,66.31 
03,011,01,013,0241,0,257,1,258,353,0,0,0,0,0,0,0,66.31 ,73.09 ,66.31 
03,011,01,013,0242,0,472,4,476,684,0,0,0,0,0,0,0,66.31 ,69.59 ,66.31 
03,011,01,013,0243,0,222,0,222,335,0,0,0,0,0,0,0,66.31 ,66.27 ,66.31 
03,011,01,013,0244,0,292,5,297,435,0,0,0,0,0,0,0,66.31 ,68.28 ,66.31 
03,011,01,013,0245,0,330,4,334,524,0,0,0,0,0,0,0,66.31 ,63.74 ,66.31 
03,011,01,013,0246,0,228,1,229,341,0,0,0,0,0,0,0,66.31 ,67.16 ,66.31 
03,011,01,013,0247,0,600,5,605,834,0,0,0,0,0,0,0,66.31 ,72.54 ,66.31 
03,011,01,013,0248,0,301,1,302,492,0,0,0,0,0,0,0,66.31 ,61.38 ,66.31 
03,011,01,013,0249,0,727,9,736,1142,0,0,0,0,0,0,0,66.31 ,64.45 ,66.31 
03,011,01,013,0250,0,353,2,355,516,0,0,0,0,0,0,0,66.31 ,68.80 ,66.31 
03,011,01,013,0251,0,451,5,456,722,0,0,0,0,0,0,0,66.31 ,63.16 ,66.31 
03,011,01,013,0252,0,518,3,521,692,0,0,0,0,0,0,0,66.31 ,75.29 ,66.31 
03,011,01,013,0253,0,325,2,327,518,0,0,0,0,0,0,0,66.31 ,63.13 ,66.31 
03,011,01,013,0254,0,340,1,341,479,0,0,0,0,0,0,0,66.31 ,71.19 ,66.31 
03,011,01,014,0255,0,1746,29,1775,2520,0,0,0,0,0,0,0,66.31 ,70.44 ,66.31 
03,011,01,014,0256,0,2169,16,2185,3091,0,0,0,0,0,0,0,66.31 ,70.69 ,66.31 
03,011,01,014,0257,0,1307,23,1330,1853,0,0,0,0,0,0,0,66.31 ,71.78 ,66.31 
03,011,01,014,0258,0,916,8,924,1248,0,0,0,0,0,0,0,66.31 ,74.04 ,66.31 
03,011,01,014,0259,0,1057,17,1074,1528,0,0,0,0,0,0,0,66.31 ,70.29 ,66.31 
03,011,01,014,0260,0,935,10,945,1282,0,0,0,0,0,0,0,66.31 ,73.71 ,66.31 
03,011,01,014,0261,0,860,6,866,1276,0,0,0,0,0,0,0,66.31 ,67.87 ,66.31 
03,011,01,014,0262,0,598,8,606,836,0,0,0,0,0,0,0,66.31 ,72.49 ,66.31 
03,011,01,014,0263,0,798,8,806,1131,0,0,0,0,0,0,0,66.31 ,71.26 ,66.31 
03,011,01,014,0264,0,839,9,848,1160,0,0,0,0,0,0,0,66.31 ,73.10 ,66.31 
03,011,01,014,0265,0,626,2,628,845,0,0,0,0,0,0,0,66.31 ,74.32 ,66.31 
03,011,01,014,0266,0,833,14,847,1150,0,0,0,0,0,0,0,66.31 ,73.65 ,66.31 
03,011,01,015,0267,0,390,5,395,539,0,0,0,0,0,0,0,66.31 ,73.28 ,66.31 
03,011,01,015,0268,0,489,5,494,749,0,0,0,0,0,0,0,66.31 ,65.95 ,66.31 
03,011,01,015,0269,0,392,5,397,496,0,0,0,0,0,0,0,66.31 ,80.04 ,66.31 
03,011,01,015,0270,0,577,6,583,822,0,0,0,0,0,0,0,66.31 ,70.92 ,66.31 
03,011,01,015,0271,0,700,5,705,951,0,0,0,0,0,0,0,66.31 ,74.13 ,66.31 
03,011,01,015,0272,0,418,2,420,580,0,0,0,0,0,0,0,66.31 ,72.41 ,66.31 
03,011,01,015,0273,0,323,4,327,461,0,0,0,0,0,0,0,66.31 ,70.93 ,66.31 
03,011,01,015,0274,0,529,3,532,776,0,0,0,0,0,0,0,66.31 ,68.56 ,66.31 
03,011,01,015,0275,0,1153,11,1164,1646,0,0,0,0,0,0,0,66.31 ,70.72 ,66.31 
03,011,01,015,0276,0,274,0,274,347,0,0,0,0,0,0,0,66.31 ,78.96 ,66.31 
03,011,01,015,0277,0,577,9,586,884,0,0,0,0,0,0,0,66.31 ,66.29 ,66.31 
03,011,01,015,0278,0,554,2,556,780,0,0,0,0,0,0,0,66.31 ,71.28 ,66.31 
03,011,01,015,0279,0,876,11,887,1284,0,0,0,0,0,0,0,66.31 ,69.08 ,66.31 
03,011,01,015,0280,0,711,7,718,967,0,0,0,0,0,0,0,66.31 ,74.25 ,66.31 
03,011,01,015,0281,0,409,5,414,590,0,0,0,0,0,0,0,66.31 ,70.17 ,66.31 
03,011,01,015,0282,0,715,7,722,1005,0,0,0,0,0,0,0,66.31 ,71.84 ,66.31 
03,011,01,015,0283,0,437,0,437,571,0,0,0,0,0,0,0,66.31 ,76.53 ,66.31 
03,011,01,015,0284,0,571,2,573,741,0,0,0,0,0,0,0,66.31 ,77.33 ,66.31 
03,011,01,015,0285,0,699,3,702,943,0,0,0,0,0,0,0,66.31 ,74.44 ,66.31 
03,011,01,015,0286,0,467,7,474,640,0,0,0,0,0,0,0,66.31 ,74.06 ,66.31 
03,011,01,015,0287,0,576,2,578,809,0,0,0,0,0,0,0,66.31 ,71.45 ,66.31 
03,011,01,015,0288,0,1534,15,1549,2012,0,0,0,0,0,0,0,66.31 ,76.99 ,66.31 
03,011,01,015,0289,0,935,5,940,1320,0,0,0,0,0,0,0,66.31 ,71.21 ,66.31 
03,011,01,016,0290,0,620,7,627,856,0,0,0,0,0,0,0,66.31 ,73.25 ,66.31 
03,011,01,016,0291,0,891,6,897,1260,0,0,0,0,0,0,0,66.31 ,71.19 ,66.31 
03,011,01,016,0292,0,764,6,770,1091,0,0,0,0,0,0,0,66.31 ,70.58 ,66.31 
03,011,01,016,0293,0,1021,2,1023,1439,0,0,0,0,0,0,0,66.31 ,71.09 ,66.31 
03,011,01,016,0294,0,669,4,673,903,0,0,0,0,0,0,0,66.31 ,74.53 ,66.31 
03,011,01,016,0295,0,773,1,774,1049,0,0,0,0,0,0,0,66.31 ,73.78 ,66.31 
03,011,01,016,0296,0,679,4,683,1044,0,0,0,0,0,0,0,66.31 ,65.42 ,66.31 
03,011,01,016,0297,0,501,3,504,806,0,0,0,0,0,0,0,66.31 ,62.53 ,66.31 
03,011,01,016,0298,0,447,7,454,662,0,0,0,0,0,0,0,66.31 ,68.58 ,66.31 
03,011,01,016,0299,0,472,3,475,748,0,0,0,0,0,0,0,66.31 ,63.50 ,66.31 
03,011,01,016,0300,0,456,0,456,646,0,0,0,0,0,0,0,66.31 ,70.59 ,66.31 
03,011,01,016,0301,0,273,0,273,437,0,0,0,0,0,0,0,66.31 ,62.47 ,66.31 
03,011,01,016,0302,0,604,1,605,915,0,0,0,0,0,0,0,66.31 ,66.12 ,66.31 
03,011,01,016,0303,0,472,4,476,754,0,0,0,0,0,0,0,66.31 ,63.13 ,66.31 
03,011,01,016,0304,0,910,6,916,1416,0,0,0,0,0,0,0,66.31 ,64.69 ,66.31 
03,011,01,016,0305,0,807,7,814,1207,0,0,0,0,0,0,0,66.31 ,67.44 ,66.31 
03,011,01,016,0306,0,1203,7,1210,1922,0,0,0,0,0,0,0,66.31 ,62.96 ,66.31 
03,011,01,016,0307,0,543,5,548,988,0,0,0,0,0,0,0,66.31 ,55.47 ,66.31 
03,011,01,017,0308,0,671,7,678,933,0,0,0,0,0,0,0,66.31 ,72.67 ,66.31 
03,011,01,017,0309,0,355,2,357,502,0,0,0,0,0,0,0,66.31 ,71.12 ,66.31 
03,011,01,017,0310,0,285,2,287,423,0,0,0,0,0,0,0,66.31 ,67.85 ,66.31 
03,011,01,017,0311,0,564,6,570,828,0,0,0,0,0,0,0,66.31 ,68.84 ,66.31 
03,011,01,017,0312,0,852,11,863,1286,0,0,0,0,0,0,0,66.31 ,67.11 ,66.31 
03,011,01,017,0313,0,438,4,442,691,0,0,0,0,0,0,0,66.31 ,63.97 ,66.31 
03,011,01,017,0314,0,514,4,518,773,0,0,0,0,0,0,0,66.31 ,67.01 ,66.31 
03,011,01,017,0315,0,356,0,356,595,0,0,0,0,0,0,0,66.31 ,59.83 ,66.31 
03,011,01,017,0316,0,748,8,756,1122,0,0,0,0,0,0,0,66.31 ,67.38 ,66.31 
03,011,01,017,0317,0,457,4,461,635,0,0,0,0,0,0,0,66.31 ,72.60 ,66.31 
03,011,01,017,0318,0,824,3,827,1154,0,0,0,0,0,0,0,66.31 ,71.66 ,66.31 
03,011,01,017,0319,0,499,4,503,728,0,0,0,0,0,0,0,66.31 ,69.09 ,66.31 
03,011,01,017,0320,0,484,4,488,722,0,0,0,0,0,0,0,66.31 ,67.59 ,66.31 
03,011,01,018,0321,0,1032,20,1052,1566,0,0,0,0,0,0,0,66.31 ,67.18 ,66.31 
03,011,01,018,0322,0,2286,25,2311,3594,0,0,0,0,0,0,0,66.31 ,64.30 ,66.31 
03,011,01,018,0323,0,950,15,965,1546,0,0,0,0,0,0,0,66.31 ,62.42 ,66.31 
03,011,01,018,0324,0,2332,37,2369,3370,0,0,0,0,0,0,0,66.31 ,70.30 ,66.31 
03,011,01,018,0325,0,291,4,295,429,0,0,0,0,0,0,0,66.31 ,68.76 ,66.31 
03,011,01,018,0326,0,421,8,429,632,0,0,0,0,0,0,0,66.31 ,67.88 ,66.31 
03,011,01,018,0327,0,351,11,362,462,0,0,0,0,0,0,0,66.31 ,78.35 ,66.31 
03,011,01,018,0328,0,662,5,667,960,0,0,0,0,0,0,0,66.31 ,69.48 ,66.31 
03,011,01,018,0329,0,1767,26,1793,2795,0,0,0,0,0,0,0,66.31 ,64.15 ,66.31 
03,011,01,018,0330,0,957,21,978,1487,0,0,0,0,0,0,0,66.31 ,65.77 ,66.31 
03,011,01,018,0331,0,747,5,752,1041,0,0,0,0,0,0,0,66.31 ,72.24 ,66.31 
03,011,01,018,0332,0,1535,23,1558,2177,0,0,0,0,0,0,0,66.31 ,71.57 ,66.31 
03,011,01,018,0333,0,1118,11,1129,1710,0,0,0,0,0,0,0,66.31 ,66.02 ,66.31 
03,011,01,018,0334,0,1224,22,1246,1662,0,0,0,0,0,0,0,66.31 ,74.97 ,66.31 
03,011,01,018,0335,0,1346,24,1370,2050,0,0,0,0,0,0,0,66.31 ,66.83 ,66.31 
03,011,01,018,0336,0,870,14,884,1200,0,0,0,0,0,0,0,66.31 ,73.67 ,66.31 
03,011,01,018,0337,0,379,7,386,529,0,0,0,0,0,0,0,66.31 ,72.97 ,66.31 
03,011,01,018,0338,0,1346,26,1372,1964,0,0,0,0,0,0,0,66.31 ,69.86 ,66.31 
03,011,01,018,0339,0,574,11,585,859,0,0,0,0,0,0,0,66.31 ,68.10 ,66.31 
03,011,01,018,0340,0,687,10,697,1077,0,0,0,0,0,0,0,66.31 ,64.72 ,66.31 
03,011,01,019,0341,0,567,4,571,954,0,0,0,0,0,0,0,66.31 ,59.85 ,66.31 
03,011,01,019,0342,0,1550,22,1572,2453,0,0,0,0,0,0,0,66.31 ,64.08 ,66.31 
03,011,01,019,0343,0,2285,35,2320,3742,0,0,0,0,0,0,0,66.31 ,62.00 ,66.31 
03,011,01,019,0344,0,1185,12,1197,1927,0,0,0,0,0,0,0,66.31 ,62.12 ,66.31 
03,011,01,019,0345,0,809,12,821,1272,0,0,0,0,0,0,0,66.31 ,64.54 ,66.31 
03,011,01,019,0346,0,406,5,411,654,0,0,0,0,0,0,0,66.31 ,62.84 ,66.31 
03,011,01,019,0347,0,328,4,332,486,0,0,0,0,0,0,0,66.31 ,68.31 ,66.31 
03,011,01,019,0348,0,664,6,670,1075,0,0,0,0,0,0,0,66.31 ,62.33 ,66.31 
03,011,01,019,0349,0,837,10,847,1263,0,0,0,0,0,0,0,66.31 ,67.06 ,66.31 
03,011,01,019,0350,0,1320,19,1339,1923,0,0,0,0,0,0,0,66.31 ,69.63 ,66.31 
03,011,01,019,0351,0,551,6,557,851,0,0,0,0,0,0,0,66.31 ,65.45 ,66.31 
03,011,01,019,0352,0,1076,16,1092,1600,0,0,0,0,0,0,0,66.31 ,68.25 ,66.31 
03,011,01,019,0353,0,441,4,445,659,0,0,0,0,0,0,0,66.31 ,67.53 ,66.31 
03,011,01,019,0354,0,718,12,730,1047,0,0,0,0,0,0,0,66.31 ,69.72 ,66.31 
03,011,01,019,0355,0,1164,11,1175,1654,0,0,0,0,0,0,0,66.31 ,71.04 ,66.31 
03,011,01,019,0356,0,577,6,583,809,0,0,0,0,0,0,0,66.31 ,72.06 ,66.31 
03,011,01,019,0357,0,671,8,679,980,0,0,0,0,0,0,0,66.31 ,69.29 ,66.31 
03,011,01,019,0358,0,934,5,939,1382,0,0,0,0,0,0,0,66.31 ,67.95 ,66.31 
03,011,01,019,0359,0,902,15,917,1352,0,0,0,0,0,0,0,66.31 ,67.83 ,66.31 
03,011,01,019,0360,0,645,7,652,988,0,0,0,0,0,0,0,66.31 ,65.99 ,66.31 
03,011,01,019,0361,0,1501,17,1518,2447,0,0,0,0,0,0,0,66.31 ,62.04 ,66.31 
03,011,01,020,0362,0,1389,19,1408,2238,0,0,0,0,0,0,0,66.31 ,62.91 ,66.31 
03,011,01,020,0363,0,2911,36,2947,4796,0,0,0,0,0,0,0,66.31 ,61.45 ,66.31 
03,011,01,020,0364,0,1202,12,1214,1757,0,0,0,0,0,0,0,66.31 ,69.10 ,66.31 
03,011,01,020,0365,0,437,5,442,597,0,0,0,0,0,0,0,66.31 ,74.04 ,66.31 
03,011,01,020,0366,0,502,4,506,829,0,0,0,0,0,0,0,66.31 ,61.04 ,66.31 
03,011,01,020,0367,0,604,12,616,913,0,0,0,0,0,0,0,66.31 ,67.47 ,66.31 
03,011,01,020,0368,0,1507,18,1525,2135,0,0,0,0,0,0,0,66.31 ,71.43 ,66.31 
03,011,01,020,0369,0,2001,32,2033,2994,0,0,0,0,0,0,0,66.31 ,67.90 ,66.31 
03,011,01,020,0370,0,911,15,926,1394,0,0,0,0,0,0,0,66.31 ,66.43 ,66.31 
03,011,01,020,0371,0,1663,20,1683,2631,0,0,0,0,0,0,0,66.31 ,63.97 ,66.31 
03,011,01,020,0372,0,1180,9,1189,1856,0,0,0,0,0,0,0,66.31 ,64.06 ,66.31 
03,011,01,021,0373,0,1364,12,1376,1992,0,0,0,0,0,0,0,66.31 ,69.08 ,66.31 
03,011,01,021,0374,0,1078,18,1096,1718,0,0,0,0,0,0,0,66.31 ,63.80 ,66.31 
03,011,01,021,0375,0,851,15,866,1322,0,0,0,0,0,0,0,66.31 ,65.51 ,66.31 
03,011,01,021,0376,0,777,8,785,1110,0,0,0,0,0,0,0,66.31 ,70.72 ,66.31 
03,011,01,021,0377,0,506,5,511,722,0,0,0,0,0,0,0,66.31 ,70.78 ,66.31 
03,011,01,021,0378,0,972,8,980,1424,0,0,0,0,0,0,0,66.31 ,68.82 ,66.31 
03,011,01,021,0379,0,666,7,673,977,0,0,0,0,0,0,0,66.31 ,68.88 ,66.31 
03,011,01,021,0380,0,1396,14,1410,1991,0,0,0,0,0,0,0,66.31 ,70.82 ,66.31 
03,011,01,021,0381,0,1380,19,1399,2067,0,0,0,0,0,0,0,66.31 ,67.68 ,66.31 
03,011,01,021,0382,0,481,5,486,617,0,0,0,0,0,0,0,66.31 ,78.77 ,66.31 
03,011,01,021,0383,0,891,11,902,1289,0,0,0,0,0,0,0,66.31 ,69.98 ,66.31 
03,011,01,021,0384,0,491,7,498,694,0,0,0,0,0,0,0,66.31 ,71.76 ,66.31 
03,011,01,021,0385,0,1061,8,1069,1534,0,0,0,0,0,0,0,66.31 ,69.69 ,66.31 
03,011,01,021,0386,0,1580,11,1591,2082,0,0,0,0,0,0,0,66.31 ,76.42 ,66.31 
03,011,01,021,0387,0,614,6,620,891,0,0,0,0,0,0,0,66.31 ,69.58 ,66.31 
03,011,01,021,0388,0,353,6,359,449,0,0,0,0,0,0,0,66.31 ,79.96 ,66.31 
03,011,01,022,0389,0,1074,15,1089,1672,0,0,0,0,0,0,0,66.31 ,65.13 ,66.31 
03,011,01,022,0390,0,1081,7,1088,1490,0,0,0,0,0,0,0,66.31 ,73.02 ,66.31 
03,011,01,022,0391,0,567,9,576,839,0,0,0,0,0,0,0,66.31 ,68.65 ,66.31 
03,011,01,022,0392,0,479,7,486,736,0,0,0,0,0,0,0,66.31 ,66.03 ,66.31 
03,011,01,022,0393,0,368,7,375,574,0,0,0,0,0,0,0,66.31 ,65.33 ,66.31 
03,011,01,022,0394,0,268,6,274,369,0,0,0,0,0,0,0,66.31 ,74.25 ,66.31 
03,011,01,022,0395,0,211,3,214,323,0,0,0,0,0,0,0,66.31 ,66.25 ,66.31 
03,011,01,023,0396,0,685,7,692,976,0,0,0,0,0,0,0,66.31 ,70.90 ,66.31 
03,011,01,023,0397,0,2805,25,2830,3965,0,0,0,0,0,0,0,66.31 ,71.37 ,66.31 
03,011,01,023,0398,0,942,10,952,1288,0,0,0,0,0,0,0,66.31 ,73.91 ,66.31 
03,011,01,023,0399,0,835,9,844,1319,0,0,0,0,0,0,0,66.31 ,63.99 ,66.31 
03,011,01,023,0400,0,324,5,329,481,0,0,0,0,0,0,0,66.31 ,68.40 ,66.31 
03,011,01,023,0401,0,314,3,317,512,0,0,0,0,0,0,0,66.31 ,61.91 ,66.31 
03,011,01,023,0402,0,551,2,553,766,0,0,0,0,0,0,0,66.31 ,72.19 ,66.31 
03,011,01,023,0403,0,1069,13,1082,1543,0,0,0,0,0,0,0,66.31 ,70.12 ,66.31 
03,011,01,023,0404,0,562,4,566,727,0,0,0,0,0,0,0,66.31 ,77.85 ,66.31 
03,011,01,023,0405,0,731,4,735,1037,0,0,0,0,0,0,0,66.31 ,70.88 ,66.31 
03,011,01,024,0406,0,1303,15,1318,1950,0,0,0,0,0,0,0,66.31 ,67.59 ,66.31 
03,011,01,024,0407,0,882,6,888,1298,0,0,0,0,0,0,0,66.31 ,68.41 ,66.31 
03,011,01,024,0408,0,610,10,620,899,0,0,0,0,0,0,0,66.31 ,68.97 ,66.31 
03,011,01,024,0409,0,705,14,719,1062,0,0,0,0,0,0,0,66.31 ,67.70 ,66.31 
03,011,01,024,0410,0,776,6,782,1082,0,0,0,0,0,0,0,66.31 ,72.27 ,66.31 
03,011,01,024,0411,0,542,3,545,730,0,0,0,0,0,0,0,66.31 ,74.66 ,66.31 
03,011,01,024,0412,0,1644,14,1658,2265,0,0,0,0,0,0,0,66.31 ,73.20 ,66.31 
03,011,01,025,0413,0,1005,7,1012,1406,0,0,0,0,0,0,0,66.31 ,71.98 ,66.31 
03,011,01,025,0414,0,578,7,585,809,0,0,0,0,0,0,0,66.31 ,72.31 ,66.31 
03,011,01,025,0415,0,473,3,476,690,0,0,0,0,0,0,0,66.31 ,68.99 ,66.31 
03,011,01,025,0416,0,389,2,391,514,0,0,0,0,0,0,0,66.31 ,76.07 ,66.31 
03,011,01,025,0417,0,463,3,466,582,0,0,0,0,0,0,0,66.31 ,80.07 ,66.31 
03,011,01,025,0418,0,618,9,627,836,0,0,0,0,0,0,0,66.31 ,75.00 ,66.31 
03,011,01,025,0419,0,875,6,881,1237,0,0,0,0,0,0,0,66.31 ,71.22 ,66.31 
03,011,01,025,0420,0,676,6,682,942,0,0,0,0,0,0,0,66.31 ,72.40 ,66.31 
03,011,01,025,0421,0,300,4,304,534,0,0,0,0,0,0,0,66.31 ,56.93 ,66.31 
03,011,01,026,0422,0,322,1,323,457,0,0,0,0,0,0,0,66.31 ,70.68 ,66.31 
03,011,01,026,0423,0,530,4,534,719,0,0,0,0,0,0,0,66.31 ,74.27 ,66.31 
03,011,01,026,0424,0,408,7,415,557,0,0,0,0,0,0,0,66.31 ,74.51 ,66.31 
03,011,01,026,0425,0,689,6,695,916,0,0,0,0,0,0,0,66.31 ,75.87 ,66.31 
03,011,01,026,0426,0,277,2,279,354,0,0,0,0,0,0,0,66.31 ,78.81 ,66.31 
03,011,01,026,0427,0,361,3,364,475,0,0,0,0,0,0,0,66.31 ,76.63 ,66.31 
03,011,01,026,0428,0,305,7,312,433,0,0,0,0,0,0,0,66.31 ,72.06 ,66.31 
03,011,01,026,0429,0,209,1,210,295,0,0,0,0,0,0,0,66.31 ,71.19 ,66.31 
03,011,01,026,0430,0,180,4,184,238,0,0,0,0,0,0,0,66.31 ,77.31 ,66.31 
03,011,01,026,0431,0,414,7,421,593,0,0,0,0,0,0,0,66.31 ,70.99 ,66.31 
03,011,01,027,0432,0,2272,33,2305,3718,0,0,0,0,0,0,0,66.31 ,62.00 ,66.31 
03,011,01,027,0433,0,1257,10,1267,2106,0,0,0,0,0,0,0,66.31 ,60.16 ,66.31 
03,011,01,027,0434,0,1034,8,1042,1663,0,0,0,0,0,0,0,66.31 ,62.66 ,66.31 
03,011,01,027,0435,0,1980,37,2017,3419,0,0,0,0,0,0,0,66.31 ,58.99 ,66.31 
03,011,01,027,0436,0,3649,45,3694,5807,0,0,0,0,0,0,0,66.31 ,63.61 ,66.31 
03,011,01,027,0437,0,1428,21,1449,2337,0,0,0,0,0,0,0,66.31 ,62.00 ,66.31 
03,011,01,027,0438,0,3212,37,3249,5476,0,0,0,0,0,0,0,66.31 ,59.33 ,66.31 
03,011,01,027,0439,0,2185,31,2216,3674,0,0,0,0,0,0,0,66.31 ,60.32 ,66.31 
03,011,01,027,0440,0,938,10,948,1249,0,0,0,0,0,0,0,66.31 ,75.90 ,66.31 
03,011,01,027,0441,0,531,5,536,662,0,0,0,0,0,0,0,66.31 ,80.97 ,66.31 
03,011,01,027,0442,0,1242,15,1257,2053,0,0,0,0,0,0,0,66.31 ,61.23 ,66.31 
03,011,01,027,0443,0,2259,41,2300,3467,0,0,0,0,0,0,0,66.31 ,66.34 ,66.31 
03,011,01,027,0444,0,826,23,849,1197,0,0,0,0,0,0,0,66.31 ,70.93 ,66.31 
03,011,01,027,0445,0,1292,20,1312,1947,0,0,0,0,0,0,0,66.31 ,67.39 ,66.31 
03,011,01,027,0446,0,1450,29,1479,1965,0,0,0,0,0,0,0,66.31 ,75.27 ,66.31 
03,011,01,027,0447,0,1382,22,1404,1850,0,0,0,0,0,0,0,66.31 ,75.89 ,66.31 
03,011,01,027,0448,0,828,10,838,1193,0,0,0,0,0,0,0,66.31 ,70.24 ,66.31 
03,011,01,027,0449,0,978,16,994,1373,0,0,0,0,0,0,0,66.31 ,72.40 ,66.31 
03,011,01,028,0450,0,2639,26,2665,4091,0,0,0,0,0,0,0,66.31 ,65.14 ,66.31 
03,011,01,028,0451,0,1563,12,1575,2458,0,0,0,0,0,0,0,66.31 ,64.08 ,66.31 
03,011,01,028,0452,0,2869,35,2904,4547,0,0,0,0,0,0,0,66.31 ,63.87 ,66.31 
03,011,01,028,0453,0,3064,24,3088,4713,0,0,0,0,0,0,0,66.31 ,65.52 ,66.31 
03,011,01,028,0454,0,2742,23,2765,4146,0,0,0,0,0,0,0,66.31 ,66.69 ,66.31 
03,011,01,028,0455,0,1743,17,1760,2577,0,0,0,0,0,0,0,66.31 ,68.30 ,66.31 
03,011,01,028,0456,0,909,9,918,1258,0,0,0,0,0,0,0,66.31 ,72.97 ,66.31 
03,011,01,028,0457,0,866,12,878,1258,0,0,0,0,0,0,0,66.31 ,69.79 ,66.31 
03,011,01,028,0458,0,1276,11,1287,1785,0,0,0,0,0,0,0,66.31 ,72.10 ,66.31 
03,011,01,028,0459,0,380,4,384,533,0,0,0,0,0,0,0,66.31 ,72.05 ,66.31 
03,011,01,028,0460,0,1167,4,1171,1620,0,0,0,0,0,0,0,66.31 ,72.28 ,66.31 
03,011,01,028,0461,0,814,16,830,1247,0,0,0,0,0,0,0,66.31 ,66.56 ,66.31 
03,011,01,028,0462,0,1203,7,1210,1780,0,0,0,0,0,0,0,66.31 ,67.98 ,66.31 
03,011,01,028,0463,0,1229,18,1247,1860,0,0,0,0,0,0,0,66.31 ,67.04 ,66.31 
03,011,01,028,0464,0,1143,13,1156,1776,0,0,0,0,0,0,0,66.31 ,65.09 ,66.31 
03,011,01,028,0465,0,1231,13,1244,1792,0,0,0,0,0,0,0,66.31 ,69.42 ,66.31 
03,011,01,028,0466,0,899,17,916,1278,0,0,0,0,0,0,0,66.31 ,71.67 ,66.31 
03,011,01,028,0467,0,1295,16,1311,2088,0,0,0,0,0,0,0,66.31 ,62.79 ,66.31 
03,011,01,029,0468,0,1206,13,1219,1804,0,0,0,0,0,0,0,66.31 ,67.57 ,66.31 
03,011,01,029,0469,0,1158,11,1169,1756,0,0,0,0,0,0,0,66.31 ,66.57 ,66.31 
03,011,01,029,0470,0,2188,14,2202,3397,0,0,0,0,0,0,0,66.31 ,64.82 ,66.31 
03,011,01,029,0471,0,1662,14,1676,2442,0,0,0,0,0,0,0,66.31 ,68.63 ,66.31 
03,011,01,029,0472,0,575,8,583,832,0,0,0,0,0,0,0,66.31 ,70.07 ,66.31 
03,011,01,029,0473,0,525,3,528,748,0,0,0,0,0,0,0,66.31 ,70.59 ,66.31 
03,011,01,029,0474,0,1684,30,1714,2500,0,0,0,0,0,0,0,66.31 ,68.56 ,66.31 
03,011,01,029,0475,0,1845,14,1859,2775,0,0,0,0,0,0,0,66.31 ,66.99 ,66.31 
03,011,01,029,0476,0,1334,10,1344,1893,0,0,0,0,0,0,0,66.31 ,71.00 ,66.31 
03,011,01,029,0477,0,890,7,897,1342,0,0,0,0,0,0,0,66.31 ,66.84 ,66.31 
03,011,01,029,0478,0,1344,9,1353,2066,0,0,0,0,0,0,0,66.31 ,65.49 ,66.31 
03,011,01,029,0479,0,994,13,1007,1454,0,0,0,0,0,0,0,66.31 ,69.26 ,66.31 
03,011,01,029,0480,0,786,9,795,1181,0,0,0,0,0,0,0,66.31 ,67.32 ,66.31 
03,011,01,029,0481,0,542,6,548,746,0,0,0,0,0,0,0,66.31 ,73.46 ,66.31 
03,011,01,029,0482,0,582,1,583,745,0,0,0,0,0,0,0,66.31 ,78.26 ,66.31 
03,011,01,029,0483,0,941,10,951,1443,0,0,0,0,0,0,0,66.31 ,65.90 ,66.31 
03,011,01,029,0484,0,297,1,298,388,0,0,0,0,0,0,0,66.31 ,76.80 ,66.31 
03,011,01,030,0485,0,817,2,819,1175,0,0,0,0,0,0,0,66.31 ,69.70 ,66.31 
03,011,01,030,0486,0,514,4,518,696,0,0,0,0,0,0,0,66.31 ,74.43 ,66.31 
03,011,01,030,0487,0,102,0,102,212,0,0,0,0,0,0,0,66.31 ,48.11 ,66.31 
03,011,01,030,0488,0,235,3,238,301,0,0,0,0,0,0,0,66.31 ,79.07 ,66.31 
03,011,01,030,0489,0,217,1,218,285,0,0,0,0,0,0,0,66.31 ,76.49 ,66.31 
03,011,01,030,0490,0,216,1,217,302,0,0,0,0,0,0,0,66.31 ,71.85 ,66.31 
03,011,01,030,0491,0,331,1,332,455,0,0,0,0,0,0,0,66.31 ,72.97 ,66.31 
03,011,01,030,0492,0,279,1,280,377,0,0,0,0,0,0,0,66.31 ,74.27 ,66.31 
03,011,01,031,0493,0,1857,22,1879,3565,0,0,0,0,0,0,0,66.31 ,52.71 ,66.31 
03,011,01,031,0494,0,1367,14,1381,2480,0,0,0,0,0,0,0,66.31 ,55.69 ,66.31 
03,011,01,031,0495,0,1282,23,1305,2627,0,0,0,0,0,0,0,66.31 ,49.68 ,66.31 
03,011,01,031,0496,0,1846,22,1868,3395,0,0,0,0,0,0,0,66.31 ,55.02 ,66.31 
03,011,01,031,0497,0,2615,26,2641,5118,0,0,0,0,0,0,0,66.31 ,51.60 ,66.31 
03,011,01,031,0498,0,2864,31,2895,5076,0,0,0,0,0,0,0,66.31 ,57.03 ,66.31 
03,011,01,031,0499,0,2476,37,2513,4505,0,0,0,0,0,0,0,66.31 ,55.78 ,66.31 
03,011,01,031,0500,0,2880,43,2923,5158,0,0,0,0,0,0,0,66.31 ,56.67 ,66.31 
03,011,01,031,0501,0,1914,16,1930,3743,0,0,0,0,0,0,0,66.31 ,51.56 ,66.31 
03,011,01,031,0502,0,1174,11,1185,2105,0,0,0,0,0,0,0,66.31 ,56.29 ,66.31 
03,011,01,031,0503,0,1182,19,1201,2179,0,0,0,0,0,0,0,66.31 ,55.12 ,66.31 
03,011,01,031,0504,0,1125,14,1139,2252,0,0,0,0,0,0,0,66.31 ,50.58 ,66.31 
03,011,01,031,0505,0,860,10,870,1325,0,0,0,0,0,0,0,66.31 ,65.66 ,66.31 
03,011,01,031,0506,0,704,5,709,1065,0,0,0,0,0,0,0,66.31 ,66.57 ,66.31 
03,011,01,031,0507,0,2793,34,2827,5414,0,0,0,0,0,0,0,66.31 ,52.22 ,66.31 
03,011,01,031,0508,0,2191,27,2218,3917,0,0,0,0,0,0,0,66.31 ,56.62 ,66.31 
03,011,01,031,0509,0,1462,18,1480,2179,0,0,0,0,0,0,0,66.31 ,67.92 ,66.31 
03,011,01,031,0510,0,1703,13,1716,2991,0,0,0,0,0,0,0,66.31 ,57.37 ,66.31 
03,011,01,031,0511,0,3010,27,3037,5578,0,0,0,0,0,0,0,66.31 ,54.45 ,66.31 
03,011,01,031,0512,0,1115,7,1122,1679,0,0,0,0,0,0,0,66.31 ,66.83 ,66.31 
03,011,01,031,0513,0,788,5,793,1306,0,0,0,0,0,0,0,66.31 ,60.72 ,66.31 
03,011,01,031,0514,0,1978,31,2009,3384,0,0,0,0,0,0,0,66.31 ,59.37 ,66.31 
03,011,01,031,0515,0,735,6,741,1186,0,0,0,0,0,0,0,66.31 ,62.48 ,66.31 
03,011,01,031,0516,0,1905,23,1928,2785,0,0,0,0,0,0,0,66.31 ,69.23 ,66.31 
03,011,01,031,0517,0,1733,29,1762,2839,0,0,0,0,0,0,0,66.31 ,62.06 ,66.31 
03,011,01,031,0518,0,2604,38,2642,4380,0,0,0,0,0,0,0,66.31 ,60.32 ,66.31 
03,011,01,031,0519,0,2136,12,2148,3256,0,0,0,0,0,0,0,66.31 ,65.97 ,66.31 
03,011,01,031,0520,0,2918,33,2951,4787,0,0,0,0,0,0,0,66.31 ,61.65 ,66.31 
03,011,01,031,0521,0,2726,40,2766,4594,0,0,0,0,0,0,0,66.31 ,60.21 ,66.31 
03,011,01,031,0522,0,1154,31,1185,1810,0,0,0,0,0,0,0,66.31 ,65.47 ,66.31 
03,011,01,031,0523,0,1313,21,1334,1991,0,0,0,0,0,0,0,66.31 ,67.00 ,66.31 
03,011,01,031,0524,0,1245,15,1260,1987,0,0,0,0,0,0,0,66.31 ,63.41 ,66.31 
03,011,01,031,0525,0,4453,57,4510,8866,0,0,0,0,0,0,0,66.31 ,50.87 ,66.31 
03,011,01,031,0526,0,786,6,792,1214,0,0,0,0,0,0,0,66.31 ,65.24 ,66.31 
03,011,01,031,0527,0,1098,13,1111,1761,0,0,0,0,0,0,0,66.31 ,63.09 ,66.31 
03,011,01,031,0528,0,1350,21,1371,2196,0,0,0,0,0,0,0,66.31 ,62.43 ,66.31 
03,011,01,031,0529,0,959,7,966,1807,0,0,0,0,0,0,0,66.31 ,53.46 ,66.31 
03,011,01,031,0530,0,1605,18,1623,2682,0,0,0,0,0,0,0,66.31 ,60.51 ,66.31 
03,011,01,031,0531,0,2215,30,2245,4168,0,0,0,0,0,0,0,66.31 ,53.86 ,66.31 
03,012,01,001,0001,0,816,9,825,1300,0,0,0,0,0,0,0,66.31 ,63.46 ,66.31 
03,012,01,001,0002,0,573,3,576,870,0,0,0,0,0,0,0,66.31 ,66.21 ,66.31 
03,012,01,001,0003,0,1495,17,1512,2327,0,0,0,0,0,0,0,66.31 ,64.98 ,66.31 
03,012,01,001,0004,0,3160,40,3200,4905,0,0,0,0,0,0,0,66.31 ,65.24 ,66.31 
03,012,01,001,0005,0,2380,43,2423,3682,0,0,0,0,0,0,0,66.31 ,65.81 ,66.31 
03,012,01,001,0006,0,2521,42,2563,3880,0,0,0,0,0,0,0,66.31 ,66.06 ,66.31 
03,012,01,001,0007,0,1316,15,1331,2230,0,0,0,0,0,0,0,66.31 ,59.69 ,66.31 
03,012,01,001,0008,0,1833,30,1863,2868,0,0,0,0,0,0,0,66.31 ,64.96 ,66.31 
03,012,01,001,0009,0,1414,23,1437,2197,0,0,0,0,0,0,0,66.31 ,65.41 ,66.31 
03,012,01,001,0010,0,2549,31,2580,3984,0,0,0,0,0,0,0,66.31 ,64.76 ,66.31 
03,012,01,001,0011,0,3017,40,3057,4637,0,0,0,0,0,0,0,66.31 ,65.93 ,66.31 
03,012,01,001,0012,0,2252,23,2275,4077,0,0,0,0,0,0,0,66.31 ,55.80 ,66.31 
03,012,01,001,0013,0,1350,11,1361,2033,0,0,0,0,0,0,0,66.31 ,66.95 ,66.31 
03,012,01,001,0014,0,2662,34,2696,4625,0,0,0,0,0,0,0,66.31 ,58.29 ,66.31 
03,012,01,001,0015,0,571,6,577,817,0,0,0,0,0,0,0,66.31 ,70.62 ,66.31 
03,012,01,001,0016,0,362,4,366,525,0,0,0,0,0,0,0,66.31 ,69.71 ,66.31 
03,012,01,001,0017,0,950,9,959,1374,0,0,0,0,0,0,0,66.31 ,69.80 ,66.31 
03,012,01,001,0018,0,1053,13,1066,1596,0,0,0,0,0,0,0,66.31 ,66.79 ,66.31 
03,012,01,001,0019,0,2897,25,2922,4412,0,0,0,0,0,0,0,66.31 ,66.23 ,66.31 
03,012,01,001,0020,0,644,11,655,1008,0,0,0,0,0,0,0,66.31 ,64.98 ,66.31 
03,012,01,001,0021,0,794,8,802,1099,0,0,0,0,0,0,0,66.31 ,72.98 ,66.31 
03,012,01,001,0022,0,850,9,859,1166,0,0,0,0,0,0,0,66.31 ,73.67 ,66.31 
03,012,01,001,0023,0,2385,26,2411,3601,0,0,0,0,0,0,0,66.31 ,66.95 ,66.31 
03,012,01,001,0024,0,560,1,561,807,0,0,0,0,0,0,0,66.31 ,69.52 ,66.31 
03,012,01,001,0025,0,2275,24,2299,3354,0,0,0,0,0,0,0,66.31 ,68.55 ,66.31 
03,012,01,001,0026,0,2287,19,2306,3526,0,0,0,0,0,0,0,66.31 ,65.40 ,66.31 
03,012,01,001,0027,0,3178,31,3209,4937,0,0,0,0,0,0,0,66.31 ,65.00 ,66.31 
03,012,01,001,0028,0,2107,21,2128,3177,0,0,0,0,0,0,0,66.31 ,66.98 ,66.31 
03,012,01,001,0029,0,735,7,742,1063,0,0,0,0,0,0,0,66.31 ,69.80 ,66.31 
03,012,01,001,0030,0,397,3,400,606,0,0,0,0,0,0,0,66.31 ,66.01 ,66.31 
03,012,01,001,0031,0,999,11,1010,1452,0,0,0,0,0,0,0,66.31 ,69.56 ,66.31 
03,012,01,001,0032,0,1399,21,1420,2203,0,0,0,0,0,0,0,66.31 ,64.46 ,66.31 
03,012,01,001,0033,0,3160,40,3200,4798,0,0,0,0,0,0,0,66.31 ,66.69 ,66.31 
03,012,01,001,0034,0,2170,31,2201,3435,0,0,0,0,0,0,0,66.31 ,64.08 ,66.31 
03,012,01,001,0035,0,2129,20,2149,3342,0,0,0,0,0,0,0,66.31 ,64.30 ,66.31 
03,012,01,001,0036,0,1391,16,1407,2059,0,0,0,0,0,0,0,66.31 ,68.33 ,66.31 
03,012,01,001,0037,0,919,10,929,1577,0,0,0,0,0,0,0,66.31 ,58.91 ,66.31 
03,012,01,001,0038,0,1410,24,1434,2194,0,0,0,0,0,0,0,66.31 ,65.36 ,66.31 
03,012,01,001,0039,0,2379,31,2410,3587,0,0,0,0,0,0,0,66.31 ,67.19 ,66.31 
03,012,01,001,0040,0,2854,27,2881,4281,0,0,0,0,0,0,0,66.31 ,67.30 ,66.31 
03,012,01,001,0041,0,666,7,673,902,0,0,0,0,0,0,0,66.31 ,74.61 ,66.31 
03,012,01,001,0042,0,1366,13,1379,2059,0,0,0,0,0,0,0,66.31 ,66.97 ,66.31 
03,012,01,001,0043,0,2467,36,2503,3930,0,0,0,0,0,0,0,66.31 ,63.69 ,66.31 
03,012,01,001,0044,0,1790,20,1810,2477,0,0,0,0,0,0,0,66.31 ,73.07 ,66.31 
03,012,01,001,0045,0,2373,24,2397,3679,0,0,0,0,0,0,0,66.31 ,65.15 ,66.31 
03,012,01,001,0046,0,2672,39,2711,4294,0,0,0,0,0,0,0,66.31 ,63.13 ,66.31 
03,012,01,001,0047,0,939,10,949,1521,0,0,0,0,0,0,0,66.31 ,62.39 ,66.31 
03,012,01,001,0048,0,1164,13,1177,1890,0,0,0,0,0,0,0,66.31 ,62.28 ,66.31 
03,012,01,001,0049,0,630,10,640,908,0,0,0,0,0,0,0,66.31 ,70.48 ,66.31 
03,012,01,001,0050,0,666,10,676,1008,0,0,0,0,0,0,0,66.31 ,67.06 ,66.31 
03,012,01,001,0051,0,2361,37,2398,3564,0,0,0,0,0,0,0,66.31 ,67.28 ,66.31 
03,012,01,001,0052,0,1725,28,1753,2862,0,0,0,0,0,0,0,66.31 ,61.25 ,66.31 
03,012,01,001,0053,0,534,8,542,872,0,0,0,0,0,0,0,66.31 ,62.16 ,66.31 
03,012,01,001,0054,0,1474,18,1492,2305,0,0,0,0,0,0,0,66.31 ,64.73 ,66.31 
03,012,01,001,0055,0,1496,27,1523,2453,0,0,0,0,0,0,0,66.31 ,62.09 ,66.31 
03,012,01,001,0056,0,2050,13,2063,3101,0,0,0,0,0,0,0,66.31 ,66.53 ,66.31 
03,012,01,001,0057,0,1721,26,1747,2552,0,0,0,0,0,0,0,66.31 ,68.46 ,66.31 
03,012,01,001,0058,0,1882,28,1910,3065,0,0,0,0,0,0,0,66.31 ,62.32 ,66.31 
03,012,01,001,0059,0,3350,48,3398,5364,0,0,0,0,0,0,0,66.31 ,63.35 ,66.31 
03,012,01,001,0060,0,1759,24,1783,2957,0,0,0,0,0,0,0,66.31 ,60.30 ,66.31 
03,012,01,001,0061,0,1116,11,1127,1702,0,0,0,0,0,0,0,66.31 ,66.22 ,66.31 
03,012,01,001,0062,0,1974,24,1998,3232,0,0,0,0,0,0,0,66.31 ,61.82 ,66.31 
03,012,01,001,0063,0,1517,22,1539,2354,0,0,0,0,0,0,0,66.31 ,65.38 ,66.31 
03,012,01,001,0064,0,3418,49,3467,5293,0,0,0,0,0,0,0,66.31 ,65.50 ,66.31 
03,012,01,001,0065,0,1961,33,1994,3061,0,0,0,0,0,0,0,66.31 ,65.14 ,66.31 
03,012,01,001,0066,0,1915,33,1948,2870,0,0,0,0,0,0,0,66.31 ,67.87 ,66.31 
03,012,01,001,0067,0,1416,17,1433,2153,0,0,0,0,0,0,0,66.31 ,66.56 ,66.31 
03,012,01,001,0068,0,2540,32,2572,3624,0,0,0,0,0,0,0,66.31 ,70.97 ,66.31 
03,012,01,001,0069,0,1307,21,1328,1904,0,0,0,0,0,0,0,66.31 ,69.75 ,66.31 
03,012,01,001,0070,0,2322,37,2359,3817,0,0,0,0,0,0,0,66.31 ,61.80 ,66.31 
03,012,01,001,0071,0,1121,15,1136,1777,0,0,0,0,0,0,0,66.31 ,63.93 ,66.31 
03,012,01,001,0072,0,1651,14,1665,2494,0,0,0,0,0,0,0,66.31 ,66.76 ,66.31 
03,012,01,001,0073,0,2137,32,2169,3177,0,0,0,0,0,0,0,66.31 ,68.27 ,66.31 
03,012,01,001,0074,0,2244,37,2281,3430,0,0,0,0,0,0,0,66.31 ,66.50 ,66.31 
03,012,01,001,0075,0,1992,29,2021,2896,0,0,0,0,0,0,0,66.31 ,69.79 ,66.31 
03,012,01,001,0076,0,2044,30,2074,3109,0,0,0,0,0,0,0,66.31 ,66.71 ,66.31 
03,012,01,001,0077,0,3377,51,3428,5170,0,0,0,0,0,0,0,66.31 ,66.31 ,66.31 
03,012,01,001,0078,0,1324,28,1352,2111,0,0,0,0,0,0,0,66.31 ,64.05 ,66.31 
03,012,01,001,0079,0,1549,27,1576,2644,0,0,0,0,0,0,0,66.31 ,59.61 ,66.31 
03,012,01,002,0080,0,1659,17,1676,2393,0,0,0,0,0,0,0,66.31 ,70.04 ,66.31 
03,012,01,002,0081,0,1942,25,1967,2763,0,0,0,0,0,0,0,66.31 ,71.19 ,66.31 
03,012,01,002,0082,0,1411,15,1426,2019,0,0,0,0,0,0,0,66.31 ,70.63 ,66.31 
03,012,01,002,0083,0,1633,15,1648,2393,0,0,0,0,0,0,0,66.31 ,68.87 ,66.31 
03,012,01,002,0084,0,2143,22,2165,3081,0,0,0,0,0,0,0,66.31 ,70.27 ,66.31 
03,012,01,002,0085,0,1131,17,1148,1772,0,0,0,0,0,0,0,66.31 ,64.79 ,66.31 
03,012,01,002,0086,0,1558,20,1578,2205,0,0,0,0,0,0,0,66.31 ,71.56 ,66.31 
03,012,01,002,0087,0,1811,28,1839,2469,0,0,0,0,0,0,0,66.31 ,74.48 ,66.31 
03,012,01,002,0088,0,1301,15,1316,1713,0,0,0,0,0,0,0,66.31 ,76.82 ,66.31 
03,012,01,002,0089,0,1953,24,1977,2709,0,0,0,0,0,0,0,66.31 ,72.98 ,66.31 
03,012,01,002,0090,0,1897,16,1913,2565,0,0,0,0,0,0,0,66.31 ,74.58 ,66.31 
03,012,01,002,0091,0,968,5,973,1220,0,0,0,0,0,0,0,66.31 ,79.75 ,66.31 
03,012,01,002,0092,0,1114,10,1124,1518,0,0,0,0,0,0,0,66.31 ,74.04 ,66.31 
03,012,01,002,0093,0,1350,21,1371,1878,0,0,0,0,0,0,0,66.31 ,73.00 ,66.31 
03,012,01,002,0094,0,2181,21,2202,3056,0,0,0,0,0,0,0,66.31 ,72.05 ,66.31 
03,012,01,002,0095,0,1144,12,1156,1559,0,0,0,0,0,0,0,66.31 ,74.15 ,66.31 
03,012,01,002,0096,0,869,10,879,1226,0,0,0,0,0,0,0,66.31 ,71.70 ,66.31 
03,012,01,002,0097,0,1741,23,1764,2522,0,0,0,0,0,0,0,66.31 ,69.94 ,66.31 
03,012,01,002,0098,0,1202,14,1216,1683,0,0,0,0,0,0,0,66.31 ,72.25 ,66.31 
03,012,01,002,0099,0,1251,11,1262,1629,0,0,0,0,0,0,0,66.31 ,77.47 ,66.31 
03,012,01,002,0100,0,640,6,646,904,0,0,0,0,0,0,0,66.31 ,71.46 ,66.31 
03,012,01,002,0101,0,528,7,535,743,0,0,0,0,0,0,0,66.31 ,72.01 ,66.31 
03,012,01,002,0102,0,1410,11,1421,2104,0,0,0,0,0,0,0,66.31 ,67.54 ,66.31 
03,012,01,002,0103,0,984,10,994,1503,0,0,0,0,0,0,0,66.31 ,66.13 ,66.31 
03,012,01,003,0104,0,1435,24,1459,1961,0,0,0,0,0,0,0,66.31 ,74.40 ,66.31 
03,012,01,003,0105,0,982,15,997,1283,0,0,0,0,0,0,0,66.31 ,77.71 ,66.31 
03,012,01,003,0106,0,1062,19,1081,1484,0,0,0,0,0,0,0,66.31 ,72.84 ,66.31 
03,012,01,003,0107,0,5149,56,5205,7820,0,0,0,0,0,0,0,66.31 ,66.56 ,66.31 
03,012,01,003,0108,0,3032,39,3071,4639,0,0,0,0,0,0,0,66.31 ,66.20 ,66.31 
03,012,01,003,0109,0,1364,17,1381,1857,0,0,0,0,0,0,0,66.31 ,74.37 ,66.31 
03,012,01,003,0110,0,3714,47,3761,5509,0,0,0,0,0,0,0,66.31 ,68.27 ,66.31 
03,012,01,003,0111,0,1743,21,1764,2421,0,0,0,0,0,0,0,66.31 ,72.86 ,66.31 
03,012,01,003,0112,0,1552,21,1573,2143,0,0,0,0,0,0,0,66.31 ,73.40 ,66.31 
03,012,01,003,0113,0,2812,23,2835,3798,0,0,0,0,0,0,0,66.31 ,74.64 ,66.31 
03,012,01,003,0114,0,1666,21,1687,2205,0,0,0,0,0,0,0,66.31 ,76.51 ,66.31 
03,012,01,003,0115,0,2041,18,2059,2841,0,0,0,0,0,0,0,66.31 ,72.47 ,66.31 
03,012,01,003,0116,0,3678,34,3712,5344,0,0,0,0,0,0,0,66.31 ,69.46 ,66.31 
03,012,01,003,0117,0,3260,52,3312,5033,0,0,0,0,0,0,0,66.31 ,65.81 ,66.31 
03,012,01,003,0118,0,2933,35,2968,4298,0,0,0,0,0,0,0,66.31 ,69.06 ,66.31 
03,012,01,003,0119,0,2588,28,2616,3663,0,0,0,0,0,0,0,66.31 ,71.42 ,66.31 
03,012,01,003,0120,0,1415,9,1424,1919,0,0,0,0,0,0,0,66.31 ,74.21 ,66.31 
03,012,01,003,0121,0,3174,48,3222,5003,0,0,0,0,0,0,0,66.31 ,64.40 ,66.31 
03,012,01,003,0122,0,893,16,909,1198,0,0,0,0,0,0,0,66.31 ,75.88 ,66.31 
03,012,01,003,0123,0,1999,30,2029,3129,0,0,0,0,0,0,0,66.31 ,64.84 ,66.31 
03,012,01,003,0124,0,1021,14,1035,1337,0,0,0,0,0,0,0,66.31 ,77.41 ,66.31 
03,012,01,003,0125,0,1144,19,1163,1599,0,0,0,0,0,0,0,66.31 ,72.73 ,66.31 
03,012,01,003,0126,0,1904,21,1925,2479,0,0,0,0,0,0,0,66.31 ,77.65 ,66.31 
03,012,01,003,0127,0,940,13,953,1202,0,0,0,0,0,0,0,66.31 ,79.28 ,66.31 
03,012,01,003,0128,0,1866,17,1883,2695,0,0,0,0,0,0,0,66.31 ,69.87 ,66.31 
03,012,01,003,0129,0,1214,18,1232,1742,0,0,0,0,0,0,0,66.31 ,70.72 ,66.31 
03,012,01,004,0130,0,914,7,921,1192,0,0,0,0,0,0,0,66.31 ,77.27 ,66.31 
03,012,01,004,0131,0,1137,9,1146,1520,0,0,0,0,0,0,0,66.31 ,75.39 ,66.31 
03,012,01,004,0132,0,1532,9,1541,2146,0,0,0,0,0,0,0,66.31 ,71.81 ,66.31 
03,012,01,004,0133,0,2130,22,2152,3004,0,0,0,0,0,0,0,66.31 ,71.64 ,66.31 
03,012,01,004,0134,0,777,8,785,1066,0,0,0,0,0,0,0,66.31 ,73.64 ,66.31 
03,012,01,004,0135,0,695,3,698,950,0,0,0,0,0,0,0,66.31 ,73.47 ,66.31 
03,012,01,004,0136,0,771,8,779,1029,0,0,0,0,0,0,0,66.31 ,75.70 ,66.31 
03,012,01,004,0137,0,628,4,632,866,0,0,0,0,0,0,0,66.31 ,72.98 ,66.31 
03,012,01,004,0138,0,883,5,888,1263,0,0,0,0,0,0,0,66.31 ,70.31 ,66.31 
03,012,01,004,0139,0,633,8,641,822,0,0,0,0,0,0,0,66.31 ,77.98 ,66.31 
03,012,01,004,0140,0,1361,19,1380,1980,0,0,0,0,0,0,0,66.31 ,69.70 ,66.31 
03,012,01,004,0141,0,2522,35,2557,3707,0,0,0,0,0,0,0,66.31 ,68.98 ,66.31 
03,012,01,004,0142,0,2825,38,2863,3965,0,0,0,0,0,0,0,66.31 ,72.21 ,66.31 
03,012,01,004,0143,0,1505,14,1519,2100,0,0,0,0,0,0,0,66.31 ,72.33 ,66.31 
03,012,01,004,0144,0,1679,12,1691,2252,0,0,0,0,0,0,0,66.31 ,75.09 ,66.31 
03,012,01,004,0145,0,1152,9,1161,1548,0,0,0,0,0,0,0,66.31 ,75.00 ,66.31 
03,012,01,004,0146,0,757,7,764,1032,0,0,0,0,0,0,0,66.31 ,74.03 ,66.31 
03,012,01,004,0147,0,1338,17,1355,1909,0,0,0,0,0,0,0,66.31 ,70.98 ,66.31 
03,012,01,004,0148,0,491,5,496,686,0,0,0,0,0,0,0,66.31 ,72.30 ,66.31 
03,012,01,005,0149,0,685,8,693,936,0,0,0,0,0,0,0,66.31 ,74.04 ,66.31 
03,012,01,005,0150,0,1247,11,1258,1757,0,0,0,0,0,0,0,66.31 ,71.60 ,66.31 
03,012,01,005,0151,0,2527,43,2570,3727,0,0,0,0,0,0,0,66.31 ,68.96 ,66.31 
03,012,01,005,0152,0,1657,26,1683,2352,0,0,0,0,0,0,0,66.31 ,71.56 ,66.31 
03,012,01,005,0153,0,1783,31,1814,2524,0,0,0,0,0,0,0,66.31 ,71.87 ,66.31 
03,012,01,005,0154,0,2865,38,2903,4276,0,0,0,0,0,0,0,66.31 ,67.89 ,66.31 
03,012,01,005,0155,0,2190,37,2227,3364,0,0,0,0,0,0,0,66.31 ,66.20 ,66.31 
03,012,01,005,0156,0,1724,28,1752,2392,0,0,0,0,0,0,0,66.31 ,73.24 ,66.31 
03,012,01,005,0157,0,938,12,950,1286,0,0,0,0,0,0,0,66.31 ,73.87 ,66.31 
03,012,01,006,0158,0,2722,36,2758,3883,0,0,0,0,0,0,0,66.31 ,71.03 ,66.31 
03,012,01,006,0159,0,2232,38,2270,3228,0,0,0,0,0,0,0,66.31 ,70.32 ,66.31 
03,012,01,006,0160,0,1324,18,1342,1932,0,0,0,0,0,0,0,66.31 ,69.46 ,66.31 
03,012,01,006,0161,0,1463,20,1483,2114,0,0,0,0,0,0,0,66.31 ,70.15 ,66.31 
03,012,01,006,0162,0,805,14,819,1269,0,0,0,0,0,0,0,66.31 ,64.54 ,66.31 
03,012,01,006,0163,0,2297,45,2342,3529,0,0,0,0,0,0,0,66.31 ,66.36 ,66.31 
03,012,01,006,0164,0,1196,24,1220,1760,0,0,0,0,0,0,0,66.31 ,69.32 ,66.31 
03,012,01,006,0165,0,1176,31,1207,1639,0,0,0,0,0,0,0,66.31 ,73.64 ,66.31 
03,012,01,006,0166,0,946,15,961,1427,0,0,0,0,0,0,0,66.31 ,67.34 ,66.31 
03,012,01,006,0167,0,915,13,928,1302,0,0,0,0,0,0,0,66.31 ,71.27 ,66.31 
03,012,01,006,0168,0,1009,14,1023,1549,0,0,0,0,0,0,0,66.31 ,66.04 ,66.31 
03,012,01,006,0169,0,1704,33,1737,2575,0,0,0,0,0,0,0,66.31 ,67.46 ,66.31 
03,012,01,006,0170,0,708,10,718,1056,0,0,0,0,0,0,0,66.31 ,67.99 ,66.31 
03,012,01,006,0171,0,1686,20,1706,2489,0,0,0,0,0,0,0,66.31 ,68.54 ,66.31 
03,012,01,006,0172,0,1758,27,1785,2471,0,0,0,0,0,0,0,66.31 ,72.24 ,66.31 
03,012,01,006,0173,0,339,6,345,469,0,0,0,0,0,0,0,66.31 ,73.56 ,66.31 
03,012,01,007,0174,0,4004,46,4050,6297,0,0,0,0,0,0,0,66.31 ,64.32 ,66.31 
03,012,01,007,0175,0,1568,15,1583,2033,0,0,0,0,0,0,0,66.31 ,77.87 ,66.31 
03,012,01,007,0176,0,4034,47,4081,6317,0,0,0,0,0,0,0,66.31 ,64.60 ,66.31 
03,012,01,007,0177,0,1865,21,1886,2468,0,0,0,0,0,0,0,66.31 ,76.42 ,66.31 
03,012,01,007,0178,0,3851,41,3892,5208,0,0,0,0,0,0,0,66.31 ,74.73 ,66.31 
03,012,01,007,0179,0,2116,26,2142,2919,0,0,0,0,0,0,0,66.31 ,73.38 ,66.31 
03,012,01,007,0180,0,491,10,501,628,0,0,0,0,0,0,0,66.31 ,79.78 ,66.31 
03,012,01,008,0181,0,2270,29,2299,3371,0,0,0,0,0,0,0,66.31 ,68.20 ,66.31 
03,012,01,008,0182,0,895,9,904,1275,0,0,0,0,0,0,0,66.31 ,70.90 ,66.31 
03,012,01,008,0183,0,1873,32,1905,2834,0,0,0,0,0,0,0,66.31 ,67.22 ,66.31 
03,012,01,008,0184,0,911,11,922,1320,0,0,0,0,0,0,0,66.31 ,69.85 ,66.31 
03,012,01,008,0185,0,842,8,850,1194,0,0,0,0,0,0,0,66.31 ,71.19 ,66.31 
03,012,01,008,0186,0,820,10,830,1138,0,0,0,0,0,0,0,66.31 ,72.93 ,66.31 
03,012,01,008,0187,0,1642,27,1669,2429,0,0,0,0,0,0,0,66.31 ,68.71 ,66.31 
03,012,01,008,0188,0,1725,20,1745,2610,0,0,0,0,0,0,0,66.31 ,66.86 ,66.31 
03,012,01,008,0189,0,1730,27,1757,2562,0,0,0,0,0,0,0,66.31 ,68.58 ,66.31 
03,012,01,008,0190,0,2184,36,2220,3377,0,0,0,0,0,0,0,66.31 ,65.74 ,66.31 
03,012,01,008,0191,0,1915,24,1939,2756,0,0,0,0,0,0,0,66.31 ,70.36 ,66.31 
03,012,01,008,0192,0,464,8,472,568,0,0,0,0,0,0,0,66.31 ,83.10 ,66.31 
03,012,01,008,0193,0,1635,22,1657,2415,0,0,0,0,0,0,0,66.31 ,68.61 ,66.31 
03,012,01,008,0194,0,1134,23,1157,1616,0,0,0,0,0,0,0,66.31 ,71.60 ,66.31 
03,012,01,008,0195,0,2208,30,2238,3179,0,0,0,0,0,0,0,66.31 ,70.40 ,66.31 
03,012,01,008,0196,0,2023,28,2051,2932,0,0,0,0,0,0,0,66.31 ,69.95 ,66.31 
03,012,01,008,0197,0,975,8,983,1259,0,0,0,0,0,0,0,66.31 ,78.08 ,66.31 
03,012,01,008,0198,0,2826,33,2859,4282,0,0,0,0,0,0,0,66.31 ,66.77 ,66.31 
03,012,01,008,0199,0,1316,15,1331,1830,0,0,0,0,0,0,0,66.31 ,72.73 ,66.31 
03,012,01,008,0200,0,885,18,903,1265,0,0,0,0,0,0,0,66.31 ,71.38 ,66.31 
03,012,01,008,0201,0,560,5,565,721,0,0,0,0,0,0,0,66.31 ,78.36 ,66.31 
03,012,01,008,0202,0,909,11,920,1179,0,0,0,0,0,0,0,66.31 ,78.03 ,66.31 
03,012,01,008,0203,0,730,6,736,986,0,0,0,0,0,0,0,66.31 ,74.65 ,66.31 
03,012,01,008,0204,0,2219,31,2250,3067,0,0,0,0,0,0,0,66.31 ,73.36 ,66.31 
03,012,01,008,0205,0,1220,10,1230,1564,0,0,0,0,0,0,0,66.31 ,78.64 ,66.31 
03,012,01,008,0206,0,575,10,585,717,0,0,0,0,0,0,0,66.31 ,81.59 ,66.31 
03,012,01,008,0207,0,1028,11,1039,1259,0,0,0,0,0,0,0,66.31 ,82.53 ,66.31 
03,012,01,008,0208,0,534,9,543,707,0,0,0,0,0,0,0,66.31 ,76.80 ,66.31 
03,012,01,008,0209,0,625,11,636,819,0,0,0,0,0,0,0,66.31 ,77.66 ,66.31 
03,012,01,008,0210,0,663,4,667,958,0,0,0,0,0,0,0,66.31 ,69.62 ,66.31 
03,012,01,008,0211,0,650,6,656,943,0,0,0,0,0,0,0,66.31 ,69.57 ,66.31 
03,012,01,008,0212,0,1464,12,1476,2116,0,0,0,0,0,0,0,66.31 ,69.75 ,66.31 
03,012,01,008,0213,0,987,8,995,1394,0,0,0,0,0,0,0,66.31 ,71.38 ,66.31 
03,012,01,008,0214,0,1005,6,1011,1339,0,0,0,0,0,0,0,66.31 ,75.50 ,66.31 
03,012,01,008,0215,0,362,3,365,508,0,0,0,0,0,0,0,66.31 ,71.85 ,66.31 
03,012,01,009,0216,0,1034,14,1048,1490,0,0,0,0,0,0,0,66.31 ,70.34 ,66.31 
03,012,01,009,0217,0,651,8,659,891,0,0,0,0,0,0,0,66.31 ,73.96 ,66.31 
03,012,01,009,0218,0,237,5,242,321,0,0,0,0,0,0,0,66.31 ,75.39 ,66.31 
03,012,01,009,0219,0,1505,17,1522,2184,0,0,0,0,0,0,0,66.31 ,69.69 ,66.31 
03,012,01,009,0220,0,1437,20,1457,2080,0,0,0,0,0,0,0,66.31 ,70.05 ,66.31 
03,012,01,009,0221,0,2078,19,2097,3002,0,0,0,0,0,0,0,66.31 ,69.85 ,66.31 
03,012,01,009,0222,0,954,11,965,1250,0,0,0,0,0,0,0,66.31 ,77.20 ,66.31 
03,012,01,009,0223,0,1420,20,1440,1956,0,0,0,0,0,0,0,66.31 ,73.62 ,66.31 
03,012,01,009,0224,0,1465,25,1490,2021,0,0,0,0,0,0,0,66.31 ,73.73 ,66.31 
03,012,01,009,0225,0,738,9,747,1012,0,0,0,0,0,0,0,66.31 ,73.81 ,66.31 
03,012,01,009,0226,0,1763,22,1785,2472,0,0,0,0,0,0,0,66.31 ,72.21 ,66.31 
03,012,01,009,0227,0,1298,13,1311,1771,0,0,0,0,0,0,0,66.31 ,74.03 ,66.31 
03,012,01,009,0228,0,1111,12,1123,1441,0,0,0,0,0,0,0,66.31 ,77.93 ,66.31 
03,012,01,009,0229,0,1539,15,1554,2022,0,0,0,0,0,0,0,66.31 ,76.85 ,66.31 
03,012,01,009,0230,0,685,7,692,929,0,0,0,0,0,0,0,66.31 ,74.49 ,66.31 
03,012,01,009,0231,0,1027,5,1032,1339,0,0,0,0,0,0,0,66.31 ,77.07 ,66.31 
03,012,01,009,0232,0,480,8,488,640,0,0,0,0,0,0,0,66.31 ,76.25 ,66.31 
03,012,01,010,0233,0,354,3,357,444,0,0,0,0,0,0,0,66.31 ,80.41 ,66.31 
03,012,01,010,0234,0,852,13,865,1102,0,0,0,0,0,0,0,66.31 ,78.49 ,66.31 
03,012,01,010,0235,0,1607,20,1627,2105,0,0,0,0,0,0,0,66.31 ,77.29 ,66.31 
03,012,01,010,0236,0,2141,20,2161,2875,0,0,0,0,0,0,0,66.31 ,75.17 ,66.31 
03,012,01,010,0237,0,1921,24,1945,2498,0,0,0,0,0,0,0,66.31 ,77.86 ,66.31 
03,012,01,010,0238,0,1277,23,1300,1664,0,0,0,0,0,0,0,66.31 ,78.13 ,66.31 
03,012,01,010,0239,0,3065,37,3102,4181,0,0,0,0,0,0,0,66.31 ,74.19 ,66.31 
03,012,01,010,0240,0,1530,17,1547,2068,0,0,0,0,0,0,0,66.31 ,74.81 ,66.31 
03,012,01,010,0241,0,1680,27,1707,2219,0,0,0,0,0,0,0,66.31 ,76.93 ,66.31 
03,012,01,010,0242,0,1247,22,1269,1738,0,0,0,0,0,0,0,66.31 ,73.01 ,66.31 
03,012,01,010,0243,0,1733,35,1768,2445,0,0,0,0,0,0,0,66.31 ,72.31 ,66.31 
03,012,01,011,0244,0,287,1,288,384,0,0,0,0,0,0,0,66.31 ,75.00 ,66.31 
03,012,01,011,0245,0,509,4,513,680,0,0,0,0,0,0,0,66.31 ,75.44 ,66.31 
03,012,01,011,0246,0,769,6,775,997,0,0,0,0,0,0,0,66.31 ,77.73 ,66.31 
03,012,01,011,0247,0,299,3,302,423,0,0,0,0,0,0,0,66.31 ,71.39 ,66.31 
03,012,01,011,0248,0,659,15,674,937,0,0,0,0,0,0,0,66.31 ,71.93 ,66.31 
03,012,01,011,0249,0,976,19,995,1395,0,0,0,0,0,0,0,66.31 ,71.33 ,66.31 
03,012,01,011,0250,0,270,4,274,414,0,0,0,0,0,0,0,66.31 ,66.18 ,66.31 
03,012,01,011,0251,0,332,2,334,471,0,0,0,0,0,0,0,66.31 ,70.91 ,66.31 
03,012,01,011,0252,0,690,5,695,1028,0,0,0,0,0,0,0,66.31 ,67.61 ,66.31 
03,012,01,011,0253,0,986,16,1002,1304,0,0,0,0,0,0,0,66.31 ,76.84 ,66.31 
03,012,01,012,0254,0,2602,33,2635,3808,0,0,0,0,0,0,0,66.31 ,69.20 ,66.31 
03,012,01,012,0255,0,1782,33,1815,2568,0,0,0,0,0,0,0,66.31 ,70.68 ,66.31 
03,012,01,012,0256,0,1690,23,1713,2401,0,0,0,0,0,0,0,66.31 ,71.35 ,66.31 
03,012,01,012,0257,0,1305,19,1324,1916,0,0,0,0,0,0,0,66.31 ,69.10 ,66.31 
03,012,01,012,0258,0,967,19,986,1285,0,0,0,0,0,0,0,66.31 ,76.73 ,66.31 
03,012,01,012,0259,0,806,21,827,1246,0,0,0,0,0,0,0,66.31 ,66.37 ,66.31 
03,012,01,012,0260,0,1286,32,1318,1840,0,0,0,0,0,0,0,66.31 ,71.63 ,66.31 
03,012,01,012,0261,0,887,14,901,1116,0,0,0,0,0,0,0,66.31 ,80.73 ,66.31 
03,012,01,012,0262,0,1290,18,1308,1700,0,0,0,0,0,0,0,66.31 ,76.94 ,66.31 
03,012,01,012,0263,0,509,10,519,705,0,0,0,0,0,0,0,66.31 ,73.62 ,66.31 
03,012,01,012,0264,0,1114,32,1146,1504,0,0,0,0,0,0,0,66.31 ,76.20 ,66.31 
03,012,01,012,0265,0,717,15,732,939,0,0,0,0,0,0,0,66.31 ,77.96 ,66.31 
03,012,01,013,0266,0,1281,13,1294,1666,0,0,0,0,0,0,0,66.31 ,77.67 ,66.31 
03,012,01,013,0267,0,1894,25,1919,2416,0,0,0,0,0,0,0,66.31 ,79.43 ,66.31 
03,012,01,013,0268,0,2070,46,2116,2792,0,0,0,0,0,0,0,66.31 ,75.79 ,66.31 
03,012,01,013,0269,0,1369,16,1385,1826,0,0,0,0,0,0,0,66.31 ,75.85 ,66.31 
03,012,01,013,0270,0,1185,13,1198,1526,0,0,0,0,0,0,0,66.31 ,78.51 ,66.31 
03,012,01,013,0271,0,722,8,730,919,0,0,0,0,0,0,0,66.31 ,79.43 ,66.31 
03,012,01,013,0272,0,1601,29,1630,2170,0,0,0,0,0,0,0,66.31 ,75.12 ,66.31 
03,012,01,013,0273,0,2269,32,2301,3114,0,0,0,0,0,0,0,66.31 ,73.89 ,66.31 
03,012,01,013,0274,0,1765,18,1783,2537,0,0,0,0,0,0,0,66.31 ,70.28 ,66.31 
03,012,01,013,0275,0,1811,26,1837,2513,0,0,0,0,0,0,0,66.31 ,73.10 ,66.31 
03,012,01,013,0276,0,1544,20,1564,2001,0,0,0,0,0,0,0,66.31 ,78.16 ,66.31 
03,012,01,013,0277,0,1427,18,1445,1956,0,0,0,0,0,0,0,66.31 ,73.88 ,66.31 
03,012,01,013,0278,0,1808,32,1840,2416,0,0,0,0,0,0,0,66.31 ,76.16 ,66.31 
03,012,01,013,0279,0,1607,24,1631,2218,0,0,0,0,0,0,0,66.31 ,73.53 ,66.31 
03,012,01,013,0280,0,887,14,901,1142,0,0,0,0,0,0,0,66.31 ,78.90 ,66.31 
03,012,01,013,0281,0,861,9,870,1147,0,0,0,0,0,0,0,66.31 ,75.85 ,66.31 
03,012,01,013,0282,0,680,14,694,873,0,0,0,0,0,0,0,66.31 ,79.50 ,66.31 
03,012,01,013,0283,0,807,4,811,1004,0,0,0,0,0,0,0,66.31 ,80.78 ,66.31 
03,012,01,013,0284,0,669,15,684,816,0,0,0,0,0,0,0,66.31 ,83.82 ,66.31 
03,012,01,013,0285,0,1037,17,1054,1369,0,0,0,0,0,0,0,66.31 ,76.99 ,66.31 
03,012,01,014,0286,0,1722,30,1752,2315,0,0,0,0,0,0,0,66.31 ,75.68 ,66.31 
03,012,01,014,0287,0,798,5,803,1046,0,0,0,0,0,0,0,66.31 ,76.77 ,66.31 
03,012,01,014,0288,0,2632,46,2678,4058,0,0,0,0,0,0,0,66.31 ,65.99 ,66.31 
03,012,01,014,0289,0,1211,17,1228,1656,0,0,0,0,0,0,0,66.31 ,74.15 ,66.31 
03,012,01,014,0290,0,842,13,855,1128,0,0,0,0,0,0,0,66.31 ,75.80 ,66.31 
03,012,01,014,0291,0,818,10,828,1099,0,0,0,0,0,0,0,66.31 ,75.34 ,66.31 
03,012,01,014,0292,0,612,7,619,845,0,0,0,0,0,0,0,66.31 ,73.25 ,66.31 
03,012,01,014,0293,0,1000,16,1016,1429,0,0,0,0,0,0,0,66.31 ,71.10 ,66.31 
03,012,01,014,0294,0,1123,15,1138,1635,0,0,0,0,0,0,0,66.31 ,69.60 ,66.31 
03,012,01,014,0295,0,800,23,823,1155,0,0,0,0,0,0,0,66.31 ,71.26 ,66.31 
03,012,01,014,0296,0,1397,24,1421,1951,0,0,0,0,0,0,0,66.31 ,72.83 ,66.31 
03,012,01,014,0297,0,664,11,675,928,0,0,0,0,0,0,0,66.31 ,72.74 ,66.31 
03,012,01,014,0298,0,575,6,581,740,0,0,0,0,0,0,0,66.31 ,78.51 ,66.31 
03,012,01,015,0299,0,769,6,775,1032,0,0,0,0,0,0,0,66.31 ,75.10 ,66.31 
03,012,01,015,0300,0,633,13,646,887,0,0,0,0,0,0,0,66.31 ,72.83 ,66.31 
03,012,01,015,0301,0,1089,17,1106,1565,0,0,0,0,0,0,0,66.31 ,70.67 ,66.31 
03,012,01,015,0302,0,1800,21,1821,2602,0,0,0,0,0,0,0,66.31 ,69.98 ,66.31 
03,012,01,015,0303,0,960,11,971,1349,0,0,0,0,0,0,0,66.31 ,71.98 ,66.31 
03,012,01,015,0304,0,1328,11,1339,1840,0,0,0,0,0,0,0,66.31 ,72.77 ,66.31 
03,012,01,015,0305,0,853,7,860,1212,0,0,0,0,0,0,0,66.31 ,70.96 ,66.31 
03,012,01,015,0306,0,765,11,776,1059,0,0,0,0,0,0,0,66.31 ,73.28 ,66.31 
03,012,01,015,0307,0,851,11,862,1208,0,0,0,0,0,0,0,66.31 ,71.36 ,66.31 
03,012,01,015,0308,0,940,10,950,1325,0,0,0,0,0,0,0,66.31 ,71.70 ,66.31 
03,012,01,015,0309,0,1886,26,1912,2816,0,0,0,0,0,0,0,66.31 ,67.90 ,66.31 
03,012,01,015,0310,0,854,9,863,1163,0,0,0,0,0,0,0,66.31 ,74.20 ,66.31 
03,012,01,015,0311,0,737,10,747,1024,0,0,0,0,0,0,0,66.31 ,72.95 ,66.31 
03,012,01,015,0312,0,942,3,945,1213,0,0,0,0,0,0,0,66.31 ,77.91 ,66.31 
03,012,01,015,0313,0,2132,26,2158,3062,0,0,0,0,0,0,0,66.31 ,70.48 ,66.31 
03,012,01,016,0314,0,558,2,560,738,0,0,0,0,0,0,0,66.31 ,75.88 ,66.31 
03,012,01,016,0315,0,1931,23,1954,2608,0,0,0,0,0,0,0,66.31 ,74.92 ,66.31 
03,012,01,016,0316,0,1182,11,1193,1575,0,0,0,0,0,0,0,66.31 ,75.75 ,66.31 
03,012,01,016,0317,0,821,5,826,1173,0,0,0,0,0,0,0,66.31 ,70.42 ,66.31 
03,012,01,016,0318,0,1448,7,1455,1906,0,0,0,0,0,0,0,66.31 ,76.34 ,66.31 
03,012,01,016,0319,0,1715,22,1737,2384,0,0,0,0,0,0,0,66.31 ,72.86 ,66.31 
03,012,01,017,0320,0,1097,17,1114,1405,0,0,0,0,0,0,0,66.31 ,79.29 ,66.31 
03,012,01,017,0321,0,1416,18,1434,1791,0,0,0,0,0,0,0,66.31 ,80.07 ,66.31 
03,012,01,017,0322,0,1411,35,1446,1830,0,0,0,0,0,0,0,66.31 ,79.02 ,66.31 
03,012,01,017,0323,0,746,8,754,908,0,0,0,0,0,0,0,66.31 ,83.04 ,66.31 
03,012,01,017,0324,0,798,12,810,1051,0,0,0,0,0,0,0,66.31 ,77.07 ,66.31 
03,012,01,017,0325,0,1365,13,1378,1769,0,0,0,0,0,0,0,66.31 ,77.90 ,66.31 
03,012,01,017,0326,0,471,6,477,586,0,0,0,0,0,0,0,66.31 ,81.40 ,66.31 
03,012,01,017,0327,0,593,4,597,758,0,0,0,0,0,0,0,66.31 ,78.76 ,66.31 
03,012,01,017,0328,0,1148,16,1164,1461,0,0,0,0,0,0,0,66.31 ,79.67 ,66.31 
03,012,01,017,0329,0,624,6,630,819,0,0,0,0,0,0,0,66.31 ,76.92 ,66.31 
03,012,01,017,0330,0,800,7,807,924,0,0,0,0,0,0,0,66.31 ,87.34 ,66.31 
03,012,01,017,0331,0,1505,21,1526,1883,0,0,0,0,0,0,0,66.31 ,81.04 ,66.31 
03,012,01,018,0332,0,1303,24,1327,1841,0,0,0,0,0,0,0,66.31 ,72.08 ,66.31 
03,012,01,018,0333,0,1340,24,1364,1923,0,0,0,0,0,0,0,66.31 ,70.93 ,66.31 
03,012,01,018,0334,0,1589,15,1604,2179,0,0,0,0,0,0,0,66.31 ,73.61 ,66.31 
03,012,01,018,0335,0,813,9,822,1051,0,0,0,0,0,0,0,66.31 ,78.21 ,66.31 
03,012,01,018,0336,0,734,14,748,954,0,0,0,0,0,0,0,66.31 ,78.41 ,66.31 
03,012,01,018,0337,0,671,8,679,841,0,0,0,0,0,0,0,66.31 ,80.74 ,66.31 
03,012,01,018,0338,0,2338,46,2384,3262,0,0,0,0,0,0,0,66.31 ,73.08 ,66.31 
03,012,01,018,0339,0,1417,25,1442,1888,0,0,0,0,0,0,0,66.31 ,76.38 ,66.31 
03,012,01,018,0340,0,1799,17,1816,2341,0,0,0,0,0,0,0,66.31 ,77.57 ,66.31 
03,012,01,018,0341,0,498,9,507,700,0,0,0,0,0,0,0,66.31 ,72.43 ,66.31 
03,012,01,018,0342,0,1699,31,1730,2283,0,0,0,0,0,0,0,66.31 ,75.78 ,66.31 
03,012,01,018,0343,0,1528,25,1553,2150,0,0,0,0,0,0,0,66.31 ,72.23 ,66.31 
03,012,01,018,0344,0,975,18,993,1378,0,0,0,0,0,0,0,66.31 ,72.06 ,66.31 
03,012,01,018,0345,0,1631,28,1659,2152,0,0,0,0,0,0,0,66.31 ,77.09 ,66.31 
03,012,01,018,0346,0,1651,25,1676,2265,0,0,0,0,0,0,0,66.31 ,74.00 ,66.31 
03,012,01,019,0347,0,1497,9,1506,2242,0,0,0,0,0,0,0,66.31 ,67.17 ,66.31 
03,012,01,019,0348,0,1702,23,1725,2426,0,0,0,0,0,0,0,66.31 ,71.10 ,66.31 
03,012,01,019,0349,0,619,11,630,928,0,0,0,0,0,0,0,66.31 ,67.89 ,66.31 
03,012,01,019,0350,0,475,3,478,691,0,0,0,0,0,0,0,66.31 ,69.18 ,66.31 
03,012,01,019,0351,0,623,3,626,855,0,0,0,0,0,0,0,66.31 ,73.22 ,66.31 
03,012,01,019,0352,0,495,7,502,715,0,0,0,0,0,0,0,66.31 ,70.21 ,66.31 
03,012,01,019,0353,0,372,4,376,505,0,0,0,0,0,0,0,66.31 ,74.46 ,66.31 
03,012,01,019,0354,0,1305,14,1319,1845,0,0,0,0,0,0,0,66.31 ,71.49 ,66.31 
03,012,01,019,0355,0,1984,29,2013,2854,0,0,0,0,0,0,0,66.31 ,70.53 ,66.31 
03,012,01,019,0356,0,1306,22,1328,1867,0,0,0,0,0,0,0,66.31 ,71.13 ,66.31 
03,012,01,019,0357,0,1299,24,1323,1869,0,0,0,0,0,0,0,66.31 ,70.79 ,66.31 
03,012,01,019,0358,0,1164,8,1172,1539,0,0,0,0,0,0,0,66.31 ,76.15 ,66.31 
03,012,01,019,0359,0,1102,17,1119,1588,0,0,0,0,0,0,0,66.31 ,70.47 ,66.31 
03,012,01,019,0360,0,750,6,756,994,0,0,0,0,0,0,0,66.31 ,76.06 ,66.31 
03,012,01,019,0361,0,723,10,733,937,0,0,0,0,0,0,0,66.31 ,78.23 ,66.31 
03,012,01,019,0362,0,1039,17,1056,1349,0,0,0,0,0,0,0,66.31 ,78.28 ,66.31 
03,012,01,019,0363,0,778,7,785,1027,0,0,0,0,0,0,0,66.31 ,76.44 ,66.31 
03,012,01,019,0364,0,1052,16,1068,1402,0,0,0,0,0,0,0,66.31 ,76.18 ,66.31 
03,012,01,019,0365,0,743,5,748,958,0,0,0,0,0,0,0,66.31 ,78.08 ,66.31 
03,012,01,019,0366,0,1757,34,1791,2391,0,0,0,0,0,0,0,66.31 ,74.91 ,66.31 
03,012,01,019,0367,0,1311,18,1329,1845,0,0,0,0,0,0,0,66.31 ,72.03 ,66.31 
03,012,01,019,0368,0,467,4,471,660,0,0,0,0,0,0,0,66.31 ,71.36 ,66.31 
03,012,01,019,0369,0,291,1,292,376,0,0,0,0,0,0,0,66.31 ,77.66 ,66.31 
03,012,01,019,0370,0,442,8,450,588,0,0,0,0,0,0,0,66.31 ,76.53 ,66.31 
03,012,01,019,0371,0,145,1,146,201,0,0,0,0,0,0,0,66.31 ,72.64 ,66.31 
03,012,01,020,0372,0,1221,17,1238,1654,0,0,0,0,0,0,0,66.31 ,74.85 ,66.31 
03,012,01,020,0373,0,1034,18,1052,1456,0,0,0,0,0,0,0,66.31 ,72.25 ,66.31 
03,012,01,020,0374,0,1011,12,1023,1407,0,0,0,0,0,0,0,66.31 ,72.71 ,66.31 
03,012,01,020,0375,0,1640,19,1659,2266,0,0,0,0,0,0,0,66.31 ,73.21 ,66.31 
03,012,01,020,0376,0,1622,16,1638,2220,0,0,0,0,0,0,0,66.31 ,73.78 ,66.31 
03,012,01,020,0377,0,1846,10,1856,2516,0,0,0,0,0,0,0,66.31 ,73.77 ,66.31 
03,012,01,020,0378,0,1730,23,1753,2474,0,0,0,0,0,0,0,66.31 ,70.86 ,66.31 
03,012,01,020,0379,0,1504,9,1513,2008,0,0,0,0,0,0,0,66.31 ,75.35 ,66.31 
03,012,01,020,0380,0,1175,6,1181,1511,0,0,0,0,0,0,0,66.31 ,78.16 ,66.31 
03,012,01,020,0381,0,1256,14,1270,1720,0,0,0,0,0,0,0,66.31 ,73.84 ,66.31 
03,012,01,020,0382,0,1063,8,1071,1442,0,0,0,0,0,0,0,66.31 ,74.27 ,66.31 
03,012,01,020,0383,0,1483,18,1501,2047,0,0,0,0,0,0,0,66.31 ,73.33 ,66.31 
03,012,01,020,0384,0,1254,14,1268,1666,0,0,0,0,0,0,0,66.31 ,76.11 ,66.31 
03,012,01,020,0385,0,1580,25,1605,2235,0,0,0,0,0,0,0,66.31 ,71.81 ,66.31 
03,012,01,020,0386,0,1773,23,1796,2364,0,0,0,0,0,0,0,66.31 ,75.97 ,66.31 
03,012,01,020,0387,0,1262,15,1277,1677,0,0,0,0,0,0,0,66.31 ,76.15 ,66.31 
03,012,01,020,0388,0,1019,11,1030,1429,0,0,0,0,0,0,0,66.31 ,72.08 ,66.31 
03,012,01,020,0389,0,896,9,905,1215,0,0,0,0,0,0,0,66.31 ,74.49 ,66.31 
03,012,01,020,0390,0,1227,14,1241,1770,0,0,0,0,0,0,0,66.31 ,70.11 ,66.31 
03,012,01,021,0391,0,648,8,656,1075,0,0,0,0,0,0,0,66.31 ,61.02 ,66.31 
03,012,01,021,0392,0,891,14,905,1233,0,0,0,0,0,0,0,66.31 ,73.40 ,66.31 
03,012,01,021,0393,0,1013,23,1036,1640,0,0,0,0,0,0,0,66.31 ,63.17 ,66.31 
03,012,01,021,0394,0,874,17,891,1387,0,0,0,0,0,0,0,66.31 ,64.24 ,66.31 
03,012,01,021,0395,0,637,10,647,951,0,0,0,0,0,0,0,66.31 ,68.03 ,66.31 
03,012,01,021,0396,0,600,7,607,873,0,0,0,0,0,0,0,66.31 ,69.53 ,66.31 
03,012,01,021,0397,0,554,8,562,772,0,0,0,0,0,0,0,66.31 ,72.80 ,66.31 
03,012,01,021,0398,0,508,9,517,658,0,0,0,0,0,0,0,66.31 ,78.57 ,66.31 
03,012,01,021,0399,0,264,2,266,378,0,0,0,0,0,0,0,66.31 ,70.37 ,66.31 
03,012,01,021,0400,0,846,15,861,1480,0,0,0,0,0,0,0,66.31 ,58.18 ,66.31 
03,012,01,021,0401,0,950,21,971,1555,0,0,0,0,0,0,0,66.31 ,62.44 ,66.31 
03,012,01,021,0402,0,694,12,706,1079,0,0,0,0,0,0,0,66.31 ,65.43 ,66.31 
03,012,01,022,0403,0,466,3,469,643,0,0,0,0,0,0,0,66.31 ,72.94 ,66.31 
03,012,01,022,0404,0,811,11,822,1065,0,0,0,0,0,0,0,66.31 ,77.18 ,66.31 
03,012,01,022,0405,0,575,3,578,801,0,0,0,0,0,0,0,66.31 ,72.16 ,66.31 
03,012,01,022,0406,0,1077,17,1094,1516,0,0,0,0,0,0,0,66.31 ,72.16 ,66.31 
03,012,01,022,0407,0,532,3,535,718,0,0,0,0,0,0,0,66.31 ,74.51 ,66.31 
03,012,01,022,0408,0,513,9,522,720,0,0,0,0,0,0,0,66.31 ,72.50 ,66.31 
03,012,01,022,0409,0,710,14,724,1134,0,0,0,0,0,0,0,66.31 ,63.84 ,66.31 
03,012,01,023,0410,0,591,5,596,860,0,0,0,0,0,0,0,66.31 ,69.30 ,66.31 
03,012,01,023,0411,0,506,10,516,827,0,0,0,0,0,0,0,66.31 ,62.39 ,66.31 
03,012,01,023,0412,0,1202,24,1226,1918,0,0,0,0,0,0,0,66.31 ,63.92 ,66.31 
03,012,01,023,0413,0,1301,14,1315,1859,0,0,0,0,0,0,0,66.31 ,70.74 ,66.31 
03,012,01,023,0414,0,1137,9,1146,1603,0,0,0,0,0,0,0,66.31 ,71.49 ,66.31 
03,012,01,023,0415,0,1300,17,1317,1858,0,0,0,0,0,0,0,66.31 ,70.88 ,66.31 
03,012,01,023,0416,0,1021,16,1037,1431,0,0,0,0,0,0,0,66.31 ,72.47 ,66.31 
03,012,01,024,0417,0,591,8,599,778,0,0,0,0,0,0,0,66.31 ,76.99 ,66.31 
03,012,01,024,0418,0,752,11,763,1066,0,0,0,0,0,0,0,66.31 ,71.58 ,66.31 
03,012,01,024,0419,0,340,6,346,508,0,0,0,0,0,0,0,66.31 ,68.11 ,66.31 
03,012,01,024,0420,0,383,4,387,499,0,0,0,0,0,0,0,66.31 ,77.56 ,66.31 
03,012,01,024,0421,0,806,9,815,1028,0,0,0,0,0,0,0,66.31 ,79.28 ,66.31 
03,012,01,024,0422,0,1335,17,1352,1756,0,0,0,0,0,0,0,66.31 ,76.99 ,66.31 
03,012,01,024,0423,0,497,2,499,616,0,0,0,0,0,0,0,66.31 ,81.01 ,66.31 
03,012,01,024,0424,0,270,5,275,377,0,0,0,0,0,0,0,66.31 ,72.94 ,66.31 
03,012,01,024,0425,0,289,6,295,372,0,0,0,0,0,0,0,66.31 ,79.30 ,66.31 
03,012,01,024,0426,0,642,9,651,805,0,0,0,0,0,0,0,66.31 ,80.87 ,66.31 
03,012,01,024,0427,0,527,3,530,655,0,0,0,0,0,0,0,66.31 ,80.92 ,66.31 
03,012,01,024,0428,0,365,7,372,482,0,0,0,0,0,0,0,66.31 ,77.18 ,66.31 
03,012,01,024,0429,0,910,8,918,1145,0,0,0,0,0,0,0,66.31 ,80.17 ,66.31 
03,012,01,024,0430,0,799,5,804,958,0,0,0,0,0,0,0,66.31 ,83.92 ,66.31 
03,012,01,024,0431,0,388,4,392,543,0,0,0,0,0,0,0,66.31 ,72.19 ,66.31 
03,012,01,024,0432,0,522,5,527,680,0,0,0,0,0,0,0,66.31 ,77.50 ,66.31 
03,012,01,024,0433,0,513,5,518,684,0,0,0,0,0,0,0,66.31 ,75.73 ,66.31 
03,012,01,024,0434,0,493,3,496,615,0,0,0,0,0,0,0,66.31 ,80.65 ,66.31 
03,012,01,025,0435,0,42,0,42,70,0,0,0,0,0,0,0,66.31 ,60.00 ,66.31 
03,012,01,025,0436,0,7,0,7,16,0,0,0,0,0,0,0,66.31 ,43.75 ,66.31 
03,012,01,025,0437,0,14,0,14,22,0,0,0,0,0,0,0,66.31 ,63.64 ,66.31 
03,012,01,026,0438,0,14,0,14,34,0,0,0,0,0,0,0,66.31 ,41.18 ,66.31 
03,012,01,026,0439,0,54,1,55,76,0,0,0,0,0,0,0,66.31 ,72.37 ,66.31 
03,012,01,026,0440,0,41,1,42,83,0,0,0,0,0,0,0,66.31 ,50.60 ,66.31 
03,012,01,026,0441,0,81,0,81,144,0,0,0,0,0,0,0,66.31 ,56.25 ,66.31 
03,012,01,026,0442,0,10,0,10,19,0,0,0,0,0,0,0,66.31 ,52.63 ,66.31 
03,012,01,026,0443,0,11,0,11,15,0,0,0,0,0,0,0,66.31 ,73.33 ,66.31 
03,012,01,026,0444,0,7,0,7,12,0,0,0,0,0,0,0,66.31 ,58.33 ,66.31 
03,012,01,026,0445,0,8,0,8,16,0,0,0,0,0,0,0,66.31 ,50.00 ,66.31 
03,012,01,027,0446,0,49,1,50,156,0,0,0,0,0,0,0,66.31 ,32.05 ,66.31 
03,012,01,027,0447,0,26,0,26,45,0,0,0,0,0,0,0,66.31 ,57.78 ,66.31 
03,012,01,027,0448,0,58,0,58,98,0,0,0,0,0,0,0,66.31 ,59.18 ,66.31 
03,013,01,001,0001,0,801,5,806,1224,0,0,0,0,0,0,0,66.31 ,65.85 ,66.31 
03,013,01,001,0002,0,1042,13,1055,1531,0,0,0,0,0,0,0,66.31 ,68.91 ,66.31 
03,013,01,001,0003,0,586,4,590,798,0,0,0,0,0,0,0,66.31 ,73.93 ,66.31 
03,013,01,001,0004,0,878,3,881,1394,0,0,0,0,0,0,0,66.31 ,63.20 ,66.31 
03,013,01,001,0005,0,1933,14,1947,2882,0,0,0,0,0,0,0,66.31 ,67.56 ,66.31 
03,013,01,001,0006,0,987,5,992,1486,0,0,0,0,0,0,0,66.31 ,66.76 ,66.31 
03,013,01,001,0007,0,608,10,618,897,0,0,0,0,0,0,0,66.31 ,68.90 ,66.31 
03,013,01,001,0008,0,599,8,607,853,0,0,0,0,0,0,0,66.31 ,71.16 ,66.31 
03,013,01,001,0009,0,867,5,872,1282,0,0,0,0,0,0,0,66.31 ,68.02 ,66.31 
03,013,01,001,0010,0,637,8,645,918,0,0,0,0,0,0,0,66.31 ,70.26 ,66.31 
03,013,01,001,0011,0,740,9,749,1102,0,0,0,0,0,0,0,66.31 ,67.97 ,66.31 
03,013,01,001,0012,0,947,6,953,1539,0,0,0,0,0,0,0,66.31 ,61.92 ,66.31 
03,013,01,001,0013,0,658,8,666,954,0,0,0,0,0,0,0,66.31 ,69.81 ,66.31 
03,013,01,001,0014,0,1250,12,1262,2022,0,0,0,0,0,0,0,66.31 ,62.41 ,66.31 
03,013,01,001,0015,0,1484,10,1494,2296,0,0,0,0,0,0,0,66.31 ,65.07 ,66.31 
03,013,01,001,0016,0,2358,14,2372,3665,0,0,0,0,0,0,0,66.31 ,64.72 ,66.31 
03,013,01,001,0017,0,4735,39,4774,7405,0,0,0,0,0,0,0,66.31 ,64.47 ,66.31 
03,013,01,001,0018,0,2266,17,2283,3441,0,0,0,0,0,0,0,66.31 ,66.35 ,66.31 
03,013,01,001,0019,0,628,7,635,922,0,0,0,0,0,0,0,66.31 ,68.87 ,66.31 
03,013,01,001,0020,0,910,7,917,1293,0,0,0,0,0,0,0,66.31 ,70.92 ,66.31 
03,013,01,001,0021,0,715,6,721,1069,0,0,0,0,0,0,0,66.31 ,67.45 ,66.31 
03,013,01,001,0022,0,3649,45,3694,5853,0,0,0,0,0,0,0,66.31 ,63.11 ,66.31 
03,013,01,001,0023,0,958,11,969,1375,0,0,0,0,0,0,0,66.31 ,70.47 ,66.31 
03,013,01,001,0024,0,984,10,994,1537,0,0,0,0,0,0,0,66.31 ,64.67 ,66.31 
03,013,01,001,0025,0,490,6,496,799,0,0,0,0,0,0,0,66.31 ,62.08 ,66.31 
03,013,01,001,0026,0,578,11,589,820,0,0,0,0,0,0,0,66.31 ,71.83 ,66.31 
03,013,01,001,0027,0,1859,23,1882,3077,0,0,0,0,0,0,0,66.31 ,61.16 ,66.31 
03,013,01,001,0028,0,3869,39,3908,6149,0,0,0,0,0,0,0,66.31 ,63.56 ,66.31 
03,013,01,001,0029,0,2653,28,2681,4214,0,0,0,0,0,0,0,66.31 ,63.62 ,66.31 
03,013,01,001,0030,0,373,2,375,535,0,0,0,0,0,0,0,66.31 ,70.09 ,66.31 
03,013,01,001,0031,0,679,1,680,923,0,0,0,0,0,0,0,66.31 ,73.67 ,66.31 
03,013,01,001,0032,0,1618,23,1641,2323,0,0,0,0,0,0,0,66.31 ,70.64 ,66.31 
03,013,01,001,0033,0,991,16,1007,1428,0,0,0,0,0,0,0,66.31 ,70.52 ,66.31 
03,013,01,001,0034,0,1433,7,1440,2046,0,0,0,0,0,0,0,66.31 ,70.38 ,66.31 
03,013,01,001,0035,0,1074,10,1084,1472,0,0,0,0,0,0,0,66.31 ,73.64 ,66.31 
03,013,01,001,0036,0,949,7,956,1248,0,0,0,0,0,0,0,66.31 ,76.60 ,66.31 
03,013,01,001,0037,0,757,8,765,1134,0,0,0,0,0,0,0,66.31 ,67.46 ,66.31 
03,013,01,001,0038,0,1208,16,1224,1849,0,0,0,0,0,0,0,66.31 ,66.20 ,66.31 
03,013,01,001,0039,0,832,13,845,1286,0,0,0,0,0,0,0,66.31 ,65.71 ,66.31 
03,013,01,001,0040,0,1235,18,1253,1972,0,0,0,0,0,0,0,66.31 ,63.54 ,66.31 
03,013,01,001,0041,0,730,6,736,1154,0,0,0,0,0,0,0,66.31 ,63.78 ,66.31 
03,013,01,001,0042,0,3865,43,3908,6167,0,0,0,0,0,0,0,66.31 ,63.37 ,66.31 
03,013,01,001,0043,0,2404,21,2425,3662,0,0,0,0,0,0,0,66.31 ,66.22 ,66.31 
03,013,01,001,0044,0,800,5,805,1153,0,0,0,0,0,0,0,66.31 ,69.82 ,66.31 
03,013,01,001,0045,0,706,11,717,965,0,0,0,0,0,0,0,66.31 ,74.30 ,66.31 
03,013,01,001,0046,0,936,9,945,1435,0,0,0,0,0,0,0,66.31 ,65.85 ,66.31 
03,013,01,001,0047,0,949,12,961,1375,0,0,0,0,0,0,0,66.31 ,69.89 ,66.31 
03,013,01,001,0048,0,664,2,666,1012,0,0,0,0,0,0,0,66.31 ,65.81 ,66.31 
03,013,01,001,0049,0,1225,12,1237,1846,0,0,0,0,0,0,0,66.31 ,67.01 ,66.31 
03,013,01,001,0050,0,668,5,673,1028,0,0,0,0,0,0,0,66.31 ,65.47 ,66.31 
03,013,01,001,0051,0,2673,24,2697,4083,0,0,0,0,0,0,0,66.31 ,66.05 ,66.31 
03,013,01,001,0052,0,1660,14,1674,2463,0,0,0,0,0,0,0,66.31 ,67.97 ,66.31 
03,013,01,001,0053,0,2027,10,2037,3071,0,0,0,0,0,0,0,66.31 ,66.33 ,66.31 
03,013,01,001,0054,0,1211,10,1221,1999,0,0,0,0,0,0,0,66.31 ,61.08 ,66.31 
03,013,01,001,0055,0,3123,26,3149,5071,0,0,0,0,0,0,0,66.31 ,62.10 ,66.31 
03,013,01,001,0056,0,1553,11,1564,2329,0,0,0,0,0,0,0,66.31 ,67.15 ,66.31 
03,013,01,001,0057,0,2389,20,2409,3781,0,0,0,0,0,0,0,66.31 ,63.71 ,66.31 
03,013,01,001,0058,0,1517,16,1533,2370,0,0,0,0,0,0,0,66.31 ,64.68 ,66.31 
03,013,01,001,0059,0,3752,27,3779,5587,0,0,0,0,0,0,0,66.31 ,67.64 ,66.31 
03,013,01,001,0060,0,1343,11,1354,1752,0,0,0,0,0,0,0,66.31 ,77.28 ,66.31 
03,013,01,001,0061,0,1020,8,1028,1566,0,0,0,0,0,0,0,66.31 ,65.64 ,66.31 
03,013,01,001,0062,0,504,6,510,746,0,0,0,0,0,0,0,66.31 ,68.36 ,66.31 
03,013,01,001,0063,0,3937,42,3979,6287,0,0,0,0,0,0,0,66.31 ,63.29 ,66.31 
03,013,01,001,0064,0,858,16,874,1192,0,0,0,0,0,0,0,66.31 ,73.32 ,66.31 
03,013,01,001,0065,0,633,3,636,810,0,0,0,0,0,0,0,66.31 ,78.52 ,66.31 
03,013,01,001,0066,0,713,4,717,998,0,0,0,0,0,0,0,66.31 ,71.84 ,66.31 
03,013,01,001,0067,0,1040,6,1046,1428,0,0,0,0,0,0,0,66.31 ,73.25 ,66.31 
03,013,01,001,0068,0,657,7,664,935,0,0,0,0,0,0,0,66.31 ,71.02 ,66.31 
03,013,01,002,0069,0,2614,27,2641,3927,0,0,0,0,0,0,0,66.31 ,67.25 ,66.31 
03,013,01,002,0070,0,3219,25,3244,5018,0,0,0,0,0,0,0,66.31 ,64.65 ,66.31 
03,013,01,002,0071,0,1074,7,1081,1686,0,0,0,0,0,0,0,66.31 ,64.12 ,66.31 
03,013,01,002,0072,0,666,5,671,1006,0,0,0,0,0,0,0,66.31 ,66.70 ,66.31 
03,013,01,002,0073,0,448,1,449,645,0,0,0,0,0,0,0,66.31 ,69.61 ,66.31 
03,013,01,002,0074,0,2350,25,2375,3596,0,0,0,0,0,0,0,66.31 ,66.05 ,66.31 
03,013,01,002,0075,0,599,8,607,787,0,0,0,0,0,0,0,66.31 ,77.13 ,66.31 
03,013,01,002,0076,0,782,11,793,1224,0,0,0,0,0,0,0,66.31 ,64.79 ,66.31 
03,013,01,002,0077,0,971,2,973,1474,0,0,0,0,0,0,0,66.31 ,66.01 ,66.31 
03,013,01,002,0078,0,557,2,559,768,0,0,0,0,0,0,0,66.31 ,72.79 ,66.31 
03,013,01,002,0079,0,1252,14,1266,1813,0,0,0,0,0,0,0,66.31 ,69.83 ,66.31 
03,013,01,002,0080,0,1276,13,1289,1930,0,0,0,0,0,0,0,66.31 ,66.79 ,66.31 
03,013,01,002,0081,0,2973,29,3002,4563,0,0,0,0,0,0,0,66.31 ,65.79 ,66.31 
03,013,01,002,0082,0,892,8,900,1403,0,0,0,0,0,0,0,66.31 ,64.15 ,66.31 
03,013,01,002,0083,0,881,13,894,1264,0,0,0,0,0,0,0,66.31 ,70.73 ,66.31 
03,013,01,002,0084,0,579,3,582,798,0,0,0,0,0,0,0,66.31 ,72.93 ,66.31 
03,013,01,002,0085,0,377,7,384,583,0,0,0,0,0,0,0,66.31 ,65.87 ,66.31 
03,013,01,002,0086,0,1006,15,1021,1547,0,0,0,0,0,0,0,66.31 ,66.00 ,66.31 
03,013,01,002,0087,0,1025,16,1041,1437,0,0,0,0,0,0,0,66.31 ,72.44 ,66.31 
03,013,01,002,0088,0,1337,18,1355,1872,0,0,0,0,0,0,0,66.31 ,72.38 ,66.31 
03,013,01,002,0089,0,1015,8,1023,1559,0,0,0,0,0,0,0,66.31 ,65.62 ,66.31 
03,013,01,003,0090,0,1683,13,1696,2289,0,0,0,0,0,0,0,66.31 ,74.09 ,66.31 
03,013,01,003,0091,0,426,2,428,577,0,0,0,0,0,0,0,66.31 ,74.18 ,66.31 
03,013,01,003,0092,0,382,1,383,492,0,0,0,0,0,0,0,66.31 ,77.85 ,66.31 
03,013,01,003,0093,0,530,0,530,737,0,0,0,0,0,0,0,66.31 ,71.91 ,66.31 
03,013,01,003,0094,0,429,6,435,615,0,0,0,0,0,0,0,66.31 ,70.73 ,66.31 
03,013,01,003,0095,0,3431,30,3461,4983,0,0,0,0,0,0,0,66.31 ,69.46 ,66.31 
03,013,01,003,0096,0,568,4,572,725,0,0,0,0,0,0,0,66.31 ,78.90 ,66.31 
03,013,01,003,0097,0,553,11,564,745,0,0,0,0,0,0,0,66.31 ,75.70 ,66.31 
03,013,01,003,0098,0,1314,8,1322,1904,0,0,0,0,0,0,0,66.31 ,69.43 ,66.31 
03,013,01,003,0099,0,610,4,614,884,0,0,0,0,0,0,0,66.31 ,69.46 ,66.31 
03,013,01,003,0100,0,956,12,968,1379,0,0,0,0,0,0,0,66.31 ,70.20 ,66.31 
03,013,01,003,0101,0,543,4,547,734,0,0,0,0,0,0,0,66.31 ,74.52 ,66.31 
03,013,01,003,0102,0,917,14,931,1288,0,0,0,0,0,0,0,66.31 ,72.28 ,66.31 
03,013,01,003,0103,0,1342,16,1358,1855,0,0,0,0,0,0,0,66.31 ,73.21 ,66.31 
03,013,01,003,0104,0,1716,21,1737,2424,0,0,0,0,0,0,0,66.31 ,71.66 ,66.31 
03,013,01,003,0105,0,995,6,1001,1439,0,0,0,0,0,0,0,66.31 ,69.56 ,66.31 
03,013,01,003,0106,0,1130,9,1139,1609,0,0,0,0,0,0,0,66.31 ,70.79 ,66.31 
03,013,01,003,0107,0,2205,16,2221,3227,0,0,0,0,0,0,0,66.31 ,68.83 ,66.31 
03,013,01,003,0108,0,1258,8,1266,1749,0,0,0,0,0,0,0,66.31 ,72.38 ,66.31 
03,013,01,003,0109,0,1141,9,1150,1532,0,0,0,0,0,0,0,66.31 ,75.07 ,66.31 
03,013,01,003,0110,0,640,6,646,844,0,0,0,0,0,0,0,66.31 ,76.54 ,66.31 
03,013,01,003,0111,0,506,4,510,733,0,0,0,0,0,0,0,66.31 ,69.58 ,66.31 
03,013,01,003,0112,0,210,0,210,355,0,0,0,0,0,0,0,66.31 ,59.15 ,66.31 
03,013,01,004,0113,0,643,7,650,990,0,0,0,0,0,0,0,66.31 ,65.66 ,66.31 
03,013,01,004,0114,0,1116,25,1141,1918,0,0,0,0,0,0,0,66.31 ,59.49 ,66.31 
03,013,01,004,0115,0,688,4,692,1138,0,0,0,0,0,0,0,66.31 ,60.81 ,66.31 
03,013,01,004,0116,0,1779,30,1809,3247,0,0,0,0,0,0,0,66.31 ,55.71 ,66.31 
03,013,01,004,0117,0,1383,18,1401,2443,0,0,0,0,0,0,0,66.31 ,57.35 ,66.31 
03,013,01,004,0118,0,433,2,435,802,0,0,0,0,0,0,0,66.31 ,54.24 ,66.31 
03,013,01,004,0119,0,296,10,306,503,0,0,0,0,0,0,0,66.31 ,60.83 ,66.31 
03,013,01,004,0120,0,240,2,242,487,0,0,0,0,0,0,0,66.31 ,49.69 ,66.31 
03,013,01,004,0121,0,561,13,574,924,0,0,0,0,0,0,0,66.31 ,62.12 ,66.31 
03,013,01,004,0122,0,367,11,378,570,0,0,0,0,0,0,0,66.31 ,66.32 ,66.31 
03,013,01,004,0123,0,598,9,607,956,0,0,0,0,0,0,0,66.31 ,63.49 ,66.31 
03,013,01,004,0124,0,883,15,898,1460,0,0,0,0,0,0,0,66.31 ,61.51 ,66.31 
03,013,01,004,0125,0,997,21,1018,1741,0,0,0,0,0,0,0,66.31 ,58.47 ,66.31 
03,013,01,004,0126,0,754,14,768,1410,0,0,0,0,0,0,0,66.31 ,54.47 ,66.31 
03,013,01,004,0127,0,787,17,804,1325,0,0,0,0,0,0,0,66.31 ,60.68 ,66.31 
03,013,01,004,0128,0,758,16,774,1153,0,0,0,0,0,0,0,66.31 ,67.13 ,66.31 
03,013,01,004,0129,0,660,7,667,1031,0,0,0,0,0,0,0,66.31 ,64.69 ,66.31 
03,013,01,005,0130,0,916,6,922,1330,0,0,0,0,0,0,0,66.31 ,69.32 ,66.31 
03,013,01,005,0131,0,931,5,936,1320,0,0,0,0,0,0,0,66.31 ,70.91 ,66.31 
03,013,01,005,0132,0,1220,11,1231,1680,0,0,0,0,0,0,0,66.31 ,73.27 ,66.31 
03,013,01,005,0133,0,631,7,638,819,0,0,0,0,0,0,0,66.31 ,77.90 ,66.31 
03,013,01,005,0134,0,925,4,929,1093,0,0,0,0,0,0,0,66.31 ,85.00 ,66.31 
03,013,01,005,0135,0,813,9,822,1031,0,0,0,0,0,0,0,66.31 ,79.73 ,66.31 
03,013,01,005,0136,0,500,1,501,622,0,0,0,0,0,0,0,66.31 ,80.55 ,66.31 
03,013,01,005,0137,0,1101,8,1109,1534,0,0,0,0,0,0,0,66.31 ,72.29 ,66.31 
03,013,01,005,0138,0,987,9,996,1361,0,0,0,0,0,0,0,66.31 ,73.18 ,66.31 
03,013,01,005,0139,0,1034,15,1049,1373,0,0,0,0,0,0,0,66.31 ,76.40 ,66.31 
03,013,01,005,0140,0,639,2,641,825,0,0,0,0,0,0,0,66.31 ,77.70 ,66.31 
03,013,01,005,0141,0,802,11,813,963,0,0,0,0,0,0,0,66.31 ,84.42 ,66.31 
03,013,01,005,0142,0,914,6,920,1160,0,0,0,0,0,0,0,66.31 ,79.31 ,66.31 
03,013,01,005,0143,0,1095,8,1103,1382,0,0,0,0,0,0,0,66.31 ,79.81 ,66.31 
03,013,01,005,0144,0,1369,14,1383,1752,0,0,0,0,0,0,0,66.31 ,78.94 ,66.31 
03,013,01,005,0145,0,1396,19,1415,1782,0,0,0,0,0,0,0,66.31 ,79.41 ,66.31 
03,013,01,005,0146,0,383,2,385,498,0,0,0,0,0,0,0,66.31 ,77.31 ,66.31 
03,013,01,005,0147,0,592,6,598,762,0,0,0,0,0,0,0,66.31 ,78.48 ,66.31 
03,013,01,005,0148,0,860,2,862,1084,0,0,0,0,0,0,0,66.31 ,79.52 ,66.31 
03,013,01,005,0149,0,268,3,271,351,0,0,0,0,0,0,0,66.31 ,77.21 ,66.31 
03,013,01,005,0150,0,975,11,986,1292,0,0,0,0,0,0,0,66.31 ,76.32 ,66.31 
03,013,01,005,0151,0,1031,4,1035,1416,0,0,0,0,0,0,0,66.31 ,73.09 ,66.31 
03,013,01,005,0152,0,1285,7,1292,1740,0,0,0,0,0,0,0,66.31 ,74.25 ,66.31 
03,013,01,005,0153,0,1205,8,1213,1631,0,0,0,0,0,0,0,66.31 ,74.37 ,66.31 
03,013,01,005,0154,0,1455,15,1470,1908,0,0,0,0,0,0,0,66.31 ,77.04 ,66.31 
03,013,01,005,0155,0,893,10,903,1192,0,0,0,0,0,0,0,66.31 ,75.76 ,66.31 
03,013,01,005,0156,0,543,4,547,687,0,0,0,0,0,0,0,66.31 ,79.62 ,66.31 
03,013,01,005,0157,0,376,9,385,499,0,0,0,0,0,0,0,66.31 ,77.15 ,66.31 
03,013,01,005,0158,0,351,2,353,446,0,0,0,0,0,0,0,66.31 ,79.15 ,66.31 
03,013,01,005,0159,0,2368,25,2393,3143,0,0,0,0,0,0,0,66.31 ,76.14 ,66.31 
03,013,01,006,0160,0,1287,19,1306,1996,0,0,0,0,0,0,0,66.31 ,65.43 ,66.31 
03,013,01,006,0161,0,1635,9,1644,2372,0,0,0,0,0,0,0,66.31 ,69.31 ,66.31 
03,013,01,006,0162,0,1002,11,1013,1408,0,0,0,0,0,0,0,66.31 ,71.95 ,66.31 
03,013,01,006,0163,0,1059,6,1065,1609,0,0,0,0,0,0,0,66.31 ,66.19 ,66.31 
03,013,01,006,0164,0,690,4,694,960,0,0,0,0,0,0,0,66.31 ,72.29 ,66.31 
03,013,01,006,0165,0,1028,13,1041,1404,0,0,0,0,0,0,0,66.31 ,74.15 ,66.31 
03,013,01,006,0166,0,748,11,759,1023,0,0,0,0,0,0,0,66.31 ,74.19 ,66.31 
03,013,01,006,0167,0,562,8,570,757,0,0,0,0,0,0,0,66.31 ,75.30 ,66.31 
03,013,01,006,0168,0,974,6,980,1373,0,0,0,0,0,0,0,66.31 ,71.38 ,66.31 
03,013,01,006,0169,0,618,5,623,813,0,0,0,0,0,0,0,66.31 ,76.63 ,66.31 
03,013,01,006,0170,0,765,13,778,1038,0,0,0,0,0,0,0,66.31 ,74.95 ,66.31 
03,013,01,006,0171,0,889,5,894,1295,0,0,0,0,0,0,0,66.31 ,69.03 ,66.31 
03,013,01,006,0172,0,1090,8,1098,1582,0,0,0,0,0,0,0,66.31 ,69.41 ,66.31 
03,013,01,006,0173,0,731,2,733,1027,0,0,0,0,0,0,0,66.31 ,71.37 ,66.31 
03,013,01,006,0174,0,1413,14,1427,2104,0,0,0,0,0,0,0,66.31 ,67.82 ,66.31 
03,013,01,006,0175,0,317,6,323,495,0,0,0,0,0,0,0,66.31 ,65.25 ,66.31 
03,013,01,007,0176,0,1206,13,1219,1650,0,0,0,0,0,0,0,66.31 ,73.88 ,66.31 
03,013,01,007,0177,0,632,2,634,827,0,0,0,0,0,0,0,66.31 ,76.66 ,66.31 
03,013,01,007,0178,0,1071,3,1074,1468,0,0,0,0,0,0,0,66.31 ,73.16 ,66.31 
03,013,01,007,0179,0,1468,7,1475,2096,0,0,0,0,0,0,0,66.31 ,70.37 ,66.31 
03,013,01,007,0180,0,774,3,777,1041,0,0,0,0,0,0,0,66.31 ,74.64 ,66.31 
03,013,01,007,0181,0,558,6,564,756,0,0,0,0,0,0,0,66.31 ,74.60 ,66.31 
03,013,01,007,0182,0,498,5,503,675,0,0,0,0,0,0,0,66.31 ,74.52 ,66.31 
03,013,01,008,0183,0,1153,7,1160,1528,0,0,0,0,0,0,0,66.31 ,75.92 ,66.31 
03,013,01,008,0184,0,934,12,946,1248,0,0,0,0,0,0,0,66.31 ,75.80 ,66.31 
03,013,01,008,0185,0,981,10,991,1359,0,0,0,0,0,0,0,66.31 ,72.92 ,66.31 
03,013,01,008,0186,0,746,5,751,967,0,0,0,0,0,0,0,66.31 ,77.66 ,66.31 
03,013,01,008,0187,0,877,9,886,1211,0,0,0,0,0,0,0,66.31 ,73.16 ,66.31 
03,013,01,008,0188,0,1016,6,1022,1388,0,0,0,0,0,0,0,66.31 ,73.63 ,66.31 
03,013,01,008,0189,0,2254,18,2272,3120,0,0,0,0,0,0,0,66.31 ,72.82 ,66.31 
03,013,01,008,0190,0,880,9,889,1183,0,0,0,0,0,0,0,66.31 ,75.15 ,66.31 
03,013,01,008,0191,0,807,12,819,1145,0,0,0,0,0,0,0,66.31 ,71.53 ,66.31 
03,013,01,008,0192,0,1158,10,1168,1611,0,0,0,0,0,0,0,66.31 ,72.50 ,66.31 
03,013,01,008,0193,0,952,5,957,1245,0,0,0,0,0,0,0,66.31 ,76.87 ,66.31 
03,013,01,009,0194,0,1288,11,1299,1855,0,0,0,0,0,0,0,66.31 ,70.03 ,66.31 
03,013,01,009,0195,0,876,7,883,1140,0,0,0,0,0,0,0,66.31 ,77.46 ,66.31 
03,013,01,009,0196,0,570,5,575,795,0,0,0,0,0,0,0,66.31 ,72.33 ,66.31 
03,013,01,009,0197,0,863,8,871,1176,0,0,0,0,0,0,0,66.31 ,74.06 ,66.31 
03,013,01,009,0198,0,1068,18,1086,1589,0,0,0,0,0,0,0,66.31 ,68.34 ,66.31 
03,013,01,009,0199,0,826,6,832,1167,0,0,0,0,0,0,0,66.31 ,71.29 ,66.31 
03,013,01,009,0200,0,952,12,964,1303,0,0,0,0,0,0,0,66.31 ,73.98 ,66.31 
03,013,01,009,0201,0,931,5,936,1277,0,0,0,0,0,0,0,66.31 ,73.30 ,66.31 
03,013,01,009,0202,0,1156,11,1167,1561,0,0,0,0,0,0,0,66.31 ,74.76 ,66.31 
03,013,01,009,0203,0,1627,14,1641,2223,0,0,0,0,0,0,0,66.31 ,73.82 ,66.31 
03,013,01,009,0204,0,1449,22,1471,2015,0,0,0,0,0,0,0,66.31 ,73.00 ,66.31 
03,013,01,009,0205,0,1237,11,1248,1734,0,0,0,0,0,0,0,66.31 ,71.97 ,66.31 
03,013,01,009,0206,0,526,2,528,773,0,0,0,0,0,0,0,66.31 ,68.31 ,66.31 
03,013,01,009,0207,0,359,4,363,498,0,0,0,0,0,0,0,66.31 ,72.89 ,66.31 
03,013,01,010,0208,0,1183,3,1186,1592,0,0,0,0,0,0,0,66.31 ,74.50 ,66.31 
03,013,01,010,0209,0,1573,23,1596,2187,0,0,0,0,0,0,0,66.31 ,72.98 ,66.31 
03,013,01,010,0210,0,1058,12,1070,1516,0,0,0,0,0,0,0,66.31 ,70.58 ,66.31 
03,013,01,010,0211,0,740,8,748,871,0,0,0,0,0,0,0,66.31 ,85.88 ,66.31 
03,013,01,010,0212,0,1835,22,1857,2575,0,0,0,0,0,0,0,66.31 ,72.12 ,66.31 
03,013,01,010,0213,0,1286,15,1301,1892,0,0,0,0,0,0,0,66.31 ,68.76 ,66.31 
03,013,01,010,0214,0,659,3,662,829,0,0,0,0,0,0,0,66.31 ,79.86 ,66.31 
03,013,01,010,0215,0,1899,29,1928,2711,0,0,0,0,0,0,0,66.31 ,71.12 ,66.31 
03,013,01,010,0216,0,1924,21,1945,2884,0,0,0,0,0,0,0,66.31 ,67.44 ,66.31 
03,013,01,010,0217,0,720,3,723,937,0,0,0,0,0,0,0,66.31 ,77.16 ,66.31 
03,013,01,010,0218,0,1004,22,1026,1346,0,0,0,0,0,0,0,66.31 ,76.23 ,66.31 
03,013,01,010,0219,0,398,4,402,574,0,0,0,0,0,0,0,66.31 ,70.03 ,66.31 
03,013,01,011,0220,0,1461,15,1476,2170,0,0,0,0,0,0,0,66.31 ,68.02 ,66.31 
03,013,01,011,0221,0,930,9,939,1379,0,0,0,0,0,0,0,66.31 ,68.09 ,66.31 
03,013,01,011,0222,0,581,7,588,838,0,0,0,0,0,0,0,66.31 ,70.17 ,66.31 
03,013,01,011,0223,0,431,3,434,633,0,0,0,0,0,0,0,66.31 ,68.56 ,66.31 
03,013,01,011,0224,0,657,2,659,1006,0,0,0,0,0,0,0,66.31 ,65.51 ,66.31 
03,013,01,011,0225,0,734,10,744,1198,0,0,0,0,0,0,0,66.31 ,62.10 ,66.31 
03,013,01,011,0226,0,444,6,450,696,0,0,0,0,0,0,0,66.31 ,64.66 ,66.31 
03,013,01,011,0227,0,547,5,552,855,0,0,0,0,0,0,0,66.31 ,64.56 ,66.31 
03,013,01,011,0228,0,518,6,524,761,0,0,0,0,0,0,0,66.31 ,68.86 ,66.31 
03,013,01,011,0229,0,839,8,847,1329,0,0,0,0,0,0,0,66.31 ,63.73 ,66.31 
03,013,01,011,0230,0,939,25,964,1554,0,0,0,0,0,0,0,66.31 ,62.03 ,66.31 
03,013,01,011,0231,0,1199,15,1214,2020,0,0,0,0,0,0,0,66.31 ,60.10 ,66.31 
03,013,01,011,0232,0,789,9,798,1229,0,0,0,0,0,0,0,66.31 ,64.93 ,66.31 
03,013,01,011,0233,0,627,7,634,956,0,0,0,0,0,0,0,66.31 ,66.32 ,66.31 
03,013,01,011,0234,0,695,9,704,1073,0,0,0,0,0,0,0,66.31 ,65.61 ,66.31 
03,013,01,011,0235,0,739,11,750,1046,0,0,0,0,0,0,0,66.31 ,71.70 ,66.31 
03,013,01,011,0236,0,759,9,768,1140,0,0,0,0,0,0,0,66.31 ,67.37 ,66.31 
03,013,01,011,0237,0,861,13,874,1371,0,0,0,0,0,0,0,66.31 ,63.75 ,66.31 
03,013,01,011,0238,0,909,6,915,1406,0,0,0,0,0,0,0,66.31 ,65.08 ,66.31 
03,013,01,012,0239,0,862,4,866,1230,0,0,0,0,0,0,0,66.31 ,70.41 ,66.31 
03,013,01,012,0240,0,594,5,599,799,0,0,0,0,0,0,0,66.31 ,74.97 ,66.31 
03,013,01,012,0241,0,940,12,952,1369,0,0,0,0,0,0,0,66.31 ,69.54 ,66.31 
03,013,01,012,0242,0,656,2,658,908,0,0,0,0,0,0,0,66.31 ,72.47 ,66.31 
03,013,01,012,0243,0,383,2,385,531,0,0,0,0,0,0,0,66.31 ,72.50 ,66.31 
03,013,01,012,0244,0,877,13,890,1280,0,0,0,0,0,0,0,66.31 ,69.53 ,66.31 
03,013,01,012,0245,0,861,9,870,1152,0,0,0,0,0,0,0,66.31 ,75.52 ,66.31 
03,013,01,012,0246,0,915,17,932,1380,0,0,0,0,0,0,0,66.31 ,67.54 ,66.31 
03,013,01,012,0247,0,952,22,974,1669,0,0,0,0,0,0,0,66.31 ,58.36 ,66.31 
03,013,01,012,0248,0,1232,20,1252,1897,0,0,0,0,0,0,0,66.31 ,66.00 ,66.31 
03,013,01,012,0249,0,1104,10,1114,1564,0,0,0,0,0,0,0,66.31 ,71.23 ,66.31 
03,013,01,012,0250,0,1155,13,1168,1497,0,0,0,0,0,0,0,66.31 ,78.02 ,66.31 
03,013,01,012,0251,0,779,6,785,1063,0,0,0,0,0,0,0,66.31 ,73.85 ,66.31 
03,013,01,012,0252,0,769,5,774,1187,0,0,0,0,0,0,0,66.31 ,65.21 ,66.31 
03,013,01,013,0253,0,1957,24,1981,3015,0,0,0,0,0,0,0,66.31 ,65.70 ,66.31 
03,013,01,013,0254,0,1687,19,1706,2680,0,0,0,0,0,0,0,66.31 ,63.66 ,66.31 
03,013,01,013,0255,0,976,11,987,1337,0,0,0,0,0,0,0,66.31 ,73.82 ,66.31 
03,013,01,013,0256,0,374,3,377,566,0,0,0,0,0,0,0,66.31 ,66.61 ,66.31 
03,013,01,013,0257,0,1362,20,1382,1997,0,0,0,0,0,0,0,66.31 ,69.20 ,66.31 
03,013,01,013,0258,0,1195,10,1205,1741,0,0,0,0,0,0,0,66.31 ,69.21 ,66.31 
03,013,01,013,0259,0,2464,12,2476,3755,0,0,0,0,0,0,0,66.31 ,65.94 ,66.31 
03,013,01,013,0260,0,1361,13,1374,2269,0,0,0,0,0,0,0,66.31 ,60.56 ,66.31 
03,013,01,013,0261,0,1138,11,1149,1638,0,0,0,0,0,0,0,66.31 ,70.15 ,66.31 
03,013,01,013,0262,0,1291,11,1302,1893,0,0,0,0,0,0,0,66.31 ,68.78 ,66.31 
03,013,01,013,0263,0,961,17,978,1498,0,0,0,0,0,0,0,66.31 ,65.29 ,66.31 
03,013,01,013,0264,0,1973,26,1999,2901,0,0,0,0,0,0,0,66.31 ,68.91 ,66.31 
03,013,01,013,0265,0,635,7,642,949,0,0,0,0,0,0,0,66.31 ,67.65 ,66.31 
03,013,01,013,0266,0,720,6,726,1027,0,0,0,0,0,0,0,66.31 ,70.69 ,66.31 
03,013,01,013,0267,0,1398,11,1409,2319,0,0,0,0,0,0,0,66.31 ,60.76 ,66.31 
03,013,01,013,0268,0,953,7,960,1399,0,0,0,0,0,0,0,66.31 ,68.62 ,66.31 
03,013,01,013,0269,0,1591,13,1604,2469,0,0,0,0,0,0,0,66.31 ,64.97 ,66.31 
03,013,01,013,0270,0,1577,38,1615,2555,0,0,0,0,0,0,0,66.31 ,63.21 ,66.31 
03,013,01,013,0271,0,1355,25,1380,2091,0,0,0,0,0,0,0,66.31 ,66.00 ,66.31 
03,013,01,013,0272,0,1151,18,1169,1689,0,0,0,0,0,0,0,66.31 ,69.21 ,66.31 
03,013,01,013,0273,0,1407,13,1420,2166,0,0,0,0,0,0,0,66.31 ,65.56 ,66.31 
03,013,01,013,0274,0,704,10,714,1150,0,0,0,0,0,0,0,66.31 ,62.09 ,66.31 
03,013,01,013,0275,0,527,6,533,800,0,0,0,0,0,0,0,66.31 ,66.63 ,66.31 
03,013,01,014,0276,0,1037,10,1047,1417,0,0,0,0,0,0,0,66.31 ,73.89 ,66.31 
03,013,01,014,0277,0,602,6,608,856,0,0,0,0,0,0,0,66.31 ,71.03 ,66.31 
03,013,01,014,0278,0,497,3,500,675,0,0,0,0,0,0,0,66.31 ,74.07 ,66.31 
03,013,01,014,0279,0,445,3,448,585,0,0,0,0,0,0,0,66.31 ,76.58 ,66.31 
03,013,01,014,0280,0,960,12,972,1292,0,0,0,0,0,0,0,66.31 ,75.23 ,66.31 
03,013,01,014,0281,0,738,7,745,966,0,0,0,0,0,0,0,66.31 ,77.12 ,66.31 
03,013,01,014,0282,0,472,2,474,601,0,0,0,0,0,0,0,66.31 ,78.87 ,66.31 
03,013,01,014,0283,0,351,4,355,457,0,0,0,0,0,0,0,66.31 ,77.68 ,66.31 
03,013,01,014,0284,0,1853,19,1872,2561,0,0,0,0,0,0,0,66.31 ,73.10 ,66.31 
03,013,01,014,0285,0,336,4,340,425,0,0,0,0,0,0,0,66.31 ,80.00 ,66.31 
03,013,01,014,0286,0,398,4,402,570,0,0,0,0,0,0,0,66.31 ,70.53 ,66.31 
03,013,01,014,0287,0,498,3,501,647,0,0,0,0,0,0,0,66.31 ,77.43 ,66.31 
03,013,01,014,0288,0,749,11,760,1142,0,0,0,0,0,0,0,66.31 ,66.55 ,66.31 
03,013,01,014,0289,0,783,4,787,1108,0,0,0,0,0,0,0,66.31 ,71.03 ,66.31 
03,013,01,014,0290,0,693,6,699,942,0,0,0,0,0,0,0,66.31 ,74.20 ,66.31 
03,013,01,015,0291,0,1311,13,1324,1860,0,0,0,0,0,0,0,66.31 ,71.18 ,66.31 
03,013,01,015,0292,0,877,6,883,1214,0,0,0,0,0,0,0,66.31 ,72.73 ,66.31 
03,013,01,015,0293,0,744,7,751,1058,0,0,0,0,0,0,0,66.31 ,70.98 ,66.31 
03,013,01,015,0294,0,503,3,506,753,0,0,0,0,0,0,0,66.31 ,67.20 ,66.31 
03,013,01,015,0295,0,1042,9,1051,1653,0,0,0,0,0,0,0,66.31 ,63.58 ,66.31 
03,013,01,015,0296,0,728,5,733,1309,0,0,0,0,0,0,0,66.31 ,56.00 ,66.31 
03,013,01,015,0297,0,709,2,711,1071,0,0,0,0,0,0,0,66.31 ,66.39 ,66.31 
03,013,01,016,0298,0,882,12,894,1344,0,0,0,0,0,0,0,66.31 ,66.52 ,66.31 
03,013,01,016,0299,0,566,5,571,862,0,0,0,0,0,0,0,66.31 ,66.24 ,66.31 
03,013,01,016,0300,0,606,6,612,944,0,0,0,0,0,0,0,66.31 ,64.83 ,66.31 
03,013,01,016,0301,0,495,5,500,744,0,0,0,0,0,0,0,66.31 ,67.20 ,66.31 
03,013,01,016,0302,0,1136,7,1143,1798,0,0,0,0,0,0,0,66.31 ,63.57 ,66.31 
03,013,01,016,0303,0,2071,15,2086,3476,0,0,0,0,0,0,0,66.31 ,60.01 ,66.31 
03,013,01,016,0304,0,1364,7,1371,1974,0,0,0,0,0,0,0,66.31 ,69.45 ,66.31 
03,013,01,016,0305,0,1156,8,1164,1682,0,0,0,0,0,0,0,66.31 ,69.20 ,66.31 
03,013,01,016,0306,0,1477,26,1503,2194,0,0,0,0,0,0,0,66.31 ,68.51 ,66.31 
03,013,01,016,0307,0,417,5,422,775,0,0,0,0,0,0,0,66.31 ,54.45 ,66.31 
03,013,01,016,0308,0,585,9,594,1000,0,0,0,0,0,0,0,66.31 ,59.40 ,66.31 
03,013,01,016,0309,0,1816,18,1834,2638,0,0,0,0,0,0,0,66.31 ,69.52 ,66.31 
03,013,01,016,0310,0,399,3,402,587,0,0,0,0,0,0,0,66.31 ,68.48 ,66.31 
03,013,01,016,0311,0,608,11,619,958,0,0,0,0,0,0,0,66.31 ,64.61 ,66.31 
03,013,01,016,0312,0,251,3,254,422,0,0,0,0,0,0,0,66.31 ,60.19 ,66.31 
03,013,01,017,0313,0,1229,9,1238,1565,0,0,0,0,0,0,0,66.31 ,79.11 ,66.31 
03,013,01,017,0314,0,1630,10,1640,2231,0,0,0,0,0,0,0,66.31 ,73.51 ,66.31 
03,013,01,017,0315,0,1433,17,1450,1941,0,0,0,0,0,0,0,66.31 ,74.70 ,66.31 
03,013,01,017,0316,0,523,7,530,710,0,0,0,0,0,0,0,66.31 ,74.65 ,66.31 
03,013,01,017,0317,0,589,3,592,749,0,0,0,0,0,0,0,66.31 ,79.04 ,66.31 
03,013,01,017,0318,0,1645,20,1665,2186,0,0,0,0,0,0,0,66.31 ,76.17 ,66.31 
03,013,01,017,0319,0,1482,10,1492,1965,0,0,0,0,0,0,0,66.31 ,75.93 ,66.31 
03,013,01,017,0320,0,1741,11,1752,2175,0,0,0,0,0,0,0,66.31 ,80.55 ,66.31 
03,013,01,017,0321,0,1958,18,1976,2776,0,0,0,0,0,0,0,66.31 ,71.18 ,66.31 
03,013,01,017,0322,0,937,15,952,1247,0,0,0,0,0,0,0,66.31 ,76.34 ,66.31 
03,013,01,017,0323,0,1508,12,1520,2025,0,0,0,0,0,0,0,66.31 ,75.06 ,66.31 
03,013,01,017,0324,0,1159,15,1174,1625,0,0,0,0,0,0,0,66.31 ,72.25 ,66.31 
03,013,01,017,0325,0,956,12,968,1327,0,0,0,0,0,0,0,66.31 ,72.95 ,66.31 
03,013,01,017,0326,0,2481,16,2497,3719,0,0,0,0,0,0,0,66.31 ,67.14 ,66.31 
03,013,01,017,0327,0,1502,12,1514,2174,0,0,0,0,0,0,0,66.31 ,69.64 ,66.31 
03,013,01,018,0328,0,1320,12,1332,1892,0,0,0,0,0,0,0,66.31 ,70.40 ,66.31 
03,013,01,018,0329,0,973,6,979,1501,0,0,0,0,0,0,0,66.31 ,65.22 ,66.31 
03,013,01,018,0330,0,780,15,795,1076,0,0,0,0,0,0,0,66.31 ,73.88 ,66.31 
03,013,01,018,0331,0,796,8,804,1071,0,0,0,0,0,0,0,66.31 ,75.07 ,66.31 
03,013,01,018,0332,0,615,4,619,834,0,0,0,0,0,0,0,66.31 ,74.22 ,66.31 
03,013,01,018,0333,0,981,10,991,1433,0,0,0,0,0,0,0,66.31 ,69.16 ,66.31 
03,013,01,018,0334,0,525,8,533,743,0,0,0,0,0,0,0,66.31 ,71.74 ,66.31 
03,013,01,018,0335,0,1184,15,1199,1685,0,0,0,0,0,0,0,66.31 ,71.16 ,66.31 
03,013,01,019,0336,0,1032,11,1043,1446,0,0,0,0,0,0,0,66.31 ,72.13 ,66.31 
03,013,01,019,0337,0,1149,7,1156,1625,0,0,0,0,0,0,0,66.31 ,71.14 ,66.31 
03,013,01,019,0338,0,622,10,632,840,0,0,0,0,0,0,0,66.31 ,75.24 ,66.31 
03,013,01,019,0339,0,1110,7,1117,1584,0,0,0,0,0,0,0,66.31 ,70.52 ,66.31 
03,013,01,019,0340,0,2275,32,2307,3077,0,0,0,0,0,0,0,66.31 ,74.98 ,66.31 
03,013,01,019,0341,0,658,5,663,875,0,0,0,0,0,0,0,66.31 ,75.77 ,66.31 
03,013,01,019,0342,0,881,7,888,1269,0,0,0,0,0,0,0,66.31 ,69.98 ,66.31 
03,013,01,019,0343,0,1166,16,1182,1754,0,0,0,0,0,0,0,66.31 ,67.39 ,66.31 
03,013,01,019,0344,0,2102,29,2131,2924,0,0,0,0,0,0,0,66.31 ,72.88 ,66.31 
03,013,01,019,0345,0,810,18,828,1143,0,0,0,0,0,0,0,66.31 ,72.44 ,66.31 
03,013,01,020,0346,0,1306,13,1319,1760,0,0,0,0,0,0,0,66.31 ,74.94 ,66.31 
03,013,01,020,0347,0,722,6,728,1007,0,0,0,0,0,0,0,66.31 ,72.29 ,66.31 
03,013,01,020,0348,0,427,5,432,602,0,0,0,0,0,0,0,66.31 ,71.76 ,66.31 
03,013,01,020,0349,0,584,9,593,778,0,0,0,0,0,0,0,66.31 ,76.22 ,66.31 
03,013,01,020,0350,0,736,8,744,1039,0,0,0,0,0,0,0,66.31 ,71.61 ,66.31 
03,013,01,020,0351,0,710,7,717,973,0,0,0,0,0,0,0,66.31 ,73.69 ,66.31 
03,013,01,020,0352,0,779,5,784,1035,0,0,0,0,0,0,0,66.31 ,75.75 ,66.31 
03,013,01,020,0353,0,738,7,745,1099,0,0,0,0,0,0,0,66.31 ,67.79 ,66.31 
03,013,01,020,0354,0,629,5,634,895,0,0,0,0,0,0,0,66.31 ,70.84 ,66.31 
03,013,01,020,0355,0,426,10,436,589,0,0,0,0,0,0,0,66.31 ,74.02 ,66.31 
03,013,01,021,0356,0,1045,11,1056,1488,0,0,0,0,0,0,0,66.31 ,70.97 ,66.31 
03,013,01,021,0357,0,1173,14,1187,1701,0,0,0,0,0,0,0,66.31 ,69.78 ,66.31 
03,013,01,021,0358,0,676,12,688,968,0,0,0,0,0,0,0,66.31 ,71.07 ,66.31 
03,013,01,021,0359,0,1159,15,1174,1684,0,0,0,0,0,0,0,66.31 ,69.71 ,66.31 
03,013,01,021,0360,0,1254,12,1266,1841,0,0,0,0,0,0,0,66.31 ,68.77 ,66.31 
03,013,01,021,0361,0,1451,19,1470,2224,0,0,0,0,0,0,0,66.31 ,66.10 ,66.31 
03,013,01,021,0362,0,842,6,848,1162,0,0,0,0,0,0,0,66.31 ,72.98 ,66.31 
03,013,01,021,0363,0,586,11,597,865,0,0,0,0,0,0,0,66.31 ,69.02 ,66.31 
03,013,01,021,0364,0,887,9,896,1230,0,0,0,0,0,0,0,66.31 ,72.85 ,66.31 
03,013,01,021,0365,0,736,8,744,970,0,0,0,0,0,0,0,66.31 ,76.70 ,66.31 
03,013,01,021,0366,0,763,6,769,1074,0,0,0,0,0,0,0,66.31 ,71.60 ,66.31 
03,013,01,021,0367,0,1524,14,1538,2154,0,0,0,0,0,0,0,66.31 ,71.40 ,66.31 
03,013,01,022,0368,0,1020,8,1028,1692,0,0,0,0,0,0,0,66.31 ,60.76 ,66.31 
03,013,01,022,0369,0,611,3,614,953,0,0,0,0,0,0,0,66.31 ,64.43 ,66.31 
03,013,01,022,0370,0,515,4,519,770,0,0,0,0,0,0,0,66.31 ,67.40 ,66.31 
03,013,01,022,0371,0,826,7,833,1411,0,0,0,0,0,0,0,66.31 ,59.04 ,66.31 
03,013,01,022,0372,0,582,5,587,1043,0,0,0,0,0,0,0,66.31 ,56.28 ,66.31 
03,013,01,022,0373,0,525,1,526,966,0,0,0,0,0,0,0,66.31 ,54.45 ,66.31 
03,013,01,022,0374,0,754,10,764,1305,0,0,0,0,0,0,0,66.31 ,58.54 ,66.31 
03,013,01,022,0375,0,419,1,420,693,0,0,0,0,0,0,0,66.31 ,60.61 ,66.31 
03,013,01,023,0376,0,832,5,837,1354,0,0,0,0,0,0,0,66.31 ,61.82 ,66.31 
03,013,01,023,0377,0,390,10,400,597,0,0,0,0,0,0,0,66.31 ,67.00 ,66.31 
03,013,01,023,0378,0,459,2,461,755,0,0,0,0,0,0,0,66.31 ,61.06 ,66.31 
03,013,01,023,0379,0,495,11,506,841,0,0,0,0,0,0,0,66.31 ,60.17 ,66.31 
03,013,01,023,0380,0,243,3,246,427,0,0,0,0,0,0,0,66.31 ,57.61 ,66.31 
03,013,01,023,0381,0,552,8,560,1001,0,0,0,0,0,0,0,66.31 ,55.94 ,66.31 
03,013,01,023,0382,0,837,15,852,1399,0,0,0,0,0,0,0,66.31 ,60.90 ,66.31 
03,013,01,023,0383,0,285,5,290,432,0,0,0,0,0,0,0,66.31 ,67.13 ,66.31 
03,013,01,023,0384,0,269,12,281,451,0,0,0,0,0,0,0,66.31 ,62.31 ,66.31 
03,013,01,023,0385,0,334,3,337,540,0,0,0,0,0,0,0,66.31 ,62.41 ,66.31 
03,013,01,023,0386,0,297,6,303,512,0,0,0,0,0,0,0,66.31 ,59.18 ,66.31 
03,013,01,024,0387,0,762,16,778,1393,0,0,0,0,0,0,0,66.31 ,55.85 ,66.31 
03,013,01,024,0388,0,142,3,145,271,0,0,0,0,0,0,0,66.31 ,53.51 ,66.31 
03,013,01,024,0389,0,619,3,622,1133,0,0,0,0,0,0,0,66.31 ,54.90 ,66.31 
03,013,01,024,0390,0,611,5,616,1067,0,0,0,0,0,0,0,66.31 ,57.73 ,66.31 
03,013,01,024,0391,0,218,1,219,441,0,0,0,0,0,0,0,66.31 ,49.66 ,66.31 
03,013,01,024,0392,0,323,5,328,679,0,0,0,0,0,0,0,66.31 ,48.31 ,66.31 
03,013,01,024,0393,0,113,3,116,242,0,0,0,0,0,0,0,66.31 ,47.93 ,66.31 
03,013,01,024,0394,0,172,1,173,301,0,0,0,0,0,0,0,66.31 ,57.48 ,66.31 
03,013,01,025,0395,0,1301,17,1318,1755,0,0,0,0,0,0,0,66.31 ,75.10 ,66.31 
03,013,01,025,0396,0,714,6,720,1111,0,0,0,0,0,0,0,66.31 ,64.81 ,66.31 
03,013,01,025,0397,0,585,11,596,1129,0,0,0,0,0,0,0,66.31 ,52.79 ,66.31 
03,013,01,025,0398,0,555,10,565,1037,0,0,0,0,0,0,0,66.31 ,54.48 ,66.31 
03,013,01,026,0399,0,63,2,65,117,0,0,0,0,0,0,0,66.31 ,55.56 ,66.31 
03,013,01,026,0400,0,8,0,8,21,0,0,0,0,0,0,0,66.31 ,38.10 ,66.31 
03,013,01,026,0401,0,5,0,5,14,0,0,0,0,0,0,0,66.31 ,35.71 ,66.31 
03,013,01,026,0402,0,7,2,9,22,0,0,0,0,0,0,0,66.31 ,40.91 ,66.31 
03,013,01,026,0403,0,19,0,19,46,0,0,0,0,0,0,0,66.31 ,41.30 ,66.31 
03,013,01,026,0404,0,24,0,24,42,0,0,0,0,0,0,0,66.31 ,57.14 ,66.31 
03,013,01,026,0405,0,6,0,6,15,0,0,0,0,0,0,0,66.31 ,40.00 ,66.31 
03,013,01,026,0406,0,19,1,20,38,0,0,0,0,0,0,0,66.31 ,52.63 ,66.31 
03,013,01,026,0407,0,32,0,32,56,0,0,0,0,0,0,0,66.31 ,57.14 ,66.31 
03,013,01,026,0408,0,22,0,22,38,0,0,0,0,0,0,0,66.31 ,57.89 ,66.31 
03,013,01,027,0409,0,12,0,12,27,0,0,0,0,0,0,0,66.31 ,44.44 ,66.31 
03,013,01,027,0410,0,8,0,8,19,0,0,0,0,0,0,0,66.31 ,42.11 ,66.31 
03,013,01,027,0411,0,1,0,1,2,0,0,0,0,0,0,0,66.31 ,50.00 ,66.31 
03,013,01,027,0412,0,3,0,3,4,0,0,0,0,0,0,0,66.31 ,75.00 ,66.31 
03,013,01,027,0413,0,6,0,6,20,0,0,0,0,0,0,0,66.31 ,30.00 ,66.31 
03,013,01,027,0414,0,3,0,3,7,0,0,0,0,0,0,0,66.31 ,42.86 ,66.31 
03,013,01,028,0415,0,4,1,5,17,0,0,0,0,0,0,0,66.31 ,29.41 ,66.31 
03,013,01,028,0416,0,59,0,59,96,0,0,0,0,0,0,0,66.31 ,61.46 ,66.31 
03,013,01,028,0417,0,34,0,34,48,0,0,0,0,0,0,0,66.31 ,70.83 ,66.31 
03,013,01,028,0418,0,30,1,31,57,0,0,0,0,0,0,0,66.31 ,54.39 ,66.31 
03,013,01,028,0419,0,7,0,7,14,0,0,0,0,0,0,0,66.31 ,50.00 ,66.31 
03,013,01,028,0420,0,82,2,84,144,0,0,0,0,0,0,0,66.31 ,58.33 ,66.31 
03,013,01,029,0421,0,36,0,36,49,0,0,0,0,0,0,0,66.31 ,73.47 ,66.31 
03,013,01,029,0422,0,15,0,15,33,0,0,0,0,0,0,0,66.31 ,45.45 ,66.31 
03,013,01,029,0423,0,19,0,19,33,0,0,0,0,0,0,0,66.31 ,57.58 ,66.31 
03,013,01,029,0424,0,5,0,5,14,0,0,0,0,0,0,0,66.31 ,35.71 ,66.31 
03,013,01,029,0425,0,5,0,5,9,0,0,0,0,0,0,0,66.31 ,55.56 ,66.31 
03,013,01,029,0426,0,13,0,13,34,0,0,0,0,0,0,0,66.31 ,38.24 ,66.31 
03,013,01,030,0427,0,16,1,17,37,0,0,0,0,0,0,0,66.31 ,45.95 ,66.31 
03,013,01,030,0428,0,17,0,17,43,0,0,0,0,0,0,0,66.31 ,39.53 ,66.31 
03,013,01,030,0429,0,43,1,44,72,0,0,0,0,0,0,0,66.31 ,61.11 ,66.31 
03,013,01,030,0430,0,51,3,54,97,0,0,0,0,0,0,0,66.31 ,55.67 ,66.31 
03,013,01,030,0431,0,25,3,28,47,0,0,0,0,0,0,0,66.31 ,59.57 ,66.31 
03,013,01,030,0432,0,45,1,46,63,0,0,0,0,0,0,0,66.31 ,73.02 ,66.31 
03,013,01,030,0433,0,40,2,42,70,0,0,0,0,0,0,0,66.31 ,60.00 ,66.31 
03,013,01,031,0434,0,28,0,28,59,0,0,0,0,0,0,0,66.31 ,47.46 ,66.31 
03,013,01,031,0435,0,37,0,37,53,0,0,0,0,0,0,0,66.31 ,69.81 ,66.31 
03,013,01,031,0436,0,7,0,7,9,0,0,0,0,0,0,0,66.31 ,77.78 ,66.31 
03,013,01,031,0437,0,97,0,97,150,0,0,0,0,0,0,0,66.31 ,64.67 ,66.31 
03,013,01,031,0438,0,79,0,79,122,0,0,0,0,0,0,0,66.31 ,64.75 ,66.31 
03,013,01,031,0439,0,10,0,10,15,0,0,0,0,0,0,0,66.31 ,66.67 ,66.31 
03,013,01,032,0440,0,24,0,24,44,0,0,0,0,0,0,0,66.31 ,54.55 ,66.31 
03,013,01,032,0441,0,31,0,31,76,0,0,0,0,0,0,0,66.31 ,40.79 ,66.31 
03,013,01,032,0442,0,32,0,32,59,0,0,0,0,0,0,0,66.31 ,54.24 ,66.31 
03,013,01,032,0443,0,8,0,8,21,0,0,0,0,0,0,0,66.31 ,38.10 ,66.31 
03,013,01,032,0444,0,19,0,19,32,0,0,0,0,0,0,0,66.31 ,59.38 ,66.31 
03,013,01,032,0445,0,8,0,8,17,0,0,0,0,0,0,0,66.31 ,47.06 ,66.31 
03,013,01,032,0446,0,21,0,21,36,0,0,0,0,0,0,0,66.31 ,58.33 ,66.31 
03,013,01,032,0447,0,9,0,9,18,0,0,0,0,0,0,0,66.31 ,50.00 ,66.31 
03,013,01,033,0448,0,105,1,106,176,0,0,0,0,0,0,0,66.31 ,60.23 ,66.31 
03,013,01,033,0449,0,17,0,17,47,0,0,0,0,0,0,0,66.31 ,36.17 ,66.31 
03,013,01,033,0450,0,11,0,11,21,0,0,0,0,0,0,0,66.31 ,52.38 ,66.31 
03,013,01,033,0451,0,49,2,51,106,0,0,0,0,0,0,0,66.31 ,48.11 ,66.31 
03,013,01,033,0452,0,16,0,16,34,0,0,0,0,0,0,0,66.31 ,47.06 ,66.31 
03,013,01,033,0453,0,11,0,11,20,0,0,0,0,0,0,0,66.31 ,55.00 ,66.31 
03,014,01,001,0001,0,752,7,759,1172,0,0,0,0,0,0,0,66.31 ,64.76 ,66.31 
03,014,01,001,0002,0,1151,11,1162,1632,0,0,0,0,0,0,0,66.31 ,71.20 ,66.31 
03,014,01,001,0003,0,1984,20,2004,3194,0,0,0,0,0,0,0,66.31 ,62.74 ,66.31 
03,014,01,001,0004,0,1641,22,1663,2605,0,0,0,0,0,0,0,66.31 ,63.84 ,66.31 
03,014,01,001,0005,0,463,6,469,745,0,0,0,0,0,0,0,66.31 ,62.95 ,66.31 
03,014,01,001,0006,0,670,12,682,1067,0,0,0,0,0,0,0,66.31 ,63.92 ,66.31 
03,014,01,001,0007,0,264,0,264,455,0,0,0,0,0,0,0,66.31 ,58.02 ,66.31 
03,014,01,001,0008,0,1080,15,1095,1760,0,0,0,0,0,0,0,66.31 ,62.22 ,66.31 
03,014,01,001,0009,0,503,3,506,768,0,0,0,0,0,0,0,66.31 ,65.89 ,66.31 
03,014,01,001,0010,0,397,2,399,621,0,0,0,0,0,0,0,66.31 ,64.25 ,66.31 
03,014,01,001,0011,0,487,5,492,769,0,0,0,0,0,0,0,66.31 ,63.98 ,66.31 
03,014,01,001,0012,0,513,3,516,873,0,0,0,0,0,0,0,66.31 ,59.11 ,66.31 
03,014,01,001,0013,0,880,11,891,1441,0,0,0,0,0,0,0,66.31 ,61.83 ,66.31 
03,014,01,001,0014,0,570,2,572,916,0,0,0,0,0,0,0,66.31 ,62.45 ,66.31 
03,014,01,001,0015,0,688,5,693,1048,0,0,0,0,0,0,0,66.31 ,66.13 ,66.31 
03,014,01,001,0016,0,471,5,476,721,0,0,0,0,0,0,0,66.31 ,66.02 ,66.31 
03,014,01,001,0017,0,291,4,295,473,0,0,0,0,0,0,0,66.31 ,62.37 ,66.31 
03,014,01,001,0018,0,1626,16,1642,2664,0,0,0,0,0,0,0,66.31 ,61.64 ,66.31 
03,014,01,001,0019,0,454,2,456,724,0,0,0,0,0,0,0,66.31 ,62.98 ,66.31 
03,014,01,001,0020,0,285,4,289,501,0,0,0,0,0,0,0,66.31 ,57.68 ,66.31 
03,014,01,001,0021,0,776,9,785,1207,0,0,0,0,0,0,0,66.31 ,65.04 ,66.31 
03,014,01,001,0022,0,2468,23,2491,4194,0,0,0,0,0,0,0,66.31 ,59.39 ,66.31 
03,014,01,001,0023,0,1339,14,1353,2062,0,0,0,0,0,0,0,66.31 ,65.62 ,66.31 
03,014,01,001,0024,0,1944,18,1962,2972,0,0,0,0,0,0,0,66.31 ,66.02 ,66.31 
03,014,01,001,0025,0,770,4,774,1227,0,0,0,0,0,0,0,66.31 ,63.08 ,66.31 
03,014,01,001,0026,0,1030,16,1046,1602,0,0,0,0,0,0,0,66.31 ,65.29 ,66.31 
03,014,01,001,0027,0,505,7,512,823,0,0,0,0,0,0,0,66.31 ,62.21 ,66.31 
03,014,01,001,0028,0,694,9,703,983,0,0,0,0,0,0,0,66.31 ,71.52 ,66.31 
03,014,01,001,0029,0,666,5,671,1030,0,0,0,0,0,0,0,66.31 ,65.15 ,66.31 
03,014,01,001,0030,0,3030,35,3065,5073,0,0,0,0,0,0,0,66.31 ,60.42 ,66.31 
03,014,01,001,0031,0,1715,23,1738,2835,0,0,0,0,0,0,0,66.31 ,61.31 ,66.31 
03,014,01,001,0032,0,944,11,955,1507,0,0,0,0,0,0,0,66.31 ,63.37 ,66.31 
03,014,01,001,0033,0,629,12,641,956,0,0,0,0,0,0,0,66.31 ,67.05 ,66.31 
03,014,01,001,0034,0,685,9,694,1087,0,0,0,0,0,0,0,66.31 ,63.85 ,66.31 
03,014,01,001,0035,0,284,3,287,459,0,0,0,0,0,0,0,66.31 ,62.53 ,66.31 
03,014,01,001,0036,0,1106,14,1120,1695,0,0,0,0,0,0,0,66.31 ,66.08 ,66.31 
03,014,01,001,0037,0,578,7,585,1044,0,0,0,0,0,0,0,66.31 ,56.03 ,66.31 
03,014,01,001,0038,0,1129,12,1141,1573,0,0,0,0,0,0,0,66.31 ,72.54 ,66.31 
03,014,01,001,0039,0,836,9,845,1333,0,0,0,0,0,0,0,66.31 ,63.39 ,66.31 
03,014,01,001,0040,0,1207,6,1213,1748,0,0,0,0,0,0,0,66.31 ,69.39 ,66.31 
03,014,01,001,0041,0,650,6,656,1012,0,0,0,0,0,0,0,66.31 ,64.82 ,66.31 
03,014,01,001,0042,0,508,9,517,942,0,0,0,0,0,0,0,66.31 ,54.88 ,66.31 
03,014,01,001,0043,0,530,4,534,839,0,0,0,0,0,0,0,66.31 ,63.65 ,66.31 
03,014,01,001,0044,0,544,6,550,868,0,0,0,0,0,0,0,66.31 ,63.36 ,66.31 
03,014,01,001,0045,0,526,9,535,855,0,0,0,0,0,0,0,66.31 ,62.57 ,66.31 
03,014,01,001,0046,0,711,25,736,1121,0,0,0,0,0,0,0,66.31 ,65.66 ,66.31 
03,014,01,002,0047,0,274,2,276,477,0,0,0,0,0,0,0,66.31 ,57.86 ,66.31 
03,014,01,002,0048,0,101,0,101,179,0,0,0,0,0,0,0,66.31 ,56.42 ,66.31 
03,014,01,002,0049,0,1615,7,1622,2425,0,0,0,0,0,0,0,66.31 ,66.89 ,66.31 
03,014,01,002,0050,0,725,4,729,1066,0,0,0,0,0,0,0,66.31 ,68.39 ,66.31 
03,014,01,002,0051,0,646,2,648,1036,0,0,0,0,0,0,0,66.31 ,62.55 ,66.31 
03,014,01,002,0052,0,331,3,334,610,0,0,0,0,0,0,0,66.31 ,54.75 ,66.31 
03,014,01,002,0053,0,291,0,291,531,0,0,0,0,0,0,0,66.31 ,54.80 ,66.31 
03,014,01,002,0054,0,55,0,55,113,0,0,0,0,0,0,0,66.31 ,48.67 ,66.31 
03,014,01,003,0055,0,962,10,972,1647,0,0,0,0,0,0,0,66.31 ,59.02 ,66.31 
03,014,01,003,0056,0,558,7,565,901,0,0,0,0,0,0,0,66.31 ,62.71 ,66.31 
03,014,01,003,0057,0,410,6,416,657,0,0,0,0,0,0,0,66.31 ,63.32 ,66.31 
03,014,01,003,0058,0,585,2,587,947,0,0,0,0,0,0,0,66.31 ,61.99 ,66.31 
03,014,01,003,0059,0,407,4,411,709,0,0,0,0,0,0,0,66.31 ,57.97 ,66.31 
03,014,01,003,0060,0,775,6,781,1285,0,0,0,0,0,0,0,66.31 ,60.78 ,66.31 
03,014,01,003,0061,0,118,2,120,242,0,0,0,0,0,0,0,66.31 ,49.59 ,66.31 
03,014,01,004,0062,0,1160,24,1184,1725,0,0,0,0,0,0,0,66.31 ,68.64 ,66.31 
03,014,01,004,0063,0,604,2,606,1008,0,0,0,0,0,0,0,66.31 ,60.12 ,66.31 
03,014,01,004,0064,0,692,12,704,1057,0,0,0,0,0,0,0,66.31 ,66.60 ,66.31 
03,014,01,004,0065,0,647,13,660,1054,0,0,0,0,0,0,0,66.31 ,62.62 ,66.31 
03,014,01,004,0066,0,139,0,139,236,0,0,0,0,0,0,0,66.31 ,58.90 ,66.31 
03,014,01,004,0067,0,1887,14,1901,2895,0,0,0,0,0,0,0,66.31 ,65.66 ,66.31 
03,014,01,004,0068,0,447,4,451,715,0,0,0,0,0,0,0,66.31 ,63.08 ,66.31 
03,014,01,004,0069,0,248,2,250,402,0,0,0,0,0,0,0,66.31 ,62.19 ,66.31 
03,014,01,004,0070,0,169,2,171,299,0,0,0,0,0,0,0,66.31 ,57.19 ,66.31 
03,014,01,004,0071,0,664,7,671,1066,0,0,0,0,0,0,0,66.31 ,62.95 ,66.31 
03,014,01,004,0072,0,283,1,284,449,0,0,0,0,0,0,0,66.31 ,63.25 ,66.31 
03,014,01,004,0073,0,218,0,218,358,0,0,0,0,0,0,0,66.31 ,60.89 ,66.31 
03,014,01,004,0074,0,144,1,145,261,0,0,0,0,0,0,0,66.31 ,55.56 ,66.31 
03,014,01,005,0075,0,511,6,517,799,0,0,0,0,0,0,0,66.31 ,64.71 ,66.31 
03,014,01,005,0076,0,644,3,647,1055,0,0,0,0,0,0,0,66.31 ,61.33 ,66.31 
03,014,01,005,0077,0,596,9,605,1062,0,0,0,0,0,0,0,66.31 ,56.97 ,66.31 
03,014,01,005,0078,0,474,3,477,793,0,0,0,0,0,0,0,66.31 ,60.15 ,66.31 
03,014,01,005,0079,0,388,2,390,655,0,0,0,0,0,0,0,66.31 ,59.54 ,66.31 
03,014,01,005,0080,0,243,2,245,377,0,0,0,0,0,0,0,66.31 ,64.99 ,66.31 
03,014,01,005,0081,0,573,2,575,1025,0,0,0,0,0,0,0,66.31 ,56.10 ,66.31 
03,014,01,006,0082,0,1224,7,1231,1871,0,0,0,0,0,0,0,66.31 ,65.79 ,66.31 
03,014,01,006,0083,0,801,16,817,1369,0,0,0,0,0,0,0,66.31 ,59.68 ,66.31 
03,014,01,006,0084,0,420,2,422,700,0,0,0,0,0,0,0,66.31 ,60.29 ,66.31 
03,014,01,006,0085,0,63,1,64,111,0,0,0,0,0,0,0,66.31 ,57.66 ,66.31 
03,014,01,006,0086,0,249,4,253,399,0,0,0,0,0,0,0,66.31 ,63.41 ,66.31 
03,014,01,006,0087,0,491,9,500,842,0,0,0,0,0,0,0,66.31 ,59.38 ,66.31 
03,014,01,006,0088,0,276,0,276,457,0,0,0,0,0,0,0,66.31 ,60.39 ,66.31 
03,014,01,006,0089,0,240,1,241,413,0,0,0,0,0,0,0,66.31 ,58.35 ,66.31 
03,014,01,006,0090,0,224,1,225,383,0,0,0,0,0,0,0,66.31 ,58.75 ,66.31 
03,014,01,006,0091,0,96,0,96,181,0,0,0,0,0,0,0,66.31 ,53.04 ,66.31 
03,014,01,007,0092,0,698,11,709,1236,0,0,0,0,0,0,0,66.31 ,57.36 ,66.31 
03,014,01,007,0093,0,382,4,386,686,0,0,0,0,0,0,0,66.31 ,56.27 ,66.31 
03,014,01,007,0094,0,115,0,115,215,0,0,0,0,0,0,0,66.31 ,53.49 ,66.31 
03,014,01,007,0095,0,168,2,170,325,0,0,0,0,0,0,0,66.31 ,52.31 ,66.31 
03,014,01,007,0096,0,411,3,414,686,0,0,0,0,0,0,0,66.31 ,60.35 ,66.31 
03,014,01,007,0097,0,520,5,525,1074,0,0,0,0,0,0,0,66.31 ,48.88 ,66.31 
03,014,01,007,0098,0,101,0,101,211,0,0,0,0,0,0,0,66.31 ,47.87 ,66.31 
03,014,01,008,0099,0,187,3,190,415,0,0,0,0,0,0,0,66.31 ,45.78 ,66.31 
03,014,01,008,0100,0,201,1,202,418,0,0,0,0,0,0,0,66.31 ,48.33 ,66.31 
03,014,01,008,0101,0,663,5,668,1175,0,0,0,0,0,0,0,66.31 ,56.85 ,66.31 
03,014,01,008,0102,0,257,3,260,550,0,0,0,0,0,0,0,66.31 ,47.27 ,66.31 
03,014,01,008,0103,0,107,0,107,226,0,0,0,0,0,0,0,66.31 ,47.35 ,66.31 
03,014,01,008,0104,0,229,2,231,501,0,0,0,0,0,0,0,66.31 ,46.11 ,66.31 
03,014,01,008,0105,0,164,1,165,285,0,0,0,0,0,0,0,66.31 ,57.89 ,66.31 
03,014,01,009,0106,0,592,4,596,924,0,0,0,0,0,0,0,66.31 ,64.50 ,66.31 
03,014,01,009,0107,0,387,1,388,598,0,0,0,0,0,0,0,66.31 ,64.88 ,66.31 
03,014,01,009,0108,0,453,3,456,734,0,0,0,0,0,0,0,66.31 ,62.13 ,66.31 
03,014,01,009,0109,0,246,1,247,386,0,0,0,0,0,0,0,66.31 ,63.99 ,66.31 
03,014,01,009,0110,0,704,2,706,1191,0,0,0,0,0,0,0,66.31 ,59.28 ,66.31 
03,014,01,009,0111,0,877,9,886,1344,0,0,0,0,0,0,0,66.31 ,65.92 ,66.31 
03,014,01,009,0112,0,332,1,333,519,0,0,0,0,0,0,0,66.31 ,64.16 ,66.31 
03,014,01,009,0113,0,314,6,320,596,0,0,0,0,0,0,0,66.31 ,53.69 ,66.31 
03,014,01,009,0114,0,140,3,143,255,0,0,0,0,0,0,0,66.31 ,56.08 ,66.31 
03,014,01,010,0115,0,144,2,146,292,0,0,0,0,0,0,0,66.31 ,50.00 ,66.31 
03,014,01,010,0116,0,691,3,694,1211,0,0,0,0,0,0,0,66.31 ,57.31 ,66.31 
03,014,01,010,0117,0,549,9,558,920,0,0,0,0,0,0,0,66.31 ,60.65 ,66.31 
03,014,01,010,0118,0,69,1,70,152,0,0,0,0,0,0,0,66.31 ,46.05 ,66.31 
03,014,01,010,0119,0,38,0,38,100,0,0,0,0,0,0,0,66.31 ,38.00 ,66.31 
03,014,01,011,0120,0,384,2,386,665,0,0,0,0,0,0,0,66.31 ,58.05 ,66.31 
03,014,01,011,0121,0,402,3,405,702,0,0,0,0,0,0,0,66.31 ,57.69 ,66.31 
03,014,01,011,0122,0,313,6,319,545,0,0,0,0,0,0,0,66.31 ,58.53 ,66.31 
03,014,01,012,0123,0,12,1,13,26,0,0,0,0,0,0,0,66.31 ,50.00 ,66.31 
03,014,01,012,0124,0,30,1,31,48,0,0,0,0,0,0,0,66.31 ,64.58 ,66.31 
03,014,01,012,0125,0,64,1,65,121,0,0,0,0,0,0,0,66.31 ,53.72 ,66.31 
03,014,01,012,0126,0,41,2,43,88,0,0,0,0,0,0,0,66.31 ,48.86 ,66.31 
03,014,01,012,0127,0,16,1,17,29,0,0,0,0,0,0,0,66.31 ,58.62 ,66.31 
03,014,01,012,0128,0,15,1,16,29,0,0,0,0,0,0,0,66.31 ,55.17 ,66.31 
03,014,01,013,0129,0,56,1,57,104,0,0,0,0,0,0,0,66.31 ,54.81 ,66.31 
03,014,01,013,0130,0,15,1,16,26,0,0,0,0,0,0,0,66.31 ,61.54 ,66.31 
03,014,01,013,0131,0,11,0,11,23,0,0,0,0,0,0,0,66.31 ,47.83 ,66.31 
03,014,01,013,0132,0,21,0,21,41,0,0,0,0,0,0,0,66.31 ,51.22 ,66.31 
03,014,01,013,0133,0,63,0,63,111,0,0,0,0,0,0,0,66.31 ,56.76 ,66.31 
03,014,01,014,0134,0,48,0,48,93,0,0,0,0,0,0,0,66.31 ,51.61 ,66.31 
03,014,01,014,0135,0,27,0,27,46,0,0,0,0,0,0,0,66.31 ,58.70 ,66.31 
03,014,01,014,0136,0,19,1,20,35,0,0,0,0,0,0,0,66.31 ,57.14 ,66.31 
03,014,01,014,0137,0,8,0,8,14,0,0,0,0,0,0,0,66.31 ,57.14 ,66.31 
03,014,01,014,0138,0,4,0,4,18,0,0,0,0,0,0,0,66.31 ,22.22 ,66.31 
03,014,01,015,0139,0,98,1,99,191,0,0,0,0,0,0,0,66.31 ,51.83 ,66.31 
03,014,01,015,0140,0,27,0,27,73,0,0,0,0,0,0,0,66.31 ,36.99 ,66.31 
03,014,01,015,0141,0,28,2,30,81,0,0,0,0,0,0,0,66.31 ,37.04 ,66.31 
03,014,01,015,0142,0,7,0,7,19,0,0,0,0,0,0,0,66.31 ,36.84 ,66.31 
03,014,01,015,0143,0,8,0,8,32,0,0,0,0,0,0,0,66.31 ,25.00 ,66.31 
03,014,01,015,0144,0,8,0,8,28,0,0,0,0,0,0,0,66.31 ,28.57 ,66.31 
03,014,01,016,0145,0,24,0,24,55,0,0,0,0,0,0,0,66.31 ,43.64 ,66.31 
03,014,01,016,0146,0,40,1,41,83,0,0,0,0,0,0,0,66.31 ,49.40 ,66.31 
03,014,01,016,0147,0,4,0,4,15,0,0,0,0,0,0,0,66.31 ,26.67 ,66.31 
03,014,01,016,0148,0,6,0,6,13,0,0,0,0,0,0,0,66.31 ,46.15 ,66.31 
03,015,01,001,0001,0,933,4,937,1485,0,0,0,0,0,0,0,66.31 ,63.10 ,66.31 
03,015,01,001,0002,0,1901,26,1927,3195,0,0,0,0,0,0,0,66.31 ,60.31 ,66.31 
03,015,01,001,0003,0,1630,28,1658,2986,0,0,0,0,0,0,0,66.31 ,55.53 ,66.31 
03,015,01,001,0004,0,409,9,418,706,0,0,0,0,0,0,0,66.31 ,59.21 ,66.31 
03,015,01,001,0005,0,1617,14,1631,2862,0,0,0,0,0,0,0,66.31 ,56.99 ,66.31 
03,015,01,001,0006,0,1052,18,1070,1689,0,0,0,0,0,0,0,66.31 ,63.35 ,66.31 
03,015,01,001,0007,0,1437,19,1456,2522,0,0,0,0,0,0,0,66.31 ,57.73 ,66.31 
03,015,01,001,0008,0,897,14,911,1450,0,0,0,0,0,0,0,66.31 ,62.83 ,66.31 
03,015,01,001,0009,0,234,2,236,428,0,0,0,0,0,0,0,66.31 ,55.14 ,66.31 
03,015,01,001,0010,0,363,3,366,618,0,0,0,0,0,0,0,66.31 ,59.22 ,66.31 
03,015,01,001,0011,0,391,4,395,635,0,0,0,0,0,0,0,66.31 ,62.20 ,66.31 
03,015,01,001,0012,0,265,9,274,432,0,0,0,0,0,0,0,66.31 ,63.43 ,66.31 
03,015,01,001,0013,0,340,2,342,622,0,0,0,0,0,0,0,66.31 ,54.98 ,66.31 
03,015,01,001,0014,0,772,11,783,1318,0,0,0,0,0,0,0,66.31 ,59.41 ,66.31 
03,015,01,001,0015,0,301,2,303,505,0,0,0,0,0,0,0,66.31 ,60.00 ,66.31 
03,015,01,001,0016,0,492,3,495,776,0,0,0,0,0,0,0,66.31 ,63.79 ,66.31 
03,015,01,001,0017,0,595,4,599,1008,0,0,0,0,0,0,0,66.31 ,59.42 ,66.31 
03,015,01,001,0018,0,407,6,413,687,0,0,0,0,0,0,0,66.31 ,60.12 ,66.31 
03,015,01,001,0019,0,419,7,426,734,0,0,0,0,0,0,0,66.31 ,58.04 ,66.31 
03,015,01,001,0020,0,593,7,600,995,0,0,0,0,0,0,0,66.31 ,60.30 ,66.31 
03,015,01,001,0021,0,443,4,447,824,0,0,0,0,0,0,0,66.31 ,54.25 ,66.31 
03,015,01,001,0022,0,1514,19,1533,2724,0,0,0,0,0,0,0,66.31 ,56.28 ,66.31 
03,015,01,001,0023,0,933,8,941,1630,0,0,0,0,0,0,0,66.31 ,57.73 ,66.31 
03,015,01,001,0024,0,2742,38,2780,4803,0,0,0,0,0,0,0,66.31 ,57.88 ,66.31 
03,015,01,001,0025,0,1980,16,1996,3574,0,0,0,0,0,0,0,66.31 ,55.85 ,66.31 
03,015,01,001,0026,0,1303,15,1318,2228,0,0,0,0,0,0,0,66.31 ,59.16 ,66.31 
03,015,01,001,0027,0,1732,17,1749,3001,0,0,0,0,0,0,0,66.31 ,58.28 ,66.31 
03,015,01,001,0028,0,900,4,904,1480,0,0,0,0,0,0,0,66.31 ,61.08 ,66.31 
03,015,01,001,0029,0,652,3,655,1086,0,0,0,0,0,0,0,66.31 ,60.31 ,66.31 
03,015,01,001,0030,0,265,2,267,450,0,0,0,0,0,0,0,66.31 ,59.33 ,66.31 
03,015,01,001,0031,0,857,14,871,1411,0,0,0,0,0,0,0,66.31 ,61.73 ,66.31 
03,015,01,001,0032,0,459,3,462,799,0,0,0,0,0,0,0,66.31 ,57.82 ,66.31 
03,015,01,001,0033,0,1178,10,1188,2014,0,0,0,0,0,0,0,66.31 ,58.99 ,66.31 
03,015,01,001,0034,0,1027,6,1033,1758,0,0,0,0,0,0,0,66.31 ,58.76 ,66.31 
03,015,01,001,0035,0,2157,21,2178,4233,0,0,0,0,0,0,0,66.31 ,51.45 ,66.31 
03,015,01,001,0036,0,487,3,490,908,0,0,0,0,0,0,0,66.31 ,53.96 ,66.31 
03,015,01,001,0037,0,2273,21,2294,4015,0,0,0,0,0,0,0,66.31 ,57.14 ,66.31 
03,015,01,001,0038,0,1550,14,1564,2848,0,0,0,0,0,0,0,66.31 ,54.92 ,66.31 
03,015,01,001,0039,0,1602,14,1616,3060,0,0,0,0,0,0,0,66.31 ,52.81 ,66.31 
03,015,01,001,0040,0,368,3,371,788,0,0,0,0,0,0,0,66.31 ,47.08 ,66.31 
03,015,01,002,0041,0,704,8,712,1299,0,0,0,0,0,0,0,66.31 ,54.81 ,66.31 
03,015,01,002,0042,0,459,3,462,874,0,0,0,0,0,0,0,66.31 ,52.86 ,66.31 
03,015,01,002,0043,0,1079,13,1092,1940,0,0,0,0,0,0,0,66.31 ,56.29 ,66.31 
03,015,01,002,0044,0,848,29,877,1636,0,0,0,0,0,0,0,66.31 ,53.61 ,66.31 
03,015,01,002,0045,0,1197,16,1213,2271,0,0,0,0,0,0,0,66.31 ,53.41 ,66.31 
03,015,01,002,0046,0,279,4,283,536,0,0,0,0,0,0,0,66.31 ,52.80 ,66.31 
03,015,01,002,0047,0,1477,28,1505,2558,0,0,0,0,0,0,0,66.31 ,58.84 ,66.31 
03,015,01,002,0048,0,647,15,662,1016,0,0,0,0,0,0,0,66.31 ,65.16 ,66.31 
03,015,01,003,0049,0,141,0,141,403,0,0,0,0,0,0,0,66.31 ,34.99 ,66.31 
03,015,01,003,0050,0,200,1,201,349,0,0,0,0,0,0,0,66.31 ,57.59 ,66.31 
03,015,01,003,0051,0,204,2,206,466,0,0,0,0,0,0,0,66.31 ,44.21 ,66.31 
03,015,01,003,0052,0,58,0,58,139,0,0,0,0,0,0,0,66.31 ,41.73 ,66.31 
03,015,01,003,0053,0,68,5,73,147,0,0,0,0,0,0,0,66.31 ,49.66 ,66.31 
03,015,01,003,0054,0,73,3,76,138,0,0,0,0,0,0,0,66.31 ,55.07 ,66.31 
03,015,01,003,0055,0,63,0,63,113,0,0,0,0,0,0,0,66.31 ,55.75 ,66.31 
03,015,01,003,0056,0,64,0,64,117,0,0,0,0,0,0,0,66.31 ,54.70 ,66.31 
03,015,01,003,0057,0,38,1,39,89,0,0,0,0,0,0,0,66.31 ,43.82 ,66.31 
03,015,01,004,0058,0,1525,18,1543,2837,0,0,0,0,0,0,0,66.31 ,54.39 ,66.31 
03,015,01,004,0059,0,1276,15,1291,2295,0,0,0,0,0,0,0,66.31 ,56.25 ,66.31 
03,015,01,004,0060,0,2121,27,2148,3759,0,0,0,0,0,0,0,66.31 ,57.14 ,66.31 
03,015,01,004,0061,0,1467,19,1486,2659,0,0,0,0,0,0,0,66.31 ,55.89 ,66.31 
03,015,01,004,0062,0,1070,16,1086,1832,0,0,0,0,0,0,0,66.31 ,59.28 ,66.31 
03,015,01,004,0063,0,668,19,687,1128,0,0,0,0,0,0,0,66.31 ,60.90 ,66.31 
03,015,01,004,0064,0,506,11,517,907,0,0,0,0,0,0,0,66.31 ,57.00 ,66.31 
03,015,01,004,0065,0,828,7,835,1420,0,0,0,0,0,0,0,66.31 ,58.80 ,66.31 
03,015,01,004,0066,0,1233,9,1242,2212,0,0,0,0,0,0,0,66.31 ,56.15 ,66.31 
03,015,01,004,0067,0,964,8,972,1834,0,0,0,0,0,0,0,66.31 ,53.00 ,66.31 
03,015,01,004,0068,0,1376,20,1396,2505,0,0,0,0,0,0,0,66.31 ,55.73 ,66.31 
03,015,01,004,0069,0,3073,24,3097,5228,0,0,0,0,0,0,0,66.31 ,59.24 ,66.31 
03,015,01,004,0070,0,1644,22,1666,2940,0,0,0,0,0,0,0,66.31 ,56.67 ,66.31 
03,015,01,004,0071,0,2409,15,2424,4189,0,0,0,0,0,0,0,66.31 ,57.87 ,66.31 
03,015,01,004,0072,0,1470,22,1492,2756,0,0,0,0,0,0,0,66.31 ,54.14 ,66.31 
03,015,01,004,0073,0,670,13,683,1354,0,0,0,0,0,0,0,66.31 ,50.44 ,66.31 
03,015,01,004,0074,0,1683,30,1713,3065,0,0,0,0,0,0,0,66.31 ,55.89 ,66.31 
03,015,01,004,0075,0,469,11,480,855,0,0,0,0,0,0,0,66.31 ,56.14 ,66.31 
03,015,01,005,0076,0,410,5,415,718,0,0,0,0,0,0,0,66.31 ,57.80 ,66.31 
03,015,01,005,0077,0,171,3,174,323,0,0,0,0,0,0,0,66.31 ,53.87 ,66.31 
03,015,01,005,0078,0,1018,11,1029,1834,0,0,0,0,0,0,0,66.31 ,56.11 ,66.31 
03,015,01,005,0079,0,658,13,671,1207,0,0,0,0,0,0,0,66.31 ,55.59 ,66.31 
03,015,01,005,0080,0,391,4,395,655,0,0,0,0,0,0,0,66.31 ,60.31 ,66.31 
03,015,01,005,0081,0,605,7,612,1062,0,0,0,0,0,0,0,66.31 ,57.63 ,66.31 
03,015,01,005,0082,0,305,4,309,561,0,0,0,0,0,0,0,66.31 ,55.08 ,66.31 
03,015,01,005,0083,0,79,4,83,149,0,0,0,0,0,0,0,66.31 ,55.70 ,66.31 
03,015,01,005,0084,0,307,5,312,561,0,0,0,0,0,0,0,66.31 ,55.61 ,66.31 
03,015,01,005,0085,0,617,6,623,1035,0,0,0,0,0,0,0,66.31 ,60.19 ,66.31 
03,015,01,005,0086,0,1140,15,1155,2113,0,0,0,0,0,0,0,66.31 ,54.66 ,66.31 
03,015,01,005,0087,0,76,2,78,132,0,0,0,0,0,0,0,66.31 ,59.09 ,66.31 
03,015,01,005,0088,0,125,3,128,269,0,0,0,0,0,0,0,66.31 ,47.58 ,66.31 
03,015,01,005,0089,0,194,4,198,384,0,0,0,0,0,0,0,66.31 ,51.56 ,66.31 
03,015,01,005,0090,0,207,4,211,474,0,0,0,0,0,0,0,66.31 ,44.51 ,66.31 
03,015,01,006,0091,0,690,5,695,1124,0,0,0,0,0,0,0,66.31 ,61.83 ,66.31 
03,015,01,006,0092,0,408,1,409,683,0,0,0,0,0,0,0,66.31 ,59.88 ,66.31 
03,015,01,006,0093,0,456,5,461,734,0,0,0,0,0,0,0,66.31 ,62.81 ,66.31 
03,015,01,006,0094,0,740,8,748,1206,0,0,0,0,0,0,0,66.31 ,62.02 ,66.31 
03,015,01,006,0095,0,542,4,546,903,0,0,0,0,0,0,0,66.31 ,60.47 ,66.31 
03,015,01,006,0096,0,134,2,136,265,0,0,0,0,0,0,0,66.31 ,51.32 ,66.31 
03,015,01,006,0097,0,638,17,655,1278,0,0,0,0,0,0,0,66.31 ,51.25 ,66.31 
03,015,01,006,0098,0,366,12,378,647,0,0,0,0,0,0,0,66.31 ,58.42 ,66.31 
03,015,01,006,0099,0,387,3,390,719,0,0,0,0,0,0,0,66.31 ,54.24 ,66.31 
03,015,01,006,0100,0,549,8,557,868,0,0,0,0,0,0,0,66.31 ,64.17 ,66.31 
03,015,01,006,0101,0,586,9,595,1087,0,0,0,0,0,0,0,66.31 ,54.74 ,66.31 
03,015,01,006,0102,0,89,1,90,165,0,0,0,0,0,0,0,66.31 ,54.55 ,66.31 
03,015,01,007,0103,0,532,5,537,931,0,0,0,0,0,0,0,66.31 ,57.68 ,66.31 
03,015,01,007,0104,0,593,4,597,952,0,0,0,0,0,0,0,66.31 ,62.71 ,66.31 
03,015,01,007,0105,0,209,2,211,436,0,0,0,0,0,0,0,66.31 ,48.39 ,66.31 
03,015,01,007,0106,0,144,3,147,315,0,0,0,0,0,0,0,66.31 ,46.67 ,66.31 
03,015,01,007,0107,0,414,2,416,729,0,0,0,0,0,0,0,66.31 ,57.06 ,66.31 
03,015,01,007,0108,0,93,5,98,230,0,0,0,0,0,0,0,66.31 ,42.61 ,66.31 
03,015,01,007,0109,0,71,1,72,128,0,0,0,0,0,0,0,66.31 ,56.25 ,66.31 
03,015,01,007,0110,0,54,0,54,120,0,0,0,0,0,0,0,66.31 ,45.00 ,66.31 
03,015,01,007,0111,0,83,2,85,219,0,0,0,0,0,0,0,66.31 ,38.81 ,66.31 
03,015,01,007,0112,0,118,2,120,230,0,0,0,0,0,0,0,66.31 ,52.17 ,66.31 
03,015,01,007,0113,0,345,4,349,515,0,0,0,0,0,0,0,66.31 ,67.77 ,66.31 
03,015,01,007,0114,0,380,5,385,678,0,0,0,0,0,0,0,66.31 ,56.78 ,66.31 
03,015,01,007,0115,0,193,2,195,380,0,0,0,0,0,0,0,66.31 ,51.32 ,66.31 
03,015,01,007,0116,0,212,4,216,388,0,0,0,0,0,0,0,66.31 ,55.67 ,66.31 
03,015,01,007,0117,0,348,4,352,606,0,0,0,0,0,0,0,66.31 ,58.09 ,66.31 
03,015,01,008,0118,0,44,0,44,138,0,0,0,0,0,0,0,66.31 ,31.88 ,66.31 
03,015,01,008,0119,0,64,1,65,165,0,0,0,0,0,0,0,66.31 ,39.39 ,66.31 
03,015,01,008,0120,0,392,5,397,752,0,0,0,0,0,0,0,66.31 ,52.79 ,66.31 
03,015,01,008,0121,0,58,0,58,126,0,0,0,0,0,0,0,66.31 ,46.03 ,66.31 
03,015,01,008,0122,0,55,0,55,103,0,0,0,0,0,0,0,66.31 ,53.40 ,66.31 
03,015,01,009,0123,0,30,1,31,67,0,0,0,0,0,0,0,66.31 ,46.27 ,66.31 
03,015,01,009,0124,0,13,0,13,29,0,0,0,0,0,0,0,66.31 ,44.83 ,66.31 
03,015,01,009,0125,0,27,0,27,63,0,0,0,0,0,0,0,66.31 ,42.86 ,66.31 
03,015,01,009,0126,0,25,0,25,63,0,0,0,0,0,0,0,66.31 ,39.68 ,66.31 
03,015,01,009,0127,0,14,0,14,38,0,0,0,0,0,0,0,66.31 ,36.84 ,66.31 
03,015,01,009,0128,0,47,0,47,120,0,0,0,0,0,0,0,66.31 ,39.17 ,66.31 
03,015,01,010,0129,0,1042,10,1052,1848,0,0,0,0,0,0,0,66.31 ,56.93 ,66.31 
03,015,01,010,0130,0,892,11,903,1649,0,0,0,0,0,0,0,66.31 ,54.76 ,66.31 
03,015,01,010,0131,0,243,3,246,419,0,0,0,0,0,0,0,66.31 ,58.71 ,66.31 
03,015,01,010,0132,0,451,4,455,850,0,0,0,0,0,0,0,66.31 ,53.53 ,66.31 
03,015,01,010,0133,0,231,2,233,437,0,0,0,0,0,0,0,66.31 ,53.32 ,66.31 
03,015,01,010,0134,0,267,3,270,518,0,0,0,0,0,0,0,66.31 ,52.12 ,66.31 
03,015,01,010,0135,0,146,2,148,335,0,0,0,0,0,0,0,66.31 ,44.18 ,66.31 
03,015,01,010,0136,0,24,0,24,53,0,0,0,0,0,0,0,66.31 ,45.28 ,66.31 
03,015,01,010,0137,0,379,1,380,670,0,0,0,0,0,0,0,66.31 ,56.72 ,66.31 
03,015,01,010,0138,0,133,4,137,323,0,0,0,0,0,0,0,66.31 ,42.41 ,66.31 
03,015,01,010,0139,0,268,3,271,492,0,0,0,0,0,0,0,66.31 ,55.08 ,66.31 
03,015,01,011,0140,0,2253,20,2273,4081,0,0,0,0,0,0,0,66.31 ,55.70 ,66.31 
03,015,01,011,0141,0,780,8,788,1385,0,0,0,0,0,0,0,66.31 ,56.90 ,66.31 
03,015,01,011,0142,0,942,7,949,1762,0,0,0,0,0,0,0,66.31 ,53.86 ,66.31 
03,015,01,011,0143,0,1647,120,1767,3354,0,0,0,0,0,0,0,66.31 ,52.68 ,66.31 
03,015,01,011,0144,0,560,13,573,1065,0,0,0,0,0,0,0,66.31 ,53.80 ,66.31 
03,015,01,011,0145,0,553,10,563,1106,0,0,0,0,0,0,0,66.31 ,50.90 ,66.31 
03,015,01,011,0146,0,351,15,366,691,0,0,0,0,0,0,0,66.31 ,52.97 ,66.31 
03,015,01,011,0147,0,156,2,158,399,0,0,0,0,0,0,0,66.31 ,39.60 ,66.31 
03,015,01,011,0148,0,178,5,183,352,0,0,0,0,0,0,0,66.31 ,51.99 ,66.31 
03,015,01,011,0149,0,493,11,504,1069,0,0,0,0,0,0,0,66.31 ,47.15 ,66.31 
03,015,01,011,0150,0,271,8,279,577,0,0,0,0,0,0,0,66.31 ,48.35 ,66.31 
03,015,01,011,0151,0,249,5,254,525,0,0,0,0,0,0,0,66.31 ,48.38 ,66.31 
03,015,01,011,0152,0,38,1,39,85,0,0,0,0,0,0,0,66.31 ,45.88 ,66.31 
03,015,01,011,0153,0,531,13,544,1016,0,0,0,0,0,0,0,66.31 ,53.54 ,66.31 
03,015,01,011,0154,0,540,11,551,1100,0,0,0,0,0,0,0,66.31 ,50.09 ,66.31 
03,015,01,012,0155,0,242,0,242,470,0,0,0,0,0,0,0,66.31 ,51.49 ,66.31 
03,015,01,012,0156,0,582,11,593,1265,0,0,0,0,0,0,0,66.31 ,46.88 ,66.31 
03,015,01,012,0157,0,269,2,271,544,0,0,0,0,0,0,0,66.31 ,49.82 ,66.31 
03,015,01,012,0158,0,292,9,301,643,0,0,0,0,0,0,0,66.31 ,46.81 ,66.31 
03,015,01,012,0159,0,574,5,579,1077,0,0,0,0,0,0,0,66.31 ,53.76 ,66.31 
03,015,01,012,0160,0,232,2,234,468,0,0,0,0,0,0,0,66.31 ,50.00 ,66.31 
03,015,01,012,0161,0,464,4,468,888,0,0,0,0,0,0,0,66.31 ,52.70 ,66.31 
03,015,01,012,0162,0,238,2,240,403,0,0,0,0,0,0,0,66.31 ,59.55 ,66.31 
03,015,01,012,0163,0,875,7,882,1663,0,0,0,0,0,0,0,66.31 ,53.04 ,66.31 
03,015,01,012,0164,0,267,2,269,549,0,0,0,0,0,0,0,66.31 ,49.00 ,66.31 
03,015,01,012,0165,0,178,1,179,376,0,0,0,0,0,0,0,66.31 ,47.61 ,66.31 
03,015,01,012,0166,0,275,2,277,535,0,0,0,0,0,0,0,66.31 ,51.78 ,66.31 
03,015,01,012,0167,0,313,3,316,580,0,0,0,0,0,0,0,66.31 ,54.48 ,66.31 
03,015,01,013,0168,0,11,0,11,31,0,0,0,0,0,0,0,66.31 ,35.48 ,66.31 
03,015,01,013,0169,0,20,0,20,46,0,0,0,0,0,0,0,66.31 ,43.48 ,66.31 
03,015,01,013,0170,0,16,0,16,31,0,0,0,0,0,0,0,66.31 ,51.61 ,66.31 
03,015,01,013,0171,0,38,3,41,78,0,0,0,0,0,0,0,66.31 ,52.56 ,66.31 
03,015,01,013,0172,0,54,4,58,103,0,0,0,0,0,0,0,66.31 ,56.31 ,66.31 
03,015,01,013,0173,0,41,1,42,97,0,0,0,0,0,0,0,66.31 ,43.30 ,66.31 
03,016,01,001,0001,0,266,4,270,393,0,0,0,0,0,0,0,66.31 ,68.70 ,66.31 
03,016,01,001,0002,0,210,2,212,315,0,0,0,0,0,0,0,66.31 ,67.30 ,66.31 
03,016,01,001,0003,0,341,5,346,560,0,0,0,0,0,0,0,66.31 ,61.79 ,66.31 
03,016,01,001,0004,0,291,4,295,507,0,0,0,0,0,0,0,66.31 ,58.19 ,66.31 
03,016,01,001,0005,0,513,3,516,879,0,0,0,0,0,0,0,66.31 ,58.70 ,66.31 
03,016,01,001,0006,0,570,4,574,1016,0,0,0,0,0,0,0,66.31 ,56.50 ,66.31 
03,016,01,001,0007,0,427,7,434,720,0,0,0,0,0,0,0,66.31 ,60.28 ,66.31 
03,016,01,001,0008,0,1033,12,1045,1722,0,0,0,0,0,0,0,66.31 ,60.69 ,66.31 
03,016,01,001,0009,0,708,14,722,1201,0,0,0,0,0,0,0,66.31 ,60.12 ,66.31 
03,016,01,001,0010,0,1364,18,1382,2286,0,0,0,0,0,0,0,66.31 ,60.45 ,66.31 
03,016,01,001,0011,0,2301,23,2324,4075,0,0,0,0,0,0,0,66.31 ,57.03 ,66.31 
03,016,01,001,0012,0,1217,13,1230,2209,0,0,0,0,0,0,0,66.31 ,55.68 ,66.31 
03,016,01,001,0013,0,550,8,558,950,0,0,0,0,0,0,0,66.31 ,58.74 ,66.31 
03,016,01,001,0014,0,1338,22,1360,2298,0,0,0,0,0,0,0,66.31 ,59.18 ,66.31 
03,016,01,001,0015,0,1070,8,1078,1821,0,0,0,0,0,0,0,66.31 ,59.20 ,66.31 
03,016,01,001,0016,0,968,12,980,1626,0,0,0,0,0,0,0,66.31 ,60.27 ,66.31 
03,016,01,001,0017,0,761,16,777,1204,0,0,0,0,0,0,0,66.31 ,64.53 ,66.31 
03,016,01,001,0018,0,303,5,308,475,0,0,0,0,0,0,0,66.31 ,64.84 ,66.31 
03,016,01,001,0019,0,330,7,337,495,0,0,0,0,0,0,0,66.31 ,68.08 ,66.31 
03,016,01,001,0020,0,698,15,713,1135,0,0,0,0,0,0,0,66.31 ,62.82 ,66.31 
03,016,01,001,0021,0,235,1,236,324,0,0,0,0,0,0,0,66.31 ,72.84 ,66.31 
03,016,01,001,0022,0,716,14,730,1169,0,0,0,0,0,0,0,66.31 ,62.45 ,66.31 
03,016,01,001,0023,0,273,1,274,412,0,0,0,0,0,0,0,66.31 ,66.50 ,66.31 
03,016,01,001,0024,0,317,4,321,500,0,0,0,0,0,0,0,66.31 ,64.20 ,66.31 
03,016,01,001,0025,0,455,10,465,781,0,0,0,0,0,0,0,66.31 ,59.54 ,66.31 
03,016,01,001,0026,0,214,3,217,338,0,0,0,0,0,0,0,66.31 ,64.20 ,66.31 
03,016,01,001,0027,0,1014,12,1026,1904,0,0,0,0,0,0,0,66.31 ,53.89 ,66.31 
03,016,01,001,0028,0,698,4,702,1287,0,0,0,0,0,0,0,66.31 ,54.55 ,66.31 
03,016,01,001,0029,0,98,3,101,164,0,0,0,0,0,0,0,66.31 ,61.59 ,66.31 
03,016,01,001,0030,0,198,2,200,333,0,0,0,0,0,0,0,66.31 ,60.06 ,66.31 
03,016,01,001,0031,0,654,6,660,972,0,0,0,0,0,0,0,66.31 ,67.90 ,66.31 
03,016,01,001,0032,0,681,7,688,1078,0,0,0,0,0,0,0,66.31 ,63.82 ,66.31 
03,016,01,001,0033,0,182,2,184,533,0,0,0,0,0,0,0,66.31 ,34.52 ,66.31 
03,016,01,001,0034,0,61,0,61,192,0,0,0,0,0,0,0,66.31 ,31.77 ,66.31 
03,016,01,002,0035,0,525,5,530,815,0,0,0,0,0,0,0,66.31 ,65.03 ,66.31 
03,016,01,002,0036,0,166,1,167,273,0,0,0,0,0,0,0,66.31 ,61.17 ,66.31 
03,016,01,002,0037,0,112,1,113,189,0,0,0,0,0,0,0,66.31 ,59.79 ,66.31 
03,016,01,002,0038,0,142,4,146,235,0,0,0,0,0,0,0,66.31 ,62.13 ,66.31 
03,016,01,002,0039,0,325,8,333,592,0,0,0,0,0,0,0,66.31 ,56.25 ,66.31 
03,016,01,002,0040,0,174,4,178,258,0,0,0,0,0,0,0,66.31 ,68.99 ,66.31 
03,016,01,002,0041,0,307,5,312,535,0,0,0,0,0,0,0,66.31 ,58.32 ,66.31 
03,016,01,002,0042,0,248,2,250,421,0,0,0,0,0,0,0,66.31 ,59.38 ,66.31 
03,016,01,002,0043,0,233,1,234,382,0,0,0,0,0,0,0,66.31 ,61.26 ,66.31 
03,016,01,002,0044,0,51,0,51,102,0,0,0,0,0,0,0,66.31 ,50.00 ,66.31 
03,016,01,002,0045,0,431,3,434,703,0,0,0,0,0,0,0,66.31 ,61.74 ,66.31 
03,016,01,002,0046,0,98,2,100,161,0,0,0,0,0,0,0,66.31 ,62.11 ,66.31 
03,016,01,002,0047,0,175,6,181,295,0,0,0,0,0,0,0,66.31 ,61.36 ,66.31 
03,016,01,002,0048,0,143,1,144,215,0,0,0,0,0,0,0,66.31 ,66.98 ,66.31 
03,016,01,002,0049,0,94,6,100,177,0,0,0,0,0,0,0,66.31 ,56.50 ,66.31 
03,016,01,002,0050,0,124,2,126,174,0,0,0,0,0,0,0,66.31 ,72.41 ,66.31 
03,016,01,002,0051,0,50,1,51,80,0,0,0,0,0,0,0,66.31 ,63.75 ,66.31 
03,016,01,002,0052,0,392,4,396,598,0,0,0,0,0,0,0,66.31 ,66.22 ,66.31 
03,016,01,002,0053,0,460,9,469,811,0,0,0,0,0,0,0,66.31 ,57.83 ,66.31 
03,016,01,002,0054,0,292,5,297,500,0,0,0,0,0,0,0,66.31 ,59.40 ,66.31 
03,016,01,002,0055,0,870,12,882,1493,0,0,0,0,0,0,0,66.31 ,59.08 ,66.31 
03,016,01,002,0056,0,346,2,348,598,0,0,0,0,0,0,0,66.31 ,58.19 ,66.31 
03,016,01,003,0057,0,256,2,258,401,0,0,0,0,0,0,0,66.31 ,64.34 ,66.31 
03,016,01,003,0058,0,298,1,299,495,0,0,0,0,0,0,0,66.31 ,60.40 ,66.31 
03,016,01,003,0059,0,56,1,57,85,0,0,0,0,0,0,0,66.31 ,67.06 ,66.31 
03,016,01,003,0060,0,64,1,65,101,0,0,0,0,0,0,0,66.31 ,64.36 ,66.31 
03,016,01,003,0061,0,150,3,153,252,0,0,0,0,0,0,0,66.31 ,60.71 ,66.31 
03,016,01,003,0062,0,104,1,105,197,0,0,0,0,0,0,0,66.31 ,53.30 ,66.31 
03,016,01,003,0063,0,104,3,107,166,0,0,0,0,0,0,0,66.31 ,64.46 ,66.31 
03,016,01,003,0064,0,771,14,785,1265,0,0,0,0,0,0,0,66.31 ,62.06 ,66.31 
03,016,01,003,0065,0,164,3,167,261,0,0,0,0,0,0,0,66.31 ,63.98 ,66.31 
03,016,01,003,0066,0,358,7,365,637,0,0,0,0,0,0,0,66.31 ,57.30 ,66.31 
03,016,01,003,0067,0,404,3,407,677,0,0,0,0,0,0,0,66.31 ,60.12 ,66.31 
03,016,01,003,0068,0,408,1,409,1109,0,0,0,0,0,0,0,66.31 ,36.88 ,66.31 
03,016,01,003,0069,0,292,6,298,848,0,0,0,0,0,0,0,66.31 ,35.14 ,66.31 
03,016,01,003,0070,0,82,0,82,205,0,0,0,0,0,0,0,66.31 ,40.00 ,66.31 
03,016,01,003,0071,0,75,1,76,148,0,0,0,0,0,0,0,66.31 ,51.35 ,66.31 
03,016,01,004,0072,0,111,3,114,233,0,0,0,0,0,0,0,66.31 ,48.93 ,66.31 
03,016,01,004,0073,0,205,1,206,410,0,0,0,0,0,0,0,66.31 ,50.24 ,66.31 
03,016,01,004,0074,0,351,7,358,735,0,0,0,0,0,0,0,66.31 ,48.71 ,66.31 
03,016,01,004,0075,0,124,2,126,241,0,0,0,0,0,0,0,66.31 ,52.28 ,66.31 
03,016,01,004,0076,0,286,7,293,575,0,0,0,0,0,0,0,66.31 ,50.96 ,66.31 
03,016,01,004,0077,0,55,0,55,108,0,0,0,0,0,0,0,66.31 ,50.93 ,66.31 
03,016,01,004,0078,0,257,10,267,479,0,0,0,0,0,0,0,66.31 ,55.74 ,66.31 
03,016,01,004,0079,0,114,1,115,202,0,0,0,0,0,0,0,66.31 ,56.93 ,66.31 
03,016,01,004,0080,0,277,4,281,583,0,0,0,0,0,0,0,66.31 ,48.20 ,66.31 
03,016,01,004,0081,0,543,14,557,1159,0,0,0,0,0,0,0,66.31 ,48.06 ,66.31 
03,016,01,004,0082,0,848,6,854,1706,0,0,0,0,0,0,0,66.31 ,50.06 ,66.31 
03,016,01,005,0083,0,170,2,172,394,0,0,0,0,0,0,0,66.31 ,43.65 ,66.31 
03,016,01,005,0084,0,152,3,155,303,0,0,0,0,0,0,0,66.31 ,51.16 ,66.31 
03,016,01,005,0085,0,62,2,64,209,0,0,0,0,0,0,0,66.31 ,30.62 ,66.31 
03,016,01,005,0086,0,100,3,103,265,0,0,0,0,0,0,0,66.31 ,38.87 ,66.31 
03,016,01,005,0087,0,360,4,364,1107,0,0,0,0,0,0,0,66.31 ,32.88 ,66.31 
03,016,01,005,0088,0,20,0,20,320,0,0,0,0,0,0,0,66.31 ,6.25 ,66.31 
03,016,01,005,0089,0,30,0,30,227,0,0,0,0,0,0,0,66.31 ,13.22 ,66.31 
03,016,01,005,0090,0,26,0,26,116,0,0,0,0,0,0,0,66.31 ,22.41 ,66.31 
03,016,01,005,0091,0,104,0,104,217,0,0,0,0,0,0,0,66.31 ,47.93 ,66.31 
03,016,01,006,0092,0,110,4,114,225,0,0,0,0,0,0,0,66.31 ,50.67 ,66.31 
03,016,01,006,0093,0,153,5,158,388,0,0,0,0,0,0,0,66.31 ,40.72 ,66.31 
03,016,01,006,0094,0,167,2,169,376,0,0,0,0,0,0,0,66.31 ,44.95 ,66.31 
03,016,01,006,0095,0,101,0,101,216,0,0,0,0,0,0,0,66.31 ,46.76 ,66.31 
03,016,01,006,0096,0,100,1,101,240,0,0,0,0,0,0,0,66.31 ,42.08 ,66.31 
03,016,01,006,0097,0,365,8,373,742,0,0,0,0,0,0,0,66.31 ,50.27 ,66.31 
03,017,01,001,0001,0,413,3,416,629,0,0,0,0,0,0,0,66.31 ,66.14 ,66.31 
03,017,01,001,0002,0,1019,20,1039,1926,0,0,0,0,0,0,0,66.31 ,53.95 ,66.31 
03,017,01,001,0003,0,967,8,975,1593,0,0,0,0,0,0,0,66.31 ,61.21 ,66.31 
03,017,01,001,0004,0,741,5,746,1367,0,0,0,0,0,0,0,66.31 ,54.57 ,66.31 
03,017,01,001,0005,0,1632,16,1648,4064,0,0,0,0,0,0,0,66.31 ,40.55 ,66.31 
03,017,01,001,0006,0,893,14,907,1588,0,0,0,0,0,0,0,66.31 ,57.12 ,66.31 
03,017,01,001,0007,0,1082,13,1095,1995,0,0,0,0,0,0,0,66.31 ,54.89 ,66.31 
03,017,01,001,0008,0,563,6,569,1004,0,0,0,0,0,0,0,66.31 ,56.67 ,66.31 
03,017,01,001,0009,0,516,5,521,1030,0,0,0,0,0,0,0,66.31 ,50.58 ,66.31 
03,017,01,001,0010,0,687,11,698,1342,0,0,0,0,0,0,0,66.31 ,52.01 ,66.31 
03,017,01,001,0011,0,1093,9,1102,1996,0,0,0,0,0,0,0,66.31 ,55.21 ,66.31 
03,017,01,001,0012,0,771,4,775,1477,0,0,0,0,0,0,0,66.31 ,52.47 ,66.31 
03,017,01,001,0013,0,1213,16,1229,2156,0,0,0,0,0,0,0,66.31 ,57.00 ,66.31 
03,017,01,001,0014,0,1045,14,1059,2091,0,0,0,0,0,0,0,66.31 ,50.65 ,66.31 
03,017,01,001,0015,0,798,7,805,1474,0,0,0,0,0,0,0,66.31 ,54.61 ,66.31 
03,017,01,001,0016,0,1271,26,1297,2422,0,0,0,0,0,0,0,66.31 ,53.55 ,66.31 
03,017,01,001,0017,0,816,3,819,1425,0,0,0,0,0,0,0,66.31 ,57.47 ,66.31 
03,017,01,001,0018,0,723,5,728,1388,0,0,0,0,0,0,0,66.31 ,52.45 ,66.31 
03,017,01,001,0019,0,887,7,894,1559,0,0,0,0,0,0,0,66.31 ,57.34 ,66.31 
03,017,01,001,0020,0,699,9,708,1425,0,0,0,0,0,0,0,66.31 ,49.68 ,66.31 
03,017,01,001,0021,0,696,8,704,1273,0,0,0,0,0,0,0,66.31 ,55.30 ,66.31 
03,017,01,001,0022,0,616,7,623,1216,0,0,0,0,0,0,0,66.31 ,51.23 ,66.31 
03,017,01,001,0023,0,582,8,590,1106,0,0,0,0,0,0,0,66.31 ,53.35 ,66.31 
03,017,01,001,0024,0,822,13,835,1512,0,0,0,0,0,0,0,66.31 ,55.22 ,66.31 
03,017,01,001,0025,0,482,3,485,834,0,0,0,0,0,0,0,66.31 ,58.15 ,66.31 
03,017,01,002,0026,0,699,11,710,1202,0,0,0,0,0,0,0,66.31 ,59.07 ,66.31 
03,017,01,002,0027,0,742,7,749,1237,0,0,0,0,0,0,0,66.31 ,60.55 ,66.31 
03,017,01,002,0028,0,636,4,640,1071,0,0,0,0,0,0,0,66.31 ,59.76 ,66.31 
03,017,01,002,0029,0,1441,14,1455,2435,0,0,0,0,0,0,0,66.31 ,59.75 ,66.31 
03,017,01,002,0030,0,508,5,513,855,0,0,0,0,0,0,0,66.31 ,60.00 ,66.31 
03,017,01,002,0031,0,813,7,820,1357,0,0,0,0,0,0,0,66.31 ,60.43 ,66.31 
03,017,01,002,0032,0,440,7,447,725,0,0,0,0,0,0,0,66.31 ,61.66 ,66.31 
03,017,01,002,0033,0,956,15,971,1794,0,0,0,0,0,0,0,66.31 ,54.12 ,66.31 
03,017,01,002,0034,0,849,7,856,1511,0,0,0,0,0,0,0,66.31 ,56.65 ,66.31 
03,017,01,002,0035,0,972,4,976,1641,0,0,0,0,0,0,0,66.31 ,59.48 ,66.31 
03,017,01,002,0036,0,1381,14,1395,2380,0,0,0,0,0,0,0,66.31 ,58.61 ,66.31 
03,017,01,002,0037,0,1392,14,1406,2574,0,0,0,0,0,0,0,66.31 ,54.62 ,66.31 
03,017,01,002,0038,0,988,10,998,1863,0,0,0,0,0,0,0,66.31 ,53.57 ,66.31 
03,017,01,002,0039,0,1760,14,1774,3312,0,0,0,0,0,0,0,66.31 ,53.56 ,66.31 
03,017,01,002,0040,0,1545,26,1571,2725,0,0,0,0,0,0,0,66.31 ,57.65 ,66.31 
03,017,01,002,0041,0,1221,8,1229,2306,0,0,0,0,0,0,0,66.31 ,53.30 ,66.31 
03,017,01,002,0042,0,2002,25,2027,3933,0,0,0,0,0,0,0,66.31 ,51.54 ,66.31 
03,017,01,002,0043,0,520,3,523,857,0,0,0,0,0,0,0,66.31 ,61.03 ,66.31 
03,017,01,003,0044,0,974,4,978,1842,0,0,0,0,0,0,0,66.31 ,53.09 ,66.31 
03,017,01,003,0045,0,578,7,585,990,0,0,0,0,0,0,0,66.31 ,59.09 ,66.31 
03,017,01,003,0046,0,894,13,907,1569,0,0,0,0,0,0,0,66.31 ,57.81 ,66.31 
03,017,01,003,0047,0,1024,14,1038,1794,0,0,0,0,0,0,0,66.31 ,57.86 ,66.31 
03,017,01,003,0048,0,1280,13,1293,2280,0,0,0,0,0,0,0,66.31 ,56.71 ,66.31 
03,017,01,003,0049,0,600,6,606,1118,0,0,0,0,0,0,0,66.31 ,54.20 ,66.31 
03,017,01,003,0050,0,554,8,562,1082,0,0,0,0,0,0,0,66.31 ,51.94 ,66.31 
03,017,01,003,0051,0,657,5,662,1160,0,0,0,0,0,0,0,66.31 ,57.07 ,66.31 
03,017,01,003,0052,0,608,6,614,1052,0,0,0,0,0,0,0,66.31 ,58.37 ,66.31 
03,017,01,003,0053,0,940,12,952,1734,0,0,0,0,0,0,0,66.31 ,54.90 ,66.31 
03,017,01,003,0054,0,460,5,465,902,0,0,0,0,0,0,0,66.31 ,51.55 ,66.31 
03,017,01,003,0055,0,540,7,547,1074,0,0,0,0,0,0,0,66.31 ,50.93 ,66.31 
03,017,01,003,0056,0,1520,21,1541,3044,0,0,0,0,0,0,0,66.31 ,50.62 ,66.31 
03,017,01,003,0057,0,439,6,445,920,0,0,0,0,0,0,0,66.31 ,48.37 ,66.31 
03,017,01,003,0058,0,786,12,798,1585,0,0,0,0,0,0,0,66.31 ,50.35 ,66.31 
03,017,01,003,0059,0,444,9,453,937,0,0,0,0,0,0,0,66.31 ,48.35 ,66.31 
03,017,01,003,0060,0,669,7,676,1346,0,0,0,0,0,0,0,66.31 ,50.22 ,66.31 
03,017,01,003,0061,0,497,8,505,982,0,0,0,0,0,0,0,66.31 ,51.43 ,66.31 
03,017,01,003,0062,0,515,6,521,948,0,0,0,0,0,0,0,66.31 ,54.96 ,66.31 
03,017,01,003,0063,0,612,5,617,1170,0,0,0,0,0,0,0,66.31 ,52.74 ,66.31 
03,017,01,003,0064,0,346,1,347,685,0,0,0,0,0,0,0,66.31 ,50.66 ,66.31 
03,017,01,003,0065,0,624,13,637,1243,0,0,0,0,0,0,0,66.31 ,51.25 ,66.31 
03,017,01,003,0066,0,693,7,700,1165,0,0,0,0,0,0,0,66.31 ,60.09 ,66.31 
03,017,01,003,0067,0,1588,14,1602,2708,0,0,0,0,0,0,0,66.31 ,59.16 ,66.31 
03,017,01,003,0068,0,1228,17,1245,2315,0,0,0,0,0,0,0,66.31 ,53.78 ,66.31 
03,017,01,003,0069,0,434,2,436,752,0,0,0,0,0,0,0,66.31 ,57.98 ,66.31 
03,017,01,003,0070,0,389,8,397,699,0,0,0,0,0,0,0,66.31 ,56.80 ,66.31 
03,017,01,003,0071,0,499,4,503,883,0,0,0,0,0,0,0,66.31 ,56.96 ,66.31 
03,017,01,003,0072,0,452,2,454,808,0,0,0,0,0,0,0,66.31 ,56.19 ,66.31 
03,017,01,004,0073,0,498,13,511,828,0,0,0,0,0,0,0,66.31 ,61.71 ,66.31 
03,017,01,004,0074,0,639,6,645,1135,0,0,0,0,0,0,0,66.31 ,56.83 ,66.31 
03,017,01,004,0075,0,588,10,598,988,0,0,0,0,0,0,0,66.31 ,60.53 ,66.31 
03,017,01,004,0076,0,664,13,677,1153,0,0,0,0,0,0,0,66.31 ,58.72 ,66.31 
03,017,01,004,0077,0,603,11,614,1062,0,0,0,0,0,0,0,66.31 ,57.82 ,66.31 
03,017,01,004,0078,0,856,10,866,1455,0,0,0,0,0,0,0,66.31 ,59.52 ,66.31 
03,017,01,004,0079,0,506,5,511,875,0,0,0,0,0,0,0,66.31 ,58.40 ,66.31 
03,017,01,004,0080,0,958,16,974,1663,0,0,0,0,0,0,0,66.31 ,58.57 ,66.31 
03,017,01,004,0081,0,698,8,706,1321,0,0,0,0,0,0,0,66.31 ,53.44 ,66.31 
03,017,01,004,0082,0,855,9,864,1622,0,0,0,0,0,0,0,66.31 ,53.27 ,66.31 
03,017,01,004,0083,0,1244,16,1260,2085,0,0,0,0,0,0,0,66.31 ,60.43 ,66.31 
03,017,01,004,0084,0,467,7,474,816,0,0,0,0,0,0,0,66.31 ,58.09 ,66.31 
03,017,01,004,0085,0,444,3,447,838,0,0,0,0,0,0,0,66.31 ,53.34 ,66.31 
03,017,01,004,0086,0,631,13,644,1029,0,0,0,0,0,0,0,66.31 ,62.59 ,66.31 
03,017,01,004,0087,0,921,20,941,1654,0,0,0,0,0,0,0,66.31 ,56.89 ,66.31 
03,017,01,004,0088,0,601,6,607,1114,0,0,0,0,0,0,0,66.31 ,54.49 ,66.31 
03,017,01,004,0089,0,1619,22,1641,2887,0,0,0,0,0,0,0,66.31 ,56.84 ,66.31 
03,017,01,004,0090,0,2100,26,2126,3599,0,0,0,0,0,0,0,66.31 ,59.07 ,66.31 
03,017,01,004,0091,0,2792,35,2827,5795,0,0,0,0,0,0,0,66.31 ,48.78 ,66.31 
03,017,01,004,0092,0,969,10,979,1814,0,0,0,0,0,0,0,66.31 ,53.97 ,66.31 
03,017,01,004,0093,0,567,2,569,1027,0,0,0,0,0,0,0,66.31 ,55.40 ,66.31 
03,017,01,004,0094,0,596,7,603,1036,0,0,0,0,0,0,0,66.31 ,58.20 ,66.31 
03,017,01,004,0095,0,509,11,520,910,0,0,0,0,0,0,0,66.31 ,57.14 ,66.31 
03,017,01,005,0096,0,869,8,877,1594,0,0,0,0,0,0,0,66.31 ,55.02 ,66.31 
03,017,01,005,0097,0,795,16,811,1456,0,0,0,0,0,0,0,66.31 ,55.70 ,66.31 
03,017,01,005,0098,0,600,12,612,1251,0,0,0,0,0,0,0,66.31 ,48.92 ,66.31 
03,017,01,005,0099,0,713,16,729,1368,0,0,0,0,0,0,0,66.31 ,53.29 ,66.31 
03,017,01,005,0100,0,1291,17,1308,2429,0,0,0,0,0,0,0,66.31 ,53.85 ,66.31 
03,017,01,005,0101,0,913,16,929,2025,0,0,0,0,0,0,0,66.31 ,45.88 ,66.31 
03,017,01,005,0102,0,505,9,514,1083,0,0,0,0,0,0,0,66.31 ,47.46 ,66.31 
03,017,01,005,0103,0,464,5,469,898,0,0,0,0,0,0,0,66.31 ,52.23 ,66.31 
03,017,01,005,0104,0,450,3,453,763,0,0,0,0,0,0,0,66.31 ,59.37 ,66.31 
03,017,01,005,0105,0,1675,25,1700,3241,0,0,0,0,0,0,0,66.31 ,52.45 ,66.31 
03,017,01,005,0106,0,1828,22,1850,3636,0,0,0,0,0,0,0,66.31 ,50.88 ,66.31 
03,017,01,005,0107,0,1449,7,1456,2812,0,0,0,0,0,0,0,66.31 ,51.78 ,66.31 
03,017,01,005,0108,0,1926,23,1949,3805,0,0,0,0,0,0,0,66.31 ,51.22 ,66.31 
03,017,01,005,0109,0,1669,12,1681,3135,0,0,0,0,0,0,0,66.31 ,53.62 ,66.31 
03,017,01,005,0110,0,1797,22,1819,3311,0,0,0,0,0,0,0,66.31 ,54.94 ,66.31 
03,017,01,005,0111,0,930,6,936,1794,0,0,0,0,0,0,0,66.31 ,52.17 ,66.31 
03,017,01,005,0112,0,1824,17,1841,3352,0,0,0,0,0,0,0,66.31 ,54.92 ,66.31 
03,017,01,005,0113,0,2424,24,2448,5075,0,0,0,0,0,0,0,66.31 ,48.24 ,66.31 
03,017,01,005,0114,0,1288,14,1302,2720,0,0,0,0,0,0,0,66.31 ,47.87 ,66.31 
03,017,01,005,0115,0,1022,8,1030,2185,0,0,0,0,0,0,0,66.31 ,47.14 ,66.31 
03,017,01,005,0116,0,596,5,601,1152,0,0,0,0,0,0,0,66.31 ,52.17 ,66.31 
03,017,01,005,0117,0,1352,13,1365,3085,0,0,0,0,0,0,0,66.31 ,44.25 ,66.31 
03,017,01,006,0118,0,644,12,656,1236,0,0,0,0,0,0,0,66.31 ,53.07 ,66.31 
03,017,01,006,0119,0,390,5,395,686,0,0,0,0,0,0,0,66.31 ,57.58 ,66.31 
03,017,01,006,0120,0,414,3,417,809,0,0,0,0,0,0,0,66.31 ,51.55 ,66.31 
03,017,01,006,0121,0,291,3,294,608,0,0,0,0,0,0,0,66.31 ,48.36 ,66.31 
03,017,01,006,0122,0,1567,19,1586,3183,0,0,0,0,0,0,0,66.31 ,49.83 ,66.31 
03,017,01,006,0123,0,978,9,987,2032,0,0,0,0,0,0,0,66.31 ,48.57 ,66.31 
03,017,01,006,0124,0,1050,9,1059,1947,0,0,0,0,0,0,0,66.31 ,54.39 ,66.31 
03,017,01,006,0125,0,200,4,204,389,0,0,0,0,0,0,0,66.31 ,52.44 ,66.31 
03,017,01,006,0126,0,1612,19,1631,3363,0,0,0,0,0,0,0,66.31 ,48.50 ,66.31 
03,017,01,006,0127,0,1038,10,1048,2097,0,0,0,0,0,0,0,66.31 ,49.98 ,66.31 
03,017,01,006,0128,0,1131,11,1142,2164,0,0,0,0,0,0,0,66.31 ,52.77 ,66.31 
03,017,01,006,0129,0,1076,16,1092,2667,0,0,0,0,0,0,0,66.31 ,40.94 ,66.31 
03,017,01,006,0130,0,1679,21,1700,3277,0,0,0,0,0,0,0,66.31 ,51.88 ,66.31 
03,017,01,007,0131,0,1828,25,1853,3757,0,0,0,0,0,0,0,66.31 ,49.32 ,66.31 
03,017,01,007,0132,0,1094,13,1107,1917,0,0,0,0,0,0,0,66.31 ,57.75 ,66.31 
03,017,01,007,0133,0,1102,13,1115,2067,0,0,0,0,0,0,0,66.31 ,53.94 ,66.31 
03,017,01,007,0134,0,1965,14,1979,3570,0,0,0,0,0,0,0,66.31 ,55.43 ,66.31 
03,017,01,007,0135,0,1164,13,1177,2139,0,0,0,0,0,0,0,66.31 ,55.03 ,66.31 
03,017,01,007,0136,0,1090,12,1102,2041,0,0,0,0,0,0,0,66.31 ,53.99 ,66.31 
03,017,01,007,0137,0,821,3,824,1472,0,0,0,0,0,0,0,66.31 ,55.98 ,66.31 
03,017,01,007,0138,0,472,7,479,931,0,0,0,0,0,0,0,66.31 ,51.45 ,66.31 
03,017,01,007,0139,0,1428,24,1452,2942,0,0,0,0,0,0,0,66.31 ,49.35 ,66.31 
03,017,01,007,0140,0,614,8,622,1317,0,0,0,0,0,0,0,66.31 ,47.23 ,66.31 
03,017,01,007,0141,0,1255,17,1272,2758,0,0,0,0,0,0,0,66.31 ,46.12 ,66.31 
03,017,01,007,0142,0,1308,17,1325,2622,0,0,0,0,0,0,0,66.31 ,50.53 ,66.31 
03,017,01,007,0143,0,1791,24,1815,3833,0,0,0,0,0,0,0,66.31 ,47.35 ,66.31 
03,017,01,007,0144,0,1515,21,1536,3139,0,0,0,0,0,0,0,66.31 ,48.93 ,66.31 
03,017,01,007,0145,0,214,1,215,436,0,0,0,0,0,0,0,66.31 ,49.31 ,66.31 
03,017,01,007,0146,0,151,2,153,330,0,0,0,0,0,0,0,66.31 ,46.36 ,66.31 
03,017,01,007,0147,0,193,6,199,378,0,0,0,0,0,0,0,66.31 ,52.65 ,66.31 
03,017,01,007,0148,0,416,3,419,895,0,0,0,0,0,0,0,66.31 ,46.82 ,66.31 
03,017,01,007,0149,0,241,1,242,448,0,0,0,0,0,0,0,66.31 ,54.02 ,66.31 
03,018,01,001,0001,0,322,6,328,667,0,0,0,0,0,0,0,66.31 ,49.18 ,66.31 
03,018,01,001,0002,0,919,17,936,1858,0,0,0,0,0,0,0,66.31 ,50.38 ,66.31 
03,018,01,001,0003,0,419,13,432,838,0,0,0,0,0,0,0,66.31 ,51.55 ,66.31 
03,018,01,001,0004,0,401,11,412,806,0,0,0,0,0,0,0,66.31 ,51.12 ,66.31 
03,018,01,001,0005,0,252,10,262,514,0,0,0,0,0,0,0,66.31 ,50.97 ,66.31 
03,018,01,001,0006,0,280,4,284,592,0,0,0,0,0,0,0,66.31 ,47.97 ,66.31 
03,018,01,001,0007,0,1032,17,1049,1876,0,0,0,0,0,0,0,66.31 ,55.92 ,66.31 
03,018,01,001,0008,0,1604,28,1632,3055,0,0,0,0,0,0,0,66.31 ,53.42 ,66.31 
03,018,01,001,0009,0,1673,35,1708,3379,0,0,0,0,0,0,0,66.31 ,50.55 ,66.31 
03,018,01,001,0010,0,1373,27,1400,2859,0,0,0,0,0,0,0,66.31 ,48.97 ,66.31 
03,018,01,001,0011,0,2086,40,2126,4056,0,0,0,0,0,0,0,66.31 ,52.42 ,66.31 
03,018,01,001,0012,0,1119,22,1141,2131,0,0,0,0,0,0,0,66.31 ,53.54 ,66.31 
03,018,01,001,0013,0,954,24,978,1942,0,0,0,0,0,0,0,66.31 ,50.36 ,66.31 
03,018,01,001,0014,0,1025,26,1051,2075,0,0,0,0,0,0,0,66.31 ,50.65 ,66.31 
03,018,01,001,0015,0,1445,31,1476,2872,0,0,0,0,0,0,0,66.31 ,51.39 ,66.31 
03,018,01,001,0016,0,2059,40,2099,3956,0,0,0,0,0,0,0,66.31 ,53.06 ,66.31 
03,018,01,001,0017,0,874,19,893,1761,0,0,0,0,0,0,0,66.31 ,50.71 ,66.31 
03,018,01,001,0018,0,508,13,521,1030,0,0,0,0,0,0,0,66.31 ,50.58 ,66.31 
03,018,01,001,0019,0,1169,26,1195,2233,0,0,0,0,0,0,0,66.31 ,53.52 ,66.31 
03,018,01,001,0020,0,1345,82,1427,2899,0,0,0,0,0,0,0,66.31 ,49.22 ,66.31 
03,018,01,001,0021,0,847,42,889,1497,0,0,0,0,0,0,0,66.31 ,59.39 ,66.31 
03,018,01,001,0022,0,1445,37,1482,2690,0,0,0,0,0,0,0,66.31 ,55.09 ,66.31 
03,018,01,001,0023,0,445,10,455,737,0,0,0,0,0,0,0,66.31 ,61.74 ,66.31 
03,018,01,001,0024,0,213,2,215,409,0,0,0,0,0,0,0,66.31 ,52.57 ,66.31 
03,018,01,001,0025,0,1717,31,1748,2923,0,0,0,0,0,0,0,66.31 ,59.80 ,66.31 
03,018,01,001,0026,0,477,11,488,757,0,0,0,0,0,0,0,66.31 ,64.46 ,66.31 
03,018,01,001,0027,0,1836,39,1875,2877,0,0,0,0,0,0,0,66.31 ,65.17 ,66.31 
03,018,01,001,0028,0,1544,19,1563,2884,0,0,0,0,0,0,0,66.31 ,54.20 ,66.31 
03,018,01,001,0029,0,1389,31,1420,2588,0,0,0,0,0,0,0,66.31 ,54.87 ,66.31 
03,018,01,001,0030,0,2447,40,2487,4461,0,0,0,0,0,0,0,66.31 ,55.75 ,66.31 
03,018,01,001,0031,0,1000,31,1031,2065,0,0,0,0,0,0,0,66.31 ,49.93 ,66.31 
03,018,01,001,0032,0,1833,30,1863,3673,0,0,0,0,0,0,0,66.31 ,50.72 ,66.31 
03,018,01,001,0033,0,1824,57,1881,3585,0,0,0,0,0,0,0,66.31 ,52.47 ,66.31 
03,018,01,001,0034,0,1288,27,1315,2275,0,0,0,0,0,0,0,66.31 ,57.80 ,66.31 
03,018,01,001,0035,0,1349,23,1372,2616,0,0,0,0,0,0,0,66.31 ,52.45 ,66.31 
03,018,01,001,0036,0,371,7,378,709,0,0,0,0,0,0,0,66.31 ,53.31 ,66.31 
03,018,01,001,0037,0,296,8,304,632,0,0,0,0,0,0,0,66.31 ,48.10 ,66.31 
03,018,01,001,0038,0,370,9,379,684,0,0,0,0,0,0,0,66.31 ,55.41 ,66.31 
03,018,01,001,0039,0,481,21,502,914,0,0,0,0,0,0,0,66.31 ,54.92 ,66.31 
03,018,01,001,0040,0,651,16,667,1221,0,0,0,0,0,0,0,66.31 ,54.63 ,66.31 
03,018,01,001,0041,0,1812,37,1849,4089,0,0,0,0,0,0,0,66.31 ,45.22 ,66.31 
03,018,01,001,0042,0,1523,34,1557,2951,0,0,0,0,0,0,0,66.31 ,52.76 ,66.31 
03,018,01,001,0043,0,410,12,422,829,0,0,0,0,0,0,0,66.31 ,50.90 ,66.31 
03,018,01,001,0044,0,446,16,462,880,0,0,0,0,0,0,0,66.31 ,52.50 ,66.31 
03,018,01,001,0045,0,645,16,661,1199,0,0,0,0,0,0,0,66.31 ,55.13 ,66.31 
03,018,01,001,0046,0,1468,29,1497,3038,0,0,0,0,0,0,0,66.31 ,49.28 ,66.31 
03,018,01,001,0047,0,753,21,774,1617,0,0,0,0,0,0,0,66.31 ,47.87 ,66.31 
03,018,01,001,0048,0,1579,52,1631,3075,0,0,0,0,0,0,0,66.31 ,53.04 ,66.31 
03,018,01,001,0049,0,1323,28,1351,2726,0,0,0,0,0,0,0,66.31 ,49.56 ,66.31 
03,018,01,001,0050,0,1940,57,1997,3953,0,0,0,0,0,0,0,66.31 ,50.52 ,66.31 
03,018,01,001,0051,0,1208,27,1235,2312,0,0,0,0,0,0,0,66.31 ,53.42 ,66.31 
03,018,01,001,0052,0,1170,21,1191,2517,0,0,0,0,0,0,0,66.31 ,47.32 ,66.31 
03,018,01,001,0053,0,865,11,876,2025,0,0,0,0,0,0,0,66.31 ,43.26 ,66.31 
03,018,01,002,0054,0,267,9,276,541,0,0,0,0,0,0,0,66.31 ,51.02 ,66.31 
03,018,01,002,0055,0,385,10,395,778,0,0,0,0,0,0,0,66.31 ,50.77 ,66.31 
03,018,01,002,0056,0,295,7,302,567,0,0,0,0,0,0,0,66.31 ,53.26 ,66.31 
03,018,01,002,0057,0,271,5,276,552,0,0,0,0,0,0,0,66.31 ,50.00 ,66.31 
03,018,01,002,0058,0,447,13,460,835,0,0,0,0,0,0,0,66.31 ,55.09 ,66.31 
03,018,01,002,0059,0,612,24,636,1147,0,0,0,0,0,0,0,66.31 ,55.45 ,66.31 
03,018,01,002,0060,0,635,23,658,1287,0,0,0,0,0,0,0,66.31 ,51.13 ,66.31 
03,018,01,002,0061,0,1780,40,1820,3581,0,0,0,0,0,0,0,66.31 ,50.82 ,66.31 
03,018,01,002,0062,0,477,5,482,1018,0,0,0,0,0,0,0,66.31 ,47.35 ,66.31 
03,018,01,002,0063,0,2425,64,2489,4571,0,0,0,0,0,0,0,66.31 ,54.45 ,66.31 
03,018,01,002,0064,0,1241,45,1286,2393,0,0,0,0,0,0,0,66.31 ,53.74 ,66.31 
03,018,01,002,0065,0,1644,51,1695,3077,0,0,0,0,0,0,0,66.31 ,55.09 ,66.31 
03,018,01,002,0066,0,1623,54,1677,3084,0,0,0,0,0,0,0,66.31 ,54.38 ,66.31 
03,018,01,002,0067,0,1013,25,1038,1510,0,0,0,0,0,0,0,66.31 ,68.74 ,66.31 
03,018,01,002,0068,0,452,10,462,816,0,0,0,0,0,0,0,66.31 ,56.62 ,66.31 
03,018,01,002,0069,0,333,14,347,658,0,0,0,0,0,0,0,66.31 ,52.74 ,66.31 
03,018,01,002,0070,0,279,11,290,618,0,0,0,0,0,0,0,66.31 ,46.93 ,66.31 
03,018,01,002,0071,0,693,17,710,1293,0,0,0,0,0,0,0,66.31 ,54.91 ,66.31 
03,018,01,002,0072,0,600,12,612,1125,0,0,0,0,0,0,0,66.31 ,54.40 ,66.31 
03,018,01,002,0073,0,482,12,494,946,0,0,0,0,0,0,0,66.31 ,52.22 ,66.31 
03,018,01,002,0074,0,1825,54,1879,3818,0,0,0,0,0,0,0,66.31 ,49.21 ,66.31 
03,018,01,002,0075,0,1697,49,1746,3346,0,0,0,0,0,0,0,66.31 ,52.18 ,66.31 
03,018,01,002,0076,0,1769,46,1815,3504,0,0,0,0,0,0,0,66.31 ,51.80 ,66.31 
03,018,01,002,0077,0,1563,40,1603,2948,0,0,0,0,0,0,0,66.31 ,54.38 ,66.31 
03,018,01,002,0078,0,1167,19,1186,2328,0,0,0,0,0,0,0,66.31 ,50.95 ,66.31 
03,018,01,002,0079,0,1052,27,1079,2022,0,0,0,0,0,0,0,66.31 ,53.36 ,66.31 
03,018,01,002,0080,0,1071,23,1094,2480,0,0,0,0,0,0,0,66.31 ,44.11 ,66.31 
03,018,01,002,0081,0,1479,24,1503,3102,0,0,0,0,0,0,0,66.31 ,48.45 ,66.31 
03,018,01,002,0082,0,1023,25,1048,2074,0,0,0,0,0,0,0,66.31 ,50.53 ,66.31 
03,018,01,002,0083,0,601,20,621,1149,0,0,0,0,0,0,0,66.31 ,54.05 ,66.31 
03,018,01,002,0084,0,839,13,852,1633,0,0,0,0,0,0,0,66.31 ,52.17 ,66.31 
03,018,01,002,0085,0,1723,45,1768,3557,0,0,0,0,0,0,0,66.31 ,49.70 ,66.31 
03,018,01,002,0086,0,1671,35,1706,3405,0,0,0,0,0,0,0,66.31 ,50.10 ,66.31 
03,018,01,002,0087,0,741,14,755,1222,0,0,0,0,0,0,0,66.31 ,61.78 ,66.31 
03,018,01,002,0088,0,1349,37,1386,2553,0,0,0,0,0,0,0,66.31 ,54.29 ,66.31 
03,018,01,002,0089,0,1575,35,1610,3195,0,0,0,0,0,0,0,66.31 ,50.39 ,66.31 
03,018,01,002,0090,0,1699,33,1732,2934,0,0,0,0,0,0,0,66.31 ,59.03 ,66.31 
03,018,01,002,0091,0,394,11,405,816,0,0,0,0,0,0,0,66.31 ,49.63 ,66.31 
03,018,01,002,0092,0,1499,30,1529,3301,0,0,0,0,0,0,0,66.31 ,46.32 ,66.31 
03,018,01,002,0093,0,724,31,755,1505,0,0,0,0,0,0,0,66.31 ,50.17 ,66.31 
03,018,01,002,0094,0,542,17,559,1100,0,0,0,0,0,0,0,66.31 ,50.82 ,66.31 
03,018,01,002,0095,0,611,20,631,1265,0,0,0,0,0,0,0,66.31 ,49.88 ,66.31 
03,018,01,002,0096,0,493,11,504,1058,0,0,0,0,0,0,0,66.31 ,47.64 ,66.31 
03,018,01,002,0097,0,261,4,265,491,0,0,0,0,0,0,0,66.31 ,53.97 ,66.31 
03,018,01,003,0098,0,1306,29,1335,2601,0,0,0,0,0,0,0,66.31 ,51.33 ,66.31 
03,018,01,003,0099,0,1018,32,1050,2048,0,0,0,0,0,0,0,66.31 ,51.27 ,66.31 
03,018,01,003,0100,0,1005,23,1028,1991,0,0,0,0,0,0,0,66.31 ,51.63 ,66.31 
03,018,01,003,0101,0,869,16,885,1804,0,0,0,0,0,0,0,66.31 ,49.06 ,66.31 
03,018,01,003,0102,0,1060,28,1088,2126,0,0,0,0,0,0,0,66.31 ,51.18 ,66.31 
03,018,01,003,0103,0,832,19,851,1635,0,0,0,0,0,0,0,66.31 ,52.05 ,66.31 
03,018,01,003,0104,0,670,18,688,1361,0,0,0,0,0,0,0,66.31 ,50.55 ,66.31 
03,018,01,003,0105,0,875,19,894,1759,0,0,0,0,0,0,0,66.31 ,50.82 ,66.31 
03,018,01,003,0106,0,1782,55,1837,4031,0,0,0,0,0,0,0,66.31 ,45.57 ,66.31 
03,018,01,003,0107,0,789,20,809,1600,0,0,0,0,0,0,0,66.31 ,50.56 ,66.31 
03,018,01,003,0108,0,731,16,747,1508,0,0,0,0,0,0,0,66.31 ,49.54 ,66.31 
03,018,01,003,0109,0,809,18,827,1654,0,0,0,0,0,0,0,66.31 ,50.00 ,66.31 
03,018,01,003,0110,0,1172,29,1201,2482,0,0,0,0,0,0,0,66.31 ,48.39 ,66.31 
03,018,01,003,0111,0,880,19,899,1764,0,0,0,0,0,0,0,66.31 ,50.96 ,66.31 
03,018,01,003,0112,0,435,9,444,933,0,0,0,0,0,0,0,66.31 ,47.59 ,66.31 
03,018,01,003,0113,0,752,61,813,1592,0,0,0,0,0,0,0,66.31 ,51.07 ,66.31 
03,018,01,003,0114,0,848,31,879,1593,0,0,0,0,0,0,0,66.31 ,55.18 ,66.31 
03,018,01,003,0115,0,506,18,524,1034,0,0,0,0,0,0,0,66.31 ,50.68 ,66.31 
03,018,01,003,0116,0,1253,36,1289,2836,0,0,0,0,0,0,0,66.31 ,45.45 ,66.31 
03,018,01,003,0117,0,405,7,412,735,0,0,0,0,0,0,0,66.31 ,56.05 ,66.31 
03,018,01,003,0118,0,588,20,608,1143,0,0,0,0,0,0,0,66.31 ,53.19 ,66.31 
03,018,01,003,0119,0,358,7,365,594,0,0,0,0,0,0,0,66.31 ,61.45 ,66.31 
03,018,01,003,0120,0,353,3,356,667,0,0,0,0,0,0,0,66.31 ,53.37 ,66.31 
03,018,01,003,0121,0,402,8,410,682,0,0,0,0,0,0,0,66.31 ,60.12 ,66.31 
03,019,01,001,0001,0,575,7,582,996,0,0,0,0,0,0,0,66.31 ,58.43 ,66.31 
03,019,01,001,0002,0,647,5,652,1031,0,0,0,0,0,0,0,66.31 ,63.24 ,66.31 
03,019,01,001,0003,0,675,5,680,1162,0,0,0,0,0,0,0,66.31 ,58.52 ,66.31 
03,019,01,001,0004,0,745,5,750,1391,0,0,0,0,0,0,0,66.31 ,53.92 ,66.31 
03,019,01,001,0005,0,566,6,572,908,0,0,0,0,0,0,0,66.31 ,63.00 ,66.31 
03,019,01,001,0006,0,787,9,796,1269,0,0,0,0,0,0,0,66.31 ,62.73 ,66.31 
03,019,01,001,0007,0,699,9,708,1142,0,0,0,0,0,0,0,66.31 ,62.00 ,66.31 
03,019,01,001,0008,0,830,11,841,1413,0,0,0,0,0,0,0,66.31 ,59.52 ,66.31 
03,019,01,001,0009,0,734,9,743,1208,0,0,0,0,0,0,0,66.31 ,61.51 ,66.31 
03,019,01,001,0010,0,691,11,702,1100,0,0,0,0,0,0,0,66.31 ,63.82 ,66.31 
03,019,01,001,0011,0,658,5,663,1099,0,0,0,0,0,0,0,66.31 ,60.33 ,66.31 
03,019,01,001,0012,0,811,9,820,1307,0,0,0,0,0,0,0,66.31 ,62.74 ,66.31 
03,019,01,001,0013,0,834,6,840,1298,0,0,0,0,0,0,0,66.31 ,64.71 ,66.31 
03,019,01,001,0014,0,774,6,780,1239,0,0,0,0,0,0,0,66.31 ,62.95 ,66.31 
03,019,01,002,0015,0,661,9,670,1051,0,0,0,0,0,0,0,66.31 ,63.75 ,66.31 
03,019,01,002,0016,0,392,10,402,629,0,0,0,0,0,0,0,66.31 ,63.91 ,66.31 
03,019,01,002,0017,0,516,4,520,874,0,0,0,0,0,0,0,66.31 ,59.50 ,66.31 
03,019,01,002,0018,0,623,7,630,957,0,0,0,0,0,0,0,66.31 ,65.83 ,66.31 
03,019,01,002,0019,0,746,5,751,1233,0,0,0,0,0,0,0,66.31 ,60.91 ,66.31 
03,019,01,002,0020,0,722,8,730,1099,0,0,0,0,0,0,0,66.31 ,66.42 ,66.31 
03,019,01,002,0021,0,874,11,885,1297,0,0,0,0,0,0,0,66.31 ,68.23 ,66.31 
03,019,01,002,0022,0,678,4,682,1039,0,0,0,0,0,0,0,66.31 ,65.64 ,66.31 
03,019,01,002,0023,0,2326,31,2357,3688,0,0,0,0,0,0,0,66.31 ,63.91 ,66.31 
03,019,01,002,0024,0,1321,9,1330,1920,0,0,0,0,0,0,0,66.31 ,69.27 ,66.31 
03,019,01,002,0025,0,559,8,567,843,0,0,0,0,0,0,0,66.31 ,67.26 ,66.31 
03,019,01,002,0026,0,575,5,580,824,0,0,0,0,0,0,0,66.31 ,70.39 ,66.31 
03,019,01,002,0027,0,709,9,718,1162,0,0,0,0,0,0,0,66.31 ,61.79 ,66.31 
03,019,01,002,0028,0,487,3,490,781,0,0,0,0,0,0,0,66.31 ,62.74 ,66.31 
03,019,01,002,0029,0,687,8,695,999,0,0,0,0,0,0,0,66.31 ,69.57 ,66.31 
03,019,01,002,0030,0,984,16,1000,1371,0,0,0,0,0,0,0,66.31 ,72.94 ,66.31 
03,019,01,002,0031,0,920,12,932,1395,0,0,0,0,0,0,0,66.31 ,66.81 ,66.31 
03,019,01,002,0032,0,2904,38,2942,4524,0,0,0,0,0,0,0,66.31 ,65.03 ,66.31 
03,019,01,002,0033,0,2798,49,2847,4673,0,0,0,0,0,0,0,66.31 ,60.92 ,66.31 
03,019,01,002,0034,0,1968,25,1993,3171,0,0,0,0,0,0,0,66.31 ,62.85 ,66.31 
03,019,01,002,0035,0,956,16,972,1609,0,0,0,0,0,0,0,66.31 ,60.41 ,66.31 
03,019,01,002,0036,0,1037,13,1050,1709,0,0,0,0,0,0,0,66.31 ,61.44 ,66.31 
03,019,01,002,0037,0,908,10,918,1449,0,0,0,0,0,0,0,66.31 ,63.35 ,66.31 
03,019,01,002,0038,0,489,13,502,834,0,0,0,0,0,0,0,66.31 ,60.19 ,66.31 
03,019,01,002,0039,0,911,8,919,1398,0,0,0,0,0,0,0,66.31 ,65.74 ,66.31 
03,019,01,002,0040,0,1007,13,1020,1542,0,0,0,0,0,0,0,66.31 ,66.15 ,66.31 
03,019,01,002,0041,0,746,12,758,1295,0,0,0,0,0,0,0,66.31 ,58.53 ,66.31 
03,019,01,002,0042,0,2798,24,2822,4401,0,0,0,0,0,0,0,66.31 ,64.12 ,66.31 
03,019,01,003,0043,0,446,1,447,714,0,0,0,0,0,0,0,66.31 ,62.61 ,66.31 
03,019,01,003,0044,0,387,1,388,714,0,0,0,0,0,0,0,66.31 ,54.34 ,66.31 
03,019,01,003,0045,0,553,7,560,872,0,0,0,0,0,0,0,66.31 ,64.22 ,66.31 
03,019,01,003,0046,0,1115,7,1122,1655,0,0,0,0,0,0,0,66.31 ,67.79 ,66.31 
03,019,01,003,0047,0,639,13,652,1030,0,0,0,0,0,0,0,66.31 ,63.30 ,66.31 
03,019,01,003,0048,0,666,15,681,1051,0,0,0,0,0,0,0,66.31 ,64.80 ,66.31 
03,019,01,003,0049,0,878,8,886,1404,0,0,0,0,0,0,0,66.31 ,63.11 ,66.31 
03,019,01,003,0050,0,661,7,668,1036,0,0,0,0,0,0,0,66.31 ,64.48 ,66.31 
03,019,01,003,0051,0,1994,28,2022,3284,0,0,0,0,0,0,0,66.31 ,61.57 ,66.31 
03,019,01,003,0052,0,1869,27,1896,3193,0,0,0,0,0,0,0,66.31 ,59.38 ,66.31 
03,019,01,003,0053,0,1391,11,1402,2257,0,0,0,0,0,0,0,66.31 ,62.12 ,66.31 
03,019,01,003,0054,0,1641,20,1661,2677,0,0,0,0,0,0,0,66.31 ,62.05 ,66.31 
03,019,01,003,0055,0,1091,9,1100,1740,0,0,0,0,0,0,0,66.31 ,63.22 ,66.31 
03,019,01,003,0056,0,1104,20,1124,1976,0,0,0,0,0,0,0,66.31 ,56.88 ,66.31 
03,019,01,003,0057,0,1609,17,1626,2553,0,0,0,0,0,0,0,66.31 ,63.69 ,66.31 
03,019,01,003,0058,0,3735,49,3784,6387,0,0,0,0,0,0,0,66.31 ,59.25 ,66.31 
03,019,01,003,0059,0,4214,38,4252,7574,0,0,0,0,0,0,0,66.31 ,56.14 ,66.31 
03,019,01,003,0060,0,3356,27,3383,5884,0,0,0,0,0,0,0,66.31 ,57.49 ,66.31 
03,019,01,003,0061,0,3644,36,3680,6461,0,0,0,0,0,0,0,66.31 ,56.96 ,66.31 
03,019,01,003,0062,0,1468,23,1491,2443,0,0,0,0,0,0,0,66.31 ,61.03 ,66.31 
03,019,01,003,0063,0,3323,45,3368,5262,0,0,0,0,0,0,0,66.31 ,64.01 ,66.31 
03,019,01,004,0064,0,870,9,879,1403,0,0,0,0,0,0,0,66.31 ,62.65 ,66.31 
03,019,01,004,0065,0,533,8,541,931,0,0,0,0,0,0,0,66.31 ,58.11 ,66.31 
03,019,01,004,0066,0,1054,12,1066,2093,0,0,0,0,0,0,0,66.31 ,50.93 ,66.31 
03,019,01,004,0067,0,888,15,903,1532,0,0,0,0,0,0,0,66.31 ,58.94 ,66.31 
03,019,01,004,0068,0,2297,21,2318,3784,0,0,0,0,0,0,0,66.31 ,61.26 ,66.31 
03,019,01,004,0069,0,1115,12,1127,1751,0,0,0,0,0,0,0,66.31 ,64.36 ,66.31 
03,019,01,004,0070,0,1469,18,1487,2294,0,0,0,0,0,0,0,66.31 ,64.82 ,66.31 
03,019,01,004,0071,0,2729,42,2771,4203,0,0,0,0,0,0,0,66.31 ,65.93 ,66.31 
03,019,01,004,0072,0,526,6,532,794,0,0,0,0,0,0,0,66.31 ,67.00 ,66.31 
03,019,01,004,0073,0,901,11,912,1531,0,0,0,0,0,0,0,66.31 ,59.57 ,66.31 
03,019,01,004,0074,0,730,8,738,1256,0,0,0,0,0,0,0,66.31 ,58.76 ,66.31 
03,019,01,004,0075,0,641,5,646,1049,0,0,0,0,0,0,0,66.31 ,61.58 ,66.31 
03,019,01,004,0076,0,902,11,913,1529,0,0,0,0,0,0,0,66.31 ,59.71 ,66.31 
03,019,01,004,0077,0,774,12,786,1272,0,0,0,0,0,0,0,66.31 ,61.79 ,66.31 
03,019,01,004,0078,0,1103,12,1115,1885,0,0,0,0,0,0,0,66.31 ,59.15 ,66.31 
03,019,01,004,0079,0,757,12,769,1260,0,0,0,0,0,0,0,66.31 ,61.03 ,66.31 
03,019,01,004,0080,0,1071,11,1082,1789,0,0,0,0,0,0,0,66.31 ,60.48 ,66.31 
03,019,01,004,0081,0,1126,14,1140,1941,0,0,0,0,0,0,0,66.31 ,58.73 ,66.31 
03,019,01,004,0082,0,624,7,631,930,0,0,0,0,0,0,0,66.31 ,67.85 ,66.31 
03,019,01,004,0083,0,1196,19,1215,2082,0,0,0,0,0,0,0,66.31 ,58.36 ,66.31 
03,019,01,004,0084,0,2900,27,2927,4776,0,0,0,0,0,0,0,66.31 ,61.29 ,66.31 
03,019,01,004,0085,0,2052,27,2079,3533,0,0,0,0,0,0,0,66.31 ,58.85 ,66.31 
03,019,01,004,0086,0,2259,21,2280,3958,0,0,0,0,0,0,0,66.31 ,57.60 ,66.31 
03,019,01,004,0087,0,2650,32,2682,4634,0,0,0,0,0,0,0,66.31 ,57.88 ,66.31 
03,019,01,004,0088,0,5235,58,5293,9118,0,0,0,0,0,0,0,66.31 ,58.05 ,66.31 
03,019,01,004,0089,0,1525,29,1554,2386,0,0,0,0,0,0,0,66.31 ,65.13 ,66.31 
03,019,01,004,0090,0,1804,24,1828,2929,0,0,0,0,0,0,0,66.31 ,62.41 ,66.31 
03,019,01,004,0091,0,3866,38,3904,6530,0,0,0,0,0,0,0,66.31 ,59.79 ,66.31 
03,019,01,005,0092,0,564,6,570,868,0,0,0,0,0,0,0,66.31 ,65.67 ,66.31 
03,019,01,005,0093,0,669,6,675,1056,0,0,0,0,0,0,0,66.31 ,63.92 ,66.31 
03,019,01,005,0094,0,562,10,572,956,0,0,0,0,0,0,0,66.31 ,59.83 ,66.31 
03,019,01,005,0095,0,671,13,684,1132,0,0,0,0,0,0,0,66.31 ,60.42 ,66.31 
03,019,01,005,0096,0,1124,31,1155,1863,0,0,0,0,0,0,0,66.31 ,62.00 ,66.31 
03,019,01,005,0097,0,1195,11,1206,1959,0,0,0,0,0,0,0,66.31 ,61.56 ,66.31 
03,019,01,005,0098,0,617,3,620,1014,0,0,0,0,0,0,0,66.31 ,61.14 ,66.31 
03,019,01,005,0099,0,1018,15,1033,1615,0,0,0,0,0,0,0,66.31 ,63.96 ,66.31 
03,019,01,005,0100,0,644,2,646,1001,0,0,0,0,0,0,0,66.31 ,64.54 ,66.31 
03,019,01,005,0101,0,972,7,979,1638,0,0,0,0,0,0,0,66.31 ,59.77 ,66.31 
03,019,01,005,0102,0,509,8,517,747,0,0,0,0,0,0,0,66.31 ,69.21 ,66.31 
03,019,01,005,0103,0,734,8,742,1209,0,0,0,0,0,0,0,66.31 ,61.37 ,66.31 
03,019,01,005,0104,0,493,5,498,867,0,0,0,0,0,0,0,66.31 ,57.44 ,66.31 
03,019,01,005,0105,0,1361,20,1381,2390,0,0,0,0,0,0,0,66.31 ,57.78 ,66.31 
03,019,01,005,0106,0,1961,19,1980,3135,0,0,0,0,0,0,0,66.31 ,63.16 ,66.31 
03,019,01,005,0107,0,1875,20,1895,2919,0,0,0,0,0,0,0,66.31 ,64.92 ,66.31 
03,019,01,005,0108,0,4005,58,4063,6725,0,0,0,0,0,0,0,66.31 ,60.42 ,66.31 
03,019,01,005,0109,0,1796,23,1819,2897,0,0,0,0,0,0,0,66.31 ,62.79 ,66.31 
03,019,01,005,0110,0,1549,20,1569,2863,0,0,0,0,0,0,0,66.31 ,54.80 ,66.31 
03,019,01,005,0111,0,843,11,854,1517,0,0,0,0,0,0,0,66.31 ,56.30 ,66.31 
03,019,01,005,0112,0,2425,31,2456,4079,0,0,0,0,0,0,0,66.31 ,60.21 ,66.31 
03,019,01,005,0113,0,1138,12,1150,2129,0,0,0,0,0,0,0,66.31 ,54.02 ,66.31 
03,019,01,005,0114,0,2635,25,2660,4654,0,0,0,0,0,0,0,66.31 ,57.16 ,66.31 
03,019,01,005,0115,0,3247,37,3284,5422,0,0,0,0,0,0,0,66.31 ,60.57 ,66.31 
03,019,01,005,0116,0,2243,27,2270,3746,0,0,0,0,0,0,0,66.31 ,60.60 ,66.31 
03,019,01,005,0117,0,2256,24,2280,4068,0,0,0,0,0,0,0,66.31 ,56.05 ,66.31 
03,019,01,005,0118,0,2855,31,2886,5148,0,0,0,0,0,0,0,66.31 ,56.06 ,66.31 
03,019,01,005,0119,0,2179,35,2214,3610,0,0,0,0,0,0,0,66.31 ,61.33 ,66.31 
03,019,01,005,0120,0,1659,10,1669,2860,0,0,0,0,0,0,0,66.31 ,58.36 ,66.31 
03,019,01,005,0121,0,2291,21,2312,3553,0,0,0,0,0,0,0,66.31 ,65.07 ,66.31 
03,019,01,005,0122,0,2984,39,3023,4940,0,0,0,0,0,0,0,66.31 ,61.19 ,66.31 
03,019,01,005,0123,0,3520,25,3545,6051,0,0,0,0,0,0,0,66.31 ,58.59 ,66.31 
03,019,01,005,0124,0,4062,38,4100,6972,0,0,0,0,0,0,0,66.31 ,58.81 ,66.31 
03,019,01,005,0125,0,1528,16,1544,2513,0,0,0,0,0,0,0,66.31 ,61.44 ,66.31 
03,019,01,006,0126,0,2983,31,3014,4849,0,0,0,0,0,0,0,66.31 ,62.16 ,66.31 
03,019,01,006,0127,0,2253,16,2269,3676,0,0,0,0,0,0,0,66.31 ,61.72 ,66.31 
03,019,01,006,0128,0,2020,20,2040,3265,0,0,0,0,0,0,0,66.31 ,62.48 ,66.31 
03,019,01,006,0129,0,866,7,873,1325,0,0,0,0,0,0,0,66.31 ,65.89 ,66.31 
03,019,01,006,0130,0,686,5,691,947,0,0,0,0,0,0,0,66.31 ,72.97 ,66.31 
03,019,01,006,0131,0,2103,20,2123,3237,0,0,0,0,0,0,0,66.31 ,65.59 ,66.31 
03,019,01,006,0132,0,3644,44,3688,6664,0,0,0,0,0,0,0,66.31 ,55.34 ,66.31 
03,019,01,006,0133,0,3568,34,3602,6085,0,0,0,0,0,0,0,66.31 ,59.19 ,66.31 
03,019,01,006,0134,0,1266,16,1282,1710,0,0,0,0,0,0,0,66.31 ,74.97 ,66.31 
03,019,01,006,0135,0,2818,31,2849,4852,0,0,0,0,0,0,0,66.31 ,58.72 ,66.31 
03,019,01,006,0136,0,3699,32,3731,6450,0,0,0,0,0,0,0,66.31 ,57.84 ,66.31 
03,019,01,006,0137,0,2024,20,2044,3412,0,0,0,0,0,0,0,66.31 ,59.91 ,66.31 
03,019,01,006,0138,0,2394,27,2421,4180,0,0,0,0,0,0,0,66.31 ,57.92 ,66.31 
03,019,01,006,0139,0,3040,26,3066,5166,0,0,0,0,0,0,0,66.31 ,59.35 ,66.31 
03,019,01,006,0140,0,2456,27,2483,4260,0,0,0,0,0,0,0,66.31 ,58.29 ,66.31 
03,019,01,006,0141,0,2013,31,2044,3216,0,0,0,0,0,0,0,66.31 ,63.56 ,66.31 
03,019,01,006,0142,0,703,2,705,1027,0,0,0,0,0,0,0,66.31 ,68.65 ,66.31 
03,019,01,006,0143,0,1704,27,1731,2683,0,0,0,0,0,0,0,66.31 ,64.52 ,66.31 
03,019,01,006,0144,0,2359,24,2383,3844,0,0,0,0,0,0,0,66.31 ,61.99 ,66.31 
03,019,01,006,0145,0,2803,30,2833,4410,0,0,0,0,0,0,0,66.31 ,64.24 ,66.31 
03,019,01,006,0146,0,1307,15,1322,1829,0,0,0,0,0,0,0,66.31 ,72.28 ,66.31 
03,019,01,006,0147,0,1238,20,1258,2119,0,0,0,0,0,0,0,66.31 ,59.37 ,66.31 
03,019,01,006,0148,0,2295,24,2319,3860,0,0,0,0,0,0,0,66.31 ,60.08 ,66.31 
03,019,01,006,0149,0,8676,75,8751,15904,0,0,0,0,0,0,0,66.31 ,55.02 ,66.31 
03,019,01,006,0150,0,2312,21,2333,3754,0,0,0,0,0,0,0,66.31 ,62.15 ,66.31 
03,019,01,007,0151,0,2599,25,2624,4075,0,0,0,0,0,0,0,66.31 ,64.39 ,66.31 
03,019,01,007,0152,0,2523,29,2552,4080,0,0,0,0,0,0,0,66.31 ,62.55 ,66.31 
03,019,01,007,0153,0,2226,36,2262,3385,0,0,0,0,0,0,0,66.31 ,66.82 ,66.31 
03,019,01,007,0154,0,2239,32,2271,3243,0,0,0,0,0,0,0,66.31 ,70.03 ,66.31 
03,019,01,007,0155,0,1097,13,1110,1494,0,0,0,0,0,0,0,66.31 ,74.30 ,66.31 
03,019,01,007,0156,0,1583,22,1605,2604,0,0,0,0,0,0,0,66.31 ,61.64 ,66.31 
03,019,01,007,0157,0,2855,36,2891,4653,0,0,0,0,0,0,0,66.31 ,62.13 ,66.31 
03,019,01,007,0158,0,1409,17,1426,1967,0,0,0,0,0,0,0,66.31 ,72.50 ,66.31 
03,019,01,007,0159,0,3724,38,3762,5938,0,0,0,0,0,0,0,66.31 ,63.35 ,66.31 
03,019,01,007,0160,0,732,9,741,1155,0,0,0,0,0,0,0,66.31 ,64.16 ,66.31 
03,019,01,007,0161,0,4124,45,4169,7115,0,0,0,0,0,0,0,66.31 ,58.59 ,66.31 
03,019,01,007,0162,0,1532,13,1545,2445,0,0,0,0,0,0,0,66.31 ,63.19 ,66.31 
03,019,01,007,0163,0,871,20,891,1316,0,0,0,0,0,0,0,66.31 ,67.71 ,66.31 
03,019,01,007,0164,0,6131,82,6213,10067,0,0,0,0,0,0,0,66.31 ,61.72 ,66.31 
03,019,01,007,0165,0,4262,41,4303,7113,0,0,0,0,0,0,0,66.31 ,60.49 ,66.31 
03,019,01,007,0166,0,5480,36,5516,8966,0,0,0,0,0,0,0,66.31 ,61.52 ,66.31 
03,019,01,008,0167,0,3170,36,3206,5155,0,0,0,0,0,0,0,66.31 ,62.19 ,66.31 
03,019,01,008,0168,0,1971,21,1992,3150,0,0,0,0,0,0,0,66.31 ,63.24 ,66.31 
03,019,01,008,0169,0,5170,40,5210,8895,0,0,0,0,0,0,0,66.31 ,58.57 ,66.31 
03,019,01,008,0170,0,4856,59,4915,8431,0,0,0,0,0,0,0,66.31 ,58.30 ,66.31 
03,019,01,008,0171,0,3410,43,3453,5978,0,0,0,0,0,0,0,66.31 ,57.76 ,66.31 
03,019,01,008,0172,0,2383,42,2425,3880,0,0,0,0,0,0,0,66.31 ,62.50 ,66.31 
03,019,01,008,0173,0,3556,44,3600,6052,0,0,0,0,0,0,0,66.31 ,59.48 ,66.31 
03,019,01,008,0174,0,2223,24,2247,3755,0,0,0,0,0,0,0,66.31 ,59.84 ,66.31 
03,019,01,008,0175,0,2098,30,2128,3351,0,0,0,0,0,0,0,66.31 ,63.50 ,66.31 
03,019,01,008,0176,0,2580,28,2608,4301,0,0,0,0,0,0,0,66.31 ,60.64 ,66.31 
03,019,01,008,0177,0,3067,30,3097,4748,0,0,0,0,0,0,0,66.31 ,65.23 ,66.31 
03,019,01,008,0178,0,3658,52,3710,5578,0,0,0,0,0,0,0,66.31 ,66.51 ,66.31 
03,019,01,008,0179,0,2581,21,2602,3972,0,0,0,0,0,0,0,66.31 ,65.51 ,66.31 
03,019,01,008,0180,0,1037,9,1046,1484,0,0,0,0,0,0,0,66.31 ,70.49 ,66.31 
03,019,01,008,0181,0,1152,30,1182,1792,0,0,0,0,0,0,0,66.31 ,65.96 ,66.31 
03,019,01,008,0182,0,641,3,644,894,0,0,0,0,0,0,0,66.31 ,72.04 ,66.31 
03,019,01,008,0183,0,512,3,515,708,0,0,0,0,0,0,0,66.31 ,72.74 ,66.31 
03,019,01,008,0184,0,950,15,965,1338,0,0,0,0,0,0,0,66.31 ,72.12 ,66.31 
03,019,01,008,0185,0,2389,30,2419,3890,0,0,0,0,0,0,0,66.31 ,62.19 ,66.31 
03,019,01,008,0186,0,4037,45,4082,7005,0,0,0,0,0,0,0,66.31 ,58.27 ,66.31 
03,019,01,008,0187,0,5208,57,5265,8988,0,0,0,0,0,0,0,66.31 ,58.58 ,66.31 
03,019,01,008,0188,0,3900,38,3938,5589,0,0,0,0,0,0,0,66.31 ,70.46 ,66.31 
03,019,01,008,0189,0,3524,79,3603,4872,0,0,0,0,0,0,0,66.31 ,73.95 ,66.31 
03,019,01,008,0190,0,783,7,790,1005,0,0,0,0,0,0,0,66.31 ,78.61 ,66.31 
03,019,01,008,0191,0,3033,38,3071,4538,0,0,0,0,0,0,0,66.31 ,67.67 ,66.31 
03,019,01,008,0192,0,2710,34,2744,4207,0,0,0,0,0,0,0,66.31 ,65.22 ,66.31 
03,019,01,008,0193,0,3543,45,3588,5991,0,0,0,0,0,0,0,66.31 ,59.89 ,66.31 
03,019,01,008,0194,0,2270,20,2290,3568,0,0,0,0,0,0,0,66.31 ,64.18 ,66.31 
03,019,01,008,0195,0,2549,43,2592,4155,0,0,0,0,0,0,0,66.31 ,62.38 ,66.31 
03,019,01,008,0196,0,562,7,569,807,0,0,0,0,0,0,0,66.31 ,70.51 ,66.31 
03,019,01,008,0197,0,3385,41,3426,5267,0,0,0,0,0,0,0,66.31 ,65.05 ,66.31 
03,020,01,001,0001,0,2064,29,2093,3632,0,0,0,0,0,0,0,66.31 ,57.63 ,66.31 
03,020,01,001,0002,0,1071,8,1079,1743,0,0,0,0,0,0,0,66.31 ,61.90 ,66.31 
03,020,01,001,0003,0,374,8,382,587,0,0,0,0,0,0,0,66.31 ,65.08 ,66.31 
03,020,01,001,0004,0,1434,15,1449,2583,0,0,0,0,0,0,0,66.31 ,56.10 ,66.31 
03,020,01,001,0005,0,533,6,539,885,0,0,0,0,0,0,0,66.31 ,60.90 ,66.31 
03,020,01,001,0006,0,1827,20,1847,3099,0,0,0,0,0,0,0,66.31 ,59.60 ,66.31 
03,020,01,001,0007,0,1226,21,1247,2166,0,0,0,0,0,0,0,66.31 ,57.57 ,66.31 
03,020,01,001,0008,0,1485,11,1496,2271,0,0,0,0,0,0,0,66.31 ,65.87 ,66.31 
03,020,01,001,0009,0,1649,21,1670,2976,0,0,0,0,0,0,0,66.31 ,56.12 ,66.31 
03,020,01,001,0010,0,1676,16,1692,2928,0,0,0,0,0,0,0,66.31 ,57.79 ,66.31 
03,020,01,001,0011,0,2390,36,2426,3689,0,0,0,0,0,0,0,66.31 ,65.76 ,66.31 
03,020,01,001,0012,0,727,10,737,1274,0,0,0,0,0,0,0,66.31 ,57.85 ,66.31 
03,020,01,001,0013,0,246,0,246,335,0,0,0,0,0,0,0,66.31 ,73.43 ,66.31 
03,020,01,001,0014,0,285,3,288,487,0,0,0,0,0,0,0,66.31 ,59.14 ,66.31 
03,020,01,001,0015,0,314,5,319,533,0,0,0,0,0,0,0,66.31 ,59.85 ,66.31 
03,020,01,001,0016,0,301,4,305,511,0,0,0,0,0,0,0,66.31 ,59.69 ,66.31 
03,020,01,001,0017,0,397,5,402,611,0,0,0,0,0,0,0,66.31 ,65.79 ,66.31 
03,020,01,001,0018,0,330,2,332,550,0,0,0,0,0,0,0,66.31 ,60.36 ,66.31 
03,020,01,001,0019,0,299,2,301,480,0,0,0,0,0,0,0,66.31 ,62.71 ,66.31 
03,020,01,001,0020,0,792,10,802,1304,0,0,0,0,0,0,0,66.31 ,61.50 ,66.31 
03,020,01,001,0021,0,368,3,371,625,0,0,0,0,0,0,0,66.31 ,59.36 ,66.31 
03,020,01,001,0022,0,581,2,583,998,0,0,0,0,0,0,0,66.31 ,58.42 ,66.31 
03,020,01,001,0023,0,238,1,239,395,0,0,0,0,0,0,0,66.31 ,60.51 ,66.31 
03,020,01,001,0024,0,657,6,663,1039,0,0,0,0,0,0,0,66.31 ,63.81 ,66.31 
03,020,01,001,0025,0,390,1,391,649,0,0,0,0,0,0,0,66.31 ,60.25 ,66.31 
03,020,01,001,0026,0,397,4,401,741,0,0,0,0,0,0,0,66.31 ,54.12 ,66.31 
03,020,01,001,0027,0,449,4,453,777,0,0,0,0,0,0,0,66.31 ,58.30 ,66.31 
03,020,01,001,0028,0,414,2,416,682,0,0,0,0,0,0,0,66.31 ,61.00 ,66.31 
03,020,01,001,0029,0,807,10,817,1250,0,0,0,0,0,0,0,66.31 ,65.36 ,66.31 
03,020,01,001,0030,0,361,2,363,638,0,0,0,0,0,0,0,66.31 ,56.90 ,66.31 
03,020,01,001,0031,0,721,6,727,1156,0,0,0,0,0,0,0,66.31 ,62.89 ,66.31 
03,020,01,001,0032,0,717,9,726,1242,0,0,0,0,0,0,0,66.31 ,58.45 ,66.31 
03,020,01,001,0033,0,514,2,516,818,0,0,0,0,0,0,0,66.31 ,63.08 ,66.31 
03,020,01,001,0034,0,771,5,776,1337,0,0,0,0,0,0,0,66.31 ,58.04 ,66.31 
03,020,01,001,0035,0,1038,8,1046,1939,0,0,0,0,0,0,0,66.31 ,53.95 ,66.31 
03,020,01,001,0036,0,792,8,800,1351,0,0,0,0,0,0,0,66.31 ,59.22 ,66.31 
03,020,01,001,0037,0,858,9,867,1539,0,0,0,0,0,0,0,66.31 ,56.34 ,66.31 
03,020,01,001,0038,0,1690,21,1711,3070,0,0,0,0,0,0,0,66.31 ,55.73 ,66.31 
03,020,01,001,0039,0,1188,16,1204,2028,0,0,0,0,0,0,0,66.31 ,59.37 ,66.31 
03,020,01,001,0040,0,1143,10,1153,1918,0,0,0,0,0,0,0,66.31 ,60.11 ,66.31 
03,020,01,001,0041,0,2332,20,2352,4443,0,0,0,0,0,0,0,66.31 ,52.94 ,66.31 
03,020,01,001,0042,0,1507,18,1525,2615,0,0,0,0,0,0,0,66.31 ,58.32 ,66.31 
03,020,01,001,0043,0,1205,13,1218,2004,0,0,0,0,0,0,0,66.31 ,60.78 ,66.31 
03,020,01,001,0044,0,1502,14,1516,2839,0,0,0,0,0,0,0,66.31 ,53.40 ,66.31 
03,020,01,001,0045,0,522,9,531,874,0,0,0,0,0,0,0,66.31 ,60.76 ,66.31 
03,020,01,001,0046,0,495,9,504,673,0,0,0,0,0,0,0,66.31 ,74.89 ,66.31 
03,020,01,001,0047,0,732,10,742,1113,0,0,0,0,0,0,0,66.31 ,66.67 ,66.31 
03,020,01,001,0048,0,877,8,885,1480,0,0,0,0,0,0,0,66.31 ,59.80 ,66.31 
03,020,01,001,0049,0,582,14,596,881,0,0,0,0,0,0,0,66.31 ,67.65 ,66.31 
03,020,01,001,0050,0,324,1,325,496,0,0,0,0,0,0,0,66.31 ,65.52 ,66.31 
03,020,01,001,0051,0,1470,10,1480,2426,0,0,0,0,0,0,0,66.31 ,61.01 ,66.31 
03,020,01,001,0052,0,1093,17,1110,2017,0,0,0,0,0,0,0,66.31 ,55.03 ,66.31 
03,020,01,001,0053,0,1702,27,1729,2757,0,0,0,0,0,0,0,66.31 ,62.71 ,66.31 
03,020,01,001,0054,0,1127,11,1138,2095,0,0,0,0,0,0,0,66.31 ,54.32 ,66.31 
03,020,01,001,0055,0,2300,31,2331,4101,0,0,0,0,0,0,0,66.31 ,56.84 ,66.31 
03,020,01,002,0056,0,637,10,647,1039,0,0,0,0,0,0,0,66.31 ,62.27 ,66.31 
03,020,01,002,0057,0,397,5,402,651,0,0,0,0,0,0,0,66.31 ,61.75 ,66.31 
03,020,01,002,0058,0,333,3,336,567,0,0,0,0,0,0,0,66.31 ,59.26 ,66.31 
03,020,01,002,0059,0,424,6,430,671,0,0,0,0,0,0,0,66.31 ,64.08 ,66.31 
03,020,01,002,0060,0,340,1,341,595,0,0,0,0,0,0,0,66.31 ,57.31 ,66.31 
03,020,01,002,0061,0,556,3,559,832,0,0,0,0,0,0,0,66.31 ,67.19 ,66.31 
03,020,01,002,0062,0,409,8,417,590,0,0,0,0,0,0,0,66.31 ,70.68 ,66.31 
03,020,01,002,0063,0,691,9,700,1023,0,0,0,0,0,0,0,66.31 ,68.43 ,66.31 
03,020,01,002,0064,0,544,8,552,906,0,0,0,0,0,0,0,66.31 ,60.93 ,66.31 
03,020,01,002,0065,0,517,4,521,864,0,0,0,0,0,0,0,66.31 ,60.30 ,66.31 
03,020,01,002,0066,0,361,4,365,550,0,0,0,0,0,0,0,66.31 ,66.36 ,66.31 
03,020,01,002,0067,0,477,2,479,809,0,0,0,0,0,0,0,66.31 ,59.21 ,66.31 
03,020,01,002,0068,0,340,0,340,550,0,0,0,0,0,0,0,66.31 ,61.82 ,66.31 
03,020,01,002,0069,0,348,6,354,556,0,0,0,0,0,0,0,66.31 ,63.67 ,66.31 
03,020,01,002,0070,0,271,3,274,436,0,0,0,0,0,0,0,66.31 ,62.84 ,66.31 
03,020,01,002,0071,0,253,5,258,440,0,0,0,0,0,0,0,66.31 ,58.64 ,66.31 
03,020,01,002,0072,0,369,8,377,642,0,0,0,0,0,0,0,66.31 ,58.72 ,66.31 
03,020,01,002,0073,0,486,2,488,722,0,0,0,0,0,0,0,66.31 ,67.59 ,66.31 
03,020,01,002,0074,0,409,1,410,655,0,0,0,0,0,0,0,66.31 ,62.60 ,66.31 
03,020,01,002,0075,0,2769,25,2794,5096,0,0,0,0,0,0,0,66.31 ,54.83 ,66.31 
03,020,01,002,0076,0,594,3,597,1012,0,0,0,0,0,0,0,66.31 ,58.99 ,66.31 
03,020,01,002,0077,0,1588,13,1601,2990,0,0,0,0,0,0,0,66.31 ,53.55 ,66.31 
03,020,01,002,0078,0,900,12,912,1475,0,0,0,0,0,0,0,66.31 ,61.83 ,66.31 
03,020,01,002,0079,0,644,10,654,1089,0,0,0,0,0,0,0,66.31 ,60.06 ,66.31 
03,020,01,002,0080,0,744,10,754,1215,0,0,0,0,0,0,0,66.31 ,62.06 ,66.31 
03,020,01,002,0081,0,960,14,974,1653,0,0,0,0,0,0,0,66.31 ,58.92 ,66.31 
03,020,01,002,0082,0,1590,23,1613,2722,0,0,0,0,0,0,0,66.31 ,59.26 ,66.31 
03,020,01,002,0083,0,1162,10,1172,2129,0,0,0,0,0,0,0,66.31 ,55.05 ,66.31 
03,020,01,002,0084,0,465,5,470,761,0,0,0,0,0,0,0,66.31 ,61.76 ,66.31 
03,020,01,002,0085,0,724,6,730,1307,0,0,0,0,0,0,0,66.31 ,55.85 ,66.31 
03,020,01,002,0086,0,576,9,585,1052,0,0,0,0,0,0,0,66.31 ,55.61 ,66.31 
03,020,01,002,0087,0,1083,10,1093,1916,0,0,0,0,0,0,0,66.31 ,57.05 ,66.31 
03,020,01,002,0088,0,2002,13,2015,3628,0,0,0,0,0,0,0,66.31 ,55.54 ,66.31 
03,020,01,002,0089,0,1897,14,1911,3198,0,0,0,0,0,0,0,66.31 ,59.76 ,66.31 
03,020,01,002,0090,0,3077,29,3106,5621,0,0,0,0,0,0,0,66.31 ,55.26 ,66.31 
03,020,01,002,0091,0,1916,10,1926,3140,0,0,0,0,0,0,0,66.31 ,61.34 ,66.31 
03,020,01,002,0092,0,2147,31,2178,3722,0,0,0,0,0,0,0,66.31 ,58.52 ,66.31 
03,020,01,002,0093,0,1245,7,1252,2220,0,0,0,0,0,0,0,66.31 ,56.40 ,66.31 
03,020,01,002,0094,0,383,4,387,639,0,0,0,0,0,0,0,66.31 ,60.56 ,66.31 
03,020,01,002,0095,0,298,10,308,478,0,0,0,0,0,0,0,66.31 ,64.44 ,66.31 
03,020,01,002,0096,0,1061,12,1073,1765,0,0,0,0,0,0,0,66.31 ,60.79 ,66.31 
03,020,01,002,0097,0,766,11,777,1264,0,0,0,0,0,0,0,66.31 ,61.47 ,66.31 
03,020,01,002,0098,0,1045,11,1056,1793,0,0,0,0,0,0,0,66.31 ,58.90 ,66.31 
03,020,01,002,0099,0,1145,20,1165,2038,0,0,0,0,0,0,0,66.31 ,57.16 ,66.31 
03,020,01,002,0100,0,300,4,304,550,0,0,0,0,0,0,0,66.31 ,55.27 ,66.31 
03,020,01,002,0101,0,488,7,495,678,0,0,0,0,0,0,0,66.31 ,73.01 ,66.31 
03,020,01,002,0102,0,923,14,937,1405,0,0,0,0,0,0,0,66.31 ,66.69 ,66.31 
03,020,01,002,0103,0,722,7,729,1289,0,0,0,0,0,0,0,66.31 ,56.56 ,66.31 
03,020,01,002,0104,0,937,11,948,1724,0,0,0,0,0,0,0,66.31 ,54.99 ,66.31 
03,020,01,002,0105,0,2113,27,2140,3485,0,0,0,0,0,0,0,66.31 ,61.41 ,66.31 
03,020,01,002,0106,0,4411,57,4468,7465,0,0,0,0,0,0,0,66.31 ,59.85 ,66.31 
03,020,01,002,0107,0,1796,17,1813,3030,0,0,0,0,0,0,0,66.31 ,59.83 ,66.31 
03,020,01,002,0108,0,1306,15,1321,2153,0,0,0,0,0,0,0,66.31 ,61.36 ,66.31 
03,020,01,002,0109,0,556,8,564,1105,0,0,0,0,0,0,0,66.31 ,51.04 ,66.31 
03,020,01,002,0110,0,507,6,513,862,0,0,0,0,0,0,0,66.31 ,59.51 ,66.31 
03,021,01,001,0001,0,3191,29,3220,5740,0,0,0,0,0,0,0,66.31 ,56.10 ,66.31 
03,021,01,001,0002,0,2158,21,2179,3559,0,0,0,0,0,0,0,66.31 ,61.23 ,66.31 
03,021,01,001,0003,0,1573,23,1596,2730,0,0,0,0,0,0,0,66.31 ,58.46 ,66.31 
03,021,01,001,0004,0,3159,24,3183,5242,0,0,0,0,0,0,0,66.31 ,60.72 ,66.31 
03,021,01,001,0005,0,2530,39,2569,4110,0,0,0,0,0,0,0,66.31 ,62.51 ,66.31 
03,021,01,001,0006,0,1122,19,1141,1765,0,0,0,0,0,0,0,66.31 ,64.65 ,66.31 
03,021,01,001,0007,0,1427,24,1451,2504,0,0,0,0,0,0,0,66.31 ,57.95 ,66.31 
03,021,01,001,0008,0,1403,15,1418,2234,0,0,0,0,0,0,0,66.31 ,63.47 ,66.31 
03,021,01,001,0009,0,1517,17,1534,2620,0,0,0,0,0,0,0,66.31 ,58.55 ,66.31 
03,021,01,001,0010,0,2966,32,2998,5035,0,0,0,0,0,0,0,66.31 ,59.54 ,66.31 
03,021,01,001,0011,0,2939,37,2976,5396,0,0,0,0,0,0,0,66.31 ,55.15 ,66.31 
03,021,01,001,0012,0,1220,13,1233,2052,0,0,0,0,0,0,0,66.31 ,60.09 ,66.31 
03,021,01,001,0013,0,1819,28,1847,2978,0,0,0,0,0,0,0,66.31 ,62.02 ,66.31 
03,021,01,001,0014,0,1531,9,1540,2564,0,0,0,0,0,0,0,66.31 ,60.06 ,66.31 
03,021,01,001,0015,0,1435,11,1446,2101,0,0,0,0,0,0,0,66.31 ,68.82 ,66.31 
03,021,01,001,0016,0,1267,8,1275,1856,0,0,0,0,0,0,0,66.31 ,68.70 ,66.31 
03,021,01,001,0017,0,1871,14,1885,3291,0,0,0,0,0,0,0,66.31 ,57.28 ,66.31 
03,021,01,001,0018,0,1657,11,1668,2979,0,0,0,0,0,0,0,66.31 ,55.99 ,66.31 
03,021,01,001,0019,0,1609,14,1623,2687,0,0,0,0,0,0,0,66.31 ,60.40 ,66.31 
03,021,01,001,0020,0,2189,17,2206,3676,0,0,0,0,0,0,0,66.31 ,60.01 ,66.31 
03,021,01,001,0021,0,855,5,860,1454,0,0,0,0,0,0,0,66.31 ,59.15 ,66.31 
03,021,01,001,0022,0,526,10,536,900,0,0,0,0,0,0,0,66.31 ,59.56 ,66.31 
03,021,01,001,0023,0,443,7,450,777,0,0,0,0,0,0,0,66.31 ,57.92 ,66.31 
03,021,01,001,0024,0,649,9,658,1185,0,0,0,0,0,0,0,66.31 ,55.53 ,66.31 
03,021,01,001,0025,0,651,5,656,1131,0,0,0,0,0,0,0,66.31 ,58.00 ,66.31 
03,021,01,001,0026,0,470,11,481,777,0,0,0,0,0,0,0,66.31 ,61.90 ,66.31 
03,021,01,001,0027,0,1036,14,1050,1806,0,0,0,0,0,0,0,66.31 ,58.14 ,66.31 
03,021,01,001,0028,0,1549,15,1564,2737,0,0,0,0,0,0,0,66.31 ,57.14 ,66.31 
03,021,01,001,0029,0,947,16,963,1699,0,0,0,0,0,0,0,66.31 ,56.68 ,66.31 
03,021,01,001,0030,0,1351,19,1370,2352,0,0,0,0,0,0,0,66.31 ,58.25 ,66.31 
03,021,01,001,0031,0,1600,14,1614,2702,0,0,0,0,0,0,0,66.31 ,59.73 ,66.31 
03,021,01,001,0032,0,886,9,895,1542,0,0,0,0,0,0,0,66.31 ,58.04 ,66.31 
03,021,01,001,0033,0,1527,20,1547,2632,0,0,0,0,0,0,0,66.31 ,58.78 ,66.31 
03,021,01,001,0034,0,1153,6,1159,2011,0,0,0,0,0,0,0,66.31 ,57.63 ,66.31 
03,021,01,001,0035,0,2482,26,2508,3742,0,0,0,0,0,0,0,66.31 ,67.02 ,66.31 
03,021,01,001,0036,0,1066,5,1071,1892,0,0,0,0,0,0,0,66.31 ,56.61 ,66.31 
03,021,01,001,0037,0,1026,7,1033,1771,0,0,0,0,0,0,0,66.31 ,58.33 ,66.31 
03,021,01,001,0038,0,2832,27,2859,4690,0,0,0,0,0,0,0,66.31 ,60.96 ,66.31 
03,021,01,001,0039,0,1187,21,1208,1937,0,0,0,0,0,0,0,66.31 ,62.36 ,66.31 
03,021,01,001,0040,0,753,9,762,1335,0,0,0,0,0,0,0,66.31 ,57.08 ,66.31 
03,021,01,001,0041,0,750,9,759,1200,0,0,0,0,0,0,0,66.31 ,63.25 ,66.31 
03,021,01,001,0042,0,491,7,498,812,0,0,0,0,0,0,0,66.31 ,61.33 ,66.31 
03,021,01,001,0043,0,632,9,641,1093,0,0,0,0,0,0,0,66.31 ,58.65 ,66.31 
03,021,01,001,0044,0,2329,34,2363,3954,0,0,0,0,0,0,0,66.31 ,59.76 ,66.31 
03,021,01,001,0045,0,2831,29,2860,5014,0,0,0,0,0,0,0,66.31 ,57.04 ,66.31 
03,021,01,002,0046,0,1747,17,1764,2949,0,0,0,0,0,0,0,66.31 ,59.82 ,66.31 
03,021,01,002,0047,0,1201,15,1216,2072,0,0,0,0,0,0,0,66.31 ,58.69 ,66.31 
03,021,01,002,0048,0,2463,30,2493,4120,0,0,0,0,0,0,0,66.31 ,60.51 ,66.31 
03,021,01,002,0049,0,286,4,290,513,0,0,0,0,0,0,0,66.31 ,56.53 ,66.31 
03,021,01,002,0050,0,755,15,770,1345,0,0,0,0,0,0,0,66.31 ,57.25 ,66.31 
03,021,01,002,0051,0,690,11,701,1074,0,0,0,0,0,0,0,66.31 ,65.27 ,66.31 
03,021,01,002,0052,0,851,8,859,1255,0,0,0,0,0,0,0,66.31 ,68.45 ,66.31 
03,021,01,002,0053,0,939,14,953,1444,0,0,0,0,0,0,0,66.31 ,66.00 ,66.31 
03,021,01,002,0054,0,615,7,622,1012,0,0,0,0,0,0,0,66.31 ,61.46 ,66.31 
03,021,01,002,0055,0,1976,16,1992,3336,0,0,0,0,0,0,0,66.31 ,59.71 ,66.31 
03,021,01,002,0056,0,1494,15,1509,2603,0,0,0,0,0,0,0,66.31 ,57.97 ,66.31 
03,021,01,002,0057,0,1253,11,1264,2051,0,0,0,0,0,0,0,66.31 ,61.63 ,66.31 
03,021,01,002,0058,0,1628,9,1637,2549,0,0,0,0,0,0,0,66.31 ,64.22 ,66.31 
03,021,01,002,0059,0,1366,12,1378,2373,0,0,0,0,0,0,0,66.31 ,58.07 ,66.31 
03,021,01,002,0060,0,1728,14,1742,3009,0,0,0,0,0,0,0,66.31 ,57.89 ,66.31 
03,021,01,002,0061,0,1924,15,1939,3207,0,0,0,0,0,0,0,66.31 ,60.46 ,66.31 
03,021,01,002,0062,0,2567,23,2590,4489,0,0,0,0,0,0,0,66.31 ,57.70 ,66.31 
03,021,01,002,0063,0,1716,11,1727,2962,0,0,0,0,0,0,0,66.31 ,58.31 ,66.31 
03,021,01,002,0064,0,1102,10,1112,1948,0,0,0,0,0,0,0,66.31 ,57.08 ,66.31 
03,021,01,002,0065,0,2240,16,2256,3936,0,0,0,0,0,0,0,66.31 ,57.32 ,66.31 
03,021,01,002,0066,0,1169,19,1188,1949,0,0,0,0,0,0,0,66.31 ,60.95 ,66.31 
03,021,01,002,0067,0,1837,17,1854,3310,0,0,0,0,0,0,0,66.31 ,56.01 ,66.31 
03,021,01,002,0068,0,2020,24,2044,3722,0,0,0,0,0,0,0,66.31 ,54.92 ,66.31 
03,021,01,002,0069,0,1822,18,1840,3060,0,0,0,0,0,0,0,66.31 ,60.13 ,66.31 
03,021,01,002,0070,0,1859,11,1870,3203,0,0,0,0,0,0,0,66.31 ,58.38 ,66.31 
03,021,01,002,0071,0,1977,21,1998,3312,0,0,0,0,0,0,0,66.31 ,60.33 ,66.31 
03,021,01,002,0072,0,2273,25,2298,4178,0,0,0,0,0,0,0,66.31 ,55.00 ,66.31 
03,021,01,002,0073,0,2011,25,2036,3680,0,0,0,0,0,0,0,66.31 ,55.33 ,66.31 
03,021,01,002,0074,0,1098,12,1110,1907,0,0,0,0,0,0,0,66.31 ,58.21 ,66.31 
03,021,01,002,0075,0,725,9,734,1018,0,0,0,0,0,0,0,66.31 ,72.10 ,66.31 
03,021,01,002,0076,0,656,7,663,963,0,0,0,0,0,0,0,66.31 ,68.85 ,66.31 
03,021,01,002,0077,0,1226,13,1239,2105,0,0,0,0,0,0,0,66.31 ,58.86 ,66.31 
03,021,01,002,0078,0,921,9,930,1467,0,0,0,0,0,0,0,66.31 ,63.39 ,66.31 
03,021,01,002,0079,0,889,5,894,1411,0,0,0,0,0,0,0,66.31 ,63.36 ,66.31 
03,021,01,002,0080,0,1585,10,1595,2446,0,0,0,0,0,0,0,66.31 ,65.21 ,66.31 
03,021,01,002,0081,0,418,3,421,596,0,0,0,0,0,0,0,66.31 ,70.64 ,66.31 
03,021,01,002,0082,0,407,5,412,588,0,0,0,0,0,0,0,66.31 ,70.07 ,66.31 
03,021,01,002,0083,0,612,0,612,986,0,0,0,0,0,0,0,66.31 ,62.07 ,66.31 
03,021,01,002,0084,0,517,4,521,725,0,0,0,0,0,0,0,66.31 ,71.86 ,66.31 
03,021,01,002,0085,0,1074,18,1092,1635,0,0,0,0,0,0,0,66.31 ,66.79 ,66.31 
03,021,01,002,0086,0,1122,12,1134,1775,0,0,0,0,0,0,0,66.31 ,63.89 ,66.31 
03,021,01,002,0087,0,525,5,530,733,0,0,0,0,0,0,0,66.31 ,72.31 ,66.31 
03,021,01,002,0088,0,1150,9,1159,1752,0,0,0,0,0,0,0,66.31 ,66.15 ,66.31 
03,021,01,003,0089,0,1678,13,1691,2813,0,0,0,0,0,0,0,66.31 ,60.11 ,66.31 
03,021,01,003,0090,0,1425,14,1439,2267,0,0,0,0,0,0,0,66.31 ,63.48 ,66.31 
03,021,01,003,0091,0,1482,22,1504,2333,0,0,0,0,0,0,0,66.31 ,64.47 ,66.31 
03,021,01,003,0092,0,809,3,812,1295,0,0,0,0,0,0,0,66.31 ,62.70 ,66.31 
03,021,01,003,0093,0,1394,22,1416,2066,0,0,0,0,0,0,0,66.31 ,68.54 ,66.31 
03,021,01,003,0094,0,438,5,443,687,0,0,0,0,0,0,0,66.31 ,64.48 ,66.31 
03,021,01,003,0095,0,487,2,489,784,0,0,0,0,0,0,0,66.31 ,62.37 ,66.31 
03,021,01,003,0096,0,550,6,556,809,0,0,0,0,0,0,0,66.31 ,68.73 ,66.31 
03,021,01,003,0097,0,486,8,494,740,0,0,0,0,0,0,0,66.31 ,66.76 ,66.31 
03,021,01,003,0098,0,442,3,445,655,0,0,0,0,0,0,0,66.31 ,67.94 ,66.31 
03,021,01,003,0099,0,618,9,627,993,0,0,0,0,0,0,0,66.31 ,63.14 ,66.31 
03,021,01,003,0100,0,545,9,554,870,0,0,0,0,0,0,0,66.31 ,63.68 ,66.31 
03,021,01,003,0101,0,1351,13,1364,2232,0,0,0,0,0,0,0,66.31 ,61.11 ,66.31 
03,021,01,003,0102,0,675,12,687,1010,0,0,0,0,0,0,0,66.31 ,68.02 ,66.31 
03,021,01,003,0103,0,601,1,602,879,0,0,0,0,0,0,0,66.31 ,68.49 ,66.31 
03,021,01,003,0104,0,334,4,338,543,0,0,0,0,0,0,0,66.31 ,62.25 ,66.31 
03,021,01,003,0105,0,541,9,550,905,0,0,0,0,0,0,0,66.31 ,60.77 ,66.31 
03,021,01,003,0106,0,385,2,387,608,0,0,0,0,0,0,0,66.31 ,63.65 ,66.31 
03,021,01,003,0107,0,580,3,583,942,0,0,0,0,0,0,0,66.31 ,61.89 ,66.31 
03,021,01,003,0108,0,1271,17,1288,2150,0,0,0,0,0,0,0,66.31 ,59.91 ,66.31 
03,021,01,003,0109,0,495,5,500,850,0,0,0,0,0,0,0,66.31 ,58.82 ,66.31 
03,021,01,003,0110,0,351,3,354,562,0,0,0,0,0,0,0,66.31 ,62.99 ,66.31 
03,021,01,003,0111,0,192,2,194,263,0,0,0,0,0,0,0,66.31 ,73.76 ,66.31 
03,021,01,003,0112,0,286,0,286,422,0,0,0,0,0,0,0,66.31 ,67.77 ,66.31 
03,021,01,003,0113,0,272,4,276,474,0,0,0,0,0,0,0,66.31 ,58.23 ,66.31 
03,021,01,003,0114,0,190,0,190,283,0,0,0,0,0,0,0,66.31 ,67.14 ,66.31 
03,021,01,003,0115,0,596,3,599,943,0,0,0,0,0,0,0,66.31 ,63.52 ,66.31 
03,021,01,003,0116,0,769,6,775,1130,0,0,0,0,0,0,0,66.31 ,68.58 ,66.31 
03,021,01,003,0117,0,600,10,610,823,0,0,0,0,0,0,0,66.31 ,74.12 ,66.31 
03,021,01,003,0118,0,882,9,891,1460,0,0,0,0,0,0,0,66.31 ,61.03 ,66.31 
03,021,01,004,0119,0,544,9,553,948,0,0,0,0,0,0,0,66.31 ,58.33 ,66.31 
03,021,01,004,0120,0,594,6,600,994,0,0,0,0,0,0,0,66.31 ,60.36 ,66.31 
03,021,01,004,0121,0,515,4,519,978,0,0,0,0,0,0,0,66.31 ,53.07 ,66.31 
03,021,01,004,0122,0,724,10,734,1252,0,0,0,0,0,0,0,66.31 ,58.63 ,66.31 
03,021,01,004,0123,0,591,8,599,942,0,0,0,0,0,0,0,66.31 ,63.59 ,66.31 
03,021,01,004,0124,0,650,5,655,1055,0,0,0,0,0,0,0,66.31 ,62.09 ,66.31 
03,021,01,004,0125,0,715,12,727,1219,0,0,0,0,0,0,0,66.31 ,59.64 ,66.31 
03,021,01,004,0126,0,522,4,526,880,0,0,0,0,0,0,0,66.31 ,59.77 ,66.31 
03,021,01,004,0127,0,755,13,768,1186,0,0,0,0,0,0,0,66.31 ,64.76 ,66.31 
03,021,01,004,0128,0,570,14,584,939,0,0,0,0,0,0,0,66.31 ,62.19 ,66.31 
03,021,01,004,0129,0,1025,13,1038,1732,0,0,0,0,0,0,0,66.31 ,59.93 ,66.31 
03,021,01,004,0130,0,1209,16,1225,1917,0,0,0,0,0,0,0,66.31 ,63.90 ,66.31 
03,021,01,004,0131,0,1216,17,1233,1978,0,0,0,0,0,0,0,66.31 ,62.34 ,66.31 
03,021,01,004,0132,0,1711,24,1735,2730,0,0,0,0,0,0,0,66.31 ,63.55 ,66.31 
03,021,01,004,0133,0,1176,11,1187,2065,0,0,0,0,0,0,0,66.31 ,57.48 ,66.31 
03,021,01,004,0134,0,1232,20,1252,2018,0,0,0,0,0,0,0,66.31 ,62.04 ,66.31 
03,021,01,004,0135,0,910,14,924,1480,0,0,0,0,0,0,0,66.31 ,62.43 ,66.31 
03,021,01,004,0136,0,1043,11,1054,1852,0,0,0,0,0,0,0,66.31 ,56.91 ,66.31 
03,021,01,004,0137,0,1908,30,1938,3365,0,0,0,0,0,0,0,66.31 ,57.59 ,66.31 
03,021,01,004,0138,0,522,7,529,842,0,0,0,0,0,0,0,66.31 ,62.83 ,66.31 
03,021,01,004,0139,0,372,4,376,551,0,0,0,0,0,0,0,66.31 ,68.24 ,66.31 
03,021,01,004,0140,0,768,17,785,1280,0,0,0,0,0,0,0,66.31 ,61.33 ,66.31 
03,021,01,004,0141,0,675,2,677,1078,0,0,0,0,0,0,0,66.31 ,62.80 ,66.31 
03,021,01,004,0142,0,881,13,894,1422,0,0,0,0,0,0,0,66.31 ,62.87 ,66.31 
03,021,01,004,0143,0,440,8,448,753,0,0,0,0,0,0,0,66.31 ,59.50 ,66.31 
03,021,01,004,0144,0,334,2,336,585,0,0,0,0,0,0,0,66.31 ,57.44 ,66.31 
03,021,01,004,0145,0,887,15,902,1536,0,0,0,0,0,0,0,66.31 ,58.72 ,66.31 
03,021,01,004,0146,0,2792,36,2828,4791,0,0,0,0,0,0,0,66.31 ,59.03 ,66.31 
03,021,01,004,0147,0,897,8,905,1560,0,0,0,0,0,0,0,66.31 ,58.01 ,66.31 
03,021,01,004,0148,0,1063,16,1079,1896,0,0,0,0,0,0,0,66.31 ,56.91 ,66.31 
03,021,01,004,0149,0,972,13,985,1624,0,0,0,0,0,0,0,66.31 ,60.65 ,66.31 
03,021,01,004,0150,0,721,12,733,1304,0,0,0,0,0,0,0,66.31 ,56.21 ,66.31 
03,021,01,004,0151,0,946,13,959,1550,0,0,0,0,0,0,0,66.31 ,61.87 ,66.31 
03,021,01,004,0152,0,1248,13,1261,2239,0,0,0,0,0,0,0,66.31 ,56.32 ,66.31 
03,021,01,004,0153,0,1985,14,1999,3305,0,0,0,0,0,0,0,66.31 ,60.48 ,66.31 
03,021,01,004,0154,0,2881,23,2904,5087,0,0,0,0,0,0,0,66.31 ,57.09 ,66.31 
03,021,01,004,0155,0,2111,23,2134,3935,0,0,0,0,0,0,0,66.31 ,54.23 ,66.31 
03,021,01,004,0156,0,795,9,804,1205,0,0,0,0,0,0,0,66.31 ,66.72 ,66.31 
03,021,01,004,0157,0,893,10,903,1426,0,0,0,0,0,0,0,66.31 ,63.32 ,66.31 
03,021,01,004,0158,0,2689,30,2719,4413,0,0,0,0,0,0,0,66.31 ,61.61 ,66.31 
03,021,01,004,0159,0,3998,33,4031,6354,0,0,0,0,0,0,0,66.31 ,63.44 ,66.31 
03,021,01,004,0160,0,3189,46,3235,5356,0,0,0,0,0,0,0,66.31 ,60.40 ,66.31 
03,021,01,005,0161,0,806,4,810,1182,0,0,0,0,0,0,0,66.31 ,68.53 ,66.31 
03,021,01,005,0162,0,754,11,765,1132,0,0,0,0,0,0,0,66.31 ,67.58 ,66.31 
03,021,01,005,0163,0,721,10,731,1203,0,0,0,0,0,0,0,66.31 ,60.76 ,66.31 
03,021,01,005,0164,0,828,9,837,1441,0,0,0,0,0,0,0,66.31 ,58.08 ,66.31 
03,021,01,005,0165,0,439,5,444,702,0,0,0,0,0,0,0,66.31 ,63.25 ,66.31 
03,021,01,005,0166,0,401,2,403,706,0,0,0,0,0,0,0,66.31 ,57.08 ,66.31 
03,021,01,005,0167,0,272,1,273,442,0,0,0,0,0,0,0,66.31 ,61.76 ,66.31 
03,021,01,005,0168,0,257,0,257,447,0,0,0,0,0,0,0,66.31 ,57.49 ,66.31 
03,021,01,005,0169,0,744,7,751,1233,0,0,0,0,0,0,0,66.31 ,60.91 ,66.31 
03,021,01,005,0170,0,285,1,286,423,0,0,0,0,0,0,0,66.31 ,67.61 ,66.31 
03,021,01,005,0171,0,472,7,479,783,0,0,0,0,0,0,0,66.31 ,61.17 ,66.31 
03,021,01,005,0172,0,373,7,380,577,0,0,0,0,0,0,0,66.31 ,65.86 ,66.31 
03,021,01,005,0173,0,547,4,551,913,0,0,0,0,0,0,0,66.31 ,60.35 ,66.31 
03,021,01,005,0174,0,307,2,309,483,0,0,0,0,0,0,0,66.31 ,63.98 ,66.31 
03,021,01,005,0175,0,288,4,292,477,0,0,0,0,0,0,0,66.31 ,61.22 ,66.31 
03,021,01,005,0176,0,670,4,674,1076,0,0,0,0,0,0,0,66.31 ,62.64 ,66.31 
03,021,01,005,0177,0,1246,12,1258,2304,0,0,0,0,0,0,0,66.31 ,54.60 ,66.31 
03,021,01,005,0178,0,658,5,663,1065,0,0,0,0,0,0,0,66.31 ,62.25 ,66.31 
03,021,01,005,0179,0,881,6,887,1462,0,0,0,0,0,0,0,66.31 ,60.67 ,66.31 
03,021,01,005,0180,0,304,6,310,520,0,0,0,0,0,0,0,66.31 ,59.62 ,66.31 
03,021,01,005,0181,0,365,6,371,579,0,0,0,0,0,0,0,66.31 ,64.08 ,66.31 
03,021,01,005,0182,0,468,6,474,688,0,0,0,0,0,0,0,66.31 ,68.90 ,66.31 
03,021,01,005,0183,0,473,4,477,717,0,0,0,0,0,0,0,66.31 ,66.53 ,66.31 
03,021,01,005,0184,0,642,7,649,1028,0,0,0,0,0,0,0,66.31 ,63.13 ,66.31 
03,021,01,005,0185,0,308,5,313,517,0,0,0,0,0,0,0,66.31 ,60.54 ,66.31 
03,021,01,005,0186,0,402,4,406,686,0,0,0,0,0,0,0,66.31 ,59.18 ,66.31 
03,021,01,005,0187,0,328,7,335,544,0,0,0,0,0,0,0,66.31 ,61.58 ,66.31 
03,021,01,005,0188,0,368,4,372,641,0,0,0,0,0,0,0,66.31 ,58.03 ,66.31 
03,021,01,005,0189,0,459,5,464,746,0,0,0,0,0,0,0,66.31 ,62.20 ,66.31 
03,021,01,005,0190,0,420,6,426,671,0,0,0,0,0,0,0,66.31 ,63.49 ,66.31 
03,021,01,005,0191,0,474,8,482,773,0,0,0,0,0,0,0,66.31 ,62.35 ,66.31 
03,021,01,005,0192,0,879,10,889,1528,0,0,0,0,0,0,0,66.31 ,58.18 ,66.31 
03,021,01,005,0193,0,1046,11,1057,1735,0,0,0,0,0,0,0,66.31 ,60.92 ,66.31 
03,021,01,005,0194,0,1812,12,1824,3176,0,0,0,0,0,0,0,66.31 ,57.43 ,66.31 
03,021,01,006,0195,0,365,7,372,522,0,0,0,0,0,0,0,66.31 ,71.26 ,66.31 
03,021,01,006,0196,0,1851,26,1877,3142,0,0,0,0,0,0,0,66.31 ,59.74 ,66.31 
03,021,01,006,0197,0,2556,39,2595,3972,0,0,0,0,0,0,0,66.31 ,65.33 ,66.31 
03,021,01,006,0198,0,1384,23,1407,2083,0,0,0,0,0,0,0,66.31 ,67.55 ,66.31 
03,021,01,006,0199,0,1753,24,1777,2693,0,0,0,0,0,0,0,66.31 ,65.99 ,66.31 
03,021,01,006,0200,0,1436,24,1460,2400,0,0,0,0,0,0,0,66.31 ,60.83 ,66.31 
03,021,01,006,0201,0,1445,13,1458,2279,0,0,0,0,0,0,0,66.31 ,63.98 ,66.31 
03,021,01,006,0202,0,2280,31,2311,3620,0,0,0,0,0,0,0,66.31 ,63.84 ,66.31 
03,021,01,006,0203,0,1366,11,1377,2290,0,0,0,0,0,0,0,66.31 ,60.13 ,66.31 
03,021,01,006,0204,0,1102,18,1120,1804,0,0,0,0,0,0,0,66.31 ,62.08 ,66.31 
03,021,01,006,0205,0,1424,18,1442,2013,0,0,0,0,0,0,0,66.31 ,71.63 ,66.31 
03,021,01,006,0206,0,1669,26,1695,2864,0,0,0,0,0,0,0,66.31 ,59.18 ,66.31 
03,021,01,006,0207,0,1516,23,1539,2501,0,0,0,0,0,0,0,66.31 ,61.54 ,66.31 
03,021,01,006,0208,0,1654,18,1672,3005,0,0,0,0,0,0,0,66.31 ,55.64 ,66.31 
03,021,01,006,0209,0,1586,25,1611,2612,0,0,0,0,0,0,0,66.31 ,61.68 ,66.31 
03,021,01,006,0210,0,3158,34,3192,5487,0,0,0,0,0,0,0,66.31 ,58.17 ,66.31 
03,021,01,006,0211,0,883,15,898,1240,0,0,0,0,0,0,0,66.31 ,72.42 ,66.31 
03,021,01,006,0212,0,1701,26,1727,2746,0,0,0,0,0,0,0,66.31 ,62.89 ,66.31 
03,021,01,006,0213,0,594,9,603,888,0,0,0,0,0,0,0,66.31 ,67.91 ,66.31 
03,021,01,006,0214,0,690,11,701,1084,0,0,0,0,0,0,0,66.31 ,64.67 ,66.31 
03,021,01,006,0215,0,1001,10,1011,1566,0,0,0,0,0,0,0,66.31 ,64.56 ,66.31 
03,021,01,006,0216,0,774,13,787,1166,0,0,0,0,0,0,0,66.31 ,67.50 ,66.31 
03,021,01,006,0217,0,1098,18,1116,1620,0,0,0,0,0,0,0,66.31 ,68.89 ,66.31 
03,021,01,006,0218,0,636,3,639,787,0,0,0,0,0,0,0,66.31 ,81.19 ,66.31 
03,021,01,006,0219,0,1250,19,1269,1959,0,0,0,0,0,0,0,66.31 ,64.78 ,66.31 
03,021,01,006,0220,0,938,14,952,1356,0,0,0,0,0,0,0,66.31 ,70.21 ,66.31 
03,021,01,006,0221,0,1355,23,1378,2250,0,0,0,0,0,0,0,66.31 ,61.24 ,66.31 
03,021,01,006,0222,0,1217,18,1235,2162,0,0,0,0,0,0,0,66.31 ,57.12 ,66.31 
03,021,01,006,0223,0,1456,19,1475,2562,0,0,0,0,0,0,0,66.31 ,57.57 ,66.31 
03,021,01,006,0224,0,1671,27,1698,2824,0,0,0,0,0,0,0,66.31 ,60.13 ,66.31 
03,021,01,006,0225,0,1321,15,1336,2319,0,0,0,0,0,0,0,66.31 ,57.61 ,66.31 
03,021,01,006,0226,0,1435,19,1454,2465,0,0,0,0,0,0,0,66.31 ,58.99 ,66.31 
03,021,01,006,0227,0,1588,21,1609,2628,0,0,0,0,0,0,0,66.31 ,61.23 ,66.31 
03,021,01,006,0228,0,2071,32,2103,3413,0,0,0,0,0,0,0,66.31 ,61.62 ,66.31 
03,021,01,006,0229,0,856,15,871,1419,0,0,0,0,0,0,0,66.31 ,61.38 ,66.31 
03,021,01,006,0230,0,1308,22,1330,2317,0,0,0,0,0,0,0,66.31 ,57.40 ,66.31 
03,021,01,006,0231,0,2057,29,2086,3699,0,0,0,0,0,0,0,66.31 ,56.39 ,66.31 
03,021,01,006,0232,0,1928,24,1952,3149,0,0,0,0,0,0,0,66.31 ,61.99 ,66.31 
03,021,01,006,0233,0,1093,7,1100,1863,0,0,0,0,0,0,0,66.31 ,59.04 ,66.31 
03,021,01,006,0234,0,931,10,941,1312,0,0,0,0,0,0,0,66.31 ,71.72 ,66.31 
03,021,01,006,0235,0,1576,18,1594,2182,0,0,0,0,0,0,0,66.31 ,73.05 ,66.31 
03,021,01,006,0236,0,858,9,867,1115,0,0,0,0,0,0,0,66.31 ,77.76 ,66.31 
03,021,01,006,0237,0,611,7,618,875,0,0,0,0,0,0,0,66.31 ,70.63 ,66.31 
03,021,01,006,0238,0,818,8,826,1091,0,0,0,0,0,0,0,66.31 ,75.71 ,66.31 
03,021,01,006,0239,0,557,7,564,676,0,0,0,0,0,0,0,66.31 ,83.43 ,66.31 
03,021,01,006,0240,0,690,9,699,945,0,0,0,0,0,0,0,66.31 ,73.97 ,66.31 
03,021,01,006,0241,0,726,6,732,990,0,0,0,0,0,0,0,66.31 ,73.94 ,66.31 
03,021,01,006,0242,0,446,6,452,605,0,0,0,0,0,0,0,66.31 ,74.71 ,66.31 
03,021,01,006,0243,0,953,11,964,1368,0,0,0,0,0,0,0,66.31 ,70.47 ,66.31 
03,021,01,006,0244,0,404,8,412,558,0,0,0,0,0,0,0,66.31 ,73.84 ,66.31 
03,021,01,007,0245,0,545,5,550,825,0,0,0,0,0,0,0,66.31 ,66.67 ,66.31 
03,021,01,007,0246,0,530,6,536,857,0,0,0,0,0,0,0,66.31 ,62.54 ,66.31 
03,021,01,007,0247,0,256,1,257,360,0,0,0,0,0,0,0,66.31 ,71.39 ,66.31 
03,021,01,007,0248,0,223,5,228,389,0,0,0,0,0,0,0,66.31 ,58.61 ,66.31 
03,021,01,007,0249,0,1400,7,1407,2103,0,0,0,0,0,0,0,66.31 ,66.90 ,66.31 
03,021,01,007,0250,0,242,1,243,344,0,0,0,0,0,0,0,66.31 ,70.64 ,66.31 
03,021,01,007,0251,0,892,8,900,1386,0,0,0,0,0,0,0,66.31 ,64.94 ,66.31 
03,021,01,007,0252,0,2826,25,2851,4560,0,0,0,0,0,0,0,66.31 ,62.52 ,66.31 
03,021,01,007,0253,0,306,2,308,464,0,0,0,0,0,0,0,66.31 ,66.38 ,66.31 
03,021,01,007,0254,0,356,6,362,486,0,0,0,0,0,0,0,66.31 ,74.49 ,66.31 
03,021,01,007,0255,0,1052,12,1064,1908,0,0,0,0,0,0,0,66.31 ,55.77 ,66.31 
03,021,01,007,0256,0,657,4,661,1375,0,0,0,0,0,0,0,66.31 ,48.07 ,66.31 
03,021,01,007,0257,0,1473,12,1485,2791,0,0,0,0,0,0,0,66.31 ,53.21 ,66.31 
03,021,01,007,0258,0,1414,10,1424,2667,0,0,0,0,0,0,0,66.31 ,53.39 ,66.31 
03,021,01,007,0259,0,1169,11,1180,2065,0,0,0,0,0,0,0,66.31 ,57.14 ,66.31 
03,021,01,007,0260,0,961,3,964,1863,0,0,0,0,0,0,0,66.31 ,51.74 ,66.31 
03,021,01,007,0261,0,1218,6,1224,2662,0,0,0,0,0,0,0,66.31 ,45.98 ,66.31 
03,021,01,007,0262,0,502,5,507,885,0,0,0,0,0,0,0,66.31 ,57.29 ,66.31 
04,001,01,001,0001,0,910,6,916,1553,0,0,0,0,0,0,0,66.31 ,58.98 ,66.31 
04,001,01,001,0002,0,1128,22,1150,1869,0,0,0,0,0,0,0,66.31 ,61.53 ,66.31 
04,001,01,001,0003,0,1714,29,1743,2901,0,0,0,0,0,0,0,66.31 ,60.08 ,66.31 
04,001,01,001,0004,0,755,12,767,1341,0,0,0,0,0,0,0,66.31 ,57.20 ,66.31 
04,001,01,001,0005,0,625,12,637,1062,0,0,0,0,0,0,0,66.31 ,59.98 ,66.31 
04,001,01,001,0006,0,383,5,388,575,0,0,0,0,0,0,0,66.31 ,67.48 ,66.31 
04,001,01,001,0007,0,695,16,711,1133,0,0,0,0,0,0,0,66.31 ,62.75 ,66.31 
04,001,01,001,0008,0,304,7,311,565,0,0,0,0,0,0,0,66.31 ,55.04 ,66.31 
04,001,01,002,0009,0,696,11,707,1069,0,0,0,0,0,0,0,66.31 ,66.14 ,66.31 
04,001,01,002,0010,0,771,12,783,1314,0,0,0,0,0,0,0,66.31 ,59.59 ,66.31 
04,001,01,002,0011,0,606,11,617,1029,0,0,0,0,0,0,0,66.31 ,59.96 ,66.31 
04,001,01,002,0012,0,698,13,711,1293,0,0,0,0,0,0,0,66.31 ,54.99 ,66.31 
04,001,01,002,0013,0,606,7,613,990,0,0,0,0,0,0,0,66.31 ,61.92 ,66.31 
04,001,01,002,0014,0,239,6,245,442,0,0,0,0,0,0,0,66.31 ,55.43 ,66.31 
04,001,01,003,0015,0,1049,13,1062,1590,0,0,0,0,0,0,0,66.31 ,66.79 ,66.31 
04,001,01,003,0016,0,730,11,741,1164,0,0,0,0,0,0,0,66.31 ,63.66 ,66.31 
04,001,01,003,0017,0,301,4,305,514,0,0,0,0,0,0,0,66.31 ,59.34 ,66.31 
04,001,01,003,0018,0,312,4,316,500,0,0,0,0,0,0,0,66.31 ,63.20 ,66.31 
04,001,01,003,0019,0,327,3,330,527,0,0,0,0,0,0,0,66.31 ,62.62 ,66.31 
04,001,01,003,0020,0,802,19,821,1298,0,0,0,0,0,0,0,66.31 ,63.25 ,66.31 
04,001,01,003,0021,0,553,11,564,799,0,0,0,0,0,0,0,66.31 ,70.59 ,66.31 
04,001,01,003,0022,0,653,16,669,1078,0,0,0,0,0,0,0,66.31 ,62.06 ,66.31 
04,001,01,004,0023,0,1034,11,1045,1701,0,0,0,0,0,0,0,66.31 ,61.43 ,66.31 
04,001,01,004,0024,0,449,6,455,675,0,0,0,0,0,0,0,66.31 ,67.41 ,66.31 
04,001,01,004,0025,0,432,7,439,756,0,0,0,0,0,0,0,66.31 ,58.07 ,66.31 
04,001,01,004,0026,0,274,7,281,509,0,0,0,0,0,0,0,66.31 ,55.21 ,66.31 
04,001,01,004,0027,0,321,3,324,629,0,0,0,0,0,0,0,66.31 ,51.51 ,66.31 
04,001,01,004,0028,0,373,6,379,641,0,0,0,0,0,0,0,66.31 ,59.13 ,66.31 
04,001,01,004,0029,0,224,4,228,405,0,0,0,0,0,0,0,66.31 ,56.30 ,66.31 
04,001,01,004,0030,0,381,11,392,671,0,0,0,0,0,0,0,66.31 ,58.42 ,66.31 
04,001,01,005,0031,0,609,10,619,1022,0,0,0,0,0,0,0,66.31 ,60.57 ,66.31 
04,001,01,005,0032,0,243,8,251,445,0,0,0,0,0,0,0,66.31 ,56.40 ,66.31 
04,001,01,005,0033,0,352,7,359,684,0,0,0,0,0,0,0,66.31 ,52.49 ,66.31 
04,001,01,005,0034,0,246,2,248,427,0,0,0,0,0,0,0,66.31 ,58.08 ,66.31 
04,001,01,005,0035,0,491,9,500,869,0,0,0,0,0,0,0,66.31 ,57.54 ,66.31 
04,001,01,006,0036,0,38,0,38,276,0,0,0,0,0,0,0,66.31 ,13.77 ,66.31 
04,002,01,001,0001,0,568,63,631,996,0,0,0,0,0,0,0,66.31 ,63.35 ,66.31 
04,002,01,001,0002,0,477,35,512,790,0,0,0,0,0,0,0,66.31 ,64.81 ,66.31 
04,002,01,001,0003,0,443,52,495,852,0,0,0,0,0,0,0,66.31 ,58.10 ,66.31 
04,002,01,002,0004,0,277,76,353,666,0,0,0,0,0,0,0,66.31 ,53.00 ,66.31 
04,002,01,002,0005,0,122,28,150,263,0,0,0,0,0,0,0,66.31 ,57.03 ,66.31 
04,002,01,003,0006,0,140,19,159,426,0,0,0,0,0,0,0,66.31 ,37.32 ,66.31 
04,002,01,003,0007,0,113,9,122,226,0,0,0,0,0,0,0,66.31 ,53.98 ,66.31 
04,002,01,004,0008,0,303,30,333,515,0,0,0,0,0,0,0,66.31 ,64.66 ,66.31 
01,000,01,001,0001,1,887,16,903,1062,0,0,0,0,0,0,0,66.31 ,85.03 ,66.31 
01,000,01,001,0001,2,1030,17,1047,1279,0,0,0,0,0,0,0,66.31 ,81.86 ,66.31 
01,000,01,001,0001,3,1115,22,1137,1379,0,0,0,0,0,0,0,66.31 ,82.45 ,66.31 
01,000,01,001,0002,4,1237,23,1260,1484,0,0,0,0,0,0,0,66.31 ,84.91 ,66.31 
01,000,01,001,0002,5,1462,22,1484,1786,0,0,0,0,0,0,0,66.31 ,83.09 ,66.31 
01,000,01,001,0003,6,1014,17,1031,1232,0,0,0,0,0,0,0,66.31 ,83.69 ,66.31 
01,000,01,001,0003,7,1230,20,1250,1483,0,0,0,0,0,0,0,66.31 ,84.29 ,66.31 
01,000,01,001,0003,8,1197,15,1212,1477,0,0,0,0,0,0,0,66.31 ,82.06 ,66.31 
01,000,01,001,0004,9,1086,23,1109,1318,0,0,0,0,0,0,0,66.31 ,84.14 ,66.31 
01,000,01,001,0004,10,1030,27,1057,1238,0,0,0,0,0,0,0,66.31 ,85.38 ,66.31 
01,000,01,001,0004,11,902,12,914,1093,0,0,0,0,0,0,0,66.31 ,83.62 ,66.31 
01,000,01,001,0004,12,1067,18,1085,1244,0,0,0,0,0,0,0,66.31 ,87.22 ,66.31 
01,000,01,001,0005,13,1094,23,1117,1349,0,0,0,0,0,0,0,66.31 ,82.80 ,66.31 
01,000,01,001,0005,14,1136,14,1150,1345,0,0,0,0,0,0,0,66.31 ,85.50 ,66.31 
01,000,01,001,0005,15,1183,12,1195,1416,0,0,0,0,0,0,0,66.31 ,84.39 ,66.31 
01,000,01,001,0005,16,969,18,987,1181,0,0,0,0,0,0,0,66.31 ,83.57 ,66.31 
01,000,01,001,0006,17,1035,20,1055,1260,0,0,0,0,0,0,0,66.31 ,83.73 ,66.31 
01,000,01,001,0006,18,1107,11,1118,1431,0,0,0,0,0,0,0,66.31 ,78.13 ,66.31 
01,000,01,001,0006,19,1040,20,1060,1287,0,0,0,0,0,0,0,66.31 ,82.36 ,66.31 
01,000,01,001,0006,20,1154,22,1176,1407,0,0,0,0,0,0,0,66.31 ,83.58 ,66.31 
01,000,01,001,0007,21,1245,25,1270,1546,0,0,0,0,0,0,0,66.31 ,82.15 ,66.31 
01,000,01,001,0007,22,963,20,983,1147,0,0,0,0,0,0,0,66.31 ,85.70 ,66.31 
01,000,01,001,0007,23,999,13,1012,1189,0,0,0,0,0,0,0,66.31 ,85.11 ,66.31 
01,000,01,001,0007,24,934,24,958,1172,0,0,0,0,0,0,0,66.31 ,81.74 ,66.31 
01,000,01,001,0008,25,1171,12,1183,1435,0,0,0,0,0,0,0,66.31 ,82.44 ,66.31 
01,000,01,001,0008,26,1121,23,1144,1357,0,0,0,0,0,0,0,66.31 ,84.30 ,66.31 
01,000,01,001,0008,27,1293,21,1314,1516,0,0,0,0,0,0,0,66.31 ,86.68 ,66.31 
01,000,01,001,0008,28,1381,23,1404,1714,0,0,0,0,0,0,0,66.31 ,81.91 ,66.31 
01,000,01,001,0009,29,1100,27,1127,1351,0,0,0,0,0,0,0,66.31 ,83.42 ,66.31 
01,000,01,001,0009,30,1206,16,1222,1500,0,0,0,0,0,0,0,66.31 ,81.47 ,66.31 
01,000,01,001,0009,31,1178,20,1198,1515,0,0,0,0,0,0,0,66.31 ,79.08 ,66.31 
01,000,01,001,0009,32,995,14,1009,1265,0,0,0,0,0,0,0,66.31 ,79.76 ,66.31 
01,000,01,001,0010,33,1190,19,1209,1509,0,0,0,0,0,0,0,66.31 ,80.12 ,66.31 
01,000,01,001,0010,34,1294,21,1315,1660,0,0,0,0,0,0,0,66.31 ,79.22 ,66.31 
01,000,01,001,0010,35,1260,20,1280,1574,0,0,0,0,0,0,0,66.31 ,81.32 ,66.31 
01,000,01,001,0011,36,1210,21,1231,1478,0,0,0,0,0,0,0,66.31 ,83.29 ,66.31 
01,000,01,001,0011,37,1530,28,1558,1852,0,0,0,0,0,0,0,66.31 ,84.13 ,66.31 
01,000,01,001,0012,38,968,22,990,1149,0,0,0,0,0,0,0,66.31 ,86.16 ,66.31 
01,000,01,001,0012,39,1108,15,1123,1272,0,0,0,0,0,0,0,66.31 ,88.29 ,66.31 
01,000,01,001,0012,40,967,19,986,1226,0,0,0,0,0,0,0,66.31 ,80.42 ,66.31 
01,000,01,001,0013,41,1033,23,1056,1274,0,0,0,0,0,0,0,66.31 ,82.89 ,66.31 
01,000,01,001,0013,42,952,13,965,1182,0,0,0,0,0,0,0,66.31 ,81.64 ,66.31 
01,000,01,001,0013,43,810,17,827,997,0,0,0,0,0,0,0,66.31 ,82.95 ,66.31 
01,000,01,001,0013,44,968,20,988,1131,0,0,0,0,0,0,0,66.31 ,87.36 ,66.31 
01,000,01,001,0014,45,1004,9,1013,1206,0,0,0,0,0,0,0,66.31 ,84.00 ,66.31 
01,000,01,001,0014,46,1215,21,1236,1471,0,0,0,0,0,0,0,66.31 ,84.02 ,66.31 
01,000,01,001,0014,47,959,14,973,1146,0,0,0,0,0,0,0,66.31 ,84.90 ,66.31 
01,000,01,001,0015,48,912,17,929,1118,0,0,0,0,0,0,0,66.31 ,83.09 ,66.31 
01,000,01,001,0015,49,1008,7,1015,1217,0,0,0,0,0,0,0,66.31 ,83.40 ,66.31 
01,000,01,001,0015,50,1086,27,1113,1322,0,0,0,0,0,0,0,66.31 ,84.19 ,66.31 
01,000,01,001,0016,51,1069,24,1093,1298,0,0,0,0,0,0,0,66.31 ,84.21 ,66.31 
01,000,01,001,0016,52,1004,18,1022,1210,0,0,0,0,0,0,0,66.31 ,84.46 ,66.31 
01,000,01,001,0016,53,1117,18,1135,1370,0,0,0,0,0,0,0,66.31 ,82.85 ,66.31 
01,000,01,001,0017,54,1244,19,1263,1481,0,0,0,0,0,0,0,66.31 ,85.28 ,66.31 
01,000,01,001,0017,55,1388,17,1405,1640,0,0,0,0,0,0,0,66.31 ,85.67 ,66.31 
01,000,01,001,0017,56,1214,20,1234,1457,0,0,0,0,0,0,0,66.31 ,84.69 ,66.31 
01,000,01,001,0017,57,1281,26,1307,1528,0,0,0,0,0,0,0,66.31 ,85.54 ,66.31 
01,000,01,001,0018,58,898,21,919,1095,0,0,0,0,0,0,0,66.31 ,83.93 ,66.31 
01,000,01,001,0018,59,911,17,928,1116,0,0,0,0,0,0,0,66.31 ,83.15 ,66.31 
01,000,01,001,0018,60,959,24,983,1187,0,0,0,0,0,0,0,66.31 ,82.81 ,66.31 
01,000,01,001,0019,61,1083,25,1108,1271,0,0,0,0,0,0,0,66.31 ,87.18 ,66.31 
01,000,01,001,0020,62,1145,24,1169,1392,0,0,0,0,0,0,0,66.31 ,83.98 ,66.31 
01,000,01,001,0020,63,1084,24,1108,1312,0,0,0,0,0,0,0,66.31 ,84.45 ,66.31 
01,000,01,001,0020,64,1099,14,1113,1306,0,0,0,0,0,0,0,66.31 ,85.22 ,66.31 
01,000,01,001,0020,65,1112,25,1137,1363,0,0,0,0,0,0,0,66.31 ,83.42 ,66.31 
01,000,01,001,0020,66,1195,13,1208,1510,0,0,0,0,0,0,0,66.31 ,80.00 ,66.31 
01,000,01,001,0021,67,1137,21,1158,1329,0,0,0,0,0,0,0,66.31 ,87.13 ,66.31 
01,000,01,001,0021,68,1327,41,1368,1616,0,0,0,0,0,0,0,66.31 ,84.65 ,66.31 
01,000,01,001,0021,69,1293,18,1311,1543,0,0,0,0,0,0,0,66.31 ,84.96 ,66.31 
01,000,01,001,0021,70,1171,37,1208,1499,0,0,0,0,0,0,0,66.31 ,80.59 ,66.31 
01,000,01,001,0022,71,973,14,987,1173,0,0,0,0,0,0,0,66.31 ,84.14 ,66.31 
01,000,01,001,0022,72,1280,9,1289,1555,0,0,0,0,0,0,0,66.31 ,82.89 ,66.31 
01,000,01,001,0022,73,1303,21,1324,1578,0,0,0,0,0,0,0,66.31 ,83.90 ,66.31 
01,000,01,001,0022,74,1114,35,1149,1364,0,0,0,0,0,0,0,66.31 ,84.24 ,66.31 
01,000,01,001,0023,75,1169,20,1189,1408,0,0,0,0,0,0,0,66.31 ,84.45 ,66.31 
01,000,01,001,0023,76,1156,28,1184,1424,0,0,0,0,0,0,0,66.31 ,83.15 ,66.31 
01,000,01,001,0023,77,1129,19,1148,1434,0,0,0,0,0,0,0,66.31 ,80.06 ,66.31 
01,000,01,001,0024,78,1161,24,1185,1363,0,0,0,0,0,0,0,66.31 ,86.94 ,66.31 
01,000,01,001,0024,79,1287,18,1305,1539,0,0,0,0,0,0,0,66.31 ,84.80 ,66.31 
01,000,01,001,0024,80,1079,17,1096,1352,0,0,0,0,0,0,0,66.31 ,81.07 ,66.31 
01,000,01,001,0025,81,1017,19,1036,1216,0,0,0,0,0,0,0,66.31 ,85.20 ,66.31 
01,000,01,001,0025,82,953,18,971,1191,0,0,0,0,0,0,0,66.31 ,81.53 ,66.31 
01,000,01,001,0025,83,1010,18,1028,1241,0,0,0,0,0,0,0,66.31 ,82.84 ,66.31 
01,000,01,001,0025,84,905,14,919,1134,0,0,0,0,0,0,0,66.31 ,81.04 ,66.31 
01,000,01,001,0026,85,987,16,1003,1272,0,0,0,0,0,0,0,66.31 ,78.85 ,66.31 
01,000,01,001,0026,86,1071,25,1096,1409,0,0,0,0,0,0,0,66.31 ,77.79 ,66.31 
01,000,01,001,0027,87,1162,14,1176,1474,0,0,0,0,0,0,0,66.31 ,79.78 ,66.31 
01,000,01,001,0027,88,1149,19,1168,1515,0,0,0,0,0,0,0,66.31 ,77.10 ,66.31 
01,000,01,001,0027,89,969,13,982,1213,0,0,0,0,0,0,0,66.31 ,80.96 ,66.31 
01,000,01,001,0028,90,931,7,938,1104,0,0,0,0,0,0,0,66.31 ,84.96 ,66.31 
01,000,01,001,0028,91,791,19,810,939,0,0,0,0,0,0,0,66.31 ,86.26 ,66.31 
01,000,01,001,0028,92,1056,16,1072,1250,0,0,0,0,0,0,0,66.31 ,85.76 ,66.31 
01,000,01,001,0029,93,1104,21,1125,1389,0,0,0,0,0,0,0,66.31 ,80.99 ,66.31 
01,000,01,001,0029,94,1050,18,1068,1281,0,0,0,0,0,0,0,66.31 ,83.37 ,66.31 
01,000,01,001,0029,95,994,23,1017,1306,0,0,0,0,0,0,0,66.31 ,77.87 ,66.31 
01,000,01,001,0029,96,890,17,907,1099,0,0,0,0,0,0,0,66.31 ,82.53 ,66.31 
01,000,01,001,0030,97,1051,14,1065,1283,0,0,0,0,0,0,0,66.31 ,83.01 ,66.31 
01,000,01,001,0030,98,934,29,963,1148,0,0,0,0,0,0,0,66.31 ,83.89 ,66.31 
01,000,01,001,0030,99,956,16,972,1194,0,0,0,0,0,0,0,66.31 ,81.41 ,66.31 
01,000,01,001,0030,100,593,9,602,756,0,0,0,0,0,0,0,66.31 ,79.63 ,66.31 
01,000,01,001,0031,101,1258,19,1277,1539,0,0,0,0,0,0,0,66.31 ,82.98 ,66.31 
01,000,01,001,0031,102,1216,14,1230,1513,0,0,0,0,0,0,0,66.31 ,81.30 ,66.31 
01,000,01,001,0031,103,1336,23,1359,1673,0,0,0,0,0,0,0,66.31 ,81.23 ,66.31 
01,000,01,001,0032,104,1185,19,1204,1474,0,0,0,0,0,0,0,66.31 ,81.68 ,66.31 
01,000,01,001,0032,105,1128,34,1162,1463,0,0,0,0,0,0,0,66.31 ,79.43 ,66.31 
01,000,01,001,0033,106,1340,13,1353,1632,0,0,0,0,0,0,0,66.31 ,82.90 ,66.31 
01,000,01,001,0033,107,1271,23,1294,1531,0,0,0,0,0,0,0,66.31 ,84.52 ,66.31 
01,000,01,001,0034,108,831,7,838,984,0,0,0,0,0,0,0,66.31 ,85.16 ,66.31 
01,000,01,001,0034,109,908,18,926,1068,0,0,0,0,0,0,0,66.31 ,86.70 ,66.31 
01,000,01,001,0034,110,961,12,973,1172,0,0,0,0,0,0,0,66.31 ,83.02 ,66.31 
01,000,01,001,0035,111,814,14,828,1027,0,0,0,0,0,0,0,66.31 ,80.62 ,66.31 
01,000,01,001,0035,112,1046,18,1064,1260,0,0,0,0,0,0,0,66.31 ,84.44 ,66.31 
01,000,01,001,0035,113,989,17,1006,1297,0,0,0,0,0,0,0,66.31 ,77.56 ,66.31 
01,000,01,001,0036,114,1283,21,1304,1539,0,0,0,0,0,0,0,66.31 ,84.73 ,66.31 
01,000,01,001,0036,115,1026,18,1044,1271,0,0,0,0,0,0,0,66.31 ,82.14 ,66.31 
01,000,01,001,0036,116,950,11,961,1143,0,0,0,0,0,0,0,66.31 ,84.08 ,66.31 
01,000,01,001,0037,117,1357,36,1393,1630,0,0,0,0,0,0,0,66.31 ,85.46 ,66.31 
01,000,01,001,0037,118,1316,29,1345,1622,0,0,0,0,0,0,0,66.31 ,82.92 ,66.31 
01,000,01,001,0037,119,1129,30,1159,1353,0,0,0,0,0,0,0,66.31 ,85.66 ,66.31 
01,000,01,001,0038,120,1196,28,1224,1445,0,0,0,0,0,0,0,66.31 ,84.71 ,66.31 
01,000,01,001,0038,121,1059,100,1159,1388,0,0,0,0,0,0,0,66.31 ,83.50 ,66.31 
01,000,01,001,0038,122,1188,36,1224,1462,0,0,0,0,0,0,0,66.31 ,83.72 ,66.31 
01,000,01,001,0038,123,1380,16,1396,1620,0,0,0,0,0,0,0,66.31 ,86.17 ,66.31 
01,000,01,001,0038,124,1204,31,1235,1448,0,0,0,0,0,0,0,66.31 ,85.29 ,66.31 
01,000,01,001,0039,125,281,6,287,365,0,0,0,0,0,0,0,66.31 ,78.63 ,66.31 
01,000,01,001,0039,126,1254,30,1284,1505,0,0,0,0,0,0,0,66.31 ,85.32 ,66.31 
01,000,01,001,0040,127,575,11,586,715,0,0,0,0,0,0,0,66.31 ,81.96 ,66.31 
01,000,01,001,0040,128,714,8,722,908,0,0,0,0,0,0,0,66.31 ,79.52 ,66.31 
01,000,01,001,0040,129,580,19,599,720,0,0,0,0,0,0,0,66.31 ,83.19 ,66.31 
01,000,01,002,0041,130,1021,18,1039,1252,0,0,0,0,0,0,0,66.31 ,82.99 ,66.31 
01,000,01,002,0041,131,1061,26,1087,1267,0,0,0,0,0,0,0,66.31 ,85.79 ,66.31 
01,000,01,002,0041,132,922,20,942,1146,0,0,0,0,0,0,0,66.31 ,82.20 ,66.31 
01,000,01,002,0042,133,1008,20,1028,1231,0,0,0,0,0,0,0,66.31 ,83.51 ,66.31 
01,000,01,002,0042,134,906,21,927,1096,0,0,0,0,0,0,0,66.31 ,84.58 ,66.31 
01,000,01,002,0043,135,910,17,927,1196,0,0,0,0,0,0,0,66.31 ,77.51 ,66.31 
01,000,01,002,0043,136,617,13,630,789,0,0,0,0,0,0,0,66.31 ,79.85 ,66.31 
01,000,01,002,0043,137,1190,10,1200,1427,0,0,0,0,0,0,0,66.31 ,84.09 ,66.31 
01,000,01,002,0044,138,896,6,902,1117,0,0,0,0,0,0,0,66.31 ,80.75 ,66.31 
01,000,01,002,0044,139,786,11,797,966,0,0,0,0,0,0,0,66.31 ,82.51 ,66.31 
01,000,01,002,0044,140,944,14,958,1172,0,0,0,0,0,0,0,66.31 ,81.74 ,66.31 
01,000,01,002,0045,141,975,17,992,1235,0,0,0,0,0,0,0,66.31 ,80.32 ,66.31 
01,000,01,002,0045,142,989,15,1004,1230,0,0,0,0,0,0,0,66.31 ,81.63 ,66.31 
01,000,01,002,0045,143,941,13,954,1175,0,0,0,0,0,0,0,66.31 ,81.19 ,66.31 
01,000,01,002,0045,144,994,18,1012,1240,0,0,0,0,0,0,0,66.31 ,81.61 ,66.31 
01,000,01,002,0045,145,1038,8,1046,1274,0,0,0,0,0,0,0,66.31 ,82.10 ,66.31 
01,000,01,002,0046,146,1159,20,1179,1397,0,0,0,0,0,0,0,66.31 ,84.40 ,66.31 
01,000,01,002,0046,147,918,13,931,1167,0,0,0,0,0,0,0,66.31 ,79.78 ,66.31 
01,000,01,002,0046,148,1225,21,1246,1492,0,0,0,0,0,0,0,66.31 ,83.51 ,66.31 
01,000,01,002,0046,149,1030,17,1047,1278,0,0,0,0,0,0,0,66.31 ,81.92 ,66.31 
01,000,01,002,0047,150,1034,16,1050,1309,0,0,0,0,0,0,0,66.31 ,80.21 ,66.31 
01,000,01,002,0047,151,1200,18,1218,1444,0,0,0,0,0,0,0,66.31 ,84.35 ,66.31 
01,000,01,002,0047,152,1134,22,1156,1418,0,0,0,0,0,0,0,66.31 ,81.52 ,66.31 
01,000,01,002,0047,153,1273,21,1294,1535,0,0,0,0,0,0,0,66.31 ,84.30 ,66.31 
01,000,01,002,0048,154,1173,36,1209,1409,0,0,0,0,0,0,0,66.31 ,85.81 ,66.31 
01,000,01,002,0048,155,1046,17,1063,1316,0,0,0,0,0,0,0,66.31 ,80.78 ,66.31 
01,000,01,002,0048,156,972,25,997,1201,0,0,0,0,0,0,0,66.31 ,83.01 ,66.31 
01,000,01,002,0048,157,942,18,960,1153,0,0,0,0,0,0,0,66.31 ,83.26 ,66.31 
01,000,01,002,0048,158,901,14,915,1126,0,0,0,0,0,0,0,66.31 ,81.26 ,66.31 
01,000,01,002,0049,159,1081,23,1104,1318,0,0,0,0,0,0,0,66.31 ,83.76 ,66.31 
01,000,01,002,0049,160,1199,12,1211,1406,0,0,0,0,0,0,0,66.31 ,86.13 ,66.31 
01,000,01,002,0049,161,1193,30,1223,1430,0,0,0,0,0,0,0,66.31 ,85.52 ,66.31 
01,000,01,002,0050,162,844,26,870,1053,0,0,0,0,0,0,0,66.31 ,82.62 ,66.31 
01,000,01,002,0050,163,883,7,890,1043,0,0,0,0,0,0,0,66.31 ,85.33 ,66.31 
01,000,01,002,0050,164,943,14,957,1099,0,0,0,0,0,0,0,66.31 ,87.08 ,66.31 
01,000,01,002,0051,165,1019,20,1039,1272,0,0,0,0,0,0,0,66.31 ,81.68 ,66.31 
01,000,01,002,0051,166,1141,13,1154,1365,0,0,0,0,0,0,0,66.31 ,84.54 ,66.31 
01,000,01,002,0051,167,1231,32,1263,1468,0,0,0,0,0,0,0,66.31 ,86.04 ,66.31 
01,000,01,002,0051,168,1197,30,1227,1471,0,0,0,0,0,0,0,66.31 ,83.41 ,66.31 
01,000,01,002,0052,169,1095,16,1111,1349,0,0,0,0,0,0,0,66.31 ,82.36 ,66.31 
01,000,01,002,0052,170,1095,31,1126,1357,0,0,0,0,0,0,0,66.31 ,82.98 ,66.31 
01,000,01,002,0052,171,987,24,1011,1236,0,0,0,0,0,0,0,66.31 ,81.80 ,66.31 
01,000,01,002,0053,172,1170,27,1197,1513,0,0,0,0,0,0,0,66.31 ,79.11 ,66.31 
01,000,01,002,0053,173,1043,30,1073,1331,0,0,0,0,0,0,0,66.31 ,80.62 ,66.31 
01,000,01,002,0053,174,1080,26,1106,1356,0,0,0,0,0,0,0,66.31 ,81.56 ,66.31 
01,000,01,002,0053,175,1039,17,1056,1262,0,0,0,0,0,0,0,66.31 ,83.68 ,66.31 
01,000,01,002,0054,176,1081,21,1102,1372,0,0,0,0,0,0,0,66.31 ,80.32 ,66.31 
01,000,01,002,0054,177,938,21,959,1187,0,0,0,0,0,0,0,66.31 ,80.79 ,66.31 
01,000,01,002,0054,178,1117,25,1142,1440,0,0,0,0,0,0,0,66.31 ,79.31 ,66.31 
01,000,01,002,0055,179,1129,30,1159,1428,0,0,0,0,0,0,0,66.31 ,81.16 ,66.31 
01,000,01,002,0055,180,1172,28,1200,1462,0,0,0,0,0,0,0,66.31 ,82.08 ,66.31 
01,000,01,002,0055,181,1234,18,1252,1476,0,0,0,0,0,0,0,66.31 ,84.82 ,66.31 
01,000,01,002,0056,182,953,22,975,1154,0,0,0,0,0,0,0,66.31 ,84.49 ,66.31 
01,000,01,002,0056,183,898,27,925,1099,0,0,0,0,0,0,0,66.31 ,84.17 ,66.31 
01,000,01,002,0056,184,915,16,931,1090,0,0,0,0,0,0,0,66.31 ,85.41 ,66.31 
01,000,01,002,0056,185,1040,28,1068,1281,0,0,0,0,0,0,0,66.31 ,83.37 ,66.31 
01,000,01,002,0057,186,883,21,904,1068,0,0,0,0,0,0,0,66.31 ,84.64 ,66.31 
01,000,01,002,0057,187,816,26,842,1015,0,0,0,0,0,0,0,66.31 ,82.96 ,66.31 
01,000,01,002,0057,188,742,12,754,888,0,0,0,0,0,0,0,66.31 ,84.91 ,66.31 
01,000,01,002,0058,189,1283,30,1313,1556,0,0,0,0,0,0,0,66.31 ,84.38 ,66.31 
01,000,01,002,0058,190,1077,27,1104,1323,0,0,0,0,0,0,0,66.31 ,83.45 ,66.31 
01,000,01,002,0058,191,1159,19,1178,1391,0,0,0,0,0,0,0,66.31 ,84.69 ,66.31 
01,000,01,002,0058,192,1171,13,1184,1381,0,0,0,0,0,0,0,66.31 ,85.73 ,66.31 
01,000,01,002,0059,193,1147,24,1171,1369,0,0,0,0,0,0,0,66.31 ,85.54 ,66.31 
01,000,01,002,0059,194,1140,31,1171,1345,0,0,0,0,0,0,0,66.31 ,87.06 ,66.31 
01,000,01,002,0059,195,1077,23,1100,1297,0,0,0,0,0,0,0,66.31 ,84.81 ,66.31 
01,000,01,002,0059,196,910,19,929,1125,0,0,0,0,0,0,0,66.31 ,82.58 ,66.31 
01,000,01,002,0059,197,945,21,966,1151,0,0,0,0,0,0,0,66.31 ,83.93 ,66.31 
01,000,01,002,0060,198,981,28,1009,1169,0,0,0,0,0,0,0,66.31 ,86.31 ,66.31 
01,000,01,002,0060,199,991,26,1017,1203,0,0,0,0,0,0,0,66.31 ,84.54 ,66.31 
01,000,01,002,0060,200,1078,23,1101,1290,0,0,0,0,0,0,0,66.31 ,85.35 ,66.31 
01,000,01,002,0060,201,1046,31,1077,1262,0,0,0,0,0,0,0,66.31 ,85.34 ,66.31 
01,000,01,002,0061,202,1014,22,1036,1220,0,0,0,0,0,0,0,66.31 ,84.92 ,66.31 
01,000,01,002,0061,203,1030,31,1061,1253,0,0,0,0,0,0,0,66.31 ,84.68 ,66.31 
01,000,01,002,0061,204,1139,21,1160,1363,0,0,0,0,0,0,0,66.31 ,85.11 ,66.31 
01,000,01,002,0061,205,1079,22,1101,1292,0,0,0,0,0,0,0,66.31 ,85.22 ,66.31 
01,000,01,002,0062,206,1085,36,1121,1257,0,0,0,0,0,0,0,66.31 ,89.18 ,66.31 
01,000,01,002,0062,207,1078,24,1102,1275,0,0,0,0,0,0,0,66.31 ,86.43 ,66.31 
01,000,01,002,0062,208,1047,35,1082,1263,0,0,0,0,0,0,0,66.31 ,85.67 ,66.31 
01,000,01,002,0063,209,1164,26,1190,1440,0,0,0,0,0,0,0,66.31 ,82.64 ,66.31 
01,000,01,002,0063,210,1164,20,1184,1401,0,0,0,0,0,0,0,66.31 ,84.51 ,66.31 
01,000,01,002,0063,211,1111,23,1134,1358,0,0,0,0,0,0,0,66.31 ,83.51 ,66.31 
01,000,01,002,0063,212,1201,25,1226,1468,0,0,0,0,0,0,0,66.31 ,83.51 ,66.31 
01,000,01,002,0064,213,1060,30,1090,1261,0,0,0,0,0,0,0,66.31 ,86.44 ,66.31 
01,000,01,002,0064,214,1120,37,1157,1378,0,0,0,0,0,0,0,66.31 ,83.96 ,66.31 
01,000,01,002,0064,215,1336,32,1368,1577,0,0,0,0,0,0,0,66.31 ,86.75 ,66.31 
01,000,01,002,0065,216,805,23,828,1119,0,0,0,0,0,0,0,66.31 ,73.99 ,66.31 
01,000,01,002,0065,217,960,15,975,1228,0,0,0,0,0,0,0,66.31 ,79.40 ,66.31 
01,000,01,002,0065,218,930,13,943,1141,0,0,0,0,0,0,0,66.31 ,82.65 ,66.31 
01,000,01,002,0066,219,973,6,979,1171,0,0,0,0,0,0,0,66.31 ,83.60 ,66.31 
01,000,01,002,0066,220,962,17,979,1202,0,0,0,0,0,0,0,66.31 ,81.45 ,66.31 
01,000,01,002,0066,221,1061,20,1081,1319,0,0,0,0,0,0,0,66.31 ,81.96 ,66.31 
01,000,01,002,0066,222,980,18,998,1247,0,0,0,0,0,0,0,66.31 ,80.03 ,66.31 
01,000,01,002,0067,223,951,14,965,1184,0,0,0,0,0,0,0,66.31 ,81.50 ,66.31 
01,000,01,002,0067,224,835,21,856,1051,0,0,0,0,0,0,0,66.31 ,81.45 ,66.31 
01,000,01,002,0067,225,839,13,852,1021,0,0,0,0,0,0,0,66.31 ,83.45 ,66.31 
01,000,01,002,0068,226,1266,16,1282,1498,0,0,0,0,0,0,0,66.31 ,85.58 ,66.31 
01,000,01,002,0068,227,1023,13,1036,1302,0,0,0,0,0,0,0,66.31 ,79.57 ,66.31 
01,000,01,002,0068,228,1211,18,1229,1545,0,0,0,0,0,0,0,66.31 ,79.55 ,66.31 
01,000,01,002,0069,229,968,12,980,1187,0,0,0,0,0,0,0,66.31 ,82.56 ,66.31 
01,000,01,002,0069,230,1036,12,1048,1288,0,0,0,0,0,0,0,66.31 ,81.37 ,66.31 
01,000,01,002,0069,231,1140,15,1155,1388,0,0,0,0,0,0,0,66.31 ,83.21 ,66.31 
01,000,01,002,0070,232,1154,19,1173,1391,0,0,0,0,0,0,0,66.31 ,84.33 ,66.31 
01,000,01,002,0070,233,1299,20,1319,1515,0,0,0,0,0,0,0,66.31 ,87.06 ,66.31 
01,000,01,002,0070,234,1179,14,1193,1496,0,0,0,0,0,0,0,66.31 ,79.75 ,66.31 
01,000,01,002,0071,235,939,20,959,1224,0,0,0,0,0,0,0,66.31 ,78.35 ,66.31 
01,000,01,002,0071,236,1201,23,1224,1449,0,0,0,0,0,0,0,66.31 ,84.47 ,66.31 
01,000,01,002,0071,237,932,8,940,1182,0,0,0,0,0,0,0,66.31 ,79.53 ,66.31 
01,000,01,002,0071,238,1072,17,1089,1328,0,0,0,0,0,0,0,66.31 ,82.00 ,66.31 
01,000,01,002,0072,239,1029,17,1046,1251,0,0,0,0,0,0,0,66.31 ,83.61 ,66.31 
01,000,01,002,0072,240,1065,20,1085,1295,0,0,0,0,0,0,0,66.31 ,83.78 ,66.31 
01,000,01,002,0072,241,1045,17,1062,1294,0,0,0,0,0,0,0,66.31 ,82.07 ,66.31 
01,000,01,002,0073,242,1145,16,1161,1405,0,0,0,0,0,0,0,66.31 ,82.63 ,66.31 
01,000,01,002,0073,243,1211,16,1227,1476,0,0,0,0,0,0,0,66.31 ,83.13 ,66.31 
01,000,01,002,0073,244,1100,18,1118,1362,0,0,0,0,0,0,0,66.31 ,82.09 ,66.31 
01,000,01,002,0074,245,977,18,995,1208,0,0,0,0,0,0,0,66.31 ,82.37 ,66.31 
01,000,01,002,0074,246,1032,17,1049,1270,0,0,0,0,0,0,0,66.31 ,82.60 ,66.31 
01,000,01,002,0074,247,1138,21,1159,1412,0,0,0,0,0,0,0,66.31 ,82.08 ,66.31 
01,000,01,002,0074,248,1096,20,1116,1369,0,0,0,0,0,0,0,66.31 ,81.52 ,66.31 
01,000,01,002,0074,249,1024,19,1043,1252,0,0,0,0,0,0,0,66.31 ,83.31 ,66.31 
01,000,01,002,0075,250,960,12,972,1179,0,0,0,0,0,0,0,66.31 ,82.44 ,66.31 
01,000,01,002,0075,251,888,14,902,1142,0,0,0,0,0,0,0,66.31 ,78.98 ,66.31 
01,000,01,002,0075,252,896,13,909,1103,0,0,0,0,0,0,0,66.31 ,82.41 ,66.31 
01,000,01,002,0075,253,940,6,946,1163,0,0,0,0,0,0,0,66.31 ,81.34 ,66.31 
01,000,01,002,0076,254,991,15,1006,1177,0,0,0,0,0,0,0,66.31 ,85.47 ,66.31 
01,000,01,002,0076,255,931,20,951,1154,0,0,0,0,0,0,0,66.31 ,82.41 ,66.31 
01,000,01,002,0076,256,1014,13,1027,1226,0,0,0,0,0,0,0,66.31 ,83.77 ,66.31 
01,000,01,002,0076,257,1054,14,1068,1367,0,0,0,0,0,0,0,66.31 ,78.13 ,66.31 
01,000,01,002,0077,258,933,19,952,1187,0,0,0,0,0,0,0,66.31 ,80.20 ,66.31 
01,000,01,002,0077,259,1091,9,1100,1338,0,0,0,0,0,0,0,66.31 ,82.21 ,66.31 
01,000,01,002,0077,260,1124,10,1134,1392,0,0,0,0,0,0,0,66.31 ,81.47 ,66.31 
01,000,01,002,0078,261,885,16,901,1151,0,0,0,0,0,0,0,66.31 ,78.28 ,66.31 
01,000,01,002,0078,262,908,8,916,1184,0,0,0,0,0,0,0,66.31 ,77.36 ,66.31 
01,000,01,002,0078,263,951,13,964,1224,0,0,0,0,0,0,0,66.31 ,78.76 ,66.31 
01,000,01,002,0079,264,1160,13,1173,1434,0,0,0,0,0,0,0,66.31 ,81.80 ,66.31 
01,000,01,002,0079,265,1126,16,1142,1397,0,0,0,0,0,0,0,66.31 ,81.75 ,66.31 
01,000,01,002,0079,266,1135,22,1157,1473,0,0,0,0,0,0,0,66.31 ,78.55 ,66.31 
01,000,01,002,0079,267,1048,20,1068,1324,0,0,0,0,0,0,0,66.31 ,80.66 ,66.31 
01,000,01,002,0080,268,999,10,1009,1298,0,0,0,0,0,0,0,66.31 ,77.73 ,66.31 
01,000,01,002,0080,269,1082,16,1098,1363,0,0,0,0,0,0,0,66.31 ,80.56 ,66.31 
01,000,01,002,0080,270,946,13,959,1202,0,0,0,0,0,0,0,66.31 ,79.78 ,66.31 
01,000,01,002,0080,271,1084,9,1093,1406,0,0,0,0,0,0,0,66.31 ,77.74 ,66.31 
01,000,01,002,0081,272,946,3,949,1237,0,0,0,0,0,0,0,66.31 ,76.72 ,66.31 
01,000,01,002,0081,273,954,4,958,1172,0,0,0,0,0,0,0,66.31 ,81.74 ,66.31 
01,000,01,002,0081,274,1023,14,1037,1263,0,0,0,0,0,0,0,66.31 ,82.11 ,66.31 
01,000,01,002,0081,275,1055,15,1070,1366,0,0,0,0,0,0,0,66.31 ,78.33 ,66.31 
01,000,01,002,0081,276,962,10,972,1232,0,0,0,0,0,0,0,66.31 ,78.90 ,66.31 
01,000,01,002,0082,277,1007,12,1019,1334,0,0,0,0,0,0,0,66.31 ,76.39 ,66.31 
01,000,01,002,0082,278,947,14,961,1200,0,0,0,0,0,0,0,66.31 ,80.08 ,66.31 
01,000,01,002,0082,279,1019,19,1038,1288,0,0,0,0,0,0,0,66.31 ,80.59 ,66.31 
01,000,01,002,0082,280,894,14,908,1158,0,0,0,0,0,0,0,66.31 ,78.41 ,66.31 
01,000,01,002,0083,281,850,21,871,1084,0,0,0,0,0,0,0,66.31 ,80.35 ,66.31 
01,000,01,002,0084,282,913,15,928,1127,0,0,0,0,0,0,0,66.31 ,82.34 ,66.31 
01,000,01,002,0085,283,601,13,614,786,0,0,0,0,0,0,0,66.31 ,78.12 ,66.31 
01,000,01,002,0085,284,717,13,730,921,0,0,0,0,0,0,0,66.31 ,79.26 ,66.31 
01,000,01,002,0086,285,707,9,716,903,0,0,0,0,0,0,0,66.31 ,79.29 ,66.31 
01,000,01,002,0086,286,642,12,654,939,0,0,0,0,0,0,0,66.31 ,69.65 ,66.31 
01,000,01,002,0086,287,635,11,646,822,0,0,0,0,0,0,0,66.31 ,78.59 ,66.31 
01,000,01,002,0087,288,1058,29,1087,1307,0,0,0,0,0,0,0,66.31 ,83.17 ,66.31 
01,000,01,002,0088,289,980,12,992,1166,0,0,0,0,0,0,0,66.31 ,85.08 ,66.31 
01,000,01,002,0089,290,962,28,990,1176,0,0,0,0,0,0,0,66.31 ,84.18 ,66.31 
01,000,01,002,0090,291,1050,24,1074,1353,0,0,0,0,0,0,0,66.31 ,79.38 ,66.31 
01,000,01,002,0090,292,1012,16,1028,1352,0,0,0,0,0,0,0,66.31 ,76.04 ,66.31 
01,000,01,002,0090,293,725,19,744,953,0,0,0,0,0,0,0,66.31 ,78.07 ,66.31 
01,000,01,002,0090,294,1012,35,1047,1365,0,0,0,0,0,0,0,66.31 ,76.70 ,66.31 
01,000,01,003,0091,295,974,26,1000,1187,0,0,0,0,0,0,0,66.31 ,84.25 ,66.31 
01,000,01,003,0091,296,1080,21,1101,1291,0,0,0,0,0,0,0,66.31 ,85.28 ,66.31 
01,000,01,003,0091,297,987,9,996,1176,0,0,0,0,0,0,0,66.31 ,84.69 ,66.31 
01,000,01,003,0091,298,1009,16,1025,1228,0,0,0,0,0,0,0,66.31 ,83.47 ,66.31 
01,000,01,003,0091,299,946,17,963,1167,0,0,0,0,0,0,0,66.31 ,82.52 ,66.31 
01,000,01,003,0092,300,875,31,906,1102,0,0,0,0,0,0,0,66.31 ,82.21 ,66.31 
01,000,01,003,0092,301,942,14,956,1135,0,0,0,0,0,0,0,66.31 ,84.23 ,66.31 
01,000,01,003,0092,302,1059,14,1073,1270,0,0,0,0,0,0,0,66.31 ,84.49 ,66.31 
01,000,01,003,0092,303,850,13,863,1040,0,0,0,0,0,0,0,66.31 ,82.98 ,66.31 
01,000,01,003,0092,304,965,27,992,1172,0,0,0,0,0,0,0,66.31 ,84.64 ,66.31 
01,000,01,003,0093,305,989,19,1008,1184,0,0,0,0,0,0,0,66.31 ,85.14 ,66.31 
01,000,01,003,0093,306,974,10,984,1193,0,0,0,0,0,0,0,66.31 ,82.48 ,66.31 
01,000,01,003,0093,307,846,15,861,1023,0,0,0,0,0,0,0,66.31 ,84.16 ,66.31 
01,000,01,003,0093,308,957,23,980,1187,0,0,0,0,0,0,0,66.31 ,82.56 ,66.31 
01,000,01,003,0094,309,1103,16,1119,1306,0,0,0,0,0,0,0,66.31 ,85.68 ,66.31 
01,000,01,003,0094,310,1134,27,1161,1393,0,0,0,0,0,0,0,66.31 ,83.35 ,66.31 
01,000,01,003,0094,311,1021,15,1036,1242,0,0,0,0,0,0,0,66.31 ,83.41 ,66.31 
01,000,01,003,0095,312,1074,15,1089,1282,0,0,0,0,0,0,0,66.31 ,84.95 ,66.31 
01,000,01,003,0095,313,1058,13,1071,1298,0,0,0,0,0,0,0,66.31 ,82.51 ,66.31 
01,000,01,003,0095,314,1219,14,1233,1452,0,0,0,0,0,0,0,66.31 ,84.92 ,66.31 
01,000,01,003,0095,315,1168,27,1195,1416,0,0,0,0,0,0,0,66.31 ,84.39 ,66.31 
01,000,01,003,0095,316,1046,28,1074,1302,0,0,0,0,0,0,0,66.31 ,82.49 ,66.31 
01,000,01,003,0095,317,980,8,988,1181,0,0,0,0,0,0,0,66.31 ,83.66 ,66.31 
01,000,01,003,0096,318,1186,15,1201,1435,0,0,0,0,0,0,0,66.31 ,83.69 ,66.31 
01,000,01,003,0096,319,1174,20,1194,1433,0,0,0,0,0,0,0,66.31 ,83.32 ,66.31 
01,000,01,003,0096,320,1057,13,1070,1261,0,0,0,0,0,0,0,66.31 ,84.85 ,66.31 
01,000,01,003,0096,321,1134,15,1149,1367,0,0,0,0,0,0,0,66.31 ,84.05 ,66.31 
01,000,01,003,0096,322,1057,11,1068,1320,0,0,0,0,0,0,0,66.31 ,80.91 ,66.31 
01,000,01,003,0097,323,1166,30,1196,1406,0,0,0,0,0,0,0,66.31 ,85.06 ,66.31 
01,000,01,003,0097,324,1201,14,1215,1418,0,0,0,0,0,0,0,66.31 ,85.68 ,66.31 
01,000,01,003,0097,325,1178,16,1194,1430,0,0,0,0,0,0,0,66.31 ,83.50 ,66.31 
01,000,01,003,0097,326,1223,13,1236,1526,0,0,0,0,0,0,0,66.31 ,81.00 ,66.31 
01,000,01,003,0098,327,1100,27,1127,1336,0,0,0,0,0,0,0,66.31 ,84.36 ,66.31 
01,000,01,003,0098,328,963,12,975,1188,0,0,0,0,0,0,0,66.31 ,82.07 ,66.31 
01,000,01,003,0098,329,1091,17,1108,1376,0,0,0,0,0,0,0,66.31 ,80.52 ,66.31 
01,000,01,003,0099,330,1157,11,1168,1466,0,0,0,0,0,0,0,66.31 ,79.67 ,66.31 
01,000,01,003,0099,331,1149,11,1160,1382,0,0,0,0,0,0,0,66.31 ,83.94 ,66.31 
01,000,01,003,0099,332,809,7,816,1047,0,0,0,0,0,0,0,66.31 ,77.94 ,66.31 
01,000,01,003,0099,333,1235,21,1256,1513,0,0,0,0,0,0,0,66.31 ,83.01 ,66.31 
01,000,01,003,0100,334,916,17,933,1162,0,0,0,0,0,0,0,66.31 ,80.29 ,66.31 
01,000,01,003,0100,335,1069,11,1080,1311,0,0,0,0,0,0,0,66.31 ,82.38 ,66.31 
01,000,01,003,0100,336,981,21,1002,1161,0,0,0,0,0,0,0,66.31 ,86.30 ,66.31 
01,000,01,003,0100,337,974,16,990,1152,0,0,0,0,0,0,0,66.31 ,85.94 ,66.31 
01,000,01,003,0100,338,1046,15,1061,1288,0,0,0,0,0,0,0,66.31 ,82.38 ,66.31 
01,000,01,003,0101,339,928,14,942,1214,0,0,0,0,0,0,0,66.31 ,77.59 ,66.31 
01,000,01,003,0101,340,950,15,965,1183,0,0,0,0,0,0,0,66.31 ,81.57 ,66.31 
01,000,01,003,0101,341,903,11,914,1137,0,0,0,0,0,0,0,66.31 ,80.39 ,66.31 
01,000,01,003,0101,342,931,17,948,1167,0,0,0,0,0,0,0,66.31 ,81.23 ,66.31 
01,000,01,003,0101,343,901,21,922,1136,0,0,0,0,0,0,0,66.31 ,81.16 ,66.31 
01,000,01,003,0101,344,919,10,929,1132,0,0,0,0,0,0,0,66.31 ,82.07 ,66.31 
01,000,01,003,0101,345,875,16,891,1106,0,0,0,0,0,0,0,66.31 ,80.56 ,66.31 
01,000,01,003,0102,346,1139,18,1157,1382,0,0,0,0,0,0,0,66.31 ,83.72 ,66.31 
01,000,01,003,0102,347,1200,18,1218,1497,0,0,0,0,0,0,0,66.31 ,81.36 ,66.31 
01,000,01,003,0102,348,1158,20,1178,1386,0,0,0,0,0,0,0,66.31 ,84.99 ,66.31 
01,000,01,003,0103,349,980,22,1002,1186,0,0,0,0,0,0,0,66.31 ,84.49 ,66.31 
01,000,01,003,0103,350,892,9,901,1126,0,0,0,0,0,0,0,66.31 ,80.02 ,66.31 
01,000,01,003,0103,351,1010,18,1028,1217,0,0,0,0,0,0,0,66.31 ,84.47 ,66.31 
01,000,01,003,0103,352,962,19,981,1182,0,0,0,0,0,0,0,66.31 ,82.99 ,66.31 
01,000,01,003,0104,353,311,7,318,389,0,0,0,0,0,0,0,66.31 ,81.75 ,66.31 
01,000,01,003,0104,354,1387,12,1399,1712,0,0,0,0,0,0,0,66.31 ,81.72 ,66.31 
01,000,01,003,0104,355,1258,10,1268,1547,0,0,0,0,0,0,0,66.31 ,81.97 ,66.31 
01,000,01,003,0104,356,1145,16,1161,1414,0,0,0,0,0,0,0,66.31 ,82.11 ,66.31 
01,000,01,003,0105,357,970,26,996,1196,0,0,0,0,0,0,0,66.31 ,83.28 ,66.31 
01,000,01,003,0105,358,1025,20,1045,1271,0,0,0,0,0,0,0,66.31 ,82.22 ,66.31 
01,000,01,003,0105,359,1082,32,1114,1320,0,0,0,0,0,0,0,66.31 ,84.39 ,66.31 
01,000,01,003,0106,360,1077,16,1093,1299,0,0,0,0,0,0,0,66.31 ,84.14 ,66.31 
01,000,01,003,0106,361,999,20,1019,1275,0,0,0,0,0,0,0,66.31 ,79.92 ,66.31 
01,000,01,003,0106,362,1121,25,1146,1405,0,0,0,0,0,0,0,66.31 ,81.57 ,66.31 
01,000,01,003,0107,363,1132,24,1156,1414,0,0,0,0,0,0,0,66.31 ,81.75 ,66.31 
01,000,01,003,0107,364,1116,17,1133,1366,0,0,0,0,0,0,0,66.31 ,82.94 ,66.31 
01,000,01,003,0107,365,1052,11,1063,1279,0,0,0,0,0,0,0,66.31 ,83.11 ,66.31 
01,000,01,003,0107,366,1180,13,1193,1462,0,0,0,0,0,0,0,66.31 ,81.60 ,66.31 
01,000,01,003,0107,367,1045,20,1065,1299,0,0,0,0,0,0,0,66.31 ,81.99 ,66.31 
01,000,01,003,0107,368,1101,20,1121,1348,0,0,0,0,0,0,0,66.31 ,83.16 ,66.31 
01,000,01,003,0107,369,1135,20,1155,1373,0,0,0,0,0,0,0,66.31 ,84.12 ,66.31 
01,000,01,003,0107,370,1036,11,1047,1308,0,0,0,0,0,0,0,66.31 ,80.05 ,66.31 
01,000,01,003,0107,371,1135,19,1154,1440,0,0,0,0,0,0,0,66.31 ,80.14 ,66.31 
01,000,01,003,0107,372,1079,14,1093,1333,0,0,0,0,0,0,0,66.31 ,82.00 ,66.31 
01,000,01,003,0107,373,1120,18,1138,1346,0,0,0,0,0,0,0,66.31 ,84.55 ,66.31 
01,000,01,003,0107,374,561,15,576,711,0,0,0,0,0,0,0,66.31 ,81.01 ,66.31 
01,000,01,003,0108,375,1051,16,1067,1296,0,0,0,0,0,0,0,66.31 ,82.33 ,66.31 
01,000,01,003,0108,376,980,14,994,1201,0,0,0,0,0,0,0,66.31 ,82.76 ,66.31 
01,000,01,003,0108,377,1007,11,1018,1211,0,0,0,0,0,0,0,66.31 ,84.06 ,66.31 
01,000,01,003,0108,378,1040,13,1053,1248,0,0,0,0,0,0,0,66.31 ,84.38 ,66.31 
01,000,01,003,0109,379,1025,23,1048,1223,0,0,0,0,0,0,0,66.31 ,85.69 ,66.31 
01,000,01,003,0109,380,962,11,973,1133,0,0,0,0,0,0,0,66.31 ,85.88 ,66.31 
01,000,01,003,0109,381,1013,16,1029,1224,0,0,0,0,0,0,0,66.31 ,84.07 ,66.31 
01,000,01,003,0109,382,983,11,994,1170,0,0,0,0,0,0,0,66.31 ,84.96 ,66.31 
01,000,01,003,0109,383,1069,23,1092,1293,0,0,0,0,0,0,0,66.31 ,84.45 ,66.31 
01,000,01,003,0110,384,1020,14,1034,1232,0,0,0,0,0,0,0,66.31 ,83.93 ,66.31 
01,000,01,003,0110,385,1030,21,1051,1231,0,0,0,0,0,0,0,66.31 ,85.38 ,66.31 
01,000,01,003,0110,386,898,14,912,1076,0,0,0,0,0,0,0,66.31 ,84.76 ,66.31 
01,000,01,003,0111,387,956,19,975,1162,0,0,0,0,0,0,0,66.31 ,83.91 ,66.31 
01,000,01,003,0111,388,1033,29,1062,1268,0,0,0,0,0,0,0,66.31 ,83.75 ,66.31 
01,000,01,003,0111,389,973,15,988,1191,0,0,0,0,0,0,0,66.31 ,82.96 ,66.31 
01,000,01,003,0111,390,923,15,938,1145,0,0,0,0,0,0,0,66.31 ,81.92 ,66.31 
01,000,01,003,0111,391,977,18,995,1188,0,0,0,0,0,0,0,66.31 ,83.75 ,66.31 
01,000,01,003,0112,392,1026,16,1042,1242,0,0,0,0,0,0,0,66.31 ,83.90 ,66.31 
01,000,01,003,0112,393,1056,18,1074,1266,0,0,0,0,0,0,0,66.31 ,84.83 ,66.31 
01,000,01,003,0112,394,940,17,957,1151,0,0,0,0,0,0,0,66.31 ,83.15 ,66.31 
01,000,01,003,0112,395,960,20,980,1181,0,0,0,0,0,0,0,66.31 ,82.98 ,66.31 
01,000,01,003,0112,396,1060,14,1074,1310,0,0,0,0,0,0,0,66.31 ,81.98 ,66.31 
01,000,01,003,0112,397,1077,20,1097,1272,0,0,0,0,0,0,0,66.31 ,86.24 ,66.31 
01,000,01,003,0112,398,973,11,984,1204,0,0,0,0,0,0,0,66.31 ,81.73 ,66.31 
01,000,01,003,0112,399,1023,17,1040,1286,0,0,0,0,0,0,0,66.31 ,80.87 ,66.31 
01,000,01,003,0113,400,1059,19,1078,1289,0,0,0,0,0,0,0,66.31 ,83.63 ,66.31 
01,000,01,003,0113,401,995,13,1008,1198,0,0,0,0,0,0,0,66.31 ,84.14 ,66.31 
01,000,01,003,0113,402,1129,16,1145,1381,0,0,0,0,0,0,0,66.31 ,82.91 ,66.31 
01,000,01,003,0113,403,1056,25,1081,1292,0,0,0,0,0,0,0,66.31 ,83.67 ,66.31 
01,000,01,003,0114,404,495,15,510,626,0,0,0,0,0,0,0,66.31 ,81.47 ,66.31 
01,000,01,003,0114,405,1055,9,1064,1310,0,0,0,0,0,0,0,66.31 ,81.22 ,66.31 
01,000,01,003,0114,406,1105,24,1129,1380,0,0,0,0,0,0,0,66.31 ,81.81 ,66.31 
01,000,01,003,0114,407,1022,27,1049,1261,0,0,0,0,0,0,0,66.31 ,83.19 ,66.31 
01,000,01,003,0114,408,1193,23,1216,1455,0,0,0,0,0,0,0,66.31 ,83.57 ,66.31 
01,000,01,003,0115,409,1066,18,1084,1265,0,0,0,0,0,0,0,66.31 ,85.69 ,66.31 
01,000,01,003,0115,410,910,17,927,1126,0,0,0,0,0,0,0,66.31 ,82.33 ,66.31 
01,000,01,003,0115,411,987,20,1007,1171,0,0,0,0,0,0,0,66.31 ,85.99 ,66.31 
01,000,01,003,0116,412,992,22,1014,1193,0,0,0,0,0,0,0,66.31 ,85.00 ,66.31 
01,000,01,003,0116,413,897,16,913,1072,0,0,0,0,0,0,0,66.31 ,85.17 ,66.31 
01,000,01,003,0116,414,1006,28,1034,1307,0,0,0,0,0,0,0,66.31 ,79.11 ,66.31 
01,000,01,003,0117,415,791,23,814,980,0,0,0,0,0,0,0,66.31 ,83.06 ,66.31 
01,000,01,003,0117,416,848,19,867,1093,0,0,0,0,0,0,0,66.31 ,79.32 ,66.31 
01,000,01,003,0118,417,1097,10,1107,1355,0,0,0,0,0,0,0,66.31 ,81.70 ,66.31 
01,000,01,003,0118,418,912,16,928,1133,0,0,0,0,0,0,0,66.31 ,81.91 ,66.31 
01,000,01,003,0118,419,963,26,989,1173,0,0,0,0,0,0,0,66.31 ,84.31 ,66.31 
01,000,01,003,0118,420,1060,12,1072,1241,0,0,0,0,0,0,0,66.31 ,86.38 ,66.31 
01,000,01,003,0119,421,982,21,1003,1214,0,0,0,0,0,0,0,66.31 ,82.62 ,66.31 
01,000,01,003,0119,422,923,12,935,1125,0,0,0,0,0,0,0,66.31 ,83.11 ,66.31 
01,000,01,003,0119,423,831,18,849,1025,0,0,0,0,0,0,0,66.31 ,82.83 ,66.31 
01,000,01,004,0120,424,1017,26,1043,1224,0,0,0,0,0,0,0,66.31 ,85.21 ,66.31 
01,000,01,004,0120,425,978,24,1002,1234,0,0,0,0,0,0,0,66.31 ,81.20 ,66.31 
01,000,01,004,0120,426,1027,15,1042,1223,0,0,0,0,0,0,0,66.31 ,85.20 ,66.31 
01,000,01,004,0121,427,1136,20,1156,1375,0,0,0,0,0,0,0,66.31 ,84.07 ,66.31 
01,000,01,004,0121,428,1100,29,1129,1356,0,0,0,0,0,0,0,66.31 ,83.26 ,66.31 
01,000,01,004,0121,429,1049,22,1071,1264,0,0,0,0,0,0,0,66.31 ,84.73 ,66.31 
01,000,01,004,0122,430,1034,13,1047,1265,0,0,0,0,0,0,0,66.31 ,82.77 ,66.31 
01,000,01,004,0122,431,922,12,934,1104,0,0,0,0,0,0,0,66.31 ,84.60 ,66.31 
01,000,01,004,0122,432,1022,18,1040,1237,0,0,0,0,0,0,0,66.31 ,84.07 ,66.31 
01,000,01,004,0122,433,984,16,1000,1211,0,0,0,0,0,0,0,66.31 ,82.58 ,66.31 
01,000,01,004,0122,434,1128,22,1150,1455,0,0,0,0,0,0,0,66.31 ,79.04 ,66.31 
01,000,01,004,0123,435,891,10,901,1065,0,0,0,0,0,0,0,66.31 ,84.60 ,66.31 
01,000,01,004,0123,436,949,12,961,1130,0,0,0,0,0,0,0,66.31 ,85.04 ,66.31 
01,000,01,004,0123,437,952,23,975,1175,0,0,0,0,0,0,0,66.31 ,82.98 ,66.31 
01,000,01,004,0124,438,1172,19,1191,1395,0,0,0,0,0,0,0,66.31 ,85.38 ,66.31 
01,000,01,004,0124,439,1104,23,1127,1331,0,0,0,0,0,0,0,66.31 ,84.67 ,66.31 
01,000,01,004,0124,440,1129,21,1150,1352,0,0,0,0,0,0,0,66.31 ,85.06 ,66.31 
01,000,01,004,0125,441,1025,20,1045,1243,0,0,0,0,0,0,0,66.31 ,84.07 ,66.31 
01,000,01,004,0125,442,1035,15,1050,1253,0,0,0,0,0,0,0,66.31 ,83.80 ,66.31 
01,000,01,004,0125,443,699,11,710,896,0,0,0,0,0,0,0,66.31 ,79.24 ,66.31 
01,000,01,004,0126,444,1139,28,1167,1378,0,0,0,0,0,0,0,66.31 ,84.69 ,66.31 
01,000,01,004,0126,445,1085,19,1104,1315,0,0,0,0,0,0,0,66.31 ,83.95 ,66.31 
01,000,01,004,0126,446,912,18,930,1083,0,0,0,0,0,0,0,66.31 ,85.87 ,66.31 
01,000,01,004,0126,447,859,18,877,1042,0,0,0,0,0,0,0,66.31 ,84.17 ,66.31 
01,000,01,004,0127,448,949,17,966,1128,0,0,0,0,0,0,0,66.31 ,85.64 ,66.31 
01,000,01,004,0127,449,1105,14,1119,1371,0,0,0,0,0,0,0,66.31 ,81.62 ,66.31 
01,000,01,004,0127,450,1004,17,1021,1196,0,0,0,0,0,0,0,66.31 ,85.37 ,66.31 
01,000,01,004,0128,451,934,17,951,1158,0,0,0,0,0,0,0,66.31 ,82.12 ,66.31 
01,000,01,004,0128,452,972,16,988,1202,0,0,0,0,0,0,0,66.31 ,82.20 ,66.31 
01,000,01,004,0128,453,953,25,978,1134,0,0,0,0,0,0,0,66.31 ,86.24 ,66.31 
01,000,01,004,0129,454,889,22,911,1081,0,0,0,0,0,0,0,66.31 ,84.27 ,66.31 
01,000,01,004,0129,455,875,18,893,1057,0,0,0,0,0,0,0,66.31 ,84.48 ,66.31 
01,000,01,004,0129,456,1228,18,1246,1482,0,0,0,0,0,0,0,66.31 ,84.08 ,66.31 
01,000,01,004,0129,457,1218,24,1242,1489,0,0,0,0,0,0,0,66.31 ,83.41 ,66.31 
01,000,01,004,0130,458,879,14,893,1097,0,0,0,0,0,0,0,66.31 ,81.40 ,66.31 
01,000,01,004,0130,459,1085,21,1106,1355,0,0,0,0,0,0,0,66.31 ,81.62 ,66.31 
01,000,01,004,0130,460,790,18,808,1019,0,0,0,0,0,0,0,66.31 ,79.29 ,66.31 
01,000,01,004,0131,461,1096,23,1119,1387,0,0,0,0,0,0,0,66.31 ,80.68 ,66.31 
01,000,01,004,0131,462,1192,31,1223,1444,0,0,0,0,0,0,0,66.31 ,84.70 ,66.31 
01,000,01,004,0131,463,1248,24,1272,1546,0,0,0,0,0,0,0,66.31 ,82.28 ,66.31 
01,000,01,004,0132,464,1168,26,1194,1395,0,0,0,0,0,0,0,66.31 ,85.59 ,66.31 
01,000,01,004,0132,465,1075,31,1106,1310,0,0,0,0,0,0,0,66.31 ,84.43 ,66.31 
01,000,01,004,0133,466,954,25,979,1133,0,0,0,0,0,0,0,66.31 ,86.41 ,66.31 
01,000,01,004,0133,467,897,17,914,1063,0,0,0,0,0,0,0,66.31 ,85.98 ,66.31 
01,000,01,004,0133,468,864,19,883,1040,0,0,0,0,0,0,0,66.31 ,84.90 ,66.31 
01,000,01,004,0134,469,806,16,822,998,0,0,0,0,0,0,0,66.31 ,82.36 ,66.31 
01,000,01,004,0134,470,940,18,958,1179,0,0,0,0,0,0,0,66.31 ,81.26 ,66.31 
01,000,01,004,0134,471,967,23,990,1164,0,0,0,0,0,0,0,66.31 ,85.05 ,66.31 
01,000,01,004,0135,472,1002,17,1019,1228,0,0,0,0,0,0,0,66.31 ,82.98 ,66.31 
01,000,01,004,0135,473,895,19,914,1211,0,0,0,0,0,0,0,66.31 ,75.47 ,66.31 
01,000,01,004,0135,474,949,24,973,1123,0,0,0,0,0,0,0,66.31 ,86.64 ,66.31 
01,000,01,004,0135,475,947,22,969,1138,0,0,0,0,0,0,0,66.31 ,85.15 ,66.31 
01,000,01,004,0135,476,949,12,961,1126,0,0,0,0,0,0,0,66.31 ,85.35 ,66.31 
01,000,01,004,0135,477,936,19,955,1158,0,0,0,0,0,0,0,66.31 ,82.47 ,66.31 
01,000,01,004,0136,478,1086,24,1110,1323,0,0,0,0,0,0,0,66.31 ,83.90 ,66.31 
01,000,01,004,0136,479,862,9,871,1075,0,0,0,0,0,0,0,66.31 ,81.02 ,66.31 
01,000,01,004,0136,480,1052,16,1068,1296,0,0,0,0,0,0,0,66.31 ,82.41 ,66.31 
01,000,01,004,0136,481,1014,24,1038,1241,0,0,0,0,0,0,0,66.31 ,83.64 ,66.31 
01,000,01,004,0136,482,959,28,987,1219,0,0,0,0,0,0,0,66.31 ,80.97 ,66.31 
01,000,01,004,0137,483,1409,21,1430,1713,0,0,0,0,0,0,0,66.31 ,83.48 ,66.31 
01,000,01,004,0137,484,1186,21,1207,1434,0,0,0,0,0,0,0,66.31 ,84.17 ,66.31 
01,000,01,004,0137,485,1210,36,1246,1522,0,0,0,0,0,0,0,66.31 ,81.87 ,66.31 
01,000,01,005,0138,486,816,18,834,1018,0,0,0,0,0,0,0,66.31 ,81.93 ,66.31 
01,000,01,005,0138,487,1005,12,1017,1233,0,0,0,0,0,0,0,66.31 ,82.48 ,66.31 
01,000,01,005,0138,488,916,12,928,1119,0,0,0,0,0,0,0,66.31 ,82.93 ,66.31 
01,000,01,005,0138,489,1092,16,1108,1378,0,0,0,0,0,0,0,66.31 ,80.41 ,66.31 
01,000,01,005,0139,490,1114,11,1125,1415,0,0,0,0,0,0,0,66.31 ,79.51 ,66.31 
01,000,01,005,0139,491,1147,15,1162,1508,0,0,0,0,0,0,0,66.31 ,77.06 ,66.31 
01,000,01,005,0139,492,1075,12,1087,1444,0,0,0,0,0,0,0,66.31 ,75.28 ,66.31 
01,000,01,005,0139,493,1131,11,1142,1423,0,0,0,0,0,0,0,66.31 ,80.25 ,66.31 
01,000,01,005,0139,494,851,7,858,1097,0,0,0,0,0,0,0,66.31 ,78.21 ,66.31 
01,000,01,005,0140,495,1049,12,1061,1303,0,0,0,0,0,0,0,66.31 ,81.43 ,66.31 
01,000,01,005,0140,496,1042,19,1061,1414,0,0,0,0,0,0,0,66.31 ,75.04 ,66.31 
01,000,01,005,0140,497,1054,11,1065,1374,0,0,0,0,0,0,0,66.31 ,77.51 ,66.31 
01,000,01,005,0140,498,1128,24,1152,1389,0,0,0,0,0,0,0,66.31 ,82.94 ,66.31 
01,000,01,005,0141,499,1038,12,1050,1294,0,0,0,0,0,0,0,66.31 ,81.14 ,66.31 
01,000,01,005,0141,500,939,25,964,1211,0,0,0,0,0,0,0,66.31 ,79.60 ,66.31 
01,000,01,005,0141,501,1032,12,1044,1274,0,0,0,0,0,0,0,66.31 ,81.95 ,66.31 
01,000,01,005,0142,502,1103,11,1114,1523,0,0,0,0,0,0,0,66.31 ,73.15 ,66.31 
01,000,01,005,0142,503,860,6,866,1069,0,0,0,0,0,0,0,66.31 ,81.01 ,66.31 
01,000,01,005,0142,504,1382,13,1395,1682,0,0,0,0,0,0,0,66.31 ,82.94 ,66.31 
01,000,01,005,0143,505,941,17,958,1206,0,0,0,0,0,0,0,66.31 ,79.44 ,66.31 
01,000,01,005,0143,506,1123,23,1146,1443,0,0,0,0,0,0,0,66.31 ,79.42 ,66.31 
01,000,01,005,0143,507,977,15,992,1225,0,0,0,0,0,0,0,66.31 ,80.98 ,66.31 
01,000,01,005,0144,508,1001,12,1013,1357,0,0,0,0,0,0,0,66.31 ,74.65 ,66.31 
01,000,01,005,0144,509,759,9,768,971,0,0,0,0,0,0,0,66.31 ,79.09 ,66.31 
01,000,01,005,0144,510,983,13,996,1334,0,0,0,0,0,0,0,66.31 ,74.66 ,66.31 
01,000,01,005,0145,511,971,9,980,1264,0,0,0,0,0,0,0,66.31 ,77.53 ,66.31 
01,000,01,005,0145,512,904,17,921,1253,0,0,0,0,0,0,0,66.31 ,73.50 ,66.31 
01,000,01,005,0145,513,951,21,972,1246,0,0,0,0,0,0,0,66.31 ,78.01 ,66.31 
01,000,01,005,0146,514,1039,14,1053,1368,0,0,0,0,0,0,0,66.31 ,76.97 ,66.31 
01,000,01,005,0146,515,861,15,876,1169,0,0,0,0,0,0,0,66.31 ,74.94 ,66.31 
01,000,01,005,0146,516,905,12,917,1202,0,0,0,0,0,0,0,66.31 ,76.29 ,66.31 
01,000,01,005,0147,517,987,18,1005,1351,0,0,0,0,0,0,0,66.31 ,74.39 ,66.31 
01,000,01,005,0147,518,986,14,1000,1260,0,0,0,0,0,0,0,66.31 ,79.37 ,66.31 
01,000,01,005,0147,519,906,28,934,1189,0,0,0,0,0,0,0,66.31 ,78.55 ,66.31 
01,000,01,005,0147,520,871,14,885,1151,0,0,0,0,0,0,0,66.31 ,76.89 ,66.31 
01,000,01,005,0147,521,877,17,894,1156,0,0,0,0,0,0,0,66.31 ,77.34 ,66.31 
01,000,01,005,0148,522,1072,15,1087,1406,0,0,0,0,0,0,0,66.31 ,77.31 ,66.31 
01,000,01,005,0148,523,1187,15,1202,1538,0,0,0,0,0,0,0,66.31 ,78.15 ,66.31 
01,000,01,005,0148,524,1192,11,1203,1590,0,0,0,0,0,0,0,66.31 ,75.66 ,66.31 
01,000,01,005,0149,525,964,15,979,1237,0,0,0,0,0,0,0,66.31 ,79.14 ,66.31 
01,000,01,005,0149,526,878,13,891,1126,0,0,0,0,0,0,0,66.31 ,79.13 ,66.31 
01,000,01,005,0149,527,1016,17,1033,1332,0,0,0,0,0,0,0,66.31 ,77.55 ,66.31 
01,000,01,005,0150,528,1063,10,1073,1377,0,0,0,0,0,0,0,66.31 ,77.92 ,66.31 
01,000,01,005,0150,529,970,14,984,1246,0,0,0,0,0,0,0,66.31 ,78.97 ,66.31 
01,000,01,005,0151,530,1024,18,1042,1271,0,0,0,0,0,0,0,66.31 ,81.98 ,66.31 
01,000,01,005,0151,531,980,13,993,1235,0,0,0,0,0,0,0,66.31 ,80.40 ,66.31 
01,000,01,005,0151,532,1028,12,1040,1282,0,0,0,0,0,0,0,66.31 ,81.12 ,66.31 
01,000,01,005,0152,533,1097,10,1107,1448,0,0,0,0,0,0,0,66.31 ,76.45 ,66.31 
01,000,01,005,0152,534,1150,16,1166,1470,0,0,0,0,0,0,0,66.31 ,79.32 ,66.31 
01,000,01,005,0152,535,997,17,1014,1354,0,0,0,0,0,0,0,66.31 ,74.89 ,66.31 
01,000,01,005,0152,536,942,6,948,1248,0,0,0,0,0,0,0,66.31 ,75.96 ,66.31 
01,000,01,005,0152,537,1071,19,1090,1398,0,0,0,0,0,0,0,66.31 ,77.97 ,66.31 
01,000,01,005,0153,538,1080,33,1113,1360,0,0,0,0,0,0,0,66.31 ,81.84 ,66.31 
01,000,01,005,0153,539,1101,13,1114,1366,0,0,0,0,0,0,0,66.31 ,81.55 ,66.31 
01,000,01,005,0153,540,1092,22,1114,1361,0,0,0,0,0,0,0,66.31 ,81.85 ,66.31 
01,000,01,005,0153,541,928,17,945,1231,0,0,0,0,0,0,0,66.31 ,76.77 ,66.31 
01,000,01,005,0154,542,1187,27,1214,1555,0,0,0,0,0,0,0,66.31 ,78.07 ,66.31 
01,000,01,005,0154,543,1096,21,1117,1445,0,0,0,0,0,0,0,66.31 ,77.30 ,66.31 
01,000,01,005,0155,544,1056,13,1069,1281,0,0,0,0,0,0,0,66.31 ,83.45 ,66.31 
01,000,01,005,0155,545,979,12,991,1191,0,0,0,0,0,0,0,66.31 ,83.21 ,66.31 
01,000,01,005,0155,546,935,12,947,1180,0,0,0,0,0,0,0,66.31 ,80.25 ,66.31 
01,000,01,005,0155,547,878,8,886,1132,0,0,0,0,0,0,0,66.31 ,78.27 ,66.31 
01,000,01,005,0156,548,1247,21,1268,1561,0,0,0,0,0,0,0,66.31 ,81.23 ,66.31 
01,000,01,005,0156,549,1259,25,1284,1519,0,0,0,0,0,0,0,66.31 ,84.53 ,66.31 
01,000,01,005,0156,550,956,22,978,1174,0,0,0,0,0,0,0,66.31 ,83.30 ,66.31 
01,000,01,005,0156,551,1214,26,1240,1490,0,0,0,0,0,0,0,66.31 ,83.22 ,66.31 
01,000,01,005,0156,552,1056,24,1080,1325,0,0,0,0,0,0,0,66.31 ,81.51 ,66.31 
01,000,01,005,0157,553,1126,11,1137,1368,0,0,0,0,0,0,0,66.31 ,83.11 ,66.31 
01,000,01,005,0157,554,1120,17,1137,1351,0,0,0,0,0,0,0,66.31 ,84.16 ,66.31 
01,000,01,005,0157,555,986,20,1006,1262,0,0,0,0,0,0,0,66.31 ,79.71 ,66.31 
01,000,01,005,0158,556,967,14,981,1296,0,0,0,0,0,0,0,66.31 ,75.69 ,66.31 
01,000,01,005,0158,557,1211,28,1239,1563,0,0,0,0,0,0,0,66.31 ,79.27 ,66.31 
01,000,01,005,0158,558,1206,12,1218,1500,0,0,0,0,0,0,0,66.31 ,81.20 ,66.31 
01,000,01,005,0158,559,1161,10,1171,1435,0,0,0,0,0,0,0,66.31 ,81.60 ,66.31 
01,000,01,005,0159,560,956,21,977,1225,0,0,0,0,0,0,0,66.31 ,79.76 ,66.31 
01,000,01,005,0159,561,889,11,900,1181,0,0,0,0,0,0,0,66.31 ,76.21 ,66.31 
01,000,01,005,0159,562,903,21,924,1171,0,0,0,0,0,0,0,66.31 ,78.91 ,66.31 
01,000,01,005,0159,563,954,12,966,1231,0,0,0,0,0,0,0,66.31 ,78.47 ,66.31 
01,000,01,005,0159,564,1073,19,1092,1335,0,0,0,0,0,0,0,66.31 ,81.80 ,66.31 
01,000,01,005,0160,565,1099,18,1117,1346,0,0,0,0,0,0,0,66.31 ,82.99 ,66.31 
01,000,01,005,0160,566,1140,24,1164,1481,0,0,0,0,0,0,0,66.31 ,78.60 ,66.31 
01,000,01,005,0160,567,1159,12,1171,1441,0,0,0,0,0,0,0,66.31 ,81.26 ,66.31 
01,000,01,005,0160,568,1022,19,1041,1402,0,0,0,0,0,0,0,66.31 ,74.25 ,66.31 
01,000,01,005,0161,569,963,26,989,1238,0,0,0,0,0,0,0,66.31 ,79.89 ,66.31 
01,000,01,005,0161,570,1136,18,1154,1447,0,0,0,0,0,0,0,66.31 ,79.75 ,66.31 
01,000,01,005,0161,571,1013,8,1021,1219,0,0,0,0,0,0,0,66.31 ,83.76 ,66.31 
01,000,01,005,0161,572,931,16,947,1163,0,0,0,0,0,0,0,66.31 ,81.43 ,66.31 
01,000,01,005,0162,573,990,18,1008,1273,0,0,0,0,0,0,0,66.31 ,79.18 ,66.31 
01,000,01,005,0162,574,911,14,925,1201,0,0,0,0,0,0,0,66.31 ,77.02 ,66.31 
01,000,01,005,0162,575,985,18,1003,1306,0,0,0,0,0,0,0,66.31 ,76.80 ,66.31 
01,000,01,005,0162,576,834,11,845,1113,0,0,0,0,0,0,0,66.31 ,75.92 ,66.31 
01,000,01,005,0162,577,871,15,886,1167,0,0,0,0,0,0,0,66.31 ,75.92 ,66.31 
01,000,01,005,0163,578,942,19,961,1224,0,0,0,0,0,0,0,66.31 ,78.51 ,66.31 
01,000,01,005,0163,579,926,12,938,1120,0,0,0,0,0,0,0,66.31 ,83.75 ,66.31 
01,000,01,005,0163,580,626,19,645,786,0,0,0,0,0,0,0,66.31 ,82.06 ,66.31 
01,000,01,005,0164,581,1219,15,1234,1490,0,0,0,0,0,0,0,66.31 ,82.82 ,66.31 
01,000,01,005,0164,582,927,11,938,1179,0,0,0,0,0,0,0,66.31 ,79.56 ,66.31 
01,000,01,005,0165,583,1191,17,1208,1484,0,0,0,0,0,0,0,66.31 ,81.40 ,66.31 
01,000,01,005,0165,584,1199,9,1208,1527,0,0,0,0,0,0,0,66.31 ,79.11 ,66.31 
01,000,01,005,0166,585,1049,15,1064,1372,0,0,0,0,0,0,0,66.31 ,77.55 ,66.31 
01,000,01,005,0166,586,1032,9,1041,1286,0,0,0,0,0,0,0,66.31 ,80.95 ,66.31 
01,000,01,005,0166,587,1135,18,1153,1402,0,0,0,0,0,0,0,66.31 ,82.24 ,66.31 
01,000,01,005,0166,588,1144,21,1165,1416,0,0,0,0,0,0,0,66.31 ,82.27 ,66.31 
01,000,01,005,0167,589,872,13,885,1083,0,0,0,0,0,0,0,66.31 ,81.72 ,66.31 
01,000,01,005,0167,590,1112,13,1125,1440,0,0,0,0,0,0,0,66.31 ,78.13 ,66.31 
01,000,01,005,0168,591,1062,17,1079,1376,0,0,0,0,0,0,0,66.31 ,78.42 ,66.31 
01,000,01,005,0168,592,1169,18,1187,1512,0,0,0,0,0,0,0,66.31 ,78.51 ,66.31 
01,000,01,005,0169,593,910,23,933,1161,0,0,0,0,0,0,0,66.31 ,80.36 ,66.31 
01,000,01,005,0169,594,963,17,980,1197,0,0,0,0,0,0,0,66.31 ,81.87 ,66.31 
01,000,01,005,0169,595,972,22,994,1278,0,0,0,0,0,0,0,66.31 ,77.78 ,66.31 
01,000,01,005,0169,596,876,16,892,1163,0,0,0,0,0,0,0,66.31 ,76.70 ,66.31 
01,000,01,005,0170,597,992,23,1015,1345,0,0,0,0,0,0,0,66.31 ,75.46 ,66.31 
01,000,01,005,0170,598,582,16,598,828,0,0,0,0,0,0,0,66.31 ,72.22 ,66.31 
01,000,01,006,0171,599,1092,15,1107,1412,0,0,0,0,0,0,0,66.31 ,78.40 ,66.31 
01,000,01,006,0171,600,1016,10,1026,1259,0,0,0,0,0,0,0,66.31 ,81.49 ,66.31 
01,000,01,006,0171,601,980,11,991,1239,0,0,0,0,0,0,0,66.31 ,79.98 ,66.31 
01,000,01,006,0172,602,1054,19,1073,1404,0,0,0,0,0,0,0,66.31 ,76.42 ,66.31 
01,000,01,006,0172,603,972,28,1000,1269,0,0,0,0,0,0,0,66.31 ,78.80 ,66.31 
01,000,01,006,0172,604,984,14,998,1290,0,0,0,0,0,0,0,66.31 ,77.36 ,66.31 
01,000,01,006,0173,605,906,24,930,1165,0,0,0,0,0,0,0,66.31 ,79.83 ,66.31 
01,000,01,006,0173,606,941,16,957,1350,0,0,0,0,0,0,0,66.31 ,70.89 ,66.31 
01,000,01,006,0174,607,888,21,909,1222,0,0,0,0,0,0,0,66.31 ,74.39 ,66.31 
01,000,01,006,0174,608,757,10,767,1047,0,0,0,0,0,0,0,66.31 ,73.26 ,66.31 
01,000,01,006,0175,609,895,14,909,1225,0,0,0,0,0,0,0,66.31 ,74.20 ,66.31 
01,000,01,006,0175,610,910,16,926,1151,0,0,0,0,0,0,0,66.31 ,80.45 ,66.31 
01,000,01,006,0175,611,804,19,823,1111,0,0,0,0,0,0,0,66.31 ,74.08 ,66.31 
01,000,01,006,0176,612,840,12,852,1171,0,0,0,0,0,0,0,66.31 ,72.76 ,66.31 
01,000,01,006,0176,613,1047,10,1057,1374,0,0,0,0,0,0,0,66.31 ,76.93 ,66.31 
01,000,01,006,0176,614,966,13,979,1166,0,0,0,0,0,0,0,66.31 ,83.96 ,66.31 
01,000,01,006,0176,615,1000,29,1029,1241,0,0,0,0,0,0,0,66.31 ,82.92 ,66.31 
01,000,01,006,0177,616,957,8,965,1236,0,0,0,0,0,0,0,66.31 ,78.07 ,66.31 
01,000,01,006,0177,617,910,24,934,1188,0,0,0,0,0,0,0,66.31 ,78.62 ,66.31 
01,000,01,006,0177,618,1034,24,1058,1322,0,0,0,0,0,0,0,66.31 ,80.03 ,66.31 
01,000,01,006,0178,619,885,15,900,1124,0,0,0,0,0,0,0,66.31 ,80.07 ,66.31 
01,000,01,006,0178,620,1066,17,1083,1346,0,0,0,0,0,0,0,66.31 ,80.46 ,66.31 
01,000,01,006,0178,621,867,10,877,1119,0,0,0,0,0,0,0,66.31 ,78.37 ,66.31 
01,000,01,006,0178,622,1002,14,1016,1284,0,0,0,0,0,0,0,66.31 ,79.13 ,66.31 
01,000,01,006,0179,623,1044,18,1062,1311,0,0,0,0,0,0,0,66.31 ,81.01 ,66.31 
01,000,01,006,0179,624,1229,14,1243,1564,0,0,0,0,0,0,0,66.31 ,79.48 ,66.31 
01,000,01,006,0179,625,1260,12,1272,1627,0,0,0,0,0,0,0,66.31 ,78.18 ,66.31 
01,000,01,006,0179,626,1100,14,1114,1437,0,0,0,0,0,0,0,66.31 ,77.52 ,66.31 
01,000,01,006,0180,627,979,27,1006,1221,0,0,0,0,0,0,0,66.31 ,82.39 ,66.31 
01,000,01,006,0180,628,1289,27,1316,1601,0,0,0,0,0,0,0,66.31 ,82.20 ,66.31 
01,000,01,006,0181,629,997,18,1015,1242,0,0,0,0,0,0,0,66.31 ,81.72 ,66.31 
01,000,01,006,0181,630,964,11,975,1221,0,0,0,0,0,0,0,66.31 ,79.85 ,66.31 
01,000,01,006,0181,631,1032,11,1043,1239,0,0,0,0,0,0,0,66.31 ,84.18 ,66.31 
01,000,01,006,0182,632,1261,29,1290,1555,0,0,0,0,0,0,0,66.31 ,82.96 ,66.31 
01,000,01,006,0182,633,1142,25,1167,1431,0,0,0,0,0,0,0,66.31 ,81.55 ,66.31 
01,000,01,006,0183,634,1139,21,1160,1390,0,0,0,0,0,0,0,66.31 ,83.45 ,66.31 
01,000,01,006,0183,635,1180,29,1209,1464,0,0,0,0,0,0,0,66.31 ,82.58 ,66.31 
01,000,01,006,0183,636,1044,26,1070,1289,0,0,0,0,0,0,0,66.31 ,83.01 ,66.31 
01,000,01,006,0184,637,878,18,896,1124,0,0,0,0,0,0,0,66.31 ,79.72 ,66.31 
01,000,01,006,0184,638,1046,25,1071,1294,0,0,0,0,0,0,0,66.31 ,82.77 ,66.31 
01,000,01,006,0184,639,1127,32,1159,1357,0,0,0,0,0,0,0,66.31 ,85.41 ,66.31 
01,000,01,006,0185,640,950,20,970,1199,0,0,0,0,0,0,0,66.31 ,80.90 ,66.31 
01,000,01,006,0185,641,1097,23,1120,1385,0,0,0,0,0,0,0,66.31 ,80.87 ,66.31 
01,000,01,006,0185,642,911,27,938,1124,0,0,0,0,0,0,0,66.31 ,83.45 ,66.31 
01,000,01,006,0186,643,1035,16,1051,1245,0,0,0,0,0,0,0,66.31 ,84.42 ,66.31 
01,000,01,006,0186,644,1263,21,1284,1525,0,0,0,0,0,0,0,66.31 ,84.20 ,66.31 
01,000,01,006,0186,645,1399,33,1432,1730,0,0,0,0,0,0,0,66.31 ,82.77 ,66.31 
01,000,01,006,0187,646,1244,13,1257,1542,0,0,0,0,0,0,0,66.31 ,81.52 ,66.31 
01,000,01,006,0187,647,1239,20,1259,1551,0,0,0,0,0,0,0,66.31 ,81.17 ,66.31 
01,000,01,006,0187,648,1197,18,1215,1509,0,0,0,0,0,0,0,66.31 ,80.52 ,66.31 
01,000,01,006,0188,649,1369,18,1387,1664,0,0,0,0,0,0,0,66.31 ,83.35 ,66.31 
01,000,01,006,0188,650,1159,21,1180,1419,0,0,0,0,0,0,0,66.31 ,83.16 ,66.31 
01,000,01,006,0188,651,1113,16,1129,1392,0,0,0,0,0,0,0,66.31 ,81.11 ,66.31 
01,000,01,006,0189,652,679,13,692,904,0,0,0,0,0,0,0,66.31 ,76.55 ,66.31 
01,000,01,006,0189,653,1084,17,1101,1344,0,0,0,0,0,0,0,66.31 ,81.92 ,66.31 
01,000,01,006,0189,654,730,16,746,910,0,0,0,0,0,0,0,66.31 ,81.98 ,66.31 
01,000,01,006,0190,655,1088,20,1108,1350,0,0,0,0,0,0,0,66.31 ,82.07 ,66.31 
01,000,01,006,0190,656,1084,18,1102,1387,0,0,0,0,0,0,0,66.31 ,79.45 ,66.31 
01,000,01,006,0190,657,1217,14,1231,1512,0,0,0,0,0,0,0,66.31 ,81.42 ,66.31 
01,000,01,006,0190,658,892,26,918,1122,0,0,0,0,0,0,0,66.31 ,81.82 ,66.31 
01,000,01,006,0191,659,971,23,994,1235,0,0,0,0,0,0,0,66.31 ,80.49 ,66.31 
01,000,01,006,0191,660,887,22,909,1133,0,0,0,0,0,0,0,66.31 ,80.23 ,66.31 
01,000,01,006,0192,661,1102,39,1141,1395,0,0,0,0,0,0,0,66.31 ,81.79 ,66.31 
01,000,01,006,0192,662,1012,18,1030,1248,0,0,0,0,0,0,0,66.31 ,82.53 ,66.31 
01,000,01,006,0192,663,969,17,986,1184,0,0,0,0,0,0,0,66.31 ,83.28 ,66.31 
01,000,01,006,0192,664,945,19,964,1177,0,0,0,0,0,0,0,66.31 ,81.90 ,66.31 
01,000,01,006,0193,665,1295,17,1312,1621,0,0,0,0,0,0,0,66.31 ,80.94 ,66.31 
01,000,01,006,0193,666,1183,10,1193,1459,0,0,0,0,0,0,0,66.31 ,81.77 ,66.31 
01,000,01,006,0193,667,1179,14,1193,1474,0,0,0,0,0,0,0,66.31 ,80.94 ,66.31 
01,000,01,006,0194,668,1058,16,1074,1288,0,0,0,0,0,0,0,66.31 ,83.39 ,66.31 
01,000,01,006,0194,669,1026,20,1046,1251,0,0,0,0,0,0,0,66.31 ,83.61 ,66.31 
01,000,01,006,0194,670,976,20,996,1212,0,0,0,0,0,0,0,66.31 ,82.18 ,66.31 
01,000,01,006,0195,671,949,18,967,1172,0,0,0,0,0,0,0,66.31 ,82.51 ,66.31 
01,000,01,006,0195,672,1044,21,1065,1266,0,0,0,0,0,0,0,66.31 ,84.12 ,66.31 
01,000,01,006,0195,673,1014,19,1033,1270,0,0,0,0,0,0,0,66.31 ,81.34 ,66.31 
01,000,01,006,0195,674,1102,23,1125,1327,0,0,0,0,0,0,0,66.31 ,84.78 ,66.31 
01,000,01,006,0195,675,1003,24,1027,1217,0,0,0,0,0,0,0,66.31 ,84.39 ,66.31 
01,000,01,006,0196,676,988,28,1016,1261,0,0,0,0,0,0,0,66.31 ,80.57 ,66.31 
01,000,01,006,0196,677,1088,27,1115,1337,0,0,0,0,0,0,0,66.31 ,83.40 ,66.31 
01,000,01,006,0196,678,1130,14,1144,1415,0,0,0,0,0,0,0,66.31 ,80.85 ,66.31 
01,000,01,006,0196,679,995,23,1018,1231,0,0,0,0,0,0,0,66.31 ,82.70 ,66.31 
01,000,01,006,0197,680,1027,26,1053,1290,0,0,0,0,0,0,0,66.31 ,81.63 ,66.31 
01,000,01,006,0197,681,980,73,1053,1359,0,0,0,0,0,0,0,66.31 ,77.48 ,66.31 
01,000,01,006,0197,682,1006,10,1016,1248,0,0,0,0,0,0,0,66.31 ,81.41 ,66.31 
01,000,01,006,0197,683,814,44,858,1032,0,0,0,0,0,0,0,66.31 ,83.14 ,66.31 
01,000,01,006,0198,684,990,14,1004,1228,0,0,0,0,0,0,0,66.31 ,81.76 ,66.31 
01,000,01,006,0198,685,1094,21,1115,1378,0,0,0,0,0,0,0,66.31 ,80.91 ,66.31 
01,000,01,006,0198,686,1047,14,1061,1377,0,0,0,0,0,0,0,66.31 ,77.05 ,66.31 
01,000,01,006,0199,687,1078,20,1098,1355,0,0,0,0,0,0,0,66.31 ,81.03 ,66.31 
01,000,01,006,0199,688,1113,19,1132,1354,0,0,0,0,0,0,0,66.31 ,83.60 ,66.31 
01,000,01,006,0199,689,1107,25,1132,1366,0,0,0,0,0,0,0,66.31 ,82.87 ,66.31 
01,000,01,006,0199,690,1162,34,1196,1430,0,0,0,0,0,0,0,66.31 ,83.64 ,66.31 
01,000,01,006,0200,691,1044,22,1066,1364,0,0,0,0,0,0,0,66.31 ,78.15 ,66.31 
01,000,01,006,0200,692,1206,15,1221,1511,0,0,0,0,0,0,0,66.31 ,80.81 ,66.31 
01,000,01,006,0200,693,1176,17,1193,1488,0,0,0,0,0,0,0,66.31 ,80.17 ,66.31 
01,000,01,006,0200,694,1145,24,1169,1456,0,0,0,0,0,0,0,66.31 ,80.29 ,66.31 
01,000,01,006,0200,695,1205,16,1221,1503,0,0,0,0,0,0,0,66.31 ,81.24 ,66.31 
01,000,01,006,0201,696,987,20,1007,1289,0,0,0,0,0,0,0,66.31 ,78.12 ,66.31 
01,000,01,006,0201,697,985,21,1006,1264,0,0,0,0,0,0,0,66.31 ,79.59 ,66.31 
01,000,01,006,0201,698,1094,25,1119,1402,0,0,0,0,0,0,0,66.31 ,79.81 ,66.31 
01,000,01,006,0202,699,1069,15,1084,1355,0,0,0,0,0,0,0,66.31 ,80.00 ,66.31 
01,000,01,006,0202,700,1271,17,1288,1589,0,0,0,0,0,0,0,66.31 ,81.06 ,66.31 
01,000,01,006,0202,701,805,19,824,1008,0,0,0,0,0,0,0,66.31 ,81.75 ,66.31 
01,000,01,006,0202,702,893,19,912,1241,0,0,0,0,0,0,0,66.31 ,73.49 ,66.31 
01,000,01,006,0203,703,974,29,1003,1313,0,0,0,0,0,0,0,66.31 ,76.39 ,66.31 
01,000,01,006,0203,704,990,26,1016,1256,0,0,0,0,0,0,0,66.31 ,80.89 ,66.31 
01,000,01,006,0203,705,1086,20,1106,1342,0,0,0,0,0,0,0,66.31 ,82.41 ,66.31 
01,000,01,006,0203,706,1082,16,1098,1368,0,0,0,0,0,0,0,66.31 ,80.26 ,66.31 
01,000,01,006,0203,707,1080,24,1104,1340,0,0,0,0,0,0,0,66.31 ,82.39 ,66.31 
01,000,01,006,0204,708,966,27,993,1282,0,0,0,0,0,0,0,66.31 ,77.46 ,66.31 
01,000,01,006,0204,709,1016,19,1035,1289,0,0,0,0,0,0,0,66.31 ,80.29 ,66.31 
01,000,01,006,0204,710,1158,19,1177,1389,0,0,0,0,0,0,0,66.31 ,84.74 ,66.31 
01,000,01,006,0205,711,944,25,969,1200,0,0,0,0,0,0,0,66.31 ,80.75 ,66.31 
01,000,01,006,0205,712,1005,21,1026,1273,0,0,0,0,0,0,0,66.31 ,80.60 ,66.31 
01,000,01,006,0205,713,1167,13,1180,1436,0,0,0,0,0,0,0,66.31 ,82.17 ,66.31 
01,000,01,006,0206,714,984,21,1005,1252,0,0,0,0,0,0,0,66.31 ,80.27 ,66.31 
01,000,01,006,0206,715,1135,21,1156,1409,0,0,0,0,0,0,0,66.31 ,82.04 ,66.31 
01,000,01,006,0206,716,1212,18,1230,1485,0,0,0,0,0,0,0,66.31 ,82.83 ,66.31 
01,000,01,006,0206,717,1057,14,1071,1332,0,0,0,0,0,0,0,66.31 ,80.41 ,66.31 
01,000,01,006,0207,718,1134,20,1154,1417,0,0,0,0,0,0,0,66.31 ,81.44 ,66.31 
01,000,01,006,0207,719,1011,25,1036,1251,0,0,0,0,0,0,0,66.31 ,82.81 ,66.31 
01,000,01,006,0208,720,757,20,777,971,0,0,0,0,0,0,0,66.31 ,80.02 ,66.31 
01,000,01,006,0208,721,1073,13,1086,1328,0,0,0,0,0,0,0,66.31 ,81.78 ,66.31 
01,000,01,006,0208,722,960,15,975,1267,0,0,0,0,0,0,0,66.31 ,76.95 ,66.31 
01,000,01,006,0209,723,1128,26,1154,1369,0,0,0,0,0,0,0,66.31 ,84.30 ,66.31 
01,000,01,006,0209,724,1181,16,1197,1470,0,0,0,0,0,0,0,66.31 ,81.43 ,66.31 
01,000,01,006,0209,725,1032,29,1061,1310,0,0,0,0,0,0,0,66.31 ,80.99 ,66.31 
01,000,01,006,0209,726,1141,32,1173,1441,0,0,0,0,0,0,0,66.31 ,81.40 ,66.31 
01,000,01,006,0210,727,1129,28,1157,1418,0,0,0,0,0,0,0,66.31 ,81.59 ,66.31 
01,000,01,006,0210,728,941,25,966,1174,0,0,0,0,0,0,0,66.31 ,82.28 ,66.31 
01,000,01,006,0210,729,1006,26,1032,1212,0,0,0,0,0,0,0,66.31 ,85.15 ,66.31 
01,000,01,006,0211,730,996,19,1015,1206,0,0,0,0,0,0,0,66.31 ,84.16 ,66.31 
01,000,01,006,0211,731,918,40,958,1267,0,0,0,0,0,0,0,66.31 ,75.61 ,66.31 
01,000,02,007,0212,732,956,18,974,1248,0,0,0,0,0,0,0,66.31 ,78.04 ,66.31 
01,000,02,007,0212,733,980,19,999,1265,0,0,0,0,0,0,0,66.31 ,78.97 ,66.31 
01,000,02,007,0213,734,592,23,615,830,0,0,0,0,0,0,0,66.31 ,74.10 ,66.31 
01,000,02,007,0213,735,1010,26,1036,1426,0,0,0,0,0,0,0,66.31 ,72.65 ,66.31 
01,000,02,007,0213,736,950,35,985,1270,0,0,0,0,0,0,0,66.31 ,77.56 ,66.31 
01,000,02,007,0214,737,814,14,828,1098,0,0,0,0,0,0,0,66.31 ,75.41 ,66.31 
01,000,02,007,0214,738,1027,20,1047,1467,0,0,0,0,0,0,0,66.31 ,71.37 ,66.31 
01,000,02,007,0215,739,1002,20,1022,1303,0,0,0,0,0,0,0,66.31 ,78.43 ,66.31 
01,000,02,007,0215,740,1019,23,1042,1434,0,0,0,0,0,0,0,66.31 ,72.66 ,66.31 
01,000,02,007,0215,741,1044,19,1063,1373,0,0,0,0,0,0,0,66.31 ,77.42 ,66.31 
01,000,02,007,0216,742,615,22,637,932,0,0,0,0,0,0,0,66.31 ,68.35 ,66.31 
01,000,02,007,0216,743,639,25,664,958,0,0,0,0,0,0,0,66.31 ,69.31 ,66.31 
01,000,02,007,0217,744,1002,23,1025,1361,0,0,0,0,0,0,0,66.31 ,75.31 ,66.31 
01,000,02,007,0217,745,906,28,934,1263,0,0,0,0,0,0,0,66.31 ,73.95 ,66.31 
01,000,02,007,0217,746,980,22,1002,1318,0,0,0,0,0,0,0,66.31 ,76.02 ,66.31 
01,000,02,007,0218,747,1031,21,1052,1418,0,0,0,0,0,0,0,66.31 ,74.19 ,66.31 
01,000,02,007,0218,748,972,21,993,1368,0,0,0,0,0,0,0,66.31 ,72.59 ,66.31 
01,000,02,007,0219,749,1052,25,1077,1317,0,0,0,0,0,0,0,66.31 ,81.78 ,66.31 
01,000,02,007,0219,750,772,19,791,998,0,0,0,0,0,0,0,66.31 ,79.26 ,66.31 
01,000,02,007,0219,751,767,21,788,1008,0,0,0,0,0,0,0,66.31 ,78.17 ,66.31 
01,000,02,007,0219,752,930,27,957,1232,0,0,0,0,0,0,0,66.31 ,77.68 ,66.31 
01,000,02,007,0220,753,1137,39,1176,1577,0,0,0,0,0,0,0,66.31 ,74.57 ,66.31 
01,000,02,007,0220,754,1085,21,1106,1426,0,0,0,0,0,0,0,66.31 ,77.56 ,66.31 
01,000,02,007,0221,755,863,26,889,1288,0,0,0,0,0,0,0,66.31 ,69.02 ,66.31 
01,000,02,007,0221,756,886,24,910,1189,0,0,0,0,0,0,0,66.31 ,76.53 ,66.31 
01,000,02,007,0222,757,833,20,853,1137,0,0,0,0,0,0,0,66.31 ,75.02 ,66.31 
01,000,02,007,0222,758,694,9,703,1013,0,0,0,0,0,0,0,66.31 ,69.40 ,66.31 
01,000,02,007,0222,759,772,12,784,1109,0,0,0,0,0,0,0,66.31 ,70.69 ,66.31 
01,000,02,007,0223,760,796,20,816,1076,0,0,0,0,0,0,0,66.31 ,75.84 ,66.31 
01,000,02,007,0223,761,651,20,671,860,0,0,0,0,0,0,0,66.31 ,78.02 ,66.31 
01,000,02,007,0223,762,747,26,773,1037,0,0,0,0,0,0,0,66.31 ,74.54 ,66.31 
01,000,02,007,0223,763,553,18,571,753,0,0,0,0,0,0,0,66.31 ,75.83 ,66.31 
01,000,02,007,0224,764,1078,18,1096,1423,0,0,0,0,0,0,0,66.31 ,77.02 ,66.31 
01,000,02,007,0224,765,1029,20,1049,1304,0,0,0,0,0,0,0,66.31 ,80.44 ,66.31 
01,000,02,007,0224,766,937,20,957,1178,0,0,0,0,0,0,0,66.31 ,81.24 ,66.31 
01,000,02,007,0225,767,835,14,849,1111,0,0,0,0,0,0,0,66.31 ,76.42 ,66.31 
01,000,02,007,0225,768,1017,18,1035,1246,0,0,0,0,0,0,0,66.31 ,83.07 ,66.31 
01,000,02,007,0226,769,993,14,1007,1257,0,0,0,0,0,0,0,66.31 ,80.11 ,66.31 
01,000,02,007,0226,770,1043,10,1053,1316,0,0,0,0,0,0,0,66.31 ,80.02 ,66.31 
01,000,02,007,0226,771,1117,21,1138,1357,0,0,0,0,0,0,0,66.31 ,83.86 ,66.31 
01,000,02,007,0226,772,1066,13,1079,1294,0,0,0,0,0,0,0,66.31 ,83.38 ,66.31 
01,000,02,007,0226,773,1056,9,1065,1305,0,0,0,0,0,0,0,66.31 ,81.61 ,66.31 
01,000,02,007,0226,774,967,20,987,1232,0,0,0,0,0,0,0,66.31 ,80.11 ,66.31 
01,000,02,007,0227,775,926,13,939,1158,0,0,0,0,0,0,0,66.31 ,81.09 ,66.31 
01,000,02,007,0227,776,885,27,912,1074,0,0,0,0,0,0,0,66.31 ,84.92 ,66.31 
01,000,02,007,0227,777,815,22,837,983,0,0,0,0,0,0,0,66.31 ,85.15 ,66.31 
01,000,02,007,0227,778,757,12,769,918,0,0,0,0,0,0,0,66.31 ,83.77 ,66.31 
01,000,02,007,0228,779,1184,20,1204,1445,0,0,0,0,0,0,0,66.31 ,83.32 ,66.31 
01,000,02,007,0228,780,1088,12,1100,1297,0,0,0,0,0,0,0,66.31 ,84.81 ,66.31 
01,000,02,007,0228,781,1077,14,1091,1346,0,0,0,0,0,0,0,66.31 ,81.05 ,66.31 
01,000,02,007,0228,782,965,12,977,1173,0,0,0,0,0,0,0,66.31 ,83.29 ,66.31 
01,000,02,007,0229,783,726,24,750,909,0,0,0,0,0,0,0,66.31 ,82.51 ,66.31 
01,000,02,007,0230,784,1135,17,1152,1336,0,0,0,0,0,0,0,66.31 ,86.23 ,66.31 
01,000,02,007,0230,785,1044,22,1066,1302,0,0,0,0,0,0,0,66.31 ,81.87 ,66.31 
01,000,02,007,0230,786,1008,25,1033,1317,0,0,0,0,0,0,0,66.31 ,78.44 ,66.31 
01,000,02,007,0231,787,985,30,1015,1232,0,0,0,0,0,0,0,66.31 ,82.39 ,66.31 
01,000,02,007,0231,788,1075,34,1109,1460,0,0,0,0,0,0,0,66.31 ,75.96 ,66.31 
01,000,02,007,0231,789,1091,31,1122,1418,0,0,0,0,0,0,0,66.31 ,79.13 ,66.31 
01,000,02,007,0232,790,957,24,981,1214,0,0,0,0,0,0,0,66.31 ,80.81 ,66.31 
01,000,02,007,0232,791,1004,14,1018,1316,0,0,0,0,0,0,0,66.31 ,77.36 ,66.31 
01,000,02,007,0232,792,1055,15,1070,1344,0,0,0,0,0,0,0,66.31 ,79.61 ,66.31 
01,000,02,007,0232,793,927,16,943,1182,0,0,0,0,0,0,0,66.31 ,79.78 ,66.31 
01,000,02,007,0233,794,868,26,894,1110,0,0,0,0,0,0,0,66.31 ,80.54 ,66.31 
01,000,02,007,0233,795,758,16,774,992,0,0,0,0,0,0,0,66.31 ,78.02 ,66.31 
01,000,02,007,0233,796,694,16,710,901,0,0,0,0,0,0,0,66.31 ,78.80 ,66.31 
01,000,02,007,0233,797,697,15,712,908,0,0,0,0,0,0,0,66.31 ,78.41 ,66.31 
01,000,02,007,0234,798,834,22,856,1087,0,0,0,0,0,0,0,66.31 ,78.75 ,66.31 
01,000,02,007,0234,799,766,23,789,995,0,0,0,0,0,0,0,66.31 ,79.30 ,66.31 
01,000,02,007,0234,800,1002,20,1022,1270,0,0,0,0,0,0,0,66.31 ,80.47 ,66.31 
01,000,02,007,0234,801,893,28,921,1222,0,0,0,0,0,0,0,66.31 ,75.37 ,66.31 
01,000,02,007,0235,802,1053,27,1080,1301,0,0,0,0,0,0,0,66.31 ,83.01 ,66.31 
01,000,02,007,0235,803,1157,21,1178,1466,0,0,0,0,0,0,0,66.31 ,80.35 ,66.31 
01,000,02,007,0235,804,1023,33,1056,1395,0,0,0,0,0,0,0,66.31 ,75.70 ,66.31 
01,000,02,007,0236,805,1011,21,1032,1256,0,0,0,0,0,0,0,66.31 ,82.17 ,66.31 
01,000,02,007,0236,806,886,26,912,1071,0,0,0,0,0,0,0,66.31 ,85.15 ,66.31 
01,000,02,007,0236,807,1152,17,1169,1427,0,0,0,0,0,0,0,66.31 ,81.92 ,66.31 
01,000,02,007,0236,808,1042,23,1065,1303,0,0,0,0,0,0,0,66.31 ,81.73 ,66.31 
01,000,02,007,0236,809,1151,27,1178,1417,0,0,0,0,0,0,0,66.31 ,83.13 ,66.31 
01,000,02,007,0237,810,712,20,732,897,0,0,0,0,0,0,0,66.31 ,81.61 ,66.31 
01,000,02,007,0237,811,814,23,837,1031,0,0,0,0,0,0,0,66.31 ,81.18 ,66.31 
01,000,02,007,0237,812,894,18,912,1117,0,0,0,0,0,0,0,66.31 ,81.65 ,66.31 
01,000,02,007,0238,813,785,12,797,1017,0,0,0,0,0,0,0,66.31 ,78.37 ,66.31 
01,000,02,007,0238,814,898,26,924,1094,0,0,0,0,0,0,0,66.31 ,84.46 ,66.31 
01,000,02,007,0238,815,962,23,985,1198,0,0,0,0,0,0,0,66.31 ,82.22 ,66.31 
01,000,02,007,0238,816,859,12,871,1065,0,0,0,0,0,0,0,66.31 ,81.78 ,66.31 
01,000,02,007,0238,817,951,22,973,1199,0,0,0,0,0,0,0,66.31 ,81.15 ,66.31 
01,000,02,007,0239,818,875,15,890,1110,0,0,0,0,0,0,0,66.31 ,80.18 ,66.31 
01,000,02,007,0239,819,842,15,857,1100,0,0,0,0,0,0,0,66.31 ,77.91 ,66.31 
01,000,02,007,0239,820,1010,14,1024,1224,0,0,0,0,0,0,0,66.31 ,83.66 ,66.31 
01,000,02,007,0239,821,645,14,659,830,0,0,0,0,0,0,0,66.31 ,79.40 ,66.31 
01,000,02,007,0239,822,687,13,700,904,0,0,0,0,0,0,0,66.31 ,77.43 ,66.31 
01,000,02,007,0240,823,959,12,971,1184,0,0,0,0,0,0,0,66.31 ,82.01 ,66.31 
01,000,02,007,0240,824,915,24,939,1134,0,0,0,0,0,0,0,66.31 ,82.80 ,66.31 
01,000,02,007,0240,825,976,15,991,1200,0,0,0,0,0,0,0,66.31 ,82.58 ,66.31 
01,000,02,007,0240,826,922,14,936,1156,0,0,0,0,0,0,0,66.31 ,80.97 ,66.31 
01,000,02,007,0240,827,926,16,942,1172,0,0,0,0,0,0,0,66.31 ,80.38 ,66.31 
01,000,02,007,0241,828,1011,16,1027,1363,0,0,0,0,0,0,0,66.31 ,75.35 ,66.31 
01,000,02,007,0241,829,1034,17,1051,1372,0,0,0,0,0,0,0,66.31 ,76.60 ,66.31 
01,000,02,007,0241,830,1131,27,1158,1472,0,0,0,0,0,0,0,66.31 ,78.67 ,66.31 
01,000,02,007,0242,831,818,18,836,1088,0,0,0,0,0,0,0,66.31 ,76.84 ,66.31 
01,000,02,007,0242,832,1055,23,1078,1363,0,0,0,0,0,0,0,66.31 ,79.09 ,66.31 
01,000,02,007,0242,833,991,27,1018,1362,0,0,0,0,0,0,0,66.31 ,74.74 ,66.31 
01,000,02,007,0243,834,991,25,1016,1374,0,0,0,0,0,0,0,66.31 ,73.94 ,66.31 
01,000,02,007,0243,835,1021,18,1039,1356,0,0,0,0,0,0,0,66.31 ,76.62 ,66.31 
01,000,02,007,0243,836,1072,16,1088,1442,0,0,0,0,0,0,0,66.31 ,75.45 ,66.31 
01,000,02,007,0244,837,711,22,733,974,0,0,0,0,0,0,0,66.31 ,75.26 ,66.31 
01,000,02,007,0244,838,782,11,793,1009,0,0,0,0,0,0,0,66.31 ,78.59 ,66.31 
01,000,02,007,0244,839,714,10,724,892,0,0,0,0,0,0,0,66.31 ,81.17 ,66.31 
01,000,02,007,0245,840,988,26,1014,1294,0,0,0,0,0,0,0,66.31 ,78.36 ,66.31 
01,000,02,007,0245,841,850,12,862,1128,0,0,0,0,0,0,0,66.31 ,76.42 ,66.31 
01,000,02,007,0245,842,1047,22,1069,1324,0,0,0,0,0,0,0,66.31 ,80.74 ,66.31 
01,000,02,007,0245,843,1006,23,1029,1264,0,0,0,0,0,0,0,66.31 ,81.41 ,66.31 
01,000,02,007,0246,844,1154,22,1176,1451,0,0,0,0,0,0,0,66.31 ,81.05 ,66.31 
01,000,02,007,0246,845,1161,11,1172,1427,0,0,0,0,0,0,0,66.31 ,82.13 ,66.31 
01,000,02,007,0246,846,1140,25,1165,1426,0,0,0,0,0,0,0,66.31 ,81.70 ,66.31 
01,000,02,007,0247,847,851,15,866,1121,0,0,0,0,0,0,0,66.31 ,77.25 ,66.31 
01,000,02,007,0247,848,888,18,906,1161,0,0,0,0,0,0,0,66.31 ,78.04 ,66.31 
01,000,02,007,0247,849,924,17,941,1136,0,0,0,0,0,0,0,66.31 ,82.83 ,66.31 
01,000,02,007,0248,850,878,17,895,1121,0,0,0,0,0,0,0,66.31 ,79.84 ,66.31 
01,000,02,007,0248,851,902,16,918,1147,0,0,0,0,0,0,0,66.31 ,80.03 ,66.31 
01,000,02,007,0248,852,889,13,902,1163,0,0,0,0,0,0,0,66.31 ,77.56 ,66.31 
01,000,02,007,0249,853,1089,15,1104,1395,0,0,0,0,0,0,0,66.31 ,79.14 ,66.31 
01,000,02,007,0249,854,965,23,988,1240,0,0,0,0,0,0,0,66.31 ,79.68 ,66.31 
01,000,02,007,0250,855,1010,17,1027,1294,0,0,0,0,0,0,0,66.31 ,79.37 ,66.31 
01,000,02,007,0250,856,906,23,929,1221,0,0,0,0,0,0,0,66.31 ,76.09 ,66.31 
01,000,02,007,0250,857,934,13,947,1224,0,0,0,0,0,0,0,66.31 ,77.37 ,66.31 
01,000,02,007,0250,858,998,11,1009,1293,0,0,0,0,0,0,0,66.31 ,78.04 ,66.31 
01,000,02,007,0251,859,1210,31,1241,1578,0,0,0,0,0,0,0,66.31 ,78.64 ,66.31 
01,000,02,007,0251,860,1074,29,1103,1432,0,0,0,0,0,0,0,66.31 ,77.03 ,66.31 
01,000,02,008,0252,861,804,16,820,1045,0,0,0,0,0,0,0,66.31 ,78.47 ,66.31 
01,000,02,008,0252,862,763,12,775,982,0,0,0,0,0,0,0,66.31 ,78.92 ,66.31 
01,000,02,008,0252,863,895,21,916,1235,0,0,0,0,0,0,0,66.31 ,74.17 ,66.31 
01,000,02,008,0253,864,845,20,865,1091,0,0,0,0,0,0,0,66.31 ,79.29 ,66.31 
01,000,02,008,0253,865,771,20,791,1025,0,0,0,0,0,0,0,66.31 ,77.17 ,66.31 
01,000,02,008,0253,866,757,10,767,980,0,0,0,0,0,0,0,66.31 ,78.27 ,66.31 
01,000,02,008,0254,867,848,14,862,1056,0,0,0,0,0,0,0,66.31 ,81.63 ,66.31 
01,000,02,008,0254,868,903,25,928,1148,0,0,0,0,0,0,0,66.31 ,80.84 ,66.31 
01,000,02,008,0254,869,812,17,829,1039,0,0,0,0,0,0,0,66.31 ,79.79 ,66.31 
01,000,02,008,0255,870,1247,35,1282,1641,0,0,0,0,0,0,0,66.31 ,78.12 ,66.31 
01,000,02,008,0255,871,947,20,967,1245,0,0,0,0,0,0,0,66.31 ,77.67 ,66.31 
01,000,02,008,0256,872,1096,20,1116,1443,0,0,0,0,0,0,0,66.31 ,77.34 ,66.31 
01,000,02,008,0256,873,1079,9,1088,1358,0,0,0,0,0,0,0,66.31 ,80.12 ,66.31 
01,000,02,008,0256,874,1065,21,1086,1338,0,0,0,0,0,0,0,66.31 ,81.17 ,66.31 
01,000,02,008,0257,875,1225,22,1247,1529,0,0,0,0,0,0,0,66.31 ,81.56 ,66.31 
01,000,02,008,0257,876,1115,24,1139,1446,0,0,0,0,0,0,0,66.31 ,78.77 ,66.31 
01,000,02,008,0258,877,1011,23,1034,1259,0,0,0,0,0,0,0,66.31 ,82.13 ,66.31 
01,000,02,008,0258,878,900,25,925,1189,0,0,0,0,0,0,0,66.31 ,77.80 ,66.31 
01,000,02,008,0258,879,933,27,960,1136,0,0,0,0,0,0,0,66.31 ,84.51 ,66.31 
01,000,02,008,0259,880,1205,27,1232,1474,0,0,0,0,0,0,0,66.31 ,83.58 ,66.31 
01,000,02,008,0259,881,1037,19,1056,1276,0,0,0,0,0,0,0,66.31 ,82.76 ,66.31 
01,000,02,008,0259,882,1197,45,1242,1512,0,0,0,0,0,0,0,66.31 ,82.14 ,66.31 
01,000,02,008,0260,883,1196,25,1221,1480,0,0,0,0,0,0,0,66.31 ,82.50 ,66.31 
01,000,02,008,0260,884,982,19,1001,1227,0,0,0,0,0,0,0,66.31 ,81.58 ,66.31 
01,000,02,008,0260,885,1103,19,1122,1348,0,0,0,0,0,0,0,66.31 ,83.23 ,66.31 
01,000,02,008,0261,886,819,20,839,1023,0,0,0,0,0,0,0,66.31 ,82.01 ,66.31 
01,000,02,008,0261,887,821,27,848,1094,0,0,0,0,0,0,0,66.31 ,77.51 ,66.31 
01,000,02,008,0261,888,767,13,780,1024,0,0,0,0,0,0,0,66.31 ,76.17 ,66.31 
01,000,02,008,0262,889,1205,31,1236,1513,0,0,0,0,0,0,0,66.31 ,81.69 ,66.31 
01,000,02,008,0262,890,1284,14,1298,1594,0,0,0,0,0,0,0,66.31 ,81.43 ,66.31 
01,000,02,008,0262,891,1386,42,1428,1730,0,0,0,0,0,0,0,66.31 ,82.54 ,66.31 
01,000,02,008,0262,892,1113,27,1140,1399,0,0,0,0,0,0,0,66.31 ,81.49 ,66.31 
01,000,02,008,0262,893,771,18,789,997,0,0,0,0,0,0,0,66.31 ,79.14 ,66.31 
01,000,02,008,0263,894,958,19,977,1245,0,0,0,0,0,0,0,66.31 ,78.47 ,66.31 
01,000,02,008,0263,895,739,10,749,957,0,0,0,0,0,0,0,66.31 ,78.27 ,66.31 
01,000,02,008,0263,896,876,20,896,1067,0,0,0,0,0,0,0,66.31 ,83.97 ,66.31 
01,000,02,008,0264,897,1097,27,1124,1396,0,0,0,0,0,0,0,66.31 ,80.52 ,66.31 
01,000,02,008,0264,898,1143,38,1181,1440,0,0,0,0,0,0,0,66.31 ,82.01 ,66.31 
01,000,02,008,0264,899,932,27,959,1251,0,0,0,0,0,0,0,66.31 ,76.66 ,66.31 
01,000,02,008,0264,900,977,15,992,1264,0,0,0,0,0,0,0,66.31 ,78.48 ,66.31 
01,000,02,008,0265,901,1063,26,1089,1325,0,0,0,0,0,0,0,66.31 ,82.19 ,66.31 
01,000,02,008,0265,902,882,27,909,1126,0,0,0,0,0,0,0,66.31 ,80.73 ,66.31 
01,000,02,008,0266,903,1046,22,1068,1323,0,0,0,0,0,0,0,66.31 ,80.73 ,66.31 
01,000,02,008,0266,904,1110,23,1133,1357,0,0,0,0,0,0,0,66.31 ,83.49 ,66.31 
01,000,02,008,0267,905,942,22,964,1222,0,0,0,0,0,0,0,66.31 ,78.89 ,66.31 
01,000,02,008,0267,906,1122,26,1148,1426,0,0,0,0,0,0,0,66.31 ,80.50 ,66.31 
01,000,02,008,0267,907,987,24,1011,1229,0,0,0,0,0,0,0,66.31 ,82.26 ,66.31 
01,000,02,008,0268,908,863,23,886,1063,0,0,0,0,0,0,0,66.31 ,83.35 ,66.31 
01,000,02,008,0268,909,1081,26,1107,1321,0,0,0,0,0,0,0,66.31 ,83.80 ,66.31 
01,000,02,008,0268,910,929,25,954,1148,0,0,0,0,0,0,0,66.31 ,83.10 ,66.31 
01,000,02,008,0269,911,835,22,857,1029,0,0,0,0,0,0,0,66.31 ,83.28 ,66.31 
01,000,02,008,0269,912,736,14,750,917,0,0,0,0,0,0,0,66.31 ,81.79 ,66.31 
01,000,02,008,0270,913,1009,35,1044,1288,0,0,0,0,0,0,0,66.31 ,81.06 ,66.31 
01,000,02,008,0270,914,997,22,1019,1257,0,0,0,0,0,0,0,66.31 ,81.07 ,66.31 
01,000,02,008,0271,915,1098,36,1134,1424,0,0,0,0,0,0,0,66.31 ,79.63 ,66.31 
01,000,02,008,0271,916,1358,24,1382,1671,0,0,0,0,0,0,0,66.31 ,82.70 ,66.31 
01,000,02,008,0271,917,1097,24,1121,1359,0,0,0,0,0,0,0,66.31 ,82.49 ,66.31 
01,000,02,008,0272,918,1184,27,1211,1448,0,0,0,0,0,0,0,66.31 ,83.63 ,66.31 
01,000,02,008,0272,919,1012,26,1038,1294,0,0,0,0,0,0,0,66.31 ,80.22 ,66.31 
01,000,02,008,0272,920,912,20,932,1100,0,0,0,0,0,0,0,66.31 ,84.73 ,66.31 
01,000,02,008,0272,921,1096,24,1120,1304,0,0,0,0,0,0,0,66.31 ,85.89 ,66.31 
01,000,02,008,0273,922,871,19,890,1102,0,0,0,0,0,0,0,66.31 ,80.76 ,66.31 
01,000,02,008,0273,923,1220,23,1243,1511,0,0,0,0,0,0,0,66.31 ,82.26 ,66.31 
01,000,02,008,0273,924,1041,15,1056,1285,0,0,0,0,0,0,0,66.31 ,82.18 ,66.31 
01,000,02,008,0273,925,1082,27,1109,1335,0,0,0,0,0,0,0,66.31 ,83.07 ,66.31 
01,000,02,008,0273,926,955,23,978,1198,0,0,0,0,0,0,0,66.31 ,81.64 ,66.31 
01,000,02,008,0274,927,857,16,873,1026,0,0,0,0,0,0,0,66.31 ,85.09 ,66.31 
01,000,02,008,0275,928,1063,26,1089,1394,0,0,0,0,0,0,0,66.31 ,78.12 ,66.31 
01,000,02,008,0275,929,1129,22,1151,1397,0,0,0,0,0,0,0,66.31 ,82.39 ,66.31 
01,000,02,008,0275,930,717,19,736,882,0,0,0,0,0,0,0,66.31 ,83.45 ,66.31 
01,000,02,008,0276,931,826,20,846,1004,0,0,0,0,0,0,0,66.31 ,84.26 ,66.31 
01,000,02,008,0276,932,906,19,925,1098,0,0,0,0,0,0,0,66.31 ,84.24 ,66.31 
01,000,02,008,0276,933,902,18,920,1095,0,0,0,0,0,0,0,66.31 ,84.02 ,66.31 
01,000,02,008,0277,934,1122,20,1142,1379,0,0,0,0,0,0,0,66.31 ,82.81 ,66.31 
01,000,02,008,0277,935,1162,24,1186,1399,0,0,0,0,0,0,0,66.31 ,84.77 ,66.31 
01,000,02,008,0277,936,895,27,922,1095,0,0,0,0,0,0,0,66.31 ,84.20 ,66.31 
01,000,02,008,0277,937,702,21,723,910,0,0,0,0,0,0,0,66.31 ,79.45 ,66.31 
01,000,02,009,0278,938,1180,22,1202,1519,0,0,0,0,0,0,0,66.31 ,79.13 ,66.31 
01,000,02,009,0278,939,1042,24,1066,1313,0,0,0,0,0,0,0,66.31 ,81.19 ,66.31 
01,000,02,009,0279,940,658,10,668,957,0,0,0,0,0,0,0,66.31 ,69.80 ,66.31 
01,000,02,009,0279,941,950,34,984,1292,0,0,0,0,0,0,0,66.31 ,76.16 ,66.31 
01,000,02,009,0280,942,876,12,888,1109,0,0,0,0,0,0,0,66.31 ,80.07 ,66.31 
01,000,02,009,0280,943,816,18,834,1080,0,0,0,0,0,0,0,66.31 ,77.22 ,66.31 
01,000,02,009,0281,944,1056,29,1085,1351,0,0,0,0,0,0,0,66.31 ,80.31 ,66.31 
01,000,02,009,0281,945,1016,24,1040,1309,0,0,0,0,0,0,0,66.31 ,79.45 ,66.31 
01,000,02,009,0281,946,904,8,912,1162,0,0,0,0,0,0,0,66.31 ,78.49 ,66.31 
01,000,02,009,0282,947,960,15,975,1227,0,0,0,0,0,0,0,66.31 ,79.46 ,66.31 
01,000,02,009,0282,948,992,18,1010,1352,0,0,0,0,0,0,0,66.31 ,74.70 ,66.31 
01,000,02,009,0282,949,984,16,1000,1343,0,0,0,0,0,0,0,66.31 ,74.46 ,66.31 
01,000,02,009,0283,950,713,13,726,970,0,0,0,0,0,0,0,66.31 ,74.85 ,66.31 
01,000,02,009,0283,951,1014,18,1032,1276,0,0,0,0,0,0,0,66.31 ,80.88 ,66.31 
01,000,02,009,0283,952,908,12,920,1121,0,0,0,0,0,0,0,66.31 ,82.07 ,66.31 
01,000,02,009,0283,953,927,13,940,1180,0,0,0,0,0,0,0,66.31 ,79.66 ,66.31 
01,000,02,009,0284,954,834,6,840,1060,0,0,0,0,0,0,0,66.31 ,79.25 ,66.31 
01,000,02,009,0284,955,835,14,849,1092,0,0,0,0,0,0,0,66.31 ,77.75 ,66.31 
01,000,02,009,0284,956,917,15,932,1186,0,0,0,0,0,0,0,66.31 ,78.58 ,66.31 
01,000,02,009,0284,957,897,22,919,1180,0,0,0,0,0,0,0,66.31 ,77.88 ,66.31 
01,000,02,009,0285,958,680,14,694,888,0,0,0,0,0,0,0,66.31 ,78.15 ,66.31 
01,000,02,009,0285,959,720,15,735,973,0,0,0,0,0,0,0,66.31 ,75.54 ,66.31 
01,000,02,009,0285,960,776,17,793,962,0,0,0,0,0,0,0,66.31 ,82.43 ,66.31 
01,000,02,009,0286,961,1035,22,1057,1334,0,0,0,0,0,0,0,66.31 ,79.24 ,66.31 
01,000,02,009,0286,962,1173,28,1201,1462,0,0,0,0,0,0,0,66.31 ,82.15 ,66.31 
01,000,02,009,0286,963,1174,9,1183,1436,0,0,0,0,0,0,0,66.31 ,82.38 ,66.31 
01,000,02,009,0287,964,991,13,1004,1238,0,0,0,0,0,0,0,66.31 ,81.10 ,66.31 
01,000,02,009,0287,965,944,19,963,1185,0,0,0,0,0,0,0,66.31 ,81.27 ,66.31 
01,000,02,009,0287,966,946,22,968,1214,0,0,0,0,0,0,0,66.31 ,79.74 ,66.31 
01,000,02,009,0288,967,1052,26,1078,1316,0,0,0,0,0,0,0,66.31 ,81.91 ,66.31 
01,000,02,009,0288,968,860,27,887,1082,0,0,0,0,0,0,0,66.31 ,81.98 ,66.31 
01,000,02,009,0288,969,796,20,816,999,0,0,0,0,0,0,0,66.31 ,81.68 ,66.31 
01,000,02,009,0288,970,791,19,810,995,0,0,0,0,0,0,0,66.31 ,81.41 ,66.31 
01,000,02,009,0289,971,936,16,952,1154,0,0,0,0,0,0,0,66.31 ,82.50 ,66.31 
01,000,02,009,0289,972,1031,21,1052,1324,0,0,0,0,0,0,0,66.31 ,79.46 ,66.31 
01,000,02,009,0289,973,1029,17,1046,1247,0,0,0,0,0,0,0,66.31 ,83.88 ,66.31 
01,000,02,009,0290,974,875,28,903,1095,0,0,0,0,0,0,0,66.31 ,82.47 ,66.31 
01,000,02,009,0290,975,838,22,860,1063,0,0,0,0,0,0,0,66.31 ,80.90 ,66.31 
01,000,02,009,0290,976,965,12,977,1217,0,0,0,0,0,0,0,66.31 ,80.28 ,66.31 
01,000,02,009,0290,977,865,15,880,1117,0,0,0,0,0,0,0,66.31 ,78.78 ,66.31 
01,000,02,009,0290,978,764,12,776,947,0,0,0,0,0,0,0,66.31 ,81.94 ,66.31 
01,000,02,009,0291,979,956,28,984,1223,0,0,0,0,0,0,0,66.31 ,80.46 ,66.31 
01,000,02,009,0291,980,849,32,881,1113,0,0,0,0,0,0,0,66.31 ,79.16 ,66.31 
01,000,02,009,0291,981,884,28,912,1161,0,0,0,0,0,0,0,66.31 ,78.55 ,66.31 
01,000,02,009,0291,982,1002,29,1031,1300,0,0,0,0,0,0,0,66.31 ,79.31 ,66.31 
01,000,02,009,0291,983,968,26,994,1224,0,0,0,0,0,0,0,66.31 ,81.21 ,66.31 
01,000,02,009,0292,984,1073,15,1088,1303,0,0,0,0,0,0,0,66.31 ,83.50 ,66.31 
01,000,02,009,0292,985,1262,25,1287,1619,0,0,0,0,0,0,0,66.31 ,79.49 ,66.31 
01,000,02,009,0293,986,689,14,703,903,0,0,0,0,0,0,0,66.31 ,77.85 ,66.31 
01,000,02,009,0293,987,693,8,701,894,0,0,0,0,0,0,0,66.31 ,78.41 ,66.31 
01,000,02,009,0293,988,680,9,689,863,0,0,0,0,0,0,0,66.31 ,79.84 ,66.31 
01,000,02,009,0294,989,837,11,848,1032,0,0,0,0,0,0,0,66.31 ,82.17 ,66.31 
01,000,02,009,0294,990,814,15,829,1053,0,0,0,0,0,0,0,66.31 ,78.73 ,66.31 
01,000,02,009,0294,991,714,13,727,964,0,0,0,0,0,0,0,66.31 ,75.41 ,66.31 
01,000,02,009,0295,992,671,15,686,910,0,0,0,0,0,0,0,66.31 ,75.38 ,66.31 
01,000,02,009,0295,993,918,12,930,1183,0,0,0,0,0,0,0,66.31 ,78.61 ,66.31 
01,000,02,009,0295,994,911,6,917,1120,0,0,0,0,0,0,0,66.31 ,81.88 ,66.31 
01,000,02,009,0296,995,952,13,965,1226,0,0,0,0,0,0,0,66.31 ,78.71 ,66.31 
01,000,02,009,0296,996,962,17,979,1254,0,0,0,0,0,0,0,66.31 ,78.07 ,66.31 
01,000,02,009,0296,997,913,19,932,1213,0,0,0,0,0,0,0,66.31 ,76.83 ,66.31 
01,000,02,009,0296,998,921,11,932,1144,0,0,0,0,0,0,0,66.31 ,81.47 ,66.31 
01,000,02,009,0296,999,932,14,946,1154,0,0,0,0,0,0,0,66.31 ,81.98 ,66.31 
01,000,02,009,0297,1000,981,15,996,1276,0,0,0,0,0,0,0,66.31 ,78.06 ,66.31 
01,000,02,009,0297,1001,981,17,998,1238,0,0,0,0,0,0,0,66.31 ,80.61 ,66.31 
01,000,02,009,0297,1002,788,13,801,990,0,0,0,0,0,0,0,66.31 ,80.91 ,66.31 
01,000,02,009,0297,1003,860,19,879,1078,0,0,0,0,0,0,0,66.31 ,81.54 ,66.31 
01,000,02,009,0298,1004,1078,11,1089,1328,0,0,0,0,0,0,0,66.31 ,82.00 ,66.31 
01,000,02,009,0298,1005,1061,18,1079,1332,0,0,0,0,0,0,0,66.31 ,81.01 ,66.31 
01,000,02,009,0298,1006,975,12,987,1213,0,0,0,0,0,0,0,66.31 ,81.37 ,66.31 
01,000,02,009,0298,1007,878,13,891,1090,0,0,0,0,0,0,0,66.31 ,81.74 ,66.31 
01,000,02,009,0298,1008,1021,16,1037,1209,0,0,0,0,0,0,0,66.31 ,85.77 ,66.31 
01,000,02,009,0299,1009,872,14,886,1293,0,0,0,0,0,0,0,66.31 ,68.52 ,66.31 
01,000,02,009,0300,1010,1044,18,1062,1416,0,0,0,0,0,0,0,66.31 ,75.00 ,66.31 
01,000,02,009,0300,1011,1068,29,1097,1526,0,0,0,0,0,0,0,66.31 ,71.89 ,66.31 
01,000,02,009,0301,1012,673,16,689,1011,0,0,0,0,0,0,0,66.31 ,68.15 ,66.31 
01,000,02,009,0301,1013,810,19,829,1134,0,0,0,0,0,0,0,66.31 ,73.10 ,66.31 
01,000,02,009,0302,1014,801,11,812,1031,0,0,0,0,0,0,0,66.31 ,78.76 ,66.31 
01,000,02,009,0302,1015,747,24,771,998,0,0,0,0,0,0,0,66.31 ,77.25 ,66.31 
01,000,02,009,0302,1016,724,19,743,927,0,0,0,0,0,0,0,66.31 ,80.15 ,66.31 
01,000,02,009,0303,1017,884,14,898,1187,0,0,0,0,0,0,0,66.31 ,75.65 ,66.31 
01,000,02,009,0303,1018,897,24,921,1152,0,0,0,0,0,0,0,66.31 ,79.95 ,66.31 
01,000,02,009,0303,1019,828,21,849,1124,0,0,0,0,0,0,0,66.31 ,75.53 ,66.31 
01,000,02,009,0304,1020,963,16,979,1332,0,0,0,0,0,0,0,66.31 ,73.50 ,66.31 
01,000,02,009,0304,1021,951,13,964,1289,0,0,0,0,0,0,0,66.31 ,74.79 ,66.31 
01,000,02,009,0304,1022,704,9,713,928,0,0,0,0,0,0,0,66.31 ,76.83 ,66.31 
01,000,02,009,0305,1023,784,18,802,1001,0,0,0,0,0,0,0,66.31 ,80.12 ,66.31 
01,000,02,009,0305,1024,724,17,741,990,0,0,0,0,0,0,0,66.31 ,74.85 ,66.31 
01,000,02,009,0305,1025,837,16,853,1097,0,0,0,0,0,0,0,66.31 ,77.76 ,66.31 
01,000,02,009,0306,1026,1061,16,1077,1408,0,0,0,0,0,0,0,66.31 ,76.49 ,66.31 
01,000,02,009,0306,1027,1003,19,1022,1351,0,0,0,0,0,0,0,66.31 ,75.65 ,66.31 
01,000,02,009,0306,1028,939,15,954,1268,0,0,0,0,0,0,0,66.31 ,75.24 ,66.31 
01,000,02,009,0307,1029,814,4,818,1035,0,0,0,0,0,0,0,66.31 ,79.03 ,66.31 
01,000,02,009,0307,1030,872,6,878,1062,0,0,0,0,0,0,0,66.31 ,82.67 ,66.31 
01,000,02,009,0307,1031,829,14,843,1036,0,0,0,0,0,0,0,66.31 ,81.37 ,66.31 
01,000,02,009,0307,1032,892,12,904,1107,0,0,0,0,0,0,0,66.31 ,81.66 ,66.31 
01,000,02,009,0307,1033,754,16,770,952,0,0,0,0,0,0,0,66.31 ,80.88 ,66.31 
01,000,02,009,0308,1034,935,6,941,1254,0,0,0,0,0,0,0,66.31 ,75.04 ,66.31 
01,000,02,009,0308,1035,894,12,906,1166,0,0,0,0,0,0,0,66.31 ,77.70 ,66.31 
01,000,02,009,0308,1036,925,21,946,1230,0,0,0,0,0,0,0,66.31 ,76.91 ,66.31 
01,000,02,009,0308,1037,844,15,859,1109,0,0,0,0,0,0,0,66.31 ,77.46 ,66.31 
01,000,02,009,0308,1038,966,18,984,1284,0,0,0,0,0,0,0,66.31 ,76.64 ,66.31 
01,000,02,010,0309,1039,1025,15,1040,1325,0,0,0,0,0,0,0,66.31 ,78.49 ,66.31 
01,000,02,010,0309,1040,889,18,907,1189,0,0,0,0,0,0,0,66.31 ,76.28 ,66.31 
01,000,02,010,0309,1041,1062,24,1086,1424,0,0,0,0,0,0,0,66.31 ,76.26 ,66.31 
01,000,02,010,0310,1042,726,20,746,1079,0,0,0,0,0,0,0,66.31 ,69.14 ,66.31 
01,000,02,010,0310,1043,1113,17,1130,1550,0,0,0,0,0,0,0,66.31 ,72.90 ,66.31 
01,000,02,010,0311,1044,1153,32,1185,1617,0,0,0,0,0,0,0,66.31 ,73.28 ,66.31 
01,000,02,010,0311,1045,945,21,966,1248,0,0,0,0,0,0,0,66.31 ,77.40 ,66.31 
01,000,02,010,0312,1046,1080,21,1101,1359,0,0,0,0,0,0,0,66.31 ,81.02 ,66.31 
01,000,02,010,0312,1047,1079,46,1125,1383,0,0,0,0,0,0,0,66.31 ,81.34 ,66.31 
01,000,02,010,0312,1048,1031,37,1068,1390,0,0,0,0,0,0,0,66.31 ,76.83 ,66.31 
01,000,02,010,0312,1049,1213,25,1238,1526,0,0,0,0,0,0,0,66.31 ,81.13 ,66.31 
01,000,02,010,0313,1050,823,20,843,1124,0,0,0,0,0,0,0,66.31 ,75.00 ,66.31 
01,000,02,010,0313,1051,822,16,838,1030,0,0,0,0,0,0,0,66.31 ,81.36 ,66.31 
01,000,02,010,0313,1052,1056,15,1071,1285,0,0,0,0,0,0,0,66.31 ,83.35 ,66.31 
01,000,02,010,0313,1053,952,20,972,1173,0,0,0,0,0,0,0,66.31 ,82.86 ,66.31 
01,000,02,010,0314,1054,1091,27,1118,1376,0,0,0,0,0,0,0,66.31 ,81.25 ,66.31 
01,000,02,010,0314,1055,1160,31,1191,1462,0,0,0,0,0,0,0,66.31 ,81.46 ,66.31 
01,000,02,010,0314,1056,1066,25,1091,1368,0,0,0,0,0,0,0,66.31 ,79.75 ,66.31 
01,000,02,010,0315,1057,1075,21,1096,1367,0,0,0,0,0,0,0,66.31 ,80.18 ,66.31 
01,000,02,010,0315,1058,1196,24,1220,1482,0,0,0,0,0,0,0,66.31 ,82.32 ,66.31 
01,000,02,010,0315,1059,1044,11,1055,1315,0,0,0,0,0,0,0,66.31 ,80.23 ,66.31 
01,000,02,010,0316,1060,830,13,843,1012,0,0,0,0,0,0,0,66.31 ,83.30 ,66.31 
01,000,02,010,0316,1061,872,15,887,1069,0,0,0,0,0,0,0,66.31 ,82.97 ,66.31 
01,000,02,010,0316,1062,846,15,861,1040,0,0,0,0,0,0,0,66.31 ,82.79 ,66.31 
01,000,02,010,0317,1063,860,14,874,1055,0,0,0,0,0,0,0,66.31 ,82.84 ,66.31 
01,000,02,010,0317,1064,1128,18,1146,1394,0,0,0,0,0,0,0,66.31 ,82.21 ,66.31 
01,000,02,010,0317,1065,983,20,1003,1188,0,0,0,0,0,0,0,66.31 ,84.43 ,66.31 
01,000,02,010,0318,1066,822,11,833,995,0,0,0,0,0,0,0,66.31 ,83.72 ,66.31 
01,000,02,010,0318,1067,1219,24,1243,1495,0,0,0,0,0,0,0,66.31 ,83.14 ,66.31 
01,000,02,010,0318,1068,1145,13,1158,1386,0,0,0,0,0,0,0,66.31 ,83.55 ,66.31 
01,000,02,010,0319,1069,1613,27,1640,1990,0,0,0,0,0,0,0,66.31 ,82.41 ,66.31 
01,000,02,010,0319,1070,1293,20,1313,1559,0,0,0,0,0,0,0,66.31 ,84.22 ,66.31 
01,000,02,010,0319,1071,1152,19,1171,1383,0,0,0,0,0,0,0,66.31 ,84.67 ,66.31 
01,000,02,010,0319,1072,717,8,725,871,0,0,0,0,0,0,0,66.31 ,83.24 ,66.31 
01,000,02,010,0319,1073,687,13,700,873,0,0,0,0,0,0,0,66.31 ,80.18 ,66.31 
01,000,02,010,0320,1074,1032,19,1051,1269,0,0,0,0,0,0,0,66.31 ,82.82 ,66.31 
01,000,02,010,0320,1075,1139,35,1174,1454,0,0,0,0,0,0,0,66.31 ,80.74 ,66.31 
01,000,02,010,0320,1076,1118,24,1142,1388,0,0,0,0,0,0,0,66.31 ,82.28 ,66.31 
01,000,02,010,0321,1077,735,29,764,969,0,0,0,0,0,0,0,66.31 ,78.84 ,66.31 
01,000,02,010,0321,1078,886,17,903,1175,0,0,0,0,0,0,0,66.31 ,76.85 ,66.31 
01,000,02,010,0321,1079,1023,12,1035,1296,0,0,0,0,0,0,0,66.31 ,79.86 ,66.31 
01,000,02,010,0322,1080,996,13,1009,1224,0,0,0,0,0,0,0,66.31 ,82.43 ,66.31 
01,000,02,010,0322,1081,883,28,911,1096,0,0,0,0,0,0,0,66.31 ,83.12 ,66.31 
01,000,02,010,0322,1082,966,10,976,1174,0,0,0,0,0,0,0,66.31 ,83.13 ,66.31 
01,000,02,010,0322,1083,960,21,981,1193,0,0,0,0,0,0,0,66.31 ,82.23 ,66.31 
01,000,02,010,0322,1084,877,7,884,1197,0,0,0,0,0,0,0,66.31 ,73.85 ,66.31 
01,000,02,010,0322,1085,1096,42,1138,1360,0,0,0,0,0,0,0,66.31 ,83.68 ,66.31 
01,000,02,010,0323,1086,906,16,922,1141,0,0,0,0,0,0,0,66.31 ,80.81 ,66.31 
01,000,02,010,0323,1087,912,20,932,1151,0,0,0,0,0,0,0,66.31 ,80.97 ,66.31 
01,000,02,010,0323,1088,1034,20,1054,1287,0,0,0,0,0,0,0,66.31 ,81.90 ,66.31 
01,000,02,010,0324,1089,1201,34,1235,1511,0,0,0,0,0,0,0,66.31 ,81.73 ,66.31 
01,000,02,010,0324,1090,1166,28,1194,1439,0,0,0,0,0,0,0,66.31 ,82.97 ,66.31 
01,000,02,010,0324,1091,1258,21,1279,1543,0,0,0,0,0,0,0,66.31 ,82.89 ,66.31 
01,000,02,010,0324,1092,1208,30,1238,1492,0,0,0,0,0,0,0,66.31 ,82.98 ,66.31 
01,000,02,010,0325,1093,1052,15,1067,1309,0,0,0,0,0,0,0,66.31 ,81.51 ,66.31 
01,000,02,010,0325,1094,880,27,907,1173,0,0,0,0,0,0,0,66.31 ,77.32 ,66.31 
01,000,02,010,0325,1095,828,21,849,1091,0,0,0,0,0,0,0,66.31 ,77.82 ,66.31 
01,000,02,010,0325,1096,1040,19,1059,1269,0,0,0,0,0,0,0,66.31 ,83.45 ,66.31 
01,000,02,010,0326,1097,1138,29,1167,1404,0,0,0,0,0,0,0,66.31 ,83.12 ,66.31 
01,000,02,010,0326,1098,1081,30,1111,1328,0,0,0,0,0,0,0,66.31 ,83.66 ,66.31 
01,000,02,010,0326,1099,1116,16,1132,1350,0,0,0,0,0,0,0,66.31 ,83.85 ,66.31 
01,000,02,010,0326,1100,1161,18,1179,1456,0,0,0,0,0,0,0,66.31 ,80.98 ,66.31 
01,000,02,010,0326,1101,1116,28,1144,1472,0,0,0,0,0,0,0,66.31 ,77.72 ,66.31 
01,000,02,010,0327,1102,1319,39,1358,1677,0,0,0,0,0,0,0,66.31 ,80.98 ,66.31 
01,000,02,010,0327,1103,1093,27,1120,1381,0,0,0,0,0,0,0,66.31 ,81.10 ,66.31 
01,000,02,010,0327,1104,1252,34,1286,1565,0,0,0,0,0,0,0,66.31 ,82.17 ,66.31 
01,000,02,010,0328,1105,859,17,876,1060,0,0,0,0,0,0,0,66.31 ,82.64 ,66.31 
01,000,02,010,0328,1106,881,12,893,1038,0,0,0,0,0,0,0,66.31 ,86.03 ,66.31 
01,000,02,010,0328,1107,857,8,865,1015,0,0,0,0,0,0,0,66.31 ,85.22 ,66.31 
01,000,02,010,0329,1108,1195,31,1226,1516,0,0,0,0,0,0,0,66.31 ,80.87 ,66.31 
01,000,02,010,0329,1109,1163,29,1192,1453,0,0,0,0,0,0,0,66.31 ,82.04 ,66.31 
01,000,02,010,0329,1110,930,14,944,1221,0,0,0,0,0,0,0,66.31 ,77.31 ,66.31 
01,000,02,010,0329,1111,1086,13,1099,1333,0,0,0,0,0,0,0,66.31 ,82.45 ,66.31 
01,000,02,010,0330,1112,1021,20,1041,1281,0,0,0,0,0,0,0,66.31 ,81.26 ,66.31 
01,000,02,010,0330,1113,1034,15,1049,1249,0,0,0,0,0,0,0,66.31 ,83.99 ,66.31 
01,000,02,010,0330,1114,874,27,901,1106,0,0,0,0,0,0,0,66.31 ,81.46 ,66.31 
01,000,02,010,0331,1115,1192,19,1211,1470,0,0,0,0,0,0,0,66.31 ,82.38 ,66.31 
01,000,02,010,0331,1116,984,24,1008,1212,0,0,0,0,0,0,0,66.31 ,83.17 ,66.31 
01,000,02,010,0332,1117,1192,23,1215,1482,0,0,0,0,0,0,0,66.31 ,81.98 ,66.31 
01,000,02,010,0332,1118,957,34,991,1256,0,0,0,0,0,0,0,66.31 ,78.90 ,66.31 
01,000,02,010,0332,1119,1060,31,1091,1393,0,0,0,0,0,0,0,66.31 ,78.32 ,66.31 
01,000,02,010,0332,1120,1341,24,1365,1666,0,0,0,0,0,0,0,66.31 ,81.93 ,66.31 
01,000,02,010,0333,1121,1222,32,1254,1487,0,0,0,0,0,0,0,66.31 ,84.33 ,66.31 
01,000,02,010,0333,1122,1225,28,1253,1506,0,0,0,0,0,0,0,66.31 ,83.20 ,66.31 
01,000,02,010,0333,1123,1094,17,1111,1311,0,0,0,0,0,0,0,66.31 ,84.74 ,66.31 
01,000,02,010,0334,1124,948,26,974,1205,0,0,0,0,0,0,0,66.31 ,80.83 ,66.31 
01,000,02,010,0334,1125,908,7,915,1130,0,0,0,0,0,0,0,66.31 ,80.97 ,66.31 
01,000,02,010,0334,1126,696,15,711,871,0,0,0,0,0,0,0,66.31 ,81.63 ,66.31 
01,000,02,010,0335,1127,1048,29,1077,1290,0,0,0,0,0,0,0,66.31 ,83.49 ,66.31 
01,000,02,010,0335,1128,1017,14,1031,1242,0,0,0,0,0,0,0,66.31 ,83.01 ,66.31 
01,000,02,010,0336,1129,939,21,960,1119,0,0,0,0,0,0,0,66.31 ,85.79 ,66.31 
01,000,02,010,0336,1130,1107,23,1130,1327,0,0,0,0,0,0,0,66.31 ,85.15 ,66.31 
01,000,02,010,0336,1131,1179,23,1202,1457,0,0,0,0,0,0,0,66.31 ,82.50 ,66.31 
01,000,02,010,0337,1132,821,20,841,981,0,0,0,0,0,0,0,66.31 ,85.73 ,66.31 
01,000,02,010,0337,1133,925,36,961,1136,0,0,0,0,0,0,0,66.31 ,84.60 ,66.31 
01,000,02,010,0337,1134,1062,16,1078,1260,0,0,0,0,0,0,0,66.31 ,85.56 ,66.31 
01,000,02,010,0338,1135,1268,19,1287,1500,0,0,0,0,0,0,0,66.31 ,85.80 ,66.31 
01,000,02,010,0338,1136,1097,15,1112,1371,0,0,0,0,0,0,0,66.31 ,81.11 ,66.31 
01,000,02,010,0338,1137,981,13,994,1172,0,0,0,0,0,0,0,66.31 ,84.81 ,66.31 
01,000,02,010,0339,1138,1028,13,1041,1264,0,0,0,0,0,0,0,66.31 ,82.36 ,66.31 
01,000,02,010,0339,1139,1081,19,1100,1329,0,0,0,0,0,0,0,66.31 ,82.77 ,66.31 
01,000,02,010,0339,1140,1008,25,1033,1278,0,0,0,0,0,0,0,66.31 ,80.83 ,66.31 
01,000,02,010,0340,1141,1125,21,1146,1358,0,0,0,0,0,0,0,66.31 ,84.39 ,66.31 
01,000,02,010,0340,1142,1268,26,1294,1563,0,0,0,0,0,0,0,66.31 ,82.79 ,66.31 
01,000,02,010,0340,1143,955,25,980,1152,0,0,0,0,0,0,0,66.31 ,85.07 ,66.31 
01,000,02,010,0340,1144,945,15,960,1147,0,0,0,0,0,0,0,66.31 ,83.70 ,66.31 
01,000,02,010,0341,1145,1368,30,1398,1702,0,0,0,0,0,0,0,66.31 ,82.14 ,66.31 
01,000,02,010,0341,1146,1006,30,1036,1256,0,0,0,0,0,0,0,66.31 ,82.48 ,66.31 
01,000,02,010,0341,1147,1021,23,1044,1273,0,0,0,0,0,0,0,66.31 ,82.01 ,66.31 
01,000,02,010,0342,1148,826,17,843,1014,0,0,0,0,0,0,0,66.31 ,83.14 ,66.31 
01,000,02,010,0342,1149,972,19,991,1189,0,0,0,0,0,0,0,66.31 ,83.35 ,66.31 
01,000,02,010,0342,1150,941,17,958,1160,0,0,0,0,0,0,0,66.31 ,82.59 ,66.31 
01,000,02,010,0342,1151,803,14,817,1014,0,0,0,0,0,0,0,66.31 ,80.57 ,66.31 
01,000,02,010,0343,1152,917,30,947,1152,0,0,0,0,0,0,0,66.31 ,82.20 ,66.31 
01,000,02,010,0343,1153,955,10,965,1157,0,0,0,0,0,0,0,66.31 ,83.41 ,66.31 
01,000,02,010,0343,1154,1022,25,1047,1317,0,0,0,0,0,0,0,66.31 ,79.50 ,66.31 
01,000,02,010,0344,1155,1012,20,1032,1317,0,0,0,0,0,0,0,66.31 ,78.36 ,66.31 
01,000,02,010,0344,1156,1027,11,1038,1246,0,0,0,0,0,0,0,66.31 ,83.31 ,66.31 
01,000,02,011,0345,1157,1115,16,1131,1443,0,0,0,0,0,0,0,66.31 ,78.38 ,66.31 
01,000,02,011,0345,1158,1080,19,1099,1547,0,0,0,0,0,0,0,66.31 ,71.04 ,66.31 
01,000,02,011,0345,1159,1031,23,1054,1461,0,0,0,0,0,0,0,66.31 ,72.14 ,66.31 
01,000,02,011,0346,1160,946,10,956,1284,0,0,0,0,0,0,0,66.31 ,74.45 ,66.31 
01,000,02,011,0346,1161,814,11,825,1120,0,0,0,0,0,0,0,66.31 ,73.66 ,66.31 
01,000,02,011,0346,1162,975,13,988,1307,0,0,0,0,0,0,0,66.31 ,75.59 ,66.31 
01,000,02,011,0347,1163,811,9,820,1140,0,0,0,0,0,0,0,66.31 ,71.93 ,66.31 
01,000,02,011,0347,1164,1025,24,1049,1350,0,0,0,0,0,0,0,66.31 ,77.70 ,66.31 
01,000,02,011,0347,1165,1130,14,1144,1391,0,0,0,0,0,0,0,66.31 ,82.24 ,66.31 
01,000,02,011,0347,1166,972,17,989,1237,0,0,0,0,0,0,0,66.31 ,79.95 ,66.31 
01,000,02,011,0348,1167,974,20,994,1276,0,0,0,0,0,0,0,66.31 ,77.90 ,66.31 
01,000,02,011,0348,1168,885,12,897,1221,0,0,0,0,0,0,0,66.31 ,73.46 ,66.31 
01,000,02,011,0348,1169,971,12,983,1258,0,0,0,0,0,0,0,66.31 ,78.14 ,66.31 
01,000,02,011,0348,1170,913,14,927,1246,0,0,0,0,0,0,0,66.31 ,74.40 ,66.31 
01,000,02,011,0348,1171,857,13,870,1242,0,0,0,0,0,0,0,66.31 ,70.05 ,66.31 
01,000,02,011,0349,1172,747,15,762,1056,0,0,0,0,0,0,0,66.31 ,72.16 ,66.31 
01,000,02,011,0349,1173,821,13,834,1218,0,0,0,0,0,0,0,66.31 ,68.47 ,66.31 
01,000,02,011,0349,1174,857,13,870,1211,0,0,0,0,0,0,0,66.31 ,71.84 ,66.31 
01,000,02,011,0349,1175,676,9,685,1007,0,0,0,0,0,0,0,66.31 ,68.02 ,66.31 
01,000,02,011,0350,1176,1066,11,1077,1405,0,0,0,0,0,0,0,66.31 ,76.65 ,66.31 
01,000,02,011,0350,1177,1163,15,1178,1510,0,0,0,0,0,0,0,66.31 ,78.01 ,66.31 
01,000,02,011,0350,1178,1073,13,1086,1368,0,0,0,0,0,0,0,66.31 ,79.39 ,66.31 
01,000,02,011,0350,1179,993,10,1003,1320,0,0,0,0,0,0,0,66.31 ,75.98 ,66.31 
01,000,02,011,0351,1180,838,17,855,1118,0,0,0,0,0,0,0,66.31 ,76.48 ,66.31 
01,000,02,011,0351,1181,925,17,942,1236,0,0,0,0,0,0,0,66.31 ,76.21 ,66.31 
01,000,02,011,0351,1182,712,7,719,1016,0,0,0,0,0,0,0,66.31 ,70.77 ,66.31 
01,000,02,011,0351,1183,1040,22,1062,1354,0,0,0,0,0,0,0,66.31 ,78.43 ,66.31 
01,000,02,011,0352,1184,797,9,806,1049,0,0,0,0,0,0,0,66.31 ,76.84 ,66.31 
01,000,02,011,0352,1185,768,11,779,1045,0,0,0,0,0,0,0,66.31 ,74.55 ,66.31 
01,000,02,011,0352,1186,854,14,868,1149,0,0,0,0,0,0,0,66.31 ,75.54 ,66.31 
01,000,02,011,0353,1187,895,9,904,1235,0,0,0,0,0,0,0,66.31 ,73.20 ,66.31 
01,000,02,011,0353,1188,953,16,969,1260,0,0,0,0,0,0,0,66.31 ,76.90 ,66.31 
01,000,02,011,0353,1189,828,10,838,1070,0,0,0,0,0,0,0,66.31 ,78.32 ,66.31 
01,000,02,011,0354,1190,1065,26,1091,1616,0,0,0,0,0,0,0,66.31 ,67.51 ,66.31 
01,000,02,011,0354,1191,1162,22,1184,1530,0,0,0,0,0,0,0,66.31 ,77.39 ,66.31 
01,000,02,011,0354,1192,1095,16,1111,1477,0,0,0,0,0,0,0,66.31 ,75.22 ,66.31 
01,000,02,011,0354,1193,1046,16,1062,1493,0,0,0,0,0,0,0,66.31 ,71.13 ,66.31 
01,000,02,011,0355,1194,1141,18,1159,1510,0,0,0,0,0,0,0,66.31 ,76.75 ,66.31 
01,000,02,011,0355,1195,974,19,993,1227,0,0,0,0,0,0,0,66.31 ,80.93 ,66.31 
01,000,02,011,0355,1196,1133,13,1146,1487,0,0,0,0,0,0,0,66.31 ,77.07 ,66.31 
01,000,02,011,0356,1197,763,14,777,1081,0,0,0,0,0,0,0,66.31 ,71.88 ,66.31 
01,000,02,011,0356,1198,943,11,954,1188,0,0,0,0,0,0,0,66.31 ,80.30 ,66.31 
01,000,02,011,0356,1199,881,25,906,1191,0,0,0,0,0,0,0,66.31 ,76.07 ,66.31 
01,000,02,011,0357,1200,825,10,835,1057,0,0,0,0,0,0,0,66.31 ,79.00 ,66.31 
01,000,02,011,0357,1201,787,17,804,1021,0,0,0,0,0,0,0,66.31 ,78.75 ,66.31 
01,000,02,011,0357,1202,899,12,911,1154,0,0,0,0,0,0,0,66.31 ,78.94 ,66.31 
01,000,02,011,0358,1203,879,14,893,1135,0,0,0,0,0,0,0,66.31 ,78.68 ,66.31 
01,000,02,011,0358,1204,1075,23,1098,1367,0,0,0,0,0,0,0,66.31 ,80.32 ,66.31 
01,000,02,011,0358,1205,1001,25,1026,1311,0,0,0,0,0,0,0,66.31 ,78.26 ,66.31 
01,000,02,011,0358,1206,885,13,898,1140,0,0,0,0,0,0,0,66.31 ,78.77 ,66.31 
01,000,02,011,0359,1207,1043,17,1060,1444,0,0,0,0,0,0,0,66.31 ,73.41 ,66.31 
01,000,02,011,0359,1208,937,13,950,1223,0,0,0,0,0,0,0,66.31 ,77.68 ,66.31 
01,000,02,011,0359,1209,958,22,980,1224,0,0,0,0,0,0,0,66.31 ,80.07 ,66.31 
01,000,02,011,0360,1210,955,13,968,1221,0,0,0,0,0,0,0,66.31 ,79.28 ,66.31 
01,000,02,011,0360,1211,823,10,833,1129,0,0,0,0,0,0,0,66.31 ,73.78 ,66.31 
01,000,02,011,0360,1212,1081,13,1094,1379,0,0,0,0,0,0,0,66.31 ,79.33 ,66.31 
01,000,02,011,0361,1213,992,8,1000,1238,0,0,0,0,0,0,0,66.31 ,80.78 ,66.31 
01,000,02,011,0361,1214,973,11,984,1262,0,0,0,0,0,0,0,66.31 ,77.97 ,66.31 
01,000,02,011,0361,1215,1064,23,1087,1391,0,0,0,0,0,0,0,66.31 ,78.15 ,66.31 
01,000,02,011,0362,1216,1045,9,1054,1319,0,0,0,0,0,0,0,66.31 ,79.91 ,66.31 
01,000,02,011,0362,1217,959,14,973,1240,0,0,0,0,0,0,0,66.31 ,78.47 ,66.31 
01,000,02,011,0363,1218,684,10,694,897,0,0,0,0,0,0,0,66.31 ,77.37 ,66.31 
01,000,02,011,0363,1219,848,7,855,1039,0,0,0,0,0,0,0,66.31 ,82.29 ,66.31 
01,000,02,011,0363,1220,684,10,694,881,0,0,0,0,0,0,0,66.31 ,78.77 ,66.31 
01,000,02,011,0364,1221,1126,23,1149,1430,0,0,0,0,0,0,0,66.31 ,80.35 ,66.31 
01,000,02,011,0364,1222,1020,15,1035,1269,0,0,0,0,0,0,0,66.31 ,81.56 ,66.31 
01,000,02,011,0364,1223,1068,6,1074,1326,0,0,0,0,0,0,0,66.31 ,81.00 ,66.31 
01,000,02,011,0365,1224,1124,9,1133,1430,0,0,0,0,0,0,0,66.31 ,79.23 ,66.31 
01,000,02,011,0365,1225,1070,24,1094,1375,0,0,0,0,0,0,0,66.31 ,79.56 ,66.31 
01,000,02,011,0365,1226,1052,14,1066,1334,0,0,0,0,0,0,0,66.31 ,79.91 ,66.31 
01,000,02,011,0366,1227,1008,16,1024,1301,0,0,0,0,0,0,0,66.31 ,78.71 ,66.31 
01,000,02,011,0366,1228,987,14,1001,1236,0,0,0,0,0,0,0,66.31 ,80.99 ,66.31 
01,000,02,011,0366,1229,895,20,915,1230,0,0,0,0,0,0,0,66.31 ,74.39 ,66.31 
01,000,02,011,0366,1230,1113,7,1120,1410,0,0,0,0,0,0,0,66.31 ,79.43 ,66.31 
01,000,02,011,0367,1231,1017,10,1027,1341,0,0,0,0,0,0,0,66.31 ,76.58 ,66.31 
01,000,02,011,0367,1232,933,8,941,1152,0,0,0,0,0,0,0,66.31 ,81.68 ,66.31 
01,000,02,011,0367,1233,1006,21,1027,1272,0,0,0,0,0,0,0,66.31 ,80.74 ,66.31 
01,000,02,011,0367,1234,915,10,925,1169,0,0,0,0,0,0,0,66.31 ,79.13 ,66.31 
01,000,02,011,0368,1235,1069,15,1084,1419,0,0,0,0,0,0,0,66.31 ,76.39 ,66.31 
01,000,02,011,0368,1236,1223,13,1236,1598,0,0,0,0,0,0,0,66.31 ,77.35 ,66.31 
01,000,02,011,0369,1237,995,14,1009,1232,0,0,0,0,0,0,0,66.31 ,81.90 ,66.31 
01,000,02,011,0369,1238,1099,20,1119,1402,0,0,0,0,0,0,0,66.31 ,79.81 ,66.31 
01,000,02,011,0369,1239,1052,13,1065,1403,0,0,0,0,0,0,0,66.31 ,75.91 ,66.31 
01,000,02,011,0370,1240,992,17,1009,1200,0,0,0,0,0,0,0,66.31 ,84.08 ,66.31 
01,000,02,011,0370,1241,934,14,948,1179,0,0,0,0,0,0,0,66.31 ,80.41 ,66.31 
01,000,02,011,0370,1242,849,8,857,1128,0,0,0,0,0,0,0,66.31 ,75.98 ,66.31 
01,000,02,011,0370,1243,949,14,963,1249,0,0,0,0,0,0,0,66.31 ,77.10 ,66.31 
01,000,02,011,0371,1244,1223,19,1242,1577,0,0,0,0,0,0,0,66.31 ,78.76 ,66.31 
01,000,02,011,0371,1245,1029,30,1059,1342,0,0,0,0,0,0,0,66.31 ,78.91 ,66.31 
01,000,02,011,0371,1246,1200,17,1217,1580,0,0,0,0,0,0,0,66.31 ,77.03 ,66.31 
01,000,02,011,0372,1247,1034,25,1059,1376,0,0,0,0,0,0,0,66.31 ,76.96 ,66.31 
01,000,02,011,0372,1248,1195,13,1208,1572,0,0,0,0,0,0,0,66.31 ,76.84 ,66.31 
01,000,02,011,0372,1249,1050,14,1064,1404,0,0,0,0,0,0,0,66.31 ,75.78 ,66.31 
01,000,02,011,0373,1250,1058,18,1076,1306,0,0,0,0,0,0,0,66.31 ,82.39 ,66.31 
01,000,02,011,0373,1251,1016,27,1043,1297,0,0,0,0,0,0,0,66.31 ,80.42 ,66.31 
01,000,02,011,0373,1252,1013,17,1030,1284,0,0,0,0,0,0,0,66.31 ,80.22 ,66.31 
01,000,02,011,0373,1253,884,18,902,1091,0,0,0,0,0,0,0,66.31 ,82.68 ,66.31 
01,000,02,011,0374,1254,1327,30,1357,1710,0,0,0,0,0,0,0,66.31 ,79.36 ,66.31 
01,000,02,011,0374,1255,1085,10,1095,1369,0,0,0,0,0,0,0,66.31 ,79.99 ,66.31 
01,000,02,011,0374,1256,1104,25,1129,1402,0,0,0,0,0,0,0,66.31 ,80.53 ,66.31 
01,000,02,011,0375,1257,1018,27,1045,1281,0,0,0,0,0,0,0,66.31 ,81.58 ,66.31 
01,000,02,011,0375,1258,829,32,861,1055,0,0,0,0,0,0,0,66.31 ,81.61 ,66.31 
01,000,02,011,0375,1259,954,28,982,1224,0,0,0,0,0,0,0,66.31 ,80.23 ,66.31 
01,000,02,011,0376,1260,938,19,957,1201,0,0,0,0,0,0,0,66.31 ,79.68 ,66.31 
01,000,02,011,0376,1261,908,19,927,1169,0,0,0,0,0,0,0,66.31 ,79.30 ,66.31 
01,000,02,011,0376,1262,818,9,827,1041,0,0,0,0,0,0,0,66.31 ,79.44 ,66.31 
01,000,02,011,0377,1263,833,2,835,1099,0,0,0,0,0,0,0,66.31 ,75.98 ,66.31 
01,000,02,011,0377,1264,905,11,916,1182,0,0,0,0,0,0,0,66.31 ,77.50 ,66.31 
01,000,02,011,0377,1265,878,18,896,1142,0,0,0,0,0,0,0,66.31 ,78.46 ,66.31 
01,000,02,011,0378,1266,930,12,942,1235,0,0,0,0,0,0,0,66.31 ,76.28 ,66.31 
01,000,02,011,0378,1267,814,16,830,1011,0,0,0,0,0,0,0,66.31 ,82.10 ,66.31 
01,000,02,011,0378,1268,943,14,957,1290,0,0,0,0,0,0,0,66.31 ,74.19 ,66.31 
01,000,02,011,0378,1269,1060,7,1067,1399,0,0,0,0,0,0,0,66.31 ,76.27 ,66.31 
01,000,02,011,0379,1270,1163,10,1173,1476,0,0,0,0,0,0,0,66.31 ,79.47 ,66.31 
01,000,02,011,0379,1271,1221,8,1229,1526,0,0,0,0,0,0,0,66.31 ,80.54 ,66.31 
01,000,02,011,0379,1272,1168,16,1184,1479,0,0,0,0,0,0,0,66.31 ,80.05 ,66.31 
01,000,02,011,0379,1273,1095,13,1108,1348,0,0,0,0,0,0,0,66.31 ,82.20 ,66.31 
01,000,02,011,0380,1274,858,12,870,1122,0,0,0,0,0,0,0,66.31 ,77.54 ,66.31 
01,000,02,011,0380,1275,1092,15,1107,1473,0,0,0,0,0,0,0,66.31 ,75.15 ,66.31 
01,000,02,011,0381,1276,940,24,964,1203,0,0,0,0,0,0,0,66.31 ,80.13 ,66.31 
01,000,02,011,0381,1277,989,8,997,1284,0,0,0,0,0,0,0,66.31 ,77.65 ,66.31 
01,000,02,011,0382,1278,968,13,981,1246,0,0,0,0,0,0,0,66.31 ,78.73 ,66.31 
01,000,02,011,0382,1279,1021,12,1033,1337,0,0,0,0,0,0,0,66.31 ,77.26 ,66.31 
01,000,02,011,0382,1280,1137,13,1150,1434,0,0,0,0,0,0,0,66.31 ,80.20 ,66.31 
01,000,02,011,0382,1281,1081,10,1091,1426,0,0,0,0,0,0,0,66.31 ,76.51 ,66.31 
01,000,02,011,0382,1282,1070,10,1080,1345,0,0,0,0,0,0,0,66.31 ,80.30 ,66.31 
01,000,02,011,0383,1283,964,24,988,1311,0,0,0,0,0,0,0,66.31 ,75.36 ,66.31 
01,000,02,011,0383,1284,727,12,739,1015,0,0,0,0,0,0,0,66.31 ,72.81 ,66.31 
01,000,02,011,0383,1285,1175,16,1191,1518,0,0,0,0,0,0,0,66.31 ,78.46 ,66.31 
01,000,02,011,0384,1286,785,21,806,986,0,0,0,0,0,0,0,66.31 ,81.74 ,66.31 
01,000,02,011,0384,1287,708,10,718,1030,0,0,0,0,0,0,0,66.31 ,69.71 ,66.31 
01,000,02,011,0385,1288,1125,12,1137,1469,0,0,0,0,0,0,0,66.31 ,77.40 ,66.31 
01,000,02,011,0385,1289,1000,24,1024,1320,0,0,0,0,0,0,0,66.31 ,77.58 ,66.31 
01,000,02,011,0385,1290,1000,12,1012,1317,0,0,0,0,0,0,0,66.31 ,76.84 ,66.31 
01,000,02,011,0385,1291,778,14,792,1078,0,0,0,0,0,0,0,66.31 ,73.47 ,66.31 
01,000,02,011,0385,1292,927,7,934,1207,0,0,0,0,0,0,0,66.31 ,77.38 ,66.31 
01,000,02,011,0386,1293,947,15,962,1157,0,0,0,0,0,0,0,66.31 ,83.15 ,66.31 
01,000,02,011,0386,1294,936,18,954,1174,0,0,0,0,0,0,0,66.31 ,81.26 ,66.31 
01,000,02,011,0386,1295,1005,22,1027,1256,0,0,0,0,0,0,0,66.31 ,81.77 ,66.31 
01,000,02,011,0386,1296,970,13,983,1242,0,0,0,0,0,0,0,66.31 ,79.15 ,66.31 
01,000,02,011,0387,1297,674,21,695,898,0,0,0,0,0,0,0,66.31 ,77.39 ,66.31 
01,000,02,011,0387,1298,636,19,655,931,0,0,0,0,0,0,0,66.31 ,70.35 ,66.31 
01,000,02,011,0388,1299,832,19,851,1040,0,0,0,0,0,0,0,66.31 ,81.83 ,66.31 
01,000,02,011,0388,1300,977,16,993,1221,0,0,0,0,0,0,0,66.31 ,81.33 ,66.31 
01,000,02,011,0388,1301,937,23,960,1178,0,0,0,0,0,0,0,66.31 ,81.49 ,66.31 
01,000,02,011,0388,1302,801,27,828,992,0,0,0,0,0,0,0,66.31 ,83.47 ,66.31 
01,000,02,011,0389,1303,957,7,964,1216,0,0,0,0,0,0,0,66.31 ,79.28 ,66.31 
01,000,02,011,0389,1304,1035,11,1046,1260,0,0,0,0,0,0,0,66.31 ,83.02 ,66.31 
01,000,02,011,0389,1305,1086,18,1104,1328,0,0,0,0,0,0,0,66.31 ,83.13 ,66.31 
01,000,02,011,0389,1306,854,19,873,1087,0,0,0,0,0,0,0,66.31 ,80.31 ,66.31 
01,000,02,011,0389,1307,840,18,858,1059,0,0,0,0,0,0,0,66.31 ,81.02 ,66.31 
01,000,02,011,0390,1308,733,11,744,942,0,0,0,0,0,0,0,66.31 ,78.98 ,66.31 
01,000,02,011,0390,1309,988,8,996,1186,0,0,0,0,0,0,0,66.31 ,83.98 ,66.31 
01,000,02,011,0390,1310,945,29,974,1181,0,0,0,0,0,0,0,66.31 ,82.47 ,66.31 
01,000,02,011,0391,1311,1053,13,1066,1456,0,0,0,0,0,0,0,66.31 ,73.21 ,66.31 
01,000,02,011,0391,1312,778,17,795,1144,0,0,0,0,0,0,0,66.31 ,69.49 ,66.31 
01,000,02,011,0391,1313,1030,14,1044,1390,0,0,0,0,0,0,0,66.31 ,75.11 ,66.31 
01,000,02,011,0392,1314,819,13,832,1202,0,0,0,0,0,0,0,66.31 ,69.22 ,66.31 
01,000,02,011,0392,1315,806,10,816,1095,0,0,0,0,0,0,0,66.31 ,74.52 ,66.31 
01,000,02,011,0392,1316,816,16,832,1108,0,0,0,0,0,0,0,66.31 ,75.09 ,66.31 
01,000,02,011,0392,1317,937,15,952,1261,0,0,0,0,0,0,0,66.31 ,75.50 ,66.31 
01,000,02,011,0393,1318,853,16,869,1155,0,0,0,0,0,0,0,66.31 ,75.24 ,66.31 
01,000,02,011,0393,1319,908,21,929,1164,0,0,0,0,0,0,0,66.31 ,79.81 ,66.31 
01,000,02,011,0393,1320,831,24,855,1146,0,0,0,0,0,0,0,66.31 ,74.61 ,66.31 
01,000,02,011,0393,1321,1010,12,1022,1327,0,0,0,0,0,0,0,66.31 ,77.02 ,66.31 
01,000,02,011,0394,1322,917,8,925,1209,0,0,0,0,0,0,0,66.31 ,76.51 ,66.31 
01,000,02,011,0394,1323,921,23,944,1177,0,0,0,0,0,0,0,66.31 ,80.20 ,66.31 
01,000,02,011,0394,1324,972,23,995,1392,0,0,0,0,0,0,0,66.31 ,71.48 ,66.31 
01,000,02,011,0395,1325,931,14,945,1202,0,0,0,0,0,0,0,66.31 ,78.62 ,66.31 
01,000,02,011,0395,1326,781,13,794,1029,0,0,0,0,0,0,0,66.31 ,77.16 ,66.31 
01,000,02,011,0395,1327,885,13,898,1130,0,0,0,0,0,0,0,66.31 ,79.47 ,66.31 
01,000,02,011,0395,1328,937,13,950,1238,0,0,0,0,0,0,0,66.31 ,76.74 ,66.31 
01,000,02,011,0396,1329,769,11,780,1060,0,0,0,0,0,0,0,66.31 ,73.58 ,66.31 
01,000,02,011,0396,1330,847,19,866,1086,0,0,0,0,0,0,0,66.31 ,79.74 ,66.31 
01,000,02,011,0396,1331,928,13,941,1212,0,0,0,0,0,0,0,66.31 ,77.64 ,66.31 
01,000,02,011,0397,1332,929,24,953,1221,0,0,0,0,0,0,0,66.31 ,78.05 ,66.31 
01,000,02,011,0397,1333,1090,25,1115,1491,0,0,0,0,0,0,0,66.31 ,74.78 ,66.31 
01,000,02,011,0397,1334,788,18,806,1096,0,0,0,0,0,0,0,66.31 ,73.54 ,66.31 
01,000,02,011,0397,1335,999,24,1023,1304,0,0,0,0,0,0,0,66.31 ,78.45 ,66.31 
01,000,02,011,0398,1336,833,16,849,1075,0,0,0,0,0,0,0,66.31 ,78.98 ,66.31 
01,000,02,011,0398,1337,869,19,888,1111,0,0,0,0,0,0,0,66.31 ,79.93 ,66.31 
01,000,02,011,0398,1338,960,14,974,1266,0,0,0,0,0,0,0,66.31 ,76.94 ,66.31 
01,000,02,011,0398,1339,896,11,907,1173,0,0,0,0,0,0,0,66.31 ,77.32 ,66.31 
01,000,02,011,0398,1340,1012,18,1030,1316,0,0,0,0,0,0,0,66.31 ,78.27 ,66.31 
01,000,02,012,0399,1341,1187,21,1208,1448,0,0,0,0,0,0,0,66.31 ,83.43 ,66.31 
01,000,02,012,0399,1342,1055,9,1064,1287,0,0,0,0,0,0,0,66.31 ,82.67 ,66.31 
01,000,02,012,0399,1343,920,11,931,1150,0,0,0,0,0,0,0,66.31 ,80.96 ,66.31 
01,000,02,012,0400,1344,968,22,990,1230,0,0,0,0,0,0,0,66.31 ,80.49 ,66.31 
01,000,02,012,0400,1345,949,18,967,1195,0,0,0,0,0,0,0,66.31 ,80.92 ,66.31 
01,000,02,012,0400,1346,924,20,944,1147,0,0,0,0,0,0,0,66.31 ,82.30 ,66.31 
01,000,02,012,0400,1347,987,9,996,1195,0,0,0,0,0,0,0,66.31 ,83.35 ,66.31 
01,000,02,012,0401,1348,981,18,999,1206,0,0,0,0,0,0,0,66.31 ,82.84 ,66.31 
01,000,02,012,0401,1349,964,13,977,1161,0,0,0,0,0,0,0,66.31 ,84.15 ,66.31 
01,000,02,012,0401,1350,787,15,802,995,0,0,0,0,0,0,0,66.31 ,80.60 ,66.31 
01,000,02,012,0402,1351,920,17,937,1174,0,0,0,0,0,0,0,66.31 ,79.81 ,66.31 
01,000,02,012,0402,1352,943,17,960,1169,0,0,0,0,0,0,0,66.31 ,82.12 ,66.31 
01,000,02,012,0402,1353,985,8,993,1206,0,0,0,0,0,0,0,66.31 ,82.34 ,66.31 
01,000,02,012,0402,1354,1009,22,1031,1234,0,0,0,0,0,0,0,66.31 ,83.55 ,66.31 
01,000,02,012,0403,1355,910,24,934,1125,0,0,0,0,0,0,0,66.31 ,83.02 ,66.31 
01,000,02,012,0403,1356,954,23,977,1206,0,0,0,0,0,0,0,66.31 ,81.01 ,66.31 
01,000,02,012,0403,1357,1118,6,1124,1318,0,0,0,0,0,0,0,66.31 ,85.28 ,66.31 
01,000,02,012,0404,1358,1158,18,1176,1453,0,0,0,0,0,0,0,66.31 ,80.94 ,66.31 
01,000,02,012,0404,1359,1185,16,1201,1493,0,0,0,0,0,0,0,66.31 ,80.44 ,66.31 
01,000,02,012,0404,1360,1123,9,1132,1356,0,0,0,0,0,0,0,66.31 ,83.48 ,66.31 
01,000,02,012,0405,1361,1087,21,1108,1324,0,0,0,0,0,0,0,66.31 ,83.69 ,66.31 
01,000,02,012,0405,1362,883,15,898,1075,0,0,0,0,0,0,0,66.31 ,83.53 ,66.31 
01,000,02,012,0405,1363,950,3,953,1128,0,0,0,0,0,0,0,66.31 ,84.49 ,66.31 
01,000,02,012,0406,1364,985,19,1004,1197,0,0,0,0,0,0,0,66.31 ,83.88 ,66.31 
01,000,02,012,0406,1365,901,18,919,1105,0,0,0,0,0,0,0,66.31 ,83.17 ,66.31 
01,000,02,012,0406,1366,1005,23,1028,1226,0,0,0,0,0,0,0,66.31 ,83.85 ,66.31 
01,000,02,012,0407,1367,1170,13,1183,1458,0,0,0,0,0,0,0,66.31 ,81.14 ,66.31 
01,000,02,012,0407,1368,1134,15,1149,1394,0,0,0,0,0,0,0,66.31 ,82.42 ,66.31 
01,000,02,012,0407,1369,1212,13,1225,1479,0,0,0,0,0,0,0,66.31 ,82.83 ,66.31 
01,000,02,012,0408,1370,980,23,1003,1247,0,0,0,0,0,0,0,66.31 ,80.43 ,66.31 
01,000,02,012,0408,1371,1032,27,1059,1347,0,0,0,0,0,0,0,66.31 ,78.62 ,66.31 
01,000,02,012,0408,1372,1127,16,1143,1441,0,0,0,0,0,0,0,66.31 ,79.32 ,66.31 
01,000,02,012,0409,1373,1207,25,1232,1474,0,0,0,0,0,0,0,66.31 ,83.58 ,66.31 
01,000,02,012,0409,1374,1152,26,1178,1393,0,0,0,0,0,0,0,66.31 ,84.57 ,66.31 
01,000,02,012,0410,1375,962,14,976,1228,0,0,0,0,0,0,0,66.31 ,79.48 ,66.31 
01,000,02,012,0410,1376,1062,22,1084,1343,0,0,0,0,0,0,0,66.31 ,80.71 ,66.31 
01,000,02,012,0410,1377,942,12,954,1187,0,0,0,0,0,0,0,66.31 ,80.37 ,66.31 
01,000,02,012,0411,1378,1231,17,1248,1504,0,0,0,0,0,0,0,66.31 ,82.98 ,66.31 
01,000,02,012,0411,1379,1126,30,1156,1415,0,0,0,0,0,0,0,66.31 ,81.70 ,66.31 
01,000,02,012,0411,1380,1115,7,1122,1397,0,0,0,0,0,0,0,66.31 ,80.31 ,66.31 
01,000,02,012,0411,1381,1171,25,1196,1426,0,0,0,0,0,0,0,66.31 ,83.87 ,66.31 
01,000,02,012,0412,1382,937,25,962,1183,0,0,0,0,0,0,0,66.31 ,81.32 ,66.31 
01,000,02,012,0412,1383,934,16,950,1182,0,0,0,0,0,0,0,66.31 ,80.37 ,66.31 
01,000,02,012,0412,1384,1109,16,1125,1341,0,0,0,0,0,0,0,66.31 ,83.89 ,66.31 
01,000,02,012,0413,1385,809,16,825,994,0,0,0,0,0,0,0,66.31 ,83.00 ,66.31 
01,000,02,012,0413,1386,1269,14,1283,1511,0,0,0,0,0,0,0,66.31 ,84.91 ,66.31 
01,000,02,012,0413,1387,1392,19,1411,1735,0,0,0,0,0,0,0,66.31 ,81.33 ,66.31 
01,000,02,012,0414,1388,1213,17,1230,1498,0,0,0,0,0,0,0,66.31 ,82.11 ,66.31 
01,000,02,012,0414,1389,1248,13,1261,1567,0,0,0,0,0,0,0,66.31 ,80.47 ,66.31 
01,000,02,012,0414,1390,1205,25,1230,1533,0,0,0,0,0,0,0,66.31 ,80.23 ,66.31 
01,000,02,012,0415,1391,1207,10,1217,1487,0,0,0,0,0,0,0,66.31 ,81.84 ,66.31 
01,000,02,012,0415,1392,1154,18,1172,1390,0,0,0,0,0,0,0,66.31 ,84.32 ,66.31 
01,000,02,012,0415,1393,1063,21,1084,1342,0,0,0,0,0,0,0,66.31 ,80.77 ,66.31 
01,000,02,012,0416,1394,1242,16,1258,1513,0,0,0,0,0,0,0,66.31 ,83.15 ,66.31 
01,000,02,012,0416,1395,1033,19,1052,1293,0,0,0,0,0,0,0,66.31 ,81.36 ,66.31 
01,000,02,012,0416,1396,1194,13,1207,1472,0,0,0,0,0,0,0,66.31 ,82.00 ,66.31 
01,000,02,012,0417,1397,1142,19,1161,1365,0,0,0,0,0,0,0,66.31 ,85.05 ,66.31 
01,000,02,012,0417,1398,1166,29,1195,1452,0,0,0,0,0,0,0,66.31 ,82.30 ,66.31 
01,000,02,012,0417,1399,1220,23,1243,1479,0,0,0,0,0,0,0,66.31 ,84.04 ,66.31 
01,000,02,012,0418,1400,1345,35,1380,1690,0,0,0,0,0,0,0,66.31 ,81.66 ,66.31 
01,000,02,012,0418,1401,1032,15,1047,1263,0,0,0,0,0,0,0,66.31 ,82.90 ,66.31 
01,000,02,012,0418,1402,1203,19,1222,1509,0,0,0,0,0,0,0,66.31 ,80.98 ,66.31 
01,000,02,012,0419,1403,1227,21,1248,1486,0,0,0,0,0,0,0,66.31 ,83.98 ,66.31 
01,000,02,012,0419,1404,1113,24,1137,1381,0,0,0,0,0,0,0,66.31 ,82.33 ,66.31 
01,000,02,012,0420,1405,1028,15,1043,1300,0,0,0,0,0,0,0,66.31 ,80.23 ,66.31 
01,000,02,012,0420,1406,1099,23,1122,1354,0,0,0,0,0,0,0,66.31 ,82.87 ,66.31 
01,000,02,012,0420,1407,1164,15,1179,1422,0,0,0,0,0,0,0,66.31 ,82.91 ,66.31 
01,000,02,012,0421,1408,1070,14,1084,1298,0,0,0,0,0,0,0,66.31 ,83.51 ,66.31 
01,000,02,012,0421,1409,735,21,756,984,0,0,0,0,0,0,0,66.31 ,76.83 ,66.31 
01,000,02,012,0421,1410,952,9,961,1155,0,0,0,0,0,0,0,66.31 ,83.20 ,66.31 
01,000,02,012,0421,1411,1066,20,1086,1310,0,0,0,0,0,0,0,66.31 ,82.90 ,66.31 
01,000,02,012,0422,1412,1085,17,1102,1320,0,0,0,0,0,0,0,66.31 ,83.48 ,66.31 
01,000,02,012,0422,1413,1038,19,1057,1300,0,0,0,0,0,0,0,66.31 ,81.31 ,66.31 
01,000,02,012,0422,1414,1013,18,1031,1283,0,0,0,0,0,0,0,66.31 ,80.36 ,66.31 
01,000,02,012,0422,1415,1024,28,1052,1334,0,0,0,0,0,0,0,66.31 ,78.86 ,66.31 
01,000,02,012,0423,1416,830,58,888,1187,0,0,0,0,0,0,0,66.31 ,74.81 ,66.31 
01,000,02,012,0423,1417,660,32,692,988,0,0,0,0,0,0,0,66.31 ,70.04 ,66.31 
01,000,02,012,0423,1418,1138,19,1157,1413,0,0,0,0,0,0,0,66.31 ,81.88 ,66.31 
01,000,02,012,0424,1419,1050,23,1073,1306,0,0,0,0,0,0,0,66.31 ,82.16 ,66.31 
01,000,02,012,0424,1420,1037,30,1067,1355,0,0,0,0,0,0,0,66.31 ,78.75 ,66.31 
01,000,02,012,0424,1421,957,16,973,1182,0,0,0,0,0,0,0,66.31 ,82.32 ,66.31 
01,000,02,012,0424,1422,1127,18,1145,1346,0,0,0,0,0,0,0,66.31 ,85.07 ,66.31 
01,000,02,012,0425,1423,1171,21,1192,1420,0,0,0,0,0,0,0,66.31 ,83.94 ,66.31 
01,000,02,012,0425,1424,1200,30,1230,1465,0,0,0,0,0,0,0,66.31 ,83.96 ,66.31 
01,000,02,012,0425,1425,1091,24,1115,1319,0,0,0,0,0,0,0,66.31 ,84.53 ,66.31 
01,000,02,012,0425,1426,1272,22,1294,1554,0,0,0,0,0,0,0,66.31 ,83.27 ,66.31 
01,000,02,012,0426,1427,1094,25,1119,1363,0,0,0,0,0,0,0,66.31 ,82.10 ,66.31 
01,000,02,012,0426,1428,998,22,1020,1254,0,0,0,0,0,0,0,66.31 ,81.34 ,66.31 
01,000,02,012,0426,1429,1185,32,1217,1471,0,0,0,0,0,0,0,66.31 ,82.73 ,66.31 
01,000,02,012,0426,1430,1032,6,1038,1279,0,0,0,0,0,0,0,66.31 ,81.16 ,66.31 
01,000,02,012,0426,1431,887,26,913,1115,0,0,0,0,0,0,0,66.31 ,81.88 ,66.31 
01,000,02,012,0427,1432,1261,31,1292,1554,0,0,0,0,0,0,0,66.31 ,83.14 ,66.31 
01,000,02,012,0427,1433,1271,17,1288,1517,0,0,0,0,0,0,0,66.31 ,84.90 ,66.31 
01,000,02,012,0427,1434,1161,18,1179,1441,0,0,0,0,0,0,0,66.31 ,81.82 ,66.31 
01,000,02,012,0427,1435,1263,21,1284,1592,0,0,0,0,0,0,0,66.31 ,80.65 ,66.31 
01,000,02,012,0427,1436,1148,23,1171,1436,0,0,0,0,0,0,0,66.31 ,81.55 ,66.31 
01,000,02,012,0428,1437,1030,12,1042,1303,0,0,0,0,0,0,0,66.31 ,79.97 ,66.31 
01,000,02,012,0428,1438,1106,19,1125,1342,0,0,0,0,0,0,0,66.31 ,83.83 ,66.31 
01,000,02,012,0428,1439,1139,18,1157,1378,0,0,0,0,0,0,0,66.31 ,83.96 ,66.31 
01,000,02,012,0428,1440,913,10,923,1119,0,0,0,0,0,0,0,66.31 ,82.48 ,66.31 
01,000,02,012,0428,1441,1076,24,1100,1315,0,0,0,0,0,0,0,66.31 ,83.65 ,66.31 
01,000,02,012,0429,1442,1045,17,1062,1261,0,0,0,0,0,0,0,66.31 ,84.22 ,66.31 
01,000,02,012,0429,1443,1020,12,1032,1231,0,0,0,0,0,0,0,66.31 ,83.83 ,66.31 
01,000,02,012,0429,1444,868,22,890,1119,0,0,0,0,0,0,0,66.31 ,79.54 ,66.31 
01,000,02,012,0429,1445,1081,20,1101,1349,0,0,0,0,0,0,0,66.31 ,81.62 ,66.31 
01,000,02,012,0429,1446,1332,28,1360,1621,0,0,0,0,0,0,0,66.31 ,83.90 ,66.31 
01,000,02,012,0429,1447,1188,19,1207,1455,0,0,0,0,0,0,0,66.31 ,82.96 ,66.31 
01,000,02,012,0430,1448,1362,27,1389,1671,0,0,0,0,0,0,0,66.31 ,83.12 ,66.31 
01,000,02,012,0430,1449,1167,23,1190,1437,0,0,0,0,0,0,0,66.31 ,82.81 ,66.31 
01,000,02,012,0430,1450,880,16,896,1106,0,0,0,0,0,0,0,66.31 ,81.01 ,66.31 
01,000,02,012,0430,1451,1089,21,1110,1325,0,0,0,0,0,0,0,66.31 ,83.77 ,66.31 
01,000,02,012,0430,1452,1251,15,1266,1510,0,0,0,0,0,0,0,66.31 ,83.84 ,66.31 
01,000,02,012,0431,1453,736,12,748,896,0,0,0,0,0,0,0,66.31 ,83.48 ,66.31 
01,000,02,012,0431,1454,1127,19,1146,1405,0,0,0,0,0,0,0,66.31 ,81.57 ,66.31 
01,000,02,012,0431,1455,1098,21,1119,1373,0,0,0,0,0,0,0,66.31 ,81.50 ,66.31 
01,000,02,012,0431,1456,1027,15,1042,1229,0,0,0,0,0,0,0,66.31 ,84.78 ,66.31 
01,000,02,012,0431,1457,1132,26,1158,1432,0,0,0,0,0,0,0,66.31 ,80.87 ,66.31 
01,000,02,012,0431,1458,1497,21,1518,1848,0,0,0,0,0,0,0,66.31 ,82.14 ,66.31 
01,000,02,012,0432,1459,1066,23,1089,1357,0,0,0,0,0,0,0,66.31 ,80.25 ,66.31 
01,000,02,012,0432,1460,1224,27,1251,1589,0,0,0,0,0,0,0,66.31 ,78.73 ,66.31 
01,000,02,012,0433,1461,1251,23,1274,1631,0,0,0,0,0,0,0,66.31 ,78.11 ,66.31 
01,000,02,012,0433,1462,1316,23,1339,1644,0,0,0,0,0,0,0,66.31 ,81.45 ,66.31 
01,000,02,012,0433,1463,1273,27,1300,1588,0,0,0,0,0,0,0,66.31 ,81.86 ,66.31 
01,000,02,012,0433,1464,1032,27,1059,1287,0,0,0,0,0,0,0,66.31 ,82.28 ,66.31 
01,000,02,012,0434,1465,1059,25,1084,1330,0,0,0,0,0,0,0,66.31 ,81.50 ,66.31 
01,000,02,012,0434,1466,567,21,588,696,0,0,0,0,0,0,0,66.31 ,84.48 ,66.31 
01,000,02,012,0435,1467,518,12,530,621,0,0,0,0,0,0,0,66.31 ,85.35 ,66.31 
02,000,01,001,0001,1,803,20,823,1021,0,0,0,0,0,0,0,66.31 ,80.61 ,66.31 
02,000,01,001,0002,2,523,8,531,647,0,0,0,0,0,0,0,66.31 ,82.07 ,66.31 
02,000,01,001,0003,3,804,19,823,957,0,0,0,0,0,0,0,66.31 ,86.00 ,66.31 
02,000,01,001,0004,4,1049,16,1065,1334,0,0,0,0,0,0,0,66.31 ,79.84 ,66.31 
02,000,01,001,0005,5,1059,6,1065,1316,0,0,0,0,0,0,0,66.31 ,80.93 ,66.31 
02,000,01,001,0006,6,1737,32,1769,2182,0,0,0,0,0,0,0,66.31 ,81.07 ,66.31 
02,000,01,001,0007,7,665,9,674,839,0,0,0,0,0,0,0,66.31 ,80.33 ,66.31 
02,000,01,001,0008,8,583,11,594,732,0,0,0,0,0,0,0,66.31 ,81.15 ,66.31 
02,000,01,001,0009,9,890,19,909,1128,0,0,0,0,0,0,0,66.31 ,80.59 ,66.31 
02,000,01,001,0010,10,697,9,706,896,0,0,0,0,0,0,0,66.31 ,78.79 ,66.31 
02,000,01,001,0011,11,1447,20,1467,1889,0,0,0,0,0,0,0,66.31 ,77.66 ,66.31 
02,000,01,001,0012,12,838,15,853,1110,0,0,0,0,0,0,0,66.31 ,76.85 ,66.31 
02,000,01,001,0013,13,882,19,901,1166,0,0,0,0,0,0,0,66.31 ,77.27 ,66.31 
02,000,01,001,0014,14,903,21,924,1162,0,0,0,0,0,0,0,66.31 ,79.52 ,66.31 
02,000,01,001,0015,15,975,11,986,1248,0,0,0,0,0,0,0,66.31 ,79.01 ,66.31 
02,000,01,001,0016,16,570,13,583,678,0,0,0,0,0,0,0,66.31 ,85.99 ,66.31 
02,000,01,001,0017,17,1267,28,1295,1692,0,0,0,0,0,0,0,66.31 ,76.54 ,66.31 
02,000,01,001,0018,18,1069,12,1081,1338,0,0,0,0,0,0,0,66.31 ,80.79 ,66.31 
02,000,01,001,0019,19,581,11,592,730,0,0,0,0,0,0,0,66.31 ,81.10 ,66.31 
02,000,01,001,0020,20,649,17,666,853,0,0,0,0,0,0,0,66.31 ,78.08 ,66.31 
02,000,01,001,0021,21,740,10,750,941,0,0,0,0,0,0,0,66.31 ,79.70 ,66.31 
02,000,01,002,0022,22,791,17,808,1022,0,0,0,0,0,0,0,66.31 ,79.06 ,66.31 
02,000,01,002,0022,23,782,13,795,1000,0,0,0,0,0,0,0,66.31 ,79.50 ,66.31 
02,000,01,002,0023,24,812,19,831,1045,0,0,0,0,0,0,0,66.31 ,79.52 ,66.31 
02,000,01,002,0023,25,778,12,790,981,0,0,0,0,0,0,0,66.31 ,80.53 ,66.31 
02,000,01,002,0024,26,1066,12,1078,1282,0,0,0,0,0,0,0,66.31 ,84.09 ,66.31 
02,000,01,002,0024,27,1227,16,1243,1526,0,0,0,0,0,0,0,66.31 ,81.45 ,66.31 
02,000,01,002,0024,28,1042,8,1050,1244,0,0,0,0,0,0,0,66.31 ,84.41 ,66.31 
02,000,01,002,0025,29,1047,22,1069,1264,0,0,0,0,0,0,0,66.31 ,84.57 ,66.31 
02,000,01,002,0025,30,1114,16,1130,1362,0,0,0,0,0,0,0,66.31 ,82.97 ,66.31 
02,000,01,002,0025,31,1118,12,1130,1397,0,0,0,0,0,0,0,66.31 ,80.89 ,66.31 
02,000,01,002,0026,32,1133,25,1158,1417,0,0,0,0,0,0,0,66.31 ,81.72 ,66.31 
02,000,01,002,0027,33,1037,22,1059,1285,0,0,0,0,0,0,0,66.31 ,82.41 ,66.31 
02,000,01,002,0028,34,820,26,846,1022,0,0,0,0,0,0,0,66.31 ,82.78 ,66.31 
02,000,01,002,0028,35,814,9,823,1018,0,0,0,0,0,0,0,66.31 ,80.84 ,66.31 
02,000,01,002,0029,36,1094,20,1114,1376,0,0,0,0,0,0,0,66.31 ,80.96 ,66.31 
02,000,01,002,0029,37,1516,33,1549,1938,0,0,0,0,0,0,0,66.31 ,79.93 ,66.31 
02,000,01,002,0029,38,1102,28,1130,1416,0,0,0,0,0,0,0,66.31 ,79.80 ,66.31 
02,000,01,002,0030,39,670,11,681,857,0,0,0,0,0,0,0,66.31 ,79.46 ,66.31 
02,000,01,002,0031,40,1264,19,1283,1584,0,0,0,0,0,0,0,66.31 ,81.00 ,66.31 
02,000,01,002,0032,41,1405,30,1435,1751,0,0,0,0,0,0,0,66.31 ,81.95 ,66.31 
02,000,01,002,0033,42,1161,21,1182,1420,0,0,0,0,0,0,0,66.31 ,83.24 ,66.31 
02,000,01,002,0033,43,1213,17,1230,1491,0,0,0,0,0,0,0,66.31 ,82.49 ,66.31 
02,000,01,002,0034,44,962,17,979,1140,0,0,0,0,0,0,0,66.31 ,85.88 ,66.31 
02,000,01,002,0034,45,749,17,766,896,0,0,0,0,0,0,0,66.31 ,85.49 ,66.31 
02,000,01,002,0035,46,806,12,818,984,0,0,0,0,0,0,0,66.31 ,83.13 ,66.31 
02,000,01,002,0035,47,806,15,821,1006,0,0,0,0,0,0,0,66.31 ,81.61 ,66.31 
02,000,01,002,0036,48,1311,31,1342,1672,0,0,0,0,0,0,0,66.31 ,80.26 ,66.31 
02,000,01,002,0036,49,1125,16,1141,1544,0,0,0,0,0,0,0,66.31 ,73.90 ,66.31 
02,000,01,002,0036,50,1153,28,1181,1526,0,0,0,0,0,0,0,66.31 ,77.39 ,66.31 
02,000,01,002,0037,51,942,22,964,1268,0,0,0,0,0,0,0,66.31 ,76.03 ,66.31 
02,000,01,002,0038,52,1331,17,1348,1651,0,0,0,0,0,0,0,66.31 ,81.65 ,66.31 
02,000,01,002,0038,53,1370,24,1394,1744,0,0,0,0,0,0,0,66.31 ,79.93 ,66.31 
02,000,01,002,0038,54,1405,22,1427,1872,0,0,0,0,0,0,0,66.31 ,76.23 ,66.31 
02,000,01,002,0038,55,1735,24,1759,2327,0,0,0,0,0,0,0,66.31 ,75.59 ,66.31 
02,000,01,002,0039,56,1253,19,1272,1569,0,0,0,0,0,0,0,66.31 ,81.07 ,66.31 
02,000,01,002,0039,57,1500,18,1518,1884,0,0,0,0,0,0,0,66.31 ,80.57 ,66.31 
02,000,01,002,0040,58,921,14,935,1161,0,0,0,0,0,0,0,66.31 ,80.53 ,66.31 
02,000,01,002,0040,59,808,15,823,1040,0,0,0,0,0,0,0,66.31 ,79.13 ,66.31 
02,000,01,002,0041,60,742,8,750,923,0,0,0,0,0,0,0,66.31 ,81.26 ,66.31 
02,000,01,002,0041,61,1034,15,1049,1325,0,0,0,0,0,0,0,66.31 ,79.17 ,66.31 
02,000,01,002,0042,62,650,14,664,822,0,0,0,0,0,0,0,66.31 ,80.78 ,66.31 
02,000,01,002,0042,63,672,18,690,856,0,0,0,0,0,0,0,66.31 ,80.61 ,66.31 
02,000,01,002,0043,64,891,15,906,1083,0,0,0,0,0,0,0,66.31 ,83.66 ,66.31 
02,000,01,002,0044,65,735,17,752,935,0,0,0,0,0,0,0,66.31 ,80.43 ,66.31 
02,000,01,002,0045,66,1316,21,1337,1617,0,0,0,0,0,0,0,66.31 ,82.68 ,66.31 
02,000,01,002,0046,67,1242,25,1267,1607,0,0,0,0,0,0,0,66.31 ,78.84 ,66.31 
02,000,01,002,0047,68,759,17,776,932,0,0,0,0,0,0,0,66.31 ,83.26 ,66.31 
02,000,01,002,0047,69,652,14,666,850,0,0,0,0,0,0,0,66.31 ,78.35 ,66.31 
02,000,01,002,0048,70,1204,22,1226,1523,0,0,0,0,0,0,0,66.31 ,80.50 ,66.31 
02,000,01,002,0049,71,1389,32,1421,1744,0,0,0,0,0,0,0,66.31 ,81.48 ,66.31 
02,000,01,002,0050,72,640,6,646,815,0,0,0,0,0,0,0,66.31 ,79.26 ,66.31 
02,000,01,002,0051,73,908,18,926,1146,0,0,0,0,0,0,0,66.31 ,80.80 ,66.31 
02,000,01,002,0052,74,936,17,953,1211,0,0,0,0,0,0,0,66.31 ,78.70 ,66.31 
02,000,01,002,0053,75,974,21,995,1237,0,0,0,0,0,0,0,66.31 ,80.44 ,66.31 
02,000,01,002,0054,76,810,15,825,1077,0,0,0,0,0,0,0,66.31 ,76.60 ,66.31 
02,000,01,002,0055,77,1213,27,1240,1579,0,0,0,0,0,0,0,66.31 ,78.53 ,66.31 
02,000,01,002,0056,78,1112,26,1138,1436,0,0,0,0,0,0,0,66.31 ,79.25 ,66.31 
02,000,01,002,0057,79,1233,47,1280,1670,0,0,0,0,0,0,0,66.31 ,76.65 ,66.31 
02,000,01,002,0058,80,1013,16,1029,1282,0,0,0,0,0,0,0,66.31 ,80.27 ,66.31 
02,000,01,002,0059,81,623,9,632,773,0,0,0,0,0,0,0,66.31 ,81.76 ,66.31 
02,000,01,003,0060,82,710,15,725,942,0,0,0,0,0,0,0,66.31 ,76.96 ,66.31 
02,000,01,003,0060,83,603,18,621,765,0,0,0,0,0,0,0,66.31 ,81.18 ,66.31 
02,000,01,003,0061,84,1043,24,1067,1283,0,0,0,0,0,0,0,66.31 ,83.16 ,66.31 
02,000,01,003,0062,85,552,6,558,661,0,0,0,0,0,0,0,66.31 ,84.42 ,66.31 
02,000,01,003,0063,86,585,9,594,700,0,0,0,0,0,0,0,66.31 ,84.86 ,66.31 
02,000,01,003,0064,87,543,10,553,652,0,0,0,0,0,0,0,66.31 ,84.82 ,66.31 
02,000,01,003,0065,88,843,14,857,984,0,0,0,0,0,0,0,66.31 ,87.09 ,66.31 
02,000,01,003,0066,89,912,28,940,1083,0,0,0,0,0,0,0,66.31 ,86.80 ,66.31 
02,000,01,003,0067,90,883,15,898,1034,0,0,0,0,0,0,0,66.31 ,86.85 ,66.31 
02,000,01,003,0068,91,867,20,887,1068,0,0,0,0,0,0,0,66.31 ,83.05 ,66.31 
02,000,01,003,0068,92,1129,16,1145,1395,0,0,0,0,0,0,0,66.31 ,82.08 ,66.31 
02,000,01,003,0069,93,1340,27,1367,1670,0,0,0,0,0,0,0,66.31 ,81.86 ,66.31 
02,000,01,003,0070,94,660,18,678,848,0,0,0,0,0,0,0,66.31 ,79.95 ,66.31 
02,000,01,003,0070,95,689,12,701,879,0,0,0,0,0,0,0,66.31 ,79.75 ,66.31 
02,000,01,003,0071,96,614,15,629,745,0,0,0,0,0,0,0,66.31 ,84.43 ,66.31 
02,000,01,003,0072,97,876,25,901,1147,0,0,0,0,0,0,0,66.31 ,78.55 ,66.31 
02,000,01,003,0072,98,846,22,868,1059,0,0,0,0,0,0,0,66.31 ,81.96 ,66.31 
02,000,01,003,0073,99,1037,19,1056,1320,0,0,0,0,0,0,0,66.31 ,80.00 ,66.31 
02,000,01,003,0074,100,658,9,667,826,0,0,0,0,0,0,0,66.31 ,80.75 ,66.31 
02,000,01,003,0074,101,690,7,697,859,0,0,0,0,0,0,0,66.31 ,81.14 ,66.31 
02,000,01,003,0075,102,971,15,986,1208,0,0,0,0,0,0,0,66.31 ,81.62 ,66.31 
02,000,01,003,0075,103,1064,22,1086,1322,0,0,0,0,0,0,0,66.31 ,82.15 ,66.31 
02,000,01,003,0076,104,1032,11,1043,1350,0,0,0,0,0,0,0,66.31 ,77.26 ,66.31 
02,000,01,003,0077,105,709,6,715,897,0,0,0,0,0,0,0,66.31 ,79.71 ,66.31 
02,000,01,003,0077,106,775,21,796,999,0,0,0,0,0,0,0,66.31 ,79.68 ,66.31 
02,000,01,003,0078,107,1142,24,1166,1497,0,0,0,0,0,0,0,66.31 ,77.89 ,66.31 
02,000,01,003,0079,108,766,11,777,973,0,0,0,0,0,0,0,66.31 ,79.86 ,66.31 
02,000,01,003,0080,109,1136,8,1144,1340,0,0,0,0,0,0,0,66.31 ,85.37 ,66.31 
02,000,01,003,0081,110,799,20,819,1014,0,0,0,0,0,0,0,66.31 ,80.77 ,66.31 
02,000,01,003,0082,111,383,6,389,464,0,0,0,0,0,0,0,66.31 ,83.84 ,66.31 
02,000,01,003,0083,112,481,3,484,558,0,0,0,0,0,0,0,66.31 ,86.74 ,66.31 
02,000,01,003,0084,113,509,6,515,648,0,0,0,0,0,0,0,66.31 ,79.48 ,66.31 
02,000,01,003,0085,114,667,14,681,810,0,0,0,0,0,0,0,66.31 ,84.07 ,66.31 
02,000,01,003,0086,115,468,5,473,555,0,0,0,0,0,0,0,66.31 ,85.23 ,66.31 
02,000,01,003,0087,116,636,13,649,774,0,0,0,0,0,0,0,66.31 ,83.85 ,66.31 
02,000,01,003,0088,117,1005,15,1020,1221,0,0,0,0,0,0,0,66.31 ,83.54 ,66.31 
02,000,01,003,0089,118,1162,25,1187,1546,0,0,0,0,0,0,0,66.31 ,76.78 ,66.31 
02,000,01,003,0090,119,588,12,600,771,0,0,0,0,0,0,0,66.31 ,77.82 ,66.31 
02,000,01,003,0090,120,568,13,581,687,0,0,0,0,0,0,0,66.31 ,84.57 ,66.31 
02,000,01,003,0091,121,1107,20,1127,1365,0,0,0,0,0,0,0,66.31 ,82.56 ,66.31 
02,000,01,003,0092,122,850,26,876,1050,0,0,0,0,0,0,0,66.31 ,83.43 ,66.31 
02,000,01,003,0092,123,579,10,589,727,0,0,0,0,0,0,0,66.31 ,81.02 ,66.31 
02,000,01,003,0093,124,915,10,925,1166,0,0,0,0,0,0,0,66.31 ,79.33 ,66.31 
02,000,01,003,0094,125,1194,17,1211,1543,0,0,0,0,0,0,0,66.31 ,78.48 ,66.31 
02,000,01,003,0094,126,764,5,769,980,0,0,0,0,0,0,0,66.31 ,78.47 ,66.31 
02,000,01,003,0095,127,793,9,802,976,0,0,0,0,0,0,0,66.31 ,82.17 ,66.31 
02,000,01,003,0095,128,884,11,895,1116,0,0,0,0,0,0,0,66.31 ,80.20 ,66.31 
02,000,01,003,0096,129,1225,17,1242,1601,0,0,0,0,0,0,0,66.31 ,77.58 ,66.31 
02,000,01,003,0097,130,757,20,777,998,0,0,0,0,0,0,0,66.31 ,77.86 ,66.31 
02,000,01,003,0097,131,679,12,691,851,0,0,0,0,0,0,0,66.31 ,81.20 ,66.31 
02,000,01,003,0098,132,825,7,832,1024,0,0,0,0,0,0,0,66.31 ,81.25 ,66.31 
02,000,01,003,0098,133,971,10,981,1206,0,0,0,0,0,0,0,66.31 ,81.34 ,66.31 
02,000,01,003,0098,134,958,15,973,1186,0,0,0,0,0,0,0,66.31 ,82.04 ,66.31 
02,000,01,003,0098,135,1202,13,1215,1548,0,0,0,0,0,0,0,66.31 ,78.49 ,66.31 
02,000,01,003,0098,136,1143,26,1169,1407,0,0,0,0,0,0,0,66.31 ,83.08 ,66.31 
02,000,01,003,0099,137,955,27,982,1200,0,0,0,0,0,0,0,66.31 ,81.83 ,66.31 
02,000,01,003,0099,138,1073,20,1093,1329,0,0,0,0,0,0,0,66.31 ,82.24 ,66.31 
02,000,01,003,0099,139,1089,21,1110,1460,0,0,0,0,0,0,0,66.31 ,76.03 ,66.31 
02,000,01,003,0099,140,1030,23,1053,1337,0,0,0,0,0,0,0,66.31 ,78.76 ,66.31 
02,000,01,003,0099,141,1115,20,1135,1574,0,0,0,0,0,0,0,66.31 ,72.11 ,66.31 
02,000,01,003,0099,142,1323,17,1340,1727,0,0,0,0,0,0,0,66.31 ,77.59 ,66.31 
02,000,01,003,0099,143,1191,14,1205,1614,0,0,0,0,0,0,0,66.31 ,74.66 ,66.31 
02,000,01,003,0099,144,1232,26,1258,1690,0,0,0,0,0,0,0,66.31 ,74.44 ,66.31 
02,000,01,003,0099,145,1139,11,1150,1553,0,0,0,0,0,0,0,66.31 ,74.05 ,66.31 
02,000,01,003,0100,146,1213,21,1234,1483,0,0,0,0,0,0,0,66.31 ,83.21 ,66.31 
02,000,01,003,0100,147,1005,21,1026,1224,0,0,0,0,0,0,0,66.31 ,83.82 ,66.31 
02,000,01,003,0100,148,1102,28,1130,1403,0,0,0,0,0,0,0,66.31 ,80.54 ,66.31 
02,000,01,003,0101,149,1211,17,1228,1517,0,0,0,0,0,0,0,66.31 ,80.95 ,66.31 
02,000,01,003,0101,150,1110,16,1126,1424,0,0,0,0,0,0,0,66.31 ,79.07 ,66.31 
02,000,01,003,0101,151,1014,15,1029,1288,0,0,0,0,0,0,0,66.31 ,79.89 ,66.31 
02,000,01,003,0101,152,1159,15,1174,1487,0,0,0,0,0,0,0,66.31 ,78.95 ,66.31 
02,000,01,003,0102,153,1462,31,1493,1931,0,0,0,0,0,0,0,66.31 ,77.32 ,66.31 
02,000,01,003,0102,154,1322,44,1366,1724,0,0,0,0,0,0,0,66.31 ,79.23 ,66.31 
02,000,01,003,0102,155,1481,29,1510,1947,0,0,0,0,0,0,0,66.31 ,77.56 ,66.31 
02,000,01,003,0102,156,1422,32,1454,1790,0,0,0,0,0,0,0,66.31 ,81.23 ,66.31 
02,000,01,003,0102,157,1163,26,1189,1532,0,0,0,0,0,0,0,66.31 ,77.61 ,66.31 
02,000,01,003,0103,158,1504,36,1540,2076,0,0,0,0,0,0,0,66.31 ,74.18 ,66.31 
02,000,01,003,0103,159,1393,29,1422,1899,0,0,0,0,0,0,0,66.31 ,74.88 ,66.31 
02,000,01,003,0103,160,1460,24,1484,1951,0,0,0,0,0,0,0,66.31 ,76.06 ,66.31 
02,000,01,003,0103,161,1369,23,1392,1850,0,0,0,0,0,0,0,66.31 ,75.24 ,66.31 
02,000,01,003,0103,162,1743,26,1769,2300,0,0,0,0,0,0,0,66.31 ,76.91 ,66.31 
02,000,01,004,0104,163,1036,32,1068,1291,0,0,0,0,0,0,0,66.31 ,82.73 ,66.31 
02,000,01,004,0104,164,1047,22,1069,1267,0,0,0,0,0,0,0,66.31 ,84.37 ,66.31 
02,000,01,004,0104,165,842,17,859,1065,0,0,0,0,0,0,0,66.31 ,80.66 ,66.31 
02,000,01,004,0104,166,693,17,710,903,0,0,0,0,0,0,0,66.31 ,78.63 ,66.31 
02,000,01,004,0104,167,827,13,840,1066,0,0,0,0,0,0,0,66.31 ,78.80 ,66.31 
02,000,01,004,0104,168,971,18,989,1273,0,0,0,0,0,0,0,66.31 ,77.69 ,66.31 
02,000,01,004,0105,169,904,10,914,1094,0,0,0,0,0,0,0,66.31 ,83.55 ,66.31 
02,000,01,004,0105,170,836,21,857,1063,0,0,0,0,0,0,0,66.31 ,80.62 ,66.31 
02,000,01,004,0106,171,875,20,895,1113,0,0,0,0,0,0,0,66.31 ,80.41 ,66.31 
02,000,01,004,0106,172,1040,25,1065,1329,0,0,0,0,0,0,0,66.31 ,80.14 ,66.31 
02,000,01,004,0106,173,933,22,955,1210,0,0,0,0,0,0,0,66.31 ,78.93 ,66.31 
02,000,01,004,0107,174,925,9,934,1095,0,0,0,0,0,0,0,66.31 ,85.30 ,66.31 
02,000,01,004,0107,175,993,17,1010,1235,0,0,0,0,0,0,0,66.31 ,81.78 ,66.31 
02,000,01,004,0108,176,1058,28,1086,1326,0,0,0,0,0,0,0,66.31 ,81.90 ,66.31 
02,000,01,004,0108,177,955,13,968,1198,0,0,0,0,0,0,0,66.31 ,80.80 ,66.31 
02,000,01,004,0109,178,846,24,870,1058,0,0,0,0,0,0,0,66.31 ,82.23 ,66.31 
02,000,01,004,0109,179,888,14,902,1143,0,0,0,0,0,0,0,66.31 ,78.92 ,66.31 
02,000,01,004,0110,180,1201,23,1224,1503,0,0,0,0,0,0,0,66.31 ,81.44 ,66.31 
02,000,01,004,0110,181,1099,19,1118,1355,0,0,0,0,0,0,0,66.31 ,82.51 ,66.31 
02,000,01,004,0111,182,821,16,837,1036,0,0,0,0,0,0,0,66.31 ,80.79 ,66.31 
02,000,01,004,0111,183,942,17,959,1143,0,0,0,0,0,0,0,66.31 ,83.90 ,66.31 
02,000,01,004,0112,184,877,15,892,1062,0,0,0,0,0,0,0,66.31 ,83.99 ,66.31 
02,000,01,004,0112,185,987,11,998,1145,0,0,0,0,0,0,0,66.31 ,87.16 ,66.31 
02,000,01,004,0112,186,818,20,838,984,0,0,0,0,0,0,0,66.31 ,85.16 ,66.31 
02,000,01,004,0113,187,831,15,846,967,0,0,0,0,0,0,0,66.31 ,87.49 ,66.31 
02,000,01,004,0113,188,1003,23,1026,1165,0,0,0,0,0,0,0,66.31 ,88.07 ,66.31 
02,000,01,004,0114,189,1246,29,1275,1493,0,0,0,0,0,0,0,66.31 ,85.40 ,66.31 
02,000,01,004,0114,190,1198,21,1219,1444,0,0,0,0,0,0,0,66.31 ,84.42 ,66.31 
02,000,01,004,0115,191,1283,27,1310,1557,0,0,0,0,0,0,0,66.31 ,84.14 ,66.31 
02,000,01,004,0116,192,1163,22,1185,1398,0,0,0,0,0,0,0,66.31 ,84.76 ,66.31 
02,000,01,004,0116,193,1201,27,1228,1484,0,0,0,0,0,0,0,66.31 ,82.75 ,66.31 
02,000,01,004,0117,194,946,24,970,1226,0,0,0,0,0,0,0,66.31 ,79.12 ,66.31 
02,000,01,004,0117,195,1059,24,1083,1356,0,0,0,0,0,0,0,66.31 ,79.87 ,66.31 
02,000,01,004,0117,196,748,10,758,998,0,0,0,0,0,0,0,66.31 ,75.95 ,66.31 
02,000,01,004,0117,197,914,18,932,1189,0,0,0,0,0,0,0,66.31 ,78.39 ,66.31 
02,000,01,004,0117,198,760,13,773,1022,0,0,0,0,0,0,0,66.31 ,75.64 ,66.31 
02,000,01,004,0117,199,906,20,926,1202,0,0,0,0,0,0,0,66.31 ,77.04 ,66.31 
02,000,01,004,0117,200,1139,11,1150,1421,0,0,0,0,0,0,0,66.31 ,80.93 ,66.31 
02,000,01,004,0117,201,1032,21,1053,1334,0,0,0,0,0,0,0,66.31 ,78.94 ,66.31 
02,000,01,004,0118,202,569,6,575,687,0,0,0,0,0,0,0,66.31 ,83.70 ,66.31 
02,000,01,004,0118,203,746,13,759,964,0,0,0,0,0,0,0,66.31 ,78.73 ,66.31 
02,000,01,004,0119,204,1213,18,1231,1514,0,0,0,0,0,0,0,66.31 ,81.31 ,66.31 
02,000,01,004,0119,205,1231,16,1247,1469,0,0,0,0,0,0,0,66.31 ,84.89 ,66.31 
02,000,01,004,0120,206,1216,15,1231,1464,0,0,0,0,0,0,0,66.31 ,84.08 ,66.31 
02,000,01,004,0121,207,876,20,896,1054,0,0,0,0,0,0,0,66.31 ,85.01 ,66.31 
02,000,01,004,0121,208,708,19,727,891,0,0,0,0,0,0,0,66.31 ,81.59 ,66.31 
02,000,01,004,0121,209,744,13,757,905,0,0,0,0,0,0,0,66.31 ,83.65 ,66.31 
02,000,01,004,0122,210,823,23,846,1031,0,0,0,0,0,0,0,66.31 ,82.06 ,66.31 
02,000,01,004,0122,211,809,14,823,1020,0,0,0,0,0,0,0,66.31 ,80.69 ,66.31 
02,000,01,004,0123,212,843,21,864,1034,0,0,0,0,0,0,0,66.31 ,83.56 ,66.31 
02,000,01,004,0123,213,844,12,856,1044,0,0,0,0,0,0,0,66.31 ,81.99 ,66.31 
02,000,01,004,0124,214,782,6,788,929,0,0,0,0,0,0,0,66.31 ,84.82 ,66.31 
02,000,01,004,0124,215,660,10,670,822,0,0,0,0,0,0,0,66.31 ,81.51 ,66.31 
02,000,01,004,0125,216,1101,22,1123,1331,0,0,0,0,0,0,0,66.31 ,84.37 ,66.31 
02,000,01,004,0125,217,1089,20,1109,1343,0,0,0,0,0,0,0,66.31 ,82.58 ,66.31 
02,000,01,004,0126,218,1208,27,1235,1456,0,0,0,0,0,0,0,66.31 ,84.82 ,66.31 
02,000,01,004,0127,219,990,15,1005,1192,0,0,0,0,0,0,0,66.31 ,84.31 ,66.31 
02,000,01,004,0127,220,889,17,906,1132,0,0,0,0,0,0,0,66.31 ,80.04 ,66.31 
02,000,01,004,0128,221,907,9,916,1126,0,0,0,0,0,0,0,66.31 ,81.35 ,66.31 
02,000,01,004,0128,222,909,11,920,1090,0,0,0,0,0,0,0,66.31 ,84.40 ,66.31 
02,000,01,004,0129,223,711,10,721,881,0,0,0,0,0,0,0,66.31 ,81.84 ,66.31 
02,000,01,004,0129,224,771,10,781,913,0,0,0,0,0,0,0,66.31 ,85.54 ,66.31 
02,000,01,004,0130,225,840,16,856,1025,0,0,0,0,0,0,0,66.31 ,83.51 ,66.31 
02,000,01,004,0130,226,852,8,860,1022,0,0,0,0,0,0,0,66.31 ,84.15 ,66.31 
02,000,01,004,0131,227,1119,17,1136,1362,0,0,0,0,0,0,0,66.31 ,83.41 ,66.31 
02,000,01,004,0131,228,1171,28,1199,1419,0,0,0,0,0,0,0,66.31 ,84.50 ,66.31 
02,000,01,004,0132,229,830,19,849,1030,0,0,0,0,0,0,0,66.31 ,82.43 ,66.31 
02,000,01,004,0132,230,917,12,929,1096,0,0,0,0,0,0,0,66.31 ,84.76 ,66.31 
02,000,01,004,0132,231,856,15,871,1024,0,0,0,0,0,0,0,66.31 ,85.06 ,66.31 
02,000,01,004,0133,232,677,21,698,855,0,0,0,0,0,0,0,66.31 ,81.64 ,66.31 
02,000,01,004,0133,233,774,14,788,938,0,0,0,0,0,0,0,66.31 ,84.01 ,66.31 
02,000,01,004,0134,234,797,16,813,946,0,0,0,0,0,0,0,66.31 ,85.94 ,66.31 
02,000,01,004,0134,235,797,14,811,1001,0,0,0,0,0,0,0,66.31 ,81.02 ,66.31 
02,000,01,004,0135,236,921,20,941,1129,0,0,0,0,0,0,0,66.31 ,83.35 ,66.31 
02,000,01,004,0135,237,974,20,994,1246,0,0,0,0,0,0,0,66.31 ,79.78 ,66.31 
02,000,01,004,0136,238,882,18,900,1124,0,0,0,0,0,0,0,66.31 ,80.07 ,66.31 
02,000,01,004,0136,239,995,16,1011,1237,0,0,0,0,0,0,0,66.31 ,81.73 ,66.31 
02,000,01,004,0136,240,975,10,985,1183,0,0,0,0,0,0,0,66.31 ,83.26 ,66.31 
02,000,01,004,0136,241,925,11,936,1158,0,0,0,0,0,0,0,66.31 ,80.83 ,66.31 
02,000,01,004,0137,242,1069,21,1090,1346,0,0,0,0,0,0,0,66.31 ,80.98 ,66.31 
02,000,01,004,0137,243,1060,26,1086,1378,0,0,0,0,0,0,0,66.31 ,78.81 ,66.31 
02,000,01,004,0138,244,796,12,808,910,0,0,0,0,0,0,0,66.31 ,88.79 ,66.31 
02,000,01,004,0139,245,698,3,701,830,0,0,0,0,0,0,0,66.31 ,84.46 ,66.31 
02,000,01,004,0140,246,667,14,681,825,0,0,0,0,0,0,0,66.31 ,82.55 ,66.31 
02,000,01,004,0140,247,572,9,581,655,0,0,0,0,0,0,0,66.31 ,88.70 ,66.31 
02,000,01,005,0141,248,1071,25,1096,1363,0,0,0,0,0,0,0,66.31 ,80.41 ,66.31 
02,000,01,005,0141,249,1111,26,1137,1409,0,0,0,0,0,0,0,66.31 ,80.70 ,66.31 
02,000,01,005,0142,250,1349,20,1369,1681,0,0,0,0,0,0,0,66.31 ,81.44 ,66.31 
02,000,01,005,0142,251,1190,20,1210,1463,0,0,0,0,0,0,0,66.31 ,82.71 ,66.31 
02,000,01,005,0143,252,1249,17,1266,1567,0,0,0,0,0,0,0,66.31 ,80.79 ,66.31 
02,000,01,005,0143,253,1211,27,1238,1483,0,0,0,0,0,0,0,66.31 ,83.48 ,66.31 
02,000,01,005,0143,254,1207,22,1229,1532,0,0,0,0,0,0,0,66.31 ,80.22 ,66.31 
02,000,01,005,0144,255,1150,22,1172,1524,0,0,0,0,0,0,0,66.31 ,76.90 ,66.31 
02,000,01,005,0144,256,1216,27,1243,1513,0,0,0,0,0,0,0,66.31 ,82.15 ,66.31 
02,000,01,005,0145,257,1460,32,1492,1821,0,0,0,0,0,0,0,66.31 ,81.93 ,66.31 
02,000,01,005,0145,258,1398,23,1421,1781,0,0,0,0,0,0,0,66.31 ,79.79 ,66.31 
02,000,01,005,0146,259,1233,22,1255,1483,0,0,0,0,0,0,0,66.31 ,84.63 ,66.31 
02,000,01,005,0146,260,1244,20,1264,1486,0,0,0,0,0,0,0,66.31 ,85.06 ,66.31 
02,000,01,005,0147,261,1578,24,1602,2032,0,0,0,0,0,0,0,66.31 ,78.84 ,66.31 
02,000,01,005,0147,262,2152,28,2180,3035,0,0,0,0,0,0,0,66.31 ,71.83 ,66.31 
02,000,01,005,0147,263,1730,24,1754,2258,0,0,0,0,0,0,0,66.31 ,77.68 ,66.31 
02,000,01,005,0147,264,1549,30,1579,1938,0,0,0,0,0,0,0,66.31 ,81.48 ,66.31 
02,000,01,005,0147,265,1420,16,1436,1837,0,0,0,0,0,0,0,66.31 ,78.17 ,66.31 
02,000,01,005,0148,266,1640,36,1676,2060,0,0,0,0,0,0,0,66.31 ,81.36 ,66.31 
02,000,01,005,0148,267,1596,36,1632,2027,0,0,0,0,0,0,0,66.31 ,80.51 ,66.31 
02,000,01,005,0148,268,1719,26,1745,2100,0,0,0,0,0,0,0,66.31 ,83.10 ,66.31 
02,000,01,005,0149,269,1382,27,1409,1669,0,0,0,0,0,0,0,66.31 ,84.42 ,66.31 
02,000,01,005,0149,270,1081,24,1105,1333,0,0,0,0,0,0,0,66.31 ,82.90 ,66.31 
02,000,01,005,0149,271,1191,16,1207,1491,0,0,0,0,0,0,0,66.31 ,80.95 ,66.31 
02,000,01,005,0150,272,1568,29,1597,1933,0,0,0,0,0,0,0,66.31 ,82.62 ,66.31 
02,000,01,005,0151,273,1195,24,1219,1492,0,0,0,0,0,0,0,66.31 ,81.70 ,66.31 
02,000,01,005,0152,274,1567,25,1592,1955,0,0,0,0,0,0,0,66.31 ,81.43 ,66.31 
02,000,01,005,0152,275,1548,19,1567,1988,0,0,0,0,0,0,0,66.31 ,78.82 ,66.31 
02,000,01,005,0153,276,1161,18,1179,1450,0,0,0,0,0,0,0,66.31 ,81.31 ,66.31 
02,000,01,005,0153,277,1381,31,1412,1683,0,0,0,0,0,0,0,66.31 ,83.90 ,66.31 
02,000,01,005,0154,278,1328,25,1353,1655,0,0,0,0,0,0,0,66.31 ,81.75 ,66.31 
02,000,01,005,0154,279,1397,26,1423,1810,0,0,0,0,0,0,0,66.31 ,78.62 ,66.31 
02,000,01,005,0155,280,1438,26,1464,1837,0,0,0,0,0,0,0,66.31 ,79.70 ,66.31 
02,000,01,005,0155,281,1423,18,1441,1806,0,0,0,0,0,0,0,66.31 ,79.79 ,66.31 
02,000,01,005,0155,282,1440,18,1458,1808,0,0,0,0,0,0,0,66.31 ,80.64 ,66.31 
02,000,01,005,0156,283,1214,14,1228,1564,0,0,0,0,0,0,0,66.31 ,78.52 ,66.31 
02,000,01,005,0156,284,1249,22,1271,1577,0,0,0,0,0,0,0,66.31 ,80.60 ,66.31 
02,000,01,005,0157,285,1491,29,1520,1969,0,0,0,0,0,0,0,66.31 ,77.20 ,66.31 
02,000,01,005,0157,286,1467,20,1487,1823,0,0,0,0,0,0,0,66.31 ,81.57 ,66.31 
02,000,01,005,0158,287,899,8,907,1129,0,0,0,0,0,0,0,66.31 ,80.34 ,66.31 
02,000,01,005,0158,288,1043,17,1060,1329,0,0,0,0,0,0,0,66.31 ,79.76 ,66.31 
02,000,01,005,0159,289,1252,23,1275,1560,0,0,0,0,0,0,0,66.31 ,81.73 ,66.31 
02,000,01,005,0159,290,1353,32,1385,1687,0,0,0,0,0,0,0,66.31 ,82.10 ,66.31 
02,000,01,005,0159,291,1289,20,1309,1647,0,0,0,0,0,0,0,66.31 ,79.48 ,66.31 
02,000,01,005,0160,292,995,19,1014,1213,0,0,0,0,0,0,0,66.31 ,83.59 ,66.31 
02,000,01,005,0160,293,1034,12,1046,1266,0,0,0,0,0,0,0,66.31 ,82.62 ,66.31 
02,000,01,005,0161,294,940,19,959,1174,0,0,0,0,0,0,0,66.31 ,81.69 ,66.31 
02,000,01,005,0161,295,911,10,921,1187,0,0,0,0,0,0,0,66.31 ,77.59 ,66.31 
02,000,01,005,0162,296,1269,19,1288,1595,0,0,0,0,0,0,0,66.31 ,80.75 ,66.31 
02,000,01,005,0162,297,1408,20,1428,1747,0,0,0,0,0,0,0,66.31 ,81.74 ,66.31 
02,000,01,005,0162,298,1092,16,1108,1401,0,0,0,0,0,0,0,66.31 ,79.09 ,66.31 
02,000,01,005,0163,299,1699,31,1730,2136,0,0,0,0,0,0,0,66.31 ,80.99 ,66.31 
02,000,01,005,0164,300,832,18,850,1033,0,0,0,0,0,0,0,66.31 ,82.28 ,66.31 
02,000,01,005,0164,301,896,21,917,1151,0,0,0,0,0,0,0,66.31 ,79.67 ,66.31 
02,000,01,005,0165,302,1407,25,1432,1803,0,0,0,0,0,0,0,66.31 ,79.42 ,66.31 
02,000,01,005,0165,303,1215,19,1234,1591,0,0,0,0,0,0,0,66.31 ,77.56 ,66.31 
02,000,01,005,0166,304,1382,27,1409,1765,0,0,0,0,0,0,0,66.31 ,79.83 ,66.31 
02,000,01,005,0166,305,1358,22,1380,1764,0,0,0,0,0,0,0,66.31 ,78.23 ,66.31 
02,000,01,005,0167,306,1005,12,1017,1239,0,0,0,0,0,0,0,66.31 ,82.08 ,66.31 
02,000,01,005,0167,307,1232,28,1260,1600,0,0,0,0,0,0,0,66.31 ,78.75 ,66.31 
02,000,01,005,0167,308,1204,18,1222,1556,0,0,0,0,0,0,0,66.31 ,78.53 ,66.31 
02,000,01,005,0168,309,1261,24,1285,1560,0,0,0,0,0,0,0,66.31 ,82.37 ,66.31 
02,000,01,005,0168,310,1481,37,1518,1857,0,0,0,0,0,0,0,66.31 ,81.74 ,66.31 
02,000,01,005,0169,311,1687,42,1729,2204,0,0,0,0,0,0,0,66.31 ,78.45 ,66.31 
02,000,01,005,0169,312,1670,41,1711,2102,0,0,0,0,0,0,0,66.31 ,81.40 ,66.31 
02,000,01,005,0170,313,1317,22,1339,1725,0,0,0,0,0,0,0,66.31 ,77.62 ,66.31 
02,000,01,005,0170,314,1457,15,1472,1787,0,0,0,0,0,0,0,66.31 ,82.37 ,66.31 
02,000,01,005,0170,315,1359,29,1388,1722,0,0,0,0,0,0,0,66.31 ,80.60 ,66.31 
02,000,01,005,0171,316,1104,20,1124,1443,0,0,0,0,0,0,0,66.31 ,77.89 ,66.31 
02,000,01,005,0171,317,1026,17,1043,1344,0,0,0,0,0,0,0,66.31 ,77.60 ,66.31 
02,000,01,005,0172,318,942,17,959,1247,0,0,0,0,0,0,0,66.31 ,76.90 ,66.31 
02,000,01,005,0172,319,897,22,919,1177,0,0,0,0,0,0,0,66.31 ,78.08 ,66.31 
02,000,01,005,0173,320,1501,34,1535,1972,0,0,0,0,0,0,0,66.31 ,77.84 ,66.31 
02,000,01,005,0173,321,1577,32,1609,2003,0,0,0,0,0,0,0,66.31 ,80.33 ,66.31 
02,000,01,005,0174,322,1854,41,1895,2322,0,0,0,0,0,0,0,66.31 ,81.61 ,66.31 
02,000,01,005,0175,323,1547,27,1574,1942,0,0,0,0,0,0,0,66.31 ,81.05 ,66.31 
02,000,01,005,0176,324,1375,23,1398,1702,0,0,0,0,0,0,0,66.31 ,82.14 ,66.31 
02,000,01,005,0176,325,1361,26,1387,1628,0,0,0,0,0,0,0,66.31 ,85.20 ,66.31 
02,000,01,005,0177,326,1030,10,1040,1444,0,0,0,0,0,0,0,66.31 ,72.02 ,66.31 
02,000,01,005,0177,327,1059,20,1079,1306,0,0,0,0,0,0,0,66.31 ,82.62 ,66.31 
02,000,01,005,0178,328,1730,22,1752,2274,0,0,0,0,0,0,0,66.31 ,77.04 ,66.31 
02,000,01,005,0178,329,1707,33,1740,2192,0,0,0,0,0,0,0,66.31 ,79.38 ,66.31 
02,000,01,005,0178,330,1723,28,1751,2277,0,0,0,0,0,0,0,66.31 ,76.90 ,66.31 
02,000,01,005,0179,331,1185,21,1206,1536,0,0,0,0,0,0,0,66.31 ,78.52 ,66.31 
02,000,01,005,0179,332,1183,18,1201,1492,0,0,0,0,0,0,0,66.31 ,80.50 ,66.31 
02,000,01,005,0180,333,1164,17,1181,1465,0,0,0,0,0,0,0,66.31 ,80.61 ,66.31 
02,000,01,005,0181,334,1239,15,1254,1550,0,0,0,0,0,0,0,66.31 ,80.90 ,66.31 
02,000,01,005,0182,335,1148,21,1169,1529,0,0,0,0,0,0,0,66.31 ,76.46 ,66.31 
02,000,01,005,0182,336,1193,26,1219,1537,0,0,0,0,0,0,0,66.31 ,79.31 ,66.31 
02,000,01,005,0183,337,1741,39,1780,2207,0,0,0,0,0,0,0,66.31 ,80.65 ,66.31 
02,000,01,005,0184,338,1380,15,1395,1870,0,0,0,0,0,0,0,66.31 ,74.60 ,66.31 
02,000,01,005,0184,339,1310,21,1331,1695,0,0,0,0,0,0,0,66.31 ,78.53 ,66.31 
02,000,01,005,0185,340,1395,34,1429,1784,0,0,0,0,0,0,0,66.31 ,80.10 ,66.31 
02,000,01,005,0185,341,1554,29,1583,1968,0,0,0,0,0,0,0,66.31 ,80.44 ,66.31 
02,000,01,005,0186,342,1308,21,1329,1620,0,0,0,0,0,0,0,66.31 ,82.04 ,66.31 
02,000,01,005,0186,343,1193,18,1211,1540,0,0,0,0,0,0,0,66.31 ,78.64 ,66.31 
02,000,01,005,0187,344,917,19,936,1154,0,0,0,0,0,0,0,66.31 ,81.11 ,66.31 
02,000,01,005,0187,345,1150,25,1175,1458,0,0,0,0,0,0,0,66.31 ,80.59 ,66.31 
02,000,01,005,0188,346,1240,24,1264,1542,0,0,0,0,0,0,0,66.31 ,81.97 ,66.31 
02,000,01,005,0189,347,1336,26,1362,1687,0,0,0,0,0,0,0,66.31 ,80.74 ,66.31 
02,000,01,005,0190,348,1165,12,1177,1479,0,0,0,0,0,0,0,66.31 ,79.58 ,66.31 
02,000,01,005,0191,349,917,15,932,1109,0,0,0,0,0,0,0,66.31 ,84.04 ,66.31 
02,000,01,005,0192,350,1015,19,1034,1303,0,0,0,0,0,0,0,66.31 ,79.36 ,66.31 
02,000,01,005,0192,351,1146,18,1164,1490,0,0,0,0,0,0,0,66.31 ,78.12 ,66.31 
02,000,01,005,0193,352,916,19,935,1157,0,0,0,0,0,0,0,66.31 ,80.81 ,66.31 
02,000,01,005,0193,353,881,17,898,1154,0,0,0,0,0,0,0,66.31 ,77.82 ,66.31 
02,000,01,005,0194,354,1461,32,1493,1879,0,0,0,0,0,0,0,66.31 ,79.46 ,66.31 
02,000,01,005,0195,355,1378,26,1404,1774,0,0,0,0,0,0,0,66.31 ,79.14 ,66.31 
02,000,01,005,0196,356,707,18,725,908,0,0,0,0,0,0,0,66.31 ,79.85 ,66.31 
02,000,01,005,0197,357,949,14,963,1188,0,0,0,0,0,0,0,66.31 ,81.06 ,66.31 
02,000,01,005,0198,358,1362,17,1379,1730,0,0,0,0,0,0,0,66.31 ,79.71 ,66.31 
02,000,01,005,0199,359,817,18,835,1008,0,0,0,0,0,0,0,66.31 ,82.84 ,66.31 
02,000,01,005,0199,360,846,14,860,1043,0,0,0,0,0,0,0,66.31 ,82.45 ,66.31 
02,000,01,005,0200,361,1315,26,1341,1632,0,0,0,0,0,0,0,66.31 ,82.17 ,66.31 
02,000,01,005,0200,362,1235,26,1261,1530,0,0,0,0,0,0,0,66.31 ,82.42 ,66.31 
02,000,01,005,0201,363,1563,33,1596,1950,0,0,0,0,0,0,0,66.31 ,81.85 ,66.31 
02,000,01,005,0201,364,1542,23,1565,1992,0,0,0,0,0,0,0,66.31 ,78.56 ,66.31 
02,000,01,005,0202,365,1334,26,1360,1671,0,0,0,0,0,0,0,66.31 ,81.39 ,66.31 
02,000,01,005,0202,366,1370,18,1388,1770,0,0,0,0,0,0,0,66.31 ,78.42 ,66.31 
02,000,01,005,0203,367,1134,24,1158,1426,0,0,0,0,0,0,0,66.31 ,81.21 ,66.31 
02,000,01,005,0204,368,1397,31,1428,1751,0,0,0,0,0,0,0,66.31 ,81.55 ,66.31 
02,000,01,005,0205,369,1001,20,1021,1261,0,0,0,0,0,0,0,66.31 ,80.97 ,66.31 
02,000,01,005,0205,370,744,17,761,967,0,0,0,0,0,0,0,66.31 ,78.70 ,66.31 
02,000,01,005,0206,371,803,13,816,1011,0,0,0,0,0,0,0,66.31 ,80.71 ,66.31 
02,000,01,005,0207,372,927,23,950,1129,0,0,0,0,0,0,0,66.31 ,84.15 ,66.31 
02,000,01,005,0208,373,1005,16,1021,1310,0,0,0,0,0,0,0,66.31 ,77.94 ,66.31 
02,000,01,005,0209,374,1088,19,1107,1481,0,0,0,0,0,0,0,66.31 ,74.75 ,66.31 
02,000,01,005,0210,375,640,13,653,886,0,0,0,0,0,0,0,66.31 ,73.70 ,66.31 
02,000,01,005,0211,376,445,8,453,547,0,0,0,0,0,0,0,66.31 ,82.82 ,66.31 
02,000,01,005,0212,377,862,20,882,1167,0,0,0,0,0,0,0,66.31 ,75.58 ,66.31 
02,000,01,005,0213,378,1451,21,1472,1890,0,0,0,0,0,0,0,66.31 ,77.88 ,66.31 
02,000,01,005,0213,379,1538,33,1571,1996,0,0,0,0,0,0,0,66.31 ,78.71 ,66.31 
02,000,01,005,0214,380,944,20,964,1230,0,0,0,0,0,0,0,66.31 ,78.37 ,66.31 
02,000,01,005,0215,381,598,11,609,864,0,0,0,0,0,0,0,66.31 ,70.49 ,66.31 
02,000,01,005,0216,382,992,12,1004,1299,0,0,0,0,0,0,0,66.31 ,77.29 ,66.31 
02,000,01,005,0217,383,964,21,985,1207,0,0,0,0,0,0,0,66.31 ,81.61 ,66.31 
02,000,01,005,0218,384,773,7,780,952,0,0,0,0,0,0,0,66.31 ,81.93 ,66.31 
02,000,01,005,0218,385,920,23,943,1165,0,0,0,0,0,0,0,66.31 ,80.94 ,66.31 
02,000,01,005,0219,386,1031,29,1060,1282,0,0,0,0,0,0,0,66.31 ,82.68 ,66.31 
02,000,01,005,0220,387,342,8,350,451,0,0,0,0,0,0,0,66.31 ,77.61 ,66.31 
02,000,01,005,0221,388,1130,22,1152,1422,0,0,0,0,0,0,0,66.31 ,81.01 ,66.31 
02,000,01,005,0221,389,1087,24,1111,1333,0,0,0,0,0,0,0,66.31 ,83.35 ,66.31 
02,000,01,005,0222,390,1494,36,1530,1926,0,0,0,0,0,0,0,66.31 ,79.44 ,66.31 
02,000,01,005,0223,391,713,21,734,863,0,0,0,0,0,0,0,66.31 ,85.05 ,66.31 
02,000,01,005,0224,392,998,15,1013,1185,0,0,0,0,0,0,0,66.31 ,85.49 ,66.31 
02,000,01,005,0225,393,926,26,952,1171,0,0,0,0,0,0,0,66.31 ,81.30 ,66.31 
02,000,01,005,0226,394,1017,23,1040,1328,0,0,0,0,0,0,0,66.31 ,78.31 ,66.31 
02,000,01,005,0227,395,1099,24,1123,1419,0,0,0,0,0,0,0,66.31 ,79.14 ,66.31 
02,000,01,005,0228,396,954,21,975,1220,0,0,0,0,0,0,0,66.31 ,79.92 ,66.31 
02,000,01,005,0228,397,918,20,938,1157,0,0,0,0,0,0,0,66.31 ,81.07 ,66.31 
02,000,01,006,0229,398,1092,28,1120,1357,0,0,0,0,0,0,0,66.31 ,82.54 ,66.31 
02,000,01,006,0230,399,844,26,870,1128,0,0,0,0,0,0,0,66.31 ,77.13 ,66.31 
02,000,01,006,0231,400,1348,25,1373,1779,0,0,0,0,0,0,0,66.31 ,77.18 ,66.31 
02,000,01,006,0232,401,853,36,889,1083,0,0,0,0,0,0,0,66.31 ,82.09 ,66.31 
02,000,01,006,0232,402,717,37,754,957,0,0,0,0,0,0,0,66.31 ,78.79 ,66.31 
02,000,01,006,0233,403,1040,25,1065,1271,0,0,0,0,0,0,0,66.31 ,83.79 ,66.31 
02,000,01,006,0233,404,979,22,1001,1266,0,0,0,0,0,0,0,66.31 ,79.07 ,66.31 
02,000,01,006,0234,405,1022,19,1041,1260,0,0,0,0,0,0,0,66.31 ,82.62 ,66.31 
02,000,01,006,0235,406,969,29,998,1328,0,0,0,0,0,0,0,66.31 ,75.15 ,66.31 
02,000,01,006,0236,407,904,26,930,1211,0,0,0,0,0,0,0,66.31 ,76.80 ,66.31 
02,000,01,006,0236,408,926,24,950,1148,0,0,0,0,0,0,0,66.31 ,82.75 ,66.31 
02,000,01,006,0237,409,1344,30,1374,1692,0,0,0,0,0,0,0,66.31 ,81.21 ,66.31 
02,000,01,006,0238,410,674,21,695,859,0,0,0,0,0,0,0,66.31 ,80.91 ,66.31 
02,000,01,006,0238,411,1253,35,1288,1562,0,0,0,0,0,0,0,66.31 ,82.46 ,66.31 
02,000,01,006,0239,412,1352,34,1386,1651,0,0,0,0,0,0,0,66.31 ,83.95 ,66.31 
02,000,01,006,0240,413,926,16,942,1183,0,0,0,0,0,0,0,66.31 ,79.63 ,66.31 
02,000,01,006,0241,414,786,24,810,924,0,0,0,0,0,0,0,66.31 ,87.66 ,66.31 
02,000,01,006,0241,415,846,20,866,1016,0,0,0,0,0,0,0,66.31 ,85.24 ,66.31 
02,000,02,007,0242,416,836,21,857,1123,0,0,0,0,0,0,0,66.31 ,76.31 ,66.31 
02,000,02,007,0242,417,742,12,754,964,0,0,0,0,0,0,0,66.31 ,78.22 ,66.31 
02,000,02,007,0243,418,907,13,920,1224,0,0,0,0,0,0,0,66.31 ,75.16 ,66.31 
02,000,02,007,0244,419,578,9,587,775,0,0,0,0,0,0,0,66.31 ,75.74 ,66.31 
02,000,02,007,0244,420,991,8,999,1317,0,0,0,0,0,0,0,66.31 ,75.85 ,66.31 
02,000,02,007,0245,421,989,16,1005,1301,0,0,0,0,0,0,0,66.31 ,77.25 ,66.31 
02,000,02,007,0246,422,622,12,634,806,0,0,0,0,0,0,0,66.31 ,78.66 ,66.31 
02,000,02,007,0246,423,600,14,614,777,0,0,0,0,0,0,0,66.31 ,79.02 ,66.31 
02,000,02,007,0247,424,589,12,601,772,0,0,0,0,0,0,0,66.31 ,77.85 ,66.31 
02,000,02,007,0248,425,583,6,589,766,0,0,0,0,0,0,0,66.31 ,76.89 ,66.31 
02,000,02,007,0249,426,707,13,720,966,0,0,0,0,0,0,0,66.31 ,74.53 ,66.31 
02,000,02,007,0249,427,654,14,668,889,0,0,0,0,0,0,0,66.31 ,75.14 ,66.31 
02,000,02,007,0250,428,784,12,796,1036,0,0,0,0,0,0,0,66.31 ,76.83 ,66.31 
02,000,02,007,0251,429,605,9,614,756,0,0,0,0,0,0,0,66.31 ,81.22 ,66.31 
02,000,02,007,0252,430,1126,16,1142,1458,0,0,0,0,0,0,0,66.31 ,78.33 ,66.31 
02,000,02,007,0253,431,838,13,851,1049,0,0,0,0,0,0,0,66.31 ,81.12 ,66.31 
02,000,02,007,0254,432,929,21,950,1209,0,0,0,0,0,0,0,66.31 ,78.58 ,66.31 
02,000,02,007,0254,433,754,11,765,976,0,0,0,0,0,0,0,66.31 ,78.38 ,66.31 
02,000,02,007,0255,434,774,8,782,1027,0,0,0,0,0,0,0,66.31 ,76.14 ,66.31 
02,000,02,007,0255,435,869,10,879,1121,0,0,0,0,0,0,0,66.31 ,78.41 ,66.31 
02,000,02,007,0256,436,950,9,959,1230,0,0,0,0,0,0,0,66.31 ,77.97 ,66.31 
02,000,02,007,0256,437,995,11,1006,1277,0,0,0,0,0,0,0,66.31 ,78.78 ,66.31 
02,000,02,007,0257,438,701,8,709,883,0,0,0,0,0,0,0,66.31 ,80.29 ,66.31 
02,000,02,007,0258,439,732,5,737,914,0,0,0,0,0,0,0,66.31 ,80.63 ,66.31 
02,000,02,007,0259,440,1043,13,1056,1320,0,0,0,0,0,0,0,66.31 ,80.00 ,66.31 
02,000,02,007,0259,441,1001,17,1018,1241,0,0,0,0,0,0,0,66.31 ,82.03 ,66.31 
02,000,02,007,0260,442,920,14,934,1210,0,0,0,0,0,0,0,66.31 ,77.19 ,66.31 
02,000,02,007,0261,443,895,11,906,1214,0,0,0,0,0,0,0,66.31 ,74.63 ,66.31 
02,000,02,007,0262,444,682,16,698,910,0,0,0,0,0,0,0,66.31 ,76.70 ,66.31 
02,000,02,007,0263,445,747,15,762,951,0,0,0,0,0,0,0,66.31 ,80.13 ,66.31 
02,000,02,007,0264,446,1081,14,1095,1365,0,0,0,0,0,0,0,66.31 ,80.22 ,66.31 
02,000,02,007,0264,447,722,9,731,938,0,0,0,0,0,0,0,66.31 ,77.93 ,66.31 
02,000,02,007,0265,448,775,8,783,1093,0,0,0,0,0,0,0,66.31 ,71.64 ,66.31 
02,000,02,007,0265,449,951,16,967,1319,0,0,0,0,0,0,0,66.31 ,73.31 ,66.31 
02,000,02,007,0266,450,690,20,710,893,0,0,0,0,0,0,0,66.31 ,79.51 ,66.31 
02,000,02,007,0267,451,937,12,949,1197,0,0,0,0,0,0,0,66.31 ,79.28 ,66.31 
02,000,02,007,0268,452,933,16,949,1187,0,0,0,0,0,0,0,66.31 ,79.95 ,66.31 
02,000,02,007,0269,453,655,8,663,840,0,0,0,0,0,0,0,66.31 ,78.93 ,66.31 
02,000,02,007,0270,454,689,16,705,873,0,0,0,0,0,0,0,66.31 ,80.76 ,66.31 
02,000,02,007,0271,455,777,9,786,1015,0,0,0,0,0,0,0,66.31 ,77.44 ,66.31 
02,000,02,007,0272,456,762,16,778,935,0,0,0,0,0,0,0,66.31 ,83.21 ,66.31 
02,000,02,007,0273,457,662,14,676,819,0,0,0,0,0,0,0,66.31 ,82.54 ,66.31 
02,000,02,007,0274,458,1130,15,1145,1407,0,0,0,0,0,0,0,66.31 ,81.38 ,66.31 
02,000,02,008,0275,459,657,17,674,854,0,0,0,0,0,0,0,66.31 ,78.92 ,66.31 
02,000,02,008,0276,460,926,15,941,1204,0,0,0,0,0,0,0,66.31 ,78.16 ,66.31 
02,000,02,008,0277,461,1170,15,1185,1492,0,0,0,0,0,0,0,66.31 ,79.42 ,66.31 
02,000,02,008,0278,462,666,14,680,858,0,0,0,0,0,0,0,66.31 ,79.25 ,66.31 
02,000,02,008,0279,463,688,18,706,949,0,0,0,0,0,0,0,66.31 ,74.39 ,66.31 
02,000,02,008,0280,464,1464,27,1491,1912,0,0,0,0,0,0,0,66.31 ,77.98 ,66.31 
02,000,02,008,0280,465,877,18,895,1186,0,0,0,0,0,0,0,66.31 ,75.46 ,66.31 
02,000,02,008,0281,466,822,15,837,1047,0,0,0,0,0,0,0,66.31 ,79.94 ,66.31 
02,000,02,008,0282,467,832,8,840,1120,0,0,0,0,0,0,0,66.31 ,75.00 ,66.31 
02,000,02,008,0283,468,988,19,1007,1313,0,0,0,0,0,0,0,66.31 ,76.69 ,66.31 
02,000,02,008,0284,469,558,12,570,742,0,0,0,0,0,0,0,66.31 ,76.82 ,66.31 
02,000,02,008,0285,470,753,10,763,1014,0,0,0,0,0,0,0,66.31 ,75.25 ,66.31 
02,000,02,008,0286,471,1014,26,1040,1292,0,0,0,0,0,0,0,66.31 ,80.50 ,66.31 
02,000,02,008,0287,472,941,10,951,1189,0,0,0,0,0,0,0,66.31 ,79.98 ,66.31 
02,000,02,008,0288,473,1434,21,1455,1789,0,0,0,0,0,0,0,66.31 ,81.33 ,66.31 
02,000,02,008,0289,474,824,26,850,1060,0,0,0,0,0,0,0,66.31 ,80.19 ,66.31 
02,000,02,008,0290,475,781,8,789,1018,0,0,0,0,0,0,0,66.31 ,77.50 ,66.31 
02,000,02,008,0291,476,1207,18,1225,1633,0,0,0,0,0,0,0,66.31 ,75.02 ,66.31 
02,000,02,008,0292,477,1069,16,1085,1363,0,0,0,0,0,0,0,66.31 ,79.60 ,66.31 
02,000,02,008,0293,478,884,11,895,1158,0,0,0,0,0,0,0,66.31 ,77.29 ,66.31 
02,000,02,008,0294,479,1163,17,1180,1475,0,0,0,0,0,0,0,66.31 ,80.00 ,66.31 
02,000,02,009,0295,480,598,11,609,754,0,0,0,0,0,0,0,66.31 ,80.77 ,66.31 
02,000,02,009,0296,481,1029,18,1047,1353,0,0,0,0,0,0,0,66.31 ,77.38 ,66.31 
02,000,02,009,0297,482,1123,37,1160,1439,0,0,0,0,0,0,0,66.31 ,80.61 ,66.31 
02,000,02,009,0298,483,1237,26,1263,1556,0,0,0,0,0,0,0,66.31 ,81.17 ,66.31 
02,000,02,009,0299,484,1048,20,1068,1372,0,0,0,0,0,0,0,66.31 ,77.84 ,66.31 
02,000,02,009,0300,485,1162,28,1190,1504,0,0,0,0,0,0,0,66.31 ,79.12 ,66.31 
02,000,02,009,0301,486,1190,24,1214,1533,0,0,0,0,0,0,0,66.31 ,79.19 ,66.31 
02,000,02,009,0302,487,566,10,576,692,0,0,0,0,0,0,0,66.31 ,83.24 ,66.31 
02,000,02,009,0303,488,614,9,623,784,0,0,0,0,0,0,0,66.31 ,79.46 ,66.31 
02,000,02,009,0303,489,762,10,772,966,0,0,0,0,0,0,0,66.31 ,79.92 ,66.31 
02,000,02,009,0304,490,976,19,995,1326,0,0,0,0,0,0,0,66.31 ,75.04 ,66.31 
02,000,02,009,0304,491,388,12,400,530,0,0,0,0,0,0,0,66.31 ,75.47 ,66.31 
02,000,02,009,0305,492,1074,14,1088,1294,0,0,0,0,0,0,0,66.31 ,84.08 ,66.31 
02,000,02,009,0306,493,1189,17,1206,1481,0,0,0,0,0,0,0,66.31 ,81.43 ,66.31 
02,000,02,009,0307,494,1415,25,1440,1827,0,0,0,0,0,0,0,66.31 ,78.82 ,66.31 
02,000,02,009,0308,495,1262,34,1296,1688,0,0,0,0,0,0,0,66.31 ,76.78 ,66.31 
02,000,02,009,0309,496,832,13,845,1059,0,0,0,0,0,0,0,66.31 ,79.79 ,66.31 
02,000,02,009,0309,497,695,20,715,874,0,0,0,0,0,0,0,66.31 ,81.81 ,66.31 
02,000,02,009,0310,498,968,17,985,1238,0,0,0,0,0,0,0,66.31 ,79.56 ,66.31 
02,000,02,009,0311,499,1172,23,1195,1565,0,0,0,0,0,0,0,66.31 ,76.36 ,66.31 
02,000,02,009,0311,500,1102,17,1119,1483,0,0,0,0,0,0,0,66.31 ,75.46 ,66.31 
02,000,02,009,0312,501,900,23,923,1168,0,0,0,0,0,0,0,66.31 ,79.02 ,66.31 
02,000,02,009,0312,502,983,14,997,1260,0,0,0,0,0,0,0,66.31 ,79.13 ,66.31 
02,000,02,009,0313,503,1020,13,1033,1280,0,0,0,0,0,0,0,66.31 ,80.70 ,66.31 
02,000,02,009,0313,504,964,16,980,1280,0,0,0,0,0,0,0,66.31 ,76.56 ,66.31 
02,000,02,009,0314,505,781,9,790,983,0,0,0,0,0,0,0,66.31 ,80.37 ,66.31 
02,000,02,009,0314,506,916,19,935,1179,0,0,0,0,0,0,0,66.31 ,79.30 ,66.31 
02,000,02,009,0315,507,733,14,747,926,0,0,0,0,0,0,0,66.31 ,80.67 ,66.31 
02,000,02,009,0316,508,1188,21,1209,1506,0,0,0,0,0,0,0,66.31 ,80.28 ,66.31 
02,000,02,009,0316,509,909,15,924,1220,0,0,0,0,0,0,0,66.31 ,75.74 ,66.31 
02,000,02,009,0317,510,1219,17,1236,1534,0,0,0,0,0,0,0,66.31 ,80.57 ,66.31 
02,000,02,009,0318,511,729,8,737,962,0,0,0,0,0,0,0,66.31 ,76.61 ,66.31 
02,000,02,009,0318,512,782,21,803,1019,0,0,0,0,0,0,0,66.31 ,78.80 ,66.31 
02,000,02,009,0319,513,1194,17,1211,1522,0,0,0,0,0,0,0,66.31 ,79.57 ,66.31 
02,000,02,009,0320,514,618,13,631,782,0,0,0,0,0,0,0,66.31 ,80.69 ,66.31 
02,000,02,009,0321,515,1172,26,1198,1484,0,0,0,0,0,0,0,66.31 ,80.73 ,66.31 
02,000,02,009,0322,516,1112,21,1133,1388,0,0,0,0,0,0,0,66.31 ,81.63 ,66.31 
02,000,02,009,0322,517,1262,30,1292,1622,0,0,0,0,0,0,0,66.31 ,79.65 ,66.31 
02,000,02,009,0323,518,1482,43,1525,1930,0,0,0,0,0,0,0,66.31 ,79.02 ,66.31 
02,000,02,009,0324,519,1453,35,1488,1839,0,0,0,0,0,0,0,66.31 ,80.91 ,66.31 
02,000,02,009,0324,520,1065,18,1083,1338,0,0,0,0,0,0,0,66.31 ,80.94 ,66.31 
02,000,02,009,0325,521,1320,10,1330,1676,0,0,0,0,0,0,0,66.31 ,79.36 ,66.31 
02,000,02,009,0326,522,1132,16,1148,1481,0,0,0,0,0,0,0,66.31 ,77.52 ,66.31 
02,000,02,009,0326,523,908,12,920,1243,0,0,0,0,0,0,0,66.31 ,74.01 ,66.31 
02,000,02,009,0327,524,855,14,869,1141,0,0,0,0,0,0,0,66.31 ,76.16 ,66.31 
02,000,02,009,0327,525,933,9,942,1236,0,0,0,0,0,0,0,66.31 ,76.21 ,66.31 
02,000,02,009,0328,526,1028,23,1051,1399,0,0,0,0,0,0,0,66.31 ,75.13 ,66.31 
02,000,02,009,0329,527,1174,22,1196,1528,0,0,0,0,0,0,0,66.31 ,78.27 ,66.31 
02,000,02,009,0330,528,584,9,593,733,0,0,0,0,0,0,0,66.31 ,80.90 ,66.31 
02,000,02,009,0330,529,939,14,953,1215,0,0,0,0,0,0,0,66.31 ,78.44 ,66.31 
02,000,02,009,0331,530,711,22,733,938,0,0,0,0,0,0,0,66.31 ,78.14 ,66.31 
02,000,02,009,0331,531,986,17,1003,1337,0,0,0,0,0,0,0,66.31 ,75.02 ,66.31 
02,000,02,009,0332,532,567,7,574,719,0,0,0,0,0,0,0,66.31 ,79.83 ,66.31 
02,000,02,009,0332,533,669,14,683,831,0,0,0,0,0,0,0,66.31 ,82.19 ,66.31 
02,000,02,009,0333,534,1306,18,1324,1624,0,0,0,0,0,0,0,66.31 ,81.53 ,66.31 
02,000,02,009,0334,535,848,27,875,1080,0,0,0,0,0,0,0,66.31 ,81.02 ,66.31 
02,000,02,009,0334,536,1004,14,1018,1189,0,0,0,0,0,0,0,66.31 ,85.62 ,66.31 
02,000,02,009,0335,537,638,9,647,831,0,0,0,0,0,0,0,66.31 ,77.86 ,66.31 
02,000,02,009,0335,538,817,14,831,1056,0,0,0,0,0,0,0,66.31 ,78.69 ,66.31 
02,000,02,009,0336,539,1243,17,1260,1641,0,0,0,0,0,0,0,66.31 ,76.78 ,66.31 
02,000,02,009,0336,540,1398,26,1424,1873,0,0,0,0,0,0,0,66.31 ,76.03 ,66.31 
02,000,02,009,0337,541,701,13,714,891,0,0,0,0,0,0,0,66.31 ,80.13 ,66.31 
02,000,02,009,0337,542,713,14,727,929,0,0,0,0,0,0,0,66.31 ,78.26 ,66.31 
02,000,02,009,0338,543,1080,19,1099,1335,0,0,0,0,0,0,0,66.31 ,82.32 ,66.31 
02,000,02,009,0339,544,1037,16,1053,1326,0,0,0,0,0,0,0,66.31 ,79.41 ,66.31 
02,000,02,009,0339,545,887,14,901,1140,0,0,0,0,0,0,0,66.31 ,79.04 ,66.31 
02,000,02,009,0339,546,1021,32,1053,1307,0,0,0,0,0,0,0,66.31 ,80.57 ,66.31 
02,000,02,009,0340,547,725,13,738,934,0,0,0,0,0,0,0,66.31 ,79.01 ,66.31 
02,000,02,009,0340,548,835,16,851,1046,0,0,0,0,0,0,0,66.31 ,81.36 ,66.31 
02,000,02,009,0341,549,1316,21,1337,1625,0,0,0,0,0,0,0,66.31 ,82.28 ,66.31 
02,000,02,009,0342,550,623,14,637,806,0,0,0,0,0,0,0,66.31 ,79.03 ,66.31 
02,000,02,009,0342,551,568,8,576,731,0,0,0,0,0,0,0,66.31 ,78.80 ,66.31 
02,000,02,009,0343,552,1172,13,1185,1458,0,0,0,0,0,0,0,66.31 ,81.28 ,66.31 
02,000,02,009,0343,553,1011,13,1024,1257,0,0,0,0,0,0,0,66.31 ,81.46 ,66.31 
02,000,02,009,0344,554,1088,11,1099,1367,0,0,0,0,0,0,0,66.31 ,80.40 ,66.31 
02,000,02,009,0345,555,806,26,832,1049,0,0,0,0,0,0,0,66.31 ,79.31 ,66.31 
02,000,02,009,0346,556,836,12,848,1051,0,0,0,0,0,0,0,66.31 ,80.69 ,66.31 
02,000,02,009,0346,557,801,8,809,988,0,0,0,0,0,0,0,66.31 ,81.88 ,66.31 
02,000,02,009,0347,558,978,26,1004,1188,0,0,0,0,0,0,0,66.31 ,84.51 ,66.31 
02,000,02,009,0347,559,918,19,937,1164,0,0,0,0,0,0,0,66.31 ,80.50 ,66.31 
02,000,02,009,0348,560,1196,24,1220,1448,0,0,0,0,0,0,0,66.31 ,84.25 ,66.31 
02,000,02,009,0348,561,1125,24,1149,1433,0,0,0,0,0,0,0,66.31 ,80.18 ,66.31 
02,000,02,009,0349,562,1177,17,1194,1428,0,0,0,0,0,0,0,66.31 ,83.61 ,66.31 
02,000,02,009,0349,563,1149,21,1170,1421,0,0,0,0,0,0,0,66.31 ,82.34 ,66.31 
02,000,02,009,0350,564,912,19,931,1137,0,0,0,0,0,0,0,66.31 ,81.88 ,66.31 
02,000,02,009,0350,565,852,20,872,1151,0,0,0,0,0,0,0,66.31 ,75.76 ,66.31 
02,000,02,009,0351,566,967,17,984,1191,0,0,0,0,0,0,0,66.31 ,82.62 ,66.31 
02,000,02,009,0351,567,902,11,913,1163,0,0,0,0,0,0,0,66.31 ,78.50 ,66.31 
02,000,02,009,0352,568,839,15,854,1017,0,0,0,0,0,0,0,66.31 ,83.97 ,66.31 
02,000,02,009,0352,569,937,18,955,1222,0,0,0,0,0,0,0,66.31 ,78.15 ,66.31 
02,000,02,009,0353,570,1287,24,1311,1604,0,0,0,0,0,0,0,66.31 ,81.73 ,66.31 
02,000,02,009,0354,571,1059,18,1077,1338,0,0,0,0,0,0,0,66.31 ,80.49 ,66.31 
02,000,02,009,0354,572,702,11,713,932,0,0,0,0,0,0,0,66.31 ,76.50 ,66.31 
02,000,02,009,0355,573,958,20,978,1216,0,0,0,0,0,0,0,66.31 ,80.43 ,66.31 
02,000,02,009,0355,574,1043,12,1055,1351,0,0,0,0,0,0,0,66.31 ,78.09 ,66.31 
02,000,02,009,0355,575,1041,18,1059,1375,0,0,0,0,0,0,0,66.31 ,77.02 ,66.31 
02,000,02,009,0356,576,871,22,893,1114,0,0,0,0,0,0,0,66.31 ,80.16 ,66.31 
02,000,02,009,0356,577,1098,16,1114,1426,0,0,0,0,0,0,0,66.31 ,78.12 ,66.31 
02,000,02,009,0356,578,930,26,956,1238,0,0,0,0,0,0,0,66.31 ,77.22 ,66.31 
02,000,02,009,0357,579,1243,28,1271,1591,0,0,0,0,0,0,0,66.31 ,79.89 ,66.31 
02,000,02,009,0357,580,1327,26,1353,1704,0,0,0,0,0,0,0,66.31 ,79.40 ,66.31 
02,000,02,009,0358,581,948,16,964,1206,0,0,0,0,0,0,0,66.31 ,79.93 ,66.31 
02,000,02,009,0358,582,952,13,965,1193,0,0,0,0,0,0,0,66.31 ,80.89 ,66.31 
02,000,02,009,0358,583,873,19,892,1118,0,0,0,0,0,0,0,66.31 ,79.79 ,66.31 
02,000,02,009,0359,584,841,17,858,1036,0,0,0,0,0,0,0,66.31 ,82.82 ,66.31 
02,000,02,009,0359,585,847,12,859,1044,0,0,0,0,0,0,0,66.31 ,82.28 ,66.31 
02,000,02,009,0360,586,996,26,1022,1281,0,0,0,0,0,0,0,66.31 ,79.78 ,66.31 
02,000,02,009,0360,587,795,18,813,997,0,0,0,0,0,0,0,66.31 ,81.54 ,66.31 
02,000,02,009,0361,588,942,15,957,1142,0,0,0,0,0,0,0,66.31 ,83.80 ,66.31 
02,000,02,009,0361,589,975,23,998,1204,0,0,0,0,0,0,0,66.31 ,82.89 ,66.31 
02,000,02,009,0361,590,1124,18,1142,1313,0,0,0,0,0,0,0,66.31 ,86.98 ,66.31 
02,000,02,009,0362,591,758,15,773,954,0,0,0,0,0,0,0,66.31 ,81.03 ,66.31 
02,000,02,009,0362,592,804,19,823,981,0,0,0,0,0,0,0,66.31 ,83.89 ,66.31 
02,000,02,009,0363,593,829,15,844,1048,0,0,0,0,0,0,0,66.31 ,80.53 ,66.31 
02,000,02,009,0363,594,792,23,815,1033,0,0,0,0,0,0,0,66.31 ,78.90 ,66.31 
02,000,02,010,0364,595,1021,20,1041,1238,0,0,0,0,0,0,0,66.31 ,84.09 ,66.31 
02,000,02,010,0364,596,891,20,911,1130,0,0,0,0,0,0,0,66.31 ,80.62 ,66.31 
02,000,02,010,0364,597,983,19,1002,1267,0,0,0,0,0,0,0,66.31 ,79.08 ,66.31 
02,000,02,010,0364,598,918,19,937,1166,0,0,0,0,0,0,0,66.31 ,80.36 ,66.31 
02,000,02,010,0364,599,947,36,983,1219,0,0,0,0,0,0,0,66.31 ,80.64 ,66.31 
02,000,02,010,0364,600,1073,26,1099,1358,0,0,0,0,0,0,0,66.31 ,80.93 ,66.31 
02,000,02,010,0365,601,1241,29,1270,1548,0,0,0,0,0,0,0,66.31 ,82.04 ,66.31 
02,000,02,010,0365,602,706,17,723,950,0,0,0,0,0,0,0,66.31 ,76.11 ,66.31 
02,000,02,010,0366,603,1128,21,1149,1384,0,0,0,0,0,0,0,66.31 ,83.02 ,66.31 
02,000,02,010,0366,604,1443,30,1473,1836,0,0,0,0,0,0,0,66.31 ,80.23 ,66.31 
02,000,02,010,0367,605,852,17,869,1031,0,0,0,0,0,0,0,66.31 ,84.29 ,66.31 
02,000,02,010,0367,606,624,13,637,743,0,0,0,0,0,0,0,66.31 ,85.73 ,66.31 
02,000,02,010,0368,607,1228,40,1268,1551,0,0,0,0,0,0,0,66.31 ,81.75 ,66.31 
02,000,02,010,0369,608,875,19,894,1133,0,0,0,0,0,0,0,66.31 ,78.91 ,66.31 
02,000,02,010,0369,609,632,21,653,843,0,0,0,0,0,0,0,66.31 ,77.46 ,66.31 
02,000,02,010,0370,610,594,26,620,802,0,0,0,0,0,0,0,66.31 ,77.31 ,66.31 
02,000,02,010,0370,611,700,17,717,905,0,0,0,0,0,0,0,66.31 ,79.23 ,66.31 
02,000,02,010,0371,612,668,10,678,825,0,0,0,0,0,0,0,66.31 ,82.18 ,66.31 
02,000,02,010,0372,613,734,19,753,934,0,0,0,0,0,0,0,66.31 ,80.62 ,66.31 
02,000,02,010,0372,614,718,13,731,870,0,0,0,0,0,0,0,66.31 ,84.02 ,66.31 
02,000,02,010,0373,615,812,16,828,1018,0,0,0,0,0,0,0,66.31 ,81.34 ,66.31 
02,000,02,010,0373,616,536,9,545,646,0,0,0,0,0,0,0,66.31 ,84.37 ,66.31 
02,000,02,010,0374,617,914,26,940,1171,0,0,0,0,0,0,0,66.31 ,80.27 ,66.31 
02,000,02,010,0374,618,1131,30,1161,1447,0,0,0,0,0,0,0,66.31 ,80.23 ,66.31 
02,000,02,010,0375,619,1075,18,1093,1339,0,0,0,0,0,0,0,66.31 ,81.63 ,66.31 
02,000,02,010,0376,620,574,13,587,730,0,0,0,0,0,0,0,66.31 ,80.41 ,66.31 
02,000,02,010,0377,621,806,23,829,1008,0,0,0,0,0,0,0,66.31 ,82.24 ,66.31 
02,000,02,010,0378,622,1356,24,1380,1601,0,0,0,0,0,0,0,66.31 ,86.20 ,66.31 
02,000,02,010,0379,623,713,16,729,848,0,0,0,0,0,0,0,66.31 ,85.97 ,66.31 
02,000,02,010,0379,624,906,20,926,1094,0,0,0,0,0,0,0,66.31 ,84.64 ,66.31 
02,000,02,010,0380,625,1126,31,1157,1397,0,0,0,0,0,0,0,66.31 ,82.82 ,66.31 
02,000,02,010,0380,626,846,36,882,1102,0,0,0,0,0,0,0,66.31 ,80.04 ,66.31 
02,000,02,010,0381,627,926,19,945,1143,0,0,0,0,0,0,0,66.31 ,82.68 ,66.31 
02,000,02,010,0381,628,660,16,676,814,0,0,0,0,0,0,0,66.31 ,83.05 ,66.31 
02,000,02,010,0382,629,891,21,912,1123,0,0,0,0,0,0,0,66.31 ,81.21 ,66.31 
02,000,02,010,0382,630,955,37,992,1221,0,0,0,0,0,0,0,66.31 ,81.24 ,66.31 
02,000,02,010,0382,631,907,26,933,1163,0,0,0,0,0,0,0,66.31 ,80.22 ,66.31 
02,000,02,010,0383,632,997,20,1017,1172,0,0,0,0,0,0,0,66.31 ,86.77 ,66.31 
02,000,02,010,0384,633,943,26,969,1195,0,0,0,0,0,0,0,66.31 ,81.09 ,66.31 
02,000,02,010,0385,634,757,24,781,930,0,0,0,0,0,0,0,66.31 ,83.98 ,66.31 
02,000,02,010,0386,635,905,15,920,1117,0,0,0,0,0,0,0,66.31 ,82.36 ,66.31 
02,000,02,010,0387,636,1038,21,1059,1272,0,0,0,0,0,0,0,66.31 ,83.25 ,66.31 
02,000,02,010,0387,637,1091,27,1118,1364,0,0,0,0,0,0,0,66.31 ,81.96 ,66.31 
02,000,02,010,0388,638,948,20,968,1203,0,0,0,0,0,0,0,66.31 ,80.47 ,66.31 
02,000,02,010,0388,639,681,25,706,816,0,0,0,0,0,0,0,66.31 ,86.52 ,66.31 
02,000,02,010,0389,640,1156,24,1180,1479,0,0,0,0,0,0,0,66.31 ,79.78 ,66.31 
02,000,02,010,0389,641,1131,23,1154,1451,0,0,0,0,0,0,0,66.31 ,79.53 ,66.31 
02,000,02,010,0390,642,1161,10,1171,1409,0,0,0,0,0,0,0,66.31 ,83.11 ,66.31 
02,000,02,010,0390,643,1091,27,1118,1364,0,0,0,0,0,0,0,66.31 ,81.96 ,66.31 
02,000,02,010,0391,644,751,19,770,972,0,0,0,0,0,0,0,66.31 ,79.22 ,66.31 
02,000,02,010,0392,645,732,18,750,903,0,0,0,0,0,0,0,66.31 ,83.06 ,66.31 
02,000,02,010,0392,646,602,18,620,727,0,0,0,0,0,0,0,66.31 ,85.28 ,66.31 
02,000,02,010,0393,647,980,14,994,1257,0,0,0,0,0,0,0,66.31 ,79.08 ,66.31 
02,000,02,010,0393,648,790,12,802,1072,0,0,0,0,0,0,0,66.31 ,74.81 ,66.31 
02,000,02,010,0394,649,811,18,829,985,0,0,0,0,0,0,0,66.31 ,84.16 ,66.31 
02,000,02,010,0394,650,821,19,840,1046,0,0,0,0,0,0,0,66.31 ,80.31 ,66.31 
02,000,02,010,0395,651,708,13,721,1018,0,0,0,0,0,0,0,66.31 ,70.83 ,66.31 
02,000,02,010,0395,652,902,19,921,1246,0,0,0,0,0,0,0,66.31 ,73.92 ,66.31 
02,000,02,010,0396,653,1174,20,1194,1545,0,0,0,0,0,0,0,66.31 ,77.28 ,66.31 
02,000,02,010,0396,654,1000,23,1023,1377,0,0,0,0,0,0,0,66.31 ,74.29 ,66.31 
02,000,02,010,0397,655,1144,30,1174,1521,0,0,0,0,0,0,0,66.31 ,77.19 ,66.31 
02,000,02,010,0397,656,1136,29,1165,1583,0,0,0,0,0,0,0,66.31 ,73.59 ,66.31 
02,000,02,010,0398,657,959,27,986,1187,0,0,0,0,0,0,0,66.31 ,83.07 ,66.31 
02,000,02,010,0398,658,930,24,954,1191,0,0,0,0,0,0,0,66.31 ,80.10 ,66.31 
02,000,02,010,0398,659,918,19,937,1185,0,0,0,0,0,0,0,66.31 ,79.07 ,66.31 
02,000,02,010,0399,660,964,12,976,1196,0,0,0,0,0,0,0,66.31 ,81.61 ,66.31 
02,000,02,010,0399,661,956,23,979,1243,0,0,0,0,0,0,0,66.31 ,78.76 ,66.31 
02,000,02,010,0400,662,1111,17,1128,1378,0,0,0,0,0,0,0,66.31 ,81.86 ,66.31 
02,000,02,010,0400,663,1091,21,1112,1372,0,0,0,0,0,0,0,66.31 ,81.05 ,66.31 
02,000,02,010,0401,664,906,21,927,1168,0,0,0,0,0,0,0,66.31 ,79.37 ,66.31 
02,000,02,010,0401,665,1056,28,1084,1381,0,0,0,0,0,0,0,66.31 ,78.49 ,66.31 
02,000,02,010,0402,666,734,21,755,1016,0,0,0,0,0,0,0,66.31 ,74.31 ,66.31 
02,000,02,010,0402,667,739,17,756,962,0,0,0,0,0,0,0,66.31 ,78.59 ,66.31 
02,000,02,010,0403,668,911,19,930,1170,0,0,0,0,0,0,0,66.31 ,79.49 ,66.31 
02,000,02,010,0403,669,884,76,960,1204,0,0,0,0,0,0,0,66.31 ,79.73 ,66.31 
02,000,02,010,0404,670,814,14,828,1060,0,0,0,0,0,0,0,66.31 ,78.11 ,66.31 
02,000,02,010,0404,671,643,15,658,851,0,0,0,0,0,0,0,66.31 ,77.32 ,66.31 
02,000,02,010,0405,672,1053,22,1075,1297,0,0,0,0,0,0,0,66.31 ,82.88 ,66.31 
02,000,02,010,0405,673,1373,13,1386,1698,0,0,0,0,0,0,0,66.31 ,81.63 ,66.31 
02,000,02,010,0406,674,1100,19,1119,1409,0,0,0,0,0,0,0,66.31 ,79.42 ,66.31 
02,000,02,010,0406,675,972,21,993,1243,0,0,0,0,0,0,0,66.31 ,79.89 ,66.31 
02,000,02,010,0407,676,1054,26,1080,1333,0,0,0,0,0,0,0,66.31 ,81.02 ,66.31 
02,000,02,010,0408,677,1058,25,1083,1321,0,0,0,0,0,0,0,66.31 ,81.98 ,66.31 
02,000,02,010,0408,678,1283,21,1304,1540,0,0,0,0,0,0,0,66.31 ,84.68 ,66.31 
02,000,02,010,0408,679,1198,24,1222,1486,0,0,0,0,0,0,0,66.31 ,82.23 ,66.31 
02,000,02,010,0409,680,970,20,990,1197,0,0,0,0,0,0,0,66.31 ,82.71 ,66.31 
02,000,02,010,0409,681,816,23,839,1013,0,0,0,0,0,0,0,66.31 ,82.82 ,66.31 
02,000,02,010,0410,682,909,14,923,1170,0,0,0,0,0,0,0,66.31 ,78.89 ,66.31 
02,000,02,010,0410,683,954,26,980,1165,0,0,0,0,0,0,0,66.31 ,84.12 ,66.31 
02,000,02,010,0410,684,1530,18,1548,1854,0,0,0,0,0,0,0,66.31 ,83.50 ,66.31 
02,000,02,010,0411,685,929,15,944,1156,0,0,0,0,0,0,0,66.31 ,81.66 ,66.31 
02,000,02,010,0411,686,973,15,988,1252,0,0,0,0,0,0,0,66.31 ,78.91 ,66.31 
02,000,02,010,0412,687,769,20,789,947,0,0,0,0,0,0,0,66.31 ,83.32 ,66.31 
02,000,02,010,0412,688,783,29,812,1019,0,0,0,0,0,0,0,66.31 ,79.69 ,66.31 
02,000,02,010,0413,689,1189,24,1213,1451,0,0,0,0,0,0,0,66.31 ,83.60 ,66.31 
02,000,02,010,0413,690,1225,29,1254,1506,0,0,0,0,0,0,0,66.31 ,83.27 ,66.31 
02,000,02,010,0414,691,1014,26,1040,1332,0,0,0,0,0,0,0,66.31 ,78.08 ,66.31 
02,000,02,010,0414,692,1260,27,1287,1608,0,0,0,0,0,0,0,66.31 ,80.04 ,66.31 
02,000,02,010,0415,693,1137,22,1159,1375,0,0,0,0,0,0,0,66.31 ,84.29 ,66.31 
02,000,02,010,0415,694,1095,18,1113,1347,0,0,0,0,0,0,0,66.31 ,82.63 ,66.31 
02,000,02,010,0416,695,1146,22,1168,1390,0,0,0,0,0,0,0,66.31 ,84.03 ,66.31 
02,000,02,010,0416,696,1126,21,1147,1307,0,0,0,0,0,0,0,66.31 ,87.76 ,66.31 
02,000,02,010,0417,697,1173,27,1200,1481,0,0,0,0,0,0,0,66.31 ,81.03 ,66.31 
02,000,02,010,0417,698,885,18,903,1124,0,0,0,0,0,0,0,66.31 ,80.34 ,66.31 
02,000,02,010,0418,699,1010,20,1030,1257,0,0,0,0,0,0,0,66.31 ,81.94 ,66.31 
02,000,02,010,0418,700,1041,16,1057,1320,0,0,0,0,0,0,0,66.31 ,80.08 ,66.31 
02,000,02,010,0419,701,1011,25,1036,1265,0,0,0,0,0,0,0,66.31 ,81.90 ,66.31 
02,000,02,010,0419,702,700,14,714,883,0,0,0,0,0,0,0,66.31 ,80.86 ,66.31 
02,000,02,010,0420,703,736,16,752,921,0,0,0,0,0,0,0,66.31 ,81.65 ,66.31 
02,000,02,010,0420,704,984,20,1004,1237,0,0,0,0,0,0,0,66.31 ,81.16 ,66.31 
02,000,02,010,0421,705,1384,31,1415,1758,0,0,0,0,0,0,0,66.31 ,80.49 ,66.31 
02,000,02,010,0421,706,1260,22,1282,1630,0,0,0,0,0,0,0,66.31 ,78.65 ,66.31 
02,000,02,010,0422,707,924,24,948,1208,0,0,0,0,0,0,0,66.31 ,78.48 ,66.31 
02,000,02,010,0422,708,932,31,963,1235,0,0,0,0,0,0,0,66.31 ,77.98 ,66.31 
02,000,02,011,0423,709,576,20,596,713,0,0,0,0,0,0,0,66.31 ,83.59 ,66.31 
02,000,02,011,0423,710,826,19,845,1029,0,0,0,0,0,0,0,66.31 ,82.12 ,66.31 
02,000,02,011,0424,711,1083,14,1097,1362,0,0,0,0,0,0,0,66.31 ,80.54 ,66.31 
02,000,02,011,0424,712,1050,15,1065,1347,0,0,0,0,0,0,0,66.31 ,79.06 ,66.31 
02,000,02,011,0425,713,762,9,771,953,0,0,0,0,0,0,0,66.31 ,80.90 ,66.31 
02,000,02,011,0425,714,745,14,759,912,0,0,0,0,0,0,0,66.31 ,83.22 ,66.31 
02,000,02,011,0426,715,1094,25,1119,1321,0,0,0,0,0,0,0,66.31 ,84.71 ,66.31 
02,000,02,011,0427,716,1031,26,1057,1240,0,0,0,0,0,0,0,66.31 ,85.24 ,66.31 
02,000,02,011,0427,717,1054,26,1080,1283,0,0,0,0,0,0,0,66.31 ,84.18 ,66.31 
02,000,02,011,0428,718,691,14,705,831,0,0,0,0,0,0,0,66.31 ,84.84 ,66.31 
02,000,02,011,0428,719,646,9,655,782,0,0,0,0,0,0,0,66.31 ,83.76 ,66.31 
02,000,02,011,0429,720,1031,15,1046,1295,0,0,0,0,0,0,0,66.31 ,80.77 ,66.31 
02,000,02,011,0430,721,1398,21,1419,1685,0,0,0,0,0,0,0,66.31 ,84.21 ,66.31 
02,000,02,011,0431,722,1222,24,1246,1542,0,0,0,0,0,0,0,66.31 ,80.80 ,66.31 
02,000,02,011,0432,723,984,20,1004,1222,0,0,0,0,0,0,0,66.31 ,82.16 ,66.31 
02,000,02,011,0432,724,1067,18,1085,1287,0,0,0,0,0,0,0,66.31 ,84.30 ,66.31 
02,000,02,011,0432,725,998,12,1010,1261,0,0,0,0,0,0,0,66.31 ,80.10 ,66.31 
02,000,02,011,0433,726,726,5,731,913,0,0,0,0,0,0,0,66.31 ,80.07 ,66.31 
02,000,02,011,0433,727,823,15,838,991,0,0,0,0,0,0,0,66.31 ,84.56 ,66.31 
02,000,02,011,0434,728,991,19,1010,1222,0,0,0,0,0,0,0,66.31 ,82.65 ,66.31 
02,000,02,011,0434,729,1083,17,1100,1340,0,0,0,0,0,0,0,66.31 ,82.09 ,66.31 
02,000,02,011,0435,730,949,22,971,1184,0,0,0,0,0,0,0,66.31 ,82.01 ,66.31 
02,000,02,011,0435,731,854,10,864,1001,0,0,0,0,0,0,0,66.31 ,86.31 ,66.31 
02,000,02,011,0436,732,1146,26,1172,1472,0,0,0,0,0,0,0,66.31 ,79.62 ,66.31 
02,000,02,011,0436,733,1153,19,1172,1467,0,0,0,0,0,0,0,66.31 ,79.89 ,66.31 
02,000,02,011,0437,734,1072,21,1093,1368,0,0,0,0,0,0,0,66.31 ,79.90 ,66.31 
02,000,02,011,0437,735,1154,20,1174,1448,0,0,0,0,0,0,0,66.31 ,81.08 ,66.31 
02,000,02,011,0438,736,888,19,907,1093,0,0,0,0,0,0,0,66.31 ,82.98 ,66.31 
02,000,02,011,0439,737,1496,32,1528,1856,0,0,0,0,0,0,0,66.31 ,82.33 ,66.31 
02,000,02,011,0440,738,928,26,954,1201,0,0,0,0,0,0,0,66.31 ,79.43 ,66.31 
02,000,02,011,0440,739,826,16,842,1056,0,0,0,0,0,0,0,66.31 ,79.73 ,66.31 
02,000,02,011,0441,740,1378,35,1413,1700,0,0,0,0,0,0,0,66.31 ,83.12 ,66.31 
02,000,02,011,0442,741,1007,21,1028,1250,0,0,0,0,0,0,0,66.31 ,82.24 ,66.31 
02,000,02,011,0442,742,871,22,893,1102,0,0,0,0,0,0,0,66.31 ,81.03 ,66.31 
02,000,02,011,0443,743,1421,26,1447,1712,0,0,0,0,0,0,0,66.31 ,84.52 ,66.31 
02,000,02,011,0444,744,1263,31,1294,1562,0,0,0,0,0,0,0,66.31 ,82.84 ,66.31 
02,000,02,011,0444,745,1295,26,1321,1611,0,0,0,0,0,0,0,66.31 ,82.00 ,66.31 
02,000,02,011,0445,746,1214,26,1240,1477,0,0,0,0,0,0,0,66.31 ,83.95 ,66.31 
02,000,02,011,0445,747,1213,19,1232,1445,0,0,0,0,0,0,0,66.31 ,85.26 ,66.31 
02,000,02,011,0446,748,1241,35,1276,1610,0,0,0,0,0,0,0,66.31 ,79.25 ,66.31 
02,000,02,011,0447,749,1050,17,1067,1272,0,0,0,0,0,0,0,66.31 ,83.88 ,66.31 
02,000,02,011,0448,750,800,13,813,950,0,0,0,0,0,0,0,66.31 ,85.58 ,66.31 
02,000,02,011,0449,751,818,13,831,958,0,0,0,0,0,0,0,66.31 ,86.74 ,66.31 
02,000,02,011,0450,752,889,21,910,1053,0,0,0,0,0,0,0,66.31 ,86.42 ,66.31 
02,000,02,011,0450,753,709,21,730,955,0,0,0,0,0,0,0,66.31 ,76.44 ,66.31 
02,000,02,011,0450,754,734,21,755,981,0,0,0,0,0,0,0,66.31 ,76.96 ,66.31 
02,000,02,011,0451,755,1240,23,1263,1489,0,0,0,0,0,0,0,66.31 ,84.82 ,66.31 
02,000,02,011,0452,756,790,12,802,966,0,0,0,0,0,0,0,66.31 ,83.02 ,66.31 
02,000,02,011,0452,757,753,19,772,935,0,0,0,0,0,0,0,66.31 ,82.57 ,66.31 
02,000,02,011,0453,758,1240,26,1266,1589,0,0,0,0,0,0,0,66.31 ,79.67 ,66.31 
02,000,02,011,0453,759,1354,41,1395,1699,0,0,0,0,0,0,0,66.31 ,82.11 ,66.31 
02,000,02,011,0453,760,1137,27,1164,1460,0,0,0,0,0,0,0,66.31 ,79.73 ,66.31 
02,000,02,011,0454,761,845,15,860,1029,0,0,0,0,0,0,0,66.31 ,83.58 ,66.31 
02,000,02,011,0454,762,1045,15,1060,1266,0,0,0,0,0,0,0,66.31 ,83.73 ,66.31 
02,000,02,011,0455,763,811,8,819,948,0,0,0,0,0,0,0,66.31 ,86.39 ,66.31 
02,000,02,011,0455,764,943,20,963,1100,0,0,0,0,0,0,0,66.31 ,87.55 ,66.31 
02,000,02,011,0456,765,776,18,794,920,0,0,0,0,0,0,0,66.31 ,86.30 ,66.31 
02,000,02,011,0456,766,867,9,876,1018,0,0,0,0,0,0,0,66.31 ,86.05 ,66.31 
02,000,02,011,0457,767,1229,15,1244,1470,0,0,0,0,0,0,0,66.31 ,84.63 ,66.31 
02,000,02,011,0458,768,818,14,832,1035,0,0,0,0,0,0,0,66.31 ,80.39 ,66.31 
02,000,02,011,0458,769,854,15,869,1063,0,0,0,0,0,0,0,66.31 ,81.75 ,66.31 
02,000,02,011,0459,770,1231,19,1250,1473,0,0,0,0,0,0,0,66.31 ,84.86 ,66.31 
02,000,02,011,0460,771,896,9,905,1059,0,0,0,0,0,0,0,66.31 ,85.46 ,66.31 
02,000,02,011,0460,772,970,24,994,1222,0,0,0,0,0,0,0,66.31 ,81.34 ,66.31 
02,000,02,011,0461,773,1159,30,1189,1399,0,0,0,0,0,0,0,66.31 ,84.99 ,66.31 
02,000,02,011,0461,774,1074,32,1106,1315,0,0,0,0,0,0,0,66.31 ,84.11 ,66.31 
02,000,02,011,0461,775,1238,22,1260,1590,0,0,0,0,0,0,0,66.31 ,79.25 ,66.31 
02,000,02,011,0462,776,873,16,889,1120,0,0,0,0,0,0,0,66.31 ,79.38 ,66.31 
02,000,02,011,0462,777,913,18,931,1135,0,0,0,0,0,0,0,66.31 ,82.03 ,66.31 
02,000,02,011,0463,778,1061,29,1090,1334,0,0,0,0,0,0,0,66.31 ,81.71 ,66.31 
02,000,02,011,0463,779,866,7,873,1062,0,0,0,0,0,0,0,66.31 ,82.20 ,66.31 
02,000,02,011,0464,780,998,25,1023,1300,0,0,0,0,0,0,0,66.31 ,78.69 ,66.31 
02,000,02,011,0464,781,1093,27,1120,1429,0,0,0,0,0,0,0,66.31 ,78.38 ,66.31 
02,000,02,011,0465,782,1044,23,1067,1355,0,0,0,0,0,0,0,66.31 ,78.75 ,66.31 
02,000,02,011,0465,783,1045,34,1079,1380,0,0,0,0,0,0,0,66.31 ,78.19 ,66.31 
03,001,01,001,0001,1,681,9,690,1166,0,0,0,0,0,0,0,66.31 ,59.18 ,66.31 
03,001,01,001,0002,2,763,12,775,1234,0,0,0,0,0,0,0,66.31 ,62.80 ,66.31 
03,001,01,001,0003,3,417,12,429,642,0,0,0,0,0,0,0,66.31 ,66.82 ,66.31 
03,001,01,001,0004,4,701,8,709,1066,0,0,0,0,0,0,0,66.31 ,66.51 ,66.31 
03,001,01,001,0005,5,526,8,534,819,0,0,0,0,0,0,0,66.31 ,65.20 ,66.31 
03,001,01,001,0005,6,405,5,410,680,0,0,0,0,0,0,0,66.31 ,60.29 ,66.31 
03,001,01,001,0006,7,580,15,595,878,0,0,0,0,0,0,0,66.31 ,67.77 ,66.31 
03,001,01,001,0006,8,541,11,552,921,0,0,0,0,0,0,0,66.31 ,59.93 ,66.31 
03,001,01,001,0006,9,523,9,532,817,0,0,0,0,0,0,0,66.31 ,65.12 ,66.31 
03,001,01,001,0006,10,712,10,722,1127,0,0,0,0,0,0,0,66.31 ,64.06 ,66.31 
03,001,01,001,0007,11,795,13,808,1170,0,0,0,0,0,0,0,66.31 ,69.06 ,66.31 
03,001,01,001,0007,12,759,11,770,1228,0,0,0,0,0,0,0,66.31 ,62.70 ,66.31 
03,001,01,001,0008,13,641,13,654,1077,0,0,0,0,0,0,0,66.31 ,60.72 ,66.31 
03,001,01,001,0008,14,866,12,878,1360,0,0,0,0,0,0,0,66.31 ,64.56 ,66.31 
03,001,01,001,0008,15,667,10,677,1076,0,0,0,0,0,0,0,66.31 ,62.92 ,66.31 
03,001,01,001,0008,16,574,7,581,980,0,0,0,0,0,0,0,66.31 ,59.29 ,66.31 
03,001,01,001,0009,17,747,12,759,1145,0,0,0,0,0,0,0,66.31 ,66.29 ,66.31 
03,001,01,001,0009,18,681,10,691,1057,0,0,0,0,0,0,0,66.31 ,65.37 ,66.31 
03,001,01,001,0009,19,636,7,643,1002,0,0,0,0,0,0,0,66.31 ,64.17 ,66.31 
03,001,01,001,0010,20,626,4,630,963,0,0,0,0,0,0,0,66.31 ,65.42 ,66.31 
03,001,01,001,0010,21,645,5,650,1062,0,0,0,0,0,0,0,66.31 ,61.21 ,66.31 
03,001,01,001,0011,22,647,8,655,1131,0,0,0,0,0,0,0,66.31 ,57.91 ,66.31 
03,001,01,001,0011,23,709,10,719,1171,0,0,0,0,0,0,0,66.31 ,61.40 ,66.31 
03,001,01,001,0011,24,626,8,634,1139,0,0,0,0,0,0,0,66.31 ,55.66 ,66.31 
03,001,01,001,0012,25,667,6,673,1108,0,0,0,0,0,0,0,66.31 ,60.74 ,66.31 
03,001,01,001,0012,26,638,8,646,974,0,0,0,0,0,0,0,66.31 ,66.32 ,66.31 
03,001,01,001,0012,27,653,9,662,1154,0,0,0,0,0,0,0,66.31 ,57.37 ,66.31 
03,001,01,001,0012,28,627,12,639,1046,0,0,0,0,0,0,0,66.31 ,61.09 ,66.31 
03,001,01,001,0013,29,843,11,854,1237,0,0,0,0,0,0,0,66.31 ,69.04 ,66.31 
03,001,01,001,0013,30,721,12,733,1086,0,0,0,0,0,0,0,66.31 ,67.50 ,66.31 
03,001,01,001,0014,31,656,11,667,1132,0,0,0,0,0,0,0,66.31 ,58.92 ,66.31 
03,001,01,001,0014,32,630,2,632,964,0,0,0,0,0,0,0,66.31 ,65.56 ,66.31 
03,001,01,001,0015,33,686,6,692,1078,0,0,0,0,0,0,0,66.31 ,64.19 ,66.31 
03,001,01,001,0015,34,686,12,698,1053,0,0,0,0,0,0,0,66.31 ,66.29 ,66.31 
03,001,01,001,0016,35,759,6,765,1113,0,0,0,0,0,0,0,66.31 ,68.73 ,66.31 
03,001,01,001,0016,36,742,1,743,1038,0,0,0,0,0,0,0,66.31 ,71.58 ,66.31 
03,001,01,001,0016,37,584,10,594,941,0,0,0,0,0,0,0,66.31 ,63.12 ,66.31 
03,001,01,001,0017,38,495,3,498,890,0,0,0,0,0,0,0,66.31 ,55.96 ,66.31 
03,001,01,001,0017,39,451,4,455,784,0,0,0,0,0,0,0,66.31 ,58.04 ,66.31 
03,001,01,001,0018,40,652,7,659,1145,0,0,0,0,0,0,0,66.31 ,57.55 ,66.31 
03,001,01,001,0018,41,692,13,705,1200,0,0,0,0,0,0,0,66.31 ,58.75 ,66.31 
03,001,01,001,0018,42,563,5,568,999,0,0,0,0,0,0,0,66.31 ,56.86 ,66.31 
03,001,01,001,0019,43,582,7,589,1060,0,0,0,0,0,0,0,66.31 ,55.57 ,66.31 
03,001,01,001,0019,44,551,13,564,1036,0,0,0,0,0,0,0,66.31 ,54.44 ,66.31 
03,001,01,001,0019,45,575,6,581,1005,0,0,0,0,0,0,0,66.31 ,57.81 ,66.31 
03,001,01,001,0020,46,581,12,593,1125,0,0,0,0,0,0,0,66.31 ,52.71 ,66.31 
03,001,01,001,0020,47,512,9,521,1038,0,0,0,0,0,0,0,66.31 ,50.19 ,66.31 
03,001,01,001,0020,48,455,11,466,856,0,0,0,0,0,0,0,66.31 ,54.44 ,66.31 
03,001,01,001,0020,49,579,5,584,1018,0,0,0,0,0,0,0,66.31 ,57.37 ,66.31 
03,001,01,001,0021,50,765,5,770,1184,0,0,0,0,0,0,0,66.31 ,65.03 ,66.31 
03,001,01,001,0021,51,818,10,828,1257,0,0,0,0,0,0,0,66.31 ,65.87 ,66.31 
03,001,01,001,0022,52,509,8,517,775,0,0,0,0,0,0,0,66.31 ,66.71 ,66.31 
03,001,01,001,0022,53,610,8,618,920,0,0,0,0,0,0,0,66.31 ,67.17 ,66.31 
03,001,01,001,0023,54,606,3,609,966,0,0,0,0,0,0,0,66.31 ,63.04 ,66.31 
03,001,01,001,0023,55,737,17,754,1163,0,0,0,0,0,0,0,66.31 ,64.83 ,66.31 
03,001,01,001,0023,56,642,7,649,963,0,0,0,0,0,0,0,66.31 ,67.39 ,66.31 
03,001,01,001,0024,57,581,1,582,957,0,0,0,0,0,0,0,66.31 ,60.82 ,66.31 
03,001,01,001,0024,58,866,3,869,1302,0,0,0,0,0,0,0,66.31 ,66.74 ,66.31 
03,001,01,001,0024,59,720,17,737,1270,0,0,0,0,0,0,0,66.31 ,58.03 ,66.31 
03,001,01,001,0025,60,736,9,745,1130,0,0,0,0,0,0,0,66.31 ,65.93 ,66.31 
03,001,01,001,0025,61,613,8,621,975,0,0,0,0,0,0,0,66.31 ,63.69 ,66.31 
03,001,01,001,0025,62,546,6,552,932,0,0,0,0,0,0,0,66.31 ,59.23 ,66.31 
03,001,01,001,0026,63,728,14,742,1161,0,0,0,0,0,0,0,66.31 ,63.91 ,66.31 
03,001,01,001,0026,64,595,6,601,933,0,0,0,0,0,0,0,66.31 ,64.42 ,66.31 
03,001,01,001,0026,65,809,15,824,1264,0,0,0,0,0,0,0,66.31 ,65.19 ,66.31 
03,001,01,001,0027,66,574,8,582,880,0,0,0,0,0,0,0,66.31 ,66.14 ,66.31 
03,001,01,001,0027,67,693,12,705,1150,0,0,0,0,0,0,0,66.31 ,61.30 ,66.31 
03,001,01,001,0027,68,697,4,701,1184,0,0,0,0,0,0,0,66.31 ,59.21 ,66.31 
03,001,01,001,0028,69,445,12,457,900,0,0,0,0,0,0,0,66.31 ,50.78 ,66.31 
03,001,01,001,0028,70,552,8,560,933,0,0,0,0,0,0,0,66.31 ,60.02 ,66.31 
03,001,01,001,0029,71,709,7,716,1069,0,0,0,0,0,0,0,66.31 ,66.98 ,66.31 
03,001,01,001,0029,72,663,9,672,992,0,0,0,0,0,0,0,66.31 ,67.74 ,66.31 
03,001,01,001,0030,73,746,5,751,1182,0,0,0,0,0,0,0,66.31 ,63.54 ,66.31 
03,001,01,001,0030,74,643,15,658,1081,0,0,0,0,0,0,0,66.31 ,60.87 ,66.31 
03,001,01,001,0031,75,621,9,630,966,0,0,0,0,0,0,0,66.31 ,65.22 ,66.31 
03,001,01,001,0031,76,701,8,709,992,0,0,0,0,0,0,0,66.31 ,71.47 ,66.31 
03,001,01,001,0032,77,785,14,799,1228,0,0,0,0,0,0,0,66.31 ,65.07 ,66.31 
03,001,01,001,0032,78,742,10,752,1174,0,0,0,0,0,0,0,66.31 ,64.05 ,66.31 
03,001,01,001,0033,79,588,5,593,907,0,0,0,0,0,0,0,66.31 ,65.38 ,66.31 
03,001,01,001,0033,80,742,15,757,1111,0,0,0,0,0,0,0,66.31 ,68.14 ,66.31 
03,001,01,001,0034,81,470,12,482,831,0,0,0,0,0,0,0,66.31 ,58.00 ,66.31 
03,001,01,001,0034,82,566,4,570,866,0,0,0,0,0,0,0,66.31 ,65.82 ,66.31 
03,001,01,001,0034,83,799,17,816,1322,0,0,0,0,0,0,0,66.31 ,61.72 ,66.31 
03,001,01,001,0035,84,739,10,749,1204,0,0,0,0,0,0,0,66.31 ,62.21 ,66.31 
03,001,01,001,0035,85,791,12,803,1196,0,0,0,0,0,0,0,66.31 ,67.14 ,66.31 
03,001,01,001,0035,86,711,13,724,1211,0,0,0,0,0,0,0,66.31 ,59.79 ,66.31 
03,001,01,001,0036,87,604,10,614,1023,0,0,0,0,0,0,0,66.31 ,60.02 ,66.31 
03,001,01,001,0036,88,680,12,692,1161,0,0,0,0,0,0,0,66.31 ,59.60 ,66.31 
03,001,01,001,0036,89,768,12,780,1339,0,0,0,0,0,0,0,66.31 ,58.25 ,66.31 
03,001,01,001,0037,90,565,8,573,968,0,0,0,0,0,0,0,66.31 ,59.19 ,66.31 
03,001,01,001,0037,91,641,8,649,1122,0,0,0,0,0,0,0,66.31 ,57.84 ,66.31 
03,001,01,001,0037,92,622,6,628,1049,0,0,0,0,0,0,0,66.31 ,59.87 ,66.31 
03,001,01,001,0037,93,605,12,617,992,0,0,0,0,0,0,0,66.31 ,62.20 ,66.31 
03,001,01,001,0038,94,469,4,473,831,0,0,0,0,0,0,0,66.31 ,56.92 ,66.31 
03,001,01,001,0038,95,727,8,735,1136,0,0,0,0,0,0,0,66.31 ,64.70 ,66.31 
03,001,01,001,0039,96,716,10,726,1172,0,0,0,0,0,0,0,66.31 ,61.95 ,66.31 
03,001,01,001,0039,97,774,8,782,1224,0,0,0,0,0,0,0,66.31 ,63.89 ,66.31 
03,001,01,001,0040,98,743,15,758,1092,0,0,0,0,0,0,0,66.31 ,69.41 ,66.31 
03,001,01,001,0040,99,757,15,772,1144,0,0,0,0,0,0,0,66.31 ,67.48 ,66.31 
03,001,01,001,0041,100,751,24,775,1209,0,0,0,0,0,0,0,66.31 ,64.10 ,66.31 
03,001,01,001,0041,101,888,15,903,1336,0,0,0,0,0,0,0,66.31 ,67.59 ,66.31 
03,001,01,001,0042,102,828,12,840,1386,0,0,0,0,0,0,0,66.31 ,60.61 ,66.31 
03,001,01,001,0042,103,913,7,920,1575,0,0,0,0,0,0,0,66.31 ,58.41 ,66.31 
03,001,01,001,0042,104,930,20,950,1543,0,0,0,0,0,0,0,66.31 ,61.57 ,66.31 
03,001,01,001,0043,105,456,4,460,736,0,0,0,0,0,0,0,66.31 ,62.50 ,66.31 
03,001,01,001,0043,106,481,3,484,786,0,0,0,0,0,0,0,66.31 ,61.58 ,66.31 
03,001,01,001,0043,107,628,9,637,1075,0,0,0,0,0,0,0,66.31 ,59.26 ,66.31 
03,001,01,001,0044,108,620,6,626,984,0,0,0,0,0,0,0,66.31 ,63.62 ,66.31 
03,001,01,001,0044,109,541,14,555,890,0,0,0,0,0,0,0,66.31 ,62.36 ,66.31 
03,001,01,001,0044,110,571,14,585,901,0,0,0,0,0,0,0,66.31 ,64.93 ,66.31 
03,001,01,001,0045,111,571,12,583,955,0,0,0,0,0,0,0,66.31 ,61.05 ,66.31 
03,001,01,001,0045,112,676,12,688,1038,0,0,0,0,0,0,0,66.31 ,66.28 ,66.31 
03,001,01,001,0045,113,650,8,658,1063,0,0,0,0,0,0,0,66.31 ,61.90 ,66.31 
03,001,01,001,0046,114,543,5,548,950,0,0,0,0,0,0,0,66.31 ,57.68 ,66.31 
03,001,01,001,0046,115,531,9,540,865,0,0,0,0,0,0,0,66.31 ,62.43 ,66.31 
03,001,01,001,0046,116,512,9,521,809,0,0,0,0,0,0,0,66.31 ,64.40 ,66.31 
03,001,01,001,0047,117,527,4,531,790,0,0,0,0,0,0,0,66.31 ,67.22 ,66.31 
03,001,01,001,0047,118,501,6,507,861,0,0,0,0,0,0,0,66.31 ,58.89 ,66.31 
03,001,01,001,0047,119,573,14,587,941,0,0,0,0,0,0,0,66.31 ,62.38 ,66.31 
03,001,01,001,0048,120,470,8,478,775,0,0,0,0,0,0,0,66.31 ,61.68 ,66.31 
03,001,01,001,0048,121,618,7,625,1015,0,0,0,0,0,0,0,66.31 ,61.58 ,66.31 
03,001,01,001,0048,122,648,6,654,1073,0,0,0,0,0,0,0,66.31 ,60.95 ,66.31 
03,001,01,001,0048,123,690,11,701,1118,0,0,0,0,0,0,0,66.31 ,62.70 ,66.31 
03,001,01,001,0049,124,734,6,740,1303,0,0,0,0,0,0,0,66.31 ,56.79 ,66.31 
03,001,01,001,0049,125,869,11,880,1454,0,0,0,0,0,0,0,66.31 ,60.52 ,66.31 
03,001,01,001,0050,126,697,6,703,1171,0,0,0,0,0,0,0,66.31 ,60.03 ,66.31 
03,001,01,001,0050,127,754,10,764,1251,0,0,0,0,0,0,0,66.31 ,61.07 ,66.31 
03,001,01,001,0051,128,513,4,517,894,0,0,0,0,0,0,0,66.31 ,57.83 ,66.31 
03,001,01,001,0051,129,615,6,621,1089,0,0,0,0,0,0,0,66.31 ,57.02 ,66.31 
03,001,01,001,0051,130,636,6,642,979,0,0,0,0,0,0,0,66.31 ,65.58 ,66.31 
03,001,01,001,0052,131,738,13,751,1075,0,0,0,0,0,0,0,66.31 ,69.86 ,66.31 
03,001,01,001,0052,132,526,6,532,854,0,0,0,0,0,0,0,66.31 ,62.30 ,66.31 
03,001,01,001,0053,133,748,12,760,1238,0,0,0,0,0,0,0,66.31 ,61.39 ,66.31 
03,001,01,001,0053,134,773,13,786,1358,0,0,0,0,0,0,0,66.31 ,57.88 ,66.31 
03,001,01,001,0054,135,751,14,765,1251,0,0,0,0,0,0,0,66.31 ,61.15 ,66.31 
03,001,01,001,0054,136,639,6,645,1084,0,0,0,0,0,0,0,66.31 ,59.50 ,66.31 
03,001,01,001,0055,137,839,7,846,1370,0,0,0,0,0,0,0,66.31 ,61.75 ,66.31 
03,001,01,001,0055,138,752,21,773,1208,0,0,0,0,0,0,0,66.31 ,63.99 ,66.31 
03,001,01,001,0055,139,782,14,796,1381,0,0,0,0,0,0,0,66.31 ,57.64 ,66.31 
03,001,01,001,0056,140,609,12,621,1094,0,0,0,0,0,0,0,66.31 ,56.76 ,66.31 
03,001,01,001,0056,141,608,10,618,1030,0,0,0,0,0,0,0,66.31 ,60.00 ,66.31 
03,001,01,001,0057,142,694,11,705,1102,0,0,0,0,0,0,0,66.31 ,63.97 ,66.31 
03,001,01,001,0057,143,638,16,654,979,0,0,0,0,0,0,0,66.31 ,66.80 ,66.31 
03,001,01,001,0058,144,703,6,709,1140,0,0,0,0,0,0,0,66.31 ,62.19 ,66.31 
03,001,01,001,0058,145,546,9,555,922,0,0,0,0,0,0,0,66.31 ,60.20 ,66.31 
03,001,01,001,0058,146,638,9,647,1041,0,0,0,0,0,0,0,66.31 ,62.15 ,66.31 
03,001,01,001,0059,147,624,7,631,1203,0,0,0,0,0,0,0,66.31 ,52.45 ,66.31 
03,001,01,001,0059,148,698,12,710,1273,0,0,0,0,0,0,0,66.31 ,55.77 ,66.31 
03,001,01,001,0060,149,736,15,751,1284,0,0,0,0,0,0,0,66.31 ,58.49 ,66.31 
03,001,01,001,0060,150,741,6,747,1332,0,0,0,0,0,0,0,66.31 ,56.08 ,66.31 
03,001,01,001,0060,151,693,9,702,1263,0,0,0,0,0,0,0,66.31 ,55.58 ,66.31 
03,001,01,001,0061,152,446,8,454,726,0,0,0,0,0,0,0,66.31 ,62.53 ,66.31 
03,001,01,001,0061,153,588,11,599,910,0,0,0,0,0,0,0,66.31 ,65.82 ,66.31 
03,001,01,001,0062,154,757,10,767,1251,0,0,0,0,0,0,0,66.31 ,61.31 ,66.31 
03,001,01,001,0062,155,748,10,758,1186,0,0,0,0,0,0,0,66.31 ,63.91 ,66.31 
03,001,01,001,0062,156,471,4,475,895,0,0,0,0,0,0,0,66.31 ,53.07 ,66.31 
03,001,01,001,0062,157,383,6,389,774,0,0,0,0,0,0,0,66.31 ,50.26 ,66.31 
03,001,01,001,0063,158,720,8,728,1171,0,0,0,0,0,0,0,66.31 ,62.17 ,66.31 
03,001,01,001,0063,159,760,12,772,1202,0,0,0,0,0,0,0,66.31 ,64.23 ,66.31 
03,001,01,001,0063,160,615,14,629,883,0,0,0,0,0,0,0,66.31 ,71.23 ,66.31 
03,001,01,001,0064,161,657,11,668,1035,0,0,0,0,0,0,0,66.31 ,64.54 ,66.31 
03,001,01,001,0064,162,619,13,632,1051,0,0,0,0,0,0,0,66.31 ,60.13 ,66.31 
03,001,01,001,0064,163,575,7,582,849,0,0,0,0,0,0,0,66.31 ,68.55 ,66.31 
03,001,01,001,0065,164,712,10,722,1154,0,0,0,0,0,0,0,66.31 ,62.56 ,66.31 
03,001,01,001,0065,165,724,14,738,1240,0,0,0,0,0,0,0,66.31 ,59.52 ,66.31 
03,001,01,001,0066,166,741,15,756,1162,0,0,0,0,0,0,0,66.31 ,65.06 ,66.31 
03,001,01,001,0066,167,774,14,788,1247,0,0,0,0,0,0,0,66.31 ,63.19 ,66.31 
03,001,01,001,0066,168,805,7,812,1419,0,0,0,0,0,0,0,66.31 ,57.22 ,66.31 
03,001,01,001,0067,169,481,4,485,898,0,0,0,0,0,0,0,66.31 ,54.01 ,66.31 
03,001,01,001,0067,170,463,3,466,834,0,0,0,0,0,0,0,66.31 ,55.88 ,66.31 
03,001,01,001,0068,171,805,15,820,1144,0,0,0,0,0,0,0,66.31 ,71.68 ,66.31 
03,001,01,001,0068,172,678,16,694,1022,0,0,0,0,0,0,0,66.31 ,67.91 ,66.31 
03,001,01,001,0069,173,544,9,553,972,0,0,0,0,0,0,0,66.31 ,56.89 ,66.31 
03,001,01,001,0069,174,658,20,678,1059,0,0,0,0,0,0,0,66.31 ,64.02 ,66.31 
03,001,01,001,0070,175,806,13,819,1300,0,0,0,0,0,0,0,66.31 ,63.00 ,66.31 
03,001,01,001,0070,176,639,19,658,1016,0,0,0,0,0,0,0,66.31 ,64.76 ,66.31 
03,001,01,001,0071,177,682,16,698,1095,0,0,0,0,0,0,0,66.31 ,63.74 ,66.31 
03,001,01,001,0071,178,638,6,644,1037,0,0,0,0,0,0,0,66.31 ,62.10 ,66.31 
03,001,01,001,0071,179,781,11,792,1191,0,0,0,0,0,0,0,66.31 ,66.50 ,66.31 
03,001,01,001,0071,180,592,6,598,1106,0,0,0,0,0,0,0,66.31 ,54.07 ,66.31 
03,001,01,001,0072,181,716,10,726,1225,0,0,0,0,0,0,0,66.31 ,59.27 ,66.31 
03,001,01,001,0072,182,654,8,662,1085,0,0,0,0,0,0,0,66.31 ,61.01 ,66.31 
03,001,01,001,0073,183,696,15,711,1143,0,0,0,0,0,0,0,66.31 ,62.20 ,66.31 
03,001,01,001,0073,184,714,12,726,1070,0,0,0,0,0,0,0,66.31 ,67.85 ,66.31 
03,001,01,001,0074,185,688,12,700,1215,0,0,0,0,0,0,0,66.31 ,57.61 ,66.31 
03,001,01,001,0074,186,719,17,736,1153,0,0,0,0,0,0,0,66.31 ,63.83 ,66.31 
03,001,01,001,0074,187,672,16,688,1079,0,0,0,0,0,0,0,66.31 ,63.76 ,66.31 
03,001,01,001,0075,188,782,13,795,1194,0,0,0,0,0,0,0,66.31 ,66.58 ,66.31 
03,001,01,001,0075,189,724,16,740,1105,0,0,0,0,0,0,0,66.31 ,66.97 ,66.31 
03,001,01,001,0076,190,912,8,920,1482,0,0,0,0,0,0,0,66.31 ,62.08 ,66.31 
03,001,01,001,0076,191,743,5,748,1196,0,0,0,0,0,0,0,66.31 ,62.54 ,66.31 
03,001,01,001,0077,192,627,7,634,976,0,0,0,0,0,0,0,66.31 ,64.96 ,66.31 
03,001,01,001,0077,193,507,9,516,738,0,0,0,0,0,0,0,66.31 ,69.92 ,66.31 
03,001,01,001,0078,194,608,13,621,1039,0,0,0,0,0,0,0,66.31 ,59.77 ,66.31 
03,001,01,001,0078,195,706,8,714,1161,0,0,0,0,0,0,0,66.31 ,61.50 ,66.31 
03,001,01,001,0079,196,753,13,766,1231,0,0,0,0,0,0,0,66.31 ,62.23 ,66.31 
03,001,01,001,0079,197,741,21,762,1197,0,0,0,0,0,0,0,66.31 ,63.66 ,66.31 
03,001,01,001,0080,198,529,9,538,881,0,0,0,0,0,0,0,66.31 ,61.07 ,66.31 
03,001,01,001,0080,199,584,12,596,971,0,0,0,0,0,0,0,66.31 ,61.38 ,66.31 
03,001,01,001,0080,200,607,7,614,961,0,0,0,0,0,0,0,66.31 ,63.89 ,66.31 
03,001,01,001,0081,201,619,1,620,1064,0,0,0,0,0,0,0,66.31 ,58.27 ,66.31 
03,001,01,001,0081,202,773,7,780,1268,0,0,0,0,0,0,0,66.31 ,61.51 ,66.31 
03,001,01,001,0081,203,549,8,557,936,0,0,0,0,0,0,0,66.31 ,59.51 ,66.31 
03,001,01,001,0081,204,452,4,456,759,0,0,0,0,0,0,0,66.31 ,60.08 ,66.31 
03,001,01,001,0082,205,543,8,551,869,0,0,0,0,0,0,0,66.31 ,63.41 ,66.31 
03,001,01,001,0082,206,479,4,483,758,0,0,0,0,0,0,0,66.31 ,63.72 ,66.31 
03,001,01,001,0082,207,560,6,566,943,0,0,0,0,0,0,0,66.31 ,60.02 ,66.31 
03,001,01,001,0083,208,613,10,623,1011,0,0,0,0,0,0,0,66.31 ,61.62 ,66.31 
03,001,01,001,0083,209,605,9,614,886,0,0,0,0,0,0,0,66.31 ,69.30 ,66.31 
03,001,01,001,0084,210,587,13,600,995,0,0,0,0,0,0,0,66.31 ,60.30 ,66.31 
03,001,01,001,0084,211,717,16,733,1150,0,0,0,0,0,0,0,66.31 ,63.74 ,66.31 
03,001,01,001,0084,212,679,16,695,1101,0,0,0,0,0,0,0,66.31 ,63.12 ,66.31 
03,001,01,001,0085,213,399,6,405,685,0,0,0,0,0,0,0,66.31 ,59.12 ,66.31 
03,001,01,001,0085,214,472,7,479,761,0,0,0,0,0,0,0,66.31 ,62.94 ,66.31 
03,001,01,001,0086,215,718,12,730,1250,0,0,0,0,0,0,0,66.31 ,58.40 ,66.31 
03,001,01,001,0086,216,771,12,783,1250,0,0,0,0,0,0,0,66.31 ,62.64 ,66.31 
03,001,01,001,0087,217,587,12,599,927,0,0,0,0,0,0,0,66.31 ,64.62 ,66.31 
03,001,01,001,0087,218,594,6,600,993,0,0,0,0,0,0,0,66.31 ,60.42 ,66.31 
03,001,01,001,0088,219,494,8,502,826,0,0,0,0,0,0,0,66.31 ,60.77 ,66.31 
03,001,01,001,0088,220,457,4,461,695,0,0,0,0,0,0,0,66.31 ,66.33 ,66.31 
03,001,01,001,0089,221,696,7,703,1221,0,0,0,0,0,0,0,66.31 ,57.58 ,66.31 
03,001,01,001,0089,222,744,16,760,1216,0,0,0,0,0,0,0,66.31 ,62.50 ,66.31 
03,001,01,001,0090,223,667,12,679,1091,0,0,0,0,0,0,0,66.31 ,62.24 ,66.31 
03,001,01,001,0090,224,654,4,658,1034,0,0,0,0,0,0,0,66.31 ,63.64 ,66.31 
03,001,01,001,0090,225,529,6,535,875,0,0,0,0,0,0,0,66.31 ,61.14 ,66.31 
03,001,01,001,0091,226,669,10,679,1087,0,0,0,0,0,0,0,66.31 ,62.47 ,66.31 
03,001,01,001,0091,227,580,16,596,1004,0,0,0,0,0,0,0,66.31 ,59.36 ,66.31 
03,001,01,001,0092,228,898,5,903,1429,0,0,0,0,0,0,0,66.31 ,63.19 ,66.31 
03,001,01,001,0092,229,670,12,682,1136,0,0,0,0,0,0,0,66.31 ,60.04 ,66.31 
03,001,01,001,0093,230,709,7,716,1168,0,0,0,0,0,0,0,66.31 ,61.30 ,66.31 
03,001,01,001,0093,231,794,13,807,1208,0,0,0,0,0,0,0,66.31 ,66.80 ,66.31 
03,001,01,001,0093,232,849,10,859,1267,0,0,0,0,0,0,0,66.31 ,67.80 ,66.31 
03,001,01,001,0094,233,771,10,781,1149,0,0,0,0,0,0,0,66.31 ,67.97 ,66.31 
03,001,01,001,0094,234,792,12,804,1309,0,0,0,0,0,0,0,66.31 ,61.42 ,66.31 
03,001,01,001,0095,235,686,15,701,1073,0,0,0,0,0,0,0,66.31 ,65.33 ,66.31 
03,001,01,001,0095,236,626,9,635,1020,0,0,0,0,0,0,0,66.31 ,62.25 ,66.31 
03,001,01,001,0096,237,723,14,737,1121,0,0,0,0,0,0,0,66.31 ,65.74 ,66.31 
03,001,01,001,0096,238,780,10,790,1255,0,0,0,0,0,0,0,66.31 ,62.95 ,66.31 
03,001,01,001,0097,239,748,9,757,1183,0,0,0,0,0,0,0,66.31 ,63.99 ,66.31 
03,001,01,001,0097,240,514,12,526,865,0,0,0,0,0,0,0,66.31 ,60.81 ,66.31 
03,001,01,001,0097,241,643,10,653,1058,0,0,0,0,0,0,0,66.31 ,61.72 ,66.31 
03,001,01,001,0097,242,644,10,654,1102,0,0,0,0,0,0,0,66.31 ,59.35 ,66.31 
03,001,01,001,0098,243,790,9,799,1269,0,0,0,0,0,0,0,66.31 ,62.96 ,66.31 
03,001,01,001,0098,244,671,6,677,1066,0,0,0,0,0,0,0,66.31 ,63.51 ,66.31 
03,001,01,001,0098,245,714,4,718,1166,0,0,0,0,0,0,0,66.31 ,61.58 ,66.31 
03,001,01,001,0099,246,766,18,784,1394,0,0,0,0,0,0,0,66.31 ,56.24 ,66.31 
03,001,01,001,0099,247,707,13,720,1135,0,0,0,0,0,0,0,66.31 ,63.44 ,66.31 
03,001,01,001,0099,248,951,18,969,1629,0,0,0,0,0,0,0,66.31 ,59.48 ,66.31 
03,001,01,001,0099,249,719,11,730,1256,0,0,0,0,0,0,0,66.31 ,58.12 ,66.31 
03,001,01,001,0100,250,624,8,632,948,0,0,0,0,0,0,0,66.31 ,66.67 ,66.31 
03,001,01,001,0100,251,516,5,521,839,0,0,0,0,0,0,0,66.31 ,62.10 ,66.31 
03,001,01,001,0100,252,554,7,561,889,0,0,0,0,0,0,0,66.31 ,63.10 ,66.31 
03,001,01,001,0101,253,527,8,535,848,0,0,0,0,0,0,0,66.31 ,63.09 ,66.31 
03,001,01,001,0102,254,609,11,620,1052,0,0,0,0,0,0,0,66.31 ,58.94 ,66.31 
03,001,01,001,0102,255,652,10,662,1117,0,0,0,0,0,0,0,66.31 ,59.27 ,66.31 
03,001,01,001,0103,256,650,5,655,1078,0,0,0,0,0,0,0,66.31 ,60.76 ,66.31 
03,001,01,001,0103,257,722,7,729,1210,0,0,0,0,0,0,0,66.31 ,60.25 ,66.31 
03,001,01,001,0103,258,680,9,689,1200,0,0,0,0,0,0,0,66.31 ,57.42 ,66.31 
03,001,01,001,0104,259,781,15,796,1333,0,0,0,0,0,0,0,66.31 ,59.71 ,66.31 
03,001,01,001,0104,260,855,13,868,1408,0,0,0,0,0,0,0,66.31 ,61.65 ,66.31 
03,001,01,001,0105,261,694,17,711,1049,0,0,0,0,0,0,0,66.31 ,67.78 ,66.31 
03,001,01,001,0105,262,738,19,757,1114,0,0,0,0,0,0,0,66.31 ,67.95 ,66.31 
03,001,01,001,0106,263,546,6,552,836,0,0,0,0,0,0,0,66.31 ,66.03 ,66.31 
03,001,01,001,0106,264,510,5,515,775,0,0,0,0,0,0,0,66.31 ,66.45 ,66.31 
03,001,01,001,0107,265,730,21,751,1204,0,0,0,0,0,0,0,66.31 ,62.38 ,66.31 
03,001,01,001,0107,266,900,13,913,1452,0,0,0,0,0,0,0,66.31 ,62.88 ,66.31 
03,001,01,001,0107,267,819,18,837,1363,0,0,0,0,0,0,0,66.31 ,61.41 ,66.31 
03,001,01,001,0108,268,508,13,521,798,0,0,0,0,0,0,0,66.31 ,65.29 ,66.31 
03,001,01,001,0108,269,862,10,872,1480,0,0,0,0,0,0,0,66.31 ,58.92 ,66.31 
03,001,01,001,0108,270,836,12,848,1300,0,0,0,0,0,0,0,66.31 ,65.23 ,66.31 
03,001,01,001,0109,271,585,24,609,1020,0,0,0,0,0,0,0,66.31 ,59.71 ,66.31 
03,001,01,001,0109,272,607,6,613,942,0,0,0,0,0,0,0,66.31 ,65.07 ,66.31 
03,001,01,001,0109,273,695,16,711,1101,0,0,0,0,0,0,0,66.31 ,64.58 ,66.31 
03,001,01,001,0110,274,706,17,723,1205,0,0,0,0,0,0,0,66.31 ,60.00 ,66.31 
03,001,01,001,0110,275,689,11,700,1106,0,0,0,0,0,0,0,66.31 ,63.29 ,66.31 
03,001,01,001,0110,276,496,3,499,1133,0,0,0,0,0,0,0,66.31 ,44.04 ,66.31 
03,001,01,001,0111,277,660,8,668,1118,0,0,0,0,0,0,0,66.31 ,59.75 ,66.31 
03,001,01,001,0111,278,753,15,768,1304,0,0,0,0,0,0,0,66.31 ,58.90 ,66.31 
03,001,01,001,0111,279,786,18,804,1306,0,0,0,0,0,0,0,66.31 ,61.56 ,66.31 
03,001,01,001,0112,280,695,12,707,1090,0,0,0,0,0,0,0,66.31 ,64.86 ,66.31 
03,001,01,001,0112,281,455,10,465,759,0,0,0,0,0,0,0,66.31 ,61.26 ,66.31 
03,001,01,001,0112,282,482,6,488,746,0,0,0,0,0,0,0,66.31 ,65.42 ,66.31 
03,001,01,001,0113,283,687,8,695,1128,0,0,0,0,0,0,0,66.31 ,61.61 ,66.31 
03,001,01,001,0113,284,792,11,803,1273,0,0,0,0,0,0,0,66.31 ,63.08 ,66.31 
03,001,01,001,0114,285,726,11,737,1005,0,0,0,0,0,0,0,66.31 ,73.33 ,66.31 
03,001,01,001,0115,286,579,17,596,1010,0,0,0,0,0,0,0,66.31 ,59.01 ,66.31 
03,001,01,001,0115,287,512,6,518,892,0,0,0,0,0,0,0,66.31 ,58.07 ,66.31 
03,001,01,001,0115,288,610,10,620,1076,0,0,0,0,0,0,0,66.31 ,57.62 ,66.31 
03,001,01,001,0115,289,609,6,615,939,0,0,0,0,0,0,0,66.31 ,65.50 ,66.31 
03,001,01,001,0116,290,591,11,602,888,0,0,0,0,0,0,0,66.31 ,67.79 ,66.31 
03,001,01,001,0116,291,773,15,788,1020,0,0,0,0,0,0,0,66.31 ,77.25 ,66.31 
03,001,01,001,0116,292,374,6,380,681,0,0,0,0,0,0,0,66.31 ,55.80 ,66.31 
03,001,01,001,0117,293,670,15,685,1142,0,0,0,0,0,0,0,66.31 ,59.98 ,66.31 
03,001,01,001,0117,294,767,9,776,1238,0,0,0,0,0,0,0,66.31 ,62.68 ,66.31 
03,001,01,001,0117,295,538,11,549,881,0,0,0,0,0,0,0,66.31 ,62.32 ,66.31 
03,001,01,001,0118,296,724,7,731,1168,0,0,0,0,0,0,0,66.31 ,62.59 ,66.31 
03,001,01,001,0118,297,540,10,550,982,0,0,0,0,0,0,0,66.31 ,56.01 ,66.31 
03,001,01,001,0119,298,535,8,543,865,0,0,0,0,0,0,0,66.31 ,62.77 ,66.31 
03,001,01,001,0119,299,599,11,610,941,0,0,0,0,0,0,0,66.31 ,64.82 ,66.31 
03,001,01,001,0119,300,528,11,539,839,0,0,0,0,0,0,0,66.31 ,64.24 ,66.31 
03,001,01,001,0119,301,640,19,659,1078,0,0,0,0,0,0,0,66.31 ,61.13 ,66.31 
03,001,01,001,0120,302,687,10,697,1105,0,0,0,0,0,0,0,66.31 ,63.08 ,66.31 
03,001,01,001,0120,303,721,15,736,1219,0,0,0,0,0,0,0,66.31 ,60.38 ,66.31 
03,001,01,001,0121,304,801,18,819,1263,0,0,0,0,0,0,0,66.31 ,64.85 ,66.31 
03,001,01,001,0121,305,618,10,628,1144,0,0,0,0,0,0,0,66.31 ,54.90 ,66.31 
03,001,01,001,0121,306,571,7,578,942,0,0,0,0,0,0,0,66.31 ,61.36 ,66.31 
03,001,01,001,0121,307,867,16,883,1534,0,0,0,0,0,0,0,66.31 ,57.56 ,66.31 
03,001,01,001,0122,308,789,13,802,1367,0,0,0,0,0,0,0,66.31 ,58.67 ,66.31 
03,001,01,001,0122,309,714,12,726,1175,0,0,0,0,0,0,0,66.31 ,61.79 ,66.31 
03,001,01,001,0123,310,832,17,849,1286,0,0,0,0,0,0,0,66.31 ,66.02 ,66.31 
03,001,01,001,0123,311,737,11,748,1277,0,0,0,0,0,0,0,66.31 ,58.57 ,66.31 
03,001,01,001,0123,312,639,11,650,1086,0,0,0,0,0,0,0,66.31 ,59.85 ,66.31 
03,001,01,001,0124,313,673,9,682,1172,0,0,0,0,0,0,0,66.31 ,58.19 ,66.31 
03,001,01,001,0124,314,651,9,660,1096,0,0,0,0,0,0,0,66.31 ,60.22 ,66.31 
03,001,01,001,0124,315,710,28,738,1210,0,0,0,0,0,0,0,66.31 ,60.99 ,66.31 
03,001,01,001,0124,316,710,12,722,1231,0,0,0,0,0,0,0,66.31 ,58.65 ,66.31 
03,001,01,001,0125,317,730,18,748,1158,0,0,0,0,0,0,0,66.31 ,64.59 ,66.31 
03,001,01,001,0125,318,840,10,850,1272,0,0,0,0,0,0,0,66.31 ,66.82 ,66.31 
03,001,01,001,0126,319,788,13,801,1259,0,0,0,0,0,0,0,66.31 ,63.62 ,66.31 
03,001,01,001,0126,320,876,10,886,1308,0,0,0,0,0,0,0,66.31 ,67.74 ,66.31 
03,001,01,002,0127,321,719,18,737,1123,0,0,0,0,0,0,0,66.31 ,65.63 ,66.31 
03,001,01,002,0128,322,742,12,754,1099,0,0,0,0,0,0,0,66.31 ,68.61 ,66.31 
03,001,01,002,0129,323,954,19,973,1524,0,0,0,0,0,0,0,66.31 ,63.85 ,66.31 
03,001,01,002,0129,324,1024,27,1051,1539,0,0,0,0,0,0,0,66.31 ,68.29 ,66.31 
03,001,01,002,0130,325,637,21,658,1062,0,0,0,0,0,0,0,66.31 ,61.96 ,66.31 
03,001,01,002,0130,326,753,16,769,1294,0,0,0,0,0,0,0,66.31 ,59.43 ,66.31 
03,001,01,002,0131,327,746,17,763,1210,0,0,0,0,0,0,0,66.31 ,63.06 ,66.31 
03,001,01,002,0131,328,694,19,713,1093,0,0,0,0,0,0,0,66.31 ,65.23 ,66.31 
03,001,01,002,0132,329,735,19,754,1153,0,0,0,0,0,0,0,66.31 ,65.39 ,66.31 
03,001,01,002,0132,330,732,13,745,1189,0,0,0,0,0,0,0,66.31 ,62.66 ,66.31 
03,001,01,002,0132,331,594,9,603,946,0,0,0,0,0,0,0,66.31 ,63.74 ,66.31 
03,001,01,002,0132,332,749,10,759,1407,0,0,0,0,0,0,0,66.31 ,53.94 ,66.31 
03,001,01,002,0133,333,832,15,847,1541,0,0,0,0,0,0,0,66.31 ,54.96 ,66.31 
03,001,01,002,0133,334,819,17,836,1465,0,0,0,0,0,0,0,66.31 ,57.06 ,66.31 
03,001,01,002,0134,335,739,23,762,1315,0,0,0,0,0,0,0,66.31 ,57.95 ,66.31 
03,001,01,002,0134,336,595,13,608,1058,0,0,0,0,0,0,0,66.31 ,57.47 ,66.31 
03,001,01,002,0134,337,773,12,785,1339,0,0,0,0,0,0,0,66.31 ,58.63 ,66.31 
03,001,01,002,0135,338,608,10,618,921,0,0,0,0,0,0,0,66.31 ,67.10 ,66.31 
03,001,01,002,0135,339,651,19,670,1112,0,0,0,0,0,0,0,66.31 ,60.25 ,66.31 
03,001,01,002,0136,340,1006,17,1023,1528,0,0,0,0,0,0,0,66.31 ,66.95 ,66.31 
03,001,01,002,0137,341,566,6,572,853,0,0,0,0,0,0,0,66.31 ,67.06 ,66.31 
03,001,01,002,0138,342,885,14,899,1463,0,0,0,0,0,0,0,66.31 ,61.45 ,66.31 
03,001,01,002,0138,343,777,17,794,1363,0,0,0,0,0,0,0,66.31 ,58.25 ,66.31 
03,001,01,002,0139,344,705,15,720,1156,0,0,0,0,0,0,0,66.31 ,62.28 ,66.31 
03,001,01,002,0139,345,775,14,789,1353,0,0,0,0,0,0,0,66.31 ,58.31 ,66.31 
03,001,01,002,0139,346,759,13,772,1268,0,0,0,0,0,0,0,66.31 ,60.88 ,66.31 
03,001,01,002,0140,347,601,14,615,996,0,0,0,0,0,0,0,66.31 ,61.75 ,66.31 
03,001,01,002,0140,348,807,11,818,1387,0,0,0,0,0,0,0,66.31 ,58.98 ,66.31 
03,001,01,002,0140,349,843,12,855,1400,0,0,0,0,0,0,0,66.31 ,61.07 ,66.31 
03,001,01,002,0141,350,734,11,745,1188,0,0,0,0,0,0,0,66.31 ,62.71 ,66.31 
03,001,01,002,0141,351,908,13,921,1478,0,0,0,0,0,0,0,66.31 ,62.31 ,66.31 
03,001,01,002,0141,352,591,9,600,1005,0,0,0,0,0,0,0,66.31 ,59.70 ,66.31 
03,001,01,002,0142,353,750,15,765,1267,0,0,0,0,0,0,0,66.31 ,60.38 ,66.31 
03,001,01,002,0142,354,708,15,723,1046,0,0,0,0,0,0,0,66.31 ,69.12 ,66.31 
03,001,01,002,0142,355,726,12,738,1099,0,0,0,0,0,0,0,66.31 ,67.15 ,66.31 
03,001,01,002,0143,356,690,14,704,1112,0,0,0,0,0,0,0,66.31 ,63.31 ,66.31 
03,001,01,002,0143,357,778,13,791,1284,0,0,0,0,0,0,0,66.31 ,61.60 ,66.31 
03,001,01,002,0143,358,579,12,591,1025,0,0,0,0,0,0,0,66.31 ,57.66 ,66.31 
03,001,01,002,0144,359,866,17,883,1447,0,0,0,0,0,0,0,66.31 ,61.02 ,66.31 
03,001,01,002,0144,360,913,12,925,1403,0,0,0,0,0,0,0,66.31 ,65.93 ,66.31 
03,001,01,002,0145,361,836,17,853,1211,0,0,0,0,0,0,0,66.31 ,70.44 ,66.31 
03,001,01,002,0145,362,777,8,785,1230,0,0,0,0,0,0,0,66.31 ,63.82 ,66.31 
03,001,01,002,0146,363,912,17,929,1457,0,0,0,0,0,0,0,66.31 ,63.76 ,66.31 
03,001,01,002,0146,364,1013,9,1022,1572,0,0,0,0,0,0,0,66.31 ,65.01 ,66.31 
03,001,01,002,0147,365,711,8,719,1170,0,0,0,0,0,0,0,66.31 ,61.45 ,66.31 
03,001,01,002,0147,366,618,7,625,1102,0,0,0,0,0,0,0,66.31 ,56.72 ,66.31 
03,001,01,002,0147,367,801,10,811,1220,0,0,0,0,0,0,0,66.31 ,66.48 ,66.31 
03,001,01,002,0148,368,812,11,823,1213,0,0,0,0,0,0,0,66.31 ,67.85 ,66.31 
03,001,01,002,0148,369,638,11,649,1007,0,0,0,0,0,0,0,66.31 ,64.45 ,66.31 
03,001,01,002,0149,370,882,16,898,1378,0,0,0,0,0,0,0,66.31 ,65.17 ,66.31 
03,001,01,002,0149,371,884,10,894,1495,0,0,0,0,0,0,0,66.31 ,59.80 ,66.31 
03,001,01,002,0149,372,1013,7,1020,1659,0,0,0,0,0,0,0,66.31 ,61.48 ,66.31 
03,001,01,002,0149,373,945,18,963,1581,0,0,0,0,0,0,0,66.31 ,60.91 ,66.31 
03,001,01,002,0149,374,683,12,695,1077,0,0,0,0,0,0,0,66.31 ,64.53 ,66.31 
03,001,01,002,0150,375,785,14,799,1178,0,0,0,0,0,0,0,66.31 ,67.83 ,66.31 
03,001,01,002,0150,376,865,15,880,1300,0,0,0,0,0,0,0,66.31 ,67.69 ,66.31 
03,001,01,002,0150,377,708,11,719,1255,0,0,0,0,0,0,0,66.31 ,57.29 ,66.31 
03,001,01,002,0151,378,703,15,718,1116,0,0,0,0,0,0,0,66.31 ,64.34 ,66.31 
03,001,01,002,0151,379,653,13,666,1040,0,0,0,0,0,0,0,66.31 ,64.04 ,66.31 
03,001,01,002,0152,380,682,11,693,1150,0,0,0,0,0,0,0,66.31 ,60.26 ,66.31 
03,001,01,002,0152,381,775,12,787,1554,0,0,0,0,0,0,0,66.31 ,50.64 ,66.31 
03,001,01,002,0152,382,831,12,843,1674,0,0,0,0,0,0,0,66.31 ,50.36 ,66.31 
03,001,01,002,0152,383,781,17,798,1627,0,0,0,0,0,0,0,66.31 ,49.05 ,66.31 
03,001,01,002,0152,384,759,15,774,1492,0,0,0,0,0,0,0,66.31 ,51.88 ,66.31 
03,001,01,002,0152,385,682,12,694,1272,0,0,0,0,0,0,0,66.31 ,54.56 ,66.31 
03,001,01,002,0153,386,744,9,753,1116,0,0,0,0,0,0,0,66.31 ,67.47 ,66.31 
03,001,01,002,0153,387,477,8,485,856,0,0,0,0,0,0,0,66.31 ,56.66 ,66.31 
03,001,01,002,0154,388,852,13,865,1339,0,0,0,0,0,0,0,66.31 ,64.60 ,66.31 
03,001,01,002,0154,389,892,11,903,1599,0,0,0,0,0,0,0,66.31 ,56.47 ,66.31 
03,001,01,002,0154,390,749,8,757,1297,0,0,0,0,0,0,0,66.31 ,58.37 ,66.31 
03,001,01,002,0155,391,711,19,730,1178,0,0,0,0,0,0,0,66.31 ,61.97 ,66.31 
03,001,01,002,0156,392,958,23,981,1526,0,0,0,0,0,0,0,66.31 ,64.29 ,66.31 
03,001,01,002,0156,393,851,13,864,1404,0,0,0,0,0,0,0,66.31 ,61.54 ,66.31 
03,001,01,002,0156,394,964,18,982,1514,0,0,0,0,0,0,0,66.31 ,64.86 ,66.31 
03,001,01,002,0157,395,856,15,871,1351,0,0,0,0,0,0,0,66.31 ,64.47 ,66.31 
03,001,01,002,0157,396,768,16,784,1258,0,0,0,0,0,0,0,66.31 ,62.32 ,66.31 
03,001,01,002,0157,397,880,22,902,1427,0,0,0,0,0,0,0,66.31 ,63.21 ,66.31 
03,001,01,002,0157,398,862,13,875,1426,0,0,0,0,0,0,0,66.31 ,61.36 ,66.31 
03,001,01,002,0157,399,848,7,855,1436,0,0,0,0,0,0,0,66.31 ,59.54 ,66.31 
03,001,01,002,0158,400,641,13,654,944,0,0,0,0,0,0,0,66.31 ,69.28 ,66.31 
03,001,01,002,0158,401,690,24,714,1186,0,0,0,0,0,0,0,66.31 ,60.20 ,66.31 
03,001,01,002,0159,402,654,19,673,1082,0,0,0,0,0,0,0,66.31 ,62.20 ,66.31 
03,001,01,002,0159,403,699,14,713,1132,0,0,0,0,0,0,0,66.31 ,62.99 ,66.31 
03,001,01,002,0159,404,720,11,731,1284,0,0,0,0,0,0,0,66.31 ,56.93 ,66.31 
03,001,01,002,0160,405,719,7,726,1470,0,0,0,0,0,0,0,66.31 ,49.39 ,66.31 
03,001,01,002,0160,406,804,9,813,1442,0,0,0,0,0,0,0,66.31 ,56.38 ,66.31 
03,001,01,002,0160,407,526,8,534,1005,0,0,0,0,0,0,0,66.31 ,53.13 ,66.31 
03,001,01,002,0160,408,512,7,519,868,0,0,0,0,0,0,0,66.31 ,59.79 ,66.31 
03,001,01,002,0160,409,669,14,683,1188,0,0,0,0,0,0,0,66.31 ,57.49 ,66.31 
03,001,01,002,0161,410,604,12,616,1012,0,0,0,0,0,0,0,66.31 ,60.87 ,66.31 
03,001,01,002,0161,411,782,8,790,1264,0,0,0,0,0,0,0,66.31 ,62.50 ,66.31 
03,001,01,002,0161,412,612,6,618,1028,0,0,0,0,0,0,0,66.31 ,60.12 ,66.31 
03,001,01,002,0161,413,770,13,783,1400,0,0,0,0,0,0,0,66.31 ,55.93 ,66.31 
03,001,01,002,0162,414,792,17,809,1303,0,0,0,0,0,0,0,66.31 ,62.09 ,66.31 
03,001,01,002,0162,415,956,18,974,1566,0,0,0,0,0,0,0,66.31 ,62.20 ,66.31 
03,001,01,002,0163,416,785,17,802,1167,0,0,0,0,0,0,0,66.31 ,68.72 ,66.31 
03,001,01,002,0163,417,842,13,855,1389,0,0,0,0,0,0,0,66.31 ,61.56 ,66.31 
03,001,01,002,0163,418,917,9,926,1491,0,0,0,0,0,0,0,66.31 ,62.11 ,66.31 
03,001,01,002,0163,419,966,21,987,1603,0,0,0,0,0,0,0,66.31 ,61.57 ,66.31 
03,001,01,002,0164,420,843,13,856,1326,0,0,0,0,0,0,0,66.31 ,64.56 ,66.31 
03,001,01,002,0164,421,713,11,724,1127,0,0,0,0,0,0,0,66.31 ,64.24 ,66.31 
03,001,01,002,0164,422,576,17,593,919,0,0,0,0,0,0,0,66.31 ,64.53 ,66.31 
03,001,01,002,0164,423,675,10,685,1163,0,0,0,0,0,0,0,66.31 ,58.90 ,66.31 
03,001,01,002,0165,424,955,18,973,1733,0,0,0,0,0,0,0,66.31 ,56.15 ,66.31 
03,001,01,002,0165,425,1033,23,1056,1641,0,0,0,0,0,0,0,66.31 ,64.35 ,66.31 
03,001,01,002,0166,426,983,21,1004,1670,0,0,0,0,0,0,0,66.31 ,60.12 ,66.31 
03,001,01,002,0166,427,926,25,951,1619,0,0,0,0,0,0,0,66.31 ,58.74 ,66.31 
03,001,01,003,0167,428,534,2,536,901,0,0,0,0,0,0,0,66.31 ,59.49 ,66.31 
03,001,01,003,0167,429,712,7,719,1122,0,0,0,0,0,0,0,66.31 ,64.08 ,66.31 
03,001,01,003,0167,430,539,15,554,879,0,0,0,0,0,0,0,66.31 ,63.03 ,66.31 
03,001,01,003,0167,431,637,15,652,1023,0,0,0,0,0,0,0,66.31 ,63.73 ,66.31 
03,001,01,003,0168,432,569,10,579,933,0,0,0,0,0,0,0,66.31 ,62.06 ,66.31 
03,001,01,003,0168,433,568,9,577,910,0,0,0,0,0,0,0,66.31 ,63.41 ,66.31 
03,001,01,003,0168,434,535,11,546,882,0,0,0,0,0,0,0,66.31 ,61.90 ,66.31 
03,001,01,003,0169,435,865,9,874,1478,0,0,0,0,0,0,0,66.31 ,59.13 ,66.31 
03,001,01,003,0170,436,448,9,457,782,0,0,0,0,0,0,0,66.31 ,58.44 ,66.31 
03,001,01,003,0170,437,496,8,504,875,0,0,0,0,0,0,0,66.31 ,57.60 ,66.31 
03,001,01,003,0171,438,621,6,627,1035,0,0,0,0,0,0,0,66.31 ,60.58 ,66.31 
03,001,01,003,0172,439,831,12,843,1398,0,0,0,0,0,0,0,66.31 ,60.30 ,66.31 
03,001,01,003,0173,440,669,18,687,1219,0,0,0,0,0,0,0,66.31 ,56.36 ,66.31 
03,001,01,003,0173,441,801,15,816,1333,0,0,0,0,0,0,0,66.31 ,61.22 ,66.31 
03,001,01,003,0174,442,592,11,603,1042,0,0,0,0,0,0,0,66.31 ,57.87 ,66.31 
03,001,01,003,0174,443,569,12,581,844,0,0,0,0,0,0,0,66.31 ,68.84 ,66.31 
03,001,01,003,0174,444,643,15,658,1045,0,0,0,0,0,0,0,66.31 ,62.97 ,66.31 
03,001,01,003,0175,445,596,20,616,1048,0,0,0,0,0,0,0,66.31 ,58.78 ,66.31 
03,001,01,003,0175,446,621,8,629,1109,0,0,0,0,0,0,0,66.31 ,56.72 ,66.31 
03,001,01,003,0175,447,651,7,658,1267,0,0,0,0,0,0,0,66.31 ,51.93 ,66.31 
03,001,01,003,0176,448,706,8,714,1142,0,0,0,0,0,0,0,66.31 ,62.52 ,66.31 
03,001,01,003,0176,449,709,13,722,1312,0,0,0,0,0,0,0,66.31 ,55.03 ,66.31 
03,001,01,003,0177,450,655,8,663,1203,0,0,0,0,0,0,0,66.31 ,55.11 ,66.31 
03,001,01,003,0177,451,592,9,601,1119,0,0,0,0,0,0,0,66.31 ,53.71 ,66.31 
03,001,01,003,0178,452,752,15,767,1217,0,0,0,0,0,0,0,66.31 ,63.02 ,66.31 
03,001,01,003,0178,453,677,14,691,1247,0,0,0,0,0,0,0,66.31 ,55.41 ,66.31 
03,001,01,003,0179,454,634,10,644,981,0,0,0,0,0,0,0,66.31 ,65.65 ,66.31 
03,001,01,003,0179,455,646,7,653,1094,0,0,0,0,0,0,0,66.31 ,59.69 ,66.31 
03,001,01,003,0179,456,568,4,572,909,0,0,0,0,0,0,0,66.31 ,62.93 ,66.31 
03,001,01,003,0180,457,832,16,848,1416,0,0,0,0,0,0,0,66.31 ,59.89 ,66.31 
03,001,01,003,0180,458,708,13,721,1403,0,0,0,0,0,0,0,66.31 ,51.39 ,66.31 
03,001,01,003,0181,459,648,8,656,961,0,0,0,0,0,0,0,66.31 ,68.26 ,66.31 
03,001,01,003,0182,460,614,3,617,929,0,0,0,0,0,0,0,66.31 ,66.42 ,66.31 
03,001,01,003,0183,461,631,13,644,989,0,0,0,0,0,0,0,66.31 ,65.12 ,66.31 
03,001,01,003,0183,462,529,7,536,847,0,0,0,0,0,0,0,66.31 ,63.28 ,66.31 
03,001,01,003,0184,463,679,7,686,1151,0,0,0,0,0,0,0,66.31 ,59.60 ,66.31 
03,001,01,003,0184,464,950,16,966,1434,0,0,0,0,0,0,0,66.31 ,67.36 ,66.31 
03,001,01,003,0185,465,671,7,678,953,0,0,0,0,0,0,0,66.31 ,71.14 ,66.31 
03,001,01,003,0185,466,796,12,808,1236,0,0,0,0,0,0,0,66.31 ,65.37 ,66.31 
03,001,01,003,0185,467,851,12,863,1338,0,0,0,0,0,0,0,66.31 ,64.50 ,66.31 
03,001,01,003,0186,468,638,19,657,990,0,0,0,0,0,0,0,66.31 ,66.36 ,66.31 
03,001,01,003,0186,469,667,9,676,1018,0,0,0,0,0,0,0,66.31 ,66.40 ,66.31 
03,001,01,003,0187,470,847,11,858,1398,0,0,0,0,0,0,0,66.31 ,61.37 ,66.31 
03,001,01,003,0187,471,852,10,862,1306,0,0,0,0,0,0,0,66.31 ,66.00 ,66.31 
03,001,01,003,0188,472,713,11,724,1153,0,0,0,0,0,0,0,66.31 ,62.79 ,66.31 
03,001,01,003,0188,473,732,13,745,1177,0,0,0,0,0,0,0,66.31 ,63.30 ,66.31 
03,001,01,003,0189,474,743,11,754,1124,0,0,0,0,0,0,0,66.31 ,67.08 ,66.31 
03,001,01,003,0189,475,831,7,838,1368,0,0,0,0,0,0,0,66.31 ,61.26 ,66.31 
03,001,01,003,0190,476,710,8,718,1065,0,0,0,0,0,0,0,66.31 ,67.42 ,66.31 
03,001,01,003,0191,477,603,8,611,925,0,0,0,0,0,0,0,66.31 ,66.05 ,66.31 
03,001,01,003,0191,478,442,9,451,864,0,0,0,0,0,0,0,66.31 ,52.20 ,66.31 
03,001,01,003,0192,479,580,16,596,909,0,0,0,0,0,0,0,66.31 ,65.57 ,66.31 
03,001,01,003,0192,480,482,5,487,812,0,0,0,0,0,0,0,66.31 ,59.98 ,66.31 
03,001,01,003,0193,481,476,13,489,748,0,0,0,0,0,0,0,66.31 ,65.37 ,66.31 
03,001,01,003,0193,482,435,5,440,786,0,0,0,0,0,0,0,66.31 ,55.98 ,66.31 
03,001,01,003,0194,483,970,7,977,1414,0,0,0,0,0,0,0,66.31 ,69.09 ,66.31 
03,001,01,003,0194,484,873,16,889,1408,0,0,0,0,0,0,0,66.31 ,63.14 ,66.31 
03,001,01,003,0195,485,623,6,629,1029,0,0,0,0,0,0,0,66.31 ,61.13 ,66.31 
03,001,01,003,0195,486,699,13,712,1212,0,0,0,0,0,0,0,66.31 ,58.75 ,66.31 
03,001,01,003,0195,487,678,11,689,1201,0,0,0,0,0,0,0,66.31 ,57.37 ,66.31 
03,001,01,003,0196,488,920,16,936,1395,0,0,0,0,0,0,0,66.31 ,67.10 ,66.31 
03,001,01,003,0196,489,675,8,683,1192,0,0,0,0,0,0,0,66.31 ,57.30 ,66.31 
03,001,01,003,0197,490,748,17,765,1220,0,0,0,0,0,0,0,66.31 ,62.70 ,66.31 
03,001,01,003,0197,491,894,17,911,1418,0,0,0,0,0,0,0,66.31 ,64.25 ,66.31 
03,001,01,003,0198,492,608,8,616,926,0,0,0,0,0,0,0,66.31 ,66.52 ,66.31 
03,001,01,003,0198,493,623,9,632,1007,0,0,0,0,0,0,0,66.31 ,62.76 ,66.31 
03,001,01,003,0198,494,518,10,528,800,0,0,0,0,0,0,0,66.31 ,66.00 ,66.31 
03,001,01,003,0199,495,625,10,635,1213,0,0,0,0,0,0,0,66.31 ,52.35 ,66.31 
03,001,01,003,0199,496,680,10,690,1174,0,0,0,0,0,0,0,66.31 ,58.77 ,66.31 
03,001,01,003,0199,497,835,12,847,1380,0,0,0,0,0,0,0,66.31 ,61.38 ,66.31 
03,001,01,003,0200,498,830,16,846,1328,0,0,0,0,0,0,0,66.31 ,63.70 ,66.31 
03,001,01,003,0200,499,661,15,676,958,0,0,0,0,0,0,0,66.31 ,70.56 ,66.31 
03,001,01,003,0201,500,703,15,718,1167,0,0,0,0,0,0,0,66.31 ,61.53 ,66.31 
03,001,01,003,0201,501,770,16,786,1117,0,0,0,0,0,0,0,66.31 ,70.37 ,66.31 
03,001,01,003,0202,502,759,19,778,1120,0,0,0,0,0,0,0,66.31 ,69.46 ,66.31 
03,001,01,003,0202,503,881,17,898,1319,0,0,0,0,0,0,0,66.31 ,68.08 ,66.31 
03,001,01,003,0203,504,750,23,773,1146,0,0,0,0,0,0,0,66.31 ,67.45 ,66.31 
03,001,01,003,0204,505,745,11,756,1113,0,0,0,0,0,0,0,66.31 ,67.92 ,66.31 
03,001,01,003,0205,506,824,15,839,1270,0,0,0,0,0,0,0,66.31 ,66.06 ,66.31 
03,001,01,003,0206,507,761,7,768,1141,0,0,0,0,0,0,0,66.31 ,67.31 ,66.31 
03,001,01,003,0207,508,420,7,427,643,0,0,0,0,0,0,0,66.31 ,66.41 ,66.31 
03,001,01,003,0208,509,662,18,680,1119,0,0,0,0,0,0,0,66.31 ,60.77 ,66.31 
03,001,01,004,0209,510,325,8,333,466,0,0,0,0,0,0,0,66.31 ,71.46 ,66.31 
03,001,01,004,0210,511,614,7,621,873,0,0,0,0,0,0,0,66.31 ,71.13 ,66.31 
03,001,01,004,0211,512,860,10,870,1209,0,0,0,0,0,0,0,66.31 ,71.96 ,66.31 
03,001,01,004,0212,513,690,7,697,988,0,0,0,0,0,0,0,66.31 ,70.55 ,66.31 
03,001,01,004,0212,514,517,4,521,701,0,0,0,0,0,0,0,66.31 ,74.32 ,66.31 
03,001,01,004,0213,515,616,6,622,799,0,0,0,0,0,0,0,66.31 ,77.85 ,66.31 
03,001,01,004,0214,516,1132,14,1146,1624,0,0,0,0,0,0,0,66.31 ,70.57 ,66.31 
03,001,01,004,0214,517,596,8,604,852,0,0,0,0,0,0,0,66.31 ,70.89 ,66.31 
03,001,01,004,0214,518,668,4,672,958,0,0,0,0,0,0,0,66.31 ,70.15 ,66.31 
03,001,01,004,0215,519,633,9,642,952,0,0,0,0,0,0,0,66.31 ,67.44 ,66.31 
03,001,01,004,0215,520,740,16,756,1265,0,0,0,0,0,0,0,66.31 ,59.76 ,66.31 
03,001,01,004,0215,521,790,10,800,1297,0,0,0,0,0,0,0,66.31 ,61.68 ,66.31 
03,001,01,004,0216,522,751,7,758,1076,0,0,0,0,0,0,0,66.31 ,70.45 ,66.31 
03,001,01,004,0216,523,926,11,937,1362,0,0,0,0,0,0,0,66.31 ,68.80 ,66.31 
03,001,01,004,0217,524,1149,25,1174,1749,0,0,0,0,0,0,0,66.31 ,67.12 ,66.31 
03,001,01,004,0217,525,1154,11,1165,1712,0,0,0,0,0,0,0,66.31 ,68.05 ,66.31 
03,001,01,004,0218,526,950,16,966,1404,0,0,0,0,0,0,0,66.31 ,68.80 ,66.31 
03,001,01,004,0218,527,910,15,925,1273,0,0,0,0,0,0,0,66.31 ,72.66 ,66.31 
03,001,01,004,0218,528,740,14,754,1023,0,0,0,0,0,0,0,66.31 ,73.70 ,66.31 
03,001,01,004,0219,529,529,14,543,738,0,0,0,0,0,0,0,66.31 ,73.58 ,66.31 
03,001,01,004,0220,530,728,7,735,1048,0,0,0,0,0,0,0,66.31 ,70.13 ,66.31 
03,001,01,004,0221,531,980,10,990,1639,0,0,0,0,0,0,0,66.31 ,60.40 ,66.31 
03,001,01,004,0221,532,736,13,749,1115,0,0,0,0,0,0,0,66.31 ,67.17 ,66.31 
03,001,01,004,0221,533,721,14,735,1195,0,0,0,0,0,0,0,66.31 ,61.51 ,66.31 
03,001,01,004,0221,534,816,11,827,1189,0,0,0,0,0,0,0,66.31 ,69.55 ,66.31 
03,001,01,004,0222,535,785,10,795,1161,0,0,0,0,0,0,0,66.31 ,68.48 ,66.31 
03,001,01,004,0222,536,689,12,701,979,0,0,0,0,0,0,0,66.31 ,71.60 ,66.31 
03,001,01,004,0222,537,623,11,634,934,0,0,0,0,0,0,0,66.31 ,67.88 ,66.31 
03,001,01,004,0223,538,945,21,966,1498,0,0,0,0,0,0,0,66.31 ,64.49 ,66.31 
03,001,01,004,0223,539,807,17,824,1334,0,0,0,0,0,0,0,66.31 ,61.77 ,66.31 
03,001,01,004,0224,540,734,14,748,1160,0,0,0,0,0,0,0,66.31 ,64.48 ,66.31 
03,001,01,004,0224,541,540,14,554,897,0,0,0,0,0,0,0,66.31 ,61.76 ,66.31 
03,001,01,004,0224,542,530,5,535,1051,0,0,0,0,0,0,0,66.31 ,50.90 ,66.31 
03,001,01,004,0225,543,604,6,610,922,0,0,0,0,0,0,0,66.31 ,66.16 ,66.31 
03,001,01,004,0225,544,524,6,530,934,0,0,0,0,0,0,0,66.31 ,56.75 ,66.31 
03,001,01,004,0225,545,757,12,769,1177,0,0,0,0,0,0,0,66.31 ,65.34 ,66.31 
03,001,01,004,0226,546,682,14,696,1160,0,0,0,0,0,0,0,66.31 ,60.00 ,66.31 
03,001,01,004,0226,547,843,10,853,1348,0,0,0,0,0,0,0,66.31 ,63.28 ,66.31 
03,001,01,004,0226,548,680,14,694,1147,0,0,0,0,0,0,0,66.31 ,60.51 ,66.31 
03,001,01,004,0227,549,799,12,811,1413,0,0,0,0,0,0,0,66.31 ,57.40 ,66.31 
03,001,01,004,0227,550,797,7,804,1203,0,0,0,0,0,0,0,66.31 ,66.83 ,66.31 
03,001,01,004,0227,551,809,13,822,1233,0,0,0,0,0,0,0,66.31 ,66.67 ,66.31 
03,001,01,004,0228,552,153,3,156,231,0,0,0,0,0,0,0,66.31 ,67.53 ,66.31 
03,001,01,005,0229,553,239,1,240,356,0,0,0,0,0,0,0,66.31 ,67.42 ,66.31 
03,001,01,005,0230,554,308,4,312,442,0,0,0,0,0,0,0,66.31 ,70.59 ,66.31 
03,001,01,005,0231,555,751,10,761,1065,0,0,0,0,0,0,0,66.31 ,71.46 ,66.31 
03,001,01,005,0231,556,704,23,727,1066,0,0,0,0,0,0,0,66.31 ,68.20 ,66.31 
03,001,01,005,0232,557,739,9,748,1199,0,0,0,0,0,0,0,66.31 ,62.39 ,66.31 
03,001,01,005,0233,558,559,4,563,823,0,0,0,0,0,0,0,66.31 ,68.41 ,66.31 
03,001,01,005,0234,559,713,11,724,1104,0,0,0,0,0,0,0,66.31 ,65.58 ,66.31 
03,001,01,005,0234,560,877,9,886,1360,0,0,0,0,0,0,0,66.31 ,65.15 ,66.31 
03,001,01,005,0234,561,809,13,822,1305,0,0,0,0,0,0,0,66.31 ,62.99 ,66.31 
03,001,01,005,0235,562,905,14,919,1553,0,0,0,0,0,0,0,66.31 ,59.18 ,66.31 
03,001,01,005,0235,563,919,20,939,1421,0,0,0,0,0,0,0,66.31 ,66.08 ,66.31 
03,001,01,005,0236,564,789,13,802,1286,0,0,0,0,0,0,0,66.31 ,62.36 ,66.31 
03,001,01,005,0236,565,674,6,680,1154,0,0,0,0,0,0,0,66.31 ,58.93 ,66.31 
03,001,01,005,0237,566,891,17,908,1426,0,0,0,0,0,0,0,66.31 ,63.67 ,66.31 
03,001,01,005,0237,567,879,13,892,1488,0,0,0,0,0,0,0,66.31 ,59.95 ,66.31 
03,001,01,005,0238,568,710,16,726,1125,0,0,0,0,0,0,0,66.31 ,64.53 ,66.31 
03,001,01,005,0238,569,607,10,617,1076,0,0,0,0,0,0,0,66.31 ,57.34 ,66.31 
03,001,01,005,0238,570,616,8,624,1003,0,0,0,0,0,0,0,66.31 ,62.21 ,66.31 
03,001,01,005,0238,571,628,4,632,1013,0,0,0,0,0,0,0,66.31 ,62.39 ,66.31 
03,001,01,005,0239,572,840,14,854,1476,0,0,0,0,0,0,0,66.31 ,57.86 ,66.31 
03,001,01,005,0239,573,781,17,798,1242,0,0,0,0,0,0,0,66.31 ,64.25 ,66.31 
03,001,01,005,0239,574,849,16,865,1388,0,0,0,0,0,0,0,66.31 ,62.32 ,66.31 
03,001,01,005,0240,575,808,14,822,1283,0,0,0,0,0,0,0,66.31 ,64.07 ,66.31 
03,001,01,005,0240,576,745,10,755,1148,0,0,0,0,0,0,0,66.31 ,65.77 ,66.31 
03,001,01,005,0240,577,682,14,696,1199,0,0,0,0,0,0,0,66.31 ,58.05 ,66.31 
03,001,01,005,0240,578,736,15,751,1326,0,0,0,0,0,0,0,66.31 ,56.64 ,66.31 
03,001,01,005,0241,579,978,19,997,1580,0,0,0,0,0,0,0,66.31 ,63.10 ,66.31 
03,001,01,005,0241,580,933,10,943,1409,0,0,0,0,0,0,0,66.31 ,66.93 ,66.31 
03,001,01,005,0242,581,505,7,512,961,0,0,0,0,0,0,0,66.31 ,53.28 ,66.31 
03,001,01,005,0242,582,599,8,607,1097,0,0,0,0,0,0,0,66.31 ,55.33 ,66.31 
03,001,01,005,0243,583,756,14,770,1146,0,0,0,0,0,0,0,66.31 ,67.19 ,66.31 
03,001,01,005,0243,584,1099,13,1112,1541,0,0,0,0,0,0,0,66.31 ,72.16 ,66.31 
03,001,01,005,0244,585,612,11,623,908,0,0,0,0,0,0,0,66.31 ,68.61 ,66.31 
03,001,01,005,0245,586,611,9,620,925,0,0,0,0,0,0,0,66.31 ,67.03 ,66.31 
03,001,01,005,0246,587,282,6,288,466,0,0,0,0,0,0,0,66.31 ,61.80 ,66.31 
03,001,01,005,0247,588,573,7,580,856,0,0,0,0,0,0,0,66.31 ,67.76 ,66.31 
03,001,01,005,0248,589,506,6,512,824,0,0,0,0,0,0,0,66.31 ,62.14 ,66.31 
03,001,01,005,0249,590,838,12,850,1126,0,0,0,0,0,0,0,66.31 ,75.49 ,66.31 
03,001,01,005,0250,591,352,3,355,561,0,0,0,0,0,0,0,66.31 ,63.28 ,66.31 
03,001,01,005,0250,592,913,10,923,1212,0,0,0,0,0,0,0,66.31 ,76.16 ,66.31 
03,001,01,005,0251,593,655,18,673,937,0,0,0,0,0,0,0,66.31 ,71.82 ,66.31 
03,001,01,005,0251,594,778,12,790,1241,0,0,0,0,0,0,0,66.31 ,63.66 ,66.31 
03,001,01,005,0252,595,621,3,624,830,0,0,0,0,0,0,0,66.31 ,75.18 ,66.31 
03,001,01,005,0253,596,822,15,837,1327,0,0,0,0,0,0,0,66.31 ,63.07 ,66.31 
03,001,01,005,0254,597,1030,15,1045,1632,0,0,0,0,0,0,0,66.31 ,64.03 ,66.31 
03,001,02,006,0255,598,884,12,896,1368,0,0,0,0,0,0,0,66.31 ,65.50 ,66.31 
03,001,02,006,0255,599,682,9,691,1062,0,0,0,0,0,0,0,66.31 ,65.07 ,66.31 
03,001,02,006,0255,600,462,6,468,684,0,0,0,0,0,0,0,66.31 ,68.42 ,66.31 
03,001,02,006,0256,601,693,8,701,1072,0,0,0,0,0,0,0,66.31 ,65.39 ,66.31 
03,001,02,006,0256,602,793,14,807,1195,0,0,0,0,0,0,0,66.31 ,67.53 ,66.31 
03,001,02,006,0256,603,518,6,524,880,0,0,0,0,0,0,0,66.31 ,59.55 ,66.31 
03,001,02,006,0257,604,453,8,461,769,0,0,0,0,0,0,0,66.31 ,59.95 ,66.31 
03,001,02,006,0257,605,606,14,620,980,0,0,0,0,0,0,0,66.31 ,63.27 ,66.31 
03,001,02,006,0258,606,480,7,487,824,0,0,0,0,0,0,0,66.31 ,59.10 ,66.31 
03,001,02,006,0258,607,460,13,473,774,0,0,0,0,0,0,0,66.31 ,61.11 ,66.31 
03,001,02,006,0259,608,744,7,751,1121,0,0,0,0,0,0,0,66.31 ,66.99 ,66.31 
03,001,02,006,0260,609,618,6,624,933,0,0,0,0,0,0,0,66.31 ,66.88 ,66.31 
03,001,02,006,0260,610,533,8,541,884,0,0,0,0,0,0,0,66.31 ,61.20 ,66.31 
03,001,02,006,0261,611,975,12,987,1529,0,0,0,0,0,0,0,66.31 ,64.55 ,66.31 
03,001,02,006,0261,612,917,17,934,1310,0,0,0,0,0,0,0,66.31 ,71.30 ,66.31 
03,001,02,006,0262,613,281,5,286,391,0,0,0,0,0,0,0,66.31 ,73.15 ,66.31 
03,001,02,006,0263,614,672,5,677,1232,0,0,0,0,0,0,0,66.31 ,54.95 ,66.31 
03,001,02,006,0263,615,725,9,734,1258,0,0,0,0,0,0,0,66.31 ,58.35 ,66.31 
03,001,02,006,0264,616,846,11,857,1326,0,0,0,0,0,0,0,66.31 ,64.63 ,66.31 
03,001,02,006,0264,617,859,15,874,1314,0,0,0,0,0,0,0,66.31 ,66.51 ,66.31 
03,001,02,006,0265,618,786,7,793,1337,0,0,0,0,0,0,0,66.31 ,59.31 ,66.31 
03,001,02,006,0265,619,814,10,824,1446,0,0,0,0,0,0,0,66.31 ,56.98 ,66.31 
03,001,02,006,0266,620,729,8,737,1133,0,0,0,0,0,0,0,66.31 ,65.05 ,66.31 
03,001,02,006,0266,621,832,10,842,1259,0,0,0,0,0,0,0,66.31 ,66.88 ,66.31 
03,001,02,006,0267,622,635,6,641,1044,0,0,0,0,0,0,0,66.31 ,61.40 ,66.31 
03,001,02,006,0267,623,796,14,810,1275,0,0,0,0,0,0,0,66.31 ,63.53 ,66.31 
03,001,02,006,0267,624,731,8,739,1172,0,0,0,0,0,0,0,66.31 ,63.05 ,66.31 
03,001,02,006,0268,625,485,8,493,774,0,0,0,0,0,0,0,66.31 ,63.70 ,66.31 
03,001,02,006,0268,626,664,11,675,1008,0,0,0,0,0,0,0,66.31 ,66.96 ,66.31 
03,001,02,006,0269,627,768,12,780,1185,0,0,0,0,0,0,0,66.31 ,65.82 ,66.31 
03,001,02,006,0269,628,595,11,606,897,0,0,0,0,0,0,0,66.31 ,67.56 ,66.31 
03,001,02,006,0270,629,520,8,528,899,0,0,0,0,0,0,0,66.31 ,58.73 ,66.31 
03,001,02,006,0270,630,708,12,720,1156,0,0,0,0,0,0,0,66.31 ,62.28 ,66.31 
03,001,02,006,0270,631,710,11,721,1171,0,0,0,0,0,0,0,66.31 ,61.57 ,66.31 
03,001,02,006,0271,632,652,10,662,1129,0,0,0,0,0,0,0,66.31 ,58.64 ,66.31 
03,001,02,006,0271,633,1032,19,1051,1557,0,0,0,0,0,0,0,66.31 ,67.50 ,66.31 
03,001,02,006,0271,634,1011,10,1021,1539,0,0,0,0,0,0,0,66.31 ,66.34 ,66.31 
03,001,02,006,0272,635,674,12,686,1101,0,0,0,0,0,0,0,66.31 ,62.31 ,66.31 
03,001,02,006,0272,636,688,7,695,1099,0,0,0,0,0,0,0,66.31 ,63.24 ,66.31 
03,001,02,006,0272,637,701,9,710,1188,0,0,0,0,0,0,0,66.31 ,59.76 ,66.31 
03,001,02,006,0273,638,713,10,723,1096,0,0,0,0,0,0,0,66.31 ,65.97 ,66.31 
03,001,02,006,0273,639,737,11,748,1185,0,0,0,0,0,0,0,66.31 ,63.12 ,66.31 
03,001,02,006,0274,640,791,7,798,1197,0,0,0,0,0,0,0,66.31 ,66.67 ,66.31 
03,001,02,006,0274,641,978,12,990,1474,0,0,0,0,0,0,0,66.31 ,67.16 ,66.31 
03,001,02,006,0274,642,922,10,932,1510,0,0,0,0,0,0,0,66.31 ,61.72 ,66.31 
03,001,02,006,0275,643,727,5,732,1158,0,0,0,0,0,0,0,66.31 ,63.21 ,66.31 
03,001,02,006,0275,644,808,17,825,1428,0,0,0,0,0,0,0,66.31 ,57.77 ,66.31 
03,001,02,006,0275,645,870,12,882,1485,0,0,0,0,0,0,0,66.31 ,59.39 ,66.31 
03,001,02,006,0276,646,791,12,803,1233,0,0,0,0,0,0,0,66.31 ,65.13 ,66.31 
03,001,02,006,0276,647,524,4,528,777,0,0,0,0,0,0,0,66.31 ,67.95 ,66.31 
03,001,02,006,0277,648,758,12,770,1378,0,0,0,0,0,0,0,66.31 ,55.88 ,66.31 
03,001,02,006,0277,649,775,14,789,1396,0,0,0,0,0,0,0,66.31 ,56.52 ,66.31 
03,001,02,006,0277,650,797,11,808,1369,0,0,0,0,0,0,0,66.31 ,59.02 ,66.31 
03,001,02,006,0278,651,646,9,655,1188,0,0,0,0,0,0,0,66.31 ,55.13 ,66.31 
03,001,02,006,0279,652,871,17,888,1468,0,0,0,0,0,0,0,66.31 ,60.49 ,66.31 
03,001,02,006,0280,653,884,26,910,1473,0,0,0,0,0,0,0,66.31 ,61.78 ,66.31 
03,001,02,006,0281,654,525,2,527,887,0,0,0,0,0,0,0,66.31 ,59.41 ,66.31 
03,001,02,006,0281,655,480,8,488,808,0,0,0,0,0,0,0,66.31 ,60.40 ,66.31 
03,001,02,006,0282,656,795,8,803,1249,0,0,0,0,0,0,0,66.31 ,64.29 ,66.31 
03,001,02,006,0283,657,731,11,742,1134,0,0,0,0,0,0,0,66.31 ,65.43 ,66.31 
03,001,02,006,0284,658,716,11,727,1292,0,0,0,0,0,0,0,66.31 ,56.27 ,66.31 
03,001,02,006,0285,659,893,9,902,1475,0,0,0,0,0,0,0,66.31 ,61.15 ,66.31 
03,001,02,006,0286,660,719,12,731,1180,0,0,0,0,0,0,0,66.31 ,61.95 ,66.31 
03,001,02,006,0287,661,473,7,480,774,0,0,0,0,0,0,0,66.31 ,62.02 ,66.31 
03,001,02,006,0287,662,471,7,478,774,0,0,0,0,0,0,0,66.31 ,61.76 ,66.31 
03,001,02,006,0288,663,881,19,900,1422,0,0,0,0,0,0,0,66.31 ,63.29 ,66.31 
03,001,02,006,0289,664,528,11,539,894,0,0,0,0,0,0,0,66.31 ,60.29 ,66.31 
03,001,02,006,0289,665,630,10,640,995,0,0,0,0,0,0,0,66.31 ,64.32 ,66.31 
03,001,02,006,0290,666,903,12,915,1601,0,0,0,0,0,0,0,66.31 ,57.15 ,66.31 
03,001,02,006,0291,667,705,6,711,1070,0,0,0,0,0,0,0,66.31 ,66.45 ,66.31 
03,001,02,006,0292,668,611,6,617,1001,0,0,0,0,0,0,0,66.31 ,61.64 ,66.31 
03,001,02,006,0293,669,597,3,600,873,0,0,0,0,0,0,0,66.31 ,68.73 ,66.31 
03,001,02,006,0293,670,474,2,476,711,0,0,0,0,0,0,0,66.31 ,66.95 ,66.31 
03,001,02,006,0294,671,539,3,542,818,0,0,0,0,0,0,0,66.31 ,66.26 ,66.31 
03,001,02,006,0295,672,754,8,762,1378,0,0,0,0,0,0,0,66.31 ,55.30 ,66.31 
03,001,02,006,0296,673,488,3,491,814,0,0,0,0,0,0,0,66.31 ,60.32 ,66.31 
03,001,02,006,0296,674,535,3,538,960,0,0,0,0,0,0,0,66.31 ,56.04 ,66.31 
03,001,02,006,0297,675,580,6,586,968,0,0,0,0,0,0,0,66.31 ,60.54 ,66.31 
03,001,02,006,0298,676,624,4,628,1008,0,0,0,0,0,0,0,66.31 ,62.30 ,66.31 
03,001,02,006,0298,677,530,7,537,1006,0,0,0,0,0,0,0,66.31 ,53.38 ,66.31 
03,001,02,006,0299,678,611,8,619,953,0,0,0,0,0,0,0,66.31 ,64.95 ,66.31 
03,001,02,006,0299,679,664,17,681,1112,0,0,0,0,0,0,0,66.31 ,61.24 ,66.31 
03,001,02,006,0300,680,574,12,586,916,0,0,0,0,0,0,0,66.31 ,63.97 ,66.31 
03,001,02,006,0300,681,675,8,683,1088,0,0,0,0,0,0,0,66.31 ,62.78 ,66.31 
03,001,02,006,0301,682,722,11,733,1217,0,0,0,0,0,0,0,66.31 ,60.23 ,66.31 
03,001,02,006,0301,683,817,4,821,1351,0,0,0,0,0,0,0,66.31 ,60.77 ,66.31 
03,001,02,006,0302,684,817,16,833,1334,0,0,0,0,0,0,0,66.31 ,62.44 ,66.31 
03,001,02,006,0302,685,568,9,577,946,0,0,0,0,0,0,0,66.31 ,60.99 ,66.31 
03,001,02,006,0302,686,719,11,730,1148,0,0,0,0,0,0,0,66.31 ,63.59 ,66.31 
03,001,02,006,0303,687,848,13,861,1363,0,0,0,0,0,0,0,66.31 ,63.17 ,66.31 
03,001,02,006,0304,688,652,11,663,1040,0,0,0,0,0,0,0,66.31 ,63.75 ,66.31 
03,001,02,006,0305,689,915,9,924,1450,0,0,0,0,0,0,0,66.31 ,63.72 ,66.31 
03,001,02,006,0306,690,926,16,942,1555,0,0,0,0,0,0,0,66.31 ,60.58 ,66.31 
03,001,02,006,0307,691,979,12,991,1492,0,0,0,0,0,0,0,66.31 ,66.42 ,66.31 
03,001,02,006,0308,692,664,9,673,1164,0,0,0,0,0,0,0,66.31 ,57.82 ,66.31 
03,001,02,006,0308,693,612,5,617,1016,0,0,0,0,0,0,0,66.31 ,60.73 ,66.31 
03,001,02,006,0309,694,954,17,971,1463,0,0,0,0,0,0,0,66.31 ,66.37 ,66.31 
03,001,02,006,0310,695,566,3,569,944,0,0,0,0,0,0,0,66.31 ,60.28 ,66.31 
03,001,02,006,0311,696,938,13,951,1510,0,0,0,0,0,0,0,66.31 ,62.98 ,66.31 
03,001,02,006,0312,697,553,4,557,874,0,0,0,0,0,0,0,66.31 ,63.73 ,66.31 
03,001,02,006,0312,698,588,6,594,839,0,0,0,0,0,0,0,66.31 ,70.80 ,66.31 
03,001,02,006,0313,699,536,5,541,873,0,0,0,0,0,0,0,66.31 ,61.97 ,66.31 
03,001,02,006,0313,700,540,7,547,971,0,0,0,0,0,0,0,66.31 ,56.33 ,66.31 
03,001,02,006,0314,701,870,11,881,1482,0,0,0,0,0,0,0,66.31 ,59.45 ,66.31 
03,001,02,006,0315,702,406,10,416,724,0,0,0,0,0,0,0,66.31 ,57.46 ,66.31 
03,001,02,006,0316,703,842,9,851,1331,0,0,0,0,0,0,0,66.31 ,63.94 ,66.31 
03,001,02,006,0317,704,398,7,405,619,0,0,0,0,0,0,0,66.31 ,65.43 ,66.31 
03,001,02,006,0318,705,600,16,616,962,0,0,0,0,0,0,0,66.31 ,64.03 ,66.31 
03,001,02,006,0318,706,621,7,628,1021,0,0,0,0,0,0,0,66.31 ,61.51 ,66.31 
03,001,02,006,0319,707,1056,20,1076,1563,0,0,0,0,0,0,0,66.31 ,68.84 ,66.31 
03,001,02,006,0320,708,680,11,691,1067,0,0,0,0,0,0,0,66.31 ,64.76 ,66.31 
03,001,02,006,0320,709,487,11,498,889,0,0,0,0,0,0,0,66.31 ,56.02 ,66.31 
03,001,02,006,0321,710,864,11,875,1404,0,0,0,0,0,0,0,66.31 ,62.32 ,66.31 
03,001,02,006,0322,711,722,14,736,1097,0,0,0,0,0,0,0,66.31 ,67.09 ,66.31 
03,001,02,006,0323,712,959,16,975,1525,0,0,0,0,0,0,0,66.31 ,63.93 ,66.31 
03,001,02,006,0324,713,737,18,755,1134,0,0,0,0,0,0,0,66.31 ,66.58 ,66.31 
03,001,02,006,0324,714,655,12,667,921,0,0,0,0,0,0,0,66.31 ,72.42 ,66.31 
03,001,02,006,0325,715,770,25,795,1139,0,0,0,0,0,0,0,66.31 ,69.80 ,66.31 
03,001,02,006,0325,716,782,10,792,1188,0,0,0,0,0,0,0,66.31 ,66.67 ,66.31 
03,001,02,006,0326,717,868,14,882,1495,0,0,0,0,0,0,0,66.31 ,59.00 ,66.31 
03,001,02,006,0327,718,687,15,702,1118,0,0,0,0,0,0,0,66.31 ,62.79 ,66.31 
03,001,02,006,0328,719,860,9,869,1367,0,0,0,0,0,0,0,66.31 ,63.57 ,66.31 
03,001,02,006,0329,720,692,11,703,1128,0,0,0,0,0,0,0,66.31 ,62.32 ,66.31 
03,001,02,006,0329,721,677,11,688,1072,0,0,0,0,0,0,0,66.31 ,64.18 ,66.31 
03,001,02,006,0330,722,676,12,688,1166,0,0,0,0,0,0,0,66.31 ,59.01 ,66.31 
03,001,02,006,0330,723,559,3,562,1006,0,0,0,0,0,0,0,66.31 ,55.86 ,66.31 
03,001,02,006,0331,724,790,16,806,1350,0,0,0,0,0,0,0,66.31 ,59.70 ,66.31 
03,001,02,006,0332,725,482,11,493,845,0,0,0,0,0,0,0,66.31 ,58.34 ,66.31 
03,001,02,006,0332,726,586,2,588,963,0,0,0,0,0,0,0,66.31 ,61.06 ,66.31 
03,001,02,006,0333,727,782,13,795,1335,0,0,0,0,0,0,0,66.31 ,59.55 ,66.31 
03,001,02,006,0333,728,729,15,744,1247,0,0,0,0,0,0,0,66.31 ,59.66 ,66.31 
03,001,02,006,0333,729,544,6,550,939,0,0,0,0,0,0,0,66.31 ,58.57 ,66.31 
03,001,02,006,0334,730,1068,13,1081,1554,0,0,0,0,0,0,0,66.31 ,69.56 ,66.31 
03,001,02,006,0334,731,944,12,956,1440,0,0,0,0,0,0,0,66.31 ,66.39 ,66.31 
03,001,02,006,0335,732,811,7,818,1423,0,0,0,0,0,0,0,66.31 ,57.48 ,66.31 
03,001,02,006,0335,733,731,11,742,1224,0,0,0,0,0,0,0,66.31 ,60.62 ,66.31 
03,001,02,006,0335,734,724,5,729,1157,0,0,0,0,0,0,0,66.31 ,63.01 ,66.31 
03,001,02,006,0336,735,621,10,631,1016,0,0,0,0,0,0,0,66.31 ,62.11 ,66.31 
03,001,02,006,0336,736,538,8,546,874,0,0,0,0,0,0,0,66.31 ,62.47 ,66.31 
03,001,02,006,0337,737,507,8,515,773,0,0,0,0,0,0,0,66.31 ,66.62 ,66.31 
03,001,02,006,0337,738,520,10,530,866,0,0,0,0,0,0,0,66.31 ,61.20 ,66.31 
03,001,02,006,0338,739,608,7,615,945,0,0,0,0,0,0,0,66.31 ,65.08 ,66.31 
03,001,02,006,0338,740,713,13,726,1143,0,0,0,0,0,0,0,66.31 ,63.52 ,66.31 
03,001,02,006,0339,741,641,10,651,1129,0,0,0,0,0,0,0,66.31 ,57.66 ,66.31 
03,001,02,006,0339,742,665,18,683,1122,0,0,0,0,0,0,0,66.31 ,60.87 ,66.31 
03,001,02,006,0339,743,709,10,719,1124,0,0,0,0,0,0,0,66.31 ,63.97 ,66.31 
03,001,02,006,0340,744,731,9,740,1061,0,0,0,0,0,0,0,66.31 ,69.75 ,66.31 
03,001,02,006,0340,745,730,10,740,1053,0,0,0,0,0,0,0,66.31 ,70.28 ,66.31 
03,001,02,006,0341,746,691,14,705,1113,0,0,0,0,0,0,0,66.31 ,63.34 ,66.31 
03,001,02,006,0341,747,687,7,694,1096,0,0,0,0,0,0,0,66.31 ,63.32 ,66.31 
03,001,02,006,0342,748,833,8,841,1359,0,0,0,0,0,0,0,66.31 ,61.88 ,66.31 
03,001,02,006,0342,749,762,7,769,1169,0,0,0,0,0,0,0,66.31 ,65.78 ,66.31 
03,001,02,006,0343,750,574,13,587,854,0,0,0,0,0,0,0,66.31 ,68.74 ,66.31 
03,001,02,006,0343,751,991,13,1004,1678,0,0,0,0,0,0,0,66.31 ,59.83 ,66.31 
03,001,02,006,0344,752,777,9,786,1326,0,0,0,0,0,0,0,66.31 ,59.28 ,66.31 
03,001,02,006,0344,753,762,13,775,1233,0,0,0,0,0,0,0,66.31 ,62.85 ,66.31 
03,001,02,006,0345,754,993,24,1017,1517,0,0,0,0,0,0,0,66.31 ,67.04 ,66.31 
03,001,02,006,0345,755,707,12,719,1163,0,0,0,0,0,0,0,66.31 ,61.82 ,66.31 
03,001,02,006,0345,756,709,11,720,1174,0,0,0,0,0,0,0,66.31 ,61.33 ,66.31 
03,001,02,006,0346,757,661,17,678,1084,0,0,0,0,0,0,0,66.31 ,62.55 ,66.31 
03,001,02,006,0346,758,507,9,516,901,0,0,0,0,0,0,0,66.31 ,57.27 ,66.31 
03,001,02,006,0347,759,558,13,571,881,0,0,0,0,0,0,0,66.31 ,64.81 ,66.31 
03,001,02,006,0347,760,721,7,728,1124,0,0,0,0,0,0,0,66.31 ,64.77 ,66.31 
03,001,02,006,0347,761,676,3,679,1125,0,0,0,0,0,0,0,66.31 ,60.36 ,66.31 
03,001,02,006,0348,762,871,17,888,1306,0,0,0,0,0,0,0,66.31 ,67.99 ,66.31 
03,001,02,006,0348,763,952,18,970,1376,0,0,0,0,0,0,0,66.31 ,70.49 ,66.31 
03,001,02,006,0349,764,748,14,762,1229,0,0,0,0,0,0,0,66.31 ,62.00 ,66.31 
03,001,02,006,0349,765,583,8,591,906,0,0,0,0,0,0,0,66.31 ,65.23 ,66.31 
03,001,02,006,0350,766,847,12,859,1346,0,0,0,0,0,0,0,66.31 ,63.82 ,66.31 
03,001,02,006,0350,767,661,15,676,1119,0,0,0,0,0,0,0,66.31 ,60.41 ,66.31 
03,001,02,006,0351,768,799,15,814,1160,0,0,0,0,0,0,0,66.31 ,70.17 ,66.31 
03,001,02,006,0351,769,589,9,598,890,0,0,0,0,0,0,0,66.31 ,67.19 ,66.31 
03,001,02,006,0351,770,759,9,768,1152,0,0,0,0,0,0,0,66.31 ,66.67 ,66.31 
03,001,02,006,0352,771,728,5,733,1168,0,0,0,0,0,0,0,66.31 ,62.76 ,66.31 
03,001,02,006,0352,772,687,5,692,1075,0,0,0,0,0,0,0,66.31 ,64.37 ,66.31 
03,001,02,006,0352,773,876,12,888,1387,0,0,0,0,0,0,0,66.31 ,64.02 ,66.31 
03,001,02,006,0353,774,889,11,900,1495,0,0,0,0,0,0,0,66.31 ,60.20 ,66.31 
03,001,02,006,0353,775,803,13,816,1346,0,0,0,0,0,0,0,66.31 ,60.62 ,66.31 
03,001,02,006,0353,776,699,9,708,1094,0,0,0,0,0,0,0,66.31 ,64.72 ,66.31 
03,001,02,006,0354,777,862,14,876,1280,0,0,0,0,0,0,0,66.31 ,68.44 ,66.31 
03,001,02,006,0354,778,616,24,640,995,0,0,0,0,0,0,0,66.31 ,64.32 ,66.31 
03,001,02,006,0354,779,622,16,638,921,0,0,0,0,0,0,0,66.31 ,69.27 ,66.31 
03,001,02,006,0355,780,1179,15,1194,1755,0,0,0,0,0,0,0,66.31 ,68.03 ,66.31 
03,001,02,006,0355,781,792,13,805,1273,0,0,0,0,0,0,0,66.31 ,63.24 ,66.31 
03,001,02,006,0355,782,774,14,788,1425,0,0,0,0,0,0,0,66.31 ,55.30 ,66.31 
03,001,02,006,0356,783,840,10,850,1289,0,0,0,0,0,0,0,66.31 ,65.94 ,66.31 
03,001,02,006,0356,784,807,14,821,1323,0,0,0,0,0,0,0,66.31 ,62.06 ,66.31 
03,001,02,006,0357,785,797,17,814,1179,0,0,0,0,0,0,0,66.31 ,69.04 ,66.31 
03,001,02,006,0357,786,1017,23,1040,1538,0,0,0,0,0,0,0,66.31 ,67.62 ,66.31 
03,001,02,006,0358,787,709,14,723,1042,0,0,0,0,0,0,0,66.31 ,69.39 ,66.31 
03,001,02,006,0358,788,701,13,714,1123,0,0,0,0,0,0,0,66.31 ,63.58 ,66.31 
03,001,02,006,0359,789,875,13,888,1328,0,0,0,0,0,0,0,66.31 ,66.87 ,66.31 
03,001,02,006,0359,790,756,24,780,1144,0,0,0,0,0,0,0,66.31 ,68.18 ,66.31 
03,001,02,006,0360,791,461,11,472,730,0,0,0,0,0,0,0,66.31 ,64.66 ,66.31 
03,001,02,006,0360,792,827,14,841,1207,0,0,0,0,0,0,0,66.31 ,69.68 ,66.31 
03,001,02,006,0361,793,709,8,717,1001,0,0,0,0,0,0,0,66.31 ,71.63 ,66.31 
03,001,02,006,0361,794,622,15,637,966,0,0,0,0,0,0,0,66.31 ,65.94 ,66.31 
03,001,02,006,0362,795,705,9,714,1002,0,0,0,0,0,0,0,66.31 ,71.26 ,66.31 
03,001,02,006,0362,796,586,11,597,863,0,0,0,0,0,0,0,66.31 ,69.18 ,66.31 
03,001,02,006,0363,797,883,24,907,1282,0,0,0,0,0,0,0,66.31 ,70.75 ,66.31 
03,001,02,006,0363,798,1156,24,1180,1657,0,0,0,0,0,0,0,66.31 ,71.21 ,66.31 
03,001,02,006,0364,799,617,12,629,903,0,0,0,0,0,0,0,66.31 ,69.66 ,66.31 
03,001,02,006,0364,800,741,19,760,1036,0,0,0,0,0,0,0,66.31 ,73.36 ,66.31 
03,001,02,006,0365,801,744,11,755,1122,0,0,0,0,0,0,0,66.31 ,67.29 ,66.31 
03,001,02,006,0365,802,700,12,712,1110,0,0,0,0,0,0,0,66.31 ,64.14 ,66.31 
03,001,02,006,0365,803,625,9,634,955,0,0,0,0,0,0,0,66.31 ,66.39 ,66.31 
03,001,02,006,0366,804,684,10,694,976,0,0,0,0,0,0,0,66.31 ,71.11 ,66.31 
03,001,02,006,0366,805,778,14,792,1110,0,0,0,0,0,0,0,66.31 ,71.35 ,66.31 
03,001,02,006,0367,806,867,23,890,1320,0,0,0,0,0,0,0,66.31 ,67.42 ,66.31 
03,001,02,006,0367,807,699,14,713,1050,0,0,0,0,0,0,0,66.31 ,67.90 ,66.31 
03,001,02,006,0368,808,474,7,481,721,0,0,0,0,0,0,0,66.31 ,66.71 ,66.31 
03,001,02,006,0368,809,630,14,644,944,0,0,0,0,0,0,0,66.31 ,68.22 ,66.31 
03,001,02,006,0369,810,922,9,931,1315,0,0,0,0,0,0,0,66.31 ,70.80 ,66.31 
03,001,02,006,0369,811,858,15,873,1221,0,0,0,0,0,0,0,66.31 ,71.50 ,66.31 
03,001,02,006,0370,812,566,10,576,854,0,0,0,0,0,0,0,66.31 ,67.45 ,66.31 
03,001,02,006,0370,813,545,7,552,890,0,0,0,0,0,0,0,66.31 ,62.02 ,66.31 
03,001,02,006,0371,814,951,14,965,1447,0,0,0,0,0,0,0,66.31 ,66.69 ,66.31 
03,001,02,006,0371,815,886,15,901,1281,0,0,0,0,0,0,0,66.31 ,70.34 ,66.31 
03,001,02,006,0372,816,1083,13,1096,1576,0,0,0,0,0,0,0,66.31 ,69.54 ,66.31 
03,001,02,006,0372,817,881,14,895,1257,0,0,0,0,0,0,0,66.31 ,71.20 ,66.31 
03,001,02,006,0373,818,792,12,804,1327,0,0,0,0,0,0,0,66.31 ,60.59 ,66.31 
03,001,02,006,0373,819,741,8,749,1313,0,0,0,0,0,0,0,66.31 ,57.04 ,66.31 
03,001,02,007,0374,820,781,11,792,1192,0,0,0,0,0,0,0,66.31 ,66.44 ,66.31 
03,001,02,007,0374,821,757,14,771,1153,0,0,0,0,0,0,0,66.31 ,66.87 ,66.31 
03,001,02,007,0374,822,668,11,679,1042,0,0,0,0,0,0,0,66.31 ,65.16 ,66.31 
03,001,02,007,0375,823,929,9,938,1451,0,0,0,0,0,0,0,66.31 ,64.65 ,66.31 
03,001,02,007,0375,824,811,13,824,1342,0,0,0,0,0,0,0,66.31 ,61.40 ,66.31 
03,001,02,007,0376,825,768,8,776,1143,0,0,0,0,0,0,0,66.31 ,67.89 ,66.31 
03,001,02,007,0376,826,806,9,815,1222,0,0,0,0,0,0,0,66.31 ,66.69 ,66.31 
03,001,02,007,0377,827,678,11,689,980,0,0,0,0,0,0,0,66.31 ,70.31 ,66.31 
03,001,02,007,0377,828,752,14,766,1176,0,0,0,0,0,0,0,66.31 ,65.14 ,66.31 
03,001,02,007,0378,829,824,10,834,1392,0,0,0,0,0,0,0,66.31 ,59.91 ,66.31 
03,001,02,007,0378,830,763,11,774,1341,0,0,0,0,0,0,0,66.31 ,57.72 ,66.31 
03,001,02,007,0379,831,667,14,681,1053,0,0,0,0,0,0,0,66.31 ,64.67 ,66.31 
03,001,02,007,0379,832,849,8,857,1310,0,0,0,0,0,0,0,66.31 ,65.42 ,66.31 
03,001,02,007,0380,833,572,7,579,945,0,0,0,0,0,0,0,66.31 ,61.27 ,66.31 
03,001,02,007,0380,834,624,8,632,1014,0,0,0,0,0,0,0,66.31 ,62.33 ,66.31 
03,001,02,007,0381,835,735,12,747,1196,0,0,0,0,0,0,0,66.31 ,62.46 ,66.31 
03,001,02,007,0381,836,835,12,847,1358,0,0,0,0,0,0,0,66.31 ,62.37 ,66.31 
03,001,02,007,0382,837,1061,12,1073,1560,0,0,0,0,0,0,0,66.31 ,68.78 ,66.31 
03,001,02,007,0383,838,759,6,765,1191,0,0,0,0,0,0,0,66.31 ,64.23 ,66.31 
03,001,02,007,0383,839,801,6,807,1325,0,0,0,0,0,0,0,66.31 ,60.91 ,66.31 
03,001,02,007,0384,840,809,5,814,1365,0,0,0,0,0,0,0,66.31 ,59.63 ,66.31 
03,001,02,007,0384,841,800,12,812,1246,0,0,0,0,0,0,0,66.31 ,65.17 ,66.31 
03,001,02,007,0385,842,631,10,641,1107,0,0,0,0,0,0,0,66.31 ,57.90 ,66.31 
03,001,02,007,0385,843,709,12,721,1210,0,0,0,0,0,0,0,66.31 ,59.59 ,66.31 
03,001,02,007,0386,844,691,12,703,1234,0,0,0,0,0,0,0,66.31 ,56.97 ,66.31 
03,001,02,007,0386,845,677,10,687,1171,0,0,0,0,0,0,0,66.31 ,58.67 ,66.31 
03,001,02,007,0386,846,652,9,661,1096,0,0,0,0,0,0,0,66.31 ,60.31 ,66.31 
03,001,02,007,0387,847,625,10,635,1125,0,0,0,0,0,0,0,66.31 ,56.44 ,66.31 
03,001,02,007,0387,848,619,11,630,1156,0,0,0,0,0,0,0,66.31 ,54.50 ,66.31 
03,001,02,007,0387,849,640,9,649,1153,0,0,0,0,0,0,0,66.31 ,56.29 ,66.31 
03,001,02,007,0388,850,682,14,696,1156,0,0,0,0,0,0,0,66.31 ,60.21 ,66.31 
03,001,02,007,0388,851,621,8,629,1064,0,0,0,0,0,0,0,66.31 ,59.12 ,66.31 
03,001,02,007,0388,852,645,7,652,1056,0,0,0,0,0,0,0,66.31 ,61.74 ,66.31 
03,001,02,007,0389,853,422,8,430,619,0,0,0,0,0,0,0,66.31 ,69.47 ,66.31 
03,001,02,007,0390,854,977,12,989,1517,0,0,0,0,0,0,0,66.31 ,65.19 ,66.31 
03,001,02,007,0390,855,980,16,996,1477,0,0,0,0,0,0,0,66.31 ,67.43 ,66.31 
03,001,02,007,0391,856,1033,13,1046,1430,0,0,0,0,0,0,0,66.31 ,73.15 ,66.31 
03,001,02,007,0391,857,883,9,892,1286,0,0,0,0,0,0,0,66.31 ,69.36 ,66.31 
03,001,02,007,0392,858,839,8,847,1317,0,0,0,0,0,0,0,66.31 ,64.31 ,66.31 
03,001,02,007,0392,859,780,14,794,1263,0,0,0,0,0,0,0,66.31 ,62.87 ,66.31 
03,001,02,007,0393,860,655,11,666,984,0,0,0,0,0,0,0,66.31 ,67.68 ,66.31 
03,001,02,007,0393,861,689,17,706,1087,0,0,0,0,0,0,0,66.31 ,64.95 ,66.31 
03,001,02,007,0394,862,683,8,691,1018,0,0,0,0,0,0,0,66.31 ,67.88 ,66.31 
03,001,02,007,0394,863,591,11,602,869,0,0,0,0,0,0,0,66.31 ,69.28 ,66.31 
03,001,02,007,0395,864,831,12,843,1245,0,0,0,0,0,0,0,66.31 ,67.71 ,66.31 
03,001,02,007,0395,865,909,21,930,1440,0,0,0,0,0,0,0,66.31 ,64.58 ,66.31 
03,001,02,007,0396,866,920,10,930,1586,0,0,0,0,0,0,0,66.31 ,58.64 ,66.31 
03,001,02,007,0396,867,743,17,760,1144,0,0,0,0,0,0,0,66.31 ,66.43 ,66.31 
03,001,02,007,0396,868,679,9,688,1151,0,0,0,0,0,0,0,66.31 ,59.77 ,66.31 
03,001,02,007,0397,869,769,13,782,1144,0,0,0,0,0,0,0,66.31 ,68.36 ,66.31 
03,001,02,007,0397,870,781,9,790,1098,0,0,0,0,0,0,0,66.31 ,71.95 ,66.31 
03,001,02,007,0398,871,825,8,833,1240,0,0,0,0,0,0,0,66.31 ,67.18 ,66.31 
03,001,02,007,0398,872,727,11,738,1084,0,0,0,0,0,0,0,66.31 ,68.08 ,66.31 
03,001,02,007,0399,873,673,11,684,961,0,0,0,0,0,0,0,66.31 ,71.18 ,66.31 
03,001,02,007,0399,874,739,21,760,1047,0,0,0,0,0,0,0,66.31 ,72.59 ,66.31 
03,001,02,007,0400,875,701,12,713,1037,0,0,0,0,0,0,0,66.31 ,68.76 ,66.31 
03,001,02,007,0400,876,567,9,576,856,0,0,0,0,0,0,0,66.31 ,67.29 ,66.31 
03,001,02,007,0401,877,892,5,897,1279,0,0,0,0,0,0,0,66.31 ,70.13 ,66.31 
03,001,02,007,0401,878,993,20,1013,1441,0,0,0,0,0,0,0,66.31 ,70.30 ,66.31 
03,001,02,007,0402,879,997,21,1018,1454,0,0,0,0,0,0,0,66.31 ,70.01 ,66.31 
03,001,02,007,0403,880,718,14,732,1078,0,0,0,0,0,0,0,66.31 ,67.90 ,66.31 
03,001,02,007,0403,881,867,20,887,1284,0,0,0,0,0,0,0,66.31 ,69.08 ,66.31 
03,001,02,007,0403,882,677,11,688,1056,0,0,0,0,0,0,0,66.31 ,65.15 ,66.31 
03,001,02,007,0404,883,553,4,557,895,0,0,0,0,0,0,0,66.31 ,62.23 ,66.31 
03,001,02,007,0404,884,711,14,725,1048,0,0,0,0,0,0,0,66.31 ,69.18 ,66.31 
03,001,02,007,0405,885,628,7,635,895,0,0,0,0,0,0,0,66.31 ,70.95 ,66.31 
03,001,02,007,0405,886,615,15,630,925,0,0,0,0,0,0,0,66.31 ,68.11 ,66.31 
03,001,02,007,0406,887,861,8,869,1428,0,0,0,0,0,0,0,66.31 ,60.85 ,66.31 
03,001,02,007,0406,888,855,18,873,1370,0,0,0,0,0,0,0,66.31 ,63.72 ,66.31 
03,001,02,007,0406,889,840,12,852,1392,0,0,0,0,0,0,0,66.31 ,61.21 ,66.31 
03,001,02,007,0407,890,756,18,774,1220,0,0,0,0,0,0,0,66.31 ,63.44 ,66.31 
03,001,02,007,0407,891,974,9,983,1598,0,0,0,0,0,0,0,66.31 ,61.51 ,66.31 
03,001,02,007,0407,892,854,25,879,1331,0,0,0,0,0,0,0,66.31 ,66.04 ,66.31 
03,001,02,007,0408,893,1035,20,1055,1681,0,0,0,0,0,0,0,66.31 ,62.76 ,66.31 
03,001,02,007,0408,894,791,13,804,1320,0,0,0,0,0,0,0,66.31 ,60.91 ,66.31 
03,001,02,007,0409,895,996,19,1015,1505,0,0,0,0,0,0,0,66.31 ,67.44 ,66.31 
03,001,02,007,0410,896,830,10,840,1321,0,0,0,0,0,0,0,66.31 ,63.59 ,66.31 
03,001,02,007,0410,897,783,7,790,1241,0,0,0,0,0,0,0,66.31 ,63.66 ,66.31 
03,001,02,007,0411,898,596,11,607,920,0,0,0,0,0,0,0,66.31 ,65.98 ,66.31 
03,001,02,007,0411,899,856,19,875,1240,0,0,0,0,0,0,0,66.31 ,70.56 ,66.31 
03,001,02,008,0412,900,801,10,811,1209,0,0,0,0,0,0,0,66.31 ,67.08 ,66.31 
03,001,02,008,0412,901,616,8,624,1111,0,0,0,0,0,0,0,66.31 ,56.17 ,66.31 
03,001,02,008,0412,902,612,11,623,920,0,0,0,0,0,0,0,66.31 ,67.72 ,66.31 
03,001,02,008,0413,903,879,11,890,1458,0,0,0,0,0,0,0,66.31 ,61.04 ,66.31 
03,001,02,008,0413,904,838,12,850,1423,0,0,0,0,0,0,0,66.31 ,59.73 ,66.31 
03,001,02,008,0413,905,692,11,703,1156,0,0,0,0,0,0,0,66.31 ,60.81 ,66.31 
03,001,02,008,0414,906,872,10,882,1424,0,0,0,0,0,0,0,66.31 ,61.94 ,66.31 
03,001,02,008,0415,907,712,14,726,1357,0,0,0,0,0,0,0,66.31 ,53.50 ,66.31 
03,001,02,008,0415,908,761,10,771,1310,0,0,0,0,0,0,0,66.31 ,58.85 ,66.31 
03,001,02,008,0416,909,1042,13,1055,1599,0,0,0,0,0,0,0,66.31 ,65.98 ,66.31 
03,001,02,008,0416,910,840,9,849,1377,0,0,0,0,0,0,0,66.31 ,61.66 ,66.31 
03,001,02,008,0417,911,967,9,976,1487,0,0,0,0,0,0,0,66.31 ,65.64 ,66.31 
03,001,02,008,0418,912,667,8,675,1201,0,0,0,0,0,0,0,66.31 ,56.20 ,66.31 
03,001,02,008,0418,913,782,7,789,1370,0,0,0,0,0,0,0,66.31 ,57.59 ,66.31 
03,001,02,008,0419,914,708,11,719,1267,0,0,0,0,0,0,0,66.31 ,56.75 ,66.31 
03,001,02,008,0419,915,669,8,677,1085,0,0,0,0,0,0,0,66.31 ,62.40 ,66.31 
03,001,02,008,0419,916,764,14,778,1219,0,0,0,0,0,0,0,66.31 ,63.82 ,66.31 
03,001,02,008,0420,917,817,10,827,1434,0,0,0,0,0,0,0,66.31 ,57.67 ,66.31 
03,001,02,008,0420,918,694,6,700,1245,0,0,0,0,0,0,0,66.31 ,56.22 ,66.31 
03,001,02,008,0420,919,677,3,680,1226,0,0,0,0,0,0,0,66.31 ,55.46 ,66.31 
03,001,02,008,0421,920,536,5,541,911,0,0,0,0,0,0,0,66.31 ,59.39 ,66.31 
03,001,02,008,0421,921,479,1,480,887,0,0,0,0,0,0,0,66.31 ,54.11 ,66.31 
03,001,02,008,0422,922,755,13,768,1365,0,0,0,0,0,0,0,66.31 ,56.26 ,66.31 
03,001,02,008,0422,923,889,7,896,1516,0,0,0,0,0,0,0,66.31 ,59.10 ,66.31 
03,001,02,008,0423,924,759,11,770,1228,0,0,0,0,0,0,0,66.31 ,62.70 ,66.31 
03,001,02,008,0423,925,769,11,780,1287,0,0,0,0,0,0,0,66.31 ,60.61 ,66.31 
03,001,02,008,0423,926,761,10,771,1261,0,0,0,0,0,0,0,66.31 ,61.14 ,66.31 
03,001,02,008,0424,927,648,15,663,1085,0,0,0,0,0,0,0,66.31 ,61.11 ,66.31 
03,001,02,008,0424,928,721,10,731,1194,0,0,0,0,0,0,0,66.31 ,61.22 ,66.31 
03,001,02,008,0425,929,644,12,656,1135,0,0,0,0,0,0,0,66.31 ,57.80 ,66.31 
03,001,02,008,0425,930,702,6,708,1181,0,0,0,0,0,0,0,66.31 ,59.95 ,66.31 
03,001,02,008,0425,931,717,5,722,1202,0,0,0,0,0,0,0,66.31 ,60.07 ,66.31 
03,001,02,008,0426,932,648,11,659,1098,0,0,0,0,0,0,0,66.31 ,60.02 ,66.31 
03,001,02,008,0426,933,746,8,754,1207,0,0,0,0,0,0,0,66.31 ,62.47 ,66.31 
03,001,02,008,0426,934,791,6,797,1312,0,0,0,0,0,0,0,66.31 ,60.75 ,66.31 
03,001,02,008,0427,935,700,11,711,1154,0,0,0,0,0,0,0,66.31 ,61.61 ,66.31 
03,001,02,008,0427,936,680,4,684,1166,0,0,0,0,0,0,0,66.31 ,58.66 ,66.31 
03,001,02,008,0427,937,749,6,755,1176,0,0,0,0,0,0,0,66.31 ,64.20 ,66.31 
03,001,02,008,0428,938,622,4,626,966,0,0,0,0,0,0,0,66.31 ,64.80 ,66.31 
03,001,02,008,0428,939,682,11,693,1092,0,0,0,0,0,0,0,66.31 ,63.46 ,66.31 
03,001,02,008,0428,940,550,11,561,843,0,0,0,0,0,0,0,66.31 ,66.55 ,66.31 
03,001,02,008,0429,941,787,10,797,1198,0,0,0,0,0,0,0,66.31 ,66.53 ,66.31 
03,001,02,008,0429,942,850,16,866,1475,0,0,0,0,0,0,0,66.31 ,58.71 ,66.31 
03,001,02,008,0430,943,748,10,758,1146,0,0,0,0,0,0,0,66.31 ,66.14 ,66.31 
03,001,02,008,0431,944,994,10,1004,1554,0,0,0,0,0,0,0,66.31 ,64.61 ,66.31 
03,001,02,008,0432,945,695,4,699,1078,0,0,0,0,0,0,0,66.31 ,64.84 ,66.31 
03,001,02,008,0432,946,537,14,551,835,0,0,0,0,0,0,0,66.31 ,65.99 ,66.31 
03,001,02,008,0433,947,599,8,607,1066,0,0,0,0,0,0,0,66.31 ,56.94 ,66.31 
03,001,02,008,0433,948,644,7,651,1131,0,0,0,0,0,0,0,66.31 ,57.56 ,66.31 
03,001,02,008,0434,949,644,8,652,1056,0,0,0,0,0,0,0,66.31 ,61.74 ,66.31 
03,001,02,008,0434,950,629,8,637,998,0,0,0,0,0,0,0,66.31 ,63.83 ,66.31 
03,001,02,008,0435,951,790,14,804,1268,0,0,0,0,0,0,0,66.31 ,63.41 ,66.31 
03,001,02,008,0435,952,792,12,804,1327,0,0,0,0,0,0,0,66.31 ,60.59 ,66.31 
03,001,02,008,0436,953,668,8,676,1161,0,0,0,0,0,0,0,66.31 ,58.23 ,66.31 
03,001,02,008,0436,954,653,11,664,1152,0,0,0,0,0,0,0,66.31 ,57.64 ,66.31 
03,001,02,008,0437,955,713,9,722,1267,0,0,0,0,0,0,0,66.31 ,56.99 ,66.31 
03,001,02,008,0437,956,705,8,713,1211,0,0,0,0,0,0,0,66.31 ,58.88 ,66.31 
03,001,02,008,0438,957,746,8,754,1277,0,0,0,0,0,0,0,66.31 ,59.04 ,66.31 
03,001,02,008,0438,958,693,7,700,1198,0,0,0,0,0,0,0,66.31 ,58.43 ,66.31 
03,001,02,008,0438,959,718,10,728,1261,0,0,0,0,0,0,0,66.31 ,57.73 ,66.31 
03,001,02,008,0439,960,686,12,698,1176,0,0,0,0,0,0,0,66.31 ,59.35 ,66.31 
03,001,02,008,0439,961,709,10,719,1196,0,0,0,0,0,0,0,66.31 ,60.12 ,66.31 
03,001,02,008,0440,962,740,10,750,1226,0,0,0,0,0,0,0,66.31 ,61.17 ,66.31 
03,001,02,008,0440,963,703,15,718,1187,0,0,0,0,0,0,0,66.31 ,60.49 ,66.31 
03,001,02,008,0440,964,761,12,773,1247,0,0,0,0,0,0,0,66.31 ,61.99 ,66.31 
03,001,02,008,0441,965,1065,18,1083,1746,0,0,0,0,0,0,0,66.31 ,62.03 ,66.31 
03,001,02,008,0442,966,924,16,940,1489,0,0,0,0,0,0,0,66.31 ,63.13 ,66.31 
03,001,02,008,0442,967,854,10,864,1399,0,0,0,0,0,0,0,66.31 ,61.76 ,66.31 
03,001,02,008,0442,968,700,6,706,1224,0,0,0,0,0,0,0,66.31 ,57.68 ,66.31 
03,001,02,008,0443,969,825,6,831,1488,0,0,0,0,0,0,0,66.31 ,55.85 ,66.31 
03,001,02,008,0443,970,806,16,822,1614,0,0,0,0,0,0,0,66.31 ,50.93 ,66.31 
03,001,02,008,0444,971,786,13,799,1352,0,0,0,0,0,0,0,66.31 ,59.10 ,66.31 
03,001,02,008,0444,972,762,12,774,1347,0,0,0,0,0,0,0,66.31 ,57.46 ,66.31 
03,001,02,008,0444,973,684,5,689,1273,0,0,0,0,0,0,0,66.31 ,54.12 ,66.31 
03,001,02,008,0445,974,601,5,606,981,0,0,0,0,0,0,0,66.31 ,61.77 ,66.31 
03,001,02,008,0445,975,565,3,568,996,0,0,0,0,0,0,0,66.31 ,57.03 ,66.31 
03,001,02,008,0446,976,860,10,870,1546,0,0,0,0,0,0,0,66.31 ,56.27 ,66.31 
03,001,02,008,0446,977,760,8,768,1441,0,0,0,0,0,0,0,66.31 ,53.30 ,66.31 
03,001,02,008,0447,978,987,13,1000,1600,0,0,0,0,0,0,0,66.31 ,62.50 ,66.31 
03,001,02,008,0447,979,774,11,785,1315,0,0,0,0,0,0,0,66.31 ,59.70 ,66.31 
03,001,02,008,0448,980,954,14,968,1552,0,0,0,0,0,0,0,66.31 ,62.37 ,66.31 
03,001,02,008,0448,981,927,14,941,1492,0,0,0,0,0,0,0,66.31 ,63.07 ,66.31 
03,001,02,008,0449,982,535,2,537,1016,0,0,0,0,0,0,0,66.31 ,52.85 ,66.31 
03,001,02,008,0449,983,553,5,558,939,0,0,0,0,0,0,0,66.31 ,59.42 ,66.31 
03,001,02,008,0449,984,666,12,678,1100,0,0,0,0,0,0,0,66.31 ,61.64 ,66.31 
03,001,02,008,0450,985,574,9,583,1086,0,0,0,0,0,0,0,66.31 ,53.68 ,66.31 
03,001,02,008,0450,986,638,9,647,1186,0,0,0,0,0,0,0,66.31 ,54.55 ,66.31 
03,001,02,008,0451,987,703,14,717,1257,0,0,0,0,0,0,0,66.31 ,57.04 ,66.31 
03,001,02,008,0451,988,687,11,698,1128,0,0,0,0,0,0,0,66.31 ,61.88 ,66.31 
03,001,02,008,0451,989,572,7,579,1056,0,0,0,0,0,0,0,66.31 ,54.83 ,66.31 
03,001,02,008,0452,990,835,11,846,1481,0,0,0,0,0,0,0,66.31 ,57.12 ,66.31 
03,001,02,008,0453,991,625,3,628,992,0,0,0,0,0,0,0,66.31 ,63.31 ,66.31 
03,001,02,008,0453,992,546,4,550,945,0,0,0,0,0,0,0,66.31 ,58.20 ,66.31 
03,001,02,008,0454,993,857,20,877,1214,0,0,0,0,0,0,0,66.31 ,72.24 ,66.31 
03,001,02,008,0454,994,676,8,684,1144,0,0,0,0,0,0,0,66.31 ,59.79 ,66.31 
03,001,02,008,0455,995,568,3,571,1071,0,0,0,0,0,0,0,66.31 ,53.31 ,66.31 
03,001,02,008,0455,996,613,11,624,1127,0,0,0,0,0,0,0,66.31 ,55.37 ,66.31 
03,001,02,008,0455,997,627,11,638,1155,0,0,0,0,0,0,0,66.31 ,55.24 ,66.31 
03,001,02,008,0456,998,692,8,700,1197,0,0,0,0,0,0,0,66.31 ,58.48 ,66.31 
03,001,02,008,0456,999,651,9,660,1152,0,0,0,0,0,0,0,66.31 ,57.29 ,66.31 
03,001,02,008,0456,1000,707,10,717,1228,0,0,0,0,0,0,0,66.31 ,58.39 ,66.31 
03,001,02,008,0457,1001,1039,18,1057,1675,0,0,0,0,0,0,0,66.31 ,63.10 ,66.31 
03,001,02,008,0458,1002,774,12,786,1235,0,0,0,0,0,0,0,66.31 ,63.64 ,66.31 
03,001,02,008,0458,1003,541,6,547,965,0,0,0,0,0,0,0,66.31 ,56.68 ,66.31 
03,001,02,008,0459,1004,765,5,770,1219,0,0,0,0,0,0,0,66.31 ,63.17 ,66.31 
03,001,02,008,0459,1005,774,13,787,1415,0,0,0,0,0,0,0,66.31 ,55.62 ,66.31 
03,001,02,008,0459,1006,870,7,877,1396,0,0,0,0,0,0,0,66.31 ,62.82 ,66.31 
03,001,02,008,0460,1007,803,11,814,1242,0,0,0,0,0,0,0,66.31 ,65.54 ,66.31 
03,001,02,008,0461,1008,698,11,709,1123,0,0,0,0,0,0,0,66.31 ,63.13 ,66.31 
03,001,02,008,0461,1009,669,10,679,1109,0,0,0,0,0,0,0,66.31 ,61.23 ,66.31 
03,001,02,008,0461,1010,789,5,794,1327,0,0,0,0,0,0,0,66.31 ,59.83 ,66.31 
03,001,02,008,0462,1011,984,11,995,1537,0,0,0,0,0,0,0,66.31 ,64.74 ,66.31 
03,001,02,008,0463,1012,898,15,913,1476,0,0,0,0,0,0,0,66.31 ,61.86 ,66.31 
03,001,02,008,0463,1013,820,14,834,1488,0,0,0,0,0,0,0,66.31 ,56.05 ,66.31 
03,001,02,008,0463,1014,762,9,771,1343,0,0,0,0,0,0,0,66.31 ,57.41 ,66.31 
03,001,02,008,0464,1015,586,4,590,937,0,0,0,0,0,0,0,66.31 ,62.97 ,66.31 
03,001,02,008,0464,1016,624,7,631,1000,0,0,0,0,0,0,0,66.31 ,63.10 ,66.31 
03,001,02,008,0465,1017,613,7,620,997,0,0,0,0,0,0,0,66.31 ,62.19 ,66.31 
03,001,02,008,0465,1018,616,12,628,972,0,0,0,0,0,0,0,66.31 ,64.61 ,66.31 
03,001,02,008,0466,1019,583,10,593,986,0,0,0,0,0,0,0,66.31 ,60.14 ,66.31 
03,001,02,008,0466,1020,481,3,484,860,0,0,0,0,0,0,0,66.31 ,56.28 ,66.31 
03,001,02,008,0467,1021,925,12,937,1750,0,0,0,0,0,0,0,66.31 ,53.54 ,66.31 
03,001,02,008,0467,1022,814,5,819,1430,0,0,0,0,0,0,0,66.31 ,57.27 ,66.31 
03,001,02,008,0468,1023,595,6,601,990,0,0,0,0,0,0,0,66.31 ,60.71 ,66.31 
03,001,02,008,0468,1024,584,4,588,1062,0,0,0,0,0,0,0,66.31 ,55.37 ,66.31 
03,001,02,008,0468,1025,718,8,726,1086,0,0,0,0,0,0,0,66.31 ,66.85 ,66.31 
03,001,02,008,0469,1026,816,9,825,1391,0,0,0,0,0,0,0,66.31 ,59.31 ,66.31 
03,001,02,008,0469,1027,771,10,781,1318,0,0,0,0,0,0,0,66.31 ,59.26 ,66.31 
03,001,02,008,0469,1028,357,6,363,532,0,0,0,0,0,0,0,66.31 ,68.23 ,66.31 
03,001,02,008,0470,1029,927,9,936,1453,0,0,0,0,0,0,0,66.31 ,64.42 ,66.31 
03,001,02,008,0471,1030,588,8,596,938,0,0,0,0,0,0,0,66.31 ,63.54 ,66.31 
03,001,02,008,0471,1031,507,7,514,885,0,0,0,0,0,0,0,66.31 ,58.08 ,66.31 
03,001,02,008,0472,1032,559,9,568,1031,0,0,0,0,0,0,0,66.31 ,55.09 ,66.31 
03,001,02,008,0472,1033,720,12,732,1336,0,0,0,0,0,0,0,66.31 ,54.79 ,66.31 
03,001,02,008,0473,1034,590,6,596,1101,0,0,0,0,0,0,0,66.31 ,54.13 ,66.31 
03,001,02,008,0473,1035,631,8,639,1128,0,0,0,0,0,0,0,66.31 ,56.65 ,66.31 
03,001,02,008,0473,1036,607,7,614,1032,0,0,0,0,0,0,0,66.31 ,59.50 ,66.31 
03,001,02,008,0474,1037,443,5,448,819,0,0,0,0,0,0,0,66.31 ,54.70 ,66.31 
03,001,02,008,0474,1038,456,1,457,853,0,0,0,0,0,0,0,66.31 ,53.58 ,66.31 
03,001,02,008,0475,1039,674,7,681,1244,0,0,0,0,0,0,0,66.31 ,54.74 ,66.31 
03,001,02,008,0475,1040,775,15,790,1354,0,0,0,0,0,0,0,66.31 ,58.35 ,66.31 
03,001,02,008,0475,1041,791,10,801,1436,0,0,0,0,0,0,0,66.31 ,55.78 ,66.31 
03,001,02,008,0476,1042,469,14,483,850,0,0,0,0,0,0,0,66.31 ,56.82 ,66.31 
03,001,02,008,0476,1043,544,10,554,950,0,0,0,0,0,0,0,66.31 ,58.32 ,66.31 
03,001,02,008,0477,1044,669,4,673,1112,0,0,0,0,0,0,0,66.31 ,60.52 ,66.31 
03,001,02,008,0477,1045,634,10,644,1114,0,0,0,0,0,0,0,66.31 ,57.81 ,66.31 
03,001,02,008,0478,1046,612,8,620,1064,0,0,0,0,0,0,0,66.31 ,58.27 ,66.31 
03,001,02,008,0478,1047,591,13,604,1032,0,0,0,0,0,0,0,66.31 ,58.53 ,66.31 
03,001,02,008,0479,1048,512,7,519,969,0,0,0,0,0,0,0,66.31 ,53.56 ,66.31 
03,001,02,008,0479,1049,605,6,611,1149,0,0,0,0,0,0,0,66.31 ,53.18 ,66.31 
03,001,02,008,0480,1050,899,18,917,1567,0,0,0,0,0,0,0,66.31 ,58.52 ,66.31 
03,001,02,008,0480,1051,757,5,762,1314,0,0,0,0,0,0,0,66.31 ,57.99 ,66.31 
03,001,02,008,0481,1052,906,9,915,1762,0,0,0,0,0,0,0,66.31 ,51.93 ,66.31 
03,001,02,008,0481,1053,819,18,837,1692,0,0,0,0,0,0,0,66.31 ,49.47 ,66.31 
03,001,02,008,0482,1054,550,6,556,1034,0,0,0,0,0,0,0,66.31 ,53.77 ,66.31 
03,001,02,008,0482,1055,641,10,651,1105,0,0,0,0,0,0,0,66.31 ,58.91 ,66.31 
03,001,02,008,0483,1056,520,13,533,1053,0,0,0,0,0,0,0,66.31 ,50.62 ,66.31 
03,001,02,008,0483,1057,656,17,673,1248,0,0,0,0,0,0,0,66.31 ,53.93 ,66.31 
03,001,02,008,0483,1058,503,8,511,980,0,0,0,0,0,0,0,66.31 ,52.14 ,66.31 
03,001,02,008,0484,1059,569,10,579,1129,0,0,0,0,0,0,0,66.31 ,51.28 ,66.31 
03,001,02,008,0484,1060,795,8,803,1528,0,0,0,0,0,0,0,66.31 ,52.55 ,66.31 
03,001,02,008,0484,1061,360,6,366,664,0,0,0,0,0,0,0,66.31 ,55.12 ,66.31 
03,001,02,008,0485,1062,526,4,530,939,0,0,0,0,0,0,0,66.31 ,56.44 ,66.31 
03,001,02,008,0485,1063,571,5,576,1007,0,0,0,0,0,0,0,66.31 ,57.20 ,66.31 
03,001,02,008,0486,1064,662,7,669,1221,0,0,0,0,0,0,0,66.31 ,54.79 ,66.31 
03,001,02,008,0486,1065,626,7,633,1118,0,0,0,0,0,0,0,66.31 ,56.62 ,66.31 
03,001,02,008,0487,1066,577,8,585,1209,0,0,0,0,0,0,0,66.31 ,48.39 ,66.31 
03,001,02,008,0487,1067,594,10,604,1210,0,0,0,0,0,0,0,66.31 ,49.92 ,66.31 
03,001,02,008,0487,1068,645,13,658,1288,0,0,0,0,0,0,0,66.31 ,51.09 ,66.31 
03,001,02,008,0488,1069,534,8,542,1008,0,0,0,0,0,0,0,66.31 ,53.77 ,66.31 
03,001,02,008,0488,1070,704,15,719,1383,0,0,0,0,0,0,0,66.31 ,51.99 ,66.31 
03,001,02,008,0489,1071,617,8,625,1179,0,0,0,0,0,0,0,66.31 ,53.01 ,66.31 
03,001,02,008,0489,1072,765,10,775,1451,0,0,0,0,0,0,0,66.31 ,53.41 ,66.31 
03,001,02,008,0490,1073,560,4,564,1026,0,0,0,0,0,0,0,66.31 ,54.97 ,66.31 
03,001,02,008,0491,1074,594,14,608,1111,0,0,0,0,0,0,0,66.31 ,54.73 ,66.31 
03,001,02,008,0491,1075,698,9,707,1439,0,0,0,0,0,0,0,66.31 ,49.13 ,66.31 
03,001,02,008,0491,1076,659,13,672,1202,0,0,0,0,0,0,0,66.31 ,55.91 ,66.31 
03,001,02,008,0492,1077,506,2,508,1014,0,0,0,0,0,0,0,66.31 ,50.10 ,66.31 
03,001,02,008,0492,1078,595,5,600,1027,0,0,0,0,0,0,0,66.31 ,58.42 ,66.31 
03,001,02,008,0493,1079,595,5,600,1086,0,0,0,0,0,0,0,66.31 ,55.25 ,66.31 
03,001,02,008,0493,1080,531,8,539,966,0,0,0,0,0,0,0,66.31 ,55.80 ,66.31 
03,001,02,008,0494,1081,458,9,467,861,0,0,0,0,0,0,0,66.31 ,54.24 ,66.31 
03,001,02,008,0494,1082,380,3,383,732,0,0,0,0,0,0,0,66.31 ,52.32 ,66.31 
03,001,02,008,0495,1083,451,9,460,849,0,0,0,0,0,0,0,66.31 ,54.18 ,66.31 
03,001,02,008,0495,1084,486,6,492,917,0,0,0,0,0,0,0,66.31 ,53.65 ,66.31 
03,001,02,008,0495,1085,607,10,617,1117,0,0,0,0,0,0,0,66.31 ,55.24 ,66.31 
03,001,02,008,0495,1086,778,4,782,1456,0,0,0,0,0,0,0,66.31 ,53.71 ,66.31 
03,001,02,009,0496,1087,691,4,695,1103,0,0,0,0,0,0,0,66.31 ,63.01 ,66.31 
03,001,02,009,0496,1088,691,4,695,1112,0,0,0,0,0,0,0,66.31 ,62.50 ,66.31 
03,001,02,009,0496,1089,751,14,765,1148,0,0,0,0,0,0,0,66.31 ,66.64 ,66.31 
03,001,02,009,0497,1090,674,5,679,1073,0,0,0,0,0,0,0,66.31 ,63.28 ,66.31 
03,001,02,009,0498,1091,708,10,718,1184,0,0,0,0,0,0,0,66.31 ,60.64 ,66.31 
03,001,02,009,0498,1092,454,16,470,652,0,0,0,0,0,0,0,66.31 ,72.09 ,66.31 
03,001,02,009,0499,1093,695,6,701,1121,0,0,0,0,0,0,0,66.31 ,62.53 ,66.31 
03,001,02,009,0499,1094,622,9,631,1074,0,0,0,0,0,0,0,66.31 ,58.75 ,66.31 
03,001,02,009,0500,1095,781,11,792,1214,0,0,0,0,0,0,0,66.31 ,65.24 ,66.31 
03,001,02,009,0501,1096,588,17,605,972,0,0,0,0,0,0,0,66.31 ,62.24 ,66.31 
03,001,02,009,0501,1097,677,11,688,1109,0,0,0,0,0,0,0,66.31 ,62.04 ,66.31 
03,001,02,009,0502,1098,653,8,661,1087,0,0,0,0,0,0,0,66.31 ,60.81 ,66.31 
03,001,02,009,0502,1099,733,13,746,1126,0,0,0,0,0,0,0,66.31 ,66.25 ,66.31 
03,001,02,009,0502,1100,714,8,722,1168,0,0,0,0,0,0,0,66.31 ,61.82 ,66.31 
03,001,02,009,0503,1101,741,18,759,1218,0,0,0,0,0,0,0,66.31 ,62.32 ,66.31 
03,001,02,009,0503,1102,580,10,590,1077,0,0,0,0,0,0,0,66.31 ,54.78 ,66.31 
03,001,02,009,0504,1103,662,22,684,1038,0,0,0,0,0,0,0,66.31 ,65.90 ,66.31 
03,001,02,009,0504,1104,615,6,621,1000,0,0,0,0,0,0,0,66.31 ,62.10 ,66.31 
03,001,02,009,0505,1105,668,12,680,1103,0,0,0,0,0,0,0,66.31 ,61.65 ,66.31 
03,001,02,009,0505,1106,771,5,776,1253,0,0,0,0,0,0,0,66.31 ,61.93 ,66.31 
03,001,02,009,0506,1107,568,5,573,948,0,0,0,0,0,0,0,66.31 ,60.44 ,66.31 
03,001,02,009,0506,1108,614,5,619,1035,0,0,0,0,0,0,0,66.31 ,59.81 ,66.31 
03,001,02,009,0507,1109,729,11,740,1099,0,0,0,0,0,0,0,66.31 ,67.33 ,66.31 
03,001,02,009,0508,1110,758,7,765,1282,0,0,0,0,0,0,0,66.31 ,59.67 ,66.31 
03,001,02,009,0508,1111,836,7,843,1350,0,0,0,0,0,0,0,66.31 ,62.44 ,66.31 
03,001,02,009,0509,1112,640,7,647,1036,0,0,0,0,0,0,0,66.31 ,62.45 ,66.31 
03,001,02,009,0509,1113,612,6,618,882,0,0,0,0,0,0,0,66.31 ,70.07 ,66.31 
03,001,02,009,0510,1114,640,7,647,1062,0,0,0,0,0,0,0,66.31 ,60.92 ,66.31 
03,001,02,009,0510,1115,468,3,471,732,0,0,0,0,0,0,0,66.31 ,64.34 ,66.31 
03,001,02,009,0510,1116,523,4,527,850,0,0,0,0,0,0,0,66.31 ,62.00 ,66.31 
03,001,02,009,0511,1117,604,11,615,953,0,0,0,0,0,0,0,66.31 ,64.53 ,66.31 
03,001,02,009,0511,1118,546,12,558,945,0,0,0,0,0,0,0,66.31 ,59.05 ,66.31 
03,001,02,009,0511,1119,714,13,727,1051,0,0,0,0,0,0,0,66.31 ,69.17 ,66.31 
03,001,02,009,0511,1120,695,11,706,1136,0,0,0,0,0,0,0,66.31 ,62.15 ,66.31 
03,001,02,009,0512,1121,623,12,635,1061,0,0,0,0,0,0,0,66.31 ,59.85 ,66.31 
03,001,02,009,0512,1122,639,5,644,1048,0,0,0,0,0,0,0,66.31 ,61.45 ,66.31 
03,001,02,009,0512,1123,618,14,632,1053,0,0,0,0,0,0,0,66.31 ,60.02 ,66.31 
03,001,02,009,0513,1124,714,7,721,1071,0,0,0,0,0,0,0,66.31 ,67.32 ,66.31 
03,001,02,009,0513,1125,633,7,640,966,0,0,0,0,0,0,0,66.31 ,66.25 ,66.31 
03,001,02,009,0514,1126,441,6,447,718,0,0,0,0,0,0,0,66.31 ,62.26 ,66.31 
03,001,02,010,0515,1127,438,4,442,604,0,0,0,0,0,0,0,66.31 ,73.18 ,66.31 
03,001,02,010,0515,1128,177,2,179,249,0,0,0,0,0,0,0,66.31 ,71.89 ,66.31 
03,001,02,010,0516,1129,491,11,502,778,0,0,0,0,0,0,0,66.31 ,64.52 ,66.31 
03,001,02,010,0516,1130,405,9,414,777,0,0,0,0,0,0,0,66.31 ,53.28 ,66.31 
03,001,02,010,0516,1131,344,5,349,513,0,0,0,0,0,0,0,66.31 ,68.03 ,66.31 
03,001,02,010,0517,1132,690,7,697,1294,0,0,0,0,0,0,0,66.31 ,53.86 ,66.31 
03,001,02,010,0517,1133,687,8,695,1144,0,0,0,0,0,0,0,66.31 ,60.75 ,66.31 
03,001,02,010,0517,1134,487,6,493,860,0,0,0,0,0,0,0,66.31 ,57.33 ,66.31 
03,001,02,010,0517,1135,560,5,565,940,0,0,0,0,0,0,0,66.31 ,60.11 ,66.31 
03,001,02,010,0518,1136,612,9,621,1002,0,0,0,0,0,0,0,66.31 ,61.98 ,66.31 
03,001,02,010,0518,1137,583,9,592,947,0,0,0,0,0,0,0,66.31 ,62.51 ,66.31 
03,001,02,010,0518,1138,596,4,600,905,0,0,0,0,0,0,0,66.31 ,66.30 ,66.31 
03,001,02,010,0518,1139,556,8,564,945,0,0,0,0,0,0,0,66.31 ,59.68 ,66.31 
03,001,02,010,0519,1140,477,5,482,793,0,0,0,0,0,0,0,66.31 ,60.78 ,66.31 
03,001,02,010,0519,1141,466,2,468,789,0,0,0,0,0,0,0,66.31 ,59.32 ,66.31 
03,001,02,010,0519,1142,536,11,547,839,0,0,0,0,0,0,0,66.31 ,65.20 ,66.31 
03,001,02,010,0520,1143,553,6,559,829,0,0,0,0,0,0,0,66.31 ,67.43 ,66.31 
03,001,02,010,0520,1144,599,9,608,965,0,0,0,0,0,0,0,66.31 ,63.01 ,66.31 
03,001,02,010,0520,1145,465,2,467,766,0,0,0,0,0,0,0,66.31 ,60.97 ,66.31 
03,001,02,010,0521,1146,641,10,651,967,0,0,0,0,0,0,0,66.31 ,67.32 ,66.31 
03,001,02,010,0521,1147,539,6,545,888,0,0,0,0,0,0,0,66.31 ,61.37 ,66.31 
03,001,02,010,0522,1148,542,10,552,891,0,0,0,0,0,0,0,66.31 ,61.95 ,66.31 
03,001,02,010,0522,1149,490,5,495,777,0,0,0,0,0,0,0,66.31 ,63.71 ,66.31 
03,001,02,010,0522,1150,661,6,667,1115,0,0,0,0,0,0,0,66.31 ,59.82 ,66.31 
03,001,02,010,0523,1151,612,7,619,1065,0,0,0,0,0,0,0,66.31 ,58.12 ,66.31 
03,001,02,010,0523,1152,708,7,715,1252,0,0,0,0,0,0,0,66.31 ,57.11 ,66.31 
03,001,02,010,0523,1153,623,4,627,1096,0,0,0,0,0,0,0,66.31 ,57.21 ,66.31 
03,001,02,010,0524,1154,477,16,493,903,0,0,0,0,0,0,0,66.31 ,54.60 ,66.31 
03,001,02,010,0524,1155,504,7,511,810,0,0,0,0,0,0,0,66.31 ,63.09 ,66.31 
03,001,02,010,0524,1156,559,6,565,870,0,0,0,0,0,0,0,66.31 ,64.94 ,66.31 
03,001,02,010,0525,1157,550,4,554,859,0,0,0,0,0,0,0,66.31 ,64.49 ,66.31 
03,001,02,010,0525,1158,466,6,472,773,0,0,0,0,0,0,0,66.31 ,61.06 ,66.31 
03,001,02,010,0526,1159,667,11,678,1086,0,0,0,0,0,0,0,66.31 ,62.43 ,66.31 
03,001,02,010,0526,1160,704,10,714,1222,0,0,0,0,0,0,0,66.31 ,58.43 ,66.31 
03,001,02,010,0527,1161,618,7,625,1055,0,0,0,0,0,0,0,66.31 ,59.24 ,66.31 
03,001,02,010,0527,1162,525,11,536,849,0,0,0,0,0,0,0,66.31 ,63.13 ,66.31 
03,001,02,010,0527,1163,461,4,465,710,0,0,0,0,0,0,0,66.31 ,65.49 ,66.31 
03,001,02,010,0528,1164,783,6,789,1195,0,0,0,0,0,0,0,66.31 ,66.03 ,66.31 
03,001,02,010,0528,1165,761,18,779,1310,0,0,0,0,0,0,0,66.31 ,59.47 ,66.31 
03,001,02,010,0529,1166,713,9,722,1125,0,0,0,0,0,0,0,66.31 ,64.18 ,66.31 
03,001,02,010,0529,1167,762,5,767,1256,0,0,0,0,0,0,0,66.31 ,61.07 ,66.31 
03,001,02,010,0529,1168,604,13,617,1109,0,0,0,0,0,0,0,66.31 ,55.64 ,66.31 
03,001,02,011,0530,1169,700,6,706,1067,0,0,0,0,0,0,0,66.31 ,66.17 ,66.31 
03,001,02,011,0530,1170,579,4,583,925,0,0,0,0,0,0,0,66.31 ,63.03 ,66.31 
03,001,02,011,0530,1171,711,12,723,1140,0,0,0,0,0,0,0,66.31 ,63.42 ,66.31 
03,001,02,011,0531,1172,479,13,492,1017,0,0,0,0,0,0,0,66.31 ,48.38 ,66.31 
03,001,02,011,0531,1173,739,10,749,1156,0,0,0,0,0,0,0,66.31 ,64.79 ,66.31 
03,001,02,011,0531,1174,690,4,694,1015,0,0,0,0,0,0,0,66.31 ,68.37 ,66.31 
03,001,02,011,0532,1175,707,13,720,1063,0,0,0,0,0,0,0,66.31 ,67.73 ,66.31 
03,001,02,011,0532,1176,621,7,628,1030,0,0,0,0,0,0,0,66.31 ,60.97 ,66.31 
03,001,02,011,0532,1177,516,8,524,858,0,0,0,0,0,0,0,66.31 ,61.07 ,66.31 
03,001,02,011,0533,1178,869,13,882,1410,0,0,0,0,0,0,0,66.31 ,62.55 ,66.31 
03,001,02,011,0533,1179,907,5,912,1418,0,0,0,0,0,0,0,66.31 ,64.32 ,66.31 
03,001,02,011,0534,1180,848,11,859,1256,0,0,0,0,0,0,0,66.31 ,68.39 ,66.31 
03,001,02,011,0534,1181,734,8,742,1088,0,0,0,0,0,0,0,66.31 ,68.20 ,66.31 
03,001,02,011,0535,1182,793,10,803,998,0,0,0,0,0,0,0,66.31 ,80.46 ,66.31 
03,001,02,011,0536,1183,994,11,1005,1453,0,0,0,0,0,0,0,66.31 ,69.17 ,66.31 
03,001,02,011,0537,1184,647,34,681,967,0,0,0,0,0,0,0,66.31 ,70.42 ,66.31 
03,001,02,011,0537,1185,636,8,644,1367,0,0,0,0,0,0,0,66.31 ,47.11 ,66.31 
03,001,02,011,0537,1186,823,10,833,1610,0,0,0,0,0,0,0,66.31 ,51.74 ,66.31 
03,001,02,011,0537,1187,644,4,648,1245,0,0,0,0,0,0,0,66.31 ,52.05 ,66.31 
03,001,02,011,0538,1188,544,8,552,1021,0,0,0,0,0,0,0,66.31 ,54.06 ,66.31 
03,001,02,011,0538,1189,570,9,579,1011,0,0,0,0,0,0,0,66.31 ,57.27 ,66.31 
03,001,02,011,0538,1190,672,16,688,1096,0,0,0,0,0,0,0,66.31 ,62.77 ,66.31 
03,001,02,011,0538,1191,768,8,776,1274,0,0,0,0,0,0,0,66.31 ,60.91 ,66.31 
03,001,02,011,0538,1192,550,7,557,1032,0,0,0,0,0,0,0,66.31 ,53.97 ,66.31 
03,001,02,011,0539,1193,595,5,600,900,0,0,0,0,0,0,0,66.31 ,66.67 ,66.31 
03,001,02,011,0540,1194,626,11,637,882,0,0,0,0,0,0,0,66.31 ,72.22 ,66.31 
03,001,02,011,0541,1195,488,9,497,618,0,0,0,0,0,0,0,66.31 ,80.42 ,66.31 
03,001,02,011,0542,1196,338,7,345,447,0,0,0,0,0,0,0,66.31 ,77.18 ,66.31 
03,001,02,011,0543,1197,533,6,539,788,0,0,0,0,0,0,0,66.31 ,68.40 ,66.31 
03,001,02,012,0544,1198,434,8,442,573,0,0,0,0,0,0,0,66.31 ,77.14 ,66.31 
03,001,02,012,0545,1199,752,11,763,957,0,0,0,0,0,0,0,66.31 ,79.73 ,66.31 
03,001,02,012,0546,1200,924,13,937,1237,0,0,0,0,0,0,0,66.31 ,75.75 ,66.31 
03,001,02,012,0547,1201,961,12,973,1280,0,0,0,0,0,0,0,66.31 ,76.02 ,66.31 
03,001,02,012,0548,1202,430,1,431,748,0,0,0,0,0,0,0,66.31 ,57.62 ,66.31 
03,001,02,012,0549,1203,695,10,705,1066,0,0,0,0,0,0,0,66.31 ,66.14 ,66.31 
03,001,02,012,0549,1204,654,18,672,1073,0,0,0,0,0,0,0,66.31 ,62.63 ,66.31 
03,001,02,012,0550,1205,631,8,639,785,0,0,0,0,0,0,0,66.31 ,81.40 ,66.31 
03,001,02,012,0551,1206,1064,11,1075,1659,0,0,0,0,0,0,0,66.31 ,64.80 ,66.31 
03,001,02,012,0552,1207,652,10,662,909,0,0,0,0,0,0,0,66.31 ,72.83 ,66.31 
03,001,02,012,0553,1208,468,11,479,706,0,0,0,0,0,0,0,66.31 ,67.85 ,66.31 
03,001,02,012,0554,1209,558,7,565,907,0,0,0,0,0,0,0,66.31 ,62.29 ,66.31 
03,001,02,012,0555,1210,861,10,871,1557,0,0,0,0,0,0,0,66.31 ,55.94 ,66.31 
03,001,02,012,0555,1211,720,11,731,1293,0,0,0,0,0,0,0,66.31 ,56.54 ,66.31 
03,001,02,012,0555,1212,609,5,614,1282,0,0,0,0,0,0,0,66.31 ,47.89 ,66.31 
03,001,02,012,0556,1213,934,19,953,1697,0,0,0,0,0,0,0,66.31 ,56.16 ,66.31 
03,001,02,012,0556,1214,728,18,746,1241,0,0,0,0,0,0,0,66.31 ,60.11 ,66.31 
03,001,02,012,0556,1215,673,9,682,1218,0,0,0,0,0,0,0,66.31 ,55.99 ,66.31 
03,001,02,012,0557,1216,722,13,735,1327,0,0,0,0,0,0,0,66.31 ,55.39 ,66.31 
03,001,02,012,0557,1217,778,16,794,1284,0,0,0,0,0,0,0,66.31 ,61.84 ,66.31 
03,001,02,012,0557,1218,688,12,700,1160,0,0,0,0,0,0,0,66.31 ,60.34 ,66.31 
03,001,02,012,0558,1219,545,8,553,876,0,0,0,0,0,0,0,66.31 ,63.13 ,66.31 
03,001,02,012,0559,1220,586,0,586,1169,0,0,0,0,0,0,0,66.31 ,50.13 ,66.31 
03,001,02,012,0559,1221,521,8,529,936,0,0,0,0,0,0,0,66.31 ,56.52 ,66.31 
03,001,02,012,0560,1222,787,11,798,1136,0,0,0,0,0,0,0,66.31 ,70.25 ,66.31 
03,001,02,012,0561,1223,809,19,828,1067,0,0,0,0,0,0,0,66.31 ,77.60 ,66.31 
03,001,02,012,0562,1224,853,5,858,1325,0,0,0,0,0,0,0,66.31 ,64.75 ,66.31 
03,001,02,012,0562,1225,1107,11,1118,1622,0,0,0,0,0,0,0,66.31 ,68.93 ,66.31 
03,001,02,012,0562,1226,944,18,962,1764,0,0,0,0,0,0,0,66.31 ,54.54 ,66.31 
03,001,02,012,0562,1227,870,13,883,1625,0,0,0,0,0,0,0,66.31 ,54.34 ,66.31 
03,001,02,012,0562,1228,871,11,882,1653,0,0,0,0,0,0,0,66.31 ,53.36 ,66.31 
03,001,02,012,0562,1229,817,7,824,1488,0,0,0,0,0,0,0,66.31 ,55.38 ,66.31 
03,001,02,012,0563,1230,891,24,915,1263,0,0,0,0,0,0,0,66.31 ,72.45 ,66.31 
03,001,02,012,0563,1231,888,15,903,1504,0,0,0,0,0,0,0,66.31 ,60.04 ,66.31 
03,001,02,012,0563,1232,804,13,817,1431,0,0,0,0,0,0,0,66.31 ,57.09 ,66.31 
03,001,02,012,0563,1233,797,9,806,1651,0,0,0,0,0,0,0,66.31 ,48.82 ,66.31 
03,001,02,012,0563,1234,739,16,755,1184,0,0,0,0,0,0,0,66.31 ,63.77 ,66.31 
03,001,02,012,0564,1235,925,18,943,1548,0,0,0,0,0,0,0,66.31 ,60.92 ,66.31 
03,001,02,012,0565,1236,741,12,753,1188,0,0,0,0,0,0,0,66.31 ,63.38 ,66.31 
03,001,02,012,0565,1237,765,8,773,1227,0,0,0,0,0,0,0,66.31 ,63.00 ,66.31 
03,001,02,012,0565,1238,936,13,949,1720,0,0,0,0,0,0,0,66.31 ,55.17 ,66.31 
03,001,02,012,0565,1239,880,16,896,1594,0,0,0,0,0,0,0,66.31 ,56.21 ,66.31 
03,001,02,012,0565,1240,716,11,727,1092,0,0,0,0,0,0,0,66.31 ,66.58 ,66.31 
03,001,02,012,0565,1241,733,15,748,1157,0,0,0,0,0,0,0,66.31 ,64.65 ,66.31 
03,001,02,012,0566,1242,632,6,638,1100,0,0,0,0,0,0,0,66.31 ,58.00 ,66.31 
03,001,02,012,0566,1243,825,16,841,1278,0,0,0,0,0,0,0,66.31 ,65.81 ,66.31 
03,001,02,012,0566,1244,822,26,848,1195,0,0,0,0,0,0,0,66.31 ,70.96 ,66.31 
03,001,02,012,0567,1245,1028,19,1047,1543,0,0,0,0,0,0,0,66.31 ,67.85 ,66.31 
03,001,02,012,0568,1246,678,12,690,988,0,0,0,0,0,0,0,66.31 ,69.84 ,66.31 
03,001,02,012,0569,1247,561,8,569,804,0,0,0,0,0,0,0,66.31 ,70.77 ,66.31 
03,001,02,012,0570,1248,883,17,900,1385,0,0,0,0,0,0,0,66.31 ,64.98 ,66.31 
03,001,02,012,0571,1249,496,13,509,731,0,0,0,0,0,0,0,66.31 ,69.63 ,66.31 
03,001,02,012,0572,1250,479,4,483,748,0,0,0,0,0,0,0,66.31 ,64.57 ,66.31 
03,001,02,012,0573,1251,327,10,337,498,0,0,0,0,0,0,0,66.31 ,67.67 ,66.31 
03,001,02,012,0574,1252,679,9,688,1061,0,0,0,0,0,0,0,66.31 ,64.84 ,66.31 
03,001,02,012,0575,1253,841,4,845,1209,0,0,0,0,0,0,0,66.31 ,69.89 ,66.31 
03,001,02,012,0575,1254,478,15,493,981,0,0,0,0,0,0,0,66.31 ,50.25 ,66.31 
03,001,02,012,0575,1255,651,8,659,1024,0,0,0,0,0,0,0,66.31 ,64.36 ,66.31 
03,001,02,012,0576,1256,616,10,626,1095,0,0,0,0,0,0,0,66.31 ,57.17 ,66.31 
03,001,02,012,0576,1257,974,15,989,1543,0,0,0,0,0,0,0,66.31 ,64.10 ,66.31 
03,001,02,012,0576,1258,743,13,756,1217,0,0,0,0,0,0,0,66.31 ,62.12 ,66.31 
03,001,02,013,0577,1259,932,26,958,1499,0,0,0,0,0,0,0,66.31 ,63.91 ,66.31 
03,001,02,013,0577,1260,698,18,716,1045,0,0,0,0,0,0,0,66.31 ,68.52 ,66.31 
03,001,02,013,0577,1261,553,6,559,917,0,0,0,0,0,0,0,66.31 ,60.96 ,66.31 
03,001,02,013,0578,1262,581,10,591,899,0,0,0,0,0,0,0,66.31 ,65.74 ,66.31 
03,001,02,013,0578,1263,590,13,603,924,0,0,0,0,0,0,0,66.31 ,65.26 ,66.31 
03,001,02,013,0579,1264,828,14,842,1149,0,0,0,0,0,0,0,66.31 ,73.28 ,66.31 
03,001,02,013,0580,1265,546,5,551,908,0,0,0,0,0,0,0,66.31 ,60.68 ,66.31 
03,001,02,013,0580,1266,671,10,681,1062,0,0,0,0,0,0,0,66.31 ,64.12 ,66.31 
03,001,02,013,0581,1267,602,21,623,865,0,0,0,0,0,0,0,66.31 ,72.02 ,66.31 
03,001,02,013,0582,1268,677,15,692,1063,0,0,0,0,0,0,0,66.31 ,65.10 ,66.31 
03,001,02,013,0582,1269,514,10,524,914,0,0,0,0,0,0,0,66.31 ,57.33 ,66.31 
03,001,02,013,0582,1270,700,10,710,1290,0,0,0,0,0,0,0,66.31 ,55.04 ,66.31 
03,001,02,013,0583,1271,715,11,726,1137,0,0,0,0,0,0,0,66.31 ,63.85 ,66.31 
03,001,02,013,0583,1272,655,17,672,940,0,0,0,0,0,0,0,66.31 ,71.49 ,66.31 
03,001,02,013,0584,1273,682,15,697,916,0,0,0,0,0,0,0,66.31 ,76.09 ,66.31 
03,001,02,013,0585,1274,788,14,802,951,0,0,0,0,0,0,0,66.31 ,84.33 ,66.31 
03,001,02,013,0586,1275,765,10,775,1030,0,0,0,0,0,0,0,66.31 ,75.24 ,66.31 
03,001,02,014,0587,1276,219,1,220,335,0,0,0,0,0,0,0,66.31 ,65.67 ,66.31 
03,001,02,014,0588,1277,1015,12,1027,1599,0,0,0,0,0,0,0,66.31 ,64.23 ,66.31 
03,001,02,014,0588,1278,939,15,954,1609,0,0,0,0,0,0,0,66.31 ,59.29 ,66.31 
03,001,02,014,0589,1279,568,8,576,808,0,0,0,0,0,0,0,66.31 ,71.29 ,66.31 
03,001,02,014,0590,1280,490,5,495,794,0,0,0,0,0,0,0,66.31 ,62.34 ,66.31 
03,001,02,014,0591,1281,927,9,936,1643,0,0,0,0,0,0,0,66.31 ,56.97 ,66.31 
03,001,02,014,0591,1282,778,10,788,1196,0,0,0,0,0,0,0,66.31 ,65.89 ,66.31 
03,001,02,014,0591,1283,809,13,822,1282,0,0,0,0,0,0,0,66.31 ,64.12 ,66.31 
03,001,02,014,0592,1284,228,2,230,413,0,0,0,0,0,0,0,66.31 ,55.69 ,66.31 
03,001,02,014,0593,1285,369,5,374,536,0,0,0,0,0,0,0,66.31 ,69.78 ,66.31 
03,001,02,014,0594,1286,469,6,475,779,0,0,0,0,0,0,0,66.31 ,60.98 ,66.31 
03,001,02,014,0595,1287,729,20,749,1248,0,0,0,0,0,0,0,66.31 ,60.02 ,66.31 
03,001,02,014,0596,1288,359,5,364,577,0,0,0,0,0,0,0,66.31 ,63.08 ,66.31 
03,001,02,014,0597,1289,302,5,307,500,0,0,0,0,0,0,0,66.31 ,61.40 ,66.31 
03,001,02,014,0598,1290,423,7,430,641,0,0,0,0,0,0,0,66.31 ,67.08 ,66.31 
03,001,02,014,0599,1291,683,3,686,1117,0,0,0,0,0,0,0,66.31 ,61.41 ,66.31 
03,001,02,015,0600,1292,515,3,518,752,0,0,0,0,0,0,0,66.31 ,68.88 ,66.31 
03,001,02,015,0601,1293,648,6,654,1002,0,0,0,0,0,0,0,66.31 ,65.27 ,66.31 
03,001,02,015,0602,1294,991,34,1025,1534,0,0,0,0,0,0,0,66.31 ,66.82 ,66.31 
03,001,02,015,0603,1295,431,5,436,638,0,0,0,0,0,0,0,66.31 ,68.34 ,66.31 
03,001,02,015,0604,1296,727,7,734,1046,0,0,0,0,0,0,0,66.31 ,70.17 ,66.31 
03,001,02,015,0605,1297,735,10,745,1091,0,0,0,0,0,0,0,66.31 ,68.29 ,66.31 
03,001,02,015,0606,1298,151,2,153,268,0,0,0,0,0,0,0,66.31 ,57.09 ,66.31 
03,001,02,015,0607,1299,351,6,357,511,0,0,0,0,0,0,0,66.31 ,69.86 ,66.31 
03,001,02,015,0608,1300,449,7,456,652,0,0,0,0,0,0,0,66.31 ,69.94 ,66.31 
03,001,02,016,0609,1301,269,4,273,437,0,0,0,0,0,0,0,66.31 ,62.47 ,66.31 
03,001,02,016,0610,1302,424,5,429,645,0,0,0,0,0,0,0,66.31 ,66.51 ,66.31 
03,001,02,016,0611,1303,293,2,295,445,0,0,0,0,0,0,0,66.31 ,66.29 ,66.31 
03,001,02,016,0612,1304,859,9,868,1409,0,0,0,0,0,0,0,66.31 ,61.60 ,66.31 
03,001,02,016,0613,1305,792,4,796,1200,0,0,0,0,0,0,0,66.31 ,66.33 ,66.31 
03,001,02,016,0613,1306,1070,13,1083,1751,0,0,0,0,0,0,0,66.31 ,61.85 ,66.31 
03,001,02,016,0613,1307,905,9,914,1479,0,0,0,0,0,0,0,66.31 ,61.80 ,66.31 
03,001,02,016,0613,1308,863,7,870,1399,0,0,0,0,0,0,0,66.31 ,62.19 ,66.31 
03,001,02,016,0614,1309,415,4,419,625,0,0,0,0,0,0,0,66.31 ,67.04 ,66.31 
03,001,02,016,0614,1310,459,8,467,752,0,0,0,0,0,0,0,66.31 ,62.10 ,66.31 
03,001,02,016,0615,1311,469,3,472,823,0,0,0,0,0,0,0,66.31 ,57.35 ,66.31 
03,001,02,016,0616,1312,242,3,245,368,0,0,0,0,0,0,0,66.31 ,66.58 ,66.31 
03,001,02,016,0617,1313,336,2,338,515,0,0,0,0,0,0,0,66.31 ,65.63 ,66.31 
03,001,02,016,0618,1314,343,4,347,545,0,0,0,0,0,0,0,66.31 ,63.67 ,66.31 
03,001,02,016,0619,1315,469,9,478,765,0,0,0,0,0,0,0,66.31 ,62.48 ,66.31 
03,001,02,016,0620,1316,147,0,147,239,0,0,0,0,0,0,0,66.31 ,61.51 ,66.31 
03,001,02,016,0621,1317,273,7,280,429,0,0,0,0,0,0,0,66.31 ,65.27 ,66.31 
03,001,02,016,0622,1318,317,1,318,552,0,0,0,0,0,0,0,66.31 ,57.61 ,66.31 
03,001,02,017,0623,1319,982,16,998,1503,0,0,0,0,0,0,0,66.31 ,66.40 ,66.31 
03,001,02,017,0623,1320,887,7,894,1405,0,0,0,0,0,0,0,66.31 ,63.63 ,66.31 
03,001,02,017,0624,1321,438,3,441,723,0,0,0,0,0,0,0,66.31 ,61.00 ,66.31 
03,001,02,017,0624,1322,643,18,661,1188,0,0,0,0,0,0,0,66.31 ,55.64 ,66.31 
03,001,02,017,0625,1323,331,8,339,576,0,0,0,0,0,0,0,66.31 ,58.85 ,66.31 
03,001,02,017,0625,1324,643,3,646,961,0,0,0,0,0,0,0,66.31 ,67.22 ,66.31 
03,001,02,017,0626,1325,651,9,660,1106,0,0,0,0,0,0,0,66.31 ,59.67 ,66.31 
03,001,02,017,0626,1326,610,8,618,1024,0,0,0,0,0,0,0,66.31 ,60.35 ,66.31 
03,001,02,017,0627,1327,405,5,410,651,0,0,0,0,0,0,0,66.31 ,62.98 ,66.31 
03,001,02,017,0627,1328,902,15,917,1400,0,0,0,0,0,0,0,66.31 ,65.50 ,66.31 
03,001,02,017,0628,1329,309,4,313,455,0,0,0,0,0,0,0,66.31 ,68.79 ,66.31 
03,001,02,017,0629,1330,446,5,451,758,0,0,0,0,0,0,0,66.31 ,59.50 ,66.31 
03,001,02,017,0630,1331,314,3,317,538,0,0,0,0,0,0,0,66.31 ,58.92 ,66.31 
03,001,02,017,0631,1332,308,3,311,564,0,0,0,0,0,0,0,66.31 ,55.14 ,66.31 
03,001,02,017,0632,1333,464,17,481,767,0,0,0,0,0,0,0,66.31 ,62.71 ,66.31 
03,001,03,018,0633,1334,701,9,710,1351,0,0,0,0,0,0,0,66.31 ,52.55 ,66.31 
03,001,03,018,0633,1335,370,5,375,660,0,0,0,0,0,0,0,66.31 ,56.82 ,66.31 
03,001,03,018,0633,1336,290,4,294,534,0,0,0,0,0,0,0,66.31 ,55.06 ,66.31 
03,001,03,018,0634,1337,370,3,373,634,0,0,0,0,0,0,0,66.31 ,58.83 ,66.31 
03,001,03,018,0634,1338,409,3,412,648,0,0,0,0,0,0,0,66.31 ,63.58 ,66.31 
03,001,03,018,0635,1339,786,11,797,1384,0,0,0,0,0,0,0,66.31 ,57.59 ,66.31 
03,001,03,018,0635,1340,914,8,922,1412,0,0,0,0,0,0,0,66.31 ,65.30 ,66.31 
03,001,03,018,0635,1341,867,13,880,1559,0,0,0,0,0,0,0,66.31 ,56.45 ,66.31 
03,001,03,018,0636,1342,886,10,896,1496,0,0,0,0,0,0,0,66.31 ,59.89 ,66.31 
03,001,03,018,0636,1343,898,15,913,1567,0,0,0,0,0,0,0,66.31 ,58.26 ,66.31 
03,001,03,018,0637,1344,521,8,529,925,0,0,0,0,0,0,0,66.31 ,57.19 ,66.31 
03,001,03,018,0637,1345,518,4,522,958,0,0,0,0,0,0,0,66.31 ,54.49 ,66.31 
03,001,03,018,0638,1346,986,16,1002,1679,0,0,0,0,0,0,0,66.31 ,59.68 ,66.31 
03,001,03,018,0638,1347,869,14,883,1472,0,0,0,0,0,0,0,66.31 ,59.99 ,66.31 
03,001,03,018,0639,1348,842,14,856,1391,0,0,0,0,0,0,0,66.31 ,61.54 ,66.31 
03,001,03,018,0639,1349,789,4,793,1305,0,0,0,0,0,0,0,66.31 ,60.77 ,66.31 
03,001,03,018,0640,1350,769,12,781,1219,0,0,0,0,0,0,0,66.31 ,64.07 ,66.31 
03,001,03,018,0640,1351,859,12,871,1399,0,0,0,0,0,0,0,66.31 ,62.26 ,66.31 
03,001,03,018,0641,1352,728,13,741,1191,0,0,0,0,0,0,0,66.31 ,62.22 ,66.31 
03,001,03,018,0641,1353,672,7,679,1182,0,0,0,0,0,0,0,66.31 ,57.45 ,66.31 
03,001,03,018,0641,1354,727,5,732,1209,0,0,0,0,0,0,0,66.31 ,60.55 ,66.31 
03,001,03,018,0642,1355,855,16,871,1621,0,0,0,0,0,0,0,66.31 ,53.73 ,66.31 
03,001,03,018,0642,1356,1017,21,1038,1712,0,0,0,0,0,0,0,66.31 ,60.63 ,66.31 
03,001,03,018,0643,1357,458,6,464,693,0,0,0,0,0,0,0,66.31 ,66.96 ,66.31 
03,001,03,018,0643,1358,603,3,606,987,0,0,0,0,0,0,0,66.31 ,61.40 ,66.31 
03,001,03,018,0643,1359,757,9,766,1232,0,0,0,0,0,0,0,66.31 ,62.18 ,66.31 
03,001,03,018,0644,1360,1038,8,1046,1555,0,0,0,0,0,0,0,66.31 ,67.27 ,66.31 
03,001,03,018,0644,1361,612,8,620,1069,0,0,0,0,0,0,0,66.31 ,58.00 ,66.31 
03,001,03,018,0644,1362,679,10,689,1129,0,0,0,0,0,0,0,66.31 ,61.03 ,66.31 
03,001,03,018,0645,1363,931,17,948,1615,0,0,0,0,0,0,0,66.31 ,58.70 ,66.31 
03,001,03,018,0645,1364,996,15,1011,1640,0,0,0,0,0,0,0,66.31 ,61.65 ,66.31 
03,001,03,018,0646,1365,518,7,525,950,0,0,0,0,0,0,0,66.31 ,55.26 ,66.31 
03,001,03,018,0646,1366,792,5,797,1363,0,0,0,0,0,0,0,66.31 ,58.47 ,66.31 
03,001,03,018,0646,1367,766,9,775,1387,0,0,0,0,0,0,0,66.31 ,55.88 ,66.31 
03,001,03,018,0647,1368,770,8,778,1388,0,0,0,0,0,0,0,66.31 ,56.05 ,66.31 
03,001,03,018,0647,1369,974,10,984,1607,0,0,0,0,0,0,0,66.31 ,61.23 ,66.31 
03,001,03,018,0648,1370,864,14,878,1586,0,0,0,0,0,0,0,66.31 ,55.36 ,66.31 
03,001,03,018,0648,1371,771,18,789,1242,0,0,0,0,0,0,0,66.31 ,63.53 ,66.31 
03,001,03,018,0648,1372,585,3,588,986,0,0,0,0,0,0,0,66.31 ,59.63 ,66.31 
03,001,03,018,0649,1373,788,9,797,1413,0,0,0,0,0,0,0,66.31 ,56.40 ,66.31 
03,001,03,018,0649,1374,539,7,546,962,0,0,0,0,0,0,0,66.31 ,56.76 ,66.31 
03,001,03,018,0649,1375,1015,18,1033,1765,0,0,0,0,0,0,0,66.31 ,58.53 ,66.31 
03,001,03,018,0650,1376,1015,11,1026,1732,0,0,0,0,0,0,0,66.31 ,59.24 ,66.31 
03,001,03,018,0650,1377,773,10,783,1316,0,0,0,0,0,0,0,66.31 ,59.50 ,66.31 
03,001,03,018,0651,1378,943,13,956,1749,0,0,0,0,0,0,0,66.31 ,54.66 ,66.31 
03,001,03,018,0651,1379,1017,18,1035,1849,0,0,0,0,0,0,0,66.31 ,55.98 ,66.31 
03,001,03,018,0652,1380,772,23,795,1420,0,0,0,0,0,0,0,66.31 ,55.99 ,66.31 
03,001,03,018,0652,1381,1074,21,1095,1835,0,0,0,0,0,0,0,66.31 ,59.67 ,66.31 
03,001,03,018,0653,1382,736,13,749,1256,0,0,0,0,0,0,0,66.31 ,59.63 ,66.31 
03,001,03,018,0653,1383,727,15,742,1152,0,0,0,0,0,0,0,66.31 ,64.41 ,66.31 
03,001,03,018,0653,1384,522,11,533,886,0,0,0,0,0,0,0,66.31 ,60.16 ,66.31 
03,001,03,018,0654,1385,835,10,845,1359,0,0,0,0,0,0,0,66.31 ,62.18 ,66.31 
03,001,03,018,0654,1386,983,9,992,1610,0,0,0,0,0,0,0,66.31 ,61.61 ,66.31 
03,001,03,018,0655,1387,598,6,604,940,0,0,0,0,0,0,0,66.31 ,64.26 ,66.31 
03,001,03,018,0655,1388,485,9,494,843,0,0,0,0,0,0,0,66.31 ,58.60 ,66.31 
03,001,03,018,0656,1389,1136,3,1139,1662,0,0,0,0,0,0,0,66.31 ,68.53 ,66.31 
03,001,03,018,0656,1390,889,29,918,1641,0,0,0,0,0,0,0,66.31 ,55.94 ,66.31 
03,001,03,018,0657,1391,544,13,557,1018,0,0,0,0,0,0,0,66.31 ,54.72 ,66.31 
03,001,03,018,0657,1392,696,11,707,1250,0,0,0,0,0,0,0,66.31 ,56.56 ,66.31 
03,001,03,018,0658,1393,1023,13,1036,1625,0,0,0,0,0,0,0,66.31 ,63.75 ,66.31 
03,001,03,018,0659,1394,843,9,852,1347,0,0,0,0,0,0,0,66.31 ,63.25 ,66.31 
03,001,03,018,0659,1395,733,13,746,1210,0,0,0,0,0,0,0,66.31 ,61.65 ,66.31 
03,001,03,018,0660,1396,806,9,815,1297,0,0,0,0,0,0,0,66.31 ,62.84 ,66.31 
03,001,03,018,0660,1397,607,11,618,1019,0,0,0,0,0,0,0,66.31 ,60.65 ,66.31 
03,001,03,018,0661,1398,785,10,795,1292,0,0,0,0,0,0,0,66.31 ,61.53 ,66.31 
03,001,03,018,0661,1399,1148,12,1160,1935,0,0,0,0,0,0,0,66.31 ,59.95 ,66.31 
03,001,03,018,0662,1400,711,5,716,1111,0,0,0,0,0,0,0,66.31 ,64.45 ,66.31 
03,001,03,018,0662,1401,770,12,782,1176,0,0,0,0,0,0,0,66.31 ,66.50 ,66.31 
03,001,03,018,0662,1402,941,9,950,1496,0,0,0,0,0,0,0,66.31 ,63.50 ,66.31 
03,001,03,018,0663,1403,934,10,944,1504,0,0,0,0,0,0,0,66.31 ,62.77 ,66.31 
03,001,03,018,0663,1404,976,11,987,1501,0,0,0,0,0,0,0,66.31 ,65.76 ,66.31 
03,001,03,018,0664,1405,657,12,669,1019,0,0,0,0,0,0,0,66.31 ,65.65 ,66.31 
03,001,03,018,0664,1406,560,8,568,925,0,0,0,0,0,0,0,66.31 ,61.41 ,66.31 
03,001,03,018,0664,1407,722,10,732,1225,0,0,0,0,0,0,0,66.31 ,59.76 ,66.31 
03,001,03,018,0665,1408,936,18,954,1571,0,0,0,0,0,0,0,66.31 ,60.73 ,66.31 
03,001,03,018,0665,1409,1029,18,1047,1780,0,0,0,0,0,0,0,66.31 ,58.82 ,66.31 
03,001,03,018,0666,1410,750,10,760,1278,0,0,0,0,0,0,0,66.31 ,59.47 ,66.31 
03,001,03,018,0666,1411,855,14,869,1470,0,0,0,0,0,0,0,66.31 ,59.12 ,66.31 
03,001,03,018,0667,1412,707,12,719,1225,0,0,0,0,0,0,0,66.31 ,58.69 ,66.31 
03,001,03,018,0667,1413,609,17,626,989,0,0,0,0,0,0,0,66.31 ,63.30 ,66.31 
03,001,03,018,0668,1414,966,14,980,1596,0,0,0,0,0,0,0,66.31 ,61.40 ,66.31 
03,001,03,018,0668,1415,732,7,739,1141,0,0,0,0,0,0,0,66.31 ,64.77 ,66.31 
03,001,03,018,0668,1416,654,3,657,1025,0,0,0,0,0,0,0,66.31 ,64.10 ,66.31 
03,001,03,018,0669,1417,943,8,951,1601,0,0,0,0,0,0,0,66.31 ,59.40 ,66.31 
03,001,03,018,0669,1418,1156,19,1175,1968,0,0,0,0,0,0,0,66.31 ,59.71 ,66.31 
03,001,03,018,0669,1419,560,9,569,944,0,0,0,0,0,0,0,66.31 ,60.28 ,66.31 
03,001,03,018,0670,1420,917,10,927,1465,0,0,0,0,0,0,0,66.31 ,63.28 ,66.31 
03,001,03,018,0670,1421,825,9,834,1375,0,0,0,0,0,0,0,66.31 ,60.65 ,66.31 
03,001,03,018,0671,1422,811,5,816,1304,0,0,0,0,0,0,0,66.31 ,62.58 ,66.31 
03,001,03,018,0671,1423,747,9,756,1368,0,0,0,0,0,0,0,66.31 ,55.26 ,66.31 
03,001,03,018,0672,1424,522,6,528,877,0,0,0,0,0,0,0,66.31 ,60.21 ,66.31 
03,001,03,018,0672,1425,749,24,773,1200,0,0,0,0,0,0,0,66.31 ,64.42 ,66.31 
03,001,03,018,0673,1426,607,9,616,1066,0,0,0,0,0,0,0,66.31 ,57.79 ,66.31 
03,001,03,018,0673,1427,692,9,701,1114,0,0,0,0,0,0,0,66.31 ,62.93 ,66.31 
03,001,03,018,0673,1428,696,12,708,1180,0,0,0,0,0,0,0,66.31 ,60.00 ,66.31 
03,001,03,018,0674,1429,708,15,723,1150,0,0,0,0,0,0,0,66.31 ,62.87 ,66.31 
03,001,03,018,0674,1430,680,8,688,1155,0,0,0,0,0,0,0,66.31 ,59.57 ,66.31 
03,001,03,018,0675,1431,625,11,636,1107,0,0,0,0,0,0,0,66.31 ,57.45 ,66.31 
03,001,03,018,0675,1432,519,8,527,912,0,0,0,0,0,0,0,66.31 ,57.79 ,66.31 
03,001,03,018,0675,1433,630,17,647,1136,0,0,0,0,0,0,0,66.31 ,56.95 ,66.31 
03,001,03,018,0676,1434,717,12,729,1168,0,0,0,0,0,0,0,66.31 ,62.41 ,66.31 
03,001,03,018,0676,1435,757,10,767,1265,0,0,0,0,0,0,0,66.31 ,60.63 ,66.31 
03,001,03,018,0677,1436,657,10,667,1265,0,0,0,0,0,0,0,66.31 ,52.73 ,66.31 
03,001,03,018,0677,1437,653,8,661,1214,0,0,0,0,0,0,0,66.31 ,54.45 ,66.31 
03,001,03,018,0677,1438,800,12,812,1530,0,0,0,0,0,0,0,66.31 ,53.07 ,66.31 
03,001,03,018,0678,1439,736,4,740,1144,0,0,0,0,0,0,0,66.31 ,64.69 ,66.31 
03,001,03,018,0678,1440,850,14,864,1441,0,0,0,0,0,0,0,66.31 ,59.96 ,66.31 
03,001,03,018,0678,1441,975,21,996,1538,0,0,0,0,0,0,0,66.31 ,64.76 ,66.31 
03,001,03,018,0679,1442,930,11,941,1604,0,0,0,0,0,0,0,66.31 ,58.67 ,66.31 
03,001,03,018,0679,1443,719,14,733,1292,0,0,0,0,0,0,0,66.31 ,56.73 ,66.31 
03,001,03,018,0680,1444,484,4,488,865,0,0,0,0,0,0,0,66.31 ,56.42 ,66.31 
03,001,03,018,0680,1445,512,11,523,905,0,0,0,0,0,0,0,66.31 ,57.79 ,66.31 
03,001,03,018,0680,1446,551,10,561,978,0,0,0,0,0,0,0,66.31 ,57.36 ,66.31 
03,001,03,018,0680,1447,659,13,672,1268,0,0,0,0,0,0,0,66.31 ,53.00 ,66.31 
03,001,03,018,0681,1448,659,16,675,1139,0,0,0,0,0,0,0,66.31 ,59.26 ,66.31 
03,001,03,018,0681,1449,1055,11,1066,1634,0,0,0,0,0,0,0,66.31 ,65.24 ,66.31 
03,001,03,018,0682,1450,828,15,843,1410,0,0,0,0,0,0,0,66.31 ,59.79 ,66.31 
03,001,03,018,0682,1451,907,16,923,1515,0,0,0,0,0,0,0,66.31 ,60.92 ,66.31 
03,001,03,018,0683,1452,722,10,732,1162,0,0,0,0,0,0,0,66.31 ,62.99 ,66.31 
03,001,03,018,0683,1453,926,12,938,1596,0,0,0,0,0,0,0,66.31 ,58.77 ,66.31 
03,001,03,018,0684,1454,552,9,561,914,0,0,0,0,0,0,0,66.31 ,61.38 ,66.31 
03,001,03,018,0684,1455,571,7,578,952,0,0,0,0,0,0,0,66.31 ,60.71 ,66.31 
03,001,03,018,0685,1456,200,3,203,305,0,0,0,0,0,0,0,66.31 ,66.56 ,66.31 
03,001,03,018,0686,1457,788,15,803,1336,0,0,0,0,0,0,0,66.31 ,60.10 ,66.31 
03,001,03,018,0686,1458,781,12,793,1308,0,0,0,0,0,0,0,66.31 ,60.63 ,66.31 
03,001,03,018,0686,1459,853,8,861,1401,0,0,0,0,0,0,0,66.31 ,61.46 ,66.31 
03,001,03,018,0687,1460,846,12,858,1371,0,0,0,0,0,0,0,66.31 ,62.58 ,66.31 
03,001,03,018,0687,1461,508,10,518,879,0,0,0,0,0,0,0,66.31 ,58.93 ,66.31 
03,001,03,018,0688,1462,953,18,971,1682,0,0,0,0,0,0,0,66.31 ,57.73 ,66.31 
03,001,03,018,0688,1463,859,28,887,1464,0,0,0,0,0,0,0,66.31 ,60.59 ,66.31 
03,001,03,018,0689,1464,900,15,915,1556,0,0,0,0,0,0,0,66.31 ,58.80 ,66.31 
03,001,03,018,0689,1465,889,8,897,1511,0,0,0,0,0,0,0,66.31 ,59.36 ,66.31 
03,001,03,018,0690,1466,1019,15,1034,1776,0,0,0,0,0,0,0,66.31 ,58.22 ,66.31 
03,001,03,018,0690,1467,946,18,964,1612,0,0,0,0,0,0,0,66.31 ,59.80 ,66.31 
03,001,03,018,0691,1468,501,7,508,911,0,0,0,0,0,0,0,66.31 ,55.76 ,66.31 
03,001,03,018,0691,1469,567,10,577,981,0,0,0,0,0,0,0,66.31 ,58.82 ,66.31 
03,001,03,018,0692,1470,977,9,986,1570,0,0,0,0,0,0,0,66.31 ,62.80 ,66.31 
03,001,03,018,0692,1471,747,9,756,1309,0,0,0,0,0,0,0,66.31 ,57.75 ,66.31 
03,001,03,018,0692,1472,929,11,940,1533,0,0,0,0,0,0,0,66.31 ,61.32 ,66.31 
03,001,03,018,0693,1473,691,11,702,1089,0,0,0,0,0,0,0,66.31 ,64.46 ,66.31 
03,001,03,018,0693,1474,934,15,949,1647,0,0,0,0,0,0,0,66.31 ,57.62 ,66.31 
03,001,03,018,0694,1475,948,11,959,1682,0,0,0,0,0,0,0,66.31 ,57.02 ,66.31 
03,001,03,018,0694,1476,1036,11,1047,1808,0,0,0,0,0,0,0,66.31 ,57.91 ,66.31 
03,001,03,018,0695,1477,985,9,994,1563,0,0,0,0,0,0,0,66.31 ,63.60 ,66.31 
03,001,03,018,0695,1478,806,6,812,1343,0,0,0,0,0,0,0,66.31 ,60.46 ,66.31 
03,001,03,018,0696,1479,845,13,858,1572,0,0,0,0,0,0,0,66.31 ,54.58 ,66.31 
03,001,03,018,0696,1480,699,7,706,1132,0,0,0,0,0,0,0,66.31 ,62.37 ,66.31 
03,001,03,018,0696,1481,750,16,766,1388,0,0,0,0,0,0,0,66.31 ,55.19 ,66.31 
03,001,03,018,0697,1482,387,5,392,600,0,0,0,0,0,0,0,66.31 ,65.33 ,66.31 
03,001,03,018,0697,1483,796,11,807,1271,0,0,0,0,0,0,0,66.31 ,63.49 ,66.31 
03,001,03,018,0697,1484,781,10,791,1261,0,0,0,0,0,0,0,66.31 ,62.73 ,66.31 
03,001,03,018,0697,1485,477,7,484,781,0,0,0,0,0,0,0,66.31 ,61.97 ,66.31 
03,001,03,018,0698,1486,749,12,761,1225,0,0,0,0,0,0,0,66.31 ,62.12 ,66.31 
03,001,03,018,0698,1487,706,11,717,1181,0,0,0,0,0,0,0,66.31 ,60.71 ,66.31 
03,001,03,018,0699,1488,700,10,710,1174,0,0,0,0,0,0,0,66.31 ,60.48 ,66.31 
03,001,03,018,0699,1489,584,5,589,985,0,0,0,0,0,0,0,66.31 ,59.80 ,66.31 
03,001,03,018,0700,1490,888,13,901,1553,0,0,0,0,0,0,0,66.31 ,58.02 ,66.31 
03,001,03,018,0700,1491,663,4,667,1090,0,0,0,0,0,0,0,66.31 ,61.19 ,66.31 
03,001,03,018,0701,1492,842,8,850,1407,0,0,0,0,0,0,0,66.31 ,60.41 ,66.31 
03,001,03,018,0702,1493,767,10,777,1338,0,0,0,0,0,0,0,66.31 ,58.07 ,66.31 
03,001,03,018,0702,1494,745,12,757,1296,0,0,0,0,0,0,0,66.31 ,58.41 ,66.31 
03,001,03,018,0703,1495,300,1,301,483,0,0,0,0,0,0,0,66.31 ,62.32 ,66.31 
03,001,03,018,0704,1496,975,11,986,1731,0,0,0,0,0,0,0,66.31 ,56.96 ,66.31 
03,001,03,018,0704,1497,338,3,341,539,0,0,0,0,0,0,0,66.31 ,63.27 ,66.31 
03,001,03,018,0704,1498,927,9,936,1565,0,0,0,0,0,0,0,66.31 ,59.81 ,66.31 
03,001,03,018,0705,1499,675,7,682,1005,0,0,0,0,0,0,0,66.31 ,67.86 ,66.31 
03,001,03,018,0705,1500,693,9,702,1021,0,0,0,0,0,0,0,66.31 ,68.76 ,66.31 
03,001,03,018,0706,1501,858,11,869,1397,0,0,0,0,0,0,0,66.31 ,62.20 ,66.31 
03,001,03,018,0706,1502,678,11,689,1155,0,0,0,0,0,0,0,66.31 ,59.65 ,66.31 
03,001,03,018,0707,1503,749,8,757,1225,0,0,0,0,0,0,0,66.31 ,61.80 ,66.31 
03,001,03,018,0707,1504,1056,16,1072,1984,0,0,0,0,0,0,0,66.31 ,54.03 ,66.31 
03,001,03,018,0708,1505,238,4,242,514,0,0,0,0,0,0,0,66.31 ,47.08 ,66.31 
03,001,03,018,0708,1506,681,20,701,1307,0,0,0,0,0,0,0,66.31 ,53.63 ,66.31 
03,001,03,018,0709,1507,730,11,741,1177,0,0,0,0,0,0,0,66.31 ,62.96 ,66.31 
03,001,03,018,0709,1508,527,6,533,972,0,0,0,0,0,0,0,66.31 ,54.84 ,66.31 
03,001,03,018,0710,1509,691,9,700,1345,0,0,0,0,0,0,0,66.31 ,52.04 ,66.31 
03,001,03,018,0710,1510,758,9,767,1526,0,0,0,0,0,0,0,66.31 ,50.26 ,66.31 
03,001,03,018,0711,1511,648,8,656,1221,0,0,0,0,0,0,0,66.31 ,53.73 ,66.31 
03,001,03,018,0711,1512,795,11,806,1478,0,0,0,0,0,0,0,66.31 ,54.53 ,66.31 
03,001,03,018,0711,1513,896,11,907,1567,0,0,0,0,0,0,0,66.31 ,57.88 ,66.31 
03,001,03,018,0712,1514,769,10,779,1425,0,0,0,0,0,0,0,66.31 ,54.67 ,66.31 
03,001,03,018,0712,1515,779,17,796,1413,0,0,0,0,0,0,0,66.31 ,56.33 ,66.31 
03,001,03,018,0713,1516,753,12,765,1263,0,0,0,0,0,0,0,66.31 ,60.57 ,66.31 
03,001,03,018,0713,1517,630,7,637,1141,0,0,0,0,0,0,0,66.31 ,55.83 ,66.31 
03,001,03,018,0713,1518,635,9,644,1136,0,0,0,0,0,0,0,66.31 ,56.69 ,66.31 
03,001,03,018,0714,1519,804,11,815,1403,0,0,0,0,0,0,0,66.31 ,58.09 ,66.31 
03,001,03,018,0714,1520,767,9,776,1411,0,0,0,0,0,0,0,66.31 ,55.00 ,66.31 
03,001,03,018,0715,1521,558,6,564,935,0,0,0,0,0,0,0,66.31 ,60.32 ,66.31 
03,001,03,018,0715,1522,534,4,538,862,0,0,0,0,0,0,0,66.31 ,62.41 ,66.31 
03,001,03,018,0716,1523,893,7,900,1499,0,0,0,0,0,0,0,66.31 ,60.04 ,66.31 
03,001,03,018,0716,1524,729,6,735,1213,0,0,0,0,0,0,0,66.31 ,60.59 ,66.31 
03,001,03,018,0717,1525,868,11,879,1478,0,0,0,0,0,0,0,66.31 ,59.47 ,66.31 
03,001,03,018,0717,1526,860,14,874,1555,0,0,0,0,0,0,0,66.31 ,56.21 ,66.31 
03,001,03,018,0718,1527,731,19,750,1263,0,0,0,0,0,0,0,66.31 ,59.38 ,66.31 
03,001,03,018,0718,1528,683,21,704,1225,0,0,0,0,0,0,0,66.31 ,57.47 ,66.31 
03,001,03,018,0719,1529,577,9,586,1057,0,0,0,0,0,0,0,66.31 ,55.44 ,66.31 
03,001,03,018,0719,1530,640,8,648,1069,0,0,0,0,0,0,0,66.31 ,60.62 ,66.31 
03,001,03,018,0719,1531,706,13,719,1342,0,0,0,0,0,0,0,66.31 ,53.58 ,66.31 
03,001,03,018,0720,1532,791,9,800,1337,0,0,0,0,0,0,0,66.31 ,59.84 ,66.31 
03,001,03,018,0720,1533,651,11,662,1161,0,0,0,0,0,0,0,66.31 ,57.02 ,66.31 
03,001,03,018,0720,1534,765,13,778,1249,0,0,0,0,0,0,0,66.31 ,62.29 ,66.31 
03,001,03,018,0721,1535,788,13,801,1311,0,0,0,0,0,0,0,66.31 ,61.10 ,66.31 
03,001,03,018,0721,1536,856,10,866,1486,0,0,0,0,0,0,0,66.31 ,58.28 ,66.31 
03,001,03,018,0722,1537,603,3,606,1082,0,0,0,0,0,0,0,66.31 ,56.01 ,66.31 
03,001,03,018,0722,1538,1018,7,1025,1797,0,0,0,0,0,0,0,66.31 ,57.04 ,66.31 
03,001,03,018,0723,1539,547,11,558,965,0,0,0,0,0,0,0,66.31 ,57.82 ,66.31 
03,001,03,018,0723,1540,708,8,716,1404,0,0,0,0,0,0,0,66.31 ,51.00 ,66.31 
03,001,03,018,0724,1541,1007,11,1018,1638,0,0,0,0,0,0,0,66.31 ,62.15 ,66.31 
03,001,03,018,0725,1542,912,12,924,1670,0,0,0,0,0,0,0,66.31 ,55.33 ,66.31 
03,001,03,018,0725,1543,843,8,851,1419,0,0,0,0,0,0,0,66.31 ,59.97 ,66.31 
03,001,03,019,0726,1544,912,19,931,1546,0,0,0,0,0,0,0,66.31 ,60.22 ,66.31 
03,001,03,019,0727,1545,554,11,565,1045,0,0,0,0,0,0,0,66.31 ,54.07 ,66.31 
03,001,03,019,0728,1546,494,7,501,893,0,0,0,0,0,0,0,66.31 ,56.10 ,66.31 
03,001,03,019,0728,1547,623,7,630,1117,0,0,0,0,0,0,0,66.31 ,56.40 ,66.31 
03,001,03,019,0729,1548,937,13,950,1706,0,0,0,0,0,0,0,66.31 ,55.69 ,66.31 
03,001,03,019,0729,1549,923,15,938,1667,0,0,0,0,0,0,0,66.31 ,56.27 ,66.31 
03,001,03,019,0730,1550,1004,11,1015,1652,0,0,0,0,0,0,0,66.31 ,61.44 ,66.31 
03,001,03,019,0730,1551,700,9,709,1360,0,0,0,0,0,0,0,66.31 ,52.13 ,66.31 
03,001,03,019,0731,1552,912,10,922,1608,0,0,0,0,0,0,0,66.31 ,57.34 ,66.31 
03,001,03,019,0731,1553,950,7,957,1619,0,0,0,0,0,0,0,66.31 ,59.11 ,66.31 
03,001,03,019,0732,1554,929,5,934,1604,0,0,0,0,0,0,0,66.31 ,58.23 ,66.31 
03,001,03,019,0732,1555,897,7,904,1560,0,0,0,0,0,0,0,66.31 ,57.95 ,66.31 
03,001,03,019,0733,1556,689,12,701,1226,0,0,0,0,0,0,0,66.31 ,57.18 ,66.31 
03,001,03,019,0734,1557,656,6,662,1208,0,0,0,0,0,0,0,66.31 ,54.80 ,66.31 
03,001,03,019,0734,1558,821,6,827,1485,0,0,0,0,0,0,0,66.31 ,55.69 ,66.31 
03,001,03,019,0735,1559,874,15,889,1568,0,0,0,0,0,0,0,66.31 ,56.70 ,66.31 
03,001,03,019,0735,1560,823,5,828,1561,0,0,0,0,0,0,0,66.31 ,53.04 ,66.31 
03,001,03,019,0736,1561,620,7,627,1121,0,0,0,0,0,0,0,66.31 ,55.93 ,66.31 
03,001,03,019,0736,1562,518,6,524,927,0,0,0,0,0,0,0,66.31 ,56.53 ,66.31 
03,001,03,019,0737,1563,851,7,858,1483,0,0,0,0,0,0,0,66.31 ,57.86 ,66.31 
03,001,03,019,0737,1564,807,5,812,1435,0,0,0,0,0,0,0,66.31 ,56.59 ,66.31 
03,001,03,019,0738,1565,785,8,793,1264,0,0,0,0,0,0,0,66.31 ,62.74 ,66.31 
03,001,03,019,0738,1566,775,4,779,1336,0,0,0,0,0,0,0,66.31 ,58.31 ,66.31 
03,001,03,019,0739,1567,580,6,586,1079,0,0,0,0,0,0,0,66.31 ,54.31 ,66.31 
03,001,03,019,0739,1568,807,10,817,1497,0,0,0,0,0,0,0,66.31 ,54.58 ,66.31 
03,001,03,019,0739,1569,648,6,654,1094,0,0,0,0,0,0,0,66.31 ,59.78 ,66.31 
03,001,03,019,0740,1570,796,5,801,1280,0,0,0,0,0,0,0,66.31 ,62.58 ,66.31 
03,001,03,019,0740,1571,673,3,676,1142,0,0,0,0,0,0,0,66.31 ,59.19 ,66.31 
03,001,03,019,0740,1572,656,7,663,1068,0,0,0,0,0,0,0,66.31 ,62.08 ,66.31 
03,001,03,019,0741,1573,878,12,890,1560,0,0,0,0,0,0,0,66.31 ,57.05 ,66.31 
03,001,03,019,0741,1574,870,10,880,1477,0,0,0,0,0,0,0,66.31 ,59.58 ,66.31 
03,001,03,019,0742,1575,756,7,763,1242,0,0,0,0,0,0,0,66.31 ,61.43 ,66.31 
03,001,03,019,0742,1576,731,9,740,1214,0,0,0,0,0,0,0,66.31 ,60.96 ,66.31 
03,001,03,019,0743,1577,755,7,762,1267,0,0,0,0,0,0,0,66.31 ,60.14 ,66.31 
03,001,03,019,0743,1578,721,11,732,1208,0,0,0,0,0,0,0,66.31 ,60.60 ,66.31 
03,001,03,019,0744,1579,1060,17,1077,1670,0,0,0,0,0,0,0,66.31 ,64.49 ,66.31 
03,001,03,019,0744,1580,921,4,925,1684,0,0,0,0,0,0,0,66.31 ,54.93 ,66.31 
03,001,03,019,0745,1581,663,5,668,1222,0,0,0,0,0,0,0,66.31 ,54.66 ,66.31 
03,001,03,019,0745,1582,723,8,731,1202,0,0,0,0,0,0,0,66.31 ,60.82 ,66.31 
03,001,03,019,0745,1583,840,6,846,1377,0,0,0,0,0,0,0,66.31 ,61.44 ,66.31 
03,001,03,019,0746,1584,779,9,788,1256,0,0,0,0,0,0,0,66.31 ,62.74 ,66.31 
03,001,03,019,0746,1585,735,9,744,1271,0,0,0,0,0,0,0,66.31 ,58.54 ,66.31 
03,001,03,019,0746,1586,637,6,643,1029,0,0,0,0,0,0,0,66.31 ,62.49 ,66.31 
03,001,03,019,0747,1587,697,7,704,1191,0,0,0,0,0,0,0,66.31 ,59.11 ,66.31 
03,001,03,019,0747,1588,724,3,727,1150,0,0,0,0,0,0,0,66.31 ,63.22 ,66.31 
03,001,03,019,0747,1589,756,5,761,1150,0,0,0,0,0,0,0,66.31 ,66.17 ,66.31 
03,001,03,019,0748,1590,861,11,872,1449,0,0,0,0,0,0,0,66.31 ,60.18 ,66.31 
03,001,03,019,0748,1591,992,13,1005,1758,0,0,0,0,0,0,0,66.31 ,57.17 ,66.31 
03,001,03,019,0749,1592,602,7,609,969,0,0,0,0,0,0,0,66.31 ,62.85 ,66.31 
03,001,03,019,0749,1593,787,11,798,1282,0,0,0,0,0,0,0,66.31 ,62.25 ,66.31 
03,001,03,019,0750,1594,941,6,947,1499,0,0,0,0,0,0,0,66.31 ,63.18 ,66.31 
03,001,03,019,0750,1595,777,3,780,1272,0,0,0,0,0,0,0,66.31 ,61.32 ,66.31 
03,001,03,019,0751,1596,506,3,509,854,0,0,0,0,0,0,0,66.31 ,59.60 ,66.31 
03,001,03,019,0751,1597,637,7,644,1105,0,0,0,0,0,0,0,66.31 ,58.28 ,66.31 
03,001,03,019,0752,1598,834,10,844,1371,0,0,0,0,0,0,0,66.31 ,61.56 ,66.31 
03,001,03,019,0752,1599,718,9,727,1256,0,0,0,0,0,0,0,66.31 ,57.88 ,66.31 
03,001,03,019,0753,1600,638,9,647,1124,0,0,0,0,0,0,0,66.31 ,57.56 ,66.31 
03,001,03,019,0753,1601,756,12,768,1264,0,0,0,0,0,0,0,66.31 ,60.76 ,66.31 
03,001,03,019,0753,1602,612,3,615,1014,0,0,0,0,0,0,0,66.31 ,60.65 ,66.31 
03,001,03,019,0754,1603,690,7,697,1127,0,0,0,0,0,0,0,66.31 ,61.85 ,66.31 
03,001,03,019,0754,1604,699,10,709,1167,0,0,0,0,0,0,0,66.31 ,60.75 ,66.31 
03,001,03,019,0755,1605,792,8,800,1370,0,0,0,0,0,0,0,66.31 ,58.39 ,66.31 
03,001,03,019,0755,1606,557,10,567,914,0,0,0,0,0,0,0,66.31 ,62.04 ,66.31 
03,001,03,019,0756,1607,899,15,914,1512,0,0,0,0,0,0,0,66.31 ,60.45 ,66.31 
03,001,03,019,0756,1608,1005,13,1018,1690,0,0,0,0,0,0,0,66.31 ,60.24 ,66.31 
03,001,03,019,0757,1609,750,9,759,1312,0,0,0,0,0,0,0,66.31 ,57.85 ,66.31 
03,001,03,019,0757,1610,693,4,697,1237,0,0,0,0,0,0,0,66.31 ,56.35 ,66.31 
03,001,03,019,0758,1611,890,7,897,1529,0,0,0,0,0,0,0,66.31 ,58.67 ,66.31 
03,001,03,019,0758,1612,958,12,970,1531,0,0,0,0,0,0,0,66.31 ,63.36 ,66.31 
03,001,03,019,0759,1613,726,6,732,1269,0,0,0,0,0,0,0,66.31 ,57.68 ,66.31 
03,001,03,019,0759,1614,639,8,647,1117,0,0,0,0,0,0,0,66.31 ,57.92 ,66.31 
03,001,03,019,0759,1615,588,8,596,1078,0,0,0,0,0,0,0,66.31 ,55.29 ,66.31 
03,001,03,019,0760,1616,586,4,590,1033,0,0,0,0,0,0,0,66.31 ,57.12 ,66.31 
03,001,03,019,0760,1617,687,4,691,1122,0,0,0,0,0,0,0,66.31 ,61.59 ,66.31 
03,001,03,019,0760,1618,656,9,665,1182,0,0,0,0,0,0,0,66.31 ,56.26 ,66.31 
03,001,03,019,0761,1619,839,9,848,1425,0,0,0,0,0,0,0,66.31 ,59.51 ,66.31 
03,001,03,019,0761,1620,864,12,876,1631,0,0,0,0,0,0,0,66.31 ,53.71 ,66.31 
03,001,03,019,0762,1621,514,11,525,861,0,0,0,0,0,0,0,66.31 ,60.98 ,66.31 
03,001,03,019,0762,1622,566,7,573,965,0,0,0,0,0,0,0,66.31 ,59.38 ,66.31 
03,001,03,019,0763,1623,864,7,871,1482,0,0,0,0,0,0,0,66.31 ,58.77 ,66.31 
03,001,03,019,0763,1624,907,12,919,1592,0,0,0,0,0,0,0,66.31 ,57.73 ,66.31 
03,001,03,019,0764,1625,570,4,574,976,0,0,0,0,0,0,0,66.31 ,58.81 ,66.31 
03,001,03,019,0764,1626,528,3,531,958,0,0,0,0,0,0,0,66.31 ,55.43 ,66.31 
03,001,03,019,0765,1627,1026,14,1040,1675,0,0,0,0,0,0,0,66.31 ,62.09 ,66.31 
03,001,03,019,0765,1628,953,12,965,1583,0,0,0,0,0,0,0,66.31 ,60.96 ,66.31 
03,001,03,019,0766,1629,737,12,749,1321,0,0,0,0,0,0,0,66.31 ,56.70 ,66.31 
03,001,03,019,0766,1630,798,5,803,1292,0,0,0,0,0,0,0,66.31 ,62.15 ,66.31 
03,001,03,019,0767,1631,975,13,988,1631,0,0,0,0,0,0,0,66.31 ,60.58 ,66.31 
03,001,03,019,0767,1632,800,10,810,1325,0,0,0,0,0,0,0,66.31 ,61.13 ,66.31 
03,001,03,019,0768,1633,820,11,831,1382,0,0,0,0,0,0,0,66.31 ,60.13 ,66.31 
03,001,03,019,0768,1634,936,16,952,1510,0,0,0,0,0,0,0,66.31 ,63.05 ,66.31 
03,001,03,019,0769,1635,983,12,995,1675,0,0,0,0,0,0,0,66.31 ,59.40 ,66.31 
03,001,03,019,0770,1636,896,10,906,1564,0,0,0,0,0,0,0,66.31 ,57.93 ,66.31 
03,001,03,019,0770,1637,976,14,990,1696,0,0,0,0,0,0,0,66.31 ,58.37 ,66.31 
03,001,03,019,0771,1638,1091,8,1099,1773,0,0,0,0,0,0,0,66.31 ,61.99 ,66.31 
03,001,03,019,0771,1639,920,15,935,1414,0,0,0,0,0,0,0,66.31 ,66.12 ,66.31 
03,001,03,019,0772,1640,656,5,661,1103,0,0,0,0,0,0,0,66.31 ,59.93 ,66.31 
03,001,03,019,0772,1641,685,5,690,1166,0,0,0,0,0,0,0,66.31 ,59.18 ,66.31 
03,001,03,019,0772,1642,742,12,754,1245,0,0,0,0,0,0,0,66.31 ,60.56 ,66.31 
03,001,03,019,0773,1643,942,11,953,1648,0,0,0,0,0,0,0,66.31 ,57.83 ,66.31 
03,001,03,019,0773,1644,618,2,620,1040,0,0,0,0,0,0,0,66.31 ,59.62 ,66.31 
03,001,03,019,0773,1645,649,13,662,1168,0,0,0,0,0,0,0,66.31 ,56.68 ,66.31 
03,001,03,019,0774,1646,549,7,556,1018,0,0,0,0,0,0,0,66.31 ,54.62 ,66.31 
03,001,03,019,0774,1647,930,9,939,1616,0,0,0,0,0,0,0,66.31 ,58.11 ,66.31 
03,001,03,019,0775,1648,935,18,953,1542,0,0,0,0,0,0,0,66.31 ,61.80 ,66.31 
03,001,03,019,0775,1649,749,10,759,1343,0,0,0,0,0,0,0,66.31 ,56.52 ,66.31 
03,001,03,019,0776,1650,701,15,716,1000,0,0,0,0,0,0,0,66.31 ,71.60 ,66.31 
03,001,03,019,0777,1651,520,19,539,825,0,0,0,0,0,0,0,66.31 ,65.33 ,66.31 
03,001,03,019,0778,1652,612,15,627,1006,0,0,0,0,0,0,0,66.31 ,62.33 ,66.31 
03,001,03,019,0779,1653,472,13,485,732,0,0,0,0,0,0,0,66.31 ,66.26 ,66.31 
03,001,03,019,0780,1654,712,11,723,1137,0,0,0,0,0,0,0,66.31 ,63.59 ,66.31 
03,001,03,019,0780,1655,814,22,836,1354,0,0,0,0,0,0,0,66.31 ,61.74 ,66.31 
03,001,03,019,0781,1656,556,10,566,936,0,0,0,0,0,0,0,66.31 ,60.47 ,66.31 
03,001,03,019,0781,1657,598,6,604,1124,0,0,0,0,0,0,0,66.31 ,53.74 ,66.31 
03,001,03,019,0782,1658,551,6,557,988,0,0,0,0,0,0,0,66.31 ,56.38 ,66.31 
03,001,03,019,0782,1659,605,8,613,986,0,0,0,0,0,0,0,66.31 ,62.17 ,66.31 
03,001,03,019,0783,1660,896,13,909,1522,0,0,0,0,0,0,0,66.31 ,59.72 ,66.31 
03,001,03,019,0784,1661,469,4,473,817,0,0,0,0,0,0,0,66.31 ,57.89 ,66.31 
03,001,03,019,0784,1662,638,4,642,1086,0,0,0,0,0,0,0,66.31 ,59.12 ,66.31 
03,001,03,019,0785,1663,588,10,598,1025,0,0,0,0,0,0,0,66.31 ,58.34 ,66.31 
03,001,03,019,0785,1664,610,9,619,1000,0,0,0,0,0,0,0,66.31 ,61.90 ,66.31 
03,001,03,019,0786,1665,596,7,603,949,0,0,0,0,0,0,0,66.31 ,63.54 ,66.31 
03,001,03,019,0786,1666,506,3,509,896,0,0,0,0,0,0,0,66.31 ,56.81 ,66.31 
03,001,03,019,0787,1667,584,5,589,994,0,0,0,0,0,0,0,66.31 ,59.26 ,66.31 
03,001,03,019,0787,1668,789,7,796,1214,0,0,0,0,0,0,0,66.31 ,65.57 ,66.31 
03,001,03,020,0788,1669,917,9,926,1440,0,0,0,0,0,0,0,66.31 ,64.31 ,66.31 
03,001,03,020,0789,1670,697,13,710,1146,0,0,0,0,0,0,0,66.31 ,61.95 ,66.31 
03,001,03,020,0790,1671,477,4,481,831,0,0,0,0,0,0,0,66.31 ,57.88 ,66.31 
03,001,03,020,0790,1672,673,8,681,1181,0,0,0,0,0,0,0,66.31 ,57.66 ,66.31 
03,001,03,020,0791,1673,763,16,779,1334,0,0,0,0,0,0,0,66.31 ,58.40 ,66.31 
03,001,03,020,0792,1674,510,6,516,792,0,0,0,0,0,0,0,66.31 ,65.15 ,66.31 
03,001,03,020,0793,1675,704,12,716,1029,0,0,0,0,0,0,0,66.31 ,69.58 ,66.31 
03,001,03,020,0793,1676,673,6,679,1044,0,0,0,0,0,0,0,66.31 ,65.04 ,66.31 
03,001,03,020,0794,1677,788,10,798,1343,0,0,0,0,0,0,0,66.31 ,59.42 ,66.31 
03,001,03,020,0794,1678,636,3,639,1096,0,0,0,0,0,0,0,66.31 ,58.30 ,66.31 
03,001,03,020,0794,1679,707,9,716,1275,0,0,0,0,0,0,0,66.31 ,56.16 ,66.31 
03,001,03,020,0795,1680,719,7,726,1166,0,0,0,0,0,0,0,66.31 ,62.26 ,66.31 
03,001,03,020,0795,1681,847,11,858,1338,0,0,0,0,0,0,0,66.31 ,64.13 ,66.31 
03,001,03,020,0795,1682,775,10,785,1281,0,0,0,0,0,0,0,66.31 ,61.28 ,66.31 
03,001,03,020,0796,1683,749,7,756,1236,0,0,0,0,0,0,0,66.31 ,61.17 ,66.31 
03,001,03,020,0796,1684,695,12,707,1155,0,0,0,0,0,0,0,66.31 ,61.21 ,66.31 
03,001,03,020,0797,1685,764,9,773,1269,0,0,0,0,0,0,0,66.31 ,60.91 ,66.31 
03,001,03,020,0797,1686,705,5,710,1154,0,0,0,0,0,0,0,66.31 ,61.53 ,66.31 
03,001,03,020,0797,1687,792,7,799,1383,0,0,0,0,0,0,0,66.31 ,57.77 ,66.31 
03,001,03,020,0797,1688,769,11,780,1380,0,0,0,0,0,0,0,66.31 ,56.52 ,66.31 
03,001,03,020,0798,1689,793,7,800,1343,0,0,0,0,0,0,0,66.31 ,59.57 ,66.31 
03,001,03,020,0798,1690,729,10,739,1284,0,0,0,0,0,0,0,66.31 ,57.55 ,66.31 
03,001,03,020,0798,1691,696,9,705,1211,0,0,0,0,0,0,0,66.31 ,58.22 ,66.31 
03,001,03,020,0798,1692,846,8,854,1529,0,0,0,0,0,0,0,66.31 ,55.85 ,66.31 
03,001,03,020,0799,1693,974,6,980,1619,0,0,0,0,0,0,0,66.31 ,60.53 ,66.31 
03,001,03,020,0800,1694,622,4,626,1095,0,0,0,0,0,0,0,66.31 ,57.17 ,66.31 
03,001,03,020,0800,1695,603,6,609,998,0,0,0,0,0,0,0,66.31 ,61.02 ,66.31 
03,001,03,020,0800,1696,522,9,531,946,0,0,0,0,0,0,0,66.31 ,56.13 ,66.31 
03,001,03,020,0801,1697,659,9,668,1107,0,0,0,0,0,0,0,66.31 ,60.34 ,66.31 
03,001,03,020,0801,1698,637,14,651,1075,0,0,0,0,0,0,0,66.31 ,60.56 ,66.31 
03,001,03,020,0802,1699,792,7,799,1273,0,0,0,0,0,0,0,66.31 ,62.77 ,66.31 
03,001,03,020,0802,1700,690,9,699,1159,0,0,0,0,0,0,0,66.31 ,60.31 ,66.31 
03,001,03,020,0802,1701,892,11,903,1548,0,0,0,0,0,0,0,66.31 ,58.33 ,66.31 
03,001,03,020,0802,1702,787,10,797,1285,0,0,0,0,0,0,0,66.31 ,62.02 ,66.31 
03,001,03,020,0803,1703,657,10,667,1149,0,0,0,0,0,0,0,66.31 ,58.05 ,66.31 
03,001,03,020,0803,1704,725,7,732,1216,0,0,0,0,0,0,0,66.31 ,60.20 ,66.31 
03,001,03,020,0803,1705,615,2,617,1025,0,0,0,0,0,0,0,66.31 ,60.20 ,66.31 
03,001,03,020,0804,1706,702,8,710,1163,0,0,0,0,0,0,0,66.31 ,61.05 ,66.31 
03,001,03,020,0804,1707,660,5,665,1090,0,0,0,0,0,0,0,66.31 ,61.01 ,66.31 
03,001,03,020,0805,1708,707,6,713,1153,0,0,0,0,0,0,0,66.31 ,61.84 ,66.31 
03,001,03,020,0805,1709,879,6,885,1544,0,0,0,0,0,0,0,66.31 ,57.32 ,66.31 
03,001,03,020,0806,1710,606,8,614,1025,0,0,0,0,0,0,0,66.31 ,59.90 ,66.31 
03,001,03,020,0806,1711,728,4,732,1144,0,0,0,0,0,0,0,66.31 ,63.99 ,66.31 
03,001,03,020,0806,1712,803,14,817,1406,0,0,0,0,0,0,0,66.31 ,58.11 ,66.31 
03,001,03,020,0807,1713,701,10,711,1222,0,0,0,0,0,0,0,66.31 ,58.18 ,66.31 
03,001,03,020,0807,1714,746,10,756,1294,0,0,0,0,0,0,0,66.31 ,58.42 ,66.31 
03,001,03,020,0808,1715,878,12,890,1376,0,0,0,0,0,0,0,66.31 ,64.68 ,66.31 
03,001,03,020,0808,1716,518,9,527,910,0,0,0,0,0,0,0,66.31 ,57.91 ,66.31 
03,001,03,020,0808,1717,592,3,595,1010,0,0,0,0,0,0,0,66.31 ,58.91 ,66.31 
03,001,03,020,0809,1718,743,4,747,1172,0,0,0,0,0,0,0,66.31 ,63.74 ,66.31 
03,001,03,020,0809,1719,772,9,781,1297,0,0,0,0,0,0,0,66.31 ,60.22 ,66.31 
03,001,03,020,0810,1720,887,7,894,1432,0,0,0,0,0,0,0,66.31 ,62.43 ,66.31 
03,001,03,020,0810,1721,897,12,909,1574,0,0,0,0,0,0,0,66.31 ,57.75 ,66.31 
03,001,03,020,0811,1722,310,6,316,508,0,0,0,0,0,0,0,66.31 ,62.20 ,66.31 
03,001,03,020,0811,1723,383,7,390,690,0,0,0,0,0,0,0,66.31 ,56.52 ,66.31 
03,001,03,020,0812,1724,570,11,581,869,0,0,0,0,0,0,0,66.31 ,66.86 ,66.31 
03,001,03,020,0813,1725,696,4,700,1186,0,0,0,0,0,0,0,66.31 ,59.02 ,66.31 
03,001,03,020,0813,1726,734,6,740,1232,0,0,0,0,0,0,0,66.31 ,60.06 ,66.31 
03,001,03,020,0814,1727,662,12,674,1052,0,0,0,0,0,0,0,66.31 ,64.07 ,66.31 
03,001,03,020,0814,1728,555,4,559,981,0,0,0,0,0,0,0,66.31 ,56.98 ,66.31 
03,001,03,020,0814,1729,636,9,645,1067,0,0,0,0,0,0,0,66.31 ,60.45 ,66.31 
03,001,03,020,0815,1730,666,4,670,1147,0,0,0,0,0,0,0,66.31 ,58.41 ,66.31 
03,001,03,020,0815,1731,671,7,678,1127,0,0,0,0,0,0,0,66.31 ,60.16 ,66.31 
03,001,03,020,0815,1732,642,3,645,1083,0,0,0,0,0,0,0,66.31 ,59.56 ,66.31 
03,001,03,020,0816,1733,934,8,942,1511,0,0,0,0,0,0,0,66.31 ,62.34 ,66.31 
03,001,03,020,0816,1734,882,6,888,1431,0,0,0,0,0,0,0,66.31 ,62.05 ,66.31 
03,001,03,020,0817,1735,938,9,947,1525,0,0,0,0,0,0,0,66.31 ,62.10 ,66.31 
03,001,03,020,0817,1736,966,6,972,1552,0,0,0,0,0,0,0,66.31 ,62.63 ,66.31 
03,001,03,020,0818,1737,588,6,594,1073,0,0,0,0,0,0,0,66.31 ,55.36 ,66.31 
03,001,03,020,0818,1738,781,10,791,1240,0,0,0,0,0,0,0,66.31 ,63.79 ,66.31 
03,001,03,020,0818,1739,654,8,662,1169,0,0,0,0,0,0,0,66.31 ,56.63 ,66.31 
03,001,03,020,0819,1740,618,7,625,1118,0,0,0,0,0,0,0,66.31 ,55.90 ,66.31 
03,001,03,020,0819,1741,697,17,714,1273,0,0,0,0,0,0,0,66.31 ,56.09 ,66.31 
03,001,03,020,0820,1742,695,7,702,1121,0,0,0,0,0,0,0,66.31 ,62.62 ,66.31 
03,001,03,020,0820,1743,709,7,716,1206,0,0,0,0,0,0,0,66.31 ,59.37 ,66.31 
03,001,03,020,0820,1744,657,6,663,1135,0,0,0,0,0,0,0,66.31 ,58.41 ,66.31 
03,001,03,020,0821,1745,598,11,609,1067,0,0,0,0,0,0,0,66.31 ,57.08 ,66.31 
03,001,03,020,0821,1746,813,10,823,1423,0,0,0,0,0,0,0,66.31 ,57.84 ,66.31 
03,001,03,020,0821,1747,749,11,760,1178,0,0,0,0,0,0,0,66.31 ,64.52 ,66.31 
03,001,03,020,0822,1748,964,6,970,1695,0,0,0,0,0,0,0,66.31 ,57.23 ,66.31 
03,001,03,020,0822,1749,902,8,910,1499,0,0,0,0,0,0,0,66.31 ,60.71 ,66.31 
03,001,03,020,0822,1750,741,3,744,1241,0,0,0,0,0,0,0,66.31 ,59.95 ,66.31 
03,001,03,020,0823,1751,858,10,868,1494,0,0,0,0,0,0,0,66.31 ,58.10 ,66.31 
03,001,03,020,0823,1752,756,4,760,1288,0,0,0,0,0,0,0,66.31 ,59.01 ,66.31 
03,001,03,020,0823,1753,834,11,845,1460,0,0,0,0,0,0,0,66.31 ,57.88 ,66.31 
03,001,03,020,0824,1754,973,11,984,1663,0,0,0,0,0,0,0,66.31 ,59.17 ,66.31 
03,001,03,020,0824,1755,528,12,540,850,0,0,0,0,0,0,0,66.31 ,63.53 ,66.31 
03,001,03,020,0825,1756,202,6,208,339,0,0,0,0,0,0,0,66.31 ,61.36 ,66.31 
03,001,03,020,0826,1757,767,14,781,1236,0,0,0,0,0,0,0,66.31 ,63.19 ,66.31 
03,001,03,020,0826,1758,597,8,605,898,0,0,0,0,0,0,0,66.31 ,67.37 ,66.31 
03,001,03,020,0827,1759,539,9,548,848,0,0,0,0,0,0,0,66.31 ,64.62 ,66.31 
03,001,03,020,0827,1760,697,6,703,1190,0,0,0,0,0,0,0,66.31 ,59.08 ,66.31 
03,001,03,020,0828,1761,822,13,835,1405,0,0,0,0,0,0,0,66.31 ,59.43 ,66.31 
03,001,03,020,0829,1762,1025,13,1038,1697,0,0,0,0,0,0,0,66.31 ,61.17 ,66.31 
03,001,03,020,0830,1763,891,5,896,1586,0,0,0,0,0,0,0,66.31 ,56.49 ,66.31 
03,001,03,020,0830,1764,923,11,934,1574,0,0,0,0,0,0,0,66.31 ,59.34 ,66.31 
03,001,03,020,0830,1765,842,12,854,1540,0,0,0,0,0,0,0,66.31 ,55.45 ,66.31 
03,001,03,020,0831,1766,794,14,808,1285,0,0,0,0,0,0,0,66.31 ,62.88 ,66.31 
03,001,03,020,0831,1767,670,9,679,1204,0,0,0,0,0,0,0,66.31 ,56.40 ,66.31 
03,001,03,020,0831,1768,705,9,714,1240,0,0,0,0,0,0,0,66.31 ,57.58 ,66.31 
03,001,03,020,0832,1769,734,8,742,1307,0,0,0,0,0,0,0,66.31 ,56.77 ,66.31 
03,001,03,020,0832,1770,659,7,666,1143,0,0,0,0,0,0,0,66.31 ,58.27 ,66.31 
03,001,03,020,0832,1771,730,4,734,1201,0,0,0,0,0,0,0,66.31 ,61.12 ,66.31 
03,001,03,020,0833,1772,819,5,824,1436,0,0,0,0,0,0,0,66.31 ,57.38 ,66.31 
03,001,03,020,0833,1773,859,8,867,1527,0,0,0,0,0,0,0,66.31 ,56.78 ,66.31 
03,001,03,020,0834,1774,994,18,1012,1684,0,0,0,0,0,0,0,66.31 ,60.10 ,66.31 
03,001,03,020,0834,1775,744,8,752,1322,0,0,0,0,0,0,0,66.31 ,56.88 ,66.31 
03,001,03,020,0835,1776,756,10,766,1353,0,0,0,0,0,0,0,66.31 ,56.61 ,66.31 
03,001,03,020,0835,1777,816,16,832,1400,0,0,0,0,0,0,0,66.31 ,59.43 ,66.31 
03,001,03,020,0835,1778,704,6,710,1248,0,0,0,0,0,0,0,66.31 ,56.89 ,66.31 
03,001,03,020,0835,1779,761,9,770,1306,0,0,0,0,0,0,0,66.31 ,58.96 ,66.31 
03,001,03,020,0836,1780,705,4,709,1200,0,0,0,0,0,0,0,66.31 ,59.08 ,66.31 
03,001,03,020,0836,1781,694,2,696,1185,0,0,0,0,0,0,0,66.31 ,58.73 ,66.31 
03,001,03,020,0837,1782,807,10,817,1344,0,0,0,0,0,0,0,66.31 ,60.79 ,66.31 
03,001,03,020,0837,1783,450,6,456,698,0,0,0,0,0,0,0,66.31 ,65.33 ,66.31 
03,001,03,020,0837,1784,245,5,250,349,0,0,0,0,0,0,0,66.31 ,71.63 ,66.31 
03,001,03,020,0837,1785,810,4,814,1513,0,0,0,0,0,0,0,66.31 ,53.80 ,66.31 
03,001,03,020,0837,1786,758,13,771,1240,0,0,0,0,0,0,0,66.31 ,62.18 ,66.31 
03,001,03,020,0838,1787,752,0,752,1196,0,0,0,0,0,0,0,66.31 ,62.88 ,66.31 
03,001,03,020,0838,1788,567,4,571,972,0,0,0,0,0,0,0,66.31 ,58.74 ,66.31 
03,001,03,020,0839,1789,666,5,671,1077,0,0,0,0,0,0,0,66.31 ,62.30 ,66.31 
03,001,03,020,0839,1790,976,14,990,1615,0,0,0,0,0,0,0,66.31 ,61.30 ,66.31 
03,001,03,020,0840,1791,555,6,561,929,0,0,0,0,0,0,0,66.31 ,60.39 ,66.31 
03,001,03,020,0840,1792,542,1,543,815,0,0,0,0,0,0,0,66.31 ,66.63 ,66.31 
03,001,03,020,0840,1793,716,4,720,1278,0,0,0,0,0,0,0,66.31 ,56.34 ,66.31 
03,001,03,020,0840,1794,883,7,890,1499,0,0,0,0,0,0,0,66.31 ,59.37 ,66.31 
03,001,03,020,0841,1795,419,1,420,782,0,0,0,0,0,0,0,66.31 ,53.71 ,66.31 
03,001,03,020,0841,1796,636,7,643,1263,0,0,0,0,0,0,0,66.31 ,50.91 ,66.31 
03,001,03,020,0841,1797,599,9,608,1222,0,0,0,0,0,0,0,66.31 ,49.75 ,66.31 
03,001,03,020,0842,1798,873,12,885,1520,0,0,0,0,0,0,0,66.31 ,58.22 ,66.31 
03,001,03,020,0842,1799,663,5,668,1224,0,0,0,0,0,0,0,66.31 ,54.58 ,66.31 
03,001,03,020,0842,1800,762,7,769,1272,0,0,0,0,0,0,0,66.31 ,60.46 ,66.31 
03,001,03,020,0843,1801,827,9,836,1347,0,0,0,0,0,0,0,66.31 ,62.06 ,66.31 
03,001,03,020,0843,1802,759,12,771,1223,0,0,0,0,0,0,0,66.31 ,63.04 ,66.31 
03,001,03,020,0843,1803,759,4,763,1233,0,0,0,0,0,0,0,66.31 ,61.88 ,66.31 
03,001,03,020,0844,1804,943,7,950,1677,0,0,0,0,0,0,0,66.31 ,56.65 ,66.31 
03,001,03,020,0844,1805,848,8,856,1490,0,0,0,0,0,0,0,66.31 ,57.45 ,66.31 
03,001,03,020,0845,1806,399,4,403,667,0,0,0,0,0,0,0,66.31 ,60.42 ,66.31 
03,001,03,020,0845,1807,334,1,335,646,0,0,0,0,0,0,0,66.31 ,51.86 ,66.31 
03,001,03,020,0846,1808,945,10,955,1644,0,0,0,0,0,0,0,66.31 ,58.09 ,66.31 
03,001,03,020,0846,1809,642,7,649,1151,0,0,0,0,0,0,0,66.31 ,56.39 ,66.31 
03,001,03,020,0847,1810,843,13,856,1388,0,0,0,0,0,0,0,66.31 ,61.67 ,66.31 
03,001,03,020,0847,1811,661,13,674,1123,0,0,0,0,0,0,0,66.31 ,60.02 ,66.31 
03,001,03,020,0847,1812,583,2,585,919,0,0,0,0,0,0,0,66.31 ,63.66 ,66.31 
03,001,03,020,0848,1813,739,6,745,1208,0,0,0,0,0,0,0,66.31 ,61.67 ,66.31 
03,001,03,020,0848,1814,757,23,780,1246,0,0,0,0,0,0,0,66.31 ,62.60 ,66.31 
03,001,03,020,0849,1815,417,4,421,828,0,0,0,0,0,0,0,66.31 ,50.85 ,66.31 
03,001,03,020,0850,1816,227,3,230,361,0,0,0,0,0,0,0,66.31 ,63.71 ,66.31 
03,001,03,020,0850,1817,908,11,919,1729,0,0,0,0,0,0,0,66.31 ,53.15 ,66.31 
03,001,03,020,0851,1818,569,7,576,930,0,0,0,0,0,0,0,66.31 ,61.94 ,66.31 
03,001,03,020,0851,1819,763,16,779,1217,0,0,0,0,0,0,0,66.31 ,64.01 ,66.31 
03,001,03,020,0852,1820,807,13,820,1353,0,0,0,0,0,0,0,66.31 ,60.61 ,66.31 
03,001,03,020,0853,1821,624,12,636,1046,0,0,0,0,0,0,0,66.31 ,60.80 ,66.31 
03,001,03,020,0854,1822,281,2,283,430,0,0,0,0,0,0,0,66.31 ,65.81 ,66.31 
03,001,03,020,0854,1823,146,0,146,267,0,0,0,0,0,0,0,66.31 ,54.68 ,66.31 
03,001,03,021,0855,1824,866,14,880,1651,0,0,0,0,0,0,0,66.31 ,53.30 ,66.31 
03,001,03,021,0856,1825,553,10,563,946,0,0,0,0,0,0,0,66.31 ,59.51 ,66.31 
03,001,03,021,0856,1826,444,9,453,789,0,0,0,0,0,0,0,66.31 ,57.41 ,66.31 
03,001,03,021,0857,1827,542,10,552,880,0,0,0,0,0,0,0,66.31 ,62.73 ,66.31 
03,001,03,021,0857,1828,485,5,490,813,0,0,0,0,0,0,0,66.31 ,60.27 ,66.31 
03,001,03,021,0858,1829,636,10,646,1180,0,0,0,0,0,0,0,66.31 ,54.75 ,66.31 
03,001,03,021,0859,1830,685,11,696,1116,0,0,0,0,0,0,0,66.31 ,62.37 ,66.31 
03,001,03,021,0859,1831,597,8,605,1098,0,0,0,0,0,0,0,66.31 ,55.10 ,66.31 
03,001,03,021,0860,1832,947,11,958,1660,0,0,0,0,0,0,0,66.31 ,57.71 ,66.31 
03,001,03,021,0860,1833,872,7,879,1594,0,0,0,0,0,0,0,66.31 ,55.14 ,66.31 
03,001,03,021,0861,1834,803,15,818,1376,0,0,0,0,0,0,0,66.31 ,59.45 ,66.31 
03,001,03,021,0862,1835,304,4,308,446,0,0,0,0,0,0,0,66.31 ,69.06 ,66.31 
03,001,03,022,0863,1836,293,1,294,389,0,0,0,0,0,0,0,66.31 ,75.58 ,66.31 
03,001,03,022,0864,1837,381,4,385,656,0,0,0,0,0,0,0,66.31 ,58.69 ,66.31 
03,001,03,022,0865,1838,371,10,381,614,0,0,0,0,0,0,0,66.31 ,62.05 ,66.31 
03,001,03,022,0866,1839,173,2,175,259,0,0,0,0,0,0,0,66.31 ,67.57 ,66.31 
03,001,03,022,0867,1840,178,1,179,293,0,0,0,0,0,0,0,66.31 ,61.09 ,66.31 
03,001,03,022,0867,1841,89,0,89,139,0,0,0,0,0,0,0,66.31 ,64.03 ,66.31 
03,001,03,022,0868,1842,448,8,456,730,0,0,0,0,0,0,0,66.31 ,62.47 ,66.31 
03,001,03,022,0869,1843,178,1,179,246,0,0,0,0,0,0,0,66.31 ,72.76 ,66.31 
03,001,03,022,0870,1844,569,8,577,776,0,0,0,0,0,0,0,66.31 ,74.36 ,66.31 
03,001,03,022,0871,1845,380,7,387,571,0,0,0,0,0,0,0,66.31 ,67.78 ,66.31 
03,001,03,022,0872,1846,144,2,146,225,0,0,0,0,0,0,0,66.31 ,64.89 ,66.31 
03,001,03,022,0873,1847,250,1,251,429,0,0,0,0,0,0,0,66.31 ,58.51 ,66.31 
03,001,03,022,0874,1848,413,5,418,604,0,0,0,0,0,0,0,66.31 ,69.21 ,66.31 
03,001,03,023,0875,1849,655,7,662,979,0,0,0,0,0,0,0,66.31 ,67.62 ,66.31 
03,001,03,023,0876,1850,331,5,336,534,0,0,0,0,0,0,0,66.31 ,62.92 ,66.31 
03,001,03,023,0877,1851,491,4,495,935,0,0,0,0,0,0,0,66.31 ,52.94 ,66.31 
03,001,03,023,0878,1852,238,2,240,374,0,0,0,0,0,0,0,66.31 ,64.17 ,66.31 
03,001,03,023,0879,1853,186,3,189,318,0,0,0,0,0,0,0,66.31 ,59.43 ,66.31 
03,001,03,023,0879,1854,242,4,246,375,0,0,0,0,0,0,0,66.31 ,65.60 ,66.31 
03,001,03,023,0880,1855,179,2,181,318,0,0,0,0,0,0,0,66.31 ,56.92 ,66.31 
03,001,03,023,0880,1856,168,5,173,356,0,0,0,0,0,0,0,66.31 ,48.60 ,66.31 
03,001,03,023,0881,1857,315,6,321,492,0,0,0,0,0,0,0,66.31 ,65.24 ,66.31 
03,001,03,023,0881,1858,105,1,106,204,0,0,0,0,0,0,0,66.31 ,51.96 ,66.31 
03,001,03,024,0882,1859,253,0,253,407,0,0,0,0,0,0,0,66.31 ,62.16 ,66.31 
03,001,03,024,0883,1860,539,6,545,898,0,0,0,0,0,0,0,66.31 ,60.69 ,66.31 
03,001,03,024,0884,1861,63,0,63,93,0,0,0,0,0,0,0,66.31 ,67.74 ,66.31 
03,001,03,024,0885,1862,89,2,91,152,0,0,0,0,0,0,0,66.31 ,59.87 ,66.31 
03,001,03,024,0886,1863,27,0,27,60,0,0,0,0,0,0,0,66.31 ,45.00 ,66.31 
03,001,03,025,0887,1864,912,7,919,1448,0,0,0,0,0,0,0,66.31 ,63.47 ,66.31 
03,001,03,025,0888,1865,708,7,715,1237,0,0,0,0,0,0,0,66.31 ,57.80 ,66.31 
03,001,03,025,0889,1866,562,5,567,985,0,0,0,0,0,0,0,66.31 ,57.56 ,66.31 
03,001,03,025,0890,1867,636,5,641,1265,0,0,0,0,0,0,0,66.31 ,50.67 ,66.31 
03,001,03,025,0890,1868,756,5,761,1411,0,0,0,0,0,0,0,66.31 ,53.93 ,66.31 
03,001,03,025,0891,1869,462,4,466,781,0,0,0,0,0,0,0,66.31 ,59.67 ,66.31 
03,001,03,025,0891,1870,471,8,479,868,0,0,0,0,0,0,0,66.31 ,55.18 ,66.31 
03,001,03,025,0892,1871,297,2,299,527,0,0,0,0,0,0,0,66.31 ,56.74 ,66.31 
03,001,03,025,0893,1872,794,13,807,1329,0,0,0,0,0,0,0,66.31 ,60.72 ,66.31 
03,001,03,025,0893,1873,786,7,793,1380,0,0,0,0,0,0,0,66.31 ,57.46 ,66.31 
03,001,03,025,0893,1874,692,12,704,1237,0,0,0,0,0,0,0,66.31 ,56.91 ,66.31 
03,001,03,025,0894,1875,804,15,819,1396,0,0,0,0,0,0,0,66.31 ,58.67 ,66.31 
03,001,03,025,0895,1876,516,6,522,870,0,0,0,0,0,0,0,66.31 ,60.00 ,66.31 
03,001,03,025,0895,1877,542,5,547,945,0,0,0,0,0,0,0,66.31 ,57.88 ,66.31 
03,001,03,025,0895,1878,575,10,585,968,0,0,0,0,0,0,0,66.31 ,60.43 ,66.31 
03,001,03,025,0896,1879,592,5,597,1005,0,0,0,0,0,0,0,66.31 ,59.40 ,66.31 
03,001,03,025,0896,1880,641,4,645,1131,0,0,0,0,0,0,0,66.31 ,57.03 ,66.31 
03,001,03,025,0897,1881,987,7,994,1819,0,0,0,0,0,0,0,66.31 ,54.65 ,66.31 
03,001,03,025,0897,1882,695,5,700,1227,0,0,0,0,0,0,0,66.31 ,57.05 ,66.31 
03,001,03,025,0898,1883,884,14,898,1484,0,0,0,0,0,0,0,66.31 ,60.51 ,66.31 
03,001,03,025,0898,1884,834,14,848,1392,0,0,0,0,0,0,0,66.31 ,60.92 ,66.31 
03,001,03,025,0899,1885,699,11,710,1269,0,0,0,0,0,0,0,66.31 ,55.95 ,66.31 
03,001,03,025,0899,1886,722,11,733,1209,0,0,0,0,0,0,0,66.31 ,60.63 ,66.31 
03,001,03,025,0900,1887,594,4,598,1056,0,0,0,0,0,0,0,66.31 ,56.63 ,66.31 
03,001,03,025,0900,1888,602,9,611,977,0,0,0,0,0,0,0,66.31 ,62.54 ,66.31 
03,001,03,025,0901,1889,754,11,765,1301,0,0,0,0,0,0,0,66.31 ,58.80 ,66.31 
03,001,03,025,0901,1890,748,12,760,1374,0,0,0,0,0,0,0,66.31 ,55.31 ,66.31 
03,001,03,025,0902,1891,747,5,752,1294,0,0,0,0,0,0,0,66.31 ,58.11 ,66.31 
03,001,03,025,0902,1892,628,12,640,1210,0,0,0,0,0,0,0,66.31 ,52.89 ,66.31 
03,001,03,025,0903,1893,936,9,945,1747,0,0,0,0,0,0,0,66.31 ,54.09 ,66.31 
03,001,03,025,0903,1894,693,9,702,1335,0,0,0,0,0,0,0,66.31 ,52.58 ,66.31 
03,001,03,025,0903,1895,782,8,790,1458,0,0,0,0,0,0,0,66.31 ,54.18 ,66.31 
03,001,03,025,0904,1896,813,7,820,1447,0,0,0,0,0,0,0,66.31 ,56.67 ,66.31 
03,001,03,025,0905,1897,789,5,794,1250,0,0,0,0,0,0,0,66.31 ,63.52 ,66.31 
03,001,03,025,0906,1898,267,3,270,454,0,0,0,0,0,0,0,66.31 ,59.47 ,66.31 
03,001,03,025,0907,1899,647,7,654,1109,0,0,0,0,0,0,0,66.31 ,58.97 ,66.31 
03,001,03,025,0907,1900,571,6,577,932,0,0,0,0,0,0,0,66.31 ,61.91 ,66.31 
03,001,03,025,0907,1901,354,5,359,573,0,0,0,0,0,0,0,66.31 ,62.65 ,66.31 
03,001,03,025,0908,1902,1059,17,1076,1656,0,0,0,0,0,0,0,66.31 ,64.98 ,66.31 
03,001,03,025,0909,1903,843,9,852,1409,0,0,0,0,0,0,0,66.31 ,60.47 ,66.31 
03,001,03,025,0909,1904,620,10,630,1034,0,0,0,0,0,0,0,66.31 ,60.93 ,66.31 
03,001,03,025,0909,1905,617,2,619,1107,0,0,0,0,0,0,0,66.31 ,55.92 ,66.31 
03,001,03,025,0910,1906,603,5,608,1191,0,0,0,0,0,0,0,66.31 ,51.05 ,66.31 
03,001,03,025,0910,1907,665,6,671,1466,0,0,0,0,0,0,0,66.31 ,45.77 ,66.31 
03,001,03,025,0910,1908,540,9,549,995,0,0,0,0,0,0,0,66.31 ,55.18 ,66.31 
03,001,03,025,0911,1909,639,6,645,1161,0,0,0,0,0,0,0,66.31 ,55.56 ,66.31 
03,001,03,025,0912,1910,499,7,506,808,0,0,0,0,0,0,0,66.31 ,62.62 ,66.31 
03,001,03,025,0913,1911,552,5,557,917,0,0,0,0,0,0,0,66.31 ,60.74 ,66.31 
03,001,03,025,0914,1912,792,7,799,1383,0,0,0,0,0,0,0,66.31 ,57.77 ,66.31 
03,001,03,025,0914,1913,807,4,811,1449,0,0,0,0,0,0,0,66.31 ,55.97 ,66.31 
03,001,03,025,0915,1914,628,3,631,1247,0,0,0,0,0,0,0,66.31 ,50.60 ,66.31 
03,001,03,025,0915,1915,700,6,706,1405,0,0,0,0,0,0,0,66.31 ,50.25 ,66.31 
03,001,03,025,0916,1916,892,8,900,1521,0,0,0,0,0,0,0,66.31 ,59.17 ,66.31 
03,001,03,025,0917,1917,690,5,695,1249,0,0,0,0,0,0,0,66.31 ,55.64 ,66.31 
03,001,03,025,0917,1918,592,9,601,1019,0,0,0,0,0,0,0,66.31 ,58.98 ,66.31 
03,001,03,025,0917,1919,674,7,681,1341,0,0,0,0,0,0,0,66.31 ,50.78 ,66.31 
03,001,03,025,0918,1920,662,10,672,1212,0,0,0,0,0,0,0,66.31 ,55.45 ,66.31 
03,001,03,025,0918,1921,593,7,600,1122,0,0,0,0,0,0,0,66.31 ,53.48 ,66.31 
03,001,03,025,0919,1922,425,3,428,905,0,0,0,0,0,0,0,66.31 ,47.29 ,66.31 
03,001,03,025,0920,1923,660,5,665,1347,0,0,0,0,0,0,0,66.31 ,49.37 ,66.31 
03,001,03,025,0920,1924,721,3,724,1381,0,0,0,0,0,0,0,66.31 ,52.43 ,66.31 
03,001,03,025,0920,1925,669,8,677,1281,0,0,0,0,0,0,0,66.31 ,52.85 ,66.31 
03,001,03,025,0921,1926,474,3,477,960,0,0,0,0,0,0,0,66.31 ,49.69 ,66.31 
03,001,03,025,0921,1927,467,7,474,1015,0,0,0,0,0,0,0,66.31 ,46.70 ,66.31 
03,001,03,025,0922,1928,456,4,460,936,0,0,0,0,0,0,0,66.31 ,49.15 ,66.31 
03,001,03,025,0922,1929,428,1,429,965,0,0,0,0,0,0,0,66.31 ,44.46 ,66.31 
03,001,03,025,0923,1930,549,9,558,1106,0,0,0,0,0,0,0,66.31 ,50.45 ,66.31 
03,001,03,025,0924,1931,542,5,547,1159,0,0,0,0,0,0,0,66.31 ,47.20 ,66.31 
03,001,03,025,0924,1932,484,4,488,949,0,0,0,0,0,0,0,66.31 ,51.42 ,66.31 
03,001,03,025,0925,1933,672,4,676,1284,0,0,0,0,0,0,0,66.31 ,52.65 ,66.31 
03,001,03,025,0925,1934,853,4,857,1555,0,0,0,0,0,0,0,66.31 ,55.11 ,66.31 
03,001,03,025,0926,1935,507,2,509,902,0,0,0,0,0,0,0,66.31 ,56.43 ,66.31 
03,001,03,025,0926,1936,490,4,494,1033,0,0,0,0,0,0,0,66.31 ,47.82 ,66.31 
03,001,03,025,0926,1937,983,12,995,1690,0,0,0,0,0,0,0,66.31 ,58.88 ,66.31 
03,001,03,025,0927,1938,654,8,662,1149,0,0,0,0,0,0,0,66.31 ,57.62 ,66.31 
03,001,03,025,0927,1939,613,2,615,1110,0,0,0,0,0,0,0,66.31 ,55.41 ,66.31 
03,001,03,025,0928,1940,592,4,596,929,0,0,0,0,0,0,0,66.31 ,64.16 ,66.31 
03,001,03,025,0929,1941,835,8,843,1380,0,0,0,0,0,0,0,66.31 ,61.09 ,66.31 
03,001,03,025,0929,1942,742,8,750,1244,0,0,0,0,0,0,0,66.31 ,60.29 ,66.31 
03,001,03,025,0929,1943,795,15,810,1324,0,0,0,0,0,0,0,66.31 ,61.18 ,66.31 
03,001,03,025,0930,1944,695,7,702,1146,0,0,0,0,0,0,0,66.31 ,61.26 ,66.31 
03,001,03,025,0930,1945,691,3,694,1221,0,0,0,0,0,0,0,66.31 ,56.84 ,66.31 
03,001,03,025,0931,1946,699,6,705,1196,0,0,0,0,0,0,0,66.31 ,58.95 ,66.31 
03,001,03,025,0931,1947,644,10,654,1014,0,0,0,0,0,0,0,66.31 ,64.50 ,66.31 
03,001,03,025,0932,1948,968,12,980,1760,0,0,0,0,0,0,0,66.31 ,55.68 ,66.31 
03,001,03,026,0933,1949,499,3,502,810,0,0,0,0,0,0,0,66.31 ,61.98 ,66.31 
03,001,03,026,0934,1950,485,5,490,821,0,0,0,0,0,0,0,66.31 ,59.68 ,66.31 
03,001,03,026,0934,1951,516,0,516,798,0,0,0,0,0,0,0,66.31 ,64.66 ,66.31 
03,001,03,026,0935,1952,842,17,859,1389,0,0,0,0,0,0,0,66.31 ,61.84 ,66.31 
03,001,03,026,0936,1953,363,9,372,607,0,0,0,0,0,0,0,66.31 ,61.29 ,66.31 
03,001,03,026,0937,1954,485,4,489,798,0,0,0,0,0,0,0,66.31 ,61.28 ,66.31 
03,001,03,026,0937,1955,472,5,477,786,0,0,0,0,0,0,0,66.31 ,60.69 ,66.31 
03,001,03,026,0938,1956,756,21,777,1327,0,0,0,0,0,0,0,66.31 ,58.55 ,66.31 
03,001,03,026,0939,1957,866,9,875,1413,0,0,0,0,0,0,0,66.31 ,61.92 ,66.31 
03,001,03,026,0939,1958,670,5,675,1207,0,0,0,0,0,0,0,66.31 ,55.92 ,66.31 
03,001,03,026,0939,1959,623,6,629,1114,0,0,0,0,0,0,0,66.31 ,56.46 ,66.31 
03,001,03,026,0940,1960,634,9,643,1028,0,0,0,0,0,0,0,66.31 ,62.55 ,66.31 
03,001,03,026,0940,1961,602,7,609,984,0,0,0,0,0,0,0,66.31 ,61.89 ,66.31 
03,001,03,026,0941,1962,761,15,776,1207,0,0,0,0,0,0,0,66.31 ,64.29 ,66.31 
03,001,03,026,0941,1963,444,7,451,816,0,0,0,0,0,0,0,66.31 ,55.27 ,66.31 
03,001,03,026,0942,1964,786,13,799,1207,0,0,0,0,0,0,0,66.31 ,66.20 ,66.31 
03,001,03,026,0943,1965,171,1,172,329,0,0,0,0,0,0,0,66.31 ,52.28 ,66.31 
03,001,03,026,0944,1966,375,5,380,555,0,0,0,0,0,0,0,66.31 ,68.47 ,66.31 
03,001,03,026,0945,1967,225,2,227,397,0,0,0,0,0,0,0,66.31 ,57.18 ,66.31 
03,001,03,026,0946,1968,123,0,123,181,0,0,0,0,0,0,0,66.31 ,67.96 ,66.31 
03,001,03,026,0947,1969,548,17,565,893,0,0,0,0,0,0,0,66.31 ,63.27 ,66.31 
03,001,03,026,0947,1970,410,6,416,816,0,0,0,0,0,0,0,66.31 ,50.98 ,66.31 
03,001,03,026,0948,1971,582,13,595,1000,0,0,0,0,0,0,0,66.31 ,59.50 ,66.31 
03,001,03,026,0948,1972,403,13,416,837,0,0,0,0,0,0,0,66.31 ,49.70 ,66.31 
03,001,03,026,0948,1973,606,19,625,1088,0,0,0,0,0,0,0,66.31 ,57.44 ,66.31 
03,001,03,026,0949,1974,403,8,411,668,0,0,0,0,0,0,0,66.31 ,61.53 ,66.31 
03,001,03,026,0949,1975,346,5,351,640,0,0,0,0,0,0,0,66.31 ,54.84 ,66.31 
03,001,03,026,0950,1976,524,5,529,1024,0,0,0,0,0,0,0,66.31 ,51.66 ,66.31 
03,001,03,026,0950,1977,507,13,520,872,0,0,0,0,0,0,0,66.31 ,59.63 ,66.31 
03,001,03,026,0951,1978,379,4,383,611,0,0,0,0,0,0,0,66.31 ,62.68 ,66.31 
03,001,03,026,0952,1979,364,3,367,638,0,0,0,0,0,0,0,66.31 ,57.52 ,66.31 
03,001,03,026,0953,1980,252,6,258,488,0,0,0,0,0,0,0,66.31 ,52.87 ,66.31 
03,001,03,026,0954,1981,152,2,154,296,0,0,0,0,0,0,0,66.31 ,52.03 ,66.31 
03,001,03,026,0955,1982,249,4,253,468,0,0,0,0,0,0,0,66.31 ,54.06 ,66.31 
03,001,03,026,0956,1983,213,1,214,316,0,0,0,0,0,0,0,66.31 ,67.72 ,66.31 
03,001,03,026,0957,1984,195,2,197,311,0,0,0,0,0,0,0,66.31 ,63.34 ,66.31 
03,001,03,026,0958,1985,287,4,291,455,0,0,0,0,0,0,0,66.31 ,63.96 ,66.31 
03,001,03,026,0959,1986,262,4,266,474,0,0,0,0,0,0,0,66.31 ,56.12 ,66.31 
03,001,03,026,0960,1987,454,8,462,672,0,0,0,0,0,0,0,66.31 ,68.75 ,66.31 
03,001,03,026,0961,1988,193,3,196,357,0,0,0,0,0,0,0,66.31 ,54.90 ,66.31 
03,001,03,026,0962,1989,135,0,135,207,0,0,0,0,0,0,0,66.31 ,65.22 ,66.31 
03,001,03,026,0963,1990,338,4,342,531,0,0,0,0,0,0,0,66.31 ,64.41 ,66.31 
03,001,03,026,0964,1991,566,11,577,897,0,0,0,0,0,0,0,66.31 ,64.33 ,66.31 
03,001,03,026,0965,1992,476,13,489,795,0,0,0,0,0,0,0,66.31 ,61.51 ,66.31 
03,001,03,026,0965,1993,539,5,544,816,0,0,0,0,0,0,0,66.31 ,66.67 ,66.31 
03,001,03,026,0966,1994,563,9,572,998,0,0,0,0,0,0,0,66.31 ,57.31 ,66.31 
03,001,03,027,0967,1995,283,4,287,459,0,0,0,0,0,0,0,66.31 ,62.53 ,66.31 
03,001,03,027,0968,1996,238,3,241,321,0,0,0,0,0,0,0,66.31 ,75.08 ,66.31 
03,001,03,027,0969,1997,237,5,242,314,0,0,0,0,0,0,0,66.31 ,77.07 ,66.31 
03,001,03,027,0970,1998,342,4,346,541,0,0,0,0,0,0,0,66.31 ,63.96 ,66.31 
03,001,03,027,0971,1999,189,2,191,286,0,0,0,0,0,0,0,66.31 ,66.78 ,66.31 
03,001,03,027,0972,2000,457,3,460,697,0,0,0,0,0,0,0,66.31 ,66.00 ,66.31 
03,001,03,027,0973,2001,231,0,231,378,0,0,0,0,0,0,0,66.31 ,61.11 ,66.31 
03,001,03,027,0974,2002,647,3,650,1102,0,0,0,0,0,0,0,66.31 ,58.98 ,66.31 
03,001,03,027,0975,2003,100,1,101,156,0,0,0,0,0,0,0,66.31 ,64.74 ,66.31 
03,001,03,027,0976,2004,276,3,279,527,0,0,0,0,0,0,0,66.31 ,52.94 ,66.31 
03,001,03,027,0977,2005,108,5,113,164,0,0,0,0,0,0,0,66.31 ,68.90 ,66.31 
03,001,03,027,0978,2006,129,1,130,178,0,0,0,0,0,0,0,66.31 ,73.03 ,66.31 
03,001,03,028,0979,2007,396,2,398,600,0,0,0,0,0,0,0,66.31 ,66.33 ,66.31 
03,001,03,028,0980,2008,223,3,226,307,0,0,0,0,0,0,0,66.31 ,73.62 ,66.31 
03,001,03,028,0980,2009,458,2,460,657,0,0,0,0,0,0,0,66.31 ,70.02 ,66.31 
03,001,03,028,0981,2010,273,1,274,451,0,0,0,0,0,0,0,66.31 ,60.75 ,66.31 
03,001,03,028,0982,2011,700,7,707,1098,0,0,0,0,0,0,0,66.31 ,64.39 ,66.31 
03,001,03,028,0982,2012,548,8,556,784,0,0,0,0,0,0,0,66.31 ,70.92 ,66.31 
03,001,03,028,0983,2013,207,0,207,312,0,0,0,0,0,0,0,66.31 ,66.35 ,66.31 
03,001,03,028,0984,2014,437,5,442,677,0,0,0,0,0,0,0,66.31 ,65.29 ,66.31 
03,001,03,028,0984,2015,169,4,173,297,0,0,0,0,0,0,0,66.31 ,58.25 ,66.31 
03,001,03,028,0985,2016,468,6,474,712,0,0,0,0,0,0,0,66.31 ,66.57 ,66.31 
03,001,03,028,0986,2017,322,3,325,513,0,0,0,0,0,0,0,66.31 ,63.35 ,66.31 
03,001,03,028,0987,2018,276,2,278,403,0,0,0,0,0,0,0,66.31 ,68.98 ,66.31 
03,001,03,028,0988,2019,111,1,112,158,0,0,0,0,0,0,0,66.31 ,70.89 ,66.31 
03,001,03,028,0988,2020,240,2,242,354,0,0,0,0,0,0,0,66.31 ,68.36 ,66.31 
03,001,03,028,0989,2021,226,3,229,318,0,0,0,0,0,0,0,66.31 ,72.01 ,66.31 
03,001,03,028,0989,2022,239,0,239,333,0,0,0,0,0,0,0,66.31 ,71.77 ,66.31 
03,001,03,028,0990,2023,173,0,173,278,0,0,0,0,0,0,0,66.31 ,62.23 ,66.31 
03,001,03,028,0990,2024,90,0,90,135,0,0,0,0,0,0,0,66.31 ,66.67 ,66.31 
03,001,03,029,0991,2025,585,8,593,943,0,0,0,0,0,0,0,66.31 ,62.88 ,66.31 
03,001,03,029,0992,2026,249,2,251,434,0,0,0,0,0,0,0,66.31 ,57.83 ,66.31 
03,001,03,029,0993,2027,266,7,273,422,0,0,0,0,0,0,0,66.31 ,64.69 ,66.31 
03,001,03,029,0994,2028,264,6,270,449,0,0,0,0,0,0,0,66.31 ,60.13 ,66.31 
03,001,03,029,0994,2029,223,2,225,350,0,0,0,0,0,0,0,66.31 ,64.29 ,66.31 
03,001,03,029,0995,2030,540,5,545,897,0,0,0,0,0,0,0,66.31 ,60.76 ,66.31 
03,001,03,029,0995,2031,357,3,360,617,0,0,0,0,0,0,0,66.31 ,58.35 ,66.31 
03,001,03,029,0996,2032,454,1,455,766,0,0,0,0,0,0,0,66.31 ,59.40 ,66.31 
03,001,03,029,0997,2033,387,1,388,632,0,0,0,0,0,0,0,66.31 ,61.39 ,66.31 
03,001,03,029,0998,2034,932,19,951,1524,0,0,0,0,0,0,0,66.31 ,62.40 ,66.31 
03,001,03,029,0999,2035,623,4,627,1052,0,0,0,0,0,0,0,66.31 ,59.60 ,66.31 
03,001,03,029,0999,2036,402,4,406,786,0,0,0,0,0,0,0,66.31 ,51.65 ,66.31 
03,001,03,029,1000,2037,244,3,247,402,0,0,0,0,0,0,0,66.31 ,61.44 ,66.31 
03,001,03,029,1000,2038,262,5,267,415,0,0,0,0,0,0,0,66.31 ,64.34 ,66.31 
03,001,03,029,1001,2039,256,4,260,453,0,0,0,0,0,0,0,66.31 ,57.40 ,66.31 
03,001,03,029,1001,2040,233,2,235,437,0,0,0,0,0,0,0,66.31 ,53.78 ,66.31 
03,002,01,001,0001,1,437,4,441,726,0,0,0,0,0,0,0,66.31 ,60.74 ,66.31 
03,002,01,001,0002,2,715,8,723,1154,0,0,0,0,0,0,0,66.31 ,62.65 ,66.31 
03,002,01,001,0002,3,577,7,584,916,0,0,0,0,0,0,0,66.31 ,63.76 ,66.31 
03,002,01,001,0003,4,677,7,684,1081,0,0,0,0,0,0,0,66.31 ,63.27 ,66.31 
03,002,01,001,0003,5,707,9,716,1128,0,0,0,0,0,0,0,66.31 ,63.48 ,66.31 
03,002,01,001,0004,6,726,14,740,1250,0,0,0,0,0,0,0,66.31 ,59.20 ,66.31 
03,002,01,001,0004,7,610,7,617,1041,0,0,0,0,0,0,0,66.31 ,59.27 ,66.31 
03,002,01,001,0005,8,617,9,626,962,0,0,0,0,0,0,0,66.31 ,65.07 ,66.31 
03,002,01,001,0005,9,467,4,471,732,0,0,0,0,0,0,0,66.31 ,64.34 ,66.31 
03,002,01,001,0005,10,619,6,625,1027,0,0,0,0,0,0,0,66.31 ,60.86 ,66.31 
03,002,01,001,0006,11,1141,13,1154,1991,0,0,0,0,0,0,0,66.31 ,57.96 ,66.31 
03,002,01,001,0006,12,782,6,788,1402,0,0,0,0,0,0,0,66.31 ,56.21 ,66.31 
03,002,01,001,0007,13,725,7,732,1152,0,0,0,0,0,0,0,66.31 ,63.54 ,66.31 
03,002,01,001,0007,14,739,6,745,1246,0,0,0,0,0,0,0,66.31 ,59.79 ,66.31 
03,002,01,001,0008,15,452,3,455,743,0,0,0,0,0,0,0,66.31 ,61.24 ,66.31 
03,002,01,001,0009,16,314,7,321,472,0,0,0,0,0,0,0,66.31 ,68.01 ,66.31 
03,002,01,001,0010,17,491,5,496,729,0,0,0,0,0,0,0,66.31 ,68.04 ,66.31 
03,002,01,001,0011,18,321,5,326,569,0,0,0,0,0,0,0,66.31 ,57.29 ,66.31 
03,002,01,001,0012,19,362,5,367,613,0,0,0,0,0,0,0,66.31 ,59.87 ,66.31 
03,002,01,001,0013,20,492,6,498,799,0,0,0,0,0,0,0,66.31 ,62.33 ,66.31 
03,002,01,001,0013,21,694,5,699,1204,0,0,0,0,0,0,0,66.31 ,58.06 ,66.31 
03,002,01,001,0014,22,400,3,403,619,0,0,0,0,0,0,0,66.31 ,65.11 ,66.31 
03,002,01,001,0014,23,443,7,450,741,0,0,0,0,0,0,0,66.31 ,60.73 ,66.31 
03,002,01,001,0015,24,656,3,659,1035,0,0,0,0,0,0,0,66.31 ,63.67 ,66.31 
03,002,01,001,0015,25,764,6,770,1277,0,0,0,0,0,0,0,66.31 ,60.30 ,66.31 
03,002,01,001,0015,26,384,5,389,615,0,0,0,0,0,0,0,66.31 ,63.25 ,66.31 
03,002,01,001,0015,27,744,11,755,1156,0,0,0,0,0,0,0,66.31 ,65.31 ,66.31 
03,002,01,001,0016,28,334,2,336,597,0,0,0,0,0,0,0,66.31 ,56.28 ,66.31 
03,002,01,001,0017,29,715,4,719,1127,0,0,0,0,0,0,0,66.31 ,63.80 ,66.31 
03,002,01,001,0018,30,444,5,449,757,0,0,0,0,0,0,0,66.31 ,59.31 ,66.31 
03,002,01,001,0019,31,664,8,672,1140,0,0,0,0,0,0,0,66.31 ,58.95 ,66.31 
03,002,01,001,0020,32,677,5,682,1140,0,0,0,0,0,0,0,66.31 ,59.82 ,66.31 
03,002,01,001,0021,33,609,3,612,968,0,0,0,0,0,0,0,66.31 ,63.22 ,66.31 
03,002,01,001,0021,34,590,9,599,967,0,0,0,0,0,0,0,66.31 ,61.94 ,66.31 
03,002,01,001,0021,35,693,7,700,1172,0,0,0,0,0,0,0,66.31 ,59.73 ,66.31 
03,002,01,001,0022,36,647,7,654,1004,0,0,0,0,0,0,0,66.31 ,65.14 ,66.31 
03,002,01,001,0022,37,740,10,750,1265,0,0,0,0,0,0,0,66.31 ,59.29 ,66.31 
03,002,01,001,0022,38,599,8,607,1063,0,0,0,0,0,0,0,66.31 ,57.10 ,66.31 
03,002,01,001,0023,39,686,6,692,1137,0,0,0,0,0,0,0,66.31 ,60.86 ,66.31 
03,002,01,001,0024,40,626,4,630,1188,0,0,0,0,0,0,0,66.31 ,53.03 ,66.31 
03,002,01,001,0024,41,756,8,764,1308,0,0,0,0,0,0,0,66.31 ,58.41 ,66.31 
03,002,01,001,0024,42,750,6,756,1372,0,0,0,0,0,0,0,66.31 ,55.10 ,66.31 
03,002,01,001,0025,43,418,5,423,654,0,0,0,0,0,0,0,66.31 ,64.68 ,66.31 
03,002,01,001,0026,44,361,3,364,582,0,0,0,0,0,0,0,66.31 ,62.54 ,66.31 
03,002,01,001,0027,45,414,4,418,645,0,0,0,0,0,0,0,66.31 ,64.81 ,66.31 
03,002,01,001,0028,46,768,8,776,1264,0,0,0,0,0,0,0,66.31 ,61.39 ,66.31 
03,002,01,001,0029,47,787,10,797,1336,0,0,0,0,0,0,0,66.31 ,59.66 ,66.31 
03,002,01,001,0030,48,681,9,690,1070,0,0,0,0,0,0,0,66.31 ,64.49 ,66.31 
03,002,01,001,0031,49,777,3,780,1270,0,0,0,0,0,0,0,66.31 ,61.42 ,66.31 
03,002,01,001,0031,50,499,6,505,801,0,0,0,0,0,0,0,66.31 ,63.05 ,66.31 
03,002,01,001,0032,51,927,6,933,1671,0,0,0,0,0,0,0,66.31 ,55.83 ,66.31 
03,002,01,001,0033,52,825,10,835,1308,0,0,0,0,0,0,0,66.31 ,63.84 ,66.31 
03,002,01,001,0034,53,878,8,886,1336,0,0,0,0,0,0,0,66.31 ,66.32 ,66.31 
03,002,01,001,0034,54,613,6,619,1015,0,0,0,0,0,0,0,66.31 ,60.99 ,66.31 
03,002,01,001,0035,55,573,6,579,896,0,0,0,0,0,0,0,66.31 ,64.62 ,66.31 
03,002,01,001,0036,56,513,5,518,816,0,0,0,0,0,0,0,66.31 ,63.48 ,66.31 
03,002,01,001,0037,57,498,2,500,812,0,0,0,0,0,0,0,66.31 ,61.58 ,66.31 
03,002,01,001,0038,58,817,6,823,1241,0,0,0,0,0,0,0,66.31 ,66.32 ,66.31 
03,002,01,001,0039,59,540,8,548,848,0,0,0,0,0,0,0,66.31 ,64.62 ,66.31 
03,002,01,001,0040,60,777,8,785,1283,0,0,0,0,0,0,0,66.31 ,61.18 ,66.31 
03,002,01,002,0041,61,304,2,306,493,0,0,0,0,0,0,0,66.31 ,62.07 ,66.31 
03,002,01,002,0042,62,366,0,366,539,0,0,0,0,0,0,0,66.31 ,67.90 ,66.31 
03,002,01,002,0043,63,302,1,303,530,0,0,0,0,0,0,0,66.31 ,57.17 ,66.31 
03,002,01,002,0044,64,633,4,637,1171,0,0,0,0,0,0,0,66.31 ,54.40 ,66.31 
03,002,01,002,0045,65,468,7,475,792,0,0,0,0,0,0,0,66.31 ,59.97 ,66.31 
03,002,01,002,0045,66,569,8,577,1066,0,0,0,0,0,0,0,66.31 ,54.13 ,66.31 
03,002,01,002,0046,67,622,4,626,997,0,0,0,0,0,0,0,66.31 ,62.79 ,66.31 
03,002,01,002,0046,68,502,6,508,883,0,0,0,0,0,0,0,66.31 ,57.53 ,66.31 
03,002,01,002,0047,69,839,4,843,1605,0,0,0,0,0,0,0,66.31 ,52.52 ,66.31 
03,002,01,002,0048,70,634,6,640,1145,0,0,0,0,0,0,0,66.31 ,55.90 ,66.31 
03,002,01,002,0048,71,480,5,485,886,0,0,0,0,0,0,0,66.31 ,54.74 ,66.31 
03,002,01,002,0049,72,852,8,860,1355,0,0,0,0,0,0,0,66.31 ,63.47 ,66.31 
03,002,01,002,0050,73,709,6,715,1202,0,0,0,0,0,0,0,66.31 ,59.48 ,66.31 
03,002,01,002,0051,74,520,1,521,838,0,0,0,0,0,0,0,66.31 ,62.17 ,66.31 
03,002,01,002,0052,75,405,5,410,685,0,0,0,0,0,0,0,66.31 ,59.85 ,66.31 
03,002,01,002,0053,76,536,5,541,892,0,0,0,0,0,0,0,66.31 ,60.65 ,66.31 
03,002,01,002,0054,77,418,2,420,674,0,0,0,0,0,0,0,66.31 ,62.31 ,66.31 
03,002,01,002,0055,78,445,3,448,741,0,0,0,0,0,0,0,66.31 ,60.46 ,66.31 
03,002,01,002,0056,79,618,7,625,1044,0,0,0,0,0,0,0,66.31 ,59.87 ,66.31 
03,002,01,002,0056,80,746,5,751,1345,0,0,0,0,0,0,0,66.31 ,55.84 ,66.31 
03,002,01,002,0056,81,598,7,605,1064,0,0,0,0,0,0,0,66.31 ,56.86 ,66.31 
03,002,01,002,0057,82,487,2,489,890,0,0,0,0,0,0,0,66.31 ,54.94 ,66.31 
03,002,01,002,0057,83,702,9,711,1236,0,0,0,0,0,0,0,66.31 ,57.52 ,66.31 
03,002,01,002,0057,84,593,9,602,1013,0,0,0,0,0,0,0,66.31 ,59.43 ,66.31 
03,002,01,002,0057,85,697,7,704,1223,0,0,0,0,0,0,0,66.31 ,57.56 ,66.31 
03,002,01,002,0058,86,932,7,939,1573,0,0,0,0,0,0,0,66.31 ,59.69 ,66.31 
03,002,01,002,0058,87,806,7,813,1366,0,0,0,0,0,0,0,66.31 ,59.52 ,66.31 
03,002,01,002,0058,88,921,3,924,1584,0,0,0,0,0,0,0,66.31 ,58.33 ,66.31 
03,002,01,002,0059,89,721,6,727,1312,0,0,0,0,0,0,0,66.31 ,55.41 ,66.31 
03,002,01,002,0059,90,540,5,545,960,0,0,0,0,0,0,0,66.31 ,56.77 ,66.31 
03,002,01,002,0059,91,583,4,587,997,0,0,0,0,0,0,0,66.31 ,58.88 ,66.31 
03,002,01,002,0060,92,535,6,541,934,0,0,0,0,0,0,0,66.31 ,57.92 ,66.31 
03,002,01,002,0060,93,465,2,467,791,0,0,0,0,0,0,0,66.31 ,59.04 ,66.31 
03,002,01,002,0061,94,557,4,561,972,0,0,0,0,0,0,0,66.31 ,57.72 ,66.31 
03,002,01,002,0062,95,787,12,799,1376,0,0,0,0,0,0,0,66.31 ,58.07 ,66.31 
03,002,01,002,0062,96,739,5,744,1312,0,0,0,0,0,0,0,66.31 ,56.71 ,66.31 
03,002,01,002,0063,97,960,6,966,1588,0,0,0,0,0,0,0,66.31 ,60.83 ,66.31 
03,002,01,002,0063,98,811,5,816,1467,0,0,0,0,0,0,0,66.31 ,55.62 ,66.31 
03,002,01,002,0064,99,784,8,792,1289,0,0,0,0,0,0,0,66.31 ,61.44 ,66.31 
03,002,01,002,0064,100,680,7,687,1201,0,0,0,0,0,0,0,66.31 ,57.20 ,66.31 
03,002,01,002,0065,101,668,8,676,1068,0,0,0,0,0,0,0,66.31 ,63.30 ,66.31 
03,002,01,002,0065,102,635,5,640,1115,0,0,0,0,0,0,0,66.31 ,57.40 ,66.31 
03,002,01,003,0066,103,388,1,389,663,0,0,0,0,0,0,0,66.31 ,58.67 ,66.31 
03,002,01,003,0066,104,577,7,584,1120,0,0,0,0,0,0,0,66.31 ,52.14 ,66.31 
03,002,01,003,0066,105,629,3,632,1111,0,0,0,0,0,0,0,66.31 ,56.89 ,66.31 
03,002,01,003,0067,106,448,3,451,718,0,0,0,0,0,0,0,66.31 ,62.81 ,66.31 
03,002,01,003,0068,107,898,6,904,1537,0,0,0,0,0,0,0,66.31 ,58.82 ,66.31 
03,002,01,003,0068,108,734,5,739,1241,0,0,0,0,0,0,0,66.31 ,59.55 ,66.31 
03,002,01,003,0069,109,415,1,416,649,0,0,0,0,0,0,0,66.31 ,64.10 ,66.31 
03,002,01,003,0069,110,286,3,289,419,0,0,0,0,0,0,0,66.31 ,68.97 ,66.31 
03,002,01,003,0070,111,450,7,457,824,0,0,0,0,0,0,0,66.31 ,55.46 ,66.31 
03,002,01,003,0070,112,280,1,281,454,0,0,0,0,0,0,0,66.31 ,61.89 ,66.31 
03,002,01,003,0071,113,135,5,140,342,0,0,0,0,0,0,0,66.31 ,40.94 ,66.31 
03,002,01,003,0072,114,578,10,588,996,0,0,0,0,0,0,0,66.31 ,59.04 ,66.31 
03,002,01,003,0072,115,550,5,555,999,0,0,0,0,0,0,0,66.31 ,55.56 ,66.31 
03,002,01,003,0073,116,631,6,637,1070,0,0,0,0,0,0,0,66.31 ,59.53 ,66.31 
03,002,01,003,0074,117,673,4,677,1277,0,0,0,0,0,0,0,66.31 ,53.01 ,66.31 
03,002,01,003,0074,118,653,5,658,1175,0,0,0,0,0,0,0,66.31 ,56.00 ,66.31 
03,002,01,003,0074,119,538,3,541,981,0,0,0,0,0,0,0,66.31 ,55.15 ,66.31 
03,002,01,003,0074,120,653,5,658,1187,0,0,0,0,0,0,0,66.31 ,55.43 ,66.31 
03,002,01,003,0075,121,606,5,611,1107,0,0,0,0,0,0,0,66.31 ,55.19 ,66.31 
03,002,01,003,0075,122,643,3,646,1118,0,0,0,0,0,0,0,66.31 ,57.78 ,66.31 
03,002,01,003,0076,123,713,9,722,1237,0,0,0,0,0,0,0,66.31 ,58.37 ,66.31 
03,002,01,003,0077,124,347,4,351,601,0,0,0,0,0,0,0,66.31 ,58.40 ,66.31 
03,002,01,003,0078,125,311,4,315,576,0,0,0,0,0,0,0,66.31 ,54.69 ,66.31 
03,002,01,003,0079,126,347,3,350,621,0,0,0,0,0,0,0,66.31 ,56.36 ,66.31 
03,002,01,003,0080,127,376,5,381,584,0,0,0,0,0,0,0,66.31 ,65.24 ,66.31 
03,002,01,003,0081,128,360,5,365,668,0,0,0,0,0,0,0,66.31 ,54.64 ,66.31 
03,002,01,003,0082,129,342,2,344,545,0,0,0,0,0,0,0,66.31 ,63.12 ,66.31 
03,002,01,003,0083,130,651,8,659,1141,0,0,0,0,0,0,0,66.31 ,57.76 ,66.31 
03,002,01,003,0084,131,629,4,633,1115,0,0,0,0,0,0,0,66.31 ,56.77 ,66.31 
03,002,01,003,0085,132,701,6,707,1260,0,0,0,0,0,0,0,66.31 ,56.11 ,66.31 
03,002,01,003,0086,133,481,1,482,896,0,0,0,0,0,0,0,66.31 ,53.79 ,66.31 
03,002,01,003,0086,134,386,6,392,811,0,0,0,0,0,0,0,66.31 ,48.34 ,66.31 
03,002,01,003,0087,135,650,7,657,1176,0,0,0,0,0,0,0,66.31 ,55.87 ,66.31 
03,002,01,003,0088,136,674,8,682,1324,0,0,0,0,0,0,0,66.31 ,51.51 ,66.31 
03,002,01,003,0089,137,192,3,195,350,0,0,0,0,0,0,0,66.31 ,55.71 ,66.31 
03,002,01,003,0090,138,435,13,448,836,0,0,0,0,0,0,0,66.31 ,53.59 ,66.31 
03,002,01,003,0091,139,267,9,276,511,0,0,0,0,0,0,0,66.31 ,54.01 ,66.31 
03,002,01,003,0091,140,165,5,170,274,0,0,0,0,0,0,0,66.31 ,62.04 ,66.31 
03,002,01,004,0092,141,208,2,210,393,0,0,0,0,0,0,0,66.31 ,53.44 ,66.31 
03,002,01,004,0093,142,294,1,295,694,0,0,0,0,0,0,0,66.31 ,42.51 ,66.31 
03,002,01,004,0094,143,658,9,667,1495,0,0,0,0,0,0,0,66.31 ,44.62 ,66.31 
03,002,01,004,0095,144,207,6,213,392,0,0,0,0,0,0,0,66.31 ,54.34 ,66.31 
03,002,01,004,0096,145,740,12,752,1350,0,0,0,0,0,0,0,66.31 ,55.70 ,66.31 
03,002,01,004,0097,146,476,3,479,829,0,0,0,0,0,0,0,66.31 ,57.78 ,66.31 
03,002,01,004,0098,147,378,11,389,628,0,0,0,0,0,0,0,66.31 ,61.94 ,66.31 
03,002,01,004,0099,148,863,12,875,1345,0,0,0,0,0,0,0,66.31 ,65.06 ,66.31 
03,002,01,004,0100,149,699,7,706,1091,0,0,0,0,0,0,0,66.31 ,64.71 ,66.31 
03,002,01,004,0101,150,518,2,520,741,0,0,0,0,0,0,0,66.31 ,70.18 ,66.31 
03,002,01,004,0102,151,358,4,362,590,0,0,0,0,0,0,0,66.31 ,61.36 ,66.31 
03,002,01,004,0103,152,460,3,463,664,0,0,0,0,0,0,0,66.31 ,69.73 ,66.31 
03,002,01,004,0104,153,408,2,410,596,0,0,0,0,0,0,0,66.31 ,68.79 ,66.31 
03,002,01,004,0105,154,518,4,522,927,0,0,0,0,0,0,0,66.31 ,56.31 ,66.31 
03,002,01,004,0105,155,586,5,591,978,0,0,0,0,0,0,0,66.31 ,60.43 ,66.31 
03,002,01,004,0106,156,1086,8,1094,1754,0,0,0,0,0,0,0,66.31 ,62.37 ,66.31 
03,002,01,004,0107,157,788,5,793,1291,0,0,0,0,0,0,0,66.31 ,61.43 ,66.31 
03,002,01,004,0108,158,591,6,597,974,0,0,0,0,0,0,0,66.31 ,61.29 ,66.31 
03,002,01,004,0109,159,977,6,983,1569,0,0,0,0,0,0,0,66.31 ,62.65 ,66.31 
03,002,01,004,0110,160,390,3,393,694,0,0,0,0,0,0,0,66.31 ,56.63 ,66.31 
03,002,01,004,0111,161,863,10,873,1303,0,0,0,0,0,0,0,66.31 ,67.00 ,66.31 
03,002,01,004,0112,162,585,2,587,915,0,0,0,0,0,0,0,66.31 ,64.15 ,66.31 
03,002,01,004,0113,163,615,12,627,949,0,0,0,0,0,0,0,66.31 ,66.07 ,66.31 
03,002,01,004,0114,164,648,10,658,1053,0,0,0,0,0,0,0,66.31 ,62.49 ,66.31 
03,002,01,005,0115,165,815,6,821,1412,0,0,0,0,0,0,0,66.31 ,58.14 ,66.31 
03,002,01,005,0116,166,1017,15,1032,1607,0,0,0,0,0,0,0,66.31 ,64.22 ,66.31 
03,002,01,005,0117,167,1040,13,1053,1720,0,0,0,0,0,0,0,66.31 ,61.22 ,66.31 
03,002,01,005,0117,168,967,10,977,1649,0,0,0,0,0,0,0,66.31 ,59.25 ,66.31 
03,002,01,005,0118,169,761,11,772,1207,0,0,0,0,0,0,0,66.31 ,63.96 ,66.31 
03,002,01,005,0118,170,497,1,498,744,0,0,0,0,0,0,0,66.31 ,66.94 ,66.31 
03,002,01,005,0119,171,444,3,447,664,0,0,0,0,0,0,0,66.31 ,67.32 ,66.31 
03,002,01,005,0120,172,869,9,878,1341,0,0,0,0,0,0,0,66.31 ,65.47 ,66.31 
03,002,01,005,0121,173,705,5,710,1114,0,0,0,0,0,0,0,66.31 ,63.73 ,66.31 
03,002,01,005,0122,174,826,8,834,1331,0,0,0,0,0,0,0,66.31 ,62.66 ,66.31 
03,002,01,005,0123,175,515,7,522,822,0,0,0,0,0,0,0,66.31 ,63.50 ,66.31 
03,002,01,005,0123,176,576,5,581,970,0,0,0,0,0,0,0,66.31 ,59.90 ,66.31 
03,002,01,005,0124,177,877,6,883,1368,0,0,0,0,0,0,0,66.31 ,64.55 ,66.31 
03,002,01,005,0124,178,502,6,508,869,0,0,0,0,0,0,0,66.31 ,58.46 ,66.31 
03,002,01,005,0125,179,632,11,643,1048,0,0,0,0,0,0,0,66.31 ,61.35 ,66.31 
03,002,01,005,0126,180,409,5,414,655,0,0,0,0,0,0,0,66.31 ,63.21 ,66.31 
03,002,01,005,0127,181,532,9,541,893,0,0,0,0,0,0,0,66.31 ,60.58 ,66.31 
03,002,01,005,0128,182,640,7,647,1068,0,0,0,0,0,0,0,66.31 ,60.58 ,66.31 
03,002,01,005,0129,183,673,6,679,1002,0,0,0,0,0,0,0,66.31 ,67.76 ,66.31 
03,002,01,005,0129,184,725,3,728,1131,0,0,0,0,0,0,0,66.31 ,64.37 ,66.31 
03,002,01,005,0130,185,790,11,801,1347,0,0,0,0,0,0,0,66.31 ,59.47 ,66.31 
03,002,01,005,0130,186,759,7,766,1283,0,0,0,0,0,0,0,66.31 ,59.70 ,66.31 
03,002,01,005,0131,187,545,7,552,889,0,0,0,0,0,0,0,66.31 ,62.09 ,66.31 
03,002,01,005,0132,188,231,4,235,406,0,0,0,0,0,0,0,66.31 ,57.88 ,66.31 
03,002,01,006,0133,189,779,7,786,1329,0,0,0,0,0,0,0,66.31 ,59.14 ,66.31 
03,002,01,006,0133,190,764,6,770,1256,0,0,0,0,0,0,0,66.31 ,61.31 ,66.31 
03,002,01,006,0134,191,480,6,486,802,0,0,0,0,0,0,0,66.31 ,60.60 ,66.31 
03,002,01,006,0134,192,462,4,466,771,0,0,0,0,0,0,0,66.31 ,60.44 ,66.31 
03,002,01,006,0135,193,560,4,564,852,0,0,0,0,0,0,0,66.31 ,66.20 ,66.31 
03,002,01,006,0136,194,527,3,530,948,0,0,0,0,0,0,0,66.31 ,55.91 ,66.31 
03,002,01,006,0137,195,427,4,431,752,0,0,0,0,0,0,0,66.31 ,57.31 ,66.31 
03,002,01,006,0137,196,462,5,467,783,0,0,0,0,0,0,0,66.31 ,59.64 ,66.31 
03,002,01,006,0138,197,471,4,475,801,0,0,0,0,0,0,0,66.31 ,59.30 ,66.31 
03,002,01,006,0138,198,420,5,425,680,0,0,0,0,0,0,0,66.31 ,62.50 ,66.31 
03,002,01,006,0139,199,472,5,477,811,0,0,0,0,0,0,0,66.31 ,58.82 ,66.31 
03,002,01,006,0140,200,465,2,467,749,0,0,0,0,0,0,0,66.31 ,62.35 ,66.31 
03,002,01,006,0140,201,729,7,736,1146,0,0,0,0,0,0,0,66.31 ,64.22 ,66.31 
03,002,01,006,0141,202,754,6,760,1211,0,0,0,0,0,0,0,66.31 ,62.76 ,66.31 
03,002,01,006,0142,203,605,4,609,986,0,0,0,0,0,0,0,66.31 ,61.76 ,66.31 
03,002,01,006,0143,204,688,5,693,1112,0,0,0,0,0,0,0,66.31 ,62.32 ,66.31 
03,002,01,006,0143,205,514,6,520,760,0,0,0,0,0,0,0,66.31 ,68.42 ,66.31 
03,002,01,006,0144,206,620,2,622,1045,0,0,0,0,0,0,0,66.31 ,59.52 ,66.31 
03,002,01,006,0145,207,462,6,468,769,0,0,0,0,0,0,0,66.31 ,60.86 ,66.31 
03,002,01,006,0145,208,477,1,478,763,0,0,0,0,0,0,0,66.31 ,62.65 ,66.31 
03,002,01,007,0146,209,781,7,788,1431,0,0,0,0,0,0,0,66.31 ,55.07 ,66.31 
03,002,01,007,0146,210,738,6,744,1267,0,0,0,0,0,0,0,66.31 ,58.72 ,66.31 
03,002,01,007,0146,211,748,6,754,1332,0,0,0,0,0,0,0,66.31 ,56.61 ,66.31 
03,002,01,007,0147,212,444,1,445,842,0,0,0,0,0,0,0,66.31 ,52.85 ,66.31 
03,002,01,007,0147,213,559,9,568,990,0,0,0,0,0,0,0,66.31 ,57.37 ,66.31 
03,002,01,007,0148,214,712,15,727,1157,0,0,0,0,0,0,0,66.31 ,62.83 ,66.31 
03,002,01,007,0149,215,530,5,535,914,0,0,0,0,0,0,0,66.31 ,58.53 ,66.31 
03,002,01,007,0150,216,743,12,755,1357,0,0,0,0,0,0,0,66.31 ,55.64 ,66.31 
03,002,01,007,0151,217,527,11,538,1084,0,0,0,0,0,0,0,66.31 ,49.63 ,66.31 
03,002,01,007,0152,218,568,7,575,979,0,0,0,0,0,0,0,66.31 ,58.73 ,66.31 
03,002,01,007,0152,219,306,8,314,517,0,0,0,0,0,0,0,66.31 ,60.74 ,66.31 
03,002,01,007,0153,220,220,4,224,475,0,0,0,0,0,0,0,66.31 ,47.16 ,66.31 
03,002,01,007,0153,221,149,3,152,285,0,0,0,0,0,0,0,66.31 ,53.33 ,66.31 
03,002,01,007,0154,222,854,10,864,1560,0,0,0,0,0,0,0,66.31 ,55.38 ,66.31 
03,002,01,007,0155,223,604,12,616,1046,0,0,0,0,0,0,0,66.31 ,58.89 ,66.31 
03,002,01,007,0156,224,948,11,959,1536,0,0,0,0,0,0,0,66.31 ,62.43 ,66.31 
03,002,01,007,0156,225,295,3,298,530,0,0,0,0,0,0,0,66.31 ,56.23 ,66.31 
03,002,01,007,0157,226,819,16,835,1328,0,0,0,0,0,0,0,66.31 ,62.88 ,66.31 
03,002,01,007,0157,227,530,7,537,968,0,0,0,0,0,0,0,66.31 ,55.48 ,66.31 
03,002,01,007,0158,228,446,7,453,878,0,0,0,0,0,0,0,66.31 ,51.59 ,66.31 
03,002,01,007,0159,229,463,6,469,837,0,0,0,0,0,0,0,66.31 ,56.03 ,66.31 
03,002,01,007,0160,230,554,7,561,954,0,0,0,0,0,0,0,66.31 ,58.81 ,66.31 
03,002,01,007,0161,231,836,6,842,1525,0,0,0,0,0,0,0,66.31 ,55.21 ,66.31 
03,002,01,008,0162,232,670,2,672,1088,0,0,0,0,0,0,0,66.31 ,61.76 ,66.31 
03,002,01,008,0163,233,693,8,701,1165,0,0,0,0,0,0,0,66.31 ,60.17 ,66.31 
03,002,01,008,0164,234,544,5,549,946,0,0,0,0,0,0,0,66.31 ,58.03 ,66.31 
03,002,01,008,0165,235,465,6,471,804,0,0,0,0,0,0,0,66.31 ,58.58 ,66.31 
03,002,01,008,0166,236,614,4,618,924,0,0,0,0,0,0,0,66.31 ,66.88 ,66.31 
03,002,01,008,0167,237,678,3,681,1162,0,0,0,0,0,0,0,66.31 ,58.61 ,66.31 
03,002,01,008,0168,238,623,4,627,999,0,0,0,0,0,0,0,66.31 ,62.76 ,66.31 
03,002,01,008,0168,239,483,2,485,831,0,0,0,0,0,0,0,66.31 ,58.36 ,66.31 
03,002,01,008,0169,240,520,6,526,813,0,0,0,0,0,0,0,66.31 ,64.70 ,66.31 
03,002,01,008,0169,241,526,4,530,917,0,0,0,0,0,0,0,66.31 ,57.80 ,66.31 
03,002,01,008,0170,242,541,2,543,843,0,0,0,0,0,0,0,66.31 ,64.41 ,66.31 
03,002,01,008,0171,243,423,4,427,712,0,0,0,0,0,0,0,66.31 ,59.97 ,66.31 
03,002,01,008,0172,244,802,2,804,1290,0,0,0,0,0,0,0,66.31 ,62.33 ,66.31 
03,002,01,008,0173,245,497,1,498,813,0,0,0,0,0,0,0,66.31 ,61.25 ,66.31 
03,002,01,008,0174,246,758,6,764,1242,0,0,0,0,0,0,0,66.31 ,61.51 ,66.31 
03,002,01,008,0175,247,250,1,251,424,0,0,0,0,0,0,0,66.31 ,59.20 ,66.31 
03,002,01,008,0176,248,645,6,651,1235,0,0,0,0,0,0,0,66.31 ,52.71 ,66.31 
03,002,01,008,0176,249,752,4,756,1422,0,0,0,0,0,0,0,66.31 ,53.16 ,66.31 
03,002,01,008,0176,250,737,5,742,1415,0,0,0,0,0,0,0,66.31 ,52.44 ,66.31 
03,002,01,008,0177,251,514,4,518,917,0,0,0,0,0,0,0,66.31 ,56.49 ,66.31 
03,002,01,008,0177,252,545,3,548,996,0,0,0,0,0,0,0,66.31 ,55.02 ,66.31 
03,002,01,008,0178,253,641,6,647,1152,0,0,0,0,0,0,0,66.31 ,56.16 ,66.31 
03,002,01,008,0178,254,577,11,588,1062,0,0,0,0,0,0,0,66.31 ,55.37 ,66.31 
03,002,01,008,0178,255,737,5,742,1231,0,0,0,0,0,0,0,66.31 ,60.28 ,66.31 
03,002,01,008,0178,256,586,5,591,963,0,0,0,0,0,0,0,66.31 ,61.37 ,66.31 
03,002,01,008,0179,257,730,11,741,1260,0,0,0,0,0,0,0,66.31 ,58.81 ,66.31 
03,002,01,008,0179,258,745,6,751,1276,0,0,0,0,0,0,0,66.31 ,58.86 ,66.31 
03,002,01,008,0180,259,525,7,532,978,0,0,0,0,0,0,0,66.31 ,54.40 ,66.31 
03,002,01,008,0180,260,653,10,663,1152,0,0,0,0,0,0,0,66.31 ,57.55 ,66.31 
03,002,01,008,0181,261,541,12,553,1033,0,0,0,0,0,0,0,66.31 ,53.53 ,66.31 
03,002,01,008,0182,262,583,2,585,1054,0,0,0,0,0,0,0,66.31 ,55.50 ,66.31 
03,002,01,008,0182,263,616,6,622,1109,0,0,0,0,0,0,0,66.31 ,56.09 ,66.31 
03,002,01,008,0183,264,670,8,678,1169,0,0,0,0,0,0,0,66.31 ,58.00 ,66.31 
03,002,01,008,0184,265,541,4,545,936,0,0,0,0,0,0,0,66.31 ,58.23 ,66.31 
03,002,01,008,0185,266,443,3,446,795,0,0,0,0,0,0,0,66.31 ,56.10 ,66.31 
03,002,01,009,0186,267,982,7,989,1573,0,0,0,0,0,0,0,66.31 ,62.87 ,66.31 
03,002,01,009,0187,268,859,8,867,1380,0,0,0,0,0,0,0,66.31 ,62.83 ,66.31 
03,002,01,009,0188,269,557,4,561,931,0,0,0,0,0,0,0,66.31 ,60.26 ,66.31 
03,002,01,009,0188,270,615,9,624,983,0,0,0,0,0,0,0,66.31 ,63.48 ,66.31 
03,002,01,009,0189,271,859,10,869,1425,0,0,0,0,0,0,0,66.31 ,60.98 ,66.31 
03,002,01,009,0190,272,602,5,607,973,0,0,0,0,0,0,0,66.31 ,62.38 ,66.31 
03,002,01,009,0191,273,555,3,558,921,0,0,0,0,0,0,0,66.31 ,60.59 ,66.31 
03,002,01,009,0191,274,677,5,682,1150,0,0,0,0,0,0,0,66.31 ,59.30 ,66.31 
03,002,01,009,0192,275,926,5,931,1472,0,0,0,0,0,0,0,66.31 ,63.25 ,66.31 
03,002,01,009,0193,276,864,2,866,1346,0,0,0,0,0,0,0,66.31 ,64.34 ,66.31 
03,002,01,009,0193,277,618,3,621,1115,0,0,0,0,0,0,0,66.31 ,55.70 ,66.31 
03,002,01,009,0194,278,951,7,958,1528,0,0,0,0,0,0,0,66.31 ,62.70 ,66.31 
03,002,01,009,0194,279,695,3,698,1127,0,0,0,0,0,0,0,66.31 ,61.93 ,66.31 
03,002,01,009,0195,280,830,7,837,1305,0,0,0,0,0,0,0,66.31 ,64.14 ,66.31 
03,002,01,009,0195,281,446,7,453,828,0,0,0,0,0,0,0,66.31 ,54.71 ,66.31 
03,002,01,009,0196,282,792,7,799,1267,0,0,0,0,0,0,0,66.31 ,63.06 ,66.31 
03,002,01,009,0197,283,881,10,891,1452,0,0,0,0,0,0,0,66.31 ,61.36 ,66.31 
03,002,01,009,0198,284,616,3,619,1019,0,0,0,0,0,0,0,66.31 ,60.75 ,66.31 
03,002,01,009,0198,285,566,3,569,976,0,0,0,0,0,0,0,66.31 ,58.30 ,66.31 
03,002,01,009,0199,286,872,12,884,1595,0,0,0,0,0,0,0,66.31 ,55.42 ,66.31 
03,002,01,009,0199,287,371,3,374,710,0,0,0,0,0,0,0,66.31 ,52.68 ,66.31 
03,002,01,009,0200,288,728,8,736,1307,0,0,0,0,0,0,0,66.31 ,56.31 ,66.31 
03,002,01,009,0200,289,471,2,473,767,0,0,0,0,0,0,0,66.31 ,61.67 ,66.31 
03,002,01,010,0201,290,126,1,127,230,0,0,0,0,0,0,0,66.31 ,55.22 ,66.31 
03,002,01,010,0202,291,363,2,365,645,0,0,0,0,0,0,0,66.31 ,56.59 ,66.31 
03,002,01,010,0203,292,411,9,420,821,0,0,0,0,0,0,0,66.31 ,51.16 ,66.31 
03,002,01,010,0204,293,371,4,375,663,0,0,0,0,0,0,0,66.31 ,56.56 ,66.31 
03,002,01,010,0205,294,248,6,254,467,0,0,0,0,0,0,0,66.31 ,54.39 ,66.31 
03,002,01,010,0206,295,670,3,673,1108,0,0,0,0,0,0,0,66.31 ,60.74 ,66.31 
03,002,01,010,0207,296,647,10,657,1109,0,0,0,0,0,0,0,66.31 ,59.24 ,66.31 
03,002,01,010,0208,297,497,7,504,840,0,0,0,0,0,0,0,66.31 ,60.00 ,66.31 
03,002,01,010,0209,298,549,6,555,1060,0,0,0,0,0,0,0,66.31 ,52.36 ,66.31 
03,002,01,010,0210,299,825,10,835,1473,0,0,0,0,0,0,0,66.31 ,56.69 ,66.31 
03,002,01,010,0210,300,835,13,848,1429,0,0,0,0,0,0,0,66.31 ,59.34 ,66.31 
03,002,01,010,0211,301,369,4,373,657,0,0,0,0,0,0,0,66.31 ,56.77 ,66.31 
03,002,01,010,0212,302,284,8,292,535,0,0,0,0,0,0,0,66.31 ,54.58 ,66.31 
03,002,01,010,0213,303,247,4,251,488,0,0,0,0,0,0,0,66.31 ,51.43 ,66.31 
03,002,01,010,0214,304,378,2,380,647,0,0,0,0,0,0,0,66.31 ,58.73 ,66.31 
03,002,01,010,0215,305,663,5,668,1048,0,0,0,0,0,0,0,66.31 ,63.74 ,66.31 
03,002,01,010,0216,306,477,2,479,794,0,0,0,0,0,0,0,66.31 ,60.33 ,66.31 
03,002,01,010,0217,307,857,7,864,1247,0,0,0,0,0,0,0,66.31 ,69.29 ,66.31 
03,002,01,010,0218,308,682,5,687,1124,0,0,0,0,0,0,0,66.31 ,61.12 ,66.31 
03,002,01,011,0219,309,40,0,40,113,0,0,0,0,0,0,0,66.31 ,35.40 ,66.31 
03,002,01,011,0220,310,47,0,47,101,0,0,0,0,0,0,0,66.31 ,46.53 ,66.31 
03,002,01,011,0221,311,122,0,122,241,0,0,0,0,0,0,0,66.31 ,50.62 ,66.31 
03,002,01,011,0222,312,128,1,129,238,0,0,0,0,0,0,0,66.31 ,54.20 ,66.31 
03,002,01,011,0223,313,38,0,38,84,0,0,0,0,0,0,0,66.31 ,45.24 ,66.31 
03,002,01,011,0224,314,21,0,21,61,0,0,0,0,0,0,0,66.31 ,34.43 ,66.31 
03,002,01,011,0225,315,31,1,32,54,0,0,0,0,0,0,0,66.31 ,59.26 ,66.31 
03,002,01,011,0226,316,10,0,10,16,0,0,0,0,0,0,0,66.31 ,62.50 ,66.31 
03,002,01,011,0227,317,11,0,11,54,0,0,0,0,0,0,0,66.31 ,20.37 ,66.31 
03,002,01,011,0228,318,42,0,42,76,0,0,0,0,0,0,0,66.31 ,55.26 ,66.31 
03,002,01,012,0229,319,41,0,41,83,0,0,0,0,0,0,0,66.31 ,49.40 ,66.31 
03,002,01,012,0230,320,137,1,138,251,0,0,0,0,0,0,0,66.31 ,54.98 ,66.31 
03,002,01,012,0231,321,40,0,40,92,0,0,0,0,0,0,0,66.31 ,43.48 ,66.31 
03,002,01,012,0232,322,27,0,27,66,0,0,0,0,0,0,0,66.31 ,40.91 ,66.31 
03,002,01,012,0233,323,52,0,52,128,0,0,0,0,0,0,0,66.31 ,40.63 ,66.31 
03,002,01,012,0234,324,11,2,13,31,0,0,0,0,0,0,0,66.31 ,41.94 ,66.31 
03,002,01,012,0235,325,56,1,57,162,0,0,0,0,0,0,0,66.31 ,35.19 ,66.31 
03,003,01,001,0001,1,581,8,589,851,0,0,0,0,0,0,0,66.31 ,69.21 ,66.31 
03,003,01,001,0001,2,1215,13,1228,1916,0,0,0,0,0,0,0,66.31 ,64.09 ,66.31 
03,003,01,001,0001,3,925,9,934,1668,0,0,0,0,0,0,0,66.31 ,56.00 ,66.31 
03,003,01,001,0002,4,978,13,991,1669,0,0,0,0,0,0,0,66.31 ,59.38 ,66.31 
03,003,01,001,0002,5,888,14,902,1467,0,0,0,0,0,0,0,66.31 ,61.49 ,66.31 
03,003,01,001,0003,6,765,10,775,1228,0,0,0,0,0,0,0,66.31 ,63.11 ,66.31 
03,003,01,001,0003,7,759,10,769,1264,0,0,0,0,0,0,0,66.31 ,60.84 ,66.31 
03,003,01,001,0003,8,626,9,635,1078,0,0,0,0,0,0,0,66.31 ,58.91 ,66.31 
03,003,01,001,0004,9,881,12,893,1244,0,0,0,0,0,0,0,66.31 ,71.78 ,66.31 
03,003,01,001,0004,10,975,10,985,1583,0,0,0,0,0,0,0,66.31 ,62.22 ,66.31 
03,003,01,001,0004,11,827,12,839,1317,0,0,0,0,0,0,0,66.31 ,63.71 ,66.31 
03,003,01,001,0005,12,886,14,900,1471,0,0,0,0,0,0,0,66.31 ,61.18 ,66.31 
03,003,01,001,0005,13,1005,12,1017,1542,0,0,0,0,0,0,0,66.31 ,65.95 ,66.31 
03,003,01,001,0006,14,876,14,890,1416,0,0,0,0,0,0,0,66.31 ,62.85 ,66.31 
03,003,01,001,0006,15,882,13,895,1411,0,0,0,0,0,0,0,66.31 ,63.43 ,66.31 
03,003,01,001,0006,16,1147,12,1159,1830,0,0,0,0,0,0,0,66.31 ,63.33 ,66.31 
03,003,01,001,0007,17,891,15,906,1496,0,0,0,0,0,0,0,66.31 ,60.56 ,66.31 
03,003,01,001,0007,18,776,14,790,1290,0,0,0,0,0,0,0,66.31 ,61.24 ,66.31 
03,003,01,001,0007,19,678,7,685,1138,0,0,0,0,0,0,0,66.31 ,60.19 ,66.31 
03,003,01,001,0008,20,678,8,686,1088,0,0,0,0,0,0,0,66.31 ,63.05 ,66.31 
03,003,01,001,0008,21,700,10,710,1181,0,0,0,0,0,0,0,66.31 ,60.12 ,66.31 
03,003,01,001,0009,22,776,5,781,1190,0,0,0,0,0,0,0,66.31 ,65.63 ,66.31 
03,003,01,001,0009,23,364,2,366,657,0,0,0,0,0,0,0,66.31 ,55.71 ,66.31 
03,003,01,001,0010,24,594,8,602,917,0,0,0,0,0,0,0,66.31 ,65.65 ,66.31 
03,003,01,001,0011,25,841,9,850,1472,0,0,0,0,0,0,0,66.31 ,57.74 ,66.31 
03,003,01,001,0012,26,899,9,908,1369,0,0,0,0,0,0,0,66.31 ,66.33 ,66.31 
03,003,01,001,0013,27,495,1,496,843,0,0,0,0,0,0,0,66.31 ,58.84 ,66.31 
03,003,01,001,0014,28,913,5,918,1470,0,0,0,0,0,0,0,66.31 ,62.45 ,66.31 
03,003,01,001,0015,29,668,15,683,1022,0,0,0,0,0,0,0,66.31 ,66.83 ,66.31 
03,003,01,001,0016,30,710,8,718,1112,0,0,0,0,0,0,0,66.31 ,64.57 ,66.31 
03,003,01,001,0016,31,667,10,677,1195,0,0,0,0,0,0,0,66.31 ,56.65 ,66.31 
03,003,01,001,0016,32,639,6,645,1054,0,0,0,0,0,0,0,66.31 ,61.20 ,66.31 
03,003,01,001,0016,33,636,9,645,1029,0,0,0,0,0,0,0,66.31 ,62.68 ,66.31 
03,003,01,001,0017,34,944,7,951,1400,0,0,0,0,0,0,0,66.31 ,67.93 ,66.31 
03,003,01,001,0018,35,892,19,911,1426,0,0,0,0,0,0,0,66.31 ,63.88 ,66.31 
03,003,01,001,0019,36,731,10,741,1182,0,0,0,0,0,0,0,66.31 ,62.69 ,66.31 
03,003,01,001,0020,37,634,7,641,947,0,0,0,0,0,0,0,66.31 ,67.69 ,66.31 
03,003,01,001,0021,38,552,3,555,805,0,0,0,0,0,0,0,66.31 ,68.94 ,66.31 
03,003,01,001,0021,39,646,7,653,1005,0,0,0,0,0,0,0,66.31 ,64.98 ,66.31 
03,003,01,001,0022,40,949,11,960,1450,0,0,0,0,0,0,0,66.31 ,66.21 ,66.31 
03,003,01,001,0022,41,870,7,877,1356,0,0,0,0,0,0,0,66.31 ,64.68 ,66.31 
03,003,01,001,0022,42,925,6,931,1500,0,0,0,0,0,0,0,66.31 ,62.07 ,66.31 
03,003,01,001,0023,43,873,6,879,1355,0,0,0,0,0,0,0,66.31 ,64.87 ,66.31 
03,003,01,001,0023,44,920,10,930,1445,0,0,0,0,0,0,0,66.31 ,64.36 ,66.31 
03,003,01,001,0023,45,847,9,856,1370,0,0,0,0,0,0,0,66.31 ,62.48 ,66.31 
03,003,01,001,0024,46,739,8,747,1209,0,0,0,0,0,0,0,66.31 ,61.79 ,66.31 
03,003,01,001,0024,47,813,12,825,1456,0,0,0,0,0,0,0,66.31 ,56.66 ,66.31 
03,003,01,001,0025,48,794,6,800,1347,0,0,0,0,0,0,0,66.31 ,59.39 ,66.31 
03,003,01,001,0025,49,471,5,476,824,0,0,0,0,0,0,0,66.31 ,57.77 ,66.31 
03,003,01,001,0025,50,586,9,595,1008,0,0,0,0,0,0,0,66.31 ,59.03 ,66.31 
03,003,01,001,0026,51,802,14,816,1271,0,0,0,0,0,0,0,66.31 ,64.20 ,66.31 
03,003,01,001,0026,52,709,8,717,1381,0,0,0,0,0,0,0,66.31 ,51.92 ,66.31 
03,003,01,001,0026,53,444,8,452,780,0,0,0,0,0,0,0,66.31 ,57.95 ,66.31 
03,003,01,001,0027,54,839,8,847,1521,0,0,0,0,0,0,0,66.31 ,55.69 ,66.31 
03,003,01,001,0027,55,821,8,829,1420,0,0,0,0,0,0,0,66.31 ,58.38 ,66.31 
03,003,01,001,0028,56,869,6,875,1431,0,0,0,0,0,0,0,66.31 ,61.15 ,66.31 
03,003,01,001,0029,57,729,12,741,1296,0,0,0,0,0,0,0,66.31 ,57.18 ,66.31 
03,003,01,001,0029,58,813,11,824,1491,0,0,0,0,0,0,0,66.31 ,55.26 ,66.31 
03,003,01,001,0030,59,853,16,869,1379,0,0,0,0,0,0,0,66.31 ,63.02 ,66.31 
03,003,01,001,0030,60,669,13,682,1126,0,0,0,0,0,0,0,66.31 ,60.57 ,66.31 
03,003,01,001,0030,61,887,10,897,1268,0,0,0,0,0,0,0,66.31 ,70.74 ,66.31 
03,003,01,001,0031,62,712,9,721,1185,0,0,0,0,0,0,0,66.31 ,60.84 ,66.31 
03,003,01,001,0031,63,705,15,720,1165,0,0,0,0,0,0,0,66.31 ,61.80 ,66.31 
03,003,01,001,0031,64,824,9,833,1329,0,0,0,0,0,0,0,66.31 ,62.68 ,66.31 
03,003,01,001,0032,65,780,8,788,1278,0,0,0,0,0,0,0,66.31 ,61.66 ,66.31 
03,003,01,001,0032,66,774,18,792,1246,0,0,0,0,0,0,0,66.31 ,63.56 ,66.31 
03,003,01,001,0033,67,581,10,591,838,0,0,0,0,0,0,0,66.31 ,70.53 ,66.31 
03,003,01,001,0033,68,805,8,813,1266,0,0,0,0,0,0,0,66.31 ,64.22 ,66.31 
03,003,01,001,0033,69,298,3,301,534,0,0,0,0,0,0,0,66.31 ,56.37 ,66.31 
03,003,01,001,0034,70,733,11,744,1185,0,0,0,0,0,0,0,66.31 ,62.78 ,66.31 
03,003,01,001,0034,71,881,18,899,1454,0,0,0,0,0,0,0,66.31 ,61.83 ,66.31 
03,003,01,001,0034,72,793,15,808,1397,0,0,0,0,0,0,0,66.31 ,57.84 ,66.31 
03,003,01,001,0035,73,780,17,797,1245,0,0,0,0,0,0,0,66.31 ,64.02 ,66.31 
03,003,01,001,0035,74,1000,16,1016,1552,0,0,0,0,0,0,0,66.31 ,65.46 ,66.31 
03,003,01,001,0036,75,1047,19,1066,1433,0,0,0,0,0,0,0,66.31 ,74.39 ,66.31 
03,003,01,001,0036,76,783,7,790,1397,0,0,0,0,0,0,0,66.31 ,56.55 ,66.31 
03,003,01,001,0037,77,907,6,913,1521,0,0,0,0,0,0,0,66.31 ,60.03 ,66.31 
03,003,01,001,0038,78,674,3,677,1105,0,0,0,0,0,0,0,66.31 ,61.27 ,66.31 
03,003,01,001,0038,79,718,6,724,1254,0,0,0,0,0,0,0,66.31 ,57.74 ,66.31 
03,003,01,001,0039,80,656,5,661,1103,0,0,0,0,0,0,0,66.31 ,59.93 ,66.31 
03,003,01,001,0039,81,736,13,749,1220,0,0,0,0,0,0,0,66.31 ,61.39 ,66.31 
03,003,01,001,0039,82,771,12,783,1280,0,0,0,0,0,0,0,66.31 ,61.17 ,66.31 
03,003,01,001,0040,83,562,4,566,841,0,0,0,0,0,0,0,66.31 ,67.30 ,66.31 
03,003,01,001,0040,84,508,10,518,888,0,0,0,0,0,0,0,66.31 ,58.33 ,66.31 
03,003,01,001,0040,85,435,7,442,594,0,0,0,0,0,0,0,66.31 ,74.41 ,66.31 
03,003,01,001,0040,86,574,5,579,909,0,0,0,0,0,0,0,66.31 ,63.70 ,66.31 
03,003,01,001,0041,87,791,18,809,1293,0,0,0,0,0,0,0,66.31 ,62.57 ,66.31 
03,003,01,001,0041,88,706,10,716,1263,0,0,0,0,0,0,0,66.31 ,56.69 ,66.31 
03,003,01,001,0041,89,750,9,759,1223,0,0,0,0,0,0,0,66.31 ,62.06 ,66.31 
03,003,01,001,0042,90,739,8,747,1238,0,0,0,0,0,0,0,66.31 ,60.34 ,66.31 
03,003,01,001,0042,91,665,19,684,1172,0,0,0,0,0,0,0,66.31 ,58.36 ,66.31 
03,003,01,001,0042,92,652,7,659,1196,0,0,0,0,0,0,0,66.31 ,55.10 ,66.31 
03,003,01,001,0043,93,749,9,758,1179,0,0,0,0,0,0,0,66.31 ,64.29 ,66.31 
03,003,01,001,0043,94,779,3,782,1193,0,0,0,0,0,0,0,66.31 ,65.55 ,66.31 
03,003,01,001,0043,95,861,9,870,1352,0,0,0,0,0,0,0,66.31 ,64.35 ,66.31 
03,003,01,001,0044,96,737,6,743,1480,0,0,0,0,0,0,0,66.31 ,50.20 ,66.31 
03,003,01,001,0044,97,777,7,784,1337,0,0,0,0,0,0,0,66.31 ,58.64 ,66.31 
03,003,01,001,0044,98,821,11,832,1427,0,0,0,0,0,0,0,66.31 ,58.30 ,66.31 
03,003,01,001,0045,99,602,14,616,913,0,0,0,0,0,0,0,66.31 ,67.47 ,66.31 
03,003,01,001,0045,100,659,6,665,907,0,0,0,0,0,0,0,66.31 ,73.32 ,66.31 
03,003,01,001,0046,101,662,5,667,1203,0,0,0,0,0,0,0,66.31 ,55.44 ,66.31 
03,003,01,001,0046,102,722,8,730,1167,0,0,0,0,0,0,0,66.31 ,62.55 ,66.31 
03,003,01,001,0047,103,612,5,617,1127,0,0,0,0,0,0,0,66.31 ,54.75 ,66.31 
03,003,01,001,0047,104,680,5,685,1304,0,0,0,0,0,0,0,66.31 ,52.53 ,66.31 
03,003,01,001,0047,105,338,4,342,741,0,0,0,0,0,0,0,66.31 ,46.15 ,66.31 
03,003,01,001,0048,106,848,13,861,1709,0,0,0,0,0,0,0,66.31 ,50.38 ,66.31 
03,003,01,001,0048,107,882,10,892,1815,0,0,0,0,0,0,0,66.31 ,49.15 ,66.31 
03,003,01,001,0049,108,761,14,775,1088,0,0,0,0,0,0,0,66.31 ,71.23 ,66.31 
03,003,01,001,0049,109,637,13,650,896,0,0,0,0,0,0,0,66.31 ,72.54 ,66.31 
03,003,01,001,0050,110,724,18,742,1230,0,0,0,0,0,0,0,66.31 ,60.33 ,66.31 
03,003,01,001,0050,111,799,10,809,1269,0,0,0,0,0,0,0,66.31 ,63.75 ,66.31 
03,003,01,001,0050,112,734,10,744,1351,0,0,0,0,0,0,0,66.31 ,55.07 ,66.31 
03,003,01,001,0051,113,1049,15,1064,1885,0,0,0,0,0,0,0,66.31 ,56.45 ,66.31 
03,003,01,001,0051,114,579,6,585,852,0,0,0,0,0,0,0,66.31 ,68.66 ,66.31 
03,003,01,001,0051,115,602,11,613,887,0,0,0,0,0,0,0,66.31 ,69.11 ,66.31 
03,003,01,001,0052,116,821,7,828,1402,0,0,0,0,0,0,0,66.31 ,59.06 ,66.31 
03,003,01,001,0052,117,891,11,902,1610,0,0,0,0,0,0,0,66.31 ,56.02 ,66.31 
03,003,01,001,0053,118,416,5,421,1024,0,0,0,0,0,0,0,66.31 ,41.11 ,66.31 
03,003,01,001,0053,119,546,2,548,944,0,0,0,0,0,0,0,66.31 ,58.05 ,66.31 
03,003,01,001,0053,120,418,1,419,825,0,0,0,0,0,0,0,66.31 ,50.79 ,66.31 
03,003,01,001,0054,121,684,9,693,1157,0,0,0,0,0,0,0,66.31 ,59.90 ,66.31 
03,003,01,001,0054,122,551,2,553,898,0,0,0,0,0,0,0,66.31 ,61.58 ,66.31 
03,003,01,001,0054,123,535,5,540,1123,0,0,0,0,0,0,0,66.31 ,48.09 ,66.31 
03,003,01,001,0055,124,772,6,778,1259,0,0,0,0,0,0,0,66.31 ,61.80 ,66.31 
03,003,01,001,0055,125,702,12,714,1201,0,0,0,0,0,0,0,66.31 ,59.45 ,66.31 
03,003,01,001,0056,126,858,12,870,1476,0,0,0,0,0,0,0,66.31 ,58.94 ,66.31 
03,003,01,001,0056,127,856,14,870,1408,0,0,0,0,0,0,0,66.31 ,61.79 ,66.31 
03,003,01,001,0057,128,949,6,955,1452,0,0,0,0,0,0,0,66.31 ,65.77 ,66.31 
03,003,01,001,0058,129,1053,18,1071,1632,0,0,0,0,0,0,0,66.31 ,65.63 ,66.31 
03,003,01,001,0059,130,950,12,962,1593,0,0,0,0,0,0,0,66.31 ,60.39 ,66.31 
03,003,01,001,0060,131,860,13,873,1436,0,0,0,0,0,0,0,66.31 ,60.79 ,66.31 
03,003,01,001,0060,132,746,13,759,1206,0,0,0,0,0,0,0,66.31 ,62.94 ,66.31 
03,003,01,001,0060,133,876,3,879,1572,0,0,0,0,0,0,0,66.31 ,55.92 ,66.31 
03,003,01,001,0061,134,992,15,1007,1689,0,0,0,0,0,0,0,66.31 ,59.62 ,66.31 
03,003,01,001,0061,135,839,4,843,1404,0,0,0,0,0,0,0,66.31 ,60.04 ,66.31 
03,003,01,001,0062,136,979,8,987,1588,0,0,0,0,0,0,0,66.31 ,62.15 ,66.31 
03,003,01,001,0062,137,926,10,936,1626,0,0,0,0,0,0,0,66.31 ,57.56 ,66.31 
03,003,01,001,0063,138,593,14,607,1091,0,0,0,0,0,0,0,66.31 ,55.64 ,66.31 
03,003,01,001,0063,139,632,22,654,1071,0,0,0,0,0,0,0,66.31 ,61.06 ,66.31 
03,003,01,001,0063,140,828,10,838,1443,0,0,0,0,0,0,0,66.31 ,58.07 ,66.31 
03,003,01,001,0063,141,518,11,529,928,0,0,0,0,0,0,0,66.31 ,57.00 ,66.31 
03,003,01,001,0064,142,633,8,641,1131,0,0,0,0,0,0,0,66.31 ,56.68 ,66.31 
03,003,01,001,0064,143,919,20,939,1624,0,0,0,0,0,0,0,66.31 ,57.82 ,66.31 
03,003,01,001,0064,144,731,7,738,1299,0,0,0,0,0,0,0,66.31 ,56.81 ,66.31 
03,003,01,001,0065,145,764,12,776,1632,0,0,0,0,0,0,0,66.31 ,47.55 ,66.31 
03,003,01,001,0065,146,859,18,877,1616,0,0,0,0,0,0,0,66.31 ,54.27 ,66.31 
03,003,01,001,0066,147,713,11,724,1614,0,0,0,0,0,0,0,66.31 ,44.86 ,66.31 
03,003,01,001,0067,148,634,8,642,1171,0,0,0,0,0,0,0,66.31 ,54.82 ,66.31 
03,003,01,001,0067,149,711,11,722,1214,0,0,0,0,0,0,0,66.31 ,59.47 ,66.31 
03,003,01,001,0068,150,852,24,876,1408,0,0,0,0,0,0,0,66.31 ,62.22 ,66.31 
03,003,01,001,0068,151,757,10,767,1557,0,0,0,0,0,0,0,66.31 ,49.26 ,66.31 
03,003,01,001,0069,152,910,10,920,1396,0,0,0,0,0,0,0,66.31 ,65.90 ,66.31 
03,003,01,001,0069,153,991,18,1009,1541,0,0,0,0,0,0,0,66.31 ,65.48 ,66.31 
03,003,01,002,0070,154,801,18,819,1273,0,0,0,0,0,0,0,66.31 ,64.34 ,66.31 
03,003,01,002,0070,155,905,18,923,1541,0,0,0,0,0,0,0,66.31 ,59.90 ,66.31 
03,003,01,002,0070,156,900,18,918,1552,0,0,0,0,0,0,0,66.31 ,59.15 ,66.31 
03,003,01,002,0071,157,949,14,963,1399,0,0,0,0,0,0,0,66.31 ,68.83 ,66.31 
03,003,01,002,0071,158,680,6,686,1052,0,0,0,0,0,0,0,66.31 ,65.21 ,66.31 
03,003,01,002,0071,159,638,15,653,1181,0,0,0,0,0,0,0,66.31 ,55.29 ,66.31 
03,003,01,002,0071,160,797,11,808,1271,0,0,0,0,0,0,0,66.31 ,63.57 ,66.31 
03,003,01,002,0072,161,815,12,827,1405,0,0,0,0,0,0,0,66.31 ,58.86 ,66.31 
03,003,01,002,0072,162,676,17,693,1241,0,0,0,0,0,0,0,66.31 ,55.84 ,66.31 
03,003,01,002,0072,163,751,9,760,1148,0,0,0,0,0,0,0,66.31 ,66.20 ,66.31 
03,003,01,002,0073,164,766,11,777,1352,0,0,0,0,0,0,0,66.31 ,57.47 ,66.31 
03,003,01,002,0073,165,593,10,603,1003,0,0,0,0,0,0,0,66.31 ,60.12 ,66.31 
03,003,01,002,0073,166,724,12,736,1201,0,0,0,0,0,0,0,66.31 ,61.28 ,66.31 
03,003,01,002,0073,167,507,13,520,967,0,0,0,0,0,0,0,66.31 ,53.77 ,66.31 
03,003,01,002,0074,168,745,13,758,1078,0,0,0,0,0,0,0,66.31 ,70.32 ,66.31 
03,003,01,002,0074,169,801,11,812,1134,0,0,0,0,0,0,0,66.31 ,71.60 ,66.31 
03,003,01,002,0075,170,921,10,931,1348,0,0,0,0,0,0,0,66.31 ,69.07 ,66.31 
03,003,01,002,0075,171,389,1,390,561,0,0,0,0,0,0,0,66.31 ,69.52 ,66.31 
03,003,01,002,0076,172,904,23,927,1600,0,0,0,0,0,0,0,66.31 ,57.94 ,66.31 
03,003,01,002,0077,173,866,15,881,1722,0,0,0,0,0,0,0,66.31 ,51.16 ,66.31 
03,003,01,002,0078,174,678,18,696,1356,0,0,0,0,0,0,0,66.31 ,51.33 ,66.31 
03,003,01,002,0078,175,523,7,530,996,0,0,0,0,0,0,0,66.31 ,53.21 ,66.31 
03,003,01,002,0078,176,475,5,480,1085,0,0,0,0,0,0,0,66.31 ,44.24 ,66.31 
03,003,01,002,0079,177,553,7,560,959,0,0,0,0,0,0,0,66.31 ,58.39 ,66.31 
03,003,01,002,0079,178,605,13,618,1026,0,0,0,0,0,0,0,66.31 ,60.23 ,66.31 
03,003,01,002,0080,179,854,19,873,1486,0,0,0,0,0,0,0,66.31 ,58.75 ,66.31 
03,003,01,002,0081,180,677,15,692,1430,0,0,0,0,0,0,0,66.31 ,48.39 ,66.31 
03,003,01,002,0081,181,630,12,642,1340,0,0,0,0,0,0,0,66.31 ,47.91 ,66.31 
03,003,01,002,0082,182,549,7,556,1115,0,0,0,0,0,0,0,66.31 ,49.87 ,66.31 
03,003,01,002,0082,183,748,14,762,1420,0,0,0,0,0,0,0,66.31 ,53.66 ,66.31 
03,003,01,002,0083,184,1143,30,1173,1786,0,0,0,0,0,0,0,66.31 ,65.68 ,66.31 
03,003,01,002,0084,185,902,11,913,1540,0,0,0,0,0,0,0,66.31 ,59.29 ,66.31 
03,003,01,002,0084,186,829,13,842,1454,0,0,0,0,0,0,0,66.31 ,57.91 ,66.31 
03,003,01,002,0084,187,965,17,982,1596,0,0,0,0,0,0,0,66.31 ,61.53 ,66.31 
03,003,01,002,0085,188,895,9,904,1471,0,0,0,0,0,0,0,66.31 ,61.45 ,66.31 
03,003,01,002,0085,189,1016,16,1032,2631,0,0,0,0,0,0,0,66.31 ,39.22 ,66.31 
03,003,01,002,0086,190,797,11,808,1354,0,0,0,0,0,0,0,66.31 ,59.68 ,66.31 
03,003,01,002,0086,191,723,6,729,1286,0,0,0,0,0,0,0,66.31 ,56.69 ,66.31 
03,003,01,002,0087,192,700,9,709,1269,0,0,0,0,0,0,0,66.31 ,55.87 ,66.31 
03,003,01,002,0087,193,673,7,680,1310,0,0,0,0,0,0,0,66.31 ,51.91 ,66.31 
03,003,01,002,0087,194,604,12,616,1202,0,0,0,0,0,0,0,66.31 ,51.25 ,66.31 
03,003,01,002,0088,195,600,5,605,1322,0,0,0,0,0,0,0,66.31 ,45.76 ,66.31 
03,003,01,002,0088,196,589,9,598,1491,0,0,0,0,0,0,0,66.31 ,40.11 ,66.31 
03,003,01,002,0088,197,817,10,827,1332,0,0,0,0,0,0,0,66.31 ,62.09 ,66.31 
03,003,01,002,0088,198,647,13,660,1073,0,0,0,0,0,0,0,66.31 ,61.51 ,66.31 
03,003,01,002,0089,199,897,19,916,1538,0,0,0,0,0,0,0,66.31 ,59.56 ,66.31 
03,003,01,002,0090,200,881,11,892,1735,0,0,0,0,0,0,0,66.31 ,51.41 ,66.31 
03,003,01,002,0091,201,584,3,587,1205,0,0,0,0,0,0,0,66.31 ,48.71 ,66.31 
03,003,01,002,0091,202,441,4,445,1096,0,0,0,0,0,0,0,66.31 ,40.60 ,66.31 
03,003,01,002,0091,203,622,6,628,1391,0,0,0,0,0,0,0,66.31 ,45.15 ,66.31 
03,003,01,002,0092,204,721,9,730,1167,0,0,0,0,0,0,0,66.31 ,62.55 ,66.31 
03,003,01,002,0093,205,762,12,774,1160,0,0,0,0,0,0,0,66.31 ,66.72 ,66.31 
03,003,01,002,0094,206,647,5,652,1062,0,0,0,0,0,0,0,66.31 ,61.39 ,66.31 
03,003,01,002,0095,207,679,10,689,1160,0,0,0,0,0,0,0,66.31 ,59.40 ,66.31 
03,003,01,002,0095,208,639,15,654,1061,0,0,0,0,0,0,0,66.31 ,61.64 ,66.31 
03,003,01,003,0096,209,903,11,914,1370,0,0,0,0,0,0,0,66.31 ,66.72 ,66.31 
03,003,01,003,0096,210,907,24,931,1517,0,0,0,0,0,0,0,66.31 ,61.37 ,66.31 
03,003,01,003,0097,211,985,12,997,1337,0,0,0,0,0,0,0,66.31 ,74.57 ,66.31 
03,003,01,003,0097,212,838,16,854,1180,0,0,0,0,0,0,0,66.31 ,72.37 ,66.31 
03,003,01,003,0098,213,1028,19,1047,1556,0,0,0,0,0,0,0,66.31 ,67.29 ,66.31 
03,003,01,003,0098,214,982,14,996,1386,0,0,0,0,0,0,0,66.31 ,71.86 ,66.31 
03,003,01,003,0099,215,838,11,849,1369,0,0,0,0,0,0,0,66.31 ,62.02 ,66.31 
03,003,01,003,0099,216,831,21,852,1299,0,0,0,0,0,0,0,66.31 ,65.59 ,66.31 
03,003,01,003,0100,217,965,20,985,1428,0,0,0,0,0,0,0,66.31 ,68.98 ,66.31 
03,003,01,003,0100,218,1021,17,1038,1565,0,0,0,0,0,0,0,66.31 ,66.33 ,66.31 
03,003,01,003,0101,219,993,22,1015,1417,0,0,0,0,0,0,0,66.31 ,71.63 ,66.31 
03,003,01,003,0101,220,1079,19,1098,1523,0,0,0,0,0,0,0,66.31 ,72.09 ,66.31 
03,003,01,003,0102,221,905,9,914,1359,0,0,0,0,0,0,0,66.31 ,67.26 ,66.31 
03,003,01,003,0102,222,939,15,954,1379,0,0,0,0,0,0,0,66.31 ,69.18 ,66.31 
03,003,01,003,0103,223,1080,19,1099,1632,0,0,0,0,0,0,0,66.31 ,67.34 ,66.31 
03,003,01,003,0103,224,1072,16,1088,1589,0,0,0,0,0,0,0,66.31 ,68.47 ,66.31 
03,003,01,003,0103,225,635,17,652,935,0,0,0,0,0,0,0,66.31 ,69.73 ,66.31 
03,003,01,003,0104,226,1301,22,1323,1865,0,0,0,0,0,0,0,66.31 ,70.94 ,66.31 
03,003,01,003,0104,227,564,6,570,825,0,0,0,0,0,0,0,66.31 ,69.09 ,66.31 
03,003,01,003,0105,228,838,22,860,1270,0,0,0,0,0,0,0,66.31 ,67.72 ,66.31 
03,003,01,003,0105,229,687,15,702,1065,0,0,0,0,0,0,0,66.31 ,65.92 ,66.31 
03,003,01,003,0106,230,1094,28,1122,1585,0,0,0,0,0,0,0,66.31 ,70.79 ,66.31 
03,003,01,003,0106,231,693,21,714,1083,0,0,0,0,0,0,0,66.31 ,65.93 ,66.31 
03,003,01,003,0106,232,685,9,694,994,0,0,0,0,0,0,0,66.31 ,69.82 ,66.31 
03,003,01,003,0107,233,794,17,811,1174,0,0,0,0,0,0,0,66.31 ,69.08 ,66.31 
03,003,01,003,0107,234,558,16,574,1082,0,0,0,0,0,0,0,66.31 ,53.05 ,66.31 
03,003,01,003,0108,235,1113,17,1130,1649,0,0,0,0,0,0,0,66.31 ,68.53 ,66.31 
03,003,01,003,0108,236,1232,29,1261,1990,0,0,0,0,0,0,0,66.31 ,63.37 ,66.31 
03,003,01,003,0109,237,1009,25,1034,1581,0,0,0,0,0,0,0,66.31 ,65.40 ,66.31 
03,003,01,003,0109,238,704,16,720,1128,0,0,0,0,0,0,0,66.31 ,63.83 ,66.31 
03,003,01,003,0110,239,1204,28,1232,1833,0,0,0,0,0,0,0,66.31 ,67.21 ,66.31 
03,003,01,003,0111,240,1332,16,1348,1924,0,0,0,0,0,0,0,66.31 ,70.06 ,66.31 
03,003,01,003,0112,241,690,12,702,1047,0,0,0,0,0,0,0,66.31 ,67.05 ,66.31 
03,003,01,003,0112,242,771,19,790,1278,0,0,0,0,0,0,0,66.31 ,61.82 ,66.31 
03,003,01,003,0113,243,946,17,963,1337,0,0,0,0,0,0,0,66.31 ,72.03 ,66.31 
03,003,01,003,0114,244,1043,10,1053,1573,0,0,0,0,0,0,0,66.31 ,66.94 ,66.31 
03,003,01,003,0114,245,807,18,825,1210,0,0,0,0,0,0,0,66.31 ,68.18 ,66.31 
03,003,01,003,0115,246,1108,15,1123,1859,0,0,0,0,0,0,0,66.31 ,60.41 ,66.31 
03,003,01,003,0116,247,972,15,987,1538,0,0,0,0,0,0,0,66.31 ,64.17 ,66.31 
03,003,01,003,0117,248,801,10,811,1245,0,0,0,0,0,0,0,66.31 ,65.14 ,66.31 
03,003,01,003,0118,249,649,14,663,1030,0,0,0,0,0,0,0,66.31 ,64.37 ,66.31 
03,003,01,003,0118,250,881,12,893,1335,0,0,0,0,0,0,0,66.31 ,66.89 ,66.31 
03,003,01,003,0118,251,728,8,736,1211,0,0,0,0,0,0,0,66.31 ,60.78 ,66.31 
03,003,01,003,0119,252,859,15,874,1344,0,0,0,0,0,0,0,66.31 ,65.03 ,66.31 
03,003,01,003,0119,253,684,13,697,1070,0,0,0,0,0,0,0,66.31 ,65.14 ,66.31 
03,003,01,003,0119,254,731,10,741,1173,0,0,0,0,0,0,0,66.31 ,63.17 ,66.31 
03,003,01,003,0120,255,680,7,687,1053,0,0,0,0,0,0,0,66.31 ,65.24 ,66.31 
03,003,01,003,0120,256,662,8,670,1049,0,0,0,0,0,0,0,66.31 ,63.87 ,66.31 
03,003,01,003,0120,257,544,17,561,1203,0,0,0,0,0,0,0,66.31 ,46.63 ,66.31 
03,003,01,003,0120,258,845,18,863,1194,0,0,0,0,0,0,0,66.31 ,72.28 ,66.31 
03,003,01,003,0120,259,726,30,756,1201,0,0,0,0,0,0,0,66.31 ,62.95 ,66.31 
03,003,01,003,0121,260,656,9,665,1067,0,0,0,0,0,0,0,66.31 ,62.32 ,66.31 
03,003,01,003,0121,261,474,7,481,748,0,0,0,0,0,0,0,66.31 ,64.30 ,66.31 
03,003,01,003,0122,262,565,11,576,802,0,0,0,0,0,0,0,66.31 ,71.82 ,66.31 
03,003,01,003,0122,263,1046,13,1059,1625,0,0,0,0,0,0,0,66.31 ,65.17 ,66.31 
03,003,01,003,0123,264,1066,14,1080,1592,0,0,0,0,0,0,0,66.31 ,67.84 ,66.31 
03,003,01,003,0124,265,831,19,850,1314,0,0,0,0,0,0,0,66.31 ,64.69 ,66.31 
03,003,01,003,0125,266,1066,19,1085,1547,0,0,0,0,0,0,0,66.31 ,70.14 ,66.31 
03,003,01,003,0125,267,1146,16,1162,1747,0,0,0,0,0,0,0,66.31 ,66.51 ,66.31 
03,003,01,003,0126,268,780,10,790,1230,0,0,0,0,0,0,0,66.31 ,64.23 ,66.31 
03,003,01,003,0126,269,904,7,911,1437,0,0,0,0,0,0,0,66.31 ,63.40 ,66.31 
03,003,01,003,0127,270,589,10,599,917,0,0,0,0,0,0,0,66.31 ,65.32 ,66.31 
03,003,01,003,0127,271,541,14,555,872,0,0,0,0,0,0,0,66.31 ,63.65 ,66.31 
03,003,01,003,0128,272,882,12,894,1349,0,0,0,0,0,0,0,66.31 ,66.27 ,66.31 
03,003,01,003,0128,273,788,11,799,1199,0,0,0,0,0,0,0,66.31 ,66.64 ,66.31 
03,003,01,003,0128,274,1043,13,1056,1513,0,0,0,0,0,0,0,66.31 ,69.80 ,66.31 
03,003,01,003,0129,275,634,13,647,934,0,0,0,0,0,0,0,66.31 ,69.27 ,66.31 
03,003,01,003,0129,276,954,12,966,1546,0,0,0,0,0,0,0,66.31 ,62.48 ,66.31 
03,003,01,003,0130,277,1204,8,1212,2047,0,0,0,0,0,0,0,66.31 ,59.21 ,66.31 
03,003,01,003,0130,278,520,5,525,826,0,0,0,0,0,0,0,66.31 ,63.56 ,66.31 
03,003,01,003,0131,279,906,18,924,1360,0,0,0,0,0,0,0,66.31 ,67.94 ,66.31 
03,003,01,003,0131,280,542,6,548,817,0,0,0,0,0,0,0,66.31 ,67.07 ,66.31 
03,003,01,003,0132,281,1114,18,1132,1750,0,0,0,0,0,0,0,66.31 ,64.69 ,66.31 
03,003,01,003,0133,282,867,8,875,1428,0,0,0,0,0,0,0,66.31 ,61.27 ,66.31 
03,003,01,003,0134,283,894,16,910,1379,0,0,0,0,0,0,0,66.31 ,65.99 ,66.31 
03,003,01,003,0134,284,1015,18,1033,1934,0,0,0,0,0,0,0,66.31 ,53.41 ,66.31 
03,003,01,004,0135,285,689,15,704,1057,0,0,0,0,0,0,0,66.31 ,66.60 ,66.31 
03,003,01,004,0135,286,1103,12,1115,1691,0,0,0,0,0,0,0,66.31 ,65.94 ,66.31 
03,003,01,004,0136,287,840,8,848,1279,0,0,0,0,0,0,0,66.31 ,66.30 ,66.31 
03,003,01,004,0136,288,784,11,795,1153,0,0,0,0,0,0,0,66.31 ,68.95 ,66.31 
03,003,01,004,0137,289,942,14,956,1437,0,0,0,0,0,0,0,66.31 ,66.53 ,66.31 
03,003,01,004,0137,290,712,14,726,1099,0,0,0,0,0,0,0,66.31 ,66.06 ,66.31 
03,003,01,004,0138,291,1127,18,1145,1706,0,0,0,0,0,0,0,66.31 ,67.12 ,66.31 
03,003,01,004,0139,292,1297,17,1314,1812,0,0,0,0,0,0,0,66.31 ,72.52 ,66.31 
03,003,01,004,0140,293,733,16,749,1160,0,0,0,0,0,0,0,66.31 ,64.57 ,66.31 
03,003,01,004,0140,294,560,9,569,889,0,0,0,0,0,0,0,66.31 ,64.00 ,66.31 
03,003,01,004,0141,295,637,6,643,833,0,0,0,0,0,0,0,66.31 ,77.19 ,66.31 
03,003,01,004,0142,296,658,7,665,913,0,0,0,0,0,0,0,66.31 ,72.84 ,66.31 
03,003,01,004,0142,297,573,11,584,833,0,0,0,0,0,0,0,66.31 ,70.11 ,66.31 
03,003,01,004,0143,298,953,15,968,1355,0,0,0,0,0,0,0,66.31 ,71.44 ,66.31 
03,003,01,004,0143,299,1018,16,1034,1420,0,0,0,0,0,0,0,66.31 ,72.82 ,66.31 
03,003,01,004,0144,300,600,9,609,931,0,0,0,0,0,0,0,66.31 ,65.41 ,66.31 
03,003,01,004,0144,301,730,8,738,1137,0,0,0,0,0,0,0,66.31 ,64.91 ,66.31 
03,003,01,004,0145,302,628,10,638,859,0,0,0,0,0,0,0,66.31 ,74.27 ,66.31 
03,003,01,004,0145,303,773,18,791,1782,0,0,0,0,0,0,0,66.31 ,44.39 ,66.31 
03,003,01,004,0145,304,860,16,876,1520,0,0,0,0,0,0,0,66.31 ,57.63 ,66.31 
03,003,01,004,0146,305,506,6,512,870,0,0,0,0,0,0,0,66.31 ,58.85 ,66.31 
03,003,01,004,0146,306,685,14,699,1108,0,0,0,0,0,0,0,66.31 ,63.09 ,66.31 
03,003,01,004,0147,307,1043,12,1055,1648,0,0,0,0,0,0,0,66.31 ,64.02 ,66.31 
03,003,01,004,0148,308,734,13,747,1133,0,0,0,0,0,0,0,66.31 ,65.93 ,66.31 
03,003,01,004,0148,309,769,20,789,1171,0,0,0,0,0,0,0,66.31 ,67.38 ,66.31 
03,003,01,004,0149,310,864,13,877,1341,0,0,0,0,0,0,0,66.31 ,65.40 ,66.31 
03,003,01,004,0150,311,1096,15,1111,1813,0,0,0,0,0,0,0,66.31 ,61.28 ,66.31 
03,003,01,004,0151,312,576,13,589,1033,0,0,0,0,0,0,0,66.31 ,57.02 ,66.31 
03,003,01,004,0151,313,690,2,692,1386,0,0,0,0,0,0,0,66.31 ,49.93 ,66.31 
03,003,01,004,0152,314,615,5,620,1134,0,0,0,0,0,0,0,66.31 ,54.67 ,66.31 
03,003,01,004,0152,315,577,7,584,933,0,0,0,0,0,0,0,66.31 ,62.59 ,66.31 
03,003,01,004,0153,316,668,18,686,1253,0,0,0,0,0,0,0,66.31 ,54.75 ,66.31 
03,003,01,004,0154,317,1175,17,1192,1690,0,0,0,0,0,0,0,66.31 ,70.53 ,66.31 
03,003,01,004,0155,318,911,15,926,1319,0,0,0,0,0,0,0,66.31 ,70.20 ,66.31 
03,003,01,004,0156,319,997,13,1010,1524,0,0,0,0,0,0,0,66.31 ,66.27 ,66.31 
03,003,01,004,0157,320,819,16,835,1204,0,0,0,0,0,0,0,66.31 ,69.35 ,66.31 
03,003,01,004,0158,321,905,15,920,1264,0,0,0,0,0,0,0,66.31 ,72.78 ,66.31 
03,003,01,004,0158,322,1074,14,1088,1617,0,0,0,0,0,0,0,66.31 ,67.29 ,66.31 
03,003,01,004,0159,323,720,19,739,1032,0,0,0,0,0,0,0,66.31 ,71.61 ,66.31 
03,003,01,004,0159,324,681,10,691,958,0,0,0,0,0,0,0,66.31 ,72.13 ,66.31 
03,003,01,004,0160,325,979,18,997,1558,0,0,0,0,0,0,0,66.31 ,63.99 ,66.31 
03,003,01,004,0160,326,1004,22,1026,1587,0,0,0,0,0,0,0,66.31 ,64.65 ,66.31 
03,003,01,005,0161,327,1252,23,1275,1680,0,0,0,0,0,0,0,66.31 ,75.89 ,66.31 
03,003,01,005,0161,328,1129,16,1145,1541,0,0,0,0,0,0,0,66.31 ,74.30 ,66.31 
03,003,01,005,0161,329,1177,14,1191,1583,0,0,0,0,0,0,0,66.31 ,75.24 ,66.31 
03,003,01,005,0162,330,850,7,857,1182,0,0,0,0,0,0,0,66.31 ,72.50 ,66.31 
03,003,01,005,0162,331,847,7,854,1281,0,0,0,0,0,0,0,66.31 ,66.67 ,66.31 
03,003,01,005,0162,332,872,6,878,1248,0,0,0,0,0,0,0,66.31 ,70.35 ,66.31 
03,003,01,005,0163,333,917,19,936,1357,0,0,0,0,0,0,0,66.31 ,68.98 ,66.31 
03,003,01,005,0163,334,959,13,972,1410,0,0,0,0,0,0,0,66.31 ,68.94 ,66.31 
03,003,01,005,0164,335,970,15,985,1374,0,0,0,0,0,0,0,66.31 ,71.69 ,66.31 
03,003,01,005,0165,336,1106,15,1121,1545,0,0,0,0,0,0,0,66.31 ,72.56 ,66.31 
03,003,01,005,0165,337,1062,17,1079,1535,0,0,0,0,0,0,0,66.31 ,70.29 ,66.31 
03,003,01,005,0165,338,1146,14,1160,1525,0,0,0,0,0,0,0,66.31 ,76.07 ,66.31 
03,003,01,005,0166,339,1359,19,1378,1831,0,0,0,0,0,0,0,66.31 ,75.26 ,66.31 
03,003,01,005,0166,340,1102,13,1115,1425,0,0,0,0,0,0,0,66.31 ,78.25 ,66.31 
03,003,01,005,0167,341,892,8,900,1139,0,0,0,0,0,0,0,66.31 ,79.02 ,66.31 
03,003,01,005,0167,342,857,16,873,1215,0,0,0,0,0,0,0,66.31 ,71.85 ,66.31 
03,003,01,005,0167,343,1146,17,1163,1553,0,0,0,0,0,0,0,66.31 ,74.89 ,66.31 
03,003,01,005,0168,344,950,21,971,1195,0,0,0,0,0,0,0,66.31 ,81.26 ,66.31 
03,003,01,005,0169,345,723,5,728,964,0,0,0,0,0,0,0,66.31 ,75.52 ,66.31 
03,003,01,005,0170,346,713,3,716,956,0,0,0,0,0,0,0,66.31 ,74.90 ,66.31 
03,003,01,005,0170,347,1018,26,1044,1355,0,0,0,0,0,0,0,66.31 ,77.05 ,66.31 
03,003,01,005,0171,348,1116,17,1133,1549,0,0,0,0,0,0,0,66.31 ,73.14 ,66.31 
03,003,01,005,0171,349,758,8,766,1115,0,0,0,0,0,0,0,66.31 ,68.70 ,66.31 
03,003,01,005,0171,350,756,11,767,1143,0,0,0,0,0,0,0,66.31 ,67.10 ,66.31 
03,003,01,005,0172,351,634,3,637,848,0,0,0,0,0,0,0,66.31 ,75.12 ,66.31 
03,003,01,005,0172,352,864,12,876,1229,0,0,0,0,0,0,0,66.31 ,71.28 ,66.31 
03,003,01,005,0173,353,870,12,882,1282,0,0,0,0,0,0,0,66.31 ,68.80 ,66.31 
03,003,01,005,0174,354,851,18,869,1267,0,0,0,0,0,0,0,66.31 ,68.59 ,66.31 
03,003,01,005,0174,355,927,12,939,1298,0,0,0,0,0,0,0,66.31 ,72.34 ,66.31 
03,003,01,005,0175,356,1056,12,1068,1400,0,0,0,0,0,0,0,66.31 ,76.29 ,66.31 
03,003,01,005,0176,357,1292,20,1312,1849,0,0,0,0,0,0,0,66.31 ,70.96 ,66.31 
03,003,01,005,0177,358,1171,12,1183,1640,0,0,0,0,0,0,0,66.31 ,72.13 ,66.31 
03,003,01,005,0178,359,1075,8,1083,1575,0,0,0,0,0,0,0,66.31 ,68.76 ,66.31 
03,003,01,005,0179,360,700,7,707,1266,0,0,0,0,0,0,0,66.31 ,55.85 ,66.31 
03,003,01,005,0179,361,843,12,855,1180,0,0,0,0,0,0,0,66.31 ,72.46 ,66.31 
03,003,01,006,0180,362,598,8,606,871,0,0,0,0,0,0,0,66.31 ,69.58 ,66.31 
03,003,01,006,0180,363,570,7,577,796,0,0,0,0,0,0,0,66.31 ,72.49 ,66.31 
03,003,01,006,0181,364,774,10,784,1118,0,0,0,0,0,0,0,66.31 ,70.13 ,66.31 
03,003,01,006,0182,365,746,13,759,1144,0,0,0,0,0,0,0,66.31 ,66.35 ,66.31 
03,003,01,006,0182,366,662,12,674,1043,0,0,0,0,0,0,0,66.31 ,64.62 ,66.31 
03,003,01,006,0182,367,677,9,686,1041,0,0,0,0,0,0,0,66.31 ,65.90 ,66.31 
03,003,01,006,0183,368,554,7,561,912,0,0,0,0,0,0,0,66.31 ,61.51 ,66.31 
03,003,01,006,0183,369,643,8,651,948,0,0,0,0,0,0,0,66.31 ,68.67 ,66.31 
03,003,01,006,0183,370,652,9,661,955,0,0,0,0,0,0,0,66.31 ,69.21 ,66.31 
03,003,01,006,0184,371,801,4,805,1268,0,0,0,0,0,0,0,66.31 ,63.49 ,66.31 
03,003,01,006,0184,372,752,12,764,1148,0,0,0,0,0,0,0,66.31 ,66.55 ,66.31 
03,003,01,006,0184,373,721,9,730,1136,0,0,0,0,0,0,0,66.31 ,64.26 ,66.31 
03,003,01,006,0185,374,712,7,719,1010,0,0,0,0,0,0,0,66.31 ,71.19 ,66.31 
03,003,01,006,0186,375,622,9,631,888,0,0,0,0,0,0,0,66.31 ,71.06 ,66.31 
03,003,01,006,0187,376,698,15,713,958,0,0,0,0,0,0,0,66.31 ,74.43 ,66.31 
03,003,01,006,0188,377,694,8,702,966,0,0,0,0,0,0,0,66.31 ,72.67 ,66.31 
03,003,01,006,0188,378,433,6,439,608,0,0,0,0,0,0,0,66.31 ,72.20 ,66.31 
03,003,01,006,0189,379,521,6,527,856,0,0,0,0,0,0,0,66.31 ,61.57 ,66.31 
03,003,01,006,0189,380,614,11,625,914,0,0,0,0,0,0,0,66.31 ,68.38 ,66.31 
03,003,01,006,0189,381,483,11,494,697,0,0,0,0,0,0,0,66.31 ,70.88 ,66.31 
03,003,01,006,0190,382,707,9,716,1104,0,0,0,0,0,0,0,66.31 ,64.86 ,66.31 
03,003,01,006,0190,383,642,7,649,952,0,0,0,0,0,0,0,66.31 ,68.17 ,66.31 
03,003,01,006,0191,384,610,7,617,931,0,0,0,0,0,0,0,66.31 ,66.27 ,66.31 
03,003,01,006,0192,385,462,7,469,680,0,0,0,0,0,0,0,66.31 ,68.97 ,66.31 
03,003,01,006,0192,386,182,3,185,294,0,0,0,0,0,0,0,66.31 ,62.93 ,66.31 
03,003,01,006,0193,387,553,8,561,778,0,0,0,0,0,0,0,66.31 ,72.11 ,66.31 
03,003,01,006,0193,388,497,12,509,752,0,0,0,0,0,0,0,66.31 ,67.69 ,66.31 
03,003,01,006,0194,389,972,18,990,1361,0,0,0,0,0,0,0,66.31 ,72.74 ,66.31 
03,003,01,006,0194,390,443,3,446,619,0,0,0,0,0,0,0,66.31 ,72.05 ,66.31 
03,003,01,006,0195,391,947,20,967,1407,0,0,0,0,0,0,0,66.31 ,68.73 ,66.31 
03,003,01,006,0195,392,613,8,621,859,0,0,0,0,0,0,0,66.31 ,72.29 ,66.31 
03,003,01,006,0196,393,698,8,706,1086,0,0,0,0,0,0,0,66.31 ,65.01 ,66.31 
03,003,01,006,0197,394,629,12,641,914,0,0,0,0,0,0,0,66.31 ,70.13 ,66.31 
03,003,01,006,0197,395,603,15,618,861,0,0,0,0,0,0,0,66.31 ,71.78 ,66.31 
03,003,01,006,0197,396,607,12,619,894,0,0,0,0,0,0,0,66.31 ,69.24 ,66.31 
03,003,01,006,0198,397,470,9,479,746,0,0,0,0,0,0,0,66.31 ,64.21 ,66.31 
03,003,01,006,0198,398,665,10,675,1015,0,0,0,0,0,0,0,66.31 ,66.50 ,66.31 
03,003,01,006,0199,399,733,8,741,985,0,0,0,0,0,0,0,66.31 ,75.23 ,66.31 
03,003,01,006,0199,400,366,7,373,605,0,0,0,0,0,0,0,66.31 ,61.65 ,66.31 
03,003,01,006,0200,401,977,13,990,1401,0,0,0,0,0,0,0,66.31 ,70.66 ,66.31 
03,003,01,006,0200,402,826,13,839,1213,0,0,0,0,0,0,0,66.31 ,69.17 ,66.31 
03,003,01,006,0201,403,770,14,784,1203,0,0,0,0,0,0,0,66.31 ,65.17 ,66.31 
03,003,01,006,0201,404,630,7,637,960,0,0,0,0,0,0,0,66.31 ,66.35 ,66.31 
03,003,01,006,0201,405,454,7,461,620,0,0,0,0,0,0,0,66.31 ,74.35 ,66.31 
03,003,01,006,0202,406,790,14,804,1135,0,0,0,0,0,0,0,66.31 ,70.84 ,66.31 
03,003,01,006,0202,407,934,11,945,1266,0,0,0,0,0,0,0,66.31 ,74.64 ,66.31 
03,003,01,006,0202,408,743,21,764,1081,0,0,0,0,0,0,0,66.31 ,70.68 ,66.31 
03,003,01,006,0203,409,801,10,811,1118,0,0,0,0,0,0,0,66.31 ,72.54 ,66.31 
03,003,01,006,0204,410,457,11,468,728,0,0,0,0,0,0,0,66.31 ,64.29 ,66.31 
03,003,01,006,0204,411,608,12,620,878,0,0,0,0,0,0,0,66.31 ,70.62 ,66.31 
03,003,01,006,0205,412,929,17,946,1455,0,0,0,0,0,0,0,66.31 ,65.02 ,66.31 
03,003,01,006,0205,413,862,9,871,1286,0,0,0,0,0,0,0,66.31 ,67.73 ,66.31 
03,003,01,006,0206,414,645,9,654,950,0,0,0,0,0,0,0,66.31 ,68.84 ,66.31 
03,003,01,006,0206,415,529,8,537,809,0,0,0,0,0,0,0,66.31 ,66.38 ,66.31 
03,003,01,006,0206,416,640,7,647,948,0,0,0,0,0,0,0,66.31 ,68.25 ,66.31 
03,003,01,007,0207,417,780,12,792,1202,0,0,0,0,0,0,0,66.31 ,65.89 ,66.31 
03,003,01,007,0208,418,423,4,427,652,0,0,0,0,0,0,0,66.31 ,65.49 ,66.31 
03,003,01,007,0209,419,28,1,29,48,0,0,0,0,0,0,0,66.31 ,60.42 ,66.31 
03,003,01,007,0210,420,26,0,26,42,0,0,0,0,0,0,0,66.31 ,61.90 ,66.31 
03,003,01,007,0211,421,177,1,178,303,0,0,0,0,0,0,0,66.31 ,58.75 ,66.31 
03,003,01,007,0212,422,21,1,22,62,0,0,0,0,0,0,0,66.31 ,35.48 ,66.31 
03,003,01,007,0213,423,68,3,71,108,0,0,0,0,0,0,0,66.31 ,65.74 ,66.31 
03,003,01,007,0214,424,31,0,31,57,0,0,0,0,0,0,0,66.31 ,54.39 ,66.31 
03,003,01,007,0215,425,17,0,17,53,0,0,0,0,0,0,0,66.31 ,32.08 ,66.31 
03,003,01,007,0216,426,109,1,110,331,0,0,0,0,0,0,0,66.31 ,33.23 ,66.31 
03,003,01,008,0217,427,702,17,719,1251,0,0,0,0,0,0,0,66.31 ,57.47 ,66.31 
03,003,01,008,0217,428,694,12,706,1160,0,0,0,0,0,0,0,66.31 ,60.86 ,66.31 
03,003,01,008,0218,429,930,16,946,1477,0,0,0,0,0,0,0,66.31 ,64.05 ,66.31 
03,003,01,008,0218,430,835,9,844,1356,0,0,0,0,0,0,0,66.31 ,62.24 ,66.31 
03,003,01,008,0219,431,875,14,889,1469,0,0,0,0,0,0,0,66.31 ,60.52 ,66.31 
03,003,01,008,0219,432,825,9,834,1647,0,0,0,0,0,0,0,66.31 ,50.64 ,66.31 
03,003,01,008,0220,433,1087,13,1100,1581,0,0,0,0,0,0,0,66.31 ,69.58 ,66.31 
03,003,01,008,0220,434,979,11,990,1644,0,0,0,0,0,0,0,66.31 ,60.22 ,66.31 
03,003,01,008,0221,435,709,15,724,1143,0,0,0,0,0,0,0,66.31 ,63.34 ,66.31 
03,003,01,008,0221,436,1006,11,1017,1550,0,0,0,0,0,0,0,66.31 ,65.61 ,66.31 
03,003,01,008,0222,437,811,17,828,1242,0,0,0,0,0,0,0,66.31 ,66.67 ,66.31 
03,003,01,008,0222,438,725,13,738,1076,0,0,0,0,0,0,0,66.31 ,68.59 ,66.31 
03,003,01,008,0222,439,805,9,814,1215,0,0,0,0,0,0,0,66.31 ,67.00 ,66.31 
03,003,01,008,0223,440,880,11,891,1342,0,0,0,0,0,0,0,66.31 ,66.39 ,66.31 
03,003,01,008,0223,441,862,11,873,1321,0,0,0,0,0,0,0,66.31 ,66.09 ,66.31 
03,003,01,008,0223,442,909,18,927,1381,0,0,0,0,0,0,0,66.31 ,67.13 ,66.31 
03,003,01,008,0224,443,846,14,860,1283,0,0,0,0,0,0,0,66.31 ,67.03 ,66.31 
03,003,01,008,0224,444,923,19,942,1322,0,0,0,0,0,0,0,66.31 ,71.26 ,66.31 
03,003,01,008,0224,445,758,12,770,1306,0,0,0,0,0,0,0,66.31 ,58.96 ,66.31 
03,003,01,008,0225,446,903,9,912,1376,0,0,0,0,0,0,0,66.31 ,66.28 ,66.31 
03,003,01,008,0225,447,996,21,1017,1538,0,0,0,0,0,0,0,66.31 ,66.12 ,66.31 
03,003,01,008,0226,448,791,15,806,1141,0,0,0,0,0,0,0,66.31 ,70.64 ,66.31 
03,003,01,008,0226,449,871,21,892,1348,0,0,0,0,0,0,0,66.31 ,66.17 ,66.31 
03,003,01,008,0227,450,687,5,692,1124,0,0,0,0,0,0,0,66.31 ,61.57 ,66.31 
03,003,01,008,0227,451,731,7,738,1181,0,0,0,0,0,0,0,66.31 ,62.49 ,66.31 
03,003,01,008,0227,452,496,8,504,761,0,0,0,0,0,0,0,66.31 ,66.23 ,66.31 
03,003,01,008,0228,453,1068,13,1081,1705,0,0,0,0,0,0,0,66.31 ,63.40 ,66.31 
03,003,01,008,0228,454,789,8,797,1279,0,0,0,0,0,0,0,66.31 ,62.31 ,66.31 
03,003,01,008,0229,455,812,13,825,1302,0,0,0,0,0,0,0,66.31 ,63.36 ,66.31 
03,003,01,008,0229,456,711,14,725,1188,0,0,0,0,0,0,0,66.31 ,61.03 ,66.31 
03,003,01,008,0229,457,672,15,687,1066,0,0,0,0,0,0,0,66.31 ,64.45 ,66.31 
03,003,01,008,0230,458,887,7,894,1275,0,0,0,0,0,0,0,66.31 ,70.12 ,66.31 
03,003,01,008,0230,459,819,16,835,1332,0,0,0,0,0,0,0,66.31 ,62.69 ,66.31 
03,003,01,008,0230,460,746,10,756,1264,0,0,0,0,0,0,0,66.31 ,59.81 ,66.31 
03,003,01,008,0231,461,736,17,753,1212,0,0,0,0,0,0,0,66.31 ,62.13 ,66.31 
03,003,01,008,0231,462,799,16,815,1266,0,0,0,0,0,0,0,66.31 ,64.38 ,66.31 
03,003,01,008,0232,463,971,14,985,1448,0,0,0,0,0,0,0,66.31 ,68.02 ,66.31 
03,003,01,008,0232,464,855,20,875,1324,0,0,0,0,0,0,0,66.31 ,66.09 ,66.31 
03,003,01,008,0233,465,729,16,745,1067,0,0,0,0,0,0,0,66.31 ,69.82 ,66.31 
03,003,01,008,0233,466,547,11,558,826,0,0,0,0,0,0,0,66.31 ,67.55 ,66.31 
03,003,01,008,0233,467,609,14,623,900,0,0,0,0,0,0,0,66.31 ,69.22 ,66.31 
03,003,01,008,0233,468,602,7,609,920,0,0,0,0,0,0,0,66.31 ,66.20 ,66.31 
03,003,01,008,0234,469,631,13,644,1011,0,0,0,0,0,0,0,66.31 ,63.70 ,66.31 
03,003,01,008,0234,470,577,7,584,956,0,0,0,0,0,0,0,66.31 ,61.09 ,66.31 
03,003,01,008,0234,471,534,6,540,929,0,0,0,0,0,0,0,66.31 ,58.13 ,66.31 
03,003,01,008,0235,472,711,7,718,1168,0,0,0,0,0,0,0,66.31 ,61.47 ,66.31 
03,003,01,008,0235,473,500,6,506,1066,0,0,0,0,0,0,0,66.31 ,47.47 ,66.31 
03,003,01,008,0236,474,926,6,932,1373,0,0,0,0,0,0,0,66.31 ,67.88 ,66.31 
03,003,01,008,0236,475,741,3,744,1184,0,0,0,0,0,0,0,66.31 ,62.84 ,66.31 
03,003,01,008,0237,476,749,5,754,1077,0,0,0,0,0,0,0,66.31 ,70.01 ,66.31 
03,003,01,008,0237,477,837,8,845,1248,0,0,0,0,0,0,0,66.31 ,67.71 ,66.31 
03,003,01,008,0238,478,951,4,955,1578,0,0,0,0,0,0,0,66.31 ,60.52 ,66.31 
03,003,01,008,0238,479,859,8,867,1409,0,0,0,0,0,0,0,66.31 ,61.53 ,66.31 
03,003,01,008,0239,480,660,6,666,1015,0,0,0,0,0,0,0,66.31 ,65.62 ,66.31 
03,003,01,008,0239,481,690,10,700,1022,0,0,0,0,0,0,0,66.31 ,68.49 ,66.31 
03,003,01,008,0240,482,1066,16,1082,1659,0,0,0,0,0,0,0,66.31 ,65.22 ,66.31 
03,003,01,008,0241,483,687,12,699,992,0,0,0,0,0,0,0,66.31 ,70.46 ,66.31 
03,003,01,008,0241,484,719,12,731,1186,0,0,0,0,0,0,0,66.31 ,61.64 ,66.31 
03,003,01,008,0242,485,765,6,771,1313,0,0,0,0,0,0,0,66.31 ,58.72 ,66.31 
03,003,01,008,0242,486,562,9,571,873,0,0,0,0,0,0,0,66.31 ,65.41 ,66.31 
03,003,01,008,0243,487,950,20,970,1473,0,0,0,0,0,0,0,66.31 ,65.85 ,66.31 
03,003,01,008,0244,488,855,12,867,1283,0,0,0,0,0,0,0,66.31 ,67.58 ,66.31 
03,003,01,008,0244,489,724,10,734,1200,0,0,0,0,0,0,0,66.31 ,61.17 ,66.31 
03,003,01,008,0244,490,754,10,764,1191,0,0,0,0,0,0,0,66.31 ,64.15 ,66.31 
03,003,01,008,0245,491,860,12,872,1439,0,0,0,0,0,0,0,66.31 ,60.60 ,66.31 
03,003,01,008,0245,492,990,15,1005,1514,0,0,0,0,0,0,0,66.31 ,66.38 ,66.31 
03,003,01,008,0246,493,880,5,885,1647,0,0,0,0,0,0,0,66.31 ,53.73 ,66.31 
03,003,01,008,0246,494,842,16,858,1605,0,0,0,0,0,0,0,66.31 ,53.46 ,66.31 
03,003,01,008,0247,495,1006,26,1032,1517,0,0,0,0,0,0,0,66.31 ,68.03 ,66.31 
03,003,01,008,0248,496,693,4,697,1095,0,0,0,0,0,0,0,66.31 ,63.65 ,66.31 
03,003,01,008,0248,497,632,7,639,1235,0,0,0,0,0,0,0,66.31 ,51.74 ,66.31 
03,003,01,008,0249,498,843,11,854,1279,0,0,0,0,0,0,0,66.31 ,66.77 ,66.31 
03,003,01,008,0249,499,745,9,754,1183,0,0,0,0,0,0,0,66.31 ,63.74 ,66.31 
03,003,01,008,0249,500,620,5,625,1020,0,0,0,0,0,0,0,66.31 ,61.27 ,66.31 
03,003,01,008,0250,501,750,11,761,1183,0,0,0,0,0,0,0,66.31 ,64.33 ,66.31 
03,003,01,008,0250,502,821,21,842,1298,0,0,0,0,0,0,0,66.31 ,64.87 ,66.31 
03,003,01,008,0251,503,873,14,887,1415,0,0,0,0,0,0,0,66.31 ,62.69 ,66.31 
03,003,01,008,0251,504,573,9,582,894,0,0,0,0,0,0,0,66.31 ,65.10 ,66.31 
03,003,01,008,0252,505,799,12,811,1242,0,0,0,0,0,0,0,66.31 ,65.30 ,66.31 
03,003,01,008,0252,506,775,11,786,1217,0,0,0,0,0,0,0,66.31 ,64.59 ,66.31 
03,003,01,008,0253,507,758,11,769,1098,0,0,0,0,0,0,0,66.31 ,70.04 ,66.31 
03,003,01,008,0253,508,679,6,685,1047,0,0,0,0,0,0,0,66.31 ,65.43 ,66.31 
03,003,01,008,0253,509,904,9,913,1439,0,0,0,0,0,0,0,66.31 ,63.45 ,66.31 
03,003,01,008,0254,510,591,8,599,919,0,0,0,0,0,0,0,66.31 ,65.18 ,66.31 
03,003,01,008,0254,511,569,15,584,924,0,0,0,0,0,0,0,66.31 ,63.20 ,66.31 
03,003,01,008,0255,512,715,13,728,1129,0,0,0,0,0,0,0,66.31 ,64.48 ,66.31 
03,003,01,008,0255,513,597,5,602,1010,0,0,0,0,0,0,0,66.31 ,59.60 ,66.31 
03,003,01,008,0255,514,747,8,755,1226,0,0,0,0,0,0,0,66.31 ,61.58 ,66.31 
03,003,01,008,0256,515,1054,15,1069,1596,0,0,0,0,0,0,0,66.31 ,66.98 ,66.31 
03,003,01,008,0256,516,1007,11,1018,1566,0,0,0,0,0,0,0,66.31 ,65.01 ,66.31 
03,003,01,008,0257,517,794,8,802,1265,0,0,0,0,0,0,0,66.31 ,63.40 ,66.31 
03,003,01,008,0257,518,765,14,779,1229,0,0,0,0,0,0,0,66.31 ,63.38 ,66.31 
03,003,01,008,0257,519,723,11,734,1188,0,0,0,0,0,0,0,66.31 ,61.78 ,66.31 
03,003,01,008,0258,520,559,14,573,855,0,0,0,0,0,0,0,66.31 ,67.02 ,66.31 
03,003,01,008,0258,521,620,7,627,947,0,0,0,0,0,0,0,66.31 ,66.21 ,66.31 
03,003,01,008,0259,522,775,16,791,1220,0,0,0,0,0,0,0,66.31 ,64.84 ,66.31 
03,003,01,008,0259,523,784,13,797,1241,0,0,0,0,0,0,0,66.31 ,64.22 ,66.31 
03,003,01,008,0260,524,637,7,644,1073,0,0,0,0,0,0,0,66.31 ,60.02 ,66.31 
03,003,01,008,0260,525,473,6,479,965,0,0,0,0,0,0,0,66.31 ,49.64 ,66.31 
03,003,01,008,0261,526,819,9,828,1327,0,0,0,0,0,0,0,66.31 ,62.40 ,66.31 
03,003,01,008,0261,527,590,6,596,967,0,0,0,0,0,0,0,66.31 ,61.63 ,66.31 
03,003,01,008,0261,528,760,7,767,1098,0,0,0,0,0,0,0,66.31 ,69.85 ,66.31 
03,003,01,008,0262,529,841,17,858,1387,0,0,0,0,0,0,0,66.31 ,61.86 ,66.31 
03,003,01,008,0262,530,969,10,979,1625,0,0,0,0,0,0,0,66.31 ,60.25 ,66.31 
03,003,01,008,0262,531,1039,14,1053,1691,0,0,0,0,0,0,0,66.31 ,62.27 ,66.31 
03,003,01,008,0263,532,833,10,843,1388,0,0,0,0,0,0,0,66.31 ,60.73 ,66.31 
03,003,01,008,0263,533,833,13,846,1279,0,0,0,0,0,0,0,66.31 ,66.15 ,66.31 
03,003,01,008,0263,534,577,9,586,858,0,0,0,0,0,0,0,66.31 ,68.30 ,66.31 
03,003,01,008,0264,535,809,7,816,1330,0,0,0,0,0,0,0,66.31 ,61.35 ,66.31 
03,003,01,008,0264,536,879,5,884,1398,0,0,0,0,0,0,0,66.31 ,63.23 ,66.31 
03,003,01,008,0264,537,707,5,712,1141,0,0,0,0,0,0,0,66.31 ,62.40 ,66.31 
03,003,01,008,0264,538,719,16,735,1063,0,0,0,0,0,0,0,66.31 ,69.14 ,66.31 
03,003,01,008,0265,539,819,12,831,1185,0,0,0,0,0,0,0,66.31 ,70.13 ,66.31 
03,003,01,008,0265,540,808,10,818,1298,0,0,0,0,0,0,0,66.31 ,63.02 ,66.31 
03,003,01,008,0265,541,724,4,728,1217,0,0,0,0,0,0,0,66.31 ,59.82 ,66.31 
03,003,01,008,0266,542,698,9,707,1092,0,0,0,0,0,0,0,66.31 ,64.74 ,66.31 
03,003,01,008,0266,543,790,11,801,1083,0,0,0,0,0,0,0,66.31 ,73.96 ,66.31 
03,003,01,008,0266,544,808,11,819,1237,0,0,0,0,0,0,0,66.31 ,66.21 ,66.31 
03,003,01,008,0266,545,664,9,673,1265,0,0,0,0,0,0,0,66.31 ,53.20 ,66.31 
03,003,01,008,0267,546,728,12,740,1159,0,0,0,0,0,0,0,66.31 ,63.85 ,66.31 
03,003,01,008,0267,547,585,8,593,1128,0,0,0,0,0,0,0,66.31 ,52.57 ,66.31 
03,003,01,008,0267,548,604,2,606,1153,0,0,0,0,0,0,0,66.31 ,52.56 ,66.31 
03,003,01,008,0268,549,464,9,473,837,0,0,0,0,0,0,0,66.31 ,56.51 ,66.31 
03,003,01,008,0268,550,830,10,840,1354,0,0,0,0,0,0,0,66.31 ,62.04 ,66.31 
03,003,01,008,0268,551,816,9,825,1395,0,0,0,0,0,0,0,66.31 ,59.14 ,66.31 
03,003,01,008,0269,552,1032,8,1040,1487,0,0,0,0,0,0,0,66.31 ,69.94 ,66.31 
03,003,01,008,0270,553,1077,6,1083,1808,0,0,0,0,0,0,0,66.31 ,59.90 ,66.31 
03,003,01,008,0271,554,1047,7,1054,1622,0,0,0,0,0,0,0,66.31 ,64.98 ,66.31 
03,003,01,008,0272,555,832,12,844,1369,0,0,0,0,0,0,0,66.31 ,61.65 ,66.31 
03,003,01,008,0272,556,962,13,975,1460,0,0,0,0,0,0,0,66.31 ,66.78 ,66.31 
03,003,01,008,0272,557,1000,10,1010,1587,0,0,0,0,0,0,0,66.31 ,63.64 ,66.31 
03,003,01,008,0273,558,668,11,679,978,0,0,0,0,0,0,0,66.31 ,69.43 ,66.31 
03,003,01,008,0273,559,896,11,907,1333,0,0,0,0,0,0,0,66.31 ,68.04 ,66.31 
03,003,01,008,0274,560,699,4,703,1015,0,0,0,0,0,0,0,66.31 ,69.26 ,66.31 
03,003,01,008,0275,561,590,5,595,927,0,0,0,0,0,0,0,66.31 ,64.19 ,66.31 
03,003,01,008,0276,562,656,5,661,1066,0,0,0,0,0,0,0,66.31 ,62.01 ,66.31 
03,003,01,008,0277,563,722,5,727,1109,0,0,0,0,0,0,0,66.31 ,65.55 ,66.31 
03,003,01,008,0278,564,797,10,807,1199,0,0,0,0,0,0,0,66.31 ,67.31 ,66.31 
03,003,01,008,0278,565,663,6,669,932,0,0,0,0,0,0,0,66.31 ,71.78 ,66.31 
03,003,01,008,0279,566,687,7,694,1021,0,0,0,0,0,0,0,66.31 ,67.97 ,66.31 
03,003,01,008,0279,567,729,10,739,1126,0,0,0,0,0,0,0,66.31 ,65.63 ,66.31 
03,003,01,008,0279,568,830,8,838,1337,0,0,0,0,0,0,0,66.31 ,62.68 ,66.31 
03,003,01,008,0280,569,596,8,604,1118,0,0,0,0,0,0,0,66.31 ,54.03 ,66.31 
03,003,01,008,0280,570,1017,10,1027,1600,0,0,0,0,0,0,0,66.31 ,64.19 ,66.31 
03,003,01,008,0280,571,864,7,871,1458,0,0,0,0,0,0,0,66.31 ,59.74 ,66.31 
03,003,01,008,0281,572,753,14,767,1174,0,0,0,0,0,0,0,66.31 ,65.33 ,66.31 
03,003,01,008,0281,573,989,9,998,1693,0,0,0,0,0,0,0,66.31 ,58.95 ,66.31 
03,003,01,008,0282,574,798,16,814,1193,0,0,0,0,0,0,0,66.31 ,68.23 ,66.31 
03,003,01,008,0282,575,825,11,836,1239,0,0,0,0,0,0,0,66.31 ,67.47 ,66.31 
03,003,01,008,0283,576,614,9,623,1092,0,0,0,0,0,0,0,66.31 ,57.05 ,66.31 
03,003,01,008,0283,577,774,7,781,1201,0,0,0,0,0,0,0,66.31 ,65.03 ,66.31 
03,003,01,008,0283,578,824,16,840,1278,0,0,0,0,0,0,0,66.31 ,65.73 ,66.31 
03,003,01,008,0284,579,1034,20,1054,1631,0,0,0,0,0,0,0,66.31 ,64.62 ,66.31 
03,003,01,008,0284,580,898,12,910,1484,0,0,0,0,0,0,0,66.31 ,61.32 ,66.31 
03,003,01,008,0285,581,651,5,656,936,0,0,0,0,0,0,0,66.31 ,70.09 ,66.31 
03,003,01,008,0285,582,715,7,722,1056,0,0,0,0,0,0,0,66.31 ,68.37 ,66.31 
03,003,01,008,0286,583,884,15,899,1384,0,0,0,0,0,0,0,66.31 ,64.96 ,66.31 
03,003,01,008,0287,584,1037,10,1047,1604,0,0,0,0,0,0,0,66.31 ,65.27 ,66.31 
03,003,01,008,0287,585,949,12,961,1523,0,0,0,0,0,0,0,66.31 ,63.10 ,66.31 
03,003,01,008,0288,586,1078,12,1090,1484,0,0,0,0,0,0,0,66.31 ,73.45 ,66.31 
03,003,01,008,0288,587,799,14,813,1222,0,0,0,0,0,0,0,66.31 ,66.53 ,66.31 
03,003,01,008,0289,588,850,18,868,1222,0,0,0,0,0,0,0,66.31 ,71.03 ,66.31 
03,003,01,008,0289,589,990,13,1003,1362,0,0,0,0,0,0,0,66.31 ,73.64 ,66.31 
03,003,01,008,0290,590,842,9,851,1162,0,0,0,0,0,0,0,66.31 ,73.24 ,66.31 
03,003,01,008,0290,591,694,13,707,1000,0,0,0,0,0,0,0,66.31 ,70.70 ,66.31 
03,003,01,009,0291,592,1003,12,1015,1538,0,0,0,0,0,0,0,66.31 ,65.99 ,66.31 
03,003,01,009,0291,593,1043,16,1059,1586,0,0,0,0,0,0,0,66.31 ,66.77 ,66.31 
03,003,01,009,0292,594,965,17,982,1490,0,0,0,0,0,0,0,66.31 ,65.91 ,66.31 
03,003,01,009,0292,595,1072,16,1088,1828,0,0,0,0,0,0,0,66.31 ,59.52 ,66.31 
03,003,01,009,0293,596,638,7,645,1046,0,0,0,0,0,0,0,66.31 ,61.66 ,66.31 
03,003,01,009,0293,597,791,11,802,1516,0,0,0,0,0,0,0,66.31 ,52.90 ,66.31 
03,003,01,009,0293,598,760,7,767,1227,0,0,0,0,0,0,0,66.31 ,62.51 ,66.31 
03,003,01,009,0294,599,654,10,664,1033,0,0,0,0,0,0,0,66.31 ,64.28 ,66.31 
03,003,01,009,0294,600,554,14,568,795,0,0,0,0,0,0,0,66.31 ,71.45 ,66.31 
03,003,01,009,0295,601,1043,10,1053,1599,0,0,0,0,0,0,0,66.31 ,65.85 ,66.31 
03,003,01,009,0296,602,744,9,753,1162,0,0,0,0,0,0,0,66.31 ,64.80 ,66.31 
03,003,01,009,0296,603,641,8,649,1028,0,0,0,0,0,0,0,66.31 ,63.13 ,66.31 
03,003,01,009,0297,604,804,17,821,1308,0,0,0,0,0,0,0,66.31 ,62.77 ,66.31 
03,003,01,009,0297,605,665,3,668,969,0,0,0,0,0,0,0,66.31 ,68.94 ,66.31 
03,003,01,009,0298,606,1055,13,1068,1500,0,0,0,0,0,0,0,66.31 ,71.20 ,66.31 
03,003,01,009,0299,607,1124,18,1142,1702,0,0,0,0,0,0,0,66.31 ,67.10 ,66.31 
03,003,01,009,0299,608,1002,12,1014,1585,0,0,0,0,0,0,0,66.31 ,63.97 ,66.31 
03,003,01,009,0300,609,852,12,864,1324,0,0,0,0,0,0,0,66.31 ,65.26 ,66.31 
03,003,01,009,0300,610,846,11,857,1310,0,0,0,0,0,0,0,66.31 ,65.42 ,66.31 
03,003,01,009,0301,611,902,6,908,1443,0,0,0,0,0,0,0,66.31 ,62.92 ,66.31 
03,003,01,009,0301,612,759,9,768,1180,0,0,0,0,0,0,0,66.31 ,65.08 ,66.31 
03,003,01,009,0302,613,813,23,836,1300,0,0,0,0,0,0,0,66.31 ,64.31 ,66.31 
03,003,01,009,0302,614,738,10,748,1122,0,0,0,0,0,0,0,66.31 ,66.67 ,66.31 
03,003,01,009,0303,615,941,17,958,1374,0,0,0,0,0,0,0,66.31 ,69.72 ,66.31 
03,003,01,009,0303,616,994,11,1005,1500,0,0,0,0,0,0,0,66.31 ,67.00 ,66.31 
03,003,01,009,0304,617,680,14,694,1064,0,0,0,0,0,0,0,66.31 ,65.23 ,66.31 
03,003,01,009,0304,618,706,16,722,1120,0,0,0,0,0,0,0,66.31 ,64.46 ,66.31 
03,003,01,009,0305,619,894,14,908,1305,0,0,0,0,0,0,0,66.31 ,69.58 ,66.31 
03,003,01,009,0306,620,812,12,824,1296,0,0,0,0,0,0,0,66.31 ,63.58 ,66.31 
03,003,01,009,0307,621,938,17,955,1355,0,0,0,0,0,0,0,66.31 ,70.48 ,66.31 
03,003,01,009,0307,622,677,14,691,985,0,0,0,0,0,0,0,66.31 ,70.15 ,66.31 
03,003,01,009,0308,623,898,19,917,1458,0,0,0,0,0,0,0,66.31 ,62.89 ,66.31 
03,003,01,009,0308,624,1019,16,1035,1507,0,0,0,0,0,0,0,66.31 ,68.68 ,66.31 
03,003,01,009,0309,625,936,18,954,1474,0,0,0,0,0,0,0,66.31 ,64.72 ,66.31 
03,003,01,009,0309,626,790,17,807,1227,0,0,0,0,0,0,0,66.31 ,65.77 ,66.31 
03,003,01,009,0310,627,732,16,748,1089,0,0,0,0,0,0,0,66.31 ,68.69 ,66.31 
03,003,01,009,0310,628,592,12,604,962,0,0,0,0,0,0,0,66.31 ,62.79 ,66.31 
03,003,01,009,0311,629,717,17,734,1221,0,0,0,0,0,0,0,66.31 ,60.11 ,66.31 
03,003,01,009,0311,630,791,16,807,1201,0,0,0,0,0,0,0,66.31 ,67.19 ,66.31 
03,003,01,009,0312,631,826,10,836,1187,0,0,0,0,0,0,0,66.31 ,70.43 ,66.31 
03,003,01,009,0312,632,701,10,711,1006,0,0,0,0,0,0,0,66.31 ,70.68 ,66.31 
03,003,01,009,0312,633,614,5,619,1140,0,0,0,0,0,0,0,66.31 ,54.30 ,66.31 
03,003,01,009,0313,634,895,15,910,1303,0,0,0,0,0,0,0,66.31 ,69.84 ,66.31 
03,003,01,009,0313,635,828,15,843,1233,0,0,0,0,0,0,0,66.31 ,68.37 ,66.31 
03,003,01,009,0313,636,772,17,789,1274,0,0,0,0,0,0,0,66.31 ,61.93 ,66.31 
03,003,01,009,0314,637,881,13,894,1301,0,0,0,0,0,0,0,66.31 ,68.72 ,66.31 
03,003,01,009,0315,638,946,8,954,1396,0,0,0,0,0,0,0,66.31 ,68.34 ,66.31 
03,003,01,009,0315,639,941,15,956,1407,0,0,0,0,0,0,0,66.31 ,67.95 ,66.31 
03,003,01,009,0315,640,907,19,926,1361,0,0,0,0,0,0,0,66.31 ,68.04 ,66.31 
03,003,01,009,0316,641,722,16,738,1119,0,0,0,0,0,0,0,66.31 ,65.95 ,66.31 
03,003,01,009,0316,642,885,13,898,1351,0,0,0,0,0,0,0,66.31 ,66.47 ,66.31 
03,003,01,009,0317,643,976,9,985,1508,0,0,0,0,0,0,0,66.31 ,65.32 ,66.31 
03,003,01,009,0317,644,1149,17,1166,1949,0,0,0,0,0,0,0,66.31 ,59.83 ,66.31 
03,003,01,009,0318,645,1093,7,1100,1767,0,0,0,0,0,0,0,66.31 ,62.25 ,66.31 
03,003,01,009,0318,646,740,12,752,1154,0,0,0,0,0,0,0,66.31 ,65.16 ,66.31 
03,003,01,009,0319,647,696,10,706,1168,0,0,0,0,0,0,0,66.31 ,60.45 ,66.31 
03,003,01,009,0319,648,835,11,846,1357,0,0,0,0,0,0,0,66.31 ,62.34 ,66.31 
03,003,01,009,0319,649,774,11,785,1325,0,0,0,0,0,0,0,66.31 ,59.25 ,66.31 
03,003,01,009,0319,650,696,10,706,1066,0,0,0,0,0,0,0,66.31 ,66.23 ,66.31 
03,003,01,009,0320,651,1059,13,1072,1569,0,0,0,0,0,0,0,66.31 ,68.32 ,66.31 
03,003,01,009,0320,652,919,10,929,1487,0,0,0,0,0,0,0,66.31 ,62.47 ,66.31 
03,003,01,009,0320,653,807,9,816,1253,0,0,0,0,0,0,0,66.31 ,65.12 ,66.31 
03,003,01,009,0321,654,878,16,894,1390,0,0,0,0,0,0,0,66.31 ,64.32 ,66.31 
03,003,01,009,0321,655,928,5,933,1586,0,0,0,0,0,0,0,66.31 ,58.83 ,66.31 
03,003,01,009,0322,656,1016,19,1035,1607,0,0,0,0,0,0,0,66.31 ,64.41 ,66.31 
03,003,01,009,0322,657,512,9,521,938,0,0,0,0,0,0,0,66.31 ,55.54 ,66.31 
03,003,01,009,0322,658,710,9,719,1309,0,0,0,0,0,0,0,66.31 ,54.93 ,66.31 
03,003,01,009,0323,659,643,10,653,1066,0,0,0,0,0,0,0,66.31 ,61.26 ,66.31 
03,003,01,009,0323,660,589,8,597,1017,0,0,0,0,0,0,0,66.31 ,58.70 ,66.31 
03,003,01,009,0323,661,603,8,611,1105,0,0,0,0,0,0,0,66.31 ,55.29 ,66.31 
03,003,01,009,0324,662,802,15,817,1187,0,0,0,0,0,0,0,66.31 ,68.83 ,66.31 
03,003,01,009,0324,663,676,4,680,1003,0,0,0,0,0,0,0,66.31 ,67.80 ,66.31 
03,003,01,009,0324,664,641,5,646,1019,0,0,0,0,0,0,0,66.31 ,63.40 ,66.31 
03,003,01,009,0325,665,713,8,721,1075,0,0,0,0,0,0,0,66.31 ,67.07 ,66.31 
03,003,01,009,0325,666,799,7,806,1299,0,0,0,0,0,0,0,66.31 ,62.05 ,66.31 
03,003,01,009,0326,667,562,15,577,891,0,0,0,0,0,0,0,66.31 ,64.76 ,66.31 
03,003,01,009,0326,668,744,19,763,1094,0,0,0,0,0,0,0,66.31 ,69.74 ,66.31 
03,003,01,009,0326,669,644,15,659,946,0,0,0,0,0,0,0,66.31 ,69.66 ,66.31 
03,003,01,009,0327,670,716,12,728,1105,0,0,0,0,0,0,0,66.31 ,65.88 ,66.31 
03,003,01,009,0327,671,638,9,647,936,0,0,0,0,0,0,0,66.31 ,69.12 ,66.31 
03,003,01,009,0328,672,669,11,680,1136,0,0,0,0,0,0,0,66.31 ,59.86 ,66.31 
03,003,01,009,0328,673,689,21,710,1138,0,0,0,0,0,0,0,66.31 ,62.39 ,66.31 
03,003,01,009,0328,674,960,23,983,1558,0,0,0,0,0,0,0,66.31 ,63.09 ,66.31 
03,003,01,009,0328,675,869,9,878,1316,0,0,0,0,0,0,0,66.31 ,66.72 ,66.31 
03,003,01,009,0328,676,979,14,993,1546,0,0,0,0,0,0,0,66.31 ,64.23 ,66.31 
03,003,01,009,0329,677,1011,17,1028,1511,0,0,0,0,0,0,0,66.31 ,68.03 ,66.31 
03,003,01,009,0329,678,910,9,919,1522,0,0,0,0,0,0,0,66.31 ,60.38 ,66.31 
03,003,01,009,0330,679,560,4,564,794,0,0,0,0,0,0,0,66.31 ,71.03 ,66.31 
03,003,01,009,0330,680,752,8,760,1119,0,0,0,0,0,0,0,66.31 ,67.92 ,66.31 
03,003,01,009,0331,681,657,11,668,1069,0,0,0,0,0,0,0,66.31 ,62.49 ,66.31 
03,003,01,009,0331,682,767,9,776,1120,0,0,0,0,0,0,0,66.31 ,69.29 ,66.31 
03,003,01,010,0332,683,712,14,726,1134,0,0,0,0,0,0,0,66.31 ,64.02 ,66.31 
03,003,01,010,0332,684,994,17,1011,1481,0,0,0,0,0,0,0,66.31 ,68.26 ,66.31 
03,003,01,010,0332,685,689,11,700,1069,0,0,0,0,0,0,0,66.31 ,65.48 ,66.31 
03,003,01,010,0333,686,1083,13,1096,1530,0,0,0,0,0,0,0,66.31 ,71.63 ,66.31 
03,003,01,010,0334,687,825,12,837,1183,0,0,0,0,0,0,0,66.31 ,70.75 ,66.31 
03,003,01,010,0334,688,902,10,912,1381,0,0,0,0,0,0,0,66.31 ,66.04 ,66.31 
03,003,01,010,0335,689,560,6,566,809,0,0,0,0,0,0,0,66.31 ,69.96 ,66.31 
03,003,01,010,0335,690,435,4,439,608,0,0,0,0,0,0,0,66.31 ,72.20 ,66.31 
03,003,01,010,0336,691,550,5,555,779,0,0,0,0,0,0,0,66.31 ,71.25 ,66.31 
03,003,01,010,0336,692,643,3,646,916,0,0,0,0,0,0,0,66.31 ,70.52 ,66.31 
03,003,01,010,0337,693,661,10,671,1109,0,0,0,0,0,0,0,66.31 ,60.50 ,66.31 
03,003,01,010,0338,694,1076,19,1095,1627,0,0,0,0,0,0,0,66.31 ,67.30 ,66.31 
03,003,01,010,0338,695,946,13,959,1584,0,0,0,0,0,0,0,66.31 ,60.54 ,66.31 
03,003,01,010,0339,696,1180,8,1188,2010,0,0,0,0,0,0,0,66.31 ,59.10 ,66.31 
03,003,01,010,0340,697,747,12,759,1062,0,0,0,0,0,0,0,66.31 ,71.47 ,66.31 
03,003,01,010,0340,698,550,7,557,1150,0,0,0,0,0,0,0,66.31 ,48.43 ,66.31 
03,003,01,010,0341,699,932,6,938,1779,0,0,0,0,0,0,0,66.31 ,52.73 ,66.31 
03,003,01,010,0341,700,416,3,419,827,0,0,0,0,0,0,0,66.31 ,50.67 ,66.31 
03,003,01,010,0342,701,683,8,691,1137,0,0,0,0,0,0,0,66.31 ,60.77 ,66.31 
03,003,01,010,0342,702,695,14,709,1234,0,0,0,0,0,0,0,66.31 ,57.46 ,66.31 
03,003,01,010,0343,703,1035,15,1050,2143,0,0,0,0,0,0,0,66.31 ,49.00 ,66.31 
03,003,01,010,0344,704,869,8,877,1270,0,0,0,0,0,0,0,66.31 ,69.06 ,66.31 
03,003,01,010,0344,705,889,8,897,1370,0,0,0,0,0,0,0,66.31 ,65.47 ,66.31 
03,003,01,010,0345,706,1022,14,1036,1760,0,0,0,0,0,0,0,66.31 ,58.86 ,66.31 
03,003,01,010,0346,707,935,7,942,1350,0,0,0,0,0,0,0,66.31 ,69.78 ,66.31 
03,003,01,010,0346,708,876,7,883,1265,0,0,0,0,0,0,0,66.31 ,69.80 ,66.31 
03,003,01,010,0347,709,771,9,780,1122,0,0,0,0,0,0,0,66.31 ,69.52 ,66.31 
03,003,01,010,0348,710,926,20,946,1581,0,0,0,0,0,0,0,66.31 ,59.84 ,66.31 
03,003,01,010,0349,711,590,6,596,948,0,0,0,0,0,0,0,66.31 ,62.87 ,66.31 
03,003,01,010,0349,712,777,5,782,1095,0,0,0,0,0,0,0,66.31 ,71.42 ,66.31 
03,003,01,010,0350,713,990,15,1005,1459,0,0,0,0,0,0,0,66.31 ,68.88 ,66.31 
03,003,01,010,0350,714,1080,19,1099,1705,0,0,0,0,0,0,0,66.31 ,64.46 ,66.31 
03,003,01,010,0351,715,911,24,935,1399,0,0,0,0,0,0,0,66.31 ,66.83 ,66.31 
03,003,01,010,0351,716,928,18,946,1383,0,0,0,0,0,0,0,66.31 ,68.40 ,66.31 
03,003,01,010,0352,717,919,16,935,1281,0,0,0,0,0,0,0,66.31 ,72.99 ,66.31 
03,003,01,010,0352,718,732,10,742,1206,0,0,0,0,0,0,0,66.31 ,61.53 ,66.31 
03,003,01,010,0353,719,1051,12,1063,1635,0,0,0,0,0,0,0,66.31 ,65.02 ,66.31 
03,003,01,010,0354,720,1034,20,1054,1519,0,0,0,0,0,0,0,66.31 ,69.39 ,66.31 
03,003,01,010,0354,721,884,13,897,1253,0,0,0,0,0,0,0,66.31 ,71.59 ,66.31 
03,003,01,010,0355,722,960,10,970,1299,0,0,0,0,0,0,0,66.31 ,74.67 ,66.31 
03,003,01,010,0355,723,838,12,850,1203,0,0,0,0,0,0,0,66.31 ,70.66 ,66.31 
03,003,01,010,0355,724,894,16,910,1353,0,0,0,0,0,0,0,66.31 ,67.26 ,66.31 
03,003,01,010,0356,725,1190,11,1201,1729,0,0,0,0,0,0,0,66.31 ,69.46 ,66.31 
03,003,01,010,0357,726,599,7,606,1244,0,0,0,0,0,0,0,66.31 ,48.71 ,66.31 
03,003,01,010,0357,727,811,17,828,1247,0,0,0,0,0,0,0,66.31 ,66.40 ,66.31 
03,003,01,010,0358,728,844,22,866,1412,0,0,0,0,0,0,0,66.31 ,61.33 ,66.31 
03,003,01,010,0358,729,762,12,774,1357,0,0,0,0,0,0,0,66.31 ,57.04 ,66.31 
03,003,01,010,0359,730,727,6,733,1058,0,0,0,0,0,0,0,66.31 ,69.28 ,66.31 
03,003,01,010,0359,731,652,5,657,1000,0,0,0,0,0,0,0,66.31 ,65.70 ,66.31 
03,003,01,010,0360,732,670,6,676,1044,0,0,0,0,0,0,0,66.31 ,64.75 ,66.31 
03,003,01,010,0360,733,663,18,681,1117,0,0,0,0,0,0,0,66.31 ,60.97 ,66.31 
03,003,01,010,0360,734,689,19,708,1041,0,0,0,0,0,0,0,66.31 ,68.01 ,66.31 
03,003,01,010,0361,735,639,7,646,1214,0,0,0,0,0,0,0,66.31 ,53.21 ,66.31 
03,003,01,010,0362,736,866,17,883,1278,0,0,0,0,0,0,0,66.31 ,69.09 ,66.31 
03,003,01,010,0362,737,448,4,452,733,0,0,0,0,0,0,0,66.31 ,61.66 ,66.31 
03,003,01,010,0363,738,810,15,825,1205,0,0,0,0,0,0,0,66.31 ,68.46 ,66.31 
03,003,01,010,0364,739,985,22,1007,1675,0,0,0,0,0,0,0,66.31 ,60.12 ,66.31 
03,003,01,010,0365,740,966,11,977,1447,0,0,0,0,0,0,0,66.31 ,67.52 ,66.31 
03,003,01,010,0365,741,865,11,876,1355,0,0,0,0,0,0,0,66.31 ,64.65 ,66.31 
03,003,01,010,0366,742,943,14,957,1324,0,0,0,0,0,0,0,66.31 ,72.28 ,66.31 
03,003,01,010,0366,743,825,13,838,1450,0,0,0,0,0,0,0,66.31 ,57.79 ,66.31 
03,003,01,011,0367,744,1090,15,1105,1799,0,0,0,0,0,0,0,66.31 ,61.42 ,66.31 
03,003,01,011,0367,745,1197,24,1221,1873,0,0,0,0,0,0,0,66.31 ,65.19 ,66.31 
03,003,01,011,0367,746,974,12,986,1533,0,0,0,0,0,0,0,66.31 ,64.32 ,66.31 
03,003,01,011,0368,747,1305,17,1322,1902,0,0,0,0,0,0,0,66.31 ,69.51 ,66.31 
03,003,01,011,0368,748,993,12,1005,1466,0,0,0,0,0,0,0,66.31 ,68.55 ,66.31 
03,003,01,011,0369,749,929,20,949,1489,0,0,0,0,0,0,0,66.31 ,63.73 ,66.31 
03,003,01,011,0369,750,631,8,639,1143,0,0,0,0,0,0,0,66.31 ,55.91 ,66.31 
03,003,01,011,0369,751,821,15,836,1292,0,0,0,0,0,0,0,66.31 ,64.71 ,66.31 
03,003,01,011,0369,752,937,19,956,1499,0,0,0,0,0,0,0,66.31 ,63.78 ,66.31 
03,003,01,011,0370,753,511,9,520,720,0,0,0,0,0,0,0,66.31 ,72.22 ,66.31 
03,003,01,011,0371,754,1188,23,1211,1703,0,0,0,0,0,0,0,66.31 ,71.11 ,66.31 
03,003,01,011,0371,755,1045,24,1069,1692,0,0,0,0,0,0,0,66.31 ,63.18 ,66.31 
03,003,01,011,0371,756,900,12,912,1350,0,0,0,0,0,0,0,66.31 ,67.56 ,66.31 
03,003,01,011,0372,757,740,12,752,1196,0,0,0,0,0,0,0,66.31 ,62.88 ,66.31 
03,003,01,011,0372,758,607,12,619,975,0,0,0,0,0,0,0,66.31 ,63.49 ,66.31 
03,003,01,011,0372,759,736,14,750,1233,0,0,0,0,0,0,0,66.31 ,60.83 ,66.31 
03,003,01,011,0372,760,849,11,860,1417,0,0,0,0,0,0,0,66.31 ,60.69 ,66.31 
03,003,01,011,0373,761,663,13,676,1014,0,0,0,0,0,0,0,66.31 ,66.67 ,66.31 
03,003,01,011,0373,762,861,8,869,1376,0,0,0,0,0,0,0,66.31 ,63.15 ,66.31 
03,003,01,011,0374,763,767,5,772,1083,0,0,0,0,0,0,0,66.31 ,71.28 ,66.31 
03,003,01,011,0374,764,678,1,679,926,0,0,0,0,0,0,0,66.31 ,73.33 ,66.31 
03,003,01,011,0375,765,1041,17,1058,1504,0,0,0,0,0,0,0,66.31 ,70.35 ,66.31 
03,003,01,011,0375,766,1127,18,1145,1766,0,0,0,0,0,0,0,66.31 ,64.84 ,66.31 
03,003,01,011,0375,767,914,19,933,1415,0,0,0,0,0,0,0,66.31 ,65.94 ,66.31 
03,003,01,011,0375,768,929,9,938,1554,0,0,0,0,0,0,0,66.31 ,60.36 ,66.31 
03,003,01,011,0376,769,589,8,597,997,0,0,0,0,0,0,0,66.31 ,59.88 ,66.31 
03,003,01,011,0376,770,906,13,919,1448,0,0,0,0,0,0,0,66.31 ,63.47 ,66.31 
03,003,01,011,0376,771,873,17,890,1596,0,0,0,0,0,0,0,66.31 ,55.76 ,66.31 
03,003,01,011,0377,772,811,11,822,1293,0,0,0,0,0,0,0,66.31 ,63.57 ,66.31 
03,003,01,011,0377,773,800,9,809,1310,0,0,0,0,0,0,0,66.31 ,61.76 ,66.31 
03,003,01,011,0377,774,906,17,923,1406,0,0,0,0,0,0,0,66.31 ,65.65 ,66.31 
03,003,01,011,0377,775,1012,21,1033,1651,0,0,0,0,0,0,0,66.31 ,62.57 ,66.31 
03,003,01,011,0377,776,925,21,946,1682,0,0,0,0,0,0,0,66.31 ,56.24 ,66.31 
03,003,01,011,0378,777,1095,12,1107,1722,0,0,0,0,0,0,0,66.31 ,64.29 ,66.31 
03,003,01,011,0378,778,841,6,847,1256,0,0,0,0,0,0,0,66.31 ,67.44 ,66.31 
03,003,01,011,0379,779,863,20,883,1290,0,0,0,0,0,0,0,66.31 ,68.45 ,66.31 
03,003,01,011,0380,780,498,9,507,782,0,0,0,0,0,0,0,66.31 ,64.83 ,66.31 
03,003,01,011,0381,781,895,8,903,1318,0,0,0,0,0,0,0,66.31 ,68.51 ,66.31 
03,003,01,011,0381,782,813,9,822,1262,0,0,0,0,0,0,0,66.31 ,65.13 ,66.31 
03,003,01,011,0381,783,863,7,870,1338,0,0,0,0,0,0,0,66.31 ,65.02 ,66.31 
03,003,01,011,0381,784,912,8,920,1388,0,0,0,0,0,0,0,66.31 ,66.28 ,66.31 
03,003,01,011,0381,785,799,16,815,1342,0,0,0,0,0,0,0,66.31 ,60.73 ,66.31 
03,003,01,011,0382,786,731,8,739,1109,0,0,0,0,0,0,0,66.31 ,66.64 ,66.31 
03,003,01,011,0382,787,622,14,636,1088,0,0,0,0,0,0,0,66.31 ,58.46 ,66.31 
03,003,01,011,0383,788,656,12,668,1018,0,0,0,0,0,0,0,66.31 ,65.62 ,66.31 
03,003,01,011,0383,789,703,12,715,1181,0,0,0,0,0,0,0,66.31 ,60.54 ,66.31 
03,003,01,011,0384,790,563,12,575,802,0,0,0,0,0,0,0,66.31 ,71.70 ,66.31 
03,003,01,011,0385,791,507,3,510,672,0,0,0,0,0,0,0,66.31 ,75.89 ,66.31 
03,003,01,012,0386,792,865,10,875,1158,0,0,0,0,0,0,0,66.31 ,75.56 ,66.31 
03,003,01,012,0386,793,821,2,823,1110,0,0,0,0,0,0,0,66.31 ,74.14 ,66.31 
03,003,01,012,0387,794,949,9,958,1221,0,0,0,0,0,0,0,66.31 ,78.46 ,66.31 
03,003,01,012,0387,795,1123,7,1130,1534,0,0,0,0,0,0,0,66.31 ,73.66 ,66.31 
03,003,01,012,0388,796,861,10,871,1168,0,0,0,0,0,0,0,66.31 ,74.57 ,66.31 
03,003,01,012,0389,797,1001,17,1018,1398,0,0,0,0,0,0,0,66.31 ,72.82 ,66.31 
03,003,01,012,0389,798,904,17,921,1294,0,0,0,0,0,0,0,66.31 ,71.17 ,66.31 
03,003,01,012,0390,799,1213,13,1226,1617,0,0,0,0,0,0,0,66.31 ,75.82 ,66.31 
03,003,01,012,0391,800,789,7,796,1052,0,0,0,0,0,0,0,66.31 ,75.67 ,66.31 
03,003,01,012,0392,801,1042,15,1057,1345,0,0,0,0,0,0,0,66.31 ,78.59 ,66.31 
03,003,01,012,0393,802,1385,17,1402,1853,0,0,0,0,0,0,0,66.31 ,75.66 ,66.31 
03,003,01,012,0394,803,1213,15,1228,1686,0,0,0,0,0,0,0,66.31 ,72.84 ,66.31 
03,003,01,012,0395,804,1123,14,1137,1588,0,0,0,0,0,0,0,66.31 ,71.60 ,66.31 
03,003,01,012,0395,805,739,6,745,1042,0,0,0,0,0,0,0,66.31 ,71.50 ,66.31 
03,003,01,012,0396,806,950,12,962,1328,0,0,0,0,0,0,0,66.31 ,72.44 ,66.31 
03,003,01,012,0397,807,1123,8,1131,1498,0,0,0,0,0,0,0,66.31 ,75.50 ,66.31 
03,003,01,012,0398,808,756,12,768,1144,0,0,0,0,0,0,0,66.31 ,67.13 ,66.31 
03,003,01,012,0399,809,561,8,569,802,0,0,0,0,0,0,0,66.31 ,70.95 ,66.31 
03,003,01,012,0400,810,462,5,467,672,0,0,0,0,0,0,0,66.31 ,69.49 ,66.31 
03,003,01,012,0401,811,798,14,812,1082,0,0,0,0,0,0,0,66.31 ,75.05 ,66.31 
03,003,01,012,0402,812,791,17,808,1096,0,0,0,0,0,0,0,66.31 ,73.72 ,66.31 
03,003,01,012,0403,813,634,5,639,881,0,0,0,0,0,0,0,66.31 ,72.53 ,66.31 
03,003,01,012,0403,814,881,9,890,1244,0,0,0,0,0,0,0,66.31 ,71.54 ,66.31 
03,003,01,012,0404,815,611,7,618,913,0,0,0,0,0,0,0,66.31 ,67.69 ,66.31 
03,003,01,012,0405,816,518,3,521,732,0,0,0,0,0,0,0,66.31 ,71.17 ,66.31 
03,003,01,012,0406,817,571,8,579,820,0,0,0,0,0,0,0,66.31 ,70.61 ,66.31 
03,003,01,012,0407,818,1065,12,1077,1482,0,0,0,0,0,0,0,66.31 ,72.67 ,66.31 
03,003,01,012,0408,819,772,15,787,1054,0,0,0,0,0,0,0,66.31 ,74.67 ,66.31 
03,003,01,013,0409,820,792,13,805,1106,0,0,0,0,0,0,0,66.31 ,72.78 ,66.31 
03,003,01,013,0409,821,818,9,827,1137,0,0,0,0,0,0,0,66.31 ,72.74 ,66.31 
03,003,01,013,0410,822,846,15,861,1133,0,0,0,0,0,0,0,66.31 ,75.99 ,66.31 
03,003,01,013,0411,823,876,13,889,1270,0,0,0,0,0,0,0,66.31 ,70.00 ,66.31 
03,003,01,013,0412,824,774,8,782,1072,0,0,0,0,0,0,0,66.31 ,72.95 ,66.31 
03,003,01,013,0413,825,1011,13,1024,1440,0,0,0,0,0,0,0,66.31 ,71.11 ,66.31 
03,003,01,013,0414,826,482,4,486,667,0,0,0,0,0,0,0,66.31 ,72.86 ,66.31 
03,003,01,013,0415,827,553,2,555,723,0,0,0,0,0,0,0,66.31 ,76.76 ,66.31 
03,003,01,013,0416,828,522,5,527,691,0,0,0,0,0,0,0,66.31 ,76.27 ,66.31 
03,003,01,013,0417,829,788,15,803,1146,0,0,0,0,0,0,0,66.31 ,70.07 ,66.31 
03,003,01,013,0418,830,1113,15,1128,1682,0,0,0,0,0,0,0,66.31 ,67.06 ,66.31 
03,003,01,013,0419,831,1186,14,1200,1674,0,0,0,0,0,0,0,66.31 ,71.68 ,66.31 
03,003,01,013,0420,832,1052,22,1074,1546,0,0,0,0,0,0,0,66.31 ,69.47 ,66.31 
03,003,01,013,0421,833,630,5,635,955,0,0,0,0,0,0,0,66.31 ,66.49 ,66.31 
03,003,01,013,0422,834,1004,14,1018,1537,0,0,0,0,0,0,0,66.31 ,66.23 ,66.31 
03,003,01,013,0422,835,1129,30,1159,1651,0,0,0,0,0,0,0,66.31 ,70.20 ,66.31 
03,003,01,013,0423,836,1020,18,1038,1669,0,0,0,0,0,0,0,66.31 ,62.19 ,66.31 
03,003,01,013,0424,837,1023,16,1039,1523,0,0,0,0,0,0,0,66.31 ,68.22 ,66.31 
03,003,01,013,0425,838,846,10,856,1216,0,0,0,0,0,0,0,66.31 ,70.39 ,66.31 
03,003,01,013,0425,839,805,18,823,1244,0,0,0,0,0,0,0,66.31 ,66.16 ,66.31 
03,003,01,013,0426,840,1156,16,1172,1664,0,0,0,0,0,0,0,66.31 ,70.43 ,66.31 
03,003,01,013,0427,841,724,9,733,963,0,0,0,0,0,0,0,66.31 ,76.12 ,66.31 
03,003,01,013,0428,842,1122,13,1135,1623,0,0,0,0,0,0,0,66.31 ,69.93 ,66.31 
03,003,01,013,0429,843,1034,13,1047,1426,0,0,0,0,0,0,0,66.31 ,73.42 ,66.31 
03,003,01,013,0429,844,833,19,852,1413,0,0,0,0,0,0,0,66.31 ,60.30 ,66.31 
03,003,01,013,0430,845,882,11,893,1446,0,0,0,0,0,0,0,66.31 ,61.76 ,66.31 
03,003,01,013,0431,846,828,12,840,1269,0,0,0,0,0,0,0,66.31 ,66.19 ,66.31 
03,004,01,001,0001,1,643,9,652,979,0,0,0,0,0,0,0,66.31 ,66.60 ,66.31 
03,004,01,001,0002,2,297,5,302,455,0,0,0,0,0,0,0,66.31 ,66.37 ,66.31 
03,004,01,001,0003,3,800,9,809,1423,0,0,0,0,0,0,0,66.31 ,56.85 ,66.31 
03,004,01,001,0004,4,490,5,495,812,0,0,0,0,0,0,0,66.31 ,60.96 ,66.31 
03,004,01,001,0005,5,709,12,721,1214,0,0,0,0,0,0,0,66.31 ,59.39 ,66.31 
03,004,01,001,0005,6,653,5,658,1030,0,0,0,0,0,0,0,66.31 ,63.88 ,66.31 
03,004,01,001,0006,7,584,6,590,1021,0,0,0,0,0,0,0,66.31 ,57.79 ,66.31 
03,004,01,001,0006,8,682,12,694,1079,0,0,0,0,0,0,0,66.31 ,64.32 ,66.31 
03,004,01,001,0006,9,467,11,478,881,0,0,0,0,0,0,0,66.31 ,54.26 ,66.31 
03,004,01,001,0006,10,511,12,523,907,0,0,0,0,0,0,0,66.31 ,57.66 ,66.31 
03,004,01,001,0007,11,708,6,714,1345,0,0,0,0,0,0,0,66.31 ,53.09 ,66.31 
03,004,01,001,0007,12,763,11,774,1447,0,0,0,0,0,0,0,66.31 ,53.49 ,66.31 
03,004,01,001,0007,13,713,5,718,1361,0,0,0,0,0,0,0,66.31 ,52.76 ,66.31 
03,004,01,001,0007,14,683,8,691,1374,0,0,0,0,0,0,0,66.31 ,50.29 ,66.31 
03,004,01,001,0007,15,535,5,540,969,0,0,0,0,0,0,0,66.31 ,55.73 ,66.31 
03,004,01,001,0007,16,429,7,436,822,0,0,0,0,0,0,0,66.31 ,53.04 ,66.31 
03,004,01,001,0008,17,440,2,442,878,0,0,0,0,0,0,0,66.31 ,50.34 ,66.31 
03,004,01,001,0008,18,596,2,598,993,0,0,0,0,0,0,0,66.31 ,60.22 ,66.31 
03,004,01,001,0008,19,491,6,497,848,0,0,0,0,0,0,0,66.31 ,58.61 ,66.31 
03,004,01,001,0009,20,539,8,547,1088,0,0,0,0,0,0,0,66.31 ,50.28 ,66.31 
03,004,01,001,0009,21,580,7,587,1092,0,0,0,0,0,0,0,66.31 ,53.75 ,66.31 
03,004,01,001,0009,22,522,4,526,1029,0,0,0,0,0,0,0,66.31 ,51.12 ,66.31 
03,004,01,001,0009,23,474,7,481,985,0,0,0,0,0,0,0,66.31 ,48.83 ,66.31 
03,004,01,001,0009,24,640,7,647,1061,0,0,0,0,0,0,0,66.31 ,60.98 ,66.31 
03,004,01,001,0010,25,525,6,531,939,0,0,0,0,0,0,0,66.31 ,56.55 ,66.31 
03,004,01,001,0010,26,555,6,561,990,0,0,0,0,0,0,0,66.31 ,56.67 ,66.31 
03,004,01,001,0010,27,524,6,530,1020,0,0,0,0,0,0,0,66.31 ,51.96 ,66.31 
03,004,01,001,0010,28,409,4,413,871,0,0,0,0,0,0,0,66.31 ,47.42 ,66.31 
03,004,01,001,0010,29,554,5,559,1025,0,0,0,0,0,0,0,66.31 ,54.54 ,66.31 
03,004,01,001,0010,30,485,8,493,1065,0,0,0,0,0,0,0,66.31 ,46.29 ,66.31 
03,004,01,001,0011,31,666,8,674,1098,0,0,0,0,0,0,0,66.31 ,61.38 ,66.31 
03,004,01,001,0011,32,549,5,554,1030,0,0,0,0,0,0,0,66.31 ,53.79 ,66.31 
03,004,01,001,0011,33,402,7,409,671,0,0,0,0,0,0,0,66.31 ,60.95 ,66.31 
03,004,01,001,0012,34,549,6,555,1099,0,0,0,0,0,0,0,66.31 ,50.50 ,66.31 
03,004,01,001,0012,35,508,8,516,1147,0,0,0,0,0,0,0,66.31 ,44.99 ,66.31 
03,004,01,001,0012,36,512,14,526,1145,0,0,0,0,0,0,0,66.31 ,45.94 ,66.31 
03,004,01,001,0012,37,498,7,505,1014,0,0,0,0,0,0,0,66.31 ,49.80 ,66.31 
03,004,01,001,0013,38,519,9,528,1036,0,0,0,0,0,0,0,66.31 ,50.97 ,66.31 
03,004,01,001,0013,39,527,6,533,1105,0,0,0,0,0,0,0,66.31 ,48.24 ,66.31 
03,004,01,001,0013,40,456,5,461,872,0,0,0,0,0,0,0,66.31 ,52.87 ,66.31 
03,004,01,001,0014,41,469,13,482,902,0,0,0,0,0,0,0,66.31 ,53.44 ,66.31 
03,004,01,001,0014,42,454,3,457,765,0,0,0,0,0,0,0,66.31 ,59.74 ,66.31 
03,004,01,001,0014,43,529,10,539,882,0,0,0,0,0,0,0,66.31 ,61.11 ,66.31 
03,004,01,001,0015,44,604,7,611,1083,0,0,0,0,0,0,0,66.31 ,56.42 ,66.31 
03,004,01,001,0016,45,389,5,394,664,0,0,0,0,0,0,0,66.31 ,59.34 ,66.31 
03,004,01,001,0016,46,411,6,417,800,0,0,0,0,0,0,0,66.31 ,52.13 ,66.31 
03,004,01,001,0017,47,498,6,504,831,0,0,0,0,0,0,0,66.31 ,60.65 ,66.31 
03,004,01,001,0018,48,364,10,374,625,0,0,0,0,0,0,0,66.31 ,59.84 ,66.31 
03,004,01,001,0018,49,406,11,417,822,0,0,0,0,0,0,0,66.31 ,50.73 ,66.31 
03,004,01,001,0019,50,486,11,497,988,0,0,0,0,0,0,0,66.31 ,50.30 ,66.31 
03,004,01,001,0020,51,615,13,628,1149,0,0,0,0,0,0,0,66.31 ,54.66 ,66.31 
03,004,01,001,0021,52,426,6,432,749,0,0,0,0,0,0,0,66.31 ,57.68 ,66.31 
03,004,01,001,0021,53,312,6,318,500,0,0,0,0,0,0,0,66.31 ,63.60 ,66.31 
03,004,01,001,0022,54,684,11,695,1255,0,0,0,0,0,0,0,66.31 ,55.38 ,66.31 
03,004,01,001,0023,55,405,2,407,776,0,0,0,0,0,0,0,66.31 ,52.45 ,66.31 
03,004,01,001,0023,56,354,6,360,671,0,0,0,0,0,0,0,66.31 ,53.65 ,66.31 
03,004,01,002,0024,57,295,5,300,417,0,0,0,0,0,0,0,66.31 ,71.94 ,66.31 
03,004,01,002,0025,58,217,5,222,353,0,0,0,0,0,0,0,66.31 ,62.89 ,66.31 
03,004,01,002,0026,59,269,2,271,383,0,0,0,0,0,0,0,66.31 ,70.76 ,66.31 
03,004,01,002,0027,60,497,4,501,751,0,0,0,0,0,0,0,66.31 ,66.71 ,66.31 
03,004,01,002,0027,61,538,7,545,977,0,0,0,0,0,0,0,66.31 ,55.78 ,66.31 
03,004,01,002,0028,62,632,9,641,1095,0,0,0,0,0,0,0,66.31 ,58.54 ,66.31 
03,004,01,002,0028,63,632,6,638,1126,0,0,0,0,0,0,0,66.31 ,56.66 ,66.31 
03,004,01,002,0028,64,620,9,629,1122,0,0,0,0,0,0,0,66.31 ,56.06 ,66.31 
03,004,01,002,0028,65,641,10,651,1126,0,0,0,0,0,0,0,66.31 ,57.82 ,66.31 
03,004,01,002,0028,66,580,15,595,993,0,0,0,0,0,0,0,66.31 ,59.92 ,66.31 
03,004,01,002,0029,67,564,7,571,889,0,0,0,0,0,0,0,66.31 ,64.23 ,66.31 
03,004,01,002,0029,68,530,2,532,846,0,0,0,0,0,0,0,66.31 ,62.88 ,66.31 
03,004,01,002,0029,69,589,5,594,897,0,0,0,0,0,0,0,66.31 ,66.22 ,66.31 
03,004,01,002,0030,70,388,6,394,649,0,0,0,0,0,0,0,66.31 ,60.71 ,66.31 
03,004,01,002,0030,71,473,9,482,724,0,0,0,0,0,0,0,66.31 ,66.57 ,66.31 
03,004,01,002,0031,72,536,10,546,939,0,0,0,0,0,0,0,66.31 ,58.15 ,66.31 
03,004,01,002,0031,73,662,11,673,1075,0,0,0,0,0,0,0,66.31 ,62.60 ,66.31 
03,004,01,002,0031,74,558,8,566,895,0,0,0,0,0,0,0,66.31 ,63.24 ,66.31 
03,004,01,002,0032,75,597,11,608,918,0,0,0,0,0,0,0,66.31 ,66.23 ,66.31 
03,004,01,002,0032,76,604,2,606,920,0,0,0,0,0,0,0,66.31 ,65.87 ,66.31 
03,004,01,002,0033,77,751,13,764,1202,0,0,0,0,0,0,0,66.31 ,63.56 ,66.31 
03,004,01,002,0034,78,525,3,528,789,0,0,0,0,0,0,0,66.31 ,66.92 ,66.31 
03,004,01,002,0035,79,650,6,656,1079,0,0,0,0,0,0,0,66.31 ,60.80 ,66.31 
03,004,01,002,0035,80,667,13,680,1005,0,0,0,0,0,0,0,66.31 ,67.66 ,66.31 
03,004,01,002,0036,81,546,10,556,963,0,0,0,0,0,0,0,66.31 ,57.74 ,66.31 
03,004,01,002,0036,82,761,5,766,1240,0,0,0,0,0,0,0,66.31 ,61.77 ,66.31 
03,004,01,002,0036,83,630,10,640,1013,0,0,0,0,0,0,0,66.31 ,63.18 ,66.31 
03,004,01,002,0037,84,826,10,836,1294,0,0,0,0,0,0,0,66.31 ,64.61 ,66.31 
03,004,01,002,0037,85,822,5,827,1224,0,0,0,0,0,0,0,66.31 ,67.57 ,66.31 
03,004,01,002,0038,86,454,6,460,662,0,0,0,0,0,0,0,66.31 ,69.49 ,66.31 
03,004,01,002,0038,87,525,10,535,826,0,0,0,0,0,0,0,66.31 ,64.77 ,66.31 
03,004,01,002,0039,88,744,11,755,1270,0,0,0,0,0,0,0,66.31 ,59.45 ,66.31 
03,004,01,002,0040,89,466,4,470,709,0,0,0,0,0,0,0,66.31 ,66.29 ,66.31 
03,004,01,002,0040,90,464,2,466,711,0,0,0,0,0,0,0,66.31 ,65.54 ,66.31 
03,004,01,002,0041,91,672,10,682,1065,0,0,0,0,0,0,0,66.31 ,64.04 ,66.31 
03,004,01,002,0041,92,702,7,709,1021,0,0,0,0,0,0,0,66.31 ,69.44 ,66.31 
03,004,01,002,0041,93,514,7,521,840,0,0,0,0,0,0,0,66.31 ,62.02 ,66.31 
03,004,01,002,0041,94,737,6,743,1161,0,0,0,0,0,0,0,66.31 ,64.00 ,66.31 
03,004,01,002,0041,95,588,10,598,951,0,0,0,0,0,0,0,66.31 ,62.88 ,66.31 
03,004,01,002,0042,96,701,6,707,1394,0,0,0,0,0,0,0,66.31 ,50.72 ,66.31 
03,004,01,002,0042,97,521,10,531,894,0,0,0,0,0,0,0,66.31 ,59.40 ,66.31 
03,004,01,002,0042,98,404,8,412,681,0,0,0,0,0,0,0,66.31 ,60.50 ,66.31 
03,004,01,002,0042,99,481,6,487,847,0,0,0,0,0,0,0,66.31 ,57.50 ,66.31 
03,004,01,002,0042,100,447,9,456,736,0,0,0,0,0,0,0,66.31 ,61.96 ,66.31 
03,004,01,002,0043,101,317,2,319,464,0,0,0,0,0,0,0,66.31 ,68.75 ,66.31 
03,004,01,002,0044,102,454,9,463,782,0,0,0,0,0,0,0,66.31 ,59.21 ,66.31 
03,004,01,002,0044,103,358,5,363,652,0,0,0,0,0,0,0,66.31 ,55.67 ,66.31 
03,004,01,002,0044,104,472,4,476,876,0,0,0,0,0,0,0,66.31 ,54.34 ,66.31 
03,004,01,002,0044,105,378,9,387,654,0,0,0,0,0,0,0,66.31 ,59.17 ,66.31 
03,004,01,002,0044,106,584,9,593,1031,0,0,0,0,0,0,0,66.31 ,57.52 ,66.31 
03,004,01,002,0045,107,772,10,782,1270,0,0,0,0,0,0,0,66.31 ,61.57 ,66.31 
03,004,01,002,0045,108,476,8,484,748,0,0,0,0,0,0,0,66.31 ,64.71 ,66.31 
03,004,01,002,0045,109,655,7,662,1175,0,0,0,0,0,0,0,66.31 ,56.34 ,66.31 
03,004,01,002,0045,110,668,10,678,1163,0,0,0,0,0,0,0,66.31 ,58.30 ,66.31 
03,004,01,002,0045,111,496,8,504,879,0,0,0,0,0,0,0,66.31 ,57.34 ,66.31 
03,004,01,002,0046,112,580,10,590,1023,0,0,0,0,0,0,0,66.31 ,57.67 ,66.31 
03,004,01,002,0046,113,587,6,593,1006,0,0,0,0,0,0,0,66.31 ,58.95 ,66.31 
03,004,01,002,0046,114,737,13,750,1216,0,0,0,0,0,0,0,66.31 ,61.68 ,66.31 
03,004,01,002,0047,115,839,12,851,1332,0,0,0,0,0,0,0,66.31 ,63.89 ,66.31 
03,004,01,002,0048,116,394,7,401,695,0,0,0,0,0,0,0,66.31 ,57.70 ,66.31 
03,004,01,003,0049,117,630,15,645,992,0,0,0,0,0,0,0,66.31 ,65.02 ,66.31 
03,004,01,003,0050,118,431,6,437,670,0,0,0,0,0,0,0,66.31 ,65.22 ,66.31 
03,004,01,003,0051,119,632,4,636,1010,0,0,0,0,0,0,0,66.31 ,62.97 ,66.31 
03,004,01,003,0052,120,941,17,958,1480,0,0,0,0,0,0,0,66.31 ,64.73 ,66.31 
03,004,01,003,0052,121,534,4,538,812,0,0,0,0,0,0,0,66.31 ,66.26 ,66.31 
03,004,01,003,0053,122,501,7,508,857,0,0,0,0,0,0,0,66.31 ,59.28 ,66.31 
03,004,01,003,0053,123,463,3,466,764,0,0,0,0,0,0,0,66.31 ,60.99 ,66.31 
03,004,01,003,0054,124,549,9,558,853,0,0,0,0,0,0,0,66.31 ,65.42 ,66.31 
03,004,01,003,0054,125,586,5,591,888,0,0,0,0,0,0,0,66.31 ,66.55 ,66.31 
03,004,01,003,0055,126,925,14,939,1491,0,0,0,0,0,0,0,66.31 ,62.98 ,66.31 
03,004,01,003,0055,127,728,7,735,1174,0,0,0,0,0,0,0,66.31 ,62.61 ,66.31 
03,004,01,003,0056,128,929,12,941,1394,0,0,0,0,0,0,0,66.31 ,67.50 ,66.31 
03,004,01,003,0057,129,303,3,306,440,0,0,0,0,0,0,0,66.31 ,69.55 ,66.31 
03,004,01,003,0058,130,439,8,447,692,0,0,0,0,0,0,0,66.31 ,64.60 ,66.31 
03,004,01,003,0059,131,422,9,431,613,0,0,0,0,0,0,0,66.31 ,70.31 ,66.31 
03,004,01,003,0060,132,776,11,787,1084,0,0,0,0,0,0,0,66.31 ,72.60 ,66.31 
03,004,01,003,0061,133,709,12,721,1074,0,0,0,0,0,0,0,66.31 ,67.13 ,66.31 
03,004,01,003,0062,134,457,3,460,701,0,0,0,0,0,0,0,66.31 ,65.62 ,66.31 
03,004,01,003,0063,135,767,16,783,1246,0,0,0,0,0,0,0,66.31 ,62.84 ,66.31 
03,004,01,003,0063,136,617,11,628,988,0,0,0,0,0,0,0,66.31 ,63.56 ,66.31 
03,004,01,003,0063,137,673,12,685,1211,0,0,0,0,0,0,0,66.31 ,56.56 ,66.31 
03,004,01,003,0064,138,929,8,937,1524,0,0,0,0,0,0,0,66.31 ,61.48 ,66.31 
03,004,01,003,0065,139,570,10,580,874,0,0,0,0,0,0,0,66.31 ,66.36 ,66.31 
03,004,01,003,0065,140,470,7,477,790,0,0,0,0,0,0,0,66.31 ,60.38 ,66.31 
03,004,01,003,0066,141,635,10,645,978,0,0,0,0,0,0,0,66.31 ,65.95 ,66.31 
03,004,01,003,0067,142,453,3,456,657,0,0,0,0,0,0,0,66.31 ,69.41 ,66.31 
03,004,01,004,0068,143,422,4,426,600,0,0,0,0,0,0,0,66.31 ,71.00 ,66.31 
03,004,01,004,0069,144,1023,21,1044,1564,0,0,0,0,0,0,0,66.31 ,66.75 ,66.31 
03,004,01,004,0070,145,490,6,496,745,0,0,0,0,0,0,0,66.31 ,66.58 ,66.31 
03,004,01,004,0071,146,543,5,548,862,0,0,0,0,0,0,0,66.31 ,63.57 ,66.31 
03,004,01,004,0071,147,719,6,725,1089,0,0,0,0,0,0,0,66.31 ,66.57 ,66.31 
03,004,01,004,0071,148,845,13,858,1413,0,0,0,0,0,0,0,66.31 ,60.72 ,66.31 
03,004,01,004,0072,149,507,4,511,741,0,0,0,0,0,0,0,66.31 ,68.96 ,66.31 
03,004,01,004,0073,150,577,8,585,898,0,0,0,0,0,0,0,66.31 ,65.14 ,66.31 
03,004,01,004,0074,151,634,9,643,1019,0,0,0,0,0,0,0,66.31 ,63.10 ,66.31 
03,004,01,004,0075,152,791,10,801,1275,0,0,0,0,0,0,0,66.31 ,62.82 ,66.31 
03,004,01,004,0075,153,798,14,812,1333,0,0,0,0,0,0,0,66.31 ,60.92 ,66.31 
03,004,01,004,0076,154,456,7,463,719,0,0,0,0,0,0,0,66.31 ,64.39 ,66.31 
03,004,01,004,0077,155,671,11,682,1104,0,0,0,0,0,0,0,66.31 ,61.78 ,66.31 
03,004,01,004,0078,156,668,9,677,975,0,0,0,0,0,0,0,66.31 ,69.44 ,66.31 
03,004,01,004,0079,157,400,12,412,610,0,0,0,0,0,0,0,66.31 ,67.54 ,66.31 
03,004,01,004,0080,158,342,7,349,529,0,0,0,0,0,0,0,66.31 ,65.97 ,66.31 
03,004,01,004,0081,159,404,5,409,639,0,0,0,0,0,0,0,66.31 ,64.01 ,66.31 
03,004,01,004,0082,160,527,5,532,918,0,0,0,0,0,0,0,66.31 ,57.95 ,66.31 
03,004,01,004,0083,161,474,3,477,699,0,0,0,0,0,0,0,66.31 ,68.24 ,66.31 
03,004,01,004,0084,162,614,7,621,869,0,0,0,0,0,0,0,66.31 ,71.46 ,66.31 
03,004,01,004,0084,163,589,8,597,900,0,0,0,0,0,0,0,66.31 ,66.33 ,66.31 
03,004,01,004,0085,164,612,8,620,947,0,0,0,0,0,0,0,66.31 ,65.47 ,66.31 
03,004,01,004,0086,165,596,7,603,821,0,0,0,0,0,0,0,66.31 ,73.45 ,66.31 
03,004,01,004,0087,166,457,4,461,634,0,0,0,0,0,0,0,66.31 ,72.71 ,66.31 
03,004,01,004,0088,167,546,4,550,761,0,0,0,0,0,0,0,66.31 ,72.27 ,66.31 
03,004,01,005,0089,168,787,8,795,1191,0,0,0,0,0,0,0,66.31 ,66.75 ,66.31 
03,004,01,005,0089,169,758,13,771,1287,0,0,0,0,0,0,0,66.31 ,59.91 ,66.31 
03,004,01,005,0089,170,566,13,579,1013,0,0,0,0,0,0,0,66.31 ,57.16 ,66.31 
03,004,01,005,0089,171,612,12,624,962,0,0,0,0,0,0,0,66.31 ,64.86 ,66.31 
03,004,01,005,0090,172,633,12,645,981,0,0,0,0,0,0,0,66.31 ,65.75 ,66.31 
03,004,01,005,0090,173,579,6,585,1009,0,0,0,0,0,0,0,66.31 ,57.98 ,66.31 
03,004,01,005,0090,174,555,10,565,953,0,0,0,0,0,0,0,66.31 ,59.29 ,66.31 
03,004,01,005,0091,175,710,13,723,1095,0,0,0,0,0,0,0,66.31 ,66.03 ,66.31 
03,004,01,005,0091,176,737,13,750,1227,0,0,0,0,0,0,0,66.31 ,61.12 ,66.31 
03,004,01,005,0091,177,656,16,672,1171,0,0,0,0,0,0,0,66.31 ,57.39 ,66.31 
03,004,01,005,0092,178,551,4,555,825,0,0,0,0,0,0,0,66.31 ,67.27 ,66.31 
03,004,01,005,0093,179,733,10,743,1137,0,0,0,0,0,0,0,66.31 ,65.35 ,66.31 
03,004,01,005,0094,180,520,8,528,833,0,0,0,0,0,0,0,66.31 ,63.39 ,66.31 
03,004,01,005,0094,181,774,10,784,1260,0,0,0,0,0,0,0,66.31 ,62.22 ,66.31 
03,004,01,005,0094,182,718,7,725,1147,0,0,0,0,0,0,0,66.31 ,63.21 ,66.31 
03,004,01,005,0094,183,625,13,638,859,0,0,0,0,0,0,0,66.31 ,74.27 ,66.31 
03,004,01,005,0095,184,603,11,614,944,0,0,0,0,0,0,0,66.31 ,65.04 ,66.31 
03,004,01,005,0095,185,635,11,646,1019,0,0,0,0,0,0,0,66.31 ,63.40 ,66.31 
03,004,01,005,0095,186,593,10,603,1010,0,0,0,0,0,0,0,66.31 ,59.70 ,66.31 
03,004,01,005,0095,187,570,10,580,927,0,0,0,0,0,0,0,66.31 ,62.57 ,66.31 
03,004,01,005,0095,188,578,12,590,1005,0,0,0,0,0,0,0,66.31 ,58.71 ,66.31 
03,004,01,005,0096,189,594,13,607,1000,0,0,0,0,0,0,0,66.31 ,60.70 ,66.31 
03,004,01,005,0097,190,614,18,632,984,0,0,0,0,0,0,0,66.31 ,64.23 ,66.31 
03,004,01,005,0097,191,807,15,822,1335,0,0,0,0,0,0,0,66.31 ,61.57 ,66.31 
03,004,01,005,0098,192,627,2,629,997,0,0,0,0,0,0,0,66.31 ,63.09 ,66.31 
03,004,01,005,0099,193,691,8,699,1143,0,0,0,0,0,0,0,66.31 ,61.15 ,66.31 
03,004,01,005,0099,194,641,4,645,999,0,0,0,0,0,0,0,66.31 ,64.56 ,66.31 
03,004,01,005,0100,195,784,13,797,1158,0,0,0,0,0,0,0,66.31 ,68.83 ,66.31 
03,004,01,005,0100,196,540,10,550,875,0,0,0,0,0,0,0,66.31 ,62.86 ,66.31 
03,004,01,005,0101,197,769,14,783,1264,0,0,0,0,0,0,0,66.31 ,61.95 ,66.31 
03,004,01,005,0102,198,702,14,716,1014,0,0,0,0,0,0,0,66.31 ,70.61 ,66.31 
03,004,01,005,0102,199,705,27,732,1070,0,0,0,0,0,0,0,66.31 ,68.41 ,66.31 
03,004,01,005,0102,200,546,5,551,1039,0,0,0,0,0,0,0,66.31 ,53.03 ,66.31 
03,004,01,005,0103,201,471,7,478,865,0,0,0,0,0,0,0,66.31 ,55.26 ,66.31 
03,004,01,005,0103,202,588,11,599,1012,0,0,0,0,0,0,0,66.31 ,59.19 ,66.31 
03,004,01,005,0103,203,442,6,448,815,0,0,0,0,0,0,0,66.31 ,54.97 ,66.31 
03,004,01,005,0103,204,601,9,610,1097,0,0,0,0,0,0,0,66.31 ,55.61 ,66.31 
03,004,01,005,0103,205,511,8,519,806,0,0,0,0,0,0,0,66.31 ,64.39 ,66.31 
03,004,01,005,0104,206,675,12,687,1226,0,0,0,0,0,0,0,66.31 ,56.04 ,66.31 
03,004,01,005,0104,207,710,18,728,1163,0,0,0,0,0,0,0,66.31 ,62.60 ,66.31 
03,004,01,006,0105,208,545,9,554,794,0,0,0,0,0,0,0,66.31 ,69.77 ,66.31 
03,004,01,006,0106,209,969,16,985,1578,0,0,0,0,0,0,0,66.31 ,62.42 ,66.31 
03,004,01,006,0107,210,821,12,833,1281,0,0,0,0,0,0,0,66.31 ,65.03 ,66.31 
03,004,01,006,0108,211,613,4,617,1190,0,0,0,0,0,0,0,66.31 ,51.85 ,66.31 
03,004,01,006,0108,212,395,4,399,835,0,0,0,0,0,0,0,66.31 ,47.78 ,66.31 
03,004,01,006,0109,213,482,7,489,755,0,0,0,0,0,0,0,66.31 ,64.77 ,66.31 
03,004,01,006,0110,214,544,13,557,987,0,0,0,0,0,0,0,66.31 ,56.43 ,66.31 
03,004,01,006,0110,215,509,13,522,970,0,0,0,0,0,0,0,66.31 ,53.81 ,66.31 
03,004,01,006,0111,216,735,14,749,1269,0,0,0,0,0,0,0,66.31 ,59.02 ,66.31 
03,004,01,006,0112,217,1028,14,1042,1795,0,0,0,0,0,0,0,66.31 ,58.05 ,66.31 
03,004,01,006,0113,218,775,6,781,1340,0,0,0,0,0,0,0,66.31 ,58.28 ,66.31 
03,004,01,006,0113,219,764,6,770,1284,0,0,0,0,0,0,0,66.31 ,59.97 ,66.31 
03,004,01,006,0113,220,775,13,788,1528,0,0,0,0,0,0,0,66.31 ,51.57 ,66.31 
03,004,01,006,0113,221,495,13,508,1011,0,0,0,0,0,0,0,66.31 ,50.25 ,66.31 
03,004,01,006,0114,222,701,11,712,1176,0,0,0,0,0,0,0,66.31 ,60.54 ,66.31 
03,004,01,006,0115,223,563,7,570,903,0,0,0,0,0,0,0,66.31 ,63.12 ,66.31 
03,004,01,006,0116,224,751,11,762,1307,0,0,0,0,0,0,0,66.31 ,58.30 ,66.31 
03,004,01,006,0116,225,893,16,909,1627,0,0,0,0,0,0,0,66.31 ,55.87 ,66.31 
03,004,01,006,0116,226,826,15,841,1400,0,0,0,0,0,0,0,66.31 ,60.07 ,66.31 
03,004,01,006,0116,227,838,16,854,1477,0,0,0,0,0,0,0,66.31 ,57.82 ,66.31 
03,004,01,006,0117,228,626,10,636,1147,0,0,0,0,0,0,0,66.31 ,55.45 ,66.31 
03,004,01,006,0117,229,621,12,633,1296,0,0,0,0,0,0,0,66.31 ,48.84 ,66.31 
03,004,01,006,0117,230,701,18,719,1330,0,0,0,0,0,0,0,66.31 ,54.06 ,66.31 
03,004,01,007,0118,231,314,2,316,431,0,0,0,0,0,0,0,66.31 ,73.32 ,66.31 
03,004,01,007,0119,232,370,6,376,508,0,0,0,0,0,0,0,66.31 ,74.02 ,66.31 
03,004,01,007,0120,233,513,3,516,760,0,0,0,0,0,0,0,66.31 ,67.89 ,66.31 
03,004,01,007,0121,234,276,2,278,379,0,0,0,0,0,0,0,66.31 ,73.35 ,66.31 
03,004,01,007,0122,235,620,3,623,912,0,0,0,0,0,0,0,66.31 ,68.31 ,66.31 
03,004,01,007,0122,236,840,11,851,1291,0,0,0,0,0,0,0,66.31 ,65.92 ,66.31 
03,004,01,007,0123,237,974,14,988,1397,0,0,0,0,0,0,0,66.31 ,70.72 ,66.31 
03,004,01,007,0124,238,383,4,387,533,0,0,0,0,0,0,0,66.31 ,72.61 ,66.31 
03,004,01,007,0125,239,380,5,385,577,0,0,0,0,0,0,0,66.31 ,66.72 ,66.31 
03,004,01,007,0126,240,725,8,733,1079,0,0,0,0,0,0,0,66.31 ,67.93 ,66.31 
03,004,01,007,0126,241,527,10,537,765,0,0,0,0,0,0,0,66.31 ,70.20 ,66.31 
03,004,01,007,0127,242,966,16,982,1397,0,0,0,0,0,0,0,66.31 ,70.29 ,66.31 
03,004,01,007,0128,243,797,5,802,1202,0,0,0,0,0,0,0,66.31 ,66.72 ,66.31 
03,004,01,007,0128,244,756,7,763,1243,0,0,0,0,0,0,0,66.31 ,61.38 ,66.31 
03,004,01,007,0129,245,722,9,731,1018,0,0,0,0,0,0,0,66.31 ,71.81 ,66.31 
03,004,01,008,0130,246,773,5,778,1147,0,0,0,0,0,0,0,66.31 ,67.83 ,66.31 
03,004,01,008,0130,247,586,2,588,919,0,0,0,0,0,0,0,66.31 ,63.98 ,66.31 
03,004,01,008,0130,248,685,12,697,1102,0,0,0,0,0,0,0,66.31 ,63.25 ,66.31 
03,004,01,008,0131,249,560,5,565,812,0,0,0,0,0,0,0,66.31 ,69.58 ,66.31 
03,004,01,008,0132,250,102,1,103,145,0,0,0,0,0,0,0,66.31 ,71.03 ,66.31 
03,004,01,008,0133,251,90,2,92,135,0,0,0,0,0,0,0,66.31 ,68.15 ,66.31 
03,004,01,008,0134,252,214,1,215,327,0,0,0,0,0,0,0,66.31 ,65.75 ,66.31 
03,004,01,008,0135,253,705,8,713,1103,0,0,0,0,0,0,0,66.31 ,64.64 ,66.31 
03,004,01,008,0136,254,415,3,418,597,0,0,0,0,0,0,0,66.31 ,70.02 ,66.31 
03,004,01,008,0136,255,184,3,187,262,0,0,0,0,0,0,0,66.31 ,71.37 ,66.31 
03,004,01,008,0137,256,323,4,327,481,0,0,0,0,0,0,0,66.31 ,67.98 ,66.31 
03,004,01,008,0138,257,511,11,522,760,0,0,0,0,0,0,0,66.31 ,68.68 ,66.31 
03,004,01,008,0138,258,260,2,262,371,0,0,0,0,0,0,0,66.31 ,70.62 ,66.31 
03,004,01,008,0139,259,508,8,516,718,0,0,0,0,0,0,0,66.31 ,71.87 ,66.31 
03,004,01,008,0139,260,580,7,587,804,0,0,0,0,0,0,0,66.31 ,73.01 ,66.31 
03,004,01,008,0140,261,893,12,905,1283,0,0,0,0,0,0,0,66.31 ,70.54 ,66.31 
03,004,01,009,0141,262,723,2,725,1127,0,0,0,0,0,0,0,66.31 ,64.33 ,66.31 
03,004,01,009,0142,263,822,7,829,1275,0,0,0,0,0,0,0,66.31 ,65.02 ,66.31 
03,004,01,009,0143,264,327,5,332,482,0,0,0,0,0,0,0,66.31 ,68.88 ,66.31 
03,004,01,009,0144,265,597,6,603,879,0,0,0,0,0,0,0,66.31 ,68.60 ,66.31 
03,004,01,009,0144,266,892,14,906,1419,0,0,0,0,0,0,0,66.31 ,63.85 ,66.31 
03,004,01,009,0145,267,467,8,475,762,0,0,0,0,0,0,0,66.31 ,62.34 ,66.31 
03,004,01,009,0146,268,218,5,223,327,0,0,0,0,0,0,0,66.31 ,68.20 ,66.31 
03,004,01,009,0147,269,413,8,421,620,0,0,0,0,0,0,0,66.31 ,67.90 ,66.31 
03,004,01,009,0148,270,227,3,230,347,0,0,0,0,0,0,0,66.31 ,66.28 ,66.31 
03,004,01,009,0149,271,182,3,185,310,0,0,0,0,0,0,0,66.31 ,59.68 ,66.31 
03,004,01,010,0150,272,989,14,1003,1682,0,0,0,0,0,0,0,66.31 ,59.63 ,66.31 
03,004,01,010,0150,273,770,13,783,1635,0,0,0,0,0,0,0,66.31 ,47.89 ,66.31 
03,004,01,010,0151,274,487,2,489,902,0,0,0,0,0,0,0,66.31 ,54.21 ,66.31 
03,004,01,010,0152,275,529,4,533,763,0,0,0,0,0,0,0,66.31 ,69.86 ,66.31 
03,004,01,010,0153,276,707,5,712,1131,0,0,0,0,0,0,0,66.31 ,62.95 ,66.31 
03,004,01,010,0154,277,453,5,458,633,0,0,0,0,0,0,0,66.31 ,72.35 ,66.31 
03,004,01,010,0155,278,467,3,470,703,0,0,0,0,0,0,0,66.31 ,66.86 ,66.31 
03,004,01,010,0156,279,452,1,453,627,0,0,0,0,0,0,0,66.31 ,72.25 ,66.31 
03,004,01,010,0157,280,397,3,400,558,0,0,0,0,0,0,0,66.31 ,71.68 ,66.31 
03,004,01,010,0158,281,347,6,353,550,0,0,0,0,0,0,0,66.31 ,64.18 ,66.31 
03,004,01,011,0159,282,632,2,634,892,0,0,0,0,0,0,0,66.31 ,71.08 ,66.31 
03,004,01,011,0160,283,448,4,452,677,0,0,0,0,0,0,0,66.31 ,66.77 ,66.31 
03,004,01,011,0161,284,439,4,443,631,0,0,0,0,0,0,0,66.31 ,70.21 ,66.31 
03,004,01,011,0162,285,234,1,235,332,0,0,0,0,0,0,0,66.31 ,70.78 ,66.31 
03,004,01,011,0162,286,202,4,206,313,0,0,0,0,0,0,0,66.31 ,65.81 ,66.31 
03,004,01,011,0163,287,811,13,824,1197,0,0,0,0,0,0,0,66.31 ,68.84 ,66.31 
03,004,01,011,0164,288,315,1,316,514,0,0,0,0,0,0,0,66.31 ,61.48 ,66.31 
03,004,01,011,0164,289,244,1,245,365,0,0,0,0,0,0,0,66.31 ,67.12 ,66.31 
03,004,01,012,0165,290,272,8,280,418,0,0,0,0,0,0,0,66.31 ,66.99 ,66.31 
03,004,01,012,0166,291,15,1,16,41,0,0,0,0,0,0,0,66.31 ,39.02 ,66.31 
03,004,01,012,0167,292,75,1,76,139,0,0,0,0,0,0,0,66.31 ,54.68 ,66.31 
03,004,01,012,0168,293,90,4,94,183,0,0,0,0,0,0,0,66.31 ,51.37 ,66.31 
03,004,01,012,0169,294,34,2,36,73,0,0,0,0,0,0,0,66.31 ,49.32 ,66.31 
03,004,01,012,0169,295,36,2,38,70,0,0,0,0,0,0,0,66.31 ,54.29 ,66.31 
03,004,01,012,0170,296,19,0,19,46,0,0,0,0,0,0,0,66.31 ,41.30 ,66.31 
03,004,01,012,0171,297,14,1,15,25,0,0,0,0,0,0,0,66.31 ,60.00 ,66.31 
03,004,01,012,0171,298,4,1,5,10,0,0,0,0,0,0,0,66.31 ,50.00 ,66.31 
03,004,01,012,0172,299,7,0,7,15,0,0,0,0,0,0,0,66.31 ,46.67 ,66.31 
03,004,01,012,0172,300,17,0,17,37,0,0,0,0,0,0,0,66.31 ,45.95 ,66.31 
03,004,01,012,0172,301,5,0,5,13,0,0,0,0,0,0,0,66.31 ,38.46 ,66.31 
03,004,01,013,0173,302,74,0,74,120,0,0,0,0,0,0,0,66.31 ,61.67 ,66.31 
03,004,01,013,0173,303,11,0,11,32,0,0,0,0,0,0,0,66.31 ,34.38 ,66.31 
03,004,01,013,0174,304,40,0,40,74,0,0,0,0,0,0,0,66.31 ,54.05 ,66.31 
03,004,01,013,0175,305,7,0,7,11,0,0,0,0,0,0,0,66.31 ,63.64 ,66.31 
03,004,01,013,0176,306,21,1,22,43,0,0,0,0,0,0,0,66.31 ,51.16 ,66.31 
03,004,01,013,0176,307,32,0,32,84,0,0,0,0,0,0,0,66.31 ,38.10 ,66.31 
03,005,01,001,0001,1,567,17,584,865,0,0,0,0,0,0,0,66.31 ,67.51 ,66.31 
03,005,01,001,0002,2,680,8,688,1019,0,0,0,0,0,0,0,66.31 ,67.52 ,66.31 
03,005,01,001,0003,3,909,18,927,1470,0,0,0,0,0,0,0,66.31 ,63.06 ,66.31 
03,005,01,001,0003,4,930,22,952,1454,0,0,0,0,0,0,0,66.31 ,65.47 ,66.31 
03,005,01,001,0004,5,772,6,778,1171,0,0,0,0,0,0,0,66.31 ,66.44 ,66.31 
03,005,01,001,0004,6,828,13,841,1252,0,0,0,0,0,0,0,66.31 ,67.17 ,66.31 
03,005,01,001,0004,7,764,9,773,1183,0,0,0,0,0,0,0,66.31 ,65.34 ,66.31 
03,005,01,001,0005,8,684,8,692,1034,0,0,0,0,0,0,0,66.31 ,66.92 ,66.31 
03,005,01,001,0005,9,693,6,699,1089,0,0,0,0,0,0,0,66.31 ,64.19 ,66.31 
03,005,01,001,0006,10,740,14,754,1121,0,0,0,0,0,0,0,66.31 ,67.26 ,66.31 
03,005,01,001,0006,11,680,13,693,1068,0,0,0,0,0,0,0,66.31 ,64.89 ,66.31 
03,005,01,001,0006,12,692,22,714,1016,0,0,0,0,0,0,0,66.31 ,70.28 ,66.31 
03,005,01,001,0007,13,605,9,614,924,0,0,0,0,0,0,0,66.31 ,66.45 ,66.31 
03,005,01,001,0008,14,674,56,730,1134,0,0,0,0,0,0,0,66.31 ,64.37 ,66.31 
03,005,01,001,0008,15,763,8,771,1280,0,0,0,0,0,0,0,66.31 ,60.23 ,66.31 
03,005,01,001,0009,16,667,9,676,973,0,0,0,0,0,0,0,66.31 ,69.48 ,66.31 
03,005,01,001,0010,17,744,13,757,1101,0,0,0,0,0,0,0,66.31 ,68.76 ,66.31 
03,005,01,001,0011,18,389,7,396,652,0,0,0,0,0,0,0,66.31 ,60.74 ,66.31 
03,005,01,001,0012,19,1054,21,1075,1542,0,0,0,0,0,0,0,66.31 ,69.71 ,66.31 
03,005,01,001,0013,20,889,23,912,1329,0,0,0,0,0,0,0,66.31 ,68.62 ,66.31 
03,005,01,001,0013,21,633,5,638,862,0,0,0,0,0,0,0,66.31 ,74.01 ,66.31 
03,005,01,001,0014,22,834,13,847,1266,0,0,0,0,0,0,0,66.31 ,66.90 ,66.31 
03,005,01,001,0014,23,869,16,885,1314,0,0,0,0,0,0,0,66.31 ,67.35 ,66.31 
03,005,01,001,0014,24,570,11,581,819,0,0,0,0,0,0,0,66.31 ,70.94 ,66.31 
03,005,01,001,0015,25,564,6,570,837,0,0,0,0,0,0,0,66.31 ,68.10 ,66.31 
03,005,01,001,0015,26,816,12,828,1192,0,0,0,0,0,0,0,66.31 ,69.46 ,66.31 
03,005,01,001,0015,27,641,5,646,924,0,0,0,0,0,0,0,66.31 ,69.91 ,66.31 
03,005,01,001,0016,28,569,9,578,834,0,0,0,0,0,0,0,66.31 ,69.30 ,66.31 
03,005,01,001,0016,29,653,11,664,940,0,0,0,0,0,0,0,66.31 ,70.64 ,66.31 
03,005,01,001,0017,30,798,15,813,1187,0,0,0,0,0,0,0,66.31 ,68.49 ,66.31 
03,005,01,001,0017,31,807,11,818,1252,0,0,0,0,0,0,0,66.31 ,65.34 ,66.31 
03,005,01,001,0017,32,809,6,815,1251,0,0,0,0,0,0,0,66.31 ,65.15 ,66.31 
03,005,01,001,0018,33,1021,8,1029,1537,0,0,0,0,0,0,0,66.31 ,66.95 ,66.31 
03,005,01,001,0018,34,806,7,813,1156,0,0,0,0,0,0,0,66.31 ,70.33 ,66.31 
03,005,01,001,0018,35,882,21,903,1274,0,0,0,0,0,0,0,66.31 ,70.88 ,66.31 
03,005,01,001,0018,36,903,16,919,1285,0,0,0,0,0,0,0,66.31 ,71.52 ,66.31 
03,005,01,001,0019,37,1140,10,1150,1665,0,0,0,0,0,0,0,66.31 ,69.07 ,66.31 
03,005,01,001,0019,38,1238,25,1263,1874,0,0,0,0,0,0,0,66.31 ,67.40 ,66.31 
03,005,01,001,0019,39,946,21,967,1489,0,0,0,0,0,0,0,66.31 ,64.94 ,66.31 
03,005,01,001,0020,40,578,11,589,868,0,0,0,0,0,0,0,66.31 ,67.86 ,66.31 
03,005,01,001,0020,41,815,27,842,1199,0,0,0,0,0,0,0,66.31 ,70.23 ,66.31 
03,005,01,001,0020,42,772,8,780,1217,0,0,0,0,0,0,0,66.31 ,64.09 ,66.31 
03,005,01,001,0021,43,803,12,815,1249,0,0,0,0,0,0,0,66.31 ,65.25 ,66.31 
03,005,01,001,0021,44,874,10,884,1377,0,0,0,0,0,0,0,66.31 ,64.20 ,66.31 
03,005,01,001,0021,45,823,17,840,1287,0,0,0,0,0,0,0,66.31 ,65.27 ,66.31 
03,005,01,001,0022,46,984,15,999,1431,0,0,0,0,0,0,0,66.31 ,69.81 ,66.31 
03,005,01,001,0022,47,756,21,777,1210,0,0,0,0,0,0,0,66.31 ,64.21 ,66.31 
03,005,01,001,0022,48,1021,26,1047,1548,0,0,0,0,0,0,0,66.31 ,67.64 ,66.31 
03,005,01,001,0023,49,740,8,748,1067,0,0,0,0,0,0,0,66.31 ,70.10 ,66.31 
03,005,01,001,0024,50,765,14,779,1250,0,0,0,0,0,0,0,66.31 ,62.32 ,66.31 
03,005,01,001,0024,51,481,8,489,765,0,0,0,0,0,0,0,66.31 ,63.92 ,66.31 
03,005,01,001,0024,52,595,9,604,883,0,0,0,0,0,0,0,66.31 ,68.40 ,66.31 
03,005,01,002,0025,53,495,5,500,701,0,0,0,0,0,0,0,66.31 ,71.33 ,66.31 
03,005,01,002,0025,54,638,3,641,966,0,0,0,0,0,0,0,66.31 ,66.36 ,66.31 
03,005,01,002,0026,55,587,6,593,871,0,0,0,0,0,0,0,66.31 ,68.08 ,66.31 
03,005,01,002,0026,56,458,8,466,707,0,0,0,0,0,0,0,66.31 ,65.91 ,66.31 
03,005,01,002,0027,57,596,10,606,890,0,0,0,0,0,0,0,66.31 ,68.09 ,66.31 
03,005,01,002,0028,58,857,5,862,1302,0,0,0,0,0,0,0,66.31 ,66.21 ,66.31 
03,005,01,002,0029,59,774,13,787,1106,0,0,0,0,0,0,0,66.31 ,71.16 ,66.31 
03,005,01,002,0030,60,516,9,525,805,0,0,0,0,0,0,0,66.31 ,65.22 ,66.31 
03,005,01,002,0030,61,495,10,505,694,0,0,0,0,0,0,0,66.31 ,72.77 ,66.31 
03,005,01,002,0031,62,643,4,647,955,0,0,0,0,0,0,0,66.31 ,67.75 ,66.31 
03,005,01,002,0032,63,686,7,693,966,0,0,0,0,0,0,0,66.31 ,71.74 ,66.31 
03,005,01,002,0032,64,644,11,655,1024,0,0,0,0,0,0,0,66.31 ,63.96 ,66.31 
03,005,01,002,0033,65,642,5,647,968,0,0,0,0,0,0,0,66.31 ,66.84 ,66.31 
03,005,01,002,0033,66,643,5,648,953,0,0,0,0,0,0,0,66.31 ,68.00 ,66.31 
03,005,01,002,0033,67,659,4,663,978,0,0,0,0,0,0,0,66.31 ,67.79 ,66.31 
03,005,01,002,0034,68,595,9,604,904,0,0,0,0,0,0,0,66.31 ,66.81 ,66.31 
03,005,01,002,0034,69,555,3,558,821,0,0,0,0,0,0,0,66.31 ,67.97 ,66.31 
03,005,01,002,0035,70,615,4,619,976,0,0,0,0,0,0,0,66.31 ,63.42 ,66.31 
03,005,01,002,0036,71,404,3,407,611,0,0,0,0,0,0,0,66.31 ,66.61 ,66.31 
03,005,01,002,0037,72,746,1,747,1087,0,0,0,0,0,0,0,66.31 ,68.72 ,66.31 
03,005,01,002,0038,73,539,8,547,826,0,0,0,0,0,0,0,66.31 ,66.22 ,66.31 
03,005,01,002,0038,74,499,10,509,761,0,0,0,0,0,0,0,66.31 ,66.89 ,66.31 
03,005,01,002,0039,75,578,7,585,830,0,0,0,0,0,0,0,66.31 ,70.48 ,66.31 
03,005,01,002,0039,76,495,8,503,708,0,0,0,0,0,0,0,66.31 ,71.05 ,66.31 
03,005,01,002,0040,77,860,13,873,1252,0,0,0,0,0,0,0,66.31 ,69.73 ,66.31 
03,005,01,002,0041,78,486,3,489,630,0,0,0,0,0,0,0,66.31 ,77.62 ,66.31 
03,005,01,002,0042,79,687,12,699,945,0,0,0,0,0,0,0,66.31 ,73.97 ,66.31 
03,005,01,002,0043,80,483,7,490,737,0,0,0,0,0,0,0,66.31 ,66.49 ,66.31 
03,005,01,002,0044,81,981,10,991,1383,0,0,0,0,0,0,0,66.31 ,71.66 ,66.31 
03,005,01,002,0045,82,1025,14,1039,1503,0,0,0,0,0,0,0,66.31 ,69.13 ,66.31 
03,005,01,002,0046,83,964,11,975,1398,0,0,0,0,0,0,0,66.31 ,69.74 ,66.31 
03,005,01,002,0047,84,663,10,673,981,0,0,0,0,0,0,0,66.31 ,68.60 ,66.31 
03,005,01,002,0047,85,626,8,634,944,0,0,0,0,0,0,0,66.31 ,67.16 ,66.31 
03,005,01,002,0048,86,761,9,770,1091,0,0,0,0,0,0,0,66.31 ,70.58 ,66.31 
03,005,01,002,0049,87,852,11,863,1197,0,0,0,0,0,0,0,66.31 ,72.10 ,66.31 
03,005,01,003,0050,88,851,9,860,1259,0,0,0,0,0,0,0,66.31 ,68.31 ,66.31 
03,005,01,003,0051,89,851,10,861,1206,0,0,0,0,0,0,0,66.31 ,71.39 ,66.31 
03,005,01,003,0051,90,714,1,715,953,0,0,0,0,0,0,0,66.31 ,75.03 ,66.31 
03,005,01,003,0052,91,881,11,892,1283,0,0,0,0,0,0,0,66.31 ,69.52 ,66.31 
03,005,01,003,0052,92,705,10,715,1017,0,0,0,0,0,0,0,66.31 ,70.30 ,66.31 
03,005,01,003,0052,93,725,3,728,1057,0,0,0,0,0,0,0,66.31 ,68.87 ,66.31 
03,005,01,003,0053,94,904,8,912,1234,0,0,0,0,0,0,0,66.31 ,73.91 ,66.31 
03,005,01,003,0054,95,489,5,494,642,0,0,0,0,0,0,0,66.31 ,76.95 ,66.31 
03,005,01,003,0054,96,587,8,595,759,0,0,0,0,0,0,0,66.31 ,78.39 ,66.31 
03,005,01,003,0055,97,556,9,565,764,0,0,0,0,0,0,0,66.31 ,73.95 ,66.31 
03,005,01,003,0055,98,510,4,514,669,0,0,0,0,0,0,0,66.31 ,76.83 ,66.31 
03,005,01,003,0056,99,795,10,805,1119,0,0,0,0,0,0,0,66.31 ,71.94 ,66.31 
03,005,01,003,0056,100,833,15,848,1204,0,0,0,0,0,0,0,66.31 ,70.43 ,66.31 
03,005,01,003,0057,101,872,37,909,1211,0,0,0,0,0,0,0,66.31 ,75.06 ,66.31 
03,005,01,003,0058,102,466,3,469,663,0,0,0,0,0,0,0,66.31 ,70.74 ,66.31 
03,005,01,003,0059,103,641,12,653,843,0,0,0,0,0,0,0,66.31 ,77.46 ,66.31 
03,005,01,003,0060,104,727,16,743,1046,0,0,0,0,0,0,0,66.31 ,71.03 ,66.31 
03,005,01,003,0061,105,497,8,505,708,0,0,0,0,0,0,0,66.31 ,71.33 ,66.31 
03,005,01,003,0062,106,591,6,597,770,0,0,0,0,0,0,0,66.31 ,77.53 ,66.31 
03,005,01,003,0063,107,764,6,770,980,0,0,0,0,0,0,0,66.31 ,78.57 ,66.31 
03,005,01,003,0063,108,567,2,569,728,0,0,0,0,0,0,0,66.31 ,78.16 ,66.31 
03,005,01,003,0064,109,426,2,428,578,0,0,0,0,0,0,0,66.31 ,74.05 ,66.31 
03,005,01,003,0065,110,713,6,719,947,0,0,0,0,0,0,0,66.31 ,75.92 ,66.31 
03,005,01,003,0066,111,374,2,376,542,0,0,0,0,0,0,0,66.31 ,69.37 ,66.31 
03,005,01,003,0067,112,465,8,473,727,0,0,0,0,0,0,0,66.31 ,65.06 ,66.31 
03,005,01,003,0068,113,777,11,788,1072,0,0,0,0,0,0,0,66.31 ,73.51 ,66.31 
03,005,01,003,0068,114,714,8,722,998,0,0,0,0,0,0,0,66.31 ,72.34 ,66.31 
03,005,01,003,0069,115,924,11,935,1240,0,0,0,0,0,0,0,66.31 ,75.40 ,66.31 
03,005,01,003,0070,116,572,11,583,768,0,0,0,0,0,0,0,66.31 ,75.91 ,66.31 
03,005,01,003,0071,117,889,8,897,1304,0,0,0,0,0,0,0,66.31 ,68.79 ,66.31 
03,005,01,003,0072,118,599,3,602,828,0,0,0,0,0,0,0,66.31 ,72.71 ,66.31 
03,005,01,004,0073,119,598,3,601,858,0,0,0,0,0,0,0,66.31 ,70.05 ,66.31 
03,005,01,004,0073,120,558,11,569,829,0,0,0,0,0,0,0,66.31 ,68.64 ,66.31 
03,005,01,004,0074,121,858,16,874,1210,0,0,0,0,0,0,0,66.31 ,72.23 ,66.31 
03,005,01,004,0074,122,789,16,805,1090,0,0,0,0,0,0,0,66.31 ,73.85 ,66.31 
03,005,01,004,0075,123,632,11,643,951,0,0,0,0,0,0,0,66.31 ,67.61 ,66.31 
03,005,01,004,0075,124,776,12,788,1180,0,0,0,0,0,0,0,66.31 ,66.78 ,66.31 
03,005,01,004,0076,125,1008,8,1016,1426,0,0,0,0,0,0,0,66.31 ,71.25 ,66.31 
03,005,01,004,0076,126,764,11,775,1071,0,0,0,0,0,0,0,66.31 ,72.36 ,66.31 
03,005,01,004,0077,127,875,9,884,1174,0,0,0,0,0,0,0,66.31 ,75.30 ,66.31 
03,005,01,004,0077,128,667,7,674,1001,0,0,0,0,0,0,0,66.31 ,67.33 ,66.31 
03,005,01,004,0077,129,556,7,563,845,0,0,0,0,0,0,0,66.31 ,66.63 ,66.31 
03,005,01,004,0078,130,773,15,788,1074,0,0,0,0,0,0,0,66.31 ,73.37 ,66.31 
03,005,01,004,0078,131,890,7,897,1199,0,0,0,0,0,0,0,66.31 ,74.81 ,66.31 
03,005,01,004,0079,132,684,8,692,992,0,0,0,0,0,0,0,66.31 ,69.76 ,66.31 
03,005,01,004,0079,133,748,8,756,1097,0,0,0,0,0,0,0,66.31 ,68.92 ,66.31 
03,005,01,004,0080,134,553,11,564,839,0,0,0,0,0,0,0,66.31 ,67.22 ,66.31 
03,005,01,004,0080,135,565,15,580,858,0,0,0,0,0,0,0,66.31 ,67.60 ,66.31 
03,005,01,004,0080,136,636,14,650,925,0,0,0,0,0,0,0,66.31 ,70.27 ,66.31 
03,005,01,004,0081,137,972,14,986,1374,0,0,0,0,0,0,0,66.31 ,71.76 ,66.31 
03,005,01,004,0081,138,896,14,910,1220,0,0,0,0,0,0,0,66.31 ,74.59 ,66.31 
03,005,01,004,0081,139,857,6,863,1112,0,0,0,0,0,0,0,66.31 ,77.61 ,66.31 
03,005,01,004,0082,140,803,9,812,1187,0,0,0,0,0,0,0,66.31 ,68.41 ,66.31 
03,005,01,004,0082,141,740,7,747,1168,0,0,0,0,0,0,0,66.31 ,63.96 ,66.31 
03,005,01,004,0082,142,726,10,736,1031,0,0,0,0,0,0,0,66.31 ,71.39 ,66.31 
03,005,01,004,0082,143,724,9,733,1014,0,0,0,0,0,0,0,66.31 ,72.29 ,66.31 
03,005,01,004,0083,144,651,3,654,871,0,0,0,0,0,0,0,66.31 ,75.09 ,66.31 
03,005,01,004,0084,145,579,7,586,833,0,0,0,0,0,0,0,66.31 ,70.35 ,66.31 
03,005,01,004,0084,146,781,9,790,1148,0,0,0,0,0,0,0,66.31 ,68.82 ,66.31 
03,005,01,004,0085,147,735,10,745,1040,0,0,0,0,0,0,0,66.31 ,71.63 ,66.31 
03,005,01,004,0086,148,998,19,1017,1374,0,0,0,0,0,0,0,66.31 ,74.02 ,66.31 
03,005,01,004,0087,149,381,4,385,486,0,0,0,0,0,0,0,66.31 ,79.22 ,66.31 
03,005,01,004,0088,150,620,5,625,856,0,0,0,0,0,0,0,66.31 ,73.01 ,66.31 
03,005,01,004,0088,151,680,10,690,954,0,0,0,0,0,0,0,66.31 ,72.33 ,66.31 
03,005,01,004,0089,152,991,9,1000,1277,0,0,0,0,0,0,0,66.31 ,78.31 ,66.31 
03,005,01,004,0090,153,701,11,712,1043,0,0,0,0,0,0,0,66.31 ,68.26 ,66.31 
03,005,01,004,0091,154,574,15,589,783,0,0,0,0,0,0,0,66.31 ,75.22 ,66.31 
03,005,01,004,0091,155,794,32,826,1181,0,0,0,0,0,0,0,66.31 ,69.94 ,66.31 
03,005,01,004,0091,156,619,9,628,868,0,0,0,0,0,0,0,66.31 ,72.35 ,66.31 
03,005,01,004,0092,157,839,11,850,1118,0,0,0,0,0,0,0,66.31 ,76.03 ,66.31 
03,005,01,004,0092,158,721,10,731,972,0,0,0,0,0,0,0,66.31 ,75.21 ,66.31 
03,005,01,004,0093,159,806,23,829,1111,0,0,0,0,0,0,0,66.31 ,74.62 ,66.31 
03,005,01,004,0093,160,754,4,758,1045,0,0,0,0,0,0,0,66.31 ,72.54 ,66.31 
03,005,01,004,0094,161,629,11,640,895,0,0,0,0,0,0,0,66.31 ,71.51 ,66.31 
03,005,01,005,0095,162,545,3,548,730,0,0,0,0,0,0,0,66.31 ,75.07 ,66.31 
03,005,01,005,0095,163,798,16,814,1171,0,0,0,0,0,0,0,66.31 ,69.51 ,66.31 
03,005,01,005,0096,164,654,9,663,936,0,0,0,0,0,0,0,66.31 ,70.83 ,66.31 
03,005,01,005,0096,165,611,7,618,865,0,0,0,0,0,0,0,66.31 ,71.45 ,66.31 
03,005,01,005,0097,166,679,4,683,923,0,0,0,0,0,0,0,66.31 ,74.00 ,66.31 
03,005,01,005,0097,167,614,15,629,834,0,0,0,0,0,0,0,66.31 ,75.42 ,66.31 
03,005,01,005,0097,168,597,8,605,873,0,0,0,0,0,0,0,66.31 ,69.30 ,66.31 
03,005,01,005,0098,169,716,14,730,982,0,0,0,0,0,0,0,66.31 ,74.34 ,66.31 
03,005,01,005,0098,170,710,9,719,1081,0,0,0,0,0,0,0,66.31 ,66.51 ,66.31 
03,005,01,005,0098,171,809,20,829,1276,0,0,0,0,0,0,0,66.31 ,64.97 ,66.31 
03,005,01,005,0099,172,959,14,973,1545,0,0,0,0,0,0,0,66.31 ,62.98 ,66.31 
03,005,01,005,0099,173,713,11,724,1148,0,0,0,0,0,0,0,66.31 ,63.07 ,66.31 
03,005,01,005,0100,174,871,13,884,1253,0,0,0,0,0,0,0,66.31 ,70.55 ,66.31 
03,005,01,005,0100,175,606,5,611,938,0,0,0,0,0,0,0,66.31 ,65.14 ,66.31 
03,005,01,005,0101,176,499,10,509,787,0,0,0,0,0,0,0,66.31 ,64.68 ,66.31 
03,005,01,005,0102,177,697,17,714,1183,0,0,0,0,0,0,0,66.31 ,60.36 ,66.31 
03,005,01,005,0102,178,749,11,760,1174,0,0,0,0,0,0,0,66.31 ,64.74 ,66.31 
03,005,01,005,0103,179,814,5,819,1320,0,0,0,0,0,0,0,66.31 ,62.05 ,66.31 
03,005,01,005,0103,180,927,13,940,1408,0,0,0,0,0,0,0,66.31 ,66.76 ,66.31 
03,005,01,005,0103,181,831,6,837,1288,0,0,0,0,0,0,0,66.31 ,64.98 ,66.31 
03,005,01,005,0104,182,521,10,531,727,0,0,0,0,0,0,0,66.31 ,73.04 ,66.31 
03,005,01,005,0105,183,984,7,991,1440,0,0,0,0,0,0,0,66.31 ,68.82 ,66.31 
03,005,01,005,0106,184,735,6,741,995,0,0,0,0,0,0,0,66.31 ,74.47 ,66.31 
03,005,01,005,0107,185,535,9,544,941,0,0,0,0,0,0,0,66.31 ,57.81 ,66.31 
03,005,01,005,0107,186,686,7,693,983,0,0,0,0,0,0,0,66.31 ,70.50 ,66.31 
03,005,01,005,0108,187,794,8,802,1145,0,0,0,0,0,0,0,66.31 ,70.04 ,66.31 
03,005,01,005,0108,188,590,6,596,876,0,0,0,0,0,0,0,66.31 ,68.04 ,66.31 
03,005,01,005,0109,189,889,11,900,1389,0,0,0,0,0,0,0,66.31 ,64.79 ,66.31 
03,005,01,005,0109,190,774,6,780,1240,0,0,0,0,0,0,0,66.31 ,62.90 ,66.31 
03,005,01,005,0109,191,791,17,808,1125,0,0,0,0,0,0,0,66.31 ,71.82 ,66.31 
03,005,01,005,0110,192,693,11,704,1099,0,0,0,0,0,0,0,66.31 ,64.06 ,66.31 
03,005,01,005,0110,193,717,11,728,1127,0,0,0,0,0,0,0,66.31 ,64.60 ,66.31 
03,005,01,005,0111,194,687,9,696,1163,0,0,0,0,0,0,0,66.31 ,59.85 ,66.31 
03,005,01,005,0111,195,704,10,714,1112,0,0,0,0,0,0,0,66.31 ,64.21 ,66.31 
03,005,01,005,0112,196,506,7,513,783,0,0,0,0,0,0,0,66.31 ,65.52 ,66.31 
03,005,01,005,0112,197,543,10,553,913,0,0,0,0,0,0,0,66.31 ,60.57 ,66.31 
03,005,01,005,0113,198,660,4,664,1004,0,0,0,0,0,0,0,66.31 ,66.14 ,66.31 
03,005,01,005,0113,199,667,8,675,1065,0,0,0,0,0,0,0,66.31 ,63.38 ,66.31 
03,005,01,005,0114,200,724,11,735,1022,0,0,0,0,0,0,0,66.31 ,71.92 ,66.31 
03,005,01,005,0115,201,918,14,932,1449,0,0,0,0,0,0,0,66.31 ,64.32 ,66.31 
03,005,01,005,0116,202,566,4,570,862,0,0,0,0,0,0,0,66.31 ,66.13 ,66.31 
03,005,01,005,0116,203,473,4,477,742,0,0,0,0,0,0,0,66.31 ,64.29 ,66.31 
03,005,01,005,0117,204,506,11,517,841,0,0,0,0,0,0,0,66.31 ,61.47 ,66.31 
03,005,01,005,0117,205,550,13,563,901,0,0,0,0,0,0,0,66.31 ,62.49 ,66.31 
03,005,01,005,0118,206,847,8,855,1258,0,0,0,0,0,0,0,66.31 ,67.97 ,66.31 
03,005,01,005,0118,207,795,14,809,1281,0,0,0,0,0,0,0,66.31 ,63.15 ,66.31 
03,005,01,005,0119,208,953,13,966,1292,0,0,0,0,0,0,0,66.31 ,74.77 ,66.31 
03,005,01,005,0120,209,913,7,920,1270,0,0,0,0,0,0,0,66.31 ,72.44 ,66.31 
03,005,01,005,0121,210,621,9,630,847,0,0,0,0,0,0,0,66.31 ,74.38 ,66.31 
03,005,01,005,0122,211,718,8,726,1080,0,0,0,0,0,0,0,66.31 ,67.22 ,66.31 
03,005,01,005,0122,212,757,12,769,1255,0,0,0,0,0,0,0,66.31 ,61.27 ,66.31 
03,005,01,005,0123,213,640,6,646,1000,0,0,0,0,0,0,0,66.31 ,64.60 ,66.31 
03,005,01,005,0123,214,541,8,549,848,0,0,0,0,0,0,0,66.31 ,64.74 ,66.31 
03,005,01,006,0124,215,478,7,485,645,0,0,0,0,0,0,0,66.31 ,75.19 ,66.31 
03,005,01,006,0124,216,626,5,631,823,0,0,0,0,0,0,0,66.31 ,76.67 ,66.31 
03,005,01,006,0125,217,750,0,750,945,0,0,0,0,0,0,0,66.31 ,79.37 ,66.31 
03,005,01,006,0126,218,1006,19,1025,1391,0,0,0,0,0,0,0,66.31 ,73.69 ,66.31 
03,005,01,006,0127,219,860,10,870,1101,0,0,0,0,0,0,0,66.31 ,79.02 ,66.31 
03,005,01,006,0127,220,844,8,852,1103,0,0,0,0,0,0,0,66.31 ,77.24 ,66.31 
03,005,01,006,0127,221,683,6,689,894,0,0,0,0,0,0,0,66.31 ,77.07 ,66.31 
03,005,01,006,0128,222,737,11,748,983,0,0,0,0,0,0,0,66.31 ,76.09 ,66.31 
03,005,01,006,0128,223,794,5,799,1085,0,0,0,0,0,0,0,66.31 ,73.64 ,66.31 
03,005,01,006,0129,224,965,13,978,1250,0,0,0,0,0,0,0,66.31 ,78.24 ,66.31 
03,005,01,006,0130,225,922,6,928,1184,0,0,0,0,0,0,0,66.31 ,78.38 ,66.31 
03,005,01,006,0131,226,843,7,850,1044,0,0,0,0,0,0,0,66.31 ,81.42 ,66.31 
03,005,01,006,0131,227,807,7,814,1017,0,0,0,0,0,0,0,66.31 ,80.04 ,66.31 
03,005,01,006,0132,228,1048,11,1059,1307,0,0,0,0,0,0,0,66.31 ,81.03 ,66.31 
03,005,01,006,0133,229,485,8,493,632,0,0,0,0,0,0,0,66.31 ,78.01 ,66.31 
03,005,01,006,0134,230,1005,7,1012,1401,0,0,0,0,0,0,0,66.31 ,72.23 ,66.31 
03,005,01,006,0135,231,577,10,587,799,0,0,0,0,0,0,0,66.31 ,73.47 ,66.31 
03,005,01,006,0135,232,591,3,594,830,0,0,0,0,0,0,0,66.31 ,71.57 ,66.31 
03,005,01,006,0136,233,997,8,1005,1380,0,0,0,0,0,0,0,66.31 ,72.83 ,66.31 
03,005,01,006,0137,234,725,9,734,1008,0,0,0,0,0,0,0,66.31 ,72.82 ,66.31 
03,005,01,006,0138,235,858,11,869,1258,0,0,0,0,0,0,0,66.31 ,69.08 ,66.31 
03,005,01,006,0139,236,722,7,729,1062,0,0,0,0,0,0,0,66.31 ,68.64 ,66.31 
03,005,01,006,0140,237,549,1,550,755,0,0,0,0,0,0,0,66.31 ,72.85 ,66.31 
03,005,01,006,0141,238,791,6,797,1115,0,0,0,0,0,0,0,66.31 ,71.48 ,66.31 
03,005,01,006,0142,239,490,10,500,658,0,0,0,0,0,0,0,66.31 ,75.99 ,66.31 
03,005,01,006,0143,240,927,14,941,1256,0,0,0,0,0,0,0,66.31 ,74.92 ,66.31 
03,005,01,006,0144,241,601,3,604,836,0,0,0,0,0,0,0,66.31 ,72.25 ,66.31 
03,005,01,006,0145,242,810,6,816,1274,0,0,0,0,0,0,0,66.31 ,64.05 ,66.31 
03,005,01,006,0146,243,863,12,875,1318,0,0,0,0,0,0,0,66.31 ,66.39 ,66.31 
03,005,01,007,0147,244,826,14,840,1054,0,0,0,0,0,0,0,66.31 ,79.70 ,66.31 
03,005,01,007,0147,245,793,10,803,1052,0,0,0,0,0,0,0,66.31 ,76.33 ,66.31 
03,005,01,007,0148,246,870,12,882,1134,0,0,0,0,0,0,0,66.31 ,77.78 ,66.31 
03,005,01,007,0149,247,605,9,614,798,0,0,0,0,0,0,0,66.31 ,76.94 ,66.31 
03,005,01,007,0150,248,571,7,578,791,0,0,0,0,0,0,0,66.31 ,73.07 ,66.31 
03,005,01,007,0150,249,586,7,593,755,0,0,0,0,0,0,0,66.31 ,78.54 ,66.31 
03,005,01,007,0151,250,801,23,824,986,0,0,0,0,0,0,0,66.31 ,83.57 ,66.31 
03,005,01,007,0152,251,424,7,431,572,0,0,0,0,0,0,0,66.31 ,75.35 ,66.31 
03,005,01,007,0153,252,586,3,589,722,0,0,0,0,0,0,0,66.31 ,81.58 ,66.31 
03,005,01,007,0154,253,1086,17,1103,1485,0,0,0,0,0,0,0,66.31 ,74.28 ,66.31 
03,005,01,007,0154,254,320,12,332,427,0,0,0,0,0,0,0,66.31 ,77.75 ,66.31 
03,005,01,007,0155,255,1092,24,1116,1395,0,0,0,0,0,0,0,66.31 ,80.00 ,66.31 
03,005,01,007,0155,256,477,13,490,630,0,0,0,0,0,0,0,66.31 ,77.78 ,66.31 
03,005,01,007,0156,257,705,12,717,948,0,0,0,0,0,0,0,66.31 ,75.63 ,66.31 
03,005,01,007,0156,258,407,7,414,492,0,0,0,0,0,0,0,66.31 ,84.15 ,66.31 
03,005,01,007,0157,259,530,7,537,718,0,0,0,0,0,0,0,66.31 ,74.79 ,66.31 
03,005,01,008,0158,260,581,3,584,813,0,0,0,0,0,0,0,66.31 ,71.83 ,66.31 
03,005,01,008,0158,261,653,8,661,889,0,0,0,0,0,0,0,66.31 ,74.35 ,66.31 
03,005,01,008,0159,262,562,4,566,702,0,0,0,0,0,0,0,66.31 ,80.63 ,66.31 
03,005,01,008,0160,263,626,6,632,840,0,0,0,0,0,0,0,66.31 ,75.24 ,66.31 
03,005,01,008,0160,264,574,8,582,766,0,0,0,0,0,0,0,66.31 ,75.98 ,66.31 
03,005,01,008,0161,265,1019,10,1029,1369,0,0,0,0,0,0,0,66.31 ,75.16 ,66.31 
03,005,01,008,0162,266,474,7,481,705,0,0,0,0,0,0,0,66.31 ,68.23 ,66.31 
03,005,01,008,0163,267,929,8,937,1256,0,0,0,0,0,0,0,66.31 ,74.60 ,66.31 
03,005,01,008,0164,268,559,10,569,749,0,0,0,0,0,0,0,66.31 ,75.97 ,66.31 
03,005,01,008,0165,269,498,12,510,698,0,0,0,0,0,0,0,66.31 ,73.07 ,66.31 
03,005,01,008,0165,270,619,7,626,831,0,0,0,0,0,0,0,66.31 ,75.33 ,66.31 
03,005,01,008,0166,271,588,2,590,777,0,0,0,0,0,0,0,66.31 ,75.93 ,66.31 
03,005,01,008,0167,272,425,6,431,562,0,0,0,0,0,0,0,66.31 ,76.69 ,66.31 
03,005,01,008,0168,273,695,12,707,982,0,0,0,0,0,0,0,66.31 ,72.00 ,66.31 
03,005,01,008,0169,274,700,7,707,928,0,0,0,0,0,0,0,66.31 ,76.19 ,66.31 
03,005,01,009,0170,275,595,10,605,823,0,0,0,0,0,0,0,66.31 ,73.51 ,66.31 
03,005,01,009,0170,276,517,7,524,694,0,0,0,0,0,0,0,66.31 ,75.50 ,66.31 
03,005,01,009,0171,277,738,6,744,1052,0,0,0,0,0,0,0,66.31 ,70.72 ,66.31 
03,005,01,009,0171,278,780,18,798,1087,0,0,0,0,0,0,0,66.31 ,73.41 ,66.31 
03,005,01,009,0172,279,798,11,809,1158,0,0,0,0,0,0,0,66.31 ,69.86 ,66.31 
03,005,01,009,0172,280,924,13,937,1326,0,0,0,0,0,0,0,66.31 ,70.66 ,66.31 
03,005,01,009,0173,281,669,13,682,969,0,0,0,0,0,0,0,66.31 ,70.38 ,66.31 
03,005,01,009,0173,282,659,2,661,904,0,0,0,0,0,0,0,66.31 ,73.12 ,66.31 
03,005,01,009,0174,283,602,13,615,832,0,0,0,0,0,0,0,66.31 ,73.92 ,66.31 
03,005,01,009,0174,284,486,10,496,716,0,0,0,0,0,0,0,66.31 ,69.27 ,66.31 
03,005,01,009,0175,285,655,7,662,934,0,0,0,0,0,0,0,66.31 ,70.88 ,66.31 
03,005,01,009,0176,286,795,7,802,1046,0,0,0,0,0,0,0,66.31 ,76.67 ,66.31 
03,005,01,009,0177,287,302,3,305,412,0,0,0,0,0,0,0,66.31 ,74.03 ,66.31 
03,005,01,009,0178,288,1029,15,1044,1456,0,0,0,0,0,0,0,66.31 ,71.70 ,66.31 
03,005,01,009,0179,289,508,7,515,667,0,0,0,0,0,0,0,66.31 ,77.21 ,66.31 
03,005,01,009,0179,290,521,5,526,685,0,0,0,0,0,0,0,66.31 ,76.79 ,66.31 
03,005,01,009,0180,291,263,2,265,332,0,0,0,0,0,0,0,66.31 ,79.82 ,66.31 
03,005,01,009,0181,292,633,10,643,889,0,0,0,0,0,0,0,66.31 ,72.33 ,66.31 
03,005,01,009,0181,293,623,9,632,850,0,0,0,0,0,0,0,66.31 ,74.35 ,66.31 
03,005,01,009,0182,294,751,8,759,1014,0,0,0,0,0,0,0,66.31 ,74.85 ,66.31 
03,005,01,009,0183,295,991,12,1003,1343,0,0,0,0,0,0,0,66.31 ,74.68 ,66.31 
03,005,01,009,0184,296,954,9,963,1292,0,0,0,0,0,0,0,66.31 ,74.54 ,66.31 
03,005,01,009,0185,297,992,9,1001,1330,0,0,0,0,0,0,0,66.31 ,75.26 ,66.31 
03,005,01,009,0186,298,886,10,896,1141,0,0,0,0,0,0,0,66.31 ,78.53 ,66.31 
03,005,01,009,0187,299,157,4,161,215,0,0,0,0,0,0,0,66.31 ,74.88 ,66.31 
03,005,01,009,0188,300,253,1,254,322,0,0,0,0,0,0,0,66.31 ,78.88 ,66.31 
03,005,01,010,0189,301,761,10,771,1034,0,0,0,0,0,0,0,66.31 ,74.56 ,66.31 
03,005,01,010,0190,302,647,8,655,904,0,0,0,0,0,0,0,66.31 ,72.46 ,66.31 
03,005,01,010,0190,303,551,12,563,755,0,0,0,0,0,0,0,66.31 ,74.57 ,66.31 
03,005,01,010,0191,304,744,11,755,1069,0,0,0,0,0,0,0,66.31 ,70.63 ,66.31 
03,005,01,010,0192,305,1079,18,1097,1431,0,0,0,0,0,0,0,66.31 ,76.66 ,66.31 
03,005,01,010,0192,306,1275,18,1293,1689,0,0,0,0,0,0,0,66.31 ,76.55 ,66.31 
03,005,01,010,0192,307,580,12,592,822,0,0,0,0,0,0,0,66.31 ,72.02 ,66.31 
03,005,01,010,0193,308,938,18,956,1292,0,0,0,0,0,0,0,66.31 ,73.99 ,66.31 
03,005,01,010,0194,309,964,12,976,1264,0,0,0,0,0,0,0,66.31 ,77.22 ,66.31 
03,005,01,010,0195,310,881,10,891,1189,0,0,0,0,0,0,0,66.31 ,74.94 ,66.31 
03,005,01,010,0195,311,1002,20,1022,1417,0,0,0,0,0,0,0,66.31 ,72.12 ,66.31 
03,005,01,010,0196,312,478,3,481,630,0,0,0,0,0,0,0,66.31 ,76.35 ,66.31 
03,005,01,010,0197,313,378,3,381,551,0,0,0,0,0,0,0,66.31 ,69.15 ,66.31 
03,005,01,010,0198,314,433,8,441,611,0,0,0,0,0,0,0,66.31 ,72.18 ,66.31 
03,005,01,011,0199,315,362,4,366,537,0,0,0,0,0,0,0,66.31 ,68.16 ,66.31 
03,005,01,011,0199,316,502,9,511,772,0,0,0,0,0,0,0,66.31 ,66.19 ,66.31 
03,005,01,011,0200,317,499,3,502,719,0,0,0,0,0,0,0,66.31 ,69.82 ,66.31 
03,005,01,011,0201,318,457,5,462,698,0,0,0,0,0,0,0,66.31 ,66.19 ,66.31 
03,005,01,011,0201,319,279,1,280,423,0,0,0,0,0,0,0,66.31 ,66.19 ,66.31 
03,005,01,011,0202,320,586,8,594,910,0,0,0,0,0,0,0,66.31 ,65.27 ,66.31 
03,005,01,011,0203,321,411,4,415,623,0,0,0,0,0,0,0,66.31 ,66.61 ,66.31 
03,005,01,011,0203,322,251,11,262,418,0,0,0,0,0,0,0,66.31 ,62.68 ,66.31 
03,005,01,011,0204,323,721,17,738,1117,0,0,0,0,0,0,0,66.31 ,66.07 ,66.31 
03,005,01,011,0205,324,734,5,739,1091,0,0,0,0,0,0,0,66.31 ,67.74 ,66.31 
03,005,01,011,0206,325,297,6,303,468,0,0,0,0,0,0,0,66.31 ,64.74 ,66.31 
03,005,01,011,0207,326,180,4,184,290,0,0,0,0,0,0,0,66.31 ,63.45 ,66.31 
03,005,01,012,0208,327,897,8,905,1224,0,0,0,0,0,0,0,66.31 ,73.94 ,66.31 
03,005,01,012,0208,328,849,7,856,1086,0,0,0,0,0,0,0,66.31 ,78.82 ,66.31 
03,005,01,012,0209,329,552,6,558,751,0,0,0,0,0,0,0,66.31 ,74.30 ,66.31 
03,005,01,012,0209,330,625,3,628,753,0,0,0,0,0,0,0,66.31 ,83.40 ,66.31 
03,005,01,012,0210,331,484,4,488,636,0,0,0,0,0,0,0,66.31 ,76.73 ,66.31 
03,005,01,012,0211,332,675,10,685,877,0,0,0,0,0,0,0,66.31 ,78.11 ,66.31 
03,005,01,012,0212,333,258,1,259,352,0,0,0,0,0,0,0,66.31 ,73.58 ,66.31 
03,005,01,012,0213,334,666,6,672,882,0,0,0,0,0,0,0,66.31 ,76.19 ,66.31 
03,005,01,012,0213,335,703,9,712,952,0,0,0,0,0,0,0,66.31 ,74.79 ,66.31 
03,005,01,012,0214,336,715,5,720,929,0,0,0,0,0,0,0,66.31 ,77.50 ,66.31 
03,005,01,012,0214,337,170,2,172,218,0,0,0,0,0,0,0,66.31 ,78.90 ,66.31 
03,005,01,012,0215,338,282,2,284,372,0,0,0,0,0,0,0,66.31 ,76.34 ,66.31 
03,005,01,013,0216,339,734,11,745,978,0,0,0,0,0,0,0,66.31 ,76.18 ,66.31 
03,005,01,013,0216,340,765,11,776,1027,0,0,0,0,0,0,0,66.31 ,75.56 ,66.31 
03,005,01,013,0216,341,721,11,732,982,0,0,0,0,0,0,0,66.31 ,74.54 ,66.31 
03,005,01,013,0216,342,614,8,622,840,0,0,0,0,0,0,0,66.31 ,74.05 ,66.31 
03,005,01,013,0217,343,695,8,703,915,0,0,0,0,0,0,0,66.31 ,76.83 ,66.31 
03,005,01,013,0217,344,530,5,535,704,0,0,0,0,0,0,0,66.31 ,75.99 ,66.31 
03,005,01,013,0217,345,730,7,737,1044,0,0,0,0,0,0,0,66.31 ,70.59 ,66.31 
03,005,01,013,0218,346,707,9,716,888,0,0,0,0,0,0,0,66.31 ,80.63 ,66.31 
03,005,01,013,0218,347,534,11,545,723,0,0,0,0,0,0,0,66.31 ,75.38 ,66.31 
03,005,01,013,0219,348,536,5,541,695,0,0,0,0,0,0,0,66.31 ,77.84 ,66.31 
03,005,01,013,0219,349,499,13,512,641,0,0,0,0,0,0,0,66.31 ,79.88 ,66.31 
03,005,01,013,0220,350,937,11,948,1227,0,0,0,0,0,0,0,66.31 ,77.26 ,66.31 
03,005,01,013,0221,351,310,7,317,384,0,0,0,0,0,0,0,66.31 ,82.55 ,66.31 
03,005,01,013,0222,352,901,13,914,1150,0,0,0,0,0,0,0,66.31 ,79.48 ,66.31 
03,005,01,014,0223,353,462,6,468,623,0,0,0,0,0,0,0,66.31 ,75.12 ,66.31 
03,005,01,014,0224,354,410,7,417,571,0,0,0,0,0,0,0,66.31 ,73.03 ,66.31 
03,005,01,014,0225,355,642,10,652,915,0,0,0,0,0,0,0,66.31 ,71.26 ,66.31 
03,005,01,014,0226,356,502,5,507,666,0,0,0,0,0,0,0,66.31 ,76.13 ,66.31 
03,005,01,014,0227,357,691,9,700,998,0,0,0,0,0,0,0,66.31 ,70.14 ,66.31 
03,005,01,014,0228,358,402,3,405,538,0,0,0,0,0,0,0,66.31 ,75.28 ,66.31 
03,005,01,014,0229,359,387,5,392,544,0,0,0,0,0,0,0,66.31 ,72.06 ,66.31 
03,005,01,014,0230,360,806,9,815,1171,0,0,0,0,0,0,0,66.31 ,69.60 ,66.31 
03,005,01,014,0231,361,448,3,451,694,0,0,0,0,0,0,0,66.31 ,64.99 ,66.31 
03,005,01,015,0232,362,1215,17,1232,1608,0,0,0,0,0,0,0,66.31 ,76.62 ,66.31 
03,005,01,015,0233,363,420,3,423,530,0,0,0,0,0,0,0,66.31 ,79.81 ,66.31 
03,005,01,015,0234,364,701,7,708,946,0,0,0,0,0,0,0,66.31 ,74.84 ,66.31 
03,005,01,015,0235,365,1176,17,1193,1516,0,0,0,0,0,0,0,66.31 ,78.69 ,66.31 
03,005,01,015,0235,366,988,12,1000,1280,0,0,0,0,0,0,0,66.31 ,78.13 ,66.31 
03,005,01,015,0236,367,445,3,448,556,0,0,0,0,0,0,0,66.31 ,80.58 ,66.31 
03,005,01,015,0237,368,442,3,445,538,0,0,0,0,0,0,0,66.31 ,82.71 ,66.31 
03,005,01,015,0238,369,1038,19,1057,1356,0,0,0,0,0,0,0,66.31 ,77.95 ,66.31 
03,005,01,015,0239,370,574,10,584,731,0,0,0,0,0,0,0,66.31 ,79.89 ,66.31 
03,005,01,015,0240,371,776,7,783,995,0,0,0,0,0,0,0,66.31 ,78.69 ,66.31 
03,005,01,016,0241,372,748,8,756,1019,0,0,0,0,0,0,0,66.31 ,74.19 ,66.31 
03,005,01,016,0241,373,740,10,750,1059,0,0,0,0,0,0,0,66.31 ,70.82 ,66.31 
03,005,01,016,0242,374,477,8,485,609,0,0,0,0,0,0,0,66.31 ,79.64 ,66.31 
03,005,01,016,0243,375,588,4,592,862,0,0,0,0,0,0,0,66.31 ,68.68 ,66.31 
03,005,01,016,0244,376,189,7,196,247,0,0,0,0,0,0,0,66.31 ,79.35 ,66.31 
03,005,01,016,0245,377,421,4,425,592,0,0,0,0,0,0,0,66.31 ,71.79 ,66.31 
03,005,01,016,0246,378,466,5,471,672,0,0,0,0,0,0,0,66.31 ,70.09 ,66.31 
03,005,01,016,0247,379,381,4,385,520,0,0,0,0,0,0,0,66.31 ,74.04 ,66.31 
03,005,01,016,0248,380,255,4,259,335,0,0,0,0,0,0,0,66.31 ,77.31 ,66.31 
03,005,01,017,0249,381,208,0,208,293,0,0,0,0,0,0,0,66.31 ,70.99 ,66.31 
03,005,01,017,0250,382,490,7,497,668,0,0,0,0,0,0,0,66.31 ,74.40 ,66.31 
03,005,01,017,0251,383,762,6,768,980,0,0,0,0,0,0,0,66.31 ,78.37 ,66.31 
03,005,01,017,0252,384,451,4,455,638,0,0,0,0,0,0,0,66.31 ,71.32 ,66.31 
03,005,01,017,0253,385,471,4,475,676,0,0,0,0,0,0,0,66.31 ,70.27 ,66.31 
03,005,01,017,0254,386,284,6,290,376,0,0,0,0,0,0,0,66.31 ,77.13 ,66.31 
03,005,01,017,0255,387,566,10,576,778,0,0,0,0,0,0,0,66.31 ,74.04 ,66.31 
03,005,01,018,0256,388,108,1,109,132,0,0,0,0,0,0,0,66.31 ,82.58 ,66.31 
03,005,01,018,0257,389,213,3,216,353,0,0,0,0,0,0,0,66.31 ,61.19 ,66.31 
03,005,01,018,0258,390,227,4,231,314,0,0,0,0,0,0,0,66.31 ,73.57 ,66.31 
03,005,01,018,0258,391,269,7,276,367,0,0,0,0,0,0,0,66.31 ,75.20 ,66.31 
03,005,01,018,0259,392,69,1,70,102,0,0,0,0,0,0,0,66.31 ,68.63 ,66.31 
03,005,01,018,0260,393,95,1,96,128,0,0,0,0,0,0,0,66.31 ,75.00 ,66.31 
03,005,01,018,0261,394,18,0,18,27,0,0,0,0,0,0,0,66.31 ,66.67 ,66.31 
03,005,01,018,0262,395,39,0,39,53,0,0,0,0,0,0,0,66.31 ,73.58 ,66.31 
03,005,01,018,0263,396,19,0,19,32,0,0,0,0,0,0,0,66.31 ,59.38 ,66.31 
03,006,01,001,0001,1,684,17,701,967,0,0,0,0,0,0,0,66.31 ,72.49 ,66.31 
03,006,01,001,0001,2,692,11,703,974,0,0,0,0,0,0,0,66.31 ,72.18 ,66.31 
03,006,01,001,0002,3,665,7,672,959,0,0,0,0,0,0,0,66.31 ,70.07 ,66.31 
03,006,01,001,0003,4,536,11,547,850,0,0,0,0,0,0,0,66.31 ,64.35 ,66.31 
03,006,01,001,0004,5,677,6,683,924,0,0,0,0,0,0,0,66.31 ,73.92 ,66.31 
03,006,01,001,0005,6,606,11,617,842,0,0,0,0,0,0,0,66.31 ,73.28 ,66.31 
03,006,01,001,0006,7,880,16,896,1358,0,0,0,0,0,0,0,66.31 ,65.98 ,66.31 
03,006,01,001,0006,8,884,12,896,1322,0,0,0,0,0,0,0,66.31 ,67.78 ,66.31 
03,006,01,001,0006,9,1099,18,1117,1578,0,0,0,0,0,0,0,66.31 ,70.79 ,66.31 
03,006,01,001,0007,10,670,14,684,980,0,0,0,0,0,0,0,66.31 ,69.80 ,66.31 
03,006,01,001,0007,11,710,6,716,1014,0,0,0,0,0,0,0,66.31 ,70.61 ,66.31 
03,006,01,001,0008,12,806,9,815,1147,0,0,0,0,0,0,0,66.31 ,71.05 ,66.31 
03,006,01,001,0008,13,743,14,757,1036,0,0,0,0,0,0,0,66.31 ,73.07 ,66.31 
03,006,01,001,0009,14,840,15,855,1140,0,0,0,0,0,0,0,66.31 ,75.00 ,66.31 
03,006,01,001,0009,15,834,29,863,1253,0,0,0,0,0,0,0,66.31 ,68.87 ,66.31 
03,006,01,001,0009,16,755,12,767,1026,0,0,0,0,0,0,0,66.31 ,74.76 ,66.31 
03,006,01,001,0010,17,1097,28,1125,1645,0,0,0,0,0,0,0,66.31 ,68.39 ,66.31 
03,006,01,001,0010,18,1052,29,1081,1658,0,0,0,0,0,0,0,66.31 ,65.20 ,66.31 
03,006,01,001,0010,19,727,14,741,1172,0,0,0,0,0,0,0,66.31 ,63.23 ,66.31 
03,006,01,001,0010,20,570,14,584,971,0,0,0,0,0,0,0,66.31 ,60.14 ,66.31 
03,006,01,001,0011,21,1153,23,1176,1700,0,0,0,0,0,0,0,66.31 ,69.18 ,66.31 
03,006,01,001,0012,22,800,14,814,1093,0,0,0,0,0,0,0,66.31 ,74.47 ,66.31 
03,006,01,001,0013,23,828,7,835,1234,0,0,0,0,0,0,0,66.31 ,67.67 ,66.31 
03,006,01,001,0013,24,939,21,960,1377,0,0,0,0,0,0,0,66.31 ,69.72 ,66.31 
03,006,01,001,0014,25,704,11,715,881,0,0,0,0,0,0,0,66.31 ,81.16 ,66.31 
03,006,01,001,0015,26,602,5,607,880,0,0,0,0,0,0,0,66.31 ,68.98 ,66.31 
03,006,01,001,0016,27,1010,21,1031,1437,0,0,0,0,0,0,0,66.31 ,71.75 ,66.31 
03,006,01,001,0016,28,1039,19,1058,1623,0,0,0,0,0,0,0,66.31 ,65.19 ,66.31 
03,006,01,001,0016,29,954,10,964,1497,0,0,0,0,0,0,0,66.31 ,64.40 ,66.31 
03,006,01,001,0017,30,725,5,730,1050,0,0,0,0,0,0,0,66.31 ,69.52 ,66.31 
03,006,01,001,0017,31,707,12,719,981,0,0,0,0,0,0,0,66.31 ,73.29 ,66.31 
03,006,01,001,0018,32,875,10,885,1255,0,0,0,0,0,0,0,66.31 ,70.52 ,66.31 
03,006,01,001,0018,33,935,5,940,1382,0,0,0,0,0,0,0,66.31 ,68.02 ,66.31 
03,006,01,001,0019,34,852,15,867,1347,0,0,0,0,0,0,0,66.31 ,64.37 ,66.31 
03,006,01,001,0019,35,940,26,966,1377,0,0,0,0,0,0,0,66.31 ,70.15 ,66.31 
03,006,01,001,0019,36,881,25,906,1424,0,0,0,0,0,0,0,66.31 ,63.62 ,66.31 
03,006,01,001,0019,37,749,5,754,1408,0,0,0,0,0,0,0,66.31 ,53.55 ,66.31 
03,006,01,001,0019,38,863,18,881,1366,0,0,0,0,0,0,0,66.31 ,64.49 ,66.31 
03,006,01,001,0020,39,921,27,948,1413,0,0,0,0,0,0,0,66.31 ,67.09 ,66.31 
03,006,01,001,0020,40,880,9,889,1337,0,0,0,0,0,0,0,66.31 ,66.49 ,66.31 
03,006,01,001,0020,41,951,21,972,1348,0,0,0,0,0,0,0,66.31 ,72.11 ,66.31 
03,006,01,001,0021,42,931,21,952,1451,0,0,0,0,0,0,0,66.31 ,65.61 ,66.31 
03,006,01,001,0022,43,731,6,737,1070,0,0,0,0,0,0,0,66.31 ,68.88 ,66.31 
03,006,01,001,0023,44,969,28,997,1525,0,0,0,0,0,0,0,66.31 ,65.38 ,66.31 
03,006,01,001,0023,45,924,9,933,1435,0,0,0,0,0,0,0,66.31 ,65.02 ,66.31 
03,006,01,001,0023,46,857,13,870,1365,0,0,0,0,0,0,0,66.31 ,63.74 ,66.31 
03,006,01,001,0024,47,991,26,1017,1582,0,0,0,0,0,0,0,66.31 ,64.29 ,66.31 
03,006,01,001,0024,48,1043,29,1072,1708,0,0,0,0,0,0,0,66.31 ,62.76 ,66.31 
03,006,01,001,0024,49,947,20,967,1508,0,0,0,0,0,0,0,66.31 ,64.12 ,66.31 
03,006,01,001,0024,50,1003,25,1028,1525,0,0,0,0,0,0,0,66.31 ,67.41 ,66.31 
03,006,01,001,0024,51,1039,22,1061,1500,0,0,0,0,0,0,0,66.31 ,70.73 ,66.31 
03,006,01,001,0025,52,1173,24,1197,1659,0,0,0,0,0,0,0,66.31 ,72.15 ,66.31 
03,006,01,001,0025,53,1087,18,1105,1550,0,0,0,0,0,0,0,66.31 ,71.29 ,66.31 
03,006,01,001,0026,54,807,12,819,1154,0,0,0,0,0,0,0,66.31 ,70.97 ,66.31 
03,006,01,001,0026,55,819,10,829,1206,0,0,0,0,0,0,0,66.31 ,68.74 ,66.31 
03,006,01,001,0027,56,979,22,1001,1410,0,0,0,0,0,0,0,66.31 ,70.99 ,66.31 
03,006,01,001,0027,57,924,8,932,1446,0,0,0,0,0,0,0,66.31 ,64.45 ,66.31 
03,006,01,001,0027,58,900,14,914,1326,0,0,0,0,0,0,0,66.31 ,68.93 ,66.31 
03,006,01,001,0027,59,913,12,925,1384,0,0,0,0,0,0,0,66.31 ,66.84 ,66.31 
03,006,01,001,0028,60,908,12,920,1458,0,0,0,0,0,0,0,66.31 ,63.10 ,66.31 
03,006,01,001,0028,61,1135,13,1148,1707,0,0,0,0,0,0,0,66.31 ,67.25 ,66.31 
03,006,01,001,0028,62,1142,18,1160,1690,0,0,0,0,0,0,0,66.31 ,68.64 ,66.31 
03,006,01,001,0028,63,951,6,957,1441,0,0,0,0,0,0,0,66.31 ,66.41 ,66.31 
03,006,01,001,0028,64,950,13,963,1428,0,0,0,0,0,0,0,66.31 ,67.44 ,66.31 
03,006,01,001,0028,65,1024,20,1044,1555,0,0,0,0,0,0,0,66.31 ,67.14 ,66.31 
03,006,01,001,0029,66,1129,22,1151,1556,0,0,0,0,0,0,0,66.31 ,73.97 ,66.31 
03,006,01,001,0030,67,763,11,774,1122,0,0,0,0,0,0,0,66.31 ,68.98 ,66.31 
03,006,01,001,0030,68,807,10,817,1293,0,0,0,0,0,0,0,66.31 ,63.19 ,66.31 
03,006,01,001,0030,69,750,7,757,1165,0,0,0,0,0,0,0,66.31 ,64.98 ,66.31 
03,006,01,001,0031,70,1307,31,1338,1743,0,0,0,0,0,0,0,66.31 ,76.76 ,66.31 
03,006,01,001,0031,71,961,18,979,1310,0,0,0,0,0,0,0,66.31 ,74.73 ,66.31 
03,006,01,001,0032,72,974,25,999,1401,0,0,0,0,0,0,0,66.31 ,71.31 ,66.31 
03,006,01,001,0032,73,1019,13,1032,1371,0,0,0,0,0,0,0,66.31 ,75.27 ,66.31 
03,006,01,001,0033,74,1100,27,1127,1529,0,0,0,0,0,0,0,66.31 ,73.71 ,66.31 
03,006,01,001,0034,75,884,16,900,1286,0,0,0,0,0,0,0,66.31 ,69.98 ,66.31 
03,006,01,001,0034,76,596,6,602,915,0,0,0,0,0,0,0,66.31 ,65.79 ,66.31 
03,006,01,001,0035,77,584,16,600,791,0,0,0,0,0,0,0,66.31 ,75.85 ,66.31 
03,006,01,001,0035,78,710,31,741,999,0,0,0,0,0,0,0,66.31 ,74.17 ,66.31 
03,006,01,001,0036,79,1095,36,1131,1476,0,0,0,0,0,0,0,66.31 ,76.63 ,66.31 
03,006,01,001,0036,80,856,20,876,1253,0,0,0,0,0,0,0,66.31 ,69.91 ,66.31 
03,006,01,002,0037,81,862,27,889,1179,0,0,0,0,0,0,0,66.31 ,75.40 ,66.31 
03,006,01,002,0038,82,661,13,674,879,0,0,0,0,0,0,0,66.31 ,76.68 ,66.31 
03,006,01,002,0039,83,1057,31,1088,1502,0,0,0,0,0,0,0,66.31 ,72.44 ,66.31 
03,006,01,002,0040,84,668,14,682,861,0,0,0,0,0,0,0,66.31 ,79.21 ,66.31 
03,006,01,002,0040,85,790,21,811,1065,0,0,0,0,0,0,0,66.31 ,76.15 ,66.31 
03,006,01,002,0041,86,868,19,887,1226,0,0,0,0,0,0,0,66.31 ,72.35 ,66.31 
03,006,01,002,0041,87,801,17,818,1124,0,0,0,0,0,0,0,66.31 ,72.78 ,66.31 
03,006,01,002,0042,88,763,20,783,1014,0,0,0,0,0,0,0,66.31 ,77.22 ,66.31 
03,006,01,002,0043,89,1108,15,1123,1556,0,0,0,0,0,0,0,66.31 ,72.17 ,66.31 
03,006,01,002,0044,90,881,20,901,1259,0,0,0,0,0,0,0,66.31 ,71.56 ,66.31 
03,006,01,002,0044,91,760,13,773,1142,0,0,0,0,0,0,0,66.31 ,67.69 ,66.31 
03,006,01,002,0044,92,571,9,580,854,0,0,0,0,0,0,0,66.31 ,67.92 ,66.31 
03,006,01,002,0045,93,659,10,669,901,0,0,0,0,0,0,0,66.31 ,74.25 ,66.31 
03,006,01,002,0045,94,641,6,647,941,0,0,0,0,0,0,0,66.31 ,68.76 ,66.31 
03,006,01,002,0046,95,899,16,915,1221,0,0,0,0,0,0,0,66.31 ,74.94 ,66.31 
03,006,01,002,0046,96,1194,34,1228,1637,0,0,0,0,0,0,0,66.31 ,75.02 ,66.31 
03,006,01,002,0047,97,1021,11,1032,1405,0,0,0,0,0,0,0,66.31 ,73.45 ,66.31 
03,006,01,002,0048,98,884,17,901,1209,0,0,0,0,0,0,0,66.31 ,74.52 ,66.31 
03,006,01,002,0048,99,1125,19,1144,1492,0,0,0,0,0,0,0,66.31 ,76.68 ,66.31 
03,006,01,002,0048,100,1220,19,1239,1594,0,0,0,0,0,0,0,66.31 ,77.73 ,66.31 
03,006,01,002,0049,101,1052,24,1076,1443,0,0,0,0,0,0,0,66.31 ,74.57 ,66.31 
03,006,01,002,0050,102,733,10,743,984,0,0,0,0,0,0,0,66.31 ,75.51 ,66.31 
03,006,01,002,0051,103,714,14,728,896,0,0,0,0,0,0,0,66.31 ,81.25 ,66.31 
03,006,01,002,0052,104,811,14,825,1057,0,0,0,0,0,0,0,66.31 ,78.05 ,66.31 
03,006,01,002,0052,105,678,7,685,872,0,0,0,0,0,0,0,66.31 ,78.56 ,66.31 
03,006,01,002,0053,106,997,13,1010,1364,0,0,0,0,0,0,0,66.31 ,74.05 ,66.31 
03,006,01,002,0054,107,721,14,735,1072,0,0,0,0,0,0,0,66.31 ,68.56 ,66.31 
03,006,01,002,0054,108,544,16,560,781,0,0,0,0,0,0,0,66.31 ,71.70 ,66.31 
03,006,01,002,0055,109,917,13,930,1173,0,0,0,0,0,0,0,66.31 ,79.28 ,66.31 
03,006,01,002,0055,110,439,14,453,665,0,0,0,0,0,0,0,66.31 ,68.12 ,66.31 
03,006,01,002,0056,111,1182,23,1205,1519,0,0,0,0,0,0,0,66.31 ,79.33 ,66.31 
03,006,01,002,0057,112,851,15,866,1224,0,0,0,0,0,0,0,66.31 ,70.75 ,66.31 
03,006,01,002,0058,113,1115,21,1136,1595,0,0,0,0,0,0,0,66.31 ,71.22 ,66.31 
03,006,01,002,0059,114,561,14,575,741,0,0,0,0,0,0,0,66.31 ,77.60 ,66.31 
03,006,01,002,0060,115,554,8,562,662,0,0,0,0,0,0,0,66.31 ,84.89 ,66.31 
03,006,01,002,0061,116,1018,25,1043,1382,0,0,0,0,0,0,0,66.31 ,75.47 ,66.31 
03,006,01,003,0062,117,869,14,883,1211,0,0,0,0,0,0,0,66.31 ,72.91 ,66.31 
03,006,01,003,0063,118,841,14,855,1165,0,0,0,0,0,0,0,66.31 ,73.39 ,66.31 
03,006,01,003,0064,119,602,13,615,820,0,0,0,0,0,0,0,66.31 ,75.00 ,66.31 
03,006,01,003,0064,120,559,12,571,820,0,0,0,0,0,0,0,66.31 ,69.63 ,66.31 
03,006,01,003,0065,121,544,11,555,732,0,0,0,0,0,0,0,66.31 ,75.82 ,66.31 
03,006,01,003,0066,122,609,13,622,824,0,0,0,0,0,0,0,66.31 ,75.49 ,66.31 
03,006,01,003,0066,123,710,11,721,939,0,0,0,0,0,0,0,66.31 ,76.78 ,66.31 
03,006,01,003,0067,124,671,10,681,913,0,0,0,0,0,0,0,66.31 ,74.59 ,66.31 
03,006,01,003,0067,125,659,15,674,948,0,0,0,0,0,0,0,66.31 ,71.10 ,66.31 
03,006,01,003,0068,126,715,17,732,990,0,0,0,0,0,0,0,66.31 ,73.94 ,66.31 
03,006,01,003,0068,127,727,10,737,1027,0,0,0,0,0,0,0,66.31 ,71.76 ,66.31 
03,006,01,003,0068,128,705,16,721,979,0,0,0,0,0,0,0,66.31 ,73.65 ,66.31 
03,006,01,003,0069,129,555,7,562,763,0,0,0,0,0,0,0,66.31 ,73.66 ,66.31 
03,006,01,003,0069,130,619,11,630,809,0,0,0,0,0,0,0,66.31 ,77.87 ,66.31 
03,006,01,003,0070,131,641,21,662,948,0,0,0,0,0,0,0,66.31 ,69.83 ,66.31 
03,006,01,003,0070,132,671,10,681,965,0,0,0,0,0,0,0,66.31 ,70.57 ,66.31 
03,006,01,003,0070,133,717,21,738,1050,0,0,0,0,0,0,0,66.31 ,70.29 ,66.31 
03,006,01,003,0071,134,659,17,676,880,0,0,0,0,0,0,0,66.31 ,76.82 ,66.31 
03,006,01,003,0072,135,622,11,633,880,0,0,0,0,0,0,0,66.31 ,71.93 ,66.31 
03,006,01,003,0073,136,820,22,842,1153,0,0,0,0,0,0,0,66.31 ,73.03 ,66.31 
03,006,01,003,0073,137,883,16,899,1248,0,0,0,0,0,0,0,66.31 ,72.04 ,66.31 
03,006,01,003,0074,138,819,22,841,991,0,0,0,0,0,0,0,66.31 ,84.86 ,66.31 
03,006,01,003,0075,139,830,15,845,1031,0,0,0,0,0,0,0,66.31 ,81.96 ,66.31 
03,006,01,003,0076,140,1052,14,1066,1390,0,0,0,0,0,0,0,66.31 ,76.69 ,66.31 
03,006,01,003,0077,141,768,14,782,1085,0,0,0,0,0,0,0,66.31 ,72.07 ,66.31 
03,006,01,003,0077,142,706,15,721,980,0,0,0,0,0,0,0,66.31 ,73.57 ,66.31 
03,006,01,003,0077,143,732,9,741,1026,0,0,0,0,0,0,0,66.31 ,72.22 ,66.31 
03,006,01,003,0077,144,667,6,673,982,0,0,0,0,0,0,0,66.31 ,68.53 ,66.31 
03,006,01,003,0078,145,824,22,846,1089,0,0,0,0,0,0,0,66.31 ,77.69 ,66.31 
03,006,01,003,0079,146,894,11,905,1433,0,0,0,0,0,0,0,66.31 ,63.15 ,66.31 
03,006,01,003,0080,147,728,14,742,942,0,0,0,0,0,0,0,66.31 ,78.77 ,66.31 
03,006,01,003,0081,148,669,18,687,898,0,0,0,0,0,0,0,66.31 ,76.50 ,66.31 
03,006,01,003,0081,149,784,22,806,1011,0,0,0,0,0,0,0,66.31 ,79.72 ,66.31 
03,006,01,003,0081,150,779,23,802,1086,0,0,0,0,0,0,0,66.31 ,73.85 ,66.31 
03,006,01,003,0082,151,880,23,903,1179,0,0,0,0,0,0,0,66.31 ,76.59 ,66.31 
03,006,01,003,0083,152,755,7,762,1011,0,0,0,0,0,0,0,66.31 ,75.37 ,66.31 
03,006,01,003,0083,153,681,19,700,913,0,0,0,0,0,0,0,66.31 ,76.67 ,66.31 
03,006,01,003,0083,154,607,20,627,874,0,0,0,0,0,0,0,66.31 ,71.74 ,66.31 
03,006,01,003,0084,155,810,10,820,1099,0,0,0,0,0,0,0,66.31 ,74.61 ,66.31 
03,006,01,003,0084,156,815,14,829,1160,0,0,0,0,0,0,0,66.31 ,71.47 ,66.31 
03,006,01,003,0085,157,940,8,948,1355,0,0,0,0,0,0,0,66.31 ,69.96 ,66.31 
03,006,01,003,0085,158,844,17,861,1163,0,0,0,0,0,0,0,66.31 ,74.03 ,66.31 
03,006,01,003,0085,159,672,9,681,948,0,0,0,0,0,0,0,66.31 ,71.84 ,66.31 
03,006,01,003,0086,160,1025,21,1046,1320,0,0,0,0,0,0,0,66.31 ,79.24 ,66.31 
03,006,01,003,0087,161,551,5,556,721,0,0,0,0,0,0,0,66.31 ,77.12 ,66.31 
03,006,01,003,0087,162,553,18,571,720,0,0,0,0,0,0,0,66.31 ,79.31 ,66.31 
03,006,01,003,0088,163,863,13,876,1135,0,0,0,0,0,0,0,66.31 ,77.18 ,66.31 
03,006,01,003,0089,164,840,12,852,1025,0,0,0,0,0,0,0,66.31 ,83.12 ,66.31 
03,006,01,003,0090,165,979,7,986,1230,0,0,0,0,0,0,0,66.31 ,80.16 ,66.31 
03,006,01,004,0091,166,813,24,837,1229,0,0,0,0,0,0,0,66.31 ,68.10 ,66.31 
03,006,01,004,0092,167,790,10,800,1055,0,0,0,0,0,0,0,66.31 ,75.83 ,66.31 
03,006,01,004,0093,168,665,6,671,996,0,0,0,0,0,0,0,66.31 ,67.37 ,66.31 
03,006,01,004,0093,169,665,23,688,1029,0,0,0,0,0,0,0,66.31 ,66.86 ,66.31 
03,006,01,004,0094,170,539,4,543,741,0,0,0,0,0,0,0,66.31 ,73.28 ,66.31 
03,006,01,004,0095,171,685,6,691,969,0,0,0,0,0,0,0,66.31 ,71.31 ,66.31 
03,006,01,004,0095,172,688,10,698,996,0,0,0,0,0,0,0,66.31 ,70.08 ,66.31 
03,006,01,004,0096,173,1006,19,1025,1364,0,0,0,0,0,0,0,66.31 ,75.15 ,66.31 
03,006,01,004,0097,174,520,6,526,701,0,0,0,0,0,0,0,66.31 ,75.04 ,66.31 
03,006,01,004,0098,175,332,7,339,465,0,0,0,0,0,0,0,66.31 ,72.90 ,66.31 
03,006,01,004,0099,176,1030,16,1046,1397,0,0,0,0,0,0,0,66.31 ,74.87 ,66.31 
03,006,01,004,0099,177,707,11,718,945,0,0,0,0,0,0,0,66.31 ,75.98 ,66.31 
03,006,01,004,0100,178,681,10,691,1001,0,0,0,0,0,0,0,66.31 ,69.03 ,66.31 
03,006,01,004,0100,179,1000,11,1011,1303,0,0,0,0,0,0,0,66.31 ,77.59 ,66.31 
03,006,01,004,0100,180,1032,15,1047,1458,0,0,0,0,0,0,0,66.31 ,71.81 ,66.31 
03,006,01,004,0101,181,809,21,830,1092,0,0,0,0,0,0,0,66.31 ,76.01 ,66.31 
03,006,01,004,0102,182,1067,22,1089,1370,0,0,0,0,0,0,0,66.31 ,79.49 ,66.31 
03,006,01,004,0103,183,800,13,813,1101,0,0,0,0,0,0,0,66.31 ,73.84 ,66.31 
03,006,01,004,0103,184,780,19,799,1139,0,0,0,0,0,0,0,66.31 ,70.15 ,66.31 
03,006,01,004,0103,185,617,11,628,826,0,0,0,0,0,0,0,66.31 ,76.03 ,66.31 
03,006,01,004,0104,186,993,8,1001,1278,0,0,0,0,0,0,0,66.31 ,78.33 ,66.31 
03,006,01,004,0104,187,940,21,961,1243,0,0,0,0,0,0,0,66.31 ,77.31 ,66.31 
03,006,01,004,0105,188,804,10,814,1024,0,0,0,0,0,0,0,66.31 ,79.49 ,66.31 
03,006,01,004,0105,189,545,15,560,726,0,0,0,0,0,0,0,66.31 ,77.13 ,66.31 
03,006,01,004,0106,190,1020,15,1035,1463,0,0,0,0,0,0,0,66.31 ,70.75 ,66.31 
03,006,01,004,0106,191,1077,25,1102,1544,0,0,0,0,0,0,0,66.31 ,71.37 ,66.31 
03,006,01,004,0107,192,943,13,956,1269,0,0,0,0,0,0,0,66.31 ,75.33 ,66.31 
03,006,01,004,0107,193,447,9,456,665,0,0,0,0,0,0,0,66.31 ,68.57 ,66.31 
03,006,01,004,0108,194,982,11,993,1274,0,0,0,0,0,0,0,66.31 ,77.94 ,66.31 
03,006,01,004,0109,195,953,20,973,1243,0,0,0,0,0,0,0,66.31 ,78.28 ,66.31 
03,006,01,004,0110,196,909,30,939,1253,0,0,0,0,0,0,0,66.31 ,74.94 ,66.31 
03,006,01,004,0111,197,757,15,772,987,0,0,0,0,0,0,0,66.31 ,78.22 ,66.31 
03,006,01,004,0112,198,981,14,995,1232,0,0,0,0,0,0,0,66.31 ,80.76 ,66.31 
03,006,01,004,0113,199,706,10,716,1067,0,0,0,0,0,0,0,66.31 ,67.10 ,66.31 
03,006,01,004,0113,200,608,7,615,855,0,0,0,0,0,0,0,66.31 ,71.93 ,66.31 
03,006,01,004,0114,201,806,16,822,1018,0,0,0,0,0,0,0,66.31 ,80.75 ,66.31 
03,006,01,004,0114,202,749,7,756,1061,0,0,0,0,0,0,0,66.31 ,71.25 ,66.31 
03,006,01,004,0115,203,569,9,578,818,0,0,0,0,0,0,0,66.31 ,70.66 ,66.31 
03,006,01,004,0115,204,685,11,696,889,0,0,0,0,0,0,0,66.31 ,78.29 ,66.31 
03,006,01,004,0116,205,773,16,789,1089,0,0,0,0,0,0,0,66.31 ,72.45 ,66.31 
03,006,01,004,0116,206,595,7,602,917,0,0,0,0,0,0,0,66.31 ,65.65 ,66.31 
03,006,01,004,0117,207,999,19,1018,1429,0,0,0,0,0,0,0,66.31 ,71.24 ,66.31 
03,006,01,004,0117,208,967,22,989,1382,0,0,0,0,0,0,0,66.31 ,71.56 ,66.31 
03,006,01,004,0117,209,549,17,566,782,0,0,0,0,0,0,0,66.31 ,72.38 ,66.31 
03,006,01,004,0117,210,988,14,1002,1385,0,0,0,0,0,0,0,66.31 ,72.35 ,66.31 
03,006,01,004,0118,211,563,7,570,796,0,0,0,0,0,0,0,66.31 ,71.61 ,66.31 
03,006,01,004,0118,212,591,10,601,793,0,0,0,0,0,0,0,66.31 ,75.79 ,66.31 
03,006,01,004,0118,213,913,11,924,1272,0,0,0,0,0,0,0,66.31 ,72.64 ,66.31 
03,006,01,004,0119,214,835,23,858,1085,0,0,0,0,0,0,0,66.31 ,79.08 ,66.31 
03,006,01,004,0120,215,865,17,882,1101,0,0,0,0,0,0,0,66.31 ,80.11 ,66.31 
03,006,01,004,0121,216,770,5,775,964,0,0,0,0,0,0,0,66.31 ,80.39 ,66.31 
03,006,01,004,0122,217,833,14,847,1132,0,0,0,0,0,0,0,66.31 ,74.82 ,66.31 
03,006,01,005,0123,218,1032,12,1044,1328,0,0,0,0,0,0,0,66.31 ,78.61 ,66.31 
03,006,01,005,0124,219,759,6,765,1012,0,0,0,0,0,0,0,66.31 ,75.59 ,66.31 
03,006,01,005,0124,220,973,14,987,1224,0,0,0,0,0,0,0,66.31 ,80.64 ,66.31 
03,006,01,005,0125,221,843,16,859,1152,0,0,0,0,0,0,0,66.31 ,74.57 ,66.31 
03,006,01,005,0126,222,451,9,460,578,0,0,0,0,0,0,0,66.31 ,79.58 ,66.31 
03,006,01,005,0127,223,887,16,903,1234,0,0,0,0,0,0,0,66.31 ,73.18 ,66.31 
03,006,01,005,0127,224,710,10,720,955,0,0,0,0,0,0,0,66.31 ,75.39 ,66.31 
03,006,01,005,0128,225,698,9,707,913,0,0,0,0,0,0,0,66.31 ,77.44 ,66.31 
03,006,01,005,0128,226,1066,19,1085,1524,0,0,0,0,0,0,0,66.31 ,71.19 ,66.31 
03,006,01,005,0129,227,772,15,787,1017,0,0,0,0,0,0,0,66.31 ,77.38 ,66.31 
03,006,01,005,0129,228,843,19,862,1141,0,0,0,0,0,0,0,66.31 ,75.55 ,66.31 
03,006,01,005,0129,229,913,11,924,1167,0,0,0,0,0,0,0,66.31 ,79.18 ,66.31 
03,006,01,005,0130,230,927,14,941,1230,0,0,0,0,0,0,0,66.31 ,76.50 ,66.31 
03,006,01,005,0130,231,831,13,844,1083,0,0,0,0,0,0,0,66.31 ,77.93 ,66.31 
03,006,01,005,0130,232,903,11,914,1158,0,0,0,0,0,0,0,66.31 ,78.93 ,66.31 
03,006,01,005,0131,233,1079,9,1088,1442,0,0,0,0,0,0,0,66.31 ,75.45 ,66.31 
03,006,01,005,0131,234,741,6,747,1035,0,0,0,0,0,0,0,66.31 ,72.17 ,66.31 
03,006,01,005,0131,235,741,10,751,1032,0,0,0,0,0,0,0,66.31 ,72.77 ,66.31 
03,006,01,005,0131,236,834,12,846,1129,0,0,0,0,0,0,0,66.31 ,74.93 ,66.31 
03,006,01,005,0132,237,896,11,907,1156,0,0,0,0,0,0,0,66.31 ,78.46 ,66.31 
03,006,01,005,0132,238,888,16,904,1308,0,0,0,0,0,0,0,66.31 ,69.11 ,66.31 
03,006,01,005,0132,239,922,25,947,1347,0,0,0,0,0,0,0,66.31 ,70.30 ,66.31 
03,006,01,005,0132,240,680,8,688,981,0,0,0,0,0,0,0,66.31 ,70.13 ,66.31 
03,006,01,005,0133,241,650,14,664,831,0,0,0,0,0,0,0,66.31 ,79.90 ,66.31 
03,006,01,005,0134,242,811,11,822,1177,0,0,0,0,0,0,0,66.31 ,69.84 ,66.31 
03,006,01,005,0134,243,586,9,595,784,0,0,0,0,0,0,0,66.31 ,75.89 ,66.31 
03,006,01,005,0135,244,1098,19,1117,1531,0,0,0,0,0,0,0,66.31 ,72.96 ,66.31 
03,006,01,005,0135,245,933,22,955,1267,0,0,0,0,0,0,0,66.31 ,75.37 ,66.31 
03,006,01,005,0136,246,889,10,899,1129,0,0,0,0,0,0,0,66.31 ,79.63 ,66.31 
03,006,01,005,0137,247,1060,24,1084,1528,0,0,0,0,0,0,0,66.31 ,70.94 ,66.31 
03,006,01,005,0138,248,1210,16,1226,1580,0,0,0,0,0,0,0,66.31 ,77.59 ,66.31 
03,006,01,005,0139,249,1161,27,1188,1618,0,0,0,0,0,0,0,66.31 ,73.42 ,66.31 
03,006,01,005,0139,250,1127,30,1157,1641,0,0,0,0,0,0,0,66.31 ,70.51 ,66.31 
03,006,01,005,0140,251,869,20,889,1175,0,0,0,0,0,0,0,66.31 ,75.66 ,66.31 
03,006,01,005,0140,252,650,8,658,927,0,0,0,0,0,0,0,66.31 ,70.98 ,66.31 
03,006,01,005,0140,253,933,13,946,1213,0,0,0,0,0,0,0,66.31 ,77.99 ,66.31 
03,006,01,005,0141,254,1217,27,1244,1594,0,0,0,0,0,0,0,66.31 ,78.04 ,66.31 
03,006,01,005,0142,255,764,27,791,1040,0,0,0,0,0,0,0,66.31 ,76.06 ,66.31 
03,006,01,005,0142,256,717,10,727,912,0,0,0,0,0,0,0,66.31 ,79.71 ,66.31 
03,006,01,006,0143,257,645,5,650,883,0,0,0,0,0,0,0,66.31 ,73.61 ,66.31 
03,006,01,006,0143,258,888,14,902,1265,0,0,0,0,0,0,0,66.31 ,71.30 ,66.31 
03,006,01,006,0144,259,742,16,758,1002,0,0,0,0,0,0,0,66.31 ,75.65 ,66.31 
03,006,01,006,0144,260,697,16,713,970,0,0,0,0,0,0,0,66.31 ,73.51 ,66.31 
03,006,01,006,0145,261,806,9,815,1054,0,0,0,0,0,0,0,66.31 ,77.32 ,66.31 
03,006,01,006,0145,262,635,9,644,942,0,0,0,0,0,0,0,66.31 ,68.37 ,66.31 
03,006,01,006,0145,263,686,8,694,1030,0,0,0,0,0,0,0,66.31 ,67.38 ,66.31 
03,006,01,006,0146,264,391,8,399,540,0,0,0,0,0,0,0,66.31 ,73.89 ,66.31 
03,006,01,006,0147,265,813,16,829,1101,0,0,0,0,0,0,0,66.31 ,75.30 ,66.31 
03,006,01,006,0148,266,522,5,527,719,0,0,0,0,0,0,0,66.31 ,73.30 ,66.31 
03,006,01,006,0149,267,1104,30,1134,1633,0,0,0,0,0,0,0,66.31 ,69.44 ,66.31 
03,006,01,006,0149,268,1070,19,1089,1512,0,0,0,0,0,0,0,66.31 ,72.02 ,66.31 
03,006,01,006,0149,269,919,15,934,1211,0,0,0,0,0,0,0,66.31 ,77.13 ,66.31 
03,006,01,006,0150,270,853,19,872,1132,0,0,0,0,0,0,0,66.31 ,77.03 ,66.31 
03,006,01,006,0150,271,616,7,623,906,0,0,0,0,0,0,0,66.31 ,68.76 ,66.31 
03,006,01,006,0151,272,917,20,937,1248,0,0,0,0,0,0,0,66.31 ,75.08 ,66.31 
03,006,01,006,0151,273,776,12,788,1101,0,0,0,0,0,0,0,66.31 ,71.57 ,66.31 
03,006,01,006,0152,274,758,17,775,1026,0,0,0,0,0,0,0,66.31 ,75.54 ,66.31 
03,006,01,006,0152,275,564,14,578,810,0,0,0,0,0,0,0,66.31 ,71.36 ,66.31 
03,006,01,006,0152,276,849,12,861,1179,0,0,0,0,0,0,0,66.31 ,73.03 ,66.31 
03,006,01,006,0152,277,962,20,982,1366,0,0,0,0,0,0,0,66.31 ,71.89 ,66.31 
03,006,01,006,0153,278,870,17,887,1178,0,0,0,0,0,0,0,66.31 ,75.30 ,66.31 
03,006,01,006,0153,279,696,15,711,1018,0,0,0,0,0,0,0,66.31 ,69.84 ,66.31 
03,006,01,006,0153,280,671,8,679,885,0,0,0,0,0,0,0,66.31 ,76.72 ,66.31 
03,006,01,006,0154,281,764,13,777,981,0,0,0,0,0,0,0,66.31 ,79.20 ,66.31 
03,006,01,006,0154,282,502,9,511,661,0,0,0,0,0,0,0,66.31 ,77.31 ,66.31 
03,006,01,006,0155,283,704,10,714,914,0,0,0,0,0,0,0,66.31 ,78.12 ,66.31 
03,006,01,006,0155,284,748,21,769,1012,0,0,0,0,0,0,0,66.31 ,75.99 ,66.31 
03,006,01,006,0156,285,820,8,828,1028,0,0,0,0,0,0,0,66.31 ,80.54 ,66.31 
03,006,01,006,0156,286,741,17,758,968,0,0,0,0,0,0,0,66.31 ,78.31 ,66.31 
03,006,01,007,0157,287,681,13,694,871,0,0,0,0,0,0,0,66.31 ,79.68 ,66.31 
03,006,01,007,0157,288,678,9,687,942,0,0,0,0,0,0,0,66.31 ,72.93 ,66.31 
03,006,01,007,0158,289,693,19,712,905,0,0,0,0,0,0,0,66.31 ,78.67 ,66.31 
03,006,01,007,0158,290,1051,22,1073,1377,0,0,0,0,0,0,0,66.31 ,77.92 ,66.31 
03,006,01,007,0159,291,727,22,749,1034,0,0,0,0,0,0,0,66.31 ,72.44 ,66.31 
03,006,01,007,0159,292,909,20,929,1266,0,0,0,0,0,0,0,66.31 ,73.38 ,66.31 
03,006,01,007,0159,293,850,20,870,1187,0,0,0,0,0,0,0,66.31 ,73.29 ,66.31 
03,006,01,007,0159,294,934,21,955,1333,0,0,0,0,0,0,0,66.31 ,71.64 ,66.31 
03,006,01,007,0160,295,770,14,784,989,0,0,0,0,0,0,0,66.31 ,79.27 ,66.31 
03,006,01,007,0160,296,904,15,919,1179,0,0,0,0,0,0,0,66.31 ,77.95 ,66.31 
03,006,01,007,0160,297,750,16,766,973,0,0,0,0,0,0,0,66.31 ,78.73 ,66.31 
03,006,01,007,0161,298,1292,21,1313,1693,0,0,0,0,0,0,0,66.31 ,77.55 ,66.31 
03,006,01,007,0162,299,908,19,927,1241,0,0,0,0,0,0,0,66.31 ,74.70 ,66.31 
03,006,01,007,0162,300,850,19,869,1191,0,0,0,0,0,0,0,66.31 ,72.96 ,66.31 
03,006,01,007,0162,301,930,19,949,1207,0,0,0,0,0,0,0,66.31 ,78.62 ,66.31 
03,006,01,007,0163,302,705,9,714,881,0,0,0,0,0,0,0,66.31 ,81.04 ,66.31 
03,006,01,007,0163,303,719,15,734,914,0,0,0,0,0,0,0,66.31 ,80.31 ,66.31 
03,006,01,007,0164,304,774,22,796,1033,0,0,0,0,0,0,0,66.31 ,77.06 ,66.31 
03,006,01,007,0164,305,982,19,1001,1238,0,0,0,0,0,0,0,66.31 ,80.86 ,66.31 
03,006,01,007,0165,306,937,7,944,1230,0,0,0,0,0,0,0,66.31 ,76.75 ,66.31 
03,006,01,007,0165,307,1083,17,1100,1406,0,0,0,0,0,0,0,66.31 ,78.24 ,66.31 
03,006,01,007,0166,308,1398,38,1436,1765,0,0,0,0,0,0,0,66.31 ,81.36 ,66.31 
03,006,01,007,0167,309,909,27,936,1151,0,0,0,0,0,0,0,66.31 ,81.32 ,66.31 
03,006,01,007,0168,310,1124,35,1159,1423,0,0,0,0,0,0,0,66.31 ,81.45 ,66.31 
03,006,01,007,0169,311,676,20,696,848,0,0,0,0,0,0,0,66.31 ,82.08 ,66.31 
03,006,01,007,0169,312,773,20,793,972,0,0,0,0,0,0,0,66.31 ,81.58 ,66.31 
03,006,01,007,0170,313,869,20,889,1123,0,0,0,0,0,0,0,66.31 ,79.16 ,66.31 
03,006,01,007,0170,314,790,14,804,1069,0,0,0,0,0,0,0,66.31 ,75.21 ,66.31 
03,006,01,007,0171,315,261,6,267,329,0,0,0,0,0,0,0,66.31 ,81.16 ,66.31 
03,006,01,007,0172,316,1169,20,1189,1477,0,0,0,0,0,0,0,66.31 ,80.50 ,66.31 
03,006,01,007,0173,317,1255,32,1287,1682,0,0,0,0,0,0,0,66.31 ,76.52 ,66.31 
03,006,01,007,0174,318,928,19,947,1197,0,0,0,0,0,0,0,66.31 ,79.11 ,66.31 
03,006,01,008,0175,319,834,18,852,1208,0,0,0,0,0,0,0,66.31 ,70.53 ,66.31 
03,006,01,008,0175,320,675,11,686,1001,0,0,0,0,0,0,0,66.31 ,68.53 ,66.31 
03,006,01,008,0176,321,1001,22,1023,1374,0,0,0,0,0,0,0,66.31 ,74.45 ,66.31 
03,006,01,008,0177,322,597,6,603,832,0,0,0,0,0,0,0,66.31 ,72.48 ,66.31 
03,006,01,008,0177,323,765,19,784,1095,0,0,0,0,0,0,0,66.31 ,71.60 ,66.31 
03,006,01,008,0178,324,713,14,727,1016,0,0,0,0,0,0,0,66.31 ,71.56 ,66.31 
03,006,01,008,0178,325,628,11,639,805,0,0,0,0,0,0,0,66.31 ,79.38 ,66.31 
03,006,01,008,0179,326,819,18,837,1082,0,0,0,0,0,0,0,66.31 ,77.36 ,66.31 
03,006,01,008,0179,327,642,16,658,968,0,0,0,0,0,0,0,66.31 ,67.98 ,66.31 
03,006,01,008,0180,328,737,9,746,884,0,0,0,0,0,0,0,66.31 ,84.39 ,66.31 
03,006,01,008,0180,329,783,22,805,1034,0,0,0,0,0,0,0,66.31 ,77.85 ,66.31 
03,006,01,008,0181,330,852,9,861,1085,0,0,0,0,0,0,0,66.31 ,79.35 ,66.31 
03,006,01,008,0181,331,804,10,814,1104,0,0,0,0,0,0,0,66.31 ,73.73 ,66.31 
03,006,01,008,0181,332,803,16,819,1109,0,0,0,0,0,0,0,66.31 ,73.85 ,66.31 
03,006,01,008,0182,333,660,10,670,873,0,0,0,0,0,0,0,66.31 ,76.75 ,66.31 
03,006,01,008,0183,334,820,15,835,1062,0,0,0,0,0,0,0,66.31 ,78.63 ,66.31 
03,006,01,008,0183,335,890,17,907,1242,0,0,0,0,0,0,0,66.31 ,73.03 ,66.31 
03,006,01,008,0183,336,785,12,797,1022,0,0,0,0,0,0,0,66.31 ,77.98 ,66.31 
03,006,01,008,0183,337,872,13,885,1194,0,0,0,0,0,0,0,66.31 ,74.12 ,66.31 
03,006,01,008,0184,338,819,27,846,1185,0,0,0,0,0,0,0,66.31 ,71.39 ,66.31 
03,006,01,008,0184,339,797,17,814,1154,0,0,0,0,0,0,0,66.31 ,70.54 ,66.31 
03,006,01,008,0184,340,669,21,690,1034,0,0,0,0,0,0,0,66.31 ,66.73 ,66.31 
03,006,01,008,0185,341,822,14,836,1166,0,0,0,0,0,0,0,66.31 ,71.70 ,66.31 
03,006,01,008,0185,342,503,6,509,762,0,0,0,0,0,0,0,66.31 ,66.80 ,66.31 
03,006,01,008,0186,343,773,17,790,1064,0,0,0,0,0,0,0,66.31 ,74.25 ,66.31 
03,006,01,008,0186,344,849,15,864,1350,0,0,0,0,0,0,0,66.31 ,64.00 ,66.31 
03,006,01,008,0187,345,747,9,756,1038,0,0,0,0,0,0,0,66.31 ,72.83 ,66.31 
03,006,01,008,0187,346,798,17,815,1141,0,0,0,0,0,0,0,66.31 ,71.43 ,66.31 
03,006,01,008,0188,347,929,20,949,1406,0,0,0,0,0,0,0,66.31 ,67.50 ,66.31 
03,006,01,008,0188,348,959,21,980,1377,0,0,0,0,0,0,0,66.31 ,71.17 ,66.31 
03,006,01,008,0188,349,987,23,1010,1383,0,0,0,0,0,0,0,66.31 ,73.03 ,66.31 
03,006,01,008,0188,350,947,19,966,1443,0,0,0,0,0,0,0,66.31 ,66.94 ,66.31 
03,006,01,008,0189,351,765,13,778,1020,0,0,0,0,0,0,0,66.31 ,76.27 ,66.31 
03,006,01,008,0189,352,808,15,823,1077,0,0,0,0,0,0,0,66.31 ,76.42 ,66.31 
03,006,01,008,0190,353,918,27,945,1148,0,0,0,0,0,0,0,66.31 ,82.32 ,66.31 
03,006,01,008,0190,354,863,19,882,1116,0,0,0,0,0,0,0,66.31 ,79.03 ,66.31 
03,006,01,009,0191,355,975,18,993,1412,0,0,0,0,0,0,0,66.31 ,70.33 ,66.31 
03,006,01,009,0192,356,1271,18,1289,1969,0,0,0,0,0,0,0,66.31 ,65.46 ,66.31 
03,006,01,009,0193,357,883,21,904,1384,0,0,0,0,0,0,0,66.31 ,65.32 ,66.31 
03,006,01,009,0193,358,1097,21,1118,1748,0,0,0,0,0,0,0,66.31 ,63.96 ,66.31 
03,006,01,009,0193,359,732,9,741,1216,0,0,0,0,0,0,0,66.31 ,60.94 ,66.31 
03,006,01,009,0193,360,1054,20,1074,1587,0,0,0,0,0,0,0,66.31 ,67.67 ,66.31 
03,006,01,009,0193,361,934,28,962,1448,0,0,0,0,0,0,0,66.31 ,66.44 ,66.31 
03,006,01,009,0194,362,1070,17,1087,1580,0,0,0,0,0,0,0,66.31 ,68.80 ,66.31 
03,006,01,009,0194,363,1073,17,1090,1961,0,0,0,0,0,0,0,66.31 ,55.58 ,66.31 
03,006,01,009,0194,364,1297,32,1329,2178,0,0,0,0,0,0,0,66.31 ,61.02 ,66.31 
03,006,01,009,0195,365,1080,15,1095,2193,0,0,0,0,0,0,0,66.31 ,49.93 ,66.31 
03,006,01,009,0195,366,745,17,762,1174,0,0,0,0,0,0,0,66.31 ,64.91 ,66.31 
03,006,01,009,0195,367,1198,15,1213,1734,0,0,0,0,0,0,0,66.31 ,69.95 ,66.31 
03,006,01,009,0195,368,1235,25,1260,1929,0,0,0,0,0,0,0,66.31 ,65.32 ,66.31 
03,006,01,009,0195,369,918,16,934,1415,0,0,0,0,0,0,0,66.31 ,66.01 ,66.31 
03,006,01,009,0195,370,925,11,936,1621,0,0,0,0,0,0,0,66.31 ,57.74 ,66.31 
03,006,01,009,0195,371,531,14,545,850,0,0,0,0,0,0,0,66.31 ,64.12 ,66.31 
03,006,01,009,0196,372,1121,15,1136,1683,0,0,0,0,0,0,0,66.31 ,67.50 ,66.31 
03,006,01,009,0196,373,904,19,923,1337,0,0,0,0,0,0,0,66.31 ,69.04 ,66.31 
03,006,01,009,0196,374,990,8,998,1709,0,0,0,0,0,0,0,66.31 ,58.40 ,66.31 
03,006,01,009,0197,375,740,15,755,990,0,0,0,0,0,0,0,66.31 ,76.26 ,66.31 
03,006,01,009,0197,376,1289,25,1314,2023,0,0,0,0,0,0,0,66.31 ,64.95 ,66.31 
03,006,01,009,0197,377,1022,11,1033,1549,0,0,0,0,0,0,0,66.31 ,66.69 ,66.31 
03,006,01,009,0197,378,1276,27,1303,1787,0,0,0,0,0,0,0,66.31 ,72.92 ,66.31 
03,006,01,009,0197,379,842,19,861,1251,0,0,0,0,0,0,0,66.31 ,68.82 ,66.31 
03,006,01,009,0198,380,1013,13,1026,1296,0,0,0,0,0,0,0,66.31 ,79.17 ,66.31 
03,006,01,009,0199,381,660,7,667,898,0,0,0,0,0,0,0,66.31 ,74.28 ,66.31 
03,006,01,009,0199,382,1040,18,1058,1563,0,0,0,0,0,0,0,66.31 ,67.69 ,66.31 
03,006,01,009,0200,383,1075,20,1095,1542,0,0,0,0,0,0,0,66.31 ,71.01 ,66.31 
03,006,01,009,0200,384,924,20,944,1240,0,0,0,0,0,0,0,66.31 ,76.13 ,66.31 
03,006,01,009,0200,385,772,12,784,1040,0,0,0,0,0,0,0,66.31 ,75.38 ,66.31 
03,006,01,009,0201,386,1152,27,1179,1669,0,0,0,0,0,0,0,66.31 ,70.64 ,66.31 
03,006,01,009,0201,387,1043,14,1057,1415,0,0,0,0,0,0,0,66.31 ,74.70 ,66.31 
03,006,01,009,0202,388,965,11,976,1424,0,0,0,0,0,0,0,66.31 ,68.54 ,66.31 
03,006,01,009,0203,389,910,9,919,1374,0,0,0,0,0,0,0,66.31 ,66.89 ,66.31 
03,006,01,009,0203,390,834,17,851,1335,0,0,0,0,0,0,0,66.31 ,63.75 ,66.31 
03,006,01,010,0204,391,1087,19,1106,1556,0,0,0,0,0,0,0,66.31 ,71.08 ,66.31 
03,006,01,010,0204,392,1125,26,1151,1612,0,0,0,0,0,0,0,66.31 ,71.40 ,66.31 
03,006,01,010,0205,393,1288,38,1326,1827,0,0,0,0,0,0,0,66.31 ,72.58 ,66.31 
03,006,01,010,0205,394,1147,22,1169,1628,0,0,0,0,0,0,0,66.31 ,71.81 ,66.31 
03,006,01,010,0206,395,944,18,962,1482,0,0,0,0,0,0,0,66.31 ,64.91 ,66.31 
03,006,01,010,0206,396,923,15,938,1287,0,0,0,0,0,0,0,66.31 ,72.88 ,66.31 
03,006,01,010,0206,397,753,17,770,1096,0,0,0,0,0,0,0,66.31 ,70.26 ,66.31 
03,006,01,010,0207,398,1015,22,1037,1445,0,0,0,0,0,0,0,66.31 ,71.76 ,66.31 
03,006,01,010,0207,399,981,25,1006,1409,0,0,0,0,0,0,0,66.31 ,71.40 ,66.31 
03,006,01,010,0208,400,910,15,925,1312,0,0,0,0,0,0,0,66.31 ,70.50 ,66.31 
03,006,01,010,0208,401,1024,14,1038,1449,0,0,0,0,0,0,0,66.31 ,71.64 ,66.31 
03,006,01,010,0209,402,836,13,849,1260,0,0,0,0,0,0,0,66.31 ,67.38 ,66.31 
03,006,01,010,0209,403,832,17,849,1230,0,0,0,0,0,0,0,66.31 ,69.02 ,66.31 
03,006,01,010,0210,404,678,17,695,946,0,0,0,0,0,0,0,66.31 ,73.47 ,66.31 
03,006,01,010,0210,405,1175,27,1202,1650,0,0,0,0,0,0,0,66.31 ,72.85 ,66.31 
03,006,01,010,0211,406,964,26,990,1395,0,0,0,0,0,0,0,66.31 ,70.97 ,66.31 
03,006,01,010,0211,407,875,13,888,1387,0,0,0,0,0,0,0,66.31 ,64.02 ,66.31 
03,006,01,010,0211,408,639,18,657,1036,0,0,0,0,0,0,0,66.31 ,63.42 ,66.31 
03,006,01,010,0211,409,886,24,910,1267,0,0,0,0,0,0,0,66.31 ,71.82 ,66.31 
03,006,01,010,0211,410,861,19,880,1166,0,0,0,0,0,0,0,66.31 ,75.47 ,66.31 
03,006,01,010,0211,411,687,15,702,979,0,0,0,0,0,0,0,66.31 ,71.71 ,66.31 
03,006,01,010,0211,412,578,20,598,1029,0,0,0,0,0,0,0,66.31 ,58.11 ,66.31 
03,006,01,010,0212,413,1141,34,1175,1464,0,0,0,0,0,0,0,66.31 ,80.26 ,66.31 
03,006,01,010,0212,414,1143,32,1175,1666,0,0,0,0,0,0,0,66.31 ,70.53 ,66.31 
03,006,01,010,0212,415,1206,42,1248,1718,0,0,0,0,0,0,0,66.31 ,72.64 ,66.31 
03,006,01,010,0213,416,1378,29,1407,1832,0,0,0,0,0,0,0,66.31 ,76.80 ,66.31 
03,006,01,010,0213,417,1172,29,1201,1665,0,0,0,0,0,0,0,66.31 ,72.13 ,66.31 
03,006,01,010,0213,418,936,26,962,1369,0,0,0,0,0,0,0,66.31 ,70.27 ,66.31 
03,006,01,010,0214,419,1140,20,1160,1459,0,0,0,0,0,0,0,66.31 ,79.51 ,66.31 
03,006,01,010,0214,420,796,12,808,1012,0,0,0,0,0,0,0,66.31 ,79.84 ,66.31 
03,006,01,010,0215,421,1156,23,1179,1536,0,0,0,0,0,0,0,66.31 ,76.76 ,66.31 
03,006,01,010,0215,422,939,14,953,1250,0,0,0,0,0,0,0,66.31 ,76.24 ,66.31 
03,006,01,010,0216,423,972,22,994,1408,0,0,0,0,0,0,0,66.31 ,70.60 ,66.31 
03,006,01,010,0216,424,1195,28,1223,1799,0,0,0,0,0,0,0,66.31 ,67.98 ,66.31 
03,006,01,011,0217,425,969,21,990,1267,0,0,0,0,0,0,0,66.31 ,78.14 ,66.31 
03,006,01,011,0217,426,936,18,954,1214,0,0,0,0,0,0,0,66.31 ,78.58 ,66.31 
03,006,01,011,0218,427,1255,22,1277,1647,0,0,0,0,0,0,0,66.31 ,77.53 ,66.31 
03,006,01,011,0219,428,952,11,963,1223,0,0,0,0,0,0,0,66.31 ,78.74 ,66.31 
03,006,01,011,0220,429,699,14,713,913,0,0,0,0,0,0,0,66.31 ,78.09 ,66.31 
03,006,01,011,0221,430,910,21,931,1220,0,0,0,0,0,0,0,66.31 ,76.31 ,66.31 
03,006,01,011,0222,431,1513,24,1537,1955,0,0,0,0,0,0,0,66.31 ,78.62 ,66.31 
03,006,01,011,0223,432,1393,48,1441,1807,0,0,0,0,0,0,0,66.31 ,79.75 ,66.31 
03,006,01,011,0223,433,558,6,564,674,0,0,0,0,0,0,0,66.31 ,83.68 ,66.31 
03,006,01,011,0224,434,628,9,637,818,0,0,0,0,0,0,0,66.31 ,77.87 ,66.31 
03,006,01,011,0225,435,920,9,929,1182,0,0,0,0,0,0,0,66.31 ,78.60 ,66.31 
03,006,01,011,0225,436,1008,21,1029,1325,0,0,0,0,0,0,0,66.31 ,77.66 ,66.31 
03,006,01,011,0226,437,1026,5,1031,1272,0,0,0,0,0,0,0,66.31 ,81.05 ,66.31 
03,006,01,011,0227,438,227,0,227,273,0,0,0,0,0,0,0,66.31 ,83.15 ,66.31 
03,006,01,011,0227,439,484,8,492,636,0,0,0,0,0,0,0,66.31 ,77.36 ,66.31 
03,006,01,011,0228,440,452,8,460,618,0,0,0,0,0,0,0,66.31 ,74.43 ,66.31 
03,006,01,011,0229,441,776,16,792,1065,0,0,0,0,0,0,0,66.31 ,74.37 ,66.31 
03,006,01,011,0229,442,182,4,186,278,0,0,0,0,0,0,0,66.31 ,66.91 ,66.31 
03,006,01,012,0230,443,673,10,683,919,0,0,0,0,0,0,0,66.31 ,74.32 ,66.31 
03,006,01,012,0231,444,853,14,867,1099,0,0,0,0,0,0,0,66.31 ,78.89 ,66.31 
03,006,01,012,0232,445,727,24,751,957,0,0,0,0,0,0,0,66.31 ,78.47 ,66.31 
03,006,01,012,0233,446,770,13,783,1102,0,0,0,0,0,0,0,66.31 ,71.05 ,66.31 
03,006,01,012,0234,447,514,4,518,647,0,0,0,0,0,0,0,66.31 ,80.06 ,66.31 
03,006,01,012,0235,448,970,15,985,1226,0,0,0,0,0,0,0,66.31 ,80.34 ,66.31 
03,006,01,012,0236,449,1239,21,1260,1651,0,0,0,0,0,0,0,66.31 ,76.32 ,66.31 
03,006,01,012,0237,450,717,15,732,952,0,0,0,0,0,0,0,66.31 ,76.89 ,66.31 
03,006,01,012,0238,451,975,20,995,1303,0,0,0,0,0,0,0,66.31 ,76.36 ,66.31 
03,006,01,012,0239,452,968,24,992,1309,0,0,0,0,0,0,0,66.31 ,75.78 ,66.31 
03,006,01,013,0240,453,785,10,795,945,0,0,0,0,0,0,0,66.31 ,84.13 ,66.31 
03,006,01,013,0241,454,1032,25,1057,1347,0,0,0,0,0,0,0,66.31 ,78.47 ,66.31 
03,006,01,013,0242,455,1255,27,1282,1599,0,0,0,0,0,0,0,66.31 ,80.18 ,66.31 
03,006,01,013,0243,456,1348,12,1360,1682,0,0,0,0,0,0,0,66.31 ,80.86 ,66.31 
03,006,01,013,0243,457,1260,12,1272,1575,0,0,0,0,0,0,0,66.31 ,80.76 ,66.31 
03,006,01,013,0244,458,945,16,961,1247,0,0,0,0,0,0,0,66.31 ,77.06 ,66.31 
03,006,01,013,0244,459,882,17,899,1108,0,0,0,0,0,0,0,66.31 ,81.14 ,66.31 
03,006,01,013,0245,460,982,34,1016,1303,0,0,0,0,0,0,0,66.31 ,77.97 ,66.31 
03,006,01,013,0245,461,1052,19,1071,1438,0,0,0,0,0,0,0,66.31 ,74.48 ,66.31 
03,006,01,013,0245,462,964,21,985,1307,0,0,0,0,0,0,0,66.31 ,75.36 ,66.31 
03,006,01,013,0246,463,1004,21,1025,1281,0,0,0,0,0,0,0,66.31 ,80.02 ,66.31 
03,006,01,013,0247,464,777,10,787,932,0,0,0,0,0,0,0,66.31 ,84.44 ,66.31 
03,006,01,013,0248,465,804,16,820,1028,0,0,0,0,0,0,0,66.31 ,79.77 ,66.31 
03,006,01,013,0248,466,730,8,738,899,0,0,0,0,0,0,0,66.31 ,82.09 ,66.31 
03,006,01,013,0249,467,1198,22,1220,1440,0,0,0,0,0,0,0,66.31 ,84.72 ,66.31 
03,006,01,013,0250,468,900,16,916,1109,0,0,0,0,0,0,0,66.31 ,82.60 ,66.31 
03,006,01,014,0251,469,830,14,844,1040,0,0,0,0,0,0,0,66.31 ,81.15 ,66.31 
03,006,01,014,0252,470,894,11,905,1126,0,0,0,0,0,0,0,66.31 ,80.37 ,66.31 
03,006,01,014,0253,471,845,10,855,1108,0,0,0,0,0,0,0,66.31 ,77.17 ,66.31 
03,006,01,014,0253,472,791,20,811,1091,0,0,0,0,0,0,0,66.31 ,74.34 ,66.31 
03,006,01,014,0254,473,967,9,976,1180,0,0,0,0,0,0,0,66.31 ,82.71 ,66.31 
03,006,01,014,0255,474,817,16,833,1054,0,0,0,0,0,0,0,66.31 ,79.03 ,66.31 
03,006,01,014,0256,475,627,12,639,779,0,0,0,0,0,0,0,66.31 ,82.03 ,66.31 
03,006,01,014,0256,476,610,7,617,778,0,0,0,0,0,0,0,66.31 ,79.31 ,66.31 
03,006,01,014,0257,477,623,4,627,832,0,0,0,0,0,0,0,66.31 ,75.36 ,66.31 
03,006,01,014,0258,478,1195,11,1206,1542,0,0,0,0,0,0,0,66.31 ,78.21 ,66.31 
03,006,01,014,0259,479,729,15,744,961,0,0,0,0,0,0,0,66.31 ,77.42 ,66.31 
03,006,01,014,0260,480,1032,14,1046,1332,0,0,0,0,0,0,0,66.31 ,78.53 ,66.31 
03,006,01,014,0261,481,910,12,922,1249,0,0,0,0,0,0,0,66.31 ,73.82 ,66.31 
03,006,01,014,0262,482,562,12,574,686,0,0,0,0,0,0,0,66.31 ,83.67 ,66.31 
03,006,01,015,0263,483,1208,24,1232,1696,0,0,0,0,0,0,0,66.31 ,72.64 ,66.31 
03,006,01,015,0263,484,1114,10,1124,1554,0,0,0,0,0,0,0,66.31 ,72.33 ,66.31 
03,006,01,015,0263,485,1204,24,1228,1660,0,0,0,0,0,0,0,66.31 ,73.98 ,66.31 
03,006,01,015,0264,486,860,17,877,1182,0,0,0,0,0,0,0,66.31 ,74.20 ,66.31 
03,006,01,015,0264,487,640,7,647,1049,0,0,0,0,0,0,0,66.31 ,61.68 ,66.31 
03,006,01,015,0265,488,739,17,756,1059,0,0,0,0,0,0,0,66.31 ,71.39 ,66.31 
03,006,01,015,0265,489,648,24,672,1003,0,0,0,0,0,0,0,66.31 ,67.00 ,66.31 
03,006,01,015,0265,490,1158,31,1189,1589,0,0,0,0,0,0,0,66.31 ,74.83 ,66.31 
03,006,01,015,0266,491,1173,21,1194,1495,0,0,0,0,0,0,0,66.31 ,79.87 ,66.31 
03,006,01,015,0266,492,789,15,804,1064,0,0,0,0,0,0,0,66.31 ,75.56 ,66.31 
03,006,01,015,0267,493,1464,34,1498,1975,0,0,0,0,0,0,0,66.31 ,75.85 ,66.31 
03,006,01,015,0268,494,1001,17,1018,1567,0,0,0,0,0,0,0,66.31 ,64.96 ,66.31 
03,006,01,015,0268,495,973,26,999,1467,0,0,0,0,0,0,0,66.31 ,68.10 ,66.31 
03,006,01,015,0268,496,1126,17,1143,1840,0,0,0,0,0,0,0,66.31 ,62.12 ,66.31 
03,006,01,015,0268,497,1041,22,1063,1667,0,0,0,0,0,0,0,66.31 ,63.77 ,66.31 
03,006,01,015,0268,498,901,17,918,1471,0,0,0,0,0,0,0,66.31 ,62.41 ,66.31 
03,006,01,015,0269,499,975,15,990,1455,0,0,0,0,0,0,0,66.31 ,68.04 ,66.31 
03,006,01,015,0269,500,808,20,828,1232,0,0,0,0,0,0,0,66.31 ,67.21 ,66.31 
03,006,01,015,0269,501,1018,19,1037,1533,0,0,0,0,0,0,0,66.31 ,67.65 ,66.31 
03,006,01,015,0270,502,1407,29,1436,1939,0,0,0,0,0,0,0,66.31 ,74.06 ,66.31 
03,006,01,015,0271,503,1042,17,1059,1368,0,0,0,0,0,0,0,66.31 ,77.41 ,66.31 
03,006,01,015,0272,504,1408,16,1424,1935,0,0,0,0,0,0,0,66.31 ,73.59 ,66.31 
03,006,01,015,0273,505,1111,6,1117,1450,0,0,0,0,0,0,0,66.31 ,77.03 ,66.31 
03,006,01,015,0274,506,1246,18,1264,1609,0,0,0,0,0,0,0,66.31 ,78.56 ,66.31 
03,006,01,015,0274,507,1060,16,1076,1539,0,0,0,0,0,0,0,66.31 ,69.92 ,66.31 
03,006,01,015,0275,508,1052,17,1069,1409,0,0,0,0,0,0,0,66.31 ,75.87 ,66.31 
03,006,01,015,0276,509,883,22,905,1207,0,0,0,0,0,0,0,66.31 ,74.98 ,66.31 
03,006,01,015,0277,510,732,21,753,973,0,0,0,0,0,0,0,66.31 ,77.39 ,66.31 
03,006,01,015,0278,511,569,22,591,797,0,0,0,0,0,0,0,66.31 ,74.15 ,66.31 
03,006,01,016,0279,512,1219,26,1245,1624,0,0,0,0,0,0,0,66.31 ,76.66 ,66.31 
03,006,01,016,0279,513,1132,38,1170,1664,0,0,0,0,0,0,0,66.31 ,70.31 ,66.31 
03,006,01,016,0280,514,624,9,633,740,0,0,0,0,0,0,0,66.31 ,85.54 ,66.31 
03,006,01,016,0281,515,1053,18,1071,1386,0,0,0,0,0,0,0,66.31 ,77.27 ,66.31 
03,006,01,016,0281,516,1164,19,1183,1548,0,0,0,0,0,0,0,66.31 ,76.42 ,66.31 
03,006,01,016,0282,517,965,20,985,1191,0,0,0,0,0,0,0,66.31 ,82.70 ,66.31 
03,006,01,016,0283,518,798,17,815,1019,0,0,0,0,0,0,0,66.31 ,79.98 ,66.31 
03,006,01,016,0283,519,770,22,792,1028,0,0,0,0,0,0,0,66.31 ,77.04 ,66.31 
03,006,01,016,0284,520,769,10,779,1009,0,0,0,0,0,0,0,66.31 ,77.21 ,66.31 
03,006,01,016,0284,521,620,21,641,923,0,0,0,0,0,0,0,66.31 ,69.45 ,66.31 
03,006,01,016,0285,522,834,8,842,1098,0,0,0,0,0,0,0,66.31 ,76.68 ,66.31 
03,006,01,016,0285,523,950,16,966,1225,0,0,0,0,0,0,0,66.31 ,78.86 ,66.31 
03,006,01,016,0286,524,607,11,618,820,0,0,0,0,0,0,0,66.31 ,75.37 ,66.31 
03,006,01,016,0286,525,683,8,691,909,0,0,0,0,0,0,0,66.31 ,76.02 ,66.31 
03,006,01,016,0287,526,650,14,664,820,0,0,0,0,0,0,0,66.31 ,80.98 ,66.31 
03,006,01,016,0288,527,1007,19,1026,1225,0,0,0,0,0,0,0,66.31 ,83.76 ,66.31 
03,006,01,016,0289,528,1160,19,1179,1461,0,0,0,0,0,0,0,66.31 ,80.70 ,66.31 
03,006,01,016,0290,529,693,5,698,798,0,0,0,0,0,0,0,66.31 ,87.47 ,66.31 
03,006,01,016,0291,530,1021,37,1058,1316,0,0,0,0,0,0,0,66.31 ,80.40 ,66.31 
03,006,01,016,0292,531,1032,15,1047,1386,0,0,0,0,0,0,0,66.31 ,75.54 ,66.31 
03,006,01,016,0292,532,1020,21,1041,1369,0,0,0,0,0,0,0,66.31 ,76.04 ,66.31 
03,006,01,016,0292,533,499,11,510,742,0,0,0,0,0,0,0,66.31 ,68.73 ,66.31 
03,006,01,016,0293,534,831,10,841,1154,0,0,0,0,0,0,0,66.31 ,72.88 ,66.31 
03,006,01,016,0293,535,814,21,835,1168,0,0,0,0,0,0,0,66.31 ,71.49 ,66.31 
03,006,01,016,0293,536,679,23,702,1069,0,0,0,0,0,0,0,66.31 ,65.67 ,66.31 
03,006,01,016,0294,537,1020,15,1035,1526,0,0,0,0,0,0,0,66.31 ,67.82 ,66.31 
03,006,01,016,0294,538,899,22,921,1305,0,0,0,0,0,0,0,66.31 ,70.57 ,66.31 
03,006,01,016,0294,539,787,20,807,1327,0,0,0,0,0,0,0,66.31 ,60.81 ,66.31 
03,006,01,016,0294,540,1096,27,1123,1559,0,0,0,0,0,0,0,66.31 ,72.03 ,66.31 
03,006,01,017,0295,541,850,10,860,1131,0,0,0,0,0,0,0,66.31 ,76.04 ,66.31 
03,006,01,017,0295,542,510,10,520,635,0,0,0,0,0,0,0,66.31 ,81.89 ,66.31 
03,006,01,017,0296,543,851,15,866,1110,0,0,0,0,0,0,0,66.31 ,78.02 ,66.31 
03,006,01,017,0296,544,699,14,713,919,0,0,0,0,0,0,0,66.31 ,77.58 ,66.31 
03,006,01,017,0297,545,1088,15,1103,1357,0,0,0,0,0,0,0,66.31 ,81.28 ,66.31 
03,006,01,017,0298,546,925,16,941,1197,0,0,0,0,0,0,0,66.31 ,78.61 ,66.31 
03,006,01,017,0298,547,740,17,757,996,0,0,0,0,0,0,0,66.31 ,76.00 ,66.31 
03,006,01,017,0299,548,692,16,708,943,0,0,0,0,0,0,0,66.31 ,75.08 ,66.31 
03,006,01,017,0300,549,894,9,903,1061,0,0,0,0,0,0,0,66.31 ,85.11 ,66.31 
03,006,01,017,0300,550,653,7,660,761,0,0,0,0,0,0,0,66.31 ,86.73 ,66.31 
03,006,01,017,0301,551,891,22,913,1191,0,0,0,0,0,0,0,66.31 ,76.66 ,66.31 
03,006,01,017,0301,552,944,16,960,1160,0,0,0,0,0,0,0,66.31 ,82.76 ,66.31 
03,006,01,017,0301,553,574,7,581,752,0,0,0,0,0,0,0,66.31 ,77.26 ,66.31 
03,006,01,017,0301,554,559,6,565,758,0,0,0,0,0,0,0,66.31 ,74.54 ,66.31 
03,006,01,017,0302,555,926,11,937,1192,0,0,0,0,0,0,0,66.31 ,78.61 ,66.31 
03,006,01,017,0302,556,733,11,744,947,0,0,0,0,0,0,0,66.31 ,78.56 ,66.31 
03,006,01,017,0303,557,826,14,840,1091,0,0,0,0,0,0,0,66.31 ,76.99 ,66.31 
03,006,01,017,0303,558,844,22,866,1145,0,0,0,0,0,0,0,66.31 ,75.63 ,66.31 
03,006,01,017,0303,559,837,11,848,1101,0,0,0,0,0,0,0,66.31 ,77.02 ,66.31 
03,006,01,017,0304,560,579,6,585,752,0,0,0,0,0,0,0,66.31 ,77.79 ,66.31 
03,006,01,017,0304,561,900,18,918,1218,0,0,0,0,0,0,0,66.31 ,75.37 ,66.31 
03,006,01,017,0304,562,856,17,873,1179,0,0,0,0,0,0,0,66.31 ,74.05 ,66.31 
03,006,01,017,0305,563,681,15,696,972,0,0,0,0,0,0,0,66.31 ,71.60 ,66.31 
03,006,01,017,0305,564,833,15,848,1152,0,0,0,0,0,0,0,66.31 ,73.61 ,66.31 
03,006,01,017,0305,565,727,18,745,962,0,0,0,0,0,0,0,66.31 ,77.44 ,66.31 
03,006,01,017,0305,566,366,10,376,564,0,0,0,0,0,0,0,66.31 ,66.67 ,66.31 
03,006,01,017,0306,567,684,10,694,977,0,0,0,0,0,0,0,66.31 ,71.03 ,66.31 
03,006,01,017,0306,568,568,13,581,725,0,0,0,0,0,0,0,66.31 ,80.14 ,66.31 
03,006,01,017,0307,569,825,12,837,1187,0,0,0,0,0,0,0,66.31 ,70.51 ,66.31 
03,006,01,017,0307,570,930,17,947,1322,0,0,0,0,0,0,0,66.31 ,71.63 ,66.31 
03,006,01,017,0307,571,764,13,777,1261,0,0,0,0,0,0,0,66.31 ,61.62 ,66.31 
03,006,01,017,0308,572,896,10,906,1236,0,0,0,0,0,0,0,66.31 ,73.30 ,66.31 
03,006,01,017,0309,573,653,13,666,1273,0,0,0,0,0,0,0,66.31 ,52.32 ,66.31 
03,006,01,017,0309,574,641,16,657,1023,0,0,0,0,0,0,0,66.31 ,64.22 ,66.31 
03,006,01,017,0309,575,704,13,717,1221,0,0,0,0,0,0,0,66.31 ,58.72 ,66.31 
03,006,01,017,0309,576,494,9,503,804,0,0,0,0,0,0,0,66.31 ,62.56 ,66.31 
03,006,01,017,0310,577,907,26,933,1401,0,0,0,0,0,0,0,66.31 ,66.60 ,66.31 
03,006,01,017,0310,578,859,21,880,1360,0,0,0,0,0,0,0,66.31 ,64.71 ,66.31 
03,006,01,018,0311,579,824,10,834,1138,0,0,0,0,0,0,0,66.31 ,73.29 ,66.31 
03,006,01,018,0312,580,1316,20,1336,1936,0,0,0,0,0,0,0,66.31 ,69.01 ,66.31 
03,006,01,018,0312,581,1178,27,1205,1836,0,0,0,0,0,0,0,66.31 ,65.63 ,66.31 
03,006,01,018,0312,582,793,7,800,1179,0,0,0,0,0,0,0,66.31 ,67.85 ,66.31 
03,006,01,018,0312,583,1019,23,1042,1539,0,0,0,0,0,0,0,66.31 ,67.71 ,66.31 
03,006,01,018,0313,584,1012,21,1033,1363,0,0,0,0,0,0,0,66.31 ,75.79 ,66.31 
03,006,01,018,0313,585,949,15,964,1486,0,0,0,0,0,0,0,66.31 ,64.87 ,66.31 
03,006,01,018,0313,586,816,20,836,1303,0,0,0,0,0,0,0,66.31 ,64.16 ,66.31 
03,006,01,018,0314,587,1231,29,1260,1838,0,0,0,0,0,0,0,66.31 ,68.55 ,66.31 
03,006,01,018,0315,588,1183,24,1207,1649,0,0,0,0,0,0,0,66.31 ,73.20 ,66.31 
03,006,01,018,0316,589,650,20,670,920,0,0,0,0,0,0,0,66.31 ,72.83 ,66.31 
03,006,01,018,0317,590,774,21,795,1120,0,0,0,0,0,0,0,66.31 ,70.98 ,66.31 
03,006,01,018,0318,591,1141,21,1162,1713,0,0,0,0,0,0,0,66.31 ,67.83 ,66.31 
03,006,01,018,0318,592,1163,30,1193,1713,0,0,0,0,0,0,0,66.31 ,69.64 ,66.31 
03,006,01,018,0318,593,1122,24,1146,1658,0,0,0,0,0,0,0,66.31 ,69.12 ,66.31 
03,006,01,018,0319,594,1025,17,1042,1410,0,0,0,0,0,0,0,66.31 ,73.90 ,66.31 
03,006,01,018,0319,595,971,11,982,1321,0,0,0,0,0,0,0,66.31 ,74.34 ,66.31 
03,006,01,018,0320,596,985,15,1000,1259,0,0,0,0,0,0,0,66.31 ,79.43 ,66.31 
03,006,01,018,0321,597,1440,26,1466,1919,0,0,0,0,0,0,0,66.31 ,76.39 ,66.31 
03,006,01,018,0322,598,889,18,907,1087,0,0,0,0,0,0,0,66.31 ,83.44 ,66.31 
03,006,01,018,0322,599,828,16,844,1118,0,0,0,0,0,0,0,66.31 ,75.49 ,66.31 
03,006,01,018,0323,600,1329,21,1350,1708,0,0,0,0,0,0,0,66.31 ,79.04 ,66.31 
03,006,01,018,0324,601,1129,26,1155,1446,0,0,0,0,0,0,0,66.31 ,79.88 ,66.31 
03,006,01,018,0325,602,795,12,807,1054,0,0,0,0,0,0,0,66.31 ,76.57 ,66.31 
03,006,01,018,0326,603,887,12,899,1187,0,0,0,0,0,0,0,66.31 ,75.74 ,66.31 
03,006,01,018,0326,604,863,25,888,1285,0,0,0,0,0,0,0,66.31 ,69.11 ,66.31 
03,006,01,018,0327,605,1444,22,1466,1961,0,0,0,0,0,0,0,66.31 ,74.76 ,66.31 
03,006,01,018,0328,606,844,20,864,1096,0,0,0,0,0,0,0,66.31 ,78.83 ,66.31 
03,006,01,018,0328,607,795,22,817,1160,0,0,0,0,0,0,0,66.31 ,70.43 ,66.31 
03,006,01,018,0328,608,465,6,471,666,0,0,0,0,0,0,0,66.31 ,70.72 ,66.31 
03,006,01,018,0329,609,741,16,757,1061,0,0,0,0,0,0,0,66.31 ,71.35 ,66.31 
03,006,01,018,0330,610,863,25,888,1132,0,0,0,0,0,0,0,66.31 ,78.45 ,66.31 
03,006,01,018,0330,611,677,5,682,904,0,0,0,0,0,0,0,66.31 ,75.44 ,66.31 
03,006,01,019,0331,612,1198,28,1226,1791,0,0,0,0,0,0,0,66.31 ,68.45 ,66.31 
03,006,01,019,0331,613,1100,22,1122,1574,0,0,0,0,0,0,0,66.31 ,71.28 ,66.31 
03,006,01,019,0331,614,1003,20,1023,1438,0,0,0,0,0,0,0,66.31 ,71.14 ,66.31 
03,006,01,019,0332,615,980,21,1001,1480,0,0,0,0,0,0,0,66.31 ,67.64 ,66.31 
03,006,01,019,0332,616,773,24,797,1243,0,0,0,0,0,0,0,66.31 ,64.12 ,66.31 
03,006,01,019,0332,617,621,15,636,978,0,0,0,0,0,0,0,66.31 ,65.03 ,66.31 
03,006,01,019,0332,618,928,19,947,1504,0,0,0,0,0,0,0,66.31 ,62.97 ,66.31 
03,006,01,019,0332,619,861,27,888,1305,0,0,0,0,0,0,0,66.31 ,68.05 ,66.31 
03,006,01,019,0333,620,991,17,1008,1582,0,0,0,0,0,0,0,66.31 ,63.72 ,66.31 
03,006,01,019,0333,621,857,27,884,1296,0,0,0,0,0,0,0,66.31 ,68.21 ,66.31 
03,006,01,019,0333,622,850,20,870,1471,0,0,0,0,0,0,0,66.31 ,59.14 ,66.31 
03,006,01,019,0333,623,867,20,887,1365,0,0,0,0,0,0,0,66.31 ,64.98 ,66.31 
03,006,01,019,0334,624,926,11,937,1540,0,0,0,0,0,0,0,66.31 ,60.84 ,66.31 
03,006,01,019,0334,625,970,18,988,1610,0,0,0,0,0,0,0,66.31 ,61.37 ,66.31 
03,006,01,019,0334,626,692,10,702,1028,0,0,0,0,0,0,0,66.31 ,68.29 ,66.31 
03,006,01,019,0334,627,997,16,1013,1447,0,0,0,0,0,0,0,66.31 ,70.01 ,66.31 
03,006,01,019,0335,628,1127,22,1149,1595,0,0,0,0,0,0,0,66.31 ,72.04 ,66.31 
03,006,01,019,0335,629,1226,30,1256,1644,0,0,0,0,0,0,0,66.31 ,76.40 ,66.31 
03,006,01,019,0335,630,1088,18,1106,1554,0,0,0,0,0,0,0,66.31 ,71.17 ,66.31 
03,006,01,019,0335,631,1028,25,1053,1521,0,0,0,0,0,0,0,66.31 ,69.23 ,66.31 
03,006,01,019,0335,632,1183,25,1208,1741,0,0,0,0,0,0,0,66.31 ,69.39 ,66.31 
03,006,01,019,0336,633,856,23,879,1439,0,0,0,0,0,0,0,66.31 ,61.08 ,66.31 
03,006,01,019,0336,634,904,16,920,1369,0,0,0,0,0,0,0,66.31 ,67.20 ,66.31 
03,006,01,019,0336,635,982,23,1005,1542,0,0,0,0,0,0,0,66.31 ,65.18 ,66.31 
03,006,01,019,0337,636,775,12,787,1035,0,0,0,0,0,0,0,66.31 ,76.04 ,66.31 
03,006,01,019,0337,637,541,10,551,857,0,0,0,0,0,0,0,66.31 ,64.29 ,66.31 
03,006,01,019,0337,638,779,15,794,1142,0,0,0,0,0,0,0,66.31 ,69.53 ,66.31 
03,006,01,019,0337,639,828,15,843,1212,0,0,0,0,0,0,0,66.31 ,69.55 ,66.31 
03,006,01,019,0337,640,879,18,897,1206,0,0,0,0,0,0,0,66.31 ,74.38 ,66.31 
03,006,01,019,0337,641,1079,21,1100,1646,0,0,0,0,0,0,0,66.31 ,66.83 ,66.31 
03,006,01,019,0338,642,950,23,973,1474,0,0,0,0,0,0,0,66.31 ,66.01 ,66.31 
03,006,01,019,0338,643,1146,27,1173,1852,0,0,0,0,0,0,0,66.31 ,63.34 ,66.31 
03,006,01,019,0338,644,1103,25,1128,1729,0,0,0,0,0,0,0,66.31 ,65.24 ,66.31 
03,006,01,019,0338,645,1028,27,1055,1649,0,0,0,0,0,0,0,66.31 ,63.98 ,66.31 
03,006,01,019,0339,646,990,29,1019,1521,0,0,0,0,0,0,0,66.31 ,67.00 ,66.31 
03,006,01,019,0339,647,782,22,804,1207,0,0,0,0,0,0,0,66.31 ,66.61 ,66.31 
03,006,01,019,0339,648,914,18,932,1435,0,0,0,0,0,0,0,66.31 ,64.95 ,66.31 
03,006,01,019,0339,649,1114,19,1133,1742,0,0,0,0,0,0,0,66.31 ,65.04 ,66.31 
03,006,01,019,0340,650,787,16,803,1344,0,0,0,0,0,0,0,66.31 ,59.75 ,66.31 
03,006,01,019,0340,651,962,25,987,1633,0,0,0,0,0,0,0,66.31 ,60.44 ,66.31 
03,006,01,019,0340,652,807,21,828,1618,0,0,0,0,0,0,0,66.31 ,51.17 ,66.31 
03,006,01,019,0340,653,917,12,929,1636,0,0,0,0,0,0,0,66.31 ,56.78 ,66.31 
03,006,01,019,0340,654,1046,18,1064,1592,0,0,0,0,0,0,0,66.31 ,66.83 ,66.31 
03,006,01,019,0340,655,878,23,901,1350,0,0,0,0,0,0,0,66.31 ,66.74 ,66.31 
03,006,01,019,0340,656,853,18,871,1478,0,0,0,0,0,0,0,66.31 ,58.93 ,66.31 
03,006,01,019,0341,657,1047,23,1070,1781,0,0,0,0,0,0,0,66.31 ,60.08 ,66.31 
03,006,01,019,0341,658,872,21,893,1535,0,0,0,0,0,0,0,66.31 ,58.18 ,66.31 
03,006,01,019,0341,659,725,13,738,1355,0,0,0,0,0,0,0,66.31 ,54.46 ,66.31 
03,006,01,019,0341,660,642,18,660,1298,0,0,0,0,0,0,0,66.31 ,50.85 ,66.31 
03,006,01,019,0341,661,1010,16,1026,1623,0,0,0,0,0,0,0,66.31 ,63.22 ,66.31 
03,006,01,019,0341,662,945,29,974,1489,0,0,0,0,0,0,0,66.31 ,65.41 ,66.31 
03,006,01,019,0342,663,965,16,981,1599,0,0,0,0,0,0,0,66.31 ,61.35 ,66.31 
03,006,01,019,0342,664,1010,24,1034,1669,0,0,0,0,0,0,0,66.31 ,61.95 ,66.31 
03,006,01,019,0342,665,638,22,660,1078,0,0,0,0,0,0,0,66.31 ,61.22 ,66.31 
03,006,01,019,0342,666,872,21,893,1463,0,0,0,0,0,0,0,66.31 ,61.04 ,66.31 
03,006,01,019,0342,667,813,18,831,1425,0,0,0,0,0,0,0,66.31 ,58.32 ,66.31 
03,006,01,019,0343,668,1181,19,1200,1638,0,0,0,0,0,0,0,66.31 ,73.26 ,66.31 
03,006,01,019,0343,669,1117,24,1141,1881,0,0,0,0,0,0,0,66.31 ,60.66 ,66.31 
03,006,01,019,0344,670,812,14,826,1163,0,0,0,0,0,0,0,66.31 ,71.02 ,66.31 
03,006,01,019,0344,671,858,14,872,1302,0,0,0,0,0,0,0,66.31 ,66.97 ,66.31 
03,006,01,019,0344,672,765,19,784,1066,0,0,0,0,0,0,0,66.31 ,73.55 ,66.31 
03,006,01,019,0345,673,898,11,909,1238,0,0,0,0,0,0,0,66.31 ,73.42 ,66.31 
03,006,01,019,0346,674,1060,26,1086,1487,0,0,0,0,0,0,0,66.31 ,73.03 ,66.31 
03,006,01,019,0346,675,981,27,1008,1527,0,0,0,0,0,0,0,66.31 ,66.01 ,66.31 
03,006,01,019,0346,676,683,14,697,1028,0,0,0,0,0,0,0,66.31 ,67.80 ,66.31 
03,006,01,019,0346,677,715,22,737,1040,0,0,0,0,0,0,0,66.31 ,70.87 ,66.31 
03,006,01,019,0347,678,685,7,692,895,0,0,0,0,0,0,0,66.31 ,77.32 ,66.31 
03,006,01,019,0348,679,1043,19,1062,1452,0,0,0,0,0,0,0,66.31 ,73.14 ,66.31 
03,006,01,019,0348,680,972,17,989,1544,0,0,0,0,0,0,0,66.31 ,64.05 ,66.31 
03,006,01,019,0348,681,870,15,885,1245,0,0,0,0,0,0,0,66.31 ,71.08 ,66.31 
03,006,01,019,0349,682,1019,16,1035,1567,0,0,0,0,0,0,0,66.31 ,66.05 ,66.31 
03,006,01,019,0349,683,895,25,920,1432,0,0,0,0,0,0,0,66.31 ,64.25 ,66.31 
03,006,01,020,0350,684,993,25,1018,1405,0,0,0,0,0,0,0,66.31 ,72.46 ,66.31 
03,006,01,020,0350,685,847,12,859,1142,0,0,0,0,0,0,0,66.31 ,75.22 ,66.31 
03,006,01,020,0351,686,1097,14,1111,1642,0,0,0,0,0,0,0,66.31 ,67.66 ,66.31 
03,006,01,020,0351,687,1172,9,1181,1920,0,0,0,0,0,0,0,66.31 ,61.51 ,66.31 
03,006,01,020,0351,688,836,18,854,1199,0,0,0,0,0,0,0,66.31 ,71.23 ,66.31 
03,006,01,020,0351,689,543,17,560,792,0,0,0,0,0,0,0,66.31 ,70.71 ,66.31 
03,006,01,020,0351,690,706,13,719,1086,0,0,0,0,0,0,0,66.31 ,66.21 ,66.31 
03,006,01,020,0352,691,901,13,914,1253,0,0,0,0,0,0,0,66.31 ,72.94 ,66.31 
03,006,01,020,0352,692,931,24,955,1286,0,0,0,0,0,0,0,66.31 ,74.26 ,66.31 
03,006,01,020,0353,693,490,12,502,858,0,0,0,0,0,0,0,66.31 ,58.51 ,66.31 
03,006,01,020,0353,694,753,13,766,1210,0,0,0,0,0,0,0,66.31 ,63.31 ,66.31 
03,006,01,020,0353,695,716,14,730,1169,0,0,0,0,0,0,0,66.31 ,62.45 ,66.31 
03,006,01,020,0353,696,582,9,591,1106,0,0,0,0,0,0,0,66.31 ,53.44 ,66.31 
03,006,01,020,0353,697,540,16,556,832,0,0,0,0,0,0,0,66.31 ,66.83 ,66.31 
03,006,01,020,0354,698,863,22,885,1488,0,0,0,0,0,0,0,66.31 ,59.48 ,66.31 
03,006,01,020,0354,699,763,14,777,1313,0,0,0,0,0,0,0,66.31 ,59.18 ,66.31 
03,006,01,020,0354,700,844,14,858,1386,0,0,0,0,0,0,0,66.31 ,61.90 ,66.31 
03,006,01,020,0354,701,778,11,789,1307,0,0,0,0,0,0,0,66.31 ,60.37 ,66.31 
03,006,01,020,0354,702,748,12,760,1253,0,0,0,0,0,0,0,66.31 ,60.65 ,66.31 
03,006,01,020,0354,703,791,10,801,1452,0,0,0,0,0,0,0,66.31 ,55.17 ,66.31 
03,006,01,020,0355,704,780,23,803,1176,0,0,0,0,0,0,0,66.31 ,68.28 ,66.31 
03,006,01,020,0355,705,855,23,878,1381,0,0,0,0,0,0,0,66.31 ,63.58 ,66.31 
03,006,01,020,0356,706,1221,30,1251,1736,0,0,0,0,0,0,0,66.31 ,72.06 ,66.31 
03,006,01,020,0356,707,832,11,843,1213,0,0,0,0,0,0,0,66.31 ,69.50 ,66.31 
03,006,01,020,0357,708,1233,18,1251,1713,0,0,0,0,0,0,0,66.31 ,73.03 ,66.31 
03,006,01,020,0358,709,720,12,732,944,0,0,0,0,0,0,0,66.31 ,77.54 ,66.31 
03,006,01,020,0359,710,1053,24,1077,1636,0,0,0,0,0,0,0,66.31 ,65.83 ,66.31 
03,006,01,020,0359,711,1072,22,1094,1758,0,0,0,0,0,0,0,66.31 ,62.23 ,66.31 
03,006,01,020,0359,712,1100,15,1115,1692,0,0,0,0,0,0,0,66.31 ,65.90 ,66.31 
03,006,01,020,0359,713,993,20,1013,1563,0,0,0,0,0,0,0,66.31 ,64.81 ,66.31 
03,006,01,020,0359,714,888,23,911,1500,0,0,0,0,0,0,0,66.31 ,60.73 ,66.31 
03,006,01,020,0360,715,967,22,989,1393,0,0,0,0,0,0,0,66.31 ,71.00 ,66.31 
03,006,01,020,0360,716,903,18,921,1307,0,0,0,0,0,0,0,66.31 ,70.47 ,66.31 
03,006,01,020,0360,717,741,12,753,1186,0,0,0,0,0,0,0,66.31 ,63.49 ,66.31 
03,006,01,020,0361,718,857,18,875,1356,0,0,0,0,0,0,0,66.31 ,64.53 ,66.31 
03,006,01,020,0361,719,888,16,904,1235,0,0,0,0,0,0,0,66.31 ,73.20 ,66.31 
03,006,01,020,0361,720,1014,22,1036,1642,0,0,0,0,0,0,0,66.31 ,63.09 ,66.31 
03,006,01,020,0361,721,949,17,966,1485,0,0,0,0,0,0,0,66.31 ,65.05 ,66.31 
03,006,01,020,0362,722,734,17,751,1245,0,0,0,0,0,0,0,66.31 ,60.32 ,66.31 
03,006,01,020,0362,723,673,18,691,1200,0,0,0,0,0,0,0,66.31 ,57.58 ,66.31 
03,006,01,020,0362,724,680,8,688,1051,0,0,0,0,0,0,0,66.31 ,65.46 ,66.31 
03,006,01,020,0362,725,706,13,719,1090,0,0,0,0,0,0,0,66.31 ,65.96 ,66.31 
03,006,01,020,0362,726,704,13,717,1284,0,0,0,0,0,0,0,66.31 ,55.84 ,66.31 
03,006,01,020,0363,727,537,13,550,843,0,0,0,0,0,0,0,66.31 ,65.24 ,66.31 
03,006,01,020,0363,728,804,7,811,1350,0,0,0,0,0,0,0,66.31 ,60.07 ,66.31 
03,006,01,020,0363,729,1032,19,1051,1611,0,0,0,0,0,0,0,66.31 ,65.24 ,66.31 
03,006,01,020,0363,730,1065,25,1090,1587,0,0,0,0,0,0,0,66.31 ,68.68 ,66.31 
03,006,01,020,0363,731,980,16,996,1545,0,0,0,0,0,0,0,66.31 ,64.47 ,66.31 
03,006,01,020,0363,732,695,9,704,1061,0,0,0,0,0,0,0,66.31 ,66.35 ,66.31 
03,006,01,020,0364,733,922,21,943,1500,0,0,0,0,0,0,0,66.31 ,62.87 ,66.31 
03,006,01,020,0364,734,942,33,975,1439,0,0,0,0,0,0,0,66.31 ,67.76 ,66.31 
03,006,01,020,0365,735,1067,21,1088,1741,0,0,0,0,0,0,0,66.31 ,62.49 ,66.31 
03,006,01,020,0365,736,1127,16,1143,1774,0,0,0,0,0,0,0,66.31 ,64.43 ,66.31 
03,006,01,020,0365,737,1089,28,1117,1800,0,0,0,0,0,0,0,66.31 ,62.06 ,66.31 
03,006,01,020,0365,738,1007,10,1017,1579,0,0,0,0,0,0,0,66.31 ,64.41 ,66.31 
03,006,01,020,0365,739,966,15,981,1554,0,0,0,0,0,0,0,66.31 ,63.13 ,66.31 
03,006,01,020,0365,740,1063,21,1084,1811,0,0,0,0,0,0,0,66.31 ,59.86 ,66.31 
03,006,01,020,0366,741,1074,27,1101,1529,0,0,0,0,0,0,0,66.31 ,72.01 ,66.31 
03,006,01,020,0366,742,895,18,913,1421,0,0,0,0,0,0,0,66.31 ,64.25 ,66.31 
03,006,01,020,0366,743,1100,12,1112,1631,0,0,0,0,0,0,0,66.31 ,68.18 ,66.31 
03,006,01,020,0366,744,1038,17,1055,1549,0,0,0,0,0,0,0,66.31 ,68.11 ,66.31 
03,006,01,020,0366,745,1124,14,1138,1827,0,0,0,0,0,0,0,66.31 ,62.29 ,66.31 
03,006,01,020,0367,746,822,19,841,1274,0,0,0,0,0,0,0,66.31 ,66.01 ,66.31 
03,006,01,020,0367,747,919,20,939,1622,0,0,0,0,0,0,0,66.31 ,57.89 ,66.31 
03,006,01,020,0367,748,817,12,829,1384,0,0,0,0,0,0,0,66.31 ,59.90 ,66.31 
03,006,01,020,0367,749,655,12,667,1084,0,0,0,0,0,0,0,66.31 ,61.53 ,66.31 
03,006,01,020,0367,750,716,20,736,1182,0,0,0,0,0,0,0,66.31 ,62.27 ,66.31 
03,006,01,020,0368,751,811,14,825,1272,0,0,0,0,0,0,0,66.31 ,64.86 ,66.31 
03,006,01,020,0368,752,858,22,880,1436,0,0,0,0,0,0,0,66.31 ,61.28 ,66.31 
03,006,01,020,0368,753,890,16,906,1365,0,0,0,0,0,0,0,66.31 ,66.37 ,66.31 
03,006,01,020,0368,754,785,15,800,1282,0,0,0,0,0,0,0,66.31 ,62.40 ,66.31 
03,006,01,020,0369,755,921,21,942,1358,0,0,0,0,0,0,0,66.31 ,69.37 ,66.31 
03,006,01,020,0369,756,979,24,1003,1440,0,0,0,0,0,0,0,66.31 ,69.65 ,66.31 
03,006,01,020,0369,757,917,15,932,1368,0,0,0,0,0,0,0,66.31 ,68.13 ,66.31 
03,006,01,020,0369,758,915,10,925,1376,0,0,0,0,0,0,0,66.31 ,67.22 ,66.31 
03,006,01,020,0369,759,971,19,990,1674,0,0,0,0,0,0,0,66.31 ,59.14 ,66.31 
03,006,01,021,0370,760,84,2,86,145,0,0,0,0,0,0,0,66.31 ,59.31 ,66.31 
03,006,01,021,0370,761,511,2,513,706,0,0,0,0,0,0,0,66.31 ,72.66 ,66.31 
03,006,01,021,0370,762,360,3,363,519,0,0,0,0,0,0,0,66.31 ,69.94 ,66.31 
03,006,01,021,0371,763,292,3,295,436,0,0,0,0,0,0,0,66.31 ,67.66 ,66.31 
03,006,01,021,0372,764,377,6,383,621,0,0,0,0,0,0,0,66.31 ,61.67 ,66.31 
03,006,01,021,0372,765,325,3,328,468,0,0,0,0,0,0,0,66.31 ,70.09 ,66.31 
03,006,01,021,0373,766,65,3,68,82,0,0,0,0,0,0,0,66.31 ,82.93 ,66.31 
03,006,01,021,0373,767,86,1,87,136,0,0,0,0,0,0,0,66.31 ,63.97 ,66.31 
03,006,01,021,0373,768,194,5,199,273,0,0,0,0,0,0,0,66.31 ,72.89 ,66.31 
03,006,01,021,0374,769,242,5,247,370,0,0,0,0,0,0,0,66.31 ,66.76 ,66.31 
03,006,01,021,0374,770,61,0,61,98,0,0,0,0,0,0,0,66.31 ,62.24 ,66.31 
03,006,01,021,0375,771,192,3,195,256,0,0,0,0,0,0,0,66.31 ,76.17 ,66.31 
03,006,01,021,0376,772,99,5,104,205,0,0,0,0,0,0,0,66.31 ,50.73 ,66.31 
03,006,01,021,0376,773,472,8,480,831,0,0,0,0,0,0,0,66.31 ,57.76 ,66.31 
03,006,01,021,0376,774,118,1,119,285,0,0,0,0,0,0,0,66.31 ,41.75 ,66.31 
03,006,01,021,0376,775,38,1,39,93,0,0,0,0,0,0,0,66.31 ,41.94 ,66.31 
03,006,01,021,0377,776,127,0,127,223,0,0,0,0,0,0,0,66.31 ,56.95 ,66.31 
03,006,01,021,0377,777,98,3,101,182,0,0,0,0,0,0,0,66.31 ,55.49 ,66.31 
03,007,01,001,0001,1,905,18,923,1219,0,0,0,0,0,0,0,66.31 ,75.72 ,66.31 
03,007,01,001,0001,2,1113,25,1138,1561,0,0,0,0,0,0,0,66.31 ,72.90 ,66.31 
03,007,01,001,0002,3,799,7,806,1056,0,0,0,0,0,0,0,66.31 ,76.33 ,66.31 
03,007,01,001,0002,4,767,24,791,1114,0,0,0,0,0,0,0,66.31 ,71.01 ,66.31 
03,007,01,001,0003,5,1119,17,1136,1490,0,0,0,0,0,0,0,66.31 ,76.24 ,66.31 
03,007,01,001,0004,6,1176,20,1196,1590,0,0,0,0,0,0,0,66.31 ,75.22 ,66.31 
03,007,01,001,0005,7,761,14,775,1033,0,0,0,0,0,0,0,66.31 ,75.02 ,66.31 
03,007,01,001,0005,8,796,11,807,1068,0,0,0,0,0,0,0,66.31 ,75.56 ,66.31 
03,007,01,001,0006,9,836,11,847,1096,0,0,0,0,0,0,0,66.31 ,77.28 ,66.31 
03,007,01,001,0006,10,938,10,948,1261,0,0,0,0,0,0,0,66.31 ,75.18 ,66.31 
03,007,01,001,0007,11,1028,20,1048,1318,0,0,0,0,0,0,0,66.31 ,79.51 ,66.31 
03,007,01,001,0008,12,821,10,831,1075,0,0,0,0,0,0,0,66.31 ,77.30 ,66.31 
03,007,01,001,0008,13,566,10,576,803,0,0,0,0,0,0,0,66.31 ,71.73 ,66.31 
03,007,01,001,0009,14,1128,13,1141,1668,0,0,0,0,0,0,0,66.31 ,68.41 ,66.31 
03,007,01,001,0009,15,1169,16,1185,1612,0,0,0,0,0,0,0,66.31 ,73.51 ,66.31 
03,007,01,001,0009,16,1128,23,1151,1551,0,0,0,0,0,0,0,66.31 ,74.21 ,66.31 
03,007,01,001,0010,17,1125,26,1151,1520,0,0,0,0,0,0,0,66.31 ,75.72 ,66.31 
03,007,01,001,0010,18,1174,23,1197,1497,0,0,0,0,0,0,0,66.31 ,79.96 ,66.31 
03,007,01,001,0011,19,1061,26,1087,1521,0,0,0,0,0,0,0,66.31 ,71.47 ,66.31 
03,007,01,001,0011,20,966,18,984,1312,0,0,0,0,0,0,0,66.31 ,75.00 ,66.31 
03,007,01,001,0011,21,1068,16,1084,1425,0,0,0,0,0,0,0,66.31 ,76.07 ,66.31 
03,007,01,001,0012,22,1235,21,1256,1646,0,0,0,0,0,0,0,66.31 ,76.31 ,66.31 
03,007,01,001,0012,23,1049,16,1065,1416,0,0,0,0,0,0,0,66.31 ,75.21 ,66.31 
03,007,01,001,0012,24,1000,16,1016,1387,0,0,0,0,0,0,0,66.31 ,73.25 ,66.31 
03,007,01,001,0012,25,1020,14,1034,1420,0,0,0,0,0,0,0,66.31 ,72.82 ,66.31 
03,007,01,001,0013,26,1063,14,1077,1419,0,0,0,0,0,0,0,66.31 ,75.90 ,66.31 
03,007,01,001,0014,27,886,10,896,1177,0,0,0,0,0,0,0,66.31 ,76.13 ,66.31 
03,007,01,001,0015,28,1128,18,1146,1467,0,0,0,0,0,0,0,66.31 ,78.12 ,66.31 
03,007,01,001,0016,29,828,16,844,1080,0,0,0,0,0,0,0,66.31 ,78.15 ,66.31 
03,007,01,001,0017,30,911,14,925,1242,0,0,0,0,0,0,0,66.31 ,74.48 ,66.31 
03,007,01,001,0017,31,844,10,854,1171,0,0,0,0,0,0,0,66.31 ,72.93 ,66.31 
03,007,01,001,0018,32,1063,17,1080,1408,0,0,0,0,0,0,0,66.31 ,76.70 ,66.31 
03,007,01,001,0018,33,1124,15,1139,1518,0,0,0,0,0,0,0,66.31 ,75.03 ,66.31 
03,007,01,001,0019,34,700,10,710,927,0,0,0,0,0,0,0,66.31 ,76.59 ,66.31 
03,007,01,001,0020,35,779,22,801,1044,0,0,0,0,0,0,0,66.31 ,76.72 ,66.31 
03,007,01,001,0021,36,973,16,989,1278,0,0,0,0,0,0,0,66.31 ,77.39 ,66.31 
03,007,01,001,0022,37,949,16,965,1264,0,0,0,0,0,0,0,66.31 ,76.34 ,66.31 
03,007,01,001,0023,38,772,10,782,1015,0,0,0,0,0,0,0,66.31 ,77.04 ,66.31 
03,007,01,001,0024,39,641,13,654,821,0,0,0,0,0,0,0,66.31 ,79.66 ,66.31 
03,007,01,001,0024,40,820,15,835,1196,0,0,0,0,0,0,0,66.31 ,69.82 ,66.31 
03,007,01,001,0025,41,1219,14,1233,1586,0,0,0,0,0,0,0,66.31 ,77.74 ,66.31 
03,007,01,001,0025,42,1114,17,1131,1604,0,0,0,0,0,0,0,66.31 ,70.51 ,66.31 
03,007,01,001,0026,43,1425,25,1450,1932,0,0,0,0,0,0,0,66.31 ,75.05 ,66.31 
03,007,01,001,0026,44,1381,32,1413,1904,0,0,0,0,0,0,0,66.31 ,74.21 ,66.31 
03,007,01,001,0027,45,1482,19,1501,1967,0,0,0,0,0,0,0,66.31 ,76.31 ,66.31 
03,007,01,001,0028,46,769,15,784,1044,0,0,0,0,0,0,0,66.31 ,75.10 ,66.31 
03,007,01,001,0028,47,864,6,870,1097,0,0,0,0,0,0,0,66.31 ,79.31 ,66.31 
03,007,01,001,0029,48,1115,17,1132,1394,0,0,0,0,0,0,0,66.31 ,81.21 ,66.31 
03,007,01,001,0030,49,1278,25,1303,1560,0,0,0,0,0,0,0,66.31 ,83.53 ,66.31 
03,007,01,001,0031,50,927,12,939,1176,0,0,0,0,0,0,0,66.31 ,79.85 ,66.31 
03,007,01,001,0031,51,1098,9,1107,1380,0,0,0,0,0,0,0,66.31 ,80.22 ,66.31 
03,007,01,001,0032,52,833,13,846,1095,0,0,0,0,0,0,0,66.31 ,77.26 ,66.31 
03,007,01,001,0032,53,1063,28,1091,1344,0,0,0,0,0,0,0,66.31 ,81.18 ,66.31 
03,007,01,001,0033,54,837,17,854,1130,0,0,0,0,0,0,0,66.31 ,75.58 ,66.31 
03,007,01,001,0033,55,851,15,866,1102,0,0,0,0,0,0,0,66.31 ,78.58 ,66.31 
03,007,01,001,0034,56,856,15,871,1179,0,0,0,0,0,0,0,66.31 ,73.88 ,66.31 
03,007,01,001,0034,57,817,18,835,1089,0,0,0,0,0,0,0,66.31 ,76.68 ,66.31 
03,007,01,001,0035,58,842,14,856,1161,0,0,0,0,0,0,0,66.31 ,73.73 ,66.31 
03,007,01,001,0036,59,1013,18,1031,1449,0,0,0,0,0,0,0,66.31 ,71.15 ,66.31 
03,007,01,001,0036,60,944,28,972,1417,0,0,0,0,0,0,0,66.31 ,68.60 ,66.31 
03,007,01,001,0037,61,1373,25,1398,1878,0,0,0,0,0,0,0,66.31 ,74.44 ,66.31 
03,007,01,001,0037,62,1291,18,1309,1738,0,0,0,0,0,0,0,66.31 ,75.32 ,66.31 
03,007,01,001,0038,63,672,16,688,908,0,0,0,0,0,0,0,66.31 ,75.77 ,66.31 
03,007,01,001,0038,64,707,17,724,916,0,0,0,0,0,0,0,66.31 ,79.04 ,66.31 
03,007,01,001,0039,65,1048,12,1060,1440,0,0,0,0,0,0,0,66.31 ,73.61 ,66.31 
03,007,01,001,0040,66,716,13,729,965,0,0,0,0,0,0,0,66.31 ,75.54 ,66.31 
03,007,01,001,0041,67,1011,19,1030,1379,0,0,0,0,0,0,0,66.31 ,74.69 ,66.31 
03,007,01,001,0042,68,605,8,613,797,0,0,0,0,0,0,0,66.31 ,76.91 ,66.31 
03,007,01,001,0043,69,764,8,772,979,0,0,0,0,0,0,0,66.31 ,78.86 ,66.31 
03,007,01,001,0044,70,688,10,698,920,0,0,0,0,0,0,0,66.31 ,75.87 ,66.31 
03,007,01,001,0045,71,973,6,979,1314,0,0,0,0,0,0,0,66.31 ,74.51 ,66.31 
03,007,01,001,0046,72,623,13,636,827,0,0,0,0,0,0,0,66.31 ,76.90 ,66.31 
03,007,01,001,0047,73,817,7,824,1097,0,0,0,0,0,0,0,66.31 ,75.11 ,66.31 
03,007,01,001,0047,74,764,12,776,1019,0,0,0,0,0,0,0,66.31 ,76.15 ,66.31 
03,007,01,001,0048,75,1060,14,1074,1427,0,0,0,0,0,0,0,66.31 ,75.26 ,66.31 
03,007,01,001,0049,76,642,12,654,862,0,0,0,0,0,0,0,66.31 ,75.87 ,66.31 
03,007,01,001,0049,77,675,18,693,950,0,0,0,0,0,0,0,66.31 ,72.95 ,66.31 
03,007,01,001,0050,78,1202,25,1227,1623,0,0,0,0,0,0,0,66.31 ,75.60 ,66.31 
03,007,01,001,0050,79,1277,16,1293,1760,0,0,0,0,0,0,0,66.31 ,73.47 ,66.31 
03,007,01,001,0051,80,1279,19,1298,1585,0,0,0,0,0,0,0,66.31 ,81.89 ,66.31 
03,007,01,001,0051,81,1185,26,1211,1556,0,0,0,0,0,0,0,66.31 ,77.83 ,66.31 
03,007,01,001,0052,82,639,14,653,748,0,0,0,0,0,0,0,66.31 ,87.30 ,66.31 
03,007,01,001,0053,83,1528,25,1553,1911,0,0,0,0,0,0,0,66.31 ,81.27 ,66.31 
03,007,01,001,0054,84,825,15,840,1006,0,0,0,0,0,0,0,66.31 ,83.50 ,66.31 
03,007,01,001,0055,85,1535,25,1560,1968,0,0,0,0,0,0,0,66.31 ,79.27 ,66.31 
03,007,01,001,0056,86,983,23,1006,1316,0,0,0,0,0,0,0,66.31 ,76.44 ,66.31 
03,007,01,001,0056,87,971,18,989,1282,0,0,0,0,0,0,0,66.31 ,77.15 ,66.31 
03,007,01,001,0056,88,1060,23,1083,1371,0,0,0,0,0,0,0,66.31 ,78.99 ,66.31 
03,007,01,001,0057,89,758,18,776,1077,0,0,0,0,0,0,0,66.31 ,72.05 ,66.31 
03,007,01,001,0057,90,751,10,761,1049,0,0,0,0,0,0,0,66.31 ,72.55 ,66.31 
03,007,01,001,0058,91,1367,24,1391,1855,0,0,0,0,0,0,0,66.31 ,74.99 ,66.31 
03,007,01,001,0058,92,1316,24,1340,1840,0,0,0,0,0,0,0,66.31 ,72.83 ,66.31 
03,007,01,001,0059,93,742,12,754,1005,0,0,0,0,0,0,0,66.31 ,75.02 ,66.31 
03,007,01,001,0059,94,628,15,643,875,0,0,0,0,0,0,0,66.31 ,73.49 ,66.31 
03,007,01,001,0060,95,1051,14,1065,1364,0,0,0,0,0,0,0,66.31 ,78.08 ,66.31 
03,007,01,001,0060,96,609,9,618,786,0,0,0,0,0,0,0,66.31 ,78.63 ,66.31 
03,007,01,001,0061,97,1318,38,1356,1692,0,0,0,0,0,0,0,66.31 ,80.14 ,66.31 
03,007,01,001,0061,98,1208,19,1227,1596,0,0,0,0,0,0,0,66.31 ,76.88 ,66.31 
03,007,01,001,0061,99,1413,23,1436,1883,0,0,0,0,0,0,0,66.31 ,76.26 ,66.31 
03,007,01,001,0062,100,647,14,661,816,0,0,0,0,0,0,0,66.31 ,81.00 ,66.31 
03,007,01,001,0063,101,1127,29,1156,1533,0,0,0,0,0,0,0,66.31 ,75.41 ,66.31 
03,007,01,001,0064,102,801,8,809,953,0,0,0,0,0,0,0,66.31 ,84.89 ,66.31 
03,007,01,001,0065,103,878,18,896,1137,0,0,0,0,0,0,0,66.31 ,78.80 ,66.31 
03,007,01,001,0065,104,856,22,878,1155,0,0,0,0,0,0,0,66.31 ,76.02 ,66.31 
03,007,01,001,0066,105,843,17,860,1156,0,0,0,0,0,0,0,66.31 ,74.39 ,66.31 
03,007,01,001,0066,106,893,12,905,1072,0,0,0,0,0,0,0,66.31 ,84.42 ,66.31 
03,007,01,001,0067,107,1136,14,1150,1443,0,0,0,0,0,0,0,66.31 ,79.70 ,66.31 
03,007,01,001,0067,108,858,13,871,1129,0,0,0,0,0,0,0,66.31 ,77.15 ,66.31 
03,007,01,001,0068,109,1048,20,1068,1483,0,0,0,0,0,0,0,66.31 ,72.02 ,66.31 
03,007,01,001,0068,110,994,16,1010,1371,0,0,0,0,0,0,0,66.31 ,73.67 ,66.31 
03,007,01,001,0069,111,679,7,686,789,0,0,0,0,0,0,0,66.31 ,86.95 ,66.31 
03,007,01,001,0070,112,727,7,734,927,0,0,0,0,0,0,0,66.31 ,79.18 ,66.31 
03,007,01,001,0071,113,600,7,607,735,0,0,0,0,0,0,0,66.31 ,82.59 ,66.31 
03,007,01,001,0072,114,864,9,873,1087,0,0,0,0,0,0,0,66.31 ,80.31 ,66.31 
03,007,01,001,0073,115,833,10,843,1077,0,0,0,0,0,0,0,66.31 ,78.27 ,66.31 
03,007,01,002,0074,116,798,10,808,1042,0,0,0,0,0,0,0,66.31 ,77.54 ,66.31 
03,007,01,002,0074,117,1247,24,1271,1626,0,0,0,0,0,0,0,66.31 ,78.17 ,66.31 
03,007,01,002,0075,118,1207,16,1223,1521,0,0,0,0,0,0,0,66.31 ,80.41 ,66.31 
03,007,01,002,0076,119,668,14,682,865,0,0,0,0,0,0,0,66.31 ,78.84 ,66.31 
03,007,01,002,0076,120,918,23,941,1198,0,0,0,0,0,0,0,66.31 ,78.55 ,66.31 
03,007,01,002,0077,121,800,8,808,974,0,0,0,0,0,0,0,66.31 ,82.96 ,66.31 
03,007,01,002,0078,122,1030,12,1042,1247,0,0,0,0,0,0,0,66.31 ,83.56 ,66.31 
03,007,01,002,0079,123,1050,12,1062,1297,0,0,0,0,0,0,0,66.31 ,81.88 ,66.31 
03,007,01,002,0080,124,546,9,555,656,0,0,0,0,0,0,0,66.31 ,84.60 ,66.31 
03,007,01,002,0081,125,679,3,682,795,0,0,0,0,0,0,0,66.31 ,85.79 ,66.31 
03,007,01,002,0081,126,559,14,573,692,0,0,0,0,0,0,0,66.31 ,82.80 ,66.31 
03,007,01,002,0082,127,941,17,958,1225,0,0,0,0,0,0,0,66.31 ,78.20 ,66.31 
03,007,01,002,0082,128,986,11,997,1230,0,0,0,0,0,0,0,66.31 ,81.06 ,66.31 
03,007,01,002,0082,129,643,11,654,868,0,0,0,0,0,0,0,66.31 ,75.35 ,66.31 
03,007,01,002,0083,130,852,8,860,1083,0,0,0,0,0,0,0,66.31 ,79.41 ,66.31 
03,007,01,002,0083,131,747,16,763,939,0,0,0,0,0,0,0,66.31 ,81.26 ,66.31 
03,007,01,002,0084,132,1099,12,1111,1459,0,0,0,0,0,0,0,66.31 ,76.15 ,66.31 
03,007,01,002,0084,133,1030,22,1052,1506,0,0,0,0,0,0,0,66.31 ,69.85 ,66.31 
03,007,01,002,0085,134,999,11,1010,1290,0,0,0,0,0,0,0,66.31 ,78.29 ,66.31 
03,007,01,002,0086,135,1221,32,1253,1637,0,0,0,0,0,0,0,66.31 ,76.54 ,66.31 
03,007,01,002,0086,136,806,15,821,1003,0,0,0,0,0,0,0,66.31 ,81.85 ,66.31 
03,007,01,002,0087,137,634,7,641,794,0,0,0,0,0,0,0,66.31 ,80.73 ,66.31 
03,007,01,002,0088,138,738,9,747,958,0,0,0,0,0,0,0,66.31 ,77.97 ,66.31 
03,007,01,002,0089,139,1129,12,1141,1520,0,0,0,0,0,0,0,66.31 ,75.07 ,66.31 
03,007,01,002,0090,140,986,17,1003,1317,0,0,0,0,0,0,0,66.31 ,76.16 ,66.31 
03,007,01,002,0091,141,1001,12,1013,1306,0,0,0,0,0,0,0,66.31 ,77.57 ,66.31 
03,007,01,003,0092,142,1251,15,1266,1607,0,0,0,0,0,0,0,66.31 ,78.78 ,66.31 
03,007,01,003,0093,143,1001,16,1017,1286,0,0,0,0,0,0,0,66.31 ,79.08 ,66.31 
03,007,01,003,0094,144,1239,17,1256,1538,0,0,0,0,0,0,0,66.31 ,81.66 ,66.31 
03,007,01,003,0095,145,452,5,457,563,0,0,0,0,0,0,0,66.31 ,81.17 ,66.31 
03,007,01,003,0096,146,693,17,710,895,0,0,0,0,0,0,0,66.31 ,79.33 ,66.31 
03,007,01,003,0096,147,870,19,889,1181,0,0,0,0,0,0,0,66.31 ,75.28 ,66.31 
03,007,01,003,0097,148,803,14,817,1077,0,0,0,0,0,0,0,66.31 ,75.86 ,66.31 
03,007,01,003,0097,149,711,21,732,923,0,0,0,0,0,0,0,66.31 ,79.31 ,66.31 
03,007,01,003,0098,150,1085,22,1107,1388,0,0,0,0,0,0,0,66.31 ,79.76 ,66.31 
03,007,01,003,0099,151,693,10,703,855,0,0,0,0,0,0,0,66.31 ,82.22 ,66.31 
03,007,01,003,0100,152,715,13,728,903,0,0,0,0,0,0,0,66.31 ,80.62 ,66.31 
03,007,01,003,0101,153,812,11,823,1031,0,0,0,0,0,0,0,66.31 ,79.83 ,66.31 
03,007,01,003,0102,154,581,8,589,704,0,0,0,0,0,0,0,66.31 ,83.66 ,66.31 
03,007,01,003,0103,155,1127,14,1141,1441,0,0,0,0,0,0,0,66.31 ,79.18 ,66.31 
03,007,01,003,0104,156,940,10,950,1266,0,0,0,0,0,0,0,66.31 ,75.04 ,66.31 
03,007,01,003,0105,157,740,10,750,980,0,0,0,0,0,0,0,66.31 ,76.53 ,66.31 
03,007,01,003,0106,158,780,12,792,1059,0,0,0,0,0,0,0,66.31 ,74.79 ,66.31 
03,007,01,004,0107,159,928,15,943,1184,0,0,0,0,0,0,0,66.31 ,79.65 ,66.31 
03,007,01,004,0108,160,466,4,470,593,0,0,0,0,0,0,0,66.31 ,79.26 ,66.31 
03,007,01,004,0109,161,861,13,874,1111,0,0,0,0,0,0,0,66.31 ,78.67 ,66.31 
03,007,01,004,0110,162,769,9,778,942,0,0,0,0,0,0,0,66.31 ,82.59 ,66.31 
03,007,01,004,0111,163,826,8,834,1061,0,0,0,0,0,0,0,66.31 ,78.61 ,66.31 
03,007,01,004,0112,164,1402,23,1425,1854,0,0,0,0,0,0,0,66.31 ,76.86 ,66.31 
03,007,01,004,0113,165,938,18,956,1260,0,0,0,0,0,0,0,66.31 ,75.87 ,66.31 
03,007,01,004,0114,166,246,4,250,324,0,0,0,0,0,0,0,66.31 ,77.16 ,66.31 
03,007,01,004,0115,167,579,8,587,727,0,0,0,0,0,0,0,66.31 ,80.74 ,66.31 
03,007,01,004,0116,168,627,6,633,810,0,0,0,0,0,0,0,66.31 ,78.15 ,66.31 
03,007,01,004,0117,169,914,16,930,1163,0,0,0,0,0,0,0,66.31 ,79.97 ,66.31 
03,007,01,004,0118,170,447,2,449,584,0,0,0,0,0,0,0,66.31 ,76.88 ,66.31 
03,007,01,004,0119,171,770,14,784,971,0,0,0,0,0,0,0,66.31 ,80.74 ,66.31 
03,007,01,004,0120,172,1023,15,1038,1279,0,0,0,0,0,0,0,66.31 ,81.16 ,66.31 
03,007,01,004,0121,173,989,16,1005,1315,0,0,0,0,0,0,0,66.31 ,76.43 ,66.31 
03,007,01,004,0121,174,1136,16,1152,1468,0,0,0,0,0,0,0,66.31 ,78.47 ,66.31 
03,007,01,004,0122,175,1291,29,1320,1694,0,0,0,0,0,0,0,66.31 ,77.92 ,66.31 
03,007,01,004,0122,176,1239,15,1254,1607,0,0,0,0,0,0,0,66.31 ,78.03 ,66.31 
03,007,01,004,0123,177,1089,24,1113,1380,0,0,0,0,0,0,0,66.31 ,80.65 ,66.31 
03,007,01,004,0123,178,1017,20,1037,1319,0,0,0,0,0,0,0,66.31 ,78.62 ,66.31 
03,007,01,004,0124,179,1193,23,1216,1538,0,0,0,0,0,0,0,66.31 ,79.06 ,66.31 
03,007,01,004,0124,180,952,20,972,1249,0,0,0,0,0,0,0,66.31 ,77.82 ,66.31 
03,007,01,004,0124,181,1259,17,1276,1611,0,0,0,0,0,0,0,66.31 ,79.21 ,66.31 
03,007,01,004,0125,182,1384,22,1406,1781,0,0,0,0,0,0,0,66.31 ,78.94 ,66.31 
03,007,01,004,0125,183,954,18,972,1215,0,0,0,0,0,0,0,66.31 ,80.00 ,66.31 
03,007,01,004,0126,184,995,24,1019,1295,0,0,0,0,0,0,0,66.31 ,78.69 ,66.31 
03,007,01,004,0126,185,1227,13,1240,1487,0,0,0,0,0,0,0,66.31 ,83.39 ,66.31 
03,007,01,004,0127,186,1160,16,1176,1497,0,0,0,0,0,0,0,66.31 ,78.56 ,66.31 
03,007,01,004,0128,187,1079,16,1095,1381,0,0,0,0,0,0,0,66.31 ,79.29 ,66.31 
03,007,01,004,0128,188,934,13,947,1183,0,0,0,0,0,0,0,66.31 ,80.05 ,66.31 
03,007,01,004,0129,189,640,4,644,810,0,0,0,0,0,0,0,66.31 ,79.51 ,66.31 
03,007,01,004,0129,190,1066,15,1081,1379,0,0,0,0,0,0,0,66.31 ,78.39 ,66.31 
03,007,01,004,0130,191,1022,15,1037,1311,0,0,0,0,0,0,0,66.31 ,79.10 ,66.31 
03,007,01,004,0130,192,1129,24,1153,1401,0,0,0,0,0,0,0,66.31 ,82.30 ,66.31 
03,007,01,004,0131,193,868,13,881,1116,0,0,0,0,0,0,0,66.31 ,78.94 ,66.31 
03,007,01,004,0131,194,1263,19,1282,1549,0,0,0,0,0,0,0,66.31 ,82.76 ,66.31 
03,007,01,004,0132,195,1347,23,1370,1648,0,0,0,0,0,0,0,66.31 ,83.13 ,66.31 
03,007,01,004,0133,196,1018,16,1034,1265,0,0,0,0,0,0,0,66.31 ,81.74 ,66.31 
03,007,01,004,0133,197,634,9,643,755,0,0,0,0,0,0,0,66.31 ,85.17 ,66.31 
03,007,01,004,0134,198,1013,15,1028,1256,0,0,0,0,0,0,0,66.31 ,81.85 ,66.31 
03,007,01,004,0134,199,1269,23,1292,1570,0,0,0,0,0,0,0,66.31 ,82.29 ,66.31 
03,007,01,004,0135,200,952,9,961,1161,0,0,0,0,0,0,0,66.31 ,82.77 ,66.31 
03,007,01,004,0135,201,893,20,913,1132,0,0,0,0,0,0,0,66.31 ,80.65 ,66.31 
03,007,01,004,0135,202,592,3,595,717,0,0,0,0,0,0,0,66.31 ,82.98 ,66.31 
03,007,01,005,0136,203,802,6,808,1016,0,0,0,0,0,0,0,66.31 ,79.53 ,66.31 
03,007,01,005,0136,204,671,11,682,847,0,0,0,0,0,0,0,66.31 ,80.52 ,66.31 
03,007,01,005,0137,205,837,17,854,1063,0,0,0,0,0,0,0,66.31 ,80.34 ,66.31 
03,007,01,005,0138,206,756,16,772,939,0,0,0,0,0,0,0,66.31 ,82.22 ,66.31 
03,007,01,005,0139,207,892,10,902,1121,0,0,0,0,0,0,0,66.31 ,80.46 ,66.31 
03,007,01,005,0140,208,534,4,538,649,0,0,0,0,0,0,0,66.31 ,82.90 ,66.31 
03,007,01,005,0141,209,908,7,915,1120,0,0,0,0,0,0,0,66.31 ,81.70 ,66.31 
03,007,01,005,0142,210,814,18,832,1054,0,0,0,0,0,0,0,66.31 ,78.94 ,66.31 
03,007,01,005,0143,211,734,7,741,899,0,0,0,0,0,0,0,66.31 ,82.42 ,66.31 
03,007,01,005,0143,212,758,10,768,987,0,0,0,0,0,0,0,66.31 ,77.81 ,66.31 
03,007,01,005,0144,213,1037,19,1056,1271,0,0,0,0,0,0,0,66.31 ,83.08 ,66.31 
03,007,01,005,0145,214,985,9,994,1205,0,0,0,0,0,0,0,66.31 ,82.49 ,66.31 
03,007,01,005,0146,215,767,9,776,920,0,0,0,0,0,0,0,66.31 ,84.35 ,66.31 
03,007,01,005,0146,216,701,9,710,886,0,0,0,0,0,0,0,66.31 ,80.14 ,66.31 
03,007,01,005,0147,217,717,12,729,901,0,0,0,0,0,0,0,66.31 ,80.91 ,66.31 
03,007,01,005,0147,218,505,7,512,640,0,0,0,0,0,0,0,66.31 ,80.00 ,66.31 
03,007,01,005,0148,219,623,3,626,800,0,0,0,0,0,0,0,66.31 ,78.25 ,66.31 
03,007,01,005,0148,220,811,4,815,1010,0,0,0,0,0,0,0,66.31 ,80.69 ,66.31 
03,007,01,005,0149,221,761,12,773,997,0,0,0,0,0,0,0,66.31 ,77.53 ,66.31 
03,007,01,005,0150,222,760,1,761,998,0,0,0,0,0,0,0,66.31 ,76.25 ,66.31 
03,007,01,005,0151,223,738,14,752,947,0,0,0,0,0,0,0,66.31 ,79.41 ,66.31 
03,007,01,005,0151,224,697,15,712,951,0,0,0,0,0,0,0,66.31 ,74.87 ,66.31 
03,007,01,005,0152,225,627,11,638,807,0,0,0,0,0,0,0,66.31 ,79.06 ,66.31 
03,007,01,005,0152,226,664,9,673,866,0,0,0,0,0,0,0,66.31 ,77.71 ,66.31 
03,007,01,005,0153,227,718,9,727,861,0,0,0,0,0,0,0,66.31 ,84.44 ,66.31 
03,007,01,005,0153,228,848,9,857,1040,0,0,0,0,0,0,0,66.31 ,82.40 ,66.31 
03,007,01,005,0154,229,848,11,859,1075,0,0,0,0,0,0,0,66.31 ,79.91 ,66.31 
03,007,01,005,0155,230,933,11,944,1199,0,0,0,0,0,0,0,66.31 ,78.73 ,66.31 
03,007,01,005,0156,231,1084,23,1107,1427,0,0,0,0,0,0,0,66.31 ,77.58 ,66.31 
03,007,01,005,0156,232,834,5,839,1061,0,0,0,0,0,0,0,66.31 ,79.08 ,66.31 
03,007,01,005,0157,233,727,5,732,920,0,0,0,0,0,0,0,66.31 ,79.57 ,66.31 
03,007,01,005,0157,234,748,13,761,974,0,0,0,0,0,0,0,66.31 ,78.13 ,66.31 
03,007,01,006,0158,235,747,8,755,920,0,0,0,0,0,0,0,66.31 ,82.07 ,66.31 
03,007,01,006,0158,236,462,3,465,556,0,0,0,0,0,0,0,66.31 ,83.63 ,66.31 
03,007,01,006,0159,237,1062,22,1084,1364,0,0,0,0,0,0,0,66.31 ,79.47 ,66.31 
03,007,01,006,0160,238,875,16,891,1073,0,0,0,0,0,0,0,66.31 ,83.04 ,66.31 
03,007,01,006,0160,239,572,9,581,748,0,0,0,0,0,0,0,66.31 ,77.67 ,66.31 
03,007,01,006,0161,240,904,12,916,1083,0,0,0,0,0,0,0,66.31 ,84.58 ,66.31 
03,007,01,006,0162,241,667,7,674,800,0,0,0,0,0,0,0,66.31 ,84.25 ,66.31 
03,007,01,006,0162,242,605,5,610,730,0,0,0,0,0,0,0,66.31 ,83.56 ,66.31 
03,007,01,006,0163,243,843,14,857,1106,0,0,0,0,0,0,0,66.31 ,77.49 ,66.31 
03,007,01,006,0163,244,631,14,645,775,0,0,0,0,0,0,0,66.31 ,83.23 ,66.31 
03,007,01,006,0163,245,832,15,847,1036,0,0,0,0,0,0,0,66.31 ,81.76 ,66.31 
03,007,01,006,0164,246,1120,16,1136,1377,0,0,0,0,0,0,0,66.31 ,82.50 ,66.31 
03,007,01,006,0164,247,851,17,868,1009,0,0,0,0,0,0,0,66.31 ,86.03 ,66.31 
03,007,01,006,0165,248,868,11,879,1028,0,0,0,0,0,0,0,66.31 ,85.51 ,66.31 
03,007,01,006,0165,249,623,9,632,768,0,0,0,0,0,0,0,66.31 ,82.29 ,66.31 
03,007,01,006,0166,250,849,21,870,1052,0,0,0,0,0,0,0,66.31 ,82.70 ,66.31 
03,007,01,006,0167,251,1072,25,1097,1365,0,0,0,0,0,0,0,66.31 ,80.37 ,66.31 
03,007,01,006,0167,252,1208,16,1224,1529,0,0,0,0,0,0,0,66.31 ,80.05 ,66.31 
03,007,01,006,0168,253,486,8,494,580,0,0,0,0,0,0,0,66.31 ,85.17 ,66.31 
03,007,01,006,0168,254,808,20,828,1004,0,0,0,0,0,0,0,66.31 ,82.47 ,66.31 
03,007,01,006,0169,255,975,18,993,1192,0,0,0,0,0,0,0,66.31 ,83.31 ,66.31 
03,007,01,006,0170,256,1080,13,1093,1319,0,0,0,0,0,0,0,66.31 ,82.87 ,66.31 
03,007,01,006,0171,257,928,12,940,1080,0,0,0,0,0,0,0,66.31 ,87.04 ,66.31 
03,007,01,006,0171,258,543,6,549,674,0,0,0,0,0,0,0,66.31 ,81.45 ,66.31 
03,007,01,007,0172,259,1232,25,1257,1565,0,0,0,0,0,0,0,66.31 ,80.32 ,66.31 
03,007,01,007,0172,260,1421,21,1442,1818,0,0,0,0,0,0,0,66.31 ,79.32 ,66.31 
03,007,01,007,0173,261,1292,28,1320,1655,0,0,0,0,0,0,0,66.31 ,79.76 ,66.31 
03,007,01,007,0173,262,984,21,1005,1366,0,0,0,0,0,0,0,66.31 ,73.57 ,66.31 
03,007,01,007,0174,263,398,2,400,453,0,0,0,0,0,0,0,66.31 ,88.30 ,66.31 
03,007,01,007,0175,264,951,21,972,1264,0,0,0,0,0,0,0,66.31 ,76.90 ,66.31 
03,007,01,007,0176,265,1064,10,1074,1391,0,0,0,0,0,0,0,66.31 ,77.21 ,66.31 
03,007,01,007,0176,266,1182,24,1206,1537,0,0,0,0,0,0,0,66.31 ,78.46 ,66.31 
03,007,01,007,0177,267,649,10,659,847,0,0,0,0,0,0,0,66.31 ,77.80 ,66.31 
03,007,01,007,0177,268,874,11,885,1123,0,0,0,0,0,0,0,66.31 ,78.81 ,66.31 
03,007,01,007,0178,269,951,18,969,1141,0,0,0,0,0,0,0,66.31 ,84.93 ,66.31 
03,007,01,007,0179,270,623,12,635,735,0,0,0,0,0,0,0,66.31 ,86.39 ,66.31 
03,007,01,007,0180,271,402,4,406,503,0,0,0,0,0,0,0,66.31 ,80.72 ,66.31 
03,007,01,007,0180,272,821,9,830,1011,0,0,0,0,0,0,0,66.31 ,82.10 ,66.31 
03,007,01,007,0181,273,850,12,862,1041,0,0,0,0,0,0,0,66.31 ,82.80 ,66.31 
03,007,01,007,0181,274,895,11,906,1097,0,0,0,0,0,0,0,66.31 ,82.59 ,66.31 
03,007,01,007,0182,275,1012,8,1020,1191,0,0,0,0,0,0,0,66.31 ,85.64 ,66.31 
03,007,01,007,0183,276,1186,19,1205,1461,0,0,0,0,0,0,0,66.31 ,82.48 ,66.31 
03,007,01,007,0184,277,1159,16,1175,1411,0,0,0,0,0,0,0,66.31 ,83.27 ,66.31 
03,007,01,007,0185,278,963,15,978,1166,0,0,0,0,0,0,0,66.31 ,83.88 ,66.31 
03,007,01,007,0186,279,1269,18,1287,1606,0,0,0,0,0,0,0,66.31 ,80.14 ,66.31 
03,007,01,007,0186,280,1322,28,1350,1677,0,0,0,0,0,0,0,66.31 ,80.50 ,66.31 
03,007,01,007,0186,281,850,10,860,1130,0,0,0,0,0,0,0,66.31 ,76.11 ,66.31 
03,007,01,007,0187,282,1061,20,1081,1377,0,0,0,0,0,0,0,66.31 ,78.50 ,66.31 
03,007,01,007,0188,283,1088,25,1113,1472,0,0,0,0,0,0,0,66.31 ,75.61 ,66.31 
03,007,01,007,0189,284,853,15,868,1083,0,0,0,0,0,0,0,66.31 ,80.15 ,66.31 
03,007,01,007,0189,285,767,19,786,1035,0,0,0,0,0,0,0,66.31 ,75.94 ,66.31 
03,007,01,007,0190,286,1013,25,1038,1252,0,0,0,0,0,0,0,66.31 ,82.91 ,66.31 
03,007,01,007,0190,287,972,22,994,1218,0,0,0,0,0,0,0,66.31 ,81.61 ,66.31 
03,007,01,007,0191,288,637,6,643,726,0,0,0,0,0,0,0,66.31 ,88.57 ,66.31 
03,007,01,007,0192,289,858,23,881,1104,0,0,0,0,0,0,0,66.31 ,79.80 ,66.31 
03,007,01,007,0192,290,761,15,776,963,0,0,0,0,0,0,0,66.31 ,80.58 ,66.31 
03,007,01,007,0193,291,822,20,842,1013,0,0,0,0,0,0,0,66.31 ,83.12 ,66.31 
03,007,01,007,0193,292,784,20,804,968,0,0,0,0,0,0,0,66.31 ,83.06 ,66.31 
03,007,01,007,0194,293,809,11,820,1035,0,0,0,0,0,0,0,66.31 ,79.23 ,66.31 
03,007,01,007,0195,294,761,17,778,958,0,0,0,0,0,0,0,66.31 ,81.21 ,66.31 
03,007,01,007,0195,295,1099,27,1126,1419,0,0,0,0,0,0,0,66.31 ,79.35 ,66.31 
03,007,01,007,0196,296,1022,13,1035,1351,0,0,0,0,0,0,0,66.31 ,76.61 ,66.31 
03,007,01,007,0197,297,1308,23,1331,1578,0,0,0,0,0,0,0,66.31 ,84.35 ,66.31 
03,007,01,007,0198,298,697,12,709,832,0,0,0,0,0,0,0,66.31 ,85.22 ,66.31 
03,007,01,007,0199,299,931,10,941,1210,0,0,0,0,0,0,0,66.31 ,77.77 ,66.31 
03,007,01,007,0200,300,1328,24,1352,1655,0,0,0,0,0,0,0,66.31 ,81.69 ,66.31 
03,007,01,007,0201,301,1199,29,1228,1500,0,0,0,0,0,0,0,66.31 ,81.87 ,66.31 
03,007,01,007,0201,302,917,11,928,1156,0,0,0,0,0,0,0,66.31 ,80.28 ,66.31 
03,007,01,007,0202,303,557,5,562,669,0,0,0,0,0,0,0,66.31 ,84.01 ,66.31 
03,007,01,007,0202,304,736,11,747,888,0,0,0,0,0,0,0,66.31 ,84.12 ,66.31 
03,007,01,008,0203,305,1434,21,1455,1767,0,0,0,0,0,0,0,66.31 ,82.34 ,66.31 
03,007,01,008,0204,306,859,17,876,1080,0,0,0,0,0,0,0,66.31 ,81.11 ,66.31 
03,007,01,008,0205,307,1313,20,1333,1720,0,0,0,0,0,0,0,66.31 ,77.50 ,66.31 
03,007,01,008,0206,308,910,9,919,1109,0,0,0,0,0,0,0,66.31 ,82.87 ,66.31 
03,007,01,008,0207,309,755,16,771,956,0,0,0,0,0,0,0,66.31 ,80.65 ,66.31 
03,007,01,008,0208,310,1211,16,1227,1520,0,0,0,0,0,0,0,66.31 ,80.72 ,66.31 
03,007,01,008,0209,311,1552,24,1576,1938,0,0,0,0,0,0,0,66.31 ,81.32 ,66.31 
03,007,01,008,0210,312,820,17,837,952,0,0,0,0,0,0,0,66.31 ,87.92 ,66.31 
03,007,01,009,0211,313,858,9,867,1117,0,0,0,0,0,0,0,66.31 ,77.62 ,66.31 
03,007,01,009,0211,314,928,14,942,1214,0,0,0,0,0,0,0,66.31 ,77.59 ,66.31 
03,007,01,009,0211,315,996,12,1008,1337,0,0,0,0,0,0,0,66.31 ,75.39 ,66.31 
03,007,01,009,0212,316,1127,20,1147,1396,0,0,0,0,0,0,0,66.31 ,82.16 ,66.31 
03,007,01,009,0213,317,924,10,934,1127,0,0,0,0,0,0,0,66.31 ,82.87 ,66.31 
03,007,01,009,0214,318,1254,12,1266,1480,0,0,0,0,0,0,0,66.31 ,85.54 ,66.31 
03,007,01,009,0215,319,1074,12,1086,1330,0,0,0,0,0,0,0,66.31 ,81.65 ,66.31 
03,007,01,009,0216,320,1157,19,1176,1461,0,0,0,0,0,0,0,66.31 ,80.49 ,66.31 
03,007,01,009,0217,321,1432,24,1456,1867,0,0,0,0,0,0,0,66.31 ,77.99 ,66.31 
03,007,01,009,0218,322,1153,15,1168,1462,0,0,0,0,0,0,0,66.31 ,79.89 ,66.31 
03,007,01,009,0219,323,810,17,827,1016,0,0,0,0,0,0,0,66.31 ,81.40 ,66.31 
03,007,01,009,0220,324,1126,16,1142,1428,0,0,0,0,0,0,0,66.31 ,79.97 ,66.31 
03,007,01,009,0221,325,853,6,859,1085,0,0,0,0,0,0,0,66.31 ,79.17 ,66.31 
03,007,01,009,0222,326,651,5,656,785,0,0,0,0,0,0,0,66.31 ,83.57 ,66.31 
03,007,01,009,0223,327,1260,17,1277,1542,0,0,0,0,0,0,0,66.31 ,82.81 ,66.31 
03,007,01,009,0224,328,1408,13,1421,1740,0,0,0,0,0,0,0,66.31 ,81.67 ,66.31 
03,007,01,010,0225,329,792,10,802,1069,0,0,0,0,0,0,0,66.31 ,75.02 ,66.31 
03,007,01,010,0226,330,704,11,715,1029,0,0,0,0,0,0,0,66.31 ,69.48 ,66.31 
03,007,01,010,0226,331,1050,23,1073,1454,0,0,0,0,0,0,0,66.31 ,73.80 ,66.31 
03,007,01,010,0227,332,790,12,802,1146,0,0,0,0,0,0,0,66.31 ,69.98 ,66.31 
03,007,01,010,0227,333,949,11,960,1543,0,0,0,0,0,0,0,66.31 ,62.22 ,66.31 
03,007,01,010,0228,334,790,5,795,1128,0,0,0,0,0,0,0,66.31 ,70.48 ,66.31 
03,007,01,010,0228,335,1079,22,1101,1539,0,0,0,0,0,0,0,66.31 ,71.54 ,66.31 
03,007,01,010,0229,336,615,8,623,809,0,0,0,0,0,0,0,66.31 ,77.01 ,66.31 
03,007,01,010,0230,337,721,11,732,1052,0,0,0,0,0,0,0,66.31 ,69.58 ,66.31 
03,007,01,010,0230,338,1048,15,1063,1459,0,0,0,0,0,0,0,66.31 ,72.86 ,66.31 
03,007,01,010,0231,339,743,6,749,968,0,0,0,0,0,0,0,66.31 ,77.38 ,66.31 
03,007,01,010,0232,340,563,9,572,780,0,0,0,0,0,0,0,66.31 ,73.33 ,66.31 
03,007,01,010,0233,341,689,16,705,892,0,0,0,0,0,0,0,66.31 ,79.04 ,66.31 
03,007,01,010,0233,342,607,13,620,864,0,0,0,0,0,0,0,66.31 ,71.76 ,66.31 
03,007,01,010,0234,343,885,17,902,1316,0,0,0,0,0,0,0,66.31 ,68.54 ,66.31 
03,007,01,010,0234,344,865,6,871,1234,0,0,0,0,0,0,0,66.31 ,70.58 ,66.31 
03,007,01,010,0234,345,961,23,984,1318,0,0,0,0,0,0,0,66.31 ,74.66 ,66.31 
03,007,01,010,0235,346,709,15,724,1007,0,0,0,0,0,0,0,66.31 ,71.90 ,66.31 
03,007,01,010,0235,347,826,20,846,1223,0,0,0,0,0,0,0,66.31 ,69.17 ,66.31 
03,007,01,010,0236,348,721,17,738,1011,0,0,0,0,0,0,0,66.31 ,73.00 ,66.31 
03,007,01,010,0236,349,1128,15,1143,1560,0,0,0,0,0,0,0,66.31 ,73.27 ,66.31 
03,007,01,010,0236,350,692,11,703,975,0,0,0,0,0,0,0,66.31 ,72.10 ,66.31 
03,007,01,010,0237,351,613,8,621,832,0,0,0,0,0,0,0,66.31 ,74.64 ,66.31 
03,007,01,010,0237,352,671,13,684,986,0,0,0,0,0,0,0,66.31 ,69.37 ,66.31 
03,007,01,010,0237,353,948,15,963,1292,0,0,0,0,0,0,0,66.31 ,74.54 ,66.31 
03,007,01,010,0238,354,1012,19,1031,1422,0,0,0,0,0,0,0,66.31 ,72.50 ,66.31 
03,007,01,010,0238,355,927,16,943,1252,0,0,0,0,0,0,0,66.31 ,75.32 ,66.31 
03,007,01,010,0238,356,877,10,887,1206,0,0,0,0,0,0,0,66.31 ,73.55 ,66.31 
03,007,01,010,0239,357,1049,17,1066,1331,0,0,0,0,0,0,0,66.31 ,80.09 ,66.31 
03,007,01,010,0240,358,1243,11,1254,1598,0,0,0,0,0,0,0,66.31 ,78.47 ,66.31 
03,007,01,010,0241,359,721,18,739,1068,0,0,0,0,0,0,0,66.31 ,69.19 ,66.31 
03,007,01,010,0241,360,892,10,902,1259,0,0,0,0,0,0,0,66.31 ,71.64 ,66.31 
03,007,01,010,0241,361,821,9,830,1161,0,0,0,0,0,0,0,66.31 ,71.49 ,66.31 
03,007,01,010,0241,362,921,15,936,1388,0,0,0,0,0,0,0,66.31 ,67.44 ,66.31 
03,007,01,010,0242,363,941,15,956,1343,0,0,0,0,0,0,0,66.31 ,71.18 ,66.31 
03,007,01,010,0242,364,986,14,1000,1382,0,0,0,0,0,0,0,66.31 ,72.36 ,66.31 
03,007,01,010,0242,365,1173,19,1192,1683,0,0,0,0,0,0,0,66.31 ,70.83 ,66.31 
03,007,01,010,0243,366,761,19,780,1104,0,0,0,0,0,0,0,66.31 ,70.65 ,66.31 
03,007,01,010,0243,367,903,13,916,1260,0,0,0,0,0,0,0,66.31 ,72.70 ,66.31 
03,007,01,010,0244,368,760,13,773,1097,0,0,0,0,0,0,0,66.31 ,70.46 ,66.31 
03,007,01,010,0244,369,662,13,675,994,0,0,0,0,0,0,0,66.31 ,67.91 ,66.31 
03,007,01,010,0245,370,604,4,608,856,0,0,0,0,0,0,0,66.31 ,71.03 ,66.31 
03,007,01,010,0245,371,655,9,664,929,0,0,0,0,0,0,0,66.31 ,71.47 ,66.31 
03,007,01,010,0246,372,672,11,683,996,0,0,0,0,0,0,0,66.31 ,68.57 ,66.31 
03,007,01,010,0246,373,577,9,586,819,0,0,0,0,0,0,0,66.31 ,71.55 ,66.31 
03,007,01,010,0247,374,1017,18,1035,1370,0,0,0,0,0,0,0,66.31 ,75.55 ,66.31 
03,007,01,010,0248,375,664,9,673,886,0,0,0,0,0,0,0,66.31 ,75.96 ,66.31 
03,007,01,010,0248,376,709,9,718,955,0,0,0,0,0,0,0,66.31 ,75.18 ,66.31 
03,007,01,010,0249,377,784,19,803,1024,0,0,0,0,0,0,0,66.31 ,78.42 ,66.31 
03,007,01,010,0249,378,819,12,831,1192,0,0,0,0,0,0,0,66.31 ,69.71 ,66.31 
03,007,01,010,0250,379,725,15,740,996,0,0,0,0,0,0,0,66.31 ,74.30 ,66.31 
03,007,01,010,0250,380,607,13,620,827,0,0,0,0,0,0,0,66.31 ,74.97 ,66.31 
03,007,01,010,0251,381,721,16,737,1016,0,0,0,0,0,0,0,66.31 ,72.54 ,66.31 
03,007,01,010,0251,382,546,7,553,761,0,0,0,0,0,0,0,66.31 ,72.67 ,66.31 
03,007,01,010,0251,383,653,15,668,905,0,0,0,0,0,0,0,66.31 ,73.81 ,66.31 
03,007,01,010,0252,384,759,15,774,1038,0,0,0,0,0,0,0,66.31 ,74.57 ,66.31 
03,007,01,010,0252,385,827,16,843,1086,0,0,0,0,0,0,0,66.31 ,77.62 ,66.31 
03,007,01,010,0253,386,721,10,731,1000,0,0,0,0,0,0,0,66.31 ,73.10 ,66.31 
03,007,01,010,0253,387,733,11,744,966,0,0,0,0,0,0,0,66.31 ,77.02 ,66.31 
03,007,01,010,0254,388,652,13,665,894,0,0,0,0,0,0,0,66.31 ,74.38 ,66.31 
03,007,01,010,0254,389,813,18,831,1165,0,0,0,0,0,0,0,66.31 ,71.33 ,66.31 
03,007,01,010,0255,390,1157,29,1186,1593,0,0,0,0,0,0,0,66.31 ,74.45 ,66.31 
03,007,01,010,0256,391,962,11,973,1285,0,0,0,0,0,0,0,66.31 ,75.72 ,66.31 
03,007,01,010,0257,392,537,13,550,743,0,0,0,0,0,0,0,66.31 ,74.02 ,66.31 
03,007,01,010,0258,393,706,11,717,911,0,0,0,0,0,0,0,66.31 ,78.70 ,66.31 
03,007,01,010,0258,394,650,9,659,820,0,0,0,0,0,0,0,66.31 ,80.37 ,66.31 
03,007,01,010,0259,395,782,18,800,1057,0,0,0,0,0,0,0,66.31 ,75.69 ,66.31 
03,007,01,010,0259,396,601,11,612,859,0,0,0,0,0,0,0,66.31 ,71.25 ,66.31 
03,007,01,010,0260,397,1071,11,1082,1470,0,0,0,0,0,0,0,66.31 ,73.61 ,66.31 
03,007,01,010,0261,398,1127,23,1150,1604,0,0,0,0,0,0,0,66.31 ,71.70 ,66.31 
03,007,01,010,0262,399,1008,14,1022,1342,0,0,0,0,0,0,0,66.31 ,76.15 ,66.31 
03,007,01,010,0263,400,781,18,799,992,0,0,0,0,0,0,0,66.31 ,80.54 ,66.31 
03,007,01,010,0263,401,679,20,699,898,0,0,0,0,0,0,0,66.31 ,77.84 ,66.31 
03,007,01,011,0264,402,1287,26,1313,1728,0,0,0,0,0,0,0,66.31 ,75.98 ,66.31 
03,007,01,011,0265,403,1243,19,1262,1501,0,0,0,0,0,0,0,66.31 ,84.08 ,66.31 
03,007,01,011,0266,404,673,5,678,838,0,0,0,0,0,0,0,66.31 ,80.91 ,66.31 
03,007,01,011,0267,405,960,11,971,1214,0,0,0,0,0,0,0,66.31 ,79.98 ,66.31 
03,007,01,011,0268,406,935,8,943,1192,0,0,0,0,0,0,0,66.31 ,79.11 ,66.31 
03,007,01,011,0269,407,1120,8,1128,1420,0,0,0,0,0,0,0,66.31 ,79.44 ,66.31 
03,007,01,011,0270,408,791,17,808,1087,0,0,0,0,0,0,0,66.31 ,74.33 ,66.31 
03,007,01,011,0271,409,813,16,829,1078,0,0,0,0,0,0,0,66.31 ,76.90 ,66.31 
03,007,01,011,0272,410,1453,28,1481,1950,0,0,0,0,0,0,0,66.31 ,75.95 ,66.31 
03,007,01,011,0273,411,1142,4,1146,1395,0,0,0,0,0,0,0,66.31 ,82.15 ,66.31 
03,007,01,011,0274,412,1287,14,1301,1725,0,0,0,0,0,0,0,66.31 ,75.42 ,66.31 
03,007,01,011,0275,413,893,15,908,1127,0,0,0,0,0,0,0,66.31 ,80.57 ,66.31 
03,007,01,011,0276,414,1020,11,1031,1343,0,0,0,0,0,0,0,66.31 ,76.77 ,66.31 
03,007,01,011,0276,415,735,14,749,986,0,0,0,0,0,0,0,66.31 ,75.96 ,66.31 
03,007,01,011,0277,416,1212,20,1232,1572,0,0,0,0,0,0,0,66.31 ,78.37 ,66.31 
03,007,01,011,0278,417,1219,26,1245,1624,0,0,0,0,0,0,0,66.31 ,76.66 ,66.31 
03,007,01,011,0279,418,1413,26,1439,1861,0,0,0,0,0,0,0,66.31 ,77.32 ,66.31 
03,007,01,012,0280,419,642,10,652,800,0,0,0,0,0,0,0,66.31 ,81.50 ,66.31 
03,007,01,012,0281,420,983,19,1002,1352,0,0,0,0,0,0,0,66.31 ,74.11 ,66.31 
03,007,01,012,0282,421,1208,26,1234,1673,0,0,0,0,0,0,0,66.31 ,73.76 ,66.31 
03,007,01,012,0283,422,1196,22,1218,1630,0,0,0,0,0,0,0,66.31 ,74.72 ,66.31 
03,007,01,012,0284,423,1145,29,1174,1563,0,0,0,0,0,0,0,66.31 ,75.11 ,66.31 
03,007,01,012,0285,424,902,19,921,1221,0,0,0,0,0,0,0,66.31 ,75.43 ,66.31 
03,007,01,012,0286,425,655,12,667,853,0,0,0,0,0,0,0,66.31 ,78.19 ,66.31 
03,007,01,012,0287,426,589,7,596,778,0,0,0,0,0,0,0,66.31 ,76.61 ,66.31 
03,007,01,012,0288,427,1343,23,1366,1868,0,0,0,0,0,0,0,66.31 ,73.13 ,66.31 
03,007,01,012,0289,428,921,19,940,1210,0,0,0,0,0,0,0,66.31 ,77.69 ,66.31 
03,007,01,012,0290,429,786,14,800,1000,0,0,0,0,0,0,0,66.31 ,80.00 ,66.31 
03,007,01,012,0291,430,1068,22,1090,1368,0,0,0,0,0,0,0,66.31 ,79.68 ,66.31 
03,007,01,012,0292,431,1139,26,1165,1489,0,0,0,0,0,0,0,66.31 ,78.24 ,66.31 
03,007,01,012,0293,432,1128,11,1139,1420,0,0,0,0,0,0,0,66.31 ,80.21 ,66.31 
03,007,01,012,0294,433,818,26,844,1081,0,0,0,0,0,0,0,66.31 ,78.08 ,66.31 
03,007,01,012,0295,434,609,22,631,857,0,0,0,0,0,0,0,66.31 ,73.63 ,66.31 
03,007,01,012,0296,435,471,4,475,620,0,0,0,0,0,0,0,66.31 ,76.61 ,66.31 
03,007,01,012,0297,436,555,13,568,723,0,0,0,0,0,0,0,66.31 ,78.56 ,66.31 
03,007,01,012,0298,437,480,11,491,617,0,0,0,0,0,0,0,66.31 ,79.58 ,66.31 
03,007,01,012,0299,438,687,9,696,909,0,0,0,0,0,0,0,66.31 ,76.57 ,66.31 
03,007,01,012,0300,439,641,11,652,828,0,0,0,0,0,0,0,66.31 ,78.74 ,66.31 
03,007,01,012,0301,440,520,11,531,678,0,0,0,0,0,0,0,66.31 ,78.32 ,66.31 
03,007,01,012,0302,441,886,26,912,1137,0,0,0,0,0,0,0,66.31 ,80.21 ,66.31 
03,007,01,012,0303,442,1010,11,1021,1340,0,0,0,0,0,0,0,66.31 ,76.19 ,66.31 
03,007,01,013,0304,443,922,12,934,1149,0,0,0,0,0,0,0,66.31 ,81.29 ,66.31 
03,007,01,013,0305,444,568,6,574,736,0,0,0,0,0,0,0,66.31 ,77.99 ,66.31 
03,007,01,013,0306,445,941,18,959,1244,0,0,0,0,0,0,0,66.31 ,77.09 ,66.31 
03,007,01,013,0307,446,411,4,415,525,0,0,0,0,0,0,0,66.31 ,79.05 ,66.31 
03,007,01,013,0308,447,963,6,969,1291,0,0,0,0,0,0,0,66.31 ,75.06 ,66.31 
03,007,01,013,0308,448,989,11,1000,1342,0,0,0,0,0,0,0,66.31 ,74.52 ,66.31 
03,007,01,013,0309,449,1320,11,1331,1684,0,0,0,0,0,0,0,66.31 ,79.04 ,66.31 
03,007,01,013,0310,450,677,7,684,918,0,0,0,0,0,0,0,66.31 ,74.51 ,66.31 
03,007,01,013,0310,451,680,10,690,902,0,0,0,0,0,0,0,66.31 ,76.50 ,66.31 
03,007,01,013,0311,452,952,17,969,1197,0,0,0,0,0,0,0,66.31 ,80.95 ,66.31 
03,007,01,013,0312,453,888,9,897,1072,0,0,0,0,0,0,0,66.31 ,83.68 ,66.31 
03,007,01,013,0312,454,643,9,652,829,0,0,0,0,0,0,0,66.31 ,78.65 ,66.31 
03,007,01,013,0313,455,768,14,782,1012,0,0,0,0,0,0,0,66.31 ,77.27 ,66.31 
03,007,01,013,0313,456,832,8,840,1092,0,0,0,0,0,0,0,66.31 ,76.92 ,66.31 
03,007,01,013,0314,457,1332,12,1344,1747,0,0,0,0,0,0,0,66.31 ,76.93 ,66.31 
03,007,01,013,0315,458,610,1,611,732,0,0,0,0,0,0,0,66.31 ,83.47 ,66.31 
03,007,01,013,0316,459,1206,19,1225,1515,0,0,0,0,0,0,0,66.31 ,80.86 ,66.31 
03,007,01,013,0317,460,879,12,891,1098,0,0,0,0,0,0,0,66.31 ,81.15 ,66.31 
03,007,01,013,0317,461,833,14,847,1064,0,0,0,0,0,0,0,66.31 ,79.61 ,66.31 
03,007,01,013,0318,462,605,3,608,730,0,0,0,0,0,0,0,66.31 ,83.29 ,66.31 
03,007,01,013,0319,463,910,21,931,1160,0,0,0,0,0,0,0,66.31 ,80.26 ,66.31 
03,007,01,013,0320,464,1026,22,1048,1352,0,0,0,0,0,0,0,66.31 ,77.51 ,66.31 
03,007,01,013,0321,465,1263,20,1283,1632,0,0,0,0,0,0,0,66.31 ,78.62 ,66.31 
03,007,01,013,0321,466,1266,19,1285,1632,0,0,0,0,0,0,0,66.31 ,78.74 ,66.31 
03,007,01,013,0322,467,501,14,515,647,0,0,0,0,0,0,0,66.31 ,79.60 ,66.31 
03,007,01,013,0323,468,915,13,928,1107,0,0,0,0,0,0,0,66.31 ,83.83 ,66.31 
03,007,01,013,0324,469,560,4,564,679,0,0,0,0,0,0,0,66.31 ,83.06 ,66.31 
03,007,01,013,0325,470,901,12,913,1140,0,0,0,0,0,0,0,66.31 ,80.09 ,66.31 
03,007,01,013,0326,471,1007,12,1019,1338,0,0,0,0,0,0,0,66.31 ,76.16 ,66.31 
03,007,01,013,0327,472,598,8,606,751,0,0,0,0,0,0,0,66.31 ,80.69 ,66.31 
03,007,01,013,0327,473,749,9,758,974,0,0,0,0,0,0,0,66.31 ,77.82 ,66.31 
03,007,01,013,0328,474,1049,14,1063,1423,0,0,0,0,0,0,0,66.31 ,74.70 ,66.31 
03,007,01,014,0329,475,1127,24,1151,1410,0,0,0,0,0,0,0,66.31 ,81.63 ,66.31 
03,007,01,014,0330,476,1069,22,1091,1362,0,0,0,0,0,0,0,66.31 ,80.10 ,66.31 
03,007,01,014,0331,477,904,9,913,1070,0,0,0,0,0,0,0,66.31 ,85.33 ,66.31 
03,007,01,014,0332,478,633,6,639,758,0,0,0,0,0,0,0,66.31 ,84.30 ,66.31 
03,007,01,014,0333,479,1286,21,1307,1536,0,0,0,0,0,0,0,66.31 ,85.09 ,66.31 
03,007,01,014,0334,480,761,4,765,896,0,0,0,0,0,0,0,66.31 ,85.38 ,66.31 
03,007,01,014,0335,481,918,16,934,1201,0,0,0,0,0,0,0,66.31 ,77.77 ,66.31 
03,007,01,014,0336,482,785,0,785,964,0,0,0,0,0,0,0,66.31 ,81.43 ,66.31 
03,007,01,014,0337,483,542,5,547,668,0,0,0,0,0,0,0,66.31 ,81.89 ,66.31 
03,007,01,014,0338,484,891,12,903,1066,0,0,0,0,0,0,0,66.31 ,84.71 ,66.31 
03,007,01,014,0339,485,964,17,981,1169,0,0,0,0,0,0,0,66.31 ,83.92 ,66.31 
03,007,01,014,0340,486,1534,23,1557,1899,0,0,0,0,0,0,0,66.31 ,81.99 ,66.31 
03,007,01,014,0341,487,1037,7,1044,1212,0,0,0,0,0,0,0,66.31 ,86.14 ,66.31 
03,007,01,014,0342,488,308,0,308,385,0,0,0,0,0,0,0,66.31 ,80.00 ,66.31 
03,007,01,014,0343,489,779,7,786,985,0,0,0,0,0,0,0,66.31 ,79.80 ,66.31 
03,007,01,014,0344,490,628,6,634,743,0,0,0,0,0,0,0,66.31 ,85.33 ,66.31 
03,007,01,014,0345,491,1024,18,1042,1271,0,0,0,0,0,0,0,66.31 ,81.98 ,66.31 
03,007,01,014,0346,492,641,7,648,802,0,0,0,0,0,0,0,66.31 ,80.80 ,66.31 
03,007,01,014,0347,493,1107,13,1120,1420,0,0,0,0,0,0,0,66.31 ,78.87 ,66.31 
03,007,01,014,0348,494,1026,17,1043,1273,0,0,0,0,0,0,0,66.31 ,81.93 ,66.31 
03,007,01,014,0349,495,995,7,1002,1228,0,0,0,0,0,0,0,66.31 ,81.60 ,66.31 
03,007,01,014,0350,496,978,17,995,1225,0,0,0,0,0,0,0,66.31 ,81.22 ,66.31 
03,007,01,015,0351,497,862,9,871,1122,0,0,0,0,0,0,0,66.31 ,77.63 ,66.31 
03,007,01,015,0351,498,860,7,867,1182,0,0,0,0,0,0,0,66.31 ,73.35 ,66.31 
03,007,01,015,0352,499,888,5,893,1171,0,0,0,0,0,0,0,66.31 ,76.26 ,66.31 
03,007,01,015,0353,500,1039,15,1054,1347,0,0,0,0,0,0,0,66.31 ,78.25 ,66.31 
03,007,01,015,0354,501,824,15,839,1036,0,0,0,0,0,0,0,66.31 ,80.98 ,66.31 
03,007,01,015,0355,502,1125,18,1143,1510,0,0,0,0,0,0,0,66.31 ,75.70 ,66.31 
03,007,01,015,0356,503,1147,34,1181,1475,0,0,0,0,0,0,0,66.31 ,80.07 ,66.31 
03,007,01,015,0357,504,978,14,992,1276,0,0,0,0,0,0,0,66.31 ,77.74 ,66.31 
03,007,01,015,0358,505,969,12,981,1348,0,0,0,0,0,0,0,66.31 ,72.77 ,66.31 
03,007,01,015,0359,506,1262,26,1288,1622,0,0,0,0,0,0,0,66.31 ,79.41 ,66.31 
03,007,01,015,0360,507,460,5,465,580,0,0,0,0,0,0,0,66.31 ,80.17 ,66.31 
03,007,01,015,0361,508,700,15,715,925,0,0,0,0,0,0,0,66.31 ,77.30 ,66.31 
03,007,01,015,0362,509,777,16,793,1025,0,0,0,0,0,0,0,66.31 ,77.37 ,66.31 
03,007,01,015,0363,510,519,11,530,689,0,0,0,0,0,0,0,66.31 ,76.92 ,66.31 
03,007,01,015,0364,511,608,10,618,782,0,0,0,0,0,0,0,66.31 ,79.03 ,66.31 
03,007,01,015,0365,512,1111,23,1134,1527,0,0,0,0,0,0,0,66.31 ,74.26 ,66.31 
03,007,01,015,0366,513,983,11,994,1274,0,0,0,0,0,0,0,66.31 ,78.02 ,66.31 
03,007,01,015,0367,514,673,10,683,852,0,0,0,0,0,0,0,66.31 ,80.16 ,66.31 
03,007,01,015,0368,515,899,15,914,1136,0,0,0,0,0,0,0,66.31 ,80.46 ,66.31 
03,007,01,015,0369,516,601,12,613,713,0,0,0,0,0,0,0,66.31 ,85.97 ,66.31 
03,007,01,015,0370,517,668,20,688,842,0,0,0,0,0,0,0,66.31 ,81.71 ,66.31 
03,007,01,016,0371,518,639,10,649,863,0,0,0,0,0,0,0,66.31 ,75.20 ,66.31 
03,007,01,016,0372,519,684,27,711,1034,0,0,0,0,0,0,0,66.31 ,68.76 ,66.31 
03,007,01,016,0372,520,382,19,401,753,0,0,0,0,0,0,0,66.31 ,53.25 ,66.31 
03,007,01,016,0372,521,482,20,502,750,0,0,0,0,0,0,0,66.31 ,66.93 ,66.31 
03,007,01,016,0373,522,450,10,460,627,0,0,0,0,0,0,0,66.31 ,73.37 ,66.31 
03,007,01,016,0374,523,1039,18,1057,1485,0,0,0,0,0,0,0,66.31 ,71.18 ,66.31 
03,007,01,016,0375,524,1026,19,1045,1436,0,0,0,0,0,0,0,66.31 ,72.77 ,66.31 
03,007,01,016,0376,525,857,17,874,1154,0,0,0,0,0,0,0,66.31 ,75.74 ,66.31 
03,007,01,016,0377,526,1137,19,1156,1606,0,0,0,0,0,0,0,66.31 ,71.98 ,66.31 
03,007,01,016,0378,527,491,4,495,642,0,0,0,0,0,0,0,66.31 ,77.10 ,66.31 
03,007,01,016,0379,528,1037,20,1057,1476,0,0,0,0,0,0,0,66.31 ,71.61 ,66.31 
03,007,01,016,0379,529,751,8,759,1053,0,0,0,0,0,0,0,66.31 ,72.08 ,66.31 
03,007,01,016,0380,530,640,6,646,892,0,0,0,0,0,0,0,66.31 ,72.42 ,66.31 
03,007,01,016,0380,531,769,17,786,1082,0,0,0,0,0,0,0,66.31 ,72.64 ,66.31 
03,007,01,016,0381,532,785,10,795,1056,0,0,0,0,0,0,0,66.31 ,75.28 ,66.31 
03,007,01,016,0382,533,911,13,924,1269,0,0,0,0,0,0,0,66.31 ,72.81 ,66.31 
03,007,01,016,0383,534,647,8,655,917,0,0,0,0,0,0,0,66.31 ,71.43 ,66.31 
03,007,01,016,0383,535,785,13,798,1067,0,0,0,0,0,0,0,66.31 ,74.79 ,66.31 
03,007,01,016,0384,536,1327,37,1364,1872,0,0,0,0,0,0,0,66.31 ,72.86 ,66.31 
03,007,01,016,0385,537,1157,31,1188,1592,0,0,0,0,0,0,0,66.31 ,74.62 ,66.31 
03,007,01,016,0386,538,872,13,885,1247,0,0,0,0,0,0,0,66.31 ,70.97 ,66.31 
03,007,01,016,0387,539,1070,24,1094,1469,0,0,0,0,0,0,0,66.31 ,74.47 ,66.31 
03,007,01,016,0388,540,1094,24,1118,1548,0,0,0,0,0,0,0,66.31 ,72.22 ,66.31 
03,007,01,016,0388,541,993,16,1009,1465,0,0,0,0,0,0,0,66.31 ,68.87 ,66.31 
03,007,01,016,0389,542,865,18,883,1284,0,0,0,0,0,0,0,66.31 ,68.77 ,66.31 
03,007,01,016,0390,543,1039,22,1061,1433,0,0,0,0,0,0,0,66.31 ,74.04 ,66.31 
03,007,01,016,0391,544,684,17,701,908,0,0,0,0,0,0,0,66.31 ,77.20 ,66.31 
03,007,01,016,0392,545,560,10,570,744,0,0,0,0,0,0,0,66.31 ,76.61 ,66.31 
03,007,01,017,0393,546,816,13,829,1157,0,0,0,0,0,0,0,66.31 ,71.65 ,66.31 
03,007,01,017,0393,547,940,13,953,1279,0,0,0,0,0,0,0,66.31 ,74.51 ,66.31 
03,007,01,017,0394,548,737,8,745,946,0,0,0,0,0,0,0,66.31 ,78.75 ,66.31 
03,007,01,017,0394,549,917,17,934,1224,0,0,0,0,0,0,0,66.31 ,76.31 ,66.31 
03,007,01,017,0394,550,780,11,791,1032,0,0,0,0,0,0,0,66.31 ,76.65 ,66.31 
03,007,01,017,0395,551,703,10,713,953,0,0,0,0,0,0,0,66.31 ,74.82 ,66.31 
03,007,01,017,0395,552,948,13,961,1352,0,0,0,0,0,0,0,66.31 ,71.08 ,66.31 
03,007,01,017,0396,553,555,9,564,751,0,0,0,0,0,0,0,66.31 ,75.10 ,66.31 
03,007,01,017,0397,554,735,13,748,938,0,0,0,0,0,0,0,66.31 ,79.74 ,66.31 
03,007,01,017,0398,555,772,19,791,997,0,0,0,0,0,0,0,66.31 ,79.34 ,66.31 
03,007,01,017,0399,556,962,11,973,1283,0,0,0,0,0,0,0,66.31 ,75.84 ,66.31 
03,007,01,017,0400,557,658,13,671,851,0,0,0,0,0,0,0,66.31 ,78.85 ,66.31 
03,007,01,017,0401,558,888,12,900,1214,0,0,0,0,0,0,0,66.31 ,74.14 ,66.31 
03,007,01,017,0402,559,599,7,606,769,0,0,0,0,0,0,0,66.31 ,78.80 ,66.31 
03,007,01,017,0403,560,1311,19,1330,1752,0,0,0,0,0,0,0,66.31 ,75.91 ,66.31 
03,007,01,017,0404,561,1014,24,1038,1337,0,0,0,0,0,0,0,66.31 ,77.64 ,66.31 
03,007,01,017,0405,562,1022,16,1038,1357,0,0,0,0,0,0,0,66.31 ,76.49 ,66.31 
03,007,01,017,0406,563,829,5,834,1028,0,0,0,0,0,0,0,66.31 ,81.13 ,66.31 
03,007,01,017,0407,564,792,19,811,977,0,0,0,0,0,0,0,66.31 ,83.01 ,66.31 
03,007,01,017,0408,565,810,10,820,1025,0,0,0,0,0,0,0,66.31 ,80.00 ,66.31 
03,007,01,017,0409,566,682,11,693,889,0,0,0,0,0,0,0,66.31 ,77.95 ,66.31 
03,007,01,017,0410,567,716,13,729,925,0,0,0,0,0,0,0,66.31 ,78.81 ,66.31 
03,007,01,017,0411,568,482,30,512,668,0,0,0,0,0,0,0,66.31 ,76.65 ,66.31 
03,007,01,017,0412,569,610,9,619,794,0,0,0,0,0,0,0,66.31 ,77.96 ,66.31 
03,007,01,017,0413,570,690,6,696,856,0,0,0,0,0,0,0,66.31 ,81.31 ,66.31 
03,007,01,017,0414,571,583,11,594,763,0,0,0,0,0,0,0,66.31 ,77.85 ,66.31 
03,007,01,017,0415,572,986,20,1006,1287,0,0,0,0,0,0,0,66.31 ,78.17 ,66.31 
03,007,01,017,0416,573,1301,28,1329,1773,0,0,0,0,0,0,0,66.31 ,74.96 ,66.31 
03,007,01,018,0417,574,800,6,806,1039,0,0,0,0,0,0,0,66.31 ,77.57 ,66.31 
03,007,01,018,0418,575,529,7,536,700,0,0,0,0,0,0,0,66.31 ,76.57 ,66.31 
03,007,01,018,0419,576,638,9,647,837,0,0,0,0,0,0,0,66.31 ,77.30 ,66.31 
03,007,01,018,0420,577,786,24,810,1040,0,0,0,0,0,0,0,66.31 ,77.88 ,66.31 
03,007,01,018,0421,578,518,3,521,652,0,0,0,0,0,0,0,66.31 ,79.91 ,66.31 
03,007,01,018,0422,579,543,5,548,692,0,0,0,0,0,0,0,66.31 ,79.19 ,66.31 
03,007,01,018,0423,580,745,13,758,936,0,0,0,0,0,0,0,66.31 ,80.98 ,66.31 
03,007,01,018,0424,581,735,8,743,957,0,0,0,0,0,0,0,66.31 ,77.64 ,66.31 
03,007,01,018,0425,582,701,8,709,877,0,0,0,0,0,0,0,66.31 ,80.84 ,66.31 
03,007,01,018,0426,583,402,3,405,519,0,0,0,0,0,0,0,66.31 ,78.03 ,66.31 
03,007,01,018,0427,584,648,7,655,867,0,0,0,0,0,0,0,66.31 ,75.55 ,66.31 
03,007,01,018,0428,585,646,14,660,859,0,0,0,0,0,0,0,66.31 ,76.83 ,66.31 
03,007,01,018,0429,586,582,5,587,721,0,0,0,0,0,0,0,66.31 ,81.41 ,66.31 
03,007,01,018,0430,587,632,10,642,815,0,0,0,0,0,0,0,66.31 ,78.77 ,66.31 
03,007,01,018,0431,588,625,8,633,792,0,0,0,0,0,0,0,66.31 ,79.92 ,66.31 
03,007,01,018,0432,589,542,5,547,684,0,0,0,0,0,0,0,66.31 ,79.97 ,66.31 
03,007,01,018,0433,590,496,9,505,628,0,0,0,0,0,0,0,66.31 ,80.41 ,66.31 
03,007,01,019,0434,591,810,12,822,1084,0,0,0,0,0,0,0,66.31 ,75.83 ,66.31 
03,007,01,019,0434,592,822,10,832,1090,0,0,0,0,0,0,0,66.31 ,76.33 ,66.31 
03,007,01,019,0435,593,1239,15,1254,1604,0,0,0,0,0,0,0,66.31 ,78.18 ,66.31 
03,007,01,019,0436,594,907,13,920,1173,0,0,0,0,0,0,0,66.31 ,78.43 ,66.31 
03,007,01,019,0436,595,820,5,825,1068,0,0,0,0,0,0,0,66.31 ,77.25 ,66.31 
03,007,01,019,0436,596,995,21,1016,1286,0,0,0,0,0,0,0,66.31 ,79.00 ,66.31 
03,007,01,019,0437,597,1110,13,1123,1515,0,0,0,0,0,0,0,66.31 ,74.13 ,66.31 
03,007,01,019,0438,598,957,10,967,1278,0,0,0,0,0,0,0,66.31 ,75.67 ,66.31 
03,007,01,019,0439,599,630,10,640,817,0,0,0,0,0,0,0,66.31 ,78.34 ,66.31 
03,007,01,019,0440,600,486,7,493,646,0,0,0,0,0,0,0,66.31 ,76.32 ,66.31 
03,007,01,019,0441,601,640,7,647,804,0,0,0,0,0,0,0,66.31 ,80.47 ,66.31 
03,007,01,019,0442,602,987,18,1005,1369,0,0,0,0,0,0,0,66.31 ,73.41 ,66.31 
03,007,01,019,0443,603,1039,10,1049,1299,0,0,0,0,0,0,0,66.31 ,80.75 ,66.31 
03,007,01,019,0444,604,1182,20,1202,1583,0,0,0,0,0,0,0,66.31 ,75.93 ,66.31 
03,007,01,019,0445,605,750,19,769,980,0,0,0,0,0,0,0,66.31 ,78.47 ,66.31 
03,007,01,019,0445,606,745,6,751,1000,0,0,0,0,0,0,0,66.31 ,75.10 ,66.31 
03,007,01,019,0446,607,795,13,808,1058,0,0,0,0,0,0,0,66.31 ,76.37 ,66.31 
03,007,01,019,0447,608,1189,32,1221,1579,0,0,0,0,0,0,0,66.31 ,77.33 ,66.31 
03,007,01,019,0448,609,940,31,971,1343,0,0,0,0,0,0,0,66.31 ,72.30 ,66.31 
03,007,01,020,0449,610,532,16,548,801,0,0,0,0,0,0,0,66.31 ,68.41 ,66.31 
03,007,01,020,0449,611,616,15,631,927,0,0,0,0,0,0,0,66.31 ,68.07 ,66.31 
03,007,01,020,0450,612,460,14,474,652,0,0,0,0,0,0,0,66.31 ,72.70 ,66.31 
03,007,01,020,0451,613,678,4,682,916,0,0,0,0,0,0,0,66.31 ,74.45 ,66.31 
03,007,01,020,0452,614,597,13,610,770,0,0,0,0,0,0,0,66.31 ,79.22 ,66.31 
03,007,01,020,0452,615,637,9,646,849,0,0,0,0,0,0,0,66.31 ,76.09 ,66.31 
03,007,01,020,0453,616,978,24,1002,1283,0,0,0,0,0,0,0,66.31 ,78.10 ,66.31 
03,007,01,020,0454,617,625,4,629,821,0,0,0,0,0,0,0,66.31 ,76.61 ,66.31 
03,007,01,020,0454,618,665,10,675,897,0,0,0,0,0,0,0,66.31 ,75.25 ,66.31 
03,007,01,020,0455,619,955,11,966,1223,0,0,0,0,0,0,0,66.31 ,78.99 ,66.31 
03,007,01,020,0456,620,973,15,988,1375,0,0,0,0,0,0,0,66.31 ,71.85 ,66.31 
03,007,01,020,0457,621,774,12,786,1084,0,0,0,0,0,0,0,66.31 ,72.51 ,66.31 
03,007,01,020,0457,622,667,16,683,901,0,0,0,0,0,0,0,66.31 ,75.80 ,66.31 
03,007,01,020,0458,623,655,18,673,900,0,0,0,0,0,0,0,66.31 ,74.78 ,66.31 
03,007,01,020,0458,624,599,13,612,842,0,0,0,0,0,0,0,66.31 ,72.68 ,66.31 
03,007,01,020,0459,625,675,5,680,923,0,0,0,0,0,0,0,66.31 ,73.67 ,66.31 
03,007,01,020,0459,626,641,14,655,967,0,0,0,0,0,0,0,66.31 ,67.74 ,66.31 
03,007,01,020,0460,627,538,17,555,760,0,0,0,0,0,0,0,66.31 ,73.03 ,66.31 
03,007,01,020,0461,628,808,10,818,1080,0,0,0,0,0,0,0,66.31 ,75.74 ,66.31 
03,007,01,020,0462,629,642,11,653,945,0,0,0,0,0,0,0,66.31 ,69.10 ,66.31 
03,007,01,020,0463,630,508,7,515,749,0,0,0,0,0,0,0,66.31 ,68.76 ,66.31 
03,007,01,020,0464,631,620,12,632,840,0,0,0,0,0,0,0,66.31 ,75.24 ,66.31 
03,007,01,020,0465,632,861,21,882,1163,0,0,0,0,0,0,0,66.31 ,75.84 ,66.31 
03,007,01,020,0466,633,662,8,670,881,0,0,0,0,0,0,0,66.31 ,76.05 ,66.31 
03,007,01,020,0467,634,809,12,821,1171,0,0,0,0,0,0,0,66.31 ,70.11 ,66.31 
03,007,01,021,0468,635,896,12,908,1201,0,0,0,0,0,0,0,66.31 ,75.60 ,66.31 
03,007,01,021,0469,636,495,7,502,628,0,0,0,0,0,0,0,66.31 ,79.94 ,66.31 
03,007,01,021,0470,637,1271,26,1297,1691,0,0,0,0,0,0,0,66.31 ,76.70 ,66.31 
03,007,01,021,0471,638,841,14,855,1094,0,0,0,0,0,0,0,66.31 ,78.15 ,66.31 
03,007,01,021,0472,639,847,14,861,1087,0,0,0,0,0,0,0,66.31 ,79.21 ,66.31 
03,007,01,021,0473,640,779,25,804,1012,0,0,0,0,0,0,0,66.31 ,79.45 ,66.31 
03,007,01,021,0474,641,871,12,883,1120,0,0,0,0,0,0,0,66.31 ,78.84 ,66.31 
03,007,01,021,0475,642,696,12,708,860,0,0,0,0,0,0,0,66.31 ,82.33 ,66.31 
03,007,01,021,0476,643,519,16,535,648,0,0,0,0,0,0,0,66.31 ,82.56 ,66.31 
03,007,01,021,0477,644,635,17,652,842,0,0,0,0,0,0,0,66.31 ,77.43 ,66.31 
03,007,01,021,0478,645,810,12,822,981,0,0,0,0,0,0,0,66.31 ,83.79 ,66.31 
03,007,01,021,0479,646,855,18,873,1168,0,0,0,0,0,0,0,66.31 ,74.74 ,66.31 
03,007,01,021,0480,647,1290,18,1308,1662,0,0,0,0,0,0,0,66.31 ,78.70 ,66.31 
03,007,01,021,0481,648,653,5,658,779,0,0,0,0,0,0,0,66.31 ,84.47 ,66.31 
03,007,01,021,0482,649,647,5,652,839,0,0,0,0,0,0,0,66.31 ,77.71 ,66.31 
03,007,01,021,0483,650,1057,18,1075,1464,0,0,0,0,0,0,0,66.31 ,73.43 ,66.31 
03,007,01,021,0484,651,1130,18,1148,1474,0,0,0,0,0,0,0,66.31 ,77.88 ,66.31 
03,007,01,021,0485,652,253,2,255,315,0,0,0,0,0,0,0,66.31 ,80.95 ,66.31 
03,007,01,021,0486,653,468,5,473,643,0,0,0,0,0,0,0,66.31 ,73.56 ,66.31 
03,007,01,021,0487,654,500,8,508,651,0,0,0,0,0,0,0,66.31 ,78.03 ,66.31 
03,007,01,022,0488,655,701,14,715,943,0,0,0,0,0,0,0,66.31 ,75.82 ,66.31 
03,007,01,022,0488,656,921,34,955,1226,0,0,0,0,0,0,0,66.31 ,77.90 ,66.31 
03,007,01,022,0489,657,1061,34,1095,1442,0,0,0,0,0,0,0,66.31 ,75.94 ,66.31 
03,007,01,022,0490,658,1157,27,1184,1518,0,0,0,0,0,0,0,66.31 ,78.00 ,66.31 
03,007,01,022,0491,659,717,12,729,945,0,0,0,0,0,0,0,66.31 ,77.14 ,66.31 
03,007,01,022,0491,660,827,11,838,1078,0,0,0,0,0,0,0,66.31 ,77.74 ,66.31 
03,007,01,022,0492,661,802,8,810,1085,0,0,0,0,0,0,0,66.31 ,74.65 ,66.31 
03,007,01,022,0493,662,1077,22,1099,1443,0,0,0,0,0,0,0,66.31 ,76.16 ,66.31 
03,007,01,022,0494,663,1075,18,1093,1360,0,0,0,0,0,0,0,66.31 ,80.37 ,66.31 
03,007,01,022,0494,664,1105,25,1130,1461,0,0,0,0,0,0,0,66.31 ,77.34 ,66.31 
03,007,01,022,0495,665,1153,25,1178,1557,0,0,0,0,0,0,0,66.31 ,75.66 ,66.31 
03,007,01,022,0496,666,488,7,495,662,0,0,0,0,0,0,0,66.31 ,74.77 ,66.31 
03,007,01,022,0497,667,463,7,470,601,0,0,0,0,0,0,0,66.31 ,78.20 ,66.31 
03,007,01,022,0498,668,1171,19,1190,1566,0,0,0,0,0,0,0,66.31 ,75.99 ,66.31 
03,007,01,022,0499,669,844,19,863,1173,0,0,0,0,0,0,0,66.31 ,73.57 ,66.31 
03,007,01,022,0500,670,613,7,620,829,0,0,0,0,0,0,0,66.31 ,74.79 ,66.31 
03,007,01,022,0501,671,580,10,590,788,0,0,0,0,0,0,0,66.31 ,74.87 ,66.31 
03,007,01,022,0502,672,891,19,910,1230,0,0,0,0,0,0,0,66.31 ,73.98 ,66.31 
03,007,01,022,0503,673,638,14,652,927,0,0,0,0,0,0,0,66.31 ,70.33 ,66.31 
03,007,01,022,0504,674,702,19,721,961,0,0,0,0,0,0,0,66.31 ,75.03 ,66.31 
03,007,01,023,0505,675,626,5,631,789,0,0,0,0,0,0,0,66.31 ,79.97 ,66.31 
03,007,01,023,0505,676,872,13,885,1203,0,0,0,0,0,0,0,66.31 ,73.57 ,66.31 
03,007,01,023,0506,677,839,16,855,1108,0,0,0,0,0,0,0,66.31 ,77.17 ,66.31 
03,007,01,023,0506,678,1137,15,1152,1502,0,0,0,0,0,0,0,66.31 ,76.70 ,66.31 
03,007,01,023,0507,679,1001,19,1020,1327,0,0,0,0,0,0,0,66.31 ,76.87 ,66.31 
03,007,01,023,0508,680,746,10,756,1022,0,0,0,0,0,0,0,66.31 ,73.97 ,66.31 
03,007,01,023,0508,681,978,19,997,1306,0,0,0,0,0,0,0,66.31 ,76.34 ,66.31 
03,007,01,023,0509,682,1188,12,1200,1607,0,0,0,0,0,0,0,66.31 ,74.67 ,66.31 
03,007,01,023,0510,683,1043,12,1055,1461,0,0,0,0,0,0,0,66.31 ,72.21 ,66.31 
03,007,01,023,0511,684,855,15,870,1218,0,0,0,0,0,0,0,66.31 ,71.43 ,66.31 
03,007,01,023,0512,685,861,14,875,1095,0,0,0,0,0,0,0,66.31 ,79.91 ,66.31 
03,007,01,023,0513,686,851,16,867,1057,0,0,0,0,0,0,0,66.31 ,82.02 ,66.31 
03,007,01,023,0514,687,879,10,889,1181,0,0,0,0,0,0,0,66.31 ,75.28 ,66.31 
03,007,01,023,0515,688,836,19,855,1138,0,0,0,0,0,0,0,66.31 ,75.13 ,66.31 
03,007,01,023,0515,689,809,10,819,1017,0,0,0,0,0,0,0,66.31 ,80.53 ,66.31 
03,007,01,023,0516,690,504,14,518,728,0,0,0,0,0,0,0,66.31 ,71.15 ,66.31 
03,007,01,023,0516,691,982,18,1000,1367,0,0,0,0,0,0,0,66.31 ,73.15 ,66.31 
03,007,01,023,0517,692,945,13,958,1293,0,0,0,0,0,0,0,66.31 ,74.09 ,66.31 
03,007,01,023,0518,693,1251,27,1278,1621,0,0,0,0,0,0,0,66.31 ,78.84 ,66.31 
03,007,01,023,0519,694,1012,11,1023,1253,0,0,0,0,0,0,0,66.31 ,81.64 ,66.31 
03,007,01,023,0520,695,609,10,619,769,0,0,0,0,0,0,0,66.31 ,80.49 ,66.31 
03,007,01,023,0521,696,1150,14,1164,1439,0,0,0,0,0,0,0,66.31 ,80.89 ,66.31 
03,007,01,023,0522,697,868,8,876,1119,0,0,0,0,0,0,0,66.31 ,78.28 ,66.31 
03,007,01,023,0523,698,796,19,815,1043,0,0,0,0,0,0,0,66.31 ,78.14 ,66.31 
03,007,01,023,0524,699,882,19,901,1126,0,0,0,0,0,0,0,66.31 ,80.02 ,66.31 
03,007,01,023,0524,700,801,18,819,1043,0,0,0,0,0,0,0,66.31 ,78.52 ,66.31 
03,007,01,023,0524,701,962,17,979,1217,0,0,0,0,0,0,0,66.31 ,80.44 ,66.31 
03,007,01,023,0525,702,998,8,1006,1349,0,0,0,0,0,0,0,66.31 ,74.57 ,66.31 
03,007,01,023,0526,703,748,15,763,992,0,0,0,0,0,0,0,66.31 ,76.92 ,66.31 
03,007,01,023,0527,704,676,6,682,876,0,0,0,0,0,0,0,66.31 ,77.85 ,66.31 
03,007,01,023,0528,705,850,7,857,1146,0,0,0,0,0,0,0,66.31 ,74.78 ,66.31 
03,007,01,023,0529,706,766,10,776,999,0,0,0,0,0,0,0,66.31 ,77.68 ,66.31 
03,007,01,023,0530,707,782,8,790,1002,0,0,0,0,0,0,0,66.31 ,78.84 ,66.31 
03,007,01,023,0531,708,624,7,631,781,0,0,0,0,0,0,0,66.31 ,80.79 ,66.31 
03,007,01,024,0532,709,695,11,706,1112,0,0,0,0,0,0,0,66.31 ,63.49 ,66.31 
03,007,01,024,0533,710,360,1,361,545,0,0,0,0,0,0,0,66.31 ,66.24 ,66.31 
03,007,01,024,0534,711,601,12,613,941,0,0,0,0,0,0,0,66.31 ,65.14 ,66.31 
03,007,01,024,0535,712,425,7,432,703,0,0,0,0,0,0,0,66.31 ,61.45 ,66.31 
03,007,01,024,0536,713,672,7,679,938,0,0,0,0,0,0,0,66.31 ,72.39 ,66.31 
03,007,01,024,0537,714,1318,15,1333,1720,0,0,0,0,0,0,0,66.31 ,77.50 ,66.31 
03,007,01,024,0538,715,994,13,1007,1427,0,0,0,0,0,0,0,66.31 ,70.57 ,66.31 
03,007,01,024,0539,716,666,8,674,1123,0,0,0,0,0,0,0,66.31 ,60.02 ,66.31 
03,007,01,024,0540,717,516,7,523,784,0,0,0,0,0,0,0,66.31 ,66.71 ,66.31 
03,007,01,024,0541,718,620,12,632,810,0,0,0,0,0,0,0,66.31 ,78.02 ,66.31 
03,007,01,024,0542,719,756,11,767,999,0,0,0,0,0,0,0,66.31 ,76.78 ,66.31 
03,007,01,024,0543,720,503,2,505,712,0,0,0,0,0,0,0,66.31 ,70.93 ,66.31 
03,007,01,024,0544,721,468,3,471,683,0,0,0,0,0,0,0,66.31 ,68.96 ,66.31 
03,007,01,024,0545,722,782,11,793,1129,0,0,0,0,0,0,0,66.31 ,70.24 ,66.31 
03,007,01,024,0545,723,611,12,623,886,0,0,0,0,0,0,0,66.31 ,70.32 ,66.31 
03,007,01,024,0546,724,588,5,593,805,0,0,0,0,0,0,0,66.31 ,73.66 ,66.31 
03,007,01,024,0547,725,523,11,534,816,0,0,0,0,0,0,0,66.31 ,65.44 ,66.31 
03,007,01,024,0548,726,916,11,927,1344,0,0,0,0,0,0,0,66.31 ,68.97 ,66.31 
03,007,01,024,0549,727,531,4,535,782,0,0,0,0,0,0,0,66.31 ,68.41 ,66.31 
03,007,01,024,0550,728,1023,14,1037,1327,0,0,0,0,0,0,0,66.31 ,78.15 ,66.31 
03,007,01,024,0551,729,387,5,392,622,0,0,0,0,0,0,0,66.31 ,63.02 ,66.31 
03,007,01,024,0552,730,1010,17,1027,1339,0,0,0,0,0,0,0,66.31 ,76.70 ,66.31 
03,007,01,024,0553,731,742,15,757,998,0,0,0,0,0,0,0,66.31 ,75.85 ,66.31 
03,007,01,024,0553,732,746,21,767,1015,0,0,0,0,0,0,0,66.31 ,75.57 ,66.31 
03,007,01,024,0554,733,575,6,581,749,0,0,0,0,0,0,0,66.31 ,77.57 ,66.31 
03,007,01,024,0555,734,743,9,752,991,0,0,0,0,0,0,0,66.31 ,75.88 ,66.31 
03,007,01,024,0556,735,934,17,951,1326,0,0,0,0,0,0,0,66.31 ,71.72 ,66.31 
03,007,01,024,0557,736,1035,21,1056,1395,0,0,0,0,0,0,0,66.31 ,75.70 ,66.31 
03,007,01,024,0557,737,894,13,907,1248,0,0,0,0,0,0,0,66.31 ,72.68 ,66.31 
03,007,01,025,0558,738,951,13,964,1438,0,0,0,0,0,0,0,66.31 ,67.04 ,66.31 
03,007,01,025,0559,739,943,18,961,1427,0,0,0,0,0,0,0,66.31 ,67.34 ,66.31 
03,007,01,025,0560,740,636,7,643,901,0,0,0,0,0,0,0,66.31 ,71.37 ,66.31 
03,007,01,025,0561,741,898,11,909,1247,0,0,0,0,0,0,0,66.31 ,72.89 ,66.31 
03,007,01,025,0562,742,751,7,758,1075,0,0,0,0,0,0,0,66.31 ,70.51 ,66.31 
03,007,01,025,0563,743,434,1,435,650,0,0,0,0,0,0,0,66.31 ,66.92 ,66.31 
03,007,01,025,0563,744,394,13,407,552,0,0,0,0,0,0,0,66.31 ,73.73 ,66.31 
03,007,01,025,0564,745,516,7,523,773,0,0,0,0,0,0,0,66.31 ,67.66 ,66.31 
03,007,01,025,0565,746,349,1,350,507,0,0,0,0,0,0,0,66.31 ,69.03 ,66.31 
03,007,01,025,0565,747,526,1,527,782,0,0,0,0,0,0,0,66.31 ,67.39 ,66.31 
03,007,01,025,0566,748,627,10,637,884,0,0,0,0,0,0,0,66.31 ,72.06 ,66.31 
03,007,01,025,0567,749,481,8,489,788,0,0,0,0,0,0,0,66.31 ,62.06 ,66.31 
03,007,01,025,0568,750,887,21,908,1191,0,0,0,0,0,0,0,66.31 ,76.24 ,66.31 
03,007,01,025,0569,751,884,13,897,1327,0,0,0,0,0,0,0,66.31 ,67.60 ,66.31 
03,007,01,025,0570,752,695,7,702,1093,0,0,0,0,0,0,0,66.31 ,64.23 ,66.31 
03,007,01,025,0571,753,574,5,579,846,0,0,0,0,0,0,0,66.31 ,68.44 ,66.31 
03,007,01,025,0572,754,667,8,675,1049,0,0,0,0,0,0,0,66.31 ,64.35 ,66.31 
03,007,01,026,0573,755,790,12,802,1050,0,0,0,0,0,0,0,66.31 ,76.38 ,66.31 
03,007,01,026,0574,756,1282,10,1292,1589,0,0,0,0,0,0,0,66.31 ,81.31 ,66.31 
03,007,01,026,0575,757,633,2,635,824,0,0,0,0,0,0,0,66.31 ,77.06 ,66.31 
03,007,01,026,0576,758,584,6,590,778,0,0,0,0,0,0,0,66.31 ,75.84 ,66.31 
03,007,01,026,0577,759,1095,23,1118,1477,0,0,0,0,0,0,0,66.31 ,75.69 ,66.31 
03,007,01,026,0578,760,461,6,467,630,0,0,0,0,0,0,0,66.31 ,74.13 ,66.31 
03,007,01,026,0579,761,707,9,716,937,0,0,0,0,0,0,0,66.31 ,76.41 ,66.31 
03,007,01,026,0580,762,904,11,915,1211,0,0,0,0,0,0,0,66.31 ,75.56 ,66.31 
03,007,01,026,0581,763,395,3,398,567,0,0,0,0,0,0,0,66.31 ,70.19 ,66.31 
03,007,01,026,0582,764,634,5,639,882,0,0,0,0,0,0,0,66.31 ,72.45 ,66.31 
03,007,01,026,0583,765,539,6,545,720,0,0,0,0,0,0,0,66.31 ,75.69 ,66.31 
03,007,01,026,0584,766,472,2,474,668,0,0,0,0,0,0,0,66.31 ,70.96 ,66.31 
03,007,01,026,0585,767,567,4,571,759,0,0,0,0,0,0,0,66.31 ,75.23 ,66.31 
03,007,01,026,0586,768,505,7,512,732,0,0,0,0,0,0,0,66.31 ,69.95 ,66.31 
03,008,01,001,0001,1,589,2,591,949,0,0,0,0,0,0,0,66.31 ,62.28 ,66.31 
03,008,01,001,0002,2,891,6,897,1359,0,0,0,0,0,0,0,66.31 ,66.00 ,66.31 
03,008,01,001,0003,3,499,1,500,703,0,0,0,0,0,0,0,66.31 ,71.12 ,66.31 
03,008,01,001,0004,4,386,2,388,545,0,0,0,0,0,0,0,66.31 ,71.19 ,66.31 
03,008,01,001,0005,5,535,4,539,737,0,0,0,0,0,0,0,66.31 ,73.13 ,66.31 
03,008,01,001,0006,6,295,1,296,432,0,0,0,0,0,0,0,66.31 ,68.52 ,66.31 
03,008,01,001,0007,7,696,5,701,1022,0,0,0,0,0,0,0,66.31 ,68.59 ,66.31 
03,008,01,001,0008,8,674,5,679,1082,0,0,0,0,0,0,0,66.31 ,62.75 ,66.31 
03,008,01,001,0008,9,862,6,868,1415,0,0,0,0,0,0,0,66.31 ,61.34 ,66.31 
03,008,01,001,0008,10,825,6,831,1329,0,0,0,0,0,0,0,66.31 ,62.53 ,66.31 
03,008,01,001,0009,11,884,6,890,1302,0,0,0,0,0,0,0,66.31 ,68.36 ,66.31 
03,008,01,001,0009,12,987,7,994,1465,0,0,0,0,0,0,0,66.31 ,67.85 ,66.31 
03,008,01,001,0010,13,1136,9,1145,1616,0,0,0,0,0,0,0,66.31 ,70.85 ,66.31 
03,008,01,001,0011,14,1099,16,1115,1501,0,0,0,0,0,0,0,66.31 ,74.28 ,66.31 
03,008,01,001,0011,15,684,7,691,983,0,0,0,0,0,0,0,66.31 ,70.30 ,66.31 
03,008,01,001,0012,16,781,2,783,1238,0,0,0,0,0,0,0,66.31 ,63.25 ,66.31 
03,008,01,001,0012,17,877,13,890,1307,0,0,0,0,0,0,0,66.31 ,68.09 ,66.31 
03,008,01,001,0012,18,902,4,906,1285,0,0,0,0,0,0,0,66.31 ,70.51 ,66.31 
03,008,01,001,0012,19,748,6,754,1194,0,0,0,0,0,0,0,66.31 ,63.15 ,66.31 
03,008,01,001,0013,20,359,1,360,552,0,0,0,0,0,0,0,66.31 ,65.22 ,66.31 
03,008,01,001,0013,21,981,6,987,1387,0,0,0,0,0,0,0,66.31 ,71.16 ,66.31 
03,008,01,001,0014,22,561,7,568,799,0,0,0,0,0,0,0,66.31 ,71.09 ,66.31 
03,008,01,001,0015,23,1129,21,1150,1663,0,0,0,0,0,0,0,66.31 ,69.15 ,66.31 
03,008,01,001,0015,24,1018,12,1030,1605,0,0,0,0,0,0,0,66.31 ,64.17 ,66.31 
03,008,01,001,0015,25,248,4,252,326,0,0,0,0,0,0,0,66.31 ,77.30 ,66.31 
03,008,01,001,0016,26,298,1,299,464,0,0,0,0,0,0,0,66.31 ,64.44 ,66.31 
03,008,01,001,0017,27,670,8,678,981,0,0,0,0,0,0,0,66.31 ,69.11 ,66.31 
03,008,01,001,0017,28,632,4,636,870,0,0,0,0,0,0,0,66.31 ,73.10 ,66.31 
03,008,01,001,0018,29,1024,9,1033,1504,0,0,0,0,0,0,0,66.31 ,68.68 ,66.31 
03,008,01,001,0018,30,952,8,960,1419,0,0,0,0,0,0,0,66.31 ,67.65 ,66.31 
03,008,01,001,0018,31,913,13,926,1369,0,0,0,0,0,0,0,66.31 ,67.64 ,66.31 
03,008,01,001,0019,32,889,14,903,1159,0,0,0,0,0,0,0,66.31 ,77.91 ,66.31 
03,008,01,001,0019,33,849,11,860,1271,0,0,0,0,0,0,0,66.31 ,67.66 ,66.31 
03,008,01,001,0019,34,866,9,875,1406,0,0,0,0,0,0,0,66.31 ,62.23 ,66.31 
03,008,01,001,0019,35,368,2,370,502,0,0,0,0,0,0,0,66.31 ,73.71 ,66.31 
03,008,01,001,0020,36,1001,10,1011,1250,0,0,0,0,0,0,0,66.31 ,80.88 ,66.31 
03,008,01,001,0021,37,391,3,394,576,0,0,0,0,0,0,0,66.31 ,68.40 ,66.31 
03,008,01,001,0022,38,511,4,515,804,0,0,0,0,0,0,0,66.31 ,64.05 ,66.31 
03,008,01,001,0022,39,707,12,719,1120,0,0,0,0,0,0,0,66.31 ,64.20 ,66.31 
03,008,01,001,0023,40,685,13,698,1003,0,0,0,0,0,0,0,66.31 ,69.59 ,66.31 
03,008,01,001,0023,41,730,8,738,1096,0,0,0,0,0,0,0,66.31 ,67.34 ,66.31 
03,008,01,001,0024,42,504,4,508,765,0,0,0,0,0,0,0,66.31 ,66.41 ,66.31 
03,008,01,001,0024,43,613,8,621,867,0,0,0,0,0,0,0,66.31 ,71.63 ,66.31 
03,008,01,001,0025,44,707,8,715,1108,0,0,0,0,0,0,0,66.31 ,64.53 ,66.31 
03,008,01,001,0025,45,753,5,758,1109,0,0,0,0,0,0,0,66.31 ,68.35 ,66.31 
03,008,01,001,0026,46,721,4,725,1066,0,0,0,0,0,0,0,66.31 ,68.01 ,66.31 
03,008,01,001,0026,47,860,2,862,1289,0,0,0,0,0,0,0,66.31 ,66.87 ,66.31 
03,008,01,001,0026,48,826,8,834,1211,0,0,0,0,0,0,0,66.31 ,68.87 ,66.31 
03,008,01,001,0026,49,1091,8,1099,1667,0,0,0,0,0,0,0,66.31 ,65.93 ,66.31 
03,008,01,001,0027,50,958,20,978,1366,0,0,0,0,0,0,0,66.31 ,71.60 ,66.31 
03,008,01,001,0027,51,868,6,874,1195,0,0,0,0,0,0,0,66.31 ,73.14 ,66.31 
03,008,01,001,0027,52,661,6,667,980,0,0,0,0,0,0,0,66.31 ,68.06 ,66.31 
03,008,01,001,0028,53,939,8,947,1389,0,0,0,0,0,0,0,66.31 ,68.18 ,66.31 
03,008,01,001,0028,54,1132,9,1141,1577,0,0,0,0,0,0,0,66.31 ,72.35 ,66.31 
03,008,01,001,0029,55,735,10,745,1101,0,0,0,0,0,0,0,66.31 ,67.67 ,66.31 
03,008,01,001,0029,56,611,10,621,1085,0,0,0,0,0,0,0,66.31 ,57.24 ,66.31 
03,008,01,001,0030,57,944,11,955,1278,0,0,0,0,0,0,0,66.31 ,74.73 ,66.31 
03,008,01,001,0030,58,741,7,748,1125,0,0,0,0,0,0,0,66.31 ,66.49 ,66.31 
03,008,01,001,0031,59,819,8,827,1236,0,0,0,0,0,0,0,66.31 ,66.91 ,66.31 
03,008,01,001,0032,60,565,5,570,738,0,0,0,0,0,0,0,66.31 ,77.24 ,66.31 
03,008,01,001,0033,61,567,1,568,769,0,0,0,0,0,0,0,66.31 ,73.86 ,66.31 
03,008,01,001,0034,62,1222,10,1232,1620,0,0,0,0,0,0,0,66.31 ,76.05 ,66.31 
03,008,01,002,0035,63,590,8,598,942,0,0,0,0,0,0,0,66.31 ,63.48 ,66.31 
03,008,01,002,0035,64,704,6,710,1100,0,0,0,0,0,0,0,66.31 ,64.55 ,66.31 
03,008,01,002,0035,65,626,8,634,935,0,0,0,0,0,0,0,66.31 ,67.81 ,66.31 
03,008,01,002,0036,66,597,5,602,999,0,0,0,0,0,0,0,66.31 ,60.26 ,66.31 
03,008,01,002,0036,67,638,3,641,1100,0,0,0,0,0,0,0,66.31 ,58.27 ,66.31 
03,008,01,002,0036,68,647,4,651,1016,0,0,0,0,0,0,0,66.31 ,64.07 ,66.31 
03,008,01,002,0037,69,652,5,657,1021,0,0,0,0,0,0,0,66.31 ,64.35 ,66.31 
03,008,01,002,0038,70,771,7,778,1207,0,0,0,0,0,0,0,66.31 ,64.46 ,66.31 
03,008,01,002,0038,71,683,7,690,1117,0,0,0,0,0,0,0,66.31 ,61.77 ,66.31 
03,008,01,002,0039,72,967,9,976,1544,0,0,0,0,0,0,0,66.31 ,63.21 ,66.31 
03,008,01,002,0039,73,923,8,931,1450,0,0,0,0,0,0,0,66.31 ,64.21 ,66.31 
03,008,01,002,0040,74,573,9,582,866,0,0,0,0,0,0,0,66.31 ,67.21 ,66.31 
03,008,01,002,0040,75,665,7,672,1022,0,0,0,0,0,0,0,66.31 ,65.75 ,66.31 
03,008,01,002,0041,76,647,2,649,1037,0,0,0,0,0,0,0,66.31 ,62.58 ,66.31 
03,008,01,002,0041,77,617,4,621,1039,0,0,0,0,0,0,0,66.31 ,59.77 ,66.31 
03,008,01,002,0042,78,734,15,749,1080,0,0,0,0,0,0,0,66.31 ,69.35 ,66.31 
03,008,01,002,0042,79,710,11,721,1067,0,0,0,0,0,0,0,66.31 ,67.57 ,66.31 
03,008,01,002,0043,80,665,7,672,1059,0,0,0,0,0,0,0,66.31 ,63.46 ,66.31 
03,008,01,002,0043,81,623,1,624,1017,0,0,0,0,0,0,0,66.31 ,61.36 ,66.31 
03,008,01,002,0043,82,815,8,823,1366,0,0,0,0,0,0,0,66.31 ,60.25 ,66.31 
03,008,01,002,0044,83,903,9,912,1313,0,0,0,0,0,0,0,66.31 ,69.46 ,66.31 
03,008,01,002,0045,84,814,9,823,1366,0,0,0,0,0,0,0,66.31 ,60.25 ,66.31 
03,008,01,002,0045,85,793,13,806,1209,0,0,0,0,0,0,0,66.31 ,66.67 ,66.31 
03,008,01,002,0045,86,773,5,778,1232,0,0,0,0,0,0,0,66.31 ,63.15 ,66.31 
03,008,01,002,0045,87,865,7,872,1468,0,0,0,0,0,0,0,66.31 ,59.40 ,66.31 
03,008,01,002,0046,88,545,3,548,753,0,0,0,0,0,0,0,66.31 ,72.78 ,66.31 
03,008,01,002,0047,89,698,6,704,1048,0,0,0,0,0,0,0,66.31 ,67.18 ,66.31 
03,008,01,002,0047,90,737,3,740,1146,0,0,0,0,0,0,0,66.31 ,64.57 ,66.31 
03,008,01,002,0048,91,852,10,862,1312,0,0,0,0,0,0,0,66.31 ,65.70 ,66.31 
03,008,01,002,0048,92,424,11,435,673,0,0,0,0,0,0,0,66.31 ,64.64 ,66.31 
03,008,01,002,0048,93,732,14,746,1163,0,0,0,0,0,0,0,66.31 ,64.14 ,66.31 
03,008,01,002,0048,94,596,12,608,947,0,0,0,0,0,0,0,66.31 ,64.20 ,66.31 
03,008,01,002,0048,95,575,7,582,959,0,0,0,0,0,0,0,66.31 ,60.69 ,66.31 
03,008,01,002,0049,96,985,12,997,1657,0,0,0,0,0,0,0,66.31 ,60.17 ,66.31 
03,008,01,002,0049,97,658,13,671,1040,0,0,0,0,0,0,0,66.31 ,64.52 ,66.31 
03,008,01,002,0050,98,621,6,627,927,0,0,0,0,0,0,0,66.31 ,67.64 ,66.31 
03,008,01,002,0051,99,639,11,650,920,0,0,0,0,0,0,0,66.31 ,70.65 ,66.31 
03,008,01,002,0052,100,451,9,460,698,0,0,0,0,0,0,0,66.31 ,65.90 ,66.31 
03,008,01,002,0053,101,577,6,583,932,0,0,0,0,0,0,0,66.31 ,62.55 ,66.31 
03,008,01,002,0054,102,201,2,203,358,0,0,0,0,0,0,0,66.31 ,56.70 ,66.31 
03,008,01,002,0055,103,782,7,789,1297,0,0,0,0,0,0,0,66.31 ,60.83 ,66.31 
03,008,01,002,0056,104,790,9,799,1259,0,0,0,0,0,0,0,66.31 ,63.46 ,66.31 
03,008,01,002,0057,105,921,5,926,1466,0,0,0,0,0,0,0,66.31 ,63.17 ,66.31 
03,008,01,002,0058,106,543,11,554,858,0,0,0,0,0,0,0,66.31 ,64.57 ,66.31 
03,008,01,002,0058,107,199,2,201,322,0,0,0,0,0,0,0,66.31 ,62.42 ,66.31 
03,008,01,002,0059,108,468,6,474,667,0,0,0,0,0,0,0,66.31 ,71.06 ,66.31 
03,008,01,002,0060,109,662,9,671,998,0,0,0,0,0,0,0,66.31 ,67.23 ,66.31 
03,008,01,002,0061,110,840,1,841,1233,0,0,0,0,0,0,0,66.31 ,68.21 ,66.31 
03,008,01,002,0061,111,151,0,151,262,0,0,0,0,0,0,0,66.31 ,57.63 ,66.31 
03,008,01,002,0062,112,676,6,682,1090,0,0,0,0,0,0,0,66.31 ,62.57 ,66.31 
03,008,01,002,0063,113,400,2,402,620,0,0,0,0,0,0,0,66.31 ,64.84 ,66.31 
03,008,01,002,0064,114,610,6,616,945,0,0,0,0,0,0,0,66.31 ,65.19 ,66.31 
03,008,01,002,0065,115,695,11,706,1052,0,0,0,0,0,0,0,66.31 ,67.11 ,66.31 
03,008,01,002,0065,116,878,10,888,1305,0,0,0,0,0,0,0,66.31 ,68.05 ,66.31 
03,008,01,002,0066,117,756,7,763,1116,0,0,0,0,0,0,0,66.31 ,68.37 ,66.31 
03,008,01,002,0067,118,599,6,605,942,0,0,0,0,0,0,0,66.31 ,64.23 ,66.31 
03,008,01,002,0067,119,578,2,580,893,0,0,0,0,0,0,0,66.31 ,64.95 ,66.31 
03,008,01,002,0067,120,368,3,371,576,0,0,0,0,0,0,0,66.31 ,64.41 ,66.31 
03,008,01,003,0068,121,553,11,564,837,0,0,0,0,0,0,0,66.31 ,67.38 ,66.31 
03,008,01,003,0068,122,673,12,685,954,0,0,0,0,0,0,0,66.31 ,71.80 ,66.31 
03,008,01,003,0069,123,946,13,959,1462,0,0,0,0,0,0,0,66.31 ,65.60 ,66.31 
03,008,01,003,0069,124,993,9,1002,1601,0,0,0,0,0,0,0,66.31 ,62.59 ,66.31 
03,008,01,003,0070,125,642,6,648,937,0,0,0,0,0,0,0,66.31 ,69.16 ,66.31 
03,008,01,003,0070,126,681,10,691,1052,0,0,0,0,0,0,0,66.31 ,65.68 ,66.31 
03,008,01,003,0071,127,545,3,548,721,0,0,0,0,0,0,0,66.31 ,76.01 ,66.31 
03,008,01,003,0072,128,957,7,964,1372,0,0,0,0,0,0,0,66.31 ,70.26 ,66.31 
03,008,01,003,0073,129,632,5,637,974,0,0,0,0,0,0,0,66.31 ,65.40 ,66.31 
03,008,01,003,0073,130,850,16,866,1253,0,0,0,0,0,0,0,66.31 ,69.11 ,66.31 
03,008,01,003,0074,131,733,6,739,1120,0,0,0,0,0,0,0,66.31 ,65.98 ,66.31 
03,008,01,003,0074,132,716,11,727,1187,0,0,0,0,0,0,0,66.31 ,61.25 ,66.31 
03,008,01,003,0074,133,783,6,789,1231,0,0,0,0,0,0,0,66.31 ,64.09 ,66.31 
03,008,01,003,0074,134,837,13,850,1310,0,0,0,0,0,0,0,66.31 ,64.89 ,66.31 
03,008,01,003,0075,135,1004,13,1017,1439,0,0,0,0,0,0,0,66.31 ,70.67 ,66.31 
03,008,01,003,0075,136,894,9,903,1332,0,0,0,0,0,0,0,66.31 ,67.79 ,66.31 
03,008,01,003,0075,137,801,9,810,1201,0,0,0,0,0,0,0,66.31 ,67.44 ,66.31 
03,008,01,003,0075,138,918,14,932,1354,0,0,0,0,0,0,0,66.31 ,68.83 ,66.31 
03,008,01,003,0076,139,931,13,944,1357,0,0,0,0,0,0,0,66.31 ,69.57 ,66.31 
03,008,01,003,0076,140,855,11,866,1328,0,0,0,0,0,0,0,66.31 ,65.21 ,66.31 
03,008,01,003,0077,141,914,15,929,1264,0,0,0,0,0,0,0,66.31 ,73.50 ,66.31 
03,008,01,003,0077,142,653,10,663,899,0,0,0,0,0,0,0,66.31 ,73.75 ,66.31 
03,008,01,003,0078,143,699,15,714,1062,0,0,0,0,0,0,0,66.31 ,67.23 ,66.31 
03,008,01,003,0078,144,707,9,716,1085,0,0,0,0,0,0,0,66.31 ,65.99 ,66.31 
03,008,01,003,0078,145,459,4,463,776,0,0,0,0,0,0,0,66.31 ,59.66 ,66.31 
03,008,01,003,0079,146,671,8,679,908,0,0,0,0,0,0,0,66.31 ,74.78 ,66.31 
03,008,01,003,0079,147,393,1,394,588,0,0,0,0,0,0,0,66.31 ,67.01 ,66.31 
03,008,01,003,0080,148,877,8,885,1298,0,0,0,0,0,0,0,66.31 ,68.18 ,66.31 
03,008,01,003,0080,149,934,11,945,1353,0,0,0,0,0,0,0,66.31 ,69.84 ,66.31 
03,008,01,003,0081,150,1038,8,1046,1522,0,0,0,0,0,0,0,66.31 ,68.73 ,66.31 
03,008,01,003,0081,151,732,9,741,1175,0,0,0,0,0,0,0,66.31 ,63.06 ,66.31 
03,008,01,003,0081,152,510,7,517,837,0,0,0,0,0,0,0,66.31 ,61.77 ,66.31 
03,008,01,003,0081,153,710,8,718,1089,0,0,0,0,0,0,0,66.31 ,65.93 ,66.31 
03,008,01,003,0082,154,990,8,998,1465,0,0,0,0,0,0,0,66.31 ,68.12 ,66.31 
03,008,01,003,0082,155,1074,13,1087,1695,0,0,0,0,0,0,0,66.31 ,64.13 ,66.31 
03,008,01,003,0083,156,899,13,912,1273,0,0,0,0,0,0,0,66.31 ,71.64 ,66.31 
03,008,01,003,0083,157,917,12,929,1325,0,0,0,0,0,0,0,66.31 ,70.11 ,66.31 
03,008,01,003,0084,158,448,5,453,633,0,0,0,0,0,0,0,66.31 ,71.56 ,66.31 
03,008,01,003,0084,159,804,6,810,1136,0,0,0,0,0,0,0,66.31 ,71.30 ,66.31 
03,008,01,003,0085,160,798,7,805,1096,0,0,0,0,0,0,0,66.31 ,73.45 ,66.31 
03,008,01,003,0086,161,770,3,773,1055,0,0,0,0,0,0,0,66.31 ,73.27 ,66.31 
03,008,01,003,0086,162,740,8,748,1090,0,0,0,0,0,0,0,66.31 ,68.62 ,66.31 
03,008,01,003,0087,163,961,11,972,1566,0,0,0,0,0,0,0,66.31 ,62.07 ,66.31 
03,008,01,003,0087,164,837,10,847,1161,0,0,0,0,0,0,0,66.31 ,72.95 ,66.31 
03,008,01,003,0087,165,349,5,354,525,0,0,0,0,0,0,0,66.31 ,67.43 ,66.31 
03,008,01,003,0087,166,539,7,546,811,0,0,0,0,0,0,0,66.31 ,67.32 ,66.31 
03,008,01,003,0088,167,904,7,911,1310,0,0,0,0,0,0,0,66.31 ,69.54 ,66.31 
03,008,01,003,0088,168,332,1,333,481,0,0,0,0,0,0,0,66.31 ,69.23 ,66.31 
03,008,01,003,0089,169,688,8,696,938,0,0,0,0,0,0,0,66.31 ,74.20 ,66.31 
03,008,01,003,0089,170,524,4,528,779,0,0,0,0,0,0,0,66.31 ,67.78 ,66.31 
03,008,01,003,0090,171,829,13,842,1231,0,0,0,0,0,0,0,66.31 ,68.40 ,66.31 
03,008,01,003,0090,172,585,8,593,908,0,0,0,0,0,0,0,66.31 ,65.31 ,66.31 
03,008,01,003,0090,173,558,7,565,782,0,0,0,0,0,0,0,66.31 ,72.25 ,66.31 
03,008,01,003,0091,174,658,6,664,937,0,0,0,0,0,0,0,66.31 ,70.86 ,66.31 
03,008,01,003,0092,175,419,6,425,637,0,0,0,0,0,0,0,66.31 ,66.72 ,66.31 
03,008,01,003,0092,176,606,7,613,931,0,0,0,0,0,0,0,66.31 ,65.84 ,66.31 
03,008,01,003,0093,177,739,6,745,966,0,0,0,0,0,0,0,66.31 ,77.12 ,66.31 
03,008,01,003,0094,178,717,8,725,1120,0,0,0,0,0,0,0,66.31 ,64.73 ,66.31 
03,008,01,003,0094,179,800,6,806,1172,0,0,0,0,0,0,0,66.31 ,68.77 ,66.31 
03,008,01,004,0095,180,879,6,885,1275,0,0,0,0,0,0,0,66.31 ,69.41 ,66.31 
03,008,01,004,0095,181,687,9,696,965,0,0,0,0,0,0,0,66.31 ,72.12 ,66.31 
03,008,01,004,0096,182,554,8,562,749,0,0,0,0,0,0,0,66.31 ,75.03 ,66.31 
03,008,01,004,0097,183,776,10,786,1121,0,0,0,0,0,0,0,66.31 ,70.12 ,66.31 
03,008,01,004,0097,184,1013,8,1021,1506,0,0,0,0,0,0,0,66.31 ,67.80 ,66.31 
03,008,01,004,0097,185,1167,14,1181,1704,0,0,0,0,0,0,0,66.31 ,69.31 ,66.31 
03,008,01,004,0098,186,1019,9,1028,1464,0,0,0,0,0,0,0,66.31 ,70.22 ,66.31 
03,008,01,004,0098,187,1100,12,1112,1669,0,0,0,0,0,0,0,66.31 ,66.63 ,66.31 
03,008,01,004,0099,188,522,9,531,738,0,0,0,0,0,0,0,66.31 ,71.95 ,66.31 
03,008,01,004,0099,189,811,14,825,1261,0,0,0,0,0,0,0,66.31 ,65.42 ,66.31 
03,008,01,004,0100,190,1097,7,1104,1673,0,0,0,0,0,0,0,66.31 ,65.99 ,66.31 
03,008,01,004,0100,191,1111,13,1124,1600,0,0,0,0,0,0,0,66.31 ,70.25 ,66.31 
03,008,01,004,0101,192,357,2,359,495,0,0,0,0,0,0,0,66.31 ,72.53 ,66.31 
03,008,01,004,0101,193,313,7,320,476,0,0,0,0,0,0,0,66.31 ,67.23 ,66.31 
03,008,01,004,0102,194,647,6,653,956,0,0,0,0,0,0,0,66.31 ,68.31 ,66.31 
03,008,01,004,0103,195,848,3,851,1206,0,0,0,0,0,0,0,66.31 ,70.56 ,66.31 
03,008,01,004,0104,196,230,0,230,306,0,0,0,0,0,0,0,66.31 ,75.16 ,66.31 
03,008,01,004,0104,197,351,0,351,505,0,0,0,0,0,0,0,66.31 ,69.50 ,66.31 
03,008,01,004,0105,198,133,0,133,182,0,0,0,0,0,0,0,66.31 ,73.08 ,66.31 
03,008,01,004,0106,199,887,8,895,1356,0,0,0,0,0,0,0,66.31 ,66.00 ,66.31 
03,008,01,004,0106,200,853,13,866,1307,0,0,0,0,0,0,0,66.31 ,66.26 ,66.31 
03,008,01,004,0106,201,805,9,814,1226,0,0,0,0,0,0,0,66.31 ,66.39 ,66.31 
03,008,01,004,0107,202,993,11,1004,1624,0,0,0,0,0,0,0,66.31 ,61.82 ,66.31 
03,008,01,004,0107,203,877,22,899,1382,0,0,0,0,0,0,0,66.31 ,65.05 ,66.31 
03,008,01,004,0108,204,477,5,482,657,0,0,0,0,0,0,0,66.31 ,73.36 ,66.31 
03,008,01,004,0108,205,645,7,652,954,0,0,0,0,0,0,0,66.31 ,68.34 ,66.31 
03,008,01,004,0109,206,817,7,824,1196,0,0,0,0,0,0,0,66.31 ,68.90 ,66.31 
03,008,01,004,0109,207,651,7,658,886,0,0,0,0,0,0,0,66.31 ,74.27 ,66.31 
03,008,01,004,0109,208,435,3,438,573,0,0,0,0,0,0,0,66.31 ,76.44 ,66.31 
03,008,01,004,0110,209,434,6,440,646,0,0,0,0,0,0,0,66.31 ,68.11 ,66.31 
03,008,01,004,0111,210,817,8,825,1228,0,0,0,0,0,0,0,66.31 ,67.18 ,66.31 
03,008,01,004,0111,211,457,8,465,696,0,0,0,0,0,0,0,66.31 ,66.81 ,66.31 
03,008,01,004,0112,212,623,2,625,869,0,0,0,0,0,0,0,66.31 ,71.92 ,66.31 
03,008,01,004,0113,213,1042,7,1049,1413,0,0,0,0,0,0,0,66.31 ,74.24 ,66.31 
03,008,01,004,0114,214,497,3,500,719,0,0,0,0,0,0,0,66.31 ,69.54 ,66.31 
03,008,01,004,0115,215,293,6,299,442,0,0,0,0,0,0,0,66.31 ,67.65 ,66.31 
03,008,01,004,0115,216,139,0,139,204,0,0,0,0,0,0,0,66.31 ,68.14 ,66.31 
03,008,01,004,0116,217,819,13,832,1239,0,0,0,0,0,0,0,66.31 ,67.15 ,66.31 
03,008,01,004,0117,218,274,4,278,399,0,0,0,0,0,0,0,66.31 ,69.67 ,66.31 
03,008,01,004,0117,219,368,2,370,504,0,0,0,0,0,0,0,66.31 ,73.41 ,66.31 
03,008,01,004,0118,220,151,0,151,211,0,0,0,0,0,0,0,66.31 ,71.56 ,66.31 
03,008,01,004,0118,221,277,2,279,366,0,0,0,0,0,0,0,66.31 ,76.23 ,66.31 
03,008,01,004,0119,222,397,5,402,577,0,0,0,0,0,0,0,66.31 ,69.67 ,66.31 
03,008,01,004,0119,223,243,2,245,366,0,0,0,0,0,0,0,66.31 ,66.94 ,66.31 
03,008,01,004,0120,224,428,3,431,616,0,0,0,0,0,0,0,66.31 ,69.97 ,66.31 
03,008,01,004,0121,225,540,10,550,771,0,0,0,0,0,0,0,66.31 ,71.34 ,66.31 
03,008,01,004,0122,226,417,5,422,620,0,0,0,0,0,0,0,66.31 ,68.06 ,66.31 
03,008,01,004,0122,227,308,8,316,462,0,0,0,0,0,0,0,66.31 ,68.40 ,66.31 
03,008,01,005,0123,228,608,4,612,879,0,0,0,0,0,0,0,66.31 ,69.62 ,66.31 
03,008,01,005,0124,229,619,4,623,976,0,0,0,0,0,0,0,66.31 ,63.83 ,66.31 
03,008,01,005,0125,230,393,5,398,584,0,0,0,0,0,0,0,66.31 ,68.15 ,66.31 
03,008,01,005,0126,231,780,6,786,1091,0,0,0,0,0,0,0,66.31 ,72.04 ,66.31 
03,008,01,005,0127,232,392,0,392,542,0,0,0,0,0,0,0,66.31 ,72.32 ,66.31 
03,008,01,005,0128,233,290,2,292,440,0,0,0,0,0,0,0,66.31 ,66.36 ,66.31 
03,008,01,005,0129,234,659,5,664,917,0,0,0,0,0,0,0,66.31 ,72.41 ,66.31 
03,008,01,005,0130,235,861,11,872,1290,0,0,0,0,0,0,0,66.31 ,67.60 ,66.31 
03,008,01,005,0131,236,588,3,591,872,0,0,0,0,0,0,0,66.31 ,67.78 ,66.31 
03,008,01,005,0132,237,410,6,416,594,0,0,0,0,0,0,0,66.31 ,70.03 ,66.31 
03,008,01,005,0133,238,263,2,265,404,0,0,0,0,0,0,0,66.31 ,65.59 ,66.31 
03,008,01,005,0133,239,291,1,292,433,0,0,0,0,0,0,0,66.31 ,67.44 ,66.31 
03,008,01,006,0134,240,671,8,679,1001,0,0,0,0,0,0,0,66.31 ,67.83 ,66.31 
03,008,01,006,0135,241,771,6,777,1201,0,0,0,0,0,0,0,66.31 ,64.70 ,66.31 
03,008,01,006,0135,242,994,10,1004,1513,0,0,0,0,0,0,0,66.31 ,66.36 ,66.31 
03,008,01,006,0136,243,486,5,491,687,0,0,0,0,0,0,0,66.31 ,71.47 ,66.31 
03,008,01,006,0136,244,837,7,844,1170,0,0,0,0,0,0,0,66.31 ,72.14 ,66.31 
03,008,01,006,0137,245,1022,6,1028,1548,0,0,0,0,0,0,0,66.31 ,66.41 ,66.31 
03,008,01,006,0138,246,685,10,695,1015,0,0,0,0,0,0,0,66.31 ,68.47 ,66.31 
03,008,01,006,0139,247,710,4,714,979,0,0,0,0,0,0,0,66.31 ,72.93 ,66.31 
03,008,01,006,0140,248,1103,12,1115,1456,0,0,0,0,0,0,0,66.31 ,76.58 ,66.31 
03,008,01,006,0140,249,601,8,609,872,0,0,0,0,0,0,0,66.31 ,69.84 ,66.31 
03,008,01,006,0140,250,550,6,556,860,0,0,0,0,0,0,0,66.31 ,64.65 ,66.31 
03,008,01,006,0141,251,545,8,553,767,0,0,0,0,0,0,0,66.31 ,72.10 ,66.31 
03,008,01,006,0141,252,622,4,626,826,0,0,0,0,0,0,0,66.31 ,75.79 ,66.31 
03,008,01,006,0142,253,590,7,597,801,0,0,0,0,0,0,0,66.31 ,74.53 ,66.31 
03,008,01,006,0143,254,799,14,813,1022,0,0,0,0,0,0,0,66.31 ,79.55 ,66.31 
03,008,01,006,0144,255,731,5,736,1001,0,0,0,0,0,0,0,66.31 ,73.53 ,66.31 
03,008,01,006,0144,256,597,7,604,854,0,0,0,0,0,0,0,66.31 ,70.73 ,66.31 
03,008,01,006,0145,257,781,9,790,1123,0,0,0,0,0,0,0,66.31 ,70.35 ,66.31 
03,008,01,006,0145,258,580,12,592,803,0,0,0,0,0,0,0,66.31 ,73.72 ,66.31 
03,008,01,006,0146,259,508,6,514,748,0,0,0,0,0,0,0,66.31 ,68.72 ,66.31 
03,008,01,006,0147,260,503,6,509,691,0,0,0,0,0,0,0,66.31 ,73.66 ,66.31 
03,008,01,006,0147,261,376,1,377,565,0,0,0,0,0,0,0,66.31 ,66.73 ,66.31 
03,008,01,006,0148,262,623,9,632,880,0,0,0,0,0,0,0,66.31 ,71.82 ,66.31 
03,008,01,006,0149,263,664,19,683,976,0,0,0,0,0,0,0,66.31 ,69.98 ,66.31 
03,008,01,006,0149,264,324,4,328,452,0,0,0,0,0,0,0,66.31 ,72.57 ,66.31 
03,008,01,006,0150,265,863,10,873,1337,0,0,0,0,0,0,0,66.31 ,65.30 ,66.31 
03,008,01,006,0151,266,734,15,749,1027,0,0,0,0,0,0,0,66.31 ,72.93 ,66.31 
03,008,01,006,0152,267,554,5,559,769,0,0,0,0,0,0,0,66.31 ,72.69 ,66.31 
03,008,01,006,0153,268,587,7,594,845,0,0,0,0,0,0,0,66.31 ,70.30 ,66.31 
03,008,01,006,0154,269,572,6,578,811,0,0,0,0,0,0,0,66.31 ,71.27 ,66.31 
03,008,01,006,0155,270,498,4,502,745,0,0,0,0,0,0,0,66.31 ,67.38 ,66.31 
03,008,01,006,0155,271,575,12,587,821,0,0,0,0,0,0,0,66.31 ,71.50 ,66.31 
03,008,01,007,0156,272,1000,13,1013,1497,0,0,0,0,0,0,0,66.31 ,67.67 ,66.31 
03,008,01,007,0157,273,1121,11,1132,1637,0,0,0,0,0,0,0,66.31 ,69.15 ,66.31 
03,008,01,007,0158,274,534,5,539,718,0,0,0,0,0,0,0,66.31 ,75.07 ,66.31 
03,008,01,007,0158,275,286,1,287,400,0,0,0,0,0,0,0,66.31 ,71.75 ,66.31 
03,008,01,007,0159,276,561,5,566,768,0,0,0,0,0,0,0,66.31 ,73.70 ,66.31 
03,008,01,007,0159,277,719,2,721,987,0,0,0,0,0,0,0,66.31 ,73.05 ,66.31 
03,008,01,007,0160,278,393,6,399,616,0,0,0,0,0,0,0,66.31 ,64.77 ,66.31 
03,008,01,007,0160,279,312,0,312,438,0,0,0,0,0,0,0,66.31 ,71.23 ,66.31 
03,008,01,007,0161,280,438,3,441,636,0,0,0,0,0,0,0,66.31 ,69.34 ,66.31 
03,008,01,007,0162,281,1017,4,1021,1564,0,0,0,0,0,0,0,66.31 ,65.28 ,66.31 
03,008,01,007,0163,282,599,6,605,898,0,0,0,0,0,0,0,66.31 ,67.37 ,66.31 
03,008,01,007,0164,283,97,1,98,116,0,0,0,0,0,0,0,66.31 ,84.48 ,66.31 
03,008,01,007,0164,284,881,7,888,1190,0,0,0,0,0,0,0,66.31 ,74.62 ,66.31 
03,008,01,007,0165,285,876,5,881,1235,0,0,0,0,0,0,0,66.31 ,71.34 ,66.31 
03,008,01,007,0166,286,272,2,274,457,0,0,0,0,0,0,0,66.31 ,59.96 ,66.31 
03,008,01,007,0166,287,410,2,412,684,0,0,0,0,0,0,0,66.31 ,60.23 ,66.31 
03,008,01,007,0167,288,443,7,450,753,0,0,0,0,0,0,0,66.31 ,59.76 ,66.31 
03,008,01,007,0168,289,440,4,444,804,0,0,0,0,0,0,0,66.31 ,55.22 ,66.31 
03,008,01,008,0169,290,573,5,578,880,0,0,0,0,0,0,0,66.31 ,65.68 ,66.31 
03,008,01,008,0170,291,215,3,218,282,0,0,0,0,0,0,0,66.31 ,77.30 ,66.31 
03,008,01,008,0170,292,160,1,161,230,0,0,0,0,0,0,0,66.31 ,70.00 ,66.31 
03,008,01,008,0171,293,269,0,269,390,0,0,0,0,0,0,0,66.31 ,68.97 ,66.31 
03,008,01,008,0171,294,278,4,282,392,0,0,0,0,0,0,0,66.31 ,71.94 ,66.31 
03,008,01,008,0172,295,310,0,310,474,0,0,0,0,0,0,0,66.31 ,65.40 ,66.31 
03,008,01,008,0172,296,213,5,218,396,0,0,0,0,0,0,0,66.31 ,55.05 ,66.31 
03,008,01,008,0173,297,444,4,448,712,0,0,0,0,0,0,0,66.31 ,62.92 ,66.31 
03,008,01,008,0174,298,188,1,189,294,0,0,0,0,0,0,0,66.31 ,64.29 ,66.31 
03,008,01,008,0175,299,754,5,759,1021,0,0,0,0,0,0,0,66.31 ,74.34 ,66.31 
03,008,01,008,0175,300,619,5,624,847,0,0,0,0,0,0,0,66.31 ,73.67 ,66.31 
03,008,01,008,0176,301,533,2,535,731,0,0,0,0,0,0,0,66.31 ,73.19 ,66.31 
03,008,01,008,0177,302,390,0,390,550,0,0,0,0,0,0,0,66.31 ,70.91 ,66.31 
03,008,01,008,0178,303,258,1,259,365,0,0,0,0,0,0,0,66.31 ,70.96 ,66.31 
03,008,01,008,0178,304,431,2,433,647,0,0,0,0,0,0,0,66.31 ,66.92 ,66.31 
03,008,01,008,0179,305,380,4,384,470,0,0,0,0,0,0,0,66.31 ,81.70 ,66.31 
03,008,01,008,0179,306,456,4,460,644,0,0,0,0,0,0,0,66.31 ,71.43 ,66.31 
03,008,01,008,0180,307,638,8,646,991,0,0,0,0,0,0,0,66.31 ,65.19 ,66.31 
03,008,01,008,0181,308,344,3,347,472,0,0,0,0,0,0,0,66.31 ,73.52 ,66.31 
03,008,01,008,0182,309,531,6,537,720,0,0,0,0,0,0,0,66.31 ,74.58 ,66.31 
03,008,01,008,0183,310,399,3,402,601,0,0,0,0,0,0,0,66.31 ,66.89 ,66.31 
03,008,01,008,0184,311,464,5,469,683,0,0,0,0,0,0,0,66.31 ,68.67 ,66.31 
03,008,01,008,0185,312,310,1,311,439,0,0,0,0,0,0,0,66.31 ,70.84 ,66.31 
03,008,01,008,0186,313,408,3,411,587,0,0,0,0,0,0,0,66.31 ,70.02 ,66.31 
03,008,01,009,0187,314,1038,8,1046,1812,0,0,0,0,0,0,0,66.31 ,57.73 ,66.31 
03,008,01,009,0188,315,889,10,899,1519,0,0,0,0,0,0,0,66.31 ,59.18 ,66.31 
03,008,01,009,0189,316,280,2,282,495,0,0,0,0,0,0,0,66.31 ,56.97 ,66.31 
03,008,01,009,0189,317,341,4,345,528,0,0,0,0,0,0,0,66.31 ,65.34 ,66.31 
03,008,01,009,0190,318,677,10,687,1185,0,0,0,0,0,0,0,66.31 ,57.97 ,66.31 
03,008,01,009,0191,319,151,0,151,226,0,0,0,0,0,0,0,66.31 ,66.81 ,66.31 
03,008,01,009,0191,320,346,4,350,529,0,0,0,0,0,0,0,66.31 ,66.16 ,66.31 
03,008,01,009,0191,321,139,0,139,221,0,0,0,0,0,0,0,66.31 ,62.90 ,66.31 
03,008,01,009,0192,322,430,3,433,685,0,0,0,0,0,0,0,66.31 ,63.21 ,66.31 
03,008,01,009,0192,323,172,1,173,287,0,0,0,0,0,0,0,66.31 ,60.28 ,66.31 
03,008,01,009,0192,324,157,0,157,256,0,0,0,0,0,0,0,66.31 ,61.33 ,66.31 
03,008,01,009,0193,325,169,0,169,250,0,0,0,0,0,0,0,66.31 ,67.60 ,66.31 
03,008,01,009,0193,326,219,1,220,356,0,0,0,0,0,0,0,66.31 ,61.80 ,66.31 
03,008,01,009,0194,327,361,2,363,559,0,0,0,0,0,0,0,66.31 ,64.94 ,66.31 
03,008,01,009,0194,328,111,0,111,164,0,0,0,0,0,0,0,66.31 ,67.68 ,66.31 
03,008,01,009,0195,329,390,5,395,632,0,0,0,0,0,0,0,66.31 ,62.50 ,66.31 
03,008,01,009,0195,330,207,2,209,346,0,0,0,0,0,0,0,66.31 ,60.40 ,66.31 
03,008,01,009,0196,331,450,5,455,745,0,0,0,0,0,0,0,66.31 ,61.07 ,66.31 
03,008,01,009,0197,332,332,0,332,534,0,0,0,0,0,0,0,66.31 ,62.17 ,66.31 
03,008,01,009,0198,333,231,0,231,431,0,0,0,0,0,0,0,66.31 ,53.60 ,66.31 
03,008,01,009,0198,334,302,3,305,566,0,0,0,0,0,0,0,66.31 ,53.89 ,66.31 
03,008,01,009,0199,335,242,0,242,481,0,0,0,0,0,0,0,66.31 ,50.31 ,66.31 
03,008,01,009,0199,336,188,2,190,317,0,0,0,0,0,0,0,66.31 ,59.94 ,66.31 
03,008,01,010,0200,337,1030,11,1041,1693,0,0,0,0,0,0,0,66.31 ,61.49 ,66.31 
03,008,01,010,0201,338,1002,5,1007,1635,0,0,0,0,0,0,0,66.31 ,61.59 ,66.31 
03,008,01,010,0202,339,518,8,526,793,0,0,0,0,0,0,0,66.31 ,66.33 ,66.31 
03,008,01,010,0203,340,938,17,955,1552,0,0,0,0,0,0,0,66.31 ,61.53 ,66.31 
03,008,01,010,0204,341,493,5,498,772,0,0,0,0,0,0,0,66.31 ,64.51 ,66.31 
03,008,01,010,0205,342,544,10,554,912,0,0,0,0,0,0,0,66.31 ,60.75 ,66.31 
03,008,01,010,0206,343,711,7,718,1173,0,0,0,0,0,0,0,66.31 ,61.21 ,66.31 
03,008,01,010,0206,344,526,6,532,940,0,0,0,0,0,0,0,66.31 ,56.60 ,66.31 
03,008,01,010,0207,345,658,7,665,948,0,0,0,0,0,0,0,66.31 ,70.15 ,66.31 
03,008,01,010,0207,346,693,9,702,988,0,0,0,0,0,0,0,66.31 ,71.05 ,66.31 
03,008,01,010,0208,347,621,6,627,915,0,0,0,0,0,0,0,66.31 ,68.52 ,66.31 
03,008,01,010,0209,348,820,10,830,1206,0,0,0,0,0,0,0,66.31 ,68.82 ,66.31 
03,008,01,010,0210,349,505,3,508,784,0,0,0,0,0,0,0,66.31 ,64.80 ,66.31 
03,008,01,010,0211,350,743,12,755,1141,0,0,0,0,0,0,0,66.31 ,66.17 ,66.31 
03,008,01,010,0211,351,333,2,335,496,0,0,0,0,0,0,0,66.31 ,67.54 ,66.31 
03,008,01,010,0212,352,824,23,847,1472,0,0,0,0,0,0,0,66.31 ,57.54 ,66.31 
03,008,01,010,0212,353,333,8,341,560,0,0,0,0,0,0,0,66.31 ,60.89 ,66.31 
03,008,01,011,0213,354,550,5,555,916,0,0,0,0,0,0,0,66.31 ,60.59 ,66.31 
03,008,01,011,0214,355,370,4,374,589,0,0,0,0,0,0,0,66.31 ,63.50 ,66.31 
03,008,01,011,0214,356,693,4,697,1104,0,0,0,0,0,0,0,66.31 ,63.13 ,66.31 
03,008,01,011,0215,357,505,6,511,718,0,0,0,0,0,0,0,66.31 ,71.17 ,66.31 
03,008,01,011,0216,358,674,8,682,1049,0,0,0,0,0,0,0,66.31 ,65.01 ,66.31 
03,008,01,011,0217,359,356,2,358,531,0,0,0,0,0,0,0,66.31 ,67.42 ,66.31 
03,008,01,011,0218,360,683,5,688,1075,0,0,0,0,0,0,0,66.31 ,64.00 ,66.31 
03,008,01,011,0219,361,772,7,779,1224,0,0,0,0,0,0,0,66.31 ,63.64 ,66.31 
03,008,01,011,0220,362,727,5,732,1070,0,0,0,0,0,0,0,66.31 ,68.41 ,66.31 
03,008,01,011,0221,363,963,8,971,1329,0,0,0,0,0,0,0,66.31 ,73.06 ,66.31 
03,008,01,011,0222,364,656,8,664,1056,0,0,0,0,0,0,0,66.31 ,62.88 ,66.31 
03,008,01,011,0223,365,721,7,728,1111,0,0,0,0,0,0,0,66.31 ,65.53 ,66.31 
03,008,01,011,0224,366,271,3,274,407,0,0,0,0,0,0,0,66.31 ,67.32 ,66.31 
03,008,01,011,0225,367,266,3,269,397,0,0,0,0,0,0,0,66.31 ,67.76 ,66.31 
03,008,01,011,0226,368,811,6,817,1231,0,0,0,0,0,0,0,66.31 ,66.37 ,66.31 
03,008,01,011,0227,369,213,5,218,351,0,0,0,0,0,0,0,66.31 ,62.11 ,66.31 
03,008,01,011,0228,370,264,0,264,398,0,0,0,0,0,0,0,66.31 ,66.33 ,66.31 
03,008,01,011,0229,371,669,3,672,916,0,0,0,0,0,0,0,66.31 ,73.36 ,66.31 
03,008,01,011,0230,372,378,9,387,584,0,0,0,0,0,0,0,66.31 ,66.27 ,66.31 
03,008,01,011,0231,373,438,4,442,698,0,0,0,0,0,0,0,66.31 ,63.32 ,66.31 
03,008,01,012,0232,374,474,6,480,696,0,0,0,0,0,0,0,66.31 ,68.97 ,66.31 
03,008,01,012,0232,375,264,2,266,386,0,0,0,0,0,0,0,66.31 ,68.91 ,66.31 
03,008,01,012,0233,376,378,2,380,548,0,0,0,0,0,0,0,66.31 ,69.34 ,66.31 
03,008,01,012,0234,377,288,6,294,413,0,0,0,0,0,0,0,66.31 ,71.19 ,66.31 
03,008,01,012,0234,378,231,1,232,327,0,0,0,0,0,0,0,66.31 ,70.95 ,66.31 
03,008,01,012,0235,379,235,4,239,335,0,0,0,0,0,0,0,66.31 ,71.34 ,66.31 
03,008,01,012,0236,380,49,1,50,77,0,0,0,0,0,0,0,66.31 ,64.94 ,66.31 
03,008,01,012,0237,381,137,0,137,220,0,0,0,0,0,0,0,66.31 ,62.27 ,66.31 
03,008,01,012,0238,382,12,0,12,26,0,0,0,0,0,0,0,66.31 ,46.15 ,66.31 
03,008,01,012,0238,383,159,1,160,268,0,0,0,0,0,0,0,66.31 ,59.70 ,66.31 
03,008,01,012,0239,384,152,5,157,247,0,0,0,0,0,0,0,66.31 ,63.56 ,66.31 
03,008,01,012,0240,385,293,5,298,467,0,0,0,0,0,0,0,66.31 ,63.81 ,66.31 
03,008,01,012,0240,386,165,0,165,274,0,0,0,0,0,0,0,66.31 ,60.22 ,66.31 
03,008,01,012,0241,387,564,2,566,886,0,0,0,0,0,0,0,66.31 ,63.88 ,66.31 
03,008,01,012,0241,388,274,1,275,438,0,0,0,0,0,0,0,66.31 ,62.79 ,66.31 
03,008,01,012,0242,389,29,1,30,67,0,0,0,0,0,0,0,66.31 ,44.78 ,66.31 
03,008,01,012,0242,390,87,2,89,175,0,0,0,0,0,0,0,66.31 ,50.86 ,66.31 
03,008,01,012,0243,391,10,0,10,16,0,0,0,0,0,0,0,66.31 ,62.50 ,66.31 
03,008,01,012,0244,392,56,0,56,104,0,0,0,0,0,0,0,66.31 ,53.85 ,66.31 
03,008,01,012,0245,393,18,0,18,40,0,0,0,0,0,0,0,66.31 ,45.00 ,66.31 
03,008,01,013,0246,394,117,1,118,229,0,0,0,0,0,0,0,66.31 ,51.53 ,66.31 
03,008,01,013,0246,395,168,1,169,305,0,0,0,0,0,0,0,66.31 ,55.41 ,66.31 
03,008,01,013,0247,396,337,4,341,559,0,0,0,0,0,0,0,66.31 ,61.00 ,66.31 
03,008,01,013,0247,397,195,3,198,303,0,0,0,0,0,0,0,66.31 ,65.35 ,66.31 
03,008,01,013,0247,398,124,1,125,216,0,0,0,0,0,0,0,66.31 ,57.87 ,66.31 
03,008,01,013,0248,399,58,0,58,86,0,0,0,0,0,0,0,66.31 ,67.44 ,66.31 
03,008,01,013,0249,400,29,0,29,58,0,0,0,0,0,0,0,66.31 ,50.00 ,66.31 
03,008,01,013,0250,401,56,1,57,112,0,0,0,0,0,0,0,66.31 ,50.89 ,66.31 
03,008,01,013,0250,402,16,1,17,31,0,0,0,0,0,0,0,66.31 ,54.84 ,66.31 
03,008,01,013,0251,403,17,0,17,27,0,0,0,0,0,0,0,66.31 ,62.96 ,66.31 
03,008,01,013,0252,404,11,1,12,22,0,0,0,0,0,0,0,66.31 ,54.55 ,66.31 
03,008,01,013,0252,405,4,1,5,17,0,0,0,0,0,0,0,66.31 ,29.41 ,66.31 
03,008,01,013,0252,406,131,2,133,218,0,0,0,0,0,0,0,66.31 ,61.01 ,66.31 
03,008,01,013,0253,407,13,0,13,22,0,0,0,0,0,0,0,66.31 ,59.09 ,66.31 
03,008,01,013,0253,408,4,0,4,16,0,0,0,0,0,0,0,66.31 ,25.00 ,66.31 
03,008,01,013,0253,409,13,1,14,35,0,0,0,0,0,0,0,66.31 ,40.00 ,66.31 
03,008,01,013,0254,410,13,1,14,34,0,0,0,0,0,0,0,66.31 ,41.18 ,66.31 
03,008,01,013,0254,411,7,0,7,10,0,0,0,0,0,0,0,66.31 ,70.00 ,66.31 
03,008,01,013,0254,412,21,1,22,37,0,0,0,0,0,0,0,66.31 ,59.46 ,66.31 
03,008,01,013,0255,413,34,1,35,64,0,0,0,0,0,0,0,66.31 ,54.69 ,66.31 
03,008,01,013,0256,414,15,0,15,43,0,0,0,0,0,0,0,66.31 ,34.88 ,66.31 
03,008,01,013,0257,415,40,1,41,85,0,0,0,0,0,0,0,66.31 ,48.24 ,66.31 
03,008,01,013,0258,416,30,0,30,86,0,0,0,0,0,0,0,66.31 ,34.88 ,66.31 
03,008,01,013,0258,417,13,1,14,26,0,0,0,0,0,0,0,66.31 ,53.85 ,66.31 
03,008,01,013,0259,418,27,0,27,57,0,0,0,0,0,0,0,66.31 ,47.37 ,66.31 
03,009,01,001,0001,1,658,8,666,977,0,0,0,0,0,0,0,66.31 ,68.17 ,66.31 
03,009,01,001,0002,2,487,8,495,682,0,0,0,0,0,0,0,66.31 ,72.58 ,66.31 
03,009,01,001,0003,3,539,12,551,739,0,0,0,0,0,0,0,66.31 ,74.56 ,66.31 
03,009,01,001,0004,4,443,10,453,622,0,0,0,0,0,0,0,66.31 ,72.83 ,66.31 
03,009,01,001,0005,5,626,11,637,924,0,0,0,0,0,0,0,66.31 ,68.94 ,66.31 
03,009,01,001,0006,6,769,14,783,1157,0,0,0,0,0,0,0,66.31 ,67.68 ,66.31 
03,009,01,001,0006,7,884,24,908,1291,0,0,0,0,0,0,0,66.31 ,70.33 ,66.31 
03,009,01,001,0007,8,626,11,637,888,0,0,0,0,0,0,0,66.31 ,71.73 ,66.31 
03,009,01,001,0007,9,711,13,724,1069,0,0,0,0,0,0,0,66.31 ,67.73 ,66.31 
03,009,01,001,0007,10,876,18,894,1255,0,0,0,0,0,0,0,66.31 ,71.24 ,66.31 
03,009,01,001,0008,11,1108,14,1122,1573,0,0,0,0,0,0,0,66.31 ,71.33 ,66.31 
03,009,01,001,0008,12,1033,14,1047,1446,0,0,0,0,0,0,0,66.31 ,72.41 ,66.31 
03,009,01,001,0009,13,1030,18,1048,1609,0,0,0,0,0,0,0,66.31 ,65.13 ,66.31 
03,009,01,001,0009,14,777,9,786,1146,0,0,0,0,0,0,0,66.31 ,68.59 ,66.31 
03,009,01,001,0009,15,960,30,990,1405,0,0,0,0,0,0,0,66.31 ,70.46 ,66.31 
03,009,01,001,0009,16,835,14,849,1283,0,0,0,0,0,0,0,66.31 ,66.17 ,66.31 
03,009,01,001,0010,17,562,12,574,819,0,0,0,0,0,0,0,66.31 ,70.09 ,66.31 
03,009,01,001,0010,18,502,9,511,708,0,0,0,0,0,0,0,66.31 ,72.18 ,66.31 
03,009,01,001,0011,19,803,15,818,1142,0,0,0,0,0,0,0,66.31 ,71.63 ,66.31 
03,009,01,001,0012,20,762,13,775,1017,0,0,0,0,0,0,0,66.31 ,76.20 ,66.31 
03,009,01,001,0012,21,863,20,883,1309,0,0,0,0,0,0,0,66.31 ,67.46 ,66.31 
03,009,01,001,0013,22,667,12,679,1019,0,0,0,0,0,0,0,66.31 ,66.63 ,66.31 
03,009,01,001,0013,23,762,23,785,1087,0,0,0,0,0,0,0,66.31 ,72.22 ,66.31 
03,009,01,001,0014,24,667,7,674,905,0,0,0,0,0,0,0,66.31 ,74.48 ,66.31 
03,009,01,001,0014,25,678,18,696,1000,0,0,0,0,0,0,0,66.31 ,69.60 ,66.31 
03,009,01,001,0015,26,1004,19,1023,1483,0,0,0,0,0,0,0,66.31 ,68.98 ,66.31 
03,009,01,001,0015,27,795,10,805,1170,0,0,0,0,0,0,0,66.31 ,68.80 ,66.31 
03,009,01,001,0015,28,852,18,870,1338,0,0,0,0,0,0,0,66.31 ,65.02 ,66.31 
03,009,01,001,0015,29,759,12,771,1053,0,0,0,0,0,0,0,66.31 ,73.22 ,66.31 
03,009,01,001,0016,30,876,14,890,1338,0,0,0,0,0,0,0,66.31 ,66.52 ,66.31 
03,009,01,001,0016,31,1012,14,1026,1636,0,0,0,0,0,0,0,66.31 ,62.71 ,66.31 
03,009,01,001,0017,32,675,15,690,971,0,0,0,0,0,0,0,66.31 ,71.06 ,66.31 
03,009,01,001,0017,33,769,15,784,1113,0,0,0,0,0,0,0,66.31 ,70.44 ,66.31 
03,009,01,001,0018,34,680,12,692,946,0,0,0,0,0,0,0,66.31 ,73.15 ,66.31 
03,009,01,001,0019,35,478,4,482,636,0,0,0,0,0,0,0,66.31 ,75.79 ,66.31 
03,009,01,001,0020,36,671,15,686,933,0,0,0,0,0,0,0,66.31 ,73.53 ,66.31 
03,009,01,001,0020,37,477,6,483,653,0,0,0,0,0,0,0,66.31 ,73.97 ,66.31 
03,009,01,001,0021,38,390,5,395,527,0,0,0,0,0,0,0,66.31 ,74.95 ,66.31 
03,009,01,001,0022,39,771,14,785,1083,0,0,0,0,0,0,0,66.31 ,72.48 ,66.31 
03,009,01,001,0023,40,441,6,447,608,0,0,0,0,0,0,0,66.31 ,73.52 ,66.31 
03,009,01,001,0024,41,843,16,859,1137,0,0,0,0,0,0,0,66.31 ,75.55 ,66.31 
03,009,01,001,0024,42,400,12,412,575,0,0,0,0,0,0,0,66.31 ,71.65 ,66.31 
03,009,01,001,0025,43,775,15,790,1127,0,0,0,0,0,0,0,66.31 ,70.10 ,66.31 
03,009,01,001,0025,44,1070,26,1096,1593,0,0,0,0,0,0,0,66.31 ,68.80 ,66.31 
03,009,01,001,0025,45,857,9,866,1179,0,0,0,0,0,0,0,66.31 ,73.45 ,66.31 
03,009,01,001,0026,46,1121,20,1141,1509,0,0,0,0,0,0,0,66.31 ,75.61 ,66.31 
03,009,01,001,0026,47,842,12,854,1204,0,0,0,0,0,0,0,66.31 ,70.93 ,66.31 
03,009,01,001,0027,48,1044,17,1061,1458,0,0,0,0,0,0,0,66.31 ,72.77 ,66.31 
03,009,01,001,0028,49,879,13,892,1128,0,0,0,0,0,0,0,66.31 ,79.08 ,66.31 
03,009,01,001,0028,50,778,14,792,1077,0,0,0,0,0,0,0,66.31 ,73.54 ,66.31 
03,009,01,001,0028,51,880,24,904,1229,0,0,0,0,0,0,0,66.31 ,73.56 ,66.31 
03,009,01,001,0029,52,631,8,639,838,0,0,0,0,0,0,0,66.31 ,76.25 ,66.31 
03,009,01,001,0030,53,561,8,569,738,0,0,0,0,0,0,0,66.31 ,77.10 ,66.31 
03,009,01,001,0031,54,595,15,610,769,0,0,0,0,0,0,0,66.31 ,79.32 ,66.31 
03,009,01,001,0031,55,696,18,714,951,0,0,0,0,0,0,0,66.31 ,75.08 ,66.31 
03,009,01,001,0032,56,919,18,937,1272,0,0,0,0,0,0,0,66.31 ,73.66 ,66.31 
03,009,01,001,0033,57,726,11,737,976,0,0,0,0,0,0,0,66.31 ,75.51 ,66.31 
03,009,01,001,0033,58,866,16,882,1274,0,0,0,0,0,0,0,66.31 ,69.23 ,66.31 
03,009,01,001,0034,59,636,8,644,899,0,0,0,0,0,0,0,66.31 ,71.64 ,66.31 
03,009,01,001,0034,60,858,22,880,1279,0,0,0,0,0,0,0,66.31 ,68.80 ,66.31 
03,009,01,001,0035,61,823,9,832,1092,0,0,0,0,0,0,0,66.31 ,76.19 ,66.31 
03,009,01,002,0036,62,813,18,831,1114,0,0,0,0,0,0,0,66.31 ,74.60 ,66.31 
03,009,01,002,0037,63,991,16,1007,1386,0,0,0,0,0,0,0,66.31 ,72.66 ,66.31 
03,009,01,002,0037,64,900,15,915,1269,0,0,0,0,0,0,0,66.31 ,72.10 ,66.31 
03,009,01,002,0037,65,790,14,804,1137,0,0,0,0,0,0,0,66.31 ,70.71 ,66.31 
03,009,01,002,0038,66,677,9,686,1005,0,0,0,0,0,0,0,66.31 ,68.26 ,66.31 
03,009,01,002,0038,67,604,7,611,887,0,0,0,0,0,0,0,66.31 ,68.88 ,66.31 
03,009,01,002,0039,68,960,11,971,1225,0,0,0,0,0,0,0,66.31 ,79.27 ,66.31 
03,009,01,002,0040,69,934,13,947,1280,0,0,0,0,0,0,0,66.31 ,73.98 ,66.31 
03,009,01,002,0041,70,823,14,837,1136,0,0,0,0,0,0,0,66.31 ,73.68 ,66.31 
03,009,01,002,0042,71,637,6,643,857,0,0,0,0,0,0,0,66.31 ,75.03 ,66.31 
03,009,01,002,0043,72,611,9,620,892,0,0,0,0,0,0,0,66.31 ,69.51 ,66.31 
03,009,01,002,0044,73,673,5,678,893,0,0,0,0,0,0,0,66.31 ,75.92 ,66.31 
03,009,01,002,0045,74,507,9,516,729,0,0,0,0,0,0,0,66.31 ,70.78 ,66.31 
03,009,01,002,0046,75,927,7,934,1164,0,0,0,0,0,0,0,66.31 ,80.24 ,66.31 
03,009,01,002,0047,76,1030,15,1045,1350,0,0,0,0,0,0,0,66.31 ,77.41 ,66.31 
03,009,01,002,0048,77,1153,21,1174,1557,0,0,0,0,0,0,0,66.31 ,75.40 ,66.31 
03,009,01,002,0049,78,974,11,985,1352,0,0,0,0,0,0,0,66.31 ,72.86 ,66.31 
03,009,01,002,0049,79,1014,10,1024,1349,0,0,0,0,0,0,0,66.31 ,75.91 ,66.31 
03,009,01,002,0049,80,946,11,957,1334,0,0,0,0,0,0,0,66.31 ,71.74 ,66.31 
03,009,01,002,0050,81,787,11,798,1020,0,0,0,0,0,0,0,66.31 ,78.24 ,66.31 
03,009,01,002,0051,82,652,10,662,859,0,0,0,0,0,0,0,66.31 ,77.07 ,66.31 
03,009,01,002,0052,83,701,5,706,937,0,0,0,0,0,0,0,66.31 ,75.35 ,66.31 
03,009,01,002,0053,84,609,7,616,799,0,0,0,0,0,0,0,66.31 ,77.10 ,66.31 
03,009,01,002,0053,85,557,6,563,777,0,0,0,0,0,0,0,66.31 ,72.46 ,66.31 
03,009,01,002,0054,86,695,12,707,968,0,0,0,0,0,0,0,66.31 ,73.04 ,66.31 
03,009,01,002,0055,87,675,5,680,927,0,0,0,0,0,0,0,66.31 ,73.35 ,66.31 
03,009,01,002,0055,88,897,10,907,1296,0,0,0,0,0,0,0,66.31 ,69.98 ,66.31 
03,009,01,002,0056,89,780,15,795,1038,0,0,0,0,0,0,0,66.31 ,76.59 ,66.31 
03,009,01,002,0056,90,734,11,745,979,0,0,0,0,0,0,0,66.31 ,76.10 ,66.31 
03,009,01,002,0057,91,1107,13,1120,1529,0,0,0,0,0,0,0,66.31 ,73.25 ,66.31 
03,009,01,003,0058,92,740,11,751,1057,0,0,0,0,0,0,0,66.31 ,71.05 ,66.31 
03,009,01,003,0058,93,818,17,835,1199,0,0,0,0,0,0,0,66.31 ,69.64 ,66.31 
03,009,01,003,0059,94,491,4,495,703,0,0,0,0,0,0,0,66.31 ,70.41 ,66.31 
03,009,01,003,0059,95,650,11,661,959,0,0,0,0,0,0,0,66.31 ,68.93 ,66.31 
03,009,01,003,0060,96,714,13,727,1109,0,0,0,0,0,0,0,66.31 ,65.55 ,66.31 
03,009,01,003,0060,97,991,13,1004,1485,0,0,0,0,0,0,0,66.31 ,67.61 ,66.31 
03,009,01,003,0061,98,629,12,641,983,0,0,0,0,0,0,0,66.31 ,65.21 ,66.31 
03,009,01,003,0061,99,840,19,859,1380,0,0,0,0,0,0,0,66.31 ,62.25 ,66.31 
03,009,01,003,0062,100,799,12,811,1145,0,0,0,0,0,0,0,66.31 ,70.83 ,66.31 
03,009,01,003,0063,101,845,19,864,1346,0,0,0,0,0,0,0,66.31 ,64.19 ,66.31 
03,009,01,003,0063,102,936,8,944,1460,0,0,0,0,0,0,0,66.31 ,64.66 ,66.31 
03,009,01,003,0064,103,1052,14,1066,1515,0,0,0,0,0,0,0,66.31 ,70.36 ,66.31 
03,009,01,003,0064,104,975,21,996,1561,0,0,0,0,0,0,0,66.31 ,63.81 ,66.31 
03,009,01,003,0065,105,907,11,918,1263,0,0,0,0,0,0,0,66.31 ,72.68 ,66.31 
03,009,01,003,0066,106,726,15,741,1047,0,0,0,0,0,0,0,66.31 ,70.77 ,66.31 
03,009,01,003,0067,107,970,16,986,1476,0,0,0,0,0,0,0,66.31 ,66.80 ,66.31 
03,009,01,003,0068,108,1113,20,1133,1691,0,0,0,0,0,0,0,66.31 ,67.00 ,66.31 
03,009,01,003,0069,109,1107,17,1124,1574,0,0,0,0,0,0,0,66.31 ,71.41 ,66.31 
03,009,01,003,0070,110,629,11,640,849,0,0,0,0,0,0,0,66.31 ,75.38 ,66.31 
03,009,01,003,0071,111,470,9,479,716,0,0,0,0,0,0,0,66.31 ,66.90 ,66.31 
03,009,01,003,0072,112,791,17,808,1131,0,0,0,0,0,0,0,66.31 ,71.44 ,66.31 
03,009,01,003,0072,113,760,18,778,1043,0,0,0,0,0,0,0,66.31 ,74.59 ,66.31 
03,009,01,003,0073,114,568,9,577,741,0,0,0,0,0,0,0,66.31 ,77.87 ,66.31 
03,009,01,003,0074,115,1081,29,1110,1542,0,0,0,0,0,0,0,66.31 ,71.98 ,66.31 
03,009,01,003,0075,116,1071,16,1087,1474,0,0,0,0,0,0,0,66.31 ,73.74 ,66.31 
03,009,01,003,0076,117,882,63,945,1305,0,0,0,0,0,0,0,66.31 ,72.41 ,66.31 
03,009,01,003,0076,118,987,21,1008,1417,0,0,0,0,0,0,0,66.31 ,71.14 ,66.31 
03,009,01,003,0077,119,769,29,798,1169,0,0,0,0,0,0,0,66.31 ,68.26 ,66.31 
03,009,01,003,0077,120,723,6,729,975,0,0,0,0,0,0,0,66.31 ,74.77 ,66.31 
03,009,01,003,0078,121,776,8,784,1095,0,0,0,0,0,0,0,66.31 ,71.60 ,66.31 
03,009,01,003,0078,122,755,17,772,1123,0,0,0,0,0,0,0,66.31 ,68.74 ,66.31 
03,009,01,003,0079,123,833,23,856,1153,0,0,0,0,0,0,0,66.31 ,74.24 ,66.31 
03,009,01,003,0080,124,918,17,935,1262,0,0,0,0,0,0,0,66.31 ,74.09 ,66.31 
03,009,01,003,0081,125,795,21,816,1088,0,0,0,0,0,0,0,66.31 ,75.00 ,66.31 
03,009,01,003,0082,126,1037,11,1048,1433,0,0,0,0,0,0,0,66.31 ,73.13 ,66.31 
03,009,01,003,0083,127,523,13,536,848,0,0,0,0,0,0,0,66.31 ,63.21 ,66.31 
03,009,01,003,0084,128,605,14,619,951,0,0,0,0,0,0,0,66.31 ,65.09 ,66.31 
03,009,01,003,0085,129,545,9,554,737,0,0,0,0,0,0,0,66.31 ,75.17 ,66.31 
03,009,01,003,0086,130,682,6,688,964,0,0,0,0,0,0,0,66.31 ,71.37 ,66.31 
03,009,01,004,0087,131,1025,9,1034,1502,0,0,0,0,0,0,0,66.31 ,68.84 ,66.31 
03,009,01,004,0088,132,930,18,948,1332,0,0,0,0,0,0,0,66.31 ,71.17 ,66.31 
03,009,01,004,0089,133,1083,18,1101,1561,0,0,0,0,0,0,0,66.31 ,70.53 ,66.31 
03,009,01,004,0090,134,973,12,985,1485,0,0,0,0,0,0,0,66.31 ,66.33 ,66.31 
03,009,01,004,0090,135,863,8,871,1270,0,0,0,0,0,0,0,66.31 ,68.58 ,66.31 
03,009,01,004,0091,136,337,5,342,469,0,0,0,0,0,0,0,66.31 ,72.92 ,66.31 
03,009,01,004,0092,137,531,11,542,761,0,0,0,0,0,0,0,66.31 ,71.22 ,66.31 
03,009,01,004,0093,138,440,8,448,705,0,0,0,0,0,0,0,66.31 ,63.55 ,66.31 
03,009,01,004,0094,139,684,7,691,1019,0,0,0,0,0,0,0,66.31 ,67.81 ,66.31 
03,009,01,004,0095,140,799,13,812,1161,0,0,0,0,0,0,0,66.31 ,69.94 ,66.31 
03,009,01,004,0095,141,579,6,585,891,0,0,0,0,0,0,0,66.31 ,65.66 ,66.31 
03,009,01,004,0096,142,1014,11,1025,1587,0,0,0,0,0,0,0,66.31 ,64.59 ,66.31 
03,009,01,004,0096,143,1004,15,1019,1558,0,0,0,0,0,0,0,66.31 ,65.40 ,66.31 
03,009,01,004,0097,144,803,4,807,1231,0,0,0,0,0,0,0,66.31 ,65.56 ,66.31 
03,009,01,004,0098,145,901,14,915,1347,0,0,0,0,0,0,0,66.31 ,67.93 ,66.31 
03,009,01,004,0099,146,667,6,673,1014,0,0,0,0,0,0,0,66.31 ,66.37 ,66.31 
03,009,01,004,0099,147,482,7,489,723,0,0,0,0,0,0,0,66.31 ,67.63 ,66.31 
03,009,01,004,0100,148,603,10,613,891,0,0,0,0,0,0,0,66.31 ,68.80 ,66.31 
03,009,01,004,0101,149,730,9,739,1136,0,0,0,0,0,0,0,66.31 ,65.05 ,66.31 
03,009,01,004,0102,150,974,16,990,1459,0,0,0,0,0,0,0,66.31 ,67.85 ,66.31 
03,009,01,004,0103,151,596,8,604,863,0,0,0,0,0,0,0,66.31 ,69.99 ,66.31 
03,009,01,004,0104,152,724,7,731,1000,0,0,0,0,0,0,0,66.31 ,73.10 ,66.31 
03,009,01,004,0105,153,884,11,895,1351,0,0,0,0,0,0,0,66.31 ,66.25 ,66.31 
03,009,01,004,0106,154,505,12,517,734,0,0,0,0,0,0,0,66.31 ,70.44 ,66.31 
03,009,01,004,0107,155,592,9,601,802,0,0,0,0,0,0,0,66.31 ,74.94 ,66.31 
03,009,01,004,0108,156,681,11,692,1005,0,0,0,0,0,0,0,66.31 ,68.86 ,66.31 
03,009,01,004,0109,157,925,11,936,1351,0,0,0,0,0,0,0,66.31 ,69.28 ,66.31 
03,009,01,004,0110,158,616,10,626,935,0,0,0,0,0,0,0,66.31 ,66.95 ,66.31 
03,009,01,004,0111,159,592,3,595,949,0,0,0,0,0,0,0,66.31 ,62.70 ,66.31 
03,009,01,004,0112,160,526,10,536,911,0,0,0,0,0,0,0,66.31 ,58.84 ,66.31 
03,009,01,004,0112,161,526,6,532,850,0,0,0,0,0,0,0,66.31 ,62.59 ,66.31 
03,009,01,004,0113,162,905,10,915,1354,0,0,0,0,0,0,0,66.31 ,67.58 ,66.31 
03,009,01,005,0114,163,628,16,644,913,0,0,0,0,0,0,0,66.31 ,70.54 ,66.31 
03,009,01,005,0115,164,737,15,752,1025,0,0,0,0,0,0,0,66.31 ,73.37 ,66.31 
03,009,01,005,0116,165,898,16,914,1310,0,0,0,0,0,0,0,66.31 ,69.77 ,66.31 
03,009,01,005,0117,166,602,10,612,817,0,0,0,0,0,0,0,66.31 ,74.91 ,66.31 
03,009,01,005,0118,167,500,3,503,697,0,0,0,0,0,0,0,66.31 ,72.17 ,66.31 
03,009,01,005,0118,168,302,3,305,421,0,0,0,0,0,0,0,66.31 ,72.45 ,66.31 
03,009,01,005,0119,169,982,19,1001,1431,0,0,0,0,0,0,0,66.31 ,69.95 ,66.31 
03,009,01,005,0120,170,397,5,402,590,0,0,0,0,0,0,0,66.31 ,68.14 ,66.31 
03,009,01,005,0120,171,363,2,365,614,0,0,0,0,0,0,0,66.31 ,59.45 ,66.31 
03,009,01,005,0121,172,506,7,513,829,0,0,0,0,0,0,0,66.31 ,61.88 ,66.31 
03,009,01,005,0121,173,382,4,386,624,0,0,0,0,0,0,0,66.31 ,61.86 ,66.31 
03,009,01,005,0122,174,587,9,596,908,0,0,0,0,0,0,0,66.31 ,65.64 ,66.31 
03,009,01,005,0122,175,388,11,399,574,0,0,0,0,0,0,0,66.31 ,69.51 ,66.31 
03,009,01,005,0123,176,859,8,867,1279,0,0,0,0,0,0,0,66.31 ,67.79 ,66.31 
03,009,01,005,0123,177,656,5,661,971,0,0,0,0,0,0,0,66.31 ,68.07 ,66.31 
03,009,01,005,0124,178,534,3,537,769,0,0,0,0,0,0,0,66.31 ,69.83 ,66.31 
03,009,01,005,0124,179,433,5,438,686,0,0,0,0,0,0,0,66.31 ,63.85 ,66.31 
03,009,01,005,0125,180,564,7,571,821,0,0,0,0,0,0,0,66.31 ,69.55 ,66.31 
03,009,01,005,0126,181,645,8,653,1000,0,0,0,0,0,0,0,66.31 ,65.30 ,66.31 
03,009,01,005,0126,182,485,2,487,782,0,0,0,0,0,0,0,66.31 ,62.28 ,66.31 
03,009,01,005,0127,183,667,3,670,936,0,0,0,0,0,0,0,66.31 ,71.58 ,66.31 
03,009,01,005,0127,184,554,12,566,788,0,0,0,0,0,0,0,66.31 ,71.83 ,66.31 
03,009,01,005,0128,185,643,7,650,948,0,0,0,0,0,0,0,66.31 ,68.57 ,66.31 
03,009,01,005,0128,186,549,6,555,859,0,0,0,0,0,0,0,66.31 ,64.61 ,66.31 
03,009,01,005,0129,187,641,5,646,972,0,0,0,0,0,0,0,66.31 ,66.46 ,66.31 
03,009,01,005,0130,188,952,11,963,1435,0,0,0,0,0,0,0,66.31 ,67.11 ,66.31 
03,009,01,006,0131,189,630,24,654,857,0,0,0,0,0,0,0,66.31 ,76.31 ,66.31 
03,009,01,006,0132,190,598,9,607,811,0,0,0,0,0,0,0,66.31 ,74.85 ,66.31 
03,009,01,006,0133,191,385,3,388,524,0,0,0,0,0,0,0,66.31 ,74.05 ,66.31 
03,009,01,006,0134,192,731,19,750,1032,0,0,0,0,0,0,0,66.31 ,72.67 ,66.31 
03,009,01,006,0135,193,308,6,314,417,0,0,0,0,0,0,0,66.31 ,75.30 ,66.31 
03,009,01,006,0136,194,333,8,341,467,0,0,0,0,0,0,0,66.31 ,73.02 ,66.31 
03,009,01,006,0137,195,356,5,361,487,0,0,0,0,0,0,0,66.31 ,74.13 ,66.31 
03,009,01,006,0138,196,617,7,624,885,0,0,0,0,0,0,0,66.31 ,70.51 ,66.31 
03,009,01,006,0139,197,396,8,404,556,0,0,0,0,0,0,0,66.31 ,72.66 ,66.31 
03,009,01,006,0140,198,319,2,321,426,0,0,0,0,0,0,0,66.31 ,75.35 ,66.31 
03,009,01,006,0141,199,476,14,490,666,0,0,0,0,0,0,0,66.31 ,73.57 ,66.31 
03,009,01,006,0142,200,390,3,393,544,0,0,0,0,0,0,0,66.31 ,72.24 ,66.31 
03,009,01,006,0142,201,539,12,551,804,0,0,0,0,0,0,0,66.31 ,68.53 ,66.31 
03,009,01,006,0143,202,328,6,334,474,0,0,0,0,0,0,0,66.31 ,70.46 ,66.31 
03,009,01,006,0144,203,782,12,794,1084,0,0,0,0,0,0,0,66.31 ,73.25 ,66.31 
03,009,01,006,0144,204,924,14,938,1396,0,0,0,0,0,0,0,66.31 ,67.19 ,66.31 
03,009,01,006,0144,205,712,16,728,1022,0,0,0,0,0,0,0,66.31 ,71.23 ,66.31 
03,009,01,006,0144,206,861,18,879,1290,0,0,0,0,0,0,0,66.31 ,68.14 ,66.31 
03,009,01,006,0145,207,793,13,806,1169,0,0,0,0,0,0,0,66.31 ,68.95 ,66.31 
03,009,01,006,0146,208,656,15,671,989,0,0,0,0,0,0,0,66.31 ,67.85 ,66.31 
03,009,01,006,0146,209,833,11,844,1225,0,0,0,0,0,0,0,66.31 ,68.90 ,66.31 
03,009,01,006,0146,210,809,27,836,1191,0,0,0,0,0,0,0,66.31 ,70.19 ,66.31 
03,009,01,006,0146,211,788,20,808,1146,0,0,0,0,0,0,0,66.31 ,70.51 ,66.31 
03,009,01,006,0147,212,772,16,788,1142,0,0,0,0,0,0,0,66.31 ,69.00 ,66.31 
03,009,01,006,0148,213,379,6,385,602,0,0,0,0,0,0,0,66.31 ,63.95 ,66.31 
03,009,01,006,0148,214,232,3,235,374,0,0,0,0,0,0,0,66.31 ,62.83 ,66.31 
03,009,01,006,0149,215,294,6,300,437,0,0,0,0,0,0,0,66.31 ,68.65 ,66.31 
03,009,01,006,0150,216,569,12,581,870,0,0,0,0,0,0,0,66.31 ,66.78 ,66.31 
03,009,01,006,0151,217,928,27,955,1411,0,0,0,0,0,0,0,66.31 ,67.68 ,66.31 
03,009,01,006,0152,218,733,13,746,1235,0,0,0,0,0,0,0,66.31 ,60.40 ,66.31 
03,009,01,006,0153,219,617,11,628,1087,0,0,0,0,0,0,0,66.31 ,57.77 ,66.31 
03,009,01,006,0154,220,394,9,403,667,0,0,0,0,0,0,0,66.31 ,60.42 ,66.31 
03,009,01,006,0155,221,738,10,748,1010,0,0,0,0,0,0,0,66.31 ,74.06 ,66.31 
03,009,01,006,0155,222,431,13,444,616,0,0,0,0,0,0,0,66.31 ,72.08 ,66.31 
03,009,01,006,0156,223,783,15,798,1242,0,0,0,0,0,0,0,66.31 ,64.25 ,66.31 
03,009,01,006,0156,224,955,17,972,1418,0,0,0,0,0,0,0,66.31 ,68.55 ,66.31 
03,009,01,006,0157,225,703,11,714,1092,0,0,0,0,0,0,0,66.31 ,65.38 ,66.31 
03,009,01,006,0158,226,389,5,394,601,0,0,0,0,0,0,0,66.31 ,65.56 ,66.31 
03,009,01,007,0159,227,813,15,828,1133,0,0,0,0,0,0,0,66.31 ,73.08 ,66.31 
03,009,01,007,0159,228,692,6,698,912,0,0,0,0,0,0,0,66.31 ,76.54 ,66.31 
03,009,01,007,0160,229,1079,22,1101,1507,0,0,0,0,0,0,0,66.31 ,73.06 ,66.31 
03,009,01,007,0161,230,907,18,925,1263,0,0,0,0,0,0,0,66.31 ,73.24 ,66.31 
03,009,01,007,0161,231,1001,17,1018,1428,0,0,0,0,0,0,0,66.31 ,71.29 ,66.31 
03,009,01,007,0162,232,829,10,839,1128,0,0,0,0,0,0,0,66.31 ,74.38 ,66.31 
03,009,01,007,0162,233,208,0,208,297,0,0,0,0,0,0,0,66.31 ,70.03 ,66.31 
03,009,01,007,0163,234,840,12,852,1113,0,0,0,0,0,0,0,66.31 ,76.55 ,66.31 
03,009,01,007,0164,235,861,18,879,1223,0,0,0,0,0,0,0,66.31 ,71.87 ,66.31 
03,009,01,007,0165,236,682,6,688,890,0,0,0,0,0,0,0,66.31 ,77.30 ,66.31 
03,009,01,007,0166,237,721,13,734,954,0,0,0,0,0,0,0,66.31 ,76.94 ,66.31 
03,009,01,007,0166,238,735,9,744,1015,0,0,0,0,0,0,0,66.31 ,73.30 ,66.31 
03,009,01,007,0167,239,647,10,657,898,0,0,0,0,0,0,0,66.31 ,73.16 ,66.31 
03,009,01,007,0167,240,708,10,718,982,0,0,0,0,0,0,0,66.31 ,73.12 ,66.31 
03,009,01,007,0168,241,1023,12,1035,1353,0,0,0,0,0,0,0,66.31 ,76.50 ,66.31 
03,009,01,007,0169,242,565,6,571,716,0,0,0,0,0,0,0,66.31 ,79.75 ,66.31 
03,009,01,007,0170,243,687,9,696,921,0,0,0,0,0,0,0,66.31 ,75.57 ,66.31 
03,009,01,007,0170,244,652,8,660,916,0,0,0,0,0,0,0,66.31 ,72.05 ,66.31 
03,009,01,007,0171,245,748,12,760,1007,0,0,0,0,0,0,0,66.31 ,75.47 ,66.31 
03,009,01,007,0171,246,701,11,712,942,0,0,0,0,0,0,0,66.31 ,75.58 ,66.31 
03,009,01,007,0172,247,522,5,527,651,0,0,0,0,0,0,0,66.31 ,80.95 ,66.31 
03,009,01,007,0173,248,974,20,994,1339,0,0,0,0,0,0,0,66.31 ,74.23 ,66.31 
03,009,01,007,0174,249,259,2,261,341,0,0,0,0,0,0,0,66.31 ,76.54 ,66.31 
03,009,01,007,0175,250,751,16,767,1057,0,0,0,0,0,0,0,66.31 ,72.56 ,66.31 
03,009,01,007,0176,251,674,8,682,929,0,0,0,0,0,0,0,66.31 ,73.41 ,66.31 
03,009,01,007,0177,252,385,3,388,550,0,0,0,0,0,0,0,66.31 ,70.55 ,66.31 
03,009,01,007,0178,253,526,4,530,692,0,0,0,0,0,0,0,66.31 ,76.59 ,66.31 
03,009,01,008,0179,254,540,10,550,808,0,0,0,0,0,0,0,66.31 ,68.07 ,66.31 
03,009,01,008,0180,255,1040,9,1049,1443,0,0,0,0,0,0,0,66.31 ,72.70 ,66.31 
03,009,01,008,0180,256,444,8,452,557,0,0,0,0,0,0,0,66.31 ,81.15 ,66.31 
03,009,01,008,0181,257,785,15,800,1156,0,0,0,0,0,0,0,66.31 ,69.20 ,66.31 
03,009,01,008,0182,258,734,17,751,1084,0,0,0,0,0,0,0,66.31 ,69.28 ,66.31 
03,009,01,008,0183,259,901,9,910,1273,0,0,0,0,0,0,0,66.31 ,71.48 ,66.31 
03,009,01,008,0183,260,343,4,347,489,0,0,0,0,0,0,0,66.31 ,70.96 ,66.31 
03,009,01,008,0184,261,963,19,982,1330,0,0,0,0,0,0,0,66.31 ,73.83 ,66.31 
03,009,01,008,0184,262,371,7,378,484,0,0,0,0,0,0,0,66.31 ,78.10 ,66.31 
03,009,01,008,0185,263,844,13,857,1137,0,0,0,0,0,0,0,66.31 ,75.37 ,66.31 
03,009,01,008,0186,264,895,10,905,1228,0,0,0,0,0,0,0,66.31 ,73.70 ,66.31 
03,009,01,008,0187,265,536,4,540,807,0,0,0,0,0,0,0,66.31 ,66.91 ,66.31 
03,009,01,008,0188,266,516,7,523,715,0,0,0,0,0,0,0,66.31 ,73.15 ,66.31 
03,009,01,008,0189,267,793,9,802,1244,0,0,0,0,0,0,0,66.31 ,64.47 ,66.31 
03,009,01,008,0190,268,588,4,592,853,0,0,0,0,0,0,0,66.31 ,69.40 ,66.31 
03,009,01,008,0191,269,483,6,489,730,0,0,0,0,0,0,0,66.31 ,66.99 ,66.31 
03,009,01,008,0192,270,574,5,579,865,0,0,0,0,0,0,0,66.31 ,66.94 ,66.31 
03,009,01,008,0193,271,619,6,625,846,0,0,0,0,0,0,0,66.31 ,73.88 ,66.31 
03,009,01,009,0194,272,1069,20,1089,1477,0,0,0,0,0,0,0,66.31 ,73.73 ,66.31 
03,009,01,009,0194,273,1231,19,1250,1741,0,0,0,0,0,0,0,66.31 ,71.80 ,66.31 
03,009,01,009,0195,274,646,7,653,907,0,0,0,0,0,0,0,66.31 ,72.00 ,66.31 
03,009,01,009,0196,275,1055,11,1066,1565,0,0,0,0,0,0,0,66.31 ,68.12 ,66.31 
03,009,01,009,0197,276,398,3,401,565,0,0,0,0,0,0,0,66.31 ,70.97 ,66.31 
03,009,01,009,0197,277,535,7,542,722,0,0,0,0,0,0,0,66.31 ,75.07 ,66.31 
03,009,01,009,0198,278,798,6,804,1112,0,0,0,0,0,0,0,66.31 ,72.30 ,66.31 
03,009,01,009,0199,279,1198,23,1221,1723,0,0,0,0,0,0,0,66.31 ,70.86 ,66.31 
03,009,01,009,0200,280,897,13,910,1188,0,0,0,0,0,0,0,66.31 ,76.60 ,66.31 
03,009,01,009,0200,281,751,17,768,1021,0,0,0,0,0,0,0,66.31 ,75.22 ,66.31 
03,009,01,009,0201,282,936,13,949,1165,0,0,0,0,0,0,0,66.31 ,81.46 ,66.31 
03,009,01,009,0202,283,639,9,648,894,0,0,0,0,0,0,0,66.31 ,72.48 ,66.31 
03,009,01,009,0202,284,700,10,710,929,0,0,0,0,0,0,0,66.31 ,76.43 ,66.31 
03,009,01,009,0203,285,829,15,844,1128,0,0,0,0,0,0,0,66.31 ,74.82 ,66.31 
03,009,01,009,0204,286,1142,17,1159,1715,0,0,0,0,0,0,0,66.31 ,67.58 ,66.31 
03,009,01,009,0205,287,1070,12,1082,1533,0,0,0,0,0,0,0,66.31 ,70.58 ,66.31 
03,009,01,009,0206,288,878,17,895,1290,0,0,0,0,0,0,0,66.31 ,69.38 ,66.31 
03,009,01,009,0207,289,1127,8,1135,1652,0,0,0,0,0,0,0,66.31 ,68.70 ,66.31 
03,009,01,010,0208,290,749,14,763,1033,0,0,0,0,0,0,0,66.31 ,73.86 ,66.31 
03,009,01,010,0209,291,1009,18,1027,1437,0,0,0,0,0,0,0,66.31 ,71.47 ,66.31 
03,009,01,010,0209,292,1124,30,1154,1657,0,0,0,0,0,0,0,66.31 ,69.64 ,66.31 
03,009,01,010,0210,293,976,20,996,1356,0,0,0,0,0,0,0,66.31 ,73.45 ,66.31 
03,009,01,010,0210,294,468,8,476,696,0,0,0,0,0,0,0,66.31 ,68.39 ,66.31 
03,009,01,010,0211,295,479,5,484,633,0,0,0,0,0,0,0,66.31 ,76.46 ,66.31 
03,009,01,010,0212,296,721,13,734,997,0,0,0,0,0,0,0,66.31 ,73.62 ,66.31 
03,009,01,010,0213,297,748,22,770,1003,0,0,0,0,0,0,0,66.31 ,76.77 ,66.31 
03,009,01,010,0213,298,996,23,1019,1464,0,0,0,0,0,0,0,66.31 ,69.60 ,66.31 
03,009,01,010,0214,299,463,4,467,629,0,0,0,0,0,0,0,66.31 ,74.24 ,66.31 
03,009,01,010,0215,300,846,13,859,1122,0,0,0,0,0,0,0,66.31 ,76.56 ,66.31 
03,009,01,010,0216,301,745,24,769,1057,0,0,0,0,0,0,0,66.31 ,72.75 ,66.31 
03,009,01,010,0217,302,619,13,632,843,0,0,0,0,0,0,0,66.31 ,74.97 ,66.31 
03,009,01,010,0217,303,608,7,615,827,0,0,0,0,0,0,0,66.31 ,74.37 ,66.31 
03,009,01,011,0218,304,883,11,894,1346,0,0,0,0,0,0,0,66.31 ,66.42 ,66.31 
03,009,01,011,0219,305,1042,16,1058,1560,0,0,0,0,0,0,0,66.31 ,67.82 ,66.31 
03,009,01,011,0220,306,472,7,479,754,0,0,0,0,0,0,0,66.31 ,63.53 ,66.31 
03,009,01,011,0220,307,694,6,700,1083,0,0,0,0,0,0,0,66.31 ,64.64 ,66.31 
03,009,01,011,0221,308,347,0,347,506,0,0,0,0,0,0,0,66.31 ,68.58 ,66.31 
03,009,01,011,0221,309,800,12,812,1186,0,0,0,0,0,0,0,66.31 ,68.47 ,66.31 
03,009,01,011,0222,310,845,17,862,1223,0,0,0,0,0,0,0,66.31 ,70.48 ,66.31 
03,009,01,011,0223,311,654,12,666,984,0,0,0,0,0,0,0,66.31 ,67.68 ,66.31 
03,009,01,011,0223,312,675,13,688,964,0,0,0,0,0,0,0,66.31 ,71.37 ,66.31 
03,009,01,011,0224,313,623,5,628,930,0,0,0,0,0,0,0,66.31 ,67.53 ,66.31 
03,009,01,011,0225,314,853,11,864,1329,0,0,0,0,0,0,0,66.31 ,65.01 ,66.31 
03,009,01,011,0226,315,593,11,604,949,0,0,0,0,0,0,0,66.31 ,63.65 ,66.31 
03,009,01,011,0227,316,490,3,493,799,0,0,0,0,0,0,0,66.31 ,61.70 ,66.31 
03,009,01,011,0228,317,983,15,998,1491,0,0,0,0,0,0,0,66.31 ,66.93 ,66.31 
03,009,01,011,0229,318,749,9,758,1231,0,0,0,0,0,0,0,66.31 ,61.58 ,66.31 
03,009,01,011,0229,319,493,6,499,730,0,0,0,0,0,0,0,66.31 ,68.36 ,66.31 
03,009,01,011,0230,320,564,5,569,899,0,0,0,0,0,0,0,66.31 ,63.29 ,66.31 
03,009,01,011,0231,321,777,9,786,1103,0,0,0,0,0,0,0,66.31 ,71.26 ,66.31 
03,009,01,011,0231,322,400,4,404,677,0,0,0,0,0,0,0,66.31 ,59.68 ,66.31 
03,009,01,011,0232,323,887,7,894,1403,0,0,0,0,0,0,0,66.31 ,63.72 ,66.31 
03,009,01,011,0233,324,615,5,620,1034,0,0,0,0,0,0,0,66.31 ,59.96 ,66.31 
03,009,01,011,0234,325,582,8,590,836,0,0,0,0,0,0,0,66.31 ,70.57 ,66.31 
03,009,01,011,0235,326,710,5,715,1051,0,0,0,0,0,0,0,66.31 ,68.03 ,66.31 
03,009,01,012,0236,327,921,17,938,1294,0,0,0,0,0,0,0,66.31 ,72.49 ,66.31 
03,009,01,012,0237,328,932,14,946,1317,0,0,0,0,0,0,0,66.31 ,71.83 ,66.31 
03,009,01,012,0238,329,694,14,708,979,0,0,0,0,0,0,0,66.31 ,72.32 ,66.31 
03,009,01,012,0238,330,880,22,902,1216,0,0,0,0,0,0,0,66.31 ,74.18 ,66.31 
03,009,01,012,0239,331,681,10,691,1002,0,0,0,0,0,0,0,66.31 ,68.96 ,66.31 
03,009,01,012,0239,332,563,14,577,926,0,0,0,0,0,0,0,66.31 ,62.31 ,66.31 
03,009,01,012,0240,333,536,10,546,889,0,0,0,0,0,0,0,66.31 ,61.42 ,66.31 
03,009,01,012,0240,334,688,4,692,984,0,0,0,0,0,0,0,66.31 ,70.33 ,66.31 
03,009,01,012,0241,335,877,16,893,1335,0,0,0,0,0,0,0,66.31 ,66.89 ,66.31 
03,009,01,012,0242,336,730,6,736,1007,0,0,0,0,0,0,0,66.31 ,73.09 ,66.31 
03,009,01,012,0242,337,615,6,621,902,0,0,0,0,0,0,0,66.31 ,68.85 ,66.31 
03,009,01,012,0243,338,576,7,583,876,0,0,0,0,0,0,0,66.31 ,66.55 ,66.31 
03,009,01,012,0244,339,524,5,529,828,0,0,0,0,0,0,0,66.31 ,63.89 ,66.31 
03,009,01,012,0244,340,602,4,606,939,0,0,0,0,0,0,0,66.31 ,64.54 ,66.31 
03,009,01,012,0245,341,599,6,605,971,0,0,0,0,0,0,0,66.31 ,62.31 ,66.31 
03,009,01,012,0245,342,602,8,610,1046,0,0,0,0,0,0,0,66.31 ,58.32 ,66.31 
03,009,01,012,0246,343,805,12,817,1446,0,0,0,0,0,0,0,66.31 ,56.50 ,66.31 
03,009,01,012,0247,344,788,9,797,1144,0,0,0,0,0,0,0,66.31 ,69.67 ,66.31 
03,009,01,012,0248,345,817,7,824,1262,0,0,0,0,0,0,0,66.31 ,65.29 ,66.31 
03,009,01,012,0249,346,589,9,598,872,0,0,0,0,0,0,0,66.31 ,68.58 ,66.31 
03,009,01,013,0250,347,392,4,396,557,0,0,0,0,0,0,0,66.31 ,71.10 ,66.31 
03,009,01,013,0250,348,847,12,859,1278,0,0,0,0,0,0,0,66.31 ,67.21 ,66.31 
03,009,01,013,0250,349,736,6,742,1070,0,0,0,0,0,0,0,66.31 ,69.35 ,66.31 
03,009,01,013,0251,350,743,4,747,1151,0,0,0,0,0,0,0,66.31 ,64.90 ,66.31 
03,009,01,013,0251,351,777,14,791,1225,0,0,0,0,0,0,0,66.31 ,64.57 ,66.31 
03,009,01,013,0252,352,346,3,349,495,0,0,0,0,0,0,0,66.31 ,70.51 ,66.31 
03,009,01,013,0252,353,588,0,588,847,0,0,0,0,0,0,0,66.31 ,69.42 ,66.31 
03,009,01,013,0253,354,498,5,503,741,0,0,0,0,0,0,0,66.31 ,67.88 ,66.31 
03,009,01,013,0253,355,719,6,725,1101,0,0,0,0,0,0,0,66.31 ,65.85 ,66.31 
03,009,01,013,0254,356,517,5,522,813,0,0,0,0,0,0,0,66.31 ,64.21 ,66.31 
03,009,01,013,0254,357,391,4,395,621,0,0,0,0,0,0,0,66.31 ,63.61 ,66.31 
03,009,01,013,0255,358,655,8,663,1000,0,0,0,0,0,0,0,66.31 ,66.30 ,66.31 
03,009,01,013,0255,359,700,6,706,1059,0,0,0,0,0,0,0,66.31 ,66.67 ,66.31 
03,009,01,013,0256,360,547,6,553,880,0,0,0,0,0,0,0,66.31 ,62.84 ,66.31 
03,009,01,013,0256,361,768,8,776,1201,0,0,0,0,0,0,0,66.31 ,64.61 ,66.31 
03,009,01,013,0257,362,649,11,660,1132,0,0,0,0,0,0,0,66.31 ,58.30 ,66.31 
03,009,01,013,0257,363,428,8,436,695,0,0,0,0,0,0,0,66.31 ,62.73 ,66.31 
03,009,01,013,0258,364,572,10,582,951,0,0,0,0,0,0,0,66.31 ,61.20 ,66.31 
03,009,01,013,0258,365,904,15,919,1471,0,0,0,0,0,0,0,66.31 ,62.47 ,66.31 
03,009,01,013,0259,366,500,10,510,804,0,0,0,0,0,0,0,66.31 ,63.43 ,66.31 
03,009,01,013,0260,367,708,9,717,1124,0,0,0,0,0,0,0,66.31 ,63.79 ,66.31 
03,009,01,013,0260,368,620,6,626,1010,0,0,0,0,0,0,0,66.31 ,61.98 ,66.31 
03,009,01,013,0261,369,848,12,860,1444,0,0,0,0,0,0,0,66.31 ,59.56 ,66.31 
03,009,01,014,0262,370,735,8,743,1321,0,0,0,0,0,0,0,66.31 ,56.25 ,66.31 
03,009,01,014,0263,371,311,6,317,487,0,0,0,0,0,0,0,66.31 ,65.09 ,66.31 
03,009,01,014,0264,372,643,7,650,1017,0,0,0,0,0,0,0,66.31 ,63.91 ,66.31 
03,009,01,014,0264,373,478,11,489,775,0,0,0,0,0,0,0,66.31 ,63.10 ,66.31 
03,009,01,014,0265,374,974,14,988,1431,0,0,0,0,0,0,0,66.31 ,69.04 ,66.31 
03,009,01,014,0266,375,753,8,761,1161,0,0,0,0,0,0,0,66.31 ,65.55 ,66.31 
03,009,01,014,0267,376,627,5,632,1021,0,0,0,0,0,0,0,66.31 ,61.90 ,66.31 
03,009,01,014,0268,377,685,9,694,1091,0,0,0,0,0,0,0,66.31 ,63.61 ,66.31 
03,009,01,014,0268,378,707,14,721,1124,0,0,0,0,0,0,0,66.31 ,64.15 ,66.31 
03,009,01,014,0269,379,472,7,479,832,0,0,0,0,0,0,0,66.31 ,57.57 ,66.31 
03,009,01,014,0269,380,276,1,277,453,0,0,0,0,0,0,0,66.31 ,61.15 ,66.31 
03,009,01,014,0270,381,727,9,736,1269,0,0,0,0,0,0,0,66.31 ,58.00 ,66.31 
03,009,01,014,0271,382,496,8,504,971,0,0,0,0,0,0,0,66.31 ,51.91 ,66.31 
03,009,01,014,0272,383,628,6,634,1044,0,0,0,0,0,0,0,66.31 ,60.73 ,66.31 
03,009,01,014,0273,384,366,10,376,592,0,0,0,0,0,0,0,66.31 ,63.51 ,66.31 
03,009,01,015,0274,385,697,12,709,954,0,0,0,0,0,0,0,66.31 ,74.32 ,66.31 
03,009,01,015,0274,386,593,8,601,853,0,0,0,0,0,0,0,66.31 ,70.46 ,66.31 
03,009,01,015,0275,387,943,8,951,1353,0,0,0,0,0,0,0,66.31 ,70.29 ,66.31 
03,009,01,015,0276,388,940,12,952,1311,0,0,0,0,0,0,0,66.31 ,72.62 ,66.31 
03,009,01,015,0277,389,302,1,303,410,0,0,0,0,0,0,0,66.31 ,73.90 ,66.31 
03,009,01,015,0277,390,655,9,664,937,0,0,0,0,0,0,0,66.31 ,70.86 ,66.31 
03,009,01,015,0278,391,352,0,352,519,0,0,0,0,0,0,0,66.31 ,67.82 ,66.31 
03,009,01,015,0278,392,543,1,544,769,0,0,0,0,0,0,0,66.31 ,70.74 ,66.31 
03,009,01,015,0279,393,634,5,639,909,0,0,0,0,0,0,0,66.31 ,70.30 ,66.31 
03,009,01,015,0280,394,591,5,596,865,0,0,0,0,0,0,0,66.31 ,68.90 ,66.31 
03,009,01,015,0281,395,1001,21,1022,1274,0,0,0,0,0,0,0,66.31 ,80.22 ,66.31 
03,009,01,015,0282,396,614,9,623,991,0,0,0,0,0,0,0,66.31 ,62.87 ,66.31 
03,009,01,016,0283,397,887,3,890,1302,0,0,0,0,0,0,0,66.31 ,68.36 ,66.31 
03,009,01,016,0284,398,634,4,638,997,0,0,0,0,0,0,0,66.31 ,63.99 ,66.31 
03,009,01,016,0285,399,645,11,656,1023,0,0,0,0,0,0,0,66.31 ,64.13 ,66.31 
03,009,01,016,0286,400,632,6,638,978,0,0,0,0,0,0,0,66.31 ,65.24 ,66.31 
03,009,01,016,0286,401,556,15,571,897,0,0,0,0,0,0,0,66.31 ,63.66 ,66.31 
03,009,01,016,0287,402,516,6,522,949,0,0,0,0,0,0,0,66.31 ,55.01 ,66.31 
03,009,01,016,0288,403,954,6,960,1534,0,0,0,0,0,0,0,66.31 ,62.58 ,66.31 
03,009,01,016,0289,404,807,5,812,1351,0,0,0,0,0,0,0,66.31 ,60.10 ,66.31 
03,009,01,016,0289,405,466,3,469,736,0,0,0,0,0,0,0,66.31 ,63.72 ,66.31 
03,009,01,016,0290,406,421,5,426,661,0,0,0,0,0,0,0,66.31 ,64.45 ,66.31 
03,009,01,016,0291,407,329,4,333,558,0,0,0,0,0,0,0,66.31 ,59.68 ,66.31 
03,009,01,016,0292,408,403,5,408,661,0,0,0,0,0,0,0,66.31 ,61.72 ,66.31 
03,009,01,016,0293,409,769,8,777,1168,0,0,0,0,0,0,0,66.31 ,66.52 ,66.31 
03,009,01,016,0293,410,444,3,447,646,0,0,0,0,0,0,0,66.31 ,69.20 ,66.31 
03,009,01,016,0294,411,658,2,660,1033,0,0,0,0,0,0,0,66.31 ,63.89 ,66.31 
03,009,01,016,0294,412,305,3,308,537,0,0,0,0,0,0,0,66.31 ,57.36 ,66.31 
03,009,01,016,0295,413,945,14,959,1397,0,0,0,0,0,0,0,66.31 ,68.65 ,66.31 
03,009,01,016,0296,414,735,9,744,1043,0,0,0,0,0,0,0,66.31 ,71.33 ,66.31 
03,009,01,016,0296,415,699,7,706,1013,0,0,0,0,0,0,0,66.31 ,69.69 ,66.31 
03,009,01,016,0296,416,725,7,732,1168,0,0,0,0,0,0,0,66.31 ,62.67 ,66.31 
03,009,01,016,0297,417,976,10,986,1287,0,0,0,0,0,0,0,66.31 ,76.61 ,66.31 
03,009,01,016,0297,418,632,4,636,730,0,0,0,0,0,0,0,66.31 ,87.12 ,66.31 
03,009,01,017,0298,419,1136,11,1147,1629,0,0,0,0,0,0,0,66.31 ,70.41 ,66.31 
03,009,01,017,0298,420,908,16,924,1329,0,0,0,0,0,0,0,66.31 ,69.53 ,66.31 
03,009,01,017,0299,421,588,3,591,809,0,0,0,0,0,0,0,66.31 ,73.05 ,66.31 
03,009,01,017,0299,422,536,7,543,781,0,0,0,0,0,0,0,66.31 ,69.53 ,66.31 
03,009,01,017,0300,423,942,12,954,1478,0,0,0,0,0,0,0,66.31 ,64.55 ,66.31 
03,009,01,017,0301,424,480,4,484,776,0,0,0,0,0,0,0,66.31 ,62.37 ,66.31 
03,009,01,017,0302,425,664,10,674,1048,0,0,0,0,0,0,0,66.31 ,64.31 ,66.31 
03,009,01,017,0303,426,689,9,698,1177,0,0,0,0,0,0,0,66.31 ,59.30 ,66.31 
03,009,01,017,0304,427,575,7,582,1050,0,0,0,0,0,0,0,66.31 ,55.43 ,66.31 
03,009,01,017,0305,428,517,9,526,968,0,0,0,0,0,0,0,66.31 ,54.34 ,66.31 
03,009,01,017,0306,429,438,4,442,739,0,0,0,0,0,0,0,66.31 ,59.81 ,66.31 
03,009,01,017,0307,430,505,3,508,853,0,0,0,0,0,0,0,66.31 ,59.55 ,66.31 
03,009,01,017,0308,431,302,1,303,467,0,0,0,0,0,0,0,66.31 ,64.88 ,66.31 
03,009,01,017,0309,432,783,12,795,1285,0,0,0,0,0,0,0,66.31 ,61.87 ,66.31 
03,009,01,017,0310,433,922,7,929,1544,0,0,0,0,0,0,0,66.31 ,60.17 ,66.31 
03,009,01,017,0311,434,823,4,827,1134,0,0,0,0,0,0,0,66.31 ,72.93 ,66.31 
03,009,01,017,0312,435,575,5,580,926,0,0,0,0,0,0,0,66.31 ,62.63 ,66.31 
03,009,01,017,0313,436,898,8,906,1371,0,0,0,0,0,0,0,66.31 ,66.08 ,66.31 
03,009,01,017,0314,437,694,3,697,1086,0,0,0,0,0,0,0,66.31 ,64.18 ,66.31 
03,009,01,017,0315,438,489,5,494,778,0,0,0,0,0,0,0,66.31 ,63.50 ,66.31 
03,009,01,017,0315,439,611,7,618,913,0,0,0,0,0,0,0,66.31 ,67.69 ,66.31 
03,009,01,017,0316,440,433,2,435,712,0,0,0,0,0,0,0,66.31 ,61.10 ,66.31 
03,009,01,017,0317,441,582,11,593,982,0,0,0,0,0,0,0,66.31 ,60.39 ,66.31 
03,009,01,017,0318,442,513,3,516,772,0,0,0,0,0,0,0,66.31 ,66.84 ,66.31 
03,009,01,018,0319,443,594,12,606,1014,0,0,0,0,0,0,0,66.31 ,59.76 ,66.31 
03,009,01,018,0319,444,470,8,478,721,0,0,0,0,0,0,0,66.31 ,66.30 ,66.31 
03,009,01,018,0320,445,1003,16,1019,1504,0,0,0,0,0,0,0,66.31 ,67.75 ,66.31 
03,009,01,018,0320,446,356,4,360,611,0,0,0,0,0,0,0,66.31 ,58.92 ,66.31 
03,009,01,018,0321,447,447,5,452,720,0,0,0,0,0,0,0,66.31 ,62.78 ,66.31 
03,009,01,018,0322,448,723,11,734,1147,0,0,0,0,0,0,0,66.31 ,63.99 ,66.31 
03,009,01,018,0323,449,662,9,671,1187,0,0,0,0,0,0,0,66.31 ,56.53 ,66.31 
03,009,01,018,0324,450,552,8,560,1021,0,0,0,0,0,0,0,66.31 ,54.85 ,66.31 
03,009,01,018,0325,451,478,4,482,931,0,0,0,0,0,0,0,66.31 ,51.77 ,66.31 
03,009,01,018,0326,452,701,9,710,1284,0,0,0,0,0,0,0,66.31 ,55.30 ,66.31 
03,009,01,018,0327,453,614,6,620,1169,0,0,0,0,0,0,0,66.31 ,53.04 ,66.31 
03,009,01,018,0328,454,475,13,488,996,0,0,0,0,0,0,0,66.31 ,49.00 ,66.31 
03,009,01,018,0329,455,371,5,376,670,0,0,0,0,0,0,0,66.31 ,56.12 ,66.31 
03,009,01,018,0330,456,533,5,538,1039,0,0,0,0,0,0,0,66.31 ,51.78 ,66.31 
03,009,01,018,0331,457,247,3,250,414,0,0,0,0,0,0,0,66.31 ,60.39 ,66.31 
03,009,01,018,0332,458,542,3,545,1006,0,0,0,0,0,0,0,66.31 ,54.17 ,66.31 
03,009,01,018,0332,459,507,5,512,810,0,0,0,0,0,0,0,66.31 ,63.21 ,66.31 
03,009,01,018,0333,460,538,9,547,915,0,0,0,0,0,0,0,66.31 ,59.78 ,66.31 
03,009,01,018,0334,461,484,10,494,812,0,0,0,0,0,0,0,66.31 ,60.84 ,66.31 
03,009,01,018,0335,462,519,10,529,1023,0,0,0,0,0,0,0,66.31 ,51.71 ,66.31 
03,009,01,018,0336,463,635,12,647,1165,0,0,0,0,0,0,0,66.31 ,55.54 ,66.31 
03,009,01,018,0337,464,708,12,720,1351,0,0,0,0,0,0,0,66.31 ,53.29 ,66.31 
03,009,01,018,0338,465,572,14,586,1095,0,0,0,0,0,0,0,66.31 ,53.52 ,66.31 
03,009,01,018,0339,466,415,2,417,904,0,0,0,0,0,0,0,66.31 ,46.13 ,66.31 
03,009,01,019,0340,467,664,3,667,971,0,0,0,0,0,0,0,66.31 ,68.69 ,66.31 
03,009,01,019,0341,468,810,12,822,1252,0,0,0,0,0,0,0,66.31 ,65.65 ,66.31 
03,009,01,019,0342,469,423,6,429,762,0,0,0,0,0,0,0,66.31 ,56.30 ,66.31 
03,009,01,019,0343,470,414,9,423,631,0,0,0,0,0,0,0,66.31 ,67.04 ,66.31 
03,009,01,019,0344,471,514,12,526,936,0,0,0,0,0,0,0,66.31 ,56.20 ,66.31 
03,009,01,019,0345,472,642,4,646,972,0,0,0,0,0,0,0,66.31 ,66.46 ,66.31 
03,009,01,019,0346,473,916,14,930,1438,0,0,0,0,0,0,0,66.31 ,64.67 ,66.31 
03,009,01,019,0347,474,461,6,467,903,0,0,0,0,0,0,0,66.31 ,51.72 ,66.31 
03,009,01,019,0347,475,610,4,614,1109,0,0,0,0,0,0,0,66.31 ,55.37 ,66.31 
03,009,01,019,0348,476,467,3,470,855,0,0,0,0,0,0,0,66.31 ,54.97 ,66.31 
03,009,01,019,0348,477,496,5,501,855,0,0,0,0,0,0,0,66.31 ,58.60 ,66.31 
03,009,01,019,0349,478,911,4,915,1557,0,0,0,0,0,0,0,66.31 ,58.77 ,66.31 
03,009,01,019,0350,479,347,1,348,573,0,0,0,0,0,0,0,66.31 ,60.73 ,66.31 
03,009,01,019,0351,480,911,7,918,1344,0,0,0,0,0,0,0,66.31 ,68.30 ,66.31 
03,009,01,019,0352,481,503,10,513,776,0,0,0,0,0,0,0,66.31 ,66.11 ,66.31 
03,009,01,019,0353,482,221,3,224,339,0,0,0,0,0,0,0,66.31 ,66.08 ,66.31 
03,009,01,019,0353,483,835,13,848,1200,0,0,0,0,0,0,0,66.31 ,70.67 ,66.31 
03,009,01,019,0354,484,670,4,674,1046,0,0,0,0,0,0,0,66.31 ,64.44 ,66.31 
03,009,01,019,0355,485,613,12,625,900,0,0,0,0,0,0,0,66.31 ,69.44 ,66.31 
03,009,01,019,0355,486,628,7,635,967,0,0,0,0,0,0,0,66.31 ,65.67 ,66.31 
03,009,01,019,0356,487,843,8,851,1314,0,0,0,0,0,0,0,66.31 ,64.76 ,66.31 
03,009,01,019,0357,488,743,3,746,1085,0,0,0,0,0,0,0,66.31 ,68.76 ,66.31 
03,009,01,019,0358,489,533,9,542,798,0,0,0,0,0,0,0,66.31 ,67.92 ,66.31 
03,009,01,019,0359,490,602,4,606,1014,0,0,0,0,0,0,0,66.31 ,59.76 ,66.31 
03,009,01,019,0360,491,456,6,462,746,0,0,0,0,0,0,0,66.31 ,61.93 ,66.31 
03,009,01,020,0361,492,923,23,946,1367,0,0,0,0,0,0,0,66.31 ,69.20 ,66.31 
03,009,01,020,0361,493,633,5,638,856,0,0,0,0,0,0,0,66.31 ,74.53 ,66.31 
03,009,01,020,0362,494,739,16,755,1045,0,0,0,0,0,0,0,66.31 ,72.25 ,66.31 
03,009,01,020,0362,495,587,11,598,804,0,0,0,0,0,0,0,66.31 ,74.38 ,66.31 
03,009,01,020,0363,496,578,13,591,821,0,0,0,0,0,0,0,66.31 ,71.99 ,66.31 
03,009,01,020,0364,497,512,6,518,751,0,0,0,0,0,0,0,66.31 ,68.97 ,66.31 
03,009,01,020,0365,498,745,7,752,1122,0,0,0,0,0,0,0,66.31 ,67.02 ,66.31 
03,009,01,020,0366,499,601,20,621,941,0,0,0,0,0,0,0,66.31 ,65.99 ,66.31 
03,009,01,020,0367,500,787,9,796,1241,0,0,0,0,0,0,0,66.31 ,64.14 ,66.31 
03,009,01,020,0368,501,528,4,532,815,0,0,0,0,0,0,0,66.31 ,65.28 ,66.31 
03,009,01,020,0369,502,659,2,661,1087,0,0,0,0,0,0,0,66.31 ,60.81 ,66.31 
03,009,01,020,0370,503,458,11,469,753,0,0,0,0,0,0,0,66.31 ,62.28 ,66.31 
03,009,01,020,0371,504,403,7,410,716,0,0,0,0,0,0,0,66.31 ,57.26 ,66.31 
03,009,01,020,0372,505,761,12,773,1301,0,0,0,0,0,0,0,66.31 ,59.42 ,66.31 
03,009,01,020,0373,506,462,8,470,762,0,0,0,0,0,0,0,66.31 ,61.68 ,66.31 
03,009,01,020,0374,507,682,10,692,1103,0,0,0,0,0,0,0,66.31 ,62.74 ,66.31 
03,009,01,020,0375,508,735,14,749,1079,0,0,0,0,0,0,0,66.31 ,69.42 ,66.31 
03,009,01,020,0376,509,614,8,622,926,0,0,0,0,0,0,0,66.31 ,67.17 ,66.31 
03,009,01,020,0377,510,793,11,804,1274,0,0,0,0,0,0,0,66.31 ,63.11 ,66.31 
03,009,01,020,0378,511,393,2,395,658,0,0,0,0,0,0,0,66.31 ,60.03 ,66.31 
03,009,01,020,0379,512,541,7,548,877,0,0,0,0,0,0,0,66.31 ,62.49 ,66.31 
03,009,01,020,0380,513,541,12,553,921,0,0,0,0,0,0,0,66.31 ,60.04 ,66.31 
03,009,01,020,0381,514,492,6,498,822,0,0,0,0,0,0,0,66.31 ,60.58 ,66.31 
03,009,01,020,0382,515,719,6,725,1133,0,0,0,0,0,0,0,66.31 ,63.99 ,66.31 
03,009,01,020,0383,516,818,13,831,1292,0,0,0,0,0,0,0,66.31 ,64.32 ,66.31 
03,009,01,020,0384,517,571,7,578,849,0,0,0,0,0,0,0,66.31 ,68.08 ,66.31 
03,010,01,001,0001,1,1174,26,1200,1608,0,0,0,0,0,0,0,66.31 ,74.63 ,66.31 
03,010,01,001,0002,2,335,4,339,457,0,0,0,0,0,0,0,66.31 ,74.18 ,66.31 
03,010,01,001,0003,3,1009,12,1021,1352,0,0,0,0,0,0,0,66.31 ,75.52 ,66.31 
03,010,01,001,0004,4,1097,21,1118,1451,0,0,0,0,0,0,0,66.31 ,77.05 ,66.31 
03,010,01,001,0005,5,532,6,538,704,0,0,0,0,0,0,0,66.31 ,76.42 ,66.31 
03,010,01,001,0005,6,294,4,298,374,0,0,0,0,0,0,0,66.31 ,79.68 ,66.31 
03,010,01,001,0006,7,577,10,587,776,0,0,0,0,0,0,0,66.31 ,75.64 ,66.31 
03,010,01,001,0007,8,574,12,586,768,0,0,0,0,0,0,0,66.31 ,76.30 ,66.31 
03,010,01,001,0008,9,167,0,167,223,0,0,0,0,0,0,0,66.31 ,74.89 ,66.31 
03,010,01,001,0008,10,413,3,416,546,0,0,0,0,0,0,0,66.31 ,76.19 ,66.31 
03,010,01,001,0009,11,635,10,645,863,0,0,0,0,0,0,0,66.31 ,74.74 ,66.31 
03,010,01,001,0010,12,866,19,885,1183,0,0,0,0,0,0,0,66.31 ,74.81 ,66.31 
03,010,01,001,0011,13,643,9,652,947,0,0,0,0,0,0,0,66.31 ,68.85 ,66.31 
03,010,01,001,0012,14,356,9,365,501,0,0,0,0,0,0,0,66.31 ,72.85 ,66.31 
03,010,01,001,0012,15,159,2,161,225,0,0,0,0,0,0,0,66.31 ,71.56 ,66.31 
03,010,01,001,0013,16,233,2,235,301,0,0,0,0,0,0,0,66.31 ,78.07 ,66.31 
03,010,01,001,0013,17,209,0,209,260,0,0,0,0,0,0,0,66.31 ,80.38 ,66.31 
03,010,01,001,0014,18,448,9,457,580,0,0,0,0,0,0,0,66.31 ,78.79 ,66.31 
03,010,01,001,0014,19,849,11,860,1216,0,0,0,0,0,0,0,66.31 ,70.72 ,66.31 
03,010,01,001,0015,20,1130,19,1149,1580,0,0,0,0,0,0,0,66.31 ,72.72 ,66.31 
03,010,01,001,0015,21,585,7,592,839,0,0,0,0,0,0,0,66.31 ,70.56 ,66.31 
03,010,01,001,0016,22,1237,30,1267,1670,0,0,0,0,0,0,0,66.31 ,75.87 ,66.31 
03,010,01,001,0017,23,1512,18,1530,2052,0,0,0,0,0,0,0,66.31 ,74.56 ,66.31 
03,010,01,001,0018,24,568,14,582,715,0,0,0,0,0,0,0,66.31 ,81.40 ,66.31 
03,010,01,002,0019,25,510,4,514,853,0,0,0,0,0,0,0,66.31 ,60.26 ,66.31 
03,010,01,002,0019,26,616,5,621,886,0,0,0,0,0,0,0,66.31 ,70.09 ,66.31 
03,010,01,002,0020,27,1149,14,1163,1789,0,0,0,0,0,0,0,66.31 ,65.01 ,66.31 
03,010,01,002,0021,28,729,12,741,1103,0,0,0,0,0,0,0,66.31 ,67.18 ,66.31 
03,010,01,002,0022,29,383,4,387,537,0,0,0,0,0,0,0,66.31 ,72.07 ,66.31 
03,010,01,002,0023,30,476,8,484,773,0,0,0,0,0,0,0,66.31 ,62.61 ,66.31 
03,010,01,002,0024,31,562,2,564,777,0,0,0,0,0,0,0,66.31 ,72.59 ,66.31 
03,010,01,002,0025,32,497,7,504,785,0,0,0,0,0,0,0,66.31 ,64.20 ,66.31 
03,010,01,002,0026,33,582,7,589,850,0,0,0,0,0,0,0,66.31 ,69.29 ,66.31 
03,010,01,002,0026,34,592,9,601,947,0,0,0,0,0,0,0,66.31 ,63.46 ,66.31 
03,010,01,002,0027,35,596,13,609,915,0,0,0,0,0,0,0,66.31 ,66.56 ,66.31 
03,010,01,002,0027,36,983,13,996,1416,0,0,0,0,0,0,0,66.31 ,70.34 ,66.31 
03,010,01,002,0028,37,1214,16,1230,1866,0,0,0,0,0,0,0,66.31 ,65.92 ,66.31 
03,010,01,002,0028,38,1018,12,1030,1543,0,0,0,0,0,0,0,66.31 ,66.75 ,66.31 
03,010,01,002,0029,39,461,4,465,634,0,0,0,0,0,0,0,66.31 ,73.34 ,66.31 
03,010,01,002,0030,40,463,7,470,729,0,0,0,0,0,0,0,66.31 ,64.47 ,66.31 
03,010,01,002,0031,41,569,2,571,816,0,0,0,0,0,0,0,66.31 ,69.98 ,66.31 
03,010,01,002,0032,42,711,5,716,987,0,0,0,0,0,0,0,66.31 ,72.54 ,66.31 
03,010,01,002,0033,43,335,9,344,468,0,0,0,0,0,0,0,66.31 ,73.50 ,66.31 
03,010,01,002,0034,44,859,11,870,1239,0,0,0,0,0,0,0,66.31 ,70.22 ,66.31 
03,010,01,002,0034,45,903,14,917,1246,0,0,0,0,0,0,0,66.31 ,73.60 ,66.31 
03,010,01,002,0035,46,1060,30,1090,1554,0,0,0,0,0,0,0,66.31 ,70.14 ,66.31 
03,010,01,002,0036,47,408,8,416,566,0,0,0,0,0,0,0,66.31 ,73.50 ,66.31 
03,010,01,002,0037,48,565,8,573,955,0,0,0,0,0,0,0,66.31 ,60.00 ,66.31 
03,010,01,002,0038,49,703,14,717,1019,0,0,0,0,0,0,0,66.31 ,70.36 ,66.31 
03,010,01,002,0039,50,542,13,555,865,0,0,0,0,0,0,0,66.31 ,64.16 ,66.31 
03,010,01,002,0040,51,191,1,192,295,0,0,0,0,0,0,0,66.31 ,65.08 ,66.31 
03,010,01,002,0041,52,498,6,504,798,0,0,0,0,0,0,0,66.31 ,63.16 ,66.31 
03,010,01,002,0042,53,394,5,399,569,0,0,0,0,0,0,0,66.31 ,70.12 ,66.31 
03,010,01,002,0043,54,780,14,794,1184,0,0,0,0,0,0,0,66.31 ,67.06 ,66.31 
03,010,01,002,0044,55,943,15,958,1475,0,0,0,0,0,0,0,66.31 ,64.95 ,66.31 
03,010,01,002,0045,56,360,5,365,560,0,0,0,0,0,0,0,66.31 ,65.18 ,66.31 
03,010,01,003,0046,57,518,12,530,747,0,0,0,0,0,0,0,66.31 ,70.95 ,66.31 
03,010,01,003,0047,58,299,5,304,435,0,0,0,0,0,0,0,66.31 ,69.89 ,66.31 
03,010,01,003,0048,59,934,13,947,1353,0,0,0,0,0,0,0,66.31 ,69.99 ,66.31 
03,010,01,003,0049,60,799,17,816,1205,0,0,0,0,0,0,0,66.31 ,67.72 ,66.31 
03,010,01,003,0050,61,756,9,765,1095,0,0,0,0,0,0,0,66.31 ,69.86 ,66.31 
03,010,01,003,0050,62,503,8,511,709,0,0,0,0,0,0,0,66.31 ,72.07 ,66.31 
03,010,01,003,0051,63,645,5,650,931,0,0,0,0,0,0,0,66.31 ,69.82 ,66.31 
03,010,01,003,0052,64,588,16,604,815,0,0,0,0,0,0,0,66.31 ,74.11 ,66.31 
03,010,01,003,0053,65,633,15,648,917,0,0,0,0,0,0,0,66.31 ,70.67 ,66.31 
03,010,01,003,0054,66,955,11,966,1437,0,0,0,0,0,0,0,66.31 ,67.22 ,66.31 
03,010,01,003,0055,67,988,22,1010,1616,0,0,0,0,0,0,0,66.31 ,62.50 ,66.31 
03,010,01,003,0056,68,1039,14,1053,1604,0,0,0,0,0,0,0,66.31 ,65.65 ,66.31 
03,010,01,003,0057,69,226,3,229,331,0,0,0,0,0,0,0,66.31 ,69.18 ,66.31 
03,010,01,003,0057,70,184,1,185,287,0,0,0,0,0,0,0,66.31 ,64.46 ,66.31 
03,010,01,003,0058,71,351,2,353,508,0,0,0,0,0,0,0,66.31 ,69.49 ,66.31 
03,010,01,003,0058,72,215,3,218,285,0,0,0,0,0,0,0,66.31 ,76.49 ,66.31 
03,010,01,003,0059,73,824,23,847,1219,0,0,0,0,0,0,0,66.31 ,69.48 ,66.31 
03,010,01,003,0060,74,618,12,630,952,0,0,0,0,0,0,0,66.31 ,66.18 ,66.31 
03,010,01,003,0060,75,645,14,659,999,0,0,0,0,0,0,0,66.31 ,65.97 ,66.31 
03,010,01,003,0061,76,256,6,262,381,0,0,0,0,0,0,0,66.31 ,68.77 ,66.31 
03,010,01,003,0062,77,137,4,141,225,0,0,0,0,0,0,0,66.31 ,62.67 ,66.31 
03,010,01,003,0062,78,167,3,170,258,0,0,0,0,0,0,0,66.31 ,65.89 ,66.31 
03,010,01,003,0063,79,95,0,95,149,0,0,0,0,0,0,0,66.31 ,63.76 ,66.31 
03,010,01,003,0063,80,137,1,138,226,0,0,0,0,0,0,0,66.31 ,61.06 ,66.31 
03,010,01,003,0064,81,605,5,610,845,0,0,0,0,0,0,0,66.31 ,72.19 ,66.31 
03,010,01,003,0065,82,727,8,735,995,0,0,0,0,0,0,0,66.31 ,73.87 ,66.31 
03,010,01,003,0066,83,765,12,777,1186,0,0,0,0,0,0,0,66.31 ,65.51 ,66.31 
03,010,01,003,0067,84,689,10,699,1084,0,0,0,0,0,0,0,66.31 ,64.48 ,66.31 
03,010,01,003,0067,85,783,13,796,1234,0,0,0,0,0,0,0,66.31 ,64.51 ,66.31 
03,010,01,003,0068,86,711,19,730,1038,0,0,0,0,0,0,0,66.31 ,70.33 ,66.31 
03,010,01,004,0069,87,361,13,374,523,0,0,0,0,0,0,0,66.31 ,71.51 ,66.31 
03,010,01,004,0070,88,1170,21,1191,1837,0,0,0,0,0,0,0,66.31 ,64.83 ,66.31 
03,010,01,004,0071,89,667,10,677,958,0,0,0,0,0,0,0,66.31 ,70.67 ,66.31 
03,010,01,004,0072,90,992,17,1009,1507,0,0,0,0,0,0,0,66.31 ,66.95 ,66.31 
03,010,01,004,0072,91,797,17,814,1313,0,0,0,0,0,0,0,66.31 ,62.00 ,66.31 
03,010,01,004,0072,92,994,20,1014,1619,0,0,0,0,0,0,0,66.31 ,62.63 ,66.31 
03,010,01,004,0073,93,813,13,826,1156,0,0,0,0,0,0,0,66.31 ,71.45 ,66.31 
03,010,01,004,0074,94,909,15,924,1285,0,0,0,0,0,0,0,66.31 ,71.91 ,66.31 
03,010,01,004,0075,95,440,5,445,694,0,0,0,0,0,0,0,66.31 ,64.12 ,66.31 
03,010,01,004,0076,96,528,2,530,838,0,0,0,0,0,0,0,66.31 ,63.25 ,66.31 
03,010,01,004,0077,97,518,7,525,715,0,0,0,0,0,0,0,66.31 ,73.43 ,66.31 
03,010,01,004,0078,98,249,1,250,354,0,0,0,0,0,0,0,66.31 ,70.62 ,66.31 
03,010,01,004,0079,99,1169,19,1188,1784,0,0,0,0,0,0,0,66.31 ,66.59 ,66.31 
03,010,01,004,0080,100,1084,20,1104,1474,0,0,0,0,0,0,0,66.31 ,74.90 ,66.31 
03,010,01,004,0081,101,848,11,859,1157,0,0,0,0,0,0,0,66.31 ,74.24 ,66.31 
03,010,01,004,0081,102,278,2,280,433,0,0,0,0,0,0,0,66.31 ,64.67 ,66.31 
03,010,01,004,0082,103,646,10,656,897,0,0,0,0,0,0,0,66.31 ,73.13 ,66.31 
03,010,01,004,0083,104,1025,15,1040,1505,0,0,0,0,0,0,0,66.31 ,69.10 ,66.31 
03,010,01,004,0084,105,1202,22,1224,1831,0,0,0,0,0,0,0,66.31 ,66.85 ,66.31 
03,010,01,004,0085,106,696,2,698,1002,0,0,0,0,0,0,0,66.31 ,69.66 ,66.31 
03,010,01,004,0086,107,513,9,522,678,0,0,0,0,0,0,0,66.31 ,76.99 ,66.31 
03,010,01,004,0087,108,608,6,614,804,0,0,0,0,0,0,0,66.31 ,76.37 ,66.31 
03,010,01,004,0088,109,803,9,812,1153,0,0,0,0,0,0,0,66.31 ,70.42 ,66.31 
03,010,01,004,0089,110,522,7,529,721,0,0,0,0,0,0,0,66.31 ,73.37 ,66.31 
03,010,01,005,0090,111,761,12,773,1066,0,0,0,0,0,0,0,66.31 ,72.51 ,66.31 
03,010,01,005,0090,112,623,8,631,897,0,0,0,0,0,0,0,66.31 ,70.35 ,66.31 
03,010,01,005,0091,113,1156,12,1168,1572,0,0,0,0,0,0,0,66.31 ,74.30 ,66.31 
03,010,01,005,0092,114,934,10,944,1396,0,0,0,0,0,0,0,66.31 ,67.62 ,66.31 
03,010,01,005,0092,115,1023,7,1030,1465,0,0,0,0,0,0,0,66.31 ,70.31 ,66.31 
03,010,01,005,0093,116,1324,14,1338,1906,0,0,0,0,0,0,0,66.31 ,70.20 ,66.31 
03,010,01,005,0094,117,759,7,766,1060,0,0,0,0,0,0,0,66.31 ,72.26 ,66.31 
03,010,01,005,0095,118,1400,15,1415,1796,0,0,0,0,0,0,0,66.31 ,78.79 ,66.31 
03,010,01,005,0096,119,919,18,937,1356,0,0,0,0,0,0,0,66.31 ,69.10 ,66.31 
03,010,01,005,0097,120,1287,9,1296,1665,0,0,0,0,0,0,0,66.31 ,77.84 ,66.31 
03,010,01,005,0098,121,494,3,497,669,0,0,0,0,0,0,0,66.31 ,74.29 ,66.31 
03,010,01,005,0099,122,512,5,517,693,0,0,0,0,0,0,0,66.31 ,74.60 ,66.31 
03,010,01,005,0100,123,547,13,560,716,0,0,0,0,0,0,0,66.31 ,78.21 ,66.31 
03,010,01,005,0101,124,1010,26,1036,1413,0,0,0,0,0,0,0,66.31 ,73.32 ,66.31 
03,010,01,005,0101,125,310,2,312,399,0,0,0,0,0,0,0,66.31 ,78.20 ,66.31 
03,010,01,005,0102,126,545,7,552,798,0,0,0,0,0,0,0,66.31 ,69.17 ,66.31 
03,010,01,005,0103,127,399,7,406,611,0,0,0,0,0,0,0,66.31 ,66.45 ,66.31 
03,010,01,005,0104,128,545,5,550,793,0,0,0,0,0,0,0,66.31 ,69.36 ,66.31 
03,010,01,005,0105,129,1231,17,1248,1790,0,0,0,0,0,0,0,66.31 ,69.72 ,66.31 
03,010,01,005,0105,130,496,6,502,719,0,0,0,0,0,0,0,66.31 ,69.82 ,66.31 
03,010,01,005,0105,131,351,7,358,461,0,0,0,0,0,0,0,66.31 ,77.66 ,66.31 
03,010,01,005,0106,132,1082,17,1099,1588,0,0,0,0,0,0,0,66.31 ,69.21 ,66.31 
03,010,01,005,0107,133,1375,21,1396,2024,0,0,0,0,0,0,0,66.31 ,68.97 ,66.31 
03,010,01,005,0107,134,869,17,886,1226,0,0,0,0,0,0,0,66.31 ,72.27 ,66.31 
03,010,01,005,0108,135,585,11,596,920,0,0,0,0,0,0,0,66.31 ,64.78 ,66.31 
03,010,01,005,0108,136,662,12,674,917,0,0,0,0,0,0,0,66.31 ,73.50 ,66.31 
03,010,01,005,0109,137,1321,35,1356,1976,0,0,0,0,0,0,0,66.31 ,68.62 ,66.31 
03,010,01,005,0110,138,964,5,969,1559,0,0,0,0,0,0,0,66.31 ,62.16 ,66.31 
03,010,01,005,0111,139,1201,23,1224,1604,0,0,0,0,0,0,0,66.31 ,76.31 ,66.31 
03,010,01,005,0112,140,783,11,794,1097,0,0,0,0,0,0,0,66.31 ,72.38 ,66.31 
03,010,01,005,0112,141,566,10,576,910,0,0,0,0,0,0,0,66.31 ,63.30 ,66.31 
03,010,01,005,0113,142,1556,49,1605,2289,0,0,0,0,0,0,0,66.31 ,70.12 ,66.31 
03,010,01,005,0114,143,1139,15,1154,1607,0,0,0,0,0,0,0,66.31 ,71.81 ,66.31 
03,010,01,005,0115,144,1268,17,1285,1871,0,0,0,0,0,0,0,66.31 ,68.68 ,66.31 
03,010,01,005,0116,145,1291,17,1308,1681,0,0,0,0,0,0,0,66.31 ,77.81 ,66.31 
03,010,01,005,0116,146,921,22,943,1296,0,0,0,0,0,0,0,66.31 ,72.76 ,66.31 
03,010,01,005,0117,147,877,6,883,1172,0,0,0,0,0,0,0,66.31 ,75.34 ,66.31 
03,010,01,006,0118,148,902,21,923,1371,0,0,0,0,0,0,0,66.31 ,67.32 ,66.31 
03,010,01,006,0119,149,502,9,511,783,0,0,0,0,0,0,0,66.31 ,65.26 ,66.31 
03,010,01,006,0120,150,262,4,266,406,0,0,0,0,0,0,0,66.31 ,65.52 ,66.31 
03,010,01,006,0120,151,189,3,192,321,0,0,0,0,0,0,0,66.31 ,59.81 ,66.31 
03,010,01,006,0121,152,522,4,526,877,0,0,0,0,0,0,0,66.31 ,59.98 ,66.31 
03,010,01,006,0122,153,570,4,574,916,0,0,0,0,0,0,0,66.31 ,62.66 ,66.31 
03,010,01,006,0123,154,737,11,748,1248,0,0,0,0,0,0,0,66.31 ,59.94 ,66.31 
03,010,01,006,0124,155,621,7,628,1016,0,0,0,0,0,0,0,66.31 ,61.81 ,66.31 
03,010,01,006,0125,156,408,7,415,592,0,0,0,0,0,0,0,66.31 ,70.10 ,66.31 
03,010,01,006,0125,157,265,3,268,394,0,0,0,0,0,0,0,66.31 ,68.02 ,66.31 
03,010,01,006,0126,158,671,9,680,1090,0,0,0,0,0,0,0,66.31 ,62.39 ,66.31 
03,010,01,006,0127,159,488,11,499,782,0,0,0,0,0,0,0,66.31 ,63.81 ,66.31 
03,010,01,006,0128,160,627,12,639,906,0,0,0,0,0,0,0,66.31 ,70.53 ,66.31 
03,010,01,006,0128,161,268,2,270,374,0,0,0,0,0,0,0,66.31 ,72.19 ,66.31 
03,010,01,006,0129,162,630,9,639,965,0,0,0,0,0,0,0,66.31 ,66.22 ,66.31 
03,010,01,006,0130,163,475,7,482,728,0,0,0,0,0,0,0,66.31 ,66.21 ,66.31 
03,010,01,006,0131,164,624,12,636,903,0,0,0,0,0,0,0,66.31 ,70.43 ,66.31 
03,010,01,007,0132,165,1099,10,1109,1645,0,0,0,0,0,0,0,66.31 ,67.42 ,66.31 
03,010,01,007,0133,166,1024,9,1033,1672,0,0,0,0,0,0,0,66.31 ,61.78 ,66.31 
03,010,01,007,0134,167,886,13,899,1380,0,0,0,0,0,0,0,66.31 ,65.14 ,66.31 
03,010,01,007,0135,168,891,13,904,1447,0,0,0,0,0,0,0,66.31 ,62.47 ,66.31 
03,010,01,007,0136,169,721,11,732,1167,0,0,0,0,0,0,0,66.31 ,62.72 ,66.31 
03,010,01,007,0137,170,931,11,942,1501,0,0,0,0,0,0,0,66.31 ,62.76 ,66.31 
03,010,01,007,0138,171,1077,14,1091,1616,0,0,0,0,0,0,0,66.31 ,67.51 ,66.31 
03,010,01,007,0139,172,603,6,609,941,0,0,0,0,0,0,0,66.31 ,64.72 ,66.31 
03,010,01,007,0140,173,1115,26,1141,1630,0,0,0,0,0,0,0,66.31 ,70.00 ,66.31 
03,010,01,007,0141,174,967,16,983,1432,0,0,0,0,0,0,0,66.31 ,68.65 ,66.31 
03,010,01,007,0142,175,963,22,985,1393,0,0,0,0,0,0,0,66.31 ,70.71 ,66.31 
03,010,01,007,0143,176,560,5,565,854,0,0,0,0,0,0,0,66.31 ,66.16 ,66.31 
03,010,01,007,0144,177,671,21,692,968,0,0,0,0,0,0,0,66.31 ,71.49 ,66.31 
03,010,01,007,0145,178,509,9,518,755,0,0,0,0,0,0,0,66.31 ,68.61 ,66.31 
03,010,01,007,0146,179,804,12,816,1156,0,0,0,0,0,0,0,66.31 ,70.59 ,66.31 
03,010,01,007,0147,180,708,10,718,1117,0,0,0,0,0,0,0,66.31 ,64.28 ,66.31 
03,010,01,007,0148,181,674,27,701,1090,0,0,0,0,0,0,0,66.31 ,64.31 ,66.31 
03,010,01,007,0149,182,432,6,438,627,0,0,0,0,0,0,0,66.31 ,69.86 ,66.31 
03,010,01,007,0150,183,493,8,501,793,0,0,0,0,0,0,0,66.31 ,63.18 ,66.31 
03,010,01,007,0151,184,408,3,411,600,0,0,0,0,0,0,0,66.31 ,68.50 ,66.31 
03,010,01,007,0152,185,648,3,651,969,0,0,0,0,0,0,0,66.31 ,67.18 ,66.31 
03,010,01,007,0153,186,397,3,400,611,0,0,0,0,0,0,0,66.31 ,65.47 ,66.31 
03,010,01,007,0154,187,342,9,351,513,0,0,0,0,0,0,0,66.31 ,68.42 ,66.31 
03,010,01,008,0155,188,888,16,904,1273,0,0,0,0,0,0,0,66.31 ,71.01 ,66.31 
03,010,01,008,0156,189,584,9,593,936,0,0,0,0,0,0,0,66.31 ,63.35 ,66.31 
03,010,01,008,0157,190,580,11,591,881,0,0,0,0,0,0,0,66.31 ,67.08 ,66.31 
03,010,01,008,0158,191,274,5,279,374,0,0,0,0,0,0,0,66.31 ,74.60 ,66.31 
03,010,01,008,0159,192,848,10,858,1251,0,0,0,0,0,0,0,66.31 ,68.59 ,66.31 
03,010,01,008,0160,193,851,20,871,1365,0,0,0,0,0,0,0,66.31 ,63.81 ,66.31 
03,010,01,008,0161,194,571,11,582,902,0,0,0,0,0,0,0,66.31 ,64.52 ,66.31 
03,010,01,008,0162,195,472,5,477,752,0,0,0,0,0,0,0,66.31 ,63.43 ,66.31 
03,010,01,008,0163,196,375,9,384,622,0,0,0,0,0,0,0,66.31 ,61.74 ,66.31 
03,010,01,008,0163,197,132,1,133,190,0,0,0,0,0,0,0,66.31 ,70.00 ,66.31 
03,010,01,008,0164,198,166,3,169,265,0,0,0,0,0,0,0,66.31 ,63.77 ,66.31 
03,010,01,008,0164,199,214,5,219,325,0,0,0,0,0,0,0,66.31 ,67.38 ,66.31 
03,010,01,008,0164,200,268,3,271,417,0,0,0,0,0,0,0,66.31 ,64.99 ,66.31 
03,010,01,008,0164,201,336,5,341,450,0,0,0,0,0,0,0,66.31 ,75.78 ,66.31 
03,010,01,008,0165,202,394,5,399,666,0,0,0,0,0,0,0,66.31 ,59.91 ,66.31 
03,010,01,008,0166,203,529,6,535,788,0,0,0,0,0,0,0,66.31 ,67.89 ,66.31 
03,010,01,008,0167,204,708,2,710,1106,0,0,0,0,0,0,0,66.31 ,64.20 ,66.31 
03,010,01,008,0168,205,583,8,591,851,0,0,0,0,0,0,0,66.31 ,69.45 ,66.31 
03,010,01,008,0169,206,678,14,692,1065,0,0,0,0,0,0,0,66.31 ,64.98 ,66.31 
03,010,01,008,0170,207,935,8,943,1394,0,0,0,0,0,0,0,66.31 ,67.65 ,66.31 
03,010,01,008,0171,208,449,4,453,748,0,0,0,0,0,0,0,66.31 ,60.56 ,66.31 
03,010,01,008,0172,209,361,5,366,608,0,0,0,0,0,0,0,66.31 ,60.20 ,66.31 
03,010,01,008,0173,210,481,2,483,845,0,0,0,0,0,0,0,66.31 ,57.16 ,66.31 
03,010,01,008,0174,211,591,17,608,964,0,0,0,0,0,0,0,66.31 ,63.07 ,66.31 
03,010,01,008,0175,212,608,9,617,939,0,0,0,0,0,0,0,66.31 ,65.71 ,66.31 
03,010,01,008,0176,213,442,9,451,694,0,0,0,0,0,0,0,66.31 ,64.99 ,66.31 
03,010,01,008,0177,214,520,9,529,836,0,0,0,0,0,0,0,66.31 ,63.28 ,66.31 
03,010,01,008,0178,215,599,4,603,929,0,0,0,0,0,0,0,66.31 ,64.91 ,66.31 
03,010,01,008,0179,216,249,4,253,410,0,0,0,0,0,0,0,66.31 ,61.71 ,66.31 
03,010,01,008,0179,217,174,1,175,270,0,0,0,0,0,0,0,66.31 ,64.81 ,66.31 
03,010,01,009,0180,218,1176,18,1194,1658,0,0,0,0,0,0,0,66.31 ,72.01 ,66.31 
03,010,01,009,0181,219,672,17,689,1009,0,0,0,0,0,0,0,66.31 ,68.29 ,66.31 
03,010,01,009,0182,220,1013,20,1033,1518,0,0,0,0,0,0,0,66.31 ,68.05 ,66.31 
03,010,01,009,0183,221,1125,16,1141,1486,0,0,0,0,0,0,0,66.31 ,76.78 ,66.31 
03,010,01,009,0184,222,776,10,786,1250,0,0,0,0,0,0,0,66.31 ,62.88 ,66.31 
03,010,01,009,0185,223,447,9,456,732,0,0,0,0,0,0,0,66.31 ,62.30 ,66.31 
03,010,01,009,0186,224,309,1,310,482,0,0,0,0,0,0,0,66.31 ,64.32 ,66.31 
03,010,01,009,0187,225,633,5,638,1035,0,0,0,0,0,0,0,66.31 ,61.64 ,66.31 
03,010,01,009,0188,226,768,10,778,1138,0,0,0,0,0,0,0,66.31 ,68.37 ,66.31 
03,010,01,009,0189,227,574,5,579,928,0,0,0,0,0,0,0,66.31 ,62.39 ,66.31 
03,010,01,009,0190,228,114,0,114,196,0,0,0,0,0,0,0,66.31 ,58.16 ,66.31 
03,010,01,009,0190,229,143,0,143,252,0,0,0,0,0,0,0,66.31 ,56.75 ,66.31 
03,010,01,009,0191,230,700,3,703,1107,0,0,0,0,0,0,0,66.31 ,63.50 ,66.31 
03,010,01,009,0192,231,258,1,259,400,0,0,0,0,0,0,0,66.31 ,64.75 ,66.31 
03,010,01,009,0193,232,707,9,716,1067,0,0,0,0,0,0,0,66.31 ,67.10 ,66.31 
03,010,01,009,0193,233,182,5,187,303,0,0,0,0,0,0,0,66.31 ,61.72 ,66.31 
03,010,01,009,0194,234,898,11,909,1289,0,0,0,0,0,0,0,66.31 ,70.52 ,66.31 
03,010,01,009,0195,235,618,13,631,924,0,0,0,0,0,0,0,66.31 ,68.29 ,66.31 
03,010,01,009,0196,236,508,4,512,791,0,0,0,0,0,0,0,66.31 ,64.73 ,66.31 
03,010,01,009,0197,237,605,6,611,947,0,0,0,0,0,0,0,66.31 ,64.52 ,66.31 
03,010,01,009,0198,238,247,4,251,408,0,0,0,0,0,0,0,66.31 ,61.52 ,66.31 
03,010,01,009,0198,239,259,4,263,409,0,0,0,0,0,0,0,66.31 ,64.30 ,66.31 
03,010,01,009,0199,240,690,15,705,1024,0,0,0,0,0,0,0,66.31 ,68.85 ,66.31 
03,010,01,009,0200,241,676,9,685,993,0,0,0,0,0,0,0,66.31 ,68.98 ,66.31 
03,010,01,009,0201,242,862,15,877,1236,0,0,0,0,0,0,0,66.31 ,70.95 ,66.31 
03,010,01,009,0202,243,292,4,296,470,0,0,0,0,0,0,0,66.31 ,62.98 ,66.31 
03,010,01,009,0202,244,272,2,274,366,0,0,0,0,0,0,0,66.31 ,74.86 ,66.31 
03,010,01,010,0203,245,616,15,631,872,0,0,0,0,0,0,0,66.31 ,72.36 ,66.31 
03,010,01,010,0204,246,1137,9,1146,1568,0,0,0,0,0,0,0,66.31 ,73.09 ,66.31 
03,010,01,010,0205,247,1007,18,1025,1393,0,0,0,0,0,0,0,66.31 ,73.58 ,66.31 
03,010,01,010,0206,248,705,6,711,909,0,0,0,0,0,0,0,66.31 ,78.22 ,66.31 
03,010,01,010,0207,249,504,11,515,703,0,0,0,0,0,0,0,66.31 ,73.26 ,66.31 
03,010,01,010,0208,250,952,12,964,1291,0,0,0,0,0,0,0,66.31 ,74.67 ,66.31 
03,010,01,010,0209,251,290,2,292,434,0,0,0,0,0,0,0,66.31 ,67.28 ,66.31 
03,010,01,010,0210,252,269,2,271,392,0,0,0,0,0,0,0,66.31 ,69.13 ,66.31 
03,010,01,010,0210,253,96,0,96,131,0,0,0,0,0,0,0,66.31 ,73.28 ,66.31 
03,010,01,010,0211,254,594,6,600,833,0,0,0,0,0,0,0,66.31 ,72.03 ,66.31 
03,010,01,010,0212,255,303,3,306,433,0,0,0,0,0,0,0,66.31 ,70.67 ,66.31 
03,010,01,010,0213,256,380,3,383,510,0,0,0,0,0,0,0,66.31 ,75.10 ,66.31 
03,010,01,010,0214,257,407,5,412,580,0,0,0,0,0,0,0,66.31 ,71.03 ,66.31 
03,010,01,010,0215,258,1153,6,1159,1507,0,0,0,0,0,0,0,66.31 ,76.91 ,66.31 
03,010,01,010,0216,259,617,7,624,882,0,0,0,0,0,0,0,66.31 ,70.75 ,66.31 
03,010,01,010,0217,260,632,6,638,947,0,0,0,0,0,0,0,66.31 ,67.37 ,66.31 
03,010,01,010,0218,261,623,2,625,849,0,0,0,0,0,0,0,66.31 ,73.62 ,66.31 
03,010,01,010,0219,262,377,9,386,554,0,0,0,0,0,0,0,66.31 ,69.68 ,66.31 
03,010,01,010,0220,263,439,10,449,572,0,0,0,0,0,0,0,66.31 ,78.50 ,66.31 
03,010,01,010,0221,264,543,2,545,746,0,0,0,0,0,0,0,66.31 ,73.06 ,66.31 
03,010,01,010,0221,265,116,0,116,173,0,0,0,0,0,0,0,66.31 ,67.05 ,66.31 
03,010,01,010,0222,266,359,3,362,526,0,0,0,0,0,0,0,66.31 ,68.82 ,66.31 
03,010,01,010,0223,267,515,4,519,761,0,0,0,0,0,0,0,66.31 ,68.20 ,66.31 
03,010,01,010,0224,268,552,6,558,797,0,0,0,0,0,0,0,66.31 ,70.01 ,66.31 
03,010,01,011,0225,269,364,9,373,497,0,0,0,0,0,0,0,66.31 ,75.05 ,66.31 
03,010,01,011,0226,270,471,7,478,641,0,0,0,0,0,0,0,66.31 ,74.57 ,66.31 
03,010,01,011,0227,271,902,21,923,1269,0,0,0,0,0,0,0,66.31 ,72.73 ,66.31 
03,010,01,011,0228,272,806,23,829,1166,0,0,0,0,0,0,0,66.31 ,71.10 ,66.31 
03,010,01,011,0229,273,190,1,191,283,0,0,0,0,0,0,0,66.31 ,67.49 ,66.31 
03,010,01,011,0229,274,82,3,85,129,0,0,0,0,0,0,0,66.31 ,65.89 ,66.31 
03,010,01,011,0230,275,773,11,784,1149,0,0,0,0,0,0,0,66.31 ,68.23 ,66.31 
03,010,01,011,0231,276,369,2,371,553,0,0,0,0,0,0,0,66.31 ,67.09 ,66.31 
03,010,01,011,0232,277,615,15,630,955,0,0,0,0,0,0,0,66.31 ,65.97 ,66.31 
03,010,01,011,0233,278,793,16,809,1162,0,0,0,0,0,0,0,66.31 ,69.62 ,66.31 
03,010,01,011,0234,279,713,12,725,1113,0,0,0,0,0,0,0,66.31 ,65.14 ,66.31 
03,010,01,011,0235,280,676,14,690,941,0,0,0,0,0,0,0,66.31 ,73.33 ,66.31 
03,010,01,011,0236,281,466,5,471,684,0,0,0,0,0,0,0,66.31 ,68.86 ,66.31 
03,010,01,011,0236,282,165,3,168,236,0,0,0,0,0,0,0,66.31 ,71.19 ,66.31 
03,010,01,011,0237,283,735,16,751,1009,0,0,0,0,0,0,0,66.31 ,74.43 ,66.31 
03,010,01,011,0237,284,241,2,243,328,0,0,0,0,0,0,0,66.31 ,74.09 ,66.31 
03,010,01,011,0238,285,817,19,836,1166,0,0,0,0,0,0,0,66.31 ,71.70 ,66.31 
03,010,01,011,0238,286,281,4,285,381,0,0,0,0,0,0,0,66.31 ,74.80 ,66.31 
03,010,01,011,0239,287,218,2,220,296,0,0,0,0,0,0,0,66.31 ,74.32 ,66.31 
03,010,01,011,0239,288,210,3,213,293,0,0,0,0,0,0,0,66.31 ,72.70 ,66.31 
03,010,01,012,0240,289,384,10,394,553,0,0,0,0,0,0,0,66.31 ,71.25 ,66.31 
03,010,01,012,0240,290,521,10,531,705,0,0,0,0,0,0,0,66.31 ,75.32 ,66.31 
03,010,01,012,0240,291,964,20,984,1474,0,0,0,0,0,0,0,66.31 ,66.76 ,66.31 
03,010,01,012,0241,292,973,17,990,1388,0,0,0,0,0,0,0,66.31 ,71.33 ,66.31 
03,010,01,012,0241,293,359,7,366,498,0,0,0,0,0,0,0,66.31 ,73.49 ,66.31 
03,010,01,012,0242,294,731,13,744,1049,0,0,0,0,0,0,0,66.31 ,70.92 ,66.31 
03,010,01,012,0242,295,278,7,285,378,0,0,0,0,0,0,0,66.31 ,75.40 ,66.31 
03,010,01,012,0243,296,337,8,345,461,0,0,0,0,0,0,0,66.31 ,74.84 ,66.31 
03,010,01,012,0243,297,778,18,796,1101,0,0,0,0,0,0,0,66.31 ,72.30 ,66.31 
03,010,01,012,0244,298,776,19,795,1107,0,0,0,0,0,0,0,66.31 ,71.82 ,66.31 
03,010,01,012,0244,299,466,7,473,622,0,0,0,0,0,0,0,66.31 ,76.05 ,66.31 
03,010,01,012,0245,300,508,14,522,682,0,0,0,0,0,0,0,66.31 ,76.54 ,66.31 
03,010,01,012,0246,301,378,5,383,479,0,0,0,0,0,0,0,66.31 ,79.96 ,66.31 
03,010,01,012,0246,302,393,5,398,533,0,0,0,0,0,0,0,66.31 ,74.67 ,66.31 
03,010,01,012,0246,303,262,2,264,343,0,0,0,0,0,0,0,66.31 ,76.97 ,66.31 
03,010,01,012,0247,304,1286,18,1304,1828,0,0,0,0,0,0,0,66.31 ,71.33 ,66.31 
03,010,01,012,0248,305,641,7,648,797,0,0,0,0,0,0,0,66.31 ,81.30 ,66.31 
03,010,01,012,0249,306,1282,25,1307,1680,0,0,0,0,0,0,0,66.31 ,77.80 ,66.31 
03,010,01,012,0250,307,741,8,749,1030,0,0,0,0,0,0,0,66.31 ,72.72 ,66.31 
03,010,01,012,0251,308,489,7,496,635,0,0,0,0,0,0,0,66.31 ,78.11 ,66.31 
03,010,01,012,0252,309,441,5,446,558,0,0,0,0,0,0,0,66.31 ,79.93 ,66.31 
03,010,01,012,0253,310,615,10,625,813,0,0,0,0,0,0,0,66.31 ,76.88 ,66.31 
03,010,01,012,0253,311,278,7,285,397,0,0,0,0,0,0,0,66.31 ,71.79 ,66.31 
03,010,01,012,0254,312,954,22,976,1390,0,0,0,0,0,0,0,66.31 ,70.22 ,66.31 
03,010,01,012,0254,313,575,10,585,759,0,0,0,0,0,0,0,66.31 ,77.08 ,66.31 
03,010,01,012,0255,314,1120,28,1148,1704,0,0,0,0,0,0,0,66.31 ,67.37 ,66.31 
03,010,01,012,0256,315,1181,33,1214,1739,0,0,0,0,0,0,0,66.31 ,69.81 ,66.31 
03,010,01,012,0257,316,693,12,705,974,0,0,0,0,0,0,0,66.31 ,72.38 ,66.31 
03,010,01,012,0258,317,1097,24,1121,1622,0,0,0,0,0,0,0,66.31 ,69.11 ,66.31 
03,010,01,012,0258,318,932,23,955,1586,0,0,0,0,0,0,0,66.31 ,60.21 ,66.31 
03,010,01,012,0259,319,841,15,856,1286,0,0,0,0,0,0,0,66.31 ,66.56 ,66.31 
03,010,01,012,0259,320,1032,28,1060,1540,0,0,0,0,0,0,0,66.31 ,68.83 ,66.31 
03,010,01,012,0260,321,547,15,562,759,0,0,0,0,0,0,0,66.31 ,74.04 ,66.31 
03,010,01,012,0261,322,1228,30,1258,1755,0,0,0,0,0,0,0,66.31 ,71.68 ,66.31 
03,010,01,012,0262,323,1243,30,1273,1772,0,0,0,0,0,0,0,66.31 ,71.84 ,66.31 
03,010,01,012,0263,324,583,19,602,805,0,0,0,0,0,0,0,66.31 ,74.78 ,66.31 
03,010,01,012,0264,325,746,14,760,1040,0,0,0,0,0,0,0,66.31 ,73.08 ,66.31 
03,010,01,012,0265,326,854,23,877,1307,0,0,0,0,0,0,0,66.31 ,67.10 ,66.31 
03,010,01,013,0266,327,1136,18,1154,1580,0,0,0,0,0,0,0,66.31 ,73.04 ,66.31 
03,010,01,013,0267,328,525,7,532,758,0,0,0,0,0,0,0,66.31 ,70.18 ,66.31 
03,010,01,013,0268,329,509,13,522,729,0,0,0,0,0,0,0,66.31 ,71.60 ,66.31 
03,010,01,013,0269,330,534,6,540,844,0,0,0,0,0,0,0,66.31 ,63.98 ,66.31 
03,010,01,013,0270,331,836,10,846,1317,0,0,0,0,0,0,0,66.31 ,64.24 ,66.31 
03,010,01,013,0271,332,614,9,623,1037,0,0,0,0,0,0,0,66.31 ,60.08 ,66.31 
03,010,01,013,0271,333,823,15,838,1372,0,0,0,0,0,0,0,66.31 ,61.08 ,66.31 
03,010,01,013,0272,334,548,12,560,992,0,0,0,0,0,0,0,66.31 ,56.45 ,66.31 
03,010,01,013,0272,335,813,24,837,1252,0,0,0,0,0,0,0,66.31 ,66.85 ,66.31 
03,010,01,013,0273,336,1038,21,1059,1633,0,0,0,0,0,0,0,66.31 ,64.85 ,66.31 
03,010,01,013,0273,337,903,24,927,1606,0,0,0,0,0,0,0,66.31 ,57.72 ,66.31 
03,010,01,013,0273,338,1084,27,1111,1762,0,0,0,0,0,0,0,66.31 ,63.05 ,66.31 
03,010,01,013,0274,339,1211,38,1249,2052,0,0,0,0,0,0,0,66.31 ,60.87 ,66.31 
03,010,01,013,0274,340,825,19,844,1438,0,0,0,0,0,0,0,66.31 ,58.69 ,66.31 
03,010,01,013,0274,341,640,14,654,1076,0,0,0,0,0,0,0,66.31 ,60.78 ,66.31 
03,010,01,013,0275,342,1121,15,1136,1653,0,0,0,0,0,0,0,66.31 ,68.72 ,66.31 
03,010,01,013,0276,343,866,10,876,1240,0,0,0,0,0,0,0,66.31 ,70.65 ,66.31 
03,010,01,013,0277,344,993,20,1013,1558,0,0,0,0,0,0,0,66.31 ,65.02 ,66.31 
03,010,01,013,0277,345,326,5,331,473,0,0,0,0,0,0,0,66.31 ,69.98 ,66.31 
03,010,01,013,0278,346,824,11,835,1099,0,0,0,0,0,0,0,66.31 ,75.98 ,66.31 
03,010,01,013,0279,347,659,4,663,852,0,0,0,0,0,0,0,66.31 ,77.82 ,66.31 
03,010,01,013,0279,348,224,2,226,312,0,0,0,0,0,0,0,66.31 ,72.44 ,66.31 
03,010,01,013,0280,349,672,17,689,910,0,0,0,0,0,0,0,66.31 ,75.71 ,66.31 
03,010,01,013,0281,350,829,13,842,1203,0,0,0,0,0,0,0,66.31 ,69.99 ,66.31 
03,010,01,013,0281,351,435,8,443,658,0,0,0,0,0,0,0,66.31 ,67.33 ,66.31 
03,010,01,013,0282,352,542,11,553,738,0,0,0,0,0,0,0,66.31 ,74.93 ,66.31 
03,010,01,013,0283,353,445,10,455,612,0,0,0,0,0,0,0,66.31 ,74.35 ,66.31 
03,010,01,013,0284,354,519,7,526,687,0,0,0,0,0,0,0,66.31 ,76.56 ,66.31 
03,010,01,013,0285,355,376,6,382,521,0,0,0,0,0,0,0,66.31 ,73.32 ,66.31 
03,010,01,013,0285,356,378,6,384,583,0,0,0,0,0,0,0,66.31 ,65.87 ,66.31 
03,010,01,013,0286,357,185,2,187,336,0,0,0,0,0,0,0,66.31 ,55.65 ,66.31 
03,010,01,013,0287,358,233,8,241,319,0,0,0,0,0,0,0,66.31 ,75.55 ,66.31 
03,010,01,014,0288,359,736,9,745,1110,0,0,0,0,0,0,0,66.31 ,67.12 ,66.31 
03,010,01,014,0288,360,684,10,694,985,0,0,0,0,0,0,0,66.31 ,70.46 ,66.31 
03,010,01,014,0289,361,1261,18,1279,1765,0,0,0,0,0,0,0,66.31 ,72.46 ,66.31 
03,010,01,014,0290,362,555,11,566,741,0,0,0,0,0,0,0,66.31 ,76.38 ,66.31 
03,010,01,014,0291,363,632,7,639,851,0,0,0,0,0,0,0,66.31 ,75.09 ,66.31 
03,010,01,014,0292,364,908,16,924,1261,0,0,0,0,0,0,0,66.31 ,73.28 ,66.31 
03,010,01,014,0293,365,428,5,433,566,0,0,0,0,0,0,0,66.31 ,76.50 ,66.31 
03,010,01,014,0294,366,740,11,751,1061,0,0,0,0,0,0,0,66.31 ,70.78 ,66.31 
03,010,01,014,0295,367,705,10,715,1111,0,0,0,0,0,0,0,66.31 ,64.36 ,66.31 
03,010,01,014,0295,368,1114,19,1133,1638,0,0,0,0,0,0,0,66.31 ,69.17 ,66.31 
03,010,01,014,0295,369,888,16,904,1547,0,0,0,0,0,0,0,66.31 ,58.44 ,66.31 
03,010,01,014,0296,370,821,12,833,1224,0,0,0,0,0,0,0,66.31 ,68.06 ,66.31 
03,010,01,014,0297,371,862,13,875,1298,0,0,0,0,0,0,0,66.31 ,67.41 ,66.31 
03,010,01,014,0298,372,1129,16,1145,1633,0,0,0,0,0,0,0,66.31 ,70.12 ,66.31 
03,010,01,014,0299,373,505,7,512,678,0,0,0,0,0,0,0,66.31 ,75.52 ,66.31 
03,010,01,014,0299,374,738,15,753,1008,0,0,0,0,0,0,0,66.31 ,74.70 ,66.31 
03,010,01,014,0300,375,493,6,499,702,0,0,0,0,0,0,0,66.31 ,71.08 ,66.31 
03,010,01,014,0300,376,244,3,247,364,0,0,0,0,0,0,0,66.31 ,67.86 ,66.31 
03,010,01,014,0301,377,468,4,472,762,0,0,0,0,0,0,0,66.31 ,61.94 ,66.31 
03,010,01,014,0302,378,354,9,363,509,0,0,0,0,0,0,0,66.31 ,71.32 ,66.31 
03,010,01,014,0302,379,288,7,295,369,0,0,0,0,0,0,0,66.31 ,79.95 ,66.31 
03,010,01,014,0303,380,421,3,424,558,0,0,0,0,0,0,0,66.31 ,75.99 ,66.31 
03,010,01,014,0304,381,166,4,170,239,0,0,0,0,0,0,0,66.31 ,71.13 ,66.31 
03,010,01,014,0304,382,993,20,1013,1372,0,0,0,0,0,0,0,66.31 ,73.83 ,66.31 
03,010,01,014,0305,383,533,10,543,783,0,0,0,0,0,0,0,66.31 ,69.35 ,66.31 
03,010,01,014,0306,384,328,3,331,501,0,0,0,0,0,0,0,66.31 ,66.07 ,66.31 
03,010,01,014,0307,385,632,8,640,911,0,0,0,0,0,0,0,66.31 ,70.25 ,66.31 
03,010,01,014,0307,386,626,7,633,890,0,0,0,0,0,0,0,66.31 ,71.12 ,66.31 
03,010,01,014,0308,387,586,6,592,934,0,0,0,0,0,0,0,66.31 ,63.38 ,66.31 
03,010,01,014,0308,388,71,1,72,150,0,0,0,0,0,0,0,66.31 ,48.00 ,66.31 
03,010,01,014,0309,389,171,1,172,312,0,0,0,0,0,0,0,66.31 ,55.13 ,66.31 
03,010,01,014,0310,390,219,0,219,402,0,0,0,0,0,0,0,66.31 ,54.48 ,66.31 
03,010,01,014,0310,391,233,2,235,388,0,0,0,0,0,0,0,66.31 ,60.57 ,66.31 
03,010,01,014,0311,392,316,4,320,440,0,0,0,0,0,0,0,66.31 ,72.73 ,66.31 
03,010,01,014,0311,393,183,2,185,315,0,0,0,0,0,0,0,66.31 ,58.73 ,66.31 
03,010,01,015,0312,394,816,17,833,1193,0,0,0,0,0,0,0,66.31 ,69.82 ,66.31 
03,010,01,015,0312,395,851,17,868,1231,0,0,0,0,0,0,0,66.31 ,70.51 ,66.31 
03,010,01,015,0313,396,741,9,750,1005,0,0,0,0,0,0,0,66.31 ,74.63 ,66.31 
03,010,01,015,0314,397,814,13,827,1176,0,0,0,0,0,0,0,66.31 ,70.32 ,66.31 
03,010,01,015,0314,398,788,17,805,1188,0,0,0,0,0,0,0,66.31 ,67.76 ,66.31 
03,010,01,015,0314,399,761,18,779,1132,0,0,0,0,0,0,0,66.31 ,68.82 ,66.31 
03,010,01,015,0315,400,447,5,452,601,0,0,0,0,0,0,0,66.31 ,75.21 ,66.31 
03,010,01,015,0316,401,385,6,391,525,0,0,0,0,0,0,0,66.31 ,74.48 ,66.31 
03,010,01,015,0317,402,461,6,467,679,0,0,0,0,0,0,0,66.31 ,68.78 ,66.31 
03,010,01,015,0318,403,460,3,463,573,0,0,0,0,0,0,0,66.31 ,80.80 ,66.31 
03,010,01,015,0319,404,1130,15,1145,1662,0,0,0,0,0,0,0,66.31 ,68.89 ,66.31 
03,010,01,015,0320,405,685,6,691,960,0,0,0,0,0,0,0,66.31 ,71.98 ,66.31 
03,010,01,015,0321,406,358,3,361,527,0,0,0,0,0,0,0,66.31 ,68.50 ,66.31 
03,010,01,015,0322,407,378,12,390,500,0,0,0,0,0,0,0,66.31 ,78.00 ,66.31 
03,010,01,015,0323,408,353,8,361,505,0,0,0,0,0,0,0,66.31 ,71.49 ,66.31 
03,010,01,015,0324,409,296,3,299,424,0,0,0,0,0,0,0,66.31 ,70.52 ,66.31 
03,010,01,015,0325,410,316,6,322,485,0,0,0,0,0,0,0,66.31 ,66.39 ,66.31 
03,010,01,015,0326,411,198,1,199,322,0,0,0,0,0,0,0,66.31 ,61.80 ,66.31 
03,010,01,015,0327,412,520,5,525,732,0,0,0,0,0,0,0,66.31 ,71.72 ,66.31 
03,010,01,015,0328,413,556,15,571,754,0,0,0,0,0,0,0,66.31 ,75.73 ,66.31 
03,010,01,015,0329,414,381,8,389,575,0,0,0,0,0,0,0,66.31 ,67.65 ,66.31 
03,010,01,015,0329,415,325,3,328,459,0,0,0,0,0,0,0,66.31 ,71.46 ,66.31 
03,010,01,016,0330,416,695,11,706,962,0,0,0,0,0,0,0,66.31 ,73.39 ,66.31 
03,010,01,016,0331,417,239,3,242,362,0,0,0,0,0,0,0,66.31 ,66.85 ,66.31 
03,010,01,016,0332,418,560,4,564,782,0,0,0,0,0,0,0,66.31 ,72.12 ,66.31 
03,010,01,016,0333,419,976,14,990,1569,0,0,0,0,0,0,0,66.31 ,63.10 ,66.31 
03,010,01,016,0334,420,597,7,604,799,0,0,0,0,0,0,0,66.31 ,75.59 ,66.31 
03,010,01,016,0335,421,555,4,559,786,0,0,0,0,0,0,0,66.31 ,71.12 ,66.31 
03,010,01,016,0336,422,571,8,579,856,0,0,0,0,0,0,0,66.31 ,67.64 ,66.31 
03,010,01,016,0337,423,455,5,460,865,0,0,0,0,0,0,0,66.31 ,53.18 ,66.31 
03,010,01,016,0338,424,239,1,240,420,0,0,0,0,0,0,0,66.31 ,57.14 ,66.31 
03,010,01,016,0338,425,315,8,323,501,0,0,0,0,0,0,0,66.31 ,64.47 ,66.31 
03,010,01,016,0339,426,331,2,333,617,0,0,0,0,0,0,0,66.31 ,53.97 ,66.31 
03,010,01,016,0340,427,116,0,116,168,0,0,0,0,0,0,0,66.31 ,69.05 ,66.31 
03,010,01,016,0340,428,112,1,113,223,0,0,0,0,0,0,0,66.31 ,50.67 ,66.31 
03,010,01,017,0341,429,544,4,548,992,0,0,0,0,0,0,0,66.31 ,55.24 ,66.31 
03,010,01,017,0342,430,125,1,126,243,0,0,0,0,0,0,0,66.31 ,51.85 ,66.31 
03,010,01,017,0342,431,132,1,133,231,0,0,0,0,0,0,0,66.31 ,57.58 ,66.31 
03,010,01,017,0343,432,98,2,100,160,0,0,0,0,0,0,0,66.31 ,62.50 ,66.31 
03,010,01,017,0343,433,90,1,91,134,0,0,0,0,0,0,0,66.31 ,67.91 ,66.31 
03,010,01,017,0344,434,191,3,194,354,0,0,0,0,0,0,0,66.31 ,54.80 ,66.31 
03,010,01,017,0344,435,86,2,88,137,0,0,0,0,0,0,0,66.31 ,64.23 ,66.31 
03,010,01,017,0344,436,109,2,111,238,0,0,0,0,0,0,0,66.31 ,46.64 ,66.31 
03,010,01,017,0345,437,205,2,207,382,0,0,0,0,0,0,0,66.31 ,54.19 ,66.31 
03,010,01,018,0346,438,198,3,201,362,0,0,0,0,0,0,0,66.31 ,55.52 ,66.31 
03,010,01,018,0347,439,97,0,97,186,0,0,0,0,0,0,0,66.31 ,52.15 ,66.31 
03,010,01,018,0348,440,125,0,125,221,0,0,0,0,0,0,0,66.31 ,56.56 ,66.31 
03,010,01,018,0349,441,106,0,106,232,0,0,0,0,0,0,0,66.31 ,45.69 ,66.31 
03,010,01,018,0349,442,29,0,29,68,0,0,0,0,0,0,0,66.31 ,42.65 ,66.31 
03,010,01,018,0350,443,178,4,182,263,0,0,0,0,0,0,0,66.31 ,69.20 ,66.31 
03,010,01,018,0351,444,69,1,70,141,0,0,0,0,0,0,0,66.31 ,49.65 ,66.31 
03,010,01,018,0352,445,165,6,171,260,0,0,0,0,0,0,0,66.31 ,65.77 ,66.31 
03,010,01,018,0353,446,16,0,16,22,0,0,0,0,0,0,0,66.31 ,72.73 ,66.31 
03,010,01,018,0354,447,12,0,12,23,0,0,0,0,0,0,0,66.31 ,52.17 ,66.31 
03,010,01,018,0355,448,10,1,11,27,0,0,0,0,0,0,0,66.31 ,40.74 ,66.31 
03,010,01,018,0356,449,11,0,11,20,0,0,0,0,0,0,0,66.31 ,55.00 ,66.31 
03,010,01,018,0357,450,53,0,53,95,0,0,0,0,0,0,0,66.31 ,55.79 ,66.31 
03,011,01,001,0001,1,744,14,758,1281,0,0,0,0,0,0,0,66.31 ,59.17 ,66.31 
03,011,01,001,0001,2,770,6,776,1293,0,0,0,0,0,0,0,66.31 ,60.02 ,66.31 
03,011,01,001,0001,3,838,8,846,1431,0,0,0,0,0,0,0,66.31 ,59.12 ,66.31 
03,011,01,001,0002,4,729,4,733,1219,0,0,0,0,0,0,0,66.31 ,60.13 ,66.31 
03,011,01,001,0002,5,724,12,736,1215,0,0,0,0,0,0,0,66.31 ,60.58 ,66.31 
03,011,01,001,0003,6,841,14,855,1383,0,0,0,0,0,0,0,66.31 ,61.82 ,66.31 
03,011,01,001,0003,7,746,9,755,1312,0,0,0,0,0,0,0,66.31 ,57.55 ,66.31 
03,011,01,001,0004,8,523,8,531,915,0,0,0,0,0,0,0,66.31 ,58.03 ,66.31 
03,011,01,001,0005,9,766,12,778,1316,0,0,0,0,0,0,0,66.31 ,59.12 ,66.31 
03,011,01,001,0006,10,668,6,674,1019,0,0,0,0,0,0,0,66.31 ,66.14 ,66.31 
03,011,01,001,0007,11,587,7,594,1071,0,0,0,0,0,0,0,66.31 ,55.46 ,66.31 
03,011,01,001,0007,12,585,6,591,1005,0,0,0,0,0,0,0,66.31 ,58.81 ,66.31 
03,011,01,001,0007,13,615,9,624,1108,0,0,0,0,0,0,0,66.31 ,56.32 ,66.31 
03,011,01,001,0008,14,663,12,675,1143,0,0,0,0,0,0,0,66.31 ,59.06 ,66.31 
03,011,01,001,0008,15,651,9,660,1182,0,0,0,0,0,0,0,66.31 ,55.84 ,66.31 
03,011,01,001,0008,16,590,9,599,1060,0,0,0,0,0,0,0,66.31 ,56.51 ,66.31 
03,011,01,001,0008,17,493,10,503,856,0,0,0,0,0,0,0,66.31 ,58.76 ,66.31 
03,011,01,001,0008,18,541,5,546,893,0,0,0,0,0,0,0,66.31 ,61.14 ,66.31 
03,011,01,001,0009,19,483,7,490,825,0,0,0,0,0,0,0,66.31 ,59.39 ,66.31 
03,011,01,001,0010,20,837,13,850,1387,0,0,0,0,0,0,0,66.31 ,61.28 ,66.31 
03,011,01,001,0011,21,339,3,342,553,0,0,0,0,0,0,0,66.31 ,61.84 ,66.31 
03,011,01,001,0012,22,751,6,757,1179,0,0,0,0,0,0,0,66.31 ,64.21 ,66.31 
03,011,01,001,0012,23,680,7,687,1227,0,0,0,0,0,0,0,66.31 ,55.99 ,66.31 
03,011,01,001,0013,24,931,10,941,1426,0,0,0,0,0,0,0,66.31 ,65.99 ,66.31 
03,011,01,001,0014,25,844,9,853,1488,0,0,0,0,0,0,0,66.31 ,57.33 ,66.31 
03,011,01,001,0014,26,753,9,762,1427,0,0,0,0,0,0,0,66.31 ,53.40 ,66.31 
03,011,01,001,0015,27,837,12,849,1407,0,0,0,0,0,0,0,66.31 ,60.34 ,66.31 
03,011,01,001,0015,28,775,9,784,1406,0,0,0,0,0,0,0,66.31 ,55.76 ,66.31 
03,011,01,001,0016,29,644,12,656,1088,0,0,0,0,0,0,0,66.31 ,60.29 ,66.31 
03,011,01,001,0016,30,567,6,573,1089,0,0,0,0,0,0,0,66.31 ,52.62 ,66.31 
03,011,01,001,0017,31,618,9,627,1061,0,0,0,0,0,0,0,66.31 ,59.10 ,66.31 
03,011,01,001,0017,32,633,5,638,1153,0,0,0,0,0,0,0,66.31 ,55.33 ,66.31 
03,011,01,001,0017,33,845,12,857,1470,0,0,0,0,0,0,0,66.31 ,58.30 ,66.31 
03,011,01,001,0018,34,967,6,973,1488,0,0,0,0,0,0,0,66.31 ,65.39 ,66.31 
03,011,01,001,0019,35,742,6,748,1210,0,0,0,0,0,0,0,66.31 ,61.82 ,66.31 
03,011,01,001,0020,36,822,14,836,1380,0,0,0,0,0,0,0,66.31 ,60.58 ,66.31 
03,011,01,001,0021,37,928,9,937,1481,0,0,0,0,0,0,0,66.31 ,63.27 ,66.31 
03,011,01,001,0022,38,862,14,876,1326,0,0,0,0,0,0,0,66.31 ,66.06 ,66.31 
03,011,01,001,0022,39,659,8,667,1164,0,0,0,0,0,0,0,66.31 ,57.30 ,66.31 
03,011,01,001,0023,40,865,22,887,1369,0,0,0,0,0,0,0,66.31 ,64.79 ,66.31 
03,011,01,001,0024,41,241,2,243,362,0,0,0,0,0,0,0,66.31 ,67.13 ,66.31 
03,011,01,001,0025,42,344,4,348,453,0,0,0,0,0,0,0,66.31 ,76.82 ,66.31 
03,011,01,001,0026,43,508,11,519,746,0,0,0,0,0,0,0,66.31 ,69.57 ,66.31 
03,011,01,001,0027,44,657,13,670,970,0,0,0,0,0,0,0,66.31 ,69.07 ,66.31 
03,011,01,001,0028,45,397,3,400,572,0,0,0,0,0,0,0,66.31 ,69.93 ,66.31 
03,011,01,002,0029,46,516,5,521,830,0,0,0,0,0,0,0,66.31 ,62.77 ,66.31 
03,011,01,002,0029,47,314,3,317,487,0,0,0,0,0,0,0,66.31 ,65.09 ,66.31 
03,011,01,002,0030,48,365,5,370,528,0,0,0,0,0,0,0,66.31 ,70.08 ,66.31 
03,011,01,002,0031,49,265,2,267,388,0,0,0,0,0,0,0,66.31 ,68.81 ,66.31 
03,011,01,002,0032,50,384,3,387,598,0,0,0,0,0,0,0,66.31 ,64.72 ,66.31 
03,011,01,002,0033,51,372,4,376,545,0,0,0,0,0,0,0,66.31 ,68.99 ,66.31 
03,011,01,002,0034,52,286,1,287,418,0,0,0,0,0,0,0,66.31 ,68.66 ,66.31 
03,011,01,002,0035,53,500,8,508,772,0,0,0,0,0,0,0,66.31 ,65.80 ,66.31 
03,011,01,002,0036,54,363,9,372,632,0,0,0,0,0,0,0,66.31 ,58.86 ,66.31 
03,011,01,002,0036,55,694,10,704,1186,0,0,0,0,0,0,0,66.31 ,59.36 ,66.31 
03,011,01,002,0036,56,640,11,651,1153,0,0,0,0,0,0,0,66.31 ,56.46 ,66.31 
03,011,01,002,0037,57,422,8,430,729,0,0,0,0,0,0,0,66.31 ,58.98 ,66.31 
03,011,01,002,0038,58,637,8,645,996,0,0,0,0,0,0,0,66.31 ,64.76 ,66.31 
03,011,01,002,0039,59,510,6,516,837,0,0,0,0,0,0,0,66.31 ,61.65 ,66.31 
03,011,01,002,0039,60,802,15,817,1206,0,0,0,0,0,0,0,66.31 ,67.74 ,66.31 
03,011,01,002,0039,61,699,3,702,1019,0,0,0,0,0,0,0,66.31 ,68.89 ,66.31 
03,011,01,002,0040,62,457,6,463,619,0,0,0,0,0,0,0,66.31 ,74.80 ,66.31 
03,011,01,002,0041,63,477,1,478,774,0,0,0,0,0,0,0,66.31 ,61.76 ,66.31 
03,011,01,002,0042,64,523,9,532,815,0,0,0,0,0,0,0,66.31 ,65.28 ,66.31 
03,011,01,002,0042,65,479,5,484,759,0,0,0,0,0,0,0,66.31 ,63.77 ,66.31 
03,011,01,002,0043,66,327,7,334,543,0,0,0,0,0,0,0,66.31 ,61.51 ,66.31 
03,011,01,002,0044,67,204,3,207,292,0,0,0,0,0,0,0,66.31 ,70.89 ,66.31 
03,011,01,002,0045,68,439,5,444,695,0,0,0,0,0,0,0,66.31 ,63.88 ,66.31 
03,011,01,002,0046,69,290,6,296,480,0,0,0,0,0,0,0,66.31 ,61.67 ,66.31 
03,011,01,002,0047,70,588,10,598,855,0,0,0,0,0,0,0,66.31 ,69.94 ,66.31 
03,011,01,002,0048,71,275,6,281,424,0,0,0,0,0,0,0,66.31 ,66.27 ,66.31 
03,011,01,002,0049,72,181,2,183,290,0,0,0,0,0,0,0,66.31 ,63.10 ,66.31 
03,011,01,002,0050,73,287,3,290,382,0,0,0,0,0,0,0,66.31 ,75.92 ,66.31 
03,011,01,002,0051,74,299,2,301,437,0,0,0,0,0,0,0,66.31 ,68.88 ,66.31 
03,011,01,002,0052,75,396,7,403,628,0,0,0,0,0,0,0,66.31 ,64.17 ,66.31 
03,011,01,002,0053,76,676,10,686,944,0,0,0,0,0,0,0,66.31 ,72.67 ,66.31 
03,011,01,003,0054,77,710,7,717,1283,0,0,0,0,0,0,0,66.31 ,55.88 ,66.31 
03,011,01,003,0054,78,373,4,377,599,0,0,0,0,0,0,0,66.31 ,62.94 ,66.31 
03,011,01,003,0055,79,846,12,858,1521,0,0,0,0,0,0,0,66.31 ,56.41 ,66.31 
03,011,01,003,0055,80,642,6,648,1144,0,0,0,0,0,0,0,66.31 ,56.64 ,66.31 
03,011,01,003,0056,81,887,15,902,1426,0,0,0,0,0,0,0,66.31 ,63.25 ,66.31 
03,011,01,003,0057,82,904,9,913,1460,0,0,0,0,0,0,0,66.31 ,62.53 ,66.31 
03,011,01,003,0058,83,516,6,522,850,0,0,0,0,0,0,0,66.31 ,61.41 ,66.31 
03,011,01,003,0059,84,790,15,805,1347,0,0,0,0,0,0,0,66.31 ,59.76 ,66.31 
03,011,01,003,0060,85,270,3,273,478,0,0,0,0,0,0,0,66.31 ,57.11 ,66.31 
03,011,01,003,0061,86,385,2,387,636,0,0,0,0,0,0,0,66.31 ,60.85 ,66.31 
03,011,01,003,0062,87,336,5,341,504,0,0,0,0,0,0,0,66.31 ,67.66 ,66.31 
03,011,01,003,0063,88,352,4,356,667,0,0,0,0,0,0,0,66.31 ,53.37 ,66.31 
03,011,01,003,0064,89,718,8,726,1284,0,0,0,0,0,0,0,66.31 ,56.54 ,66.31 
03,011,01,003,0065,90,462,9,471,798,0,0,0,0,0,0,0,66.31 ,59.02 ,66.31 
03,011,01,003,0065,91,317,6,323,592,0,0,0,0,0,0,0,66.31 ,54.56 ,66.31 
03,011,01,003,0065,92,643,9,652,918,0,0,0,0,0,0,0,66.31 ,71.02 ,66.31 
03,011,01,003,0066,93,796,9,805,1193,0,0,0,0,0,0,0,66.31 ,67.48 ,66.31 
03,011,01,003,0067,94,879,6,885,1345,0,0,0,0,0,0,0,66.31 ,65.80 ,66.31 
03,011,01,003,0068,95,578,11,589,889,0,0,0,0,0,0,0,66.31 ,66.25 ,66.31 
03,011,01,003,0069,96,419,6,425,693,0,0,0,0,0,0,0,66.31 ,61.33 ,66.31 
03,011,01,003,0070,97,622,8,630,922,0,0,0,0,0,0,0,66.31 ,68.33 ,66.31 
03,011,01,003,0071,98,607,6,613,958,0,0,0,0,0,0,0,66.31 ,63.99 ,66.31 
03,011,01,003,0072,99,515,2,517,822,0,0,0,0,0,0,0,66.31 ,62.90 ,66.31 
03,011,01,003,0073,100,816,8,824,1282,0,0,0,0,0,0,0,66.31 ,64.27 ,66.31 
03,011,01,003,0074,101,465,6,471,771,0,0,0,0,0,0,0,66.31 ,61.09 ,66.31 
03,011,01,003,0075,102,515,7,522,792,0,0,0,0,0,0,0,66.31 ,65.91 ,66.31 
03,011,01,003,0076,103,585,7,592,932,0,0,0,0,0,0,0,66.31 ,63.52 ,66.31 
03,011,01,003,0077,104,425,5,430,719,0,0,0,0,0,0,0,66.31 ,59.81 ,66.31 
03,011,01,004,0078,105,940,11,951,1424,0,0,0,0,0,0,0,66.31 ,66.78 ,66.31 
03,011,01,004,0079,106,557,8,565,823,0,0,0,0,0,0,0,66.31 ,68.65 ,66.31 
03,011,01,004,0079,107,614,11,625,930,0,0,0,0,0,0,0,66.31 ,67.20 ,66.31 
03,011,01,004,0080,108,500,5,505,704,0,0,0,0,0,0,0,66.31 ,71.73 ,66.31 
03,011,01,004,0081,109,823,13,836,1195,0,0,0,0,0,0,0,66.31 ,69.96 ,66.31 
03,011,01,004,0081,110,780,12,792,1200,0,0,0,0,0,0,0,66.31 ,66.00 ,66.31 
03,011,01,004,0082,111,851,11,862,1203,0,0,0,0,0,0,0,66.31 ,71.65 ,66.31 
03,011,01,004,0083,112,310,2,312,457,0,0,0,0,0,0,0,66.31 ,68.27 ,66.31 
03,011,01,004,0083,113,201,3,204,297,0,0,0,0,0,0,0,66.31 ,68.69 ,66.31 
03,011,01,004,0084,114,550,7,557,769,0,0,0,0,0,0,0,66.31 ,72.43 ,66.31 
03,011,01,004,0084,115,525,6,531,746,0,0,0,0,0,0,0,66.31 ,71.18 ,66.31 
03,011,01,004,0085,116,996,12,1008,1461,0,0,0,0,0,0,0,66.31 ,68.99 ,66.31 
03,011,01,004,0085,117,208,2,210,307,0,0,0,0,0,0,0,66.31 ,68.40 ,66.31 
03,011,01,004,0086,118,911,19,930,1395,0,0,0,0,0,0,0,66.31 ,66.67 ,66.31 
03,011,01,004,0087,119,468,11,479,650,0,0,0,0,0,0,0,66.31 ,73.69 ,66.31 
03,011,01,004,0088,120,733,11,744,1165,0,0,0,0,0,0,0,66.31 ,63.86 ,66.31 
03,011,01,004,0088,121,159,2,161,224,0,0,0,0,0,0,0,66.31 ,71.88 ,66.31 
03,011,01,004,0089,122,727,9,736,1093,0,0,0,0,0,0,0,66.31 ,67.34 ,66.31 
03,011,01,004,0089,123,121,0,121,154,0,0,0,0,0,0,0,66.31 ,78.57 ,66.31 
03,011,01,004,0090,124,598,6,604,995,0,0,0,0,0,0,0,66.31 ,60.70 ,66.31 
03,011,01,004,0090,125,344,4,348,481,0,0,0,0,0,0,0,66.31 ,72.35 ,66.31 
03,011,01,004,0090,126,140,2,142,197,0,0,0,0,0,0,0,66.31 ,72.08 ,66.31 
03,011,01,005,0091,127,456,4,460,698,0,0,0,0,0,0,0,66.31 ,65.90 ,66.31 
03,011,01,005,0091,128,503,6,509,764,0,0,0,0,0,0,0,66.31 ,66.62 ,66.31 
03,011,01,005,0092,129,469,2,471,731,0,0,0,0,0,0,0,66.31 ,64.43 ,66.31 
03,011,01,005,0092,130,347,2,349,521,0,0,0,0,0,0,0,66.31 ,66.99 ,66.31 
03,011,01,005,0093,131,656,15,671,1058,0,0,0,0,0,0,0,66.31 ,63.42 ,66.31 
03,011,01,005,0093,132,164,1,165,251,0,0,0,0,0,0,0,66.31 ,65.74 ,66.31 
03,011,01,005,0094,133,401,4,405,605,0,0,0,0,0,0,0,66.31 ,66.94 ,66.31 
03,011,01,005,0094,134,479,6,485,706,0,0,0,0,0,0,0,66.31 ,68.70 ,66.31 
03,011,01,005,0095,135,739,12,751,1186,0,0,0,0,0,0,0,66.31 ,63.32 ,66.31 
03,011,01,005,0096,136,756,8,764,1239,0,0,0,0,0,0,0,66.31 ,61.66 ,66.31 
03,011,01,005,0097,137,523,7,530,817,0,0,0,0,0,0,0,66.31 ,64.87 ,66.31 
03,011,01,005,0098,138,356,8,364,527,0,0,0,0,0,0,0,66.31 ,69.07 ,66.31 
03,011,01,005,0099,139,324,10,334,604,0,0,0,0,0,0,0,66.31 ,55.30 ,66.31 
03,011,01,005,0100,140,540,8,548,839,0,0,0,0,0,0,0,66.31 ,65.32 ,66.31 
03,011,01,005,0101,141,337,2,339,468,0,0,0,0,0,0,0,66.31 ,72.44 ,66.31 
03,011,01,005,0102,142,403,3,406,591,0,0,0,0,0,0,0,66.31 ,68.70 ,66.31 
03,011,01,005,0102,143,347,2,349,548,0,0,0,0,0,0,0,66.31 ,63.69 ,66.31 
03,011,01,005,0103,144,376,4,380,546,0,0,0,0,0,0,0,66.31 ,69.60 ,66.31 
03,011,01,005,0104,145,696,7,703,1066,0,0,0,0,0,0,0,66.31 ,65.95 ,66.31 
03,011,01,005,0105,146,383,3,386,584,0,0,0,0,0,0,0,66.31 ,66.10 ,66.31 
03,011,01,005,0106,147,717,9,726,1027,0,0,0,0,0,0,0,66.31 ,70.69 ,66.31 
03,011,01,005,0106,148,285,2,287,430,0,0,0,0,0,0,0,66.31 ,66.74 ,66.31 
03,011,01,005,0107,149,494,4,498,715,0,0,0,0,0,0,0,66.31 ,69.65 ,66.31 
03,011,01,005,0107,150,476,4,480,792,0,0,0,0,0,0,0,66.31 ,60.61 ,66.31 
03,011,01,005,0108,151,744,10,754,1146,0,0,0,0,0,0,0,66.31 ,65.79 ,66.31 
03,011,01,005,0109,152,508,4,512,704,0,0,0,0,0,0,0,66.31 ,72.73 ,66.31 
03,011,01,005,0109,153,450,7,457,661,0,0,0,0,0,0,0,66.31 ,69.14 ,66.31 
03,011,01,005,0110,154,760,1,761,1150,0,0,0,0,0,0,0,66.31 ,66.17 ,66.31 
03,011,01,005,0111,155,423,11,434,698,0,0,0,0,0,0,0,66.31 ,62.18 ,66.31 
03,011,01,005,0112,156,127,1,128,187,0,0,0,0,0,0,0,66.31 ,68.45 ,66.31 
03,011,01,006,0113,157,821,5,826,1423,0,0,0,0,0,0,0,66.31 ,58.05 ,66.31 
03,011,01,006,0114,158,697,13,710,1172,0,0,0,0,0,0,0,66.31 ,60.58 ,66.31 
03,011,01,006,0114,159,690,2,692,1114,0,0,0,0,0,0,0,66.31 ,62.12 ,66.31 
03,011,01,006,0115,160,910,11,921,1549,0,0,0,0,0,0,0,66.31 ,59.46 ,66.31 
03,011,01,006,0116,161,567,5,572,970,0,0,0,0,0,0,0,66.31 ,58.97 ,66.31 
03,011,01,006,0117,162,691,10,701,1206,0,0,0,0,0,0,0,66.31 ,58.13 ,66.31 
03,011,01,006,0118,163,501,11,512,783,0,0,0,0,0,0,0,66.31 ,65.39 ,66.31 
03,011,01,006,0118,164,460,4,464,633,0,0,0,0,0,0,0,66.31 ,73.30 ,66.31 
03,011,01,006,0119,165,538,5,543,933,0,0,0,0,0,0,0,66.31 ,58.20 ,66.31 
03,011,01,006,0120,166,539,6,545,821,0,0,0,0,0,0,0,66.31 ,66.38 ,66.31 
03,011,01,006,0120,167,677,4,681,1057,0,0,0,0,0,0,0,66.31 ,64.43 ,66.31 
03,011,01,006,0121,168,384,5,389,561,0,0,0,0,0,0,0,66.31 ,69.34 ,66.31 
03,011,01,006,0122,169,319,1,320,513,0,0,0,0,0,0,0,66.31 ,62.38 ,66.31 
03,011,01,006,0123,170,265,1,266,400,0,0,0,0,0,0,0,66.31 ,66.50 ,66.31 
03,011,01,006,0124,171,639,5,644,997,0,0,0,0,0,0,0,66.31 ,64.59 ,66.31 
03,011,01,006,0124,172,772,11,783,1273,0,0,0,0,0,0,0,66.31 ,61.51 ,66.31 
03,011,01,006,0125,173,414,8,422,777,0,0,0,0,0,0,0,66.31 ,54.31 ,66.31 
03,011,01,006,0126,174,706,9,715,1137,0,0,0,0,0,0,0,66.31 ,62.88 ,66.31 
03,011,01,006,0127,175,673,4,677,1133,0,0,0,0,0,0,0,66.31 ,59.75 ,66.31 
03,011,01,006,0128,176,547,5,552,974,0,0,0,0,0,0,0,66.31 ,56.67 ,66.31 
03,011,01,007,0129,177,461,4,465,641,0,0,0,0,0,0,0,66.31 ,72.54 ,66.31 
03,011,01,007,0130,178,435,5,440,617,0,0,0,0,0,0,0,66.31 ,71.31 ,66.31 
03,011,01,007,0131,179,694,8,702,1047,0,0,0,0,0,0,0,66.31 ,67.05 ,66.31 
03,011,01,007,0131,180,558,4,562,841,0,0,0,0,0,0,0,66.31 ,66.83 ,66.31 
03,011,01,007,0132,181,760,8,768,1094,0,0,0,0,0,0,0,66.31 ,70.20 ,66.31 
03,011,01,007,0132,182,743,6,749,1160,0,0,0,0,0,0,0,66.31 ,64.57 ,66.31 
03,011,01,007,0133,183,914,11,925,1355,0,0,0,0,0,0,0,66.31 ,68.27 ,66.31 
03,011,01,007,0134,184,617,4,621,898,0,0,0,0,0,0,0,66.31 ,69.15 ,66.31 
03,011,01,007,0134,185,593,3,596,866,0,0,0,0,0,0,0,66.31 ,68.82 ,66.31 
03,011,01,007,0135,186,834,12,846,1251,0,0,0,0,0,0,0,66.31 ,67.63 ,66.31 
03,011,01,007,0136,187,726,5,731,964,0,0,0,0,0,0,0,66.31 ,75.83 ,66.31 
03,011,01,007,0137,188,896,9,905,1343,0,0,0,0,0,0,0,66.31 ,67.39 ,66.31 
03,011,01,007,0137,189,951,9,960,1414,0,0,0,0,0,0,0,66.31 ,67.89 ,66.31 
03,011,01,007,0138,190,809,3,812,1128,0,0,0,0,0,0,0,66.31 ,71.99 ,66.31 
03,011,01,007,0139,191,821,5,826,1276,0,0,0,0,0,0,0,66.31 ,64.73 ,66.31 
03,011,01,007,0139,192,750,17,767,1103,0,0,0,0,0,0,0,66.31 ,69.54 ,66.31 
03,011,01,007,0140,193,479,9,488,632,0,0,0,0,0,0,0,66.31 ,77.22 ,66.31 
03,011,01,007,0141,194,537,9,546,729,0,0,0,0,0,0,0,66.31 ,74.90 ,66.31 
03,011,01,007,0142,195,466,8,474,673,0,0,0,0,0,0,0,66.31 ,70.43 ,66.31 
03,011,01,007,0142,196,1065,15,1080,1515,0,0,0,0,0,0,0,66.31 ,71.29 ,66.31 
03,011,01,007,0143,197,991,15,1006,1392,0,0,0,0,0,0,0,66.31 ,72.27 ,66.31 
03,011,01,007,0144,198,602,3,605,837,0,0,0,0,0,0,0,66.31 ,72.28 ,66.31 
03,011,01,007,0145,199,929,11,940,1263,0,0,0,0,0,0,0,66.31 ,74.43 ,66.31 
03,011,01,007,0146,200,408,3,411,517,0,0,0,0,0,0,0,66.31 ,79.50 ,66.31 
03,011,01,007,0147,201,698,7,705,984,0,0,0,0,0,0,0,66.31 ,71.65 ,66.31 
03,011,01,007,0148,202,429,4,433,540,0,0,0,0,0,0,0,66.31 ,80.19 ,66.31 
03,011,01,007,0149,203,763,10,773,1138,0,0,0,0,0,0,0,66.31 ,67.93 ,66.31 
03,011,01,007,0150,204,763,7,770,1016,0,0,0,0,0,0,0,66.31 ,75.79 ,66.31 
03,011,01,007,0151,205,408,4,412,584,0,0,0,0,0,0,0,66.31 ,70.55 ,66.31 
03,011,01,007,0152,206,461,6,467,645,0,0,0,0,0,0,0,66.31 ,72.40 ,66.31 
03,011,01,007,0153,207,513,6,519,687,0,0,0,0,0,0,0,66.31 ,75.55 ,66.31 
03,011,01,007,0154,208,654,11,665,868,0,0,0,0,0,0,0,66.31 ,76.61 ,66.31 
03,011,01,007,0155,209,594,3,597,805,0,0,0,0,0,0,0,66.31 ,74.16 ,66.31 
03,011,01,007,0156,210,604,4,608,809,0,0,0,0,0,0,0,66.31 ,75.15 ,66.31 
03,011,01,007,0157,211,830,6,836,1122,0,0,0,0,0,0,0,66.31 ,74.51 ,66.31 
03,011,01,008,0158,212,672,8,680,1012,0,0,0,0,0,0,0,66.31 ,67.19 ,66.31 
03,011,01,008,0159,213,841,9,850,1258,0,0,0,0,0,0,0,66.31 ,67.57 ,66.31 
03,011,01,008,0159,214,822,7,829,1227,0,0,0,0,0,0,0,66.31 ,67.56 ,66.31 
03,011,01,008,0160,215,814,4,818,1150,0,0,0,0,0,0,0,66.31 ,71.13 ,66.31 
03,011,01,008,0161,216,1058,10,1068,1498,0,0,0,0,0,0,0,66.31 ,71.30 ,66.31 
03,011,01,008,0162,217,711,8,719,1016,0,0,0,0,0,0,0,66.31 ,70.77 ,66.31 
03,011,01,008,0162,218,662,4,666,1017,0,0,0,0,0,0,0,66.31 ,65.49 ,66.31 
03,011,01,008,0163,219,694,7,701,1040,0,0,0,0,0,0,0,66.31 ,67.40 ,66.31 
03,011,01,008,0163,220,702,6,708,1016,0,0,0,0,0,0,0,66.31 ,69.69 ,66.31 
03,011,01,008,0164,221,585,6,591,783,0,0,0,0,0,0,0,66.31 ,75.48 ,66.31 
03,011,01,008,0165,222,579,2,581,799,0,0,0,0,0,0,0,66.31 ,72.72 ,66.31 
03,011,01,008,0166,223,788,12,800,1164,0,0,0,0,0,0,0,66.31 ,68.73 ,66.31 
03,011,01,008,0167,224,743,5,748,1057,0,0,0,0,0,0,0,66.31 ,70.77 ,66.31 
03,011,01,008,0168,225,663,6,669,947,0,0,0,0,0,0,0,66.31 ,70.64 ,66.31 
03,011,01,008,0168,226,530,5,535,822,0,0,0,0,0,0,0,66.31 ,65.09 ,66.31 
03,011,01,008,0169,227,666,7,673,893,0,0,0,0,0,0,0,66.31 ,75.36 ,66.31 
03,011,01,008,0170,228,946,14,960,1293,0,0,0,0,0,0,0,66.31 ,74.25 ,66.31 
03,011,01,008,0171,229,805,8,813,1187,0,0,0,0,0,0,0,66.31 ,68.49 ,66.31 
03,011,01,008,0172,230,902,10,912,1213,0,0,0,0,0,0,0,66.31 ,75.19 ,66.31 
03,011,01,009,0173,231,916,14,930,1388,0,0,0,0,0,0,0,66.31 ,67.00 ,66.31 
03,011,01,009,0173,232,831,11,842,1259,0,0,0,0,0,0,0,66.31 ,66.88 ,66.31 
03,011,01,009,0174,233,826,10,836,1284,0,0,0,0,0,0,0,66.31 ,65.11 ,66.31 
03,011,01,009,0174,234,740,11,751,1181,0,0,0,0,0,0,0,66.31 ,63.59 ,66.31 
03,011,01,009,0175,235,849,3,852,1291,0,0,0,0,0,0,0,66.31 ,66.00 ,66.31 
03,011,01,009,0176,236,706,6,712,1051,0,0,0,0,0,0,0,66.31 ,67.75 ,66.31 
03,011,01,009,0177,237,549,10,559,829,0,0,0,0,0,0,0,66.31 ,67.43 ,66.31 
03,011,01,009,0178,238,812,10,822,1280,0,0,0,0,0,0,0,66.31 ,64.22 ,66.31 
03,011,01,009,0178,239,926,12,938,1434,0,0,0,0,0,0,0,66.31 ,65.41 ,66.31 
03,011,01,009,0179,240,627,9,636,922,0,0,0,0,0,0,0,66.31 ,68.98 ,66.31 
03,011,01,009,0179,241,564,9,573,833,0,0,0,0,0,0,0,66.31 ,68.79 ,66.31 
03,011,01,009,0180,242,530,3,533,747,0,0,0,0,0,0,0,66.31 ,71.35 ,66.31 
03,011,01,009,0180,243,496,8,504,791,0,0,0,0,0,0,0,66.31 ,63.72 ,66.31 
03,011,01,009,0181,244,708,4,712,1047,0,0,0,0,0,0,0,66.31 ,68.00 ,66.31 
03,011,01,009,0182,245,409,1,410,575,0,0,0,0,0,0,0,66.31 ,71.30 ,66.31 
03,011,01,009,0183,246,564,5,569,898,0,0,0,0,0,0,0,66.31 ,63.36 ,66.31 
03,011,01,009,0184,247,477,3,480,764,0,0,0,0,0,0,0,66.31 ,62.83 ,66.31 
03,011,01,010,0185,248,671,6,677,982,0,0,0,0,0,0,0,66.31 ,68.94 ,66.31 
03,011,01,010,0185,249,647,7,654,941,0,0,0,0,0,0,0,66.31 ,69.50 ,66.31 
03,011,01,010,0186,250,834,10,844,1135,0,0,0,0,0,0,0,66.31 ,74.36 ,66.31 
03,011,01,010,0186,251,699,8,707,1043,0,0,0,0,0,0,0,66.31 ,67.79 ,66.31 
03,011,01,010,0187,252,759,11,770,1045,0,0,0,0,0,0,0,66.31 ,73.68 ,66.31 
03,011,01,010,0188,253,492,3,495,635,0,0,0,0,0,0,0,66.31 ,77.95 ,66.31 
03,011,01,010,0189,254,329,1,330,496,0,0,0,0,0,0,0,66.31 ,66.53 ,66.31 
03,011,01,010,0190,255,629,6,635,907,0,0,0,0,0,0,0,66.31 ,70.01 ,66.31 
03,011,01,010,0190,256,618,9,627,896,0,0,0,0,0,0,0,66.31 ,69.98 ,66.31 
03,011,01,010,0191,257,518,6,524,783,0,0,0,0,0,0,0,66.31 ,66.92 ,66.31 
03,011,01,010,0191,258,698,8,706,994,0,0,0,0,0,0,0,66.31 ,71.03 ,66.31 
03,011,01,010,0191,259,676,6,682,933,0,0,0,0,0,0,0,66.31 ,73.10 ,66.31 
03,011,01,010,0192,260,648,12,660,1021,0,0,0,0,0,0,0,66.31 ,64.64 ,66.31 
03,011,01,010,0193,261,942,6,948,1380,0,0,0,0,0,0,0,66.31 ,68.70 ,66.31 
03,011,01,010,0194,262,455,5,460,696,0,0,0,0,0,0,0,66.31 ,66.09 ,66.31 
03,011,01,010,0195,263,476,3,479,607,0,0,0,0,0,0,0,66.31 ,78.91 ,66.31 
03,011,01,010,0196,264,601,6,607,820,0,0,0,0,0,0,0,66.31 ,74.02 ,66.31 
03,011,01,010,0196,265,642,7,649,843,0,0,0,0,0,0,0,66.31 ,76.99 ,66.31 
03,011,01,010,0196,266,364,8,372,572,0,0,0,0,0,0,0,66.31 ,65.03 ,66.31 
03,011,01,010,0197,267,615,6,621,916,0,0,0,0,0,0,0,66.31 ,67.79 ,66.31 
03,011,01,011,0198,268,721,7,728,1145,0,0,0,0,0,0,0,66.31 ,63.58 ,66.31 
03,011,01,011,0199,269,509,8,517,781,0,0,0,0,0,0,0,66.31 ,66.20 ,66.31 
03,011,01,011,0200,270,933,9,942,1464,0,0,0,0,0,0,0,66.31 ,64.34 ,66.31 
03,011,01,011,0201,271,716,7,723,1111,0,0,0,0,0,0,0,66.31 ,65.08 ,66.31 
03,011,01,011,0202,272,576,4,580,838,0,0,0,0,0,0,0,66.31 ,69.21 ,66.31 
03,011,01,011,0203,273,452,13,465,698,0,0,0,0,0,0,0,66.31 ,66.62 ,66.31 
03,011,01,011,0204,274,614,14,628,1062,0,0,0,0,0,0,0,66.31 ,59.13 ,66.31 
03,011,01,011,0205,275,616,5,621,934,0,0,0,0,0,0,0,66.31 ,66.49 ,66.31 
03,011,01,011,0206,276,585,4,589,959,0,0,0,0,0,0,0,66.31 ,61.42 ,66.31 
03,011,01,011,0207,277,430,6,436,646,0,0,0,0,0,0,0,66.31 ,67.49 ,66.31 
03,011,01,012,0208,278,588,4,592,882,0,0,0,0,0,0,0,66.31 ,67.12 ,66.31 
03,011,01,012,0208,279,575,7,582,841,0,0,0,0,0,0,0,66.31 ,69.20 ,66.31 
03,011,01,012,0209,280,756,7,763,1142,0,0,0,0,0,0,0,66.31 ,66.81 ,66.31 
03,011,01,012,0209,281,904,13,917,1352,0,0,0,0,0,0,0,66.31 ,67.83 ,66.31 
03,011,01,012,0210,282,719,2,721,1002,0,0,0,0,0,0,0,66.31 ,71.96 ,66.31 
03,011,01,012,0210,283,694,4,698,1036,0,0,0,0,0,0,0,66.31 ,67.37 ,66.31 
03,011,01,012,0210,284,693,8,701,987,0,0,0,0,0,0,0,66.31 ,71.02 ,66.31 
03,011,01,012,0210,285,781,6,787,1146,0,0,0,0,0,0,0,66.31 ,68.67 ,66.31 
03,011,01,012,0211,286,808,10,818,1250,0,0,0,0,0,0,0,66.31 ,65.44 ,66.31 
03,011,01,012,0211,287,835,7,842,1284,0,0,0,0,0,0,0,66.31 ,65.58 ,66.31 
03,011,01,012,0211,288,713,5,718,1119,0,0,0,0,0,0,0,66.31 ,64.16 ,66.31 
03,011,01,012,0211,289,1007,11,1018,1572,0,0,0,0,0,0,0,66.31 ,64.76 ,66.31 
03,011,01,012,0212,290,715,4,719,1218,0,0,0,0,0,0,0,66.31 ,59.03 ,66.31 
03,011,01,012,0212,291,708,5,713,1138,0,0,0,0,0,0,0,66.31 ,62.65 ,66.31 
03,011,01,012,0212,292,757,10,767,1218,0,0,0,0,0,0,0,66.31 ,62.97 ,66.31 
03,011,01,012,0212,293,828,7,835,1307,0,0,0,0,0,0,0,66.31 ,63.89 ,66.31 
03,011,01,012,0212,294,756,5,761,1098,0,0,0,0,0,0,0,66.31 ,69.31 ,66.31 
03,011,01,012,0212,295,826,2,828,1324,0,0,0,0,0,0,0,66.31 ,62.54 ,66.31 
03,011,01,012,0213,296,655,5,660,948,0,0,0,0,0,0,0,66.31 ,69.62 ,66.31 
03,011,01,012,0213,297,645,6,651,977,0,0,0,0,0,0,0,66.31 ,66.63 ,66.31 
03,011,01,012,0213,298,626,4,630,1019,0,0,0,0,0,0,0,66.31 ,61.83 ,66.31 
03,011,01,012,0214,299,627,4,631,866,0,0,0,0,0,0,0,66.31 ,72.86 ,66.31 
03,011,01,012,0214,300,631,8,639,883,0,0,0,0,0,0,0,66.31 ,72.37 ,66.31 
03,011,01,012,0215,301,603,7,610,837,0,0,0,0,0,0,0,66.31 ,72.88 ,66.31 
03,011,01,012,0216,302,928,7,935,1355,0,0,0,0,0,0,0,66.31 ,69.00 ,66.31 
03,011,01,012,0217,303,473,3,476,656,0,0,0,0,0,0,0,66.31 ,72.56 ,66.31 
03,011,01,012,0218,304,279,1,280,370,0,0,0,0,0,0,0,66.31 ,75.68 ,66.31 
03,011,01,012,0219,305,783,9,792,1218,0,0,0,0,0,0,0,66.31 ,65.02 ,66.31 
03,011,01,012,0220,306,417,4,421,596,0,0,0,0,0,0,0,66.31 ,70.64 ,66.31 
03,011,01,012,0221,307,516,6,522,758,0,0,0,0,0,0,0,66.31 ,68.87 ,66.31 
03,011,01,012,0222,308,664,6,670,939,0,0,0,0,0,0,0,66.31 ,71.35 ,66.31 
03,011,01,012,0223,309,733,13,746,1108,0,0,0,0,0,0,0,66.31 ,67.33 ,66.31 
03,011,01,012,0224,310,596,3,599,827,0,0,0,0,0,0,0,66.31 ,72.43 ,66.31 
03,011,01,012,0225,311,741,5,746,979,0,0,0,0,0,0,0,66.31 ,76.20 ,66.31 
03,011,01,012,0226,312,845,14,859,1232,0,0,0,0,0,0,0,66.31 ,69.72 ,66.31 
03,011,01,012,0227,313,544,8,552,778,0,0,0,0,0,0,0,66.31 ,70.95 ,66.31 
03,011,01,012,0227,314,492,3,495,719,0,0,0,0,0,0,0,66.31 ,68.85 ,66.31 
03,011,01,012,0228,315,566,5,571,816,0,0,0,0,0,0,0,66.31 ,69.98 ,66.31 
03,011,01,013,0229,316,465,5,470,678,0,0,0,0,0,0,0,66.31 ,69.32 ,66.31 
03,011,01,013,0229,317,311,0,311,446,0,0,0,0,0,0,0,66.31 ,69.73 ,66.31 
03,011,01,013,0230,318,849,6,855,1225,0,0,0,0,0,0,0,66.31 ,69.80 ,66.31 
03,011,01,013,0231,319,348,2,350,515,0,0,0,0,0,0,0,66.31 ,67.96 ,66.31 
03,011,01,013,0232,320,624,2,626,859,0,0,0,0,0,0,0,66.31 ,72.88 ,66.31 
03,011,01,013,0233,321,412,0,412,585,0,0,0,0,0,0,0,66.31 ,70.43 ,66.31 
03,011,01,013,0234,322,788,8,796,1122,0,0,0,0,0,0,0,66.31 ,70.94 ,66.31 
03,011,01,013,0234,323,661,4,665,938,0,0,0,0,0,0,0,66.31 ,70.90 ,66.31 
03,011,01,013,0234,324,885,5,890,1255,0,0,0,0,0,0,0,66.31 ,70.92 ,66.31 
03,011,01,013,0235,325,955,5,960,1405,0,0,0,0,0,0,0,66.31 ,68.33 ,66.31 
03,011,01,013,0236,326,535,3,538,730,0,0,0,0,0,0,0,66.31 ,73.70 ,66.31 
03,011,01,013,0236,327,359,3,362,534,0,0,0,0,0,0,0,66.31 ,67.79 ,66.31 
03,011,01,013,0237,328,403,3,406,599,0,0,0,0,0,0,0,66.31 ,67.78 ,66.31 
03,011,01,013,0237,329,504,5,509,721,0,0,0,0,0,0,0,66.31 ,70.60 ,66.31 
03,011,01,013,0238,330,358,3,361,551,0,0,0,0,0,0,0,66.31 ,65.52 ,66.31 
03,011,01,013,0239,331,377,2,379,543,0,0,0,0,0,0,0,66.31 ,69.80 ,66.31 
03,011,01,013,0240,332,534,6,540,815,0,0,0,0,0,0,0,66.31 ,66.26 ,66.31 
03,011,01,013,0241,333,257,1,258,353,0,0,0,0,0,0,0,66.31 ,73.09 ,66.31 
03,011,01,013,0242,334,472,4,476,684,0,0,0,0,0,0,0,66.31 ,69.59 ,66.31 
03,011,01,013,0243,335,222,0,222,335,0,0,0,0,0,0,0,66.31 ,66.27 ,66.31 
03,011,01,013,0244,336,292,5,297,435,0,0,0,0,0,0,0,66.31 ,68.28 ,66.31 
03,011,01,013,0245,337,330,4,334,524,0,0,0,0,0,0,0,66.31 ,63.74 ,66.31 
03,011,01,013,0246,338,228,1,229,341,0,0,0,0,0,0,0,66.31 ,67.16 ,66.31 
03,011,01,013,0247,339,388,5,393,547,0,0,0,0,0,0,0,66.31 ,71.85 ,66.31 
03,011,01,013,0247,340,212,0,212,287,0,0,0,0,0,0,0,66.31 ,73.87 ,66.31 
03,011,01,013,0248,341,301,1,302,492,0,0,0,0,0,0,0,66.31 ,61.38 ,66.31 
03,011,01,013,0249,342,727,9,736,1142,0,0,0,0,0,0,0,66.31 ,64.45 ,66.31 
03,011,01,013,0250,343,353,2,355,516,0,0,0,0,0,0,0,66.31 ,68.80 ,66.31 
03,011,01,013,0251,344,451,5,456,722,0,0,0,0,0,0,0,66.31 ,63.16 ,66.31 
03,011,01,013,0252,345,518,3,521,692,0,0,0,0,0,0,0,66.31 ,75.29 ,66.31 
03,011,01,013,0253,346,325,2,327,518,0,0,0,0,0,0,0,66.31 ,63.13 ,66.31 
03,011,01,013,0254,347,340,1,341,479,0,0,0,0,0,0,0,66.31 ,71.19 ,66.31 
03,011,01,014,0255,348,521,12,533,764,0,0,0,0,0,0,0,66.31 ,69.76 ,66.31 
03,011,01,014,0255,349,546,10,556,771,0,0,0,0,0,0,0,66.31 ,72.11 ,66.31 
03,011,01,014,0255,350,679,7,686,985,0,0,0,0,0,0,0,66.31 ,69.64 ,66.31 
03,011,01,014,0256,351,724,4,728,1047,0,0,0,0,0,0,0,66.31 ,69.53 ,66.31 
03,011,01,014,0256,352,674,6,680,929,0,0,0,0,0,0,0,66.31 ,73.20 ,66.31 
03,011,01,014,0256,353,771,6,777,1115,0,0,0,0,0,0,0,66.31 ,69.69 ,66.31 
03,011,01,014,0257,354,839,17,856,1240,0,0,0,0,0,0,0,66.31 ,69.03 ,66.31 
03,011,01,014,0257,355,468,6,474,613,0,0,0,0,0,0,0,66.31 ,77.32 ,66.31 
03,011,01,014,0258,356,640,8,648,858,0,0,0,0,0,0,0,66.31 ,75.52 ,66.31 
03,011,01,014,0258,357,276,0,276,390,0,0,0,0,0,0,0,66.31 ,70.77 ,66.31 
03,011,01,014,0259,358,518,7,525,740,0,0,0,0,0,0,0,66.31 ,70.95 ,66.31 
03,011,01,014,0259,359,539,10,549,788,0,0,0,0,0,0,0,66.31 ,69.67 ,66.31 
03,011,01,014,0260,360,935,10,945,1282,0,0,0,0,0,0,0,66.31 ,73.71 ,66.31 
03,011,01,014,0261,361,860,6,866,1276,0,0,0,0,0,0,0,66.31 ,67.87 ,66.31 
03,011,01,014,0262,362,598,8,606,836,0,0,0,0,0,0,0,66.31 ,72.49 ,66.31 
03,011,01,014,0263,363,798,8,806,1131,0,0,0,0,0,0,0,66.31 ,71.26 ,66.31 
03,011,01,014,0264,364,839,9,848,1160,0,0,0,0,0,0,0,66.31 ,73.10 ,66.31 
03,011,01,014,0265,365,626,2,628,845,0,0,0,0,0,0,0,66.31 ,74.32 ,66.31 
03,011,01,014,0266,366,313,11,324,412,0,0,0,0,0,0,0,66.31 ,78.64 ,66.31 
03,011,01,014,0266,367,520,3,523,738,0,0,0,0,0,0,0,66.31 ,70.87 ,66.31 
03,011,01,015,0267,368,390,5,395,539,0,0,0,0,0,0,0,66.31 ,73.28 ,66.31 
03,011,01,015,0268,369,489,5,494,749,0,0,0,0,0,0,0,66.31 ,65.95 ,66.31 
03,011,01,015,0269,370,392,5,397,496,0,0,0,0,0,0,0,66.31 ,80.04 ,66.31 
03,011,01,015,0270,371,577,6,583,822,0,0,0,0,0,0,0,66.31 ,70.92 ,66.31 
03,011,01,015,0271,372,700,5,705,951,0,0,0,0,0,0,0,66.31 ,74.13 ,66.31 
03,011,01,015,0272,373,418,2,420,580,0,0,0,0,0,0,0,66.31 ,72.41 ,66.31 
03,011,01,015,0273,374,323,4,327,461,0,0,0,0,0,0,0,66.31 ,70.93 ,66.31 
03,011,01,015,0274,375,529,3,532,776,0,0,0,0,0,0,0,66.31 ,68.56 ,66.31 
03,011,01,015,0275,376,555,7,562,810,0,0,0,0,0,0,0,66.31 ,69.38 ,66.31 
03,011,01,015,0275,377,598,4,602,836,0,0,0,0,0,0,0,66.31 ,72.01 ,66.31 
03,011,01,015,0276,378,274,0,274,347,0,0,0,0,0,0,0,66.31 ,78.96 ,66.31 
03,011,01,015,0277,379,577,9,586,884,0,0,0,0,0,0,0,66.31 ,66.29 ,66.31 
03,011,01,015,0278,380,554,2,556,780,0,0,0,0,0,0,0,66.31 ,71.28 ,66.31 
03,011,01,015,0279,381,876,11,887,1284,0,0,0,0,0,0,0,66.31 ,69.08 ,66.31 
03,011,01,015,0280,382,711,7,718,967,0,0,0,0,0,0,0,66.31 ,74.25 ,66.31 
03,011,01,015,0281,383,409,5,414,590,0,0,0,0,0,0,0,66.31 ,70.17 ,66.31 
03,011,01,015,0282,384,715,7,722,1005,0,0,0,0,0,0,0,66.31 ,71.84 ,66.31 
03,011,01,015,0283,385,437,0,437,571,0,0,0,0,0,0,0,66.31 ,76.53 ,66.31 
03,011,01,015,0284,386,571,2,573,741,0,0,0,0,0,0,0,66.31 ,77.33 ,66.31 
03,011,01,015,0285,387,699,3,702,943,0,0,0,0,0,0,0,66.31 ,74.44 ,66.31 
03,011,01,015,0286,388,467,7,474,640,0,0,0,0,0,0,0,66.31 ,74.06 ,66.31 
03,011,01,015,0287,389,576,2,578,809,0,0,0,0,0,0,0,66.31 ,71.45 ,66.31 
03,011,01,015,0288,390,858,9,867,1148,0,0,0,0,0,0,0,66.31 ,75.52 ,66.31 
03,011,01,015,0288,391,676,6,682,864,0,0,0,0,0,0,0,66.31 ,78.94 ,66.31 
03,011,01,015,0289,392,935,5,940,1320,0,0,0,0,0,0,0,66.31 ,71.21 ,66.31 
03,011,01,016,0290,393,620,7,627,856,0,0,0,0,0,0,0,66.31 ,73.25 ,66.31 
03,011,01,016,0291,394,891,6,897,1260,0,0,0,0,0,0,0,66.31 ,71.19 ,66.31 
03,011,01,016,0292,395,764,6,770,1091,0,0,0,0,0,0,0,66.31 ,70.58 ,66.31 
03,011,01,016,0293,396,367,0,367,501,0,0,0,0,0,0,0,66.31 ,73.25 ,66.31 
03,011,01,016,0293,397,654,2,656,938,0,0,0,0,0,0,0,66.31 ,69.94 ,66.31 
03,011,01,016,0294,398,412,4,416,562,0,0,0,0,0,0,0,66.31 ,74.02 ,66.31 
03,011,01,016,0294,399,257,0,257,341,0,0,0,0,0,0,0,66.31 ,75.37 ,66.31 
03,011,01,016,0295,400,425,0,425,594,0,0,0,0,0,0,0,66.31 ,71.55 ,66.31 
03,011,01,016,0295,401,348,1,349,455,0,0,0,0,0,0,0,66.31 ,76.70 ,66.31 
03,011,01,016,0296,402,430,3,433,659,0,0,0,0,0,0,0,66.31 ,65.71 ,66.31 
03,011,01,016,0296,403,249,1,250,385,0,0,0,0,0,0,0,66.31 ,64.94 ,66.31 
03,011,01,016,0297,404,501,3,504,806,0,0,0,0,0,0,0,66.31 ,62.53 ,66.31 
03,011,01,016,0298,405,447,7,454,662,0,0,0,0,0,0,0,66.31 ,68.58 ,66.31 
03,011,01,016,0299,406,472,3,475,748,0,0,0,0,0,0,0,66.31 ,63.50 ,66.31 
03,011,01,016,0300,407,287,0,287,431,0,0,0,0,0,0,0,66.31 ,66.59 ,66.31 
03,011,01,016,0300,408,169,0,169,215,0,0,0,0,0,0,0,66.31 ,78.60 ,66.31 
03,011,01,016,0301,409,273,0,273,437,0,0,0,0,0,0,0,66.31 ,62.47 ,66.31 
03,011,01,016,0302,410,604,1,605,915,0,0,0,0,0,0,0,66.31 ,66.12 ,66.31 
03,011,01,016,0303,411,472,4,476,754,0,0,0,0,0,0,0,66.31 ,63.13 ,66.31 
03,011,01,016,0304,412,489,3,492,748,0,0,0,0,0,0,0,66.31 ,65.78 ,66.31 
03,011,01,016,0304,413,421,3,424,668,0,0,0,0,0,0,0,66.31 ,63.47 ,66.31 
03,011,01,016,0305,414,807,7,814,1207,0,0,0,0,0,0,0,66.31 ,67.44 ,66.31 
03,011,01,016,0306,415,504,2,506,828,0,0,0,0,0,0,0,66.31 ,61.11 ,66.31 
03,011,01,016,0306,416,699,5,704,1094,0,0,0,0,0,0,0,66.31 ,64.35 ,66.31 
03,011,01,016,0307,417,543,5,548,988,0,0,0,0,0,0,0,66.31 ,55.47 ,66.31 
03,011,01,017,0308,418,365,1,366,531,0,0,0,0,0,0,0,66.31 ,68.93 ,66.31 
03,011,01,017,0308,419,306,6,312,402,0,0,0,0,0,0,0,66.31 ,77.61 ,66.31 
03,011,01,017,0309,420,355,2,357,502,0,0,0,0,0,0,0,66.31 ,71.12 ,66.31 
03,011,01,017,0310,421,285,2,287,423,0,0,0,0,0,0,0,66.31 ,67.85 ,66.31 
03,011,01,017,0311,422,333,6,339,497,0,0,0,0,0,0,0,66.31 ,68.21 ,66.31 
03,011,01,017,0311,423,231,0,231,331,0,0,0,0,0,0,0,66.31 ,69.79 ,66.31 
03,011,01,017,0312,424,500,7,507,778,0,0,0,0,0,0,0,66.31 ,65.17 ,66.31 
03,011,01,017,0312,425,352,4,356,508,0,0,0,0,0,0,0,66.31 ,70.08 ,66.31 
03,011,01,017,0313,426,438,4,442,691,0,0,0,0,0,0,0,66.31 ,63.97 ,66.31 
03,011,01,017,0314,427,272,3,275,424,0,0,0,0,0,0,0,66.31 ,64.86 ,66.31 
03,011,01,017,0314,428,242,1,243,349,0,0,0,0,0,0,0,66.31 ,69.63 ,66.31 
03,011,01,017,0315,429,356,0,356,595,0,0,0,0,0,0,0,66.31 ,59.83 ,66.31 
03,011,01,017,0316,430,748,8,756,1122,0,0,0,0,0,0,0,66.31 ,67.38 ,66.31 
03,011,01,017,0317,431,457,4,461,635,0,0,0,0,0,0,0,66.31 ,72.60 ,66.31 
03,011,01,017,0318,432,475,2,477,664,0,0,0,0,0,0,0,66.31 ,71.84 ,66.31 
03,011,01,017,0318,433,349,1,350,490,0,0,0,0,0,0,0,66.31 ,71.43 ,66.31 
03,011,01,017,0319,434,499,4,503,728,0,0,0,0,0,0,0,66.31 ,69.09 ,66.31 
03,011,01,017,0320,435,484,4,488,722,0,0,0,0,0,0,0,66.31 ,67.59 ,66.31 
03,011,01,018,0321,436,467,11,478,714,0,0,0,0,0,0,0,66.31 ,66.95 ,66.31 
03,011,01,018,0321,437,565,9,574,852,0,0,0,0,0,0,0,66.31 ,67.37 ,66.31 
03,011,01,018,0322,438,797,10,807,1303,0,0,0,0,0,0,0,66.31 ,61.93 ,66.31 
03,011,01,018,0322,439,791,7,798,1227,0,0,0,0,0,0,0,66.31 ,65.04 ,66.31 
03,011,01,018,0322,440,698,8,706,1064,0,0,0,0,0,0,0,66.31 ,66.35 ,66.31 
03,011,01,018,0323,441,525,8,533,762,0,0,0,0,0,0,0,66.31 ,69.95 ,66.31 
03,011,01,018,0323,442,425,7,432,784,0,0,0,0,0,0,0,66.31 ,55.10 ,66.31 
03,011,01,018,0324,443,630,13,643,931,0,0,0,0,0,0,0,66.31 ,69.07 ,66.31 
03,011,01,018,0324,444,561,11,572,810,0,0,0,0,0,0,0,66.31 ,70.62 ,66.31 
03,011,01,018,0324,445,590,4,594,829,0,0,0,0,0,0,0,66.31 ,71.65 ,66.31 
03,011,01,018,0324,446,551,9,560,800,0,0,0,0,0,0,0,66.31 ,70.00 ,66.31 
03,011,01,018,0325,447,291,4,295,429,0,0,0,0,0,0,0,66.31 ,68.76 ,66.31 
03,011,01,018,0326,448,421,8,429,632,0,0,0,0,0,0,0,66.31 ,67.88 ,66.31 
03,011,01,018,0327,449,351,11,362,462,0,0,0,0,0,0,0,66.31 ,78.35 ,66.31 
03,011,01,018,0328,450,662,5,667,960,0,0,0,0,0,0,0,66.31 ,69.48 ,66.31 
03,011,01,018,0329,451,564,6,570,840,0,0,0,0,0,0,0,66.31 ,67.86 ,66.31 
03,011,01,018,0329,452,634,10,644,1027,0,0,0,0,0,0,0,66.31 ,62.71 ,66.31 
03,011,01,018,0329,453,569,10,579,928,0,0,0,0,0,0,0,66.31 ,62.39 ,66.31 
03,011,01,018,0330,454,471,12,483,733,0,0,0,0,0,0,0,66.31 ,65.89 ,66.31 
03,011,01,018,0330,455,486,9,495,754,0,0,0,0,0,0,0,66.31 ,65.65 ,66.31 
03,011,01,018,0331,456,747,5,752,1041,0,0,0,0,0,0,0,66.31 ,72.24 ,66.31 
03,011,01,018,0332,457,810,15,825,1188,0,0,0,0,0,0,0,66.31 ,69.44 ,66.31 
03,011,01,018,0332,458,725,8,733,989,0,0,0,0,0,0,0,66.31 ,74.12 ,66.31 
03,011,01,018,0333,459,599,6,605,791,0,0,0,0,0,0,0,66.31 ,76.49 ,66.31 
03,011,01,018,0333,460,519,5,524,919,0,0,0,0,0,0,0,66.31 ,57.02 ,66.31 
03,011,01,018,0334,461,674,13,687,904,0,0,0,0,0,0,0,66.31 ,76.00 ,66.31 
03,011,01,018,0334,462,550,9,559,758,0,0,0,0,0,0,0,66.31 ,73.75 ,66.31 
03,011,01,018,0335,463,723,7,730,981,0,0,0,0,0,0,0,66.31 ,74.41 ,66.31 
03,011,01,018,0335,464,623,17,640,1069,0,0,0,0,0,0,0,66.31 ,59.87 ,66.31 
03,011,01,018,0336,465,870,14,884,1200,0,0,0,0,0,0,0,66.31 ,73.67 ,66.31 
03,011,01,018,0337,466,379,7,386,529,0,0,0,0,0,0,0,66.31 ,72.97 ,66.31 
03,011,01,018,0338,467,637,15,652,956,0,0,0,0,0,0,0,66.31 ,68.20 ,66.31 
03,011,01,018,0338,468,709,11,720,1008,0,0,0,0,0,0,0,66.31 ,71.43 ,66.31 
03,011,01,018,0339,469,574,11,585,859,0,0,0,0,0,0,0,66.31 ,68.10 ,66.31 
03,011,01,018,0340,470,687,10,697,1077,0,0,0,0,0,0,0,66.31 ,64.72 ,66.31 
03,011,01,019,0341,471,567,4,571,954,0,0,0,0,0,0,0,66.31 ,59.85 ,66.31 
03,011,01,019,0342,472,721,10,731,1164,0,0,0,0,0,0,0,66.31 ,62.80 ,66.31 
03,011,01,019,0342,473,829,12,841,1289,0,0,0,0,0,0,0,66.31 ,65.24 ,66.31 
03,011,01,019,0343,474,663,20,683,1045,0,0,0,0,0,0,0,66.31 ,65.36 ,66.31 
03,011,01,019,0343,475,768,6,774,1338,0,0,0,0,0,0,0,66.31 ,57.85 ,66.31 
03,011,01,019,0343,476,854,9,863,1359,0,0,0,0,0,0,0,66.31 ,63.50 ,66.31 
03,011,01,019,0344,477,554,7,561,876,0,0,0,0,0,0,0,66.31 ,64.04 ,66.31 
03,011,01,019,0344,478,631,5,636,1051,0,0,0,0,0,0,0,66.31 ,60.51 ,66.31 
03,011,01,019,0345,479,809,12,821,1272,0,0,0,0,0,0,0,66.31 ,64.54 ,66.31 
03,011,01,019,0346,480,406,5,411,654,0,0,0,0,0,0,0,66.31 ,62.84 ,66.31 
03,011,01,019,0347,481,328,4,332,486,0,0,0,0,0,0,0,66.31 ,68.31 ,66.31 
03,011,01,019,0348,482,664,6,670,1075,0,0,0,0,0,0,0,66.31 ,62.33 ,66.31 
03,011,01,019,0349,483,837,10,847,1263,0,0,0,0,0,0,0,66.31 ,67.06 ,66.31 
03,011,01,019,0350,484,853,11,864,1221,0,0,0,0,0,0,0,66.31 ,70.76 ,66.31 
03,011,01,019,0350,485,467,8,475,702,0,0,0,0,0,0,0,66.31 ,67.66 ,66.31 
03,011,01,019,0351,486,551,6,557,851,0,0,0,0,0,0,0,66.31 ,65.45 ,66.31 
03,011,01,019,0352,487,581,15,596,871,0,0,0,0,0,0,0,66.31 ,68.43 ,66.31 
03,011,01,019,0352,488,495,1,496,729,0,0,0,0,0,0,0,66.31 ,68.04 ,66.31 
03,011,01,019,0353,489,441,4,445,659,0,0,0,0,0,0,0,66.31 ,67.53 ,66.31 
03,011,01,019,0354,490,718,12,730,1047,0,0,0,0,0,0,0,66.31 ,69.72 ,66.31 
03,011,01,019,0355,491,486,5,491,684,0,0,0,0,0,0,0,66.31 ,71.78 ,66.31 
03,011,01,019,0355,492,678,6,684,970,0,0,0,0,0,0,0,66.31 ,70.52 ,66.31 
03,011,01,019,0356,493,577,6,583,809,0,0,0,0,0,0,0,66.31 ,72.06 ,66.31 
03,011,01,019,0357,494,671,8,679,980,0,0,0,0,0,0,0,66.31 ,69.29 ,66.31 
03,011,01,019,0358,495,934,5,939,1382,0,0,0,0,0,0,0,66.31 ,67.95 ,66.31 
03,011,01,019,0359,496,902,15,917,1352,0,0,0,0,0,0,0,66.31 ,67.83 ,66.31 
03,011,01,019,0360,497,645,7,652,988,0,0,0,0,0,0,0,66.31 ,65.99 ,66.31 
03,011,01,019,0361,498,726,9,735,1139,0,0,0,0,0,0,0,66.31 ,64.53 ,66.31 
03,011,01,019,0361,499,775,8,783,1308,0,0,0,0,0,0,0,66.31 ,59.86 ,66.31 
03,011,01,020,0362,500,542,7,549,857,0,0,0,0,0,0,0,66.31 ,64.06 ,66.31 
03,011,01,020,0362,501,847,12,859,1381,0,0,0,0,0,0,0,66.31 ,62.20 ,66.31 
03,011,01,020,0363,502,599,8,607,1005,0,0,0,0,0,0,0,66.31 ,60.40 ,66.31 
03,011,01,020,0363,503,600,9,609,956,0,0,0,0,0,0,0,66.31 ,63.70 ,66.31 
03,011,01,020,0363,504,429,6,435,706,0,0,0,0,0,0,0,66.31 ,61.61 ,66.31 
03,011,01,020,0363,505,590,7,597,1024,0,0,0,0,0,0,0,66.31 ,58.30 ,66.31 
03,011,01,020,0363,506,693,6,699,1105,0,0,0,0,0,0,0,66.31 ,63.26 ,66.31 
03,011,01,020,0364,507,507,7,514,774,0,0,0,0,0,0,0,66.31 ,66.41 ,66.31 
03,011,01,020,0364,508,695,5,700,983,0,0,0,0,0,0,0,66.31 ,71.21 ,66.31 
03,011,01,020,0365,509,437,5,442,597,0,0,0,0,0,0,0,66.31 ,74.04 ,66.31 
03,011,01,020,0366,510,502,4,506,829,0,0,0,0,0,0,0,66.31 ,61.04 ,66.31 
03,011,01,020,0367,511,604,12,616,913,0,0,0,0,0,0,0,66.31 ,67.47 ,66.31 
03,011,01,020,0368,512,640,9,649,940,0,0,0,0,0,0,0,66.31 ,69.04 ,66.31 
03,011,01,020,0368,513,436,3,439,592,0,0,0,0,0,0,0,66.31 ,74.16 ,66.31 
03,011,01,020,0368,514,431,6,437,603,0,0,0,0,0,0,0,66.31 ,72.47 ,66.31 
03,011,01,020,0369,515,594,11,605,905,0,0,0,0,0,0,0,66.31 ,66.85 ,66.31 
03,011,01,020,0369,516,680,10,690,994,0,0,0,0,0,0,0,66.31 ,69.42 ,66.31 
03,011,01,020,0369,517,727,11,738,1095,0,0,0,0,0,0,0,66.31 ,67.40 ,66.31 
03,011,01,020,0370,518,911,15,926,1394,0,0,0,0,0,0,0,66.31 ,66.43 ,66.31 
03,011,01,020,0371,519,418,5,423,694,0,0,0,0,0,0,0,66.31 ,60.95 ,66.31 
03,011,01,020,0371,520,587,4,591,896,0,0,0,0,0,0,0,66.31 ,65.96 ,66.31 
03,011,01,020,0371,521,658,11,669,1041,0,0,0,0,0,0,0,66.31 ,64.27 ,66.31 
03,011,01,020,0372,522,318,6,324,446,0,0,0,0,0,0,0,66.31 ,72.65 ,66.31 
03,011,01,020,0372,523,862,3,865,1410,0,0,0,0,0,0,0,66.31 ,61.35 ,66.31 
03,011,01,021,0373,524,769,6,775,1120,0,0,0,0,0,0,0,66.31 ,69.20 ,66.31 
03,011,01,021,0373,525,595,6,601,872,0,0,0,0,0,0,0,66.31 ,68.92 ,66.31 
03,011,01,021,0374,526,585,9,594,950,0,0,0,0,0,0,0,66.31 ,62.53 ,66.31 
03,011,01,021,0374,527,493,9,502,768,0,0,0,0,0,0,0,66.31 ,65.36 ,66.31 
03,011,01,021,0375,528,851,15,866,1322,0,0,0,0,0,0,0,66.31 ,65.51 ,66.31 
03,011,01,021,0376,529,777,8,785,1110,0,0,0,0,0,0,0,66.31 ,70.72 ,66.31 
03,011,01,021,0377,530,506,5,511,722,0,0,0,0,0,0,0,66.31 ,70.78 ,66.31 
03,011,01,021,0378,531,972,8,980,1424,0,0,0,0,0,0,0,66.31 ,68.82 ,66.31 
03,011,01,021,0379,532,666,7,673,977,0,0,0,0,0,0,0,66.31 ,68.88 ,66.31 
03,011,01,021,0380,533,683,7,690,981,0,0,0,0,0,0,0,66.31 ,70.34 ,66.31 
03,011,01,021,0380,534,713,7,720,1010,0,0,0,0,0,0,0,66.31 ,71.29 ,66.31 
03,011,01,021,0381,535,754,9,763,1147,0,0,0,0,0,0,0,66.31 ,66.52 ,66.31 
03,011,01,021,0381,536,626,10,636,920,0,0,0,0,0,0,0,66.31 ,69.13 ,66.31 
03,011,01,021,0382,537,481,5,486,617,0,0,0,0,0,0,0,66.31 ,78.77 ,66.31 
03,011,01,021,0383,538,891,11,902,1289,0,0,0,0,0,0,0,66.31 ,69.98 ,66.31 
03,011,01,021,0384,539,491,7,498,694,0,0,0,0,0,0,0,66.31 ,71.76 ,66.31 
03,011,01,021,0385,540,536,5,541,787,0,0,0,0,0,0,0,66.31 ,68.74 ,66.31 
03,011,01,021,0385,541,525,3,528,747,0,0,0,0,0,0,0,66.31 ,70.68 ,66.31 
03,011,01,021,0386,542,804,6,810,1007,0,0,0,0,0,0,0,66.31 ,80.44 ,66.31 
03,011,01,021,0386,543,776,5,781,1075,0,0,0,0,0,0,0,66.31 ,72.65 ,66.31 
03,011,01,021,0387,544,614,6,620,891,0,0,0,0,0,0,0,66.31 ,69.58 ,66.31 
03,011,01,021,0388,545,353,6,359,449,0,0,0,0,0,0,0,66.31 ,79.96 ,66.31 
03,011,01,022,0389,546,563,5,568,851,0,0,0,0,0,0,0,66.31 ,66.75 ,66.31 
03,011,01,022,0389,547,511,10,521,821,0,0,0,0,0,0,0,66.31 ,63.46 ,66.31 
03,011,01,022,0390,548,525,2,527,717,0,0,0,0,0,0,0,66.31 ,73.50 ,66.31 
03,011,01,022,0390,549,556,5,561,773,0,0,0,0,0,0,0,66.31 ,72.57 ,66.31 
03,011,01,022,0391,550,567,9,576,839,0,0,0,0,0,0,0,66.31 ,68.65 ,66.31 
03,011,01,022,0392,551,479,7,486,736,0,0,0,0,0,0,0,66.31 ,66.03 ,66.31 
03,011,01,022,0393,552,368,7,375,574,0,0,0,0,0,0,0,66.31 ,65.33 ,66.31 
03,011,01,022,0394,553,268,6,274,369,0,0,0,0,0,0,0,66.31 ,74.25 ,66.31 
03,011,01,022,0395,554,211,3,214,323,0,0,0,0,0,0,0,66.31 ,66.25 ,66.31 
03,011,01,023,0396,555,685,7,692,976,0,0,0,0,0,0,0,66.31 ,70.90 ,66.31 
03,011,01,023,0397,556,974,9,983,1377,0,0,0,0,0,0,0,66.31 ,71.39 ,66.31 
03,011,01,023,0397,557,882,7,889,1243,0,0,0,0,0,0,0,66.31 ,71.52 ,66.31 
03,011,01,023,0397,558,949,9,958,1345,0,0,0,0,0,0,0,66.31 ,71.23 ,66.31 
03,011,01,023,0398,559,942,10,952,1288,0,0,0,0,0,0,0,66.31 ,73.91 ,66.31 
03,011,01,023,0399,560,835,9,844,1319,0,0,0,0,0,0,0,66.31 ,63.99 ,66.31 
03,011,01,023,0400,561,324,5,329,481,0,0,0,0,0,0,0,66.31 ,68.40 ,66.31 
03,011,01,023,0401,562,314,3,317,512,0,0,0,0,0,0,0,66.31 ,61.91 ,66.31 
03,011,01,023,0402,563,551,2,553,766,0,0,0,0,0,0,0,66.31 ,72.19 ,66.31 
03,011,01,023,0403,564,1069,13,1082,1543,0,0,0,0,0,0,0,66.31 ,70.12 ,66.31 
03,011,01,023,0404,565,562,4,566,727,0,0,0,0,0,0,0,66.31 ,77.85 ,66.31 
03,011,01,023,0405,566,731,4,735,1037,0,0,0,0,0,0,0,66.31 ,70.88 ,66.31 
03,011,01,024,0406,567,665,4,669,1004,0,0,0,0,0,0,0,66.31 ,66.63 ,66.31 
03,011,01,024,0406,568,638,11,649,946,0,0,0,0,0,0,0,66.31 ,68.60 ,66.31 
03,011,01,024,0407,569,882,6,888,1298,0,0,0,0,0,0,0,66.31 ,68.41 ,66.31 
03,011,01,024,0408,570,610,10,620,899,0,0,0,0,0,0,0,66.31 ,68.97 ,66.31 
03,011,01,024,0409,571,705,14,719,1062,0,0,0,0,0,0,0,66.31 ,67.70 ,66.31 
03,011,01,024,0410,572,776,6,782,1082,0,0,0,0,0,0,0,66.31 ,72.27 ,66.31 
03,011,01,024,0411,573,542,3,545,730,0,0,0,0,0,0,0,66.31 ,74.66 ,66.31 
03,011,01,024,0412,574,756,8,764,1045,0,0,0,0,0,0,0,66.31 ,73.11 ,66.31 
03,011,01,024,0412,575,888,6,894,1220,0,0,0,0,0,0,0,66.31 ,73.28 ,66.31 
03,011,01,025,0413,576,525,4,529,716,0,0,0,0,0,0,0,66.31 ,73.88 ,66.31 
03,011,01,025,0413,577,480,3,483,690,0,0,0,0,0,0,0,66.31 ,70.00 ,66.31 
03,011,01,025,0414,578,578,7,585,809,0,0,0,0,0,0,0,66.31 ,72.31 ,66.31 
03,011,01,025,0415,579,473,3,476,690,0,0,0,0,0,0,0,66.31 ,68.99 ,66.31 
03,011,01,025,0416,580,389,2,391,514,0,0,0,0,0,0,0,66.31 ,76.07 ,66.31 
03,011,01,025,0417,581,463,3,466,582,0,0,0,0,0,0,0,66.31 ,80.07 ,66.31 
03,011,01,025,0418,582,618,9,627,836,0,0,0,0,0,0,0,66.31 ,75.00 ,66.31 
03,011,01,025,0419,583,875,6,881,1237,0,0,0,0,0,0,0,66.31 ,71.22 ,66.31 
03,011,01,025,0420,584,676,6,682,942,0,0,0,0,0,0,0,66.31 ,72.40 ,66.31 
03,011,01,025,0421,585,300,4,304,534,0,0,0,0,0,0,0,66.31 ,56.93 ,66.31 
03,011,01,026,0422,586,322,1,323,457,0,0,0,0,0,0,0,66.31 ,70.68 ,66.31 
03,011,01,026,0423,587,530,4,534,719,0,0,0,0,0,0,0,66.31 ,74.27 ,66.31 
03,011,01,026,0424,588,408,7,415,557,0,0,0,0,0,0,0,66.31 ,74.51 ,66.31 
03,011,01,026,0425,589,689,6,695,916,0,0,0,0,0,0,0,66.31 ,75.87 ,66.31 
03,011,01,026,0426,590,277,2,279,354,0,0,0,0,0,0,0,66.31 ,78.81 ,66.31 
03,011,01,026,0427,591,361,3,364,475,0,0,0,0,0,0,0,66.31 ,76.63 ,66.31 
03,011,01,026,0428,592,305,7,312,433,0,0,0,0,0,0,0,66.31 ,72.06 ,66.31 
03,011,01,026,0429,593,209,1,210,295,0,0,0,0,0,0,0,66.31 ,71.19 ,66.31 
03,011,01,026,0430,594,180,4,184,238,0,0,0,0,0,0,0,66.31 ,77.31 ,66.31 
03,011,01,026,0431,595,414,7,421,593,0,0,0,0,0,0,0,66.31 ,70.99 ,66.31 
03,011,01,027,0432,596,874,10,884,1410,0,0,0,0,0,0,0,66.31 ,62.70 ,66.31 
03,011,01,027,0432,597,745,15,760,1173,0,0,0,0,0,0,0,66.31 ,64.79 ,66.31 
03,011,01,027,0432,598,653,8,661,1135,0,0,0,0,0,0,0,66.31 ,58.24 ,66.31 
03,011,01,027,0433,599,589,5,594,972,0,0,0,0,0,0,0,66.31 ,61.11 ,66.31 
03,011,01,027,0433,600,668,5,673,1134,0,0,0,0,0,0,0,66.31 ,59.35 ,66.31 
03,011,01,027,0434,601,538,3,541,817,0,0,0,0,0,0,0,66.31 ,66.22 ,66.31 
03,011,01,027,0434,602,496,5,501,846,0,0,0,0,0,0,0,66.31 ,59.22 ,66.31 
03,011,01,027,0435,603,789,9,798,1271,0,0,0,0,0,0,0,66.31 ,62.79 ,66.31 
03,011,01,027,0435,604,531,11,542,1015,0,0,0,0,0,0,0,66.31 ,53.40 ,66.31 
03,011,01,027,0435,605,660,17,677,1133,0,0,0,0,0,0,0,66.31 ,59.75 ,66.31 
03,011,01,027,0436,606,801,6,807,1189,0,0,0,0,0,0,0,66.31 ,67.87 ,66.31 
03,011,01,027,0436,607,667,12,679,1057,0,0,0,0,0,0,0,66.31 ,64.24 ,66.31 
03,011,01,027,0436,608,909,10,919,1594,0,0,0,0,0,0,0,66.31 ,57.65 ,66.31 
03,011,01,027,0436,609,471,7,478,774,0,0,0,0,0,0,0,66.31 ,61.76 ,66.31 
03,011,01,027,0436,610,801,10,811,1193,0,0,0,0,0,0,0,66.31 ,67.98 ,66.31 
03,011,01,027,0437,611,919,15,934,1524,0,0,0,0,0,0,0,66.31 ,61.29 ,66.31 
03,011,01,027,0437,612,509,6,515,813,0,0,0,0,0,0,0,66.31 ,63.35 ,66.31 
03,011,01,027,0438,613,676,9,685,1118,0,0,0,0,0,0,0,66.31 ,61.27 ,66.31 
03,011,01,027,0438,614,1001,8,1009,1666,0,0,0,0,0,0,0,66.31 ,60.56 ,66.31 
03,011,01,027,0438,615,802,9,811,1288,0,0,0,0,0,0,0,66.31 ,62.97 ,66.31 
03,011,01,027,0438,616,733,11,744,1404,0,0,0,0,0,0,0,66.31 ,52.99 ,66.31 
03,011,01,027,0439,617,778,9,787,1368,0,0,0,0,0,0,0,66.31 ,57.53 ,66.31 
03,011,01,027,0439,618,963,17,980,1593,0,0,0,0,0,0,0,66.31 ,61.52 ,66.31 
03,011,01,027,0439,619,444,5,449,713,0,0,0,0,0,0,0,66.31 ,62.97 ,66.31 
03,011,01,027,0440,620,938,10,948,1249,0,0,0,0,0,0,0,66.31 ,75.90 ,66.31 
03,011,01,027,0441,621,531,5,536,662,0,0,0,0,0,0,0,66.31 ,80.97 ,66.31 
03,011,01,027,0442,622,461,5,466,786,0,0,0,0,0,0,0,66.31 ,59.29 ,66.31 
03,011,01,027,0442,623,781,10,791,1267,0,0,0,0,0,0,0,66.31 ,62.43 ,66.31 
03,011,01,027,0443,624,736,17,753,1184,0,0,0,0,0,0,0,66.31 ,63.60 ,66.31 
03,011,01,027,0443,625,626,12,638,952,0,0,0,0,0,0,0,66.31 ,67.02 ,66.31 
03,011,01,027,0443,626,702,10,712,1020,0,0,0,0,0,0,0,66.31 ,69.80 ,66.31 
03,011,01,027,0443,627,195,2,197,311,0,0,0,0,0,0,0,66.31 ,63.34 ,66.31 
03,011,01,027,0444,628,826,23,849,1197,0,0,0,0,0,0,0,66.31 ,70.93 ,66.31 
03,011,01,027,0445,629,654,11,665,938,0,0,0,0,0,0,0,66.31 ,70.90 ,66.31 
03,011,01,027,0445,630,638,9,647,1009,0,0,0,0,0,0,0,66.31 ,64.12 ,66.31 
03,011,01,027,0446,631,839,20,859,1172,0,0,0,0,0,0,0,66.31 ,73.29 ,66.31 
03,011,01,027,0446,632,611,9,620,793,0,0,0,0,0,0,0,66.31 ,78.18 ,66.31 
03,011,01,027,0447,633,618,11,629,817,0,0,0,0,0,0,0,66.31 ,76.99 ,66.31 
03,011,01,027,0447,634,764,11,775,1033,0,0,0,0,0,0,0,66.31 ,75.02 ,66.31 
03,011,01,027,0448,635,828,10,838,1193,0,0,0,0,0,0,0,66.31 ,70.24 ,66.31 
03,011,01,027,0449,636,978,16,994,1373,0,0,0,0,0,0,0,66.31 ,72.40 ,66.31 
03,011,01,028,0450,637,923,10,933,1445,0,0,0,0,0,0,0,66.31 ,64.57 ,66.31 
03,011,01,028,0450,638,839,7,846,1306,0,0,0,0,0,0,0,66.31 ,64.78 ,66.31 
03,011,01,028,0450,639,877,9,886,1340,0,0,0,0,0,0,0,66.31 ,66.12 ,66.31 
03,011,01,028,0451,640,834,8,842,1357,0,0,0,0,0,0,0,66.31 ,62.05 ,66.31 
03,011,01,028,0451,641,729,4,733,1101,0,0,0,0,0,0,0,66.31 ,66.58 ,66.31 
03,011,01,028,0452,642,654,10,664,1014,0,0,0,0,0,0,0,66.31 ,65.48 ,66.31 
03,011,01,028,0452,643,686,10,696,1110,0,0,0,0,0,0,0,66.31 ,62.70 ,66.31 
03,011,01,028,0452,644,726,7,733,1134,0,0,0,0,0,0,0,66.31 ,64.64 ,66.31 
03,011,01,028,0452,645,803,8,811,1289,0,0,0,0,0,0,0,66.31 ,62.92 ,66.31 
03,011,01,028,0453,646,856,5,861,1250,0,0,0,0,0,0,0,66.31 ,68.88 ,66.31 
03,011,01,028,0453,647,728,7,735,1210,0,0,0,0,0,0,0,66.31 ,60.74 ,66.31 
03,011,01,028,0453,648,742,6,748,1130,0,0,0,0,0,0,0,66.31 ,66.19 ,66.31 
03,011,01,028,0453,649,738,6,744,1123,0,0,0,0,0,0,0,66.31 ,66.25 ,66.31 
03,011,01,028,0454,650,979,8,987,1452,0,0,0,0,0,0,0,66.31 ,67.98 ,66.31 
03,011,01,028,0454,651,889,6,895,1418,0,0,0,0,0,0,0,66.31 ,63.12 ,66.31 
03,011,01,028,0454,652,874,9,883,1276,0,0,0,0,0,0,0,66.31 ,69.20 ,66.31 
03,011,01,028,0455,653,895,10,905,1385,0,0,0,0,0,0,0,66.31 ,65.34 ,66.31 
03,011,01,028,0455,654,848,7,855,1192,0,0,0,0,0,0,0,66.31 ,71.73 ,66.31 
03,011,01,028,0456,655,909,9,918,1258,0,0,0,0,0,0,0,66.31 ,72.97 ,66.31 
03,011,01,028,0457,656,866,12,878,1258,0,0,0,0,0,0,0,66.31 ,69.79 ,66.31 
03,011,01,028,0458,657,539,5,544,763,0,0,0,0,0,0,0,66.31 ,71.30 ,66.31 
03,011,01,028,0458,658,737,6,743,1022,0,0,0,0,0,0,0,66.31 ,72.70 ,66.31 
03,011,01,028,0459,659,380,4,384,533,0,0,0,0,0,0,0,66.31 ,72.05 ,66.31 
03,011,01,028,0460,660,599,2,601,853,0,0,0,0,0,0,0,66.31 ,70.46 ,66.31 
03,011,01,028,0460,661,568,2,570,767,0,0,0,0,0,0,0,66.31 ,74.32 ,66.31 
03,011,01,028,0461,662,814,16,830,1247,0,0,0,0,0,0,0,66.31 ,66.56 ,66.31 
03,011,01,028,0462,663,643,4,647,883,0,0,0,0,0,0,0,66.31 ,73.27 ,66.31 
03,011,01,028,0462,664,560,3,563,897,0,0,0,0,0,0,0,66.31 ,62.76 ,66.31 
03,011,01,028,0463,665,662,6,668,1011,0,0,0,0,0,0,0,66.31 ,66.07 ,66.31 
03,011,01,028,0463,666,567,12,579,849,0,0,0,0,0,0,0,66.31 ,68.20 ,66.31 
03,011,01,028,0464,667,659,7,666,916,0,0,0,0,0,0,0,66.31 ,72.71 ,66.31 
03,011,01,028,0464,668,484,6,490,860,0,0,0,0,0,0,0,66.31 ,56.98 ,66.31 
03,011,01,028,0465,669,655,6,661,932,0,0,0,0,0,0,0,66.31 ,70.92 ,66.31 
03,011,01,028,0465,670,576,7,583,860,0,0,0,0,0,0,0,66.31 ,67.79 ,66.31 
03,011,01,028,0466,671,495,10,505,700,0,0,0,0,0,0,0,66.31 ,72.14 ,66.31 
03,011,01,028,0466,672,404,7,411,578,0,0,0,0,0,0,0,66.31 ,71.11 ,66.31 
03,011,01,028,0467,673,748,8,756,1250,0,0,0,0,0,0,0,66.31 ,60.48 ,66.31 
03,011,01,028,0467,674,547,8,555,838,0,0,0,0,0,0,0,66.31 ,66.23 ,66.31 
03,011,01,029,0468,675,530,5,535,815,0,0,0,0,0,0,0,66.31 ,65.64 ,66.31 
03,011,01,029,0468,676,676,8,684,989,0,0,0,0,0,0,0,66.31 ,69.16 ,66.31 
03,011,01,029,0469,677,486,5,491,733,0,0,0,0,0,0,0,66.31 ,66.98 ,66.31 
03,011,01,029,0469,678,672,6,678,1023,0,0,0,0,0,0,0,66.31 ,66.28 ,66.31 
03,011,01,029,0470,679,692,4,696,1064,0,0,0,0,0,0,0,66.31 ,65.41 ,66.31 
03,011,01,029,0470,680,715,7,722,1082,0,0,0,0,0,0,0,66.31 ,66.73 ,66.31 
03,011,01,029,0470,681,781,3,784,1251,0,0,0,0,0,0,0,66.31 ,62.67 ,66.31 
03,011,01,029,0471,682,868,8,876,1235,0,0,0,0,0,0,0,66.31 ,70.93 ,66.31 
03,011,01,029,0471,683,794,6,800,1207,0,0,0,0,0,0,0,66.31 ,66.28 ,66.31 
03,011,01,029,0472,684,575,8,583,832,0,0,0,0,0,0,0,66.31 ,70.07 ,66.31 
03,011,01,029,0473,685,525,3,528,748,0,0,0,0,0,0,0,66.31 ,70.59 ,66.31 
03,011,01,029,0474,686,818,16,834,1267,0,0,0,0,0,0,0,66.31 ,65.82 ,66.31 
03,011,01,029,0474,687,866,14,880,1233,0,0,0,0,0,0,0,66.31 ,71.37 ,66.31 
03,011,01,029,0475,688,1008,6,1014,1464,0,0,0,0,0,0,0,66.31 ,69.26 ,66.31 
03,011,01,029,0475,689,837,8,845,1311,0,0,0,0,0,0,0,66.31 ,64.45 ,66.31 
03,011,01,029,0476,690,599,5,604,876,0,0,0,0,0,0,0,66.31 ,68.95 ,66.31 
03,011,01,029,0476,691,735,5,740,1017,0,0,0,0,0,0,0,66.31 ,72.76 ,66.31 
03,011,01,029,0477,692,890,7,897,1342,0,0,0,0,0,0,0,66.31 ,66.84 ,66.31 
03,011,01,029,0478,693,590,4,594,874,0,0,0,0,0,0,0,66.31 ,67.96 ,66.31 
03,011,01,029,0478,694,754,5,759,1192,0,0,0,0,0,0,0,66.31 ,63.67 ,66.31 
03,011,01,029,0479,695,994,13,1007,1454,0,0,0,0,0,0,0,66.31 ,69.26 ,66.31 
03,011,01,029,0480,696,786,9,795,1181,0,0,0,0,0,0,0,66.31 ,67.32 ,66.31 
03,011,01,029,0481,697,542,6,548,746,0,0,0,0,0,0,0,66.31 ,73.46 ,66.31 
03,011,01,029,0482,698,582,1,583,745,0,0,0,0,0,0,0,66.31 ,78.26 ,66.31 
03,011,01,029,0483,699,941,10,951,1443,0,0,0,0,0,0,0,66.31 ,65.90 ,66.31 
03,011,01,029,0484,700,297,1,298,388,0,0,0,0,0,0,0,66.31 ,76.80 ,66.31 
03,011,01,030,0485,701,817,2,819,1175,0,0,0,0,0,0,0,66.31 ,69.70 ,66.31 
03,011,01,030,0486,702,514,4,518,696,0,0,0,0,0,0,0,66.31 ,74.43 ,66.31 
03,011,01,030,0487,703,102,0,102,212,0,0,0,0,0,0,0,66.31 ,48.11 ,66.31 
03,011,01,030,0488,704,235,3,238,301,0,0,0,0,0,0,0,66.31 ,79.07 ,66.31 
03,011,01,030,0489,705,217,1,218,285,0,0,0,0,0,0,0,66.31 ,76.49 ,66.31 
03,011,01,030,0490,706,216,1,217,302,0,0,0,0,0,0,0,66.31 ,71.85 ,66.31 
03,011,01,030,0491,707,331,1,332,455,0,0,0,0,0,0,0,66.31 ,72.97 ,66.31 
03,011,01,030,0492,708,279,1,280,377,0,0,0,0,0,0,0,66.31 ,74.27 ,66.31 
03,011,01,031,0493,709,703,13,716,1300,0,0,0,0,0,0,0,66.31 ,55.08 ,66.31 
03,011,01,031,0493,710,553,4,557,1045,0,0,0,0,0,0,0,66.31 ,53.30 ,66.31 
03,011,01,031,0493,711,601,5,606,1220,0,0,0,0,0,0,0,66.31 ,49.67 ,66.31 
03,011,01,031,0494,712,707,8,715,1224,0,0,0,0,0,0,0,66.31 ,58.42 ,66.31 
03,011,01,031,0494,713,660,6,666,1256,0,0,0,0,0,0,0,66.31 ,53.03 ,66.31 
03,011,01,031,0495,714,709,14,723,1302,0,0,0,0,0,0,0,66.31 ,55.53 ,66.31 
03,011,01,031,0495,715,573,9,582,1325,0,0,0,0,0,0,0,66.31 ,43.92 ,66.31 
03,011,01,031,0496,716,679,10,689,1193,0,0,0,0,0,0,0,66.31 ,57.75 ,66.31 
03,011,01,031,0496,717,547,7,554,1082,0,0,0,0,0,0,0,66.31 ,51.20 ,66.31 
03,011,01,031,0496,718,620,5,625,1120,0,0,0,0,0,0,0,66.31 ,55.80 ,66.31 
03,011,01,031,0497,719,612,4,616,1154,0,0,0,0,0,0,0,66.31 ,53.38 ,66.31 
03,011,01,031,0497,720,743,8,751,1438,0,0,0,0,0,0,0,66.31 ,52.23 ,66.31 
03,011,01,031,0497,721,686,9,695,1297,0,0,0,0,0,0,0,66.31 ,53.59 ,66.31 
03,011,01,031,0497,722,574,5,579,1229,0,0,0,0,0,0,0,66.31 ,47.11 ,66.31 
03,011,01,031,0498,723,701,14,715,1220,0,0,0,0,0,0,0,66.31 ,58.61 ,66.31 
03,011,01,031,0498,724,787,6,793,1222,0,0,0,0,0,0,0,66.31 ,64.89 ,66.31 
03,011,01,031,0498,725,749,2,751,1309,0,0,0,0,0,0,0,66.31 ,57.37 ,66.31 
03,011,01,031,0498,726,627,9,636,1325,0,0,0,0,0,0,0,66.31 ,48.00 ,66.31 
03,011,01,031,0499,727,735,8,743,1176,0,0,0,0,0,0,0,66.31 ,63.18 ,66.31 
03,011,01,031,0499,728,572,16,588,1110,0,0,0,0,0,0,0,66.31 ,52.97 ,66.31 
03,011,01,031,0499,729,628,8,636,1162,0,0,0,0,0,0,0,66.31 ,54.73 ,66.31 
03,011,01,031,0499,730,541,5,546,1057,0,0,0,0,0,0,0,66.31 ,51.66 ,66.31 
03,011,01,031,0500,731,730,9,739,1187,0,0,0,0,0,0,0,66.31 ,62.26 ,66.31 
03,011,01,031,0500,732,793,15,808,1391,0,0,0,0,0,0,0,66.31 ,58.09 ,66.31 
03,011,01,031,0500,733,734,11,745,1305,0,0,0,0,0,0,0,66.31 ,57.09 ,66.31 
03,011,01,031,0500,734,623,8,631,1275,0,0,0,0,0,0,0,66.31 ,49.49 ,66.31 
03,011,01,031,0501,735,638,7,645,1334,0,0,0,0,0,0,0,66.31 ,48.35 ,66.31 
03,011,01,031,0501,736,650,2,652,1237,0,0,0,0,0,0,0,66.31 ,52.71 ,66.31 
03,011,01,031,0501,737,626,7,633,1172,0,0,0,0,0,0,0,66.31 ,54.01 ,66.31 
03,011,01,031,0502,738,343,5,348,645,0,0,0,0,0,0,0,66.31 ,53.95 ,66.31 
03,011,01,031,0502,739,436,3,439,774,0,0,0,0,0,0,0,66.31 ,56.72 ,66.31 
03,011,01,031,0502,740,395,3,398,686,0,0,0,0,0,0,0,66.31 ,58.02 ,66.31 
03,011,01,031,0503,741,612,12,624,1120,0,0,0,0,0,0,0,66.31 ,55.71 ,66.31 
03,011,01,031,0503,742,570,7,577,1059,0,0,0,0,0,0,0,66.31 ,54.49 ,66.31 
03,011,01,031,0504,743,527,7,534,1037,0,0,0,0,0,0,0,66.31 ,51.49 ,66.31 
03,011,01,031,0504,744,598,7,605,1215,0,0,0,0,0,0,0,66.31 ,49.79 ,66.31 
03,011,01,031,0505,745,860,10,870,1325,0,0,0,0,0,0,0,66.31 ,65.66 ,66.31 
03,011,01,031,0506,746,704,5,709,1065,0,0,0,0,0,0,0,66.31 ,66.57 ,66.31 
03,011,01,031,0507,747,522,5,527,956,0,0,0,0,0,0,0,66.31 ,55.13 ,66.31 
03,011,01,031,0507,748,572,3,575,1027,0,0,0,0,0,0,0,66.31 ,55.99 ,66.31 
03,011,01,031,0507,749,583,9,592,1154,0,0,0,0,0,0,0,66.31 ,51.30 ,66.31 
03,011,01,031,0507,750,613,8,621,1292,0,0,0,0,0,0,0,66.31 ,48.07 ,66.31 
03,011,01,031,0507,751,503,9,512,985,0,0,0,0,0,0,0,66.31 ,51.98 ,66.31 
03,011,01,031,0508,752,742,9,751,1347,0,0,0,0,0,0,0,66.31 ,55.75 ,66.31 
03,011,01,031,0508,753,754,6,760,1384,0,0,0,0,0,0,0,66.31 ,54.91 ,66.31 
03,011,01,031,0508,754,695,12,707,1186,0,0,0,0,0,0,0,66.31 ,59.61 ,66.31 
03,011,01,031,0509,755,450,4,454,630,0,0,0,0,0,0,0,66.31 ,72.06 ,66.31 
03,011,01,031,0509,756,406,6,412,666,0,0,0,0,0,0,0,66.31 ,61.86 ,66.31 
03,011,01,031,0509,757,606,8,614,883,0,0,0,0,0,0,0,66.31 ,69.54 ,66.31 
03,011,01,031,0510,758,610,1,611,1001,0,0,0,0,0,0,0,66.31 ,61.04 ,66.31 
03,011,01,031,0510,759,479,5,484,816,0,0,0,0,0,0,0,66.31 ,59.31 ,66.31 
03,011,01,031,0510,760,614,7,621,1174,0,0,0,0,0,0,0,66.31 ,52.90 ,66.31 
03,011,01,031,0511,761,807,9,816,1352,0,0,0,0,0,0,0,66.31 ,60.36 ,66.31 
03,011,01,031,0511,762,706,9,715,1262,0,0,0,0,0,0,0,66.31 ,56.66 ,66.31 
03,011,01,031,0511,763,755,4,759,1334,0,0,0,0,0,0,0,66.31 ,56.90 ,66.31 
03,011,01,031,0511,764,742,5,747,1630,0,0,0,0,0,0,0,66.31 ,45.83 ,66.31 
03,011,01,031,0512,765,716,4,720,1153,0,0,0,0,0,0,0,66.31 ,62.45 ,66.31 
03,011,01,031,0512,766,399,3,402,526,0,0,0,0,0,0,0,66.31 ,76.43 ,66.31 
03,011,01,031,0513,767,788,5,793,1306,0,0,0,0,0,0,0,66.31 ,60.72 ,66.31 
03,011,01,031,0514,768,720,10,730,1146,0,0,0,0,0,0,0,66.31 ,63.70 ,66.31 
03,011,01,031,0514,769,620,5,625,1058,0,0,0,0,0,0,0,66.31 ,59.07 ,66.31 
03,011,01,031,0514,770,638,16,654,1180,0,0,0,0,0,0,0,66.31 ,55.42 ,66.31 
03,011,01,031,0515,771,735,6,741,1186,0,0,0,0,0,0,0,66.31 ,62.48 ,66.31 
03,011,01,031,0516,772,675,8,683,1009,0,0,0,0,0,0,0,66.31 ,67.69 ,66.31 
03,011,01,031,0516,773,517,9,526,735,0,0,0,0,0,0,0,66.31 ,71.56 ,66.31 
03,011,01,031,0516,774,713,6,719,1041,0,0,0,0,0,0,0,66.31 ,69.07 ,66.31 
03,011,01,031,0517,775,535,8,543,817,0,0,0,0,0,0,0,66.31 ,66.46 ,66.31 
03,011,01,031,0517,776,537,16,553,938,0,0,0,0,0,0,0,66.31 ,58.96 ,66.31 
03,011,01,031,0517,777,661,5,666,1084,0,0,0,0,0,0,0,66.31 ,61.44 ,66.31 
03,011,01,031,0518,778,702,9,711,1092,0,0,0,0,0,0,0,66.31 ,65.11 ,66.31 
03,011,01,031,0518,779,612,9,621,1084,0,0,0,0,0,0,0,66.31 ,57.29 ,66.31 
03,011,01,031,0518,780,660,15,675,1125,0,0,0,0,0,0,0,66.31 ,60.00 ,66.31 
03,011,01,031,0518,781,630,5,635,1079,0,0,0,0,0,0,0,66.31 ,58.85 ,66.31 
03,011,01,031,0519,782,695,4,699,1168,0,0,0,0,0,0,0,66.31 ,59.85 ,66.31 
03,011,01,031,0519,783,765,2,767,1085,0,0,0,0,0,0,0,66.31 ,70.69 ,66.31 
03,011,01,031,0519,784,676,6,682,1003,0,0,0,0,0,0,0,66.31 ,68.00 ,66.31 
03,011,01,031,0520,785,719,11,730,1194,0,0,0,0,0,0,0,66.31 ,61.14 ,66.31 
03,011,01,031,0520,786,763,3,766,1241,0,0,0,0,0,0,0,66.31 ,61.72 ,66.31 
03,011,01,031,0520,787,728,7,735,1176,0,0,0,0,0,0,0,66.31 ,62.50 ,66.31 
03,011,01,031,0520,788,708,12,720,1176,0,0,0,0,0,0,0,66.31 ,61.22 ,66.31 
03,011,01,031,0521,789,712,11,723,1127,0,0,0,0,0,0,0,66.31 ,64.15 ,66.31 
03,011,01,031,0521,790,678,4,682,1096,0,0,0,0,0,0,0,66.31 ,62.23 ,66.31 
03,011,01,031,0521,791,677,8,685,1186,0,0,0,0,0,0,0,66.31 ,57.76 ,66.31 
03,011,01,031,0521,792,659,17,676,1185,0,0,0,0,0,0,0,66.31 ,57.05 ,66.31 
03,011,01,031,0522,793,521,16,537,824,0,0,0,0,0,0,0,66.31 ,65.17 ,66.31 
03,011,01,031,0522,794,633,15,648,986,0,0,0,0,0,0,0,66.31 ,65.72 ,66.31 
03,011,01,031,0523,795,718,12,730,1116,0,0,0,0,0,0,0,66.31 ,65.41 ,66.31 
03,011,01,031,0523,796,595,9,604,875,0,0,0,0,0,0,0,66.31 ,69.03 ,66.31 
03,011,01,031,0524,797,636,6,642,1007,0,0,0,0,0,0,0,66.31 ,63.75 ,66.31 
03,011,01,031,0524,798,609,9,618,980,0,0,0,0,0,0,0,66.31 ,63.06 ,66.31 
03,011,01,031,0525,799,591,10,601,1388,0,0,0,0,0,0,0,66.31 ,43.30 ,66.31 
03,011,01,031,0525,800,674,9,683,1377,0,0,0,0,0,0,0,66.31 ,49.60 ,66.31 
03,011,01,031,0525,801,646,6,652,1121,0,0,0,0,0,0,0,66.31 ,58.16 ,66.31 
03,011,01,031,0525,802,669,11,680,1420,0,0,0,0,0,0,0,66.31 ,47.89 ,66.31 
03,011,01,031,0525,803,672,11,683,1363,0,0,0,0,0,0,0,66.31 ,50.11 ,66.31 
03,011,01,031,0525,804,581,6,587,1101,0,0,0,0,0,0,0,66.31 ,53.32 ,66.31 
03,011,01,031,0525,805,620,4,624,1096,0,0,0,0,0,0,0,66.31 ,56.93 ,66.31 
03,011,01,031,0526,806,786,6,792,1214,0,0,0,0,0,0,0,66.31 ,65.24 ,66.31 
03,011,01,031,0527,807,628,8,636,931,0,0,0,0,0,0,0,66.31 ,68.31 ,66.31 
03,011,01,031,0527,808,470,5,475,830,0,0,0,0,0,0,0,66.31 ,57.23 ,66.31 
03,011,01,031,0528,809,695,8,703,1015,0,0,0,0,0,0,0,66.31 ,69.26 ,66.31 
03,011,01,031,0528,810,655,13,668,1181,0,0,0,0,0,0,0,66.31 ,56.56 ,66.31 
03,011,01,031,0529,811,451,3,454,846,0,0,0,0,0,0,0,66.31 ,53.66 ,66.31 
03,011,01,031,0529,812,508,4,512,961,0,0,0,0,0,0,0,66.31 ,53.28 ,66.31 
03,011,01,031,0530,813,799,9,808,1309,0,0,0,0,0,0,0,66.31 ,61.73 ,66.31 
03,011,01,031,0530,814,806,9,815,1373,0,0,0,0,0,0,0,66.31 ,59.36 ,66.31 
03,011,01,031,0531,815,548,12,560,912,0,0,0,0,0,0,0,66.31 ,61.40 ,66.31 
03,011,01,031,0531,816,543,4,547,1208,0,0,0,0,0,0,0,66.31 ,45.28 ,66.31 
03,011,01,031,0531,817,558,5,563,1040,0,0,0,0,0,0,0,66.31 ,54.13 ,66.31 
03,011,01,031,0531,818,566,9,575,1008,0,0,0,0,0,0,0,66.31 ,57.04 ,66.31 
03,012,01,001,0001,1,377,4,381,594,0,0,0,0,0,0,0,66.31 ,64.14 ,66.31 
03,012,01,001,0001,2,439,5,444,706,0,0,0,0,0,0,0,66.31 ,62.89 ,66.31 
03,012,01,001,0002,3,573,3,576,870,0,0,0,0,0,0,0,66.31 ,66.21 ,66.31 
03,012,01,001,0003,4,810,7,817,1227,0,0,0,0,0,0,0,66.31 ,66.59 ,66.31 
03,012,01,001,0003,5,685,10,695,1100,0,0,0,0,0,0,0,66.31 ,63.18 ,66.31 
03,012,01,001,0004,6,894,9,903,1387,0,0,0,0,0,0,0,66.31 ,65.10 ,66.31 
03,012,01,001,0004,7,805,10,815,1237,0,0,0,0,0,0,0,66.31 ,65.89 ,66.31 
03,012,01,001,0004,8,744,11,755,1130,0,0,0,0,0,0,0,66.31 ,66.81 ,66.31 
03,012,01,001,0004,9,717,10,727,1151,0,0,0,0,0,0,0,66.31 ,63.16 ,66.31 
03,012,01,001,0005,10,671,8,679,1012,0,0,0,0,0,0,0,66.31 ,67.09 ,66.31 
03,012,01,001,0005,11,579,11,590,915,0,0,0,0,0,0,0,66.31 ,64.48 ,66.31 
03,012,01,001,0005,12,559,13,572,905,0,0,0,0,0,0,0,66.31 ,63.20 ,66.31 
03,012,01,001,0005,13,571,11,582,850,0,0,0,0,0,0,0,66.31 ,68.47 ,66.31 
03,012,01,001,0006,14,635,15,650,992,0,0,0,0,0,0,0,66.31 ,65.52 ,66.31 
03,012,01,001,0006,15,740,11,751,1139,0,0,0,0,0,0,0,66.31 ,65.94 ,66.31 
03,012,01,001,0006,16,417,5,422,670,0,0,0,0,0,0,0,66.31 ,62.99 ,66.31 
03,012,01,001,0006,17,729,11,740,1079,0,0,0,0,0,0,0,66.31 ,68.58 ,66.31 
03,012,01,001,0007,18,604,6,610,1105,0,0,0,0,0,0,0,66.31 ,55.20 ,66.31 
03,012,01,001,0007,19,712,9,721,1125,0,0,0,0,0,0,0,66.31 ,64.09 ,66.31 
03,012,01,001,0008,20,882,17,899,1362,0,0,0,0,0,0,0,66.31 ,66.01 ,66.31 
03,012,01,001,0008,21,951,13,964,1506,0,0,0,0,0,0,0,66.31 ,64.01 ,66.31 
03,012,01,001,0009,22,734,9,743,1087,0,0,0,0,0,0,0,66.31 ,68.35 ,66.31 
03,012,01,001,0009,23,680,14,694,1110,0,0,0,0,0,0,0,66.31 ,62.52 ,66.31 
03,012,01,001,0010,24,632,14,646,930,0,0,0,0,0,0,0,66.31 ,69.46 ,66.31 
03,012,01,001,0010,25,589,7,596,960,0,0,0,0,0,0,0,66.31 ,62.08 ,66.31 
03,012,01,001,0010,26,613,4,617,1049,0,0,0,0,0,0,0,66.31 ,58.82 ,66.31 
03,012,01,001,0010,27,715,6,721,1045,0,0,0,0,0,0,0,66.31 ,69.00 ,66.31 
03,012,01,001,0011,28,764,7,771,1210,0,0,0,0,0,0,0,66.31 ,63.72 ,66.31 
03,012,01,001,0011,29,752,13,765,1100,0,0,0,0,0,0,0,66.31 ,69.55 ,66.31 
03,012,01,001,0011,30,741,5,746,1124,0,0,0,0,0,0,0,66.31 ,66.37 ,66.31 
03,012,01,001,0011,31,760,15,775,1203,0,0,0,0,0,0,0,66.31 ,64.42 ,66.31 
03,012,01,001,0012,32,618,8,626,1122,0,0,0,0,0,0,0,66.31 ,55.79 ,66.31 
03,012,01,001,0012,33,520,9,529,854,0,0,0,0,0,0,0,66.31 ,61.94 ,66.31 
03,012,01,001,0012,34,555,3,558,1008,0,0,0,0,0,0,0,66.31 ,55.36 ,66.31 
03,012,01,001,0012,35,559,3,562,1093,0,0,0,0,0,0,0,66.31 ,51.42 ,66.31 
03,012,01,001,0013,36,696,8,704,959,0,0,0,0,0,0,0,66.31 ,73.41 ,66.31 
03,012,01,001,0013,37,654,3,657,1074,0,0,0,0,0,0,0,66.31 ,61.17 ,66.31 
03,012,01,001,0014,38,619,5,624,1034,0,0,0,0,0,0,0,66.31 ,60.35 ,66.31 
03,012,01,001,0014,39,721,11,732,1191,0,0,0,0,0,0,0,66.31 ,61.46 ,66.31 
03,012,01,001,0014,40,616,6,622,1136,0,0,0,0,0,0,0,66.31 ,54.75 ,66.31 
03,012,01,001,0014,41,706,12,718,1264,0,0,0,0,0,0,0,66.31 ,56.80 ,66.31 
03,012,01,001,0015,42,571,6,577,817,0,0,0,0,0,0,0,66.31 ,70.62 ,66.31 
03,012,01,001,0016,43,362,4,366,525,0,0,0,0,0,0,0,66.31 ,69.71 ,66.31 
03,012,01,001,0017,44,396,6,402,588,0,0,0,0,0,0,0,66.31 ,68.37 ,66.31 
03,012,01,001,0017,45,554,3,557,786,0,0,0,0,0,0,0,66.31 ,70.87 ,66.31 
03,012,01,001,0018,46,527,6,533,811,0,0,0,0,0,0,0,66.31 ,65.72 ,66.31 
03,012,01,001,0018,47,526,7,533,785,0,0,0,0,0,0,0,66.31 ,67.90 ,66.31 
03,012,01,001,0019,48,742,7,749,1151,0,0,0,0,0,0,0,66.31 ,65.07 ,66.31 
03,012,01,001,0019,49,736,1,737,1088,0,0,0,0,0,0,0,66.31 ,67.74 ,66.31 
03,012,01,001,0019,50,690,4,694,1083,0,0,0,0,0,0,0,66.31 ,64.08 ,66.31 
03,012,01,001,0019,51,729,13,742,1090,0,0,0,0,0,0,0,66.31 ,68.07 ,66.31 
03,012,01,001,0020,52,644,11,655,1008,0,0,0,0,0,0,0,66.31 ,64.98 ,66.31 
03,012,01,001,0021,53,794,8,802,1099,0,0,0,0,0,0,0,66.31 ,72.98 ,66.31 
03,012,01,001,0022,54,850,9,859,1166,0,0,0,0,0,0,0,66.31 ,73.67 ,66.31 
03,012,01,001,0023,55,683,9,692,999,0,0,0,0,0,0,0,66.31 ,69.27 ,66.31 
03,012,01,001,0023,56,491,5,496,794,0,0,0,0,0,0,0,66.31 ,62.47 ,66.31 
03,012,01,001,0023,57,587,5,592,893,0,0,0,0,0,0,0,66.31 ,66.29 ,66.31 
03,012,01,001,0023,58,624,7,631,915,0,0,0,0,0,0,0,66.31 ,68.96 ,66.31 
03,012,01,001,0024,59,560,1,561,807,0,0,0,0,0,0,0,66.31 ,69.52 ,66.31 
03,012,01,001,0025,60,685,9,694,1121,0,0,0,0,0,0,0,66.31 ,61.91 ,66.31 
03,012,01,001,0025,61,843,9,852,1191,0,0,0,0,0,0,0,66.31 ,71.54 ,66.31 
03,012,01,001,0025,62,747,6,753,1042,0,0,0,0,0,0,0,66.31 ,72.26 ,66.31 
03,012,01,001,0026,63,610,7,617,926,0,0,0,0,0,0,0,66.31 ,66.63 ,66.31 
03,012,01,001,0026,64,876,2,878,1426,0,0,0,0,0,0,0,66.31 ,61.57 ,66.31 
03,012,01,001,0026,65,801,10,811,1174,0,0,0,0,0,0,0,66.31 ,69.08 ,66.31 
03,012,01,001,0027,66,632,7,639,1019,0,0,0,0,0,0,0,66.31 ,62.71 ,66.31 
03,012,01,001,0027,67,635,7,642,1020,0,0,0,0,0,0,0,66.31 ,62.94 ,66.31 
03,012,01,001,0027,68,614,6,620,978,0,0,0,0,0,0,0,66.31 ,63.39 ,66.31 
03,012,01,001,0027,69,666,6,672,977,0,0,0,0,0,0,0,66.31 ,68.78 ,66.31 
03,012,01,001,0027,70,631,5,636,943,0,0,0,0,0,0,0,66.31 ,67.44 ,66.31 
03,012,01,001,0028,71,737,10,747,1081,0,0,0,0,0,0,0,66.31 ,69.10 ,66.31 
03,012,01,001,0028,72,670,4,674,1039,0,0,0,0,0,0,0,66.31 ,64.87 ,66.31 
03,012,01,001,0028,73,700,7,707,1057,0,0,0,0,0,0,0,66.31 ,66.89 ,66.31 
03,012,01,001,0029,74,374,2,376,554,0,0,0,0,0,0,0,66.31 ,67.87 ,66.31 
03,012,01,001,0029,75,361,5,366,509,0,0,0,0,0,0,0,66.31 ,71.91 ,66.31 
03,012,01,001,0030,76,397,3,400,606,0,0,0,0,0,0,0,66.31 ,66.01 ,66.31 
03,012,01,001,0031,77,999,11,1010,1452,0,0,0,0,0,0,0,66.31 ,69.56 ,66.31 
03,012,01,001,0032,78,708,9,717,1144,0,0,0,0,0,0,0,66.31 ,62.67 ,66.31 
03,012,01,001,0032,79,691,12,703,1059,0,0,0,0,0,0,0,66.31 ,66.38 ,66.31 
03,012,01,001,0033,80,730,8,738,1030,0,0,0,0,0,0,0,66.31 ,71.65 ,66.31 
03,012,01,001,0033,81,555,8,563,825,0,0,0,0,0,0,0,66.31 ,68.24 ,66.31 
03,012,01,001,0033,82,714,11,725,1068,0,0,0,0,0,0,0,66.31 ,67.88 ,66.31 
03,012,01,001,0033,83,546,4,550,870,0,0,0,0,0,0,0,66.31 ,63.22 ,66.31 
03,012,01,001,0033,84,615,9,624,1005,0,0,0,0,0,0,0,66.31 ,62.09 ,66.31 
03,012,01,001,0034,85,706,20,726,1140,0,0,0,0,0,0,0,66.31 ,63.68 ,66.31 
03,012,01,001,0034,86,782,5,787,1247,0,0,0,0,0,0,0,66.31 ,63.11 ,66.31 
03,012,01,001,0034,87,682,6,688,1048,0,0,0,0,0,0,0,66.31 ,65.65 ,66.31 
03,012,01,001,0035,88,884,11,895,1356,0,0,0,0,0,0,0,66.31 ,66.00 ,66.31 
03,012,01,001,0035,89,510,4,514,828,0,0,0,0,0,0,0,66.31 ,62.08 ,66.31 
03,012,01,001,0035,90,735,5,740,1158,0,0,0,0,0,0,0,66.31 ,63.90 ,66.31 
03,012,01,001,0036,91,690,6,696,1002,0,0,0,0,0,0,0,66.31 ,69.46 ,66.31 
03,012,01,001,0036,92,701,10,711,1057,0,0,0,0,0,0,0,66.31 ,67.27 ,66.31 
03,012,01,001,0037,93,517,7,524,831,0,0,0,0,0,0,0,66.31 ,63.06 ,66.31 
03,012,01,001,0037,94,402,3,405,746,0,0,0,0,0,0,0,66.31 ,54.29 ,66.31 
03,012,01,001,0038,95,706,10,716,1178,0,0,0,0,0,0,0,66.31 ,60.78 ,66.31 
03,012,01,001,0038,96,704,14,718,1016,0,0,0,0,0,0,0,66.31 ,70.67 ,66.31 
03,012,01,001,0039,97,839,10,849,1233,0,0,0,0,0,0,0,66.31 ,68.86 ,66.31 
03,012,01,001,0039,98,799,11,810,1231,0,0,0,0,0,0,0,66.31 ,65.80 ,66.31 
03,012,01,001,0039,99,741,10,751,1123,0,0,0,0,0,0,0,66.31 ,66.87 ,66.31 
03,012,01,001,0040,100,625,3,628,912,0,0,0,0,0,0,0,66.31 ,68.86 ,66.31 
03,012,01,001,0040,101,766,9,775,1102,0,0,0,0,0,0,0,66.31 ,70.33 ,66.31 
03,012,01,001,0040,102,601,5,606,911,0,0,0,0,0,0,0,66.31 ,66.52 ,66.31 
03,012,01,001,0040,103,862,10,872,1356,0,0,0,0,0,0,0,66.31 ,64.31 ,66.31 
03,012,01,001,0041,104,666,7,673,902,0,0,0,0,0,0,0,66.31 ,74.61 ,66.31 
03,012,01,001,0042,105,656,6,662,972,0,0,0,0,0,0,0,66.31 ,68.11 ,66.31 
03,012,01,001,0042,106,710,7,717,1087,0,0,0,0,0,0,0,66.31 ,65.96 ,66.31 
03,012,01,001,0043,107,622,9,631,885,0,0,0,0,0,0,0,66.31 ,71.30 ,66.31 
03,012,01,001,0043,108,499,10,509,784,0,0,0,0,0,0,0,66.31 ,64.92 ,66.31 
03,012,01,001,0043,109,618,6,624,992,0,0,0,0,0,0,0,66.31 ,62.90 ,66.31 
03,012,01,001,0043,110,728,11,739,1269,0,0,0,0,0,0,0,66.31 ,58.23 ,66.31 
03,012,01,001,0044,111,495,6,501,716,0,0,0,0,0,0,0,66.31 ,69.97 ,66.31 
03,012,01,001,0044,112,607,7,614,817,0,0,0,0,0,0,0,66.31 ,75.15 ,66.31 
03,012,01,001,0044,113,688,7,695,944,0,0,0,0,0,0,0,66.31 ,73.62 ,66.31 
03,012,01,001,0045,114,580,3,583,871,0,0,0,0,0,0,0,66.31 ,66.93 ,66.31 
03,012,01,001,0045,115,520,6,526,780,0,0,0,0,0,0,0,66.31 ,67.44 ,66.31 
03,012,01,001,0045,116,530,3,533,878,0,0,0,0,0,0,0,66.31 ,60.71 ,66.31 
03,012,01,001,0045,117,743,12,755,1150,0,0,0,0,0,0,0,66.31 ,65.65 ,66.31 
03,012,01,001,0046,118,737,12,749,1155,0,0,0,0,0,0,0,66.31 ,64.85 ,66.31 
03,012,01,001,0046,119,700,12,712,1149,0,0,0,0,0,0,0,66.31 ,61.97 ,66.31 
03,012,01,001,0046,120,660,7,667,1012,0,0,0,0,0,0,0,66.31 ,65.91 ,66.31 
03,012,01,001,0046,121,575,8,583,978,0,0,0,0,0,0,0,66.31 ,59.61 ,66.31 
03,012,01,001,0047,122,539,5,544,864,0,0,0,0,0,0,0,66.31 ,62.96 ,66.31 
03,012,01,001,0047,123,400,5,405,657,0,0,0,0,0,0,0,66.31 ,61.64 ,66.31 
03,012,01,001,0048,124,600,7,607,929,0,0,0,0,0,0,0,66.31 ,65.34 ,66.31 
03,012,01,001,0048,125,564,6,570,961,0,0,0,0,0,0,0,66.31 ,59.31 ,66.31 
03,012,01,001,0049,126,630,10,640,908,0,0,0,0,0,0,0,66.31 ,70.48 ,66.31 
03,012,01,001,0050,127,666,10,676,1008,0,0,0,0,0,0,0,66.31 ,67.06 ,66.31 
03,012,01,001,0051,128,598,13,611,868,0,0,0,0,0,0,0,66.31 ,70.39 ,66.31 
03,012,01,001,0051,129,613,8,621,894,0,0,0,0,0,0,0,66.31 ,69.46 ,66.31 
03,012,01,001,0051,130,524,7,531,803,0,0,0,0,0,0,0,66.31 ,66.13 ,66.31 
03,012,01,001,0051,131,626,9,635,999,0,0,0,0,0,0,0,66.31 ,63.56 ,66.31 
03,012,01,001,0052,132,404,11,415,680,0,0,0,0,0,0,0,66.31 ,61.03 ,66.31 
03,012,01,001,0052,133,422,4,426,742,0,0,0,0,0,0,0,66.31 ,57.41 ,66.31 
03,012,01,001,0052,134,336,2,338,575,0,0,0,0,0,0,0,66.31 ,58.78 ,66.31 
03,012,01,001,0052,135,563,11,574,865,0,0,0,0,0,0,0,66.31 ,66.36 ,66.31 
03,012,01,001,0053,136,534,8,542,872,0,0,0,0,0,0,0,66.31 ,62.16 ,66.31 
03,012,01,001,0054,137,528,9,537,793,0,0,0,0,0,0,0,66.31 ,67.72 ,66.31 
03,012,01,001,0054,138,465,4,469,715,0,0,0,0,0,0,0,66.31 ,65.59 ,66.31 
03,012,01,001,0054,139,481,5,486,797,0,0,0,0,0,0,0,66.31 ,60.98 ,66.31 
03,012,01,001,0055,140,527,10,537,870,0,0,0,0,0,0,0,66.31 ,61.72 ,66.31 
03,012,01,001,0055,141,495,7,502,775,0,0,0,0,0,0,0,66.31 ,64.77 ,66.31 
03,012,01,001,0055,142,474,10,484,808,0,0,0,0,0,0,0,66.31 ,59.90 ,66.31 
03,012,01,001,0056,143,665,7,672,1021,0,0,0,0,0,0,0,66.31 ,65.82 ,66.31 
03,012,01,001,0056,144,759,3,762,1085,0,0,0,0,0,0,0,66.31 ,70.23 ,66.31 
03,012,01,001,0056,145,626,3,629,995,0,0,0,0,0,0,0,66.31 ,63.22 ,66.31 
03,012,01,001,0057,146,610,6,616,830,0,0,0,0,0,0,0,66.31 ,74.22 ,66.31 
03,012,01,001,0057,147,519,10,529,819,0,0,0,0,0,0,0,66.31 ,64.59 ,66.31 
03,012,01,001,0057,148,592,10,602,903,0,0,0,0,0,0,0,66.31 ,66.67 ,66.31 
03,012,01,001,0058,149,619,6,625,1035,0,0,0,0,0,0,0,66.31 ,60.39 ,66.31 
03,012,01,001,0058,150,611,11,622,981,0,0,0,0,0,0,0,66.31 ,63.40 ,66.31 
03,012,01,001,0058,151,652,11,663,1049,0,0,0,0,0,0,0,66.31 ,63.20 ,66.31 
03,012,01,001,0059,152,752,11,763,1189,0,0,0,0,0,0,0,66.31 ,64.17 ,66.31 
03,012,01,001,0059,153,692,10,702,1082,0,0,0,0,0,0,0,66.31 ,64.88 ,66.31 
03,012,01,001,0059,154,724,10,734,1148,0,0,0,0,0,0,0,66.31 ,63.94 ,66.31 
03,012,01,001,0059,155,608,10,618,959,0,0,0,0,0,0,0,66.31 ,64.44 ,66.31 
03,012,01,001,0059,156,574,7,581,986,0,0,0,0,0,0,0,66.31 ,58.92 ,66.31 
03,012,01,001,0060,157,910,8,918,1512,0,0,0,0,0,0,0,66.31 ,60.71 ,66.31 
03,012,01,001,0060,158,849,16,865,1445,0,0,0,0,0,0,0,66.31 ,59.86 ,66.31 
03,012,01,001,0061,159,458,5,463,719,0,0,0,0,0,0,0,66.31 ,64.39 ,66.31 
03,012,01,001,0061,160,658,6,664,983,0,0,0,0,0,0,0,66.31 ,67.55 ,66.31 
03,012,01,001,0062,161,846,13,859,1357,0,0,0,0,0,0,0,66.31 ,63.30 ,66.31 
03,012,01,001,0062,162,1128,11,1139,1875,0,0,0,0,0,0,0,66.31 ,60.75 ,66.31 
03,012,01,001,0063,163,479,7,486,666,0,0,0,0,0,0,0,66.31 ,72.97 ,66.31 
03,012,01,001,0063,164,407,8,415,716,0,0,0,0,0,0,0,66.31 ,57.96 ,66.31 
03,012,01,001,0063,165,631,7,638,972,0,0,0,0,0,0,0,66.31 ,65.64 ,66.31 
03,012,01,001,0064,166,631,10,641,983,0,0,0,0,0,0,0,66.31 ,65.21 ,66.31 
03,012,01,001,0064,167,746,11,757,1096,0,0,0,0,0,0,0,66.31 ,69.07 ,66.31 
03,012,01,001,0064,168,700,5,705,1058,0,0,0,0,0,0,0,66.31 ,66.64 ,66.31 
03,012,01,001,0064,169,656,9,665,1080,0,0,0,0,0,0,0,66.31 ,61.57 ,66.31 
03,012,01,001,0064,170,685,14,699,1076,0,0,0,0,0,0,0,66.31 ,64.96 ,66.31 
03,012,01,001,0065,171,715,8,723,1175,0,0,0,0,0,0,0,66.31 ,61.53 ,66.31 
03,012,01,001,0065,172,669,9,678,971,0,0,0,0,0,0,0,66.31 ,69.82 ,66.31 
03,012,01,001,0065,173,577,16,593,915,0,0,0,0,0,0,0,66.31 ,64.81 ,66.31 
03,012,01,001,0066,174,897,15,912,1412,0,0,0,0,0,0,0,66.31 ,64.59 ,66.31 
03,012,01,001,0066,175,1018,18,1036,1458,0,0,0,0,0,0,0,66.31 ,71.06 ,66.31 
03,012,01,001,0067,176,675,11,686,1046,0,0,0,0,0,0,0,66.31 ,65.58 ,66.31 
03,012,01,001,0067,177,741,6,747,1107,0,0,0,0,0,0,0,66.31 ,67.48 ,66.31 
03,012,01,001,0068,178,588,4,592,855,0,0,0,0,0,0,0,66.31 ,69.24 ,66.31 
03,012,01,001,0068,179,535,7,542,770,0,0,0,0,0,0,0,66.31 ,70.39 ,66.31 
03,012,01,001,0068,180,694,12,706,982,0,0,0,0,0,0,0,66.31 ,71.89 ,66.31 
03,012,01,001,0068,181,723,9,732,1017,0,0,0,0,0,0,0,66.31 ,71.98 ,66.31 
03,012,01,001,0069,182,416,9,425,631,0,0,0,0,0,0,0,66.31 ,67.35 ,66.31 
03,012,01,001,0069,183,462,6,468,671,0,0,0,0,0,0,0,66.31 ,69.75 ,66.31 
03,012,01,001,0069,184,429,6,435,602,0,0,0,0,0,0,0,66.31 ,72.26 ,66.31 
03,012,01,001,0070,185,658,11,669,991,0,0,0,0,0,0,0,66.31 ,67.51 ,66.31 
03,012,01,001,0070,186,528,9,537,837,0,0,0,0,0,0,0,66.31 ,64.16 ,66.31 
03,012,01,001,0070,187,594,9,603,1020,0,0,0,0,0,0,0,66.31 ,59.12 ,66.31 
03,012,01,001,0070,188,542,8,550,969,0,0,0,0,0,0,0,66.31 ,56.76 ,66.31 
03,012,01,001,0071,189,513,9,522,822,0,0,0,0,0,0,0,66.31 ,63.50 ,66.31 
03,012,01,001,0071,190,608,6,614,955,0,0,0,0,0,0,0,66.31 ,64.29 ,66.31 
03,012,01,001,0072,191,492,5,497,734,0,0,0,0,0,0,0,66.31 ,67.71 ,66.31 
03,012,01,001,0072,192,570,5,575,862,0,0,0,0,0,0,0,66.31 ,66.71 ,66.31 
03,012,01,001,0072,193,589,4,593,898,0,0,0,0,0,0,0,66.31 ,66.04 ,66.31 
03,012,01,001,0073,194,678,8,686,1062,0,0,0,0,0,0,0,66.31 ,64.60 ,66.31 
03,012,01,001,0073,195,713,13,726,1079,0,0,0,0,0,0,0,66.31 ,67.28 ,66.31 
03,012,01,001,0073,196,746,11,757,1036,0,0,0,0,0,0,0,66.31 ,73.07 ,66.31 
03,012,01,001,0074,197,538,11,549,825,0,0,0,0,0,0,0,66.31 ,66.55 ,66.31 
03,012,01,001,0074,198,629,7,636,919,0,0,0,0,0,0,0,66.31 ,69.21 ,66.31 
03,012,01,001,0074,199,562,12,574,897,0,0,0,0,0,0,0,66.31 ,63.99 ,66.31 
03,012,01,001,0074,200,515,7,522,789,0,0,0,0,0,0,0,66.31 ,66.16 ,66.31 
03,012,01,001,0075,201,660,13,673,955,0,0,0,0,0,0,0,66.31 ,70.47 ,66.31 
03,012,01,001,0075,202,634,7,641,926,0,0,0,0,0,0,0,66.31 ,69.22 ,66.31 
03,012,01,001,0075,203,698,9,707,1015,0,0,0,0,0,0,0,66.31 ,69.66 ,66.31 
03,012,01,001,0076,204,678,12,690,990,0,0,0,0,0,0,0,66.31 ,69.70 ,66.31 
03,012,01,001,0076,205,659,6,665,1011,0,0,0,0,0,0,0,66.31 ,65.78 ,66.31 
03,012,01,001,0076,206,707,12,719,1108,0,0,0,0,0,0,0,66.31 ,64.89 ,66.31 
03,012,01,001,0077,207,746,8,754,1075,0,0,0,0,0,0,0,66.31 ,70.14 ,66.31 
03,012,01,001,0077,208,656,12,668,986,0,0,0,0,0,0,0,66.31 ,67.75 ,66.31 
03,012,01,001,0077,209,645,11,656,1077,0,0,0,0,0,0,0,66.31 ,60.91 ,66.31 
03,012,01,001,0077,210,645,6,651,953,0,0,0,0,0,0,0,66.31 ,68.31 ,66.31 
03,012,01,001,0077,211,685,14,699,1079,0,0,0,0,0,0,0,66.31 ,64.78 ,66.31 
03,012,01,001,0078,212,669,16,685,1073,0,0,0,0,0,0,0,66.31 ,63.84 ,66.31 
03,012,01,001,0078,213,655,12,667,1038,0,0,0,0,0,0,0,66.31 ,64.26 ,66.31 
03,012,01,001,0079,214,522,8,530,844,0,0,0,0,0,0,0,66.31 ,62.80 ,66.31 
03,012,01,001,0079,215,492,14,506,829,0,0,0,0,0,0,0,66.31 ,61.04 ,66.31 
03,012,01,001,0079,216,535,5,540,971,0,0,0,0,0,0,0,66.31 ,55.61 ,66.31 
03,012,01,002,0080,217,826,11,837,1172,0,0,0,0,0,0,0,66.31 ,71.42 ,66.31 
03,012,01,002,0080,218,833,6,839,1221,0,0,0,0,0,0,0,66.31 ,68.71 ,66.31 
03,012,01,002,0081,219,693,8,701,976,0,0,0,0,0,0,0,66.31 ,71.82 ,66.31 
03,012,01,002,0081,220,628,6,634,922,0,0,0,0,0,0,0,66.31 ,68.76 ,66.31 
03,012,01,002,0081,221,621,11,632,865,0,0,0,0,0,0,0,66.31 ,73.06 ,66.31 
03,012,01,002,0082,222,739,5,744,1059,0,0,0,0,0,0,0,66.31 ,70.25 ,66.31 
03,012,01,002,0082,223,672,10,682,960,0,0,0,0,0,0,0,66.31 ,71.04 ,66.31 
03,012,01,002,0083,224,848,8,856,1205,0,0,0,0,0,0,0,66.31 ,71.04 ,66.31 
03,012,01,002,0083,225,785,7,792,1188,0,0,0,0,0,0,0,66.31 ,66.67 ,66.31 
03,012,01,002,0084,226,808,11,819,1099,0,0,0,0,0,0,0,66.31 ,74.52 ,66.31 
03,012,01,002,0084,227,690,3,693,997,0,0,0,0,0,0,0,66.31 ,69.51 ,66.31 
03,012,01,002,0084,228,645,8,653,985,0,0,0,0,0,0,0,66.31 ,66.29 ,66.31 
03,012,01,002,0085,229,586,5,591,899,0,0,0,0,0,0,0,66.31 ,65.74 ,66.31 
03,012,01,002,0085,230,545,12,557,873,0,0,0,0,0,0,0,66.31 ,63.80 ,66.31 
03,012,01,002,0086,231,791,10,801,1126,0,0,0,0,0,0,0,66.31 ,71.14 ,66.31 
03,012,01,002,0086,232,767,10,777,1079,0,0,0,0,0,0,0,66.31 ,72.01 ,66.31 
03,012,01,002,0087,233,944,15,959,1317,0,0,0,0,0,0,0,66.31 ,72.82 ,66.31 
03,012,01,002,0087,234,867,13,880,1152,0,0,0,0,0,0,0,66.31 ,76.39 ,66.31 
03,012,01,002,0088,235,672,8,680,888,0,0,0,0,0,0,0,66.31 ,76.58 ,66.31 
03,012,01,002,0088,236,629,7,636,825,0,0,0,0,0,0,0,66.31 ,77.09 ,66.31 
03,012,01,002,0089,237,650,5,655,927,0,0,0,0,0,0,0,66.31 ,70.66 ,66.31 
03,012,01,002,0089,238,669,7,676,936,0,0,0,0,0,0,0,66.31 ,72.22 ,66.31 
03,012,01,002,0089,239,634,12,646,846,0,0,0,0,0,0,0,66.31 ,76.36 ,66.31 
03,012,01,002,0090,240,608,2,610,803,0,0,0,0,0,0,0,66.31 ,75.97 ,66.31 
03,012,01,002,0090,241,723,5,728,962,0,0,0,0,0,0,0,66.31 ,75.68 ,66.31 
03,012,01,002,0090,242,566,9,575,800,0,0,0,0,0,0,0,66.31 ,71.88 ,66.31 
03,012,01,002,0091,243,968,5,973,1220,0,0,0,0,0,0,0,66.31 ,79.75 ,66.31 
03,012,01,002,0092,244,521,2,523,753,0,0,0,0,0,0,0,66.31 ,69.46 ,66.31 
03,012,01,002,0092,245,593,8,601,765,0,0,0,0,0,0,0,66.31 ,78.56 ,66.31 
03,012,01,002,0093,246,587,11,598,807,0,0,0,0,0,0,0,66.31 ,74.10 ,66.31 
03,012,01,002,0093,247,763,10,773,1071,0,0,0,0,0,0,0,66.31 ,72.18 ,66.31 
03,012,01,002,0094,248,603,5,608,873,0,0,0,0,0,0,0,66.31 ,69.64 ,66.31 
03,012,01,002,0094,249,754,6,760,1029,0,0,0,0,0,0,0,66.31 ,73.86 ,66.31 
03,012,01,002,0094,250,824,10,834,1154,0,0,0,0,0,0,0,66.31 ,72.27 ,66.31 
03,012,01,002,0095,251,579,7,586,802,0,0,0,0,0,0,0,66.31 ,73.07 ,66.31 
03,012,01,002,0095,252,565,5,570,757,0,0,0,0,0,0,0,66.31 ,75.30 ,66.31 
03,012,01,002,0096,253,869,10,879,1226,0,0,0,0,0,0,0,66.31 ,71.70 ,66.31 
03,012,01,002,0097,254,891,12,903,1346,0,0,0,0,0,0,0,66.31 ,67.09 ,66.31 
03,012,01,002,0097,255,850,11,861,1176,0,0,0,0,0,0,0,66.31 ,73.21 ,66.31 
03,012,01,002,0098,256,645,7,652,920,0,0,0,0,0,0,0,66.31 ,70.87 ,66.31 
03,012,01,002,0098,257,557,7,564,763,0,0,0,0,0,0,0,66.31 ,73.92 ,66.31 
03,012,01,002,0099,258,613,8,621,778,0,0,0,0,0,0,0,66.31 ,79.82 ,66.31 
03,012,01,002,0099,259,638,3,641,851,0,0,0,0,0,0,0,66.31 ,75.32 ,66.31 
03,012,01,002,0100,260,640,6,646,904,0,0,0,0,0,0,0,66.31 ,71.46 ,66.31 
03,012,01,002,0101,261,528,7,535,743,0,0,0,0,0,0,0,66.31 ,72.01 ,66.31 
03,012,01,002,0102,262,761,4,765,1104,0,0,0,0,0,0,0,66.31 ,69.29 ,66.31 
03,012,01,002,0102,263,649,7,656,1000,0,0,0,0,0,0,0,66.31 ,65.60 ,66.31 
03,012,01,002,0103,264,398,6,404,615,0,0,0,0,0,0,0,66.31 ,65.69 ,66.31 
03,012,01,002,0103,265,586,4,590,888,0,0,0,0,0,0,0,66.31 ,66.44 ,66.31 
03,012,01,003,0104,266,713,10,723,923,0,0,0,0,0,0,0,66.31 ,78.33 ,66.31 
03,012,01,003,0104,267,722,14,736,1038,0,0,0,0,0,0,0,66.31 ,70.91 ,66.31 
03,012,01,003,0105,268,982,15,997,1283,0,0,0,0,0,0,0,66.31 ,77.71 ,66.31 
03,012,01,003,0106,269,471,7,478,676,0,0,0,0,0,0,0,66.31 ,70.71 ,66.31 
03,012,01,003,0106,270,591,12,603,808,0,0,0,0,0,0,0,66.31 ,74.63 ,66.31 
03,012,01,003,0107,271,649,17,666,1026,0,0,0,0,0,0,0,66.31 ,64.91 ,66.31 
03,012,01,003,0107,272,659,8,667,996,0,0,0,0,0,0,0,66.31 ,66.97 ,66.31 
03,012,01,003,0107,273,572,5,577,884,0,0,0,0,0,0,0,66.31 ,65.27 ,66.31 
03,012,01,003,0107,274,673,6,679,1038,0,0,0,0,0,0,0,66.31 ,65.41 ,66.31 
03,012,01,003,0107,275,592,6,598,908,0,0,0,0,0,0,0,66.31 ,65.86 ,66.31 
03,012,01,003,0107,276,656,4,660,967,0,0,0,0,0,0,0,66.31 ,68.25 ,66.31 
03,012,01,003,0107,277,685,7,692,992,0,0,0,0,0,0,0,66.31 ,69.76 ,66.31 
03,012,01,003,0107,278,663,3,666,1009,0,0,0,0,0,0,0,66.31 ,66.01 ,66.31 
03,012,01,003,0108,279,816,16,832,1222,0,0,0,0,0,0,0,66.31 ,68.09 ,66.31 
03,012,01,003,0108,280,747,7,754,1092,0,0,0,0,0,0,0,66.31 ,69.05 ,66.31 
03,012,01,003,0108,281,748,9,757,1154,0,0,0,0,0,0,0,66.31 ,65.60 ,66.31 
03,012,01,003,0108,282,721,7,728,1171,0,0,0,0,0,0,0,66.31 ,62.17 ,66.31 
03,012,01,003,0109,283,698,11,709,923,0,0,0,0,0,0,0,66.31 ,76.81 ,66.31 
03,012,01,003,0109,284,666,6,672,934,0,0,0,0,0,0,0,66.31 ,71.95 ,66.31 
03,012,01,003,0110,285,942,21,963,1362,0,0,0,0,0,0,0,66.31 ,70.70 ,66.31 
03,012,01,003,0110,286,833,9,842,1232,0,0,0,0,0,0,0,66.31 ,68.34 ,66.31 
03,012,01,003,0110,287,1012,7,1019,1561,0,0,0,0,0,0,0,66.31 ,65.28 ,66.31 
03,012,01,003,0110,288,927,10,937,1354,0,0,0,0,0,0,0,66.31 ,69.20 ,66.31 
03,012,01,003,0111,289,919,9,928,1281,0,0,0,0,0,0,0,66.31 ,72.44 ,66.31 
03,012,01,003,0111,290,824,12,836,1140,0,0,0,0,0,0,0,66.31 ,73.33 ,66.31 
03,012,01,003,0112,291,774,9,783,1084,0,0,0,0,0,0,0,66.31 ,72.23 ,66.31 
03,012,01,003,0112,292,778,12,790,1059,0,0,0,0,0,0,0,66.31 ,74.60 ,66.31 
03,012,01,003,0113,293,632,3,635,858,0,0,0,0,0,0,0,66.31 ,74.01 ,66.31 
03,012,01,003,0113,294,709,10,719,970,0,0,0,0,0,0,0,66.31 ,74.12 ,66.31 
03,012,01,003,0113,295,770,4,774,1045,0,0,0,0,0,0,0,66.31 ,74.07 ,66.31 
03,012,01,003,0113,296,701,6,707,925,0,0,0,0,0,0,0,66.31 ,76.43 ,66.31 
03,012,01,003,0114,297,906,11,917,1161,0,0,0,0,0,0,0,66.31 ,78.98 ,66.31 
03,012,01,003,0114,298,760,10,770,1044,0,0,0,0,0,0,0,66.31 ,73.75 ,66.31 
03,012,01,003,0115,299,566,7,573,827,0,0,0,0,0,0,0,66.31 ,69.29 ,66.31 
03,012,01,003,0115,300,578,3,581,813,0,0,0,0,0,0,0,66.31 ,71.46 ,66.31 
03,012,01,003,0115,301,897,8,905,1201,0,0,0,0,0,0,0,66.31 ,75.35 ,66.31 
03,012,01,003,0116,302,1144,9,1153,1674,0,0,0,0,0,0,0,66.31 ,68.88 ,66.31 
03,012,01,003,0116,303,596,10,606,862,0,0,0,0,0,0,0,66.31 ,70.30 ,66.31 
03,012,01,003,0116,304,972,9,981,1380,0,0,0,0,0,0,0,66.31 ,71.09 ,66.31 
03,012,01,003,0116,305,966,6,972,1428,0,0,0,0,0,0,0,66.31 ,68.07 ,66.31 
03,012,01,003,0117,306,843,14,857,1174,0,0,0,0,0,0,0,66.31 ,73.00 ,66.31 
03,012,01,003,0117,307,922,11,933,1379,0,0,0,0,0,0,0,66.31 ,67.66 ,66.31 
03,012,01,003,0117,308,727,13,740,1257,0,0,0,0,0,0,0,66.31 ,58.87 ,66.31 
03,012,01,003,0117,309,768,14,782,1223,0,0,0,0,0,0,0,66.31 ,63.94 ,66.31 
03,012,01,003,0118,310,639,8,647,948,0,0,0,0,0,0,0,66.31 ,68.25 ,66.31 
03,012,01,003,0118,311,716,9,725,1027,0,0,0,0,0,0,0,66.31 ,70.59 ,66.31 
03,012,01,003,0118,312,891,11,902,1379,0,0,0,0,0,0,0,66.31 ,65.41 ,66.31 
03,012,01,003,0118,313,687,7,694,944,0,0,0,0,0,0,0,66.31 ,73.52 ,66.31 
03,012,01,003,0119,314,895,9,904,1243,0,0,0,0,0,0,0,66.31 ,72.73 ,66.31 
03,012,01,003,0119,315,883,11,894,1230,0,0,0,0,0,0,0,66.31 ,72.68 ,66.31 
03,012,01,003,0119,316,810,8,818,1190,0,0,0,0,0,0,0,66.31 ,68.74 ,66.31 
03,012,01,003,0120,317,775,5,780,1043,0,0,0,0,0,0,0,66.31 ,74.78 ,66.31 
03,012,01,003,0120,318,640,4,644,876,0,0,0,0,0,0,0,66.31 ,73.52 ,66.31 
03,012,01,003,0121,319,781,12,793,1206,0,0,0,0,0,0,0,66.31 ,65.75 ,66.31 
03,012,01,003,0121,320,826,20,846,1356,0,0,0,0,0,0,0,66.31 ,62.39 ,66.31 
03,012,01,003,0121,321,830,4,834,1252,0,0,0,0,0,0,0,66.31 ,66.61 ,66.31 
03,012,01,003,0121,322,737,12,749,1189,0,0,0,0,0,0,0,66.31 ,62.99 ,66.31 
03,012,01,003,0122,323,893,16,909,1198,0,0,0,0,0,0,0,66.31 ,75.88 ,66.31 
03,012,01,003,0123,324,799,19,818,1403,0,0,0,0,0,0,0,66.31 ,58.30 ,66.31 
03,012,01,003,0123,325,888,6,894,1277,0,0,0,0,0,0,0,66.31 ,70.01 ,66.31 
03,012,01,003,0123,326,312,5,317,449,0,0,0,0,0,0,0,66.31 ,70.60 ,66.31 
03,012,01,003,0124,327,1021,14,1035,1337,0,0,0,0,0,0,0,66.31 ,77.41 ,66.31 
03,012,01,003,0125,328,683,13,696,982,0,0,0,0,0,0,0,66.31 ,70.88 ,66.31 
03,012,01,003,0125,329,461,6,467,617,0,0,0,0,0,0,0,66.31 ,75.69 ,66.31 
03,012,01,003,0126,330,982,13,995,1271,0,0,0,0,0,0,0,66.31 ,78.28 ,66.31 
03,012,01,003,0126,331,922,8,930,1208,0,0,0,0,0,0,0,66.31 ,76.99 ,66.31 
03,012,01,003,0127,332,940,13,953,1202,0,0,0,0,0,0,0,66.31 ,79.28 ,66.31 
03,012,01,003,0128,333,951,11,962,1376,0,0,0,0,0,0,0,66.31 ,69.91 ,66.31 
03,012,01,003,0128,334,915,6,921,1319,0,0,0,0,0,0,0,66.31 ,69.83 ,66.31 
03,012,01,003,0129,335,644,8,652,953,0,0,0,0,0,0,0,66.31 ,68.42 ,66.31 
03,012,01,003,0129,336,570,10,580,789,0,0,0,0,0,0,0,66.31 ,73.51 ,66.31 
03,012,01,004,0130,337,914,7,921,1192,0,0,0,0,0,0,0,66.31 ,77.27 ,66.31 
03,012,01,004,0131,338,546,4,550,724,0,0,0,0,0,0,0,66.31 ,75.97 ,66.31 
03,012,01,004,0131,339,591,5,596,796,0,0,0,0,0,0,0,66.31 ,74.87 ,66.31 
03,012,01,004,0132,340,789,3,792,1099,0,0,0,0,0,0,0,66.31 ,72.07 ,66.31 
03,012,01,004,0132,341,743,6,749,1047,0,0,0,0,0,0,0,66.31 ,71.54 ,66.31 
03,012,01,004,0133,342,795,7,802,1124,0,0,0,0,0,0,0,66.31 ,71.35 ,66.31 
03,012,01,004,0133,343,596,6,602,850,0,0,0,0,0,0,0,66.31 ,70.82 ,66.31 
03,012,01,004,0133,344,739,9,748,1030,0,0,0,0,0,0,0,66.31 ,72.62 ,66.31 
03,012,01,004,0134,345,777,8,785,1066,0,0,0,0,0,0,0,66.31 ,73.64 ,66.31 
03,012,01,004,0135,346,695,3,698,950,0,0,0,0,0,0,0,66.31 ,73.47 ,66.31 
03,012,01,004,0136,347,771,8,779,1029,0,0,0,0,0,0,0,66.31 ,75.70 ,66.31 
03,012,01,004,0137,348,628,4,632,866,0,0,0,0,0,0,0,66.31 ,72.98 ,66.31 
03,012,01,004,0138,349,883,5,888,1263,0,0,0,0,0,0,0,66.31 ,70.31 ,66.31 
03,012,01,004,0139,350,633,8,641,822,0,0,0,0,0,0,0,66.31 ,77.98 ,66.31 
03,012,01,004,0140,351,699,10,709,972,0,0,0,0,0,0,0,66.31 ,72.94 ,66.31 
03,012,01,004,0140,352,662,9,671,1008,0,0,0,0,0,0,0,66.31 ,66.57 ,66.31 
03,012,01,004,0141,353,773,6,779,1137,0,0,0,0,0,0,0,66.31 ,68.51 ,66.31 
03,012,01,004,0141,354,846,13,859,1177,0,0,0,0,0,0,0,66.31 ,72.98 ,66.31 
03,012,01,004,0141,355,903,16,919,1393,0,0,0,0,0,0,0,66.31 ,65.97 ,66.31 
03,012,01,004,0142,356,1015,14,1029,1446,0,0,0,0,0,0,0,66.31 ,71.16 ,66.31 
03,012,01,004,0142,357,784,5,789,1093,0,0,0,0,0,0,0,66.31 ,72.19 ,66.31 
03,012,01,004,0142,358,1026,19,1045,1426,0,0,0,0,0,0,0,66.31 ,73.28 ,66.31 
03,012,01,004,0143,359,803,6,809,1059,0,0,0,0,0,0,0,66.31 ,76.39 ,66.31 
03,012,01,004,0143,360,702,8,710,1041,0,0,0,0,0,0,0,66.31 ,68.20 ,66.31 
03,012,01,004,0144,361,838,6,844,1108,0,0,0,0,0,0,0,66.31 ,76.17 ,66.31 
03,012,01,004,0144,362,841,6,847,1144,0,0,0,0,0,0,0,66.31 ,74.04 ,66.31 
03,012,01,004,0145,363,583,4,587,782,0,0,0,0,0,0,0,66.31 ,75.06 ,66.31 
03,012,01,004,0145,364,569,5,574,766,0,0,0,0,0,0,0,66.31 ,74.93 ,66.31 
03,012,01,004,0146,365,757,7,764,1032,0,0,0,0,0,0,0,66.31 ,74.03 ,66.31 
03,012,01,004,0147,366,712,10,722,952,0,0,0,0,0,0,0,66.31 ,75.84 ,66.31 
03,012,01,004,0147,367,626,7,633,957,0,0,0,0,0,0,0,66.31 ,66.14 ,66.31 
03,012,01,004,0148,368,491,5,496,686,0,0,0,0,0,0,0,66.31 ,72.30 ,66.31 
03,012,01,005,0149,369,685,8,693,936,0,0,0,0,0,0,0,66.31 ,74.04 ,66.31 
03,012,01,005,0150,370,781,8,789,1026,0,0,0,0,0,0,0,66.31 ,76.90 ,66.31 
03,012,01,005,0150,371,466,3,469,731,0,0,0,0,0,0,0,66.31 ,64.16 ,66.31 
03,012,01,005,0151,372,617,13,630,949,0,0,0,0,0,0,0,66.31 ,66.39 ,66.31 
03,012,01,005,0151,373,625,6,631,884,0,0,0,0,0,0,0,66.31 ,71.38 ,66.31 
03,012,01,005,0151,374,690,11,701,1025,0,0,0,0,0,0,0,66.31 ,68.39 ,66.31 
03,012,01,005,0151,375,595,13,608,869,0,0,0,0,0,0,0,66.31 ,69.97 ,66.31 
03,012,01,005,0152,376,771,12,783,1127,0,0,0,0,0,0,0,66.31 ,69.48 ,66.31 
03,012,01,005,0152,377,886,14,900,1225,0,0,0,0,0,0,0,66.31 ,73.47 ,66.31 
03,012,01,005,0153,378,1079,18,1097,1511,0,0,0,0,0,0,0,66.31 ,72.60 ,66.31 
03,012,01,005,0153,379,704,13,717,1013,0,0,0,0,0,0,0,66.31 ,70.78 ,66.31 
03,012,01,005,0154,380,655,8,663,938,0,0,0,0,0,0,0,66.31 ,70.68 ,66.31 
03,012,01,005,0154,381,788,13,801,1201,0,0,0,0,0,0,0,66.31 ,66.69 ,66.31 
03,012,01,005,0154,382,704,10,714,1052,0,0,0,0,0,0,0,66.31 ,67.87 ,66.31 
03,012,01,005,0154,383,718,7,725,1085,0,0,0,0,0,0,0,66.31 ,66.82 ,66.31 
03,012,01,005,0155,384,712,18,730,1121,0,0,0,0,0,0,0,66.31 ,65.12 ,66.31 
03,012,01,005,0155,385,809,11,820,1202,0,0,0,0,0,0,0,66.31 ,68.22 ,66.31 
03,012,01,005,0155,386,669,8,677,1041,0,0,0,0,0,0,0,66.31 ,65.03 ,66.31 
03,012,01,005,0156,387,971,13,984,1303,0,0,0,0,0,0,0,66.31 ,75.52 ,66.31 
03,012,01,005,0156,388,753,15,768,1089,0,0,0,0,0,0,0,66.31 ,70.52 ,66.31 
03,012,01,005,0157,389,938,12,950,1286,0,0,0,0,0,0,0,66.31 ,73.87 ,66.31 
03,012,01,006,0158,390,904,7,911,1291,0,0,0,0,0,0,0,66.31 ,70.57 ,66.31 
03,012,01,006,0158,391,860,18,878,1232,0,0,0,0,0,0,0,66.31 ,71.27 ,66.31 
03,012,01,006,0158,392,958,11,969,1360,0,0,0,0,0,0,0,66.31 ,71.25 ,66.31 
03,012,01,006,0159,393,739,14,753,1081,0,0,0,0,0,0,0,66.31 ,69.66 ,66.31 
03,012,01,006,0159,394,836,16,852,1275,0,0,0,0,0,0,0,66.31 ,66.82 ,66.31 
03,012,01,006,0159,395,657,8,665,872,0,0,0,0,0,0,0,66.31 ,76.26 ,66.31 
03,012,01,006,0160,396,660,11,671,954,0,0,0,0,0,0,0,66.31 ,70.34 ,66.31 
03,012,01,006,0160,397,664,7,671,978,0,0,0,0,0,0,0,66.31 ,68.61 ,66.31 
03,012,01,006,0161,398,724,7,731,1065,0,0,0,0,0,0,0,66.31 ,68.64 ,66.31 
03,012,01,006,0161,399,739,13,752,1049,0,0,0,0,0,0,0,66.31 ,71.69 ,66.31 
03,012,01,006,0162,400,805,14,819,1269,0,0,0,0,0,0,0,66.31 ,64.54 ,66.31 
03,012,01,006,0163,401,857,12,869,1316,0,0,0,0,0,0,0,66.31 ,66.03 ,66.31 
03,012,01,006,0163,402,690,12,702,1080,0,0,0,0,0,0,0,66.31 ,65.00 ,66.31 
03,012,01,006,0163,403,750,21,771,1133,0,0,0,0,0,0,0,66.31 ,68.05 ,66.31 
03,012,01,006,0164,404,602,10,612,927,0,0,0,0,0,0,0,66.31 ,66.02 ,66.31 
03,012,01,006,0164,405,594,14,608,833,0,0,0,0,0,0,0,66.31 ,72.99 ,66.31 
03,012,01,006,0165,406,576,14,590,865,0,0,0,0,0,0,0,66.31 ,68.21 ,66.31 
03,012,01,006,0165,407,600,17,617,774,0,0,0,0,0,0,0,66.31 ,79.72 ,66.31 
03,012,01,006,0166,408,946,15,961,1427,0,0,0,0,0,0,0,66.31 ,67.34 ,66.31 
03,012,01,006,0167,409,915,13,928,1302,0,0,0,0,0,0,0,66.31 ,71.27 ,66.31 
03,012,01,006,0168,410,518,7,525,750,0,0,0,0,0,0,0,66.31 ,70.00 ,66.31 
03,012,01,006,0168,411,491,7,498,799,0,0,0,0,0,0,0,66.31 ,62.33 ,66.31 
03,012,01,006,0169,412,889,11,900,1323,0,0,0,0,0,0,0,66.31 ,68.03 ,66.31 
03,012,01,006,0169,413,815,22,837,1252,0,0,0,0,0,0,0,66.31 ,66.85 ,66.31 
03,012,01,006,0170,414,708,10,718,1056,0,0,0,0,0,0,0,66.31 ,67.99 ,66.31 
03,012,01,006,0171,415,900,12,912,1315,0,0,0,0,0,0,0,66.31 ,69.35 ,66.31 
03,012,01,006,0171,416,786,8,794,1174,0,0,0,0,0,0,0,66.31 ,67.63 ,66.31 
03,012,01,006,0172,417,1102,10,1112,1466,0,0,0,0,0,0,0,66.31 ,75.85 ,66.31 
03,012,01,006,0172,418,656,17,673,1005,0,0,0,0,0,0,0,66.31 ,66.97 ,66.31 
03,012,01,006,0173,419,339,6,345,469,0,0,0,0,0,0,0,66.31 ,73.56 ,66.31 
03,012,01,007,0174,420,1046,13,1059,1612,0,0,0,0,0,0,0,66.31 ,65.69 ,66.31 
03,012,01,007,0174,421,1062,8,1070,1584,0,0,0,0,0,0,0,66.31 ,67.55 ,66.31 
03,012,01,007,0174,422,946,8,954,1737,0,0,0,0,0,0,0,66.31 ,54.92 ,66.31 
03,012,01,007,0174,423,950,17,967,1364,0,0,0,0,0,0,0,66.31 ,70.89 ,66.31 
03,012,01,007,0175,424,882,6,888,1092,0,0,0,0,0,0,0,66.31 ,81.32 ,66.31 
03,012,01,007,0175,425,686,9,695,941,0,0,0,0,0,0,0,66.31 ,73.86 ,66.31 
03,012,01,007,0176,426,847,9,856,1184,0,0,0,0,0,0,0,66.31 ,72.30 ,66.31 
03,012,01,007,0176,427,1205,18,1223,1917,0,0,0,0,0,0,0,66.31 ,63.80 ,66.31 
03,012,01,007,0176,428,1098,11,1109,1797,0,0,0,0,0,0,0,66.31 ,61.71 ,66.31 
03,012,01,007,0176,429,884,9,893,1419,0,0,0,0,0,0,0,66.31 ,62.93 ,66.31 
03,012,01,007,0177,430,935,8,943,1216,0,0,0,0,0,0,0,66.31 ,77.55 ,66.31 
03,012,01,007,0177,431,930,13,943,1252,0,0,0,0,0,0,0,66.31 ,75.32 ,66.31 
03,012,01,007,0178,432,1040,10,1050,1392,0,0,0,0,0,0,0,66.31 ,75.43 ,66.31 
03,012,01,007,0178,433,1067,13,1080,1331,0,0,0,0,0,0,0,66.31 ,81.14 ,66.31 
03,012,01,007,0178,434,897,10,907,1241,0,0,0,0,0,0,0,66.31 ,73.09 ,66.31 
03,012,01,007,0178,435,847,8,855,1244,0,0,0,0,0,0,0,66.31 ,68.73 ,66.31 
03,012,01,007,0179,436,939,14,953,1260,0,0,0,0,0,0,0,66.31 ,75.63 ,66.31 
03,012,01,007,0179,437,1177,12,1189,1659,0,0,0,0,0,0,0,66.31 ,71.67 ,66.31 
03,012,01,007,0180,438,491,10,501,628,0,0,0,0,0,0,0,66.31 ,79.78 ,66.31 
03,012,01,008,0181,439,847,8,855,1215,0,0,0,0,0,0,0,66.31 ,70.37 ,66.31 
03,012,01,008,0181,440,697,13,710,1096,0,0,0,0,0,0,0,66.31 ,64.78 ,66.31 
03,012,01,008,0181,441,726,8,734,1060,0,0,0,0,0,0,0,66.31 ,69.25 ,66.31 
03,012,01,008,0182,442,895,9,904,1275,0,0,0,0,0,0,0,66.31 ,70.90 ,66.31 
03,012,01,008,0183,443,736,12,748,1133,0,0,0,0,0,0,0,66.31 ,66.02 ,66.31 
03,012,01,008,0183,444,668,9,677,1006,0,0,0,0,0,0,0,66.31 ,67.30 ,66.31 
03,012,01,008,0183,445,469,11,480,695,0,0,0,0,0,0,0,66.31 ,69.06 ,66.31 
03,012,01,008,0184,446,431,2,433,661,0,0,0,0,0,0,0,66.31 ,65.51 ,66.31 
03,012,01,008,0184,447,480,9,489,659,0,0,0,0,0,0,0,66.31 ,74.20 ,66.31 
03,012,01,008,0185,448,842,8,850,1194,0,0,0,0,0,0,0,66.31 ,71.19 ,66.31 
03,012,01,008,0186,449,820,10,830,1138,0,0,0,0,0,0,0,66.31 ,72.93 ,66.31 
03,012,01,008,0187,450,833,18,851,1163,0,0,0,0,0,0,0,66.31 ,73.17 ,66.31 
03,012,01,008,0187,451,809,9,818,1266,0,0,0,0,0,0,0,66.31 ,64.61 ,66.31 
03,012,01,008,0188,452,934,8,942,1388,0,0,0,0,0,0,0,66.31 ,67.87 ,66.31 
03,012,01,008,0188,453,791,12,803,1222,0,0,0,0,0,0,0,66.31 ,65.71 ,66.31 
03,012,01,008,0189,454,996,21,1017,1420,0,0,0,0,0,0,0,66.31 ,71.62 ,66.31 
03,012,01,008,0189,455,734,6,740,1142,0,0,0,0,0,0,0,66.31 ,64.80 ,66.31 
03,012,01,008,0190,456,755,12,767,1196,0,0,0,0,0,0,0,66.31 ,64.13 ,66.31 
03,012,01,008,0190,457,758,13,771,1168,0,0,0,0,0,0,0,66.31 ,66.01 ,66.31 
03,012,01,008,0190,458,671,11,682,1013,0,0,0,0,0,0,0,66.31 ,67.32 ,66.31 
03,012,01,008,0191,459,981,15,996,1410,0,0,0,0,0,0,0,66.31 ,70.64 ,66.31 
03,012,01,008,0191,460,934,9,943,1346,0,0,0,0,0,0,0,66.31 ,70.06 ,66.31 
03,012,01,008,0192,461,464,8,472,568,0,0,0,0,0,0,0,66.31 ,83.10 ,66.31 
03,012,01,008,0193,462,672,8,680,976,0,0,0,0,0,0,0,66.31 ,69.67 ,66.31 
03,012,01,008,0193,463,963,14,977,1439,0,0,0,0,0,0,0,66.31 ,67.89 ,66.31 
03,012,01,008,0194,464,1134,23,1157,1616,0,0,0,0,0,0,0,66.31 ,71.60 ,66.31 
03,012,01,008,0195,465,711,11,722,1013,0,0,0,0,0,0,0,66.31 ,71.27 ,66.31 
03,012,01,008,0195,466,684,7,691,968,0,0,0,0,0,0,0,66.31 ,71.38 ,66.31 
03,012,01,008,0195,467,813,12,825,1198,0,0,0,0,0,0,0,66.31 ,68.86 ,66.31 
03,012,01,008,0196,468,812,11,823,1195,0,0,0,0,0,0,0,66.31 ,68.87 ,66.31 
03,012,01,008,0196,469,819,11,830,1208,0,0,0,0,0,0,0,66.31 ,68.71 ,66.31 
03,012,01,008,0196,470,392,6,398,529,0,0,0,0,0,0,0,66.31 ,75.24 ,66.31 
03,012,01,008,0197,471,975,8,983,1259,0,0,0,0,0,0,0,66.31 ,78.08 ,66.31 
03,012,01,008,0198,472,679,10,689,1046,0,0,0,0,0,0,0,66.31 ,65.87 ,66.31 
03,012,01,008,0198,473,669,6,675,932,0,0,0,0,0,0,0,66.31 ,72.42 ,66.31 
03,012,01,008,0198,474,648,7,655,1015,0,0,0,0,0,0,0,66.31 ,64.53 ,66.31 
03,012,01,008,0198,475,830,10,840,1289,0,0,0,0,0,0,0,66.31 ,65.17 ,66.31 
03,012,01,008,0199,476,773,6,779,1067,0,0,0,0,0,0,0,66.31 ,73.01 ,66.31 
03,012,01,008,0199,477,543,9,552,763,0,0,0,0,0,0,0,66.31 ,72.35 ,66.31 
03,012,01,008,0200,478,885,18,903,1265,0,0,0,0,0,0,0,66.31 ,71.38 ,66.31 
03,012,01,008,0201,479,560,5,565,721,0,0,0,0,0,0,0,66.31 ,78.36 ,66.31 
03,012,01,008,0202,480,909,11,920,1179,0,0,0,0,0,0,0,66.31 ,78.03 ,66.31 
03,012,01,008,0203,481,730,6,736,986,0,0,0,0,0,0,0,66.31 ,74.65 ,66.31 
03,012,01,008,0204,482,746,9,755,1013,0,0,0,0,0,0,0,66.31 ,74.53 ,66.31 
03,012,01,008,0204,483,729,11,740,1003,0,0,0,0,0,0,0,66.31 ,73.78 ,66.31 
03,012,01,008,0204,484,744,11,755,1051,0,0,0,0,0,0,0,66.31 ,71.84 ,66.31 
03,012,01,008,0205,485,967,5,972,1258,0,0,0,0,0,0,0,66.31 ,77.27 ,66.31 
03,012,01,008,0205,486,253,5,258,306,0,0,0,0,0,0,0,66.31 ,84.31 ,66.31 
03,012,01,008,0206,487,575,10,585,717,0,0,0,0,0,0,0,66.31 ,81.59 ,66.31 
03,012,01,008,0207,488,1028,11,1039,1259,0,0,0,0,0,0,0,66.31 ,82.53 ,66.31 
03,012,01,008,0208,489,534,9,543,707,0,0,0,0,0,0,0,66.31 ,76.80 ,66.31 
03,012,01,008,0209,490,625,11,636,819,0,0,0,0,0,0,0,66.31 ,77.66 ,66.31 
03,012,01,008,0210,491,663,4,667,958,0,0,0,0,0,0,0,66.31 ,69.62 ,66.31 
03,012,01,008,0211,492,650,6,656,943,0,0,0,0,0,0,0,66.31 ,69.57 ,66.31 
03,012,01,008,0212,493,685,5,690,976,0,0,0,0,0,0,0,66.31 ,70.70 ,66.31 
03,012,01,008,0212,494,779,7,786,1140,0,0,0,0,0,0,0,66.31 ,68.95 ,66.31 
03,012,01,008,0213,495,419,2,421,610,0,0,0,0,0,0,0,66.31 ,69.02 ,66.31 
03,012,01,008,0213,496,568,6,574,784,0,0,0,0,0,0,0,66.31 ,73.21 ,66.31 
03,012,01,008,0214,497,440,4,444,593,0,0,0,0,0,0,0,66.31 ,74.87 ,66.31 
03,012,01,008,0214,498,565,2,567,746,0,0,0,0,0,0,0,66.31 ,76.01 ,66.31 
03,012,01,008,0215,499,362,3,365,508,0,0,0,0,0,0,0,66.31 ,71.85 ,66.31 
03,012,01,009,0216,500,615,12,627,903,0,0,0,0,0,0,0,66.31 ,69.44 ,66.31 
03,012,01,009,0216,501,419,2,421,587,0,0,0,0,0,0,0,66.31 ,71.72 ,66.31 
03,012,01,009,0217,502,651,8,659,891,0,0,0,0,0,0,0,66.31 ,73.96 ,66.31 
03,012,01,009,0218,503,237,5,242,321,0,0,0,0,0,0,0,66.31 ,75.39 ,66.31 
03,012,01,009,0219,504,655,11,666,934,0,0,0,0,0,0,0,66.31 ,71.31 ,66.31 
03,012,01,009,0219,505,850,6,856,1250,0,0,0,0,0,0,0,66.31 ,68.48 ,66.31 
03,012,01,009,0220,506,702,8,710,1031,0,0,0,0,0,0,0,66.31 ,68.87 ,66.31 
03,012,01,009,0220,507,735,12,747,1049,0,0,0,0,0,0,0,66.31 ,71.21 ,66.31 
03,012,01,009,0221,508,725,9,734,1066,0,0,0,0,0,0,0,66.31 ,68.86 ,66.31 
03,012,01,009,0221,509,740,9,749,1063,0,0,0,0,0,0,0,66.31 ,70.46 ,66.31 
03,012,01,009,0221,510,613,1,614,873,0,0,0,0,0,0,0,66.31 ,70.33 ,66.31 
03,012,01,009,0222,511,547,5,552,745,0,0,0,0,0,0,0,66.31 ,74.09 ,66.31 
03,012,01,009,0222,512,270,4,274,318,0,0,0,0,0,0,0,66.31 ,86.16 ,66.31 
03,012,01,009,0222,513,137,2,139,187,0,0,0,0,0,0,0,66.31 ,74.33 ,66.31 
03,012,01,009,0223,514,825,14,839,1088,0,0,0,0,0,0,0,66.31 ,77.11 ,66.31 
03,012,01,009,0223,515,595,6,601,868,0,0,0,0,0,0,0,66.31 ,69.24 ,66.31 
03,012,01,009,0224,516,765,13,778,1065,0,0,0,0,0,0,0,66.31 ,73.05 ,66.31 
03,012,01,009,0224,517,700,12,712,956,0,0,0,0,0,0,0,66.31 ,74.48 ,66.31 
03,012,01,009,0225,518,738,9,747,1012,0,0,0,0,0,0,0,66.31 ,73.81 ,66.31 
03,012,01,009,0226,519,801,7,808,1175,0,0,0,0,0,0,0,66.31 ,68.77 ,66.31 
03,012,01,009,0226,520,639,11,650,900,0,0,0,0,0,0,0,66.31 ,72.22 ,66.31 
03,012,01,009,0226,521,323,4,327,397,0,0,0,0,0,0,0,66.31 ,82.37 ,66.31 
03,012,01,009,0227,522,809,6,815,1075,0,0,0,0,0,0,0,66.31 ,75.81 ,66.31 
03,012,01,009,0227,523,489,7,496,696,0,0,0,0,0,0,0,66.31 ,71.26 ,66.31 
03,012,01,009,0228,524,538,7,545,712,0,0,0,0,0,0,0,66.31 ,76.54 ,66.31 
03,012,01,009,0228,525,573,5,578,729,0,0,0,0,0,0,0,66.31 ,79.29 ,66.31 
03,012,01,009,0229,526,748,7,755,1004,0,0,0,0,0,0,0,66.31 ,75.20 ,66.31 
03,012,01,009,0229,527,791,8,799,1018,0,0,0,0,0,0,0,66.31 ,78.49 ,66.31 
03,012,01,009,0230,528,685,7,692,929,0,0,0,0,0,0,0,66.31 ,74.49 ,66.31 
03,012,01,009,0231,529,404,2,406,498,0,0,0,0,0,0,0,66.31 ,81.53 ,66.31 
03,012,01,009,0231,530,623,3,626,841,0,0,0,0,0,0,0,66.31 ,74.44 ,66.31 
03,012,01,009,0232,531,480,8,488,640,0,0,0,0,0,0,0,66.31 ,76.25 ,66.31 
03,012,01,010,0233,532,354,3,357,444,0,0,0,0,0,0,0,66.31 ,80.41 ,66.31 
03,012,01,010,0234,533,852,13,865,1102,0,0,0,0,0,0,0,66.31 ,78.49 ,66.31 
03,012,01,010,0235,534,936,17,953,1255,0,0,0,0,0,0,0,66.31 ,75.94 ,66.31 
03,012,01,010,0235,535,671,3,674,850,0,0,0,0,0,0,0,66.31 ,79.29 ,66.31 
03,012,01,010,0236,536,743,11,754,1000,0,0,0,0,0,0,0,66.31 ,75.40 ,66.31 
03,012,01,010,0236,537,664,2,666,883,0,0,0,0,0,0,0,66.31 ,75.42 ,66.31 
03,012,01,010,0236,538,734,7,741,992,0,0,0,0,0,0,0,66.31 ,74.70 ,66.31 
03,012,01,010,0237,539,988,13,1001,1297,0,0,0,0,0,0,0,66.31 ,77.18 ,66.31 
03,012,01,010,0237,540,933,11,944,1201,0,0,0,0,0,0,0,66.31 ,78.60 ,66.31 
03,012,01,010,0238,541,579,14,593,753,0,0,0,0,0,0,0,66.31 ,78.75 ,66.31 
03,012,01,010,0238,542,698,9,707,911,0,0,0,0,0,0,0,66.31 ,77.61 ,66.31 
03,012,01,010,0239,543,952,17,969,1234,0,0,0,0,0,0,0,66.31 ,78.53 ,66.31 
03,012,01,010,0239,544,1008,10,1018,1330,0,0,0,0,0,0,0,66.31 ,76.54 ,66.31 
03,012,01,010,0239,545,252,2,254,390,0,0,0,0,0,0,0,66.31 ,65.13 ,66.31 
03,012,01,010,0239,546,352,6,358,490,0,0,0,0,0,0,0,66.31 ,73.06 ,66.31 
03,012,01,010,0239,547,501,2,503,737,0,0,0,0,0,0,0,66.31 ,68.25 ,66.31 
03,012,01,010,0240,548,591,4,595,783,0,0,0,0,0,0,0,66.31 ,75.99 ,66.31 
03,012,01,010,0240,549,418,5,423,537,0,0,0,0,0,0,0,66.31 ,78.77 ,66.31 
03,012,01,010,0240,550,521,8,529,748,0,0,0,0,0,0,0,66.31 ,70.72 ,66.31 
03,012,01,010,0241,551,728,9,737,998,0,0,0,0,0,0,0,66.31 ,73.85 ,66.31 
03,012,01,010,0241,552,952,18,970,1221,0,0,0,0,0,0,0,66.31 ,79.44 ,66.31 
03,012,01,010,0242,553,649,10,659,917,0,0,0,0,0,0,0,66.31 ,71.86 ,66.31 
03,012,01,010,0242,554,598,12,610,821,0,0,0,0,0,0,0,66.31 ,74.30 ,66.31 
03,012,01,010,0243,555,882,13,895,1210,0,0,0,0,0,0,0,66.31 ,73.97 ,66.31 
03,012,01,010,0243,556,851,22,873,1235,0,0,0,0,0,0,0,66.31 ,70.69 ,66.31 
03,012,01,011,0244,557,287,1,288,384,0,0,0,0,0,0,0,66.31 ,75.00 ,66.31 
03,012,01,011,0245,558,509,4,513,680,0,0,0,0,0,0,0,66.31 ,75.44 ,66.31 
03,012,01,011,0246,559,769,6,775,997,0,0,0,0,0,0,0,66.31 ,77.73 ,66.31 
03,012,01,011,0247,560,299,3,302,423,0,0,0,0,0,0,0,66.31 ,71.39 ,66.31 
03,012,01,011,0248,561,659,15,674,937,0,0,0,0,0,0,0,66.31 ,71.93 ,66.31 
03,012,01,011,0249,562,566,13,579,829,0,0,0,0,0,0,0,66.31 ,69.84 ,66.31 
03,012,01,011,0249,563,410,6,416,566,0,0,0,0,0,0,0,66.31 ,73.50 ,66.31 
03,012,01,011,0250,564,270,4,274,414,0,0,0,0,0,0,0,66.31 ,66.18 ,66.31 
03,012,01,011,0251,565,332,2,334,471,0,0,0,0,0,0,0,66.31 ,70.91 ,66.31 
03,012,01,011,0252,566,690,5,695,1028,0,0,0,0,0,0,0,66.31 ,67.61 ,66.31 
03,012,01,011,0253,567,986,16,1002,1304,0,0,0,0,0,0,0,66.31 ,76.84 ,66.31 
03,012,01,012,0254,568,906,10,916,1390,0,0,0,0,0,0,0,66.31 ,65.90 ,66.31 
03,012,01,012,0254,569,839,15,854,1140,0,0,0,0,0,0,0,66.31 ,74.91 ,66.31 
03,012,01,012,0254,570,857,8,865,1278,0,0,0,0,0,0,0,66.31 ,67.68 ,66.31 
03,012,01,012,0255,571,959,22,981,1387,0,0,0,0,0,0,0,66.31 ,70.73 ,66.31 
03,012,01,012,0255,572,823,11,834,1181,0,0,0,0,0,0,0,66.31 ,70.62 ,66.31 
03,012,01,012,0256,573,945,12,957,1343,0,0,0,0,0,0,0,66.31 ,71.26 ,66.31 
03,012,01,012,0256,574,745,11,756,1058,0,0,0,0,0,0,0,66.31 ,71.46 ,66.31 
03,012,01,012,0257,575,579,8,587,850,0,0,0,0,0,0,0,66.31 ,69.06 ,66.31 
03,012,01,012,0257,576,726,11,737,1066,0,0,0,0,0,0,0,66.31 ,69.14 ,66.31 
03,012,01,012,0258,577,967,19,986,1285,0,0,0,0,0,0,0,66.31 ,76.73 ,66.31 
03,012,01,012,0259,578,806,21,827,1246,0,0,0,0,0,0,0,66.31 ,66.37 ,66.31 
03,012,01,012,0260,579,674,22,696,971,0,0,0,0,0,0,0,66.31 ,71.68 ,66.31 
03,012,01,012,0260,580,612,10,622,869,0,0,0,0,0,0,0,66.31 ,71.58 ,66.31 
03,012,01,012,0261,581,887,14,901,1116,0,0,0,0,0,0,0,66.31 ,80.73 ,66.31 
03,012,01,012,0262,582,931,13,944,1221,0,0,0,0,0,0,0,66.31 ,77.31 ,66.31 
03,012,01,012,0262,583,359,5,364,479,0,0,0,0,0,0,0,66.31 ,75.99 ,66.31 
03,012,01,012,0263,584,509,10,519,705,0,0,0,0,0,0,0,66.31 ,73.62 ,66.31 
03,012,01,012,0264,585,595,14,609,774,0,0,0,0,0,0,0,66.31 ,78.68 ,66.31 
03,012,01,012,0264,586,519,18,537,730,0,0,0,0,0,0,0,66.31 ,73.56 ,66.31 
03,012,01,012,0265,587,717,15,732,939,0,0,0,0,0,0,0,66.31 ,77.96 ,66.31 
03,012,01,013,0266,588,576,3,579,754,0,0,0,0,0,0,0,66.31 ,76.79 ,66.31 
03,012,01,013,0266,589,705,10,715,912,0,0,0,0,0,0,0,66.31 ,78.40 ,66.31 
03,012,01,013,0267,590,970,12,982,1218,0,0,0,0,0,0,0,66.31 ,80.62 ,66.31 
03,012,01,013,0267,591,924,13,937,1198,0,0,0,0,0,0,0,66.31 ,78.21 ,66.31 
03,012,01,013,0268,592,681,8,689,883,0,0,0,0,0,0,0,66.31 ,78.03 ,66.31 
03,012,01,013,0268,593,731,11,742,925,0,0,0,0,0,0,0,66.31 ,80.22 ,66.31 
03,012,01,013,0268,594,658,27,685,984,0,0,0,0,0,0,0,66.31 ,69.61 ,66.31 
03,012,01,013,0269,595,672,5,677,909,0,0,0,0,0,0,0,66.31 ,74.48 ,66.31 
03,012,01,013,0269,596,697,11,708,917,0,0,0,0,0,0,0,66.31 ,77.21 ,66.31 
03,012,01,013,0270,597,579,5,584,753,0,0,0,0,0,0,0,66.31 ,77.56 ,66.31 
03,012,01,013,0270,598,606,8,614,773,0,0,0,0,0,0,0,66.31 ,79.43 ,66.31 
03,012,01,013,0271,599,722,8,730,919,0,0,0,0,0,0,0,66.31 ,79.43 ,66.31 
03,012,01,013,0272,600,785,12,797,1050,0,0,0,0,0,0,0,66.31 ,75.90 ,66.31 
03,012,01,013,0272,601,816,17,833,1120,0,0,0,0,0,0,0,66.31 ,74.38 ,66.31 
03,012,01,013,0273,602,755,7,762,995,0,0,0,0,0,0,0,66.31 ,76.58 ,66.31 
03,012,01,013,0273,603,771,8,779,1031,0,0,0,0,0,0,0,66.31 ,75.56 ,66.31 
03,012,01,013,0273,604,743,17,760,1088,0,0,0,0,0,0,0,66.31 ,69.85 ,66.31 
03,012,01,013,0274,605,856,8,864,1261,0,0,0,0,0,0,0,66.31 ,68.52 ,66.31 
03,012,01,013,0274,606,909,10,919,1276,0,0,0,0,0,0,0,66.31 ,72.02 ,66.31 
03,012,01,013,0275,607,1008,15,1023,1403,0,0,0,0,0,0,0,66.31 ,72.92 ,66.31 
03,012,01,013,0275,608,803,11,814,1110,0,0,0,0,0,0,0,66.31 ,73.33 ,66.31 
03,012,01,013,0276,609,739,8,747,916,0,0,0,0,0,0,0,66.31 ,81.55 ,66.31 
03,012,01,013,0276,610,805,12,817,1085,0,0,0,0,0,0,0,66.31 ,75.30 ,66.31 
03,012,01,013,0277,611,722,9,731,975,0,0,0,0,0,0,0,66.31 ,74.97 ,66.31 
03,012,01,013,0277,612,705,9,714,981,0,0,0,0,0,0,0,66.31 ,72.78 ,66.31 
03,012,01,013,0278,613,873,10,883,1153,0,0,0,0,0,0,0,66.31 ,76.58 ,66.31 
03,012,01,013,0278,614,935,22,957,1263,0,0,0,0,0,0,0,66.31 ,75.77 ,66.31 
03,012,01,013,0279,615,732,10,742,1054,0,0,0,0,0,0,0,66.31 ,70.40 ,66.31 
03,012,01,013,0279,616,875,14,889,1164,0,0,0,0,0,0,0,66.31 ,76.37 ,66.31 
03,012,01,013,0280,617,887,14,901,1142,0,0,0,0,0,0,0,66.31 ,78.90 ,66.31 
03,012,01,013,0281,618,861,9,870,1147,0,0,0,0,0,0,0,66.31 ,75.85 ,66.31 
03,012,01,013,0282,619,680,14,694,873,0,0,0,0,0,0,0,66.31 ,79.50 ,66.31 
03,012,01,013,0283,620,807,4,811,1004,0,0,0,0,0,0,0,66.31 ,80.78 ,66.31 
03,012,01,013,0284,621,669,15,684,816,0,0,0,0,0,0,0,66.31 ,83.82 ,66.31 
03,012,01,013,0285,622,1037,17,1054,1369,0,0,0,0,0,0,0,66.31 ,76.99 ,66.31 
03,012,01,014,0286,623,505,11,516,659,0,0,0,0,0,0,0,66.31 ,78.30 ,66.31 
03,012,01,014,0286,624,558,8,566,739,0,0,0,0,0,0,0,66.31 ,76.59 ,66.31 
03,012,01,014,0286,625,659,11,670,917,0,0,0,0,0,0,0,66.31 ,73.06 ,66.31 
03,012,01,014,0287,626,798,5,803,1046,0,0,0,0,0,0,0,66.31 ,76.77 ,66.31 
03,012,01,014,0288,627,655,11,666,894,0,0,0,0,0,0,0,66.31 ,74.50 ,66.31 
03,012,01,014,0288,628,830,11,841,1371,0,0,0,0,0,0,0,66.31 ,61.34 ,66.31 
03,012,01,014,0288,629,430,8,438,652,0,0,0,0,0,0,0,66.31 ,67.18 ,66.31 
03,012,01,014,0288,630,717,16,733,1141,0,0,0,0,0,0,0,66.31 ,64.24 ,66.31 
03,012,01,014,0289,631,551,5,556,760,0,0,0,0,0,0,0,66.31 ,73.16 ,66.31 
03,012,01,014,0289,632,660,12,672,896,0,0,0,0,0,0,0,66.31 ,75.00 ,66.31 
03,012,01,014,0290,633,842,13,855,1128,0,0,0,0,0,0,0,66.31 ,75.80 ,66.31 
03,012,01,014,0291,634,818,10,828,1099,0,0,0,0,0,0,0,66.31 ,75.34 ,66.31 
03,012,01,014,0292,635,612,7,619,845,0,0,0,0,0,0,0,66.31 ,73.25 ,66.31 
03,012,01,014,0293,636,492,5,497,696,0,0,0,0,0,0,0,66.31 ,71.41 ,66.31 
03,012,01,014,0293,637,508,11,519,733,0,0,0,0,0,0,0,66.31 ,70.80 ,66.31 
03,012,01,014,0294,638,577,7,584,820,0,0,0,0,0,0,0,66.31 ,71.22 ,66.31 
03,012,01,014,0294,639,546,8,554,815,0,0,0,0,0,0,0,66.31 ,67.98 ,66.31 
03,012,01,014,0295,640,800,23,823,1155,0,0,0,0,0,0,0,66.31 ,71.26 ,66.31 
03,012,01,014,0296,641,616,13,629,879,0,0,0,0,0,0,0,66.31 ,71.56 ,66.31 
03,012,01,014,0296,642,781,11,792,1072,0,0,0,0,0,0,0,66.31 ,73.88 ,66.31 
03,012,01,014,0297,643,664,11,675,928,0,0,0,0,0,0,0,66.31 ,72.74 ,66.31 
03,012,01,014,0298,644,575,6,581,740,0,0,0,0,0,0,0,66.31 ,78.51 ,66.31 
03,012,01,015,0299,645,769,6,775,1032,0,0,0,0,0,0,0,66.31 ,75.10 ,66.31 
03,012,01,015,0300,646,633,13,646,887,0,0,0,0,0,0,0,66.31 ,72.83 ,66.31 
03,012,01,015,0301,647,1089,17,1106,1565,0,0,0,0,0,0,0,66.31 ,70.67 ,66.31 
03,012,01,015,0302,648,856,9,865,1198,0,0,0,0,0,0,0,66.31 ,72.20 ,66.31 
03,012,01,015,0302,649,944,12,956,1404,0,0,0,0,0,0,0,66.31 ,68.09 ,66.31 
03,012,01,015,0303,650,960,11,971,1349,0,0,0,0,0,0,0,66.31 ,71.98 ,66.31 
03,012,01,015,0304,651,1328,11,1339,1840,0,0,0,0,0,0,0,66.31 ,72.77 ,66.31 
03,012,01,015,0305,652,853,7,860,1212,0,0,0,0,0,0,0,66.31 ,70.96 ,66.31 
03,012,01,015,0306,653,765,11,776,1059,0,0,0,0,0,0,0,66.31 ,73.28 ,66.31 
03,012,01,015,0307,654,851,11,862,1208,0,0,0,0,0,0,0,66.31 ,71.36 ,66.31 
03,012,01,015,0308,655,940,10,950,1325,0,0,0,0,0,0,0,66.31 ,71.70 ,66.31 
03,012,01,015,0309,656,848,13,861,1288,0,0,0,0,0,0,0,66.31 ,66.85 ,66.31 
03,012,01,015,0309,657,1038,13,1051,1528,0,0,0,0,0,0,0,66.31 ,68.78 ,66.31 
03,012,01,015,0310,658,854,9,863,1163,0,0,0,0,0,0,0,66.31 ,74.20 ,66.31 
03,012,01,015,0311,659,737,10,747,1024,0,0,0,0,0,0,0,66.31 ,72.95 ,66.31 
03,012,01,015,0312,660,942,3,945,1213,0,0,0,0,0,0,0,66.31 ,77.91 ,66.31 
03,012,01,015,0313,661,1169,16,1185,1534,0,0,0,0,0,0,0,66.31 ,77.25 ,66.31 
03,012,01,015,0313,662,963,10,973,1528,0,0,0,0,0,0,0,66.31 ,63.68 ,66.31 
03,012,01,016,0314,663,558,2,560,738,0,0,0,0,0,0,0,66.31 ,75.88 ,66.31 
03,012,01,016,0315,664,618,10,628,821,0,0,0,0,0,0,0,66.31 ,76.49 ,66.31 
03,012,01,016,0315,665,675,8,683,900,0,0,0,0,0,0,0,66.31 ,75.89 ,66.31 
03,012,01,016,0315,666,638,5,643,887,0,0,0,0,0,0,0,66.31 ,72.49 ,66.31 
03,012,01,016,0316,667,680,6,686,880,0,0,0,0,0,0,0,66.31 ,77.95 ,66.31 
03,012,01,016,0316,668,502,5,507,695,0,0,0,0,0,0,0,66.31 ,72.95 ,66.31 
03,012,01,016,0317,669,529,4,533,744,0,0,0,0,0,0,0,66.31 ,71.64 ,66.31 
03,012,01,016,0317,670,292,1,293,429,0,0,0,0,0,0,0,66.31 ,68.30 ,66.31 
03,012,01,016,0318,671,876,6,882,1081,0,0,0,0,0,0,0,66.31 ,81.59 ,66.31 
03,012,01,016,0318,672,572,1,573,825,0,0,0,0,0,0,0,66.31 ,69.45 ,66.31 
03,012,01,016,0319,673,891,7,898,1166,0,0,0,0,0,0,0,66.31 ,77.02 ,66.31 
03,012,01,016,0319,674,824,15,839,1218,0,0,0,0,0,0,0,66.31 ,68.88 ,66.31 
03,012,01,017,0320,675,1097,17,1114,1405,0,0,0,0,0,0,0,66.31 ,79.29 ,66.31 
03,012,01,017,0321,676,1416,18,1434,1791,0,0,0,0,0,0,0,66.31 ,80.07 ,66.31 
03,012,01,017,0322,677,1411,35,1446,1830,0,0,0,0,0,0,0,66.31 ,79.02 ,66.31 
03,012,01,017,0323,678,746,8,754,908,0,0,0,0,0,0,0,66.31 ,83.04 ,66.31 
03,012,01,017,0324,679,798,12,810,1051,0,0,0,0,0,0,0,66.31 ,77.07 ,66.31 
03,012,01,017,0325,680,1365,13,1378,1769,0,0,0,0,0,0,0,66.31 ,77.90 ,66.31 
03,012,01,017,0326,681,471,6,477,586,0,0,0,0,0,0,0,66.31 ,81.40 ,66.31 
03,012,01,017,0327,682,593,4,597,758,0,0,0,0,0,0,0,66.31 ,78.76 ,66.31 
03,012,01,017,0328,683,1148,16,1164,1461,0,0,0,0,0,0,0,66.31 ,79.67 ,66.31 
03,012,01,017,0329,684,624,6,630,819,0,0,0,0,0,0,0,66.31 ,76.92 ,66.31 
03,012,01,017,0330,685,800,7,807,924,0,0,0,0,0,0,0,66.31 ,87.34 ,66.31 
03,012,01,017,0331,686,1505,21,1526,1883,0,0,0,0,0,0,0,66.31 ,81.04 ,66.31 
03,012,01,018,0332,687,629,12,641,900,0,0,0,0,0,0,0,66.31 ,71.22 ,66.31 
03,012,01,018,0332,688,674,12,686,941,0,0,0,0,0,0,0,66.31 ,72.90 ,66.31 
03,012,01,018,0333,689,643,15,658,941,0,0,0,0,0,0,0,66.31 ,69.93 ,66.31 
03,012,01,018,0333,690,697,9,706,982,0,0,0,0,0,0,0,66.31 ,71.89 ,66.31 
03,012,01,018,0334,691,803,7,810,1097,0,0,0,0,0,0,0,66.31 ,73.84 ,66.31 
03,012,01,018,0334,692,786,8,794,1082,0,0,0,0,0,0,0,66.31 ,73.38 ,66.31 
03,012,01,018,0335,693,813,9,822,1051,0,0,0,0,0,0,0,66.31 ,78.21 ,66.31 
03,012,01,018,0336,694,734,14,748,954,0,0,0,0,0,0,0,66.31 ,78.41 ,66.31 
03,012,01,018,0337,695,671,8,679,841,0,0,0,0,0,0,0,66.31 ,80.74 ,66.31 
03,012,01,018,0338,696,996,16,1012,1382,0,0,0,0,0,0,0,66.31 ,73.23 ,66.31 
03,012,01,018,0338,697,598,16,614,869,0,0,0,0,0,0,0,66.31 ,70.66 ,66.31 
03,012,01,018,0338,698,744,14,758,1011,0,0,0,0,0,0,0,66.31 ,74.98 ,66.31 
03,012,01,018,0339,699,855,12,867,1154,0,0,0,0,0,0,0,66.31 ,75.13 ,66.31 
03,012,01,018,0339,700,562,13,575,734,0,0,0,0,0,0,0,66.31 ,78.34 ,66.31 
03,012,01,018,0340,701,1067,6,1073,1371,0,0,0,0,0,0,0,66.31 ,78.26 ,66.31 
03,012,01,018,0340,702,732,11,743,970,0,0,0,0,0,0,0,66.31 ,76.60 ,66.31 
03,012,01,018,0341,703,498,9,507,700,0,0,0,0,0,0,0,66.31 ,72.43 ,66.31 
03,012,01,018,0342,704,805,15,820,1110,0,0,0,0,0,0,0,66.31 ,73.87 ,66.31 
03,012,01,018,0342,705,894,16,910,1173,0,0,0,0,0,0,0,66.31 ,77.58 ,66.31 
03,012,01,018,0343,706,588,10,598,829,0,0,0,0,0,0,0,66.31 ,72.14 ,66.31 
03,012,01,018,0343,707,940,15,955,1321,0,0,0,0,0,0,0,66.31 ,72.29 ,66.31 
03,012,01,018,0344,708,975,18,993,1378,0,0,0,0,0,0,0,66.31 ,72.06 ,66.31 
03,012,01,018,0345,709,898,23,921,1171,0,0,0,0,0,0,0,66.31 ,78.65 ,66.31 
03,012,01,018,0345,710,733,5,738,981,0,0,0,0,0,0,0,66.31 ,75.23 ,66.31 
03,012,01,018,0346,711,877,12,889,1105,0,0,0,0,0,0,0,66.31 ,80.45 ,66.31 
03,012,01,018,0346,712,774,13,787,1160,0,0,0,0,0,0,0,66.31 ,67.84 ,66.31 
03,012,01,019,0347,713,664,6,670,963,0,0,0,0,0,0,0,66.31 ,69.57 ,66.31 
03,012,01,019,0347,714,833,3,836,1279,0,0,0,0,0,0,0,66.31 ,65.36 ,66.31 
03,012,01,019,0348,715,921,11,932,1270,0,0,0,0,0,0,0,66.31 ,73.39 ,66.31 
03,012,01,019,0348,716,781,12,793,1156,0,0,0,0,0,0,0,66.31 ,68.60 ,66.31 
03,012,01,019,0349,717,619,11,630,928,0,0,0,0,0,0,0,66.31 ,67.89 ,66.31 
03,012,01,019,0350,718,475,3,478,691,0,0,0,0,0,0,0,66.31 ,69.18 ,66.31 
03,012,01,019,0351,719,623,3,626,855,0,0,0,0,0,0,0,66.31 ,73.22 ,66.31 
03,012,01,019,0352,720,495,7,502,715,0,0,0,0,0,0,0,66.31 ,70.21 ,66.31 
03,012,01,019,0353,721,372,4,376,505,0,0,0,0,0,0,0,66.31 ,74.46 ,66.31 
03,012,01,019,0354,722,603,9,612,871,0,0,0,0,0,0,0,66.31 ,70.26 ,66.31 
03,012,01,019,0354,723,702,5,707,974,0,0,0,0,0,0,0,66.31 ,72.59 ,66.31 
03,012,01,019,0355,724,993,8,1001,1477,0,0,0,0,0,0,0,66.31 ,67.77 ,66.31 
03,012,01,019,0355,725,991,21,1012,1377,0,0,0,0,0,0,0,66.31 ,73.49 ,66.31 
03,012,01,019,0356,726,705,14,719,1031,0,0,0,0,0,0,0,66.31 ,69.74 ,66.31 
03,012,01,019,0356,727,376,4,380,532,0,0,0,0,0,0,0,66.31 ,71.43 ,66.31 
03,012,01,019,0356,728,225,4,229,304,0,0,0,0,0,0,0,66.31 ,75.33 ,66.31 
03,012,01,019,0357,729,718,13,731,1026,0,0,0,0,0,0,0,66.31 ,71.25 ,66.31 
03,012,01,019,0357,730,581,11,592,843,0,0,0,0,0,0,0,66.31 ,70.23 ,66.31 
03,012,01,019,0358,731,759,6,765,1042,0,0,0,0,0,0,0,66.31 ,73.42 ,66.31 
03,012,01,019,0358,732,405,2,407,497,0,0,0,0,0,0,0,66.31 ,81.89 ,66.31 
03,012,01,019,0359,733,714,13,727,1050,0,0,0,0,0,0,0,66.31 ,69.24 ,66.31 
03,012,01,019,0359,734,388,4,392,538,0,0,0,0,0,0,0,66.31 ,72.86 ,66.31 
03,012,01,019,0360,735,750,6,756,994,0,0,0,0,0,0,0,66.31 ,76.06 ,66.31 
03,012,01,019,0361,736,723,10,733,937,0,0,0,0,0,0,0,66.31 ,78.23 ,66.31 
03,012,01,019,0362,737,1039,17,1056,1349,0,0,0,0,0,0,0,66.31 ,78.28 ,66.31 
03,012,01,019,0363,738,778,7,785,1027,0,0,0,0,0,0,0,66.31 ,76.44 ,66.31 
03,012,01,019,0364,739,1052,16,1068,1402,0,0,0,0,0,0,0,66.31 ,76.18 ,66.31 
03,012,01,019,0365,740,743,5,748,958,0,0,0,0,0,0,0,66.31 ,78.08 ,66.31 
03,012,01,019,0366,741,873,22,895,1221,0,0,0,0,0,0,0,66.31 ,73.30 ,66.31 
03,012,01,019,0366,742,884,12,896,1170,0,0,0,0,0,0,0,66.31 ,76.58 ,66.31 
03,012,01,019,0367,743,681,8,689,911,0,0,0,0,0,0,0,66.31 ,75.63 ,66.31 
03,012,01,019,0367,744,630,10,640,934,0,0,0,0,0,0,0,66.31 ,68.52 ,66.31 
03,012,01,019,0368,745,467,4,471,660,0,0,0,0,0,0,0,66.31 ,71.36 ,66.31 
03,012,01,019,0369,746,291,1,292,376,0,0,0,0,0,0,0,66.31 ,77.66 ,66.31 
03,012,01,019,0370,747,442,8,450,588,0,0,0,0,0,0,0,66.31 ,76.53 ,66.31 
03,012,01,019,0371,748,145,1,146,201,0,0,0,0,0,0,0,66.31 ,72.64 ,66.31 
03,012,01,020,0372,749,1221,17,1238,1654,0,0,0,0,0,0,0,66.31 ,74.85 ,66.31 
03,012,01,020,0373,750,1034,18,1052,1456,0,0,0,0,0,0,0,66.31 ,72.25 ,66.31 
03,012,01,020,0374,751,1011,12,1023,1407,0,0,0,0,0,0,0,66.31 ,72.71 ,66.31 
03,012,01,020,0375,752,703,11,714,978,0,0,0,0,0,0,0,66.31 ,73.01 ,66.31 
03,012,01,020,0375,753,937,8,945,1288,0,0,0,0,0,0,0,66.31 ,73.37 ,66.31 
03,012,01,020,0376,754,873,13,886,1195,0,0,0,0,0,0,0,66.31 ,74.14 ,66.31 
03,012,01,020,0376,755,749,3,752,1025,0,0,0,0,0,0,0,66.31 ,73.37 ,66.31 
03,012,01,020,0377,756,890,3,893,1180,0,0,0,0,0,0,0,66.31 ,75.68 ,66.31 
03,012,01,020,0377,757,956,7,963,1336,0,0,0,0,0,0,0,66.31 ,72.08 ,66.31 
03,012,01,020,0378,758,888,8,896,1276,0,0,0,0,0,0,0,66.31 ,70.22 ,66.31 
03,012,01,020,0378,759,842,15,857,1198,0,0,0,0,0,0,0,66.31 ,71.54 ,66.31 
03,012,01,020,0379,760,667,5,672,884,0,0,0,0,0,0,0,66.31 ,76.02 ,66.31 
03,012,01,020,0379,761,837,4,841,1124,0,0,0,0,0,0,0,66.31 ,74.82 ,66.31 
03,012,01,020,0380,762,1175,6,1181,1511,0,0,0,0,0,0,0,66.31 ,78.16 ,66.31 
03,012,01,020,0381,763,714,10,724,982,0,0,0,0,0,0,0,66.31 ,73.73 ,66.31 
03,012,01,020,0381,764,542,4,546,738,0,0,0,0,0,0,0,66.31 ,73.98 ,66.31 
03,012,01,020,0382,765,1063,8,1071,1442,0,0,0,0,0,0,0,66.31 ,74.27 ,66.31 
03,012,01,020,0383,766,747,12,759,1027,0,0,0,0,0,0,0,66.31 ,73.90 ,66.31 
03,012,01,020,0383,767,736,6,742,1020,0,0,0,0,0,0,0,66.31 ,72.75 ,66.31 
03,012,01,020,0384,768,624,5,629,832,0,0,0,0,0,0,0,66.31 ,75.60 ,66.31 
03,012,01,020,0384,769,630,9,639,834,0,0,0,0,0,0,0,66.31 ,76.62 ,66.31 
03,012,01,020,0385,770,838,14,852,1170,0,0,0,0,0,0,0,66.31 ,72.82 ,66.31 
03,012,01,020,0385,771,742,11,753,1065,0,0,0,0,0,0,0,66.31 ,70.70 ,66.31 
03,012,01,020,0386,772,1039,16,1055,1381,0,0,0,0,0,0,0,66.31 ,76.39 ,66.31 
03,012,01,020,0386,773,734,7,741,983,0,0,0,0,0,0,0,66.31 ,75.38 ,66.31 
03,012,01,020,0387,774,605,7,612,778,0,0,0,0,0,0,0,66.31 ,78.66 ,66.31 
03,012,01,020,0387,775,657,8,665,899,0,0,0,0,0,0,0,66.31 ,73.97 ,66.31 
03,012,01,020,0388,776,1019,11,1030,1429,0,0,0,0,0,0,0,66.31 ,72.08 ,66.31 
03,012,01,020,0389,777,896,9,905,1215,0,0,0,0,0,0,0,66.31 ,74.49 ,66.31 
03,012,01,020,0390,778,667,8,675,921,0,0,0,0,0,0,0,66.31 ,73.29 ,66.31 
03,012,01,020,0390,779,560,6,566,849,0,0,0,0,0,0,0,66.31 ,66.67 ,66.31 
03,012,01,021,0391,780,648,8,656,1075,0,0,0,0,0,0,0,66.31 ,61.02 ,66.31 
03,012,01,021,0392,781,891,14,905,1233,0,0,0,0,0,0,0,66.31 ,73.40 ,66.31 
03,012,01,021,0393,782,1013,23,1036,1640,0,0,0,0,0,0,0,66.31 ,63.17 ,66.31 
03,012,01,021,0394,783,874,17,891,1387,0,0,0,0,0,0,0,66.31 ,64.24 ,66.31 
03,012,01,021,0395,784,637,10,647,951,0,0,0,0,0,0,0,66.31 ,68.03 ,66.31 
03,012,01,021,0396,785,600,7,607,873,0,0,0,0,0,0,0,66.31 ,69.53 ,66.31 
03,012,01,021,0397,786,554,8,562,772,0,0,0,0,0,0,0,66.31 ,72.80 ,66.31 
03,012,01,021,0398,787,508,9,517,658,0,0,0,0,0,0,0,66.31 ,78.57 ,66.31 
03,012,01,021,0399,788,264,2,266,378,0,0,0,0,0,0,0,66.31 ,70.37 ,66.31 
03,012,01,021,0400,789,846,15,861,1480,0,0,0,0,0,0,0,66.31 ,58.18 ,66.31 
03,012,01,021,0401,790,950,21,971,1555,0,0,0,0,0,0,0,66.31 ,62.44 ,66.31 
03,012,01,021,0402,791,694,12,706,1079,0,0,0,0,0,0,0,66.31 ,65.43 ,66.31 
03,012,01,022,0403,792,466,3,469,643,0,0,0,0,0,0,0,66.31 ,72.94 ,66.31 
03,012,01,022,0404,793,811,11,822,1065,0,0,0,0,0,0,0,66.31 ,77.18 ,66.31 
03,012,01,022,0405,794,575,3,578,801,0,0,0,0,0,0,0,66.31 ,72.16 ,66.31 
03,012,01,022,0406,795,1077,17,1094,1516,0,0,0,0,0,0,0,66.31 ,72.16 ,66.31 
03,012,01,022,0407,796,532,3,535,718,0,0,0,0,0,0,0,66.31 ,74.51 ,66.31 
03,012,01,022,0408,797,513,9,522,720,0,0,0,0,0,0,0,66.31 ,72.50 ,66.31 
03,012,01,022,0409,798,710,14,724,1134,0,0,0,0,0,0,0,66.31 ,63.84 ,66.31 
03,012,01,023,0410,799,591,5,596,860,0,0,0,0,0,0,0,66.31 ,69.30 ,66.31 
03,012,01,023,0411,800,506,10,516,827,0,0,0,0,0,0,0,66.31 ,62.39 ,66.31 
03,012,01,023,0412,801,715,13,728,1136,0,0,0,0,0,0,0,66.31 ,64.08 ,66.31 
03,012,01,023,0412,802,487,11,498,782,0,0,0,0,0,0,0,66.31 ,63.68 ,66.31 
03,012,01,023,0413,803,844,7,851,1211,0,0,0,0,0,0,0,66.31 ,70.27 ,66.31 
03,012,01,023,0413,804,457,7,464,648,0,0,0,0,0,0,0,66.31 ,71.60 ,66.31 
03,012,01,023,0414,805,1137,9,1146,1603,0,0,0,0,0,0,0,66.31 ,71.49 ,66.31 
03,012,01,023,0415,806,1300,17,1317,1858,0,0,0,0,0,0,0,66.31 ,70.88 ,66.31 
03,012,01,023,0416,807,1021,16,1037,1431,0,0,0,0,0,0,0,66.31 ,72.47 ,66.31 
03,012,01,024,0417,808,591,8,599,778,0,0,0,0,0,0,0,66.31 ,76.99 ,66.31 
03,012,01,024,0418,809,752,11,763,1066,0,0,0,0,0,0,0,66.31 ,71.58 ,66.31 
03,012,01,024,0419,810,340,6,346,508,0,0,0,0,0,0,0,66.31 ,68.11 ,66.31 
03,012,01,024,0420,811,383,4,387,499,0,0,0,0,0,0,0,66.31 ,77.56 ,66.31 
03,012,01,024,0421,812,806,9,815,1028,0,0,0,0,0,0,0,66.31 ,79.28 ,66.31 
03,012,01,024,0422,813,521,8,529,678,0,0,0,0,0,0,0,66.31 ,78.02 ,66.31 
03,012,01,024,0422,814,814,9,823,1078,0,0,0,0,0,0,0,66.31 ,76.35 ,66.31 
03,012,01,024,0423,815,497,2,499,616,0,0,0,0,0,0,0,66.31 ,81.01 ,66.31 
03,012,01,024,0424,816,270,5,275,377,0,0,0,0,0,0,0,66.31 ,72.94 ,66.31 
03,012,01,024,0425,817,289,6,295,372,0,0,0,0,0,0,0,66.31 ,79.30 ,66.31 
03,012,01,024,0426,818,642,9,651,805,0,0,0,0,0,0,0,66.31 ,80.87 ,66.31 
03,012,01,024,0427,819,527,3,530,655,0,0,0,0,0,0,0,66.31 ,80.92 ,66.31 
03,012,01,024,0428,820,365,7,372,482,0,0,0,0,0,0,0,66.31 ,77.18 ,66.31 
03,012,01,024,0429,821,910,8,918,1145,0,0,0,0,0,0,0,66.31 ,80.17 ,66.31 
03,012,01,024,0430,822,799,5,804,958,0,0,0,0,0,0,0,66.31 ,83.92 ,66.31 
03,012,01,024,0431,823,388,4,392,543,0,0,0,0,0,0,0,66.31 ,72.19 ,66.31 
03,012,01,024,0432,824,522,5,527,680,0,0,0,0,0,0,0,66.31 ,77.50 ,66.31 
03,012,01,024,0433,825,513,5,518,684,0,0,0,0,0,0,0,66.31 ,75.73 ,66.31 
03,012,01,024,0434,826,493,3,496,615,0,0,0,0,0,0,0,66.31 ,80.65 ,66.31 
03,012,01,025,0435,827,42,0,42,70,0,0,0,0,0,0,0,66.31 ,60.00 ,66.31 
03,012,01,025,0436,828,7,0,7,16,0,0,0,0,0,0,0,66.31 ,43.75 ,66.31 
03,012,01,025,0437,829,14,0,14,22,0,0,0,0,0,0,0,66.31 ,63.64 ,66.31 
03,012,01,026,0438,830,2,0,2,5,0,0,0,0,0,0,0,66.31 ,40.00 ,66.31 
03,012,01,026,0438,831,12,0,12,29,0,0,0,0,0,0,0,66.31 ,41.38 ,66.31 
03,012,01,026,0439,832,54,1,55,76,0,0,0,0,0,0,0,66.31 ,72.37 ,66.31 
03,012,01,026,0440,833,41,1,42,83,0,0,0,0,0,0,0,66.31 ,50.60 ,66.31 
03,012,01,026,0441,834,81,0,81,144,0,0,0,0,0,0,0,66.31 ,56.25 ,66.31 
03,012,01,026,0442,835,10,0,10,19,0,0,0,0,0,0,0,66.31 ,52.63 ,66.31 
03,012,01,026,0443,836,11,0,11,15,0,0,0,0,0,0,0,66.31 ,73.33 ,66.31 
03,012,01,026,0444,837,7,0,7,12,0,0,0,0,0,0,0,66.31 ,58.33 ,66.31 
03,012,01,026,0445,838,8,0,8,16,0,0,0,0,0,0,0,66.31 ,50.00 ,66.31 
03,012,01,027,0446,839,49,1,50,156,0,0,0,0,0,0,0,66.31 ,32.05 ,66.31 
03,012,01,027,0447,840,26,0,26,45,0,0,0,0,0,0,0,66.31 ,57.78 ,66.31 
03,012,01,027,0448,841,58,0,58,98,0,0,0,0,0,0,0,66.31 ,59.18 ,66.31 
03,013,01,001,0001,1,801,5,806,1224,0,0,0,0,0,0,0,66.31 ,65.85 ,66.31 
03,013,01,001,0002,2,1042,13,1055,1531,0,0,0,0,0,0,0,66.31 ,68.91 ,66.31 
03,013,01,001,0003,3,586,4,590,798,0,0,0,0,0,0,0,66.31 ,73.93 ,66.31 
03,013,01,001,0004,4,878,3,881,1394,0,0,0,0,0,0,0,66.31 ,63.20 ,66.31 
03,013,01,001,0005,5,1037,8,1045,1497,0,0,0,0,0,0,0,66.31 ,69.81 ,66.31 
03,013,01,001,0005,6,896,6,902,1385,0,0,0,0,0,0,0,66.31 ,65.13 ,66.31 
03,013,01,001,0006,7,987,5,992,1486,0,0,0,0,0,0,0,66.31 ,66.76 ,66.31 
03,013,01,001,0007,8,608,10,618,897,0,0,0,0,0,0,0,66.31 ,68.90 ,66.31 
03,013,01,001,0008,9,599,8,607,853,0,0,0,0,0,0,0,66.31 ,71.16 ,66.31 
03,013,01,001,0009,10,867,5,872,1282,0,0,0,0,0,0,0,66.31 ,68.02 ,66.31 
03,013,01,001,0010,11,637,8,645,918,0,0,0,0,0,0,0,66.31 ,70.26 ,66.31 
03,013,01,001,0011,12,740,9,749,1102,0,0,0,0,0,0,0,66.31 ,67.97 ,66.31 
03,013,01,001,0012,13,947,6,953,1539,0,0,0,0,0,0,0,66.31 ,61.92 ,66.31 
03,013,01,001,0013,14,658,8,666,954,0,0,0,0,0,0,0,66.31 ,69.81 ,66.31 
03,013,01,001,0014,15,617,5,622,976,0,0,0,0,0,0,0,66.31 ,63.73 ,66.31 
03,013,01,001,0014,16,633,7,640,1046,0,0,0,0,0,0,0,66.31 ,61.19 ,66.31 
03,013,01,001,0015,17,725,5,730,1154,0,0,0,0,0,0,0,66.31 ,63.26 ,66.31 
03,013,01,001,0015,18,759,5,764,1142,0,0,0,0,0,0,0,66.31 ,66.90 ,66.31 
03,013,01,001,0016,19,664,1,665,1027,0,0,0,0,0,0,0,66.31 ,64.75 ,66.31 
03,013,01,001,0016,20,795,5,800,1240,0,0,0,0,0,0,0,66.31 ,64.52 ,66.31 
03,013,01,001,0016,21,899,8,907,1398,0,0,0,0,0,0,0,66.31 ,64.88 ,66.31 
03,013,01,001,0017,22,826,6,832,1337,0,0,0,0,0,0,0,66.31 ,62.23 ,66.31 
03,013,01,001,0017,23,963,6,969,1446,0,0,0,0,0,0,0,66.31 ,67.01 ,66.31 
03,013,01,001,0017,24,873,6,879,1396,0,0,0,0,0,0,0,66.31 ,62.97 ,66.31 
03,013,01,001,0017,25,1075,9,1084,1645,0,0,0,0,0,0,0,66.31 ,65.90 ,66.31 
03,013,01,001,0017,26,998,12,1010,1581,0,0,0,0,0,0,0,66.31 ,63.88 ,66.31 
03,013,01,001,0018,27,770,3,773,1164,0,0,0,0,0,0,0,66.31 ,66.41 ,66.31 
03,013,01,001,0018,28,789,11,800,1174,0,0,0,0,0,0,0,66.31 ,68.14 ,66.31 
03,013,01,001,0018,29,707,3,710,1103,0,0,0,0,0,0,0,66.31 ,64.37 ,66.31 
03,013,01,001,0019,30,628,7,635,922,0,0,0,0,0,0,0,66.31 ,68.87 ,66.31 
03,013,01,001,0020,31,910,7,917,1293,0,0,0,0,0,0,0,66.31 ,70.92 ,66.31 
03,013,01,001,0021,32,715,6,721,1069,0,0,0,0,0,0,0,66.31 ,67.45 ,66.31 
03,013,01,001,0022,33,964,4,968,1543,0,0,0,0,0,0,0,66.31 ,62.73 ,66.31 
03,013,01,001,0022,34,848,27,875,1362,0,0,0,0,0,0,0,66.31 ,64.24 ,66.31 
03,013,01,001,0022,35,967,7,974,1532,0,0,0,0,0,0,0,66.31 ,63.58 ,66.31 
03,013,01,001,0022,36,870,7,877,1416,0,0,0,0,0,0,0,66.31 ,61.94 ,66.31 
03,013,01,001,0023,37,958,11,969,1375,0,0,0,0,0,0,0,66.31 ,70.47 ,66.31 
03,013,01,001,0024,38,984,10,994,1537,0,0,0,0,0,0,0,66.31 ,64.67 ,66.31 
03,013,01,001,0025,39,490,6,496,799,0,0,0,0,0,0,0,66.31 ,62.08 ,66.31 
03,013,01,001,0026,40,578,11,589,820,0,0,0,0,0,0,0,66.31 ,71.83 ,66.31 
03,013,01,001,0027,41,803,10,813,1372,0,0,0,0,0,0,0,66.31 ,59.26 ,66.31 
03,013,01,001,0027,42,1056,13,1069,1705,0,0,0,0,0,0,0,66.31 ,62.70 ,66.31 
03,013,01,001,0028,43,864,5,869,1362,0,0,0,0,0,0,0,66.31 ,63.80 ,66.31 
03,013,01,001,0028,44,1037,10,1047,1586,0,0,0,0,0,0,0,66.31 ,66.02 ,66.31 
03,013,01,001,0028,45,1027,12,1039,1634,0,0,0,0,0,0,0,66.31 ,63.59 ,66.31 
03,013,01,001,0028,46,941,12,953,1567,0,0,0,0,0,0,0,66.31 ,60.82 ,66.31 
03,013,01,001,0029,47,751,7,758,1113,0,0,0,0,0,0,0,66.31 ,68.10 ,66.31 
03,013,01,001,0029,48,1035,13,1048,1742,0,0,0,0,0,0,0,66.31 ,60.16 ,66.31 
03,013,01,001,0029,49,867,8,875,1359,0,0,0,0,0,0,0,66.31 ,64.39 ,66.31 
03,013,01,001,0030,50,373,2,375,535,0,0,0,0,0,0,0,66.31 ,70.09 ,66.31 
03,013,01,001,0031,51,679,1,680,923,0,0,0,0,0,0,0,66.31 ,73.67 ,66.31 
03,013,01,001,0032,52,926,13,939,1303,0,0,0,0,0,0,0,66.31 ,72.06 ,66.31 
03,013,01,001,0032,53,692,10,702,1020,0,0,0,0,0,0,0,66.31 ,68.82 ,66.31 
03,013,01,001,0033,54,991,16,1007,1428,0,0,0,0,0,0,0,66.31 ,70.52 ,66.31 
03,013,01,001,0034,55,1433,7,1440,2046,0,0,0,0,0,0,0,66.31 ,70.38 ,66.31 
03,013,01,001,0035,56,1074,10,1084,1472,0,0,0,0,0,0,0,66.31 ,73.64 ,66.31 
03,013,01,001,0036,57,949,7,956,1248,0,0,0,0,0,0,0,66.31 ,76.60 ,66.31 
03,013,01,001,0037,58,757,8,765,1134,0,0,0,0,0,0,0,66.31 ,67.46 ,66.31 
03,013,01,001,0038,59,600,11,611,922,0,0,0,0,0,0,0,66.31 ,66.27 ,66.31 
03,013,01,001,0038,60,608,5,613,927,0,0,0,0,0,0,0,66.31 ,66.13 ,66.31 
03,013,01,001,0039,61,832,13,845,1286,0,0,0,0,0,0,0,66.31 ,65.71 ,66.31 
03,013,01,001,0040,62,635,8,643,1026,0,0,0,0,0,0,0,66.31 ,62.67 ,66.31 
03,013,01,001,0040,63,600,10,610,946,0,0,0,0,0,0,0,66.31 ,64.48 ,66.31 
03,013,01,001,0041,64,730,6,736,1154,0,0,0,0,0,0,0,66.31 ,63.78 ,66.31 
03,013,01,001,0042,65,440,4,444,680,0,0,0,0,0,0,0,66.31 ,65.29 ,66.31 
03,013,01,001,0042,66,1202,17,1219,2014,0,0,0,0,0,0,0,66.31 ,60.53 ,66.31 
03,013,01,001,0042,67,1156,10,1166,1751,0,0,0,0,0,0,0,66.31 ,66.59 ,66.31 
03,013,01,001,0042,68,1067,12,1079,1722,0,0,0,0,0,0,0,66.31 ,62.66 ,66.31 
03,013,01,001,0043,69,1014,11,1025,1439,0,0,0,0,0,0,0,66.31 ,71.23 ,66.31 
03,013,01,001,0043,70,557,2,559,884,0,0,0,0,0,0,0,66.31 ,63.24 ,66.31 
03,013,01,001,0043,71,833,8,841,1339,0,0,0,0,0,0,0,66.31 ,62.81 ,66.31 
03,013,01,001,0044,72,800,5,805,1153,0,0,0,0,0,0,0,66.31 ,69.82 ,66.31 
03,013,01,001,0045,73,706,11,717,965,0,0,0,0,0,0,0,66.31 ,74.30 ,66.31 
03,013,01,001,0046,74,936,9,945,1435,0,0,0,0,0,0,0,66.31 ,65.85 ,66.31 
03,013,01,001,0047,75,949,12,961,1375,0,0,0,0,0,0,0,66.31 ,69.89 ,66.31 
03,013,01,001,0048,76,664,2,666,1012,0,0,0,0,0,0,0,66.31 ,65.81 ,66.31 
03,013,01,001,0049,77,527,8,535,725,0,0,0,0,0,0,0,66.31 ,73.79 ,66.31 
03,013,01,001,0049,78,698,4,702,1121,0,0,0,0,0,0,0,66.31 ,62.62 ,66.31 
03,013,01,001,0050,79,668,5,673,1028,0,0,0,0,0,0,0,66.31 ,65.47 ,66.31 
03,013,01,001,0051,80,879,10,889,1292,0,0,0,0,0,0,0,66.31 ,68.81 ,66.31 
03,013,01,001,0051,81,844,7,851,1310,0,0,0,0,0,0,0,66.31 ,64.96 ,66.31 
03,013,01,001,0051,82,950,7,957,1481,0,0,0,0,0,0,0,66.31 ,64.62 ,66.31 
03,013,01,001,0052,83,776,9,785,1183,0,0,0,0,0,0,0,66.31 ,66.36 ,66.31 
03,013,01,001,0052,84,884,5,889,1280,0,0,0,0,0,0,0,66.31 ,69.45 ,66.31 
03,013,01,001,0053,85,1134,6,1140,1720,0,0,0,0,0,0,0,66.31 ,66.28 ,66.31 
03,013,01,001,0053,86,893,4,897,1351,0,0,0,0,0,0,0,66.31 ,66.40 ,66.31 
03,013,01,001,0054,87,578,2,580,949,0,0,0,0,0,0,0,66.31 ,61.12 ,66.31 
03,013,01,001,0054,88,633,8,641,1050,0,0,0,0,0,0,0,66.31 ,61.05 ,66.31 
03,013,01,001,0055,89,802,5,807,1215,0,0,0,0,0,0,0,66.31 ,66.42 ,66.31 
03,013,01,001,0055,90,736,5,741,1257,0,0,0,0,0,0,0,66.31 ,58.95 ,66.31 
03,013,01,001,0055,91,855,8,863,1440,0,0,0,0,0,0,0,66.31 ,59.93 ,66.31 
03,013,01,001,0055,92,730,8,738,1159,0,0,0,0,0,0,0,66.31 ,63.68 ,66.31 
03,013,01,001,0056,93,733,5,738,1105,0,0,0,0,0,0,0,66.31 ,66.79 ,66.31 
03,013,01,001,0056,94,820,6,826,1224,0,0,0,0,0,0,0,66.31 ,67.48 ,66.31 
03,013,01,001,0057,95,725,5,730,1196,0,0,0,0,0,0,0,66.31 ,61.04 ,66.31 
03,013,01,001,0057,96,755,4,759,1225,0,0,0,0,0,0,0,66.31 ,61.96 ,66.31 
03,013,01,001,0057,97,909,11,920,1360,0,0,0,0,0,0,0,66.31 ,67.65 ,66.31 
03,013,01,001,0058,98,671,8,679,1029,0,0,0,0,0,0,0,66.31 ,65.99 ,66.31 
03,013,01,001,0058,99,846,8,854,1341,0,0,0,0,0,0,0,66.31 ,63.68 ,66.31 
03,013,01,001,0059,100,803,5,808,1220,0,0,0,0,0,0,0,66.31 ,66.23 ,66.31 
03,013,01,001,0059,101,963,6,969,1350,0,0,0,0,0,0,0,66.31 ,71.78 ,66.31 
03,013,01,001,0059,102,1036,12,1048,1572,0,0,0,0,0,0,0,66.31 ,66.67 ,66.31 
03,013,01,001,0059,103,950,4,954,1445,0,0,0,0,0,0,0,66.31 ,66.02 ,66.31 
03,013,01,001,0060,104,1343,11,1354,1752,0,0,0,0,0,0,0,66.31 ,77.28 ,66.31 
03,013,01,001,0061,105,1020,8,1028,1566,0,0,0,0,0,0,0,66.31 ,65.64 ,66.31 
03,013,01,001,0062,106,504,6,510,746,0,0,0,0,0,0,0,66.31 ,68.36 ,66.31 
03,013,01,001,0063,107,1051,19,1070,1682,0,0,0,0,0,0,0,66.31 ,63.61 ,66.31 
03,013,01,001,0063,108,992,7,999,1575,0,0,0,0,0,0,0,66.31 ,63.43 ,66.31 
03,013,01,001,0063,109,871,10,881,1369,0,0,0,0,0,0,0,66.31 ,64.35 ,66.31 
03,013,01,001,0063,110,1023,6,1029,1661,0,0,0,0,0,0,0,66.31 ,61.95 ,66.31 
03,013,01,001,0064,111,858,16,874,1192,0,0,0,0,0,0,0,66.31 ,73.32 ,66.31 
03,013,01,001,0065,112,633,3,636,810,0,0,0,0,0,0,0,66.31 ,78.52 ,66.31 
03,013,01,001,0066,113,713,4,717,998,0,0,0,0,0,0,0,66.31 ,71.84 ,66.31 
03,013,01,001,0067,114,1040,6,1046,1428,0,0,0,0,0,0,0,66.31 ,73.25 ,66.31 
03,013,01,001,0068,115,657,7,664,935,0,0,0,0,0,0,0,66.31 ,71.02 ,66.31 
03,013,01,002,0069,116,1186,11,1197,1810,0,0,0,0,0,0,0,66.31 ,66.13 ,66.31 
03,013,01,002,0069,117,1428,16,1444,2117,0,0,0,0,0,0,0,66.31 ,68.21 ,66.31 
03,013,01,002,0070,118,1030,9,1039,1594,0,0,0,0,0,0,0,66.31 ,65.18 ,66.31 
03,013,01,002,0070,119,1097,12,1109,1723,0,0,0,0,0,0,0,66.31 ,64.36 ,66.31 
03,013,01,002,0070,120,1092,4,1096,1701,0,0,0,0,0,0,0,66.31 ,64.43 ,66.31 
03,013,01,002,0071,121,1074,7,1081,1686,0,0,0,0,0,0,0,66.31 ,64.12 ,66.31 
03,013,01,002,0072,122,666,5,671,1006,0,0,0,0,0,0,0,66.31 ,66.70 ,66.31 
03,013,01,002,0073,123,448,1,449,645,0,0,0,0,0,0,0,66.31 ,69.61 ,66.31 
03,013,01,002,0074,124,1257,15,1272,1913,0,0,0,0,0,0,0,66.31 ,66.49 ,66.31 
03,013,01,002,0074,125,1093,10,1103,1683,0,0,0,0,0,0,0,66.31 ,65.54 ,66.31 
03,013,01,002,0075,126,599,8,607,787,0,0,0,0,0,0,0,66.31 ,77.13 ,66.31 
03,013,01,002,0076,127,782,11,793,1224,0,0,0,0,0,0,0,66.31 ,64.79 ,66.31 
03,013,01,002,0077,128,971,2,973,1474,0,0,0,0,0,0,0,66.31 ,66.01 ,66.31 
03,013,01,002,0078,129,557,2,559,768,0,0,0,0,0,0,0,66.31 ,72.79 ,66.31 
03,013,01,002,0079,130,1252,14,1266,1813,0,0,0,0,0,0,0,66.31 ,69.83 ,66.31 
03,013,01,002,0080,131,1276,13,1289,1930,0,0,0,0,0,0,0,66.31 ,66.79 ,66.31 
03,013,01,002,0081,132,1009,10,1019,1571,0,0,0,0,0,0,0,66.31 ,64.86 ,66.31 
03,013,01,002,0081,133,829,12,841,1259,0,0,0,0,0,0,0,66.31 ,66.80 ,66.31 
03,013,01,002,0081,134,1135,7,1142,1733,0,0,0,0,0,0,0,66.31 ,65.90 ,66.31 
03,013,01,002,0082,135,892,8,900,1403,0,0,0,0,0,0,0,66.31 ,64.15 ,66.31 
03,013,01,002,0083,136,881,13,894,1264,0,0,0,0,0,0,0,66.31 ,70.73 ,66.31 
03,013,01,002,0084,137,579,3,582,798,0,0,0,0,0,0,0,66.31 ,72.93 ,66.31 
03,013,01,002,0085,138,377,7,384,583,0,0,0,0,0,0,0,66.31 ,65.87 ,66.31 
03,013,01,002,0086,139,1006,15,1021,1547,0,0,0,0,0,0,0,66.31 ,66.00 ,66.31 
03,013,01,002,0087,140,1025,16,1041,1437,0,0,0,0,0,0,0,66.31 ,72.44 ,66.31 
03,013,01,002,0088,141,1337,18,1355,1872,0,0,0,0,0,0,0,66.31 ,72.38 ,66.31 
03,013,01,002,0089,142,1015,8,1023,1559,0,0,0,0,0,0,0,66.31 ,65.62 ,66.31 
03,013,01,003,0090,143,800,8,808,1090,0,0,0,0,0,0,0,66.31 ,74.13 ,66.31 
03,013,01,003,0090,144,883,5,888,1199,0,0,0,0,0,0,0,66.31 ,74.06 ,66.31 
03,013,01,003,0091,145,426,2,428,577,0,0,0,0,0,0,0,66.31 ,74.18 ,66.31 
03,013,01,003,0092,146,382,1,383,492,0,0,0,0,0,0,0,66.31 ,77.85 ,66.31 
03,013,01,003,0093,147,530,0,530,737,0,0,0,0,0,0,0,66.31 ,71.91 ,66.31 
03,013,01,003,0094,148,429,6,435,615,0,0,0,0,0,0,0,66.31 ,70.73 ,66.31 
03,013,01,003,0095,149,1228,13,1241,1731,0,0,0,0,0,0,0,66.31 ,71.69 ,66.31 
03,013,01,003,0095,150,1107,8,1115,1737,0,0,0,0,0,0,0,66.31 ,64.19 ,66.31 
03,013,01,003,0095,151,1096,9,1105,1515,0,0,0,0,0,0,0,66.31 ,72.94 ,66.31 
03,013,01,003,0096,152,568,4,572,725,0,0,0,0,0,0,0,66.31 ,78.90 ,66.31 
03,013,01,003,0097,153,553,11,564,745,0,0,0,0,0,0,0,66.31 ,75.70 ,66.31 
03,013,01,003,0098,154,875,7,882,1291,0,0,0,0,0,0,0,66.31 ,68.32 ,66.31 
03,013,01,003,0098,155,439,1,440,613,0,0,0,0,0,0,0,66.31 ,71.78 ,66.31 
03,013,01,003,0099,156,610,4,614,884,0,0,0,0,0,0,0,66.31 ,69.46 ,66.31 
03,013,01,003,0100,157,956,12,968,1379,0,0,0,0,0,0,0,66.31 ,70.20 ,66.31 
03,013,01,003,0101,158,543,4,547,734,0,0,0,0,0,0,0,66.31 ,74.52 ,66.31 
03,013,01,003,0102,159,917,14,931,1288,0,0,0,0,0,0,0,66.31 ,72.28 ,66.31 
03,013,01,003,0103,160,567,7,574,770,0,0,0,0,0,0,0,66.31 ,74.55 ,66.31 
03,013,01,003,0103,161,775,9,784,1085,0,0,0,0,0,0,0,66.31 ,72.26 ,66.31 
03,013,01,003,0104,162,856,13,869,1187,0,0,0,0,0,0,0,66.31 ,73.21 ,66.31 
03,013,01,003,0104,163,860,8,868,1237,0,0,0,0,0,0,0,66.31 ,70.17 ,66.31 
03,013,01,003,0105,164,995,6,1001,1439,0,0,0,0,0,0,0,66.31 ,69.56 ,66.31 
03,013,01,003,0106,165,348,4,352,449,0,0,0,0,0,0,0,66.31 ,78.40 ,66.31 
03,013,01,003,0106,166,782,5,787,1160,0,0,0,0,0,0,0,66.31 ,67.84 ,66.31 
03,013,01,003,0107,167,1410,13,1423,2001,0,0,0,0,0,0,0,66.31 ,71.11 ,66.31 
03,013,01,003,0107,168,795,3,798,1226,0,0,0,0,0,0,0,66.31 ,65.09 ,66.31 
03,013,01,003,0108,169,1258,8,1266,1749,0,0,0,0,0,0,0,66.31 ,72.38 ,66.31 
03,013,01,003,0109,170,1141,9,1150,1532,0,0,0,0,0,0,0,66.31 ,75.07 ,66.31 
03,013,01,003,0110,171,640,6,646,844,0,0,0,0,0,0,0,66.31 ,76.54 ,66.31 
03,013,01,003,0111,172,506,4,510,733,0,0,0,0,0,0,0,66.31 ,69.58 ,66.31 
03,013,01,003,0112,173,210,0,210,355,0,0,0,0,0,0,0,66.31 ,59.15 ,66.31 
03,013,01,004,0113,174,643,7,650,990,0,0,0,0,0,0,0,66.31 ,65.66 ,66.31 
03,013,01,004,0114,175,564,16,580,933,0,0,0,0,0,0,0,66.31 ,62.17 ,66.31 
03,013,01,004,0114,176,552,9,561,985,0,0,0,0,0,0,0,66.31 ,56.95 ,66.31 
03,013,01,004,0115,177,688,4,692,1138,0,0,0,0,0,0,0,66.31 ,60.81 ,66.31 
03,013,01,004,0116,178,644,4,648,1119,0,0,0,0,0,0,0,66.31 ,57.91 ,66.31 
03,013,01,004,0116,179,576,16,592,1042,0,0,0,0,0,0,0,66.31 ,56.81 ,66.31 
03,013,01,004,0116,180,559,10,569,1086,0,0,0,0,0,0,0,66.31 ,52.39 ,66.31 
03,013,01,004,0117,181,735,9,744,1299,0,0,0,0,0,0,0,66.31 ,57.27 ,66.31 
03,013,01,004,0117,182,648,9,657,1144,0,0,0,0,0,0,0,66.31 ,57.43 ,66.31 
03,013,01,004,0118,183,433,2,435,802,0,0,0,0,0,0,0,66.31 ,54.24 ,66.31 
03,013,01,004,0119,184,296,10,306,503,0,0,0,0,0,0,0,66.31 ,60.83 ,66.31 
03,013,01,004,0120,185,240,2,242,487,0,0,0,0,0,0,0,66.31 ,49.69 ,66.31 
03,013,01,004,0121,186,561,13,574,924,0,0,0,0,0,0,0,66.31 ,62.12 ,66.31 
03,013,01,004,0122,187,367,11,378,570,0,0,0,0,0,0,0,66.31 ,66.32 ,66.31 
03,013,01,004,0123,188,598,9,607,956,0,0,0,0,0,0,0,66.31 ,63.49 ,66.31 
03,013,01,004,0124,189,883,15,898,1460,0,0,0,0,0,0,0,66.31 ,61.51 ,66.31 
03,013,01,004,0125,190,501,11,512,863,0,0,0,0,0,0,0,66.31 ,59.33 ,66.31 
03,013,01,004,0125,191,496,10,506,878,0,0,0,0,0,0,0,66.31 ,57.63 ,66.31 
03,013,01,004,0126,192,754,14,768,1410,0,0,0,0,0,0,0,66.31 ,54.47 ,66.31 
03,013,01,004,0127,193,787,17,804,1325,0,0,0,0,0,0,0,66.31 ,60.68 ,66.31 
03,013,01,004,0128,194,758,16,774,1153,0,0,0,0,0,0,0,66.31 ,67.13 ,66.31 
03,013,01,004,0129,195,660,7,667,1031,0,0,0,0,0,0,0,66.31 ,64.69 ,66.31 
03,013,01,005,0130,196,916,6,922,1330,0,0,0,0,0,0,0,66.31 ,69.32 ,66.31 
03,013,01,005,0131,197,931,5,936,1320,0,0,0,0,0,0,0,66.31 ,70.91 ,66.31 
03,013,01,005,0132,198,1220,11,1231,1680,0,0,0,0,0,0,0,66.31 ,73.27 ,66.31 
03,013,01,005,0133,199,631,7,638,819,0,0,0,0,0,0,0,66.31 ,77.90 ,66.31 
03,013,01,005,0134,200,925,4,929,1093,0,0,0,0,0,0,0,66.31 ,85.00 ,66.31 
03,013,01,005,0135,201,813,9,822,1031,0,0,0,0,0,0,0,66.31 ,79.73 ,66.31 
03,013,01,005,0136,202,500,1,501,622,0,0,0,0,0,0,0,66.31 ,80.55 ,66.31 
03,013,01,005,0137,203,1101,8,1109,1534,0,0,0,0,0,0,0,66.31 ,72.29 ,66.31 
03,013,01,005,0138,204,987,9,996,1361,0,0,0,0,0,0,0,66.31 ,73.18 ,66.31 
03,013,01,005,0139,205,1034,15,1049,1373,0,0,0,0,0,0,0,66.31 ,76.40 ,66.31 
03,013,01,005,0140,206,639,2,641,825,0,0,0,0,0,0,0,66.31 ,77.70 ,66.31 
03,013,01,005,0141,207,802,11,813,963,0,0,0,0,0,0,0,66.31 ,84.42 ,66.31 
03,013,01,005,0142,208,914,6,920,1160,0,0,0,0,0,0,0,66.31 ,79.31 ,66.31 
03,013,01,005,0143,209,1095,8,1103,1382,0,0,0,0,0,0,0,66.31 ,79.81 ,66.31 
03,013,01,005,0144,210,1369,14,1383,1752,0,0,0,0,0,0,0,66.31 ,78.94 ,66.31 
03,013,01,005,0145,211,1396,19,1415,1782,0,0,0,0,0,0,0,66.31 ,79.41 ,66.31 
03,013,01,005,0146,212,383,2,385,498,0,0,0,0,0,0,0,66.31 ,77.31 ,66.31 
03,013,01,005,0147,213,592,6,598,762,0,0,0,0,0,0,0,66.31 ,78.48 ,66.31 
03,013,01,005,0148,214,860,2,862,1084,0,0,0,0,0,0,0,66.31 ,79.52 ,66.31 
03,013,01,005,0149,215,268,3,271,351,0,0,0,0,0,0,0,66.31 ,77.21 ,66.31 
03,013,01,005,0150,216,975,11,986,1292,0,0,0,0,0,0,0,66.31 ,76.32 ,66.31 
03,013,01,005,0151,217,1031,4,1035,1416,0,0,0,0,0,0,0,66.31 ,73.09 ,66.31 
03,013,01,005,0152,218,1285,7,1292,1740,0,0,0,0,0,0,0,66.31 ,74.25 ,66.31 
03,013,01,005,0153,219,1205,8,1213,1631,0,0,0,0,0,0,0,66.31 ,74.37 ,66.31 
03,013,01,005,0154,220,716,9,725,955,0,0,0,0,0,0,0,66.31 ,75.92 ,66.31 
03,013,01,005,0154,221,739,6,745,953,0,0,0,0,0,0,0,66.31 ,78.17 ,66.31 
03,013,01,005,0155,222,893,10,903,1192,0,0,0,0,0,0,0,66.31 ,75.76 ,66.31 
03,013,01,005,0156,223,543,4,547,687,0,0,0,0,0,0,0,66.31 ,79.62 ,66.31 
03,013,01,005,0157,224,376,9,385,499,0,0,0,0,0,0,0,66.31 ,77.15 ,66.31 
03,013,01,005,0158,225,351,2,353,446,0,0,0,0,0,0,0,66.31 ,79.15 ,66.31 
03,013,01,005,0159,226,1245,17,1262,1655,0,0,0,0,0,0,0,66.31 ,76.25 ,66.31 
03,013,01,005,0159,227,1123,8,1131,1488,0,0,0,0,0,0,0,66.31 ,76.01 ,66.31 
03,013,01,006,0160,228,572,10,582,898,0,0,0,0,0,0,0,66.31 ,64.81 ,66.31 
03,013,01,006,0160,229,715,9,724,1098,0,0,0,0,0,0,0,66.31 ,65.94 ,66.31 
03,013,01,006,0161,230,692,2,694,1027,0,0,0,0,0,0,0,66.31 ,67.58 ,66.31 
03,013,01,006,0161,231,943,7,950,1345,0,0,0,0,0,0,0,66.31 ,70.63 ,66.31 
03,013,01,006,0162,232,1002,11,1013,1408,0,0,0,0,0,0,0,66.31 ,71.95 ,66.31 
03,013,01,006,0163,233,1059,6,1065,1609,0,0,0,0,0,0,0,66.31 ,66.19 ,66.31 
03,013,01,006,0164,234,690,4,694,960,0,0,0,0,0,0,0,66.31 ,72.29 ,66.31 
03,013,01,006,0165,235,1028,13,1041,1404,0,0,0,0,0,0,0,66.31 ,74.15 ,66.31 
03,013,01,006,0166,236,748,11,759,1023,0,0,0,0,0,0,0,66.31 ,74.19 ,66.31 
03,013,01,006,0167,237,562,8,570,757,0,0,0,0,0,0,0,66.31 ,75.30 ,66.31 
03,013,01,006,0168,238,974,6,980,1373,0,0,0,0,0,0,0,66.31 ,71.38 ,66.31 
03,013,01,006,0169,239,618,5,623,813,0,0,0,0,0,0,0,66.31 ,76.63 ,66.31 
03,013,01,006,0170,240,765,13,778,1038,0,0,0,0,0,0,0,66.31 ,74.95 ,66.31 
03,013,01,006,0171,241,889,5,894,1295,0,0,0,0,0,0,0,66.31 ,69.03 ,66.31 
03,013,01,006,0172,242,1090,8,1098,1582,0,0,0,0,0,0,0,66.31 ,69.41 ,66.31 
03,013,01,006,0173,243,731,2,733,1027,0,0,0,0,0,0,0,66.31 ,71.37 ,66.31 
03,013,01,006,0174,244,848,7,855,1171,0,0,0,0,0,0,0,66.31 ,73.01 ,66.31 
03,013,01,006,0174,245,565,7,572,933,0,0,0,0,0,0,0,66.31 ,61.31 ,66.31 
03,013,01,006,0175,246,317,6,323,495,0,0,0,0,0,0,0,66.31 ,65.25 ,66.31 
03,013,01,007,0176,247,492,7,499,697,0,0,0,0,0,0,0,66.31 ,71.59 ,66.31 
03,013,01,007,0176,248,714,6,720,953,0,0,0,0,0,0,0,66.31 ,75.55 ,66.31 
03,013,01,007,0177,249,632,2,634,827,0,0,0,0,0,0,0,66.31 ,76.66 ,66.31 
03,013,01,007,0178,250,1071,3,1074,1468,0,0,0,0,0,0,0,66.31 ,73.16 ,66.31 
03,013,01,007,0179,251,780,6,786,1108,0,0,0,0,0,0,0,66.31 ,70.94 ,66.31 
03,013,01,007,0179,252,688,1,689,988,0,0,0,0,0,0,0,66.31 ,69.74 ,66.31 
03,013,01,007,0180,253,774,3,777,1041,0,0,0,0,0,0,0,66.31 ,74.64 ,66.31 
03,013,01,007,0181,254,558,6,564,756,0,0,0,0,0,0,0,66.31 ,74.60 ,66.31 
03,013,01,007,0182,255,498,5,503,675,0,0,0,0,0,0,0,66.31 ,74.52 ,66.31 
03,013,01,008,0183,256,1153,7,1160,1528,0,0,0,0,0,0,0,66.31 ,75.92 ,66.31 
03,013,01,008,0184,257,934,12,946,1248,0,0,0,0,0,0,0,66.31 ,75.80 ,66.31 
03,013,01,008,0185,258,981,10,991,1359,0,0,0,0,0,0,0,66.31 ,72.92 ,66.31 
03,013,01,008,0186,259,746,5,751,967,0,0,0,0,0,0,0,66.31 ,77.66 ,66.31 
03,013,01,008,0187,260,877,9,886,1211,0,0,0,0,0,0,0,66.31 ,73.16 ,66.31 
03,013,01,008,0188,261,1016,6,1022,1388,0,0,0,0,0,0,0,66.31 ,73.63 ,66.31 
03,013,01,008,0189,262,452,2,454,625,0,0,0,0,0,0,0,66.31 ,72.64 ,66.31 
03,013,01,008,0189,263,1151,13,1164,1572,0,0,0,0,0,0,0,66.31 ,74.05 ,66.31 
03,013,01,008,0189,264,651,3,654,923,0,0,0,0,0,0,0,66.31 ,70.86 ,66.31 
03,013,01,008,0190,265,880,9,889,1183,0,0,0,0,0,0,0,66.31 ,75.15 ,66.31 
03,013,01,008,0191,266,807,12,819,1145,0,0,0,0,0,0,0,66.31 ,71.53 ,66.31 
03,013,01,008,0192,267,1158,10,1168,1611,0,0,0,0,0,0,0,66.31 ,72.50 ,66.31 
03,013,01,008,0193,268,952,5,957,1245,0,0,0,0,0,0,0,66.31 ,76.87 ,66.31 
03,013,01,009,0194,269,534,4,538,772,0,0,0,0,0,0,0,66.31 ,69.69 ,66.31 
03,013,01,009,0194,270,754,7,761,1083,0,0,0,0,0,0,0,66.31 ,70.27 ,66.31 
03,013,01,009,0195,271,876,7,883,1140,0,0,0,0,0,0,0,66.31 ,77.46 ,66.31 
03,013,01,009,0196,272,570,5,575,795,0,0,0,0,0,0,0,66.31 ,72.33 ,66.31 
03,013,01,009,0197,273,863,8,871,1176,0,0,0,0,0,0,0,66.31 ,74.06 ,66.31 
03,013,01,009,0198,274,587,8,595,827,0,0,0,0,0,0,0,66.31 ,71.95 ,66.31 
03,013,01,009,0198,275,481,10,491,762,0,0,0,0,0,0,0,66.31 ,64.44 ,66.31 
03,013,01,009,0199,276,826,6,832,1167,0,0,0,0,0,0,0,66.31 ,71.29 ,66.31 
03,013,01,009,0200,277,952,12,964,1303,0,0,0,0,0,0,0,66.31 ,73.98 ,66.31 
03,013,01,009,0201,278,931,5,936,1277,0,0,0,0,0,0,0,66.31 ,73.30 ,66.31 
03,013,01,009,0202,279,295,5,300,402,0,0,0,0,0,0,0,66.31 ,74.63 ,66.31 
03,013,01,009,0202,280,861,6,867,1159,0,0,0,0,0,0,0,66.31 ,74.81 ,66.31 
03,013,01,009,0203,281,707,6,713,969,0,0,0,0,0,0,0,66.31 ,73.58 ,66.31 
03,013,01,009,0203,282,920,8,928,1254,0,0,0,0,0,0,0,66.31 ,74.00 ,66.31 
03,013,01,009,0204,283,1079,11,1090,1487,0,0,0,0,0,0,0,66.31 ,73.30 ,66.31 
03,013,01,009,0204,284,370,11,381,528,0,0,0,0,0,0,0,66.31 ,72.16 ,66.31 
03,013,01,009,0205,285,631,9,640,869,0,0,0,0,0,0,0,66.31 ,73.65 ,66.31 
03,013,01,009,0205,286,606,2,608,865,0,0,0,0,0,0,0,66.31 ,70.29 ,66.31 
03,013,01,009,0206,287,526,2,528,773,0,0,0,0,0,0,0,66.31 ,68.31 ,66.31 
03,013,01,009,0207,288,359,4,363,498,0,0,0,0,0,0,0,66.31 ,72.89 ,66.31 
03,013,01,010,0208,289,1183,3,1186,1592,0,0,0,0,0,0,0,66.31 ,74.50 ,66.31 
03,013,01,010,0209,290,1573,23,1596,2187,0,0,0,0,0,0,0,66.31 ,72.98 ,66.31 
03,013,01,010,0210,291,1058,12,1070,1516,0,0,0,0,0,0,0,66.31 ,70.58 ,66.31 
03,013,01,010,0211,292,740,8,748,871,0,0,0,0,0,0,0,66.31 ,85.88 ,66.31 
03,013,01,010,0212,293,881,15,896,1257,0,0,0,0,0,0,0,66.31 ,71.28 ,66.31 
03,013,01,010,0212,294,954,7,961,1318,0,0,0,0,0,0,0,66.31 ,72.91 ,66.31 
03,013,01,010,0213,295,1286,15,1301,1892,0,0,0,0,0,0,0,66.31 ,68.76 ,66.31 
03,013,01,010,0214,296,659,3,662,829,0,0,0,0,0,0,0,66.31 ,79.86 ,66.31 
03,013,01,010,0215,297,1899,29,1928,2711,0,0,0,0,0,0,0,66.31 ,71.12 ,66.31 
03,013,01,010,0216,298,852,10,862,1229,0,0,0,0,0,0,0,66.31 ,70.14 ,66.31 
03,013,01,010,0216,299,1072,11,1083,1655,0,0,0,0,0,0,0,66.31 ,65.44 ,66.31 
03,013,01,010,0217,300,720,3,723,937,0,0,0,0,0,0,0,66.31 ,77.16 ,66.31 
03,013,01,010,0218,301,1004,22,1026,1346,0,0,0,0,0,0,0,66.31 ,76.23 ,66.31 
03,013,01,010,0219,302,398,4,402,574,0,0,0,0,0,0,0,66.31 ,70.03 ,66.31 
03,013,01,011,0220,303,794,12,806,1184,0,0,0,0,0,0,0,66.31 ,68.07 ,66.31 
03,013,01,011,0220,304,667,3,670,986,0,0,0,0,0,0,0,66.31 ,67.95 ,66.31 
03,013,01,011,0221,305,930,9,939,1379,0,0,0,0,0,0,0,66.31 ,68.09 ,66.31 
03,013,01,011,0222,306,581,7,588,838,0,0,0,0,0,0,0,66.31 ,70.17 ,66.31 
03,013,01,011,0223,307,431,3,434,633,0,0,0,0,0,0,0,66.31 ,68.56 ,66.31 
03,013,01,011,0224,308,657,2,659,1006,0,0,0,0,0,0,0,66.31 ,65.51 ,66.31 
03,013,01,011,0225,309,734,10,744,1198,0,0,0,0,0,0,0,66.31 ,62.10 ,66.31 
03,013,01,011,0226,310,444,6,450,696,0,0,0,0,0,0,0,66.31 ,64.66 ,66.31 
03,013,01,011,0227,311,547,5,552,855,0,0,0,0,0,0,0,66.31 ,64.56 ,66.31 
03,013,01,011,0228,312,518,6,524,761,0,0,0,0,0,0,0,66.31 ,68.86 ,66.31 
03,013,01,011,0229,313,839,8,847,1329,0,0,0,0,0,0,0,66.31 ,63.73 ,66.31 
03,013,01,011,0230,314,939,25,964,1554,0,0,0,0,0,0,0,66.31 ,62.03 ,66.31 
03,013,01,011,0231,315,599,5,604,994,0,0,0,0,0,0,0,66.31 ,60.76 ,66.31 
03,013,01,011,0231,316,600,10,610,1026,0,0,0,0,0,0,0,66.31 ,59.45 ,66.31 
03,013,01,011,0232,317,789,9,798,1229,0,0,0,0,0,0,0,66.31 ,64.93 ,66.31 
03,013,01,011,0233,318,627,7,634,956,0,0,0,0,0,0,0,66.31 ,66.32 ,66.31 
03,013,01,011,0234,319,695,9,704,1073,0,0,0,0,0,0,0,66.31 ,65.61 ,66.31 
03,013,01,011,0235,320,739,11,750,1046,0,0,0,0,0,0,0,66.31 ,71.70 ,66.31 
03,013,01,011,0236,321,759,9,768,1140,0,0,0,0,0,0,0,66.31 ,67.37 ,66.31 
03,013,01,011,0237,322,466,7,473,740,0,0,0,0,0,0,0,66.31 ,63.92 ,66.31 
03,013,01,011,0237,323,395,6,401,631,0,0,0,0,0,0,0,66.31 ,63.55 ,66.31 
03,013,01,011,0238,324,909,6,915,1406,0,0,0,0,0,0,0,66.31 ,65.08 ,66.31 
03,013,01,012,0239,325,862,4,866,1230,0,0,0,0,0,0,0,66.31 ,70.41 ,66.31 
03,013,01,012,0240,326,594,5,599,799,0,0,0,0,0,0,0,66.31 ,74.97 ,66.31 
03,013,01,012,0241,327,940,12,952,1369,0,0,0,0,0,0,0,66.31 ,69.54 ,66.31 
03,013,01,012,0242,328,656,2,658,908,0,0,0,0,0,0,0,66.31 ,72.47 ,66.31 
03,013,01,012,0243,329,383,2,385,531,0,0,0,0,0,0,0,66.31 ,72.50 ,66.31 
03,013,01,012,0244,330,877,13,890,1280,0,0,0,0,0,0,0,66.31 ,69.53 ,66.31 
03,013,01,012,0245,331,861,9,870,1152,0,0,0,0,0,0,0,66.31 ,75.52 ,66.31 
03,013,01,012,0246,332,915,17,932,1380,0,0,0,0,0,0,0,66.31 ,67.54 ,66.31 
03,013,01,012,0247,333,952,22,974,1669,0,0,0,0,0,0,0,66.31 ,58.36 ,66.31 
03,013,01,012,0248,334,669,9,678,990,0,0,0,0,0,0,0,66.31 ,68.48 ,66.31 
03,013,01,012,0248,335,563,11,574,907,0,0,0,0,0,0,0,66.31 ,63.29 ,66.31 
03,013,01,012,0249,336,1104,10,1114,1564,0,0,0,0,0,0,0,66.31 ,71.23 ,66.31 
03,013,01,012,0250,337,1155,13,1168,1497,0,0,0,0,0,0,0,66.31 ,78.02 ,66.31 
03,013,01,012,0251,338,779,6,785,1063,0,0,0,0,0,0,0,66.31 ,73.85 ,66.31 
03,013,01,012,0252,339,395,2,397,594,0,0,0,0,0,0,0,66.31 ,66.84 ,66.31 
03,013,01,012,0252,340,374,3,377,593,0,0,0,0,0,0,0,66.31 ,63.58 ,66.31 
03,013,01,013,0253,341,832,16,848,1260,0,0,0,0,0,0,0,66.31 ,67.30 ,66.31 
03,013,01,013,0253,342,1125,8,1133,1755,0,0,0,0,0,0,0,66.31 ,64.56 ,66.31 
03,013,01,013,0254,343,670,8,678,1103,0,0,0,0,0,0,0,66.31 ,61.47 ,66.31 
03,013,01,013,0254,344,1017,11,1028,1577,0,0,0,0,0,0,0,66.31 ,65.19 ,66.31 
03,013,01,013,0255,345,976,11,987,1337,0,0,0,0,0,0,0,66.31 ,73.82 ,66.31 
03,013,01,013,0256,346,374,3,377,566,0,0,0,0,0,0,0,66.31 ,66.61 ,66.31 
03,013,01,013,0257,347,683,8,691,1005,0,0,0,0,0,0,0,66.31 ,68.76 ,66.31 
03,013,01,013,0257,348,679,12,691,992,0,0,0,0,0,0,0,66.31 ,69.66 ,66.31 
03,013,01,013,0258,349,585,6,591,828,0,0,0,0,0,0,0,66.31 ,71.38 ,66.31 
03,013,01,013,0258,350,610,4,614,913,0,0,0,0,0,0,0,66.31 ,67.25 ,66.31 
03,013,01,013,0259,351,689,8,697,979,0,0,0,0,0,0,0,66.31 ,71.20 ,66.31 
03,013,01,013,0259,352,812,2,814,1274,0,0,0,0,0,0,0,66.31 ,63.89 ,66.31 
03,013,01,013,0259,353,963,2,965,1502,0,0,0,0,0,0,0,66.31 ,64.25 ,66.31 
03,013,01,013,0260,354,648,8,656,1107,0,0,0,0,0,0,0,66.31 ,59.26 ,66.31 
03,013,01,013,0260,355,713,5,718,1162,0,0,0,0,0,0,0,66.31 ,61.79 ,66.31 
03,013,01,013,0261,356,628,5,633,862,0,0,0,0,0,0,0,66.31 ,73.43 ,66.31 
03,013,01,013,0261,357,510,6,516,776,0,0,0,0,0,0,0,66.31 ,66.49 ,66.31 
03,013,01,013,0262,358,578,4,582,821,0,0,0,0,0,0,0,66.31 ,70.89 ,66.31 
03,013,01,013,0262,359,713,7,720,1072,0,0,0,0,0,0,0,66.31 ,67.16 ,66.31 
03,013,01,013,0263,360,961,17,978,1498,0,0,0,0,0,0,0,66.31 ,65.29 ,66.31 
03,013,01,013,0264,361,804,5,809,1160,0,0,0,0,0,0,0,66.31 ,69.74 ,66.31 
03,013,01,013,0264,362,1169,21,1190,1741,0,0,0,0,0,0,0,66.31 ,68.35 ,66.31 
03,013,01,013,0265,363,635,7,642,949,0,0,0,0,0,0,0,66.31 ,67.65 ,66.31 
03,013,01,013,0266,364,720,6,726,1027,0,0,0,0,0,0,0,66.31 ,70.69 ,66.31 
03,013,01,013,0267,365,678,5,683,1102,0,0,0,0,0,0,0,66.31 ,61.98 ,66.31 
03,013,01,013,0267,366,720,6,726,1217,0,0,0,0,0,0,0,66.31 ,59.65 ,66.31 
03,013,01,013,0268,367,953,7,960,1399,0,0,0,0,0,0,0,66.31 ,68.62 ,66.31 
03,013,01,013,0269,368,882,6,888,1336,0,0,0,0,0,0,0,66.31 ,66.47 ,66.31 
03,013,01,013,0269,369,709,7,716,1133,0,0,0,0,0,0,0,66.31 ,63.20 ,66.31 
03,013,01,013,0270,370,118,4,122,188,0,0,0,0,0,0,0,66.31 ,64.89 ,66.31 
03,013,01,013,0270,371,860,17,877,1351,0,0,0,0,0,0,0,66.31 ,64.91 ,66.31 
03,013,01,013,0270,372,599,17,616,1016,0,0,0,0,0,0,0,66.31 ,60.63 ,66.31 
03,013,01,013,0271,373,441,3,444,638,0,0,0,0,0,0,0,66.31 ,69.59 ,66.31 
03,013,01,013,0271,374,914,22,936,1453,0,0,0,0,0,0,0,66.31 ,64.42 ,66.31 
03,013,01,013,0272,375,891,13,904,1277,0,0,0,0,0,0,0,66.31 ,70.79 ,66.31 
03,013,01,013,0272,376,260,5,265,412,0,0,0,0,0,0,0,66.31 ,64.32 ,66.31 
03,013,01,013,0273,377,711,4,715,1128,0,0,0,0,0,0,0,66.31 ,63.39 ,66.31 
03,013,01,013,0273,378,696,9,705,1038,0,0,0,0,0,0,0,66.31 ,67.92 ,66.31 
03,013,01,013,0274,379,704,10,714,1150,0,0,0,0,0,0,0,66.31 ,62.09 ,66.31 
03,013,01,013,0275,380,527,6,533,800,0,0,0,0,0,0,0,66.31 ,66.63 ,66.31 
03,013,01,014,0276,381,1037,10,1047,1417,0,0,0,0,0,0,0,66.31 ,73.89 ,66.31 
03,013,01,014,0277,382,602,6,608,856,0,0,0,0,0,0,0,66.31 ,71.03 ,66.31 
03,013,01,014,0278,383,497,3,500,675,0,0,0,0,0,0,0,66.31 ,74.07 ,66.31 
03,013,01,014,0279,384,445,3,448,585,0,0,0,0,0,0,0,66.31 ,76.58 ,66.31 
03,013,01,014,0280,385,960,12,972,1292,0,0,0,0,0,0,0,66.31 ,75.23 ,66.31 
03,013,01,014,0281,386,738,7,745,966,0,0,0,0,0,0,0,66.31 ,77.12 ,66.31 
03,013,01,014,0282,387,472,2,474,601,0,0,0,0,0,0,0,66.31 ,78.87 ,66.31 
03,013,01,014,0283,388,351,4,355,457,0,0,0,0,0,0,0,66.31 ,77.68 ,66.31 
03,013,01,014,0284,389,957,12,969,1311,0,0,0,0,0,0,0,66.31 ,73.91 ,66.31 
03,013,01,014,0284,390,896,7,903,1250,0,0,0,0,0,0,0,66.31 ,72.24 ,66.31 
03,013,01,014,0285,391,336,4,340,425,0,0,0,0,0,0,0,66.31 ,80.00 ,66.31 
03,013,01,014,0286,392,398,4,402,570,0,0,0,0,0,0,0,66.31 ,70.53 ,66.31 
03,013,01,014,0287,393,498,3,501,647,0,0,0,0,0,0,0,66.31 ,77.43 ,66.31 
03,013,01,014,0288,394,749,11,760,1142,0,0,0,0,0,0,0,66.31 ,66.55 ,66.31 
03,013,01,014,0289,395,783,4,787,1108,0,0,0,0,0,0,0,66.31 ,71.03 ,66.31 
03,013,01,014,0290,396,693,6,699,942,0,0,0,0,0,0,0,66.31 ,74.20 ,66.31 
03,013,01,015,0291,397,1057,11,1068,1521,0,0,0,0,0,0,0,66.31 ,70.22 ,66.31 
03,013,01,015,0291,398,254,2,256,339,0,0,0,0,0,0,0,66.31 ,75.52 ,66.31 
03,013,01,015,0292,399,877,6,883,1214,0,0,0,0,0,0,0,66.31 ,72.73 ,66.31 
03,013,01,015,0293,400,744,7,751,1058,0,0,0,0,0,0,0,66.31 ,70.98 ,66.31 
03,013,01,015,0294,401,503,3,506,753,0,0,0,0,0,0,0,66.31 ,67.20 ,66.31 
03,013,01,015,0295,402,644,8,652,1008,0,0,0,0,0,0,0,66.31 ,64.68 ,66.31 
03,013,01,015,0295,403,398,1,399,645,0,0,0,0,0,0,0,66.31 ,61.86 ,66.31 
03,013,01,015,0296,404,728,5,733,1309,0,0,0,0,0,0,0,66.31 ,56.00 ,66.31 
03,013,01,015,0297,405,312,0,312,528,0,0,0,0,0,0,0,66.31 ,59.09 ,66.31 
03,013,01,015,0297,406,397,2,399,543,0,0,0,0,0,0,0,66.31 ,73.48 ,66.31 
03,013,01,016,0298,407,882,12,894,1344,0,0,0,0,0,0,0,66.31 ,66.52 ,66.31 
03,013,01,016,0299,408,566,5,571,862,0,0,0,0,0,0,0,66.31 ,66.24 ,66.31 
03,013,01,016,0300,409,606,6,612,944,0,0,0,0,0,0,0,66.31 ,64.83 ,66.31 
03,013,01,016,0301,410,495,5,500,744,0,0,0,0,0,0,0,66.31 ,67.20 ,66.31 
03,013,01,016,0302,411,1136,7,1143,1798,0,0,0,0,0,0,0,66.31 ,63.57 ,66.31 
03,013,01,016,0303,412,1028,6,1034,1728,0,0,0,0,0,0,0,66.31 ,59.84 ,66.31 
03,013,01,016,0303,413,1043,9,1052,1748,0,0,0,0,0,0,0,66.31 ,60.18 ,66.31 
03,013,01,016,0304,414,642,2,644,920,0,0,0,0,0,0,0,66.31 ,70.00 ,66.31 
03,013,01,016,0304,415,722,5,727,1054,0,0,0,0,0,0,0,66.31 ,68.98 ,66.31 
03,013,01,016,0305,416,1156,8,1164,1682,0,0,0,0,0,0,0,66.31 ,69.20 ,66.31 
03,013,01,016,0306,417,713,13,726,1059,0,0,0,0,0,0,0,66.31 ,68.56 ,66.31 
03,013,01,016,0306,418,764,13,777,1135,0,0,0,0,0,0,0,66.31 ,68.46 ,66.31 
03,013,01,016,0307,419,417,5,422,775,0,0,0,0,0,0,0,66.31 ,54.45 ,66.31 
03,013,01,016,0308,420,585,9,594,1000,0,0,0,0,0,0,0,66.31 ,59.40 ,66.31 
03,013,01,016,0309,421,755,8,763,1068,0,0,0,0,0,0,0,66.31 ,71.44 ,66.31 
03,013,01,016,0309,422,1061,10,1071,1570,0,0,0,0,0,0,0,66.31 ,68.22 ,66.31 
03,013,01,016,0310,423,399,3,402,587,0,0,0,0,0,0,0,66.31 ,68.48 ,66.31 
03,013,01,016,0311,424,608,11,619,958,0,0,0,0,0,0,0,66.31 ,64.61 ,66.31 
03,013,01,016,0312,425,251,3,254,422,0,0,0,0,0,0,0,66.31 ,60.19 ,66.31 
03,013,01,017,0313,426,1229,9,1238,1565,0,0,0,0,0,0,0,66.31 ,79.11 ,66.31 
03,013,01,017,0314,427,750,2,752,1010,0,0,0,0,0,0,0,66.31 ,74.46 ,66.31 
03,013,01,017,0314,428,880,8,888,1221,0,0,0,0,0,0,0,66.31 ,72.73 ,66.31 
03,013,01,017,0315,429,727,6,733,987,0,0,0,0,0,0,0,66.31 ,74.27 ,66.31 
03,013,01,017,0315,430,706,11,717,954,0,0,0,0,0,0,0,66.31 ,75.16 ,66.31 
03,013,01,017,0316,431,523,7,530,710,0,0,0,0,0,0,0,66.31 ,74.65 ,66.31 
03,013,01,017,0317,432,589,3,592,749,0,0,0,0,0,0,0,66.31 ,79.04 ,66.31 
03,013,01,017,0318,433,896,14,910,1198,0,0,0,0,0,0,0,66.31 ,75.96 ,66.31 
03,013,01,017,0318,434,749,6,755,988,0,0,0,0,0,0,0,66.31 ,76.42 ,66.31 
03,013,01,017,0319,435,677,7,684,895,0,0,0,0,0,0,0,66.31 ,76.42 ,66.31 
03,013,01,017,0319,436,805,3,808,1070,0,0,0,0,0,0,0,66.31 ,75.51 ,66.31 
03,013,01,017,0320,437,850,4,854,1053,0,0,0,0,0,0,0,66.31 ,81.10 ,66.31 
03,013,01,017,0320,438,891,7,898,1122,0,0,0,0,0,0,0,66.31 ,80.04 ,66.31 
03,013,01,017,0321,439,693,4,697,966,0,0,0,0,0,0,0,66.31 ,72.15 ,66.31 
03,013,01,017,0321,440,552,4,556,754,0,0,0,0,0,0,0,66.31 ,73.74 ,66.31 
03,013,01,017,0321,441,713,10,723,1056,0,0,0,0,0,0,0,66.31 ,68.47 ,66.31 
03,013,01,017,0322,442,937,15,952,1247,0,0,0,0,0,0,0,66.31 ,76.34 ,66.31 
03,013,01,017,0323,443,661,8,669,881,0,0,0,0,0,0,0,66.31 ,75.94 ,66.31 
03,013,01,017,0323,444,847,4,851,1144,0,0,0,0,0,0,0,66.31 ,74.39 ,66.31 
03,013,01,017,0324,445,1159,15,1174,1625,0,0,0,0,0,0,0,66.31 ,72.25 ,66.31 
03,013,01,017,0325,446,956,12,968,1327,0,0,0,0,0,0,0,66.31 ,72.95 ,66.31 
03,013,01,017,0326,447,879,11,890,1339,0,0,0,0,0,0,0,66.31 ,66.47 ,66.31 
03,013,01,017,0326,448,810,3,813,1170,0,0,0,0,0,0,0,66.31 ,69.49 ,66.31 
03,013,01,017,0326,449,792,2,794,1210,0,0,0,0,0,0,0,66.31 ,65.62 ,66.31 
03,013,01,017,0327,450,754,5,759,1073,0,0,0,0,0,0,0,66.31 ,70.74 ,66.31 
03,013,01,017,0327,451,748,7,755,1101,0,0,0,0,0,0,0,66.31 ,68.57 ,66.31 
03,013,01,018,0328,452,1320,12,1332,1892,0,0,0,0,0,0,0,66.31 ,70.40 ,66.31 
03,013,01,018,0329,453,973,6,979,1501,0,0,0,0,0,0,0,66.31 ,65.22 ,66.31 
03,013,01,018,0330,454,780,15,795,1076,0,0,0,0,0,0,0,66.31 ,73.88 ,66.31 
03,013,01,018,0331,455,796,8,804,1071,0,0,0,0,0,0,0,66.31 ,75.07 ,66.31 
03,013,01,018,0332,456,615,4,619,834,0,0,0,0,0,0,0,66.31 ,74.22 ,66.31 
03,013,01,018,0333,457,981,10,991,1433,0,0,0,0,0,0,0,66.31 ,69.16 ,66.31 
03,013,01,018,0334,458,525,8,533,743,0,0,0,0,0,0,0,66.31 ,71.74 ,66.31 
03,013,01,018,0335,459,1184,15,1199,1685,0,0,0,0,0,0,0,66.31 ,71.16 ,66.31 
03,013,01,019,0336,460,1032,11,1043,1446,0,0,0,0,0,0,0,66.31 ,72.13 ,66.31 
03,013,01,019,0337,461,1149,7,1156,1625,0,0,0,0,0,0,0,66.31 ,71.14 ,66.31 
03,013,01,019,0338,462,622,10,632,840,0,0,0,0,0,0,0,66.31 ,75.24 ,66.31 
03,013,01,019,0339,463,1110,7,1117,1584,0,0,0,0,0,0,0,66.31 ,70.52 ,66.31 
03,013,01,019,0340,464,1088,10,1098,1479,0,0,0,0,0,0,0,66.31 ,74.24 ,66.31 
03,013,01,019,0340,465,1187,22,1209,1598,0,0,0,0,0,0,0,66.31 ,75.66 ,66.31 
03,013,01,019,0341,466,658,5,663,875,0,0,0,0,0,0,0,66.31 ,75.77 ,66.31 
03,013,01,019,0342,467,881,7,888,1269,0,0,0,0,0,0,0,66.31 ,69.98 ,66.31 
03,013,01,019,0343,468,1166,16,1182,1754,0,0,0,0,0,0,0,66.31 ,67.39 ,66.31 
03,013,01,019,0344,469,1121,15,1136,1551,0,0,0,0,0,0,0,66.31 ,73.24 ,66.31 
03,013,01,019,0344,470,981,14,995,1373,0,0,0,0,0,0,0,66.31 ,72.47 ,66.31 
03,013,01,019,0345,471,810,18,828,1143,0,0,0,0,0,0,0,66.31 ,72.44 ,66.31 
03,013,01,020,0346,472,1306,13,1319,1760,0,0,0,0,0,0,0,66.31 ,74.94 ,66.31 
03,013,01,020,0347,473,722,6,728,1007,0,0,0,0,0,0,0,66.31 ,72.29 ,66.31 
03,013,01,020,0348,474,427,5,432,602,0,0,0,0,0,0,0,66.31 ,71.76 ,66.31 
03,013,01,020,0349,475,584,9,593,778,0,0,0,0,0,0,0,66.31 ,76.22 ,66.31 
03,013,01,020,0350,476,736,8,744,1039,0,0,0,0,0,0,0,66.31 ,71.61 ,66.31 
03,013,01,020,0351,477,710,7,717,973,0,0,0,0,0,0,0,66.31 ,73.69 ,66.31 
03,013,01,020,0352,478,779,5,784,1035,0,0,0,0,0,0,0,66.31 ,75.75 ,66.31 
03,013,01,020,0353,479,738,7,745,1099,0,0,0,0,0,0,0,66.31 ,67.79 ,66.31 
03,013,01,020,0354,480,629,5,634,895,0,0,0,0,0,0,0,66.31 ,70.84 ,66.31 
03,013,01,020,0355,481,426,10,436,589,0,0,0,0,0,0,0,66.31 ,74.02 ,66.31 
03,013,01,021,0356,482,1045,11,1056,1488,0,0,0,0,0,0,0,66.31 ,70.97 ,66.31 
03,013,01,021,0357,483,1173,14,1187,1701,0,0,0,0,0,0,0,66.31 ,69.78 ,66.31 
03,013,01,021,0358,484,676,12,688,968,0,0,0,0,0,0,0,66.31 ,71.07 ,66.31 
03,013,01,021,0359,485,1159,15,1174,1684,0,0,0,0,0,0,0,66.31 ,69.71 ,66.31 
03,013,01,021,0360,486,1254,12,1266,1841,0,0,0,0,0,0,0,66.31 ,68.77 ,66.31 
03,013,01,021,0361,487,649,12,661,1004,0,0,0,0,0,0,0,66.31 ,65.84 ,66.31 
03,013,01,021,0361,488,802,7,809,1220,0,0,0,0,0,0,0,66.31 ,66.31 ,66.31 
03,013,01,021,0362,489,842,6,848,1162,0,0,0,0,0,0,0,66.31 ,72.98 ,66.31 
03,013,01,021,0363,490,586,11,597,865,0,0,0,0,0,0,0,66.31 ,69.02 ,66.31 
03,013,01,021,0364,491,887,9,896,1230,0,0,0,0,0,0,0,66.31 ,72.85 ,66.31 
03,013,01,021,0365,492,736,8,744,970,0,0,0,0,0,0,0,66.31 ,76.70 ,66.31 
03,013,01,021,0366,493,763,6,769,1074,0,0,0,0,0,0,0,66.31 ,71.60 ,66.31 
03,013,01,021,0367,494,731,8,739,1042,0,0,0,0,0,0,0,66.31 ,70.92 ,66.31 
03,013,01,021,0367,495,793,6,799,1112,0,0,0,0,0,0,0,66.31 ,71.85 ,66.31 
03,013,01,022,0368,496,1020,8,1028,1692,0,0,0,0,0,0,0,66.31 ,60.76 ,66.31 
03,013,01,022,0369,497,611,3,614,953,0,0,0,0,0,0,0,66.31 ,64.43 ,66.31 
03,013,01,022,0370,498,515,4,519,770,0,0,0,0,0,0,0,66.31 ,67.40 ,66.31 
03,013,01,022,0371,499,826,7,833,1411,0,0,0,0,0,0,0,66.31 ,59.04 ,66.31 
03,013,01,022,0372,500,582,5,587,1043,0,0,0,0,0,0,0,66.31 ,56.28 ,66.31 
03,013,01,022,0373,501,525,1,526,966,0,0,0,0,0,0,0,66.31 ,54.45 ,66.31 
03,013,01,022,0374,502,754,10,764,1305,0,0,0,0,0,0,0,66.31 ,58.54 ,66.31 
03,013,01,022,0375,503,419,1,420,693,0,0,0,0,0,0,0,66.31 ,60.61 ,66.31 
03,013,01,023,0376,504,300,1,301,452,0,0,0,0,0,0,0,66.31 ,66.59 ,66.31 
03,013,01,023,0376,505,532,4,536,902,0,0,0,0,0,0,0,66.31 ,59.42 ,66.31 
03,013,01,023,0377,506,390,10,400,597,0,0,0,0,0,0,0,66.31 ,67.00 ,66.31 
03,013,01,023,0378,507,459,2,461,755,0,0,0,0,0,0,0,66.31 ,61.06 ,66.31 
03,013,01,023,0379,508,495,11,506,841,0,0,0,0,0,0,0,66.31 ,60.17 ,66.31 
03,013,01,023,0380,509,243,3,246,427,0,0,0,0,0,0,0,66.31 ,57.61 ,66.31 
03,013,01,023,0381,510,552,8,560,1001,0,0,0,0,0,0,0,66.31 ,55.94 ,66.31 
03,013,01,023,0382,511,431,7,438,713,0,0,0,0,0,0,0,66.31 ,61.43 ,66.31 
03,013,01,023,0382,512,406,8,414,686,0,0,0,0,0,0,0,66.31 ,60.35 ,66.31 
03,013,01,023,0383,513,285,5,290,432,0,0,0,0,0,0,0,66.31 ,67.13 ,66.31 
03,013,01,023,0384,514,269,12,281,451,0,0,0,0,0,0,0,66.31 ,62.31 ,66.31 
03,013,01,023,0385,515,334,3,337,540,0,0,0,0,0,0,0,66.31 ,62.41 ,66.31 
03,013,01,023,0386,516,297,6,303,512,0,0,0,0,0,0,0,66.31 ,59.18 ,66.31 
03,013,01,024,0387,517,762,16,778,1393,0,0,0,0,0,0,0,66.31 ,55.85 ,66.31 
03,013,01,024,0388,518,142,3,145,271,0,0,0,0,0,0,0,66.31 ,53.51 ,66.31 
03,013,01,024,0389,519,619,3,622,1133,0,0,0,0,0,0,0,66.31 ,54.90 ,66.31 
03,013,01,024,0390,520,611,5,616,1067,0,0,0,0,0,0,0,66.31 ,57.73 ,66.31 
03,013,01,024,0391,521,218,1,219,441,0,0,0,0,0,0,0,66.31 ,49.66 ,66.31 
03,013,01,024,0392,522,323,5,328,679,0,0,0,0,0,0,0,66.31 ,48.31 ,66.31 
03,013,01,024,0393,523,113,3,116,242,0,0,0,0,0,0,0,66.31 ,47.93 ,66.31 
03,013,01,024,0394,524,172,1,173,301,0,0,0,0,0,0,0,66.31 ,57.48 ,66.31 
03,013,01,025,0395,525,599,11,610,835,0,0,0,0,0,0,0,66.31 ,73.05 ,66.31 
03,013,01,025,0395,526,702,6,708,920,0,0,0,0,0,0,0,66.31 ,76.96 ,66.31 
03,013,01,025,0396,527,398,4,402,628,0,0,0,0,0,0,0,66.31 ,64.01 ,66.31 
03,013,01,025,0396,528,316,2,318,483,0,0,0,0,0,0,0,66.31 ,65.84 ,66.31 
03,013,01,025,0397,529,585,11,596,1129,0,0,0,0,0,0,0,66.31 ,52.79 ,66.31 
03,013,01,025,0398,530,555,10,565,1037,0,0,0,0,0,0,0,66.31 ,54.48 ,66.31 
03,013,01,026,0399,531,63,2,65,117,0,0,0,0,0,0,0,66.31 ,55.56 ,66.31 
03,013,01,026,0400,532,8,0,8,21,0,0,0,0,0,0,0,66.31 ,38.10 ,66.31 
03,013,01,026,0401,533,5,0,5,14,0,0,0,0,0,0,0,66.31 ,35.71 ,66.31 
03,013,01,026,0402,534,7,2,9,22,0,0,0,0,0,0,0,66.31 ,40.91 ,66.31 
03,013,01,026,0403,535,19,0,19,46,0,0,0,0,0,0,0,66.31 ,41.30 ,66.31 
03,013,01,026,0404,536,24,0,24,42,0,0,0,0,0,0,0,66.31 ,57.14 ,66.31 
03,013,01,026,0405,537,6,0,6,15,0,0,0,0,0,0,0,66.31 ,40.00 ,66.31 
03,013,01,026,0406,538,19,1,20,38,0,0,0,0,0,0,0,66.31 ,52.63 ,66.31 
03,013,01,026,0407,539,32,0,32,56,0,0,0,0,0,0,0,66.31 ,57.14 ,66.31 
03,013,01,026,0408,540,22,0,22,38,0,0,0,0,0,0,0,66.31 ,57.89 ,66.31 
03,013,01,027,0409,541,5,0,5,14,0,0,0,0,0,0,0,66.31 ,35.71 ,66.31 
03,013,01,027,0409,542,3,0,3,8,0,0,0,0,0,0,0,66.31 ,37.50 ,66.31 
03,013,01,027,0409,543,4,0,4,5,0,0,0,0,0,0,0,66.31 ,80.00 ,66.31 
03,013,01,027,0410,544,8,0,8,19,0,0,0,0,0,0,0,66.31 ,42.11 ,66.31 
03,013,01,027,0411,545,1,0,1,2,0,0,0,0,0,0,0,66.31 ,50.00 ,66.31 
03,013,01,027,0412,546,3,0,3,4,0,0,0,0,0,0,0,66.31 ,75.00 ,66.31 
03,013,01,027,0413,547,6,0,6,20,0,0,0,0,0,0,0,66.31 ,30.00 ,66.31 
03,013,01,027,0414,548,3,0,3,7,0,0,0,0,0,0,0,66.31 ,42.86 ,66.31 
03,013,01,028,0415,549,4,1,5,17,0,0,0,0,0,0,0,66.31 ,29.41 ,66.31 
03,013,01,028,0416,550,59,0,59,96,0,0,0,0,0,0,0,66.31 ,61.46 ,66.31 
03,013,01,028,0417,551,34,0,34,48,0,0,0,0,0,0,0,66.31 ,70.83 ,66.31 
03,013,01,028,0418,552,30,1,31,57,0,0,0,0,0,0,0,66.31 ,54.39 ,66.31 
03,013,01,028,0419,553,7,0,7,14,0,0,0,0,0,0,0,66.31 ,50.00 ,66.31 
03,013,01,028,0420,554,24,0,24,42,0,0,0,0,0,0,0,66.31 ,57.14 ,66.31 
03,013,01,028,0420,555,28,1,29,48,0,0,0,0,0,0,0,66.31 ,60.42 ,66.31 
03,013,01,028,0420,556,30,1,31,54,0,0,0,0,0,0,0,66.31 ,57.41 ,66.31 
03,013,01,029,0421,557,28,0,28,37,0,0,0,0,0,0,0,66.31 ,75.68 ,66.31 
03,013,01,029,0421,558,8,0,8,12,0,0,0,0,0,0,0,66.31 ,66.67 ,66.31 
03,013,01,029,0422,559,15,0,15,33,0,0,0,0,0,0,0,66.31 ,45.45 ,66.31 
03,013,01,029,0423,560,19,0,19,33,0,0,0,0,0,0,0,66.31 ,57.58 ,66.31 
03,013,01,029,0424,561,5,0,5,14,0,0,0,0,0,0,0,66.31 ,35.71 ,66.31 
03,013,01,029,0425,562,5,0,5,9,0,0,0,0,0,0,0,66.31 ,55.56 ,66.31 
03,013,01,029,0426,563,13,0,13,34,0,0,0,0,0,0,0,66.31 ,38.24 ,66.31 
03,013,01,030,0427,564,16,1,17,37,0,0,0,0,0,0,0,66.31 ,45.95 ,66.31 
03,013,01,030,0428,565,13,0,13,34,0,0,0,0,0,0,0,66.31 ,38.24 ,66.31 
03,013,01,030,0428,566,4,0,4,9,0,0,0,0,0,0,0,66.31 ,44.44 ,66.31 
03,013,01,030,0429,567,29,0,29,49,0,0,0,0,0,0,0,66.31 ,59.18 ,66.31 
03,013,01,030,0429,568,14,1,15,23,0,0,0,0,0,0,0,66.31 ,65.22 ,66.31 
03,013,01,030,0430,569,51,3,54,97,0,0,0,0,0,0,0,66.31 ,55.67 ,66.31 
03,013,01,030,0431,570,25,3,28,47,0,0,0,0,0,0,0,66.31 ,59.57 ,66.31 
03,013,01,030,0432,571,45,1,46,63,0,0,0,0,0,0,0,66.31 ,73.02 ,66.31 
03,013,01,030,0433,572,40,2,42,70,0,0,0,0,0,0,0,66.31 ,60.00 ,66.31 
03,013,01,031,0434,573,28,0,28,59,0,0,0,0,0,0,0,66.31 ,47.46 ,66.31 
03,013,01,031,0435,574,37,0,37,53,0,0,0,0,0,0,0,66.31 ,69.81 ,66.31 
03,013,01,031,0436,575,7,0,7,9,0,0,0,0,0,0,0,66.31 ,77.78 ,66.31 
03,013,01,031,0437,576,97,0,97,150,0,0,0,0,0,0,0,66.31 ,64.67 ,66.31 
03,013,01,031,0438,577,79,0,79,122,0,0,0,0,0,0,0,66.31 ,64.75 ,66.31 
03,013,01,031,0439,578,10,0,10,15,0,0,0,0,0,0,0,66.31 ,66.67 ,66.31 
03,013,01,032,0440,579,24,0,24,44,0,0,0,0,0,0,0,66.31 ,54.55 ,66.31 
03,013,01,032,0441,580,31,0,31,76,0,0,0,0,0,0,0,66.31 ,40.79 ,66.31 
03,013,01,032,0442,581,32,0,32,59,0,0,0,0,0,0,0,66.31 ,54.24 ,66.31 
03,013,01,032,0443,582,8,0,8,21,0,0,0,0,0,0,0,66.31 ,38.10 ,66.31 
03,013,01,032,0444,583,19,0,19,32,0,0,0,0,0,0,0,66.31 ,59.38 ,66.31 
03,013,01,032,0445,584,8,0,8,17,0,0,0,0,0,0,0,66.31 ,47.06 ,66.31 
03,013,01,032,0446,585,21,0,21,36,0,0,0,0,0,0,0,66.31 ,58.33 ,66.31 
03,013,01,032,0447,586,9,0,9,18,0,0,0,0,0,0,0,66.31 ,50.00 ,66.31 
03,013,01,033,0448,587,105,1,106,176,0,0,0,0,0,0,0,66.31 ,60.23 ,66.31 
03,013,01,033,0449,588,17,0,17,47,0,0,0,0,0,0,0,66.31 ,36.17 ,66.31 
03,013,01,033,0450,589,11,0,11,21,0,0,0,0,0,0,0,66.31 ,52.38 ,66.31 
03,013,01,033,0451,590,49,2,51,106,0,0,0,0,0,0,0,66.31 ,48.11 ,66.31 
03,013,01,033,0452,591,16,0,16,34,0,0,0,0,0,0,0,66.31 ,47.06 ,66.31 
03,013,01,033,0453,592,11,0,11,20,0,0,0,0,0,0,0,66.31 ,55.00 ,66.31 
03,014,01,001,0001,1,752,7,759,1172,0,0,0,0,0,0,0,66.31 ,64.76 ,66.31 
03,014,01,001,0002,2,572,6,578,821,0,0,0,0,0,0,0,66.31 ,70.40 ,66.31 
03,014,01,001,0002,3,579,5,584,811,0,0,0,0,0,0,0,66.31 ,72.01 ,66.31 
03,014,01,001,0003,4,877,10,887,1430,0,0,0,0,0,0,0,66.31 ,62.03 ,66.31 
03,014,01,001,0003,5,1107,10,1117,1764,0,0,0,0,0,0,0,66.31 ,63.32 ,66.31 
03,014,01,001,0004,6,880,13,893,1404,0,0,0,0,0,0,0,66.31 ,63.60 ,66.31 
03,014,01,001,0004,7,761,9,770,1201,0,0,0,0,0,0,0,66.31 ,64.11 ,66.31 
03,014,01,001,0005,8,463,6,469,745,0,0,0,0,0,0,0,66.31 ,62.95 ,66.31 
03,014,01,001,0006,9,670,12,682,1067,0,0,0,0,0,0,0,66.31 ,63.92 ,66.31 
03,014,01,001,0007,10,264,0,264,455,0,0,0,0,0,0,0,66.31 ,58.02 ,66.31 
03,014,01,001,0008,11,592,7,599,912,0,0,0,0,0,0,0,66.31 ,65.68 ,66.31 
03,014,01,001,0008,12,488,8,496,848,0,0,0,0,0,0,0,66.31 ,58.49 ,66.31 
03,014,01,001,0009,13,503,3,506,768,0,0,0,0,0,0,0,66.31 ,65.89 ,66.31 
03,014,01,001,0010,14,397,2,399,621,0,0,0,0,0,0,0,66.31 ,64.25 ,66.31 
03,014,01,001,0011,15,487,5,492,769,0,0,0,0,0,0,0,66.31 ,63.98 ,66.31 
03,014,01,001,0012,16,513,3,516,873,0,0,0,0,0,0,0,66.31 ,59.11 ,66.31 
03,014,01,001,0013,17,880,11,891,1441,0,0,0,0,0,0,0,66.31 ,61.83 ,66.31 
03,014,01,001,0014,18,570,2,572,916,0,0,0,0,0,0,0,66.31 ,62.45 ,66.31 
03,014,01,001,0015,19,688,5,693,1048,0,0,0,0,0,0,0,66.31 ,66.13 ,66.31 
03,014,01,001,0016,20,471,5,476,721,0,0,0,0,0,0,0,66.31 ,66.02 ,66.31 
03,014,01,001,0017,21,291,4,295,473,0,0,0,0,0,0,0,66.31 ,62.37 ,66.31 
03,014,01,001,0018,22,695,6,701,1159,0,0,0,0,0,0,0,66.31 ,60.48 ,66.31 
03,014,01,001,0018,23,931,10,941,1505,0,0,0,0,0,0,0,66.31 ,62.52 ,66.31 
03,014,01,001,0019,24,454,2,456,724,0,0,0,0,0,0,0,66.31 ,62.98 ,66.31 
03,014,01,001,0020,25,285,4,289,501,0,0,0,0,0,0,0,66.31 ,57.68 ,66.31 
03,014,01,001,0021,26,776,9,785,1207,0,0,0,0,0,0,0,66.31 ,65.04 ,66.31 
03,014,01,001,0022,27,637,6,643,1139,0,0,0,0,0,0,0,66.31 ,56.45 ,66.31 
03,014,01,001,0022,28,919,10,929,1523,0,0,0,0,0,0,0,66.31 ,61.00 ,66.31 
03,014,01,001,0022,29,912,7,919,1532,0,0,0,0,0,0,0,66.31 ,59.99 ,66.31 
03,014,01,001,0023,30,528,5,533,838,0,0,0,0,0,0,0,66.31 ,63.60 ,66.31 
03,014,01,001,0023,31,811,9,820,1224,0,0,0,0,0,0,0,66.31 ,66.99 ,66.31 
03,014,01,001,0024,32,636,11,647,988,0,0,0,0,0,0,0,66.31 ,65.49 ,66.31 
03,014,01,001,0024,33,642,3,645,963,0,0,0,0,0,0,0,66.31 ,66.98 ,66.31 
03,014,01,001,0024,34,666,4,670,1021,0,0,0,0,0,0,0,66.31 ,65.62 ,66.31 
03,014,01,001,0025,35,770,4,774,1227,0,0,0,0,0,0,0,66.31 ,63.08 ,66.31 
03,014,01,001,0026,36,332,2,334,509,0,0,0,0,0,0,0,66.31 ,65.62 ,66.31 
03,014,01,001,0026,37,698,14,712,1093,0,0,0,0,0,0,0,66.31 ,65.14 ,66.31 
03,014,01,001,0027,38,505,7,512,823,0,0,0,0,0,0,0,66.31 ,62.21 ,66.31 
03,014,01,001,0028,39,694,9,703,983,0,0,0,0,0,0,0,66.31 ,71.52 ,66.31 
03,014,01,001,0029,40,666,5,671,1030,0,0,0,0,0,0,0,66.31 ,65.15 ,66.31 
03,014,01,001,0030,41,697,9,706,1142,0,0,0,0,0,0,0,66.31 ,61.82 ,66.31 
03,014,01,001,0030,42,700,9,709,1188,0,0,0,0,0,0,0,66.31 ,59.68 ,66.31 
03,014,01,001,0030,43,732,9,741,1261,0,0,0,0,0,0,0,66.31 ,58.76 ,66.31 
03,014,01,001,0030,44,901,8,909,1482,0,0,0,0,0,0,0,66.31 ,61.34 ,66.31 
03,014,01,001,0031,45,609,4,613,1014,0,0,0,0,0,0,0,66.31 ,60.45 ,66.31 
03,014,01,001,0031,46,343,9,352,574,0,0,0,0,0,0,0,66.31 ,61.32 ,66.31 
03,014,01,001,0031,47,763,10,773,1247,0,0,0,0,0,0,0,66.31 ,61.99 ,66.31 
03,014,01,001,0032,48,944,11,955,1507,0,0,0,0,0,0,0,66.31 ,63.37 ,66.31 
03,014,01,001,0033,49,629,12,641,956,0,0,0,0,0,0,0,66.31 ,67.05 ,66.31 
03,014,01,001,0034,50,685,9,694,1087,0,0,0,0,0,0,0,66.31 ,63.85 ,66.31 
03,014,01,001,0035,51,284,3,287,459,0,0,0,0,0,0,0,66.31 ,62.53 ,66.31 
03,014,01,001,0036,52,662,10,672,997,0,0,0,0,0,0,0,66.31 ,67.40 ,66.31 
03,014,01,001,0036,53,297,4,301,468,0,0,0,0,0,0,0,66.31 ,64.32 ,66.31 
03,014,01,001,0036,54,147,0,147,230,0,0,0,0,0,0,0,66.31 ,63.91 ,66.31 
03,014,01,001,0037,55,578,7,585,1044,0,0,0,0,0,0,0,66.31 ,56.03 ,66.31 
03,014,01,001,0038,56,1129,12,1141,1573,0,0,0,0,0,0,0,66.31 ,72.54 ,66.31 
03,014,01,001,0039,57,491,4,495,780,0,0,0,0,0,0,0,66.31 ,63.46 ,66.31 
03,014,01,001,0039,58,345,5,350,553,0,0,0,0,0,0,0,66.31 ,63.29 ,66.31 
03,014,01,001,0040,59,596,3,599,855,0,0,0,0,0,0,0,66.31 ,70.06 ,66.31 
03,014,01,001,0040,60,611,3,614,893,0,0,0,0,0,0,0,66.31 ,68.76 ,66.31 
03,014,01,001,0041,61,650,6,656,1012,0,0,0,0,0,0,0,66.31 ,64.82 ,66.31 
03,014,01,001,0042,62,508,9,517,942,0,0,0,0,0,0,0,66.31 ,54.88 ,66.31 
03,014,01,001,0043,63,530,4,534,839,0,0,0,0,0,0,0,66.31 ,63.65 ,66.31 
03,014,01,001,0044,64,544,6,550,868,0,0,0,0,0,0,0,66.31 ,63.36 ,66.31 
03,014,01,001,0045,65,526,9,535,855,0,0,0,0,0,0,0,66.31 ,62.57 ,66.31 
03,014,01,001,0046,66,711,25,736,1121,0,0,0,0,0,0,0,66.31 ,65.66 ,66.31 
03,014,01,002,0047,67,119,0,119,204,0,0,0,0,0,0,0,66.31 ,58.33 ,66.31 
03,014,01,002,0047,68,94,1,95,168,0,0,0,0,0,0,0,66.31 ,56.55 ,66.31 
03,014,01,002,0047,69,61,1,62,105,0,0,0,0,0,0,0,66.31 ,59.05 ,66.31 
03,014,01,002,0048,70,101,0,101,179,0,0,0,0,0,0,0,66.31 ,56.42 ,66.31 
03,014,01,002,0049,71,52,0,52,101,0,0,0,0,0,0,0,66.31 ,51.49 ,66.31 
03,014,01,002,0049,72,694,4,698,1038,0,0,0,0,0,0,0,66.31 ,67.24 ,66.31 
03,014,01,002,0049,73,869,3,872,1286,0,0,0,0,0,0,0,66.31 ,67.81 ,66.31 
03,014,01,002,0050,74,725,4,729,1066,0,0,0,0,0,0,0,66.31 ,68.39 ,66.31 
03,014,01,002,0051,75,229,1,230,405,0,0,0,0,0,0,0,66.31 ,56.79 ,66.31 
03,014,01,002,0051,76,417,1,418,631,0,0,0,0,0,0,0,66.31 ,66.24 ,66.31 
03,014,01,002,0052,77,112,0,112,184,0,0,0,0,0,0,0,66.31 ,60.87 ,66.31 
03,014,01,002,0052,78,219,3,222,426,0,0,0,0,0,0,0,66.31 ,52.11 ,66.31 
03,014,01,002,0053,79,151,0,151,265,0,0,0,0,0,0,0,66.31 ,56.98 ,66.31 
03,014,01,002,0053,80,140,0,140,266,0,0,0,0,0,0,0,66.31 ,52.63 ,66.31 
03,014,01,002,0054,81,36,0,36,66,0,0,0,0,0,0,0,66.31 ,54.55 ,66.31 
03,014,01,002,0054,82,19,0,19,47,0,0,0,0,0,0,0,66.31 ,40.43 ,66.31 
03,014,01,003,0055,83,565,2,567,921,0,0,0,0,0,0,0,66.31 ,61.56 ,66.31 
03,014,01,003,0055,84,397,8,405,726,0,0,0,0,0,0,0,66.31 ,55.79 ,66.31 
03,014,01,003,0056,85,558,7,565,901,0,0,0,0,0,0,0,66.31 ,62.71 ,66.31 
03,014,01,003,0057,86,410,6,416,657,0,0,0,0,0,0,0,66.31 ,63.32 ,66.31 
03,014,01,003,0058,87,585,2,587,947,0,0,0,0,0,0,0,66.31 ,61.99 ,66.31 
03,014,01,003,0059,88,407,4,411,709,0,0,0,0,0,0,0,66.31 ,57.97 ,66.31 
03,014,01,003,0060,89,293,4,297,501,0,0,0,0,0,0,0,66.31 ,59.28 ,66.31 
03,014,01,003,0060,90,482,2,484,784,0,0,0,0,0,0,0,66.31 ,61.73 ,66.31 
03,014,01,003,0061,91,118,2,120,242,0,0,0,0,0,0,0,66.31 ,49.59 ,66.31 
03,014,01,004,0062,92,576,18,594,858,0,0,0,0,0,0,0,66.31 ,69.23 ,66.31 
03,014,01,004,0062,93,584,6,590,867,0,0,0,0,0,0,0,66.31 ,68.05 ,66.31 
03,014,01,004,0063,94,148,1,149,258,0,0,0,0,0,0,0,66.31 ,57.75 ,66.31 
03,014,01,004,0063,95,279,1,280,428,0,0,0,0,0,0,0,66.31 ,65.42 ,66.31 
03,014,01,004,0063,96,177,0,177,322,0,0,0,0,0,0,0,66.31 ,54.97 ,66.31 
03,014,01,004,0064,97,382,6,388,600,0,0,0,0,0,0,0,66.31 ,64.67 ,66.31 
03,014,01,004,0064,98,310,6,316,457,0,0,0,0,0,0,0,66.31 ,69.15 ,66.31 
03,014,01,004,0065,99,477,5,482,734,0,0,0,0,0,0,0,66.31 ,65.67 ,66.31 
03,014,01,004,0065,100,170,8,178,320,0,0,0,0,0,0,0,66.31 ,55.63 ,66.31 
03,014,01,004,0066,101,117,0,117,194,0,0,0,0,0,0,0,66.31 ,60.31 ,66.31 
03,014,01,004,0066,102,22,0,22,42,0,0,0,0,0,0,0,66.31 ,52.38 ,66.31 
03,014,01,004,0067,103,796,5,801,1210,0,0,0,0,0,0,0,66.31 ,66.20 ,66.31 
03,014,01,004,0067,104,666,6,672,977,0,0,0,0,0,0,0,66.31 ,68.78 ,66.31 
03,014,01,004,0067,105,425,3,428,708,0,0,0,0,0,0,0,66.31 ,60.45 ,66.31 
03,014,01,004,0068,106,447,4,451,715,0,0,0,0,0,0,0,66.31 ,63.08 ,66.31 
03,014,01,004,0069,107,248,2,250,402,0,0,0,0,0,0,0,66.31 ,62.19 ,66.31 
03,014,01,004,0070,108,169,2,171,299,0,0,0,0,0,0,0,66.31 ,57.19 ,66.31 
03,014,01,004,0071,109,552,6,558,870,0,0,0,0,0,0,0,66.31 ,64.14 ,66.31 
03,014,01,004,0071,110,112,1,113,196,0,0,0,0,0,0,0,66.31 ,57.65 ,66.31 
03,014,01,004,0072,111,283,1,284,449,0,0,0,0,0,0,0,66.31 ,63.25 ,66.31 
03,014,01,004,0073,112,218,0,218,358,0,0,0,0,0,0,0,66.31 ,60.89 ,66.31 
03,014,01,004,0074,113,144,1,145,261,0,0,0,0,0,0,0,66.31 ,55.56 ,66.31 
03,014,01,005,0075,114,110,3,113,203,0,0,0,0,0,0,0,66.31 ,55.67 ,66.31 
03,014,01,005,0075,115,401,3,404,596,0,0,0,0,0,0,0,66.31 ,67.79 ,66.31 
03,014,01,005,0076,116,644,3,647,1055,0,0,0,0,0,0,0,66.31 ,61.33 ,66.31 
03,014,01,005,0077,117,433,7,440,765,0,0,0,0,0,0,0,66.31 ,57.52 ,66.31 
03,014,01,005,0077,118,163,2,165,297,0,0,0,0,0,0,0,66.31 ,55.56 ,66.31 
03,014,01,005,0078,119,474,3,477,793,0,0,0,0,0,0,0,66.31 ,60.15 ,66.31 
03,014,01,005,0079,120,388,2,390,655,0,0,0,0,0,0,0,66.31 ,59.54 ,66.31 
03,014,01,005,0080,121,243,2,245,377,0,0,0,0,0,0,0,66.31 ,64.99 ,66.31 
03,014,01,005,0081,122,257,1,258,460,0,0,0,0,0,0,0,66.31 ,56.09 ,66.31 
03,014,01,005,0081,123,316,1,317,565,0,0,0,0,0,0,0,66.31 ,56.11 ,66.31 
03,014,01,006,0082,124,620,5,625,949,0,0,0,0,0,0,0,66.31 ,65.86 ,66.31 
03,014,01,006,0082,125,604,2,606,922,0,0,0,0,0,0,0,66.31 ,65.73 ,66.31 
03,014,01,006,0083,126,396,3,399,635,0,0,0,0,0,0,0,66.31 ,62.83 ,66.31 
03,014,01,006,0083,127,405,13,418,734,0,0,0,0,0,0,0,66.31 ,56.95 ,66.31 
03,014,01,006,0084,128,420,2,422,700,0,0,0,0,0,0,0,66.31 ,60.29 ,66.31 
03,014,01,006,0085,129,63,1,64,111,0,0,0,0,0,0,0,66.31 ,57.66 ,66.31 
03,014,01,006,0086,130,249,4,253,399,0,0,0,0,0,0,0,66.31 ,63.41 ,66.31 
03,014,01,006,0087,131,491,9,500,842,0,0,0,0,0,0,0,66.31 ,59.38 ,66.31 
03,014,01,006,0088,132,276,0,276,457,0,0,0,0,0,0,0,66.31 ,60.39 ,66.31 
03,014,01,006,0089,133,240,1,241,413,0,0,0,0,0,0,0,66.31 ,58.35 ,66.31 
03,014,01,006,0090,134,224,1,225,383,0,0,0,0,0,0,0,66.31 ,58.75 ,66.31 
03,014,01,006,0091,135,96,0,96,181,0,0,0,0,0,0,0,66.31 ,53.04 ,66.31 
03,014,01,007,0092,136,146,3,149,285,0,0,0,0,0,0,0,66.31 ,52.28 ,66.31 
03,014,01,007,0092,137,246,5,251,395,0,0,0,0,0,0,0,66.31 ,63.54 ,66.31 
03,014,01,007,0092,138,306,3,309,556,0,0,0,0,0,0,0,66.31 ,55.58 ,66.31 
03,014,01,007,0093,139,239,2,241,436,0,0,0,0,0,0,0,66.31 ,55.28 ,66.31 
03,014,01,007,0093,140,143,2,145,250,0,0,0,0,0,0,0,66.31 ,58.00 ,66.31 
03,014,01,007,0094,141,115,0,115,215,0,0,0,0,0,0,0,66.31 ,53.49 ,66.31 
03,014,01,007,0095,142,168,2,170,325,0,0,0,0,0,0,0,66.31 ,52.31 ,66.31 
03,014,01,007,0096,143,411,3,414,686,0,0,0,0,0,0,0,66.31 ,60.35 ,66.31 
03,014,01,007,0097,144,192,3,195,517,0,0,0,0,0,0,0,66.31 ,37.72 ,66.31 
03,014,01,007,0097,145,127,0,127,220,0,0,0,0,0,0,0,66.31 ,57.73 ,66.31 
03,014,01,007,0097,146,201,2,203,337,0,0,0,0,0,0,0,66.31 ,60.24 ,66.31 
03,014,01,007,0098,147,68,0,68,145,0,0,0,0,0,0,0,66.31 ,46.90 ,66.31 
03,014,01,007,0098,148,33,0,33,66,0,0,0,0,0,0,0,66.31 ,50.00 ,66.31 
03,014,01,008,0099,149,55,0,55,119,0,0,0,0,0,0,0,66.31 ,46.22 ,66.31 
03,014,01,008,0099,150,132,3,135,296,0,0,0,0,0,0,0,66.31 ,45.61 ,66.31 
03,014,01,008,0100,151,201,1,202,418,0,0,0,0,0,0,0,66.31 ,48.33 ,66.31 
03,014,01,008,0101,152,663,5,668,1175,0,0,0,0,0,0,0,66.31 ,56.85 ,66.31 
03,014,01,008,0102,153,257,3,260,550,0,0,0,0,0,0,0,66.31 ,47.27 ,66.31 
03,014,01,008,0103,154,107,0,107,226,0,0,0,0,0,0,0,66.31 ,47.35 ,66.31 
03,014,01,008,0104,155,94,1,95,222,0,0,0,0,0,0,0,66.31 ,42.79 ,66.31 
03,014,01,008,0104,156,70,1,71,134,0,0,0,0,0,0,0,66.31 ,52.99 ,66.31 
03,014,01,008,0104,157,65,0,65,145,0,0,0,0,0,0,0,66.31 ,44.83 ,66.31 
03,014,01,008,0105,158,164,1,165,285,0,0,0,0,0,0,0,66.31 ,57.89 ,66.31 
03,014,01,009,0106,159,592,4,596,924,0,0,0,0,0,0,0,66.31 ,64.50 ,66.31 
03,014,01,009,0107,160,387,1,388,598,0,0,0,0,0,0,0,66.31 ,64.88 ,66.31 
03,014,01,009,0108,161,453,3,456,734,0,0,0,0,0,0,0,66.31 ,62.13 ,66.31 
03,014,01,009,0109,162,246,1,247,386,0,0,0,0,0,0,0,66.31 ,63.99 ,66.31 
03,014,01,009,0110,163,327,1,328,529,0,0,0,0,0,0,0,66.31 ,62.00 ,66.31 
03,014,01,009,0110,164,377,1,378,662,0,0,0,0,0,0,0,66.31 ,57.10 ,66.31 
03,014,01,009,0111,165,527,5,532,780,0,0,0,0,0,0,0,66.31 ,68.21 ,66.31 
03,014,01,009,0111,166,350,4,354,564,0,0,0,0,0,0,0,66.31 ,62.77 ,66.31 
03,014,01,009,0112,167,249,1,250,385,0,0,0,0,0,0,0,66.31 ,64.94 ,66.31 
03,014,01,009,0112,168,83,0,83,134,0,0,0,0,0,0,0,66.31 ,61.94 ,66.31 
03,014,01,009,0113,169,125,1,126,228,0,0,0,0,0,0,0,66.31 ,55.26 ,66.31 
03,014,01,009,0113,170,158,1,159,293,0,0,0,0,0,0,0,66.31 ,54.27 ,66.31 
03,014,01,009,0113,171,31,4,35,75,0,0,0,0,0,0,0,66.31 ,46.67 ,66.31 
03,014,01,009,0114,172,5,0,5,19,0,0,0,0,0,0,0,66.31 ,26.32 ,66.31 
03,014,01,009,0114,173,135,3,138,236,0,0,0,0,0,0,0,66.31 ,58.47 ,66.31 
03,014,01,010,0115,174,144,2,146,292,0,0,0,0,0,0,0,66.31 ,50.00 ,66.31 
03,014,01,010,0116,175,691,3,694,1211,0,0,0,0,0,0,0,66.31 ,57.31 ,66.31 
03,014,01,010,0117,176,549,9,558,920,0,0,0,0,0,0,0,66.31 ,60.65 ,66.31 
03,014,01,010,0118,177,69,1,70,152,0,0,0,0,0,0,0,66.31 ,46.05 ,66.31 
03,014,01,010,0119,178,18,0,18,60,0,0,0,0,0,0,0,66.31 ,30.00 ,66.31 
03,014,01,010,0119,179,20,0,20,40,0,0,0,0,0,0,0,66.31 ,50.00 ,66.31 
03,014,01,011,0120,180,384,2,386,665,0,0,0,0,0,0,0,66.31 ,58.05 ,66.31 
03,014,01,011,0121,181,402,3,405,702,0,0,0,0,0,0,0,66.31 ,57.69 ,66.31 
03,014,01,011,0122,182,227,4,231,424,0,0,0,0,0,0,0,66.31 ,54.48 ,66.31 
03,014,01,011,0122,183,86,2,88,121,0,0,0,0,0,0,0,66.31 ,72.73 ,66.31 
03,014,01,012,0123,184,12,1,13,26,0,0,0,0,0,0,0,66.31 ,50.00 ,66.31 
03,014,01,012,0124,185,30,1,31,48,0,0,0,0,0,0,0,66.31 ,64.58 ,66.31 
03,014,01,012,0125,186,64,1,65,121,0,0,0,0,0,0,0,66.31 ,53.72 ,66.31 
03,014,01,012,0126,187,41,2,43,88,0,0,0,0,0,0,0,66.31 ,48.86 ,66.31 
03,014,01,012,0127,188,16,1,17,29,0,0,0,0,0,0,0,66.31 ,58.62 ,66.31 
03,014,01,012,0128,189,15,1,16,29,0,0,0,0,0,0,0,66.31 ,55.17 ,66.31 
03,014,01,013,0129,190,56,1,57,104,0,0,0,0,0,0,0,66.31 ,54.81 ,66.31 
03,014,01,013,0130,191,15,1,16,26,0,0,0,0,0,0,0,66.31 ,61.54 ,66.31 
03,014,01,013,0131,192,11,0,11,23,0,0,0,0,0,0,0,66.31 ,47.83 ,66.31 
03,014,01,013,0132,193,21,0,21,41,0,0,0,0,0,0,0,66.31 ,51.22 ,66.31 
03,014,01,013,0133,194,14,0,14,33,0,0,0,0,0,0,0,66.31 ,42.42 ,66.31 
03,014,01,013,0133,195,49,0,49,78,0,0,0,0,0,0,0,66.31 ,62.82 ,66.31 
03,014,01,014,0134,196,48,0,48,93,0,0,0,0,0,0,0,66.31 ,51.61 ,66.31 
03,014,01,014,0135,197,27,0,27,46,0,0,0,0,0,0,0,66.31 ,58.70 ,66.31 
03,014,01,014,0136,198,19,1,20,35,0,0,0,0,0,0,0,66.31 ,57.14 ,66.31 
03,014,01,014,0137,199,8,0,8,14,0,0,0,0,0,0,0,66.31 ,57.14 ,66.31 
03,014,01,014,0138,200,4,0,4,18,0,0,0,0,0,0,0,66.31 ,22.22 ,66.31 
03,014,01,015,0139,201,64,1,65,131,0,0,0,0,0,0,0,66.31 ,49.62 ,66.31 
03,014,01,015,0139,202,34,0,34,60,0,0,0,0,0,0,0,66.31 ,56.67 ,66.31 
03,014,01,015,0140,203,27,0,27,73,0,0,0,0,0,0,0,66.31 ,36.99 ,66.31 
03,014,01,015,0141,204,28,2,30,81,0,0,0,0,0,0,0,66.31 ,37.04 ,66.31 
03,014,01,015,0142,205,7,0,7,19,0,0,0,0,0,0,0,66.31 ,36.84 ,66.31 
03,014,01,015,0143,206,8,0,8,32,0,0,0,0,0,0,0,66.31 ,25.00 ,66.31 
03,014,01,015,0144,207,8,0,8,28,0,0,0,0,0,0,0,66.31 ,28.57 ,66.31 
03,014,01,016,0145,208,24,0,24,55,0,0,0,0,0,0,0,66.31 ,43.64 ,66.31 
03,014,01,016,0146,209,40,1,41,83,0,0,0,0,0,0,0,66.31 ,49.40 ,66.31 
03,014,01,016,0147,210,4,0,4,15,0,0,0,0,0,0,0,66.31 ,26.67 ,66.31 
03,014,01,016,0148,211,6,0,6,13,0,0,0,0,0,0,0,66.31 ,46.15 ,66.31 
03,015,01,001,0001,1,933,4,937,1485,0,0,0,0,0,0,0,66.31 ,63.10 ,66.31 
03,015,01,001,0002,2,764,12,776,1309,0,0,0,0,0,0,0,66.31 ,59.28 ,66.31 
03,015,01,001,0002,3,560,12,572,929,0,0,0,0,0,0,0,66.31 ,61.57 ,66.31 
03,015,01,001,0002,4,577,2,579,957,0,0,0,0,0,0,0,66.31 ,60.50 ,66.31 
03,015,01,001,0003,5,538,4,542,994,0,0,0,0,0,0,0,66.31 ,54.53 ,66.31 
03,015,01,001,0003,6,625,17,642,1159,0,0,0,0,0,0,0,66.31 ,55.39 ,66.31 
03,015,01,001,0003,7,467,7,474,833,0,0,0,0,0,0,0,66.31 ,56.90 ,66.31 
03,015,01,001,0004,8,409,9,418,706,0,0,0,0,0,0,0,66.31 ,59.21 ,66.31 
03,015,01,001,0005,9,373,0,373,670,0,0,0,0,0,0,0,66.31 ,55.67 ,66.31 
03,015,01,001,0005,10,545,7,552,978,0,0,0,0,0,0,0,66.31 ,56.44 ,66.31 
03,015,01,001,0005,11,699,7,706,1214,0,0,0,0,0,0,0,66.31 ,58.15 ,66.31 
03,015,01,001,0006,12,576,11,587,935,0,0,0,0,0,0,0,66.31 ,62.78 ,66.31 
03,015,01,001,0006,13,476,7,483,754,0,0,0,0,0,0,0,66.31 ,64.06 ,66.31 
03,015,01,001,0007,14,683,10,693,1181,0,0,0,0,0,0,0,66.31 ,58.68 ,66.31 
03,015,01,001,0007,15,754,9,763,1341,0,0,0,0,0,0,0,66.31 ,56.90 ,66.31 
03,015,01,001,0008,16,897,14,911,1450,0,0,0,0,0,0,0,66.31 ,62.83 ,66.31 
03,015,01,001,0009,17,234,2,236,428,0,0,0,0,0,0,0,66.31 ,55.14 ,66.31 
03,015,01,001,0010,18,363,3,366,618,0,0,0,0,0,0,0,66.31 ,59.22 ,66.31 
03,015,01,001,0011,19,391,4,395,635,0,0,0,0,0,0,0,66.31 ,62.20 ,66.31 
03,015,01,001,0012,20,265,9,274,432,0,0,0,0,0,0,0,66.31 ,63.43 ,66.31 
03,015,01,001,0013,21,340,2,342,622,0,0,0,0,0,0,0,66.31 ,54.98 ,66.31 
03,015,01,001,0014,22,772,11,783,1318,0,0,0,0,0,0,0,66.31 ,59.41 ,66.31 
03,015,01,001,0015,23,301,2,303,505,0,0,0,0,0,0,0,66.31 ,60.00 ,66.31 
03,015,01,001,0016,24,492,3,495,776,0,0,0,0,0,0,0,66.31 ,63.79 ,66.31 
03,015,01,001,0017,25,595,4,599,1008,0,0,0,0,0,0,0,66.31 ,59.42 ,66.31 
03,015,01,001,0018,26,407,6,413,687,0,0,0,0,0,0,0,66.31 ,60.12 ,66.31 
03,015,01,001,0019,27,419,7,426,734,0,0,0,0,0,0,0,66.31 ,58.04 ,66.31 
03,015,01,001,0020,28,593,7,600,995,0,0,0,0,0,0,0,66.31 ,60.30 ,66.31 
03,015,01,001,0021,29,443,4,447,824,0,0,0,0,0,0,0,66.31 ,54.25 ,66.31 
03,015,01,001,0022,30,731,13,744,1259,0,0,0,0,0,0,0,66.31 ,59.09 ,66.31 
03,015,01,001,0022,31,783,6,789,1465,0,0,0,0,0,0,0,66.31 ,53.86 ,66.31 
03,015,01,001,0023,32,441,5,446,786,0,0,0,0,0,0,0,66.31 ,56.74 ,66.31 
03,015,01,001,0023,33,492,3,495,844,0,0,0,0,0,0,0,66.31 ,58.65 ,66.31 
03,015,01,001,0024,34,887,12,899,1466,0,0,0,0,0,0,0,66.31 ,61.32 ,66.31 
03,015,01,001,0024,35,591,9,600,1097,0,0,0,0,0,0,0,66.31 ,54.69 ,66.31 
03,015,01,001,0024,36,591,9,600,1023,0,0,0,0,0,0,0,66.31 ,58.65 ,66.31 
03,015,01,001,0024,37,673,8,681,1217,0,0,0,0,0,0,0,66.31 ,55.96 ,66.31 
03,015,01,001,0025,38,621,7,628,1103,0,0,0,0,0,0,0,66.31 ,56.94 ,66.31 
03,015,01,001,0025,39,658,3,661,1225,0,0,0,0,0,0,0,66.31 ,53.96 ,66.31 
03,015,01,001,0025,40,701,6,707,1246,0,0,0,0,0,0,0,66.31 ,56.74 ,66.31 
03,015,01,001,0026,41,685,10,695,1165,0,0,0,0,0,0,0,66.31 ,59.66 ,66.31 
03,015,01,001,0026,42,618,5,623,1063,0,0,0,0,0,0,0,66.31 ,58.61 ,66.31 
03,015,01,001,0027,43,907,7,914,1511,0,0,0,0,0,0,0,66.31 ,60.49 ,66.31 
03,015,01,001,0027,44,825,10,835,1490,0,0,0,0,0,0,0,66.31 ,56.04 ,66.31 
03,015,01,001,0028,45,900,4,904,1480,0,0,0,0,0,0,0,66.31 ,61.08 ,66.31 
03,015,01,001,0029,46,652,3,655,1086,0,0,0,0,0,0,0,66.31 ,60.31 ,66.31 
03,015,01,001,0030,47,265,2,267,450,0,0,0,0,0,0,0,66.31 ,59.33 ,66.31 
03,015,01,001,0031,48,857,14,871,1411,0,0,0,0,0,0,0,66.31 ,61.73 ,66.31 
03,015,01,001,0032,49,459,3,462,799,0,0,0,0,0,0,0,66.31 ,57.82 ,66.31 
03,015,01,001,0033,50,679,6,685,1146,0,0,0,0,0,0,0,66.31 ,59.77 ,66.31 
03,015,01,001,0033,51,499,4,503,868,0,0,0,0,0,0,0,66.31 ,57.95 ,66.31 
03,015,01,001,0034,52,544,4,548,955,0,0,0,0,0,0,0,66.31 ,57.38 ,66.31 
03,015,01,001,0034,53,483,2,485,803,0,0,0,0,0,0,0,66.31 ,60.40 ,66.31 
03,015,01,001,0035,54,836,10,846,1506,0,0,0,0,0,0,0,66.31 ,56.18 ,66.31 
03,015,01,001,0035,55,763,7,770,1617,0,0,0,0,0,0,0,66.31 ,47.62 ,66.31 
03,015,01,001,0035,56,558,4,562,1110,0,0,0,0,0,0,0,66.31 ,50.63 ,66.31 
03,015,01,001,0036,57,487,3,490,908,0,0,0,0,0,0,0,66.31 ,53.96 ,66.31 
03,015,01,001,0037,58,751,8,759,1250,0,0,0,0,0,0,0,66.31 ,60.72 ,66.31 
03,015,01,001,0037,59,808,6,814,1421,0,0,0,0,0,0,0,66.31 ,57.28 ,66.31 
03,015,01,001,0037,60,714,7,721,1344,0,0,0,0,0,0,0,66.31 ,53.65 ,66.31 
03,015,01,001,0038,61,476,6,482,933,0,0,0,0,0,0,0,66.31 ,51.66 ,66.31 
03,015,01,001,0038,62,548,5,553,944,0,0,0,0,0,0,0,66.31 ,58.58 ,66.31 
03,015,01,001,0038,63,526,3,529,971,0,0,0,0,0,0,0,66.31 ,54.48 ,66.31 
03,015,01,001,0039,64,453,8,461,812,0,0,0,0,0,0,0,66.31 ,56.77 ,66.31 
03,015,01,001,0039,65,519,3,522,1144,0,0,0,0,0,0,0,66.31 ,45.63 ,66.31 
03,015,01,001,0039,66,630,3,633,1104,0,0,0,0,0,0,0,66.31 ,57.34 ,66.31 
03,015,01,001,0040,67,368,3,371,788,0,0,0,0,0,0,0,66.31 ,47.08 ,66.31 
03,015,01,002,0041,68,175,1,176,365,0,0,0,0,0,0,0,66.31 ,48.22 ,66.31 
03,015,01,002,0041,69,529,7,536,934,0,0,0,0,0,0,0,66.31 ,57.39 ,66.31 
03,015,01,002,0042,70,303,2,305,590,0,0,0,0,0,0,0,66.31 ,51.69 ,66.31 
03,015,01,002,0042,71,156,1,157,284,0,0,0,0,0,0,0,66.31 ,55.28 ,66.31 
03,015,01,002,0043,72,184,4,188,306,0,0,0,0,0,0,0,66.31 ,61.44 ,66.31 
03,015,01,002,0043,73,895,9,904,1634,0,0,0,0,0,0,0,66.31 ,55.32 ,66.31 
03,015,01,002,0044,74,603,17,620,1212,0,0,0,0,0,0,0,66.31 ,51.16 ,66.31 
03,015,01,002,0044,75,245,12,257,424,0,0,0,0,0,0,0,66.31 ,60.61 ,66.31 
03,015,01,002,0045,76,577,9,586,1099,0,0,0,0,0,0,0,66.31 ,53.32 ,66.31 
03,015,01,002,0045,77,620,7,627,1172,0,0,0,0,0,0,0,66.31 ,53.50 ,66.31 
03,015,01,002,0046,78,279,4,283,536,0,0,0,0,0,0,0,66.31 ,52.80 ,66.31 
03,015,01,002,0047,79,748,14,762,1320,0,0,0,0,0,0,0,66.31 ,57.73 ,66.31 
03,015,01,002,0047,80,729,14,743,1238,0,0,0,0,0,0,0,66.31 ,60.02 ,66.31 
03,015,01,002,0048,81,422,7,429,623,0,0,0,0,0,0,0,66.31 ,68.86 ,66.31 
03,015,01,002,0048,82,225,8,233,393,0,0,0,0,0,0,0,66.31 ,59.29 ,66.31 
03,015,01,003,0049,83,91,0,91,274,0,0,0,0,0,0,0,66.31 ,33.21 ,66.31 
03,015,01,003,0049,84,50,0,50,129,0,0,0,0,0,0,0,66.31 ,38.76 ,66.31 
03,015,01,003,0050,85,200,1,201,349,0,0,0,0,0,0,0,66.31 ,57.59 ,66.31 
03,015,01,003,0051,86,114,1,115,237,0,0,0,0,0,0,0,66.31 ,48.52 ,66.31 
03,015,01,003,0051,87,90,1,91,229,0,0,0,0,0,0,0,66.31 ,39.74 ,66.31 
03,015,01,003,0052,88,58,0,58,139,0,0,0,0,0,0,0,66.31 ,41.73 ,66.31 
03,015,01,003,0053,89,30,4,34,60,0,0,0,0,0,0,0,66.31 ,56.67 ,66.31 
03,015,01,003,0053,90,38,1,39,87,0,0,0,0,0,0,0,66.31 ,44.83 ,66.31 
03,015,01,003,0054,91,73,3,76,138,0,0,0,0,0,0,0,66.31 ,55.07 ,66.31 
03,015,01,003,0055,92,63,0,63,113,0,0,0,0,0,0,0,66.31 ,55.75 ,66.31 
03,015,01,003,0056,93,64,0,64,117,0,0,0,0,0,0,0,66.31 ,54.70 ,66.31 
03,015,01,003,0057,94,32,1,33,77,0,0,0,0,0,0,0,66.31 ,42.86 ,66.31 
03,015,01,003,0057,95,6,0,6,12,0,0,0,0,0,0,0,66.31 ,50.00 ,66.31 
03,015,01,004,0058,96,750,10,760,1336,0,0,0,0,0,0,0,66.31 ,56.89 ,66.31 
03,015,01,004,0058,97,775,8,783,1501,0,0,0,0,0,0,0,66.31 ,52.17 ,66.31 
03,015,01,004,0059,98,782,7,789,1419,0,0,0,0,0,0,0,66.31 ,55.60 ,66.31 
03,015,01,004,0059,99,494,8,502,876,0,0,0,0,0,0,0,66.31 ,57.31 ,66.31 
03,015,01,004,0060,100,701,4,705,1254,0,0,0,0,0,0,0,66.31 ,56.22 ,66.31 
03,015,01,004,0060,101,762,12,774,1299,0,0,0,0,0,0,0,66.31 ,59.58 ,66.31 
03,015,01,004,0060,102,658,11,669,1206,0,0,0,0,0,0,0,66.31 ,55.47 ,66.31 
03,015,01,004,0061,103,605,6,611,1127,0,0,0,0,0,0,0,66.31 ,54.21 ,66.31 
03,015,01,004,0061,104,862,13,875,1532,0,0,0,0,0,0,0,66.31 ,57.11 ,66.31 
03,015,01,004,0062,105,440,7,447,775,0,0,0,0,0,0,0,66.31 ,57.68 ,66.31 
03,015,01,004,0062,106,630,9,639,1057,0,0,0,0,0,0,0,66.31 ,60.45 ,66.31 
03,015,01,004,0063,107,668,19,687,1128,0,0,0,0,0,0,0,66.31 ,60.90 ,66.31 
03,015,01,004,0064,108,506,11,517,907,0,0,0,0,0,0,0,66.31 ,57.00 ,66.31 
03,015,01,004,0065,109,828,7,835,1420,0,0,0,0,0,0,0,66.31 ,58.80 ,66.31 
03,015,01,004,0066,110,723,5,728,1299,0,0,0,0,0,0,0,66.31 ,56.04 ,66.31 
03,015,01,004,0066,111,510,4,514,913,0,0,0,0,0,0,0,66.31 ,56.30 ,66.31 
03,015,01,004,0067,112,372,3,375,722,0,0,0,0,0,0,0,66.31 ,51.94 ,66.31 
03,015,01,004,0067,113,592,5,597,1112,0,0,0,0,0,0,0,66.31 ,53.69 ,66.31 
03,015,01,004,0068,114,694,13,707,1271,0,0,0,0,0,0,0,66.31 ,55.63 ,66.31 
03,015,01,004,0068,115,682,7,689,1234,0,0,0,0,0,0,0,66.31 ,55.83 ,66.31 
03,015,01,004,0069,116,737,9,746,1359,0,0,0,0,0,0,0,66.31 ,54.89 ,66.31 
03,015,01,004,0069,117,819,6,825,1319,0,0,0,0,0,0,0,66.31 ,62.55 ,66.31 
03,015,01,004,0069,118,763,5,768,1267,0,0,0,0,0,0,0,66.31 ,60.62 ,66.31 
03,015,01,004,0069,119,754,4,758,1283,0,0,0,0,0,0,0,66.31 ,59.08 ,66.31 
03,015,01,004,0070,120,740,9,749,1348,0,0,0,0,0,0,0,66.31 ,55.56 ,66.31 
03,015,01,004,0070,121,904,13,917,1592,0,0,0,0,0,0,0,66.31 ,57.60 ,66.31 
03,015,01,004,0071,122,503,1,504,817,0,0,0,0,0,0,0,66.31 ,61.69 ,66.31 
03,015,01,004,0071,123,722,8,730,1281,0,0,0,0,0,0,0,66.31 ,56.99 ,66.31 
03,015,01,004,0071,124,553,2,555,975,0,0,0,0,0,0,0,66.31 ,56.92 ,66.31 
03,015,01,004,0071,125,631,4,635,1116,0,0,0,0,0,0,0,66.31 ,56.90 ,66.31 
03,015,01,004,0072,126,529,5,534,935,0,0,0,0,0,0,0,66.31 ,57.11 ,66.31 
03,015,01,004,0072,127,572,7,579,1077,0,0,0,0,0,0,0,66.31 ,53.76 ,66.31 
03,015,01,004,0072,128,369,10,379,744,0,0,0,0,0,0,0,66.31 ,50.94 ,66.31 
03,015,01,004,0073,129,670,13,683,1354,0,0,0,0,0,0,0,66.31 ,50.44 ,66.31 
03,015,01,004,0074,130,638,6,644,1145,0,0,0,0,0,0,0,66.31 ,56.24 ,66.31 
03,015,01,004,0074,131,542,6,548,973,0,0,0,0,0,0,0,66.31 ,56.32 ,66.31 
03,015,01,004,0074,132,503,18,521,947,0,0,0,0,0,0,0,66.31 ,55.02 ,66.31 
03,015,01,004,0075,133,469,11,480,855,0,0,0,0,0,0,0,66.31 ,56.14 ,66.31 
03,015,01,005,0076,134,410,5,415,718,0,0,0,0,0,0,0,66.31 ,57.80 ,66.31 
03,015,01,005,0077,135,171,3,174,323,0,0,0,0,0,0,0,66.31 ,53.87 ,66.31 
03,015,01,005,0078,136,1018,11,1029,1834,0,0,0,0,0,0,0,66.31 ,56.11 ,66.31 
03,015,01,005,0079,137,658,13,671,1207,0,0,0,0,0,0,0,66.31 ,55.59 ,66.31 
03,015,01,005,0080,138,391,4,395,655,0,0,0,0,0,0,0,66.31 ,60.31 ,66.31 
03,015,01,005,0081,139,605,7,612,1062,0,0,0,0,0,0,0,66.31 ,57.63 ,66.31 
03,015,01,005,0082,140,305,4,309,561,0,0,0,0,0,0,0,66.31 ,55.08 ,66.31 
03,015,01,005,0083,141,79,4,83,149,0,0,0,0,0,0,0,66.31 ,55.70 ,66.31 
03,015,01,005,0084,142,307,5,312,561,0,0,0,0,0,0,0,66.31 ,55.61 ,66.31 
03,015,01,005,0085,143,455,3,458,747,0,0,0,0,0,0,0,66.31 ,61.31 ,66.31 
03,015,01,005,0085,144,162,3,165,288,0,0,0,0,0,0,0,66.31 ,57.29 ,66.31 
03,015,01,005,0086,145,928,10,938,1734,0,0,0,0,0,0,0,66.31 ,54.09 ,66.31 
03,015,01,005,0086,146,212,5,217,379,0,0,0,0,0,0,0,66.31 ,57.26 ,66.31 
03,015,01,005,0087,147,53,2,55,88,0,0,0,0,0,0,0,66.31 ,62.50 ,66.31 
03,015,01,005,0087,148,23,0,23,44,0,0,0,0,0,0,0,66.31 ,52.27 ,66.31 
03,015,01,005,0088,149,125,3,128,269,0,0,0,0,0,0,0,66.31 ,47.58 ,66.31 
03,015,01,005,0089,150,194,4,198,384,0,0,0,0,0,0,0,66.31 ,51.56 ,66.31 
03,015,01,005,0090,151,173,4,177,417,0,0,0,0,0,0,0,66.31 ,42.45 ,66.31 
03,015,01,005,0090,152,34,0,34,57,0,0,0,0,0,0,0,66.31 ,59.65 ,66.31 
03,015,01,006,0091,153,690,5,695,1124,0,0,0,0,0,0,0,66.31 ,61.83 ,66.31 
03,015,01,006,0092,154,408,1,409,683,0,0,0,0,0,0,0,66.31 ,59.88 ,66.31 
03,015,01,006,0093,155,456,5,461,734,0,0,0,0,0,0,0,66.31 ,62.81 ,66.31 
03,015,01,006,0094,156,740,8,748,1206,0,0,0,0,0,0,0,66.31 ,62.02 ,66.31 
03,015,01,006,0095,157,400,3,403,681,0,0,0,0,0,0,0,66.31 ,59.18 ,66.31 
03,015,01,006,0095,158,142,1,143,222,0,0,0,0,0,0,0,66.31 ,64.41 ,66.31 
03,015,01,006,0096,159,91,2,93,184,0,0,0,0,0,0,0,66.31 ,50.54 ,66.31 
03,015,01,006,0096,160,43,0,43,81,0,0,0,0,0,0,0,66.31 ,53.09 ,66.31 
03,015,01,006,0097,161,324,6,330,668,0,0,0,0,0,0,0,66.31 ,49.40 ,66.31 
03,015,01,006,0097,162,314,11,325,610,0,0,0,0,0,0,0,66.31 ,53.28 ,66.31 
03,015,01,006,0098,163,366,12,378,647,0,0,0,0,0,0,0,66.31 ,58.42 ,66.31 
03,015,01,006,0099,164,387,3,390,719,0,0,0,0,0,0,0,66.31 ,54.24 ,66.31 
03,015,01,006,0100,165,549,8,557,868,0,0,0,0,0,0,0,66.31 ,64.17 ,66.31 
03,015,01,006,0101,166,586,9,595,1087,0,0,0,0,0,0,0,66.31 ,54.74 ,66.31 
03,015,01,006,0102,167,89,1,90,165,0,0,0,0,0,0,0,66.31 ,54.55 ,66.31 
03,015,01,007,0103,168,532,5,537,931,0,0,0,0,0,0,0,66.31 ,57.68 ,66.31 
03,015,01,007,0104,169,593,4,597,952,0,0,0,0,0,0,0,66.31 ,62.71 ,66.31 
03,015,01,007,0105,170,209,2,211,436,0,0,0,0,0,0,0,66.31 ,48.39 ,66.31 
03,015,01,007,0106,171,144,3,147,315,0,0,0,0,0,0,0,66.31 ,46.67 ,66.31 
03,015,01,007,0107,172,414,2,416,729,0,0,0,0,0,0,0,66.31 ,57.06 ,66.31 
03,015,01,007,0108,173,43,0,43,92,0,0,0,0,0,0,0,66.31 ,46.74 ,66.31 
03,015,01,007,0108,174,50,5,55,138,0,0,0,0,0,0,0,66.31 ,39.86 ,66.31 
03,015,01,007,0109,175,71,1,72,128,0,0,0,0,0,0,0,66.31 ,56.25 ,66.31 
03,015,01,007,0110,176,54,0,54,120,0,0,0,0,0,0,0,66.31 ,45.00 ,66.31 
03,015,01,007,0111,177,83,2,85,219,0,0,0,0,0,0,0,66.31 ,38.81 ,66.31 
03,015,01,007,0112,178,118,2,120,230,0,0,0,0,0,0,0,66.31 ,52.17 ,66.31 
03,015,01,007,0113,179,345,4,349,515,0,0,0,0,0,0,0,66.31 ,67.77 ,66.31 
03,015,01,007,0114,180,300,3,303,541,0,0,0,0,0,0,0,66.31 ,56.01 ,66.31 
03,015,01,007,0114,181,80,2,82,137,0,0,0,0,0,0,0,66.31 ,59.85 ,66.31 
03,015,01,007,0115,182,193,2,195,380,0,0,0,0,0,0,0,66.31 ,51.32 ,66.31 
03,015,01,007,0116,183,212,4,216,388,0,0,0,0,0,0,0,66.31 ,55.67 ,66.31 
03,015,01,007,0117,184,348,4,352,606,0,0,0,0,0,0,0,66.31 ,58.09 ,66.31 
03,015,01,008,0118,185,44,0,44,138,0,0,0,0,0,0,0,66.31 ,31.88 ,66.31 
03,015,01,008,0119,186,64,1,65,165,0,0,0,0,0,0,0,66.31 ,39.39 ,66.31 
03,015,01,008,0120,187,36,0,36,74,0,0,0,0,0,0,0,66.31 ,48.65 ,66.31 
03,015,01,008,0120,188,314,5,319,590,0,0,0,0,0,0,0,66.31 ,54.07 ,66.31 
03,015,01,008,0120,189,42,0,42,88,0,0,0,0,0,0,0,66.31 ,47.73 ,66.31 
03,015,01,008,0121,190,58,0,58,126,0,0,0,0,0,0,0,66.31 ,46.03 ,66.31 
03,015,01,008,0122,191,55,0,55,103,0,0,0,0,0,0,0,66.31 ,53.40 ,66.31 
03,015,01,009,0123,192,30,1,31,67,0,0,0,0,0,0,0,66.31 ,46.27 ,66.31 
03,015,01,009,0124,193,13,0,13,29,0,0,0,0,0,0,0,66.31 ,44.83 ,66.31 
03,015,01,009,0125,194,27,0,27,63,0,0,0,0,0,0,0,66.31 ,42.86 ,66.31 
03,015,01,009,0126,195,25,0,25,63,0,0,0,0,0,0,0,66.31 ,39.68 ,66.31 
03,015,01,009,0127,196,5,0,5,13,0,0,0,0,0,0,0,66.31 ,38.46 ,66.31 
03,015,01,009,0127,197,9,0,9,25,0,0,0,0,0,0,0,66.31 ,36.00 ,66.31 
03,015,01,009,0128,198,47,0,47,120,0,0,0,0,0,0,0,66.31 ,39.17 ,66.31 
03,015,01,010,0129,199,458,5,463,794,0,0,0,0,0,0,0,66.31 ,58.31 ,66.31 
03,015,01,010,0129,200,584,5,589,1054,0,0,0,0,0,0,0,66.31 ,55.88 ,66.31 
03,015,01,010,0130,201,436,7,443,792,0,0,0,0,0,0,0,66.31 ,55.93 ,66.31 
03,015,01,010,0130,202,456,4,460,857,0,0,0,0,0,0,0,66.31 ,53.68 ,66.31 
03,015,01,010,0131,203,243,3,246,419,0,0,0,0,0,0,0,66.31 ,58.71 ,66.31 
03,015,01,010,0132,204,451,4,455,850,0,0,0,0,0,0,0,66.31 ,53.53 ,66.31 
03,015,01,010,0133,205,231,2,233,437,0,0,0,0,0,0,0,66.31 ,53.32 ,66.31 
03,015,01,010,0134,206,267,3,270,518,0,0,0,0,0,0,0,66.31 ,52.12 ,66.31 
03,015,01,010,0135,207,146,2,148,335,0,0,0,0,0,0,0,66.31 ,44.18 ,66.31 
03,015,01,010,0136,208,24,0,24,53,0,0,0,0,0,0,0,66.31 ,45.28 ,66.31 
03,015,01,010,0137,209,379,1,380,670,0,0,0,0,0,0,0,66.31 ,56.72 ,66.31 
03,015,01,010,0138,210,133,4,137,323,0,0,0,0,0,0,0,66.31 ,42.41 ,66.31 
03,015,01,010,0139,211,268,3,271,492,0,0,0,0,0,0,0,66.31 ,55.08 ,66.31 
03,015,01,011,0140,212,845,9,854,1575,0,0,0,0,0,0,0,66.31 ,54.22 ,66.31 
03,015,01,011,0140,213,781,5,786,1416,0,0,0,0,0,0,0,66.31 ,55.51 ,66.31 
03,015,01,011,0140,214,627,6,633,1090,0,0,0,0,0,0,0,66.31 ,58.07 ,66.31 
03,015,01,011,0141,215,780,8,788,1385,0,0,0,0,0,0,0,66.31 ,56.90 ,66.31 
03,015,01,011,0142,216,455,3,458,848,0,0,0,0,0,0,0,66.31 ,54.01 ,66.31 
03,015,01,011,0142,217,487,4,491,914,0,0,0,0,0,0,0,66.31 ,53.72 ,66.31 
03,015,01,011,0143,218,661,13,674,1136,0,0,0,0,0,0,0,66.31 ,59.33 ,66.31 
03,015,01,011,0143,219,667,65,732,1251,0,0,0,0,0,0,0,66.31 ,58.51 ,66.31 
03,015,01,011,0143,220,319,42,361,967,0,0,0,0,0,0,0,66.31 ,37.33 ,66.31 
03,015,01,011,0144,221,560,13,573,1065,0,0,0,0,0,0,0,66.31 ,53.80 ,66.31 
03,015,01,011,0145,222,553,10,563,1106,0,0,0,0,0,0,0,66.31 ,50.90 ,66.31 
03,015,01,011,0146,223,351,15,366,691,0,0,0,0,0,0,0,66.31 ,52.97 ,66.31 
03,015,01,011,0147,224,156,2,158,399,0,0,0,0,0,0,0,66.31 ,39.60 ,66.31 
03,015,01,011,0148,225,178,5,183,352,0,0,0,0,0,0,0,66.31 ,51.99 ,66.31 
03,015,01,011,0149,226,326,7,333,722,0,0,0,0,0,0,0,66.31 ,46.12 ,66.31 
03,015,01,011,0149,227,167,4,171,347,0,0,0,0,0,0,0,66.31 ,49.28 ,66.31 
03,015,01,011,0150,228,271,8,279,577,0,0,0,0,0,0,0,66.31 ,48.35 ,66.31 
03,015,01,011,0151,229,249,5,254,525,0,0,0,0,0,0,0,66.31 ,48.38 ,66.31 
03,015,01,011,0152,230,38,1,39,85,0,0,0,0,0,0,0,66.31 ,45.88 ,66.31 
03,015,01,011,0153,231,531,13,544,1016,0,0,0,0,0,0,0,66.31 ,53.54 ,66.31 
03,015,01,011,0154,232,540,11,551,1100,0,0,0,0,0,0,0,66.31 ,50.09 ,66.31 
03,015,01,012,0155,233,242,0,242,470,0,0,0,0,0,0,0,66.31 ,51.49 ,66.31 
03,015,01,012,0156,234,582,11,593,1265,0,0,0,0,0,0,0,66.31 ,46.88 ,66.31 
03,015,01,012,0157,235,269,2,271,544,0,0,0,0,0,0,0,66.31 ,49.82 ,66.31 
03,015,01,012,0158,236,292,9,301,643,0,0,0,0,0,0,0,66.31 ,46.81 ,66.31 
03,015,01,012,0159,237,574,5,579,1077,0,0,0,0,0,0,0,66.31 ,53.76 ,66.31 
03,015,01,012,0160,238,232,2,234,468,0,0,0,0,0,0,0,66.31 ,50.00 ,66.31 
03,015,01,012,0161,239,464,4,468,888,0,0,0,0,0,0,0,66.31 ,52.70 ,66.31 
03,015,01,012,0162,240,238,2,240,403,0,0,0,0,0,0,0,66.31 ,59.55 ,66.31 
03,015,01,012,0163,241,875,7,882,1663,0,0,0,0,0,0,0,66.31 ,53.04 ,66.31 
03,015,01,012,0164,242,267,2,269,549,0,0,0,0,0,0,0,66.31 ,49.00 ,66.31 
03,015,01,012,0165,243,178,1,179,376,0,0,0,0,0,0,0,66.31 ,47.61 ,66.31 
03,015,01,012,0166,244,275,2,277,535,0,0,0,0,0,0,0,66.31 ,51.78 ,66.31 
03,015,01,012,0167,245,313,3,316,580,0,0,0,0,0,0,0,66.31 ,54.48 ,66.31 
03,015,01,013,0168,246,11,0,11,31,0,0,0,0,0,0,0,66.31 ,35.48 ,66.31 
03,015,01,013,0169,247,7,0,7,18,0,0,0,0,0,0,0,66.31 ,38.89 ,66.31 
03,015,01,013,0169,248,13,0,13,28,0,0,0,0,0,0,0,66.31 ,46.43 ,66.31 
03,015,01,013,0170,249,7,0,7,13,0,0,0,0,0,0,0,66.31 ,53.85 ,66.31 
03,015,01,013,0170,250,9,0,9,18,0,0,0,0,0,0,0,66.31 ,50.00 ,66.31 
03,015,01,013,0171,251,38,3,41,78,0,0,0,0,0,0,0,66.31 ,52.56 ,66.31 
03,015,01,013,0172,252,35,3,38,71,0,0,0,0,0,0,0,66.31 ,53.52 ,66.31 
03,015,01,013,0172,253,19,1,20,32,0,0,0,0,0,0,0,66.31 ,62.50 ,66.31 
03,015,01,013,0173,254,18,0,18,44,0,0,0,0,0,0,0,66.31 ,40.91 ,66.31 
03,015,01,013,0173,255,12,1,13,32,0,0,0,0,0,0,0,66.31 ,40.63 ,66.31 
03,015,01,013,0173,256,11,0,11,21,0,0,0,0,0,0,0,66.31 ,52.38 ,66.31 
03,016,01,001,0001,1,266,4,270,393,0,0,0,0,0,0,0,66.31 ,68.70 ,66.31 
03,016,01,001,0002,2,210,2,212,315,0,0,0,0,0,0,0,66.31 ,67.30 ,66.31 
03,016,01,001,0003,3,341,5,346,560,0,0,0,0,0,0,0,66.31 ,61.79 ,66.31 
03,016,01,001,0004,4,291,4,295,507,0,0,0,0,0,0,0,66.31 ,58.19 ,66.31 
03,016,01,001,0005,5,513,3,516,879,0,0,0,0,0,0,0,66.31 ,58.70 ,66.31 
03,016,01,001,0006,6,570,4,574,1016,0,0,0,0,0,0,0,66.31 ,56.50 ,66.31 
03,016,01,001,0007,7,427,7,434,720,0,0,0,0,0,0,0,66.31 ,60.28 ,66.31 
03,016,01,001,0008,8,520,6,526,891,0,0,0,0,0,0,0,66.31 ,59.03 ,66.31 
03,016,01,001,0008,9,513,6,519,831,0,0,0,0,0,0,0,66.31 ,62.45 ,66.31 
03,016,01,001,0009,10,322,10,332,584,0,0,0,0,0,0,0,66.31 ,56.85 ,66.31 
03,016,01,001,0009,11,386,4,390,617,0,0,0,0,0,0,0,66.31 ,63.21 ,66.31 
03,016,01,001,0010,12,696,8,704,1154,0,0,0,0,0,0,0,66.31 ,61.01 ,66.31 
03,016,01,001,0010,13,668,10,678,1132,0,0,0,0,0,0,0,66.31 ,59.89 ,66.31 
03,016,01,001,0011,14,736,4,740,1250,0,0,0,0,0,0,0,66.31 ,59.20 ,66.31 
03,016,01,001,0011,15,778,9,787,1382,0,0,0,0,0,0,0,66.31 ,56.95 ,66.31 
03,016,01,001,0011,16,787,10,797,1443,0,0,0,0,0,0,0,66.31 ,55.23 ,66.31 
03,016,01,001,0012,17,642,7,649,1123,0,0,0,0,0,0,0,66.31 ,57.79 ,66.31 
03,016,01,001,0012,18,575,6,581,1086,0,0,0,0,0,0,0,66.31 ,53.50 ,66.31 
03,016,01,001,0013,19,550,8,558,950,0,0,0,0,0,0,0,66.31 ,58.74 ,66.31 
03,016,01,001,0014,20,658,15,673,1140,0,0,0,0,0,0,0,66.31 ,59.04 ,66.31 
03,016,01,001,0014,21,680,7,687,1158,0,0,0,0,0,0,0,66.31 ,59.33 ,66.31 
03,016,01,001,0015,22,590,5,595,994,0,0,0,0,0,0,0,66.31 ,59.86 ,66.31 
03,016,01,001,0015,23,480,3,483,827,0,0,0,0,0,0,0,66.31 ,58.40 ,66.31 
03,016,01,001,0016,24,550,6,556,870,0,0,0,0,0,0,0,66.31 ,63.91 ,66.31 
03,016,01,001,0016,25,418,6,424,756,0,0,0,0,0,0,0,66.31 ,56.08 ,66.31 
03,016,01,001,0017,26,761,16,777,1204,0,0,0,0,0,0,0,66.31 ,64.53 ,66.31 
03,016,01,001,0018,27,303,5,308,475,0,0,0,0,0,0,0,66.31 ,64.84 ,66.31 
03,016,01,001,0019,28,330,7,337,495,0,0,0,0,0,0,0,66.31 ,68.08 ,66.31 
03,016,01,001,0020,29,698,15,713,1135,0,0,0,0,0,0,0,66.31 ,62.82 ,66.31 
03,016,01,001,0021,30,235,1,236,324,0,0,0,0,0,0,0,66.31 ,72.84 ,66.31 
03,016,01,001,0022,31,716,14,730,1169,0,0,0,0,0,0,0,66.31 ,62.45 ,66.31 
03,016,01,001,0023,32,273,1,274,412,0,0,0,0,0,0,0,66.31 ,66.50 ,66.31 
03,016,01,001,0024,33,317,4,321,500,0,0,0,0,0,0,0,66.31 ,64.20 ,66.31 
03,016,01,001,0025,34,455,10,465,781,0,0,0,0,0,0,0,66.31 ,59.54 ,66.31 
03,016,01,001,0026,35,214,3,217,338,0,0,0,0,0,0,0,66.31 ,64.20 ,66.31 
03,016,01,001,0027,36,493,10,503,951,0,0,0,0,0,0,0,66.31 ,52.89 ,66.31 
03,016,01,001,0027,37,521,2,523,953,0,0,0,0,0,0,0,66.31 ,54.88 ,66.31 
03,016,01,001,0028,38,698,4,702,1287,0,0,0,0,0,0,0,66.31 ,54.55 ,66.31 
03,016,01,001,0029,39,98,3,101,164,0,0,0,0,0,0,0,66.31 ,61.59 ,66.31 
03,016,01,001,0030,40,198,2,200,333,0,0,0,0,0,0,0,66.31 ,60.06 ,66.31 
03,016,01,001,0031,41,654,6,660,972,0,0,0,0,0,0,0,66.31 ,67.90 ,66.31 
03,016,01,001,0032,42,681,7,688,1078,0,0,0,0,0,0,0,66.31 ,63.82 ,66.31 
03,016,01,001,0033,43,182,2,184,533,0,0,0,0,0,0,0,66.31 ,34.52 ,66.31 
03,016,01,001,0034,44,61,0,61,192,0,0,0,0,0,0,0,66.31 ,31.77 ,66.31 
03,016,01,002,0035,45,525,5,530,815,0,0,0,0,0,0,0,66.31 ,65.03 ,66.31 
03,016,01,002,0036,46,166,1,167,273,0,0,0,0,0,0,0,66.31 ,61.17 ,66.31 
03,016,01,002,0037,47,112,1,113,189,0,0,0,0,0,0,0,66.31 ,59.79 ,66.31 
03,016,01,002,0038,48,142,4,146,235,0,0,0,0,0,0,0,66.31 ,62.13 ,66.31 
03,016,01,002,0039,49,325,8,333,592,0,0,0,0,0,0,0,66.31 ,56.25 ,66.31 
03,016,01,002,0040,50,174,4,178,258,0,0,0,0,0,0,0,66.31 ,68.99 ,66.31 
03,016,01,002,0041,51,307,5,312,535,0,0,0,0,0,0,0,66.31 ,58.32 ,66.31 
03,016,01,002,0042,52,248,2,250,421,0,0,0,0,0,0,0,66.31 ,59.38 ,66.31 
03,016,01,002,0043,53,233,1,234,382,0,0,0,0,0,0,0,66.31 ,61.26 ,66.31 
03,016,01,002,0044,54,51,0,51,102,0,0,0,0,0,0,0,66.31 ,50.00 ,66.31 
03,016,01,002,0045,55,431,3,434,703,0,0,0,0,0,0,0,66.31 ,61.74 ,66.31 
03,016,01,002,0046,56,98,2,100,161,0,0,0,0,0,0,0,66.31 ,62.11 ,66.31 
03,016,01,002,0047,57,175,6,181,295,0,0,0,0,0,0,0,66.31 ,61.36 ,66.31 
03,016,01,002,0048,58,143,1,144,215,0,0,0,0,0,0,0,66.31 ,66.98 ,66.31 
03,016,01,002,0049,59,94,6,100,177,0,0,0,0,0,0,0,66.31 ,56.50 ,66.31 
03,016,01,002,0050,60,124,2,126,174,0,0,0,0,0,0,0,66.31 ,72.41 ,66.31 
03,016,01,002,0051,61,50,1,51,80,0,0,0,0,0,0,0,66.31 ,63.75 ,66.31 
03,016,01,002,0052,62,392,4,396,598,0,0,0,0,0,0,0,66.31 ,66.22 ,66.31 
03,016,01,002,0053,63,460,9,469,811,0,0,0,0,0,0,0,66.31 ,57.83 ,66.31 
03,016,01,002,0054,64,292,5,297,500,0,0,0,0,0,0,0,66.31 ,59.40 ,66.31 
03,016,01,002,0055,65,422,5,427,734,0,0,0,0,0,0,0,66.31 ,58.17 ,66.31 
03,016,01,002,0055,66,448,7,455,759,0,0,0,0,0,0,0,66.31 ,59.95 ,66.31 
03,016,01,002,0056,67,346,2,348,598,0,0,0,0,0,0,0,66.31 ,58.19 ,66.31 
03,016,01,003,0057,68,256,2,258,401,0,0,0,0,0,0,0,66.31 ,64.34 ,66.31 
03,016,01,003,0058,69,298,1,299,495,0,0,0,0,0,0,0,66.31 ,60.40 ,66.31 
03,016,01,003,0059,70,56,1,57,85,0,0,0,0,0,0,0,66.31 ,67.06 ,66.31 
03,016,01,003,0060,71,64,1,65,101,0,0,0,0,0,0,0,66.31 ,64.36 ,66.31 
03,016,01,003,0061,72,150,3,153,252,0,0,0,0,0,0,0,66.31 ,60.71 ,66.31 
03,016,01,003,0062,73,104,1,105,197,0,0,0,0,0,0,0,66.31 ,53.30 ,66.31 
03,016,01,003,0063,74,104,3,107,166,0,0,0,0,0,0,0,66.31 ,64.46 ,66.31 
03,016,01,003,0064,75,771,14,785,1265,0,0,0,0,0,0,0,66.31 ,62.06 ,66.31 
03,016,01,003,0065,76,164,3,167,261,0,0,0,0,0,0,0,66.31 ,63.98 ,66.31 
03,016,01,003,0066,77,358,7,365,637,0,0,0,0,0,0,0,66.31 ,57.30 ,66.31 
03,016,01,003,0067,78,404,3,407,677,0,0,0,0,0,0,0,66.31 ,60.12 ,66.31 
03,016,01,003,0068,79,408,1,409,1109,0,0,0,0,0,0,0,66.31 ,36.88 ,66.31 
03,016,01,003,0069,80,292,6,298,848,0,0,0,0,0,0,0,66.31 ,35.14 ,66.31 
03,016,01,003,0070,81,82,0,82,205,0,0,0,0,0,0,0,66.31 ,40.00 ,66.31 
03,016,01,003,0071,82,75,1,76,148,0,0,0,0,0,0,0,66.31 ,51.35 ,66.31 
03,016,01,004,0072,83,111,3,114,233,0,0,0,0,0,0,0,66.31 ,48.93 ,66.31 
03,016,01,004,0073,84,205,1,206,410,0,0,0,0,0,0,0,66.31 ,50.24 ,66.31 
03,016,01,004,0074,85,351,7,358,735,0,0,0,0,0,0,0,66.31 ,48.71 ,66.31 
03,016,01,004,0075,86,124,2,126,241,0,0,0,0,0,0,0,66.31 ,52.28 ,66.31 
03,016,01,004,0076,87,286,7,293,575,0,0,0,0,0,0,0,66.31 ,50.96 ,66.31 
03,016,01,004,0077,88,55,0,55,108,0,0,0,0,0,0,0,66.31 ,50.93 ,66.31 
03,016,01,004,0078,89,257,10,267,479,0,0,0,0,0,0,0,66.31 ,55.74 ,66.31 
03,016,01,004,0079,90,114,1,115,202,0,0,0,0,0,0,0,66.31 ,56.93 ,66.31 
03,016,01,004,0080,91,277,4,281,583,0,0,0,0,0,0,0,66.31 ,48.20 ,66.31 
03,016,01,004,0081,92,543,14,557,1159,0,0,0,0,0,0,0,66.31 ,48.06 ,66.31 
03,016,01,004,0082,93,359,4,363,771,0,0,0,0,0,0,0,66.31 ,47.08 ,66.31 
03,016,01,004,0082,94,489,2,491,935,0,0,0,0,0,0,0,66.31 ,52.51 ,66.31 
03,016,01,005,0083,95,170,2,172,394,0,0,0,0,0,0,0,66.31 ,43.65 ,66.31 
03,016,01,005,0084,96,152,3,155,303,0,0,0,0,0,0,0,66.31 ,51.16 ,66.31 
03,016,01,005,0085,97,62,2,64,209,0,0,0,0,0,0,0,66.31 ,30.62 ,66.31 
03,016,01,005,0086,98,100,3,103,265,0,0,0,0,0,0,0,66.31 ,38.87 ,66.31 
03,016,01,005,0087,99,161,3,164,550,0,0,0,0,0,0,0,66.31 ,29.82 ,66.31 
03,016,01,005,0087,100,199,1,200,557,0,0,0,0,0,0,0,66.31 ,35.91 ,66.31 
03,016,01,005,0088,101,20,0,20,320,0,0,0,0,0,0,0,66.31 ,6.25 ,66.31 
03,016,01,005,0089,102,30,0,30,227,0,0,0,0,0,0,0,66.31 ,13.22 ,66.31 
03,016,01,005,0090,103,26,0,26,116,0,0,0,0,0,0,0,66.31 ,22.41 ,66.31 
03,016,01,005,0091,104,104,0,104,217,0,0,0,0,0,0,0,66.31 ,47.93 ,66.31 
03,016,01,006,0092,105,110,4,114,225,0,0,0,0,0,0,0,66.31 ,50.67 ,66.31 
03,016,01,006,0093,106,153,5,158,388,0,0,0,0,0,0,0,66.31 ,40.72 ,66.31 
03,016,01,006,0094,107,167,2,169,376,0,0,0,0,0,0,0,66.31 ,44.95 ,66.31 
03,016,01,006,0095,108,101,0,101,216,0,0,0,0,0,0,0,66.31 ,46.76 ,66.31 
03,016,01,006,0096,109,100,1,101,240,0,0,0,0,0,0,0,66.31 ,42.08 ,66.31 
03,016,01,006,0097,110,365,8,373,742,0,0,0,0,0,0,0,66.31 ,50.27 ,66.31 
03,017,01,001,0001,1,413,3,416,629,0,0,0,0,0,0,0,66.31 ,66.14 ,66.31 
03,017,01,001,0002,2,711,12,723,1314,0,0,0,0,0,0,0,66.31 ,55.02 ,66.31 
03,017,01,001,0002,3,308,8,316,612,0,0,0,0,0,0,0,66.31 ,51.63 ,66.31 
03,017,01,001,0003,4,967,8,975,1593,0,0,0,0,0,0,0,66.31 ,61.21 ,66.31 
03,017,01,001,0004,5,741,5,746,1367,0,0,0,0,0,0,0,66.31 ,54.57 ,66.31 
03,017,01,001,0005,6,735,9,744,1767,0,0,0,0,0,0,0,66.31 ,42.11 ,66.31 
03,017,01,001,0005,7,897,7,904,2297,0,0,0,0,0,0,0,66.31 ,39.36 ,66.31 
03,017,01,001,0006,8,893,14,907,1588,0,0,0,0,0,0,0,66.31 ,57.12 ,66.31 
03,017,01,001,0007,9,542,8,550,981,0,0,0,0,0,0,0,66.31 ,56.07 ,66.31 
03,017,01,001,0007,10,540,5,545,1014,0,0,0,0,0,0,0,66.31 ,53.75 ,66.31 
03,017,01,001,0008,11,563,6,569,1004,0,0,0,0,0,0,0,66.31 ,56.67 ,66.31 
03,017,01,001,0009,12,516,5,521,1030,0,0,0,0,0,0,0,66.31 ,50.58 ,66.31 
03,017,01,001,0010,13,687,11,698,1342,0,0,0,0,0,0,0,66.31 ,52.01 ,66.31 
03,017,01,001,0011,14,558,4,562,966,0,0,0,0,0,0,0,66.31 ,58.18 ,66.31 
03,017,01,001,0011,15,535,5,540,1030,0,0,0,0,0,0,0,66.31 ,52.43 ,66.31 
03,017,01,001,0012,16,771,4,775,1477,0,0,0,0,0,0,0,66.31 ,52.47 ,66.31 
03,017,01,001,0013,17,556,7,563,989,0,0,0,0,0,0,0,66.31 ,56.93 ,66.31 
03,017,01,001,0013,18,657,9,666,1167,0,0,0,0,0,0,0,66.31 ,57.07 ,66.31 
03,017,01,001,0014,19,524,9,533,1080,0,0,0,0,0,0,0,66.31 ,49.35 ,66.31 
03,017,01,001,0014,20,521,5,526,1011,0,0,0,0,0,0,0,66.31 ,52.03 ,66.31 
03,017,01,001,0015,21,798,7,805,1474,0,0,0,0,0,0,0,66.31 ,54.61 ,66.31 
03,017,01,001,0016,22,564,14,578,1005,0,0,0,0,0,0,0,66.31 ,57.51 ,66.31 
03,017,01,001,0016,23,707,12,719,1417,0,0,0,0,0,0,0,66.31 ,50.74 ,66.31 
03,017,01,001,0017,24,816,3,819,1425,0,0,0,0,0,0,0,66.31 ,57.47 ,66.31 
03,017,01,001,0018,25,723,5,728,1388,0,0,0,0,0,0,0,66.31 ,52.45 ,66.31 
03,017,01,001,0019,26,887,7,894,1559,0,0,0,0,0,0,0,66.31 ,57.34 ,66.31 
03,017,01,001,0020,27,699,9,708,1425,0,0,0,0,0,0,0,66.31 ,49.68 ,66.31 
03,017,01,001,0021,28,696,8,704,1273,0,0,0,0,0,0,0,66.31 ,55.30 ,66.31 
03,017,01,001,0022,29,616,7,623,1216,0,0,0,0,0,0,0,66.31 ,51.23 ,66.31 
03,017,01,001,0023,30,582,8,590,1106,0,0,0,0,0,0,0,66.31 ,53.35 ,66.31 
03,017,01,001,0024,31,822,13,835,1512,0,0,0,0,0,0,0,66.31 ,55.22 ,66.31 
03,017,01,001,0025,32,482,3,485,834,0,0,0,0,0,0,0,66.31 ,58.15 ,66.31 
03,017,01,002,0026,33,699,11,710,1202,0,0,0,0,0,0,0,66.31 ,59.07 ,66.31 
03,017,01,002,0027,34,742,7,749,1237,0,0,0,0,0,0,0,66.31 ,60.55 ,66.31 
03,017,01,002,0028,35,636,4,640,1071,0,0,0,0,0,0,0,66.31 ,59.76 ,66.31 
03,017,01,002,0029,36,737,9,746,1221,0,0,0,0,0,0,0,66.31 ,61.10 ,66.31 
03,017,01,002,0029,37,704,5,709,1214,0,0,0,0,0,0,0,66.31 ,58.40 ,66.31 
03,017,01,002,0030,38,508,5,513,855,0,0,0,0,0,0,0,66.31 ,60.00 ,66.31 
03,017,01,002,0031,39,813,7,820,1357,0,0,0,0,0,0,0,66.31 ,60.43 ,66.31 
03,017,01,002,0032,40,440,7,447,725,0,0,0,0,0,0,0,66.31 ,61.66 ,66.31 
03,017,01,002,0033,41,377,9,386,714,0,0,0,0,0,0,0,66.31 ,54.06 ,66.31 
03,017,01,002,0033,42,579,6,585,1080,0,0,0,0,0,0,0,66.31 ,54.17 ,66.31 
03,017,01,002,0034,43,849,7,856,1511,0,0,0,0,0,0,0,66.31 ,56.65 ,66.31 
03,017,01,002,0035,44,972,4,976,1641,0,0,0,0,0,0,0,66.31 ,59.48 ,66.31 
03,017,01,002,0036,45,825,11,836,1357,0,0,0,0,0,0,0,66.31 ,61.61 ,66.31 
03,017,01,002,0036,46,556,3,559,1023,0,0,0,0,0,0,0,66.31 ,54.64 ,66.31 
03,017,01,002,0037,47,507,2,509,932,0,0,0,0,0,0,0,66.31 ,54.61 ,66.31 
03,017,01,002,0037,48,885,12,897,1642,0,0,0,0,0,0,0,66.31 ,54.63 ,66.31 
03,017,01,002,0038,49,988,10,998,1863,0,0,0,0,0,0,0,66.31 ,53.57 ,66.31 
03,017,01,002,0039,50,810,8,818,1521,0,0,0,0,0,0,0,66.31 ,53.78 ,66.31 
03,017,01,002,0039,51,950,6,956,1791,0,0,0,0,0,0,0,66.31 ,53.38 ,66.31 
03,017,01,002,0040,52,801,15,816,1451,0,0,0,0,0,0,0,66.31 ,56.24 ,66.31 
03,017,01,002,0040,53,744,11,755,1274,0,0,0,0,0,0,0,66.31 ,59.26 ,66.31 
03,017,01,002,0041,54,1221,8,1229,2306,0,0,0,0,0,0,0,66.31 ,53.30 ,66.31 
03,017,01,002,0042,55,880,11,891,1498,0,0,0,0,0,0,0,66.31 ,59.48 ,66.31 
03,017,01,002,0042,56,1122,14,1136,2435,0,0,0,0,0,0,0,66.31 ,46.65 ,66.31 
03,017,01,002,0043,57,520,3,523,857,0,0,0,0,0,0,0,66.31 ,61.03 ,66.31 
03,017,01,003,0044,58,410,3,413,807,0,0,0,0,0,0,0,66.31 ,51.18 ,66.31 
03,017,01,003,0044,59,564,1,565,1035,0,0,0,0,0,0,0,66.31 ,54.59 ,66.31 
03,017,01,003,0045,60,578,7,585,990,0,0,0,0,0,0,0,66.31 ,59.09 ,66.31 
03,017,01,003,0046,61,894,13,907,1569,0,0,0,0,0,0,0,66.31 ,57.81 ,66.31 
03,017,01,003,0047,62,1024,14,1038,1794,0,0,0,0,0,0,0,66.31 ,57.86 ,66.31 
03,017,01,003,0048,63,658,8,666,1155,0,0,0,0,0,0,0,66.31 ,57.66 ,66.31 
03,017,01,003,0048,64,622,5,627,1125,0,0,0,0,0,0,0,66.31 ,55.73 ,66.31 
03,017,01,003,0049,65,600,6,606,1118,0,0,0,0,0,0,0,66.31 ,54.20 ,66.31 
03,017,01,003,0050,66,554,8,562,1082,0,0,0,0,0,0,0,66.31 ,51.94 ,66.31 
03,017,01,003,0051,67,657,5,662,1160,0,0,0,0,0,0,0,66.31 ,57.07 ,66.31 
03,017,01,003,0052,68,608,6,614,1052,0,0,0,0,0,0,0,66.31 ,58.37 ,66.31 
03,017,01,003,0053,69,638,7,645,1207,0,0,0,0,0,0,0,66.31 ,53.44 ,66.31 
03,017,01,003,0053,70,302,5,307,527,0,0,0,0,0,0,0,66.31 ,58.25 ,66.31 
03,017,01,003,0054,71,460,5,465,902,0,0,0,0,0,0,0,66.31 ,51.55 ,66.31 
03,017,01,003,0055,72,540,7,547,1074,0,0,0,0,0,0,0,66.31 ,50.93 ,66.31 
03,017,01,003,0056,73,795,9,804,1571,0,0,0,0,0,0,0,66.31 ,51.18 ,66.31 
03,017,01,003,0056,74,725,12,737,1473,0,0,0,0,0,0,0,66.31 ,50.03 ,66.31 
03,017,01,003,0057,75,439,6,445,920,0,0,0,0,0,0,0,66.31 ,48.37 ,66.31 
03,017,01,003,0058,76,411,6,417,805,0,0,0,0,0,0,0,66.31 ,51.80 ,66.31 
03,017,01,003,0058,77,375,6,381,780,0,0,0,0,0,0,0,66.31 ,48.85 ,66.31 
03,017,01,003,0059,78,444,9,453,937,0,0,0,0,0,0,0,66.31 ,48.35 ,66.31 
03,017,01,003,0060,79,669,7,676,1346,0,0,0,0,0,0,0,66.31 ,50.22 ,66.31 
03,017,01,003,0061,80,497,8,505,982,0,0,0,0,0,0,0,66.31 ,51.43 ,66.31 
03,017,01,003,0062,81,515,6,521,948,0,0,0,0,0,0,0,66.31 ,54.96 ,66.31 
03,017,01,003,0063,82,612,5,617,1170,0,0,0,0,0,0,0,66.31 ,52.74 ,66.31 
03,017,01,003,0064,83,346,1,347,685,0,0,0,0,0,0,0,66.31 ,50.66 ,66.31 
03,017,01,003,0065,84,624,13,637,1243,0,0,0,0,0,0,0,66.31 ,51.25 ,66.31 
03,017,01,003,0066,85,693,7,700,1165,0,0,0,0,0,0,0,66.31 ,60.09 ,66.31 
03,017,01,003,0067,86,897,9,906,1437,0,0,0,0,0,0,0,66.31 ,63.05 ,66.31 
03,017,01,003,0067,87,691,5,696,1271,0,0,0,0,0,0,0,66.31 ,54.76 ,66.31 
03,017,01,003,0068,88,623,7,630,1192,0,0,0,0,0,0,0,66.31 ,52.85 ,66.31 
03,017,01,003,0068,89,605,10,615,1123,0,0,0,0,0,0,0,66.31 ,54.76 ,66.31 
03,017,01,003,0069,90,434,2,436,752,0,0,0,0,0,0,0,66.31 ,57.98 ,66.31 
03,017,01,003,0070,91,389,8,397,699,0,0,0,0,0,0,0,66.31 ,56.80 ,66.31 
03,017,01,003,0071,92,499,4,503,883,0,0,0,0,0,0,0,66.31 ,56.96 ,66.31 
03,017,01,003,0072,93,452,2,454,808,0,0,0,0,0,0,0,66.31 ,56.19 ,66.31 
03,017,01,004,0073,94,498,13,511,828,0,0,0,0,0,0,0,66.31 ,61.71 ,66.31 
03,017,01,004,0074,95,639,6,645,1135,0,0,0,0,0,0,0,66.31 ,56.83 ,66.31 
03,017,01,004,0075,96,588,10,598,988,0,0,0,0,0,0,0,66.31 ,60.53 ,66.31 
03,017,01,004,0076,97,664,13,677,1153,0,0,0,0,0,0,0,66.31 ,58.72 ,66.31 
03,017,01,004,0077,98,603,11,614,1062,0,0,0,0,0,0,0,66.31 ,57.82 ,66.31 
03,017,01,004,0078,99,856,10,866,1455,0,0,0,0,0,0,0,66.31 ,59.52 ,66.31 
03,017,01,004,0079,100,506,5,511,875,0,0,0,0,0,0,0,66.31 ,58.40 ,66.31 
03,017,01,004,0080,101,958,16,974,1663,0,0,0,0,0,0,0,66.31 ,58.57 ,66.31 
03,017,01,004,0081,102,698,8,706,1321,0,0,0,0,0,0,0,66.31 ,53.44 ,66.31 
03,017,01,004,0082,103,356,4,360,670,0,0,0,0,0,0,0,66.31 ,53.73 ,66.31 
03,017,01,004,0082,104,499,5,504,952,0,0,0,0,0,0,0,66.31 ,52.94 ,66.31 
03,017,01,004,0083,105,458,8,466,756,0,0,0,0,0,0,0,66.31 ,61.64 ,66.31 
03,017,01,004,0083,106,786,8,794,1329,0,0,0,0,0,0,0,66.31 ,59.74 ,66.31 
03,017,01,004,0084,107,467,7,474,816,0,0,0,0,0,0,0,66.31 ,58.09 ,66.31 
03,017,01,004,0085,108,444,3,447,838,0,0,0,0,0,0,0,66.31 ,53.34 ,66.31 
03,017,01,004,0086,109,631,13,644,1029,0,0,0,0,0,0,0,66.31 ,62.59 ,66.31 
03,017,01,004,0087,110,352,10,362,652,0,0,0,0,0,0,0,66.31 ,55.52 ,66.31 
03,017,01,004,0087,111,569,10,579,1002,0,0,0,0,0,0,0,66.31 ,57.78 ,66.31 
03,017,01,004,0088,112,601,6,607,1114,0,0,0,0,0,0,0,66.31 ,54.49 ,66.31 
03,017,01,004,0089,113,688,10,698,1120,0,0,0,0,0,0,0,66.31 ,62.32 ,66.31 
03,017,01,004,0089,114,931,12,943,1767,0,0,0,0,0,0,0,66.31 ,53.37 ,66.31 
03,017,01,004,0090,115,1149,18,1167,2064,0,0,0,0,0,0,0,66.31 ,56.54 ,66.31 
03,017,01,004,0090,116,951,8,959,1535,0,0,0,0,0,0,0,66.31 ,62.48 ,66.31 
03,017,01,004,0091,117,710,8,718,1380,0,0,0,0,0,0,0,66.31 ,52.03 ,66.31 
03,017,01,004,0091,118,751,10,761,1602,0,0,0,0,0,0,0,66.31 ,47.50 ,66.31 
03,017,01,004,0091,119,1331,17,1348,2813,0,0,0,0,0,0,0,66.31 ,47.92 ,66.31 
03,017,01,004,0092,120,547,7,554,1002,0,0,0,0,0,0,0,66.31 ,55.29 ,66.31 
03,017,01,004,0092,121,422,3,425,812,0,0,0,0,0,0,0,66.31 ,52.34 ,66.31 
03,017,01,004,0093,122,567,2,569,1027,0,0,0,0,0,0,0,66.31 ,55.40 ,66.31 
03,017,01,004,0094,123,596,7,603,1036,0,0,0,0,0,0,0,66.31 ,58.20 ,66.31 
03,017,01,004,0095,124,509,11,520,910,0,0,0,0,0,0,0,66.31 ,57.14 ,66.31 
03,017,01,005,0096,125,869,8,877,1594,0,0,0,0,0,0,0,66.31 ,55.02 ,66.31 
03,017,01,005,0097,126,795,16,811,1456,0,0,0,0,0,0,0,66.31 ,55.70 ,66.31 
03,017,01,005,0098,127,600,12,612,1251,0,0,0,0,0,0,0,66.31 ,48.92 ,66.31 
03,017,01,005,0099,128,713,16,729,1368,0,0,0,0,0,0,0,66.31 ,53.29 ,66.31 
03,017,01,005,0100,129,830,4,834,1585,0,0,0,0,0,0,0,66.31 ,52.62 ,66.31 
03,017,01,005,0100,130,461,13,474,844,0,0,0,0,0,0,0,66.31 ,56.16 ,66.31 
03,017,01,005,0101,131,685,6,691,1542,0,0,0,0,0,0,0,66.31 ,44.81 ,66.31 
03,017,01,005,0101,132,228,10,238,483,0,0,0,0,0,0,0,66.31 ,49.28 ,66.31 
03,017,01,005,0102,133,505,9,514,1083,0,0,0,0,0,0,0,66.31 ,47.46 ,66.31 
03,017,01,005,0103,134,464,5,469,898,0,0,0,0,0,0,0,66.31 ,52.23 ,66.31 
03,017,01,005,0104,135,450,3,453,763,0,0,0,0,0,0,0,66.31 ,59.37 ,66.31 
03,017,01,005,0105,136,962,10,972,1854,0,0,0,0,0,0,0,66.31 ,52.43 ,66.31 
03,017,01,005,0105,137,713,15,728,1387,0,0,0,0,0,0,0,66.31 ,52.49 ,66.31 
03,017,01,005,0106,138,1118,15,1133,2275,0,0,0,0,0,0,0,66.31 ,49.80 ,66.31 
03,017,01,005,0106,139,710,7,717,1361,0,0,0,0,0,0,0,66.31 ,52.68 ,66.31 
03,017,01,005,0107,140,782,2,784,1484,0,0,0,0,0,0,0,66.31 ,52.83 ,66.31 
03,017,01,005,0107,141,667,5,672,1328,0,0,0,0,0,0,0,66.31 ,50.60 ,66.31 
03,017,01,005,0108,142,851,10,861,1623,0,0,0,0,0,0,0,66.31 ,53.05 ,66.31 
03,017,01,005,0108,143,793,10,803,1600,0,0,0,0,0,0,0,66.31 ,50.19 ,66.31 
03,017,01,005,0108,144,282,3,285,582,0,0,0,0,0,0,0,66.31 ,48.97 ,66.31 
03,017,01,005,0109,145,1079,11,1090,1909,0,0,0,0,0,0,0,66.31 ,57.10 ,66.31 
03,017,01,005,0109,146,590,1,591,1226,0,0,0,0,0,0,0,66.31 ,48.21 ,66.31 
03,017,01,005,0110,147,1025,12,1037,1851,0,0,0,0,0,0,0,66.31 ,56.02 ,66.31 
03,017,01,005,0110,148,772,10,782,1460,0,0,0,0,0,0,0,66.31 ,53.56 ,66.31 
03,017,01,005,0111,149,930,6,936,1794,0,0,0,0,0,0,0,66.31 ,52.17 ,66.31 
03,017,01,005,0112,150,902,9,911,1644,0,0,0,0,0,0,0,66.31 ,55.41 ,66.31 
03,017,01,005,0112,151,922,8,930,1708,0,0,0,0,0,0,0,66.31 ,54.45 ,66.31 
03,017,01,005,0113,152,1172,15,1187,2347,0,0,0,0,0,0,0,66.31 ,50.58 ,66.31 
03,017,01,005,0113,153,696,5,701,1557,0,0,0,0,0,0,0,66.31 ,45.02 ,66.31 
03,017,01,005,0113,154,556,4,560,1171,0,0,0,0,0,0,0,66.31 ,47.82 ,66.31 
03,017,01,005,0114,155,829,7,836,1714,0,0,0,0,0,0,0,66.31 ,48.77 ,66.31 
03,017,01,005,0114,156,459,7,466,1006,0,0,0,0,0,0,0,66.31 ,46.32 ,66.31 
03,017,01,005,0115,157,1022,8,1030,2185,0,0,0,0,0,0,0,66.31 ,47.14 ,66.31 
03,017,01,005,0116,158,596,5,601,1152,0,0,0,0,0,0,0,66.31 ,52.17 ,66.31 
03,017,01,005,0117,159,673,5,678,1590,0,0,0,0,0,0,0,66.31 ,42.64 ,66.31 
03,017,01,005,0117,160,679,8,687,1495,0,0,0,0,0,0,0,66.31 ,45.95 ,66.31 
03,017,01,006,0118,161,644,12,656,1236,0,0,0,0,0,0,0,66.31 ,53.07 ,66.31 
03,017,01,006,0119,162,390,5,395,686,0,0,0,0,0,0,0,66.31 ,57.58 ,66.31 
03,017,01,006,0120,163,414,3,417,809,0,0,0,0,0,0,0,66.31 ,51.55 ,66.31 
03,017,01,006,0121,164,291,3,294,608,0,0,0,0,0,0,0,66.31 ,48.36 ,66.31 
03,017,01,006,0122,165,773,14,787,1683,0,0,0,0,0,0,0,66.31 ,46.76 ,66.31 
03,017,01,006,0122,166,794,5,799,1500,0,0,0,0,0,0,0,66.31 ,53.27 ,66.31 
03,017,01,006,0123,167,511,7,518,1079,0,0,0,0,0,0,0,66.31 ,48.01 ,66.31 
03,017,01,006,0123,168,467,2,469,953,0,0,0,0,0,0,0,66.31 ,49.21 ,66.31 
03,017,01,006,0124,169,450,6,456,813,0,0,0,0,0,0,0,66.31 ,56.09 ,66.31 
03,017,01,006,0124,170,600,3,603,1134,0,0,0,0,0,0,0,66.31 ,53.17 ,66.31 
03,017,01,006,0125,171,200,4,204,389,0,0,0,0,0,0,0,66.31 ,52.44 ,66.31 
03,017,01,006,0126,172,891,12,903,1839,0,0,0,0,0,0,0,66.31 ,49.10 ,66.31 
03,017,01,006,0126,173,721,7,728,1524,0,0,0,0,0,0,0,66.31 ,47.77 ,66.31 
03,017,01,006,0127,174,461,3,464,863,0,0,0,0,0,0,0,66.31 ,53.77 ,66.31 
03,017,01,006,0127,175,577,7,584,1234,0,0,0,0,0,0,0,66.31 ,47.33 ,66.31 
03,017,01,006,0128,176,553,7,560,830,0,0,0,0,0,0,0,66.31 ,67.47 ,66.31 
03,017,01,006,0128,177,578,4,582,1334,0,0,0,0,0,0,0,66.31 ,43.63 ,66.31 
03,017,01,006,0129,178,1076,16,1092,2667,0,0,0,0,0,0,0,66.31 ,40.94 ,66.31 
03,017,01,006,0130,179,937,16,953,1935,0,0,0,0,0,0,0,66.31 ,49.25 ,66.31 
03,017,01,006,0130,180,742,5,747,1342,0,0,0,0,0,0,0,66.31 ,55.66 ,66.31 
03,017,01,007,0131,181,804,10,814,1580,0,0,0,0,0,0,0,66.31 ,51.52 ,66.31 
03,017,01,007,0131,182,501,7,508,1157,0,0,0,0,0,0,0,66.31 ,43.91 ,66.31 
03,017,01,007,0131,183,523,8,531,1020,0,0,0,0,0,0,0,66.31 ,52.06 ,66.31 
03,017,01,007,0132,184,665,8,673,1141,0,0,0,0,0,0,0,66.31 ,58.98 ,66.31 
03,017,01,007,0132,185,429,5,434,776,0,0,0,0,0,0,0,66.31 ,55.93 ,66.31 
03,017,01,007,0133,186,693,8,701,1331,0,0,0,0,0,0,0,66.31 ,52.67 ,66.31 
03,017,01,007,0133,187,409,5,414,736,0,0,0,0,0,0,0,66.31 ,56.25 ,66.31 
03,017,01,007,0134,188,951,5,956,1772,0,0,0,0,0,0,0,66.31 ,53.95 ,66.31 
03,017,01,007,0134,189,1014,9,1023,1798,0,0,0,0,0,0,0,66.31 ,56.90 ,66.31 
03,017,01,007,0135,190,565,12,577,1022,0,0,0,0,0,0,0,66.31 ,56.46 ,66.31 
03,017,01,007,0135,191,599,1,600,1117,0,0,0,0,0,0,0,66.31 ,53.72 ,66.31 
03,017,01,007,0136,192,651,8,659,1245,0,0,0,0,0,0,0,66.31 ,52.93 ,66.31 
03,017,01,007,0136,193,439,4,443,796,0,0,0,0,0,0,0,66.31 ,55.65 ,66.31 
03,017,01,007,0137,194,139,1,140,282,0,0,0,0,0,0,0,66.31 ,49.65 ,66.31 
03,017,01,007,0137,195,682,2,684,1190,0,0,0,0,0,0,0,66.31 ,57.48 ,66.31 
03,017,01,007,0138,196,472,7,479,931,0,0,0,0,0,0,0,66.31 ,51.45 ,66.31 
03,017,01,007,0139,197,390,5,395,775,0,0,0,0,0,0,0,66.31 ,50.97 ,66.31 
03,017,01,007,0139,198,545,12,557,1294,0,0,0,0,0,0,0,66.31 ,43.04 ,66.31 
03,017,01,007,0139,199,493,7,500,873,0,0,0,0,0,0,0,66.31 ,57.27 ,66.31 
03,017,01,007,0140,200,614,8,622,1317,0,0,0,0,0,0,0,66.31 ,47.23 ,66.31 
03,017,01,007,0141,201,590,5,595,1238,0,0,0,0,0,0,0,66.31 ,48.06 ,66.31 
03,017,01,007,0141,202,665,12,677,1520,0,0,0,0,0,0,0,66.31 ,44.54 ,66.31 
03,017,01,007,0142,203,614,8,622,1283,0,0,0,0,0,0,0,66.31 ,48.48 ,66.31 
03,017,01,007,0142,204,694,9,703,1339,0,0,0,0,0,0,0,66.31 ,52.50 ,66.31 
03,017,01,007,0143,205,535,9,544,1140,0,0,0,0,0,0,0,66.31 ,47.72 ,66.31 
03,017,01,007,0143,206,698,9,707,1401,0,0,0,0,0,0,0,66.31 ,50.46 ,66.31 
03,017,01,007,0143,207,558,6,564,1292,0,0,0,0,0,0,0,66.31 ,43.65 ,66.31 
03,017,01,007,0144,208,580,8,588,1147,0,0,0,0,0,0,0,66.31 ,51.26 ,66.31 
03,017,01,007,0144,209,397,2,399,875,0,0,0,0,0,0,0,66.31 ,45.60 ,66.31 
03,017,01,007,0144,210,538,11,549,1117,0,0,0,0,0,0,0,66.31 ,49.15 ,66.31 
03,017,01,007,0145,211,214,1,215,436,0,0,0,0,0,0,0,66.31 ,49.31 ,66.31 
03,017,01,007,0146,212,151,2,153,330,0,0,0,0,0,0,0,66.31 ,46.36 ,66.31 
03,017,01,007,0147,213,193,6,199,378,0,0,0,0,0,0,0,66.31 ,52.65 ,66.31 
03,017,01,007,0148,214,416,3,419,895,0,0,0,0,0,0,0,66.31 ,46.82 ,66.31 
03,017,01,007,0149,215,241,1,242,448,0,0,0,0,0,0,0,66.31 ,54.02 ,66.31 
03,018,01,001,0001,1,322,6,328,667,0,0,0,0,0,0,0,66.31 ,49.18 ,66.31 
03,018,01,001,0002,2,485,4,489,943,0,0,0,0,0,0,0,66.31 ,51.86 ,66.31 
03,018,01,001,0002,3,434,13,447,915,0,0,0,0,0,0,0,66.31 ,48.85 ,66.31 
03,018,01,001,0003,4,419,13,432,838,0,0,0,0,0,0,0,66.31 ,51.55 ,66.31 
03,018,01,001,0004,5,401,11,412,806,0,0,0,0,0,0,0,66.31 ,51.12 ,66.31 
03,018,01,001,0005,6,252,10,262,514,0,0,0,0,0,0,0,66.31 ,50.97 ,66.31 
03,018,01,001,0006,7,280,4,284,592,0,0,0,0,0,0,0,66.31 ,47.97 ,66.31 
03,018,01,001,0007,8,589,11,600,1090,0,0,0,0,0,0,0,66.31 ,55.05 ,66.31 
03,018,01,001,0007,9,443,6,449,786,0,0,0,0,0,0,0,66.31 ,57.12 ,66.31 
03,018,01,001,0008,10,533,9,542,1022,0,0,0,0,0,0,0,66.31 ,53.03 ,66.31 
03,018,01,001,0008,11,506,6,512,898,0,0,0,0,0,0,0,66.31 ,57.02 ,66.31 
03,018,01,001,0008,12,565,13,578,1135,0,0,0,0,0,0,0,66.31 ,50.93 ,66.31 
03,018,01,001,0009,13,807,18,825,1637,0,0,0,0,0,0,0,66.31 ,50.40 ,66.31 
03,018,01,001,0009,14,866,17,883,1742,0,0,0,0,0,0,0,66.31 ,50.69 ,66.31 
03,018,01,001,0010,15,681,11,692,1464,0,0,0,0,0,0,0,66.31 ,47.27 ,66.31 
03,018,01,001,0010,16,692,16,708,1395,0,0,0,0,0,0,0,66.31 ,50.75 ,66.31 
03,018,01,001,0011,17,618,12,630,1178,0,0,0,0,0,0,0,66.31 ,53.48 ,66.31 
03,018,01,001,0011,18,890,20,910,1716,0,0,0,0,0,0,0,66.31 ,53.03 ,66.31 
03,018,01,001,0011,19,578,8,586,1162,0,0,0,0,0,0,0,66.31 ,50.43 ,66.31 
03,018,01,001,0012,20,410,6,416,842,0,0,0,0,0,0,0,66.31 ,49.41 ,66.31 
03,018,01,001,0012,21,709,16,725,1289,0,0,0,0,0,0,0,66.31 ,56.25 ,66.31 
03,018,01,001,0013,22,454,12,466,970,0,0,0,0,0,0,0,66.31 ,48.04 ,66.31 
03,018,01,001,0013,23,500,12,512,972,0,0,0,0,0,0,0,66.31 ,52.67 ,66.31 
03,018,01,001,0014,24,591,16,607,1173,0,0,0,0,0,0,0,66.31 ,51.75 ,66.31 
03,018,01,001,0014,25,434,10,444,902,0,0,0,0,0,0,0,66.31 ,49.22 ,66.31 
03,018,01,001,0015,26,424,17,441,905,0,0,0,0,0,0,0,66.31 ,48.73 ,66.31 
03,018,01,001,0015,27,516,7,523,989,0,0,0,0,0,0,0,66.31 ,52.88 ,66.31 
03,018,01,001,0015,28,505,7,512,978,0,0,0,0,0,0,0,66.31 ,52.35 ,66.31 
03,018,01,001,0016,29,664,16,680,1240,0,0,0,0,0,0,0,66.31 ,54.84 ,66.31 
03,018,01,001,0016,30,646,14,660,1308,0,0,0,0,0,0,0,66.31 ,50.46 ,66.31 
03,018,01,001,0016,31,749,10,759,1408,0,0,0,0,0,0,0,66.31 ,53.91 ,66.31 
03,018,01,001,0017,32,432,11,443,917,0,0,0,0,0,0,0,66.31 ,48.31 ,66.31 
03,018,01,001,0017,33,442,8,450,844,0,0,0,0,0,0,0,66.31 ,53.32 ,66.31 
03,018,01,001,0018,34,508,13,521,1030,0,0,0,0,0,0,0,66.31 ,50.58 ,66.31 
03,018,01,001,0019,35,691,13,704,1381,0,0,0,0,0,0,0,66.31 ,50.98 ,66.31 
03,018,01,001,0019,36,478,13,491,852,0,0,0,0,0,0,0,66.31 ,57.63 ,66.31 
03,018,01,001,0020,37,630,54,684,1414,0,0,0,0,0,0,0,66.31 ,48.37 ,66.31 
03,018,01,001,0020,38,715,28,743,1485,0,0,0,0,0,0,0,66.31 ,50.03 ,66.31 
03,018,01,001,0021,39,847,42,889,1497,0,0,0,0,0,0,0,66.31 ,59.39 ,66.31 
03,018,01,001,0022,40,835,26,861,1531,0,0,0,0,0,0,0,66.31 ,56.24 ,66.31 
03,018,01,001,0022,41,610,11,621,1159,0,0,0,0,0,0,0,66.31 ,53.58 ,66.31 
03,018,01,001,0023,42,445,10,455,737,0,0,0,0,0,0,0,66.31 ,61.74 ,66.31 
03,018,01,001,0024,43,213,2,215,409,0,0,0,0,0,0,0,66.31 ,52.57 ,66.31 
03,018,01,001,0025,44,840,15,855,1338,0,0,0,0,0,0,0,66.31 ,63.90 ,66.31 
03,018,01,001,0025,45,877,16,893,1585,0,0,0,0,0,0,0,66.31 ,56.34 ,66.31 
03,018,01,001,0026,46,477,11,488,757,0,0,0,0,0,0,0,66.31 ,64.46 ,66.31 
03,018,01,001,0027,47,797,20,817,1288,0,0,0,0,0,0,0,66.31 ,63.43 ,66.31 
03,018,01,001,0027,48,501,8,509,784,0,0,0,0,0,0,0,66.31 ,64.92 ,66.31 
03,018,01,001,0027,49,538,11,549,805,0,0,0,0,0,0,0,66.31 ,68.20 ,66.31 
03,018,01,001,0028,50,664,12,676,1253,0,0,0,0,0,0,0,66.31 ,53.95 ,66.31 
03,018,01,001,0028,51,281,3,284,513,0,0,0,0,0,0,0,66.31 ,55.36 ,66.31 
03,018,01,001,0028,52,599,4,603,1118,0,0,0,0,0,0,0,66.31 ,53.94 ,66.31 
03,018,01,001,0029,53,439,8,447,846,0,0,0,0,0,0,0,66.31 ,52.84 ,66.31 
03,018,01,001,0029,54,401,8,409,785,0,0,0,0,0,0,0,66.31 ,52.10 ,66.31 
03,018,01,001,0029,55,549,15,564,957,0,0,0,0,0,0,0,66.31 ,58.93 ,66.31 
03,018,01,001,0030,56,841,12,853,1540,0,0,0,0,0,0,0,66.31 ,55.39 ,66.31 
03,018,01,001,0030,57,852,17,869,1595,0,0,0,0,0,0,0,66.31 ,54.48 ,66.31 
03,018,01,001,0030,58,754,11,765,1326,0,0,0,0,0,0,0,66.31 ,57.69 ,66.31 
03,018,01,001,0031,59,493,21,514,1015,0,0,0,0,0,0,0,66.31 ,50.64 ,66.31 
03,018,01,001,0031,60,507,10,517,1050,0,0,0,0,0,0,0,66.31 ,49.24 ,66.31 
03,018,01,001,0032,61,654,13,667,1313,0,0,0,0,0,0,0,66.31 ,50.80 ,66.31 
03,018,01,001,0032,62,623,10,633,1272,0,0,0,0,0,0,0,66.31 ,49.76 ,66.31 
03,018,01,001,0032,63,556,7,563,1088,0,0,0,0,0,0,0,66.31 ,51.75 ,66.31 
03,018,01,001,0033,64,532,17,549,1065,0,0,0,0,0,0,0,66.31 ,51.55 ,66.31 
03,018,01,001,0033,65,616,20,636,1216,0,0,0,0,0,0,0,66.31 ,52.30 ,66.31 
03,018,01,001,0033,66,676,20,696,1304,0,0,0,0,0,0,0,66.31 ,53.37 ,66.31 
03,018,01,001,0034,67,383,7,390,780,0,0,0,0,0,0,0,66.31 ,50.00 ,66.31 
03,018,01,001,0034,68,434,11,445,697,0,0,0,0,0,0,0,66.31 ,63.85 ,66.31 
03,018,01,001,0034,69,471,9,480,798,0,0,0,0,0,0,0,66.31 ,60.15 ,66.31 
03,018,01,001,0035,70,603,12,615,1193,0,0,0,0,0,0,0,66.31 ,51.55 ,66.31 
03,018,01,001,0035,71,746,11,757,1423,0,0,0,0,0,0,0,66.31 ,53.20 ,66.31 
03,018,01,001,0036,72,371,7,378,709,0,0,0,0,0,0,0,66.31 ,53.31 ,66.31 
03,018,01,001,0037,73,296,8,304,632,0,0,0,0,0,0,0,66.31 ,48.10 ,66.31 
03,018,01,001,0038,74,370,9,379,684,0,0,0,0,0,0,0,66.31 ,55.41 ,66.31 
03,018,01,001,0039,75,481,21,502,914,0,0,0,0,0,0,0,66.31 ,54.92 ,66.31 
03,018,01,001,0040,76,651,16,667,1221,0,0,0,0,0,0,0,66.31 ,54.63 ,66.31 
03,018,01,001,0041,77,565,11,576,1204,0,0,0,0,0,0,0,66.31 ,47.84 ,66.31 
03,018,01,001,0041,78,689,12,701,1523,0,0,0,0,0,0,0,66.31 ,46.03 ,66.31 
03,018,01,001,0041,79,558,14,572,1362,0,0,0,0,0,0,0,66.31 ,42.00 ,66.31 
03,018,01,001,0042,80,503,13,516,930,0,0,0,0,0,0,0,66.31 ,55.48 ,66.31 
03,018,01,001,0042,81,535,16,551,1060,0,0,0,0,0,0,0,66.31 ,51.98 ,66.31 
03,018,01,001,0042,82,485,5,490,961,0,0,0,0,0,0,0,66.31 ,50.99 ,66.31 
03,018,01,001,0043,83,410,12,422,829,0,0,0,0,0,0,0,66.31 ,50.90 ,66.31 
03,018,01,001,0044,84,446,16,462,880,0,0,0,0,0,0,0,66.31 ,52.50 ,66.31 
03,018,01,001,0045,85,645,16,661,1199,0,0,0,0,0,0,0,66.31 ,55.13 ,66.31 
03,018,01,001,0046,86,469,10,479,1012,0,0,0,0,0,0,0,66.31 ,47.33 ,66.31 
03,018,01,001,0046,87,495,9,504,971,0,0,0,0,0,0,0,66.31 ,51.91 ,66.31 
03,018,01,001,0046,88,504,10,514,1055,0,0,0,0,0,0,0,66.31 ,48.72 ,66.31 
03,018,01,001,0047,89,307,10,317,725,0,0,0,0,0,0,0,66.31 ,43.72 ,66.31 
03,018,01,001,0047,90,446,11,457,892,0,0,0,0,0,0,0,66.31 ,51.23 ,66.31 
03,018,01,001,0048,91,330,8,338,582,0,0,0,0,0,0,0,66.31 ,58.08 ,66.31 
03,018,01,001,0048,92,697,31,728,1403,0,0,0,0,0,0,0,66.31 ,51.89 ,66.31 
03,018,01,001,0048,93,552,13,565,1090,0,0,0,0,0,0,0,66.31 ,51.83 ,66.31 
03,018,01,001,0049,94,620,19,639,1350,0,0,0,0,0,0,0,66.31 ,47.33 ,66.31 
03,018,01,001,0049,95,703,9,712,1376,0,0,0,0,0,0,0,66.31 ,51.74 ,66.31 
03,018,01,001,0050,96,740,20,760,1470,0,0,0,0,0,0,0,66.31 ,51.70 ,66.31 
03,018,01,001,0050,97,547,21,568,1155,0,0,0,0,0,0,0,66.31 ,49.18 ,66.31 
03,018,01,001,0050,98,653,16,669,1328,0,0,0,0,0,0,0,66.31 ,50.38 ,66.31 
03,018,01,001,0051,99,673,12,685,1301,0,0,0,0,0,0,0,66.31 ,52.65 ,66.31 
03,018,01,001,0051,100,535,15,550,1011,0,0,0,0,0,0,0,66.31 ,54.40 ,66.31 
03,018,01,001,0052,101,593,12,605,1224,0,0,0,0,0,0,0,66.31 ,49.43 ,66.31 
03,018,01,001,0052,102,577,9,586,1293,0,0,0,0,0,0,0,66.31 ,45.32 ,66.31 
03,018,01,001,0053,103,398,5,403,921,0,0,0,0,0,0,0,66.31 ,43.76 ,66.31 
03,018,01,001,0053,104,467,6,473,1104,0,0,0,0,0,0,0,66.31 ,42.84 ,66.31 
03,018,01,002,0054,105,267,9,276,541,0,0,0,0,0,0,0,66.31 ,51.02 ,66.31 
03,018,01,002,0055,106,385,10,395,778,0,0,0,0,0,0,0,66.31 ,50.77 ,66.31 
03,018,01,002,0056,107,295,7,302,567,0,0,0,0,0,0,0,66.31 ,53.26 ,66.31 
03,018,01,002,0057,108,271,5,276,552,0,0,0,0,0,0,0,66.31 ,50.00 ,66.31 
03,018,01,002,0058,109,447,13,460,835,0,0,0,0,0,0,0,66.31 ,55.09 ,66.31 
03,018,01,002,0059,110,612,24,636,1147,0,0,0,0,0,0,0,66.31 ,55.45 ,66.31 
03,018,01,002,0060,111,635,23,658,1287,0,0,0,0,0,0,0,66.31 ,51.13 ,66.31 
03,018,01,002,0061,112,441,14,455,840,0,0,0,0,0,0,0,66.31 ,54.17 ,66.31 
03,018,01,002,0061,113,590,11,601,1254,0,0,0,0,0,0,0,66.31 ,47.93 ,66.31 
03,018,01,002,0061,114,749,15,764,1487,0,0,0,0,0,0,0,66.31 ,51.38 ,66.31 
03,018,01,002,0062,115,477,5,482,1018,0,0,0,0,0,0,0,66.31 ,47.35 ,66.31 
03,018,01,002,0063,116,474,8,482,803,0,0,0,0,0,0,0,66.31 ,60.02 ,66.31 
03,018,01,002,0063,117,661,27,688,1334,0,0,0,0,0,0,0,66.31 ,51.57 ,66.31 
03,018,01,002,0063,118,702,23,725,1163,0,0,0,0,0,0,0,66.31 ,62.34 ,66.31 
03,018,01,002,0063,119,588,6,594,1271,0,0,0,0,0,0,0,66.31 ,46.73 ,66.31 
03,018,01,002,0064,120,575,20,595,1163,0,0,0,0,0,0,0,66.31 ,51.16 ,66.31 
03,018,01,002,0064,121,666,25,691,1230,0,0,0,0,0,0,0,66.31 ,56.18 ,66.31 
03,018,01,002,0065,122,529,18,547,905,0,0,0,0,0,0,0,66.31 ,60.44 ,66.31 
03,018,01,002,0065,123,569,17,586,991,0,0,0,0,0,0,0,66.31 ,59.13 ,66.31 
03,018,01,002,0065,124,546,16,562,1181,0,0,0,0,0,0,0,66.31 ,47.59 ,66.31 
03,018,01,002,0066,125,494,19,513,897,0,0,0,0,0,0,0,66.31 ,57.19 ,66.31 
03,018,01,002,0066,126,652,15,667,1264,0,0,0,0,0,0,0,66.31 ,52.77 ,66.31 
03,018,01,002,0066,127,477,20,497,923,0,0,0,0,0,0,0,66.31 ,53.85 ,66.31 
03,018,01,002,0067,128,541,12,553,811,0,0,0,0,0,0,0,66.31 ,68.19 ,66.31 
03,018,01,002,0067,129,472,13,485,699,0,0,0,0,0,0,0,66.31 ,69.38 ,66.31 
03,018,01,002,0068,130,452,10,462,816,0,0,0,0,0,0,0,66.31 ,56.62 ,66.31 
03,018,01,002,0069,131,333,14,347,658,0,0,0,0,0,0,0,66.31 ,52.74 ,66.31 
03,018,01,002,0070,132,279,11,290,618,0,0,0,0,0,0,0,66.31 ,46.93 ,66.31 
03,018,01,002,0071,133,693,17,710,1293,0,0,0,0,0,0,0,66.31 ,54.91 ,66.31 
03,018,01,002,0072,134,600,12,612,1125,0,0,0,0,0,0,0,66.31 ,54.40 ,66.31 
03,018,01,002,0073,135,482,12,494,946,0,0,0,0,0,0,0,66.31 ,52.22 ,66.31 
03,018,01,002,0074,136,565,21,586,1186,0,0,0,0,0,0,0,66.31 ,49.41 ,66.31 
03,018,01,002,0074,137,665,18,683,1360,0,0,0,0,0,0,0,66.31 ,50.22 ,66.31 
03,018,01,002,0074,138,595,15,610,1272,0,0,0,0,0,0,0,66.31 ,47.96 ,66.31 
03,018,01,002,0075,139,620,14,634,1171,0,0,0,0,0,0,0,66.31 ,54.14 ,66.31 
03,018,01,002,0075,140,537,13,550,1102,0,0,0,0,0,0,0,66.31 ,49.91 ,66.31 
03,018,01,002,0075,141,540,22,562,1073,0,0,0,0,0,0,0,66.31 ,52.38 ,66.31 
03,018,01,002,0076,142,727,14,741,1441,0,0,0,0,0,0,0,66.31 ,51.42 ,66.31 
03,018,01,002,0076,143,616,15,631,1224,0,0,0,0,0,0,0,66.31 ,51.55 ,66.31 
03,018,01,002,0076,144,426,17,443,839,0,0,0,0,0,0,0,66.31 ,52.80 ,66.31 
03,018,01,002,0077,145,747,17,764,1395,0,0,0,0,0,0,0,66.31 ,54.77 ,66.31 
03,018,01,002,0077,146,816,23,839,1553,0,0,0,0,0,0,0,66.31 ,54.02 ,66.31 
03,018,01,002,0078,147,608,10,618,1188,0,0,0,0,0,0,0,66.31 ,52.02 ,66.31 
03,018,01,002,0078,148,559,9,568,1140,0,0,0,0,0,0,0,66.31 ,49.82 ,66.31 
03,018,01,002,0079,149,477,15,492,978,0,0,0,0,0,0,0,66.31 ,50.31 ,66.31 
03,018,01,002,0079,150,575,12,587,1044,0,0,0,0,0,0,0,66.31 ,56.23 ,66.31 
03,018,01,002,0080,151,455,11,466,1141,0,0,0,0,0,0,0,66.31 ,40.84 ,66.31 
03,018,01,002,0080,152,616,12,628,1339,0,0,0,0,0,0,0,66.31 ,46.90 ,66.31 
03,018,01,002,0081,153,652,11,663,1533,0,0,0,0,0,0,0,66.31 ,43.25 ,66.31 
03,018,01,002,0081,154,827,13,840,1569,0,0,0,0,0,0,0,66.31 ,53.54 ,66.31 
03,018,01,002,0082,155,473,15,488,917,0,0,0,0,0,0,0,66.31 ,53.22 ,66.31 
03,018,01,002,0082,156,550,10,560,1157,0,0,0,0,0,0,0,66.31 ,48.40 ,66.31 
03,018,01,002,0083,157,601,20,621,1149,0,0,0,0,0,0,0,66.31 ,54.05 ,66.31 
03,018,01,002,0084,158,839,13,852,1633,0,0,0,0,0,0,0,66.31 ,52.17 ,66.31 
03,018,01,002,0085,159,640,18,658,1329,0,0,0,0,0,0,0,66.31 ,49.51 ,66.31 
03,018,01,002,0085,160,403,9,412,902,0,0,0,0,0,0,0,66.31 ,45.68 ,66.31 
03,018,01,002,0085,161,680,18,698,1326,0,0,0,0,0,0,0,66.31 ,52.64 ,66.31 
03,018,01,002,0086,162,804,17,821,1670,0,0,0,0,0,0,0,66.31 ,49.16 ,66.31 
03,018,01,002,0086,163,867,18,885,1735,0,0,0,0,0,0,0,66.31 ,51.01 ,66.31 
03,018,01,002,0087,164,741,14,755,1222,0,0,0,0,0,0,0,66.31 ,61.78 ,66.31 
03,018,01,002,0088,165,602,20,622,1105,0,0,0,0,0,0,0,66.31 ,56.29 ,66.31 
03,018,01,002,0088,166,747,17,764,1448,0,0,0,0,0,0,0,66.31 ,52.76 ,66.31 
03,018,01,002,0089,167,858,19,877,1812,0,0,0,0,0,0,0,66.31 ,48.40 ,66.31 
03,018,01,002,0089,168,717,16,733,1383,0,0,0,0,0,0,0,66.31 ,53.00 ,66.31 
03,018,01,002,0090,169,648,15,663,1200,0,0,0,0,0,0,0,66.31 ,55.25 ,66.31 
03,018,01,002,0090,170,522,6,528,831,0,0,0,0,0,0,0,66.31 ,63.54 ,66.31 
03,018,01,002,0090,171,529,12,541,903,0,0,0,0,0,0,0,66.31 ,59.91 ,66.31 
03,018,01,002,0091,172,394,11,405,816,0,0,0,0,0,0,0,66.31 ,49.63 ,66.31 
03,018,01,002,0092,173,573,14,587,1213,0,0,0,0,0,0,0,66.31 ,48.39 ,66.31 
03,018,01,002,0092,174,398,4,402,838,0,0,0,0,0,0,0,66.31 ,47.97 ,66.31 
03,018,01,002,0092,175,528,12,540,1250,0,0,0,0,0,0,0,66.31 ,43.20 ,66.31 
03,018,01,002,0093,176,724,31,755,1505,0,0,0,0,0,0,0,66.31 ,50.17 ,66.31 
03,018,01,002,0094,177,542,17,559,1100,0,0,0,0,0,0,0,66.31 ,50.82 ,66.31 
03,018,01,002,0095,178,611,20,631,1265,0,0,0,0,0,0,0,66.31 ,49.88 ,66.31 
03,018,01,002,0096,179,493,11,504,1058,0,0,0,0,0,0,0,66.31 ,47.64 ,66.31 
03,018,01,002,0097,180,261,4,265,491,0,0,0,0,0,0,0,66.31 ,53.97 ,66.31 
03,018,01,003,0098,181,718,21,739,1469,0,0,0,0,0,0,0,66.31 ,50.31 ,66.31 
03,018,01,003,0098,182,588,8,596,1132,0,0,0,0,0,0,0,66.31 ,52.65 ,66.31 
03,018,01,003,0099,183,362,12,374,776,0,0,0,0,0,0,0,66.31 ,48.20 ,66.31 
03,018,01,003,0099,184,656,20,676,1272,0,0,0,0,0,0,0,66.31 ,53.14 ,66.31 
03,018,01,003,0100,185,486,10,496,925,0,0,0,0,0,0,0,66.31 ,53.62 ,66.31 
03,018,01,003,0100,186,519,13,532,1066,0,0,0,0,0,0,0,66.31 ,49.91 ,66.31 
03,018,01,003,0101,187,473,7,480,972,0,0,0,0,0,0,0,66.31 ,49.38 ,66.31 
03,018,01,003,0101,188,396,9,405,832,0,0,0,0,0,0,0,66.31 ,48.68 ,66.31 
03,018,01,003,0102,189,536,13,549,1052,0,0,0,0,0,0,0,66.31 ,52.19 ,66.31 
03,018,01,003,0102,190,524,15,539,1074,0,0,0,0,0,0,0,66.31 ,50.19 ,66.31 
03,018,01,003,0103,191,403,7,410,776,0,0,0,0,0,0,0,66.31 ,52.84 ,66.31 
03,018,01,003,0103,192,429,12,441,859,0,0,0,0,0,0,0,66.31 ,51.34 ,66.31 
03,018,01,003,0104,193,670,18,688,1361,0,0,0,0,0,0,0,66.31 ,50.55 ,66.31 
03,018,01,003,0105,194,467,11,478,957,0,0,0,0,0,0,0,66.31 ,49.95 ,66.31 
03,018,01,003,0105,195,408,8,416,802,0,0,0,0,0,0,0,66.31 ,51.87 ,66.31 
03,018,01,003,0106,196,602,14,616,1250,0,0,0,0,0,0,0,66.31 ,49.28 ,66.31 
03,018,01,003,0106,197,480,21,501,1198,0,0,0,0,0,0,0,66.31 ,41.82 ,66.31 
03,018,01,003,0106,198,700,20,720,1583,0,0,0,0,0,0,0,66.31 ,45.48 ,66.31 
03,018,01,003,0107,199,433,14,447,847,0,0,0,0,0,0,0,66.31 ,52.77 ,66.31 
03,018,01,003,0107,200,356,6,362,753,0,0,0,0,0,0,0,66.31 ,48.07 ,66.31 
03,018,01,003,0108,201,274,7,281,618,0,0,0,0,0,0,0,66.31 ,45.47 ,66.31 
03,018,01,003,0108,202,457,9,466,890,0,0,0,0,0,0,0,66.31 ,52.36 ,66.31 
03,018,01,003,0109,203,370,14,384,745,0,0,0,0,0,0,0,66.31 ,51.54 ,66.31 
03,018,01,003,0109,204,439,4,443,909,0,0,0,0,0,0,0,66.31 ,48.73 ,66.31 
03,018,01,003,0110,205,667,16,683,1403,0,0,0,0,0,0,0,66.31 ,48.68 ,66.31 
03,018,01,003,0110,206,505,13,518,1079,0,0,0,0,0,0,0,66.31 ,48.01 ,66.31 
03,018,01,003,0111,207,446,11,457,860,0,0,0,0,0,0,0,66.31 ,53.14 ,66.31 
03,018,01,003,0111,208,434,8,442,904,0,0,0,0,0,0,0,66.31 ,48.89 ,66.31 
03,018,01,003,0112,209,435,9,444,933,0,0,0,0,0,0,0,66.31 ,47.59 ,66.31 
03,018,01,003,0113,210,752,61,813,1592,0,0,0,0,0,0,0,66.31 ,51.07 ,66.31 
03,018,01,003,0114,211,542,16,558,939,0,0,0,0,0,0,0,66.31 ,59.42 ,66.31 
03,018,01,003,0114,212,306,15,321,654,0,0,0,0,0,0,0,66.31 ,49.08 ,66.31 
03,018,01,003,0115,213,506,18,524,1034,0,0,0,0,0,0,0,66.31 ,50.68 ,66.31 
03,018,01,003,0116,214,593,15,608,1369,0,0,0,0,0,0,0,66.31 ,44.41 ,66.31 
03,018,01,003,0116,215,660,21,681,1467,0,0,0,0,0,0,0,66.31 ,46.42 ,66.31 
03,018,01,003,0117,216,405,7,412,735,0,0,0,0,0,0,0,66.31 ,56.05 ,66.31 
03,018,01,003,0118,217,588,20,608,1143,0,0,0,0,0,0,0,66.31 ,53.19 ,66.31 
03,018,01,003,0119,218,358,7,365,594,0,0,0,0,0,0,0,66.31 ,61.45 ,66.31 
03,018,01,003,0120,219,353,3,356,667,0,0,0,0,0,0,0,66.31 ,53.37 ,66.31 
03,018,01,003,0121,220,402,8,410,682,0,0,0,0,0,0,0,66.31 ,60.12 ,66.31 
03,019,01,001,0001,1,575,7,582,996,0,0,0,0,0,0,0,66.31 ,58.43 ,66.31 
03,019,01,001,0002,2,647,5,652,1031,0,0,0,0,0,0,0,66.31 ,63.24 ,66.31 
03,019,01,001,0003,3,675,5,680,1162,0,0,0,0,0,0,0,66.31 ,58.52 ,66.31 
03,019,01,001,0004,4,745,5,750,1391,0,0,0,0,0,0,0,66.31 ,53.92 ,66.31 
03,019,01,001,0005,5,566,6,572,908,0,0,0,0,0,0,0,66.31 ,63.00 ,66.31 
03,019,01,001,0006,6,787,9,796,1269,0,0,0,0,0,0,0,66.31 ,62.73 ,66.31 
03,019,01,001,0007,7,699,9,708,1142,0,0,0,0,0,0,0,66.31 ,62.00 ,66.31 
03,019,01,001,0008,8,830,11,841,1413,0,0,0,0,0,0,0,66.31 ,59.52 ,66.31 
03,019,01,001,0009,9,734,9,743,1208,0,0,0,0,0,0,0,66.31 ,61.51 ,66.31 
03,019,01,001,0010,10,691,11,702,1100,0,0,0,0,0,0,0,66.31 ,63.82 ,66.31 
03,019,01,001,0011,11,658,5,663,1099,0,0,0,0,0,0,0,66.31 ,60.33 ,66.31 
03,019,01,001,0012,12,811,9,820,1307,0,0,0,0,0,0,0,66.31 ,62.74 ,66.31 
03,019,01,001,0013,13,834,6,840,1298,0,0,0,0,0,0,0,66.31 ,64.71 ,66.31 
03,019,01,001,0014,14,774,6,780,1239,0,0,0,0,0,0,0,66.31 ,62.95 ,66.31 
03,019,01,002,0015,15,661,9,670,1051,0,0,0,0,0,0,0,66.31 ,63.75 ,66.31 
03,019,01,002,0016,16,392,10,402,629,0,0,0,0,0,0,0,66.31 ,63.91 ,66.31 
03,019,01,002,0017,17,516,4,520,874,0,0,0,0,0,0,0,66.31 ,59.50 ,66.31 
03,019,01,002,0018,18,623,7,630,957,0,0,0,0,0,0,0,66.31 ,65.83 ,66.31 
03,019,01,002,0019,19,746,5,751,1233,0,0,0,0,0,0,0,66.31 ,60.91 ,66.31 
03,019,01,002,0020,20,722,8,730,1099,0,0,0,0,0,0,0,66.31 ,66.42 ,66.31 
03,019,01,002,0021,21,874,11,885,1297,0,0,0,0,0,0,0,66.31 ,68.23 ,66.31 
03,019,01,002,0022,22,678,4,682,1039,0,0,0,0,0,0,0,66.31 ,65.64 ,66.31 
03,019,01,002,0023,23,795,9,804,1187,0,0,0,0,0,0,0,66.31 ,67.73 ,66.31 
03,019,01,002,0023,24,765,14,779,1267,0,0,0,0,0,0,0,66.31 ,61.48 ,66.31 
03,019,01,002,0023,25,766,8,774,1234,0,0,0,0,0,0,0,66.31 ,62.72 ,66.31 
03,019,01,002,0024,26,636,3,639,915,0,0,0,0,0,0,0,66.31 ,69.84 ,66.31 
03,019,01,002,0024,27,685,6,691,1005,0,0,0,0,0,0,0,66.31 ,68.76 ,66.31 
03,019,01,002,0025,28,559,8,567,843,0,0,0,0,0,0,0,66.31 ,67.26 ,66.31 
03,019,01,002,0026,29,575,5,580,824,0,0,0,0,0,0,0,66.31 ,70.39 ,66.31 
03,019,01,002,0027,30,709,9,718,1162,0,0,0,0,0,0,0,66.31 ,61.79 ,66.31 
03,019,01,002,0028,31,487,3,490,781,0,0,0,0,0,0,0,66.31 ,62.74 ,66.31 
03,019,01,002,0029,32,687,8,695,999,0,0,0,0,0,0,0,66.31 ,69.57 ,66.31 
03,019,01,002,0030,33,984,16,1000,1371,0,0,0,0,0,0,0,66.31 ,72.94 ,66.31 
03,019,01,002,0031,34,920,12,932,1395,0,0,0,0,0,0,0,66.31 ,66.81 ,66.31 
03,019,01,002,0032,35,710,10,720,1211,0,0,0,0,0,0,0,66.31 ,59.45 ,66.31 
03,019,01,002,0032,36,1151,18,1169,1690,0,0,0,0,0,0,0,66.31 ,69.17 ,66.31 
03,019,01,002,0032,37,1043,10,1053,1623,0,0,0,0,0,0,0,66.31 ,64.88 ,66.31 
03,019,01,002,0033,38,959,12,971,1611,0,0,0,0,0,0,0,66.31 ,60.27 ,66.31 
03,019,01,002,0033,39,972,18,990,1519,0,0,0,0,0,0,0,66.31 ,65.17 ,66.31 
03,019,01,002,0033,40,867,19,886,1543,0,0,0,0,0,0,0,66.31 ,57.42 ,66.31 
03,019,01,002,0034,41,745,9,754,1247,0,0,0,0,0,0,0,66.31 ,60.47 ,66.31 
03,019,01,002,0034,42,696,10,706,1119,0,0,0,0,0,0,0,66.31 ,63.09 ,66.31 
03,019,01,002,0034,43,527,6,533,805,0,0,0,0,0,0,0,66.31 ,66.21 ,66.31 
03,019,01,002,0035,44,491,9,500,813,0,0,0,0,0,0,0,66.31 ,61.50 ,66.31 
03,019,01,002,0035,45,465,7,472,796,0,0,0,0,0,0,0,66.31 ,59.30 ,66.31 
03,019,01,002,0036,46,545,8,553,855,0,0,0,0,0,0,0,66.31 ,64.68 ,66.31 
03,019,01,002,0036,47,492,5,497,854,0,0,0,0,0,0,0,66.31 ,58.20 ,66.31 
03,019,01,002,0037,48,908,10,918,1449,0,0,0,0,0,0,0,66.31 ,63.35 ,66.31 
03,019,01,002,0038,49,489,13,502,834,0,0,0,0,0,0,0,66.31 ,60.19 ,66.31 
03,019,01,002,0039,50,911,8,919,1398,0,0,0,0,0,0,0,66.31 ,65.74 ,66.31 
03,019,01,002,0040,51,526,6,532,799,0,0,0,0,0,0,0,66.31 ,66.58 ,66.31 
03,019,01,002,0040,52,481,7,488,743,0,0,0,0,0,0,0,66.31 ,65.68 ,66.31 
03,019,01,002,0041,53,746,12,758,1295,0,0,0,0,0,0,0,66.31 ,58.53 ,66.31 
03,019,01,002,0042,54,1007,11,1018,1572,0,0,0,0,0,0,0,66.31 ,64.76 ,66.31 
03,019,01,002,0042,55,857,10,867,1392,0,0,0,0,0,0,0,66.31 ,62.28 ,66.31 
03,019,01,002,0042,56,934,3,937,1437,0,0,0,0,0,0,0,66.31 ,65.21 ,66.31 
03,019,01,003,0043,57,446,1,447,714,0,0,0,0,0,0,0,66.31 ,62.61 ,66.31 
03,019,01,003,0044,58,387,1,388,714,0,0,0,0,0,0,0,66.31 ,54.34 ,66.31 
03,019,01,003,0045,59,553,7,560,872,0,0,0,0,0,0,0,66.31 ,64.22 ,66.31 
03,019,01,003,0046,60,1115,7,1122,1655,0,0,0,0,0,0,0,66.31 ,67.79 ,66.31 
03,019,01,003,0047,61,639,13,652,1030,0,0,0,0,0,0,0,66.31 ,63.30 ,66.31 
03,019,01,003,0048,62,666,15,681,1051,0,0,0,0,0,0,0,66.31 ,64.80 ,66.31 
03,019,01,003,0049,63,878,8,886,1404,0,0,0,0,0,0,0,66.31 ,63.11 ,66.31 
03,019,01,003,0050,64,661,7,668,1036,0,0,0,0,0,0,0,66.31 ,64.48 ,66.31 
03,019,01,003,0051,65,968,8,976,1630,0,0,0,0,0,0,0,66.31 ,59.88 ,66.31 
03,019,01,003,0051,66,1026,20,1046,1654,0,0,0,0,0,0,0,66.31 ,63.24 ,66.31 
03,019,01,003,0052,67,967,15,982,1693,0,0,0,0,0,0,0,66.31 ,58.00 ,66.31 
03,019,01,003,0052,68,902,12,914,1500,0,0,0,0,0,0,0,66.31 ,60.93 ,66.31 
03,019,01,003,0053,69,636,2,638,1046,0,0,0,0,0,0,0,66.31 ,60.99 ,66.31 
03,019,01,003,0053,70,755,9,764,1211,0,0,0,0,0,0,0,66.31 ,63.09 ,66.31 
03,019,01,003,0054,71,741,7,748,1188,0,0,0,0,0,0,0,66.31 ,62.96 ,66.31 
03,019,01,003,0054,72,900,13,913,1489,0,0,0,0,0,0,0,66.31 ,61.32 ,66.31 
03,019,01,003,0055,73,1091,9,1100,1740,0,0,0,0,0,0,0,66.31 ,63.22 ,66.31 
03,019,01,003,0056,74,1104,20,1124,1976,0,0,0,0,0,0,0,66.31 ,56.88 ,66.31 
03,019,01,003,0057,75,809,9,818,1291,0,0,0,0,0,0,0,66.31 ,63.36 ,66.31 
03,019,01,003,0057,76,800,8,808,1262,0,0,0,0,0,0,0,66.31 ,64.03 ,66.31 
03,019,01,003,0058,77,946,11,957,1666,0,0,0,0,0,0,0,66.31 ,57.44 ,66.31 
03,019,01,003,0058,78,892,12,904,1528,0,0,0,0,0,0,0,66.31 ,59.16 ,66.31 
03,019,01,003,0058,79,941,10,951,1560,0,0,0,0,0,0,0,66.31 ,60.96 ,66.31 
03,019,01,003,0058,80,956,16,972,1633,0,0,0,0,0,0,0,66.31 ,59.52 ,66.31 
03,019,01,003,0059,81,825,8,833,1490,0,0,0,0,0,0,0,66.31 ,55.91 ,66.31 
03,019,01,003,0059,82,958,7,965,2056,0,0,0,0,0,0,0,66.31 ,46.94 ,66.31 
03,019,01,003,0059,83,802,9,811,1277,0,0,0,0,0,0,0,66.31 ,63.51 ,66.31 
03,019,01,003,0059,84,806,6,812,1318,0,0,0,0,0,0,0,66.31 ,61.61 ,66.31 
03,019,01,003,0059,85,823,8,831,1433,0,0,0,0,0,0,0,66.31 ,57.99 ,66.31 
03,019,01,003,0060,86,767,5,772,1370,0,0,0,0,0,0,0,66.31 ,56.35 ,66.31 
03,019,01,003,0060,87,880,12,892,1514,0,0,0,0,0,0,0,66.31 ,58.92 ,66.31 
03,019,01,003,0060,88,889,3,892,1470,0,0,0,0,0,0,0,66.31 ,60.68 ,66.31 
03,019,01,003,0060,89,820,7,827,1530,0,0,0,0,0,0,0,66.31 ,54.05 ,66.31 
03,019,01,003,0061,90,940,6,946,1534,0,0,0,0,0,0,0,66.31 ,61.67 ,66.31 
03,019,01,003,0061,91,958,12,970,1659,0,0,0,0,0,0,0,66.31 ,58.47 ,66.31 
03,019,01,003,0061,92,829,5,834,1724,0,0,0,0,0,0,0,66.31 ,48.38 ,66.31 
03,019,01,003,0061,93,917,13,930,1544,0,0,0,0,0,0,0,66.31 ,60.23 ,66.31 
03,019,01,003,0062,94,786,15,801,1362,0,0,0,0,0,0,0,66.31 ,58.81 ,66.31 
03,019,01,003,0062,95,682,8,690,1081,0,0,0,0,0,0,0,66.31 ,63.83 ,66.31 
03,019,01,003,0063,96,905,21,926,1334,0,0,0,0,0,0,0,66.31 ,69.42 ,66.31 
03,019,01,003,0063,97,828,6,834,1457,0,0,0,0,0,0,0,66.31 ,57.24 ,66.31 
03,019,01,003,0063,98,799,6,805,1234,0,0,0,0,0,0,0,66.31 ,65.24 ,66.31 
03,019,01,003,0063,99,791,12,803,1237,0,0,0,0,0,0,0,66.31 ,64.92 ,66.31 
03,019,01,004,0064,100,870,9,879,1403,0,0,0,0,0,0,0,66.31 ,62.65 ,66.31 
03,019,01,004,0065,101,533,8,541,931,0,0,0,0,0,0,0,66.31 ,58.11 ,66.31 
03,019,01,004,0066,102,509,5,514,901,0,0,0,0,0,0,0,66.31 ,57.05 ,66.31 
03,019,01,004,0066,103,545,7,552,1192,0,0,0,0,0,0,0,66.31 ,46.31 ,66.31 
03,019,01,004,0067,104,888,15,903,1532,0,0,0,0,0,0,0,66.31 ,58.94 ,66.31 
03,019,01,004,0068,105,801,6,807,1306,0,0,0,0,0,0,0,66.31 ,61.79 ,66.31 
03,019,01,004,0068,106,703,6,709,1178,0,0,0,0,0,0,0,66.31 ,60.19 ,66.31 
03,019,01,004,0068,107,793,9,802,1300,0,0,0,0,0,0,0,66.31 ,61.69 ,66.31 
03,019,01,004,0069,108,1115,12,1127,1751,0,0,0,0,0,0,0,66.31 ,64.36 ,66.31 
03,019,01,004,0070,109,614,4,618,974,0,0,0,0,0,0,0,66.31 ,63.45 ,66.31 
03,019,01,004,0070,110,855,14,869,1320,0,0,0,0,0,0,0,66.31 ,65.83 ,66.31 
03,019,01,004,0071,111,814,12,826,1235,0,0,0,0,0,0,0,66.31 ,66.88 ,66.31 
03,019,01,004,0071,112,929,11,940,1345,0,0,0,0,0,0,0,66.31 ,69.89 ,66.31 
03,019,01,004,0071,113,986,19,1005,1623,0,0,0,0,0,0,0,66.31 ,61.92 ,66.31 
03,019,01,004,0072,114,526,6,532,794,0,0,0,0,0,0,0,66.31 ,67.00 ,66.31 
03,019,01,004,0073,115,901,11,912,1531,0,0,0,0,0,0,0,66.31 ,59.57 ,66.31 
03,019,01,004,0074,116,730,8,738,1256,0,0,0,0,0,0,0,66.31 ,58.76 ,66.31 
03,019,01,004,0075,117,641,5,646,1049,0,0,0,0,0,0,0,66.31 ,61.58 ,66.31 
03,019,01,004,0076,118,902,11,913,1529,0,0,0,0,0,0,0,66.31 ,59.71 ,66.31 
03,019,01,004,0077,119,774,12,786,1272,0,0,0,0,0,0,0,66.31 ,61.79 ,66.31 
03,019,01,004,0078,120,652,7,659,1128,0,0,0,0,0,0,0,66.31 ,58.42 ,66.31 
03,019,01,004,0078,121,451,5,456,757,0,0,0,0,0,0,0,66.31 ,60.24 ,66.31 
03,019,01,004,0079,122,757,12,769,1260,0,0,0,0,0,0,0,66.31 ,61.03 ,66.31 
03,019,01,004,0080,123,543,2,545,914,0,0,0,0,0,0,0,66.31 ,59.63 ,66.31 
03,019,01,004,0080,124,528,9,537,875,0,0,0,0,0,0,0,66.31 ,61.37 ,66.31 
03,019,01,004,0081,125,559,8,567,983,0,0,0,0,0,0,0,66.31 ,57.68 ,66.31 
03,019,01,004,0081,126,567,6,573,958,0,0,0,0,0,0,0,66.31 ,59.81 ,66.31 
03,019,01,004,0082,127,624,7,631,930,0,0,0,0,0,0,0,66.31 ,67.85 ,66.31 
03,019,01,004,0083,128,646,10,656,1123,0,0,0,0,0,0,0,66.31 ,58.41 ,66.31 
03,019,01,004,0083,129,550,9,559,959,0,0,0,0,0,0,0,66.31 ,58.29 ,66.31 
03,019,01,004,0084,130,553,3,556,857,0,0,0,0,0,0,0,66.31 ,64.88 ,66.31 
03,019,01,004,0084,131,617,6,623,1065,0,0,0,0,0,0,0,66.31 ,58.50 ,66.31 
03,019,01,004,0084,132,817,11,828,1329,0,0,0,0,0,0,0,66.31 ,62.30 ,66.31 
03,019,01,004,0084,133,913,7,920,1525,0,0,0,0,0,0,0,66.31 ,60.33 ,66.31 
03,019,01,004,0085,134,762,10,772,1236,0,0,0,0,0,0,0,66.31 ,62.46 ,66.31 
03,019,01,004,0085,135,647,10,657,1108,0,0,0,0,0,0,0,66.31 ,59.30 ,66.31 
03,019,01,004,0085,136,643,7,650,1189,0,0,0,0,0,0,0,66.31 ,54.67 ,66.31 
03,019,01,004,0086,137,718,8,726,1272,0,0,0,0,0,0,0,66.31 ,57.08 ,66.31 
03,019,01,004,0086,138,732,6,738,1298,0,0,0,0,0,0,0,66.31 ,56.86 ,66.31 
03,019,01,004,0086,139,809,7,816,1388,0,0,0,0,0,0,0,66.31 ,58.79 ,66.31 
03,019,01,004,0087,140,659,12,671,1223,0,0,0,0,0,0,0,66.31 ,54.87 ,66.31 
03,019,01,004,0087,141,694,7,701,1221,0,0,0,0,0,0,0,66.31 ,57.41 ,66.31 
03,019,01,004,0087,142,583,8,591,1044,0,0,0,0,0,0,0,66.31 ,56.61 ,66.31 
03,019,01,004,0087,143,714,5,719,1146,0,0,0,0,0,0,0,66.31 ,62.74 ,66.31 
03,019,01,004,0088,144,936,12,948,1575,0,0,0,0,0,0,0,66.31 ,60.19 ,66.31 
03,019,01,004,0088,145,583,8,591,967,0,0,0,0,0,0,0,66.31 ,61.12 ,66.31 
03,019,01,004,0088,146,574,8,582,1054,0,0,0,0,0,0,0,66.31 ,55.22 ,66.31 
03,019,01,004,0088,147,524,2,526,888,0,0,0,0,0,0,0,66.31 ,59.23 ,66.31 
03,019,01,004,0088,148,618,6,624,1176,0,0,0,0,0,0,0,66.31 ,53.06 ,66.31 
03,019,01,004,0088,149,654,6,660,1136,0,0,0,0,0,0,0,66.31 ,58.10 ,66.31 
03,019,01,004,0088,150,781,9,790,1271,0,0,0,0,0,0,0,66.31 ,62.16 ,66.31 
03,019,01,004,0088,151,565,7,572,1051,0,0,0,0,0,0,0,66.31 ,54.42 ,66.31 
03,019,01,004,0089,152,756,20,776,1212,0,0,0,0,0,0,0,66.31 ,64.03 ,66.31 
03,019,01,004,0089,153,769,9,778,1174,0,0,0,0,0,0,0,66.31 ,66.27 ,66.31 
03,019,01,004,0090,154,820,16,836,1335,0,0,0,0,0,0,0,66.31 ,62.62 ,66.31 
03,019,01,004,0090,155,984,8,992,1594,0,0,0,0,0,0,0,66.31 ,62.23 ,66.31 
03,019,01,004,0091,156,913,8,921,1474,0,0,0,0,0,0,0,66.31 ,62.48 ,66.31 
03,019,01,004,0091,157,887,7,894,1481,0,0,0,0,0,0,0,66.31 ,60.36 ,66.31 
03,019,01,004,0091,158,842,7,849,1523,0,0,0,0,0,0,0,66.31 ,55.75 ,66.31 
03,019,01,004,0091,159,590,9,599,1036,0,0,0,0,0,0,0,66.31 ,57.82 ,66.31 
03,019,01,004,0091,160,634,7,641,1016,0,0,0,0,0,0,0,66.31 ,63.09 ,66.31 
03,019,01,005,0092,161,564,6,570,868,0,0,0,0,0,0,0,66.31 ,65.67 ,66.31 
03,019,01,005,0093,162,669,6,675,1056,0,0,0,0,0,0,0,66.31 ,63.92 ,66.31 
03,019,01,005,0094,163,562,10,572,956,0,0,0,0,0,0,0,66.31 ,59.83 ,66.31 
03,019,01,005,0095,164,671,13,684,1132,0,0,0,0,0,0,0,66.31 ,60.42 ,66.31 
03,019,01,005,0096,165,582,25,607,948,0,0,0,0,0,0,0,66.31 ,64.03 ,66.31 
03,019,01,005,0096,166,542,6,548,915,0,0,0,0,0,0,0,66.31 ,59.89 ,66.31 
03,019,01,005,0097,167,637,11,648,976,0,0,0,0,0,0,0,66.31 ,66.39 ,66.31 
03,019,01,005,0097,168,558,0,558,983,0,0,0,0,0,0,0,66.31 ,56.77 ,66.31 
03,019,01,005,0098,169,617,3,620,1014,0,0,0,0,0,0,0,66.31 ,61.14 ,66.31 
03,019,01,005,0099,170,1018,15,1033,1615,0,0,0,0,0,0,0,66.31 ,63.96 ,66.31 
03,019,01,005,0100,171,644,2,646,1001,0,0,0,0,0,0,0,66.31 ,64.54 ,66.31 
03,019,01,005,0101,172,557,6,563,904,0,0,0,0,0,0,0,66.31 ,62.28 ,66.31 
03,019,01,005,0101,173,415,1,416,734,0,0,0,0,0,0,0,66.31 ,56.68 ,66.31 
03,019,01,005,0102,174,509,8,517,747,0,0,0,0,0,0,0,66.31 ,69.21 ,66.31 
03,019,01,005,0103,175,734,8,742,1209,0,0,0,0,0,0,0,66.31 ,61.37 ,66.31 
03,019,01,005,0104,176,493,5,498,867,0,0,0,0,0,0,0,66.31 ,57.44 ,66.31 
03,019,01,005,0105,177,842,17,859,1400,0,0,0,0,0,0,0,66.31 ,61.36 ,66.31 
03,019,01,005,0105,178,519,3,522,990,0,0,0,0,0,0,0,66.31 ,52.73 ,66.31 
03,019,01,005,0106,179,689,8,697,1064,0,0,0,0,0,0,0,66.31 ,65.51 ,66.31 
03,019,01,005,0106,180,812,8,820,1244,0,0,0,0,0,0,0,66.31 ,65.92 ,66.31 
03,019,01,005,0106,181,460,3,463,827,0,0,0,0,0,0,0,66.31 ,55.99 ,66.31 
03,019,01,005,0107,182,569,4,573,878,0,0,0,0,0,0,0,66.31 ,65.26 ,66.31 
03,019,01,005,0107,183,580,10,590,932,0,0,0,0,0,0,0,66.31 ,63.30 ,66.31 
03,019,01,005,0107,184,726,6,732,1109,0,0,0,0,0,0,0,66.31 ,66.01 ,66.31 
03,019,01,005,0108,185,646,10,656,1041,0,0,0,0,0,0,0,66.31 ,63.02 ,66.31 
03,019,01,005,0108,186,710,9,719,1102,0,0,0,0,0,0,0,66.31 ,65.25 ,66.31 
03,019,01,005,0108,187,700,8,708,1078,0,0,0,0,0,0,0,66.31 ,65.68 ,66.31 
03,019,01,005,0108,188,616,7,623,1199,0,0,0,0,0,0,0,66.31 ,51.96 ,66.31 
03,019,01,005,0108,189,608,12,620,1134,0,0,0,0,0,0,0,66.31 ,54.67 ,66.31 
03,019,01,005,0108,190,725,12,737,1171,0,0,0,0,0,0,0,66.31 ,62.94 ,66.31 
03,019,01,005,0109,191,836,9,845,1325,0,0,0,0,0,0,0,66.31 ,63.77 ,66.31 
03,019,01,005,0109,192,960,14,974,1572,0,0,0,0,0,0,0,66.31 ,61.96 ,66.31 
03,019,01,005,0110,193,736,7,743,1378,0,0,0,0,0,0,0,66.31 ,53.92 ,66.31 
03,019,01,005,0110,194,813,13,826,1485,0,0,0,0,0,0,0,66.31 ,55.62 ,66.31 
03,019,01,005,0111,195,843,11,854,1517,0,0,0,0,0,0,0,66.31 ,56.30 ,66.31 
03,019,01,005,0112,196,819,8,827,1354,0,0,0,0,0,0,0,66.31 ,61.08 ,66.31 
03,019,01,005,0112,197,790,9,799,1389,0,0,0,0,0,0,0,66.31 ,57.52 ,66.31 
03,019,01,005,0112,198,816,14,830,1336,0,0,0,0,0,0,0,66.31 ,62.13 ,66.31 
03,019,01,005,0113,199,669,9,678,1177,0,0,0,0,0,0,0,66.31 ,57.60 ,66.31 
03,019,01,005,0113,200,469,3,472,952,0,0,0,0,0,0,0,66.31 ,49.58 ,66.31 
03,019,01,005,0114,201,894,8,902,1565,0,0,0,0,0,0,0,66.31 ,57.64 ,66.31 
03,019,01,005,0114,202,909,11,920,1576,0,0,0,0,0,0,0,66.31 ,58.38 ,66.31 
03,019,01,005,0114,203,832,6,838,1513,0,0,0,0,0,0,0,66.31 ,55.39 ,66.31 
03,019,01,005,0115,204,719,17,736,1177,0,0,0,0,0,0,0,66.31 ,62.53 ,66.31 
03,019,01,005,0115,205,793,5,798,1348,0,0,0,0,0,0,0,66.31 ,59.20 ,66.31 
03,019,01,005,0115,206,827,8,835,1396,0,0,0,0,0,0,0,66.31 ,59.81 ,66.31 
03,019,01,005,0115,207,908,7,915,1501,0,0,0,0,0,0,0,66.31 ,60.96 ,66.31 
03,019,01,005,0116,208,821,13,834,1356,0,0,0,0,0,0,0,66.31 ,61.50 ,66.31 
03,019,01,005,0116,209,619,5,624,1018,0,0,0,0,0,0,0,66.31 ,61.30 ,66.31 
03,019,01,005,0116,210,803,9,812,1372,0,0,0,0,0,0,0,66.31 ,59.18 ,66.31 
03,019,01,005,0117,211,678,11,689,1257,0,0,0,0,0,0,0,66.31 ,54.81 ,66.31 
03,019,01,005,0117,212,812,4,816,1405,0,0,0,0,0,0,0,66.31 ,58.08 ,66.31 
03,019,01,005,0117,213,766,9,775,1406,0,0,0,0,0,0,0,66.31 ,55.12 ,66.31 
03,019,01,005,0118,214,715,9,724,1396,0,0,0,0,0,0,0,66.31 ,51.86 ,66.31 
03,019,01,005,0118,215,755,6,761,1322,0,0,0,0,0,0,0,66.31 ,57.56 ,66.31 
03,019,01,005,0118,216,671,8,679,1211,0,0,0,0,0,0,0,66.31 ,56.07 ,66.31 
03,019,01,005,0118,217,714,8,722,1219,0,0,0,0,0,0,0,66.31 ,59.23 ,66.31 
03,019,01,005,0119,218,736,16,752,1200,0,0,0,0,0,0,0,66.31 ,62.67 ,66.31 
03,019,01,005,0119,219,697,11,708,1199,0,0,0,0,0,0,0,66.31 ,59.05 ,66.31 
03,019,01,005,0119,220,746,8,754,1211,0,0,0,0,0,0,0,66.31 ,62.26 ,66.31 
03,019,01,005,0120,221,800,8,808,1433,0,0,0,0,0,0,0,66.31 ,56.39 ,66.31 
03,019,01,005,0120,222,859,2,861,1427,0,0,0,0,0,0,0,66.31 ,60.34 ,66.31 
03,019,01,005,0121,223,796,6,802,1229,0,0,0,0,0,0,0,66.31 ,65.26 ,66.31 
03,019,01,005,0121,224,763,10,773,1200,0,0,0,0,0,0,0,66.31 ,64.42 ,66.31 
03,019,01,005,0121,225,732,5,737,1124,0,0,0,0,0,0,0,66.31 ,65.57 ,66.31 
03,019,01,005,0122,226,689,10,699,1080,0,0,0,0,0,0,0,66.31 ,64.72 ,66.31 
03,019,01,005,0122,227,794,12,806,1268,0,0,0,0,0,0,0,66.31 ,63.56 ,66.31 
03,019,01,005,0122,228,805,7,812,1371,0,0,0,0,0,0,0,66.31 ,59.23 ,66.31 
03,019,01,005,0122,229,696,10,706,1221,0,0,0,0,0,0,0,66.31 ,57.82 ,66.31 
03,019,01,005,0123,230,556,5,561,957,0,0,0,0,0,0,0,66.31 ,58.62 ,66.31 
03,019,01,005,0123,231,840,10,850,1426,0,0,0,0,0,0,0,66.31 ,59.61 ,66.31 
03,019,01,005,0123,232,662,4,666,1218,0,0,0,0,0,0,0,66.31 ,54.68 ,66.31 
03,019,01,005,0123,233,750,0,750,1297,0,0,0,0,0,0,0,66.31 ,57.83 ,66.31 
03,019,01,005,0123,234,712,6,718,1153,0,0,0,0,0,0,0,66.31 ,62.27 ,66.31 
03,019,01,005,0124,235,741,7,748,1342,0,0,0,0,0,0,0,66.31 ,55.74 ,66.31 
03,019,01,005,0124,236,853,9,862,1580,0,0,0,0,0,0,0,66.31 ,54.56 ,66.31 
03,019,01,005,0124,237,744,8,752,1310,0,0,0,0,0,0,0,66.31 ,57.40 ,66.31 
03,019,01,005,0124,238,940,10,950,1484,0,0,0,0,0,0,0,66.31 ,64.02 ,66.31 
03,019,01,005,0124,239,784,4,788,1256,0,0,0,0,0,0,0,66.31 ,62.74 ,66.31 
03,019,01,005,0125,240,780,8,788,1293,0,0,0,0,0,0,0,66.31 ,60.94 ,66.31 
03,019,01,005,0125,241,748,8,756,1220,0,0,0,0,0,0,0,66.31 ,61.97 ,66.31 
03,019,01,006,0126,242,1077,9,1086,1669,0,0,0,0,0,0,0,66.31 ,65.07 ,66.31 
03,019,01,006,0126,243,1071,14,1085,1767,0,0,0,0,0,0,0,66.31 ,61.40 ,66.31 
03,019,01,006,0126,244,835,8,843,1413,0,0,0,0,0,0,0,66.31 ,59.66 ,66.31 
03,019,01,006,0127,245,618,8,626,1087,0,0,0,0,0,0,0,66.31 ,57.59 ,66.31 
03,019,01,006,0127,246,725,7,732,1229,0,0,0,0,0,0,0,66.31 ,59.56 ,66.31 
03,019,01,006,0127,247,910,1,911,1360,0,0,0,0,0,0,0,66.31 ,66.99 ,66.31 
03,019,01,006,0128,248,1155,12,1167,1790,0,0,0,0,0,0,0,66.31 ,65.20 ,66.31 
03,019,01,006,0128,249,865,8,873,1475,0,0,0,0,0,0,0,66.31 ,59.19 ,66.31 
03,019,01,006,0129,250,866,7,873,1325,0,0,0,0,0,0,0,66.31 ,65.89 ,66.31 
03,019,01,006,0130,251,686,5,691,947,0,0,0,0,0,0,0,66.31 ,72.97 ,66.31 
03,019,01,006,0131,252,1140,11,1151,1733,0,0,0,0,0,0,0,66.31 ,66.42 ,66.31 
03,019,01,006,0131,253,963,9,972,1504,0,0,0,0,0,0,0,66.31 ,64.63 ,66.31 
03,019,01,006,0132,254,828,2,830,1304,0,0,0,0,0,0,0,66.31 ,63.65 ,66.31 
03,019,01,006,0132,255,967,13,980,1861,0,0,0,0,0,0,0,66.31 ,52.66 ,66.31 
03,019,01,006,0132,256,954,17,971,1835,0,0,0,0,0,0,0,66.31 ,52.92 ,66.31 
03,019,01,006,0132,257,895,12,907,1664,0,0,0,0,0,0,0,66.31 ,54.51 ,66.31 
03,019,01,006,0133,258,1086,16,1102,1806,0,0,0,0,0,0,0,66.31 ,61.02 ,66.31 
03,019,01,006,0133,259,813,6,819,1401,0,0,0,0,0,0,0,66.31 ,58.46 ,66.31 
03,019,01,006,0133,260,800,5,805,1460,0,0,0,0,0,0,0,66.31 ,55.14 ,66.31 
03,019,01,006,0133,261,869,7,876,1418,0,0,0,0,0,0,0,66.31 ,61.78 ,66.31 
03,019,01,006,0134,262,663,7,670,896,0,0,0,0,0,0,0,66.31 ,74.78 ,66.31 
03,019,01,006,0134,263,603,9,612,814,0,0,0,0,0,0,0,66.31 ,75.18 ,66.31 
03,019,01,006,0135,264,966,9,975,1620,0,0,0,0,0,0,0,66.31 ,60.19 ,66.31 
03,019,01,006,0135,265,963,12,975,1633,0,0,0,0,0,0,0,66.31 ,59.71 ,66.31 
03,019,01,006,0135,266,889,10,899,1599,0,0,0,0,0,0,0,66.31 ,56.22 ,66.31 
03,019,01,006,0136,267,1038,6,1044,1735,0,0,0,0,0,0,0,66.31 ,60.17 ,66.31 
03,019,01,006,0136,268,950,10,960,1587,0,0,0,0,0,0,0,66.31 ,60.49 ,66.31 
03,019,01,006,0136,269,783,7,790,1429,0,0,0,0,0,0,0,66.31 ,55.28 ,66.31 
03,019,01,006,0136,270,928,9,937,1699,0,0,0,0,0,0,0,66.31 ,55.15 ,66.31 
03,019,01,006,0137,271,686,7,693,1170,0,0,0,0,0,0,0,66.31 ,59.23 ,66.31 
03,019,01,006,0137,272,629,8,637,1072,0,0,0,0,0,0,0,66.31 ,59.42 ,66.31 
03,019,01,006,0137,273,709,5,714,1170,0,0,0,0,0,0,0,66.31 ,61.03 ,66.31 
03,019,01,006,0138,274,865,12,877,1500,0,0,0,0,0,0,0,66.31 ,58.47 ,66.31 
03,019,01,006,0138,275,729,4,733,1250,0,0,0,0,0,0,0,66.31 ,58.64 ,66.31 
03,019,01,006,0138,276,800,11,811,1430,0,0,0,0,0,0,0,66.31 ,56.71 ,66.31 
03,019,01,006,0139,277,1010,3,1013,1558,0,0,0,0,0,0,0,66.31 ,65.02 ,66.31 
03,019,01,006,0139,278,1018,11,1029,1827,0,0,0,0,0,0,0,66.31 ,56.32 ,66.31 
03,019,01,006,0139,279,1012,12,1024,1781,0,0,0,0,0,0,0,66.31 ,57.50 ,66.31 
03,019,01,006,0140,280,958,6,964,1571,0,0,0,0,0,0,0,66.31 ,61.36 ,66.31 
03,019,01,006,0140,281,847,16,863,1451,0,0,0,0,0,0,0,66.31 ,59.48 ,66.31 
03,019,01,006,0140,282,651,5,656,1238,0,0,0,0,0,0,0,66.31 ,52.99 ,66.31 
03,019,01,006,0141,283,1013,22,1035,1653,0,0,0,0,0,0,0,66.31 ,62.61 ,66.31 
03,019,01,006,0141,284,1000,9,1009,1563,0,0,0,0,0,0,0,66.31 ,64.56 ,66.31 
03,019,01,006,0142,285,703,2,705,1027,0,0,0,0,0,0,0,66.31 ,68.65 ,66.31 
03,019,01,006,0143,286,866,15,881,1337,0,0,0,0,0,0,0,66.31 ,65.89 ,66.31 
03,019,01,006,0143,287,838,12,850,1346,0,0,0,0,0,0,0,66.31 ,63.15 ,66.31 
03,019,01,006,0144,288,968,10,978,1480,0,0,0,0,0,0,0,66.31 ,66.08 ,66.31 
03,019,01,006,0144,289,697,7,704,1151,0,0,0,0,0,0,0,66.31 ,61.16 ,66.31 
03,019,01,006,0144,290,694,7,701,1213,0,0,0,0,0,0,0,66.31 ,57.79 ,66.31 
03,019,01,006,0145,291,618,5,623,824,0,0,0,0,0,0,0,66.31 ,75.61 ,66.31 
03,019,01,006,0145,292,647,5,652,983,0,0,0,0,0,0,0,66.31 ,66.33 ,66.31 
03,019,01,006,0145,293,752,6,758,1297,0,0,0,0,0,0,0,66.31 ,58.44 ,66.31 
03,019,01,006,0145,294,786,14,800,1306,0,0,0,0,0,0,0,66.31 ,61.26 ,66.31 
03,019,01,006,0146,295,607,3,610,848,0,0,0,0,0,0,0,66.31 ,71.93 ,66.31 
03,019,01,006,0146,296,700,12,712,981,0,0,0,0,0,0,0,66.31 ,72.58 ,66.31 
03,019,01,006,0147,297,638,14,652,1031,0,0,0,0,0,0,0,66.31 ,63.24 ,66.31 
03,019,01,006,0147,298,600,6,606,1088,0,0,0,0,0,0,0,66.31 ,55.70 ,66.31 
03,019,01,006,0148,299,928,6,934,1512,0,0,0,0,0,0,0,66.31 ,61.77 ,66.31 
03,019,01,006,0148,300,792,8,800,1343,0,0,0,0,0,0,0,66.31 ,59.57 ,66.31 
03,019,01,006,0148,301,575,10,585,1005,0,0,0,0,0,0,0,66.31 ,58.21 ,66.31 
03,019,01,006,0149,302,969,11,980,1690,0,0,0,0,0,0,0,66.31 ,57.99 ,66.31 
03,019,01,006,0149,303,847,6,853,1585,0,0,0,0,0,0,0,66.31 ,53.82 ,66.31 
03,019,01,006,0149,304,744,4,748,1445,0,0,0,0,0,0,0,66.31 ,51.76 ,66.31 
03,019,01,006,0149,305,738,12,750,1159,0,0,0,0,0,0,0,66.31 ,64.71 ,66.31 
03,019,01,006,0149,306,931,11,942,1597,0,0,0,0,0,0,0,66.31 ,58.99 ,66.31 
03,019,01,006,0149,307,957,5,962,1640,0,0,0,0,0,0,0,66.31 ,58.66 ,66.31 
03,019,01,006,0149,308,787,3,790,1339,0,0,0,0,0,0,0,66.31 ,59.00 ,66.31 
03,019,01,006,0149,309,706,4,710,1341,0,0,0,0,0,0,0,66.31 ,52.95 ,66.31 
03,019,01,006,0149,310,656,5,661,1265,0,0,0,0,0,0,0,66.31 ,52.25 ,66.31 
03,019,01,006,0149,311,684,12,696,1365,0,0,0,0,0,0,0,66.31 ,50.99 ,66.31 
03,019,01,006,0149,312,657,2,659,1478,0,0,0,0,0,0,0,66.31 ,44.59 ,66.31 
03,019,01,006,0150,313,647,4,651,1148,0,0,0,0,0,0,0,66.31 ,56.71 ,66.31 
03,019,01,006,0150,314,1112,10,1122,1723,0,0,0,0,0,0,0,66.31 ,65.12 ,66.31 
03,019,01,006,0150,315,553,7,560,883,0,0,0,0,0,0,0,66.31 ,63.42 ,66.31 
03,019,01,007,0151,316,907,9,916,1396,0,0,0,0,0,0,0,66.31 ,65.62 ,66.31 
03,019,01,007,0151,317,764,9,773,1222,0,0,0,0,0,0,0,66.31 ,63.26 ,66.31 
03,019,01,007,0151,318,928,7,935,1457,0,0,0,0,0,0,0,66.31 ,64.17 ,66.31 
03,019,01,007,0152,319,918,13,931,1409,0,0,0,0,0,0,0,66.31 ,66.08 ,66.31 
03,019,01,007,0152,320,764,9,773,1314,0,0,0,0,0,0,0,66.31 ,58.83 ,66.31 
03,019,01,007,0152,321,841,7,848,1357,0,0,0,0,0,0,0,66.31 ,62.49 ,66.31 
03,019,01,007,0153,322,669,19,688,1078,0,0,0,0,0,0,0,66.31 ,63.82 ,66.31 
03,019,01,007,0153,323,892,13,905,1288,0,0,0,0,0,0,0,66.31 ,70.26 ,66.31 
03,019,01,007,0153,324,665,4,669,1019,0,0,0,0,0,0,0,66.31 ,65.65 ,66.31 
03,019,01,007,0154,325,728,13,741,1079,0,0,0,0,0,0,0,66.31 ,68.67 ,66.31 
03,019,01,007,0154,326,759,9,768,1064,0,0,0,0,0,0,0,66.31 ,72.18 ,66.31 
03,019,01,007,0154,327,752,10,762,1100,0,0,0,0,0,0,0,66.31 ,69.27 ,66.31 
03,019,01,007,0155,328,679,6,685,886,0,0,0,0,0,0,0,66.31 ,77.31 ,66.31 
03,019,01,007,0155,329,418,7,425,608,0,0,0,0,0,0,0,66.31 ,69.90 ,66.31 
03,019,01,007,0156,330,618,10,628,1043,0,0,0,0,0,0,0,66.31 ,60.21 ,66.31 
03,019,01,007,0156,331,965,12,977,1561,0,0,0,0,0,0,0,66.31 ,62.59 ,66.31 
03,019,01,007,0157,332,974,11,985,1512,0,0,0,0,0,0,0,66.31 ,65.15 ,66.31 
03,019,01,007,0157,333,857,10,867,1297,0,0,0,0,0,0,0,66.31 ,66.85 ,66.31 
03,019,01,007,0157,334,627,9,636,896,0,0,0,0,0,0,0,66.31 ,70.98 ,66.31 
03,019,01,007,0157,335,397,6,403,948,0,0,0,0,0,0,0,66.31 ,42.51 ,66.31 
03,019,01,007,0158,336,697,5,702,972,0,0,0,0,0,0,0,66.31 ,72.22 ,66.31 
03,019,01,007,0158,337,712,12,724,995,0,0,0,0,0,0,0,66.31 ,72.76 ,66.31 
03,019,01,007,0159,338,762,11,773,1176,0,0,0,0,0,0,0,66.31 ,65.73 ,66.31 
03,019,01,007,0159,339,625,3,628,1173,0,0,0,0,0,0,0,66.31 ,53.54 ,66.31 
03,019,01,007,0159,340,872,14,886,1384,0,0,0,0,0,0,0,66.31 ,64.02 ,66.31 
03,019,01,007,0159,341,676,4,680,1080,0,0,0,0,0,0,0,66.31 ,62.96 ,66.31 
03,019,01,007,0159,342,789,6,795,1125,0,0,0,0,0,0,0,66.31 ,70.67 ,66.31 
03,019,01,007,0160,343,732,9,741,1155,0,0,0,0,0,0,0,66.31 ,64.16 ,66.31 
03,019,01,007,0161,344,726,11,737,1254,0,0,0,0,0,0,0,66.31 ,58.77 ,66.31 
03,019,01,007,0161,345,763,4,767,1446,0,0,0,0,0,0,0,66.31 ,53.04 ,66.31 
03,019,01,007,0161,346,863,8,871,1444,0,0,0,0,0,0,0,66.31 ,60.32 ,66.31 
03,019,01,007,0161,347,957,11,968,1532,0,0,0,0,0,0,0,66.31 ,63.19 ,66.31 
03,019,01,007,0161,348,815,11,826,1439,0,0,0,0,0,0,0,66.31 ,57.40 ,66.31 
03,019,01,007,0162,349,818,8,826,1232,0,0,0,0,0,0,0,66.31 ,67.05 ,66.31 
03,019,01,007,0162,350,714,5,719,1213,0,0,0,0,0,0,0,66.31 ,59.27 ,66.31 
03,019,01,007,0163,351,871,20,891,1316,0,0,0,0,0,0,0,66.31 ,67.71 ,66.31 
03,019,01,007,0164,352,980,6,986,1603,0,0,0,0,0,0,0,66.31 ,61.51 ,66.31 
03,019,01,007,0164,353,943,11,954,1715,0,0,0,0,0,0,0,66.31 ,55.63 ,66.31 
03,019,01,007,0164,354,786,11,797,1272,0,0,0,0,0,0,0,66.31 ,62.66 ,66.31 
03,019,01,007,0164,355,653,6,659,1077,0,0,0,0,0,0,0,66.31 ,61.19 ,66.31 
03,019,01,007,0164,356,609,13,622,1001,0,0,0,0,0,0,0,66.31 ,62.14 ,66.31 
03,019,01,007,0164,357,784,12,796,1188,0,0,0,0,0,0,0,66.31 ,67.00 ,66.31 
03,019,01,007,0164,358,669,14,683,1027,0,0,0,0,0,0,0,66.31 ,66.50 ,66.31 
03,019,01,007,0164,359,707,9,716,1184,0,0,0,0,0,0,0,66.31 ,60.47 ,66.31 
03,019,01,007,0165,360,781,6,787,1333,0,0,0,0,0,0,0,66.31 ,59.04 ,66.31 
03,019,01,007,0165,361,608,8,616,960,0,0,0,0,0,0,0,66.31 ,64.17 ,66.31 
03,019,01,007,0165,362,521,5,526,897,0,0,0,0,0,0,0,66.31 ,58.64 ,66.31 
03,019,01,007,0165,363,544,11,555,942,0,0,0,0,0,0,0,66.31 ,58.92 ,66.31 
03,019,01,007,0165,364,635,3,638,1017,0,0,0,0,0,0,0,66.31 ,62.73 ,66.31 
03,019,01,007,0165,365,603,6,609,976,0,0,0,0,0,0,0,66.31 ,62.40 ,66.31 
03,019,01,007,0165,366,570,2,572,988,0,0,0,0,0,0,0,66.31 ,57.89 ,66.31 
03,019,01,007,0166,367,913,5,918,1484,0,0,0,0,0,0,0,66.31 ,61.86 ,66.31 
03,019,01,007,0166,368,866,8,874,1470,0,0,0,0,0,0,0,66.31 ,59.46 ,66.31 
03,019,01,007,0166,369,748,2,750,1106,0,0,0,0,0,0,0,66.31 ,67.81 ,66.31 
03,019,01,007,0166,370,695,2,697,1085,0,0,0,0,0,0,0,66.31 ,64.24 ,66.31 
03,019,01,007,0166,371,693,6,699,1213,0,0,0,0,0,0,0,66.31 ,57.63 ,66.31 
03,019,01,007,0166,372,780,10,790,1368,0,0,0,0,0,0,0,66.31 ,57.75 ,66.31 
03,019,01,007,0166,373,785,3,788,1240,0,0,0,0,0,0,0,66.31 ,63.55 ,66.31 
03,019,01,008,0167,374,1096,11,1107,1689,0,0,0,0,0,0,0,66.31 ,65.54 ,66.31 
03,019,01,008,0167,375,1003,16,1019,1743,0,0,0,0,0,0,0,66.31 ,58.46 ,66.31 
03,019,01,008,0167,376,1071,9,1080,1723,0,0,0,0,0,0,0,66.31 ,62.68 ,66.31 
03,019,01,008,0168,377,1043,13,1056,1687,0,0,0,0,0,0,0,66.31 ,62.60 ,66.31 
03,019,01,008,0168,378,928,8,936,1463,0,0,0,0,0,0,0,66.31 ,63.98 ,66.31 
03,019,01,008,0169,379,864,6,870,1566,0,0,0,0,0,0,0,66.31 ,55.56 ,66.31 
03,019,01,008,0169,380,736,4,740,1308,0,0,0,0,0,0,0,66.31 ,56.57 ,66.31 
03,019,01,008,0169,381,685,4,689,1076,0,0,0,0,0,0,0,66.31 ,64.03 ,66.31 
03,019,01,008,0169,382,1266,10,1276,2257,0,0,0,0,0,0,0,66.31 ,56.54 ,66.31 
03,019,01,008,0169,383,967,10,977,1668,0,0,0,0,0,0,0,66.31 ,58.57 ,66.31 
03,019,01,008,0169,384,652,6,658,1020,0,0,0,0,0,0,0,66.31 ,64.51 ,66.31 
03,019,01,008,0170,385,1177,9,1186,2040,0,0,0,0,0,0,0,66.31 ,58.14 ,66.31 
03,019,01,008,0170,386,1097,14,1111,1906,0,0,0,0,0,0,0,66.31 ,58.29 ,66.31 
03,019,01,008,0170,387,1066,17,1083,1831,0,0,0,0,0,0,0,66.31 ,59.15 ,66.31 
03,019,01,008,0170,388,672,8,680,1230,0,0,0,0,0,0,0,66.31 ,55.28 ,66.31 
03,019,01,008,0170,389,844,11,855,1424,0,0,0,0,0,0,0,66.31 ,60.04 ,66.31 
03,019,01,008,0171,390,942,15,957,1674,0,0,0,0,0,0,0,66.31 ,57.17 ,66.31 
03,019,01,008,0171,391,856,6,862,1575,0,0,0,0,0,0,0,66.31 ,54.73 ,66.31 
03,019,01,008,0171,392,779,9,788,1335,0,0,0,0,0,0,0,66.31 ,59.03 ,66.31 
03,019,01,008,0171,393,833,13,846,1394,0,0,0,0,0,0,0,66.31 ,60.69 ,66.31 
03,019,01,008,0172,394,814,17,831,1240,0,0,0,0,0,0,0,66.31 ,67.02 ,66.31 
03,019,01,008,0172,395,749,13,762,1254,0,0,0,0,0,0,0,66.31 ,60.77 ,66.31 
03,019,01,008,0172,396,820,12,832,1386,0,0,0,0,0,0,0,66.31 ,60.03 ,66.31 
03,019,01,008,0173,397,800,9,809,1394,0,0,0,0,0,0,0,66.31 ,58.03 ,66.31 
03,019,01,008,0173,398,760,10,770,1414,0,0,0,0,0,0,0,66.31 ,54.46 ,66.31 
03,019,01,008,0173,399,971,12,983,1658,0,0,0,0,0,0,0,66.31 ,59.29 ,66.31 
03,019,01,008,0173,400,1025,13,1038,1586,0,0,0,0,0,0,0,66.31 ,65.45 ,66.31 
03,019,01,008,0174,401,634,7,641,1186,0,0,0,0,0,0,0,66.31 ,54.05 ,66.31 
03,019,01,008,0174,402,773,8,781,1283,0,0,0,0,0,0,0,66.31 ,60.87 ,66.31 
03,019,01,008,0174,403,816,9,825,1286,0,0,0,0,0,0,0,66.31 ,64.15 ,66.31 
03,019,01,008,0175,404,1058,9,1067,1628,0,0,0,0,0,0,0,66.31 ,65.54 ,66.31 
03,019,01,008,0175,405,1040,21,1061,1723,0,0,0,0,0,0,0,66.31 ,61.58 ,66.31 
03,019,01,008,0176,406,827,9,836,1258,0,0,0,0,0,0,0,66.31 ,66.45 ,66.31 
03,019,01,008,0176,407,920,11,931,1617,0,0,0,0,0,0,0,66.31 ,57.58 ,66.31 
03,019,01,008,0176,408,833,8,841,1426,0,0,0,0,0,0,0,66.31 ,58.98 ,66.31 
03,019,01,008,0177,409,833,12,845,1280,0,0,0,0,0,0,0,66.31 ,66.02 ,66.31 
03,019,01,008,0177,410,1178,9,1187,1787,0,0,0,0,0,0,0,66.31 ,66.42 ,66.31 
03,019,01,008,0177,411,1056,9,1065,1681,0,0,0,0,0,0,0,66.31 ,63.36 ,66.31 
03,019,01,008,0178,412,1005,10,1015,1518,0,0,0,0,0,0,0,66.31 ,66.86 ,66.31 
03,019,01,008,0178,413,928,17,945,1304,0,0,0,0,0,0,0,66.31 ,72.47 ,66.31 
03,019,01,008,0178,414,878,11,889,1318,0,0,0,0,0,0,0,66.31 ,67.45 ,66.31 
03,019,01,008,0178,415,847,14,861,1438,0,0,0,0,0,0,0,66.31 ,59.87 ,66.31 
03,019,01,008,0179,416,1167,12,1179,1717,0,0,0,0,0,0,0,66.31 ,68.67 ,66.31 
03,019,01,008,0179,417,977,7,984,1537,0,0,0,0,0,0,0,66.31 ,64.02 ,66.31 
03,019,01,008,0179,418,437,2,439,718,0,0,0,0,0,0,0,66.31 ,61.14 ,66.31 
03,019,01,008,0180,419,1037,9,1046,1484,0,0,0,0,0,0,0,66.31 ,70.49 ,66.31 
03,019,01,008,0181,420,488,4,492,780,0,0,0,0,0,0,0,66.31 ,63.08 ,66.31 
03,019,01,008,0181,421,664,26,690,1012,0,0,0,0,0,0,0,66.31 ,68.18 ,66.31 
03,019,01,008,0182,422,641,3,644,894,0,0,0,0,0,0,0,66.31 ,72.04 ,66.31 
03,019,01,008,0183,423,512,3,515,708,0,0,0,0,0,0,0,66.31 ,72.74 ,66.31 
03,019,01,008,0184,424,950,15,965,1338,0,0,0,0,0,0,0,66.31 ,72.12 ,66.31 
03,019,01,008,0185,425,796,8,804,1285,0,0,0,0,0,0,0,66.31 ,62.57 ,66.31 
03,019,01,008,0185,426,871,15,886,1364,0,0,0,0,0,0,0,66.31 ,64.96 ,66.31 
03,019,01,008,0185,427,722,7,729,1241,0,0,0,0,0,0,0,66.31 ,58.74 ,66.31 
03,019,01,008,0186,428,826,14,840,1387,0,0,0,0,0,0,0,66.31 ,60.56 ,66.31 
03,019,01,008,0186,429,618,9,627,1193,0,0,0,0,0,0,0,66.31 ,52.56 ,66.31 
03,019,01,008,0186,430,580,5,585,1011,0,0,0,0,0,0,0,66.31 ,57.86 ,66.31 
03,019,01,008,0186,431,632,11,643,1075,0,0,0,0,0,0,0,66.31 ,59.81 ,66.31 
03,019,01,008,0186,432,741,2,743,1230,0,0,0,0,0,0,0,66.31 ,60.41 ,66.31 
03,019,01,008,0186,433,640,4,644,1109,0,0,0,0,0,0,0,66.31 ,58.07 ,66.31 
03,019,01,008,0187,434,872,10,882,1626,0,0,0,0,0,0,0,66.31 ,54.24 ,66.31 
03,019,01,008,0187,435,881,11,892,1589,0,0,0,0,0,0,0,66.31 ,56.14 ,66.31 
03,019,01,008,0187,436,848,9,857,1389,0,0,0,0,0,0,0,66.31 ,61.70 ,66.31 
03,019,01,008,0187,437,835,12,847,1389,0,0,0,0,0,0,0,66.31 ,60.98 ,66.31 
03,019,01,008,0187,438,901,10,911,1515,0,0,0,0,0,0,0,66.31 ,60.13 ,66.31 
03,019,01,008,0187,439,871,5,876,1480,0,0,0,0,0,0,0,66.31 ,59.19 ,66.31 
03,019,01,008,0188,440,1090,16,1106,1579,0,0,0,0,0,0,0,66.31 ,70.04 ,66.31 
03,019,01,008,0188,441,934,6,940,1315,0,0,0,0,0,0,0,66.31 ,71.48 ,66.31 
03,019,01,008,0188,442,1006,5,1011,1437,0,0,0,0,0,0,0,66.31 ,70.35 ,66.31 
03,019,01,008,0188,443,870,11,881,1258,0,0,0,0,0,0,0,66.31 ,70.03 ,66.31 
03,019,01,008,0189,444,1140,20,1160,1622,0,0,0,0,0,0,0,66.31 ,71.52 ,66.31 
03,019,01,008,0189,445,1181,45,1226,1614,0,0,0,0,0,0,0,66.31 ,75.96 ,66.31 
03,019,01,008,0189,446,1203,14,1217,1636,0,0,0,0,0,0,0,66.31 ,74.39 ,66.31 
03,019,01,008,0190,447,783,7,790,1005,0,0,0,0,0,0,0,66.31 ,78.61 ,66.31 
03,019,01,008,0191,448,1104,15,1119,1454,0,0,0,0,0,0,0,66.31 ,76.96 ,66.31 
03,019,01,008,0191,449,936,8,944,1411,0,0,0,0,0,0,0,66.31 ,66.90 ,66.31 
03,019,01,008,0191,450,993,15,1008,1673,0,0,0,0,0,0,0,66.31 ,60.25 ,66.31 
03,019,01,008,0192,451,1051,14,1065,1693,0,0,0,0,0,0,0,66.31 ,62.91 ,66.31 
03,019,01,008,0192,452,862,13,875,1334,0,0,0,0,0,0,0,66.31 ,65.59 ,66.31 
03,019,01,008,0192,453,797,7,804,1180,0,0,0,0,0,0,0,66.31 ,68.14 ,66.31 
03,019,01,008,0193,454,702,12,714,1228,0,0,0,0,0,0,0,66.31 ,58.14 ,66.31 
03,019,01,008,0193,455,810,9,819,1389,0,0,0,0,0,0,0,66.31 ,58.96 ,66.31 
03,019,01,008,0193,456,1008,10,1018,1516,0,0,0,0,0,0,0,66.31 ,67.15 ,66.31 
03,019,01,008,0193,457,1023,14,1037,1858,0,0,0,0,0,0,0,66.31 ,55.81 ,66.31 
03,019,01,008,0194,458,761,10,771,1251,0,0,0,0,0,0,0,66.31 ,61.63 ,66.31 
03,019,01,008,0194,459,749,4,753,1145,0,0,0,0,0,0,0,66.31 ,65.76 ,66.31 
03,019,01,008,0194,460,760,6,766,1172,0,0,0,0,0,0,0,66.31 ,65.36 ,66.31 
03,019,01,008,0195,461,914,12,926,1593,0,0,0,0,0,0,0,66.31 ,58.13 ,66.31 
03,019,01,008,0195,462,881,17,898,1324,0,0,0,0,0,0,0,66.31 ,67.82 ,66.31 
03,019,01,008,0195,463,754,14,768,1238,0,0,0,0,0,0,0,66.31 ,62.04 ,66.31 
03,019,01,008,0196,464,562,7,569,807,0,0,0,0,0,0,0,66.31 ,70.51 ,66.31 
03,019,01,008,0197,465,777,8,785,1215,0,0,0,0,0,0,0,66.31 ,64.61 ,66.31 
03,019,01,008,0197,466,747,11,758,1189,0,0,0,0,0,0,0,66.31 ,63.75 ,66.31 
03,019,01,008,0197,467,1023,11,1034,1593,0,0,0,0,0,0,0,66.31 ,64.91 ,66.31 
03,019,01,008,0197,468,838,11,849,1270,0,0,0,0,0,0,0,66.31 ,66.85 ,66.31 
03,020,01,001,0001,1,723,8,731,1236,0,0,0,0,0,0,0,66.31 ,59.14 ,66.31 
03,020,01,001,0001,2,556,7,563,1083,0,0,0,0,0,0,0,66.31 ,51.99 ,66.31 
03,020,01,001,0001,3,785,14,799,1313,0,0,0,0,0,0,0,66.31 ,60.85 ,66.31 
03,020,01,001,0002,4,501,3,504,823,0,0,0,0,0,0,0,66.31 ,61.24 ,66.31 
03,020,01,001,0002,5,570,5,575,920,0,0,0,0,0,0,0,66.31 ,62.50 ,66.31 
03,020,01,001,0003,6,374,8,382,587,0,0,0,0,0,0,0,66.31 ,65.08 ,66.31 
03,020,01,001,0004,7,569,9,578,892,0,0,0,0,0,0,0,66.31 ,64.80 ,66.31 
03,020,01,001,0004,8,865,6,871,1691,0,0,0,0,0,0,0,66.31 ,51.51 ,66.31 
03,020,01,001,0005,9,533,6,539,885,0,0,0,0,0,0,0,66.31 ,60.90 ,66.31 
03,020,01,001,0006,10,483,8,491,834,0,0,0,0,0,0,0,66.31 ,58.87 ,66.31 
03,020,01,001,0006,11,458,3,461,770,0,0,0,0,0,0,0,66.31 ,59.87 ,66.31 
03,020,01,001,0006,12,395,8,403,673,0,0,0,0,0,0,0,66.31 ,59.88 ,66.31 
03,020,01,001,0006,13,491,1,492,822,0,0,0,0,0,0,0,66.31 ,59.85 ,66.31 
03,020,01,001,0007,14,626,8,634,1080,0,0,0,0,0,0,0,66.31 ,58.70 ,66.31 
03,020,01,001,0007,15,600,13,613,1086,0,0,0,0,0,0,0,66.31 ,56.45 ,66.31 
03,020,01,001,0008,16,773,4,777,1106,0,0,0,0,0,0,0,66.31 ,70.25 ,66.31 
03,020,01,001,0008,17,712,7,719,1165,0,0,0,0,0,0,0,66.31 ,61.72 ,66.31 
03,020,01,001,0009,18,663,9,672,1252,0,0,0,0,0,0,0,66.31 ,53.67 ,66.31 
03,020,01,001,0009,19,535,3,538,916,0,0,0,0,0,0,0,66.31 ,58.73 ,66.31 
03,020,01,001,0009,20,451,9,460,808,0,0,0,0,0,0,0,66.31 ,56.93 ,66.31 
03,020,01,001,0010,21,715,7,722,1163,0,0,0,0,0,0,0,66.31 ,62.08 ,66.31 
03,020,01,001,0010,22,479,6,485,884,0,0,0,0,0,0,0,66.31 ,54.86 ,66.31 
03,020,01,001,0010,23,482,3,485,881,0,0,0,0,0,0,0,66.31 ,55.05 ,66.31 
03,020,01,001,0011,24,827,9,836,1168,0,0,0,0,0,0,0,66.31 ,71.58 ,66.31 
03,020,01,001,0011,25,663,13,676,985,0,0,0,0,0,0,0,66.31 ,68.63 ,66.31 
03,020,01,001,0011,26,900,14,914,1536,0,0,0,0,0,0,0,66.31 ,59.51 ,66.31 
03,020,01,001,0012,27,727,10,737,1274,0,0,0,0,0,0,0,66.31 ,57.85 ,66.31 
03,020,01,001,0013,28,246,0,246,335,0,0,0,0,0,0,0,66.31 ,73.43 ,66.31 
03,020,01,001,0014,29,285,3,288,487,0,0,0,0,0,0,0,66.31 ,59.14 ,66.31 
03,020,01,001,0015,30,314,5,319,533,0,0,0,0,0,0,0,66.31 ,59.85 ,66.31 
03,020,01,001,0016,31,301,4,305,511,0,0,0,0,0,0,0,66.31 ,59.69 ,66.31 
03,020,01,001,0017,32,397,5,402,611,0,0,0,0,0,0,0,66.31 ,65.79 ,66.31 
03,020,01,001,0018,33,330,2,332,550,0,0,0,0,0,0,0,66.31 ,60.36 ,66.31 
03,020,01,001,0019,34,299,2,301,480,0,0,0,0,0,0,0,66.31 ,62.71 ,66.31 
03,020,01,001,0020,35,399,3,402,643,0,0,0,0,0,0,0,66.31 ,62.52 ,66.31 
03,020,01,001,0020,36,393,7,400,661,0,0,0,0,0,0,0,66.31 ,60.51 ,66.31 
03,020,01,001,0021,37,368,3,371,625,0,0,0,0,0,0,0,66.31 ,59.36 ,66.31 
03,020,01,001,0022,38,581,2,583,998,0,0,0,0,0,0,0,66.31 ,58.42 ,66.31 
03,020,01,001,0023,39,238,1,239,395,0,0,0,0,0,0,0,66.31 ,60.51 ,66.31 
03,020,01,001,0024,40,657,6,663,1039,0,0,0,0,0,0,0,66.31 ,63.81 ,66.31 
03,020,01,001,0025,41,390,1,391,649,0,0,0,0,0,0,0,66.31 ,60.25 ,66.31 
03,020,01,001,0026,42,397,4,401,741,0,0,0,0,0,0,0,66.31 ,54.12 ,66.31 
03,020,01,001,0027,43,449,4,453,777,0,0,0,0,0,0,0,66.31 ,58.30 ,66.31 
03,020,01,001,0028,44,414,2,416,682,0,0,0,0,0,0,0,66.31 ,61.00 ,66.31 
03,020,01,001,0029,45,807,10,817,1250,0,0,0,0,0,0,0,66.31 ,65.36 ,66.31 
03,020,01,001,0030,46,361,2,363,638,0,0,0,0,0,0,0,66.31 ,56.90 ,66.31 
03,020,01,001,0031,47,721,6,727,1156,0,0,0,0,0,0,0,66.31 ,62.89 ,66.31 
03,020,01,001,0032,48,717,9,726,1242,0,0,0,0,0,0,0,66.31 ,58.45 ,66.31 
03,020,01,001,0033,49,514,2,516,818,0,0,0,0,0,0,0,66.31 ,63.08 ,66.31 
03,020,01,001,0034,50,400,4,404,688,0,0,0,0,0,0,0,66.31 ,58.72 ,66.31 
03,020,01,001,0034,51,371,1,372,649,0,0,0,0,0,0,0,66.31 ,57.32 ,66.31 
03,020,01,001,0035,52,532,5,537,1000,0,0,0,0,0,0,0,66.31 ,53.70 ,66.31 
03,020,01,001,0035,53,506,3,509,939,0,0,0,0,0,0,0,66.31 ,54.21 ,66.31 
03,020,01,001,0036,54,353,4,357,610,0,0,0,0,0,0,0,66.31 ,58.52 ,66.31 
03,020,01,001,0036,55,439,4,443,741,0,0,0,0,0,0,0,66.31 ,59.78 ,66.31 
03,020,01,001,0037,56,441,2,443,711,0,0,0,0,0,0,0,66.31 ,62.31 ,66.31 
03,020,01,001,0037,57,417,7,424,828,0,0,0,0,0,0,0,66.31 ,51.21 ,66.31 
03,020,01,001,0038,58,648,5,653,1133,0,0,0,0,0,0,0,66.31 ,57.63 ,66.31 
03,020,01,001,0038,59,519,5,524,920,0,0,0,0,0,0,0,66.31 ,56.96 ,66.31 
03,020,01,001,0038,60,523,11,534,1017,0,0,0,0,0,0,0,66.31 ,52.51 ,66.31 
03,020,01,001,0039,61,710,11,721,1251,0,0,0,0,0,0,0,66.31 ,57.63 ,66.31 
03,020,01,001,0039,62,478,5,483,777,0,0,0,0,0,0,0,66.31 ,62.16 ,66.31 
03,020,01,001,0040,63,633,7,640,1053,0,0,0,0,0,0,0,66.31 ,60.78 ,66.31 
03,020,01,001,0040,64,510,3,513,865,0,0,0,0,0,0,0,66.31 ,59.31 ,66.31 
03,020,01,001,0041,65,531,4,535,953,0,0,0,0,0,0,0,66.31 ,56.14 ,66.31 
03,020,01,001,0041,66,493,3,496,974,0,0,0,0,0,0,0,66.31 ,50.92 ,66.31 
03,020,01,001,0041,67,605,6,611,1144,0,0,0,0,0,0,0,66.31 ,53.41 ,66.31 
03,020,01,001,0041,68,703,7,710,1372,0,0,0,0,0,0,0,66.31 ,51.75 ,66.31 
03,020,01,001,0042,69,743,8,751,1197,0,0,0,0,0,0,0,66.31 ,62.74 ,66.31 
03,020,01,001,0042,70,764,10,774,1418,0,0,0,0,0,0,0,66.31 ,54.58 ,66.31 
03,020,01,001,0043,71,607,7,614,1051,0,0,0,0,0,0,0,66.31 ,58.42 ,66.31 
03,020,01,001,0043,72,598,6,604,953,0,0,0,0,0,0,0,66.31 ,63.38 ,66.31 
03,020,01,001,0044,73,710,9,719,1347,0,0,0,0,0,0,0,66.31 ,53.38 ,66.31 
03,020,01,001,0044,74,792,5,797,1492,0,0,0,0,0,0,0,66.31 ,53.42 ,66.31 
03,020,01,001,0045,75,522,9,531,874,0,0,0,0,0,0,0,66.31 ,60.76 ,66.31 
03,020,01,001,0046,76,495,9,504,673,0,0,0,0,0,0,0,66.31 ,74.89 ,66.31 
03,020,01,001,0047,77,732,10,742,1113,0,0,0,0,0,0,0,66.31 ,66.67 ,66.31 
03,020,01,001,0048,78,583,4,587,975,0,0,0,0,0,0,0,66.31 ,60.21 ,66.31 
03,020,01,001,0048,79,294,4,298,505,0,0,0,0,0,0,0,66.31 ,59.01 ,66.31 
03,020,01,001,0049,80,582,14,596,881,0,0,0,0,0,0,0,66.31 ,67.65 ,66.31 
03,020,01,001,0050,81,324,1,325,496,0,0,0,0,0,0,0,66.31 ,65.52 ,66.31 
03,020,01,001,0051,82,697,1,698,1165,0,0,0,0,0,0,0,66.31 ,59.91 ,66.31 
03,020,01,001,0051,83,773,9,782,1261,0,0,0,0,0,0,0,66.31 ,62.01 ,66.31 
03,020,01,001,0052,84,610,10,620,1093,0,0,0,0,0,0,0,66.31 ,56.72 ,66.31 
03,020,01,001,0052,85,483,7,490,924,0,0,0,0,0,0,0,66.31 ,53.03 ,66.31 
03,020,01,001,0053,86,920,15,935,1480,0,0,0,0,0,0,0,66.31 ,63.18 ,66.31 
03,020,01,001,0053,87,782,12,794,1277,0,0,0,0,0,0,0,66.31 ,62.18 ,66.31 
03,020,01,001,0054,88,526,5,531,1045,0,0,0,0,0,0,0,66.31 ,50.81 ,66.31 
03,020,01,001,0054,89,601,6,607,1050,0,0,0,0,0,0,0,66.31 ,57.81 ,66.31 
03,020,01,001,0055,90,621,11,632,1106,0,0,0,0,0,0,0,66.31 ,57.14 ,66.31 
03,020,01,001,0055,91,620,7,627,1129,0,0,0,0,0,0,0,66.31 ,55.54 ,66.31 
03,020,01,001,0055,92,458,6,464,894,0,0,0,0,0,0,0,66.31 ,51.90 ,66.31 
03,020,01,001,0055,93,601,7,608,972,0,0,0,0,0,0,0,66.31 ,62.55 ,66.31 
03,020,01,002,0056,94,637,10,647,1039,0,0,0,0,0,0,0,66.31 ,62.27 ,66.31 
03,020,01,002,0057,95,397,5,402,651,0,0,0,0,0,0,0,66.31 ,61.75 ,66.31 
03,020,01,002,0058,96,333,3,336,567,0,0,0,0,0,0,0,66.31 ,59.26 ,66.31 
03,020,01,002,0059,97,424,6,430,671,0,0,0,0,0,0,0,66.31 ,64.08 ,66.31 
03,020,01,002,0060,98,340,1,341,595,0,0,0,0,0,0,0,66.31 ,57.31 ,66.31 
03,020,01,002,0061,99,556,3,559,832,0,0,0,0,0,0,0,66.31 ,67.19 ,66.31 
03,020,01,002,0062,100,409,8,417,590,0,0,0,0,0,0,0,66.31 ,70.68 ,66.31 
03,020,01,002,0063,101,691,9,700,1023,0,0,0,0,0,0,0,66.31 ,68.43 ,66.31 
03,020,01,002,0064,102,544,8,552,906,0,0,0,0,0,0,0,66.31 ,60.93 ,66.31 
03,020,01,002,0065,103,517,4,521,864,0,0,0,0,0,0,0,66.31 ,60.30 ,66.31 
03,020,01,002,0066,104,361,4,365,550,0,0,0,0,0,0,0,66.31 ,66.36 ,66.31 
03,020,01,002,0067,105,477,2,479,809,0,0,0,0,0,0,0,66.31 ,59.21 ,66.31 
03,020,01,002,0068,106,340,0,340,550,0,0,0,0,0,0,0,66.31 ,61.82 ,66.31 
03,020,01,002,0069,107,348,6,354,556,0,0,0,0,0,0,0,66.31 ,63.67 ,66.31 
03,020,01,002,0070,108,271,3,274,436,0,0,0,0,0,0,0,66.31 ,62.84 ,66.31 
03,020,01,002,0071,109,253,5,258,440,0,0,0,0,0,0,0,66.31 ,58.64 ,66.31 
03,020,01,002,0072,110,369,8,377,642,0,0,0,0,0,0,0,66.31 ,58.72 ,66.31 
03,020,01,002,0073,111,486,2,488,722,0,0,0,0,0,0,0,66.31 ,67.59 ,66.31 
03,020,01,002,0074,112,409,1,410,655,0,0,0,0,0,0,0,66.31 ,62.60 ,66.31 
03,020,01,002,0075,113,687,7,694,1219,0,0,0,0,0,0,0,66.31 ,56.93 ,66.31 
03,020,01,002,0075,114,691,4,695,1297,0,0,0,0,0,0,0,66.31 ,53.59 ,66.31 
03,020,01,002,0075,115,654,6,660,1121,0,0,0,0,0,0,0,66.31 ,58.88 ,66.31 
03,020,01,002,0075,116,737,8,745,1459,0,0,0,0,0,0,0,66.31 ,51.06 ,66.31 
03,020,01,002,0076,117,594,3,597,1012,0,0,0,0,0,0,0,66.31 ,58.99 ,66.31 
03,020,01,002,0077,118,541,7,548,1011,0,0,0,0,0,0,0,66.31 ,54.20 ,66.31 
03,020,01,002,0077,119,676,5,681,1316,0,0,0,0,0,0,0,66.31 ,51.75 ,66.31 
03,020,01,002,0077,120,371,1,372,663,0,0,0,0,0,0,0,66.31 ,56.11 ,66.31 
03,020,01,002,0078,121,900,12,912,1475,0,0,0,0,0,0,0,66.31 ,61.83 ,66.31 
03,020,01,002,0079,122,644,10,654,1089,0,0,0,0,0,0,0,66.31 ,60.06 ,66.31 
03,020,01,002,0080,123,744,10,754,1215,0,0,0,0,0,0,0,66.31 ,62.06 ,66.31 
03,020,01,002,0081,124,481,8,489,871,0,0,0,0,0,0,0,66.31 ,56.14 ,66.31 
03,020,01,002,0081,125,479,6,485,782,0,0,0,0,0,0,0,66.31 ,62.02 ,66.31 
03,020,01,002,0082,126,772,15,787,1303,0,0,0,0,0,0,0,66.31 ,60.40 ,66.31 
03,020,01,002,0082,127,818,8,826,1419,0,0,0,0,0,0,0,66.31 ,58.21 ,66.31 
03,020,01,002,0083,128,527,7,534,934,0,0,0,0,0,0,0,66.31 ,57.17 ,66.31 
03,020,01,002,0083,129,635,3,638,1195,0,0,0,0,0,0,0,66.31 ,53.39 ,66.31 
03,020,01,002,0084,130,465,5,470,761,0,0,0,0,0,0,0,66.31 ,61.76 ,66.31 
03,020,01,002,0085,131,291,4,295,540,0,0,0,0,0,0,0,66.31 ,54.63 ,66.31 
03,020,01,002,0085,132,433,2,435,767,0,0,0,0,0,0,0,66.31 ,56.71 ,66.31 
03,020,01,002,0086,133,576,9,585,1052,0,0,0,0,0,0,0,66.31 ,55.61 ,66.31 
03,020,01,002,0087,134,503,8,511,869,0,0,0,0,0,0,0,66.31 ,58.80 ,66.31 
03,020,01,002,0087,135,580,2,582,1047,0,0,0,0,0,0,0,66.31 ,55.59 ,66.31 
03,020,01,002,0088,136,593,5,598,1141,0,0,0,0,0,0,0,66.31 ,52.41 ,66.31 
03,020,01,002,0088,137,644,6,650,1102,0,0,0,0,0,0,0,66.31 ,58.98 ,66.31 
03,020,01,002,0088,138,765,2,767,1385,0,0,0,0,0,0,0,66.31 ,55.38 ,66.31 
03,020,01,002,0089,139,637,5,642,1077,0,0,0,0,0,0,0,66.31 ,59.61 ,66.31 
03,020,01,002,0089,140,616,4,620,1039,0,0,0,0,0,0,0,66.31 ,59.67 ,66.31 
03,020,01,002,0089,141,644,5,649,1082,0,0,0,0,0,0,0,66.31 ,59.98 ,66.31 
03,020,01,002,0090,142,587,9,596,1029,0,0,0,0,0,0,0,66.31 ,57.92 ,66.31 
03,020,01,002,0090,143,630,4,634,1153,0,0,0,0,0,0,0,66.31 ,54.99 ,66.31 
03,020,01,002,0090,144,703,6,709,1310,0,0,0,0,0,0,0,66.31 ,54.12 ,66.31 
03,020,01,002,0090,145,577,4,581,1084,0,0,0,0,0,0,0,66.31 ,53.60 ,66.31 
03,020,01,002,0090,146,580,6,586,1045,0,0,0,0,0,0,0,66.31 ,56.08 ,66.31 
03,020,01,002,0091,147,703,3,706,1053,0,0,0,0,0,0,0,66.31 ,67.05 ,66.31 
03,020,01,002,0091,148,706,6,712,1220,0,0,0,0,0,0,0,66.31 ,58.36 ,66.31 
03,020,01,002,0091,149,507,1,508,867,0,0,0,0,0,0,0,66.31 ,58.59 ,66.31 
03,020,01,002,0092,150,627,9,636,1052,0,0,0,0,0,0,0,66.31 ,60.46 ,66.31 
03,020,01,002,0092,151,813,9,822,1367,0,0,0,0,0,0,0,66.31 ,60.13 ,66.31 
03,020,01,002,0092,152,707,13,720,1303,0,0,0,0,0,0,0,66.31 ,55.26 ,66.31 
03,020,01,002,0093,153,629,5,634,1095,0,0,0,0,0,0,0,66.31 ,57.90 ,66.31 
03,020,01,002,0093,154,616,2,618,1125,0,0,0,0,0,0,0,66.31 ,54.93 ,66.31 
03,020,01,002,0094,155,383,4,387,639,0,0,0,0,0,0,0,66.31 ,60.56 ,66.31 
03,020,01,002,0095,156,298,10,308,478,0,0,0,0,0,0,0,66.31 ,64.44 ,66.31 
03,020,01,002,0096,157,533,4,537,883,0,0,0,0,0,0,0,66.31 ,60.82 ,66.31 
03,020,01,002,0096,158,528,8,536,882,0,0,0,0,0,0,0,66.31 ,60.77 ,66.31 
03,020,01,002,0097,159,766,11,777,1264,0,0,0,0,0,0,0,66.31 ,61.47 ,66.31 
03,020,01,002,0098,160,508,8,516,912,0,0,0,0,0,0,0,66.31 ,56.58 ,66.31 
03,020,01,002,0098,161,537,3,540,881,0,0,0,0,0,0,0,66.31 ,61.29 ,66.31 
03,020,01,002,0099,162,575,7,582,1111,0,0,0,0,0,0,0,66.31 ,52.39 ,66.31 
03,020,01,002,0099,163,570,13,583,927,0,0,0,0,0,0,0,66.31 ,62.89 ,66.31 
03,020,01,002,0100,164,300,4,304,550,0,0,0,0,0,0,0,66.31 ,55.27 ,66.31 
03,020,01,002,0101,165,488,7,495,678,0,0,0,0,0,0,0,66.31 ,73.01 ,66.31 
03,020,01,002,0102,166,492,5,497,736,0,0,0,0,0,0,0,66.31 ,67.53 ,66.31 
03,020,01,002,0102,167,431,9,440,669,0,0,0,0,0,0,0,66.31 ,65.77 ,66.31 
03,020,01,002,0103,168,722,7,729,1289,0,0,0,0,0,0,0,66.31 ,56.56 ,66.31 
03,020,01,002,0104,169,445,6,451,838,0,0,0,0,0,0,0,66.31 ,53.82 ,66.31 
03,020,01,002,0104,170,492,5,497,886,0,0,0,0,0,0,0,66.31 ,56.09 ,66.31 
03,020,01,002,0105,171,981,20,1001,1548,0,0,0,0,0,0,0,66.31 ,64.66 ,66.31 
03,020,01,002,0105,172,637,5,642,1055,0,0,0,0,0,0,0,66.31 ,60.85 ,66.31 
03,020,01,002,0105,173,495,2,497,882,0,0,0,0,0,0,0,66.31 ,56.35 ,66.31 
03,020,01,002,0106,174,825,11,836,1293,0,0,0,0,0,0,0,66.31 ,64.66 ,66.31 
03,020,01,002,0106,175,842,9,851,1229,0,0,0,0,0,0,0,66.31 ,69.24 ,66.31 
03,020,01,002,0106,176,684,8,692,1205,0,0,0,0,0,0,0,66.31 ,57.43 ,66.31 
03,020,01,002,0106,177,765,10,775,1289,0,0,0,0,0,0,0,66.31 ,60.12 ,66.31 
03,020,01,002,0106,178,612,8,620,1187,0,0,0,0,0,0,0,66.31 ,52.23 ,66.31 
03,020,01,002,0106,179,683,11,694,1262,0,0,0,0,0,0,0,66.31 ,54.99 ,66.31 
03,020,01,002,0107,180,592,7,599,955,0,0,0,0,0,0,0,66.31 ,62.72 ,66.31 
03,020,01,002,0107,181,633,5,638,1108,0,0,0,0,0,0,0,66.31 ,57.58 ,66.31 
03,020,01,002,0107,182,571,5,576,967,0,0,0,0,0,0,0,66.31 ,59.57 ,66.31 
03,020,01,002,0108,183,633,5,638,1051,0,0,0,0,0,0,0,66.31 ,60.70 ,66.31 
03,020,01,002,0108,184,673,10,683,1102,0,0,0,0,0,0,0,66.31 ,61.98 ,66.31 
03,020,01,002,0109,185,556,8,564,1105,0,0,0,0,0,0,0,66.31 ,51.04 ,66.31 
03,020,01,002,0110,186,507,6,513,862,0,0,0,0,0,0,0,66.31 ,59.51 ,66.31 
03,021,01,001,0001,1,663,9,672,1196,0,0,0,0,0,0,0,66.31 ,56.19 ,66.31 
03,021,01,001,0001,2,996,9,1005,1810,0,0,0,0,0,0,0,66.31 ,55.52 ,66.31 
03,021,01,001,0001,3,799,6,805,1487,0,0,0,0,0,0,0,66.31 ,54.14 ,66.31 
03,021,01,001,0001,4,733,5,738,1247,0,0,0,0,0,0,0,66.31 ,59.18 ,66.31 
03,021,01,001,0002,5,1133,12,1145,1827,0,0,0,0,0,0,0,66.31 ,62.67 ,66.31 
03,021,01,001,0002,6,1025,9,1034,1732,0,0,0,0,0,0,0,66.31 ,59.70 ,66.31 
03,021,01,001,0003,7,803,13,816,1336,0,0,0,0,0,0,0,66.31 ,61.08 ,66.31 
03,021,01,001,0003,8,770,10,780,1394,0,0,0,0,0,0,0,66.31 ,55.95 ,66.31 
03,021,01,001,0004,9,1119,12,1131,1815,0,0,0,0,0,0,0,66.31 ,62.31 ,66.31 
03,021,01,001,0004,10,1151,8,1159,2014,0,0,0,0,0,0,0,66.31 ,57.55 ,66.31 
03,021,01,001,0004,11,889,4,893,1413,0,0,0,0,0,0,0,66.31 ,63.20 ,66.31 
03,021,01,001,0005,12,736,17,753,1195,0,0,0,0,0,0,0,66.31 ,63.01 ,66.31 
03,021,01,001,0005,13,949,13,962,1545,0,0,0,0,0,0,0,66.31 ,62.27 ,66.31 
03,021,01,001,0005,14,845,9,854,1370,0,0,0,0,0,0,0,66.31 ,62.34 ,66.31 
03,021,01,001,0006,15,1122,19,1141,1765,0,0,0,0,0,0,0,66.31 ,64.65 ,66.31 
03,021,01,001,0007,16,580,7,587,965,0,0,0,0,0,0,0,66.31 ,60.83 ,66.31 
03,021,01,001,0007,17,847,17,864,1539,0,0,0,0,0,0,0,66.31 ,56.14 ,66.31 
03,021,01,001,0008,18,606,7,613,959,0,0,0,0,0,0,0,66.31 ,63.92 ,66.31 
03,021,01,001,0008,19,797,8,805,1275,0,0,0,0,0,0,0,66.31 ,63.14 ,66.31 
03,021,01,001,0009,20,703,7,710,1101,0,0,0,0,0,0,0,66.31 ,64.49 ,66.31 
03,021,01,001,0009,21,814,10,824,1519,0,0,0,0,0,0,0,66.31 ,54.25 ,66.31 
03,021,01,001,0010,22,917,16,933,1492,0,0,0,0,0,0,0,66.31 ,62.53 ,66.31 
03,021,01,001,0010,23,974,10,984,1780,0,0,0,0,0,0,0,66.31 ,55.28 ,66.31 
03,021,01,001,0010,24,1075,6,1081,1763,0,0,0,0,0,0,0,66.31 ,61.32 ,66.31 
03,021,01,001,0011,25,881,12,893,1634,0,0,0,0,0,0,0,66.31 ,54.65 ,66.31 
03,021,01,001,0011,26,1064,15,1079,1930,0,0,0,0,0,0,0,66.31 ,55.91 ,66.31 
03,021,01,001,0011,27,994,10,1004,1832,0,0,0,0,0,0,0,66.31 ,54.80 ,66.31 
03,021,01,001,0012,28,675,7,682,1121,0,0,0,0,0,0,0,66.31 ,60.84 ,66.31 
03,021,01,001,0012,29,545,6,551,931,0,0,0,0,0,0,0,66.31 ,59.18 ,66.31 
03,021,01,001,0013,30,817,14,831,1349,0,0,0,0,0,0,0,66.31 ,61.60 ,66.31 
03,021,01,001,0013,31,1002,14,1016,1629,0,0,0,0,0,0,0,66.31 ,62.37 ,66.31 
03,021,01,001,0014,32,679,3,682,1131,0,0,0,0,0,0,0,66.31 ,60.30 ,66.31 
03,021,01,001,0014,33,852,6,858,1433,0,0,0,0,0,0,0,66.31 ,59.87 ,66.31 
03,021,01,001,0015,34,723,8,731,1068,0,0,0,0,0,0,0,66.31 ,68.45 ,66.31 
03,021,01,001,0015,35,712,3,715,1033,0,0,0,0,0,0,0,66.31 ,69.22 ,66.31 
03,021,01,001,0016,36,636,4,640,922,0,0,0,0,0,0,0,66.31 ,69.41 ,66.31 
03,021,01,001,0016,37,631,4,635,934,0,0,0,0,0,0,0,66.31 ,67.99 ,66.31 
03,021,01,001,0017,38,869,8,877,1515,0,0,0,0,0,0,0,66.31 ,57.89 ,66.31 
03,021,01,001,0017,39,1002,6,1008,1776,0,0,0,0,0,0,0,66.31 ,56.76 ,66.31 
03,021,01,001,0018,40,786,6,792,1401,0,0,0,0,0,0,0,66.31 ,56.53 ,66.31 
03,021,01,001,0018,41,871,5,876,1578,0,0,0,0,0,0,0,66.31 ,55.51 ,66.31 
03,021,01,001,0019,42,828,11,839,1353,0,0,0,0,0,0,0,66.31 ,62.01 ,66.31 
03,021,01,001,0019,43,781,3,784,1334,0,0,0,0,0,0,0,66.31 ,58.77 ,66.31 
03,021,01,001,0020,44,760,11,771,1308,0,0,0,0,0,0,0,66.31 ,58.94 ,66.31 
03,021,01,001,0020,45,739,3,742,1227,0,0,0,0,0,0,0,66.31 ,60.47 ,66.31 
03,021,01,001,0020,46,690,3,693,1141,0,0,0,0,0,0,0,66.31 ,60.74 ,66.31 
03,021,01,001,0021,47,855,5,860,1454,0,0,0,0,0,0,0,66.31 ,59.15 ,66.31 
03,021,01,001,0022,48,526,10,536,900,0,0,0,0,0,0,0,66.31 ,59.56 ,66.31 
03,021,01,001,0023,49,443,7,450,777,0,0,0,0,0,0,0,66.31 ,57.92 ,66.31 
03,021,01,001,0024,50,649,9,658,1185,0,0,0,0,0,0,0,66.31 ,55.53 ,66.31 
03,021,01,001,0025,51,651,5,656,1131,0,0,0,0,0,0,0,66.31 ,58.00 ,66.31 
03,021,01,001,0026,52,470,11,481,777,0,0,0,0,0,0,0,66.31 ,61.90 ,66.31 
03,021,01,001,0027,53,585,7,592,1006,0,0,0,0,0,0,0,66.31 ,58.85 ,66.31 
03,021,01,001,0027,54,451,7,458,800,0,0,0,0,0,0,0,66.31 ,57.25 ,66.31 
03,021,01,001,0028,55,795,6,801,1372,0,0,0,0,0,0,0,66.31 ,58.38 ,66.31 
03,021,01,001,0028,56,754,9,763,1365,0,0,0,0,0,0,0,66.31 ,55.90 ,66.31 
03,021,01,001,0029,57,947,16,963,1699,0,0,0,0,0,0,0,66.31 ,56.68 ,66.31 
03,021,01,001,0030,58,686,7,693,1201,0,0,0,0,0,0,0,66.31 ,57.70 ,66.31 
03,021,01,001,0030,59,665,12,677,1151,0,0,0,0,0,0,0,66.31 ,58.82 ,66.31 
03,021,01,001,0031,60,914,7,921,1457,0,0,0,0,0,0,0,66.31 ,63.21 ,66.31 
03,021,01,001,0031,61,686,7,693,1245,0,0,0,0,0,0,0,66.31 ,55.66 ,66.31 
03,021,01,001,0032,62,886,9,895,1542,0,0,0,0,0,0,0,66.31 ,58.04 ,66.31 
03,021,01,001,0033,63,733,8,741,1246,0,0,0,0,0,0,0,66.31 ,59.47 ,66.31 
03,021,01,001,0033,64,794,12,806,1386,0,0,0,0,0,0,0,66.31 ,58.15 ,66.31 
03,021,01,001,0034,65,530,2,532,951,0,0,0,0,0,0,0,66.31 ,55.94 ,66.31 
03,021,01,001,0034,66,623,4,627,1060,0,0,0,0,0,0,0,66.31 ,59.15 ,66.31 
03,021,01,001,0035,67,1365,14,1379,2043,0,0,0,0,0,0,0,66.31 ,67.50 ,66.31 
03,021,01,001,0035,68,1117,12,1129,1699,0,0,0,0,0,0,0,66.31 ,66.45 ,66.31 
03,021,01,001,0036,69,1066,5,1071,1892,0,0,0,0,0,0,0,66.31 ,56.61 ,66.31 
03,021,01,001,0037,70,1026,7,1033,1771,0,0,0,0,0,0,0,66.31 ,58.33 ,66.31 
03,021,01,001,0038,71,752,10,762,991,0,0,0,0,0,0,0,66.31 ,76.89 ,66.31 
03,021,01,001,0038,72,766,5,771,1356,0,0,0,0,0,0,0,66.31 ,56.86 ,66.31 
03,021,01,001,0038,73,591,6,597,1117,0,0,0,0,0,0,0,66.31 ,53.45 ,66.31 
03,021,01,001,0038,74,723,6,729,1226,0,0,0,0,0,0,0,66.31 ,59.46 ,66.31 
03,021,01,001,0039,75,622,10,632,1025,0,0,0,0,0,0,0,66.31 ,61.66 ,66.31 
03,021,01,001,0039,76,565,11,576,912,0,0,0,0,0,0,0,66.31 ,63.16 ,66.31 
03,021,01,001,0040,77,753,9,762,1335,0,0,0,0,0,0,0,66.31 ,57.08 ,66.31 
03,021,01,001,0041,78,750,9,759,1200,0,0,0,0,0,0,0,66.31 ,63.25 ,66.31 
03,021,01,001,0042,79,491,7,498,812,0,0,0,0,0,0,0,66.31 ,61.33 ,66.31 
03,021,01,001,0043,80,632,9,641,1093,0,0,0,0,0,0,0,66.31 ,58.65 ,66.31 
03,021,01,001,0044,81,1122,12,1134,1935,0,0,0,0,0,0,0,66.31 ,58.60 ,66.31 
03,021,01,001,0044,82,1207,22,1229,2019,0,0,0,0,0,0,0,66.31 ,60.87 ,66.31 
03,021,01,001,0045,83,875,9,884,1522,0,0,0,0,0,0,0,66.31 ,58.08 ,66.31 
03,021,01,001,0045,84,1100,10,1110,1974,0,0,0,0,0,0,0,66.31 ,56.23 ,66.31 
03,021,01,001,0045,85,856,10,866,1518,0,0,0,0,0,0,0,66.31 ,57.05 ,66.31 
03,021,01,002,0046,86,834,10,844,1413,0,0,0,0,0,0,0,66.31 ,59.73 ,66.31 
03,021,01,002,0046,87,913,7,920,1536,0,0,0,0,0,0,0,66.31 ,59.90 ,66.31 
03,021,01,002,0047,88,637,9,646,1076,0,0,0,0,0,0,0,66.31 ,60.04 ,66.31 
03,021,01,002,0047,89,564,6,570,996,0,0,0,0,0,0,0,66.31 ,57.23 ,66.31 
03,021,01,002,0048,90,716,8,724,1191,0,0,0,0,0,0,0,66.31 ,60.79 ,66.31 
03,021,01,002,0048,91,826,14,840,1487,0,0,0,0,0,0,0,66.31 ,56.49 ,66.31 
03,021,01,002,0048,92,921,8,929,1442,0,0,0,0,0,0,0,66.31 ,64.42 ,66.31 
03,021,01,002,0049,93,286,4,290,513,0,0,0,0,0,0,0,66.31 ,56.53 ,66.31 
03,021,01,002,0050,94,755,15,770,1345,0,0,0,0,0,0,0,66.31 ,57.25 ,66.31 
03,021,01,002,0051,95,690,11,701,1074,0,0,0,0,0,0,0,66.31 ,65.27 ,66.31 
03,021,01,002,0052,96,851,8,859,1255,0,0,0,0,0,0,0,66.31 ,68.45 ,66.31 
03,021,01,002,0053,97,939,14,953,1444,0,0,0,0,0,0,0,66.31 ,66.00 ,66.31 
03,021,01,002,0054,98,615,7,622,1012,0,0,0,0,0,0,0,66.31 ,61.46 ,66.31 
03,021,01,002,0055,99,506,3,509,913,0,0,0,0,0,0,0,66.31 ,55.75 ,66.31 
03,021,01,002,0055,100,861,8,869,1447,0,0,0,0,0,0,0,66.31 ,60.06 ,66.31 
03,021,01,002,0055,101,609,5,614,976,0,0,0,0,0,0,0,66.31 ,62.91 ,66.31 
03,021,01,002,0056,102,707,9,716,1216,0,0,0,0,0,0,0,66.31 ,58.88 ,66.31 
03,021,01,002,0056,103,787,6,793,1387,0,0,0,0,0,0,0,66.31 ,57.17 ,66.31 
03,021,01,002,0057,104,677,5,682,1063,0,0,0,0,0,0,0,66.31 ,64.16 ,66.31 
03,021,01,002,0057,105,576,6,582,988,0,0,0,0,0,0,0,66.31 ,58.91 ,66.31 
03,021,01,002,0058,106,780,5,785,1266,0,0,0,0,0,0,0,66.31 ,62.01 ,66.31 
03,021,01,002,0058,107,848,4,852,1283,0,0,0,0,0,0,0,66.31 ,66.41 ,66.31 
03,021,01,002,0059,108,601,10,611,997,0,0,0,0,0,0,0,66.31 ,61.28 ,66.31 
03,021,01,002,0059,109,765,2,767,1376,0,0,0,0,0,0,0,66.31 ,55.74 ,66.31 
03,021,01,002,0060,110,815,5,820,1468,0,0,0,0,0,0,0,66.31 ,55.86 ,66.31 
03,021,01,002,0060,111,913,9,922,1541,0,0,0,0,0,0,0,66.31 ,59.83 ,66.31 
03,021,01,002,0061,112,944,8,952,1534,0,0,0,0,0,0,0,66.31 ,62.06 ,66.31 
03,021,01,002,0061,113,980,7,987,1673,0,0,0,0,0,0,0,66.31 ,59.00 ,66.31 
03,021,01,002,0062,114,815,8,823,1395,0,0,0,0,0,0,0,66.31 ,59.00 ,66.31 
03,021,01,002,0062,115,883,5,888,1578,0,0,0,0,0,0,0,66.31 ,56.27 ,66.31 
03,021,01,002,0062,116,869,10,879,1516,0,0,0,0,0,0,0,66.31 ,57.98 ,66.31 
03,021,01,002,0063,117,926,7,933,1543,0,0,0,0,0,0,0,66.31 ,60.47 ,66.31 
03,021,01,002,0063,118,790,4,794,1419,0,0,0,0,0,0,0,66.31 ,55.95 ,66.31 
03,021,01,002,0064,119,568,6,574,928,0,0,0,0,0,0,0,66.31 ,61.85 ,66.31 
03,021,01,002,0064,120,534,4,538,1020,0,0,0,0,0,0,0,66.31 ,52.75 ,66.31 
03,021,01,002,0065,121,889,5,894,1539,0,0,0,0,0,0,0,66.31 ,58.09 ,66.31 
03,021,01,002,0065,122,661,4,665,1266,0,0,0,0,0,0,0,66.31 ,52.53 ,66.31 
03,021,01,002,0065,123,690,7,697,1131,0,0,0,0,0,0,0,66.31 ,61.63 ,66.31 
03,021,01,002,0066,124,476,6,482,807,0,0,0,0,0,0,0,66.31 ,59.73 ,66.31 
03,021,01,002,0066,125,693,13,706,1142,0,0,0,0,0,0,0,66.31 ,61.82 ,66.31 
03,021,01,002,0067,126,830,10,840,1565,0,0,0,0,0,0,0,66.31 ,53.67 ,66.31 
03,021,01,002,0067,127,1007,7,1014,1745,0,0,0,0,0,0,0,66.31 ,58.11 ,66.31 
03,021,01,002,0068,128,631,7,638,1183,0,0,0,0,0,0,0,66.31 ,53.93 ,66.31 
03,021,01,002,0068,129,847,10,857,1459,0,0,0,0,0,0,0,66.31 ,58.74 ,66.31 
03,021,01,002,0068,130,542,7,549,1080,0,0,0,0,0,0,0,66.31 ,50.83 ,66.31 
03,021,01,002,0069,131,934,10,944,1501,0,0,0,0,0,0,0,66.31 ,62.89 ,66.31 
03,021,01,002,0069,132,888,8,896,1559,0,0,0,0,0,0,0,66.31 ,57.47 ,66.31 
03,021,01,002,0070,133,957,4,961,1602,0,0,0,0,0,0,0,66.31 ,59.99 ,66.31 
03,021,01,002,0070,134,902,7,909,1601,0,0,0,0,0,0,0,66.31 ,56.78 ,66.31 
03,021,01,002,0071,135,977,8,985,1589,0,0,0,0,0,0,0,66.31 ,61.99 ,66.31 
03,021,01,002,0071,136,1000,13,1013,1723,0,0,0,0,0,0,0,66.31 ,58.79 ,66.31 
03,021,01,002,0072,137,673,7,680,1235,0,0,0,0,0,0,0,66.31 ,55.06 ,66.31 
03,021,01,002,0072,138,804,11,815,1509,0,0,0,0,0,0,0,66.31 ,54.01 ,66.31 
03,021,01,002,0072,139,796,7,803,1434,0,0,0,0,0,0,0,66.31 ,56.00 ,66.31 
03,021,01,002,0073,140,889,11,900,1625,0,0,0,0,0,0,0,66.31 ,55.38 ,66.31 
03,021,01,002,0073,141,1122,14,1136,2055,0,0,0,0,0,0,0,66.31 ,55.28 ,66.31 
03,021,01,002,0074,142,490,7,497,926,0,0,0,0,0,0,0,66.31 ,53.67 ,66.31 
03,021,01,002,0074,143,608,5,613,981,0,0,0,0,0,0,0,66.31 ,62.49 ,66.31 
03,021,01,002,0075,144,725,9,734,1018,0,0,0,0,0,0,0,66.31 ,72.10 ,66.31 
03,021,01,002,0076,145,656,7,663,963,0,0,0,0,0,0,0,66.31 ,68.85 ,66.31 
03,021,01,002,0077,146,580,7,587,1016,0,0,0,0,0,0,0,66.31 ,57.78 ,66.31 
03,021,01,002,0077,147,646,6,652,1089,0,0,0,0,0,0,0,66.31 ,59.87 ,66.31 
03,021,01,002,0078,148,921,9,930,1467,0,0,0,0,0,0,0,66.31 ,63.39 ,66.31 
03,021,01,002,0079,149,889,5,894,1411,0,0,0,0,0,0,0,66.31 ,63.36 ,66.31 
03,021,01,002,0080,150,824,4,828,1248,0,0,0,0,0,0,0,66.31 ,66.35 ,66.31 
03,021,01,002,0080,151,761,6,767,1198,0,0,0,0,0,0,0,66.31 ,64.02 ,66.31 
03,021,01,002,0081,152,418,3,421,596,0,0,0,0,0,0,0,66.31 ,70.64 ,66.31 
03,021,01,002,0082,153,407,5,412,588,0,0,0,0,0,0,0,66.31 ,70.07 ,66.31 
03,021,01,002,0083,154,612,0,612,986,0,0,0,0,0,0,0,66.31 ,62.07 ,66.31 
03,021,01,002,0084,155,517,4,521,725,0,0,0,0,0,0,0,66.31 ,71.86 ,66.31 
03,021,01,002,0085,156,1074,18,1092,1635,0,0,0,0,0,0,0,66.31 ,66.79 ,66.31 
03,021,01,002,0086,157,1122,12,1134,1775,0,0,0,0,0,0,0,66.31 ,63.89 ,66.31 
03,021,01,002,0087,158,525,5,530,733,0,0,0,0,0,0,0,66.31 ,72.31 ,66.31 
03,021,01,002,0088,159,1150,9,1159,1752,0,0,0,0,0,0,0,66.31 ,66.15 ,66.31 
03,021,01,003,0089,160,1064,9,1073,1892,0,0,0,0,0,0,0,66.31 ,56.71 ,66.31 
03,021,01,003,0089,161,614,4,618,921,0,0,0,0,0,0,0,66.31 ,67.10 ,66.31 
03,021,01,003,0090,162,526,4,530,855,0,0,0,0,0,0,0,66.31 ,61.99 ,66.31 
03,021,01,003,0090,163,899,10,909,1412,0,0,0,0,0,0,0,66.31 ,64.38 ,66.31 
03,021,01,003,0091,164,863,12,875,1335,0,0,0,0,0,0,0,66.31 ,65.54 ,66.31 
03,021,01,003,0091,165,619,10,629,998,0,0,0,0,0,0,0,66.31 ,63.03 ,66.31 
03,021,01,003,0092,166,809,3,812,1295,0,0,0,0,0,0,0,66.31 ,62.70 ,66.31 
03,021,01,003,0093,167,762,13,775,1142,0,0,0,0,0,0,0,66.31 ,67.86 ,66.31 
03,021,01,003,0093,168,632,9,641,924,0,0,0,0,0,0,0,66.31 ,69.37 ,66.31 
03,021,01,003,0094,169,438,5,443,687,0,0,0,0,0,0,0,66.31 ,64.48 ,66.31 
03,021,01,003,0095,170,487,2,489,784,0,0,0,0,0,0,0,66.31 ,62.37 ,66.31 
03,021,01,003,0096,171,550,6,556,809,0,0,0,0,0,0,0,66.31 ,68.73 ,66.31 
03,021,01,003,0097,172,486,8,494,740,0,0,0,0,0,0,0,66.31 ,66.76 ,66.31 
03,021,01,003,0098,173,442,3,445,655,0,0,0,0,0,0,0,66.31 ,67.94 ,66.31 
03,021,01,003,0099,174,618,9,627,993,0,0,0,0,0,0,0,66.31 ,63.14 ,66.31 
03,021,01,003,0100,175,545,9,554,870,0,0,0,0,0,0,0,66.31 ,63.68 ,66.31 
03,021,01,003,0101,176,667,11,678,1051,0,0,0,0,0,0,0,66.31 ,64.51 ,66.31 
03,021,01,003,0101,177,684,2,686,1181,0,0,0,0,0,0,0,66.31 ,58.09 ,66.31 
03,021,01,003,0102,178,675,12,687,1010,0,0,0,0,0,0,0,66.31 ,68.02 ,66.31 
03,021,01,003,0103,179,601,1,602,879,0,0,0,0,0,0,0,66.31 ,68.49 ,66.31 
03,021,01,003,0104,180,334,4,338,543,0,0,0,0,0,0,0,66.31 ,62.25 ,66.31 
03,021,01,003,0105,181,541,9,550,905,0,0,0,0,0,0,0,66.31 ,60.77 ,66.31 
03,021,01,003,0106,182,385,2,387,608,0,0,0,0,0,0,0,66.31 ,63.65 ,66.31 
03,021,01,003,0107,183,580,3,583,942,0,0,0,0,0,0,0,66.31 ,61.89 ,66.31 
03,021,01,003,0108,184,559,7,566,985,0,0,0,0,0,0,0,66.31 ,57.46 ,66.31 
03,021,01,003,0108,185,712,10,722,1165,0,0,0,0,0,0,0,66.31 ,61.97 ,66.31 
03,021,01,003,0109,186,495,5,500,850,0,0,0,0,0,0,0,66.31 ,58.82 ,66.31 
03,021,01,003,0110,187,351,3,354,562,0,0,0,0,0,0,0,66.31 ,62.99 ,66.31 
03,021,01,003,0111,188,192,2,194,263,0,0,0,0,0,0,0,66.31 ,73.76 ,66.31 
03,021,01,003,0112,189,286,0,286,422,0,0,0,0,0,0,0,66.31 ,67.77 ,66.31 
03,021,01,003,0113,190,272,4,276,474,0,0,0,0,0,0,0,66.31 ,58.23 ,66.31 
03,021,01,003,0114,191,190,0,190,283,0,0,0,0,0,0,0,66.31 ,67.14 ,66.31 
03,021,01,003,0115,192,596,3,599,943,0,0,0,0,0,0,0,66.31 ,63.52 ,66.31 
03,021,01,003,0116,193,769,6,775,1130,0,0,0,0,0,0,0,66.31 ,68.58 ,66.31 
03,021,01,003,0117,194,600,10,610,823,0,0,0,0,0,0,0,66.31 ,74.12 ,66.31 
03,021,01,003,0118,195,882,9,891,1460,0,0,0,0,0,0,0,66.31 ,61.03 ,66.31 
03,021,01,004,0119,196,544,9,553,948,0,0,0,0,0,0,0,66.31 ,58.33 ,66.31 
03,021,01,004,0120,197,594,6,600,994,0,0,0,0,0,0,0,66.31 ,60.36 ,66.31 
03,021,01,004,0121,198,515,4,519,978,0,0,0,0,0,0,0,66.31 ,53.07 ,66.31 
03,021,01,004,0122,199,724,10,734,1252,0,0,0,0,0,0,0,66.31 ,58.63 ,66.31 
03,021,01,004,0123,200,591,8,599,942,0,0,0,0,0,0,0,66.31 ,63.59 ,66.31 
03,021,01,004,0124,201,650,5,655,1055,0,0,0,0,0,0,0,66.31 ,62.09 ,66.31 
03,021,01,004,0125,202,715,12,727,1219,0,0,0,0,0,0,0,66.31 ,59.64 ,66.31 
03,021,01,004,0126,203,522,4,526,880,0,0,0,0,0,0,0,66.31 ,59.77 ,66.31 
03,021,01,004,0127,204,755,13,768,1186,0,0,0,0,0,0,0,66.31 ,64.76 ,66.31 
03,021,01,004,0128,205,570,14,584,939,0,0,0,0,0,0,0,66.31 ,62.19 ,66.31 
03,021,01,004,0129,206,469,2,471,795,0,0,0,0,0,0,0,66.31 ,59.25 ,66.31 
03,021,01,004,0129,207,556,11,567,937,0,0,0,0,0,0,0,66.31 ,60.51 ,66.31 
03,021,01,004,0130,208,572,7,579,945,0,0,0,0,0,0,0,66.31 ,61.27 ,66.31 
03,021,01,004,0130,209,637,9,646,972,0,0,0,0,0,0,0,66.31 ,66.46 ,66.31 
03,021,01,004,0131,210,573,10,583,976,0,0,0,0,0,0,0,66.31 ,59.73 ,66.31 
03,021,01,004,0131,211,643,7,650,1002,0,0,0,0,0,0,0,66.31 ,64.87 ,66.31 
03,021,01,004,0132,212,835,16,851,1472,0,0,0,0,0,0,0,66.31 ,57.81 ,66.31 
03,021,01,004,0132,213,876,8,884,1258,0,0,0,0,0,0,0,66.31 ,70.27 ,66.31 
03,021,01,004,0133,214,573,7,580,1022,0,0,0,0,0,0,0,66.31 ,56.75 ,66.31 
03,021,01,004,0133,215,603,4,607,1043,0,0,0,0,0,0,0,66.31 ,58.20 ,66.31 
03,021,01,004,0134,216,585,8,593,989,0,0,0,0,0,0,0,66.31 ,59.96 ,66.31 
03,021,01,004,0134,217,647,12,659,1029,0,0,0,0,0,0,0,66.31 ,64.04 ,66.31 
03,021,01,004,0135,218,910,14,924,1480,0,0,0,0,0,0,0,66.31 ,62.43 ,66.31 
03,021,01,004,0136,219,524,6,530,912,0,0,0,0,0,0,0,66.31 ,58.11 ,66.31 
03,021,01,004,0136,220,519,5,524,940,0,0,0,0,0,0,0,66.31 ,55.74 ,66.31 
03,021,01,004,0137,221,1108,13,1121,1710,0,0,0,0,0,0,0,66.31 ,65.56 ,66.31 
03,021,01,004,0137,222,800,17,817,1655,0,0,0,0,0,0,0,66.31 ,49.37 ,66.31 
03,021,01,004,0138,223,522,7,529,842,0,0,0,0,0,0,0,66.31 ,62.83 ,66.31 
03,021,01,004,0139,224,372,4,376,551,0,0,0,0,0,0,0,66.31 ,68.24 ,66.31 
03,021,01,004,0140,225,768,17,785,1280,0,0,0,0,0,0,0,66.31 ,61.33 ,66.31 
03,021,01,004,0141,226,675,2,677,1078,0,0,0,0,0,0,0,66.31 ,62.80 ,66.31 
03,021,01,004,0142,227,881,13,894,1422,0,0,0,0,0,0,0,66.31 ,62.87 ,66.31 
03,021,01,004,0143,228,440,8,448,753,0,0,0,0,0,0,0,66.31 ,59.50 ,66.31 
03,021,01,004,0144,229,334,2,336,585,0,0,0,0,0,0,0,66.31 ,57.44 ,66.31 
03,021,01,004,0145,230,472,10,482,824,0,0,0,0,0,0,0,66.31 ,58.50 ,66.31 
03,021,01,004,0145,231,415,5,420,712,0,0,0,0,0,0,0,66.31 ,58.99 ,66.31 
03,021,01,004,0146,232,732,7,739,1196,0,0,0,0,0,0,0,66.31 ,61.79 ,66.31 
03,021,01,004,0146,233,672,11,683,1158,0,0,0,0,0,0,0,66.31 ,58.98 ,66.31 
03,021,01,004,0146,234,647,6,653,1191,0,0,0,0,0,0,0,66.31 ,54.83 ,66.31 
03,021,01,004,0146,235,741,12,753,1246,0,0,0,0,0,0,0,66.31 ,60.43 ,66.31 
03,021,01,004,0147,236,897,8,905,1560,0,0,0,0,0,0,0,66.31 ,58.01 ,66.31 
03,021,01,004,0148,237,501,6,507,891,0,0,0,0,0,0,0,66.31 ,56.90 ,66.31 
03,021,01,004,0148,238,562,10,572,1005,0,0,0,0,0,0,0,66.31 ,56.92 ,66.31 
03,021,01,004,0149,239,972,13,985,1624,0,0,0,0,0,0,0,66.31 ,60.65 ,66.31 
03,021,01,004,0150,240,721,12,733,1304,0,0,0,0,0,0,0,66.31 ,56.21 ,66.31 
03,021,01,004,0151,241,946,13,959,1550,0,0,0,0,0,0,0,66.31 ,61.87 ,66.31 
03,021,01,004,0152,242,642,7,649,1115,0,0,0,0,0,0,0,66.31 ,58.21 ,66.31 
03,021,01,004,0152,243,606,6,612,1124,0,0,0,0,0,0,0,66.31 ,54.45 ,66.31 
03,021,01,004,0153,244,756,4,760,1252,0,0,0,0,0,0,0,66.31 ,60.70 ,66.31 
03,021,01,004,0153,245,647,6,653,1066,0,0,0,0,0,0,0,66.31 ,61.26 ,66.31 
03,021,01,004,0153,246,582,4,586,987,0,0,0,0,0,0,0,66.31 ,59.37 ,66.31 
03,021,01,004,0154,247,707,5,712,1264,0,0,0,0,0,0,0,66.31 ,56.33 ,66.31 
03,021,01,004,0154,248,645,2,647,1074,0,0,0,0,0,0,0,66.31 ,60.24 ,66.31 
03,021,01,004,0154,249,827,10,837,1499,0,0,0,0,0,0,0,66.31 ,55.84 ,66.31 
03,021,01,004,0154,250,702,6,708,1250,0,0,0,0,0,0,0,66.31 ,56.64 ,66.31 
03,021,01,004,0155,251,693,5,698,1257,0,0,0,0,0,0,0,66.31 ,55.53 ,66.31 
03,021,01,004,0155,252,893,9,902,1763,0,0,0,0,0,0,0,66.31 ,51.16 ,66.31 
03,021,01,004,0155,253,525,9,534,915,0,0,0,0,0,0,0,66.31 ,58.36 ,66.31 
03,021,01,004,0156,254,795,9,804,1205,0,0,0,0,0,0,0,66.31 ,66.72 ,66.31 
03,021,01,004,0157,255,893,10,903,1426,0,0,0,0,0,0,0,66.31 ,63.32 ,66.31 
03,021,01,004,0158,256,666,5,671,1033,0,0,0,0,0,0,0,66.31 ,64.96 ,66.31 
03,021,01,004,0158,257,667,7,674,1181,0,0,0,0,0,0,0,66.31 ,57.07 ,66.31 
03,021,01,004,0158,258,685,6,691,1111,0,0,0,0,0,0,0,66.31 ,62.20 ,66.31 
03,021,01,004,0158,259,671,12,683,1088,0,0,0,0,0,0,0,66.31 ,62.78 ,66.31 
03,021,01,004,0159,260,820,4,824,1275,0,0,0,0,0,0,0,66.31 ,64.63 ,66.31 
03,021,01,004,0159,261,785,6,791,1274,0,0,0,0,0,0,0,66.31 ,62.09 ,66.31 
03,021,01,004,0159,262,768,5,773,1179,0,0,0,0,0,0,0,66.31 ,65.56 ,66.31 
03,021,01,004,0159,263,846,11,857,1305,0,0,0,0,0,0,0,66.31 ,65.67 ,66.31 
03,021,01,004,0159,264,779,7,786,1321,0,0,0,0,0,0,0,66.31 ,59.50 ,66.31 
03,021,01,004,0160,265,775,8,783,1318,0,0,0,0,0,0,0,66.31 ,59.41 ,66.31 
03,021,01,004,0160,266,881,21,902,1478,0,0,0,0,0,0,0,66.31 ,61.03 ,66.31 
03,021,01,004,0160,267,742,7,749,1330,0,0,0,0,0,0,0,66.31 ,56.32 ,66.31 
03,021,01,004,0160,268,791,10,801,1230,0,0,0,0,0,0,0,66.31 ,65.12 ,66.31 
03,021,01,005,0161,269,806,4,810,1182,0,0,0,0,0,0,0,66.31 ,68.53 ,66.31 
03,021,01,005,0162,270,754,11,765,1132,0,0,0,0,0,0,0,66.31 ,67.58 ,66.31 
03,021,01,005,0163,271,721,10,731,1203,0,0,0,0,0,0,0,66.31 ,60.76 ,66.31 
03,021,01,005,0164,272,828,9,837,1441,0,0,0,0,0,0,0,66.31 ,58.08 ,66.31 
03,021,01,005,0165,273,439,5,444,702,0,0,0,0,0,0,0,66.31 ,63.25 ,66.31 
03,021,01,005,0166,274,401,2,403,706,0,0,0,0,0,0,0,66.31 ,57.08 ,66.31 
03,021,01,005,0167,275,272,1,273,442,0,0,0,0,0,0,0,66.31 ,61.76 ,66.31 
03,021,01,005,0168,276,257,0,257,447,0,0,0,0,0,0,0,66.31 ,57.49 ,66.31 
03,021,01,005,0169,277,744,7,751,1233,0,0,0,0,0,0,0,66.31 ,60.91 ,66.31 
03,021,01,005,0170,278,285,1,286,423,0,0,0,0,0,0,0,66.31 ,67.61 ,66.31 
03,021,01,005,0171,279,472,7,479,783,0,0,0,0,0,0,0,66.31 ,61.17 ,66.31 
03,021,01,005,0172,280,373,7,380,577,0,0,0,0,0,0,0,66.31 ,65.86 ,66.31 
03,021,01,005,0173,281,547,4,551,913,0,0,0,0,0,0,0,66.31 ,60.35 ,66.31 
03,021,01,005,0174,282,307,2,309,483,0,0,0,0,0,0,0,66.31 ,63.98 ,66.31 
03,021,01,005,0175,283,288,4,292,477,0,0,0,0,0,0,0,66.31 ,61.22 ,66.31 
03,021,01,005,0176,284,670,4,674,1076,0,0,0,0,0,0,0,66.31 ,62.64 ,66.31 
03,021,01,005,0177,285,623,4,627,1230,0,0,0,0,0,0,0,66.31 ,50.98 ,66.31 
03,021,01,005,0177,286,623,8,631,1074,0,0,0,0,0,0,0,66.31 ,58.75 ,66.31 
03,021,01,005,0178,287,658,5,663,1065,0,0,0,0,0,0,0,66.31 ,62.25 ,66.31 
03,021,01,005,0179,288,881,6,887,1462,0,0,0,0,0,0,0,66.31 ,60.67 ,66.31 
03,021,01,005,0180,289,304,6,310,520,0,0,0,0,0,0,0,66.31 ,59.62 ,66.31 
03,021,01,005,0181,290,365,6,371,579,0,0,0,0,0,0,0,66.31 ,64.08 ,66.31 
03,021,01,005,0182,291,468,6,474,688,0,0,0,0,0,0,0,66.31 ,68.90 ,66.31 
03,021,01,005,0183,292,473,4,477,717,0,0,0,0,0,0,0,66.31 ,66.53 ,66.31 
03,021,01,005,0184,293,642,7,649,1028,0,0,0,0,0,0,0,66.31 ,63.13 ,66.31 
03,021,01,005,0185,294,308,5,313,517,0,0,0,0,0,0,0,66.31 ,60.54 ,66.31 
03,021,01,005,0186,295,402,4,406,686,0,0,0,0,0,0,0,66.31 ,59.18 ,66.31 
03,021,01,005,0187,296,328,7,335,544,0,0,0,0,0,0,0,66.31 ,61.58 ,66.31 
03,021,01,005,0188,297,368,4,372,641,0,0,0,0,0,0,0,66.31 ,58.03 ,66.31 
03,021,01,005,0189,298,459,5,464,746,0,0,0,0,0,0,0,66.31 ,62.20 ,66.31 
03,021,01,005,0190,299,420,6,426,671,0,0,0,0,0,0,0,66.31 ,63.49 ,66.31 
03,021,01,005,0191,300,474,8,482,773,0,0,0,0,0,0,0,66.31 ,62.35 ,66.31 
03,021,01,005,0192,301,879,10,889,1528,0,0,0,0,0,0,0,66.31 ,58.18 ,66.31 
03,021,01,005,0193,302,1046,11,1057,1735,0,0,0,0,0,0,0,66.31 ,60.92 ,66.31 
03,021,01,005,0194,303,977,6,983,1650,0,0,0,0,0,0,0,66.31 ,59.58 ,66.31 
03,021,01,005,0194,304,835,6,841,1526,0,0,0,0,0,0,0,66.31 ,55.11 ,66.31 
03,021,01,006,0195,305,365,7,372,522,0,0,0,0,0,0,0,66.31 ,71.26 ,66.31 
03,021,01,006,0196,306,1086,15,1101,1796,0,0,0,0,0,0,0,66.31 ,61.30 ,66.31 
03,021,01,006,0196,307,765,11,776,1346,0,0,0,0,0,0,0,66.31 ,57.65 ,66.31 
03,021,01,006,0197,308,980,13,993,1474,0,0,0,0,0,0,0,66.31 ,67.37 ,66.31 
03,021,01,006,0197,309,852,16,868,1305,0,0,0,0,0,0,0,66.31 ,66.51 ,66.31 
03,021,01,006,0197,310,724,10,734,1193,0,0,0,0,0,0,0,66.31 ,61.53 ,66.31 
03,021,01,006,0198,311,698,11,709,1033,0,0,0,0,0,0,0,66.31 ,68.64 ,66.31 
03,021,01,006,0198,312,686,12,698,1050,0,0,0,0,0,0,0,66.31 ,66.48 ,66.31 
03,021,01,006,0199,313,852,9,861,1234,0,0,0,0,0,0,0,66.31 ,69.77 ,66.31 
03,021,01,006,0199,314,901,15,916,1459,0,0,0,0,0,0,0,66.31 ,62.78 ,66.31 
03,021,01,006,0200,315,704,15,719,1131,0,0,0,0,0,0,0,66.31 ,63.57 ,66.31 
03,021,01,006,0200,316,732,9,741,1269,0,0,0,0,0,0,0,66.31 ,58.39 ,66.31 
03,021,01,006,0201,317,771,8,779,1121,0,0,0,0,0,0,0,66.31 ,69.49 ,66.31 
03,021,01,006,0201,318,674,5,679,1158,0,0,0,0,0,0,0,66.31 ,58.64 ,66.31 
03,021,01,006,0202,319,1279,20,1299,2001,0,0,0,0,0,0,0,66.31 ,64.92 ,66.31 
03,021,01,006,0202,320,1001,11,1012,1619,0,0,0,0,0,0,0,66.31 ,62.51 ,66.31 
03,021,01,006,0203,321,693,7,700,1139,0,0,0,0,0,0,0,66.31 ,61.46 ,66.31 
03,021,01,006,0203,322,673,4,677,1151,0,0,0,0,0,0,0,66.31 ,58.82 ,66.31 
03,021,01,006,0204,323,1102,18,1120,1804,0,0,0,0,0,0,0,66.31 ,62.08 ,66.31 
03,021,01,006,0205,324,337,5,342,477,0,0,0,0,0,0,0,66.31 ,71.70 ,66.31 
03,021,01,006,0205,325,1087,13,1100,1536,0,0,0,0,0,0,0,66.31 ,71.61 ,66.31 
03,021,01,006,0206,326,803,12,815,1380,0,0,0,0,0,0,0,66.31 ,59.06 ,66.31 
03,021,01,006,0206,327,866,14,880,1484,0,0,0,0,0,0,0,66.31 ,59.30 ,66.31 
03,021,01,006,0207,328,751,16,767,1165,0,0,0,0,0,0,0,66.31 ,65.84 ,66.31 
03,021,01,006,0207,329,765,7,772,1336,0,0,0,0,0,0,0,66.31 ,57.78 ,66.31 
03,021,01,006,0208,330,866,10,876,1584,0,0,0,0,0,0,0,66.31 ,55.30 ,66.31 
03,021,01,006,0208,331,788,8,796,1421,0,0,0,0,0,0,0,66.31 ,56.02 ,66.31 
03,021,01,006,0209,332,788,18,806,1278,0,0,0,0,0,0,0,66.31 ,63.07 ,66.31 
03,021,01,006,0209,333,798,7,805,1334,0,0,0,0,0,0,0,66.31 ,60.34 ,66.31 
03,021,01,006,0210,334,1099,7,1106,1951,0,0,0,0,0,0,0,66.31 ,56.69 ,66.31 
03,021,01,006,0210,335,962,13,975,1738,0,0,0,0,0,0,0,66.31 ,56.10 ,66.31 
03,021,01,006,0210,336,1097,14,1111,1798,0,0,0,0,0,0,0,66.31 ,61.79 ,66.31 
03,021,01,006,0211,337,883,15,898,1240,0,0,0,0,0,0,0,66.31 ,72.42 ,66.31 
03,021,01,006,0212,338,808,11,819,1319,0,0,0,0,0,0,0,66.31 ,62.09 ,66.31 
03,021,01,006,0212,339,893,15,908,1427,0,0,0,0,0,0,0,66.31 ,63.63 ,66.31 
03,021,01,006,0213,340,594,9,603,888,0,0,0,0,0,0,0,66.31 ,67.91 ,66.31 
03,021,01,006,0214,341,690,11,701,1084,0,0,0,0,0,0,0,66.31 ,64.67 ,66.31 
03,021,01,006,0215,342,1001,10,1011,1566,0,0,0,0,0,0,0,66.31 ,64.56 ,66.31 
03,021,01,006,0216,343,774,13,787,1166,0,0,0,0,0,0,0,66.31 ,67.50 ,66.31 
03,021,01,006,0217,344,1098,18,1116,1620,0,0,0,0,0,0,0,66.31 ,68.89 ,66.31 
03,021,01,006,0218,345,636,3,639,787,0,0,0,0,0,0,0,66.31 ,81.19 ,66.31 
03,021,01,006,0219,346,662,9,671,1002,0,0,0,0,0,0,0,66.31 ,66.97 ,66.31 
03,021,01,006,0219,347,588,10,598,957,0,0,0,0,0,0,0,66.31 ,62.49 ,66.31 
03,021,01,006,0220,348,938,14,952,1356,0,0,0,0,0,0,0,66.31 ,70.21 ,66.31 
03,021,01,006,0221,349,685,8,693,1097,0,0,0,0,0,0,0,66.31 ,63.17 ,66.31 
03,021,01,006,0221,350,670,15,685,1153,0,0,0,0,0,0,0,66.31 ,59.41 ,66.31 
03,021,01,006,0222,351,575,12,587,988,0,0,0,0,0,0,0,66.31 ,59.41 ,66.31 
03,021,01,006,0222,352,642,6,648,1174,0,0,0,0,0,0,0,66.31 ,55.20 ,66.31 
03,021,01,006,0223,353,789,10,799,1357,0,0,0,0,0,0,0,66.31 ,58.88 ,66.31 
03,021,01,006,0223,354,667,9,676,1205,0,0,0,0,0,0,0,66.31 ,56.10 ,66.31 
03,021,01,006,0224,355,505,5,510,785,0,0,0,0,0,0,0,66.31 ,64.97 ,66.31 
03,021,01,006,0224,356,1166,22,1188,2039,0,0,0,0,0,0,0,66.31 ,58.26 ,66.31 
03,021,01,006,0225,357,648,8,656,1104,0,0,0,0,0,0,0,66.31 ,59.42 ,66.31 
03,021,01,006,0225,358,673,7,680,1215,0,0,0,0,0,0,0,66.31 ,55.97 ,66.31 
03,021,01,006,0226,359,808,11,819,1413,0,0,0,0,0,0,0,66.31 ,57.96 ,66.31 
03,021,01,006,0226,360,627,8,635,1052,0,0,0,0,0,0,0,66.31 ,60.36 ,66.31 
03,021,01,006,0227,361,804,10,814,1330,0,0,0,0,0,0,0,66.31 ,61.20 ,66.31 
03,021,01,006,0227,362,784,11,795,1298,0,0,0,0,0,0,0,66.31 ,61.25 ,66.31 
03,021,01,006,0228,363,1050,22,1072,1746,0,0,0,0,0,0,0,66.31 ,61.40 ,66.31 
03,021,01,006,0228,364,1021,10,1031,1667,0,0,0,0,0,0,0,66.31 ,61.85 ,66.31 
03,021,01,006,0229,365,856,15,871,1419,0,0,0,0,0,0,0,66.31 ,61.38 ,66.31 
03,021,01,006,0230,366,890,16,906,1589,0,0,0,0,0,0,0,66.31 ,57.02 ,66.31 
03,021,01,006,0230,367,418,6,424,728,0,0,0,0,0,0,0,66.31 ,58.24 ,66.31 
03,021,01,006,0231,368,955,14,969,1720,0,0,0,0,0,0,0,66.31 ,56.34 ,66.31 
03,021,01,006,0231,369,1102,15,1117,1979,0,0,0,0,0,0,0,66.31 ,56.44 ,66.31 
03,021,01,006,0232,370,835,11,846,1330,0,0,0,0,0,0,0,66.31 ,63.61 ,66.31 
03,021,01,006,0232,371,1093,13,1106,1819,0,0,0,0,0,0,0,66.31 ,60.80 ,66.31 
03,021,01,006,0233,372,575,5,580,966,0,0,0,0,0,0,0,66.31 ,60.04 ,66.31 
03,021,01,006,0233,373,518,2,520,897,0,0,0,0,0,0,0,66.31 ,57.97 ,66.31 
03,021,01,006,0234,374,931,10,941,1312,0,0,0,0,0,0,0,66.31 ,71.72 ,66.31 
03,021,01,006,0235,375,447,8,455,614,0,0,0,0,0,0,0,66.31 ,74.10 ,66.31 
03,021,01,006,0235,376,1129,10,1139,1568,0,0,0,0,0,0,0,66.31 ,72.64 ,66.31 
03,021,01,006,0236,377,858,9,867,1115,0,0,0,0,0,0,0,66.31 ,77.76 ,66.31 
03,021,01,006,0237,378,611,7,618,875,0,0,0,0,0,0,0,66.31 ,70.63 ,66.31 
03,021,01,006,0238,379,818,8,826,1091,0,0,0,0,0,0,0,66.31 ,75.71 ,66.31 
03,021,01,006,0239,380,557,7,564,676,0,0,0,0,0,0,0,66.31 ,83.43 ,66.31 
03,021,01,006,0240,381,336,4,340,444,0,0,0,0,0,0,0,66.31 ,76.58 ,66.31 
03,021,01,006,0240,382,354,5,359,501,0,0,0,0,0,0,0,66.31 ,71.66 ,66.31 
03,021,01,006,0241,383,726,6,732,990,0,0,0,0,0,0,0,66.31 ,73.94 ,66.31 
03,021,01,006,0242,384,446,6,452,605,0,0,0,0,0,0,0,66.31 ,74.71 ,66.31 
03,021,01,006,0243,385,953,11,964,1368,0,0,0,0,0,0,0,66.31 ,70.47 ,66.31 
03,021,01,006,0244,386,404,8,412,558,0,0,0,0,0,0,0,66.31 ,73.84 ,66.31 
03,021,01,007,0245,387,545,5,550,825,0,0,0,0,0,0,0,66.31 ,66.67 ,66.31 
03,021,01,007,0246,388,530,6,536,857,0,0,0,0,0,0,0,66.31 ,62.54 ,66.31 
03,021,01,007,0247,389,256,1,257,360,0,0,0,0,0,0,0,66.31 ,71.39 ,66.31 
03,021,01,007,0248,390,223,5,228,389,0,0,0,0,0,0,0,66.31 ,58.61 ,66.31 
03,021,01,007,0249,391,676,3,679,1051,0,0,0,0,0,0,0,66.31 ,64.61 ,66.31 
03,021,01,007,0249,392,724,4,728,1052,0,0,0,0,0,0,0,66.31 ,69.20 ,66.31 
03,021,01,007,0250,393,242,1,243,344,0,0,0,0,0,0,0,66.31 ,70.64 ,66.31 
03,021,01,007,0251,394,892,8,900,1386,0,0,0,0,0,0,0,66.31 ,64.94 ,66.31 
03,021,01,007,0252,395,900,7,907,1498,0,0,0,0,0,0,0,66.31 ,60.55 ,66.31 
03,021,01,007,0252,396,1013,4,1017,1586,0,0,0,0,0,0,0,66.31 ,64.12 ,66.31 
03,021,01,007,0252,397,913,14,927,1476,0,0,0,0,0,0,0,66.31 ,62.80 ,66.31 
03,021,01,007,0253,398,306,2,308,464,0,0,0,0,0,0,0,66.31 ,66.38 ,66.31 
03,021,01,007,0254,399,356,6,362,486,0,0,0,0,0,0,0,66.31 ,74.49 ,66.31 
03,021,01,007,0255,400,1052,12,1064,1908,0,0,0,0,0,0,0,66.31 ,55.77 ,66.31 
03,021,01,007,0256,401,657,4,661,1375,0,0,0,0,0,0,0,66.31 ,48.07 ,66.31 
03,021,01,007,0257,402,774,7,781,1394,0,0,0,0,0,0,0,66.31 ,56.03 ,66.31 
03,021,01,007,0257,403,699,5,704,1397,0,0,0,0,0,0,0,66.31 ,50.39 ,66.31 
03,021,01,007,0258,404,703,6,709,1408,0,0,0,0,0,0,0,66.31 ,50.36 ,66.31 
03,021,01,007,0258,405,711,4,715,1259,0,0,0,0,0,0,0,66.31 ,56.79 ,66.31 
03,021,01,007,0259,406,684,9,693,1130,0,0,0,0,0,0,0,66.31 ,61.33 ,66.31 
03,021,01,007,0259,407,485,2,487,935,0,0,0,0,0,0,0,66.31 ,52.09 ,66.31 
03,021,01,007,0260,408,486,1,487,893,0,0,0,0,0,0,0,66.31 ,54.54 ,66.31 
03,021,01,007,0260,409,475,2,477,970,0,0,0,0,0,0,0,66.31 ,49.18 ,66.31 
03,021,01,007,0261,410,635,3,638,1426,0,0,0,0,0,0,0,66.31 ,44.74 ,66.31 
03,021,01,007,0261,411,583,3,586,1236,0,0,0,0,0,0,0,66.31 ,47.41 ,66.31 
03,021,01,007,0262,412,502,5,507,885,0,0,0,0,0,0,0,66.31 ,57.29 ,66.31 
04,001,01,001,0001,1,910,6,916,1553,0,0,0,0,0,0,0,66.31 ,58.98 ,66.31 
04,001,01,001,0002,2,508,8,516,842,0,0,0,0,0,0,0,66.31 ,61.28 ,66.31 
04,001,01,001,0002,3,620,14,634,1027,0,0,0,0,0,0,0,66.31 ,61.73 ,66.31 
04,001,01,001,0003,4,549,9,558,940,0,0,0,0,0,0,0,66.31 ,59.36 ,66.31 
04,001,01,001,0003,5,558,6,564,983,0,0,0,0,0,0,0,66.31 ,57.38 ,66.31 
04,001,01,001,0003,6,607,14,621,978,0,0,0,0,0,0,0,66.31 ,63.50 ,66.31 
04,001,01,001,0004,7,755,12,767,1341,0,0,0,0,0,0,0,66.31 ,57.20 ,66.31 
04,001,01,001,0005,8,625,12,637,1062,0,0,0,0,0,0,0,66.31 ,59.98 ,66.31 
04,001,01,001,0006,9,383,5,388,575,0,0,0,0,0,0,0,66.31 ,67.48 ,66.31 
04,001,01,001,0007,10,695,16,711,1133,0,0,0,0,0,0,0,66.31 ,62.75 ,66.31 
04,001,01,001,0008,11,304,7,311,565,0,0,0,0,0,0,0,66.31 ,55.04 ,66.31 
04,001,01,002,0009,12,696,11,707,1069,0,0,0,0,0,0,0,66.31 ,66.14 ,66.31 
04,001,01,002,0010,13,771,12,783,1314,0,0,0,0,0,0,0,66.31 ,59.59 ,66.31 
04,001,01,002,0011,14,606,11,617,1029,0,0,0,0,0,0,0,66.31 ,59.96 ,66.31 
04,001,01,002,0012,15,698,13,711,1293,0,0,0,0,0,0,0,66.31 ,54.99 ,66.31 
04,001,01,002,0013,16,606,7,613,990,0,0,0,0,0,0,0,66.31 ,61.92 ,66.31 
04,001,01,002,0014,17,239,6,245,442,0,0,0,0,0,0,0,66.31 ,55.43 ,66.31 
04,001,01,003,0015,18,554,10,564,782,0,0,0,0,0,0,0,66.31 ,72.12 ,66.31 
04,001,01,003,0015,19,495,3,498,808,0,0,0,0,0,0,0,66.31 ,61.63 ,66.31 
04,001,01,003,0016,20,730,11,741,1164,0,0,0,0,0,0,0,66.31 ,63.66 ,66.31 
04,001,01,003,0017,21,301,4,305,514,0,0,0,0,0,0,0,66.31 ,59.34 ,66.31 
04,001,01,003,0018,22,312,4,316,500,0,0,0,0,0,0,0,66.31 ,63.20 ,66.31 
04,001,01,003,0019,23,327,3,330,527,0,0,0,0,0,0,0,66.31 ,62.62 ,66.31 
04,001,01,003,0020,24,802,19,821,1298,0,0,0,0,0,0,0,66.31 ,63.25 ,66.31 
04,001,01,003,0021,25,553,11,564,799,0,0,0,0,0,0,0,66.31 ,70.59 ,66.31 
04,001,01,003,0022,26,653,16,669,1078,0,0,0,0,0,0,0,66.31 ,62.06 ,66.31 
04,001,01,004,0023,27,522,7,529,873,0,0,0,0,0,0,0,66.31 ,60.60 ,66.31 
04,001,01,004,0023,28,512,4,516,828,0,0,0,0,0,0,0,66.31 ,62.32 ,66.31 
04,001,01,004,0024,29,449,6,455,675,0,0,0,0,0,0,0,66.31 ,67.41 ,66.31 
04,001,01,004,0025,30,432,7,439,756,0,0,0,0,0,0,0,66.31 ,58.07 ,66.31 
04,001,01,004,0026,31,274,7,281,509,0,0,0,0,0,0,0,66.31 ,55.21 ,66.31 
04,001,01,004,0027,32,321,3,324,629,0,0,0,0,0,0,0,66.31 ,51.51 ,66.31 
04,001,01,004,0028,33,373,6,379,641,0,0,0,0,0,0,0,66.31 ,59.13 ,66.31 
04,001,01,004,0029,34,224,4,228,405,0,0,0,0,0,0,0,66.31 ,56.30 ,66.31 
04,001,01,004,0030,35,381,11,392,671,0,0,0,0,0,0,0,66.31 ,58.42 ,66.31 
04,001,01,005,0031,36,609,10,619,1022,0,0,0,0,0,0,0,66.31 ,60.57 ,66.31 
04,001,01,005,0032,37,243,8,251,445,0,0,0,0,0,0,0,66.31 ,56.40 ,66.31 
04,001,01,005,0033,38,352,7,359,684,0,0,0,0,0,0,0,66.31 ,52.49 ,66.31 
04,001,01,005,0034,39,246,2,248,427,0,0,0,0,0,0,0,66.31 ,58.08 ,66.31 
04,001,01,005,0035,40,491,9,500,869,0,0,0,0,0,0,0,66.31 ,57.54 ,66.31 
04,001,01,006,0036,41,38,0,38,276,0,0,0,0,0,0,0,66.31 ,13.77 ,66.31 
04,002,01,001,0001,1,568,63,631,996,0,0,0,0,0,0,0,66.31 ,63.35 ,66.31 
04,002,01,001,0002,2,477,35,512,790,0,0,0,0,0,0,0,66.31 ,64.81 ,66.31 
04,002,01,001,0003,3,443,52,495,852,0,0,0,0,0,0,0,66.31 ,58.10 ,66.31 
04,002,01,002,0004,4,277,76,353,666,0,0,0,0,0,0,0,66.31 ,53.00 ,66.31 
04,002,01,002,0005,5,122,28,150,263,0,0,0,0,0,0,0,66.31 ,57.03 ,66.31 
04,002,01,003,0006,6,140,19,159,426,0,0,0,0,0,0,0,66.31 ,37.32 ,66.31 
04,002,01,003,0007,7,113,9,122,226,0,0,0,0,0,0,0,66.31 ,53.98 ,66.31 
04,002,01,004,0008,8,303,30,333,515,0,0,0,0,0,0,0,66.31 ,64.66 ,66.31 
