00,000,00,000,0000,0,2024759,34666,2059425,3127793,4118022,174 ,94,120 ,54,59,35,75.95 ,65.84 ,54.02 
01,000,00,000,0000,0,1269173,20601,1289774,1996635,2615536,101 ,51,71 ,30,32,19,76.34 ,64.60 ,50.50 
01,000,01,000,0000,0,266443,3356,269799,409850,534932,20 ,10,14 ,6,6,4,76.62 ,65.83 ,50.00 
01,000,02,000,0000,0,176711,2878,179589,275962,373817,14 ,7,9 ,5,4,3,73.82 ,65.08 ,50.00 
01,000,03,000,0000,0,211912,4320,216232,335800,438378,16 ,9,11 ,5,6,3,76.60 ,64.39 ,56.25 
01,000,04,000,0000,0,167793,3217,171010,269362,344508,12 ,7,9 ,3,4,3,78.19 ,63.49 ,58.33 
01,000,05,000,0000,0,172250,3020,175270,272262,351734,17 ,7,14 ,3,5,2,77.41 ,64.38 ,41.18 
01,000,06,000,0000,0,274064,3810,277874,433399,572167,22 ,11,14 ,8,7,4,75.75 ,64.12 ,50.00 
02,000,00,000,0000,0,755586,14065,769651,1131158,1502486,73 ,43,49 ,24,27,16,75.29 ,68.04 ,58.90 
02,000,01,000,0000,0,94362,1528,95890,136158,175064,9 ,5,6 ,3,3,2,77.78 ,70.43 ,55.56 
02,000,02,000,0000,0,168127,2903,171030,250411,344239,17 ,10,10 ,7,6,4,72.74 ,68.30 ,58.82 
02,000,03,000,0000,0,175582,3295,178877,267096,357164,17 ,10,14 ,3,7,3,74.78 ,66.97 ,58.82 
02,000,04,000,0000,0,144782,2661,147443,218122,279791,14 ,8,10 ,4,6,2,77.96 ,67.60 ,57.14 
02,000,05,000,0000,0,172733,3678,176411,259371,346228,16 ,10,9 ,7,5,5,74.91 ,68.01 ,62.50 
01,000,01,001,0000,0,122368,1483,123851,188850,474265,2,1,2,0,1,0,70.83 ,65.58 ,50.00 
01,000,01,002,0000,0,144075,1873,145948,221000,559558,6,1,6,0,1,0,73.50 ,66.04 ,16.67 
01,000,02,003,0000,0,122532,1957,124489,191165,1530298,3,1,3,0,1,0,71.42 ,65.12 ,33.33 
01,000,02,004,0000,0,54179,921,55100,84797,1315020,3,1,2,1,1,0,73.08 ,64.98 ,33.33 
01,000,03,005,0000,0,98885,2111,100996,156627,537345,4,1,4,0,1,0,74.24 ,64.48 ,25.00 
01,000,03,006,0000,0,113027,2209,115236,179173,734052,3,1,2,1,0,1,75.40 ,64.32 ,33.33 
01,000,04,007,0000,0,105268,2038,107306,171025,556365,2,1,2,0,1,0,75.92 ,62.74 ,50.00 
01,000,04,008,0000,0,62525,1179,63704,98337,1105050,4,1,4,0,1,0,75.53 ,64.78 ,25.00 
01,000,05,009,0000,0,73598,1463,75061,118156,1240203,2,1,2,0,1,0,74.89 ,63.53 ,50.00 
01,000,05,010,0000,0,98652,1557,100209,154106,898611,4,1,3,1,1,0,74.87 ,65.03 ,25.00 
01,000,06,011,0000,0,148713,2207,150920,239391,239184,3,1,3,0,1,0,74.75 ,63.04 ,33.33 
01,000,06,012,0000,0,125351,1603,126954,194008,347641,4,1,4,0,1,0,74.43 ,65.44 ,25.00 
02,000,01,001,0000,0,16363,250,16613,23099,92362,3,1,3,0,1,0,76.25 ,71.92 ,33.33 
02,000,01,002,0000,0,61717,1075,62792,89722,392084,4,1,4,0,1,0,74.56 ,69.99 ,25.00 
02,000,01,003,0000,0,16282,203,16485,23337,389488,2,1,2,0,1,0,71.17 ,70.64 ,50.00 
02,000,02,004,0000,0,88172,1757,89929,131930,1029644,4,1,2,2,1,0,70.90 ,68.16 ,25.00 
02,000,02,005,0000,0,79955,1146,81101,118481,271949,2,1,0,2,0,1,72.09 ,68.45 ,50.00 
02,000,03,006,0000,0,175582,3295,178877,267096,756751,3,1,2,1,1,0,73.78 ,66.97 ,33.33 
02,000,04,007,0000,0,30241,553,30794,45928,68265,3,1,3,0,1,0,76.23 ,67.05 ,33.33 
02,000,04,008,0000,0,16137,292,16429,24718,10527,3,1,3,0,1,0,77.61 ,66.47 ,33.33 
02,000,04,009,0000,0,98404,1816,100220,147476,155496,5,1,4,1,0,1,66.42 ,67.96 ,20.00 
02,000,05,010,0000,0,100311,2344,102655,150844,81169,2,1,1,1,1,0,66.90 ,68.05 ,50.00 
02,000,05,011,0000,0,72422,1334,73756,108527,83691,3,1,3,0,1,0,66.61 ,67.96 ,33.33 
01,000,01,001,0001,0,2210,20,2230,3347,118173,3,1,3,0,1,0,71.99 ,66.63 ,33.33 
01,000,01,001,0002,0,2410,35,2445,3664,163727,7,1,6,1,1,0,73.82 ,66.73 ,14.29 
01,000,01,001,0003,0,2810,40,2850,4301,46538,2,1,2,0,1,0,73.84 ,66.26 ,50.00 
01,000,01,001,0004,0,3767,31,3798,5436,231133,5,1,5,0,1,0,66.46 ,69.87 ,20.00 
01,000,01,001,0005,0,3717,40,3757,5654,168134,7,1,6,1,1,0,65.91 ,66.45 ,14.29 
01,000,01,001,0006,0,3954,40,3994,6111,70467,3,1,3,0,1,0,67.30 ,65.36 ,33.33 
01,000,01,001,0007,0,3713,59,3772,5656,62493,2,1,1,1,1,0,67.71 ,66.69 ,50.00 
01,000,01,001,0008,0,4190,52,4242,6375,52316,4,1,3,1,1,0,66.01 ,66.54 ,25.00 
01,000,01,001,0009,0,4266,56,4322,6743,20114,4,1,3,1,0,1,73.10 ,64.10 ,25.00 
01,000,01,001,0010,0,3624,53,3677,5730,7445,4,1,4,0,1,0,78.94 ,64.17 ,25.00 
01,000,01,001,0011,0,2426,30,2456,3618,5994,2,1,2,0,1,0,81.73 ,67.88 ,50.00 
01,000,01,001,0012,0,2569,31,2600,3677,22788,2,1,1,1,1,0,71.42 ,70.71 ,50.00 
01,000,01,001,0013,0,3380,38,3418,5160,10850,2,1,2,0,1,0,75.86 ,66.24 ,50.00 
01,000,01,001,0014,0,2756,31,2787,4074,29160,4,1,4,0,1,0,69.65 ,68.41 ,25.00 
01,000,01,001,0015,0,2483,30,2513,3795,5944,2,1,2,0,1,0,85.70 ,66.22 ,50.00 
01,000,01,001,0016,0,2618,38,2656,4176,10298,3,1,3,0,1,0,81.65 ,63.60 ,33.33 
01,000,01,001,0017,0,4519,42,4561,6888,13552,2,1,2,0,1,0,78.87 ,66.22 ,50.00 
01,000,01,001,0018,0,2624,31,2655,4026,21379,2,1,1,1,1,0,71.43 ,65.95 ,50.00 
01,000,01,001,0019,0,1077,8,1085,1594,18438,2,1,2,0,1,0,75.60 ,68.07 ,50.00 
01,000,01,001,0020,0,5017,52,5069,7805,4273,1,1,1,0,1,0,73.84 ,64.95 ,100.00 
01,000,01,001,0021,0,4662,51,4713,7704,92385,3,1,2,1,1,0,68.86 ,61.18 ,33.33 
01,000,01,001,0022,0,3903,46,3949,5983,70372,3,1,2,1,1,0,67.72 ,66.00 ,33.33 
01,000,01,001,0023,0,3131,34,3165,4863,46679,3,1,3,0,1,0,71.97 ,65.08 ,33.33 
01,000,01,001,0024,0,3113,39,3152,4824,33217,3,1,3,0,1,0,70.90 ,65.34 ,33.33 
01,000,01,001,0025,0,3328,37,3365,5129,38137,3,1,3,0,1,0,71.08 ,65.61 ,33.33 
01,000,01,001,0026,0,1631,14,1645,2708,26645,2,1,2,0,1,0,72.27 ,60.75 ,50.00 
01,000,01,001,0027,0,2927,31,2958,4946,33963,3,1,3,0,1,0,71.40 ,59.81 ,33.33 
01,000,01,001,0028,0,2270,35,2305,3496,51543,3,1,3,0,1,0,71.25 ,65.93 ,33.33 
01,000,01,001,0029,0,3457,37,3494,5264,39229,2,1,2,0,1,0,71.55 ,66.38 ,50.00 
01,000,01,001,0030,0,2694,32,2726,4099,22112,2,1,2,0,1,0,74.34 ,66.50 ,50.00 
01,000,01,001,0031,0,3154,42,3196,4720,5718,2,1,2,0,1,0,69.85 ,67.71 ,50.00 
01,000,01,001,0032,0,1940,21,1961,2879,5825,4,1,4,0,1,0,66.20 ,68.11 ,25.00 
01,000,01,001,0033,0,2281,27,2308,3361,334927,5,1,5,0,1,0,67.16 ,68.67 ,20.00 
01,000,01,001,0034,0,2189,22,2211,3351,328121,3,1,3,0,1,0,68.43 ,65.98 ,33.33 
01,000,01,001,0035,0,2441,32,2473,3998,83519,3,1,3,0,1,0,68.66 ,61.86 ,33.33 
01,000,01,001,0036,0,2917,44,2961,4428,130732,5,1,5,0,1,0,67.09 ,66.87 ,20.00 
01,000,01,001,0037,0,3247,33,3280,5165,101290,4,1,4,0,1,0,65.74 ,63.50 ,25.00 
01,000,01,001,0038,0,5422,110,5532,8526,77736,4,1,4,0,1,0,66.33 ,64.88 ,25.00 
01,000,01,001,0039,0,1300,11,1311,1977,114604,2,1,2,0,1,0,69.35 ,66.31 ,50.00 
01,000,01,001,0040,0,1130,14,1144,1803,165779,3,1,3,0,1,0,68.23 ,63.45 ,33.33 
01,000,01,001,0041,0,608,9,617,986,106433,3,1,3,0,1,0,67.45 ,62.58 ,33.33 
01,000,01,001,0042,0,493,5,498,810,193621,5,1,3,2,0,1,66.39 ,61.48 ,20.00 
01,000,01,002,0043,0,2248,26,2274,3377,49075,2,1,2,0,1,0,70.19 ,67.34 ,50.00 
01,000,01,002,0044,0,1839,33,1872,2715,53643,2,1,2,0,1,0,68.58 ,68.95 ,50.00 
01,000,01,002,0045,0,1628,10,1638,2514,11251,4,1,4,0,1,0,69.74 ,65.16 ,25.00 
01,000,01,002,0046,0,2334,30,2364,4619,91747,2,1,2,0,1,0,66.83 ,51.18 ,50.00 
01,000,01,002,0047,0,4235,56,4291,6373,88834,2,1,2,0,1,0,68.07 ,67.33 ,50.00 
01,000,01,002,0048,0,3482,43,3525,5234,36708,2,1,2,0,1,0,71.22 ,67.35 ,50.00 
01,000,01,002,0049,0,4177,38,4215,6161,32559,3,1,3,0,1,0,71.94 ,68.41 ,33.33 
01,000,01,002,0050,0,4122,67,4189,6469,67960,2,1,2,0,1,0,67.16 ,64.75 ,50.00 
01,000,01,002,0051,0,2981,24,3005,4485,46718,2,1,2,0,1,0,65.94 ,67.00 ,50.00 
01,000,01,002,0052,0,2265,27,2292,3490,20852,2,1,2,0,1,0,69.78 ,65.67 ,50.00 
01,000,01,002,0053,0,3932,52,3984,5836,15045,2,1,2,0,1,0,73.01 ,68.27 ,50.00 
01,000,01,002,0054,0,2922,37,2959,4507,10541,1,1,1,0,1,0,71.95 ,65.65 ,100.00 
01,000,01,002,0055,0,3407,53,3460,5485,12945,2,1,2,0,1,0,70.78 ,63.08 ,50.00 
01,000,01,002,0056,0,2640,32,2672,4105,6393,2,1,2,0,1,0,76.16 ,65.09 ,50.00 
01,000,01,002,0057,0,2780,52,2832,4294,8186,4,1,4,0,1,0,67.54 ,65.95 ,25.00 
01,000,01,002,0058,0,3123,54,3177,4798,4828,3,1,3,0,1,0,73.34 ,66.22 ,33.33 
01,000,01,002,0059,0,4106,63,4169,6049,91005,4,1,3,1,1,0,70.63 ,68.92 ,25.00 
01,000,01,002,0060,0,2026,24,2050,3165,49329,2,1,1,1,1,0,70.11 ,64.77 ,50.00 
01,000,01,002,0061,0,3381,43,3424,5079,41216,2,1,2,0,1,0,71.88 ,67.41 ,50.00 
01,000,01,002,0062,0,4505,31,4536,6822,70035,4,1,4,0,1,0,68.51 ,66.49 ,25.00 
01,000,01,002,0063,0,3982,42,4024,5770,89256,3,1,3,0,1,0,68.26 ,69.74 ,33.33 
01,000,01,002,0064,0,4071,38,4109,5803,42310,2,1,2,0,1,0,71.77 ,70.81 ,50.00 
01,000,01,002,0065,0,2804,32,2836,3943,19568,2,1,2,0,1,0,72.67 ,71.92 ,50.00 
01,000,01,002,0066,0,3194,38,3232,4469,17181,4,1,3,1,1,0,73.40 ,72.32 ,25.00 
01,000,01,002,0067,0,1956,22,1978,3103,34851,1,1,1,0,1,0,69.78 ,63.74 ,100.00 
01,000,01,002,0068,0,3827,49,3876,5830,20704,2,1,1,1,1,0,71.69 ,66.48 ,50.00 
01,000,01,002,0069,0,2202,25,2227,3387,12179,6,1,5,1,1,0,75.89 ,65.75 ,16.67 
01,000,01,002,0070,0,2988,32,3020,4763,12305,3,1,2,1,0,1,73.30 ,63.41 ,33.33 
01,000,01,002,0071,0,2804,29,2833,4264,18061,3,1,3,0,1,0,69.87 ,66.44 ,33.33 
01,000,01,002,0072,0,3142,38,3180,4656,8579,2,1,1,1,1,0,75.91 ,68.30 ,50.00 
01,000,01,002,0073,0,3884,53,3937,5896,14300,3,1,3,0,1,0,71.19 ,66.77 ,33.33 
01,000,01,002,0074,0,2849,43,2892,4216,7765,4,1,4,0,1,0,73.78 ,68.60 ,25.00 
01,000,01,002,0075,0,2919,46,2965,4557,5439,2,1,2,0,1,0,79.94 ,65.06 ,50.00 
01,000,01,002,0076,0,4443,61,4504,7094,5496,2,1,0,2,0,1,76.06 ,63.49 ,50.00 
01,000,01,002,0077,0,3330,41,3371,5011,161524,3,1,3,0,1,0,68.05 ,67.27 ,33.33 
01,000,01,002,0078,0,3272,59,3331,4994,57499,5,1,4,1,1,0,72.08 ,66.70 ,20.00 
01,000,01,002,0079,0,2676,46,2722,4136,78470,3,1,3,0,1,0,66.87 ,65.81 ,33.33 
01,000,01,002,0080,0,2484,41,2525,3913,84966,4,1,4,0,1,0,69.15 ,64.53 ,25.00 
01,000,01,002,0081,0,3880,50,3930,6133,73004,5,1,4,1,0,1,67.70 ,64.08 ,20.00 
01,000,01,002,0082,0,3480,55,3535,5652,50479,4,1,3,1,1,0,67.12 ,62.54 ,25.00 
01,000,01,002,0083,0,4229,67,4296,6778,55327,2,1,2,0,1,0,70.21 ,63.38 ,50.00 
01,000,01,002,0084,0,3391,45,3436,5249,62586,4,1,4,0,1,0,68.18 ,65.46 ,25.00 
01,000,01,002,0085,0,751,9,760,1211,90365,3,1,3,0,1,0,67.47 ,62.76 ,33.33 
01,000,01,002,0086,0,794,5,799,1260,81805,2,1,2,0,1,0,64.97 ,63.41 ,50.00 
01,000,01,002,0087,0,1180,10,1190,1775,26642,4,1,4,0,1,0,73.20 ,67.04 ,25.00 
01,000,01,002,0088,0,1650,20,1670,2711,15211,3,1,2,1,1,0,73.45 ,61.60 ,33.33 
01,000,01,002,0089,0,948,12,960,1395,31463,3,1,3,0,1,0,68.81 ,68.82 ,33.33 
01,000,01,002,0090,0,836,7,843,1191,21391,2,1,1,1,1,0,70.53 ,70.78 ,50.00 
01,000,01,002,0091,0,871,9,880,1292,21391,2,1,1,1,1,0,70.53 ,68.11 ,50.00 
01,000,01,002,0092,0,1561,20,1581,2475,21391,2,1,1,1,1,0,70.53 ,63.88 ,50.00 
01,000,01,002,0093,0,1544,34,1578,2496,21391,2,1,1,1,1,0,70.53 ,63.22 ,50.00 
01,000,02,003,0094,0,4106,69,4175,6215,21391,2,1,1,1,1,0,70.53 ,67.18 ,50.00 
01,000,02,003,0095,0,4329,72,4401,6588,21391,2,1,1,1,1,0,70.53 ,66.80 ,50.00 
01,000,02,003,0096,0,3321,65,3386,5142,21391,2,1,1,1,1,0,70.53 ,65.85 ,50.00 
01,000,02,003,0097,0,2959,49,3008,4564,21391,2,1,1,1,1,0,70.53 ,65.91 ,50.00 
01,000,02,003,0098,0,2655,45,2700,4044,21391,2,1,1,1,1,0,70.53 ,66.77 ,50.00 
01,000,02,003,0099,0,2731,49,2780,4190,21391,2,1,1,1,1,0,70.53 ,66.35 ,50.00 
01,000,02,003,0100,0,4744,81,4825,7207,21391,2,1,1,1,1,0,70.53 ,66.95 ,50.00 
01,000,02,003,0101,0,4188,90,4278,6326,21391,2,1,1,1,1,0,70.53 ,67.63 ,50.00 
01,000,02,003,0102,0,2946,42,2988,4692,21391,2,1,1,1,1,0,70.53 ,63.68 ,50.00 
01,000,02,003,0103,0,3944,55,3999,5878,21391,2,1,1,1,1,0,70.53 ,68.03 ,50.00 
01,000,02,003,0104,0,2555,34,2589,3973,64870,3,1,3,0,1,0,68.56 ,65.16 ,33.33 
01,000,02,003,0105,0,3062,51,3113,4817,54724,3,1,3,0,1,0,68.03 ,64.63 ,33.33 
01,000,02,003,0106,0,2852,38,2890,4491,66909,3,1,3,0,1,0,67.07 ,64.35 ,33.33 
01,000,02,003,0107,0,3357,55,3412,5114,65951,4,1,4,0,1,0,69.35 ,66.72 ,25.00 
01,000,02,003,0108,0,3530,50,3580,5366,167530,2,1,2,0,1,0,67.30 ,66.72 ,50.00 
01,000,02,003,0109,0,2502,32,2534,3709,176314,5,1,5,0,1,0,66.13 ,68.32 ,20.00 
01,000,02,003,0110,0,4330,58,4388,6269,11140,3,1,3,0,1,0,77.24 ,70.00 ,33.33 
01,000,02,003,0111,0,3718,49,3767,5910,230816,4,1,4,0,1,0,68.37 ,63.74 ,25.00 
01,000,02,003,0112,0,4372,56,4428,6568,83734,4,1,3,1,1,0,68.19 ,67.42 ,25.00 
01,000,02,003,0113,0,3106,54,3160,4665,86753,2,1,2,0,1,0,68.39 ,67.74 ,50.00 
01,000,02,003,0114,0,3760,63,3823,6003,16836,2,1,2,0,1,0,68.89 ,63.68 ,50.00 
01,000,02,003,0115,0,3512,59,3571,5510,34322,3,1,3,0,1,0,67.06 ,64.81 ,33.33 
01,000,02,003,0116,0,4724,77,4801,7448,48495,3,1,3,0,1,0,68.50 ,64.46 ,33.33 
01,000,02,003,0117,0,3741,52,3793,5981,37827,2,1,2,0,1,0,68.23 ,63.42 ,50.00 
01,000,02,003,0118,0,2353,28,2381,3638,45952,4,1,4,0,1,0,69.40 ,65.45 ,25.00 
01,000,02,003,0119,0,4442,62,4504,7030,26578,3,1,2,1,0,1,72.11 ,64.07 ,33.33 
01,000,02,003,0120,0,3816,55,3871,6127,126723,5,1,5,0,1,0,68.05 ,63.18 ,20.00 
01,000,02,003,0121,0,3478,51,3529,5394,55784,2,1,2,0,1,0,67.43 ,65.42 ,50.00 
01,000,02,003,0122,0,3795,64,3859,6318,46614,3,1,3,0,1,0,71.85 ,61.08 ,33.33 
01,000,02,003,0123,0,2095,29,2124,3328,35495,2,1,2,0,1,0,70.96 ,63.82 ,50.00 
01,000,02,003,0124,0,2341,40,2381,3721,35600,3,1,3,0,1,0,70.87 ,63.99 ,33.33 
01,000,02,003,0125,0,551,4,555,863,34697,2,1,2,0,1,0,70.68 ,64.31 ,50.00 
01,000,02,003,0126,0,2582,38,2620,3973,40154,3,1,3,0,1,0,70.22 ,65.95 ,33.33 
01,000,02,003,0127,0,3278,86,3364,5157,45263,2,1,1,1,0,1,69.88 ,65.23 ,50.00 
01,000,02,003,0128,0,855,19,874,1345,18145,2,1,1,1,1,0,75.44 ,64.98 ,50.00 
01,000,02,003,0129,0,5295,89,5384,9478,33854,4,1,4,0,1,0,69.84 ,56.81 ,25.00 
01,000,02,003,0130,0,2607,47,2654,4123,56825,5,1,4,1,1,0,70.60 ,64.37 ,20.00 
01,000,02,004,0131,0,2995,55,3050,4943,29319,3,1,2,1,0,1,71.16 ,61.70 ,33.33 
01,000,02,004,0132,0,2004,24,2028,3182,32738,2,1,2,0,1,0,71.46 ,63.73 ,50.00 
01,000,02,004,0133,0,1639,30,1669,2569,38642,2,1,2,0,1,0,75.45 ,64.97 ,50.00 
01,000,02,004,0134,0,2011,27,2038,3166,20980,3,1,2,1,1,0,78.43 ,64.37 ,33.33 
01,000,02,004,0135,0,4421,69,4490,6969,17118,2,1,2,0,1,0,75.44 ,64.43 ,50.00 
01,000,02,004,0136,0,2388,34,2422,3693,32659,3,1,3,0,1,0,73.46 ,65.58 ,33.33 
01,000,02,004,0137,0,2448,34,2482,3762,104631,4,1,4,0,1,0,68.89 ,65.98 ,25.00 
01,000,02,004,0138,0,4673,62,4735,7157,87402,5,1,3,2,0,1,71.85 ,66.16 ,20.00 
01,000,02,004,0139,0,3304,46,3350,4964,97966,2,1,2,0,1,0,70.06 ,67.49 ,50.00 
01,000,02,004,0140,0,4257,57,4314,6902,61192,3,1,3,0,1,0,72.17 ,62.50 ,33.33 
01,000,02,004,0141,0,2222,42,2264,3600,12240,2,1,2,0,1,0,74.61 ,62.89 ,50.00 
01,000,02,004,0142,0,3517,82,3599,5520,42810,5,1,5,0,1,0,72.35 ,65.20 ,20.00 
01,000,02,004,0143,0,2066,43,2109,3137,20608,1,1,1,0,1,0,74.58 ,67.23 ,100.00 
01,000,02,004,0144,0,2414,37,2451,3752,17572,4,1,4,0,1,0,76.49 ,65.33 ,25.00 
01,000,02,004,0145,0,2804,48,2852,4234,17693,3,1,3,0,1,0,76.07 ,67.36 ,33.33 
01,000,02,004,0146,0,3487,75,3562,5454,23461,2,1,2,0,1,0,74.03 ,65.31 ,50.00 
01,000,02,004,0147,0,2237,44,2281,3349,22577,3,1,3,0,1,0,73.83 ,68.11 ,33.33 
01,000,02,004,0148,0,2528,57,2585,4060,17743,4,1,4,0,1,0,66.35 ,63.67 ,25.00 
01,000,02,004,0149,0,2764,55,2819,4384,15347,4,1,3,1,1,0,70.05 ,64.30 ,25.00 
01,000,03,005,0150,0,3016,62,3078,4727,101349,4,1,4,0,1,0,69.21 ,65.12 ,25.00 
01,000,03,005,0151,0,4240,82,4322,6728,48353,2,1,2,0,1,0,71.10 ,64.24 ,50.00 
01,000,03,005,0152,0,3499,63,3562,5555,67502,3,1,3,0,1,0,71.68 ,64.12 ,33.33 
01,000,03,005,0153,0,2386,45,2431,3761,50269,3,1,2,1,0,1,71.34 ,64.64 ,33.33 
01,000,03,005,0154,0,2706,66,2772,4243,32084,1,1,1,0,1,0,73.21 ,65.33 ,100.00 
01,000,03,005,0155,0,2493,52,2545,4040,46369,2,1,1,1,1,0,72.82 ,63.00 ,50.00 
01,000,03,005,0156,0,2323,42,2365,3735,35730,3,1,2,1,0,1,73.57 ,63.32 ,33.33 
01,000,03,005,0157,0,2361,52,2413,3695,22895,4,1,4,0,1,0,74.21 ,65.30 ,25.00 
01,000,03,005,0158,0,2210,52,2262,3623,31918,2,1,2,0,1,0,72.24 ,62.43 ,50.00 
01,000,03,005,0159,0,3804,65,3869,6030,21129,4,1,3,1,1,0,71.26 ,64.16 ,25.00 
01,000,03,005,0160,0,4795,112,4907,7519,32226,2,1,2,0,1,0,75.05 ,65.26 ,50.00 
01,000,03,005,0161,0,1389,37,1426,2204,29407,2,1,2,0,1,0,74.15 ,64.70 ,50.00 
01,000,03,005,0162,0,2300,42,2342,3625,32268,5,1,5,0,1,0,72.71 ,64.61 ,20.00 
01,000,03,005,0163,0,3188,49,3237,4931,19176,4,1,4,0,1,0,75.44 ,65.65 ,25.00 
01,000,03,005,0164,0,4429,127,4556,7105,15445,4,1,4,0,1,0,73.00 ,64.12 ,25.00 
01,000,03,005,0165,0,3440,80,3520,5262,29075,2,1,2,0,1,0,75.10 ,66.89 ,50.00 
01,000,03,005,0166,0,2978,57,3035,5578,31836,3,1,3,0,1,0,77.09 ,54.41 ,33.33 
01,000,03,005,0167,0,4633,85,4718,6838,29794,2,1,2,0,1,0,76.86 ,69.00 ,50.00 
01,000,03,005,0168,0,2989,46,3035,4655,33118,3,1,3,0,1,0,73.90 ,65.20 ,33.33 
01,000,03,005,0169,0,4996,88,5084,7481,32276,2,1,2,0,1,0,77.09 ,67.96 ,50.00 
01,000,03,005,0170,0,4280,97,4377,6859,33009,2,1,2,0,1,0,69.32 ,63.81 ,50.00 
01,000,03,005,0171,0,3972,76,4048,6212,44400,2,1,1,1,0,1,71.47 ,65.16 ,50.00 
01,000,03,005,0172,0,3427,78,3505,5294,33343,2,1,2,0,1,0,75.70 ,66.21 ,50.00 
01,000,03,005,0173,0,3912,101,4013,6645,36174,2,1,1,1,1,0,73.25 ,60.39 ,50.00 
01,000,03,005,0174,0,2026,41,2067,3160,70848,2,1,2,0,1,0,70.32 ,65.41 ,50.00 
01,000,03,005,0175,0,1691,35,1726,2665,17792,3,1,3,0,1,0,75.83 ,64.77 ,33.33 
01,000,03,005,0176,0,2027,47,2074,3194,36049,2,1,2,0,1,0,72.87 ,64.93 ,50.00 
01,000,03,005,0177,0,3595,102,3697,5620,28890,2,1,2,0,1,0,77.96 ,65.78 ,50.00 
01,000,03,005,0178,0,1574,45,1619,2510,29953,2,1,2,0,1,0,78.34 ,64.50 ,50.00 
01,000,03,005,0179,0,1932,46,1978,3138,24141,2,1,2,0,1,0,76.76 ,63.03 ,50.00 
01,000,03,005,0180,0,3053,53,3106,4799,18181,3,1,3,0,1,0,77.42 ,64.72 ,33.33 
01,000,03,005,0181,0,1329,42,1371,2122,55364,3,1,2,1,1,0,73.18 ,64.61 ,33.33 
01,000,03,005,0182,0,1892,44,1936,3074,48329,3,1,3,0,1,0,71.48 ,62.98 ,33.33 
01,000,03,006,0183,0,2630,54,2684,4980,41241,2,1,2,0,1,0,72.61 ,53.90 ,50.00 
01,000,03,006,0184,0,2492,49,2541,3908,23360,2,1,2,0,1,0,73.52 ,65.02 ,50.00 
01,000,03,006,0185,0,1474,35,1509,2519,12046,1,1,1,0,1,0,73.88 ,59.90 ,100.00 
01,000,03,006,0186,0,1470,26,1496,2619,3735,3,1,3,0,1,0,78.80 ,57.12 ,33.33 
01,000,03,006,0187,0,1825,44,1869,2852,6123,1,1,1,0,1,0,73.22 ,65.53 ,100.00 
01,000,03,006,0188,0,3137,73,3210,4849,77741,2,1,2,0,1,0,70.06 ,66.20 ,50.00 
01,000,03,006,0189,0,2438,37,2475,3893,28743,2,1,2,0,1,0,74.31 ,63.58 ,50.00 
01,000,03,006,0190,0,3843,60,3903,6082,34569,2,1,2,0,1,0,76.39 ,64.17 ,50.00 
01,000,03,006,0191,0,4076,85,4161,6607,24120,4,1,4,0,1,0,74.23 ,62.98 ,25.00 
01,000,03,006,0192,0,1948,40,1988,2982,27803,6,1,6,0,1,0,77.28 ,66.67 ,16.67 
01,000,03,006,0193,0,2577,33,2610,4002,25066,3,1,2,1,0,1,76.55 ,65.22 ,33.33 
01,000,03,006,0194,0,1919,46,1965,3055,47348,6,1,6,0,1,0,73.39 ,64.32 ,16.67 
01,000,03,006,0195,0,2821,42,2863,4242,27885,2,1,2,0,1,0,74.49 ,67.49 ,50.00 
01,000,03,006,0196,0,2241,57,2298,3598,25247,1,1,1,0,1,0,70.92 ,63.87 ,100.00 
01,000,03,006,0197,0,2307,40,2347,3544,23624,4,1,4,0,1,0,74.42 ,66.22 ,25.00 
01,000,03,006,0198,0,3106,61,3167,4676,12018,2,1,2,0,1,0,79.45 ,67.73 ,50.00 
01,000,03,006,0199,0,2728,65,2793,4531,58115,2,1,2,0,1,0,71.67 ,61.64 ,50.00 
01,000,03,006,0200,0,2668,74,2742,4266,29940,4,1,2,2,0,1,73.17 ,64.28 ,25.00 
01,000,03,006,0201,0,2123,33,2156,3364,26231,2,1,2,0,1,0,71.24 ,64.09 ,50.00 
01,000,03,006,0202,0,3782,54,3836,5994,26157,3,1,2,1,1,0,75.61 ,64.00 ,33.33 
01,000,03,006,0203,0,1234,18,1252,2020,23364,2,1,2,0,1,0,77.59 ,61.98 ,50.00 
01,000,03,006,0204,0,3330,59,3389,5381,13410,1,1,1,0,1,0,76.41 ,62.98 ,100.00 
01,000,03,006,0205,0,2761,49,2810,4406,45332,2,1,2,0,1,0,71.70 ,63.78 ,50.00 
01,000,03,006,0206,0,2376,48,2424,3737,42073,1,1,1,0,1,0,72.52 ,64.86 ,100.00 
01,000,03,006,0207,0,4151,82,4233,6491,34625,3,1,3,0,1,0,68.50 ,65.21 ,33.33 
01,000,03,006,0208,0,3385,56,3441,5405,29958,1,1,1,0,1,0,72.08 ,63.66 ,100.00 
01,000,03,006,0209,0,2721,58,2779,4084,8129,2,1,2,0,1,0,75.56 ,68.05 ,50.00 
01,000,03,006,0210,0,2622,58,2680,4129,16927,2,1,2,0,1,0,74.49 ,64.91 ,50.00 
01,000,03,006,0211,0,3604,79,3683,5480,11793,2,1,2,0,1,0,77.33 ,67.21 ,50.00 
01,000,03,006,0212,0,4869,86,4955,7566,9476,3,1,3,0,1,0,78.21 ,65.49 ,33.33 
01,000,03,006,0213,0,2601,35,2636,4154,6069,1,1,1,0,1,0,81.35 ,63.46 ,100.00 
01,000,03,006,0214,0,3421,53,3474,5641,66070,2,1,2,0,1,0,73.08 ,61.58 ,50.00 
01,000,03,006,0215,0,4109,85,4194,6613,63949,2,1,2,0,1,0,68.93 ,63.42 ,50.00 
01,000,03,006,0216,0,2504,55,2559,3913,38471,3,1,3,0,1,0,73.15 ,65.40 ,33.33 
01,000,03,006,0217,0,2346,46,2392,3619,4363,1,1,1,0,1,0,84.09 ,66.10 ,100.00 
01,000,03,006,0218,0,3806,73,3879,5921,198003,7,1,7,0,1,0,68.47 ,65.51 ,14.29 
01,000,03,006,0219,0,1727,39,1766,2666,322860,2,1,2,0,1,0,70.88 ,66.24 ,50.00 
01,000,03,006,0220,0,2210,48,2258,3542,72071,4,1,3,1,1,0,69.35 ,63.75 ,25.00 
01,000,03,006,0221,0,3649,75,3724,5622,115210,5,1,4,1,1,0,71.27 ,66.24 ,20.00 
01,000,03,006,0222,0,2587,65,2652,4027,46585,3,1,3,0,1,0,71.99 ,65.86 ,33.33 
01,000,03,006,0223,0,1409,34,1443,2193,33408,2,1,2,0,1,0,72.90 ,65.80 ,50.00 
01,000,04,007,0224,0,1493,36,1529,2400,54015,3,1,3,0,1,0,70.47 ,63.71 ,33.33 
01,000,04,007,0225,0,2035,52,2087,3663,38516,4,1,3,1,0,1,74.20 ,56.98 ,25.00 
01,000,04,007,0226,0,1481,25,1506,2689,93699,2,1,2,0,1,0,70.26 ,56.01 ,50.00 
01,000,04,007,0227,0,2614,49,2663,4178,37932,3,1,3,0,1,0,72.72 ,63.74 ,33.33 
01,000,04,007,0228,0,1092,20,1112,2004,32281,2,1,2,0,1,0,73.00 ,55.49 ,50.00 
01,000,04,007,0229,0,2453,43,2496,4278,9563,2,1,2,0,1,0,81.07 ,58.35 ,50.00 
01,000,04,007,0230,0,1629,35,1664,3038,31469,3,1,3,0,1,0,69.26 ,54.77 ,33.33 
01,000,04,007,0231,0,3090,64,3154,5068,53629,2,1,2,0,1,0,71.07 ,62.23 ,50.00 
01,000,04,007,0232,0,1813,21,1834,3086,28701,2,1,2,0,1,0,73.23 ,59.43 ,50.00 
01,000,04,007,0233,0,1939,47,1986,3260,33173,2,1,2,0,1,0,72.77 ,60.92 ,50.00 
01,000,04,007,0234,0,2122,51,2173,3824,14679,1,1,1,0,1,0,72.27 ,56.83 ,100.00 
01,000,04,007,0235,0,1760,36,1796,3110,21714,2,1,2,0,1,0,71.51 ,57.75 ,50.00 
01,000,04,007,0236,0,2488,44,2532,4035,39279,3,1,3,0,1,0,71.92 ,62.75 ,33.33 
01,000,04,007,0237,0,2142,23,2165,3183,43673,3,1,2,1,1,0,74.56 ,68.02 ,33.33 
01,000,04,007,0238,0,5018,75,5093,7628,46319,4,1,4,0,1,0,75.51 ,66.77 ,25.00 
01,000,04,007,0239,0,2017,40,2057,3147,17071,4,1,4,0,1,0,75.95 ,65.36 ,25.00 
01,000,04,007,0240,0,4455,92,4547,6934,8821,2,1,2,0,1,0,77.51 ,65.58 ,50.00 
01,000,04,007,0241,0,709,9,718,1046,12705,3,1,3,0,1,0,78.77 ,68.64 ,33.33 
01,000,04,007,0242,0,2891,61,2952,4695,17847,2,1,2,0,1,0,75.61 ,62.88 ,50.00 
01,000,04,007,0243,0,1490,23,1513,2208,1793,2,1,2,0,1,0,72.28 ,68.52 ,50.00 
01,000,04,007,0244,0,2595,43,2638,4040,4715,3,1,3,0,1,0,69.10 ,65.30 ,33.33 
01,000,04,007,0245,0,2668,59,2727,4223,3361,2,1,2,0,1,0,63.67 ,64.57 ,50.00 
01,000,04,007,0246,0,3340,49,3389,5035,215769,3,1,3,0,1,0,70.85 ,67.31 ,33.33 
01,000,04,007,0247,0,2710,68,2778,4151,57920,5,1,5,0,1,0,70.72 ,66.92 ,20.00 
01,000,04,007,0248,0,2715,43,2758,4380,49814,3,1,3,0,1,0,68.51 ,62.97 ,33.33 
01,000,04,007,0249,0,2900,66,2966,5873,31288,4,1,4,0,1,0,72.47 ,50.50 ,25.00 
01,000,04,007,0250,0,4176,86,4262,6564,54439,2,1,2,0,1,0,70.23 ,64.93 ,50.00 
01,000,04,007,0251,0,2136,29,2165,3471,30352,3,1,3,0,1,0,73.32 ,62.37 ,33.33 
01,000,04,007,0252,0,3753,98,3851,6003,12068,2,1,2,0,1,0,73.29 ,64.15 ,50.00 
01,000,04,007,0253,0,3467,55,3522,5522,23483,4,1,3,1,1,0,70.99 ,63.78 ,25.00 
01,000,04,007,0254,0,3974,81,4055,6350,27171,2,1,2,0,1,0,71.91 ,63.86 ,50.00 
01,000,04,007,0255,0,2617,47,2664,4187,28497,4,1,4,0,1,0,72.06 ,63.63 ,25.00 
01,000,04,007,0256,0,2491,33,2524,3947,29165,2,1,2,0,1,0,76.82 ,63.95 ,50.00 
01,000,04,007,0257,0,2521,32,2553,4152,24117,3,1,3,0,1,0,74.10 ,61.49 ,33.33 
01,000,04,007,0258,0,1884,30,1914,2934,62360,3,1,3,0,1,0,72.28 ,65.24 ,33.33 
01,000,04,007,0259,0,2995,62,3057,4885,19284,2,1,1,1,1,0,74.36 ,62.58 ,50.00 
01,000,04,007,0260,0,2873,54,2927,4245,11822,3,1,2,1,0,1,76.39 ,68.95 ,33.33 
01,000,04,007,0261,0,2225,57,2282,3663,29554,2,1,2,0,1,0,73.76 ,62.30 ,50.00 
01,000,04,007,0262,0,1899,56,1955,3073,41370,2,1,2,0,1,0,70.43 ,63.62 ,50.00 
01,000,04,007,0263,0,1509,34,1543,2506,15392,5,1,5,0,1,0,69.65 ,61.57 ,20.00 
01,000,04,007,0264,0,3009,71,3080,4922,22763,2,1,2,0,1,0,74.19 ,62.58 ,50.00 
01,000,04,007,0265,0,2080,39,2119,3425,13197,3,1,3,0,1,0,74.47 ,61.87 ,33.33 
01,000,04,008,0266,0,1620,42,1662,2701,23322,2,1,2,0,1,0,74.55 ,61.53 ,50.00 
01,000,04,008,0267,0,1739,34,1773,2760,13109,2,1,2,0,1,0,81.79 ,64.24 ,50.00 
01,000,04,008,0268,0,2440,52,2492,3906,10879,4,1,4,0,1,0,75.75 ,63.80 ,25.00 
01,000,04,008,0269,0,1813,46,1859,2883,8787,4,1,4,0,1,0,79.03 ,64.48 ,25.00 
01,000,04,008,0270,0,2667,38,2705,4305,6575,2,1,2,0,1,0,75.44 ,62.83 ,50.00 
01,000,04,008,0271,0,2013,39,2052,3299,7265,2,1,2,0,1,0,72.02 ,62.20 ,50.00 
01,000,04,008,0272,0,2669,45,2714,4210,2739,2,1,2,0,1,0,90.98 ,64.47 ,50.00 
01,000,04,008,0273,0,2665,63,2728,4157,6256,2,1,2,0,1,0,72.20 ,65.62 ,50.00 
01,000,04,008,0274,0,2690,46,2736,4074,4762,2,1,2,0,1,0,70.92 ,67.16 ,50.00 
01,000,04,008,0275,0,2089,39,2128,3328,7974,2,1,2,0,1,0,69.80 ,63.94 ,50.00 
01,000,04,008,0276,0,4883,55,4938,7652,5118,1,1,1,0,1,0,69.19 ,64.53 ,100.00 
01,000,04,008,0277,0,2088,46,2134,3368,5084,2,1,2,0,1,0,72.38 ,63.36 ,50.00 
01,000,04,008,0278,0,3187,56,3243,5061,5104,2,1,2,0,1,0,73.26 ,64.08 ,50.00 
01,000,04,008,0279,0,1581,35,1616,2419,110993,2,1,2,0,1,0,70.05 ,66.80 ,50.00 
01,000,04,008,0280,0,1769,25,1794,2638,18491,2,1,2,0,1,0,73.48 ,68.01 ,50.00 
01,000,04,008,0281,0,2432,46,2478,3857,10994,2,1,2,0,1,0,71.64 ,64.25 ,50.00 
01,000,04,008,0282,0,1687,40,1727,2578,20016,2,1,2,0,1,0,75.15 ,66.99 ,50.00 
01,000,04,008,0283,0,2104,34,2138,3258,9827,3,1,2,1,1,0,74.68 ,65.62 ,33.33 
01,000,04,008,0284,0,1778,44,1822,3309,10594,2,1,2,0,1,0,76.10 ,55.06 ,50.00 
01,000,04,008,0285,0,2721,55,2776,4322,11060,2,1,2,0,1,0,78.10 ,64.23 ,50.00 
01,000,04,008,0286,0,3347,68,3415,5142,10311,3,1,3,0,1,0,77.58 ,66.41 ,33.33 
01,000,04,008,0287,0,4078,68,4146,6262,13349,1,1,1,0,1,0,73.95 ,66.21 ,100.00 
01,000,04,008,0288,0,3041,54,3095,4730,6667,2,1,2,0,1,0,73.50 ,65.43 ,50.00 
01,000,04,008,0289,0,3096,62,3158,4635,2844,1,1,1,0,1,0,70.85 ,68.13 ,100.00 
01,000,04,008,0290,0,2328,47,2375,3483,4788,2,1,2,0,1,0,65.31 ,68.19 ,50.00 
01,000,05,009,0291,0,1511,40,1551,2509,3678,2,1,2,0,1,0,71.67 ,61.82 ,50.00 
01,000,05,009,0292,0,1541,31,1572,2512,3369,2,1,2,0,1,0,69.69 ,62.58 ,50.00 
01,000,05,009,0293,0,1418,35,1453,2222,4082,2,1,2,0,1,0,74.13 ,65.39 ,50.00 
01,000,05,009,0294,0,2413,51,2464,3871,3156,2,1,2,0,1,0,67.87 ,63.65 ,50.00 
01,000,05,009,0295,0,2373,44,2417,3836,108272,2,1,2,0,1,0,69.48 ,63.01 ,50.00 
01,000,05,009,0296,0,3049,55,3104,4710,13809,3,1,3,0,1,0,77.12 ,65.90 ,33.33 
01,000,05,009,0297,0,2815,73,2888,4433,32029,4,1,3,1,1,0,73.99 ,65.15 ,25.00 
01,000,05,009,0298,0,1796,39,1835,2812,20537,3,1,2,1,1,0,72.99 ,65.26 ,33.33 
01,000,05,009,0299,0,3008,43,3051,4499,76730,2,1,2,0,1,0,71.82 ,67.82 ,50.00 
01,000,05,009,0300,0,2369,40,2409,3647,20398,2,1,1,1,0,1,74.53 ,66.05 ,50.00 
01,000,05,009,0301,0,3196,39,3235,4986,16339,2,1,2,0,1,0,74.32 ,64.88 ,50.00 
01,000,05,009,0302,0,2843,35,2878,4396,6372,3,1,2,1,1,0,75.41 ,65.47 ,33.33 
01,000,05,009,0303,0,1998,37,2035,3061,14972,3,1,3,0,1,0,73.24 ,66.48 ,33.33 
01,000,05,009,0304,0,3553,49,3602,5601,13366,2,1,2,0,1,0,76.24 ,64.31 ,50.00 
01,000,05,009,0305,0,1900,34,1934,3027,15265,3,1,2,1,1,0,65.37 ,63.89 ,33.33 
01,000,05,009,0306,0,1606,18,1624,2494,7643,3,1,3,0,1,0,64.07 ,65.12 ,33.33 
01,000,05,009,0307,0,1391,17,1408,2228,7077,2,1,2,0,1,0,66.98 ,63.20 ,50.00 
01,000,05,009,0308,0,1703,32,1735,2729,53093,1,1,1,0,1,0,71.32 ,63.58 ,100.00 
01,000,05,009,0309,0,4262,84,4346,6614,12768,3,1,2,1,1,0,76.33 ,65.71 ,33.33 
01,000,05,009,0310,0,3012,48,3060,5484,9206,3,1,3,0,1,0,76.96 ,55.80 ,33.33 
01,000,05,009,0311,0,4016,93,4109,6405,8377,2,1,2,0,1,0,77.82 ,64.15 ,50.00 
01,000,05,009,0312,0,622,5,627,1064,4425,2,1,2,0,1,0,86.31 ,58.93 ,50.00 
01,000,05,009,0313,0,1736,47,1783,3021,3183,3,1,3,0,1,0,71.47 ,59.02 ,33.33 
01,000,05,009,0314,0,1342,32,1374,2458,19130,9,1,8,1,1,0,68.74 ,55.90 ,11.11 
01,000,05,009,0315,0,1725,42,1767,2800,9339,3,1,3,0,1,0,74.07 ,63.11 ,33.33 
01,000,05,009,0316,0,2223,52,2275,3685,12403,1,1,1,0,1,0,69.14 ,61.74 ,100.00 
01,000,05,009,0317,0,2111,59,2170,3481,9766,3,1,3,0,1,0,74.66 ,62.34 ,33.33 
01,000,05,009,0318,0,2127,47,2174,3535,5214,3,1,3,0,1,0,75.55 ,61.50 ,33.33 
01,000,05,009,0319,0,2518,64,2582,4077,363,3,1,3,0,1,0,84.85 ,63.33 ,33.33 
01,000,05,009,0320,0,3590,74,3664,5671,5034,3,1,3,0,1,0,77.69 ,64.61 ,33.33 
01,000,05,009,0321,0,3831,104,3935,6288,1635,1,1,1,0,1,0,85.81 ,62.58 ,100.00 
01,000,05,010,0322,0,2594,47,2641,4340,822,2,1,2,0,1,0,78.47 ,60.85 ,50.00 
01,000,05,010,0323,0,1603,36,1639,2925,825,2,1,2,0,1,0,71.76 ,56.03 ,50.00 
01,000,05,010,0324,0,1747,31,1778,3136,825,2,1,2,0,1,0,71.76 ,56.70 ,50.00 
01,000,05,010,0325,0,3316,76,3392,5469,825,2,1,2,0,1,0,71.76 ,62.02 ,50.00 
01,000,05,010,0326,0,3039,62,3101,4892,123456,2,1,2,0,1,0,71.76 ,63.39 ,50.00 
01,000,05,010,0327,0,2828,51,2879,4600,123456,2,1,2,0,1,0,71.76 ,62.59 ,50.00 
01,000,05,010,0328,0,2832,49,2881,4370,123456,2,1,2,0,1,0,71.76 ,65.93 ,50.00 
01,000,05,010,0329,0,2012,25,2037,3025,123456,2,1,2,0,1,0,71.76 ,67.34 ,50.00 
01,000,05,010,0330,0,2374,47,2421,3593,123456,2,1,2,0,1,0,71.76 ,67.38 ,50.00 
01,000,05,010,0331,0,2570,31,2601,4126,123456,2,1,2,0,1,0,71.76 ,63.04 ,50.00 
01,000,05,010,0332,0,2859,39,2898,4508,123456,2,1,2,0,1,0,71.76 ,64.29 ,50.00 
01,000,05,010,0333,0,4493,80,4573,7011,123456,2,1,2,0,1,0,71.76 ,65.23 ,50.00 
01,000,05,010,0334,0,2947,66,3013,4660,123456,2,1,2,0,1,0,71.76 ,64.66 ,50.00 
01,000,05,010,0335,0,2256,31,2287,3717,123456,2,1,2,0,1,0,71.76 ,61.53 ,50.00 
01,000,05,010,0336,0,4391,49,4440,7060,123456,2,1,2,0,1,0,71.76 ,62.89 ,50.00 
01,000,05,010,0337,0,2501,39,2540,3870,123456,2,1,2,0,1,0,71.76 ,65.63 ,50.00 
01,000,05,010,0338,0,3943,63,4006,5969,123456,2,1,2,0,1,0,71.76 ,67.11 ,50.00 
01,000,05,010,0339,0,3567,69,3636,5843,123456,2,1,2,0,1,0,71.76 ,62.23 ,50.00 
01,000,05,010,0340,0,2229,26,2255,3545,123456,2,1,2,0,1,0,71.76 ,63.61 ,50.00 
01,000,05,010,0341,0,2076,35,2111,3169,123456,2,1,2,0,1,0,71.76 ,66.61 ,50.00 
01,000,05,010,0342,0,2883,39,2922,4407,123456,2,1,2,0,1,0,71.76 ,66.30 ,50.00 
01,000,05,010,0343,0,2522,26,2548,3744,123456,2,1,2,0,1,0,71.76 ,68.06 ,50.00 
01,000,05,010,0344,0,2883,42,2925,4476,123456,2,1,2,0,1,0,71.76 ,65.35 ,50.00 
01,000,05,010,0345,0,2566,42,2608,3893,123456,2,1,2,0,1,0,71.76 ,66.99 ,50.00 
01,000,05,010,0346,0,1798,26,1824,2681,123456,2,1,2,0,1,0,71.76 ,68.03 ,50.00 
01,000,05,010,0347,0,1683,25,1708,2449,123456,2,1,2,0,1,0,71.76 ,69.74 ,50.00 
01,000,05,010,0348,0,2301,40,2341,3291,123456,2,1,2,0,1,0,71.76 ,71.13 ,50.00 
01,000,05,010,0349,0,3386,44,3430,5126,123456,2,1,2,0,1,0,71.76 ,66.91 ,50.00 
01,000,05,010,0350,0,2479,40,2519,3892,123456,2,1,2,0,1,0,71.76 ,64.72 ,50.00 
01,000,05,010,0351,0,2623,39,2662,4026,123456,2,1,2,0,1,0,71.76 ,66.12 ,50.00 
01,000,05,010,0352,0,2900,39,2939,4282,123456,2,1,2,0,1,0,71.76 ,68.64 ,50.00 
01,000,05,010,0353,0,2137,30,2167,3275,123456,2,1,2,0,1,0,71.76 ,66.17 ,50.00 
01,000,05,010,0354,0,4958,65,5023,7348,123456,2,1,2,0,1,0,71.76 ,68.36 ,50.00 
01,000,05,010,0355,0,3446,51,3497,5368,123456,2,1,2,0,1,0,71.76 ,65.15 ,50.00 
01,000,05,010,0356,0,2185,30,2215,3398,123456,2,1,2,0,1,0,71.76 ,65.19 ,50.00 
01,000,05,010,0357,0,1725,27,1752,2622,123456,2,1,2,0,1,0,71.76 ,66.82 ,50.00 
01,000,06,011,0358,0,2825,44,2869,4739,123456,2,1,2,0,1,0,71.76 ,60.54 ,50.00 
01,000,06,011,0359,0,2375,45,2420,3894,123456,2,1,2,0,1,0,71.76 ,62.15 ,50.00 
01,000,06,011,0360,0,3286,36,3322,5159,123456,2,1,2,0,1,0,71.76 ,64.39 ,50.00 
01,000,06,011,0361,0,3898,58,3956,6344,123456,2,1,2,0,1,0,71.76 ,62.36 ,50.00 
01,000,06,011,0362,0,2590,51,2641,4697,123456,2,1,2,0,1,0,71.76 ,56.23 ,50.00 
01,000,06,011,0363,0,3492,36,3528,5458,123456,2,1,2,0,1,0,71.76 ,64.64 ,50.00 
01,000,06,011,0364,0,3453,63,3516,5629,123456,2,1,2,0,1,0,71.76 ,62.46 ,50.00 
01,000,06,011,0365,0,1698,34,1732,2710,123456,2,1,2,0,1,0,71.76 ,63.91 ,50.00 
01,000,06,011,0366,0,2279,58,2337,3679,123456,2,1,2,0,1,0,71.76 ,63.52 ,50.00 
01,000,06,011,0367,0,3868,66,3934,6578,123456,2,1,2,0,1,0,71.76 ,59.81 ,50.00 
01,000,06,011,0368,0,2939,37,2976,4721,123456,2,1,2,0,1,0,71.76 ,63.04 ,50.00 
01,000,06,011,0369,0,2250,17,2267,3630,123456,2,1,2,0,1,0,71.76 ,62.45 ,50.00 
01,000,06,011,0370,0,2097,30,2127,3399,123456,2,1,2,0,1,0,71.76 ,62.58 ,50.00 
01,000,06,011,0371,0,3280,48,3328,5305,123456,2,1,2,0,1,0,71.76 ,62.73 ,50.00 
01,000,06,011,0372,0,2834,31,2865,5802,123456,2,1,2,0,1,0,71.76 ,49.38 ,50.00 
01,000,06,011,0373,0,2604,33,2637,4159,123456,2,1,2,0,1,0,71.76 ,63.40 ,50.00 
01,000,06,011,0374,0,2813,41,2854,4495,123456,2,1,2,0,1,0,71.76 ,63.49 ,50.00 
01,000,06,011,0375,0,1677,17,1694,2651,123456,2,1,2,0,1,0,71.76 ,63.90 ,50.00 
01,000,06,011,0376,0,1918,22,1940,2915,123456,2,1,2,0,1,0,71.76 ,66.55 ,50.00 
01,000,06,011,0377,0,2557,42,2599,3961,123456,2,1,2,0,1,0,71.76 ,65.61 ,50.00 
01,000,06,011,0378,0,2653,23,2676,4050,123456,2,1,2,0,1,0,71.76 ,66.07 ,50.00 
01,000,06,011,0379,0,3276,42,3318,5341,123456,2,1,2,0,1,0,71.76 ,62.12 ,50.00 
01,000,06,011,0380,0,3386,40,3426,5250,123456,2,1,2,0,1,0,71.76 ,65.26 ,50.00 
01,000,06,011,0381,0,1827,23,1850,2946,123456,2,1,2,0,1,0,71.76 ,62.80 ,50.00 
01,000,06,011,0382,0,2515,60,2575,4028,123456,2,1,2,0,1,0,71.76 ,63.93 ,50.00 
01,000,06,011,0383,0,3297,39,3336,5010,123456,2,1,2,0,1,0,71.76 ,66.59 ,50.00 
01,000,06,011,0384,0,2630,35,2665,4321,123456,2,1,2,0,1,0,71.76 ,61.68 ,50.00 
01,000,06,011,0385,0,2807,35,2842,4561,123456,2,1,2,0,1,0,71.76 ,62.31 ,50.00 
01,000,06,011,0386,0,3219,53,3272,5019,123456,2,1,2,0,1,0,71.76 ,65.19 ,50.00 
01,000,06,011,0387,0,2938,47,2985,4721,123456,2,1,2,0,1,0,71.76 ,63.23 ,50.00 
01,000,06,011,0388,0,2270,39,2309,3436,123456,2,1,2,0,1,0,71.76 ,67.20 ,50.00 
01,000,06,011,0389,0,2331,53,2384,3646,123456,2,1,2,0,1,0,71.76 ,65.39 ,50.00 
01,000,06,011,0390,0,2248,40,2288,3639,123456,2,1,2,0,1,0,71.76 ,62.87 ,50.00 
01,000,06,011,0391,0,3126,42,3168,5064,123456,2,1,2,0,1,0,71.76 ,62.56 ,50.00 
01,000,06,011,0392,0,3956,51,4007,5931,123456,2,1,2,0,1,0,71.76 ,67.56 ,50.00 
01,000,06,011,0393,0,1821,29,1850,2917,123456,2,1,2,0,1,0,71.76 ,63.42 ,50.00 
01,000,06,011,0394,0,1118,21,1139,1780,123456,2,1,2,0,1,0,71.76 ,63.99 ,50.00 
01,000,06,011,0395,0,4571,59,4630,7032,123456,2,1,2,0,1,0,71.76 ,65.84 ,50.00 
01,000,06,011,0396,0,2070,22,2092,3325,123456,2,1,2,0,1,0,71.76 ,62.92 ,50.00 
01,000,06,011,0397,0,4031,54,4085,6537,123456,2,1,2,0,1,0,71.76 ,62.49 ,50.00 
01,000,06,011,0398,0,3307,51,3358,5131,123456,2,1,2,0,1,0,71.76 ,65.45 ,50.00 
01,000,06,011,0399,0,2922,44,2966,4545,123456,2,1,2,0,1,0,71.76 ,65.26 ,50.00 
01,000,06,011,0400,0,4190,57,4247,6247,123456,2,1,2,0,1,0,71.76 ,67.98 ,50.00 
01,000,06,011,0401,0,2398,30,2428,3709,123456,2,1,2,0,1,0,71.76 ,65.46 ,50.00 
01,000,06,011,0402,0,2454,37,2491,4141,123456,2,1,2,0,1,0,71.76 ,60.15 ,50.00 
01,000,06,011,0403,0,2897,43,2940,4983,123456,2,1,2,0,1,0,71.76 ,59.00 ,50.00 
01,000,06,011,0404,0,2982,57,3039,4989,123456,2,1,2,0,1,0,71.76 ,60.91 ,50.00 
01,000,06,011,0405,0,2425,50,2475,4062,123456,2,1,2,0,1,0,71.76 ,60.93 ,50.00 
01,000,06,011,0406,0,3000,49,3049,4834,123456,2,1,2,0,1,0,71.76 ,63.07 ,50.00 
01,000,06,011,0407,0,2217,40,2257,3568,123456,2,1,2,0,1,0,71.76 ,63.26 ,50.00 
01,000,06,011,0408,0,3162,44,3206,5335,123456,2,1,2,0,1,0,71.76 ,60.09 ,50.00 
01,000,06,011,0409,0,4024,61,4085,6365,123456,2,1,2,0,1,0,71.76 ,64.18 ,50.00 
01,000,06,011,0410,0,1912,28,1940,3003,123456,2,1,2,0,1,0,71.76 ,64.60 ,50.00 
01,000,06,012,0411,0,2796,37,2833,4451,123456,2,1,2,0,1,0,71.76 ,63.65 ,50.00 
01,000,06,012,0412,0,3442,47,3489,5407,123456,2,1,2,0,1,0,71.76 ,64.53 ,50.00 
01,000,06,012,0413,0,2410,30,2440,3721,123456,2,1,2,0,1,0,71.76 ,65.57 ,50.00 
01,000,06,012,0414,0,3325,44,3369,5119,123456,2,1,2,0,1,0,71.76 ,65.81 ,50.00 
01,000,06,012,0415,0,2406,27,2433,3616,123456,2,1,2,0,1,0,71.76 ,67.28 ,50.00 
01,000,06,012,0416,0,3034,36,3070,4669,123456,2,1,2,0,1,0,71.76 ,65.75 ,50.00 
01,000,06,012,0417,0,2514,23,2537,3787,123456,2,1,2,0,1,0,71.76 ,66.99 ,50.00 
01,000,06,012,0418,0,2440,40,2480,3673,123456,2,1,2,0,1,0,71.76 ,67.52 ,50.00 
01,000,06,012,0419,0,3867,46,3913,5798,123456,2,1,2,0,1,0,71.76 ,67.49 ,50.00 
01,000,06,012,0420,0,2777,36,2813,4305,123456,2,1,2,0,1,0,71.76 ,65.34 ,50.00 
01,000,06,012,0421,0,1712,9,1721,2576,123456,2,1,2,0,1,0,71.76 ,66.81 ,50.00 
01,000,06,012,0422,0,2393,29,2422,3788,123456,2,1,2,0,1,0,71.76 ,63.94 ,50.00 
01,000,06,012,0423,0,4698,54,4752,7125,123456,2,1,2,0,1,0,71.76 ,66.69 ,50.00 
01,000,06,012,0424,0,1631,17,1648,2540,123456,2,1,2,0,1,0,71.76 ,64.88 ,50.00 
01,000,06,012,0425,0,3912,43,3955,5904,123456,2,1,2,0,1,0,71.76 ,66.99 ,50.00 
01,000,06,012,0426,0,3051,34,3085,4994,123456,2,1,2,0,1,0,71.76 ,61.77 ,50.00 
01,000,06,012,0427,0,2859,35,2894,4860,123456,2,1,2,0,1,0,71.76 ,59.55 ,50.00 
01,000,06,012,0428,0,3338,34,3372,5072,123456,2,1,2,0,1,0,71.76 ,66.48 ,50.00 
01,000,06,012,0429,0,3085,35,3120,4644,123456,2,1,2,0,1,0,71.76 ,67.18 ,50.00 
01,000,06,012,0430,0,3627,56,3683,5633,123456,2,1,2,0,1,0,71.76 ,65.38 ,50.00 
01,000,06,012,0431,0,1948,24,1972,3012,123456,2,1,2,0,1,0,71.76 ,65.47 ,50.00 
01,000,06,012,0432,0,3315,38,3353,5288,123456,2,1,2,0,1,0,71.76 ,63.41 ,50.00 
01,000,06,012,0433,0,3471,50,3521,5214,123456,2,1,2,0,1,0,71.76 ,67.53 ,50.00 
01,000,06,012,0434,0,3929,51,3980,6104,123456,2,1,2,0,1,0,71.76 ,65.20 ,50.00 
01,000,06,012,0435,0,2248,41,2289,3879,123456,2,1,2,0,1,0,71.76 ,59.01 ,50.00 
01,000,06,012,0436,0,3605,38,3643,5606,123456,2,1,2,0,1,0,71.76 ,64.98 ,50.00 
01,000,06,012,0437,0,4056,41,4097,6039,123456,2,1,2,0,1,0,71.76 ,67.84 ,50.00 
01,000,06,012,0438,0,4529,74,4603,7145,123456,2,1,2,0,1,0,71.76 ,64.42 ,50.00 
01,000,06,012,0439,0,3725,59,3784,5626,123456,2,1,2,0,1,0,71.76 ,67.26 ,50.00 
01,000,06,012,0440,0,2072,25,2097,3098,123456,2,1,2,0,1,0,71.76 ,67.69 ,50.00 
01,000,06,012,0441,0,4323,49,4372,6657,123456,2,1,2,0,1,0,71.76 ,65.68 ,50.00 
01,000,06,012,0442,0,5872,103,5975,9164,123456,2,1,2,0,1,0,71.76 ,65.20 ,50.00 
01,000,06,012,0443,0,4856,93,4949,7295,123456,2,1,2,0,1,0,71.76 ,67.84 ,50.00 
01,000,06,012,0444,0,3903,31,3934,6071,123456,2,1,2,0,1,0,71.76 ,64.80 ,50.00 
01,000,06,012,0445,0,3382,41,3423,5438,123456,2,1,2,0,1,0,71.76 ,62.95 ,50.00 
01,000,06,012,0446,0,2671,40,2711,4087,123456,2,1,2,0,1,0,71.76 ,66.33 ,50.00 
01,000,06,012,0447,0,6184,66,6250,9546,123456,2,1,2,0,1,0,71.76 ,65.47 ,50.00 
01,000,06,012,0448,0,1495,23,1518,2352,123456,2,1,2,0,1,0,71.76 ,64.54 ,50.00 
01,000,06,012,0449,0,450,4,454,705,123456,2,1,2,0,1,0,71.76 ,64.40 ,50.00 
02,000,01,001,0001,0,936,12,948,1290,123456,2,1,2,0,1,0,71.76 ,73.49 ,50.00 
02,000,01,001,0002,0,333,9,342,439,123456,2,1,2,0,1,0,71.76 ,77.90 ,50.00 
02,000,01,001,0003,0,539,13,552,720,123456,2,1,2,0,1,0,71.76 ,76.67 ,50.00 
02,000,01,001,0004,0,946,15,961,1357,123456,2,1,2,0,1,0,71.76 ,70.82 ,50.00 
02,000,01,001,0005,0,856,10,866,1170,123456,2,1,2,0,1,0,71.76 ,74.02 ,50.00 
02,000,01,001,0006,0,1600,17,1617,2179,123456,2,1,2,0,1,0,71.76 ,74.21 ,50.00 
02,000,01,001,0007,0,659,14,673,910,123456,2,1,2,0,1,0,71.76 ,73.96 ,50.00 
02,000,01,001,0008,0,540,5,545,730,123456,2,1,2,0,1,0,71.76 ,74.66 ,50.00 
02,000,01,001,0009,0,809,11,820,1262,123456,2,1,2,0,1,0,71.76 ,64.98 ,50.00 
02,000,01,001,0010,0,573,8,581,822,123456,2,1,2,0,1,0,71.76 ,70.68 ,50.00 
02,000,01,001,0011,0,1259,18,1277,1822,123456,2,1,2,0,1,0,71.76 ,70.09 ,50.00 
02,000,01,001,0012,0,720,6,726,1042,123456,2,1,2,0,1,0,71.76 ,69.67 ,50.00 
02,000,01,001,0013,0,813,15,828,1136,123456,2,1,2,0,1,0,71.76 ,72.89 ,50.00 
02,000,01,001,0014,0,763,8,771,1149,123456,2,1,2,0,1,0,71.76 ,67.10 ,50.00 
02,000,01,001,0015,0,863,11,874,1189,123456,2,1,2,0,1,0,71.76 ,73.51 ,50.00 
02,000,01,001,0016,0,444,11,455,563,123456,2,1,2,0,1,0,71.76 ,80.82 ,50.00 
02,000,01,001,0017,0,1185,24,1209,1799,123456,2,1,2,0,1,0,71.76 ,67.20 ,50.00 
02,000,01,001,0018,0,889,16,905,1266,123456,2,1,2,0,1,0,71.76 ,71.48 ,50.00 
02,000,01,001,0019,0,496,9,505,690,123456,2,1,2,0,1,0,71.76 ,73.19 ,50.00 
02,000,01,001,0020,0,544,6,550,690,123456,2,1,2,0,1,0,71.76 ,79.71 ,50.00 
02,000,01,001,0021,0,596,12,608,874,123456,2,1,2,0,1,0,71.76 ,69.57 ,50.00 
02,000,01,002,0022,0,1412,14,1426,1989,123456,2,1,2,0,1,0,71.76 ,71.69 ,50.00 
02,000,01,002,0023,0,1443,29,1472,2088,123456,2,1,2,0,1,0,71.76 ,70.50 ,50.00 
02,000,01,002,0024,0,3108,41,3149,4238,123456,2,1,2,0,1,0,71.76 ,74.30 ,50.00 
02,000,01,002,0025,0,2752,35,2787,3776,123456,2,1,2,0,1,0,71.76 ,73.81 ,50.00 
02,000,01,002,0026,0,1088,19,1107,1433,123456,2,1,2,0,1,0,71.76 ,77.25 ,50.00 
02,000,01,002,0027,0,861,8,869,1185,123456,2,1,2,0,1,0,71.76 ,73.33 ,50.00 
02,000,01,002,0028,0,1630,20,1650,2184,123456,2,1,2,0,1,0,71.76 ,75.55 ,50.00 
02,000,01,002,0029,0,2784,36,2820,3878,123456,2,1,2,0,1,0,71.76 ,72.72 ,50.00 
02,000,01,002,0030,0,593,6,599,802,123456,2,1,2,0,1,0,71.76 ,74.69 ,50.00 
02,000,01,002,0031,0,966,17,983,1440,123456,2,1,2,0,1,0,71.76 ,68.26 ,50.00 
02,000,01,002,0032,0,1344,27,1371,1869,123456,2,1,2,0,1,0,71.76 ,73.35 ,50.00 
02,000,01,002,0033,0,2311,36,2347,3287,123456,2,1,2,0,1,0,71.76 ,71.40 ,50.00 
02,000,01,002,0034,0,1988,28,2016,2731,123456,2,1,2,0,1,0,71.76 ,73.82 ,50.00 
02,000,01,002,0035,0,1908,32,1940,2721,123456,2,1,2,0,1,0,71.76 ,71.30 ,50.00 
02,000,01,002,0036,0,4777,116,4893,7278,123456,2,1,2,0,1,0,71.76 ,67.23 ,50.00 
02,000,01,002,0037,0,3566,92,3658,5753,123456,2,1,2,0,1,0,71.76 ,63.58 ,50.00 
02,000,01,002,0038,0,7958,167,8125,12170,123456,2,1,2,0,1,0,71.76 ,66.76 ,50.00 
02,000,01,002,0039,0,2529,57,2586,3626,123456,2,1,2,0,1,0,71.76 ,71.32 ,50.00 
02,000,01,002,0040,0,1963,40,2003,2836,123456,2,1,2,0,1,0,71.76 ,70.63 ,50.00 
02,000,01,002,0041,0,1540,23,1563,2345,123456,2,1,2,0,1,0,71.76 ,66.65 ,50.00 
02,000,01,002,0042,0,1030,15,1045,1446,123456,2,1,2,0,1,0,71.76 ,72.27 ,50.00 
02,000,01,002,0043,0,939,6,945,1194,123456,2,1,2,0,1,0,71.76 ,79.15 ,50.00 
02,000,01,002,0044,0,734,13,747,1295,123456,2,1,2,0,1,0,71.76 ,57.68 ,50.00 
02,000,01,002,0045,0,1023,18,1041,1454,123456,2,1,2,0,1,0,71.76 ,71.60 ,50.00 
02,000,01,002,0046,0,1005,13,1018,1409,123456,2,1,2,0,1,0,71.76 ,72.25 ,50.00 
02,000,01,002,0047,0,893,11,904,1249,123456,2,1,2,0,1,0,71.76 ,72.38 ,50.00 
02,000,01,002,0048,0,1110,23,1133,1510,123456,2,1,2,0,1,0,71.76 ,75.03 ,50.00 
02,000,01,002,0049,0,1043,16,1059,1527,123456,2,1,2,0,1,0,71.76 ,69.35 ,50.00 
02,000,01,002,0050,0,502,9,511,754,123456,2,1,2,0,1,0,71.76 ,67.77 ,50.00 
02,000,01,002,0051,0,666,14,680,1013,123456,2,1,2,0,1,0,71.76 ,67.13 ,50.00 
02,000,01,002,0052,0,751,16,767,1100,123456,2,1,2,0,1,0,71.76 ,69.73 ,50.00 
02,000,01,002,0053,0,755,16,771,1137,123456,2,1,2,0,1,0,71.76 ,67.81 ,50.00 
02,000,01,002,0054,0,646,8,654,906,123456,2,1,2,0,1,0,71.76 ,72.19 ,50.00 
02,000,01,002,0055,0,960,8,968,1403,123456,2,1,2,0,1,0,71.76 ,69.00 ,50.00 
02,000,01,002,0056,0,875,18,893,1372,123456,2,1,2,0,1,0,71.76 ,65.09 ,50.00 
02,000,01,002,0057,0,1029,11,1040,1540,123456,2,1,2,0,1,0,71.76 ,67.53 ,50.00 
02,000,01,002,0058,0,780,11,791,1151,123456,2,1,2,0,1,0,71.76 ,68.72 ,50.00 
02,000,01,002,0059,0,455,6,461,633,123456,2,1,2,0,1,0,71.76 ,72.83 ,50.00 
02,000,01,003,0060,0,861,5,866,1224,123456,2,1,2,0,1,0,71.76 ,70.75 ,50.00 
02,000,01,003,0061,0,753,8,761,1098,123456,2,1,2,0,1,0,71.76 ,69.31 ,50.00 
02,000,01,003,0062,0,1171,16,1187,1720,123456,2,1,2,0,1,0,71.76 ,69.01 ,50.00 
02,000,01,003,0063,0,1540,19,1559,2160,123456,2,1,2,0,1,0,71.76 ,72.18 ,50.00 
02,000,01,003,0064,0,1922,21,1943,2785,123456,2,1,2,0,1,0,71.76 ,69.77 ,50.00 
02,000,01,003,0065,0,917,11,928,1275,123456,2,1,2,0,1,0,71.76 ,72.78 ,50.00 
02,000,01,003,0066,0,865,12,877,1309,123456,2,1,2,0,1,0,71.76 ,67.00 ,50.00 
02,000,01,003,0067,0,1738,24,1762,2475,123456,2,1,2,0,1,0,71.76 ,71.19 ,50.00 
02,000,01,003,0068,0,1291,8,1299,1771,123456,2,1,2,0,1,0,71.76 ,73.35 ,50.00 
02,000,01,003,0069,0,1759,19,1778,2611,123456,2,1,2,0,1,0,71.76 ,68.10 ,50.00 
02,000,01,003,0070,0,1172,22,1194,1697,123456,2,1,2,0,1,0,71.76 ,70.36 ,50.00 
02,000,01,003,0071,0,603,5,608,896,123456,2,1,2,0,1,0,71.76 ,67.86 ,50.00 
02,000,01,003,0072,0,1690,33,1723,2316,123456,2,1,2,0,1,0,71.76 ,74.40 ,50.00 
02,000,02,004,0073,0,1094,12,1106,2048,123456,2,1,2,0,1,0,71.76 ,54.00 ,50.00 
02,000,02,004,0074,0,830,13,843,1150,123456,2,1,2,0,1,0,71.76 ,73.30 ,50.00 
02,000,02,004,0075,0,427,9,436,587,123456,2,1,2,0,1,0,71.76 ,74.28 ,50.00 
02,000,02,004,0076,0,527,10,537,690,123456,2,1,2,0,1,0,71.76 ,77.83 ,50.00 
02,000,02,004,0077,0,396,8,404,570,123456,2,1,2,0,1,0,71.76 ,70.88 ,50.00 
02,000,02,004,0078,0,608,11,619,862,123456,2,1,2,0,1,0,71.76 ,71.81 ,50.00 
02,000,02,004,0079,0,735,6,741,992,123456,2,1,2,0,1,0,71.76 ,74.70 ,50.00 
02,000,02,004,0080,0,552,6,558,788,123456,2,1,2,0,1,0,71.76 ,70.81 ,50.00 
02,000,02,004,0081,0,2023,32,2055,2858,123456,2,1,2,0,1,0,71.76 ,71.90 ,50.00 
02,000,02,004,0082,0,1035,22,1057,1437,123456,2,1,2,0,1,0,71.76 ,73.56 ,50.00 
02,000,02,004,0083,0,404,10,414,540,123456,2,1,2,0,1,0,71.76 ,76.67 ,50.00 
02,000,02,004,0084,0,1251,32,1283,1809,123456,2,1,2,0,1,0,71.76 ,70.92 ,50.00 
02,000,02,004,0085,0,826,8,834,1150,123456,2,1,2,0,1,0,71.76 ,72.52 ,50.00 
02,000,02,004,0086,0,1158,15,1173,1713,123456,2,1,2,0,1,0,71.76 ,68.48 ,50.00 
02,000,02,004,0087,0,1743,34,1777,2523,123456,2,1,2,0,1,0,71.76 ,70.43 ,50.00 
02,000,02,004,0088,0,923,17,940,1319,123456,2,1,2,0,1,0,71.76 ,71.27 ,50.00 
02,000,02,004,0089,0,989,12,1001,1456,123456,2,1,2,0,1,0,71.76 ,68.75 ,50.00 
02,000,02,004,0090,0,868,16,884,1130,123456,2,1,2,0,1,0,71.76 ,78.23 ,50.00 
02,000,02,004,0091,0,663,10,673,897,123456,2,1,2,0,1,0,71.76 ,75.03 ,50.00 
02,000,02,004,0092,0,264,2,266,355,123456,2,1,2,0,1,0,71.76 ,74.93 ,50.00 
02,000,02,004,0093,0,373,3,376,546,123456,2,1,2,0,1,0,71.76 ,68.86 ,50.00 
02,000,02,004,0094,0,385,7,392,545,123456,2,1,2,0,1,0,71.76 ,71.93 ,50.00 
02,000,02,004,0095,0,534,8,542,739,123456,2,1,2,0,1,0,71.76 ,73.34 ,50.00 
02,000,02,004,0096,0,359,8,367,501,123456,2,1,2,0,1,0,71.76 ,73.25 ,50.00 
02,000,02,004,0097,0,498,7,505,687,123456,2,1,2,0,1,0,71.76 ,73.51 ,50.00 
02,000,02,004,0098,0,750,10,760,1050,123456,2,1,2,0,1,0,71.76 ,72.38 ,50.00 
02,000,02,004,0099,0,892,31,923,1376,123456,2,1,2,0,1,0,71.76 ,67.08 ,50.00 
02,000,02,004,0100,0,764,8,772,1098,123456,2,1,2,0,1,0,71.76 ,70.31 ,50.00 
02,000,02,004,0101,0,4230,78,4308,5804,123456,2,1,2,0,1,0,71.76 ,74.22 ,50.00 
02,000,02,004,0102,0,830,18,848,1198,123456,2,1,2,0,1,0,71.76 ,70.78 ,50.00 
02,000,02,004,0103,0,1430,28,1458,2088,123456,2,1,2,0,1,0,71.76 ,69.83 ,50.00 
02,000,02,004,0104,0,1335,17,1352,1820,123456,2,1,2,0,1,0,71.76 ,74.29 ,50.00 
02,000,02,004,0105,0,1037,22,1059,1542,123456,2,1,2,0,1,0,71.76 ,68.68 ,50.00 
02,000,02,004,0106,0,1194,11,1205,1701,123456,2,1,2,0,1,0,71.76 ,70.84 ,50.00 
02,000,02,004,0107,0,6829,115,6944,10116,123456,2,1,2,0,1,0,71.76 ,68.64 ,50.00 
02,000,02,004,0108,0,12995,316,13311,19825,123456,2,1,2,0,1,0,71.76 ,67.14 ,50.00 
02,000,02,004,0109,0,3117,62,3179,4524,123456,2,1,2,0,1,0,71.76 ,70.27 ,50.00 
02,000,02,004,0110,0,6554,128,6682,9767,123456,2,1,2,0,1,0,71.76 ,68.41 ,50.00 
02,000,02,004,0111,0,12793,275,13068,19763,123456,2,1,2,0,1,0,71.76 ,66.12 ,50.00 
02,000,02,004,0112,0,13957,320,14277,22366,123456,2,1,2,0,1,0,71.76 ,63.83 ,50.00 
02,000,02,005,0113,0,7604,115,7719,11736,123456,2,1,2,0,1,0,71.76 ,65.77 ,50.00 
02,000,02,005,0114,0,1560,28,1588,2414,123456,2,1,2,0,1,0,71.76 ,65.78 ,50.00 
02,000,02,005,0115,0,2800,42,2842,4508,123456,2,1,2,0,1,0,71.76 ,63.04 ,50.00 
02,000,02,005,0116,0,1779,21,1800,2698,123456,2,1,2,0,1,0,71.76 ,66.72 ,50.00 
02,000,02,005,0117,0,1765,25,1790,2626,123456,2,1,2,0,1,0,71.76 ,68.16 ,50.00 
02,000,02,005,0118,0,1475,25,1500,2649,123456,2,1,2,0,1,0,71.76 ,56.63 ,50.00 
02,000,02,005,0119,0,2216,31,2247,3271,123456,2,1,2,0,1,0,71.76 ,68.69 ,50.00 
02,000,02,005,0120,0,2225,23,2248,3448,123456,2,1,2,0,1,0,71.76 ,65.20 ,50.00 
02,000,02,005,0121,0,2272,29,2301,3275,123456,2,1,2,0,1,0,71.76 ,70.26 ,50.00 
02,000,02,005,0122,0,1624,22,1646,2224,123456,2,1,2,0,1,0,71.76 ,74.01 ,50.00 
02,000,02,005,0123,0,2138,37,2175,3069,123456,2,1,2,0,1,0,71.76 ,70.87 ,50.00 
02,000,02,005,0124,0,1104,10,1114,1543,123456,2,1,2,0,1,0,71.76 ,72.20 ,50.00 
02,000,02,005,0125,0,2236,33,2269,3383,123456,2,1,2,0,1,0,71.76 ,67.07 ,50.00 
02,000,02,005,0126,0,6805,131,6936,10778,123456,2,1,2,0,1,0,71.76 ,64.35 ,50.00 
02,000,02,005,0127,0,1141,20,1161,1707,123456,2,1,2,0,1,0,71.76 ,68.01 ,50.00 
02,000,02,005,0128,0,2009,32,2041,2799,123456,2,1,2,0,1,0,71.76 ,72.92 ,50.00 
02,000,02,005,0129,0,1634,24,1658,2230,123456,2,1,2,0,1,0,71.76 ,74.35 ,50.00 
02,000,02,005,0130,0,2127,31,2158,2956,123456,2,1,2,0,1,0,71.76 ,73.00 ,50.00 
02,000,02,005,0131,0,1479,26,1505,2236,123456,2,1,2,0,1,0,71.76 ,67.31 ,50.00 
02,000,02,005,0132,0,1433,16,1449,2011,123456,2,1,2,0,1,0,71.76 ,72.05 ,50.00 
02,000,02,005,0133,0,1353,17,1370,1823,123456,2,1,2,0,1,0,71.76 ,75.15 ,50.00 
02,000,02,005,0134,0,3120,47,3167,4387,123456,2,1,2,0,1,0,71.76 ,72.19 ,50.00 
02,000,02,005,0135,0,1040,9,1049,1446,123456,2,1,2,0,1,0,71.76 ,72.54 ,50.00 
02,000,02,005,0136,0,2402,30,2432,3378,123456,2,1,2,0,1,0,71.76 ,72.00 ,50.00 
02,000,02,005,0137,0,1657,21,1678,2418,123456,2,1,2,0,1,0,71.76 ,69.40 ,50.00 
02,000,02,005,0138,0,1665,17,1682,2455,123456,2,1,2,0,1,0,71.76 ,68.51 ,50.00 
02,000,02,005,0139,0,1479,21,1500,2074,123456,2,1,2,0,1,0,71.76 ,72.32 ,50.00 
02,000,02,005,0140,0,2253,17,2270,3080,123456,2,1,2,0,1,0,71.76 ,73.70 ,50.00 
02,000,02,005,0141,0,2197,24,2221,3196,123456,2,1,2,0,1,0,71.76 ,69.49 ,50.00 
02,000,02,005,0142,0,1376,18,1394,2038,123456,2,1,2,0,1,0,71.76 ,68.40 ,50.00 
02,000,02,005,0143,0,2301,30,2331,3133,123456,2,1,2,0,1,0,71.76 ,74.40 ,50.00 
02,000,02,005,0144,0,2185,27,2212,3217,123456,2,1,2,0,1,0,71.76 ,68.76 ,50.00 
02,000,02,005,0145,0,4160,63,4223,6340,123456,2,1,2,0,1,0,71.76 ,66.61 ,50.00 
02,000,02,005,0146,0,2255,45,2300,3548,123456,2,1,2,0,1,0,71.76 ,64.83 ,50.00 
02,000,02,005,0147,0,1296,19,1315,1864,123456,2,1,2,0,1,0,71.76 ,70.55 ,50.00 
02,000,02,005,0148,0,683,8,691,983,123456,2,1,2,0,1,0,71.76 ,70.30 ,50.00 
02,000,02,005,0149,0,1107,12,1119,1540,123456,2,1,2,0,1,0,71.76 ,72.66 ,50.00 
02,000,03,006,0150,0,1936,34,1970,3105,123456,2,1,2,0,1,0,71.76 ,63.45 ,50.00 
02,000,03,006,0151,0,3837,74,3911,6019,123456,2,1,2,0,1,0,71.76 ,64.98 ,50.00 
02,000,03,006,0152,0,2271,47,2318,3404,123456,2,1,2,0,1,0,71.76 ,68.10 ,50.00 
02,000,03,006,0153,0,2239,46,2285,3393,123456,2,1,2,0,1,0,71.76 ,67.34 ,50.00 
02,000,03,006,0154,0,3796,82,3878,5962,123456,2,1,2,0,1,0,71.76 ,65.05 ,50.00 
02,000,03,006,0155,0,2288,41,2329,3189,123456,2,1,2,0,1,0,71.76 ,73.03 ,50.00 
02,000,03,006,0156,0,10912,210,11122,16481,123456,2,1,2,0,1,0,71.76 ,67.48 ,50.00 
02,000,03,006,0157,0,4971,82,5053,7506,123456,2,1,2,0,1,0,71.76 ,67.32 ,50.00 
02,000,03,006,0158,0,3897,67,3964,6090,123456,2,1,2,0,1,0,71.76 ,65.09 ,50.00 
02,000,03,006,0159,0,1399,16,1415,2027,123456,2,1,2,0,1,0,71.76 ,69.81 ,50.00 
02,000,03,006,0160,0,1053,23,1076,1557,123456,2,1,2,0,1,0,71.76 ,69.11 ,50.00 
02,000,03,006,0161,0,3095,55,3150,4610,123456,2,1,2,0,1,0,71.76 ,68.33 ,50.00 
02,000,03,006,0162,0,2614,52,2666,3886,123456,2,1,2,0,1,0,71.76 ,68.61 ,50.00 
02,000,03,006,0163,0,2787,47,2834,4246,123456,2,1,2,0,1,0,71.76 ,66.75 ,50.00 
02,000,03,006,0164,0,4311,92,4403,6662,123456,2,1,2,0,1,0,71.76 ,66.09 ,50.00 
02,000,03,006,0165,0,2196,44,2240,3448,123456,2,1,2,0,1,0,71.76 ,64.97 ,50.00 
02,000,03,006,0166,0,2874,53,2927,4511,123456,2,1,2,0,1,0,71.76 ,64.89 ,50.00 
02,000,03,006,0167,0,2093,44,2137,3395,123456,2,1,2,0,1,0,71.76 ,62.95 ,50.00 
02,000,03,006,0168,0,3680,59,3739,5444,123456,2,1,2,0,1,0,71.76 ,68.68 ,50.00 
02,000,03,006,0169,0,1848,29,1877,2718,123456,2,1,2,0,1,0,71.76 ,69.06 ,50.00 
02,000,03,006,0170,0,1793,45,1838,2843,123456,2,1,2,0,1,0,71.76 ,64.65 ,50.00 
02,000,03,006,0171,0,4352,74,4426,6701,123456,2,1,2,0,1,0,71.76 ,66.05 ,50.00 
02,000,03,006,0172,0,1717,43,1760,2648,123456,2,1,2,0,1,0,71.76 ,66.47 ,50.00 
02,000,03,006,0173,0,1547,38,1585,2517,123456,2,1,2,0,1,0,71.76 ,62.97 ,50.00 
02,000,03,006,0174,0,2660,46,2706,4245,123456,2,1,2,0,1,0,71.76 ,63.75 ,50.00 
02,000,03,006,0175,0,2806,54,2860,4175,123456,2,1,2,0,1,0,71.76 ,68.50 ,50.00 
02,000,03,006,0176,0,3802,61,3863,6043,123456,2,1,2,0,1,0,71.76 ,63.93 ,50.00 
02,000,03,006,0177,0,2650,42,2692,3917,123456,2,1,2,0,1,0,71.76 ,68.73 ,50.00 
02,000,03,006,0178,0,3106,61,3167,5518,123456,2,1,2,0,1,0,71.76 ,57.39 ,50.00 
02,000,03,006,0179,0,4587,81,4668,7243,123456,2,1,2,0,1,0,71.76 ,64.45 ,50.00 
02,000,03,006,0180,0,1916,36,1952,3057,123456,2,1,2,0,1,0,71.76 ,63.85 ,50.00 
02,000,03,006,0181,0,1825,41,1866,2881,123456,2,1,2,0,1,0,71.76 ,64.77 ,50.00 
02,000,03,006,0182,0,2596,46,2642,4044,123456,2,1,2,0,1,0,71.76 ,65.33 ,50.00 
02,000,03,006,0183,0,1618,22,1640,2606,123456,2,1,2,0,1,0,71.76 ,62.93 ,50.00 
02,000,03,006,0184,0,1398,21,1419,2010,123456,2,1,2,0,1,0,71.76 ,70.60 ,50.00 
02,000,03,006,0185,0,2155,42,2197,3212,123456,2,1,2,0,1,0,71.76 ,68.40 ,50.00 
02,000,03,006,0186,0,1914,30,1944,3040,123456,2,1,2,0,1,0,71.76 ,63.95 ,50.00 
02,000,03,006,0187,0,5783,79,5862,9144,123456,2,1,2,0,1,0,71.76 ,64.11 ,50.00 
02,000,03,006,0188,0,2157,37,2194,3271,123456,2,1,2,0,1,0,71.76 ,67.07 ,50.00 
02,000,03,006,0189,0,1138,20,1158,1625,123456,2,1,2,0,1,0,71.76 ,71.26 ,50.00 
02,000,03,006,0190,0,1293,16,1309,2076,123456,2,1,2,0,1,0,71.76 ,63.05 ,50.00 
02,000,03,006,0191,0,1875,31,1906,2893,123456,2,1,2,0,1,0,71.76 ,65.88 ,50.00 
02,000,03,006,0192,0,1337,24,1361,1990,123456,2,1,2,0,1,0,71.76 ,68.39 ,50.00 
02,000,03,006,0193,0,2808,45,2853,4392,123456,2,1,2,0,1,0,71.76 ,64.96 ,50.00 
02,000,03,006,0194,0,2721,59,2780,4243,123456,2,1,2,0,1,0,71.76 ,65.52 ,50.00 
02,000,03,006,0195,0,2148,42,2190,3078,123456,2,1,2,0,1,0,71.76 ,71.15 ,50.00 
02,000,03,006,0196,0,1807,39,1846,2590,123456,2,1,2,0,1,0,71.76 ,71.27 ,50.00 
02,000,03,006,0197,0,1021,18,1039,1406,123456,2,1,2,0,1,0,71.76 ,73.90 ,50.00 
02,000,03,006,0198,0,1166,22,1188,1630,123456,2,1,2,0,1,0,71.76 ,72.88 ,50.00 
02,000,03,006,0199,0,991,18,1009,1412,123456,2,1,2,0,1,0,71.76 ,71.46 ,50.00 
02,000,03,006,0200,0,729,14,743,1042,123456,2,1,2,0,1,0,71.76 ,71.31 ,50.00 
02,000,03,006,0201,0,1876,33,1909,2814,123456,2,1,2,0,1,0,71.76 ,67.84 ,50.00 
02,000,03,006,0202,0,1643,26,1669,2375,123456,2,1,2,0,1,0,71.76 ,70.27 ,50.00 
02,000,03,006,0203,0,1215,27,1242,1853,123456,2,1,2,0,1,0,71.76 ,67.03 ,50.00 
02,000,03,006,0204,0,1153,21,1174,1605,123456,2,1,2,0,1,0,71.76 ,73.15 ,50.00 
02,000,03,006,0205,0,615,8,623,852,123456,2,1,2,0,1,0,71.76 ,73.12 ,50.00 
02,000,03,006,0206,0,769,17,786,1086,123456,2,1,2,0,1,0,71.76 ,72.38 ,50.00 
02,000,03,006,0207,0,1094,32,1126,1569,123456,2,1,2,0,1,0,71.76 ,71.77 ,50.00 
02,000,03,006,0208,0,1457,21,1478,2057,123456,2,1,2,0,1,0,71.76 ,71.85 ,50.00 
02,000,03,006,0209,0,2207,48,2255,3129,123456,2,1,2,0,1,0,71.76 ,72.07 ,50.00 
02,000,03,006,0210,0,2560,42,2602,3856,123456,2,1,2,0,1,0,71.76 ,67.48 ,50.00 
02,000,03,006,0211,0,2428,38,2466,3909,123456,2,1,2,0,1,0,71.76 ,63.09 ,50.00 
02,000,03,006,0212,0,1082,10,1092,1531,123456,2,1,2,0,1,0,71.76 ,71.33 ,50.00 
02,000,03,006,0213,0,1238,26,1264,1814,123456,2,1,2,0,1,0,71.76 ,69.68 ,50.00 
02,000,03,006,0214,0,1340,28,1368,2006,123456,2,1,2,0,1,0,71.76 ,68.20 ,50.00 
02,000,03,006,0215,0,636,12,648,881,123456,2,1,2,0,1,0,71.76 ,73.55 ,50.00 
02,000,03,006,0216,0,723,15,738,1035,123456,2,1,2,0,1,0,71.76 ,71.30 ,50.00 
02,000,03,006,0217,0,913,12,925,1351,123456,2,1,2,0,1,0,71.76 ,68.47 ,50.00 
02,000,03,006,0218,0,923,17,940,1386,123456,2,1,2,0,1,0,71.76 ,67.82 ,50.00 
02,000,03,006,0219,0,528,8,536,805,123456,2,1,2,0,1,0,71.76 ,66.58 ,50.00 
02,000,03,006,0220,0,172,3,175,248,123456,2,1,2,0,1,0,71.76 ,70.56 ,50.00 
02,000,03,006,0221,0,735,11,746,1142,123456,2,1,2,0,1,0,71.76 ,65.32 ,50.00 
02,000,03,006,0222,0,2719,55,2774,4007,123456,2,1,2,0,1,0,71.76 ,69.23 ,50.00 
02,000,03,006,0223,0,752,19,771,1131,123456,2,1,2,0,1,0,71.76 ,68.17 ,50.00 
02,000,03,006,0224,0,620,12,632,1088,123456,2,1,2,0,1,0,71.76 ,58.09 ,50.00 
02,000,03,006,0225,0,1106,28,1134,1669,123456,2,1,2,0,1,0,71.76 ,67.94 ,50.00 
02,000,03,006,0226,0,786,13,799,1109,123456,2,1,2,0,1,0,71.76 ,72.05 ,50.00 
02,000,03,006,0227,0,1222,21,1243,1724,123456,2,1,2,0,1,0,71.76 ,72.10 ,50.00 
02,000,03,006,0228,0,772,20,792,1168,123456,2,1,2,0,1,0,71.76 ,67.81 ,50.00 
02,000,03,006,0229,0,1831,52,1883,2626,123456,2,1,2,0,1,0,71.76 ,71.71 ,50.00 
02,000,03,006,0230,0,1184,34,1218,1826,123456,2,1,2,0,1,0,71.76 ,66.70 ,50.00 
02,000,03,006,0231,0,808,33,841,1165,123456,2,1,2,0,1,0,71.76 ,72.19 ,50.00 
02,000,03,006,0232,0,853,13,866,1114,123456,2,1,2,0,1,0,71.76 ,77.74 ,50.00 
02,000,03,006,0233,0,795,16,811,1136,123456,2,1,2,0,1,0,71.76 ,71.39 ,50.00 
02,000,03,006,0234,0,911,18,929,1315,123456,2,1,2,0,1,0,71.76 ,70.65 ,50.00 
02,000,03,006,0235,0,925,30,955,1315,123456,2,1,2,0,1,0,71.76 ,72.62 ,50.00 
02,000,03,006,0236,0,1478,32,1510,2254,123456,2,1,2,0,1,0,71.76 ,66.99 ,50.00 
02,000,04,007,0237,0,1273,20,1293,1897,123456,2,1,2,0,1,0,71.76 ,68.16 ,50.00 
02,000,04,007,0238,0,798,14,812,1249,123456,2,1,2,0,1,0,71.76 ,65.01 ,50.00 
02,000,04,007,0239,0,1716,26,1742,2687,123456,2,1,2,0,1,0,71.76 ,64.83 ,50.00 
02,000,04,007,0240,0,844,11,855,1268,123456,2,1,2,0,1,0,71.76 ,67.43 ,50.00 
02,000,04,007,0241,0,1052,19,1071,1553,123456,2,1,2,0,1,0,71.76 ,68.96 ,50.00 
02,000,04,007,0242,0,491,9,500,747,123456,2,1,2,0,1,0,71.76 ,66.93 ,50.00 
02,000,04,007,0243,0,537,11,548,908,123456,2,1,2,0,1,0,71.76 ,60.35 ,50.00 
02,000,04,007,0244,0,1348,19,1367,2044,123456,2,1,2,0,1,0,71.76 ,66.88 ,50.00 
02,000,04,007,0245,0,668,14,682,995,123456,2,1,2,0,1,0,71.76 ,68.54 ,50.00 
02,000,04,007,0246,0,540,9,549,762,123456,2,1,2,0,1,0,71.76 ,72.05 ,50.00 
02,000,04,007,0247,0,900,15,915,1405,123456,2,1,2,0,1,0,71.76 ,65.12 ,50.00 
02,000,04,007,0248,0,657,12,669,1027,123456,2,1,2,0,1,0,71.76 ,65.14 ,50.00 
02,000,04,007,0249,0,1413,22,1435,2020,123456,2,1,2,0,1,0,71.76 ,71.04 ,50.00 
02,000,04,007,0250,0,1709,34,1743,2580,123456,2,1,2,0,1,0,71.76 ,67.56 ,50.00 
02,000,04,007,0251,0,1571,19,1590,2326,123456,2,1,2,0,1,0,71.76 ,68.36 ,50.00 
02,000,04,007,0252,0,1185,21,1206,1741,123456,2,1,2,0,1,0,71.76 ,69.27 ,50.00 
02,000,04,007,0253,0,2073,48,2121,3035,123456,2,1,2,0,1,0,71.76 ,69.88 ,50.00 
02,000,04,007,0254,0,779,15,794,1160,123456,2,1,2,0,1,0,71.76 ,68.45 ,50.00 
02,000,04,007,0255,0,690,17,707,1112,123456,2,1,2,0,1,0,71.76 ,63.58 ,50.00 
02,000,04,007,0256,0,589,11,600,905,123456,2,1,2,0,1,0,71.76 ,66.30 ,50.00 
02,000,04,007,0257,0,550,6,556,857,123456,2,1,2,0,1,0,71.76 ,64.88 ,50.00 
02,000,04,007,0258,0,1528,29,1557,2184,123456,2,1,2,0,1,0,71.76 ,71.29 ,50.00 
02,000,04,007,0259,0,1595,33,1628,2825,123456,2,1,2,0,1,0,71.76 ,57.63 ,50.00 
02,000,04,007,0260,0,525,9,534,820,123456,2,1,2,0,1,0,71.76 ,65.12 ,50.00 
02,000,04,007,0261,0,750,15,765,1137,123456,2,1,2,0,1,0,71.76 ,67.28 ,50.00 
02,000,04,007,0262,0,625,10,635,948,123456,2,1,2,0,1,0,71.76 ,66.98 ,50.00 
02,000,04,007,0263,0,627,14,641,966,123456,2,1,2,0,1,0,71.76 ,66.36 ,50.00 
02,000,04,007,0264,0,577,11,588,881,123456,2,1,2,0,1,0,71.76 ,66.74 ,50.00 
02,000,04,007,0265,0,606,18,624,944,123456,2,1,2,0,1,0,71.76 ,66.10 ,50.00 
02,000,04,007,0266,0,599,18,617,850,123456,2,1,2,0,1,0,71.76 ,72.59 ,50.00 
02,000,04,007,0267,0,565,11,576,822,123456,2,1,2,0,1,0,71.76 ,70.07 ,50.00 
02,000,04,007,0268,0,861,13,874,1273,123456,2,1,2,0,1,0,71.76 ,68.66 ,50.00 
02,000,04,008,0269,0,519,11,530,753,123456,2,1,2,0,1,0,71.76 ,70.39 ,50.00 
02,000,04,008,0270,0,743,20,763,1118,123456,2,1,2,0,1,0,71.76 ,68.25 ,50.00 
02,000,04,008,0271,0,951,11,962,1395,123456,2,1,2,0,1,0,71.76 ,68.96 ,50.00 
02,000,04,008,0272,0,562,9,571,886,123456,2,1,2,0,1,0,71.76 ,64.45 ,50.00 
02,000,04,008,0273,0,619,12,631,948,123456,2,1,2,0,1,0,71.76 ,66.56 ,50.00 
02,000,04,008,0274,0,2014,37,2051,3043,123456,2,1,2,0,1,0,71.76 ,67.40 ,50.00 
02,000,04,008,0275,0,571,10,581,907,123456,2,1,2,0,1,0,71.76 ,64.06 ,50.00 
02,000,04,008,0276,0,712,6,718,1137,123456,2,1,2,0,1,0,71.76 ,63.15 ,50.00 
02,000,04,008,0277,0,893,16,909,1458,123456,2,1,2,0,1,0,71.76 ,62.35 ,50.00 
02,000,04,008,0278,0,467,8,475,732,123456,2,1,2,0,1,0,71.76 ,64.89 ,50.00 
02,000,04,008,0279,0,694,8,702,1055,123456,2,1,2,0,1,0,71.76 ,66.54 ,50.00 
02,000,04,008,0280,0,750,16,766,1262,123456,2,1,2,0,1,0,71.76 ,60.70 ,50.00 
02,000,04,008,0281,0,720,19,739,1073,123456,2,1,2,0,1,0,71.76 ,68.87 ,50.00 
02,000,04,008,0282,0,1156,19,1175,1690,123456,2,1,2,0,1,0,71.76 ,69.53 ,50.00 
02,000,04,008,0283,0,764,12,776,1169,123456,2,1,2,0,1,0,71.76 ,66.38 ,50.00 
02,000,04,008,0284,0,604,9,613,930,123456,2,1,2,0,1,0,71.76 ,65.91 ,50.00 
02,000,04,008,0285,0,954,18,972,1520,123456,2,1,2,0,1,0,71.76 ,63.95 ,50.00 
02,000,04,008,0286,0,851,19,870,1255,123456,2,1,2,0,1,0,71.76 ,69.32 ,50.00 
02,000,04,008,0287,0,729,7,736,1070,123456,2,1,2,0,1,0,71.76 ,68.79 ,50.00 
02,000,04,008,0288,0,864,25,889,1317,123456,2,1,2,0,1,0,71.76 ,67.50 ,50.00 
02,000,04,009,0289,0,434,9,443,605,123456,2,1,2,0,1,0,71.76 ,73.22 ,50.00 
02,000,04,009,0290,0,867,20,887,1271,123456,2,1,2,0,1,0,71.76 ,69.79 ,50.00 
02,000,04,009,0291,0,1008,9,1017,1383,123456,2,1,2,0,1,0,71.76 ,73.54 ,50.00 
02,000,04,009,0292,0,1082,16,1098,1627,123456,2,1,2,0,1,0,71.76 ,67.49 ,50.00 
02,000,04,009,0293,0,995,16,1011,1470,123456,2,1,2,0,1,0,71.76 ,68.78 ,50.00 
02,000,04,009,0294,0,1037,23,1060,1577,123456,2,1,2,0,1,0,71.76 ,67.22 ,50.00 
02,000,04,009,0295,0,1017,22,1039,1550,123456,2,1,2,0,1,0,71.76 ,67.03 ,50.00 
02,000,04,009,0296,0,457,10,467,673,123456,2,1,2,0,1,0,71.76 ,69.39 ,50.00 
02,000,04,009,0297,0,1241,31,1272,1981,123456,2,1,2,0,1,0,71.76 ,64.21 ,50.00 
02,000,04,009,0298,0,1742,31,1773,2921,123456,2,1,2,0,1,0,71.76 ,60.70 ,50.00 
02,000,04,009,0299,0,777,16,793,1080,123456,2,1,2,0,1,0,71.76 ,73.43 ,50.00 
02,000,04,009,0300,0,953,10,963,1377,123456,2,1,2,0,1,0,71.76 ,69.93 ,50.00 
02,000,04,009,0301,0,1206,17,1223,1856,123456,2,1,2,0,1,0,71.76 ,65.89 ,50.00 
02,000,04,009,0302,0,854,15,869,1327,123456,2,1,2,0,1,0,71.76 ,65.49 ,50.00 
02,000,04,009,0303,0,1425,30,1455,1978,123456,2,1,2,0,1,0,71.76 ,73.56 ,50.00 
02,000,04,009,0304,0,819,17,836,1231,123456,2,1,2,0,1,0,71.76 ,67.91 ,50.00 
02,000,04,009,0305,0,1941,28,1969,2937,123456,2,1,2,0,1,0,71.76 ,67.04 ,50.00 
02,000,04,009,0306,0,1483,43,1526,2214,123456,2,1,2,0,1,0,71.76 ,68.93 ,50.00 
02,000,04,009,0307,0,1729,30,1759,2580,123456,2,1,2,0,1,0,71.76 ,68.18 ,50.00 
02,000,04,009,0308,0,1481,18,1499,2134,123456,2,1,2,0,1,0,71.76 ,70.24 ,50.00 
02,000,04,009,0309,0,791,17,808,1899,123456,2,1,2,0,1,0,71.76 ,42.55 ,50.00 
02,000,04,009,0310,0,1901,30,1931,2855,123456,2,1,2,0,1,0,71.76 ,67.64 ,50.00 
02,000,04,009,0311,0,1252,26,1278,1845,123456,2,1,2,0,1,0,71.76 ,69.27 ,50.00 
02,000,04,009,0312,0,1451,37,1488,2189,123456,2,1,2,0,1,0,71.76 ,67.98 ,50.00 
02,000,04,009,0313,0,1062,14,1076,1540,123456,2,1,2,0,1,0,71.76 ,69.87 ,50.00 
02,000,04,009,0314,0,527,11,538,756,123456,2,1,2,0,1,0,71.76 ,71.16 ,50.00 
02,000,04,009,0315,0,985,19,1004,1405,123456,2,1,2,0,1,0,71.76 ,71.46 ,50.00 
02,000,04,009,0316,0,1953,40,1993,2939,123456,2,1,2,0,1,0,71.76 ,67.81 ,50.00 
02,000,04,009,0317,0,1120,24,1144,1710,123456,2,1,2,0,1,0,71.76 ,66.90 ,50.00 
02,000,04,009,0318,0,2137,46,2183,3172,123456,2,1,2,0,1,0,71.76 ,68.82 ,50.00 
02,000,04,009,0319,0,1230,20,1250,1834,123456,2,1,2,0,1,0,71.76 ,68.16 ,50.00 
02,000,04,009,0320,0,1907,40,1947,2899,123456,2,1,2,0,1,0,71.76 ,67.16 ,50.00 
02,000,04,009,0321,0,1705,32,1737,2607,123456,2,1,2,0,1,0,71.76 ,66.63 ,50.00 
02,000,04,009,0322,0,942,12,954,1429,123456,2,1,2,0,1,0,71.76 ,66.76 ,50.00 
02,000,04,009,0323,0,1358,31,1389,2004,123456,2,1,2,0,1,0,71.76 ,69.31 ,50.00 
02,000,04,009,0324,0,1331,22,1353,1848,123456,2,1,2,0,1,0,71.76 ,73.21 ,50.00 
02,000,04,009,0325,0,1559,42,1601,2368,123456,2,1,2,0,1,0,71.76 ,67.61 ,50.00 
02,000,04,009,0326,0,1135,8,1143,1611,123456,2,1,2,0,1,0,71.76 ,70.95 ,50.00 
02,000,04,009,0327,0,1062,13,1075,1526,123456,2,1,2,0,1,0,71.76 ,70.45 ,50.00 
02,000,04,009,0328,0,1544,26,1570,2259,123456,2,1,2,0,1,0,71.76 ,69.50 ,50.00 
02,000,04,009,0329,0,1341,28,1369,1957,123456,2,1,2,0,1,0,71.76 ,69.95 ,50.00 
02,000,04,009,0330,0,2506,45,2551,3822,123456,2,1,2,0,1,0,71.76 ,66.75 ,50.00 
02,000,04,009,0331,0,1204,19,1223,1818,123456,2,1,2,0,1,0,71.76 ,67.27 ,50.00 
02,000,04,009,0332,0,955,15,970,1349,123456,2,1,2,0,1,0,71.76 ,71.91 ,50.00 
02,000,04,009,0333,0,2628,52,2680,3913,123456,2,1,2,0,1,0,71.76 ,68.49 ,50.00 
02,000,04,009,0334,0,1321,22,1343,2028,123456,2,1,2,0,1,0,71.76 ,66.22 ,50.00 
02,000,04,009,0335,0,1077,9,1086,1538,123456,2,1,2,0,1,0,71.76 ,70.61 ,50.00 
02,000,04,009,0336,0,957,16,973,1458,123456,2,1,2,0,1,0,71.76 ,66.74 ,50.00 
02,000,04,009,0337,0,1750,28,1778,2693,123456,2,1,2,0,1,0,71.76 ,66.02 ,50.00 
02,000,04,009,0338,0,900,10,910,1308,123456,2,1,2,0,1,0,71.76 ,69.57 ,50.00 
02,000,04,009,0339,0,757,15,772,1075,123456,2,1,2,0,1,0,71.76 ,71.81 ,50.00 
02,000,04,009,0340,0,1288,21,1309,1892,123456,2,1,2,0,1,0,71.76 ,69.19 ,50.00 
02,000,04,009,0341,0,1431,31,1462,2085,123456,2,1,2,0,1,0,71.76 ,70.12 ,50.00 
02,000,04,009,0342,0,1970,40,2010,2818,123456,2,1,2,0,1,0,71.76 ,71.33 ,50.00 
02,000,04,009,0343,0,1944,43,1987,2791,123456,2,1,2,0,1,0,71.76 ,71.19 ,50.00 
02,000,04,009,0344,0,1732,29,1761,2548,123456,2,1,2,0,1,0,71.76 ,69.11 ,50.00 
02,000,04,009,0345,0,1323,35,1358,1922,123456,2,1,2,0,1,0,71.76 ,70.66 ,50.00 
02,000,04,009,0346,0,1618,22,1640,2371,123456,2,1,2,0,1,0,71.76 ,69.17 ,50.00 
02,000,04,009,0347,0,1219,20,1239,1826,123456,2,1,2,0,1,0,71.76 ,67.85 ,50.00 
02,000,04,009,0348,0,1842,39,1881,2704,123456,2,1,2,0,1,0,71.76 ,69.56 ,50.00 
02,000,04,009,0349,0,2949,64,3013,4598,123456,2,1,2,0,1,0,71.76 ,65.53 ,50.00 
02,000,04,009,0350,0,2475,56,2531,3800,123456,2,1,2,0,1,0,71.76 ,66.61 ,50.00 
02,000,04,009,0351,0,2336,43,2379,3610,123456,2,1,2,0,1,0,71.76 ,65.90 ,50.00 
02,000,04,009,0352,0,2698,44,2742,4171,123456,2,1,2,0,1,0,71.76 ,65.74 ,50.00 
02,000,04,009,0353,0,1609,31,1640,2404,123456,2,1,2,0,1,0,71.76 ,68.22 ,50.00 
02,000,04,009,0354,0,1702,22,1724,2521,123456,2,1,2,0,1,0,71.76 ,68.39 ,50.00 
02,000,04,009,0355,0,2646,48,2694,3809,123456,2,1,2,0,1,0,71.76 ,70.73 ,50.00 
02,000,04,009,0356,0,1382,29,1411,2049,123456,2,1,2,0,1,0,71.76 ,68.86 ,50.00 
02,000,04,009,0357,0,1344,19,1363,2131,123456,2,1,2,0,1,0,71.76 ,63.96 ,50.00 
02,000,05,010,0358,0,5266,122,5388,8279,123456,2,1,2,0,1,0,71.76 ,65.08 ,50.00 
02,000,05,010,0359,0,1674,45,1719,2480,123456,2,1,2,0,1,0,71.76 ,69.31 ,50.00 
02,000,05,010,0360,0,2194,44,2238,3266,123456,2,1,2,0,1,0,71.76 ,68.52 ,50.00 
02,000,05,010,0361,0,1458,35,1493,2068,123456,2,1,2,0,1,0,71.76 ,72.20 ,50.00 
02,000,05,010,0362,0,923,11,934,1381,123456,2,1,2,0,1,0,71.76 ,67.63 ,50.00 
02,000,05,010,0363,0,1214,23,1237,1807,123456,2,1,2,0,1,0,71.76 ,68.46 ,50.00 
02,000,05,010,0364,0,1167,19,1186,2404,123456,2,1,2,0,1,0,71.76 ,49.33 ,50.00 
02,000,05,010,0365,0,413,11,424,661,123456,2,1,2,0,1,0,71.76 ,64.15 ,50.00 
02,000,05,010,0366,0,1107,20,1127,1700,123456,2,1,2,0,1,0,71.76 ,66.29 ,50.00 
02,000,05,010,0367,0,1058,26,1084,1527,123456,2,1,2,0,1,0,71.76 ,70.99 ,50.00 
02,000,05,010,0368,0,1533,30,1563,2356,123456,2,1,2,0,1,0,71.76 ,66.34 ,50.00 
02,000,05,010,0369,0,869,15,884,1216,123456,2,1,2,0,1,0,71.76 ,72.70 ,50.00 
02,000,05,010,0370,0,544,8,552,750,123456,2,1,2,0,1,0,71.76 ,73.60 ,50.00 
02,000,05,010,0371,0,550,13,563,855,123456,2,1,2,0,1,0,71.76 ,65.85 ,50.00 
02,000,05,010,0372,0,1093,30,1123,1533,123456,2,1,2,0,1,0,71.76 ,73.26 ,50.00 
02,000,05,010,0373,0,1327,38,1365,1862,123456,2,1,2,0,1,0,71.76 ,73.31 ,50.00 
02,000,05,010,0374,0,1544,34,1578,2249,123456,2,1,2,0,1,0,71.76 ,70.16 ,50.00 
02,000,05,010,0375,0,1371,37,1408,2037,123456,2,1,2,0,1,0,71.76 ,69.12 ,50.00 
02,000,05,010,0376,0,2524,61,2585,4000,123456,2,1,2,0,1,0,71.76 ,64.63 ,50.00 
02,000,05,010,0377,0,785,20,805,1075,123456,2,1,2,0,1,0,71.76 ,74.88 ,50.00 
02,000,05,010,0378,0,1384,38,1422,2069,123456,2,1,2,0,1,0,71.76 ,68.73 ,50.00 
02,000,05,010,0379,0,625,23,648,871,123456,2,1,2,0,1,0,71.76 ,74.40 ,50.00 
02,000,05,010,0380,0,792,22,814,1056,123456,2,1,2,0,1,0,71.76 ,77.08 ,50.00 
02,000,05,010,0381,0,3420,52,3472,4910,123456,2,1,2,0,1,0,71.76 ,70.71 ,50.00 
02,000,05,010,0382,0,1524,33,1557,2048,123456,2,1,2,0,1,0,71.76 ,76.03 ,50.00 
02,000,05,010,0383,0,2282,59,2341,3397,123456,2,1,2,0,1,0,71.76 ,68.91 ,50.00 
02,000,05,010,0384,0,2662,73,2735,3859,123456,2,1,2,0,1,0,71.76 ,70.87 ,50.00 
02,000,05,010,0385,0,566,16,582,835,123456,2,1,2,0,1,0,71.76 ,69.70 ,50.00 
02,000,05,010,0386,0,1412,34,1446,2056,123456,2,1,2,0,1,0,71.76 ,70.33 ,50.00 
02,000,05,010,0387,0,1762,34,1796,2615,123456,2,1,2,0,1,0,71.76 ,68.68 ,50.00 
02,000,05,010,0388,0,1298,27,1325,1904,123456,2,1,2,0,1,0,71.76 ,69.59 ,50.00 
02,000,05,010,0389,0,1533,44,1577,2497,123456,2,1,2,0,1,0,71.76 ,63.16 ,50.00 
02,000,05,010,0390,0,1812,59,1871,2883,123456,2,1,2,0,1,0,71.76 ,64.90 ,50.00 
02,000,05,010,0391,0,1819,46,1865,2942,123456,2,1,2,0,1,0,71.76 ,63.39 ,50.00 
02,000,05,010,0392,0,3052,88,3140,4763,123456,2,1,2,0,1,0,71.76 ,65.92 ,50.00 
02,000,05,010,0393,0,1577,42,1619,2313,123456,2,1,2,0,1,0,71.76 ,70.00 ,50.00 
02,000,05,010,0394,0,1891,31,1922,2769,123456,2,1,2,0,1,0,71.76 ,69.41 ,50.00 
02,000,05,010,0395,0,1783,35,1818,2526,123456,2,1,2,0,1,0,71.76 ,71.97 ,50.00 
02,000,05,010,0396,0,1305,39,1344,2092,123456,2,1,2,0,1,0,71.76 ,64.24 ,50.00 
02,000,05,010,0397,0,2194,59,2253,3486,123456,2,1,2,0,1,0,71.76 ,64.63 ,50.00 
02,000,05,010,0398,0,1316,29,1345,2036,123456,2,1,2,0,1,0,71.76 ,66.06 ,50.00 
02,000,05,010,0399,0,2662,79,2741,3809,123456,2,1,2,0,1,0,71.76 ,71.96 ,50.00 
02,000,05,010,0400,0,1927,46,1973,2945,123456,2,1,2,0,1,0,71.76 ,66.99 ,50.00 
02,000,05,010,0401,0,876,37,913,1315,123456,2,1,2,0,1,0,71.76 ,69.43 ,50.00 
02,000,05,010,0402,0,3016,71,3087,4467,123456,2,1,2,0,1,0,71.76 ,69.11 ,50.00 
02,000,05,010,0403,0,1787,44,1831,2604,123456,2,1,2,0,1,0,71.76 ,70.31 ,50.00 
02,000,05,010,0404,0,3146,68,3214,4627,123456,2,1,2,0,1,0,71.76 ,69.46 ,50.00 
02,000,05,010,0405,0,1633,40,1673,2344,123456,2,1,2,0,1,0,71.76 ,71.37 ,50.00 
02,000,05,010,0406,0,1283,37,1320,1962,123456,2,1,2,0,1,0,71.76 ,67.28 ,50.00 
02,000,05,010,0407,0,2514,50,2564,3639,123456,2,1,2,0,1,0,71.76 ,70.46 ,50.00 
02,000,05,010,0408,0,2218,43,2261,3398,123456,2,1,2,0,1,0,71.76 ,66.54 ,50.00 
02,000,05,010,0409,0,1923,42,1965,2916,123456,2,1,2,0,1,0,71.76 ,67.39 ,50.00 
02,000,05,010,0410,0,1784,33,1817,2535,123456,2,1,2,0,1,0,71.76 ,71.68 ,50.00 
02,000,05,010,0411,0,1680,25,1705,2490,123456,2,1,2,0,1,0,71.76 ,68.47 ,50.00 
02,000,05,010,0412,0,1654,33,1687,2559,123456,2,1,2,0,1,0,71.76 ,65.92 ,50.00 
02,000,05,010,0413,0,1637,30,1667,2496,123456,2,1,2,0,1,0,71.76 ,66.79 ,50.00 
02,000,05,010,0414,0,1560,40,1600,2391,123456,2,1,2,0,1,0,71.76 ,66.92 ,50.00 
02,000,05,010,0415,0,2639,68,2707,4202,123456,2,1,2,0,1,0,71.76 ,64.42 ,50.00 
02,000,05,010,0416,0,1749,33,1782,2712,123456,2,1,2,0,1,0,71.76 ,65.71 ,50.00 
02,000,05,011,0417,0,1336,18,1354,1960,123456,2,1,2,0,1,0,71.76 ,69.08 ,50.00 
02,000,05,011,0418,0,2120,41,2161,3239,123456,2,1,2,0,1,0,71.76 ,66.72 ,50.00 
02,000,05,011,0419,0,1645,37,1682,2467,123456,2,1,2,0,1,0,71.76 ,68.18 ,50.00 
02,000,05,011,0420,0,1120,19,1139,1568,123456,2,1,2,0,1,0,71.76 ,72.64 ,50.00 
02,000,05,011,0421,0,2020,34,2054,2910,123456,2,1,2,0,1,0,71.76 ,70.58 ,50.00 
02,000,05,011,0422,0,1393,19,1412,2006,123456,2,1,2,0,1,0,71.76 ,70.39 ,50.00 
02,000,05,011,0423,0,1125,23,1148,1922,123456,2,1,2,0,1,0,71.76 ,59.73 ,50.00 
02,000,05,011,0424,0,1553,28,1581,2248,123456,2,1,2,0,1,0,71.76 ,70.33 ,50.00 
02,000,05,011,0425,0,1235,25,1260,1984,123456,2,1,2,0,1,0,71.76 ,63.51 ,50.00 
02,000,05,011,0426,0,3270,53,3323,5075,123456,2,1,2,0,1,0,71.76 ,65.48 ,50.00 
02,000,05,011,0427,0,1561,32,1593,2358,123456,2,1,2,0,1,0,71.76 ,67.56 ,50.00 
02,000,05,011,0428,0,2274,45,2319,3445,123456,2,1,2,0,1,0,71.76 ,67.31 ,50.00 
02,000,05,011,0429,0,1818,34,1852,2719,123456,2,1,2,0,1,0,71.76 ,68.11 ,50.00 
02,000,05,011,0430,0,2360,39,2399,3615,123456,2,1,2,0,1,0,71.76 ,66.36 ,50.00 
02,000,05,011,0431,0,2501,45,2546,3946,123456,2,1,2,0,1,0,71.76 ,64.52 ,50.00 
02,000,05,011,0432,0,1440,21,1461,2096,123456,2,1,2,0,1,0,71.76 ,69.70 ,50.00 
02,000,05,011,0433,0,1873,44,1917,2875,123456,2,1,2,0,1,0,71.76 ,66.68 ,50.00 
02,000,05,011,0434,0,1560,31,1591,2302,123456,2,1,2,0,1,0,71.76 ,69.11 ,50.00 
02,000,05,011,0435,0,1331,24,1355,1919,123456,2,1,2,0,1,0,71.76 ,70.61 ,50.00 
02,000,05,011,0436,0,2391,31,2422,3369,123456,2,1,2,0,1,0,71.76 ,71.89 ,50.00 
02,000,05,011,0437,0,1816,35,1851,2582,123456,2,1,2,0,1,0,71.76 ,71.69 ,50.00 
02,000,05,011,0438,0,4754,69,4823,7238,123456,2,1,2,0,1,0,71.76 ,66.63 ,50.00 
02,000,05,011,0439,0,2056,48,2104,3188,123456,2,1,2,0,1,0,71.76 ,66.00 ,50.00 
02,000,05,011,0440,0,1460,29,1489,2226,123456,2,1,2,0,1,0,71.76 ,66.89 ,50.00 
02,000,05,011,0441,0,1579,38,1617,2294,123456,2,1,2,0,1,0,71.76 ,70.49 ,50.00 
02,000,05,011,0442,0,1008,18,1026,1515,123456,2,1,2,0,1,0,71.76 ,67.72 ,50.00 
02,000,05,011,0443,0,1687,28,1715,2476,123456,2,1,2,0,1,0,71.76 ,69.26 ,50.00 
02,000,05,011,0444,0,2083,34,2117,3200,123456,2,1,2,0,1,0,71.76 ,66.16 ,50.00 
02,000,05,011,0445,0,1324,34,1358,2054,123456,2,1,2,0,1,0,71.76 ,66.11 ,50.00 
02,000,05,011,0446,0,1572,36,1608,2292,123456,2,1,2,0,1,0,71.76 ,70.16 ,50.00 
02,000,05,011,0447,0,3998,90,4088,6238,123456,2,1,2,0,1,0,71.76 ,65.53 ,50.00 
02,000,05,011,0448,0,1794,44,1838,2872,123456,2,1,2,0,1,0,71.76 ,64.00 ,50.00 
02,000,05,011,0449,0,1787,23,1810,2424,123456,2,1,2,0,1,0,71.76 ,74.67 ,50.00 
02,000,05,011,0450,0,1604,29,1633,2277,123456,2,1,2,0,1,0,71.76 ,71.72 ,50.00 
02,000,05,011,0451,0,1179,19,1198,1727,123456,2,1,2,0,1,0,71.76 ,69.37 ,50.00 
02,000,05,011,0452,0,1577,38,1615,2315,123456,2,1,2,0,1,0,71.76 ,69.76 ,50.00 
02,000,05,011,0453,0,1299,23,1322,1787,123456,2,1,2,0,1,0,71.76 ,73.98 ,50.00 
02,000,05,011,0454,0,1837,30,1867,2690,123456,2,1,2,0,1,0,71.76 ,69.41 ,50.00 
02,000,05,011,0455,0,680,8,688,988,123456,2,1,2,0,1,0,71.76 ,69.64 ,50.00 
02,000,05,011,0456,0,377,1,378,548,123456,2,1,2,0,1,0,71.76 ,68.98 ,50.00 
02,000,05,011,0457,0,263,5,268,409,123456,2,1,2,0,1,0,71.76 ,65.53 ,50.00 
02,000,05,011,0458,0,354,5,359,549,123456,2,1,2,0,1,0,71.76 ,65.39 ,50.00 
02,000,05,011,0459,0,408,7,415,615,123456,2,1,2,0,1,0,71.76 ,67.48 ,50.00 
01,000,01,001,0001,1,1018,11,1029,1569,123456,2,1,2,0,1,0,71.76 ,65.58,50.00 
01,000,01,001,0001,2,1192,9,1201,1778,123456,2,1,2,0,1,0,71.76 ,67.55,50.00 
01,000,01,001,0002,3,745,9,754,1161,123456,2,1,2,0,1,0,71.76 ,64.94,50.00 
01,000,01,001,0002,4,880,9,889,1272,123456,2,1,2,0,1,0,71.76 ,69.89,50.00 
01,000,01,001,0002,5,785,17,802,1231,123456,2,1,2,0,1,0,71.76 ,65.15,50.00 
01,000,01,001,0003,6,894,16,910,1399,123456,2,1,2,0,1,0,71.76 ,65.05,50.00 
01,000,01,001,0003,7,973,10,983,1435,123456,2,1,2,0,1,0,71.76 ,68.5,50.00 
01,000,01,001,0003,8,943,14,957,1467,123456,2,1,2,0,1,0,71.76 ,65.24,50.00 
01,000,01,001,0004,9,933,8,941,1355,123456,2,1,2,0,1,0,71.76 ,69.45,50.00 
01,000,01,001,0004,10,919,2,921,1337,123456,2,1,2,0,1,0,71.76 ,68.89,50.00 
01,000,01,001,0004,11,900,13,913,1302,123456,2,1,2,0,1,0,71.76 ,70.12,50.00 
01,000,01,001,0004,12,1015,8,1023,1442,123456,2,1,2,0,1,0,71.76 ,70.94,50.00 
01,000,01,001,0005,13,888,6,894,1387,123456,2,1,2,0,1,0,71.76 ,64.46,50.00 
01,000,01,001,0005,14,933,11,944,1423,123456,2,1,2,0,1,0,71.76 ,66.34,50.00 
01,000,01,001,0005,15,987,9,996,1453,123456,2,1,2,0,1,0,71.76 ,68.55,50.00 
01,000,01,001,0005,16,909,14,923,1391,123456,2,1,2,0,1,0,71.76 ,66.36,50.00 
01,000,01,001,0006,17,937,4,941,1489,123456,2,1,2,0,1,0,71.76 ,63.2,50.00 
01,000,01,001,0006,18,967,6,973,1569,123456,2,1,2,0,1,0,71.76 ,62.01,50.00 
01,000,01,001,0006,19,1089,13,1102,1637,123456,2,1,2,0,1,0,71.76 ,67.32,50.00 
01,000,01,001,0006,20,961,17,978,1416,123456,2,1,2,0,1,0,71.76 ,69.07,50.00 
01,000,01,001,0007,21,937,15,952,1424,123456,2,1,2,0,1,0,71.76 ,66.85,50.00 
01,000,01,001,0007,22,988,12,1000,1454,123456,2,1,2,0,1,0,71.76 ,68.78,50.00 
01,000,01,001,0007,23,893,16,909,1400,123456,2,1,2,0,1,0,71.76 ,64.93,50.00 
01,000,01,001,0007,24,895,16,911,1378,123456,2,1,2,0,1,0,71.76 ,66.11,50.00 
01,000,01,001,0008,25,1132,10,1142,1692,123456,2,1,2,0,1,0,71.76 ,67.49,50.00 
01,000,01,001,0008,26,1167,14,1181,1794,123456,2,1,2,0,1,0,71.76 ,65.83,50.00 
01,000,01,001,0008,27,925,17,942,1425,123456,2,1,2,0,1,0,71.76 ,66.11,50.00 
01,000,01,001,0008,28,966,11,977,1464,123456,2,1,2,0,1,0,71.76 ,66.73,50.00 
01,000,01,001,0009,29,1077,12,1089,1696,123456,2,1,2,0,1,0,71.76 ,64.21,50.00 
01,000,01,001,0009,30,1038,9,1047,1628,123456,2,1,2,0,1,0,71.76 ,64.31,50.00 
01,000,01,001,0009,31,1061,18,1079,1691,123456,2,1,2,0,1,0,71.76 ,63.81,50.00 
01,000,01,001,0009,32,1090,17,1107,1728,123456,2,1,2,0,1,0,71.76 ,64.06,50.00 
01,000,01,001,0010,33,1208,17,1225,1968,123456,2,1,2,0,1,0,71.76 ,62.25,50.00 
01,000,01,001,0010,34,1190,13,1203,1792,123456,2,1,2,0,1,0,71.76 ,67.13,50.00 
01,000,01,001,0010,35,1226,23,1249,1970,123456,2,1,2,0,1,0,71.76 ,63.4,50.00 
01,000,01,001,0011,36,1268,12,1280,1838,123456,2,1,2,0,1,0,71.76 ,69.64,50.00 
01,000,01,001,0011,37,1158,18,1176,1780,123456,2,1,2,0,1,0,71.76 ,66.07,50.00 
01,000,01,001,0012,38,1324,14,1338,1854,123456,2,1,2,0,1,0,71.76 ,72.17,50.00 
01,000,01,001,0012,39,1245,17,1262,1823,123456,2,1,2,0,1,0,71.76 ,69.23,50.00 
01,000,01,001,0013,40,1094,11,1105,1700,123456,2,1,2,0,1,0,71.76 ,65,50.00 
01,000,01,001,0013,41,1154,14,1168,1763,123456,2,1,2,0,1,0,71.76 ,66.25,50.00 
01,000,01,001,0013,42,1132,13,1145,1697,123456,2,1,2,0,1,0,71.76 ,67.47,50.00 
01,000,01,001,0014,43,927,12,939,1385,123456,2,1,2,0,1,0,71.76 ,67.8,50.00 
01,000,01,001,0014,44,925,11,936,1339,123456,2,1,2,0,1,0,71.76 ,69.9,50.00 
01,000,01,001,0014,45,904,8,912,1350,123456,2,1,2,0,1,0,71.76 ,67.56,50.00 
01,000,01,001,0015,46,801,13,814,1261,123456,2,1,2,0,1,0,71.76 ,64.55,50.00 
01,000,01,001,0015,47,843,8,851,1295,123456,2,1,2,0,1,0,71.76 ,65.71,50.00 
01,000,01,001,0015,48,839,9,848,1239,123456,2,1,2,0,1,0,71.76 ,68.44,50.00 
01,000,01,001,0016,49,935,12,947,1453,123456,2,1,2,0,1,0,71.76 ,65.18,50.00 
01,000,01,001,0016,50,809,11,820,1264,123456,2,1,2,0,1,0,71.76 ,64.87,50.00 
01,000,01,001,0016,51,874,15,889,1459,123456,2,1,2,0,1,0,71.76 ,60.93,50.00 
01,000,01,001,0017,52,1152,8,1160,1759,123456,2,1,2,0,1,0,71.76 ,65.95,50.00 
01,000,01,001,0017,53,1127,11,1138,1753,123456,2,1,2,0,1,0,71.76 ,64.92,50.00 
01,000,01,001,0017,54,1100,14,1114,1669,123456,2,1,2,0,1,0,71.76 ,66.75,50.00 
01,000,01,001,0017,55,1140,9,1149,1707,123456,2,1,2,0,1,0,71.76 ,67.31,50.00 
01,000,01,001,0018,56,851,18,869,1343,123456,2,1,2,0,1,0,71.76 ,64.71,50.00 
01,000,01,001,0018,57,1003,5,1008,1496,123456,2,1,2,0,1,0,71.76 ,67.38,50.00 
01,000,01,001,0018,58,770,8,778,1187,123456,2,1,2,0,1,0,71.76 ,65.54,50.00 
01,000,01,001,0019,59,1077,8,1085,1594,123456,2,1,2,0,1,0,71.76 ,68.07,50.00 
01,000,01,001,0020,60,941,17,958,1438,123456,2,1,2,0,1,0,71.76 ,66.62,50.00 
01,000,01,001,0020,61,948,15,963,1507,123456,2,1,2,0,1,0,71.76 ,63.9,50.00 
01,000,01,001,0020,62,994,5,999,1505,123456,2,1,2,0,1,0,71.76 ,66.38,50.00 
01,000,01,001,0020,63,1089,8,1097,1759,123456,2,1,2,0,1,0,71.76 ,62.36,50.00 
01,000,01,001,0020,64,1045,7,1052,1596,123456,2,1,2,0,1,0,71.76 ,65.91,50.00 
01,000,01,001,0021,65,1181,24,1205,2520,123456,2,1,2,0,1,0,71.76 ,47.82,50.00 
01,000,01,001,0021,66,1168,8,1176,1705,123456,2,1,2,0,1,0,71.76 ,68.97,50.00 
01,000,01,001,0021,67,1166,11,1177,1759,123456,2,1,2,0,1,0,71.76 ,66.91,50.00 
01,000,01,001,0021,68,1147,8,1155,1720,123456,2,1,2,0,1,0,71.76 ,67.15,50.00 
01,000,01,001,0022,69,1009,12,1021,1482,123456,2,1,2,0,1,0,71.76 ,68.89,50.00 
01,000,01,001,0022,70,920,12,932,1416,123456,2,1,2,0,1,0,71.76 ,65.82,50.00 
01,000,01,001,0022,71,986,9,995,1602,123456,2,1,2,0,1,0,71.76 ,62.11,50.00 
01,000,01,001,0022,72,988,13,1001,1483,123456,2,1,2,0,1,0,71.76 ,67.5,50.00 
01,000,01,001,0023,73,1101,7,1108,1604,123456,2,1,2,0,1,0,71.76 ,69.08,50.00 
01,000,01,001,0023,74,949,14,963,1472,123456,2,1,2,0,1,0,71.76 ,65.42,50.00 
01,000,01,001,0023,75,1081,13,1094,1787,123456,2,1,2,0,1,0,71.76 ,61.22,50.00 
01,000,01,001,0024,76,1101,14,1115,1636,123456,2,1,2,0,1,0,71.76 ,68.15,50.00 
01,000,01,001,0024,77,986,8,994,1540,123456,2,1,2,0,1,0,71.76 ,64.55,50.00 
01,000,01,001,0024,78,1026,17,1043,1648,123456,2,1,2,0,1,0,71.76 ,63.29,50.00 
01,000,01,001,0025,79,1130,12,1142,1689,123456,2,1,2,0,1,0,71.76 ,67.61,50.00 
01,000,01,001,0025,80,1071,15,1086,1699,123456,2,1,2,0,1,0,71.76 ,63.92,50.00 
01,000,01,001,0025,81,1127,10,1137,1741,123456,2,1,2,0,1,0,71.76 ,65.31,50.00 
01,000,01,001,0026,82,780,8,788,1259,123456,2,1,2,0,1,0,71.76 ,62.59,50.00 
01,000,01,001,0026,83,851,6,857,1449,123456,2,1,2,0,1,0,71.76 ,59.14,50.00 
01,000,01,001,0027,84,984,6,990,1655,123456,2,1,2,0,1,0,71.76 ,59.82,50.00 
01,000,01,001,0027,85,920,13,933,1531,123456,2,1,2,0,1,0,71.76 ,60.94,50.00 
01,000,01,001,0027,86,1023,12,1035,1760,123456,2,1,2,0,1,0,71.76 ,58.81,50.00 
01,000,01,001,0028,87,1136,12,1148,1763,123456,2,1,2,0,1,0,71.76 ,65.12,50.00 
01,000,01,001,0028,88,1134,23,1157,1733,123456,2,1,2,0,1,0,71.76 ,66.76,50.00 
01,000,01,001,0029,89,1185,11,1196,1748,123456,2,1,2,0,1,0,71.76 ,68.42,50.00 
01,000,01,001,0029,90,1148,16,1164,1745,123456,2,1,2,0,1,0,71.76 ,66.7,50.00 
01,000,01,001,0029,91,1124,10,1134,1771,123456,2,1,2,0,1,0,71.76 ,64.03,50.00 
01,000,01,001,0030,92,1117,18,1135,1664,123456,2,1,2,0,1,0,71.76 ,68.21,50.00 
01,000,01,001,0030,93,794,10,804,1232,123456,2,1,2,0,1,0,71.76 ,65.26,50.00 
01,000,01,001,0030,94,783,4,787,1203,123456,2,1,2,0,1,0,71.76 ,65.42,50.00 
01,000,01,001,0031,95,944,15,959,1436,123456,2,1,2,0,1,0,71.76 ,66.78,50.00 
01,000,01,001,0031,96,1163,13,1176,1704,123456,2,1,2,0,1,0,71.76 ,69.01,50.00 
01,000,01,001,0031,97,1047,14,1061,1580,123456,2,1,2,0,1,0,71.76 ,67.15,50.00 
01,000,01,001,0032,98,949,14,963,1398,123456,2,1,2,0,1,0,71.76 ,68.88,50.00 
01,000,01,001,0032,99,991,7,998,1481,123456,2,1,2,0,1,0,71.76 ,67.39,50.00 
01,000,01,001,0033,100,1202,12,1214,1722,123456,2,1,2,0,1,0,71.76 ,70.5,50.00 
01,000,01,001,0033,101,1079,15,1094,1639,123456,2,1,2,0,1,0,71.76 ,66.75,50.00 
01,000,01,001,0034,102,1129,14,1143,1722,123456,2,1,2,0,1,0,71.76 ,66.38,50.00 
01,000,01,001,0034,103,1060,8,1068,1629,123456,2,1,2,0,1,0,71.76 ,65.56,50.00 
01,000,01,001,0035,104,926,14,940,1496,123456,2,1,2,0,1,0,71.76 ,62.83,50.00 
01,000,01,001,0035,105,900,10,910,1485,123456,2,1,2,0,1,0,71.76 ,61.28,50.00 
01,000,01,001,0035,106,615,8,623,1017,123456,2,1,2,0,1,0,71.76 ,61.26,50.00 
01,000,01,001,0036,107,924,18,942,1442,123456,2,1,2,0,1,0,71.76 ,65.33,50.00 
01,000,01,001,0036,108,1085,17,1102,1587,123456,2,1,2,0,1,0,71.76 ,69.44,50.00 
01,000,01,001,0036,109,908,9,917,1399,123456,2,1,2,0,1,0,71.76 ,65.55,50.00 
01,000,01,001,0037,110,1149,8,1157,1805,123456,2,1,2,0,1,0,71.76 ,64.1,50.00 
01,000,01,001,0037,111,1041,14,1055,1708,123456,2,1,2,0,1,0,71.76 ,61.77,50.00 
01,000,01,001,0037,112,1057,11,1068,1652,123456,2,1,2,0,1,0,71.76 ,64.65,50.00 
01,000,01,001,0038,113,919,12,931,1463,123456,2,1,2,0,1,0,71.76 ,63.64,50.00 
01,000,01,001,0038,114,806,10,816,1377,123456,2,1,2,0,1,0,71.76 ,59.26,50.00 
01,000,01,001,0038,115,957,14,971,1459,123456,2,1,2,0,1,0,71.76 ,66.55,50.00 
01,000,01,001,0038,116,921,17,938,1421,123456,2,1,2,0,1,0,71.76 ,66.01,50.00 
01,000,01,001,0038,117,972,24,996,1500,123456,2,1,2,0,1,0,71.76 ,66.4,50.00 
01,000,01,001,0038,118,847,33,880,1306,123456,2,1,2,0,1,0,71.76 ,67.38,50.00 
01,000,01,001,0039,119,285,2,287,399,123456,2,1,2,0,1,0,71.76 ,71.93,50.00 
01,000,01,001,0039,120,1015,9,1024,1578,123456,2,1,2,0,1,0,71.76 ,64.89,50.00 
01,000,01,001,0040,121,486,7,493,746,123456,2,1,2,0,1,0,71.76 ,66.09,50.00 
01,000,01,001,0040,122,644,7,651,1057,123456,2,1,2,0,1,0,71.76 ,61.59,50.00 
01,000,01,001,0041,123,608,9,617,986,123456,2,1,2,0,1,0,71.76 ,62.58,50.00 
01,000,01,001,0042,124,493,5,498,810,123456,2,1,2,0,1,0,71.76 ,61.48,50.00 
01,000,01,002,0043,125,1166,13,1179,1777,123456,2,1,2,0,1,0,71.76 ,66.35,50.00 
01,000,01,002,0043,126,1082,13,1095,1600,123456,2,1,2,0,1,0,71.76 ,68.44,50.00 
01,000,01,002,0044,127,861,15,876,1324,123456,2,1,2,0,1,0,71.76 ,66.16,50.00 
01,000,01,002,0044,128,978,18,996,1391,123456,2,1,2,0,1,0,71.76 ,71.6,50.00 
01,000,01,002,0045,129,259,3,262,415,123456,2,1,2,0,1,0,71.76 ,63.13,50.00 
01,000,01,002,0045,130,438,3,441,722,123456,2,1,2,0,1,0,71.76 ,61.08,50.00 
01,000,01,002,0045,131,931,4,935,1377,123456,2,1,2,0,1,0,71.76 ,67.9,50.00 
01,000,01,002,0046,132,890,11,901,1383,123456,2,1,2,0,1,0,71.76 ,65.15,50.00 
01,000,01,002,0046,133,893,7,900,1398,123456,2,1,2,0,1,0,71.76 ,64.38,50.00 
01,000,01,002,0046,134,551,12,563,1838,123456,2,1,2,0,1,0,71.76 ,30.63,50.00 
01,000,01,002,0047,135,976,8,984,1527,123456,2,1,2,0,1,0,71.76 ,64.44,50.00 
01,000,01,002,0047,136,1089,20,1109,1543,123456,2,1,2,0,1,0,71.76 ,71.87,50.00 
01,000,01,002,0047,137,990,15,1005,1547,123456,2,1,2,0,1,0,71.76 ,64.96,50.00 
01,000,01,002,0047,138,1180,13,1193,1756,123456,2,1,2,0,1,0,71.76 ,67.94,50.00 
01,000,01,002,0048,139,1209,16,1225,1772,123456,2,1,2,0,1,0,71.76 ,69.13,50.00 
01,000,01,002,0048,140,1062,15,1077,1579,123456,2,1,2,0,1,0,71.76 ,68.21,50.00 
01,000,01,002,0048,141,1211,12,1223,1883,123456,2,1,2,0,1,0,71.76 ,64.95,50.00 
01,000,01,002,0049,142,908,6,914,1359,123456,2,1,2,0,1,0,71.76 ,67.26,50.00 
01,000,01,002,0049,143,1039,10,1049,1532,123456,2,1,2,0,1,0,71.76 ,68.47,50.00 
01,000,01,002,0049,144,1180,12,1192,1786,123456,2,1,2,0,1,0,71.76 ,66.74,50.00 
01,000,01,002,0049,145,1050,10,1060,1484,123456,2,1,2,0,1,0,71.76 ,71.43,50.00 
01,000,01,002,0050,146,1122,14,1136,1695,123456,2,1,2,0,1,0,71.76 ,67.02,50.00 
01,000,01,002,0050,147,1025,15,1040,1638,123456,2,1,2,0,1,0,71.76 ,63.49,50.00 
01,000,01,002,0050,148,1053,21,1074,1680,123456,2,1,2,0,1,0,71.76 ,63.93,50.00 
01,000,01,002,0050,149,922,17,939,1456,123456,2,1,2,0,1,0,71.76 ,64.49,50.00 
01,000,01,002,0051,150,900,6,906,1377,123456,2,1,2,0,1,0,71.76 ,65.8,50.00 
01,000,01,002,0051,151,983,7,990,1456,123456,2,1,2,0,1,0,71.76 ,67.99,50.00 
01,000,01,002,0051,152,1098,11,1109,1652,123456,2,1,2,0,1,0,71.76 ,67.13,50.00 
01,000,01,002,0052,153,1106,13,1119,1751,123456,2,1,2,0,1,0,71.76 ,63.91,50.00 
01,000,01,002,0052,154,1159,14,1173,1739,123456,2,1,2,0,1,0,71.76 ,67.45,50.00 
01,000,01,002,0053,155,993,24,1017,1495,123456,2,1,2,0,1,0,71.76 ,68.03,50.00 
01,000,01,002,0053,156,959,7,966,1420,123456,2,1,2,0,1,0,71.76 ,68.03,50.00 
01,000,01,002,0053,157,951,17,968,1389,123456,2,1,2,0,1,0,71.76 ,69.69,50.00 
01,000,01,002,0053,158,1029,4,1033,1532,123456,2,1,2,0,1,0,71.76 ,67.43,50.00 
01,000,01,002,0054,159,974,16,990,1497,123456,2,1,2,0,1,0,71.76 ,66.13,50.00 
01,000,01,002,0054,160,1030,12,1042,1582,123456,2,1,2,0,1,0,71.76 ,65.87,50.00 
01,000,01,002,0054,161,918,9,927,1428,123456,2,1,2,0,1,0,71.76 ,64.92,50.00 
01,000,01,002,0055,162,758,15,773,1275,123456,2,1,2,0,1,0,71.76 ,60.63,50.00 
01,000,01,002,0055,163,630,10,640,1050,123456,2,1,2,0,1,0,71.76 ,60.95,50.00 
01,000,01,002,0055,164,883,20,903,1485,123456,2,1,2,0,1,0,71.76 ,60.81,50.00 
01,000,01,002,0055,165,1136,8,1144,1675,123456,2,1,2,0,1,0,71.76 ,68.3,50.00 
01,000,01,002,0056,166,794,7,801,1286,123456,2,1,2,0,1,0,71.76 ,62.29,50.00 
01,000,01,002,0056,167,928,13,941,1379,123456,2,1,2,0,1,0,71.76 ,68.24,50.00 
01,000,01,002,0056,168,918,12,930,1440,123456,2,1,2,0,1,0,71.76 ,64.58,50.00 
01,000,01,002,0057,169,862,18,880,1371,123456,2,1,2,0,1,0,71.76 ,64.19,50.00 
01,000,01,002,0057,170,917,21,938,1396,123456,2,1,2,0,1,0,71.76 ,67.19,50.00 
01,000,01,002,0057,171,1001,13,1014,1527,123456,2,1,2,0,1,0,71.76 ,66.4,50.00 
01,000,01,002,0058,172,1051,21,1072,1663,123456,2,1,2,0,1,0,71.76 ,64.46,50.00 
01,000,01,002,0058,173,997,18,1015,1535,123456,2,1,2,0,1,0,71.76 ,66.12,50.00 
01,000,01,002,0058,174,1075,15,1090,1600,123456,2,1,2,0,1,0,71.76 ,68.12,50.00 
01,000,01,002,0059,175,1069,17,1086,1523,123456,2,1,2,0,1,0,71.76 ,71.31,50.00 
01,000,01,002,0059,176,1017,23,1040,1521,123456,2,1,2,0,1,0,71.76 ,68.38,50.00 
01,000,01,002,0059,177,1099,8,1107,1633,123456,2,1,2,0,1,0,71.76 ,67.79,50.00 
01,000,01,002,0059,178,921,15,936,1372,123456,2,1,2,0,1,0,71.76 ,68.22,50.00 
01,000,01,002,0060,179,1058,11,1069,1739,123456,2,1,2,0,1,0,71.76 ,61.47,50.00 
01,000,01,002,0060,180,968,13,981,1426,123456,2,1,2,0,1,0,71.76 ,68.79,50.00 
01,000,01,002,0061,181,1074,20,1094,1583,123456,2,1,2,0,1,0,71.76 ,69.11,50.00 
01,000,01,002,0061,182,1111,13,1124,1720,123456,2,1,2,0,1,0,71.76 ,65.35,50.00 
01,000,01,002,0061,183,1196,10,1206,1776,123456,2,1,2,0,1,0,71.76 ,67.91,50.00 
01,000,01,002,0062,184,994,4,998,1473,123456,2,1,2,0,1,0,71.76 ,67.75,50.00 
01,000,01,002,0062,185,846,5,851,1270,123456,2,1,2,0,1,0,71.76 ,67.01,50.00 
01,000,01,002,0062,186,942,6,948,1471,123456,2,1,2,0,1,0,71.76 ,64.45,50.00 
01,000,01,002,0062,187,788,8,796,1217,123456,2,1,2,0,1,0,71.76 ,65.41,50.00 
01,000,01,002,0062,188,935,8,943,1391,123456,2,1,2,0,1,0,71.76 ,67.79,50.00 
01,000,01,002,0063,189,1234,11,1245,1854,123456,2,1,2,0,1,0,71.76 ,67.15,50.00 
01,000,01,002,0063,190,1298,14,1312,1854,123456,2,1,2,0,1,0,71.76 ,70.77,50.00 
01,000,01,002,0063,191,1450,17,1467,2062,123456,2,1,2,0,1,0,71.76 ,71.14,50.00 
01,000,01,002,0064,192,1024,5,1029,1486,123456,2,1,2,0,1,0,71.76 ,69.25,50.00 
01,000,01,002,0064,193,897,12,909,1281,123456,2,1,2,0,1,0,71.76 ,70.96,50.00 
01,000,01,002,0064,194,1101,8,1109,1539,123456,2,1,2,0,1,0,71.76 ,72.06,50.00 
01,000,01,002,0064,195,1049,13,1062,1497,123456,2,1,2,0,1,0,71.76 ,70.94,50.00 
01,000,01,002,0065,196,945,11,956,1309,123456,2,1,2,0,1,0,71.76 ,73.03,50.00 
01,000,01,002,0065,197,922,12,934,1295,123456,2,1,2,0,1,0,71.76 ,72.12,50.00 
01,000,01,002,0065,198,937,9,946,1339,123456,2,1,2,0,1,0,71.76 ,70.65,50.00 
01,000,01,002,0066,199,994,10,1004,1414,123456,2,1,2,0,1,0,71.76 ,71,50.00 
01,000,01,002,0066,200,957,15,972,1348,123456,2,1,2,0,1,0,71.76 ,72.11,50.00 
01,000,01,002,0066,201,1243,13,1256,1707,123456,2,1,2,0,1,0,71.76 ,73.58,50.00 
01,000,01,002,0067,202,959,15,974,1565,123456,2,1,2,0,1,0,71.76 ,62.24,50.00 
01,000,01,002,0067,203,997,7,1004,1538,123456,2,1,2,0,1,0,71.76 ,65.28,50.00 
01,000,01,002,0068,204,1014,11,1025,1517,123456,2,1,2,0,1,0,71.76 ,67.57,50.00 
01,000,01,002,0068,205,978,12,990,1472,123456,2,1,2,0,1,0,71.76 ,67.26,50.00 
01,000,01,002,0068,206,893,12,905,1395,123456,2,1,2,0,1,0,71.76 ,64.87,50.00 
01,000,01,002,0068,207,942,14,956,1446,123456,2,1,2,0,1,0,71.76 ,66.11,50.00 
01,000,01,002,0069,208,1082,12,1094,1622,123456,2,1,2,0,1,0,71.76 ,67.45,50.00 
01,000,01,002,0069,209,1120,13,1133,1765,123456,2,1,2,0,1,0,71.76 ,64.19,50.00 
01,000,01,002,0070,210,865,8,873,1432,123456,2,1,2,0,1,0,71.76 ,60.96,50.00 
01,000,01,002,0070,211,1050,12,1062,1632,123456,2,1,2,0,1,0,71.76 ,65.07,50.00 
01,000,01,002,0070,212,1073,12,1085,1699,123456,2,1,2,0,1,0,71.76 ,63.86,50.00 
01,000,01,002,0071,213,911,13,924,1434,123456,2,1,2,0,1,0,71.76 ,64.44,50.00 
01,000,01,002,0071,214,936,8,944,1407,123456,2,1,2,0,1,0,71.76 ,67.09,50.00 
01,000,01,002,0071,215,957,8,965,1423,123456,2,1,2,0,1,0,71.76 ,67.81,50.00 
01,000,01,002,0072,216,1067,17,1084,1514,123456,2,1,2,0,1,0,71.76 ,71.6,50.00 
01,000,01,002,0072,217,991,11,1002,1489,123456,2,1,2,0,1,0,71.76 ,67.29,50.00 
01,000,01,002,0072,218,1084,10,1094,1653,123456,2,1,2,0,1,0,71.76 ,66.18,50.00 
01,000,01,002,0073,219,908,13,921,1417,123456,2,1,2,0,1,0,71.76 ,65,50.00 
01,000,01,002,0073,220,979,15,994,1475,123456,2,1,2,0,1,0,71.76 ,67.39,50.00 
01,000,01,002,0073,221,963,13,976,1424,123456,2,1,2,0,1,0,71.76 ,68.54,50.00 
01,000,01,002,0073,222,1034,12,1046,1580,123456,2,1,2,0,1,0,71.76 ,66.2,50.00 
01,000,01,002,0074,223,1012,15,1027,1452,123456,2,1,2,0,1,0,71.76 ,70.73,50.00 
01,000,01,002,0074,224,980,12,992,1507,123456,2,1,2,0,1,0,71.76 ,65.83,50.00 
01,000,01,002,0074,225,857,16,873,1257,123456,2,1,2,0,1,0,71.76 ,69.45,50.00 
01,000,01,002,0075,226,917,19,936,1467,123456,2,1,2,0,1,0,71.76 ,63.8,50.00 
01,000,01,002,0075,227,1037,12,1049,1618,123456,2,1,2,0,1,0,71.76 ,64.83,50.00 
01,000,01,002,0075,228,965,15,980,1472,123456,2,1,2,0,1,0,71.76 ,66.58,50.00 
01,000,01,002,0076,229,872,11,883,1433,123456,2,1,2,0,1,0,71.76 ,61.62,50.00 
01,000,01,002,0076,230,883,13,896,1379,123456,2,1,2,0,1,0,71.76 ,64.97,50.00 
01,000,01,002,0076,231,966,13,979,1489,123456,2,1,2,0,1,0,71.76 ,65.75,50.00 
01,000,01,002,0076,232,866,10,876,1409,123456,2,1,2,0,1,0,71.76 ,62.17,50.00 
01,000,01,002,0076,233,856,14,870,1384,123456,2,1,2,0,1,0,71.76 ,62.86,50.00 
01,000,01,002,0077,234,1097,10,1107,1676,123456,2,1,2,0,1,0,71.76 ,66.05,50.00 
01,000,01,002,0077,235,1010,17,1027,1544,123456,2,1,2,0,1,0,71.76 ,66.52,50.00 
01,000,01,002,0077,236,1223,14,1237,1791,123456,2,1,2,0,1,0,71.76 ,69.07,50.00 
01,000,01,002,0078,237,1079,19,1098,1631,123456,2,1,2,0,1,0,71.76 ,67.32,50.00 
01,000,01,002,0078,238,1203,25,1228,1825,123456,2,1,2,0,1,0,71.76 ,67.29,50.00 
01,000,01,002,0078,239,990,15,1005,1538,123456,2,1,2,0,1,0,71.76 ,65.34,50.00 
01,000,01,002,0079,240,895,18,913,1401,123456,2,1,2,0,1,0,71.76 ,65.17,50.00 
01,000,01,002,0079,241,921,16,937,1395,123456,2,1,2,0,1,0,71.76 ,67.17,50.00 
01,000,01,002,0079,242,860,12,872,1340,123456,2,1,2,0,1,0,71.76 ,65.07,50.00 
01,000,01,002,0080,243,1267,17,1284,2007,123456,2,1,2,0,1,0,71.76 ,63.98,50.00 
01,000,01,002,0080,244,1217,24,1241,1906,123456,2,1,2,0,1,0,71.76 ,65.11,50.00 
01,000,01,002,0081,245,957,9,966,1487,123456,2,1,2,0,1,0,71.76 ,64.96,50.00 
01,000,01,002,0081,246,1006,12,1018,1539,123456,2,1,2,0,1,0,71.76 ,66.15,50.00 
01,000,01,002,0081,247,977,14,991,1606,123456,2,1,2,0,1,0,71.76 ,61.71,50.00 
01,000,01,002,0081,248,940,15,955,1501,123456,2,1,2,0,1,0,71.76 ,63.62,50.00 
01,000,01,002,0082,249,864,14,878,1392,123456,2,1,2,0,1,0,71.76 ,63.07,50.00 
01,000,01,002,0082,250,897,17,914,1501,123456,2,1,2,0,1,0,71.76 ,60.89,50.00 
01,000,01,002,0082,251,799,11,810,1290,123456,2,1,2,0,1,0,71.76 ,62.79,50.00 
01,000,01,002,0082,252,920,13,933,1469,123456,2,1,2,0,1,0,71.76 ,63.51,50.00 
01,000,01,002,0083,253,1068,17,1085,1766,123456,2,1,2,0,1,0,71.76 ,61.44,50.00 
01,000,01,002,0083,254,1021,14,1035,1553,123456,2,1,2,0,1,0,71.76 ,66.65,50.00 
01,000,01,002,0083,255,1131,20,1151,1764,123456,2,1,2,0,1,0,71.76 ,65.25,50.00 
01,000,01,002,0083,256,1009,16,1025,1695,123456,2,1,2,0,1,0,71.76 ,60.47,50.00 
01,000,01,002,0084,257,1125,11,1136,1750,123456,2,1,2,0,1,0,71.76 ,64.91,50.00 
01,000,01,002,0084,258,1180,21,1201,1820,123456,2,1,2,0,1,0,71.76 ,65.99,50.00 
01,000,01,002,0084,259,1086,13,1099,1679,123456,2,1,2,0,1,0,71.76 ,65.46,50.00 
01,000,01,002,0085,260,751,9,760,1211,123456,2,1,2,0,1,0,71.76 ,62.76,50.00 
01,000,01,002,0086,261,794,5,799,1260,123456,2,1,2,0,1,0,71.76 ,63.41,50.00 
01,000,01,002,0087,262,1180,10,1190,1775,123456,2,1,2,0,1,0,71.76 ,67.04,50.00 
01,000,01,002,0088,263,588,6,594,931,123456,2,1,2,0,1,0,71.76 ,63.8,50.00 
01,000,01,002,0088,264,584,9,593,993,123456,2,1,2,0,1,0,71.76 ,59.72,50.00 
01,000,01,002,0088,265,478,5,483,787,123456,2,1,2,0,1,0,71.76 ,61.37,50.00 
01,000,01,002,0089,266,373,1,374,532,123456,2,1,2,0,1,0,71.76 ,70.3,50.00 
01,000,01,002,0089,267,575,11,586,863,123456,2,1,2,0,1,0,71.76 ,67.9,50.00 
01,000,01,002,0090,268,836,7,843,1191,123456,2,1,2,0,1,0,71.76 ,70.78,50.00 
01,000,01,002,0091,269,871,9,880,1292,123456,2,1,2,0,1,0,71.76 ,68.11,50.00 
01,000,01,002,0092,270,788,11,799,1245,123456,2,1,2,0,1,0,71.76 ,64.18,50.00 
01,000,01,002,0092,271,773,9,782,1230,123456,2,1,2,0,1,0,71.76 ,63.58,50.00 
01,000,01,002,0093,272,889,19,908,1398,123456,2,1,2,0,1,0,71.76 ,64.95,50.00 
01,000,01,002,0093,273,655,15,670,1098,123456,2,1,2,0,1,0,71.76 ,61.02,50.00 
01,000,02,003,0094,274,961,19,980,1441,123456,2,1,2,0,1,0,71.76 ,68.01,50.00 
01,000,02,003,0094,275,1041,13,1054,1589,123456,2,1,2,0,1,0,71.76 ,66.33,50.00 
01,000,02,003,0094,276,1063,21,1084,1614,123456,2,1,2,0,1,0,71.76 ,67.16,50.00 
01,000,02,003,0094,277,1041,16,1057,1571,123456,2,1,2,0,1,0,71.76 ,67.28,50.00 
01,000,02,003,0095,278,1070,27,1097,1599,123456,2,1,2,0,1,0,71.76 ,68.61,50.00 
01,000,02,003,0095,279,1018,11,1029,1555,123456,2,1,2,0,1,0,71.76 ,66.17,50.00 
01,000,02,003,0095,280,932,18,950,1520,123456,2,1,2,0,1,0,71.76 ,62.5,50.00 
01,000,02,003,0095,281,1309,16,1325,1914,123456,2,1,2,0,1,0,71.76 ,69.23,50.00 
01,000,02,003,0096,282,1072,12,1084,1637,123456,2,1,2,0,1,0,71.76 ,66.22,50.00 
01,000,02,003,0096,283,1235,25,1260,1858,123456,2,1,2,0,1,0,71.76 ,67.81,50.00 
01,000,02,003,0096,284,1014,28,1042,1647,123456,2,1,2,0,1,0,71.76 ,63.27,50.00 
01,000,02,003,0097,285,1055,18,1073,1525,123456,2,1,2,0,1,0,71.76 ,70.36,50.00 
01,000,02,003,0097,286,988,14,1002,1560,123456,2,1,2,0,1,0,71.76 ,64.23,50.00 
01,000,02,003,0097,287,916,17,933,1479,123456,2,1,2,0,1,0,71.76 ,63.08,50.00 
01,000,02,003,0098,288,893,14,907,1301,123456,2,1,2,0,1,0,71.76 ,69.72,50.00 
01,000,02,003,0098,289,913,19,932,1412,123456,2,1,2,0,1,0,71.76 ,66.01,50.00 
01,000,02,003,0098,290,849,12,861,1331,123456,2,1,2,0,1,0,71.76 ,64.69,50.00 
01,000,02,003,0099,291,946,21,967,1472,123456,2,1,2,0,1,0,71.76 ,65.69,50.00 
01,000,02,003,0099,292,959,12,971,1437,123456,2,1,2,0,1,0,71.76 ,67.57,50.00 
01,000,02,003,0099,293,826,16,842,1281,123456,2,1,2,0,1,0,71.76 ,65.73,50.00 
01,000,02,003,0100,294,971,9,980,1441,123456,2,1,2,0,1,0,71.76 ,68.01,50.00 
01,000,02,003,0100,295,960,23,983,1494,123456,2,1,2,0,1,0,71.76 ,65.8,50.00 
01,000,02,003,0100,296,870,10,880,1352,123456,2,1,2,0,1,0,71.76 ,65.09,50.00 
01,000,02,003,0100,297,1031,24,1055,1507,123456,2,1,2,0,1,0,71.76 ,70.01,50.00 
01,000,02,003,0100,298,912,15,927,1413,123456,2,1,2,0,1,0,71.76 ,65.61,50.00 
01,000,02,003,0101,299,1064,21,1085,1607,123456,2,1,2,0,1,0,71.76 ,67.52,50.00 
01,000,02,003,0101,300,1024,28,1052,1544,123456,2,1,2,0,1,0,71.76 ,68.13,50.00 
01,000,02,003,0101,301,1117,18,1135,1652,123456,2,1,2,0,1,0,71.76 ,68.7,50.00 
01,000,02,003,0101,302,983,23,1006,1523,123456,2,1,2,0,1,0,71.76 ,66.05,50.00 
01,000,02,003,0102,303,996,10,1006,1534,123456,2,1,2,0,1,0,71.76 ,65.58,50.00 
01,000,02,003,0102,304,1044,14,1058,1601,123456,2,1,2,0,1,0,71.76 ,66.08,50.00 
01,000,02,003,0102,305,906,18,924,1557,123456,2,1,2,0,1,0,71.76 ,59.34,50.00 
01,000,02,003,0103,306,1033,14,1047,1651,123456,2,1,2,0,1,0,71.76 ,63.42,50.00 
01,000,02,003,0103,307,1157,16,1173,1704,123456,2,1,2,0,1,0,71.76 ,68.84,50.00 
01,000,02,003,0103,308,1000,14,1014,1386,123456,2,1,2,0,1,0,71.76 ,73.16,50.00 
01,000,02,003,0103,309,754,11,765,1137,123456,2,1,2,0,1,0,71.76 ,67.28,50.00 
01,000,02,003,0104,310,795,13,808,1263,123456,2,1,2,0,1,0,71.76 ,63.97,50.00 
01,000,02,003,0104,311,961,10,971,1382,123456,2,1,2,0,1,0,71.76 ,70.26,50.00 
01,000,02,003,0104,312,799,11,810,1328,123456,2,1,2,0,1,0,71.76 ,60.99,50.00 
01,000,02,003,0105,313,1020,20,1040,1615,123456,2,1,2,0,1,0,71.76 ,64.4,50.00 
01,000,02,003,0105,314,1052,15,1067,1643,123456,2,1,2,0,1,0,71.76 ,64.94,50.00 
01,000,02,003,0105,315,990,16,1006,1559,123456,2,1,2,0,1,0,71.76 ,64.53,50.00 
01,000,02,003,0106,316,980,14,994,1570,123456,2,1,2,0,1,0,71.76 ,63.31,50.00 
01,000,02,003,0106,317,978,15,993,1554,123456,2,1,2,0,1,0,71.76 ,63.9,50.00 
01,000,02,003,0106,318,894,9,903,1367,123456,2,1,2,0,1,0,71.76 ,66.06,50.00 
01,000,02,003,0107,319,1120,20,1140,1680,123456,2,1,2,0,1,0,71.76 ,67.86,50.00 
01,000,02,003,0107,320,1074,22,1096,1686,123456,2,1,2,0,1,0,71.76 ,65.01,50.00 
01,000,02,003,0107,321,1163,13,1176,1748,123456,2,1,2,0,1,0,71.76 ,67.28,50.00 
01,000,02,003,0108,322,279,0,279,406,123456,2,1,2,0,1,0,71.76 ,68.72,50.00 
01,000,02,003,0108,323,1147,17,1164,1715,123456,2,1,2,0,1,0,71.76 ,67.87,50.00 
01,000,02,003,0108,324,1159,18,1177,1764,123456,2,1,2,0,1,0,71.76 ,66.72,50.00 
01,000,02,003,0108,325,945,15,960,1481,123456,2,1,2,0,1,0,71.76 ,64.82,50.00 
01,000,02,003,0109,326,826,14,840,1234,123456,2,1,2,0,1,0,71.76 ,68.07,50.00 
01,000,02,003,0109,327,805,6,811,1193,123456,2,1,2,0,1,0,71.76 ,67.98,50.00 
01,000,02,003,0109,328,871,12,883,1282,123456,2,1,2,0,1,0,71.76 ,68.88,50.00 
01,000,02,003,0110,329,1136,18,1154,1662,123456,2,1,2,0,1,0,71.76 ,69.43,50.00 
01,000,02,003,0110,330,1014,11,1025,1505,123456,2,1,2,0,1,0,71.76 ,68.11,50.00 
01,000,02,003,0110,331,1066,15,1081,1491,123456,2,1,2,0,1,0,71.76 ,72.5,50.00 
01,000,02,003,0110,332,1114,14,1128,1611,123456,2,1,2,0,1,0,71.76 ,70.02,50.00 
01,000,02,003,0111,333,923,14,937,1450,123456,2,1,2,0,1,0,71.76 ,64.62,50.00 
01,000,02,003,0111,334,903,14,917,1492,123456,2,1,2,0,1,0,71.76 ,61.46,50.00 
01,000,02,003,0111,335,902,9,911,1455,123456,2,1,2,0,1,0,71.76 ,62.61,50.00 
01,000,02,003,0111,336,990,12,1002,1513,123456,2,1,2,0,1,0,71.76 ,66.23,50.00 
01,000,02,003,0112,337,1043,11,1054,1519,123456,2,1,2,0,1,0,71.76 ,69.39,50.00 
01,000,02,003,0112,338,1117,14,1131,1743,123456,2,1,2,0,1,0,71.76 ,64.89,50.00 
01,000,02,003,0112,339,1100,17,1117,1661,123456,2,1,2,0,1,0,71.76 ,67.25,50.00 
01,000,02,003,0112,340,1112,14,1126,1645,123456,2,1,2,0,1,0,71.76 ,68.45,50.00 
01,000,02,003,0113,341,1058,16,1074,1507,123456,2,1,2,0,1,0,71.76 ,71.27,50.00 
01,000,02,003,0113,342,990,24,1014,1514,123456,2,1,2,0,1,0,71.76 ,66.97,50.00 
01,000,02,003,0113,343,1058,14,1072,1644,123456,2,1,2,0,1,0,71.76 ,65.21,50.00 
01,000,02,003,0114,344,992,24,1016,1558,123456,2,1,2,0,1,0,71.76 ,65.21,50.00 
01,000,02,003,0114,345,987,10,997,1500,123456,2,1,2,0,1,0,71.76 ,66.47,50.00 
01,000,02,003,0114,346,866,8,874,1443,123456,2,1,2,0,1,0,71.76 ,60.57,50.00 
01,000,02,003,0114,347,915,21,936,1502,123456,2,1,2,0,1,0,71.76 ,62.32,50.00 
01,000,02,003,0115,348,860,20,880,1305,123456,2,1,2,0,1,0,71.76 ,67.43,50.00 
01,000,02,003,0115,349,940,17,957,1544,123456,2,1,2,0,1,0,71.76 ,61.98,50.00 
01,000,02,003,0115,350,873,13,886,1349,123456,2,1,2,0,1,0,71.76 ,65.68,50.00 
01,000,02,003,0115,351,839,9,848,1312,123456,2,1,2,0,1,0,71.76 ,64.63,50.00 
01,000,02,003,0116,352,962,14,976,1454,123456,2,1,2,0,1,0,71.76 ,67.13,50.00 
01,000,02,003,0116,353,911,9,920,1459,123456,2,1,2,0,1,0,71.76 ,63.06,50.00 
01,000,02,003,0116,354,970,22,992,1535,123456,2,1,2,0,1,0,71.76 ,64.63,50.00 
01,000,02,003,0116,355,947,20,967,1468,123456,2,1,2,0,1,0,71.76 ,65.87,50.00 
01,000,02,003,0116,356,934,12,946,1532,123456,2,1,2,0,1,0,71.76 ,61.75,50.00 
01,000,02,003,0117,357,934,15,949,1543,123456,2,1,2,0,1,0,71.76 ,61.5,50.00 
01,000,02,003,0117,358,965,9,974,1550,123456,2,1,2,0,1,0,71.76 ,62.84,50.00 
01,000,02,003,0117,359,932,14,946,1444,123456,2,1,2,0,1,0,71.76 ,65.51,50.00 
01,000,02,003,0117,360,910,14,924,1444,123456,2,1,2,0,1,0,71.76 ,63.99,50.00 
01,000,02,003,0118,361,821,10,831,1242,123456,2,1,2,0,1,0,71.76 ,66.91,50.00 
01,000,02,003,0118,362,764,10,774,1167,123456,2,1,2,0,1,0,71.76 ,66.32,50.00 
01,000,02,003,0118,363,768,8,776,1229,123456,2,1,2,0,1,0,71.76 ,63.14,50.00 
01,000,02,003,0119,364,903,8,911,1421,123456,2,1,2,0,1,0,71.76 ,64.11,50.00 
01,000,02,003,0119,365,903,12,915,1478,123456,2,1,2,0,1,0,71.76 ,61.91,50.00 
01,000,02,003,0119,366,890,16,906,1382,123456,2,1,2,0,1,0,71.76 ,65.56,50.00 
01,000,02,003,0119,367,876,15,891,1387,123456,2,1,2,0,1,0,71.76 ,64.24,50.00 
01,000,02,003,0119,368,870,11,881,1362,123456,2,1,2,0,1,0,71.76 ,64.68,50.00 
01,000,02,003,0120,369,973,14,987,1530,123456,2,1,2,0,1,0,71.76 ,64.51,50.00 
01,000,02,003,0120,370,983,9,992,1553,123456,2,1,2,0,1,0,71.76 ,63.88,50.00 
01,000,02,003,0120,371,949,15,964,1543,123456,2,1,2,0,1,0,71.76 ,62.48,50.00 
01,000,02,003,0120,372,911,17,928,1501,123456,2,1,2,0,1,0,71.76 ,61.83,50.00 
01,000,02,003,0121,373,912,17,929,1413,123456,2,1,2,0,1,0,71.76 ,65.75,50.00 
01,000,02,003,0121,374,793,14,807,1248,123456,2,1,2,0,1,0,71.76 ,64.66,50.00 
01,000,02,003,0121,375,824,8,832,1256,123456,2,1,2,0,1,0,71.76 ,66.24,50.00 
01,000,02,003,0121,376,949,12,961,1477,123456,2,1,2,0,1,0,71.76 ,65.06,50.00 
01,000,02,003,0122,377,917,21,938,1551,123456,2,1,2,0,1,0,71.76 ,60.48,50.00 
01,000,02,003,0122,378,968,16,984,1622,123456,2,1,2,0,1,0,71.76 ,60.67,50.00 
01,000,02,003,0122,379,940,17,957,1487,123456,2,1,2,0,1,0,71.76 ,64.36,50.00 
01,000,02,003,0122,380,970,10,980,1658,123456,2,1,2,0,1,0,71.76 ,59.11,50.00 
01,000,02,003,0123,381,495,7,502,792,123456,2,1,2,0,1,0,71.76 ,63.38,50.00 
01,000,02,003,0123,382,764,11,775,1203,123456,2,1,2,0,1,0,71.76 ,64.42,50.00 
01,000,02,003,0123,383,836,11,847,1333,123456,2,1,2,0,1,0,71.76 ,63.54,50.00 
01,000,02,003,0124,384,761,11,772,1208,123456,2,1,2,0,1,0,71.76 ,63.91,50.00 
01,000,02,003,0124,385,885,12,897,1358,123456,2,1,2,0,1,0,71.76 ,66.05,50.00 
01,000,02,003,0124,386,695,17,712,1155,123456,2,1,2,0,1,0,71.76 ,61.65,50.00 
01,000,02,003,0125,387,551,4,555,863,123456,2,1,2,0,1,0,71.76 ,64.31,50.00 
01,000,02,003,0126,388,802,15,817,1229,123456,2,1,2,0,1,0,71.76 ,66.48,50.00 
01,000,02,003,0126,389,841,9,850,1283,123456,2,1,2,0,1,0,71.76 ,66.25,50.00 
01,000,02,003,0126,390,939,14,953,1461,123456,2,1,2,0,1,0,71.76 ,65.23,50.00 
01,000,02,003,0127,391,675,15,690,1059,123456,2,1,2,0,1,0,71.76 ,65.16,50.00 
01,000,02,003,0127,392,890,27,917,1367,123456,2,1,2,0,1,0,71.76 ,67.08,50.00 
01,000,02,003,0127,393,843,19,862,1338,123456,2,1,2,0,1,0,71.76 ,64.42,50.00 
01,000,02,003,0127,394,870,25,895,1393,123456,2,1,2,0,1,0,71.76 ,64.25,50.00 
01,000,02,003,0128,395,855,19,874,1345,123456,2,1,2,0,1,0,71.76 ,64.98,50.00 
01,000,02,003,0129,396,828,12,840,1362,123456,2,1,2,0,1,0,71.76 ,61.67,50.00 
01,000,02,003,0129,397,824,14,838,2327,123456,2,1,2,0,1,0,71.76 ,36.01,50.00 
01,000,02,003,0129,398,988,14,1002,1522,123456,2,1,2,0,1,0,71.76 ,65.83,50.00 
01,000,02,003,0129,399,829,13,842,1275,123456,2,1,2,0,1,0,71.76 ,66.04,50.00 
01,000,02,003,0129,400,857,21,878,1438,123456,2,1,2,0,1,0,71.76 ,61.06,50.00 
01,000,02,003,0129,401,969,15,984,1554,123456,2,1,2,0,1,0,71.76 ,63.32,50.00 
01,000,02,003,0130,402,844,16,860,1339,123456,2,1,2,0,1,0,71.76 ,64.23,50.00 
01,000,02,003,0130,403,836,16,852,1346,123456,2,1,2,0,1,0,71.76 ,63.3,50.00 
01,000,02,003,0130,404,927,15,942,1438,123456,2,1,2,0,1,0,71.76 ,65.51,50.00 
01,000,02,004,0131,405,994,20,1014,1551,123456,2,1,2,0,1,0,71.76 ,65.38,50.00 
01,000,02,004,0131,406,997,20,1017,1564,123456,2,1,2,0,1,0,71.76 ,65.03,50.00 
01,000,02,004,0131,407,1004,15,1019,1828,123456,2,1,2,0,1,0,71.76 ,55.74,50.00 
01,000,02,004,0132,408,1119,18,1137,1806,123456,2,1,2,0,1,0,71.76 ,62.96,50.00 
01,000,02,004,0132,409,885,6,891,1376,123456,2,1,2,0,1,0,71.76 ,64.75,50.00 
01,000,02,004,0133,410,834,12,846,1310,123456,2,1,2,0,1,0,71.76 ,64.58,50.00 
01,000,02,004,0133,411,805,18,823,1259,123456,2,1,2,0,1,0,71.76 ,65.37,50.00 
01,000,02,004,0134,412,974,16,990,1514,123456,2,1,2,0,1,0,71.76 ,65.39,50.00 
01,000,02,004,0134,413,1037,11,1048,1652,123456,2,1,2,0,1,0,71.76 ,63.44,50.00 
01,000,02,004,0135,414,887,16,903,1400,123456,2,1,2,0,1,0,71.76 ,64.5,50.00 
01,000,02,004,0135,415,1028,11,1039,1589,123456,2,1,2,0,1,0,71.76 ,65.39,50.00 
01,000,02,004,0135,416,783,17,800,1269,123456,2,1,2,0,1,0,71.76 ,63.04,50.00 
01,000,02,004,0135,417,588,11,599,949,123456,2,1,2,0,1,0,71.76 ,63.12,50.00 
01,000,02,004,0135,418,1135,14,1149,1762,123456,2,1,2,0,1,0,71.76 ,65.21,50.00 
01,000,02,004,0136,419,1285,21,1306,1896,123456,2,1,2,0,1,0,71.76 ,68.88,50.00 
01,000,02,004,0136,420,1103,13,1116,1797,123456,2,1,2,0,1,0,71.76 ,62.1,50.00 
01,000,02,004,0137,421,1190,16,1206,1901,123456,2,1,2,0,1,0,71.76 ,63.44,50.00 
01,000,02,004,0137,422,1258,18,1276,1861,123456,2,1,2,0,1,0,71.76 ,68.57,50.00 
01,000,02,004,0138,423,963,16,979,1524,123456,2,1,2,0,1,0,71.76 ,64.24,50.00 
01,000,02,004,0138,424,953,11,964,1454,123456,2,1,2,0,1,0,71.76 ,66.3,50.00 
01,000,02,004,0138,425,860,9,869,1345,123456,2,1,2,0,1,0,71.76 ,64.61,50.00 
01,000,02,004,0138,426,1019,13,1032,1502,123456,2,1,2,0,1,0,71.76 ,68.71,50.00 
01,000,02,004,0138,427,878,13,891,1332,123456,2,1,2,0,1,0,71.76 ,66.89,50.00 
01,000,02,004,0139,428,1114,16,1130,1696,123456,2,1,2,0,1,0,71.76 ,66.63,50.00 
01,000,02,004,0139,429,1182,12,1194,1664,123456,2,1,2,0,1,0,71.76 ,71.75,50.00 
01,000,02,004,0139,430,1008,18,1026,1604,123456,2,1,2,0,1,0,71.76 ,63.97,50.00 
01,000,02,004,0140,431,813,7,820,1295,123456,2,1,2,0,1,0,71.76 ,63.32,50.00 
01,000,02,004,0140,432,785,15,800,1316,123456,2,1,2,0,1,0,71.76 ,60.79,50.00 
01,000,02,004,0140,433,908,7,915,1457,123456,2,1,2,0,1,0,71.76 ,62.8,50.00 
01,000,02,004,0140,434,864,11,875,1368,123456,2,1,2,0,1,0,71.76 ,63.96,50.00 
01,000,02,004,0140,435,887,17,904,1466,123456,2,1,2,0,1,0,71.76 ,61.66,50.00 
01,000,02,004,0141,436,1081,25,1106,1795,123456,2,1,2,0,1,0,71.76 ,61.62,50.00 
01,000,02,004,0141,437,1141,17,1158,1805,123456,2,1,2,0,1,0,71.76 ,64.16,50.00 
01,000,02,004,0142,438,979,18,997,1523,123456,2,1,2,0,1,0,71.76 ,65.46,50.00 
01,000,02,004,0142,439,864,30,894,1395,123456,2,1,2,0,1,0,71.76 ,64.09,50.00 
01,000,02,004,0142,440,833,19,852,1342,123456,2,1,2,0,1,0,71.76 ,63.49,50.00 
01,000,02,004,0142,441,841,15,856,1260,123456,2,1,2,0,1,0,71.76 ,67.94,50.00 
01,000,02,004,0143,442,1128,19,1147,1623,123456,2,1,2,0,1,0,71.76 ,70.67,50.00 
01,000,02,004,0143,443,938,24,962,1514,123456,2,1,2,0,1,0,71.76 ,63.54,50.00 
01,000,02,004,0144,444,1208,15,1223,1849,123456,2,1,2,0,1,0,71.76 ,66.14,50.00 
01,000,02,004,0144,445,1206,22,1228,1903,123456,2,1,2,0,1,0,71.76 ,64.53,50.00 
01,000,02,004,0145,446,907,15,922,1365,123456,2,1,2,0,1,0,71.76 ,67.55,50.00 
01,000,02,004,0145,447,916,11,927,1418,123456,2,1,2,0,1,0,71.76 ,65.37,50.00 
01,000,02,004,0145,448,981,22,1003,1451,123456,2,1,2,0,1,0,71.76 ,69.12,50.00 
01,000,02,004,0146,449,890,14,904,1332,123456,2,1,2,0,1,0,71.76 ,67.87,50.00 
01,000,02,004,0146,450,867,20,887,1357,123456,2,1,2,0,1,0,71.76 ,65.36,50.00 
01,000,02,004,0146,451,593,13,606,990,123456,2,1,2,0,1,0,71.76 ,61.21,50.00 
01,000,02,004,0146,452,1137,28,1165,1775,123456,2,1,2,0,1,0,71.76 ,65.63,50.00 
01,000,02,004,0147,453,1192,21,1213,1737,123456,2,1,2,0,1,0,71.76 ,69.83,50.00 
01,000,02,004,0147,454,1045,23,1068,1612,123456,2,1,2,0,1,0,71.76 ,66.25,50.00 
01,000,02,004,0148,455,916,12,928,1438,123456,2,1,2,0,1,0,71.76 ,64.53,50.00 
01,000,02,004,0148,456,823,17,840,1324,123456,2,1,2,0,1,0,71.76 ,63.44,50.00 
01,000,02,004,0148,457,789,28,817,1298,123456,2,1,2,0,1,0,71.76 ,62.94,50.00 
01,000,02,004,0149,458,818,8,826,1330,123456,2,1,2,0,1,0,71.76 ,62.11,50.00 
01,000,02,004,0149,459,992,18,1010,1566,123456,2,1,2,0,1,0,71.76 ,64.5,50.00 
01,000,02,004,0149,460,954,29,983,1488,123456,2,1,2,0,1,0,71.76 ,66.06,50.00 
01,000,03,005,0150,461,951,23,974,1525,123456,2,1,2,0,1,0,71.76 ,63.87,50.00 
01,000,03,005,0150,462,1064,20,1084,1607,123456,2,1,2,0,1,0,71.76 ,67.45,50.00 
01,000,03,005,0150,463,1001,19,1020,1595,123456,2,1,2,0,1,0,71.76 ,63.95,50.00 
01,000,03,005,0151,464,1095,18,1113,1711,123456,2,1,2,0,1,0,71.76 ,65.05,50.00 
01,000,03,005,0151,465,1081,23,1104,1748,123456,2,1,2,0,1,0,71.76 ,63.16,50.00 
01,000,03,005,0151,466,1064,18,1082,1629,123456,2,1,2,0,1,0,71.76 ,66.42,50.00 
01,000,03,005,0151,467,1000,23,1023,1640,123456,2,1,2,0,1,0,71.76 ,62.38,50.00 
01,000,03,005,0152,468,955,13,968,1466,123456,2,1,2,0,1,0,71.76 ,66.03,50.00 
01,000,03,005,0152,469,822,13,835,1324,123456,2,1,2,0,1,0,71.76 ,63.07,50.00 
01,000,03,005,0152,470,865,21,886,1435,123456,2,1,2,0,1,0,71.76 ,61.74,50.00 
01,000,03,005,0152,471,857,16,873,1330,123456,2,1,2,0,1,0,71.76 ,65.64,50.00 
01,000,03,005,0153,472,810,17,827,1303,123456,2,1,2,0,1,0,71.76 ,63.47,50.00 
01,000,03,005,0153,473,796,19,815,1271,123456,2,1,2,0,1,0,71.76 ,64.12,50.00 
01,000,03,005,0153,474,780,9,789,1187,123456,2,1,2,0,1,0,71.76 ,66.47,50.00 
01,000,03,005,0154,475,955,24,979,1550,123456,2,1,2,0,1,0,71.76 ,63.16,50.00 
01,000,03,005,0154,476,942,27,969,1517,123456,2,1,2,0,1,0,71.76 ,63.88,50.00 
01,000,03,005,0154,477,809,15,824,1176,123456,2,1,2,0,1,0,71.76 ,70.07,50.00 
01,000,03,005,0155,478,824,22,846,1317,123456,2,1,2,0,1,0,71.76 ,64.24,50.00 
01,000,03,005,0155,479,843,16,859,1334,123456,2,1,2,0,1,0,71.76 ,64.39,50.00 
01,000,03,005,0155,480,826,14,840,1389,123456,2,1,2,0,1,0,71.76 ,60.48,50.00 
01,000,03,005,0156,481,782,14,796,1224,123456,2,1,2,0,1,0,71.76 ,65.03,50.00 
01,000,03,005,0156,482,818,7,825,1280,123456,2,1,2,0,1,0,71.76 ,64.45,50.00 
01,000,03,005,0156,483,723,21,744,1231,123456,2,1,2,0,1,0,71.76 ,60.44,50.00 
01,000,03,005,0157,484,787,21,808,1191,123456,2,1,2,0,1,0,71.76 ,67.84,50.00 
01,000,03,005,0157,485,745,18,763,1196,123456,2,1,2,0,1,0,71.76 ,63.8,50.00 
01,000,03,005,0157,486,829,13,842,1308,123456,2,1,2,0,1,0,71.76 ,64.37,50.00 
01,000,03,005,0158,487,699,19,718,1132,123456,2,1,2,0,1,0,71.76 ,63.43,50.00 
01,000,03,005,0158,488,835,14,849,1332,123456,2,1,2,0,1,0,71.76 ,63.74,50.00 
01,000,03,005,0158,489,676,19,695,1159,123456,2,1,2,0,1,0,71.76 ,59.97,50.00 
01,000,03,005,0159,490,915,20,935,1556,123456,2,1,2,0,1,0,71.76 ,60.09,50.00 
01,000,03,005,0159,491,982,19,1001,1509,123456,2,1,2,0,1,0,71.76 ,66.34,50.00 
01,000,03,005,0159,492,864,10,874,1399,123456,2,1,2,0,1,0,71.76 ,62.47,50.00 
01,000,03,005,0159,493,1043,16,1059,1566,123456,2,1,2,0,1,0,71.76 ,67.62,50.00 
01,000,03,005,0160,494,804,25,829,1298,123456,2,1,2,0,1,0,71.76 ,63.87,50.00 
01,000,03,005,0160,495,966,24,990,1445,123456,2,1,2,0,1,0,71.76 ,68.51,50.00 
01,000,03,005,0160,496,1050,12,1062,1634,123456,2,1,2,0,1,0,71.76 ,64.99,50.00 
01,000,03,005,0160,497,1051,24,1075,1665,123456,2,1,2,0,1,0,71.76 ,64.56,50.00 
01,000,03,005,0160,498,924,27,951,1477,123456,2,1,2,0,1,0,71.76 ,64.39,50.00 
01,000,03,005,0161,499,662,17,679,1057,123456,2,1,2,0,1,0,71.76 ,64.24,50.00 
01,000,03,005,0161,500,727,20,747,1147,123456,2,1,2,0,1,0,71.76 ,65.13,50.00 
01,000,03,005,0162,501,747,17,764,1197,123456,2,1,2,0,1,0,71.76 ,63.83,50.00 
01,000,03,005,0162,502,806,15,821,1252,123456,2,1,2,0,1,0,71.76 ,65.58,50.00 
01,000,03,005,0162,503,747,10,757,1176,123456,2,1,2,0,1,0,71.76 ,64.37,50.00 
01,000,03,005,0163,504,1071,30,1101,1698,123456,2,1,2,0,1,0,71.76 ,64.84,50.00 
01,000,03,005,0163,505,982,8,990,1499,123456,2,1,2,0,1,0,71.76 ,66.04,50.00 
01,000,03,005,0163,506,1135,11,1146,1734,123456,2,1,2,0,1,0,71.76 ,66.09,50.00 
01,000,03,005,0164,507,908,21,929,1467,123456,2,1,2,0,1,0,71.76 ,63.33,50.00 
01,000,03,005,0164,508,906,24,930,1446,123456,2,1,2,0,1,0,71.76 ,64.32,50.00 
01,000,03,005,0164,509,929,28,957,1445,123456,2,1,2,0,1,0,71.76 ,66.23,50.00 
01,000,03,005,0164,510,813,27,840,1354,123456,2,1,2,0,1,0,71.76 ,62.04,50.00 
01,000,03,005,0164,511,873,27,900,1393,123456,2,1,2,0,1,0,71.76 ,64.61,50.00 
01,000,03,005,0165,512,1250,24,1274,1843,123456,2,1,2,0,1,0,71.76 ,69.13,50.00 
01,000,03,005,0165,513,1159,25,1184,1756,123456,2,1,2,0,1,0,71.76 ,67.43,50.00 
01,000,03,005,0165,514,1031,31,1062,1663,123456,2,1,2,0,1,0,71.76 ,63.86,50.00 
01,000,03,005,0166,515,1090,22,1112,1733,123456,2,1,2,0,1,0,71.76 ,64.17,50.00 
01,000,03,005,0166,516,950,18,968,2407,123456,2,1,2,0,1,0,71.76 ,40.22,50.00 
01,000,03,005,0166,517,938,17,955,1438,123456,2,1,2,0,1,0,71.76 ,66.41,50.00 
01,000,03,005,0167,518,1187,26,1213,1747,123456,2,1,2,0,1,0,71.76 ,69.43,50.00 
01,000,03,005,0167,519,1141,17,1158,1731,123456,2,1,2,0,1,0,71.76 ,66.9,50.00 
01,000,03,005,0167,520,1201,27,1228,1776,123456,2,1,2,0,1,0,71.76 ,69.14,50.00 
01,000,03,005,0167,521,1104,15,1119,1584,123456,2,1,2,0,1,0,71.76 ,70.64,50.00 
01,000,03,005,0168,522,1011,17,1028,1558,123456,2,1,2,0,1,0,71.76 ,65.98,50.00 
01,000,03,005,0168,523,955,13,968,1479,123456,2,1,2,0,1,0,71.76 ,65.45,50.00 
01,000,03,005,0168,524,1023,16,1039,1618,123456,2,1,2,0,1,0,71.76 ,64.22,50.00 
01,000,03,005,0169,525,892,17,909,1264,123456,2,1,2,0,1,0,71.76 ,71.91,50.00 
01,000,03,005,0169,526,958,14,972,1477,123456,2,1,2,0,1,0,71.76 ,65.81,50.00 
01,000,03,005,0169,527,981,18,999,1480,123456,2,1,2,0,1,0,71.76 ,67.5,50.00 
01,000,03,005,0169,528,1064,16,1080,1624,123456,2,1,2,0,1,0,71.76 ,66.5,50.00 
01,000,03,005,0169,529,1101,23,1124,1636,123456,2,1,2,0,1,0,71.76 ,68.7,50.00 
01,000,03,005,0170,530,1088,29,1117,1725,123456,2,1,2,0,1,0,71.76 ,64.75,50.00 
01,000,03,005,0170,531,1114,25,1139,1769,123456,2,1,2,0,1,0,71.76 ,64.39,50.00 
01,000,03,005,0170,532,1011,21,1032,1680,123456,2,1,2,0,1,0,71.76 ,61.43,50.00 
01,000,03,005,0170,533,1067,22,1089,1685,123456,2,1,2,0,1,0,71.76 ,64.63,50.00 
01,000,03,005,0171,534,906,20,926,1473,123456,2,1,2,0,1,0,71.76 ,62.86,50.00 
01,000,03,005,0171,535,1094,15,1109,1654,123456,2,1,2,0,1,0,71.76 ,67.05,50.00 
01,000,03,005,0171,536,960,12,972,1538,123456,2,1,2,0,1,0,71.76 ,63.2,50.00 
01,000,03,005,0171,537,1012,29,1041,1547,123456,2,1,2,0,1,0,71.76 ,67.29,50.00 
01,000,03,005,0172,538,808,17,825,1246,123456,2,1,2,0,1,0,71.76 ,66.21,50.00 
01,000,03,005,0172,539,810,18,828,1233,123456,2,1,2,0,1,0,71.76 ,67.15,50.00 
01,000,03,005,0172,540,886,26,912,1389,123456,2,1,2,0,1,0,71.76 ,65.66,50.00 
01,000,03,005,0172,541,923,17,940,1426,123456,2,1,2,0,1,0,71.76 ,65.92,50.00 
01,000,03,005,0173,542,993,25,1018,1646,123456,2,1,2,0,1,0,71.76 ,61.85,50.00 
01,000,03,005,0173,543,995,23,1018,1706,123456,2,1,2,0,1,0,71.76 ,59.67,50.00 
01,000,03,005,0173,544,1039,32,1071,1747,123456,2,1,2,0,1,0,71.76 ,61.31,50.00 
01,000,03,005,0173,545,885,21,906,1546,123456,2,1,2,0,1,0,71.76 ,58.6,50.00 
01,000,03,005,0174,546,985,27,1012,1629,123456,2,1,2,0,1,0,71.76 ,62.12,50.00 
01,000,03,005,0174,547,1041,14,1055,1531,123456,2,1,2,0,1,0,71.76 ,68.91,50.00 
01,000,03,005,0175,548,853,19,872,1364,123456,2,1,2,0,1,0,71.76 ,63.93,50.00 
01,000,03,005,0175,549,838,16,854,1301,123456,2,1,2,0,1,0,71.76 ,65.64,50.00 
01,000,03,005,0176,550,1032,24,1056,1634,123456,2,1,2,0,1,0,71.76 ,64.63,50.00 
01,000,03,005,0176,551,995,23,1018,1560,123456,2,1,2,0,1,0,71.76 ,65.26,50.00 
01,000,03,005,0177,552,829,23,852,1376,123456,2,1,2,0,1,0,71.76 ,61.92,50.00 
01,000,03,005,0177,553,991,25,1016,1502,123456,2,1,2,0,1,0,71.76 ,67.64,50.00 
01,000,03,005,0177,554,930,24,954,1432,123456,2,1,2,0,1,0,71.76 ,66.62,50.00 
01,000,03,005,0177,555,845,30,875,1310,123456,2,1,2,0,1,0,71.76 ,66.79,50.00 
01,000,03,005,0178,556,835,20,855,1331,123456,2,1,2,0,1,0,71.76 ,64.24,50.00 
01,000,03,005,0178,557,739,25,764,1179,123456,2,1,2,0,1,0,71.76 ,64.8,50.00 
01,000,03,005,0179,558,920,25,945,1471,123456,2,1,2,0,1,0,71.76 ,64.24,50.00 
01,000,03,005,0179,559,1012,21,1033,1667,123456,2,1,2,0,1,0,71.76 ,61.97,50.00 
01,000,03,005,0180,560,1160,18,1178,1755,123456,2,1,2,0,1,0,71.76 ,67.12,50.00 
01,000,03,005,0180,561,964,18,982,1549,123456,2,1,2,0,1,0,71.76 ,63.4,50.00 
01,000,03,005,0180,562,929,17,946,1495,123456,2,1,2,0,1,0,71.76 ,63.28,50.00 
01,000,03,005,0181,563,740,27,767,1192,123456,2,1,2,0,1,0,71.76 ,64.35,50.00 
01,000,03,005,0181,564,589,15,604,930,123456,2,1,2,0,1,0,71.76 ,64.95,50.00 
01,000,03,005,0182,565,1007,27,1034,1591,123456,2,1,2,0,1,0,71.76 ,64.99,50.00 
01,000,03,005,0182,566,885,17,902,1483,123456,2,1,2,0,1,0,71.76 ,60.82,50.00 
01,000,03,006,0183,567,851,17,868,2271,123456,2,1,2,0,1,0,71.76 ,38.22,50.00 
01,000,03,006,0183,568,930,20,950,1378,123456,2,1,2,0,1,0,71.76 ,68.94,50.00 
01,000,03,006,0183,569,849,17,866,1331,123456,2,1,2,0,1,0,71.76 ,65.06,50.00 
01,000,03,006,0184,570,889,16,905,1407,123456,2,1,2,0,1,0,71.76 ,64.32,50.00 
01,000,03,006,0184,571,828,17,845,1233,123456,2,1,2,0,1,0,71.76 ,68.53,50.00 
01,000,03,006,0184,572,775,16,791,1268,123456,2,1,2,0,1,0,71.76 ,62.38,50.00 
01,000,03,006,0185,573,655,12,667,1093,123456,2,1,2,0,1,0,71.76 ,61.02,50.00 
01,000,03,006,0185,574,819,23,842,1426,123456,2,1,2,0,1,0,71.76 ,59.05,50.00 
01,000,03,006,0186,575,733,11,744,1313,123456,2,1,2,0,1,0,71.76 ,56.66,50.00 
01,000,03,006,0186,576,737,15,752,1306,123456,2,1,2,0,1,0,71.76 ,57.58,50.00 
01,000,03,006,0187,577,932,18,950,1457,123456,2,1,2,0,1,0,71.76 ,65.2,50.00 
01,000,03,006,0187,578,893,26,919,1395,123456,2,1,2,0,1,0,71.76 ,65.88,50.00 
01,000,03,006,0188,579,1055,30,1085,1666,123456,2,1,2,0,1,0,71.76 ,65.13,50.00 
01,000,03,006,0188,580,1008,27,1035,1532,123456,2,1,2,0,1,0,71.76 ,67.56,50.00 
01,000,03,006,0188,581,1074,16,1090,1651,123456,2,1,2,0,1,0,71.76 ,66.02,50.00 
01,000,03,006,0189,582,841,15,856,1307,123456,2,1,2,0,1,0,71.76 ,65.49,50.00 
01,000,03,006,0189,583,770,11,781,1286,123456,2,1,2,0,1,0,71.76 ,60.73,50.00 
01,000,03,006,0189,584,827,11,838,1300,123456,2,1,2,0,1,0,71.76 ,64.46,50.00 
01,000,03,006,0190,585,967,12,979,1557,123456,2,1,2,0,1,0,71.76 ,62.88,50.00 
01,000,03,006,0190,586,1067,21,1088,1642,123456,2,1,2,0,1,0,71.76 ,66.26,50.00 
01,000,03,006,0190,587,967,13,980,1576,123456,2,1,2,0,1,0,71.76 ,62.18,50.00 
01,000,03,006,0190,588,842,14,856,1307,123456,2,1,2,0,1,0,71.76 ,65.49,50.00 
01,000,03,006,0191,589,1008,22,1030,1574,123456,2,1,2,0,1,0,71.76 ,65.44,50.00 
01,000,03,006,0191,590,1044,15,1059,1657,123456,2,1,2,0,1,0,71.76 ,63.91,50.00 
01,000,03,006,0191,591,1046,19,1065,1687,123456,2,1,2,0,1,0,71.76 ,63.13,50.00 
01,000,03,006,0191,592,978,29,1007,1689,123456,2,1,2,0,1,0,71.76 ,59.62,50.00 
01,000,03,006,0192,593,965,20,985,1541,123456,2,1,2,0,1,0,71.76 ,63.92,50.00 
01,000,03,006,0192,594,983,20,1003,1441,123456,2,1,2,0,1,0,71.76 ,69.6,50.00 
01,000,03,006,0193,595,812,10,822,1281,123456,2,1,2,0,1,0,71.76 ,64.17,50.00 
01,000,03,006,0193,596,798,14,812,1251,123456,2,1,2,0,1,0,71.76 ,64.91,50.00 
01,000,03,006,0193,597,967,9,976,1470,123456,2,1,2,0,1,0,71.76 ,66.39,50.00 
01,000,03,006,0194,598,950,17,967,1508,123456,2,1,2,0,1,0,71.76 ,64.12,50.00 
01,000,03,006,0194,599,969,29,998,1547,123456,2,1,2,0,1,0,71.76 ,64.51,50.00 
01,000,03,006,0195,600,953,8,961,1450,123456,2,1,2,0,1,0,71.76 ,66.28,50.00 
01,000,03,006,0195,601,940,19,959,1401,123456,2,1,2,0,1,0,71.76 ,68.45,50.00 
01,000,03,006,0195,602,928,15,943,1391,123456,2,1,2,0,1,0,71.76 ,67.79,50.00 
01,000,03,006,0196,603,1117,24,1141,1909,123456,2,1,2,0,1,0,71.76 ,59.77,50.00 
01,000,03,006,0196,604,1124,33,1157,1689,123456,2,1,2,0,1,0,71.76 ,68.5,50.00 
01,000,03,006,0197,605,1135,19,1154,1762,123456,2,1,2,0,1,0,71.76 ,65.49,50.00 
01,000,03,006,0197,606,1172,21,1193,1782,123456,2,1,2,0,1,0,71.76 ,66.95,50.00 
01,000,03,006,0198,607,984,23,1007,1530,123456,2,1,2,0,1,0,71.76 ,65.82,50.00 
01,000,03,006,0198,608,1073,17,1090,1577,123456,2,1,2,0,1,0,71.76 ,69.12,50.00 
01,000,03,006,0198,609,1049,21,1070,1569,123456,2,1,2,0,1,0,71.76 ,68.2,50.00 
01,000,03,006,0199,610,1005,22,1027,1607,123456,2,1,2,0,1,0,71.76 ,63.91,50.00 
01,000,03,006,0199,611,931,22,953,1545,123456,2,1,2,0,1,0,71.76 ,61.68,50.00 
01,000,03,006,0199,612,792,21,813,1379,123456,2,1,2,0,1,0,71.76 ,58.96,50.00 
01,000,03,006,0200,613,899,31,930,1453,123456,2,1,2,0,1,0,71.76 ,64.01,50.00 
01,000,03,006,0200,614,861,24,885,1338,123456,2,1,2,0,1,0,71.76 ,66.14,50.00 
01,000,03,006,0200,615,908,19,927,1475,123456,2,1,2,0,1,0,71.76 ,62.85,50.00 
01,000,03,006,0201,616,1172,25,1197,1762,123456,2,1,2,0,1,0,71.76 ,67.93,50.00 
01,000,03,006,0201,617,951,8,959,1602,123456,2,1,2,0,1,0,71.76 ,59.86,50.00 
01,000,03,006,0202,618,834,8,842,1404,123456,2,1,2,0,1,0,71.76 ,59.97,50.00 
01,000,03,006,0202,619,1014,11,1025,1509,123456,2,1,2,0,1,0,71.76 ,67.93,50.00 
01,000,03,006,0202,620,962,17,979,1531,123456,2,1,2,0,1,0,71.76 ,63.95,50.00 
01,000,03,006,0202,621,972,18,990,1550,123456,2,1,2,0,1,0,71.76 ,63.87,50.00 
01,000,03,006,0203,622,681,11,692,1109,123456,2,1,2,0,1,0,71.76 ,62.4,50.00 
01,000,03,006,0203,623,553,7,560,911,123456,2,1,2,0,1,0,71.76 ,61.47,50.00 
01,000,03,006,0204,624,1120,15,1135,1791,123456,2,1,2,0,1,0,71.76 ,63.37,50.00 
01,000,03,006,0204,625,1106,24,1130,1782,123456,2,1,2,0,1,0,71.76 ,63.41,50.00 
01,000,03,006,0204,626,1104,20,1124,1808,123456,2,1,2,0,1,0,71.76 ,62.17,50.00 
01,000,03,006,0205,627,849,20,869,1417,123456,2,1,2,0,1,0,71.76 ,61.33,50.00 
01,000,03,006,0205,628,919,17,936,1443,123456,2,1,2,0,1,0,71.76 ,64.86,50.00 
01,000,03,006,0205,629,993,12,1005,1546,123456,2,1,2,0,1,0,71.76 ,65.01,50.00 
01,000,03,006,0206,630,732,18,750,1154,123456,2,1,2,0,1,0,71.76 ,64.99,50.00 
01,000,03,006,0206,631,780,16,796,1219,123456,2,1,2,0,1,0,71.76 ,65.3,50.00 
01,000,03,006,0206,632,864,14,878,1364,123456,2,1,2,0,1,0,71.76 ,64.37,50.00 
01,000,03,006,0207,633,992,23,1015,1561,123456,2,1,2,0,1,0,71.76 ,65.02,50.00 
01,000,03,006,0207,634,1090,15,1105,1714,123456,2,1,2,0,1,0,71.76 ,64.47,50.00 
01,000,03,006,0207,635,1030,11,1041,1568,123456,2,1,2,0,1,0,71.76 ,66.39,50.00 
01,000,03,006,0207,636,1039,33,1072,1648,123456,2,1,2,0,1,0,71.76 ,65.05,50.00 
01,000,03,006,0208,637,871,20,891,1414,123456,2,1,2,0,1,0,71.76 ,63.01,50.00 
01,000,03,006,0208,638,882,13,895,1379,123456,2,1,2,0,1,0,71.76 ,64.9,50.00 
01,000,03,006,0208,639,812,15,827,1280,123456,2,1,2,0,1,0,71.76 ,64.61,50.00 
01,000,03,006,0208,640,820,8,828,1332,123456,2,1,2,0,1,0,71.76 ,62.16,50.00 
01,000,03,006,0209,641,696,29,725,1097,123456,2,1,2,0,1,0,71.76 ,66.09,50.00 
01,000,03,006,0209,642,998,22,1020,1498,123456,2,1,2,0,1,0,71.76 ,68.09,50.00 
01,000,03,006,0209,643,1027,7,1034,1489,123456,2,1,2,0,1,0,71.76 ,69.44,50.00 
01,000,03,006,0210,644,889,16,905,1390,123456,2,1,2,0,1,0,71.76 ,65.11,50.00 
01,000,03,006,0210,645,908,24,932,1399,123456,2,1,2,0,1,0,71.76 ,66.62,50.00 
01,000,03,006,0210,646,825,18,843,1340,123456,2,1,2,0,1,0,71.76 ,62.91,50.00 
01,000,03,006,0211,647,842,27,869,1327,123456,2,1,2,0,1,0,71.76 ,65.49,50.00 
01,000,03,006,0211,648,969,14,983,1488,123456,2,1,2,0,1,0,71.76 ,66.06,50.00 
01,000,03,006,0211,649,949,19,968,1414,123456,2,1,2,0,1,0,71.76 ,68.46,50.00 
01,000,03,006,0211,650,844,19,863,1251,123456,2,1,2,0,1,0,71.76 ,68.98,50.00 
01,000,03,006,0212,651,1002,17,1019,1525,123456,2,1,2,0,1,0,71.76 ,66.82,50.00 
01,000,03,006,0212,652,953,19,972,1495,123456,2,1,2,0,1,0,71.76 ,65.02,50.00 
01,000,03,006,0212,653,1030,14,1044,1590,123456,2,1,2,0,1,0,71.76 ,65.66,50.00 
01,000,03,006,0212,654,995,24,1019,1535,123456,2,1,2,0,1,0,71.76 ,66.38,50.00 
01,000,03,006,0212,655,889,12,901,1421,123456,2,1,2,0,1,0,71.76 ,63.41,50.00 
01,000,03,006,0213,656,789,14,803,1257,123456,2,1,2,0,1,0,71.76 ,63.88,50.00 
01,000,03,006,0213,657,949,12,961,1491,123456,2,1,2,0,1,0,71.76 ,64.45,50.00 
01,000,03,006,0213,658,863,9,872,1406,123456,2,1,2,0,1,0,71.76 ,62.02,50.00 
01,000,03,006,0214,659,970,13,983,1558,123456,2,1,2,0,1,0,71.76 ,63.09,50.00 
01,000,03,006,0214,660,899,19,918,1441,123456,2,1,2,0,1,0,71.76 ,63.71,50.00 
01,000,03,006,0214,661,802,11,813,1333,123456,2,1,2,0,1,0,71.76 ,60.99,50.00 
01,000,03,006,0214,662,750,10,760,1309,123456,2,1,2,0,1,0,71.76 ,58.06,50.00 
01,000,03,006,0215,663,884,14,898,1545,123456,2,1,2,0,1,0,71.76 ,58.12,50.00 
01,000,03,006,0215,664,979,21,1000,1537,123456,2,1,2,0,1,0,71.76 ,65.06,50.00 
01,000,03,006,0215,665,1151,24,1175,1789,123456,2,1,2,0,1,0,71.76 ,65.68,50.00 
01,000,03,006,0215,666,1095,26,1121,1742,123456,2,1,2,0,1,0,71.76 ,64.35,50.00 
01,000,03,006,0216,667,761,19,780,1230,123456,2,1,2,0,1,0,71.76 ,63.41,50.00 
01,000,03,006,0216,668,895,19,914,1365,123456,2,1,2,0,1,0,71.76 ,66.96,50.00 
01,000,03,006,0216,669,848,17,865,1318,123456,2,1,2,0,1,0,71.76 ,65.63,50.00 
01,000,03,006,0217,670,683,12,695,1053,123456,2,1,2,0,1,0,71.76 ,66,50.00 
01,000,03,006,0217,671,783,14,797,1239,123456,2,1,2,0,1,0,71.76 ,64.33,50.00 
01,000,03,006,0217,672,880,20,900,1327,123456,2,1,2,0,1,0,71.76 ,67.82,50.00 
01,000,03,006,0218,673,991,12,1003,1553,123456,2,1,2,0,1,0,71.76 ,64.58,50.00 
01,000,03,006,0218,674,913,14,927,1389,123456,2,1,2,0,1,0,71.76 ,66.74,50.00 
01,000,03,006,0218,675,923,22,945,1474,123456,2,1,2,0,1,0,71.76 ,64.11,50.00 
01,000,03,006,0218,676,979,25,1004,1505,123456,2,1,2,0,1,0,71.76 ,66.71,50.00 
01,000,03,006,0219,677,923,22,945,1414,123456,2,1,2,0,1,0,71.76 ,66.83,50.00 
01,000,03,006,0219,678,804,17,821,1252,123456,2,1,2,0,1,0,71.76 ,65.58,50.00 
01,000,03,006,0220,679,1071,24,1095,1780,123456,2,1,2,0,1,0,71.76 ,61.52,50.00 
01,000,03,006,0220,680,1139,24,1163,1762,123456,2,1,2,0,1,0,71.76 ,66,50.00 
01,000,03,006,0221,681,1066,16,1082,1602,123456,2,1,2,0,1,0,71.76 ,67.54,50.00 
01,000,03,006,0221,682,802,28,830,1254,123456,2,1,2,0,1,0,71.76 ,66.19,50.00 
01,000,03,006,0221,683,1020,17,1037,1577,123456,2,1,2,0,1,0,71.76 ,65.76,50.00 
01,000,03,006,0221,684,761,14,775,1189,123456,2,1,2,0,1,0,71.76 ,65.18,50.00 
01,000,03,006,0222,685,903,24,927,1397,123456,2,1,2,0,1,0,71.76 ,66.36,50.00 
01,000,03,006,0222,686,750,14,764,1191,123456,2,1,2,0,1,0,71.76 ,64.15,50.00 
01,000,03,006,0222,687,934,27,961,1439,123456,2,1,2,0,1,0,71.76 ,66.78,50.00 
01,000,03,006,0223,688,742,20,762,1226,123456,2,1,2,0,1,0,71.76 ,62.15,50.00 
01,000,03,006,0223,689,667,14,681,967,123456,2,1,2,0,1,0,71.76 ,70.42,50.00 
01,000,04,007,0224,690,577,14,591,868,123456,2,1,2,0,1,0,71.76 ,68.09,50.00 
01,000,04,007,0224,691,916,22,938,1532,123456,2,1,2,0,1,0,71.76 ,61.23,50.00 
01,000,04,007,0225,692,635,16,651,1182,123456,2,1,2,0,1,0,71.76 ,55.08,50.00 
01,000,04,007,0225,693,552,14,566,1000,123456,2,1,2,0,1,0,71.76 ,56.6,50.00 
01,000,04,007,0225,694,848,22,870,1481,123456,2,1,2,0,1,0,71.76 ,58.74,50.00 
01,000,04,007,0226,695,626,9,635,1126,123456,2,1,2,0,1,0,71.76 ,56.39,50.00 
01,000,04,007,0226,696,855,16,871,1563,123456,2,1,2,0,1,0,71.76 ,55.73,50.00 
01,000,04,007,0227,697,997,24,1021,1546,123456,2,1,2,0,1,0,71.76 ,66.04,50.00 
01,000,04,007,0227,698,771,15,786,1335,123456,2,1,2,0,1,0,71.76 ,58.88,50.00 
01,000,04,007,0227,699,846,10,856,1297,123456,2,1,2,0,1,0,71.76 ,66,50.00 
01,000,04,007,0228,700,600,13,613,1084,123456,2,1,2,0,1,0,71.76 ,56.55,50.00 
01,000,04,007,0228,701,492,7,499,920,123456,2,1,2,0,1,0,71.76 ,54.24,50.00 
01,000,04,007,0229,702,821,13,834,1404,123456,2,1,2,0,1,0,71.76 ,59.4,50.00 
01,000,04,007,0229,703,772,13,785,1438,123456,2,1,2,0,1,0,71.76 ,54.59,50.00 
01,000,04,007,0229,704,860,17,877,1436,123456,2,1,2,0,1,0,71.76 ,61.07,50.00 
01,000,04,007,0230,705,877,11,888,1596,123456,2,1,2,0,1,0,71.76 ,55.64,50.00 
01,000,04,007,0230,706,752,24,776,1442,123456,2,1,2,0,1,0,71.76 ,53.81,50.00 
01,000,04,007,0231,707,1037,25,1062,1662,123456,2,1,2,0,1,0,71.76 ,63.9,50.00 
01,000,04,007,0231,708,987,20,1007,1598,123456,2,1,2,0,1,0,71.76 ,63.02,50.00 
01,000,04,007,0231,709,1066,19,1085,1808,123456,2,1,2,0,1,0,71.76 ,60.01,50.00 
01,000,04,007,0232,710,897,9,906,1542,123456,2,1,2,0,1,0,71.76 ,58.75,50.00 
01,000,04,007,0232,711,916,12,928,1544,123456,2,1,2,0,1,0,71.76 ,60.1,50.00 
01,000,04,007,0233,712,876,22,898,1496,123456,2,1,2,0,1,0,71.76 ,60.03,50.00 
01,000,04,007,0233,713,1063,25,1088,1764,123456,2,1,2,0,1,0,71.76 ,61.68,50.00 
01,000,04,007,0234,714,747,16,763,1334,123456,2,1,2,0,1,0,71.76 ,57.2,50.00 
01,000,04,007,0234,715,621,17,638,1186,123456,2,1,2,0,1,0,71.76 ,53.79,50.00 
01,000,04,007,0234,716,754,18,772,1304,123456,2,1,2,0,1,0,71.76 ,59.2,50.00 
01,000,04,007,0235,717,923,19,942,1616,123456,2,1,2,0,1,0,71.76 ,58.29,50.00 
01,000,04,007,0235,718,837,17,854,1494,123456,2,1,2,0,1,0,71.76 ,57.16,50.00 
01,000,04,007,0236,719,795,8,803,1375,123456,2,1,2,0,1,0,71.76 ,58.4,50.00 
01,000,04,007,0236,720,842,24,866,1338,123456,2,1,2,0,1,0,71.76 ,64.72,50.00 
01,000,04,007,0236,721,851,12,863,1322,123456,2,1,2,0,1,0,71.76 ,65.28,50.00 
01,000,04,007,0237,722,962,8,970,1457,123456,2,1,2,0,1,0,71.76 ,66.58,50.00 
01,000,04,007,0237,723,1180,15,1195,1726,123456,2,1,2,0,1,0,71.76 ,69.24,50.00 
01,000,04,007,0238,724,935,9,944,1420,123456,2,1,2,0,1,0,71.76 ,66.48,50.00 
01,000,04,007,0238,725,965,18,983,1474,123456,2,1,2,0,1,0,71.76 ,66.69,50.00 
01,000,04,007,0238,726,1011,18,1029,1525,123456,2,1,2,0,1,0,71.76 ,67.48,50.00 
01,000,04,007,0238,727,1085,15,1100,1630,123456,2,1,2,0,1,0,71.76 ,67.48,50.00 
01,000,04,007,0238,728,1022,15,1037,1579,123456,2,1,2,0,1,0,71.76 ,65.67,50.00 
01,000,04,007,0239,729,1024,16,1040,1543,123456,2,1,2,0,1,0,71.76 ,67.4,50.00 
01,000,04,007,0239,730,993,24,1017,1604,123456,2,1,2,0,1,0,71.76 ,63.4,50.00 
01,000,04,007,0240,731,1184,17,1201,1826,123456,2,1,2,0,1,0,71.76 ,65.77,50.00 
01,000,04,007,0240,732,1073,26,1099,1665,123456,2,1,2,0,1,0,71.76 ,66.01,50.00 
01,000,04,007,0240,733,1087,26,1113,1736,123456,2,1,2,0,1,0,71.76 ,64.11,50.00 
01,000,04,007,0240,734,1111,23,1134,1707,123456,2,1,2,0,1,0,71.76 ,66.43,50.00 
01,000,04,007,0241,735,709,9,718,1046,123456,2,1,2,0,1,0,71.76 ,68.64,50.00 
01,000,04,007,0242,736,1066,19,1085,1727,123456,2,1,2,0,1,0,71.76 ,62.83,50.00 
01,000,04,007,0242,737,893,28,921,1470,123456,2,1,2,0,1,0,71.76 ,62.65,50.00 
01,000,04,007,0242,738,932,14,946,1498,123456,2,1,2,0,1,0,71.76 ,63.15,50.00 
01,000,04,007,0243,739,816,10,826,1218,123456,2,1,2,0,1,0,71.76 ,67.82,50.00 
01,000,04,007,0243,740,674,13,687,990,123456,2,1,2,0,1,0,71.76 ,69.39,50.00 
01,000,04,007,0244,741,939,18,957,1356,123456,2,1,2,0,1,0,71.76 ,70.58,50.00 
01,000,04,007,0244,742,864,8,872,1365,123456,2,1,2,0,1,0,71.76 ,63.88,50.00 
01,000,04,007,0244,743,792,17,809,1319,123456,2,1,2,0,1,0,71.76 ,61.33,50.00 
01,000,04,007,0245,744,828,21,849,1285,123456,2,1,2,0,1,0,71.76 ,66.07,50.00 
01,000,04,007,0245,745,881,24,905,1469,123456,2,1,2,0,1,0,71.76 ,61.61,50.00 
01,000,04,007,0245,746,959,14,973,1469,123456,2,1,2,0,1,0,71.76 ,66.24,50.00 
01,000,04,007,0246,747,1206,12,1218,1750,123456,2,1,2,0,1,0,71.76 ,69.6,50.00 
01,000,04,007,0246,748,1133,23,1156,1715,123456,2,1,2,0,1,0,71.76 ,67.41,50.00 
01,000,04,007,0246,749,1001,14,1015,1570,123456,2,1,2,0,1,0,71.76 ,64.65,50.00 
01,000,04,007,0247,750,827,19,846,1250,123456,2,1,2,0,1,0,71.76 ,67.68,50.00 
01,000,04,007,0247,751,893,21,914,1449,123456,2,1,2,0,1,0,71.76 ,63.08,50.00 
01,000,04,007,0247,752,990,28,1018,1452,123456,2,1,2,0,1,0,71.76 ,70.11,50.00 
01,000,04,007,0248,753,923,12,935,1449,123456,2,1,2,0,1,0,71.76 ,64.53,50.00 
01,000,04,007,0248,754,963,11,974,1497,123456,2,1,2,0,1,0,71.76 ,65.06,50.00 
01,000,04,007,0248,755,829,20,849,1434,123456,2,1,2,0,1,0,71.76 ,59.21,50.00 
01,000,04,007,0249,756,699,11,710,2392,123456,2,1,2,0,1,0,71.76 ,29.68,50.00 
01,000,04,007,0249,757,1111,29,1140,1785,123456,2,1,2,0,1,0,71.76 ,63.87,50.00 
01,000,04,007,0249,758,1090,26,1116,1696,123456,2,1,2,0,1,0,71.76 ,65.8,50.00 
01,000,04,007,0250,759,1093,22,1115,1780,123456,2,1,2,0,1,0,71.76 ,62.64,50.00 
01,000,04,007,0250,760,1157,27,1184,1776,123456,2,1,2,0,1,0,71.76 ,66.67,50.00 
01,000,04,007,0250,761,997,20,1017,1546,123456,2,1,2,0,1,0,71.76 ,65.78,50.00 
01,000,04,007,0250,762,929,17,946,1462,123456,2,1,2,0,1,0,71.76 ,64.71,50.00 
01,000,04,007,0251,763,1089,15,1104,1708,123456,2,1,2,0,1,0,71.76 ,64.64,50.00 
01,000,04,007,0251,764,1047,14,1061,1763,123456,2,1,2,0,1,0,71.76 ,60.18,50.00 
01,000,04,007,0252,765,920,15,935,1441,123456,2,1,2,0,1,0,71.76 ,64.89,50.00 
01,000,04,007,0252,766,907,27,934,1460,123456,2,1,2,0,1,0,71.76 ,63.97,50.00 
01,000,04,007,0252,767,868,17,885,1399,123456,2,1,2,0,1,0,71.76 ,63.26,50.00 
01,000,04,007,0252,768,1058,39,1097,1703,123456,2,1,2,0,1,0,71.76 ,64.42,50.00 
01,000,04,007,0253,769,989,13,1002,1528,123456,2,1,2,0,1,0,71.76 ,65.58,50.00 
01,000,04,007,0253,770,807,15,822,1291,123456,2,1,2,0,1,0,71.76 ,63.67,50.00 
01,000,04,007,0253,771,833,9,842,1323,123456,2,1,2,0,1,0,71.76 ,63.64,50.00 
01,000,04,007,0253,772,838,18,856,1380,123456,2,1,2,0,1,0,71.76 ,62.03,50.00 
01,000,04,007,0254,773,962,21,983,1506,123456,2,1,2,0,1,0,71.76 ,65.27,50.00 
01,000,04,007,0254,774,1094,29,1123,1750,123456,2,1,2,0,1,0,71.76 ,64.17,50.00 
01,000,04,007,0254,775,998,17,1015,1637,123456,2,1,2,0,1,0,71.76 ,62,50.00 
01,000,04,007,0254,776,920,14,934,1457,123456,2,1,2,0,1,0,71.76 ,64.1,50.00 
01,000,04,007,0255,777,887,16,903,1396,123456,2,1,2,0,1,0,71.76 ,64.68,50.00 
01,000,04,007,0255,778,866,14,880,1402,123456,2,1,2,0,1,0,71.76 ,62.77,50.00 
01,000,04,007,0255,779,864,17,881,1389,123456,2,1,2,0,1,0,71.76 ,63.43,50.00 
01,000,04,007,0256,780,720,14,734,1148,123456,2,1,2,0,1,0,71.76 ,63.94,50.00 
01,000,04,007,0256,781,911,9,920,1422,123456,2,1,2,0,1,0,71.76 ,64.7,50.00 
01,000,04,007,0256,782,860,10,870,1377,123456,2,1,2,0,1,0,71.76 ,63.18,50.00 
01,000,04,007,0257,783,992,9,1001,1669,123456,2,1,2,0,1,0,71.76 ,59.98,50.00 
01,000,04,007,0257,784,641,11,652,1027,123456,2,1,2,0,1,0,71.76 ,63.49,50.00 
01,000,04,007,0257,785,888,12,900,1456,123456,2,1,2,0,1,0,71.76 ,61.81,50.00 
01,000,04,007,0258,786,913,11,924,1424,123456,2,1,2,0,1,0,71.76 ,64.89,50.00 
01,000,04,007,0258,787,971,19,990,1510,123456,2,1,2,0,1,0,71.76 ,65.56,50.00 
01,000,04,007,0259,788,984,23,1007,1629,123456,2,1,2,0,1,0,71.76 ,61.82,50.00 
01,000,04,007,0259,789,1010,21,1031,1616,123456,2,1,2,0,1,0,71.76 ,63.8,50.00 
01,000,04,007,0259,790,1001,18,1019,1640,123456,2,1,2,0,1,0,71.76 ,62.13,50.00 
01,000,04,007,0260,791,968,24,992,1470,123456,2,1,2,0,1,0,71.76 ,67.48,50.00 
01,000,04,007,0260,792,868,12,880,1249,123456,2,1,2,0,1,0,71.76 ,70.46,50.00 
01,000,04,007,0260,793,1037,18,1055,1526,123456,2,1,2,0,1,0,71.76 ,69.13,50.00 
01,000,04,007,0261,794,764,11,775,1201,123456,2,1,2,0,1,0,71.76 ,64.53,50.00 
01,000,04,007,0261,795,621,14,635,1113,123456,2,1,2,0,1,0,71.76 ,57.05,50.00 
01,000,04,007,0261,796,840,32,872,1349,123456,2,1,2,0,1,0,71.76 ,64.64,50.00 
01,000,04,007,0262,797,883,28,911,1451,123456,2,1,2,0,1,0,71.76 ,62.78,50.00 
01,000,04,007,0262,798,1016,28,1044,1622,123456,2,1,2,0,1,0,71.76 ,64.36,50.00 
01,000,04,007,0263,799,773,16,789,1338,123456,2,1,2,0,1,0,71.76 ,58.97,50.00 
01,000,04,007,0263,800,736,18,754,1168,123456,2,1,2,0,1,0,71.76 ,64.55,50.00 
01,000,04,007,0264,801,972,22,994,1538,123456,2,1,2,0,1,0,71.76 ,64.63,50.00 
01,000,04,007,0264,802,1022,25,1047,1709,123456,2,1,2,0,1,0,71.76 ,61.26,50.00 
01,000,04,007,0264,803,1015,24,1039,1675,123456,2,1,2,0,1,0,71.76 ,62.03,50.00 
01,000,04,007,0265,804,1049,17,1066,1684,123456,2,1,2,0,1,0,71.76 ,63.3,50.00 
01,000,04,007,0265,805,1031,22,1053,1741,123456,2,1,2,0,1,0,71.76 ,60.48,50.00 
01,000,04,008,0266,806,915,23,938,1444,123456,2,1,2,0,1,0,71.76 ,64.96,50.00 
01,000,04,008,0266,807,705,19,724,1257,123456,2,1,2,0,1,0,71.76 ,57.6,50.00 
01,000,04,008,0267,808,852,17,869,1354,123456,2,1,2,0,1,0,71.76 ,64.18,50.00 
01,000,04,008,0267,809,887,17,904,1406,123456,2,1,2,0,1,0,71.76 ,64.3,50.00 
01,000,04,008,0268,810,1304,34,1338,1964,123456,2,1,2,0,1,0,71.76 ,68.13,50.00 
01,000,04,008,0268,811,1136,18,1154,1942,123456,2,1,2,0,1,0,71.76 ,59.42,50.00 
01,000,04,008,0269,812,1024,26,1050,1619,123456,2,1,2,0,1,0,71.76 ,64.85,50.00 
01,000,04,008,0269,813,789,20,809,1264,123456,2,1,2,0,1,0,71.76 ,64,50.00 
01,000,04,008,0270,814,970,13,983,1606,123456,2,1,2,0,1,0,71.76 ,61.21,50.00 
01,000,04,008,0270,815,836,11,847,1321,123456,2,1,2,0,1,0,71.76 ,64.12,50.00 
01,000,04,008,0270,816,861,14,875,1378,123456,2,1,2,0,1,0,71.76 ,63.5,50.00 
01,000,04,008,0271,817,1014,22,1036,1683,123456,2,1,2,0,1,0,71.76 ,61.56,50.00 
01,000,04,008,0271,818,999,17,1016,1616,123456,2,1,2,0,1,0,71.76 ,62.87,50.00 
01,000,04,008,0272,819,875,13,888,1386,123456,2,1,2,0,1,0,71.76 ,64.07,50.00 
01,000,04,008,0272,820,884,16,900,1367,123456,2,1,2,0,1,0,71.76 ,65.84,50.00 
01,000,04,008,0272,821,910,16,926,1457,123456,2,1,2,0,1,0,71.76 ,63.56,50.00 
01,000,04,008,0273,822,920,26,946,1483,123456,2,1,2,0,1,0,71.76 ,63.79,50.00 
01,000,04,008,0273,823,800,14,814,1263,123456,2,1,2,0,1,0,71.76 ,64.45,50.00 
01,000,04,008,0273,824,945,23,968,1411,123456,2,1,2,0,1,0,71.76 ,68.6,50.00 
01,000,04,008,0274,825,858,16,874,1307,123456,2,1,2,0,1,0,71.76 ,66.87,50.00 
01,000,04,008,0274,826,930,22,952,1447,123456,2,1,2,0,1,0,71.76 ,65.79,50.00 
01,000,04,008,0274,827,902,8,910,1320,123456,2,1,2,0,1,0,71.76 ,68.94,50.00 
01,000,04,008,0275,828,1032,21,1053,1699,123456,2,1,2,0,1,0,71.76 ,61.98,50.00 
01,000,04,008,0275,829,1057,18,1075,1629,123456,2,1,2,0,1,0,71.76 ,65.99,50.00 
01,000,04,008,0276,830,1037,10,1047,1510,123456,2,1,2,0,1,0,71.76 ,69.34,50.00 
01,000,04,008,0276,831,1024,14,1038,1643,123456,2,1,2,0,1,0,71.76 ,63.18,50.00 
01,000,04,008,0276,832,1039,9,1048,1596,123456,2,1,2,0,1,0,71.76 ,65.66,50.00 
01,000,04,008,0276,833,909,5,914,1442,123456,2,1,2,0,1,0,71.76 ,63.38,50.00 
01,000,04,008,0276,834,874,17,891,1461,123456,2,1,2,0,1,0,71.76 ,60.99,50.00 
01,000,04,008,0277,835,984,19,1003,1633,123456,2,1,2,0,1,0,71.76 ,61.42,50.00 
01,000,04,008,0277,836,1104,27,1131,1735,123456,2,1,2,0,1,0,71.76 ,65.19,50.00 
01,000,04,008,0278,837,1092,19,1111,1755,123456,2,1,2,0,1,0,71.76 ,63.3,50.00 
01,000,04,008,0278,838,1114,20,1134,1705,123456,2,1,2,0,1,0,71.76 ,66.51,50.00 
01,000,04,008,0278,839,981,17,998,1601,123456,2,1,2,0,1,0,71.76 ,62.34,50.00 
01,000,04,008,0279,840,832,14,846,1276,123456,2,1,2,0,1,0,71.76 ,66.3,50.00 
01,000,04,008,0279,841,749,21,770,1143,123456,2,1,2,0,1,0,71.76 ,67.37,50.00 
01,000,04,008,0280,842,923,14,937,1398,123456,2,1,2,0,1,0,71.76 ,67.02,50.00 
01,000,04,008,0280,843,846,11,857,1240,123456,2,1,2,0,1,0,71.76 ,69.11,50.00 
01,000,04,008,0281,844,782,14,796,1289,123456,2,1,2,0,1,0,71.76 ,61.75,50.00 
01,000,04,008,0281,845,767,14,781,1204,123456,2,1,2,0,1,0,71.76 ,64.87,50.00 
01,000,04,008,0281,846,883,18,901,1364,123456,2,1,2,0,1,0,71.76 ,66.06,50.00 
01,000,04,008,0282,847,725,9,734,1094,123456,2,1,2,0,1,0,71.76 ,67.09,50.00 
01,000,04,008,0282,848,962,31,993,1484,123456,2,1,2,0,1,0,71.76 ,66.91,50.00 
01,000,04,008,0283,849,1009,16,1025,1537,123456,2,1,2,0,1,0,71.76 ,66.69,50.00 
01,000,04,008,0283,850,1095,18,1113,1721,123456,2,1,2,0,1,0,71.76 ,64.67,50.00 
01,000,04,008,0284,851,933,29,962,1381,123456,2,1,2,0,1,0,71.76 ,69.66,50.00 
01,000,04,008,0284,852,845,15,860,1928,123456,2,1,2,0,1,0,71.76 ,44.61,50.00 
01,000,04,008,0285,853,858,17,875,1491,123456,2,1,2,0,1,0,71.76 ,58.69,50.00 
01,000,04,008,0285,854,1047,23,1070,1594,123456,2,1,2,0,1,0,71.76 ,67.13,50.00 
01,000,04,008,0285,855,816,15,831,1237,123456,2,1,2,0,1,0,71.76 ,67.18,50.00 
01,000,04,008,0286,856,879,15,894,1352,123456,2,1,2,0,1,0,71.76 ,66.12,50.00 
01,000,04,008,0286,857,836,18,854,1284,123456,2,1,2,0,1,0,71.76 ,66.51,50.00 
01,000,04,008,0286,858,782,19,801,1273,123456,2,1,2,0,1,0,71.76 ,62.92,50.00 
01,000,04,008,0286,859,850,16,866,1233,123456,2,1,2,0,1,0,71.76 ,70.24,50.00 
01,000,04,008,0287,860,984,22,1006,1554,123456,2,1,2,0,1,0,71.76 ,64.74,50.00 
01,000,04,008,0287,861,1020,12,1032,1554,123456,2,1,2,0,1,0,71.76 ,66.41,50.00 
01,000,04,008,0287,862,1008,16,1024,1523,123456,2,1,2,0,1,0,71.76 ,67.24,50.00 
01,000,04,008,0287,863,1066,18,1084,1631,123456,2,1,2,0,1,0,71.76 ,66.46,50.00 
01,000,04,008,0288,864,1013,21,1034,1649,123456,2,1,2,0,1,0,71.76 ,62.7,50.00 
01,000,04,008,0288,865,996,9,1005,1500,123456,2,1,2,0,1,0,71.76 ,67,50.00 
01,000,04,008,0288,866,1032,24,1056,1581,123456,2,1,2,0,1,0,71.76 ,66.79,50.00 
01,000,04,008,0289,867,1064,20,1084,1600,123456,2,1,2,0,1,0,71.76 ,67.75,50.00 
01,000,04,008,0289,868,983,18,1001,1468,123456,2,1,2,0,1,0,71.76 ,68.19,50.00 
01,000,04,008,0289,869,1049,24,1073,1567,123456,2,1,2,0,1,0,71.76 ,68.47,50.00 
01,000,04,008,0290,870,822,21,843,1207,123456,2,1,2,0,1,0,71.76 ,69.84,50.00 
01,000,04,008,0290,871,796,13,809,1192,123456,2,1,2,0,1,0,71.76 ,67.87,50.00 
01,000,04,008,0290,872,710,13,723,1084,123456,2,1,2,0,1,0,71.76 ,66.7,50.00 
01,000,05,009,0291,873,797,23,820,1315,123456,2,1,2,0,1,0,71.76 ,62.36,50.00 
01,000,05,009,0291,874,714,17,731,1194,123456,2,1,2,0,1,0,71.76 ,61.22,50.00 
01,000,05,009,0292,875,781,12,793,1310,123456,2,1,2,0,1,0,71.76 ,60.53,50.00 
01,000,05,009,0292,876,760,19,779,1202,123456,2,1,2,0,1,0,71.76 ,64.81,50.00 
01,000,05,009,0293,877,752,16,768,1128,123456,2,1,2,0,1,0,71.76 ,68.09,50.00 
01,000,05,009,0293,878,666,19,685,1094,123456,2,1,2,0,1,0,71.76 ,62.61,50.00 
01,000,05,009,0294,879,802,18,820,1249,123456,2,1,2,0,1,0,71.76 ,65.65,50.00 
01,000,05,009,0294,880,819,11,830,1309,123456,2,1,2,0,1,0,71.76 ,63.41,50.00 
01,000,05,009,0294,881,792,22,814,1313,123456,2,1,2,0,1,0,71.76 ,62,50.00 
01,000,05,009,0295,882,799,14,813,1240,123456,2,1,2,0,1,0,71.76 ,65.56,50.00 
01,000,05,009,0295,883,787,15,802,1309,123456,2,1,2,0,1,0,71.76 ,61.27,50.00 
01,000,05,009,0295,884,787,15,802,1287,123456,2,1,2,0,1,0,71.76 ,62.32,50.00 
01,000,05,009,0296,885,952,14,966,1541,123456,2,1,2,0,1,0,71.76 ,62.69,50.00 
01,000,05,009,0296,886,1065,21,1086,1613,123456,2,1,2,0,1,0,71.76 ,67.33,50.00 
01,000,05,009,0296,887,1032,20,1052,1556,123456,2,1,2,0,1,0,71.76 ,67.61,50.00 
01,000,05,009,0297,888,978,20,998,1551,123456,2,1,2,0,1,0,71.76 ,64.35,50.00 
01,000,05,009,0297,889,898,21,919,1380,123456,2,1,2,0,1,0,71.76 ,66.59,50.00 
01,000,05,009,0297,890,939,32,971,1502,123456,2,1,2,0,1,0,71.76 ,64.65,50.00 
01,000,05,009,0298,891,965,21,986,1511,123456,2,1,2,0,1,0,71.76 ,65.25,50.00 
01,000,05,009,0298,892,831,18,849,1301,123456,2,1,2,0,1,0,71.76 ,65.26,50.00 
01,000,05,009,0299,893,1084,16,1100,1568,123456,2,1,2,0,1,0,71.76 ,70.15,50.00 
01,000,05,009,0299,894,911,14,925,1397,123456,2,1,2,0,1,0,71.76 ,66.21,50.00 
01,000,05,009,0299,895,1013,13,1026,1534,123456,2,1,2,0,1,0,71.76 ,66.88,50.00 
01,000,05,009,0300,896,738,8,746,1147,123456,2,1,2,0,1,0,71.76 ,65.04,50.00 
01,000,05,009,0300,897,878,21,899,1307,123456,2,1,2,0,1,0,71.76 ,68.78,50.00 
01,000,05,009,0300,898,753,11,764,1193,123456,2,1,2,0,1,0,71.76 ,64.04,50.00 
01,000,05,009,0301,899,1159,16,1175,1759,123456,2,1,2,0,1,0,71.76 ,66.8,50.00 
01,000,05,009,0301,900,1013,16,1029,1588,123456,2,1,2,0,1,0,71.76 ,64.8,50.00 
01,000,05,009,0301,901,1024,7,1031,1639,123456,2,1,2,0,1,0,71.76 ,62.9,50.00 
01,000,05,009,0302,902,979,14,993,1495,123456,2,1,2,0,1,0,71.76 ,66.42,50.00 
01,000,05,009,0302,903,985,12,997,1517,123456,2,1,2,0,1,0,71.76 ,65.72,50.00 
01,000,05,009,0302,904,879,9,888,1384,123456,2,1,2,0,1,0,71.76 ,64.16,50.00 
01,000,05,009,0303,905,1051,15,1066,1612,123456,2,1,2,0,1,0,71.76 ,66.13,50.00 
01,000,05,009,0303,906,947,22,969,1449,123456,2,1,2,0,1,0,71.76 ,66.87,50.00 
01,000,05,009,0304,907,903,10,913,1473,123456,2,1,2,0,1,0,71.76 ,61.98,50.00 
01,000,05,009,0304,908,911,14,925,1453,123456,2,1,2,0,1,0,71.76 ,63.66,50.00 
01,000,05,009,0304,909,846,14,860,1334,123456,2,1,2,0,1,0,71.76 ,64.47,50.00 
01,000,05,009,0304,910,893,11,904,1341,123456,2,1,2,0,1,0,71.76 ,67.41,50.00 
01,000,05,009,0305,911,960,18,978,1468,123456,2,1,2,0,1,0,71.76 ,66.62,50.00 
01,000,05,009,0305,912,940,16,956,1559,123456,2,1,2,0,1,0,71.76 ,61.32,50.00 
01,000,05,009,0306,913,783,9,792,1238,123456,2,1,2,0,1,0,71.76 ,63.97,50.00 
01,000,05,009,0306,914,823,9,832,1256,123456,2,1,2,0,1,0,71.76 ,66.24,50.00 
01,000,05,009,0307,915,747,13,760,1158,123456,2,1,2,0,1,0,71.76 ,65.63,50.00 
01,000,05,009,0307,916,644,4,648,1070,123456,2,1,2,0,1,0,71.76 ,60.56,50.00 
01,000,05,009,0308,917,858,15,873,1388,123456,2,1,2,0,1,0,71.76 ,62.9,50.00 
01,000,05,009,0308,918,845,17,862,1341,123456,2,1,2,0,1,0,71.76 ,64.28,50.00 
01,000,05,009,0309,919,1094,20,1114,1710,123456,2,1,2,0,1,0,71.76 ,65.15,50.00 
01,000,05,009,0309,920,1136,16,1152,1715,123456,2,1,2,0,1,0,71.76 ,67.17,50.00 
01,000,05,009,0309,921,946,27,973,1556,123456,2,1,2,0,1,0,71.76 ,62.53,50.00 
01,000,05,009,0309,922,1086,21,1107,1633,123456,2,1,2,0,1,0,71.76 ,67.79,50.00 
01,000,05,009,0310,923,1007,16,1023,2291,123456,2,1,2,0,1,0,71.76 ,44.65,50.00 
01,000,05,009,0310,924,981,14,995,1576,123456,2,1,2,0,1,0,71.76 ,63.13,50.00 
01,000,05,009,0310,925,1024,18,1042,1617,123456,2,1,2,0,1,0,71.76 ,64.44,50.00 
01,000,05,009,0311,926,987,23,1010,1596,123456,2,1,2,0,1,0,71.76 ,63.28,50.00 
01,000,05,009,0311,927,993,17,1010,1610,123456,2,1,2,0,1,0,71.76 ,62.73,50.00 
01,000,05,009,0311,928,988,34,1022,1595,123456,2,1,2,0,1,0,71.76 ,64.08,50.00 
01,000,05,009,0311,929,1048,19,1067,1604,123456,2,1,2,0,1,0,71.76 ,66.52,50.00 
01,000,05,009,0312,930,622,5,627,1064,123456,2,1,2,0,1,0,71.76 ,58.93,50.00 
01,000,05,009,0313,931,768,21,789,1338,123456,2,1,2,0,1,0,71.76 ,58.97,50.00 
01,000,05,009,0313,932,968,26,994,1683,123456,2,1,2,0,1,0,71.76 ,59.06,50.00 
01,000,05,009,0314,933,643,20,663,1245,123456,2,1,2,0,1,0,71.76 ,53.25,50.00 
01,000,05,009,0314,934,699,12,711,1213,123456,2,1,2,0,1,0,71.76 ,58.62,50.00 
01,000,05,009,0315,935,939,21,960,1505,123456,2,1,2,0,1,0,71.76 ,63.79,50.00 
01,000,05,009,0315,936,786,21,807,1295,123456,2,1,2,0,1,0,71.76 ,62.32,50.00 
01,000,05,009,0316,937,780,21,801,1298,123456,2,1,2,0,1,0,71.76 ,61.71,50.00 
01,000,05,009,0316,938,758,11,769,1210,123456,2,1,2,0,1,0,71.76 ,63.55,50.00 
01,000,05,009,0316,939,685,20,705,1177,123456,2,1,2,0,1,0,71.76 ,59.9,50.00 
01,000,05,009,0317,940,715,18,733,1183,123456,2,1,2,0,1,0,71.76 ,61.96,50.00 
01,000,05,009,0317,941,689,23,712,1157,123456,2,1,2,0,1,0,71.76 ,61.54,50.00 
01,000,05,009,0317,942,707,18,725,1141,123456,2,1,2,0,1,0,71.76 ,63.54,50.00 
01,000,05,009,0318,943,745,16,761,1183,123456,2,1,2,0,1,0,71.76 ,64.33,50.00 
01,000,05,009,0318,944,697,12,709,1174,123456,2,1,2,0,1,0,71.76 ,60.39,50.00 
01,000,05,009,0318,945,685,19,704,1178,123456,2,1,2,0,1,0,71.76 ,59.76,50.00 
01,000,05,009,0319,946,774,22,796,1237,123456,2,1,2,0,1,0,71.76 ,64.35,50.00 
01,000,05,009,0319,947,896,18,914,1436,123456,2,1,2,0,1,0,71.76 ,63.65,50.00 
01,000,05,009,0319,948,848,24,872,1404,123456,2,1,2,0,1,0,71.76 ,62.11,50.00 
01,000,05,009,0320,949,921,19,940,1476,123456,2,1,2,0,1,0,71.76 ,63.69,50.00 
01,000,05,009,0320,950,811,20,831,1310,123456,2,1,2,0,1,0,71.76 ,63.44,50.00 
01,000,05,009,0320,951,949,19,968,1464,123456,2,1,2,0,1,0,71.76 ,66.12,50.00 
01,000,05,009,0320,952,909,16,925,1421,123456,2,1,2,0,1,0,71.76 ,65.1,50.00 
01,000,05,009,0321,953,1072,36,1108,1699,123456,2,1,2,0,1,0,71.76 ,65.21,50.00 
01,000,05,009,0321,954,1023,26,1049,1712,123456,2,1,2,0,1,0,71.76 ,61.27,50.00 
01,000,05,009,0321,955,835,24,859,1391,123456,2,1,2,0,1,0,71.76 ,61.75,50.00 
01,000,05,009,0321,956,901,18,919,1486,123456,2,1,2,0,1,0,71.76 ,61.84,50.00 
01,000,05,010,0322,957,968,14,982,1553,123456,2,1,2,0,1,0,71.76 ,63.23,50.00 
01,000,05,010,0322,958,780,13,793,1331,123456,2,1,2,0,1,0,71.76 ,59.58,50.00 
01,000,05,010,0322,959,846,20,866,1456,123456,2,1,2,0,1,0,71.76 ,59.48,50.00 
01,000,05,010,0323,960,775,19,794,1429,123456,2,1,2,0,1,0,71.76 ,55.56,50.00 
01,000,05,010,0323,961,828,17,845,1496,123456,2,1,2,0,1,0,71.76 ,56.48,50.00 
01,000,05,010,0324,962,877,14,891,1605,123456,2,1,2,0,1,0,71.76 ,55.51,50.00 
01,000,05,010,0324,963,870,17,887,1531,123456,2,1,2,0,1,0,71.76 ,57.94,50.00 
01,000,05,010,0325,964,849,22,871,1383,123456,2,1,2,0,1,0,71.76 ,62.98,50.00 
01,000,05,010,0325,965,834,20,854,1375,123456,2,1,2,0,1,0,71.76 ,62.11,50.00 
01,000,05,010,0325,966,790,17,807,1362,123456,2,1,2,0,1,0,71.76 ,59.25,50.00 
01,000,05,010,0325,967,843,17,860,1349,123456,2,1,2,0,1,0,71.76 ,63.75,50.00 
01,000,05,010,0326,968,934,26,960,1587,123456,2,1,2,0,1,0,71.76 ,60.49,50.00 
01,000,05,010,0326,969,998,19,1017,1527,123456,2,1,2,0,1,0,71.76 ,66.6,50.00 
01,000,05,010,0326,970,1107,17,1124,1778,123456,2,1,2,0,1,0,71.76 ,63.22,50.00 
01,000,05,010,0327,971,925,28,953,1529,123456,2,1,2,0,1,0,71.76 ,62.33,50.00 
01,000,05,010,0327,972,1010,11,1021,1628,123456,2,1,2,0,1,0,71.76 ,62.71,50.00 
01,000,05,010,0327,973,893,12,905,1443,123456,2,1,2,0,1,0,71.76 ,62.72,50.00 
01,000,05,010,0328,974,1134,25,1159,1769,123456,2,1,2,0,1,0,71.76 ,65.52,50.00 
01,000,05,010,0328,975,766,15,781,1245,123456,2,1,2,0,1,0,71.76 ,62.73,50.00 
01,000,05,010,0328,976,932,9,941,1356,123456,2,1,2,0,1,0,71.76 ,69.4,50.00 
01,000,05,010,0329,977,1029,16,1045,1570,123456,2,1,2,0,1,0,71.76 ,66.56,50.00 
01,000,05,010,0329,978,983,9,992,1455,123456,2,1,2,0,1,0,71.76 ,68.18,50.00 
01,000,05,010,0330,979,1205,35,1240,1844,123456,2,1,2,0,1,0,71.76 ,67.25,50.00 
01,000,05,010,0330,980,1169,12,1181,1749,123456,2,1,2,0,1,0,71.76 ,67.52,50.00 
01,000,05,010,0331,981,821,11,832,1547,123456,2,1,2,0,1,0,71.76 ,53.78,50.00 
01,000,05,010,0331,982,801,8,809,1190,123456,2,1,2,0,1,0,71.76 ,67.98,50.00 
01,000,05,010,0331,983,948,12,960,1389,123456,2,1,2,0,1,0,71.76 ,69.11,50.00 
01,000,05,010,0332,984,1076,17,1093,1764,123456,2,1,2,0,1,0,71.76 ,61.96,50.00 
01,000,05,010,0332,985,818,7,825,1220,123456,2,1,2,0,1,0,71.76 ,67.62,50.00 
01,000,05,010,0332,986,965,15,980,1524,123456,2,1,2,0,1,0,71.76 ,64.3,50.00 
01,000,05,010,0333,987,881,17,898,1314,123456,2,1,2,0,1,0,71.76 ,68.34,50.00 
01,000,05,010,0333,988,911,13,924,1397,123456,2,1,2,0,1,0,71.76 ,66.14,50.00 
01,000,05,010,0333,989,851,16,867,1286,123456,2,1,2,0,1,0,71.76 ,67.42,50.00 
01,000,05,010,0333,990,947,10,957,1478,123456,2,1,2,0,1,0,71.76 ,64.75,50.00 
01,000,05,010,0333,991,903,24,927,1536,123456,2,1,2,0,1,0,71.76 ,60.35,50.00 
01,000,05,010,0334,992,918,12,930,1427,123456,2,1,2,0,1,0,71.76 ,65.17,50.00 
01,000,05,010,0334,993,918,37,955,1520,123456,2,1,2,0,1,0,71.76 ,62.83,50.00 
01,000,05,010,0334,994,1111,17,1128,1713,123456,2,1,2,0,1,0,71.76 ,65.85,50.00 
01,000,05,010,0335,995,873,7,880,1331,123456,2,1,2,0,1,0,71.76 ,66.12,50.00 
01,000,05,010,0335,996,679,8,687,1190,123456,2,1,2,0,1,0,71.76 ,57.73,50.00 
01,000,05,010,0335,997,704,16,720,1196,123456,2,1,2,0,1,0,71.76 ,60.2,50.00 
01,000,05,010,0336,998,941,10,951,1295,123456,2,1,2,0,1,0,71.76 ,73.44,50.00 
01,000,05,010,0336,999,833,6,839,1248,123456,2,1,2,0,1,0,71.76 ,67.23,50.00 
01,000,05,010,0336,1000,678,6,684,1582,123456,2,1,2,0,1,0,71.76 ,43.24,50.00 
01,000,05,010,0336,1001,1033,15,1048,1515,123456,2,1,2,0,1,0,71.76 ,69.17,50.00 
01,000,05,010,0336,1002,906,12,918,1420,123456,2,1,2,0,1,0,71.76 ,64.65,50.00 
01,000,05,010,0337,1003,822,9,831,1255,123456,2,1,2,0,1,0,71.76 ,66.22,50.00 
01,000,05,010,0337,1004,839,14,853,1287,123456,2,1,2,0,1,0,71.76 ,66.28,50.00 
01,000,05,010,0337,1005,840,16,856,1328,123456,2,1,2,0,1,0,71.76 ,64.46,50.00 
01,000,05,010,0338,1006,939,21,960,1428,123456,2,1,2,0,1,0,71.76 ,67.23,50.00 
01,000,05,010,0338,1007,1063,17,1080,1566,123456,2,1,2,0,1,0,71.76 ,68.97,50.00 
01,000,05,010,0338,1008,945,11,956,1441,123456,2,1,2,0,1,0,71.76 ,66.34,50.00 
01,000,05,010,0338,1009,996,14,1010,1534,123456,2,1,2,0,1,0,71.76 ,65.84,50.00 
01,000,05,010,0339,1010,1048,21,1069,1601,123456,2,1,2,0,1,0,71.76 ,66.77,50.00 
01,000,05,010,0339,1011,770,15,785,1387,123456,2,1,2,0,1,0,71.76 ,56.6,50.00 
01,000,05,010,0339,1012,815,20,835,1406,123456,2,1,2,0,1,0,71.76 ,59.39,50.00 
01,000,05,010,0339,1013,934,13,947,1449,123456,2,1,2,0,1,0,71.76 ,65.36,50.00 
01,000,05,010,0340,1014,1128,17,1145,1784,123456,2,1,2,0,1,0,71.76 ,64.18,50.00 
01,000,05,010,0340,1015,1101,9,1110,1761,123456,2,1,2,0,1,0,71.76 ,63.03,50.00 
01,000,05,010,0341,1016,962,11,973,1507,123456,2,1,2,0,1,0,71.76 ,64.57,50.00 
01,000,05,010,0341,1017,1114,24,1138,1662,123456,2,1,2,0,1,0,71.76 ,68.47,50.00 
01,000,05,010,0342,1018,1143,11,1154,1638,123456,2,1,2,0,1,0,71.76 ,70.45,50.00 
01,000,05,010,0342,1019,831,12,843,1362,123456,2,1,2,0,1,0,71.76 ,61.89,50.00 
01,000,05,010,0342,1020,909,16,925,1407,123456,2,1,2,0,1,0,71.76 ,65.74,50.00 
01,000,05,010,0343,1021,897,9,906,1364,123456,2,1,2,0,1,0,71.76 ,66.42,50.00 
01,000,05,010,0343,1022,866,10,876,1265,123456,2,1,2,0,1,0,71.76 ,69.25,50.00 
01,000,05,010,0343,1023,759,7,766,1115,123456,2,1,2,0,1,0,71.76 ,68.7,50.00 
01,000,05,010,0344,1024,977,12,989,1512,123456,2,1,2,0,1,0,71.76 ,65.41,50.00 
01,000,05,010,0344,1025,1029,9,1038,1628,123456,2,1,2,0,1,0,71.76 ,63.76,50.00 
01,000,05,010,0344,1026,877,21,898,1336,123456,2,1,2,0,1,0,71.76 ,67.22,50.00 
01,000,05,010,0345,1027,920,22,942,1368,123456,2,1,2,0,1,0,71.76 ,68.86,50.00 
01,000,05,010,0345,1028,939,14,953,1405,123456,2,1,2,0,1,0,71.76 ,67.83,50.00 
01,000,05,010,0345,1029,707,6,713,1120,123456,2,1,2,0,1,0,71.76 ,63.66,50.00 
01,000,05,010,0346,1030,944,14,958,1436,123456,2,1,2,0,1,0,71.76 ,66.71,50.00 
01,000,05,010,0346,1031,854,12,866,1245,123456,2,1,2,0,1,0,71.76 ,69.56,50.00 
01,000,05,010,0347,1032,856,18,874,1221,123456,2,1,2,0,1,0,71.76 ,71.58,50.00 
01,000,05,010,0347,1033,827,7,834,1228,123456,2,1,2,0,1,0,71.76 ,67.92,50.00 
01,000,05,010,0348,1034,1095,16,1111,1550,123456,2,1,2,0,1,0,71.76 ,71.68,50.00 
01,000,05,010,0348,1035,1206,24,1230,1741,123456,2,1,2,0,1,0,71.76 ,70.65,50.00 
01,000,05,010,0349,1036,1186,13,1199,1834,123456,2,1,2,0,1,0,71.76 ,65.38,50.00 
01,000,05,010,0349,1037,1158,26,1184,1725,123456,2,1,2,0,1,0,71.76 ,68.64,50.00 
01,000,05,010,0349,1038,1042,5,1047,1567,123456,2,1,2,0,1,0,71.76 ,66.82,50.00 
01,000,05,010,0350,1039,806,14,820,1240,123456,2,1,2,0,1,0,71.76 ,66.13,50.00 
01,000,05,010,0350,1040,886,8,894,1364,123456,2,1,2,0,1,0,71.76 ,65.54,50.00 
01,000,05,010,0350,1041,787,18,805,1288,123456,2,1,2,0,1,0,71.76 ,62.5,50.00 
01,000,05,010,0351,1042,894,18,912,1425,123456,2,1,2,0,1,0,71.76 ,64,50.00 
01,000,05,010,0351,1043,1038,13,1051,1636,123456,2,1,2,0,1,0,71.76 ,64.24,50.00 
01,000,05,010,0351,1044,691,8,699,965,123456,2,1,2,0,1,0,71.76 ,72.44,50.00 
01,000,05,010,0352,1045,931,11,942,1319,123456,2,1,2,0,1,0,71.76 ,71.42,50.00 
01,000,05,010,0352,1046,1004,18,1022,1503,123456,2,1,2,0,1,0,71.76 ,68,50.00 
01,000,05,010,0352,1047,965,10,975,1460,123456,2,1,2,0,1,0,71.76 ,66.78,50.00 
01,000,05,010,0353,1048,936,14,950,1529,123456,2,1,2,0,1,0,71.76 ,62.13,50.00 
01,000,05,010,0353,1049,1201,16,1217,1746,123456,2,1,2,0,1,0,71.76 ,69.7,50.00 
01,000,05,010,0354,1050,1079,12,1091,1525,123456,2,1,2,0,1,0,71.76 ,71.54,50.00 
01,000,05,010,0354,1051,975,17,992,1437,123456,2,1,2,0,1,0,71.76 ,69.03,50.00 
01,000,05,010,0354,1052,966,13,979,1468,123456,2,1,2,0,1,0,71.76 ,66.69,50.00 
01,000,05,010,0354,1053,883,7,890,1424,123456,2,1,2,0,1,0,71.76 ,62.5,50.00 
01,000,05,010,0354,1054,1055,16,1071,1494,123456,2,1,2,0,1,0,71.76 ,71.69,50.00 
01,000,05,010,0355,1055,922,14,936,1481,123456,2,1,2,0,1,0,71.76 ,63.2,50.00 
01,000,05,010,0355,1056,888,9,897,1413,123456,2,1,2,0,1,0,71.76 ,63.48,50.00 
01,000,05,010,0355,1057,714,13,727,1151,123456,2,1,2,0,1,0,71.76 ,63.16,50.00 
01,000,05,010,0355,1058,922,15,937,1323,123456,2,1,2,0,1,0,71.76 ,70.82,50.00 
01,000,05,010,0356,1059,1124,13,1137,1772,123456,2,1,2,0,1,0,71.76 ,64.16,50.00 
01,000,05,010,0356,1060,1061,17,1078,1626,123456,2,1,2,0,1,0,71.76 ,66.3,50.00 
01,000,05,010,0357,1061,883,10,893,1342,123456,2,1,2,0,1,0,71.76 ,66.54,50.00 
01,000,05,010,0357,1062,842,17,859,1280,123456,2,1,2,0,1,0,71.76 ,67.11,50.00 
01,000,06,011,0358,1063,1079,15,1094,1666,123456,2,1,2,0,1,0,71.76 ,65.67,50.00 
01,000,06,011,0358,1064,912,13,925,1525,123456,2,1,2,0,1,0,71.76 ,60.66,50.00 
01,000,06,011,0358,1065,834,16,850,1548,123456,2,1,2,0,1,0,71.76 ,54.91,50.00 
01,000,06,011,0359,1066,821,18,839,1372,123456,2,1,2,0,1,0,71.76 ,61.15,50.00 
01,000,06,011,0359,1067,682,10,692,1098,123456,2,1,2,0,1,0,71.76 ,63.02,50.00 
01,000,06,011,0359,1068,872,17,889,1424,123456,2,1,2,0,1,0,71.76 ,62.43,50.00 
01,000,06,011,0360,1069,1067,11,1078,1708,123456,2,1,2,0,1,0,71.76 ,63.11,50.00 
01,000,06,011,0360,1070,1077,17,1094,1715,123456,2,1,2,0,1,0,71.76 ,63.79,50.00 
01,000,06,011,0360,1071,1142,8,1150,1736,123456,2,1,2,0,1,0,71.76 ,66.24,50.00 
01,000,06,011,0361,1072,989,12,1001,1637,123456,2,1,2,0,1,0,71.76 ,61.15,50.00 
01,000,06,011,0361,1073,953,14,967,1519,123456,2,1,2,0,1,0,71.76 ,63.66,50.00 
01,000,06,011,0361,1074,893,13,906,1450,123456,2,1,2,0,1,0,71.76 ,62.48,50.00 
01,000,06,011,0361,1075,1063,19,1082,1738,123456,2,1,2,0,1,0,71.76 ,62.26,50.00 
01,000,06,011,0362,1076,904,19,923,1638,123456,2,1,2,0,1,0,71.76 ,56.35,50.00 
01,000,06,011,0362,1077,856,23,879,1579,123456,2,1,2,0,1,0,71.76 ,55.67,50.00 
01,000,06,011,0362,1078,830,9,839,1480,123456,2,1,2,0,1,0,71.76 ,56.69,50.00 
01,000,06,011,0363,1079,901,6,907,1383,123456,2,1,2,0,1,0,71.76 ,65.58,50.00 
01,000,06,011,0363,1080,852,6,858,1352,123456,2,1,2,0,1,0,71.76 ,63.46,50.00 
01,000,06,011,0363,1081,848,10,858,1287,123456,2,1,2,0,1,0,71.76 ,66.67,50.00 
01,000,06,011,0363,1082,891,14,905,1436,123456,2,1,2,0,1,0,71.76 ,63.02,50.00 
01,000,06,011,0364,1083,898,21,919,1469,123456,2,1,2,0,1,0,71.76 ,62.56,50.00 
01,000,06,011,0364,1084,1036,17,1053,1651,123456,2,1,2,0,1,0,71.76 ,63.78,50.00 
01,000,06,011,0364,1085,642,16,658,1097,123456,2,1,2,0,1,0,71.76 ,59.98,50.00 
01,000,06,011,0364,1086,877,9,886,1412,123456,2,1,2,0,1,0,71.76 ,62.75,50.00 
01,000,06,011,0365,1087,801,19,820,1276,123456,2,1,2,0,1,0,71.76 ,64.26,50.00 
01,000,06,011,0365,1088,897,15,912,1434,123456,2,1,2,0,1,0,71.76 ,63.6,50.00 
01,000,06,011,0366,1089,837,22,859,1300,123456,2,1,2,0,1,0,71.76 ,66.08,50.00 
01,000,06,011,0366,1090,727,23,750,1178,123456,2,1,2,0,1,0,71.76 ,63.67,50.00 
01,000,06,011,0366,1091,715,13,728,1201,123456,2,1,2,0,1,0,71.76 ,60.62,50.00 
01,000,06,011,0367,1092,980,15,995,1711,123456,2,1,2,0,1,0,71.76 ,58.15,50.00 
01,000,06,011,0367,1093,1025,24,1049,1727,123456,2,1,2,0,1,0,71.76 ,60.74,50.00 
01,000,06,011,0367,1094,909,13,922,1548,123456,2,1,2,0,1,0,71.76 ,59.56,50.00 
01,000,06,011,0367,1095,954,14,968,1592,123456,2,1,2,0,1,0,71.76 ,60.8,50.00 
01,000,06,011,0368,1096,908,11,919,1506,123456,2,1,2,0,1,0,71.76 ,61.02,50.00 
01,000,06,011,0368,1097,958,10,968,1525,123456,2,1,2,0,1,0,71.76 ,63.48,50.00 
01,000,06,011,0368,1098,1073,16,1089,1690,123456,2,1,2,0,1,0,71.76 ,64.44,50.00 
01,000,06,011,0369,1099,700,8,708,1130,123456,2,1,2,0,1,0,71.76 ,62.65,50.00 
01,000,06,011,0369,1100,781,5,786,1282,123456,2,1,2,0,1,0,71.76 ,61.31,50.00 
01,000,06,011,0369,1101,769,4,773,1218,123456,2,1,2,0,1,0,71.76 ,63.46,50.00 
01,000,06,011,0370,1102,1037,19,1056,1688,123456,2,1,2,0,1,0,71.76 ,62.56,50.00 
01,000,06,011,0370,1103,1060,11,1071,1711,123456,2,1,2,0,1,0,71.76 ,62.59,50.00 
01,000,06,011,0371,1104,780,8,788,1278,123456,2,1,2,0,1,0,71.76 ,61.66,50.00 
01,000,06,011,0371,1105,708,13,721,1154,123456,2,1,2,0,1,0,71.76 ,62.48,50.00 
01,000,06,011,0371,1106,761,10,771,1237,123456,2,1,2,0,1,0,71.76 ,62.33,50.00 
01,000,06,011,0371,1107,1031,17,1048,1636,123456,2,1,2,0,1,0,71.76 ,64.06,50.00 
01,000,06,011,0372,1108,245,2,247,1768,123456,2,1,2,0,1,0,71.76 ,13.97,50.00 
01,000,06,011,0372,1109,949,14,963,1465,123456,2,1,2,0,1,0,71.76 ,65.73,50.00 
01,000,06,011,0372,1110,797,4,801,1233,123456,2,1,2,0,1,0,71.76 ,64.96,50.00 
01,000,06,011,0372,1111,843,11,854,1336,123456,2,1,2,0,1,0,71.76 ,63.92,50.00 
01,000,06,011,0373,1112,757,6,763,1247,123456,2,1,2,0,1,0,71.76 ,61.19,50.00 
01,000,06,011,0373,1113,893,16,909,1372,123456,2,1,2,0,1,0,71.76 ,66.25,50.00 
01,000,06,011,0373,1114,954,11,965,1540,123456,2,1,2,0,1,0,71.76 ,62.66,50.00 
01,000,06,011,0374,1115,829,9,838,1325,123456,2,1,2,0,1,0,71.76 ,63.25,50.00 
01,000,06,011,0374,1116,957,9,966,1556,123456,2,1,2,0,1,0,71.76 ,62.08,50.00 
01,000,06,011,0374,1117,1027,23,1050,1614,123456,2,1,2,0,1,0,71.76 ,65.06,50.00 
01,000,06,011,0375,1118,889,6,895,1398,123456,2,1,2,0,1,0,71.76 ,64.02,50.00 
01,000,06,011,0375,1119,788,11,799,1253,123456,2,1,2,0,1,0,71.76 ,63.77,50.00 
01,000,06,011,0376,1120,975,11,986,1467,123456,2,1,2,0,1,0,71.76 ,67.21,50.00 
01,000,06,011,0376,1121,943,11,954,1448,123456,2,1,2,0,1,0,71.76 ,65.88,50.00 
01,000,06,011,0377,1122,823,16,839,1270,123456,2,1,2,0,1,0,71.76 ,66.06,50.00 
01,000,06,011,0377,1123,890,11,901,1364,123456,2,1,2,0,1,0,71.76 ,66.06,50.00 
01,000,06,011,0377,1124,844,15,859,1327,123456,2,1,2,0,1,0,71.76 ,64.73,50.00 
01,000,06,011,0378,1125,912,2,914,1361,123456,2,1,2,0,1,0,71.76 ,67.16,50.00 
01,000,06,011,0378,1126,916,10,926,1397,123456,2,1,2,0,1,0,71.76 ,66.28,50.00 
01,000,06,011,0378,1127,825,11,836,1292,123456,2,1,2,0,1,0,71.76 ,64.71,50.00 
01,000,06,011,0379,1128,762,9,771,1265,123456,2,1,2,0,1,0,71.76 ,60.95,50.00 
01,000,06,011,0379,1129,816,12,828,1310,123456,2,1,2,0,1,0,71.76 ,63.21,50.00 
01,000,06,011,0379,1130,789,10,799,1291,123456,2,1,2,0,1,0,71.76 ,61.89,50.00 
01,000,06,011,0379,1131,909,11,920,1475,123456,2,1,2,0,1,0,71.76 ,62.37,50.00 
01,000,06,011,0380,1132,1069,16,1085,1731,123456,2,1,2,0,1,0,71.76 ,62.68,50.00 
01,000,06,011,0380,1133,1221,14,1235,1778,123456,2,1,2,0,1,0,71.76 ,69.46,50.00 
01,000,06,011,0380,1134,1096,10,1106,1741,123456,2,1,2,0,1,0,71.76 ,63.53,50.00 
01,000,06,011,0381,1135,885,11,896,1429,123456,2,1,2,0,1,0,71.76 ,62.7,50.00 
01,000,06,011,0381,1136,942,12,954,1517,123456,2,1,2,0,1,0,71.76 ,62.89,50.00 
01,000,06,011,0382,1137,789,20,809,1265,123456,2,1,2,0,1,0,71.76 ,63.95,50.00 
01,000,06,011,0382,1138,916,17,933,1405,123456,2,1,2,0,1,0,71.76 ,66.41,50.00 
01,000,06,011,0382,1139,810,23,833,1358,123456,2,1,2,0,1,0,71.76 ,61.34,50.00 
01,000,06,011,0383,1140,1129,11,1140,1615,123456,2,1,2,0,1,0,71.76 ,70.59,50.00 
01,000,06,011,0383,1141,1088,14,1102,1709,123456,2,1,2,0,1,0,71.76 ,64.48,50.00 
01,000,06,011,0383,1142,1080,14,1094,1686,123456,2,1,2,0,1,0,71.76 ,64.89,50.00 
01,000,06,011,0384,1143,936,13,949,1512,123456,2,1,2,0,1,0,71.76 ,62.76,50.00 
01,000,06,011,0384,1144,770,16,786,1268,123456,2,1,2,0,1,0,71.76 ,61.99,50.00 
01,000,06,011,0384,1145,924,6,930,1541,123456,2,1,2,0,1,0,71.76 ,60.35,50.00 
01,000,06,011,0385,1146,964,14,978,1587,123456,2,1,2,0,1,0,71.76 ,61.63,50.00 
01,000,06,011,0385,1147,979,12,991,1560,123456,2,1,2,0,1,0,71.76 ,63.53,50.00 
01,000,06,011,0385,1148,864,9,873,1414,123456,2,1,2,0,1,0,71.76 ,61.74,50.00 
01,000,06,011,0386,1149,987,18,1005,1602,123456,2,1,2,0,1,0,71.76 ,62.73,50.00 
01,000,06,011,0386,1150,1179,21,1200,1762,123456,2,1,2,0,1,0,71.76 ,68.1,50.00 
01,000,06,011,0386,1151,1053,14,1067,1655,123456,2,1,2,0,1,0,71.76 ,64.47,50.00 
01,000,06,011,0387,1152,1047,20,1067,1680,123456,2,1,2,0,1,0,71.76 ,63.51,50.00 
01,000,06,011,0387,1153,928,15,943,1531,123456,2,1,2,0,1,0,71.76 ,61.59,50.00 
01,000,06,011,0387,1154,963,12,975,1510,123456,2,1,2,0,1,0,71.76 ,64.57,50.00 
01,000,06,011,0388,1155,1110,22,1132,1655,123456,2,1,2,0,1,0,71.76 ,68.4,50.00 
01,000,06,011,0388,1156,1160,17,1177,1781,123456,2,1,2,0,1,0,71.76 ,66.09,50.00 
01,000,06,011,0389,1157,823,15,838,1272,123456,2,1,2,0,1,0,71.76 ,65.88,50.00 
01,000,06,011,0389,1158,740,22,762,1149,123456,2,1,2,0,1,0,71.76 ,66.32,50.00 
01,000,06,011,0389,1159,768,16,784,1225,123456,2,1,2,0,1,0,71.76 ,64,50.00 
01,000,06,011,0390,1160,792,16,808,1281,123456,2,1,2,0,1,0,71.76 ,63.08,50.00 
01,000,06,011,0390,1161,746,9,755,1208,123456,2,1,2,0,1,0,71.76 ,62.5,50.00 
01,000,06,011,0390,1162,710,15,725,1150,123456,2,1,2,0,1,0,71.76 ,63.04,50.00 
01,000,06,011,0391,1163,1109,14,1123,1774,123456,2,1,2,0,1,0,71.76 ,63.3,50.00 
01,000,06,011,0391,1164,957,15,972,1521,123456,2,1,2,0,1,0,71.76 ,63.91,50.00 
01,000,06,011,0391,1165,1060,13,1073,1769,123456,2,1,2,0,1,0,71.76 ,60.66,50.00 
01,000,06,011,0392,1166,1018,17,1035,1560,123456,2,1,2,0,1,0,71.76 ,66.35,50.00 
01,000,06,011,0392,1167,954,14,968,1395,123456,2,1,2,0,1,0,71.76 ,69.39,50.00 
01,000,06,011,0392,1168,911,8,919,1361,123456,2,1,2,0,1,0,71.76 ,67.52,50.00 
01,000,06,011,0392,1169,1073,12,1085,1615,123456,2,1,2,0,1,0,71.76 ,67.18,50.00 
01,000,06,011,0393,1170,869,11,880,1336,123456,2,1,2,0,1,0,71.76 ,65.87,50.00 
01,000,06,011,0393,1171,952,18,970,1581,123456,2,1,2,0,1,0,71.76 ,61.35,50.00 
01,000,06,011,0394,1172,1118,21,1139,1780,123456,2,1,2,0,1,0,71.76 ,63.99,50.00 
01,000,06,011,0395,1173,906,17,923,1427,123456,2,1,2,0,1,0,71.76 ,64.68,50.00 
01,000,06,011,0395,1174,1010,12,1022,1548,123456,2,1,2,0,1,0,71.76 ,66.02,50.00 
01,000,06,011,0395,1175,900,6,906,1376,123456,2,1,2,0,1,0,71.76 ,65.84,50.00 
01,000,06,011,0395,1176,843,10,853,1280,123456,2,1,2,0,1,0,71.76 ,66.64,50.00 
01,000,06,011,0395,1177,912,14,926,1401,123456,2,1,2,0,1,0,71.76 ,66.1,50.00 
01,000,06,011,0396,1178,1026,11,1037,1664,123456,2,1,2,0,1,0,71.76 ,62.32,50.00 
01,000,06,011,0396,1179,1044,11,1055,1661,123456,2,1,2,0,1,0,71.76 ,63.52,50.00 
01,000,06,011,0397,1180,986,17,1003,1608,123456,2,1,2,0,1,0,71.76 ,62.38,50.00 
01,000,06,011,0397,1181,1051,11,1062,1660,123456,2,1,2,0,1,0,71.76 ,63.98,50.00 
01,000,06,011,0397,1182,974,10,984,1642,123456,2,1,2,0,1,0,71.76 ,59.93,50.00 
01,000,06,011,0397,1183,1020,16,1036,1627,123456,2,1,2,0,1,0,71.76 ,63.68,50.00 
01,000,06,011,0398,1184,1196,9,1205,1775,123456,2,1,2,0,1,0,71.76 ,67.89,50.00 
01,000,06,011,0398,1185,1032,21,1053,1610,123456,2,1,2,0,1,0,71.76 ,65.4,50.00 
01,000,06,011,0398,1186,1079,21,1100,1746,123456,2,1,2,0,1,0,71.76 ,63,50.00 
01,000,06,011,0399,1187,981,17,998,1559,123456,2,1,2,0,1,0,71.76 ,64.02,50.00 
01,000,06,011,0399,1188,1033,5,1038,1563,123456,2,1,2,0,1,0,71.76 ,66.41,50.00 
01,000,06,011,0399,1189,908,22,930,1423,123456,2,1,2,0,1,0,71.76 ,65.35,50.00 
01,000,06,011,0400,1190,1004,19,1023,1502,123456,2,1,2,0,1,0,71.76 ,68.11,50.00 
01,000,06,011,0400,1191,958,12,970,1457,123456,2,1,2,0,1,0,71.76 ,66.58,50.00 
01,000,06,011,0400,1192,1092,15,1107,1594,123456,2,1,2,0,1,0,71.76 ,69.45,50.00 
01,000,06,011,0400,1193,1136,11,1147,1694,123456,2,1,2,0,1,0,71.76 ,67.71,50.00 
01,000,06,011,0401,1194,719,13,732,1168,123456,2,1,2,0,1,0,71.76 ,62.67,50.00 
01,000,06,011,0401,1195,869,11,880,1305,123456,2,1,2,0,1,0,71.76 ,67.43,50.00 
01,000,06,011,0401,1196,810,6,816,1236,123456,2,1,2,0,1,0,71.76 ,66.02,50.00 
01,000,06,011,0402,1197,930,12,942,1527,123456,2,1,2,0,1,0,71.76 ,61.69,50.00 
01,000,06,011,0402,1198,771,13,784,1429,123456,2,1,2,0,1,0,71.76 ,54.86,50.00 
01,000,06,011,0402,1199,753,12,765,1185,123456,2,1,2,0,1,0,71.76 ,64.56,50.00 
01,000,06,011,0403,1200,961,15,976,1698,123456,2,1,2,0,1,0,71.76 ,57.48,50.00 
01,000,06,011,0403,1201,1040,12,1052,1735,123456,2,1,2,0,1,0,71.76 ,60.63,50.00 
01,000,06,011,0403,1202,896,16,912,1550,123456,2,1,2,0,1,0,71.76 ,58.84,50.00 
01,000,06,011,0404,1203,1006,12,1018,1678,123456,2,1,2,0,1,0,71.76 ,60.67,50.00 
01,000,06,011,0404,1204,958,21,979,1578,123456,2,1,2,0,1,0,71.76 ,62.04,50.00 
01,000,06,011,0404,1205,1018,24,1042,1733,123456,2,1,2,0,1,0,71.76 ,60.13,50.00 
01,000,06,011,0405,1206,702,17,719,1179,123456,2,1,2,0,1,0,71.76 ,60.98,50.00 
01,000,06,011,0405,1207,817,10,827,1308,123456,2,1,2,0,1,0,71.76 ,63.23,50.00 
01,000,06,011,0405,1208,906,23,929,1575,123456,2,1,2,0,1,0,71.76 ,58.98,50.00 
01,000,06,011,0406,1209,1058,17,1075,1655,123456,2,1,2,0,1,0,71.76 ,64.95,50.00 
01,000,06,011,0406,1210,977,20,997,1612,123456,2,1,2,0,1,0,71.76 ,61.85,50.00 
01,000,06,011,0406,1211,965,12,977,1567,123456,2,1,2,0,1,0,71.76 ,62.35,50.00 
01,000,06,011,0407,1212,1185,20,1205,1931,123456,2,1,2,0,1,0,71.76 ,62.4,50.00 
01,000,06,011,0407,1213,1032,20,1052,1637,123456,2,1,2,0,1,0,71.76 ,64.26,50.00 
01,000,06,011,0408,1214,990,15,1005,1763,123456,2,1,2,0,1,0,71.76 ,57.01,50.00 
01,000,06,011,0408,1215,1107,16,1123,1825,123456,2,1,2,0,1,0,71.76 ,61.53,50.00 
01,000,06,011,0408,1216,1065,13,1078,1747,123456,2,1,2,0,1,0,71.76 ,61.71,50.00 
01,000,06,011,0409,1217,1052,16,1068,1609,123456,2,1,2,0,1,0,71.76 ,66.38,50.00 
01,000,06,011,0409,1218,1069,15,1084,1669,123456,2,1,2,0,1,0,71.76 ,64.95,50.00 
01,000,06,011,0409,1219,948,16,964,1526,123456,2,1,2,0,1,0,71.76 ,63.17,50.00 
01,000,06,011,0409,1220,955,14,969,1561,123456,2,1,2,0,1,0,71.76 ,62.08,50.00 
01,000,06,011,0410,1221,698,7,705,1033,123456,2,1,2,0,1,0,71.76 ,68.25,50.00 
01,000,06,011,0410,1222,456,10,466,727,123456,2,1,2,0,1,0,71.76 ,64.1,50.00 
01,000,06,011,0410,1223,758,11,769,1243,123456,2,1,2,0,1,0,71.76 ,61.87,50.00 
01,000,06,012,0411,1224,814,9,823,1362,123456,2,1,2,0,1,0,71.76 ,60.43,50.00 
01,000,06,012,0411,1225,940,12,952,1442,123456,2,1,2,0,1,0,71.76 ,66.02,50.00 
01,000,06,012,0411,1226,1042,16,1058,1647,123456,2,1,2,0,1,0,71.76 ,64.24,50.00 
01,000,06,012,0412,1227,900,16,916,1473,123456,2,1,2,0,1,0,71.76 ,62.19,50.00 
01,000,06,012,0412,1228,829,14,843,1322,123456,2,1,2,0,1,0,71.76 ,63.77,50.00 
01,000,06,012,0412,1229,808,5,813,1235,123456,2,1,2,0,1,0,71.76 ,65.83,50.00 
01,000,06,012,0412,1230,905,12,917,1377,123456,2,1,2,0,1,0,71.76 ,66.59,50.00 
01,000,06,012,0413,1231,902,12,914,1385,123456,2,1,2,0,1,0,71.76 ,65.99,50.00 
01,000,06,012,0413,1232,788,8,796,1225,123456,2,1,2,0,1,0,71.76 ,64.98,50.00 
01,000,06,012,0413,1233,720,10,730,1111,123456,2,1,2,0,1,0,71.76 ,65.71,50.00 
01,000,06,012,0414,1234,1083,15,1098,1704,123456,2,1,2,0,1,0,71.76 ,64.44,50.00 
01,000,06,012,0414,1235,1076,13,1089,1675,123456,2,1,2,0,1,0,71.76 ,65.01,50.00 
01,000,06,012,0414,1236,1166,16,1182,1740,123456,2,1,2,0,1,0,71.76 ,67.93,50.00 
01,000,06,012,0415,1237,964,9,973,1425,123456,2,1,2,0,1,0,71.76 ,68.28,50.00 
01,000,06,012,0415,1238,880,13,893,1299,123456,2,1,2,0,1,0,71.76 ,68.75,50.00 
01,000,06,012,0415,1239,562,5,567,892,123456,2,1,2,0,1,0,71.76 ,63.57,50.00 
01,000,06,012,0416,1240,1036,13,1049,1637,123456,2,1,2,0,1,0,71.76 ,64.08,50.00 
01,000,06,012,0416,1241,989,14,1003,1527,123456,2,1,2,0,1,0,71.76 ,65.68,50.00 
01,000,06,012,0416,1242,1009,9,1018,1505,123456,2,1,2,0,1,0,71.76 ,67.64,50.00 
01,000,06,012,0417,1243,850,6,856,1238,123456,2,1,2,0,1,0,71.76 ,69.14,50.00 
01,000,06,012,0417,1244,776,5,781,1227,123456,2,1,2,0,1,0,71.76 ,63.65,50.00 
01,000,06,012,0417,1245,888,12,900,1322,123456,2,1,2,0,1,0,71.76 ,68.08,50.00 
01,000,06,012,0418,1246,838,13,851,1286,123456,2,1,2,0,1,0,71.76 ,66.17,50.00 
01,000,06,012,0418,1247,738,5,743,1100,123456,2,1,2,0,1,0,71.76 ,67.55,50.00 
01,000,06,012,0418,1248,864,22,886,1287,123456,2,1,2,0,1,0,71.76 ,68.84,50.00 
01,000,06,012,0419,1249,1005,14,1019,1460,123456,2,1,2,0,1,0,71.76 ,69.79,50.00 
01,000,06,012,0419,1250,1053,13,1066,1574,123456,2,1,2,0,1,0,71.76 ,67.73,50.00 
01,000,06,012,0419,1251,984,11,995,1475,123456,2,1,2,0,1,0,71.76 ,67.46,50.00 
01,000,06,012,0419,1252,825,8,833,1289,123456,2,1,2,0,1,0,71.76 ,64.62,50.00 
01,000,06,012,0420,1253,1002,11,1013,1567,123456,2,1,2,0,1,0,71.76 ,64.65,50.00 
01,000,06,012,0420,1254,886,12,898,1361,123456,2,1,2,0,1,0,71.76 ,65.98,50.00 
01,000,06,012,0420,1255,889,13,902,1377,123456,2,1,2,0,1,0,71.76 ,65.5,50.00 
01,000,06,012,0421,1256,826,3,829,1259,123456,2,1,2,0,1,0,71.76 ,65.85,50.00 
01,000,06,012,0421,1257,886,6,892,1317,123456,2,1,2,0,1,0,71.76 ,67.73,50.00 
01,000,06,012,0422,1258,771,12,783,1270,123456,2,1,2,0,1,0,71.76 ,61.65,50.00 
01,000,06,012,0422,1259,740,8,748,1175,123456,2,1,2,0,1,0,71.76 ,63.66,50.00 
01,000,06,012,0422,1260,882,9,891,1343,123456,2,1,2,0,1,0,71.76 ,66.34,50.00 
01,000,06,012,0423,1261,925,10,935,1424,123456,2,1,2,0,1,0,71.76 ,65.66,50.00 
01,000,06,012,0423,1262,943,8,951,1425,123456,2,1,2,0,1,0,71.76 ,66.74,50.00 
01,000,06,012,0423,1263,956,6,962,1444,123456,2,1,2,0,1,0,71.76 ,66.62,50.00 
01,000,06,012,0423,1264,992,19,1011,1540,123456,2,1,2,0,1,0,71.76 ,65.65,50.00 
01,000,06,012,0423,1265,882,11,893,1292,123456,2,1,2,0,1,0,71.76 ,69.12,50.00 
01,000,06,012,0424,1266,833,12,845,1316,123456,2,1,2,0,1,0,71.76 ,64.21,50.00 
01,000,06,012,0424,1267,798,5,803,1224,123456,2,1,2,0,1,0,71.76 ,65.6,50.00 
01,000,06,012,0425,1268,937,9,946,1447,123456,2,1,2,0,1,0,71.76 ,65.38,50.00 
01,000,06,012,0425,1269,1194,16,1210,1737,123456,2,1,2,0,1,0,71.76 ,69.66,50.00 
01,000,06,012,0425,1270,1078,8,1086,1601,123456,2,1,2,0,1,0,71.76 ,67.83,50.00 
01,000,06,012,0425,1271,703,10,713,1119,123456,2,1,2,0,1,0,71.76 ,63.72,50.00 
01,000,06,012,0426,1272,971,13,984,1544,123456,2,1,2,0,1,0,71.76 ,63.73,50.00 
01,000,06,012,0426,1273,1090,10,1100,1795,123456,2,1,2,0,1,0,71.76 ,61.28,50.00 
01,000,06,012,0426,1274,990,11,1001,1655,123456,2,1,2,0,1,0,71.76 ,60.48,50.00 
01,000,06,012,0427,1275,894,11,905,1765,123456,2,1,2,0,1,0,71.76 ,51.27,50.00 
01,000,06,012,0427,1276,930,12,942,1475,123456,2,1,2,0,1,0,71.76 ,63.86,50.00 
01,000,06,012,0427,1277,1035,12,1047,1620,123456,2,1,2,0,1,0,71.76 ,64.63,50.00 
01,000,06,012,0428,1278,861,7,868,1298,123456,2,1,2,0,1,0,71.76 ,66.87,50.00 
01,000,06,012,0428,1279,831,11,842,1285,123456,2,1,2,0,1,0,71.76 ,65.53,50.00 
01,000,06,012,0428,1280,872,6,878,1244,123456,2,1,2,0,1,0,71.76 ,70.58,50.00 
01,000,06,012,0428,1281,774,10,784,1245,123456,2,1,2,0,1,0,71.76 ,62.97,50.00 
01,000,06,012,0429,1282,1092,5,1097,1655,123456,2,1,2,0,1,0,71.76 ,66.28,50.00 
01,000,06,012,0429,1283,987,12,999,1507,123456,2,1,2,0,1,0,71.76 ,66.29,50.00 
01,000,06,012,0429,1284,1006,18,1024,1482,123456,2,1,2,0,1,0,71.76 ,69.1,50.00 
01,000,06,012,0430,1285,917,11,928,1450,123456,2,1,2,0,1,0,71.76 ,64,50.00 
01,000,06,012,0430,1286,925,11,936,1375,123456,2,1,2,0,1,0,71.76 ,68.07,50.00 
01,000,06,012,0430,1287,833,17,850,1345,123456,2,1,2,0,1,0,71.76 ,63.2,50.00 
01,000,06,012,0430,1288,952,17,969,1463,123456,2,1,2,0,1,0,71.76 ,66.23,50.00 
01,000,06,012,0431,1289,1030,16,1046,1585,123456,2,1,2,0,1,0,71.76 ,65.99,50.00 
01,000,06,012,0431,1290,918,8,926,1427,123456,2,1,2,0,1,0,71.76 ,64.89,50.00 
01,000,06,012,0432,1291,863,7,870,1339,123456,2,1,2,0,1,0,71.76 ,64.97,50.00 
01,000,06,012,0432,1292,813,9,822,1300,123456,2,1,2,0,1,0,71.76 ,63.23,50.00 
01,000,06,012,0432,1293,888,12,900,1408,123456,2,1,2,0,1,0,71.76 ,63.92,50.00 
01,000,06,012,0432,1294,751,10,761,1241,123456,2,1,2,0,1,0,71.76 ,61.32,50.00 
01,000,06,012,0433,1295,1102,18,1120,1670,123456,2,1,2,0,1,0,71.76 ,67.07,50.00 
01,000,06,012,0433,1296,1169,16,1185,1755,123456,2,1,2,0,1,0,71.76 ,67.52,50.00 
01,000,06,012,0433,1297,1200,16,1216,1789,123456,2,1,2,0,1,0,71.76 ,67.97,50.00 
01,000,06,012,0434,1298,992,10,1002,1558,123456,2,1,2,0,1,0,71.76 ,64.31,50.00 
01,000,06,012,0434,1299,995,15,1010,1564,123456,2,1,2,0,1,0,71.76 ,64.58,50.00 
01,000,06,012,0434,1300,1000,16,1016,1546,123456,2,1,2,0,1,0,71.76 ,65.72,50.00 
01,000,06,012,0434,1301,942,10,952,1436,123456,2,1,2,0,1,0,71.76 ,66.3,50.00 
01,000,06,012,0435,1302,815,8,823,1313,123456,2,1,2,0,1,0,71.76 ,62.68,50.00 
01,000,06,012,0435,1303,674,19,693,1233,123456,2,1,2,0,1,0,71.76 ,56.2,50.00 
01,000,06,012,0435,1304,759,14,773,1333,123456,2,1,2,0,1,0,71.76 ,57.99,50.00 
01,000,06,012,0436,1305,945,11,956,1439,123456,2,1,2,0,1,0,71.76 ,66.44,50.00 
01,000,06,012,0436,1306,781,6,787,1296,123456,2,1,2,0,1,0,71.76 ,60.73,50.00 
01,000,06,012,0436,1307,976,9,985,1490,123456,2,1,2,0,1,0,71.76 ,66.11,50.00 
01,000,06,012,0436,1308,903,12,915,1381,123456,2,1,2,0,1,0,71.76 ,66.26,50.00 
01,000,06,012,0437,1309,985,11,996,1527,123456,2,1,2,0,1,0,71.76 ,65.23,50.00 
01,000,06,012,0437,1310,1009,12,1021,1558,123456,2,1,2,0,1,0,71.76 ,65.53,50.00 
01,000,06,012,0437,1311,1072,8,1080,1469,123456,2,1,2,0,1,0,71.76 ,73.52,50.00 
01,000,06,012,0437,1312,990,10,1000,1485,123456,2,1,2,0,1,0,71.76 ,67.34,50.00 
01,000,06,012,0438,1313,839,15,854,1388,123456,2,1,2,0,1,0,71.76 ,61.53,50.00 
01,000,06,012,0438,1314,908,12,920,1449,123456,2,1,2,0,1,0,71.76 ,63.49,50.00 
01,000,06,012,0438,1315,902,21,923,1428,123456,2,1,2,0,1,0,71.76 ,64.64,50.00 
01,000,06,012,0438,1316,937,16,953,1403,123456,2,1,2,0,1,0,71.76 ,67.93,50.00 
01,000,06,012,0438,1317,943,10,953,1477,123456,2,1,2,0,1,0,71.76 ,64.52,50.00 
01,000,06,012,0439,1318,938,10,948,1403,123456,2,1,2,0,1,0,71.76 ,67.57,50.00 
01,000,06,012,0439,1319,927,20,947,1390,123456,2,1,2,0,1,0,71.76 ,68.13,50.00 
01,000,06,012,0439,1320,957,17,974,1463,123456,2,1,2,0,1,0,71.76 ,66.58,50.00 
01,000,06,012,0439,1321,903,12,915,1370,123456,2,1,2,0,1,0,71.76 ,66.79,50.00 
01,000,06,012,0440,1322,1065,15,1080,1571,123456,2,1,2,0,1,0,71.76 ,68.75,50.00 
01,000,06,012,0440,1323,1007,10,1017,1527,123456,2,1,2,0,1,0,71.76 ,66.6,50.00 
01,000,06,012,0441,1324,1049,7,1056,1600,123456,2,1,2,0,1,0,71.76 ,66,50.00 
01,000,06,012,0441,1325,1148,20,1168,1762,123456,2,1,2,0,1,0,71.76 ,66.29,50.00 
01,000,06,012,0441,1326,1030,12,1042,1617,123456,2,1,2,0,1,0,71.76 ,64.44,50.00 
01,000,06,012,0441,1327,1096,10,1106,1678,123456,2,1,2,0,1,0,71.76 ,65.91,50.00 
01,000,06,012,0442,1328,1041,24,1065,1564,123456,2,1,2,0,1,0,71.76 ,68.09,50.00 
01,000,06,012,0442,1329,1058,8,1066,1657,123456,2,1,2,0,1,0,71.76 ,64.33,50.00 
01,000,06,012,0442,1330,943,13,956,1503,123456,2,1,2,0,1,0,71.76 ,63.61,50.00 
01,000,06,012,0442,1331,1012,23,1035,1594,123456,2,1,2,0,1,0,71.76 ,64.93,50.00 
01,000,06,012,0442,1332,919,12,931,1457,123456,2,1,2,0,1,0,71.76 ,63.9,50.00 
01,000,06,012,0442,1333,899,23,922,1389,123456,2,1,2,0,1,0,71.76 ,66.38,50.00 
01,000,06,012,0443,1334,976,12,988,1531,123456,2,1,2,0,1,0,71.76 ,64.53,50.00 
01,000,06,012,0443,1335,958,32,990,1495,123456,2,1,2,0,1,0,71.76 ,66.22,50.00 
01,000,06,012,0443,1336,989,17,1006,1363,123456,2,1,2,0,1,0,71.76 ,73.81,50.00 
01,000,06,012,0443,1337,933,15,948,1404,123456,2,1,2,0,1,0,71.76 ,67.52,50.00 
01,000,06,012,0443,1338,1000,17,1017,1502,123456,2,1,2,0,1,0,71.76 ,67.71,50.00 
01,000,06,012,0444,1339,833,5,838,1315,123456,2,1,2,0,1,0,71.76 ,63.73,50.00 
01,000,06,012,0444,1340,978,5,983,1499,123456,2,1,2,0,1,0,71.76 ,65.58,50.00 
01,000,06,012,0444,1341,1032,11,1043,1609,123456,2,1,2,0,1,0,71.76 ,64.82,50.00 
01,000,06,012,0444,1342,1060,10,1070,1648,123456,2,1,2,0,1,0,71.76 ,64.93,50.00 
01,000,06,012,0445,1343,879,10,889,1364,123456,2,1,2,0,1,0,71.76 ,65.18,50.00 
01,000,06,012,0445,1344,872,17,889,1472,123456,2,1,2,0,1,0,71.76 ,60.39,50.00 
01,000,06,012,0445,1345,788,6,794,1303,123456,2,1,2,0,1,0,71.76 ,60.94,50.00 
01,000,06,012,0445,1346,843,8,851,1299,123456,2,1,2,0,1,0,71.76 ,65.51,50.00 
01,000,06,012,0446,1347,834,16,850,1278,123456,2,1,2,0,1,0,71.76 ,66.51,50.00 
01,000,06,012,0446,1348,1025,12,1037,1556,123456,2,1,2,0,1,0,71.76 ,66.65,50.00 
01,000,06,012,0446,1349,812,12,824,1253,123456,2,1,2,0,1,0,71.76 ,65.76,50.00 
01,000,06,012,0447,1350,965,8,973,1466,123456,2,1,2,0,1,0,71.76 ,66.37,50.00 
01,000,06,012,0447,1351,991,11,1002,1474,123456,2,1,2,0,1,0,71.76 ,67.98,50.00 
01,000,06,012,0447,1352,1034,10,1044,1642,123456,2,1,2,0,1,0,71.76 ,63.58,50.00 
01,000,06,012,0447,1353,1013,15,1028,1549,123456,2,1,2,0,1,0,71.76 ,66.37,50.00 
01,000,06,012,0447,1354,1090,11,1101,1715,123456,2,1,2,0,1,0,71.76 ,64.2,50.00 
01,000,06,012,0447,1355,1091,11,1102,1700,123456,2,1,2,0,1,0,71.76 ,64.82,50.00 
01,000,06,012,0448,1356,1002,13,1015,1597,123456,2,1,2,0,1,0,71.76 ,63.56,50.00 
01,000,06,012,0448,1357,493,10,503,755,123456,2,1,2,0,1,0,71.76 ,66.62,50.00 
01,000,06,012,0449,1358,450,4,454,705,123456,2,1,2,0,1,0,71.76 ,64.4,50.00 
02,000,01,001,0001,1,936,12,948,1290,123456,2,1,2,0,1,0,71.76 ,73.49,50.00 
02,000,01,001,0002,2,333,9,342,439,123456,2,1,2,0,1,0,71.76 ,77.9,50.00 
02,000,01,001,0003,3,539,13,552,720,123456,2,1,2,0,1,0,71.76 ,76.67,50.00 
02,000,01,001,0004,4,946,15,961,1357,123456,2,1,2,0,1,0,71.76 ,70.82,50.00 
02,000,01,001,0005,5,856,10,866,1170,123456,2,1,2,0,1,0,71.76 ,74.02,50.00 
02,000,01,001,0006,6,692,9,701,972,123456,2,1,2,0,1,0,71.76 ,72.12,50.00 
02,000,01,001,0006,7,908,8,916,1207,123456,2,1,2,0,1,0,71.76 ,75.89,50.00 
02,000,01,001,0007,8,659,14,673,910,123456,2,1,2,0,1,0,71.76 ,73.96,50.00 
02,000,01,001,0008,9,540,5,545,730,123456,2,1,2,0,1,0,71.76 ,74.66,50.00 
02,000,01,001,0009,10,809,11,820,1262,123456,2,1,2,0,1,0,71.76 ,64.98,50.00 
02,000,01,001,0010,11,573,8,581,822,123456,2,1,2,0,1,0,71.76 ,70.68,50.00 
02,000,01,001,0011,12,678,10,688,988,123456,2,1,2,0,1,0,71.76 ,69.64,50.00 
02,000,01,001,0011,13,581,8,589,834,123456,2,1,2,0,1,0,71.76 ,70.62,50.00 
02,000,01,001,0012,14,720,6,726,1042,123456,2,1,2,0,1,0,71.76 ,69.67,50.00 
02,000,01,001,0013,15,813,15,828,1136,123456,2,1,2,0,1,0,71.76 ,72.89,50.00 
02,000,01,001,0014,16,763,8,771,1149,123456,2,1,2,0,1,0,71.76 ,67.1,50.00 
02,000,01,001,0015,17,863,11,874,1189,123456,2,1,2,0,1,0,71.76 ,73.51,50.00 
02,000,01,001,0016,18,444,11,455,563,123456,2,1,2,0,1,0,71.76 ,80.82,50.00 
02,000,01,001,0017,19,1185,24,1209,1799,123456,2,1,2,0,1,0,71.76 ,67.2,50.00 
02,000,01,001,0018,20,889,16,905,1266,123456,2,1,2,0,1,0,71.76 ,71.48,50.00 
02,000,01,001,0019,21,496,9,505,690,123456,2,1,2,0,1,0,71.76 ,73.19,50.00 
02,000,01,001,0020,22,544,6,550,690,123456,2,1,2,0,1,0,71.76 ,79.71,50.00 
02,000,01,001,0021,23,596,12,608,874,123456,2,1,2,0,1,0,71.76 ,69.57,50.00 
02,000,01,002,0022,24,705,7,712,1012,123456,2,1,2,0,1,0,71.76 ,70.36,50.00 
02,000,01,002,0022,25,707,7,714,977,123456,2,1,2,0,1,0,71.76 ,73.08,50.00 
02,000,01,002,0023,26,684,17,701,987,123456,2,1,2,0,1,0,71.76 ,71.02,50.00 
02,000,01,002,0023,27,759,12,771,1101,123456,2,1,2,0,1,0,71.76 ,70.03,50.00 
02,000,01,002,0024,28,1182,12,1194,1625,123456,2,1,2,0,1,0,71.76 ,73.48,50.00 
02,000,01,002,0024,29,1055,18,1073,1418,123456,2,1,2,0,1,0,71.76 ,75.67,50.00 
02,000,01,002,0024,30,871,11,882,1195,123456,2,1,2,0,1,0,71.76 ,73.81,50.00 
02,000,01,002,0025,31,865,10,875,1174,123456,2,1,2,0,1,0,71.76 ,74.53,50.00 
02,000,01,002,0025,32,917,18,935,1320,123456,2,1,2,0,1,0,71.76 ,70.83,50.00 
02,000,01,002,0025,33,970,7,977,1282,123456,2,1,2,0,1,0,71.76 ,76.21,50.00 
02,000,01,002,0026,34,1088,19,1107,1433,123456,2,1,2,0,1,0,71.76 ,77.25,50.00 
02,000,01,002,0027,35,861,8,869,1185,123456,2,1,2,0,1,0,71.76 ,73.33,50.00 
02,000,01,002,0028,36,961,12,973,1284,123456,2,1,2,0,1,0,71.76 ,75.78,50.00 
02,000,01,002,0028,37,669,8,677,900,123456,2,1,2,0,1,0,71.76 ,75.22,50.00 
02,000,01,002,0029,38,965,10,975,1373,123456,2,1,2,0,1,0,71.76 ,71.01,50.00 
02,000,01,002,0029,39,946,15,961,1301,123456,2,1,2,0,1,0,71.76 ,73.87,50.00 
02,000,01,002,0029,40,873,11,884,1204,123456,2,1,2,0,1,0,71.76 ,73.42,50.00 
02,000,01,002,0030,41,593,6,599,802,123456,2,1,2,0,1,0,71.76 ,74.69,50.00 
02,000,01,002,0031,42,966,17,983,1440,123456,2,1,2,0,1,0,71.76 ,68.26,50.00 
02,000,01,002,0032,43,1344,27,1371,1869,123456,2,1,2,0,1,0,71.76 ,73.35,50.00 
02,000,01,002,0033,44,1176,16,1192,1680,123456,2,1,2,0,1,0,71.76 ,70.95,50.00 
02,000,01,002,0033,45,1135,20,1155,1607,123456,2,1,2,0,1,0,71.76 ,71.87,50.00 
02,000,01,002,0034,46,1000,22,1022,1352,123456,2,1,2,0,1,0,71.76 ,75.59,50.00 
02,000,01,002,0034,47,988,6,994,1379,123456,2,1,2,0,1,0,71.76 ,72.08,50.00 
02,000,01,002,0035,48,832,16,848,1235,123456,2,1,2,0,1,0,71.76 ,68.66,50.00 
02,000,01,002,0035,49,1076,16,1092,1486,123456,2,1,2,0,1,0,71.76 ,73.49,50.00 
02,000,01,002,0036,50,1123,33,1156,1716,123456,2,1,2,0,1,0,71.76 ,67.37,50.00 
02,000,01,002,0036,51,1349,35,1384,2175,123456,2,1,2,0,1,0,71.76 ,63.63,50.00 
02,000,01,002,0036,52,1114,26,1140,1603,123456,2,1,2,0,1,0,71.76 ,71.12,50.00 
02,000,01,002,0036,53,1191,22,1213,1784,123456,2,1,2,0,1,0,71.76 ,67.99,50.00 
02,000,01,002,0037,54,1578,44,1622,2603,123456,2,1,2,0,1,0,71.76 ,62.31,50.00 
02,000,01,002,0037,55,1988,48,2036,3150,123456,2,1,2,0,1,0,71.76 ,64.63,50.00 
02,000,01,002,0038,56,1245,21,1266,1786,123456,2,1,2,0,1,0,71.76 ,70.88,50.00 
02,000,01,002,0038,57,1158,20,1178,1723,123456,2,1,2,0,1,0,71.76 ,68.37,50.00 
02,000,01,002,0038,58,1037,21,1058,1709,123456,2,1,2,0,1,0,71.76 ,61.91,50.00 
02,000,01,002,0038,59,1095,28,1123,1689,123456,2,1,2,0,1,0,71.76 ,66.49,50.00 
02,000,01,002,0038,60,1175,19,1194,1732,123456,2,1,2,0,1,0,71.76 ,68.94,50.00 
02,000,01,002,0038,61,1121,28,1149,1784,123456,2,1,2,0,1,0,71.76 ,64.41,50.00 
02,000,01,002,0038,62,1127,30,1157,1747,123456,2,1,2,0,1,0,71.76 ,66.23,50.00 
02,000,01,002,0039,63,1256,27,1283,1801,123456,2,1,2,0,1,0,71.76 ,71.24,50.00 
02,000,01,002,0039,64,1273,30,1303,1825,123456,2,1,2,0,1,0,71.76 ,71.4,50.00 
02,000,01,002,0040,65,939,10,949,1380,123456,2,1,2,0,1,0,71.76 ,68.77,50.00 
02,000,01,002,0040,66,1024,30,1054,1456,123456,2,1,2,0,1,0,71.76 ,72.39,50.00 
02,000,01,002,0041,67,725,12,737,1057,123456,2,1,2,0,1,0,71.76 ,69.73,50.00 
02,000,01,002,0041,68,815,11,826,1288,123456,2,1,2,0,1,0,71.76 ,64.13,50.00 
02,000,01,002,0042,69,1030,15,1045,1446,123456,2,1,2,0,1,0,71.76 ,72.27,50.00 
02,000,01,002,0043,70,939,6,945,1194,123456,2,1,2,0,1,0,71.76 ,79.15,50.00 
02,000,01,002,0044,71,734,13,747,1295,123456,2,1,2,0,1,0,71.76 ,57.68,50.00 
02,000,01,002,0045,72,1023,18,1041,1454,123456,2,1,2,0,1,0,71.76 ,71.6,50.00 
02,000,01,002,0046,73,1005,13,1018,1409,123456,2,1,2,0,1,0,71.76 ,72.25,50.00 
02,000,01,002,0047,74,893,11,904,1249,123456,2,1,2,0,1,0,71.76 ,72.38,50.00 
02,000,01,002,0048,75,1110,23,1133,1510,123456,2,1,2,0,1,0,71.76 ,75.03,50.00 
02,000,01,002,0049,76,1043,16,1059,1527,123456,2,1,2,0,1,0,71.76 ,69.35,50.00 
02,000,01,002,0050,77,502,9,511,754,123456,2,1,2,0,1,0,71.76 ,67.77,50.00 
02,000,01,002,0051,78,666,14,680,1013,123456,2,1,2,0,1,0,71.76 ,67.13,50.00 
02,000,01,002,0052,79,751,16,767,1100,123456,2,1,2,0,1,0,71.76 ,69.73,50.00 
02,000,01,002,0053,80,755,16,771,1137,123456,2,1,2,0,1,0,71.76 ,67.81,50.00 
02,000,01,002,0054,81,646,8,654,906,123456,2,1,2,0,1,0,71.76 ,72.19,50.00 
02,000,01,002,0055,82,960,8,968,1403,123456,2,1,2,0,1,0,71.76 ,69,50.00 
02,000,01,002,0056,83,875,18,893,1372,123456,2,1,2,0,1,0,71.76 ,65.09,50.00 
02,000,01,002,0057,84,1029,11,1040,1540,123456,2,1,2,0,1,0,71.76 ,67.53,50.00 
02,000,01,002,0058,85,780,11,791,1151,123456,2,1,2,0,1,0,71.76 ,68.72,50.00 
02,000,01,002,0059,86,455,6,461,633,123456,2,1,2,0,1,0,71.76 ,72.83,50.00 
02,000,01,003,0060,87,861,5,866,1224,123456,2,1,2,0,1,0,71.76 ,70.75,50.00 
02,000,01,003,0061,88,753,8,761,1098,123456,2,1,2,0,1,0,71.76 ,69.31,50.00 
02,000,01,003,0062,89,1171,16,1187,1720,123456,2,1,2,0,1,0,71.76 ,69.01,50.00 
02,000,01,003,0063,90,831,9,840,1140,123456,2,1,2,0,1,0,71.76 ,73.68,50.00 
02,000,01,003,0063,91,709,10,719,1020,123456,2,1,2,0,1,0,71.76 ,70.49,50.00 
02,000,01,003,0064,92,1006,10,1016,1435,123456,2,1,2,0,1,0,71.76 ,70.8,50.00 
02,000,01,003,0064,93,916,11,927,1350,123456,2,1,2,0,1,0,71.76 ,68.67,50.00 
02,000,01,003,0065,94,917,11,928,1275,123456,2,1,2,0,1,0,71.76 ,72.78,50.00 
02,000,01,003,0066,95,865,12,877,1309,123456,2,1,2,0,1,0,71.76 ,67,50.00 
02,000,01,003,0067,96,855,15,870,1219,123456,2,1,2,0,1,0,71.76 ,71.37,50.00 
02,000,01,003,0067,97,883,9,892,1256,123456,2,1,2,0,1,0,71.76 ,71.02,50.00 
02,000,01,003,0068,98,1291,8,1299,1771,123456,2,1,2,0,1,0,71.76 ,73.35,50.00 
02,000,01,003,0069,99,604,6,610,882,123456,2,1,2,0,1,0,71.76 ,69.16,50.00 
02,000,01,003,0069,100,1155,13,1168,1729,123456,2,1,2,0,1,0,71.76 ,67.55,50.00 
02,000,01,003,0070,101,1172,22,1194,1697,123456,2,1,2,0,1,0,71.76 ,70.36,50.00 
02,000,01,003,0071,102,603,5,608,896,123456,2,1,2,0,1,0,71.76 ,67.86,50.00 
02,000,01,003,0072,103,842,20,862,1128,123456,2,1,2,0,1,0,71.76 ,76.42,50.00 
02,000,01,003,0072,104,848,13,861,1188,123456,2,1,2,0,1,0,71.76 ,72.47,50.00 
02,000,02,004,0073,105,1094,12,1106,2048,123456,2,1,2,0,1,0,71.76 ,54,50.00 
02,000,02,004,0074,106,830,13,843,1150,123456,2,1,2,0,1,0,71.76 ,73.3,50.00 
02,000,02,004,0075,107,427,9,436,587,123456,2,1,2,0,1,0,71.76 ,74.28,50.00 
02,000,02,004,0076,108,527,10,537,690,123456,2,1,2,0,1,0,71.76 ,77.83,50.00 
02,000,02,004,0077,109,396,8,404,570,123456,2,1,2,0,1,0,71.76 ,70.88,50.00 
02,000,02,004,0078,110,608,11,619,862,123456,2,1,2,0,1,0,71.76 ,71.81,50.00 
02,000,02,004,0079,111,735,6,741,992,123456,2,1,2,0,1,0,71.76 ,74.7,50.00 
02,000,02,004,0080,112,552,6,558,788,123456,2,1,2,0,1,0,71.76 ,70.81,50.00 
02,000,02,004,0081,113,955,23,978,1335,123456,2,1,2,0,1,0,71.76 ,73.26,50.00 
02,000,02,004,0081,114,1068,9,1077,1523,123456,2,1,2,0,1,0,71.76 ,70.72,50.00 
02,000,02,004,0082,115,1035,22,1057,1437,123456,2,1,2,0,1,0,71.76 ,73.56,50.00 
02,000,02,004,0083,116,404,10,414,540,123456,2,1,2,0,1,0,71.76 ,76.67,50.00 
02,000,02,004,0084,117,654,16,670,950,123456,2,1,2,0,1,0,71.76 ,70.53,50.00 
02,000,02,004,0084,118,597,16,613,859,123456,2,1,2,0,1,0,71.76 ,71.36,50.00 
02,000,02,004,0085,119,826,8,834,1150,123456,2,1,2,0,1,0,71.76 ,72.52,50.00 
02,000,02,004,0086,120,1158,15,1173,1713,123456,2,1,2,0,1,0,71.76 ,68.48,50.00 
02,000,02,004,0087,121,770,16,786,1119,123456,2,1,2,0,1,0,71.76 ,70.24,50.00 
02,000,02,004,0087,122,973,18,991,1404,123456,2,1,2,0,1,0,71.76 ,70.58,50.00 
02,000,02,004,0088,123,923,17,940,1319,123456,2,1,2,0,1,0,71.76 ,71.27,50.00 
02,000,02,004,0089,124,989,12,1001,1456,123456,2,1,2,0,1,0,71.76 ,68.75,50.00 
02,000,02,004,0090,125,868,16,884,1130,123456,2,1,2,0,1,0,71.76 ,78.23,50.00 
02,000,02,004,0091,126,663,10,673,897,123456,2,1,2,0,1,0,71.76 ,75.03,50.00 
02,000,02,004,0092,127,264,2,266,355,123456,2,1,2,0,1,0,71.76 ,74.93,50.00 
02,000,02,004,0093,128,373,3,376,546,123456,2,1,2,0,1,0,71.76 ,68.86,50.00 
02,000,02,004,0094,129,385,7,392,545,123456,2,1,2,0,1,0,71.76 ,71.93,50.00 
02,000,02,004,0095,130,534,8,542,739,123456,2,1,2,0,1,0,71.76 ,73.34,50.00 
02,000,02,004,0096,131,359,8,367,501,123456,2,1,2,0,1,0,71.76 ,73.25,50.00 
02,000,02,004,0097,132,498,7,505,687,123456,2,1,2,0,1,0,71.76 ,73.51,50.00 
02,000,02,004,0098,133,750,10,760,1050,123456,2,1,2,0,1,0,71.76 ,72.38,50.00 
02,000,02,004,0099,134,892,31,923,1376,123456,2,1,2,0,1,0,71.76 ,67.08,50.00 
02,000,02,004,0100,135,764,8,772,1098,123456,2,1,2,0,1,0,71.76 ,70.31,50.00 
02,000,02,004,0101,136,1020,19,1039,1390,123456,2,1,2,0,1,0,71.76 ,74.75,50.00 
02,000,02,004,0101,137,1435,25,1460,2019,123456,2,1,2,0,1,0,71.76 ,72.31,50.00 
02,000,02,004,0101,138,992,22,1014,1346,123456,2,1,2,0,1,0,71.76 ,75.33,50.00 
02,000,02,004,0101,139,783,12,795,1049,123456,2,1,2,0,1,0,71.76 ,75.79,50.00 
02,000,02,004,0102,140,830,18,848,1198,123456,2,1,2,0,1,0,71.76 ,70.78,50.00 
02,000,02,004,0103,141,919,16,935,1312,123456,2,1,2,0,1,0,71.76 ,71.27,50.00 
02,000,02,004,0103,142,511,12,523,776,123456,2,1,2,0,1,0,71.76 ,67.4,50.00 
02,000,02,004,0104,143,1335,17,1352,1820,123456,2,1,2,0,1,0,71.76 ,74.29,50.00 
02,000,02,004,0105,144,1037,22,1059,1542,123456,2,1,2,0,1,0,71.76 ,68.68,50.00 
02,000,02,004,0106,145,1194,11,1205,1701,123456,2,1,2,0,1,0,71.76 ,70.84,50.00 
02,000,02,004,0107,146,1171,26,1197,1740,123456,2,1,2,0,1,0,71.76 ,68.79,50.00 
02,000,02,004,0107,147,1201,20,1221,1785,123456,2,1,2,0,1,0,71.76 ,68.4,50.00 
02,000,02,004,0107,148,1086,18,1104,1668,123456,2,1,2,0,1,0,71.76 ,66.19,50.00 
02,000,02,004,0107,149,1211,19,1230,1833,123456,2,1,2,0,1,0,71.76 ,67.1,50.00 
02,000,02,004,0107,150,1185,11,1196,1713,123456,2,1,2,0,1,0,71.76 ,69.82,50.00 
02,000,02,004,0107,151,975,21,996,1377,123456,2,1,2,0,1,0,71.76 ,72.33,50.00 
02,000,02,004,0108,152,1170,23,1193,1648,123456,2,1,2,0,1,0,71.76 ,72.39,50.00 
02,000,02,004,0108,153,1096,20,1116,1573,123456,2,1,2,0,1,0,71.76 ,70.95,50.00 
02,000,02,004,0108,154,1037,18,1055,1532,123456,2,1,2,0,1,0,71.76 ,68.86,50.00 
02,000,02,004,0108,155,966,25,991,1452,123456,2,1,2,0,1,0,71.76 ,68.25,50.00 
02,000,02,004,0108,156,1102,22,1124,1657,123456,2,1,2,0,1,0,71.76 ,67.83,50.00 
02,000,02,004,0108,157,1032,27,1059,1778,123456,2,1,2,0,1,0,71.76 ,59.56,50.00 
02,000,02,004,0108,158,1096,34,1130,1638,123456,2,1,2,0,1,0,71.76 ,68.99,50.00 
02,000,02,004,0108,159,1161,28,1189,1736,123456,2,1,2,0,1,0,71.76 ,68.49,50.00 
02,000,02,004,0108,160,1067,36,1103,1689,123456,2,1,2,0,1,0,71.76 ,65.3,50.00 
02,000,02,004,0108,161,1043,22,1065,1664,123456,2,1,2,0,1,0,71.76 ,64,50.00 
02,000,02,004,0108,162,1143,35,1178,1748,123456,2,1,2,0,1,0,71.76 ,67.39,50.00 
02,000,02,004,0108,163,1082,26,1108,1710,123456,2,1,2,0,1,0,71.76 ,64.8,50.00 
02,000,02,004,0109,164,1205,35,1240,1755,123456,2,1,2,0,1,0,71.76 ,70.66,50.00 
02,000,02,004,0109,165,894,13,907,1252,123456,2,1,2,0,1,0,71.76 ,72.44,50.00 
02,000,02,004,0109,166,1018,14,1032,1517,123456,2,1,2,0,1,0,71.76 ,68.03,50.00 
02,000,02,004,0110,167,1153,17,1170,1608,123456,2,1,2,0,1,0,71.76 ,72.76,50.00 
02,000,02,004,0110,168,1106,25,1131,1621,123456,2,1,2,0,1,0,71.76 ,69.77,50.00 
02,000,02,004,0110,169,1023,22,1045,1542,123456,2,1,2,0,1,0,71.76 ,67.77,50.00 
02,000,02,004,0110,170,1073,25,1098,1605,123456,2,1,2,0,1,0,71.76 ,68.41,50.00 
02,000,02,004,0110,171,1097,17,1114,1647,123456,2,1,2,0,1,0,71.76 ,67.64,50.00 
02,000,02,004,0110,172,1102,22,1124,1744,123456,2,1,2,0,1,0,71.76 ,64.45,50.00 
02,000,02,004,0111,173,1193,14,1207,1714,123456,2,1,2,0,1,0,71.76 ,70.42,50.00 
02,000,02,004,0111,174,1084,29,1113,1641,123456,2,1,2,0,1,0,71.76 ,67.82,50.00 
02,000,02,004,0111,175,1097,30,1127,1652,123456,2,1,2,0,1,0,71.76 ,68.22,50.00 
02,000,02,004,0111,176,1061,27,1088,1636,123456,2,1,2,0,1,0,71.76 ,66.5,50.00 
02,000,02,004,0111,177,1002,24,1026,1602,123456,2,1,2,0,1,0,71.76 ,64.04,50.00 
02,000,02,004,0111,178,962,26,988,1624,123456,2,1,2,0,1,0,71.76 ,60.84,50.00 
02,000,02,004,0111,179,1075,27,1102,1725,123456,2,1,2,0,1,0,71.76 ,63.88,50.00 
02,000,02,004,0111,180,1085,26,1111,1709,123456,2,1,2,0,1,0,71.76 ,65.01,50.00 
02,000,02,004,0111,181,1158,23,1181,1810,123456,2,1,2,0,1,0,71.76 ,65.25,50.00 
02,000,02,004,0111,182,1187,6,1193,1741,123456,2,1,2,0,1,0,71.76 ,68.52,50.00 
02,000,02,004,0111,183,1014,28,1042,1587,123456,2,1,2,0,1,0,71.76 ,65.66,50.00 
02,000,02,004,0111,184,875,15,890,1322,123456,2,1,2,0,1,0,71.76 ,67.32,50.00 
02,000,02,004,0112,185,879,23,902,1442,123456,2,1,2,0,1,0,71.76 ,62.55,50.00 
02,000,02,004,0112,186,959,21,980,1565,123456,2,1,2,0,1,0,71.76 ,62.62,50.00 
02,000,02,004,0112,187,969,13,982,1486,123456,2,1,2,0,1,0,71.76 ,66.08,50.00 
02,000,02,004,0112,188,942,19,961,1452,123456,2,1,2,0,1,0,71.76 ,66.18,50.00 
02,000,02,004,0112,189,979,27,1006,1534,123456,2,1,2,0,1,0,71.76 ,65.58,50.00 
02,000,02,004,0112,190,995,22,1017,1580,123456,2,1,2,0,1,0,71.76 ,64.37,50.00 
02,000,02,004,0112,191,949,22,971,1553,123456,2,1,2,0,1,0,71.76 ,62.52,50.00 
02,000,02,004,0112,192,973,21,994,1657,123456,2,1,2,0,1,0,71.76 ,59.99,50.00 
02,000,02,004,0112,193,1124,22,1146,1795,123456,2,1,2,0,1,0,71.76 ,63.84,50.00 
02,000,02,004,0112,194,1025,25,1050,1622,123456,2,1,2,0,1,0,71.76 ,64.73,50.00 
02,000,02,004,0112,195,1151,28,1179,1865,123456,2,1,2,0,1,0,71.76 ,63.22,50.00 
02,000,02,004,0112,196,924,21,945,1563,123456,2,1,2,0,1,0,71.76 ,60.46,50.00 
02,000,02,004,0112,197,1070,41,1111,1691,123456,2,1,2,0,1,0,71.76 ,65.7,50.00 
02,000,02,004,0112,198,1018,15,1033,1561,123456,2,1,2,0,1,0,71.76 ,66.18,50.00 
02,000,02,005,0113,199,1073,18,1091,1571,123456,2,1,2,0,1,0,71.76 ,69.45,50.00 
02,000,02,005,0113,200,1100,21,1121,1664,123456,2,1,2,0,1,0,71.76 ,67.37,50.00 
02,000,02,005,0113,201,904,15,919,1422,123456,2,1,2,0,1,0,71.76 ,64.63,50.00 
02,000,02,005,0113,202,897,17,914,1479,123456,2,1,2,0,1,0,71.76 ,61.8,50.00 
02,000,02,005,0113,203,1040,18,1058,1638,123456,2,1,2,0,1,0,71.76 ,64.59,50.00 
02,000,02,005,0113,204,889,10,899,1352,123456,2,1,2,0,1,0,71.76 ,66.49,50.00 
02,000,02,005,0113,205,885,8,893,1408,123456,2,1,2,0,1,0,71.76 ,63.42,50.00 
02,000,02,005,0113,206,816,8,824,1202,123456,2,1,2,0,1,0,71.76 ,68.55,50.00 
02,000,02,005,0114,207,741,7,748,1135,123456,2,1,2,0,1,0,71.76 ,65.9,50.00 
02,000,02,005,0114,208,819,21,840,1279,123456,2,1,2,0,1,0,71.76 ,65.68,50.00 
02,000,02,005,0115,209,935,10,945,1382,123456,2,1,2,0,1,0,71.76 ,68.38,50.00 
02,000,02,005,0115,210,1020,18,1038,1610,123456,2,1,2,0,1,0,71.76 ,64.47,50.00 
02,000,02,005,0115,211,845,14,859,1516,123456,2,1,2,0,1,0,71.76 ,56.66,50.00 
02,000,02,005,0116,212,891,12,903,1262,123456,2,1,2,0,1,0,71.76 ,71.55,50.00 
02,000,02,005,0116,213,888,9,897,1436,123456,2,1,2,0,1,0,71.76 ,62.47,50.00 
02,000,02,005,0117,214,875,14,889,1286,123456,2,1,2,0,1,0,71.76 ,69.13,50.00 
02,000,02,005,0117,215,890,11,901,1340,123456,2,1,2,0,1,0,71.76 ,67.24,50.00 
02,000,02,005,0118,216,662,8,670,1391,123456,2,1,2,0,1,0,71.76 ,48.17,50.00 
02,000,02,005,0118,217,813,17,830,1258,123456,2,1,2,0,1,0,71.76 ,65.98,50.00 
02,000,02,005,0119,218,1043,11,1054,1564,123456,2,1,2,0,1,0,71.76 ,67.39,50.00 
02,000,02,005,0119,219,1173,20,1193,1707,123456,2,1,2,0,1,0,71.76 ,69.89,50.00 
02,000,02,005,0120,220,1054,8,1062,1626,123456,2,1,2,0,1,0,71.76 ,65.31,50.00 
02,000,02,005,0120,221,1171,15,1186,1822,123456,2,1,2,0,1,0,71.76 ,65.09,50.00 
02,000,02,005,0121,222,1121,20,1141,1604,123456,2,1,2,0,1,0,71.76 ,71.13,50.00 
02,000,02,005,0121,223,1151,9,1160,1671,123456,2,1,2,0,1,0,71.76 ,69.42,50.00 
02,000,02,005,0122,224,731,7,738,1001,123456,2,1,2,0,1,0,71.76 ,73.73,50.00 
02,000,02,005,0122,225,893,15,908,1223,123456,2,1,2,0,1,0,71.76 ,74.24,50.00 
02,000,02,005,0123,226,1058,16,1074,1500,123456,2,1,2,0,1,0,71.76 ,71.6,50.00 
02,000,02,005,0123,227,1080,21,1101,1569,123456,2,1,2,0,1,0,71.76 ,70.17,50.00 
02,000,02,005,0124,228,1104,10,1114,1543,123456,2,1,2,0,1,0,71.76 ,72.2,50.00 
02,000,02,005,0125,229,1150,18,1168,1709,123456,2,1,2,0,1,0,71.76 ,68.34,50.00 
02,000,02,005,0125,230,1086,15,1101,1674,123456,2,1,2,0,1,0,71.76 ,65.77,50.00 
02,000,02,005,0126,231,964,20,984,1454,123456,2,1,2,0,1,0,71.76 ,67.68,50.00 
02,000,02,005,0126,232,991,18,1009,1552,123456,2,1,2,0,1,0,71.76 ,65.01,50.00 
02,000,02,005,0126,233,890,28,918,1441,123456,2,1,2,0,1,0,71.76 ,63.71,50.00 
02,000,02,005,0126,234,983,16,999,1587,123456,2,1,2,0,1,0,71.76 ,62.95,50.00 
02,000,02,005,0126,235,958,15,973,1487,123456,2,1,2,0,1,0,71.76 ,65.43,50.00 
02,000,02,005,0126,236,960,17,977,1553,123456,2,1,2,0,1,0,71.76 ,62.91,50.00 
02,000,02,005,0126,237,1059,17,1076,1704,123456,2,1,2,0,1,0,71.76 ,63.15,50.00 
02,000,02,005,0127,238,1141,20,1161,1707,123456,2,1,2,0,1,0,71.76 ,68.01,50.00 
02,000,02,005,0128,239,1022,11,1033,1412,123456,2,1,2,0,1,0,71.76 ,73.16,50.00 
02,000,02,005,0128,240,987,21,1008,1387,123456,2,1,2,0,1,0,71.76 ,72.67,50.00 
02,000,02,005,0129,241,906,8,914,1255,123456,2,1,2,0,1,0,71.76 ,72.83,50.00 
02,000,02,005,0129,242,728,16,744,975,123456,2,1,2,0,1,0,71.76 ,76.31,50.00 
02,000,02,005,0130,243,1019,15,1034,1366,123456,2,1,2,0,1,0,71.76 ,75.7,50.00 
02,000,02,005,0130,244,1108,16,1124,1590,123456,2,1,2,0,1,0,71.76 ,70.69,50.00 
02,000,02,005,0131,245,695,9,704,1029,123456,2,1,2,0,1,0,71.76 ,68.42,50.00 
02,000,02,005,0131,246,784,17,801,1207,123456,2,1,2,0,1,0,71.76 ,66.36,50.00 
02,000,02,005,0132,247,717,6,723,1003,123456,2,1,2,0,1,0,71.76 ,72.08,50.00 
02,000,02,005,0132,248,716,10,726,1008,123456,2,1,2,0,1,0,71.76 ,72.02,50.00 
02,000,02,005,0133,249,1353,17,1370,1823,123456,2,1,2,0,1,0,71.76 ,75.15,50.00 
02,000,02,005,0134,250,1109,10,1119,1488,123456,2,1,2,0,1,0,71.76 ,75.2,50.00 
02,000,02,005,0134,251,995,20,1015,1471,123456,2,1,2,0,1,0,71.76 ,69,50.00 
02,000,02,005,0134,252,1016,17,1033,1428,123456,2,1,2,0,1,0,71.76 ,72.34,50.00 
02,000,02,005,0135,253,1040,9,1049,1446,123456,2,1,2,0,1,0,71.76 ,72.54,50.00 
02,000,02,005,0136,254,1245,17,1262,1733,123456,2,1,2,0,1,0,71.76 ,72.82,50.00 
02,000,02,005,0136,255,1157,13,1170,1645,123456,2,1,2,0,1,0,71.76 ,71.12,50.00 
02,000,02,005,0137,256,952,12,964,1389,123456,2,1,2,0,1,0,71.76 ,69.4,50.00 
02,000,02,005,0137,257,705,9,714,1029,123456,2,1,2,0,1,0,71.76 ,69.39,50.00 
02,000,02,005,0138,258,778,9,787,1142,123456,2,1,2,0,1,0,71.76 ,68.91,50.00 
02,000,02,005,0138,259,887,8,895,1313,123456,2,1,2,0,1,0,71.76 ,68.16,50.00 
02,000,02,005,0139,260,704,9,713,986,123456,2,1,2,0,1,0,71.76 ,72.31,50.00 
02,000,02,005,0139,261,775,12,787,1088,123456,2,1,2,0,1,0,71.76 ,72.33,50.00 
02,000,02,005,0140,262,1196,8,1204,1604,123456,2,1,2,0,1,0,71.76 ,75.06,50.00 
02,000,02,005,0140,263,1057,9,1066,1476,123456,2,1,2,0,1,0,71.76 ,72.22,50.00 
02,000,02,005,0141,264,1140,15,1155,1640,123456,2,1,2,0,1,0,71.76 ,70.43,50.00 
02,000,02,005,0141,265,1057,9,1066,1556,123456,2,1,2,0,1,0,71.76 ,68.51,50.00 
02,000,02,005,0142,266,654,7,661,1015,123456,2,1,2,0,1,0,71.76 ,65.12,50.00 
02,000,02,005,0142,267,722,11,733,1023,123456,2,1,2,0,1,0,71.76 ,71.65,50.00 
02,000,02,005,0143,268,1085,16,1101,1465,123456,2,1,2,0,1,0,71.76 ,75.15,50.00 
02,000,02,005,0143,269,1216,14,1230,1668,123456,2,1,2,0,1,0,71.76 ,73.74,50.00 
02,000,02,005,0144,270,1116,15,1131,1565,123456,2,1,2,0,1,0,71.76 ,72.27,50.00 
02,000,02,005,0144,271,1069,12,1081,1652,123456,2,1,2,0,1,0,71.76 ,65.44,50.00 
02,000,02,005,0145,272,1014,18,1032,1560,123456,2,1,2,0,1,0,71.76 ,66.15,50.00 
02,000,02,005,0145,273,1097,15,1112,1589,123456,2,1,2,0,1,0,71.76 ,69.98,50.00 
02,000,02,005,0145,274,1036,11,1047,1630,123456,2,1,2,0,1,0,71.76 ,64.23,50.00 
02,000,02,005,0145,275,1013,19,1032,1561,123456,2,1,2,0,1,0,71.76 ,66.11,50.00 
02,000,02,005,0146,276,1133,23,1156,1793,123456,2,1,2,0,1,0,71.76 ,64.47,50.00 
02,000,02,005,0146,277,1122,22,1144,1755,123456,2,1,2,0,1,0,71.76 ,65.19,50.00 
02,000,02,005,0147,278,1296,19,1315,1864,123456,2,1,2,0,1,0,71.76 ,70.55,50.00 
02,000,02,005,0148,279,683,8,691,983,123456,2,1,2,0,1,0,71.76 ,70.3,50.00 
02,000,02,005,0149,280,1107,12,1119,1540,123456,2,1,2,0,1,0,71.76 ,72.66,50.00 
02,000,03,006,0150,281,1149,19,1168,1879,123456,2,1,2,0,1,0,71.76 ,62.16,50.00 
02,000,03,006,0150,282,787,15,802,1226,123456,2,1,2,0,1,0,71.76 ,65.42,50.00 
02,000,03,006,0151,283,863,25,888,1366,123456,2,1,2,0,1,0,71.76 ,65.01,50.00 
02,000,03,006,0151,284,951,12,963,1450,123456,2,1,2,0,1,0,71.76 ,66.41,50.00 
02,000,03,006,0151,285,995,17,1012,1578,123456,2,1,2,0,1,0,71.76 ,64.13,50.00 
02,000,03,006,0151,286,1028,20,1048,1625,123456,2,1,2,0,1,0,71.76 ,64.49,50.00 
02,000,03,006,0152,287,1126,22,1148,1635,123456,2,1,2,0,1,0,71.76 ,70.21,50.00 
02,000,03,006,0152,288,1145,25,1170,1769,123456,2,1,2,0,1,0,71.76 ,66.14,50.00 
02,000,03,006,0153,289,1063,29,1092,1632,123456,2,1,2,0,1,0,71.76 ,66.91,50.00 
02,000,03,006,0153,290,1176,17,1193,1761,123456,2,1,2,0,1,0,71.76 ,67.75,50.00 
02,000,03,006,0154,291,954,22,976,1443,123456,2,1,2,0,1,0,71.76 ,67.64,50.00 
02,000,03,006,0154,292,923,19,942,1389,123456,2,1,2,0,1,0,71.76 ,67.82,50.00 
02,000,03,006,0154,293,967,22,989,1541,123456,2,1,2,0,1,0,71.76 ,64.18,50.00 
02,000,03,006,0154,294,952,19,971,1589,123456,2,1,2,0,1,0,71.76 ,61.11,50.00 
02,000,03,006,0155,295,1158,18,1176,1615,123456,2,1,2,0,1,0,71.76 ,72.82,50.00 
02,000,03,006,0155,296,1130,23,1153,1574,123456,2,1,2,0,1,0,71.76 ,73.25,50.00 
02,000,03,006,0156,297,1160,26,1186,1740,123456,2,1,2,0,1,0,71.76 ,68.16,50.00 
02,000,03,006,0156,298,1140,19,1159,1687,123456,2,1,2,0,1,0,71.76 ,68.7,50.00 
02,000,03,006,0156,299,1155,23,1178,1717,123456,2,1,2,0,1,0,71.76 ,68.61,50.00 
02,000,03,006,0156,300,997,26,1023,1649,123456,2,1,2,0,1,0,71.76 ,62.04,50.00 
02,000,03,006,0156,301,1111,19,1130,1708,123456,2,1,2,0,1,0,71.76 ,66.16,50.00 
02,000,03,006,0156,302,1129,14,1143,1722,123456,2,1,2,0,1,0,71.76 ,66.38,50.00 
02,000,03,006,0156,303,1091,19,1110,1628,123456,2,1,2,0,1,0,71.76 ,68.18,50.00 
02,000,03,006,0156,304,938,8,946,1382,123456,2,1,2,0,1,0,71.76 ,68.45,50.00 
02,000,03,006,0156,305,1117,22,1139,1634,123456,2,1,2,0,1,0,71.76 ,69.71,50.00 
02,000,03,006,0156,306,1074,34,1108,1614,123456,2,1,2,0,1,0,71.76 ,68.65,50.00 
02,000,03,006,0157,307,1015,20,1035,1534,123456,2,1,2,0,1,0,71.76 ,67.47,50.00 
02,000,03,006,0157,308,925,18,943,1407,123456,2,1,2,0,1,0,71.76 ,67.02,50.00 
02,000,03,006,0157,309,948,13,961,1448,123456,2,1,2,0,1,0,71.76 ,66.37,50.00 
02,000,03,006,0157,310,1033,15,1048,1538,123456,2,1,2,0,1,0,71.76 ,68.14,50.00 
02,000,03,006,0157,311,1050,16,1066,1579,123456,2,1,2,0,1,0,71.76 ,67.51,50.00 
02,000,03,006,0158,312,1043,21,1064,1571,123456,2,1,2,0,1,0,71.76 ,67.73,50.00 
02,000,03,006,0158,313,1022,18,1040,1552,123456,2,1,2,0,1,0,71.76 ,67.01,50.00 
02,000,03,006,0158,314,907,7,914,1478,123456,2,1,2,0,1,0,71.76 ,61.84,50.00 
02,000,03,006,0158,315,925,21,946,1489,123456,2,1,2,0,1,0,71.76 ,63.53,50.00 
02,000,03,006,0159,316,728,9,737,1090,123456,2,1,2,0,1,0,71.76 ,67.61,50.00 
02,000,03,006,0159,317,671,7,678,937,123456,2,1,2,0,1,0,71.76 ,72.36,50.00 
02,000,03,006,0160,318,1053,23,1076,1557,123456,2,1,2,0,1,0,71.76 ,69.11,50.00 
02,000,03,006,0161,319,1034,20,1054,1569,123456,2,1,2,0,1,0,71.76 ,67.18,50.00 
02,000,03,006,0161,320,1011,27,1038,1565,123456,2,1,2,0,1,0,71.76 ,66.33,50.00 
02,000,03,006,0161,321,1050,8,1058,1476,123456,2,1,2,0,1,0,71.76 ,71.68,50.00 
02,000,03,006,0162,322,774,16,790,1197,123456,2,1,2,0,1,0,71.76 ,66,50.00 
02,000,03,006,0162,323,895,17,912,1311,123456,2,1,2,0,1,0,71.76 ,69.57,50.00 
02,000,03,006,0162,324,945,19,964,1378,123456,2,1,2,0,1,0,71.76 ,69.96,50.00 
02,000,03,006,0163,325,938,18,956,1404,123456,2,1,2,0,1,0,71.76 ,68.09,50.00 
02,000,03,006,0163,326,862,19,881,1325,123456,2,1,2,0,1,0,71.76 ,66.49,50.00 
02,000,03,006,0163,327,987,10,997,1517,123456,2,1,2,0,1,0,71.76 ,65.72,50.00 
02,000,03,006,0164,328,1088,19,1107,1636,123456,2,1,2,0,1,0,71.76 ,67.67,50.00 
02,000,03,006,0164,329,1087,20,1107,1650,123456,2,1,2,0,1,0,71.76 ,67.09,50.00 
02,000,03,006,0164,330,1104,32,1136,1742,123456,2,1,2,0,1,0,71.76 ,65.21,50.00 
02,000,03,006,0164,331,1032,21,1053,1634,123456,2,1,2,0,1,0,71.76 ,64.44,50.00 
02,000,03,006,0165,332,1169,24,1193,1852,123456,2,1,2,0,1,0,71.76 ,64.42,50.00 
02,000,03,006,0165,333,1027,20,1047,1596,123456,2,1,2,0,1,0,71.76 ,65.6,50.00 
02,000,03,006,0166,334,960,18,978,1529,123456,2,1,2,0,1,0,71.76 ,63.96,50.00 
02,000,03,006,0166,335,924,16,940,1435,123456,2,1,2,0,1,0,71.76 ,65.51,50.00 
02,000,03,006,0166,336,990,19,1009,1547,123456,2,1,2,0,1,0,71.76 ,65.22,50.00 
02,000,03,006,0167,337,1108,24,1132,1729,123456,2,1,2,0,1,0,71.76 ,65.47,50.00 
02,000,03,006,0167,338,985,20,1005,1666,123456,2,1,2,0,1,0,71.76 ,60.32,50.00 
02,000,03,006,0168,339,835,12,847,1209,123456,2,1,2,0,1,0,71.76 ,70.06,50.00 
02,000,03,006,0168,340,970,16,986,1404,123456,2,1,2,0,1,0,71.76 ,70.23,50.00 
02,000,03,006,0168,341,939,12,951,1361,123456,2,1,2,0,1,0,71.76 ,69.88,50.00 
02,000,03,006,0168,342,936,19,955,1470,123456,2,1,2,0,1,0,71.76 ,64.97,50.00 
02,000,03,006,0169,343,851,14,865,1248,123456,2,1,2,0,1,0,71.76 ,69.31,50.00 
02,000,03,006,0169,344,997,15,1012,1470,123456,2,1,2,0,1,0,71.76 ,68.84,50.00 
02,000,03,006,0170,345,887,24,911,1392,123456,2,1,2,0,1,0,71.76 ,65.45,50.00 
02,000,03,006,0170,346,906,21,927,1451,123456,2,1,2,0,1,0,71.76 ,63.89,50.00 
02,000,03,006,0171,347,1179,25,1204,1931,123456,2,1,2,0,1,0,71.76 ,62.35,50.00 
02,000,03,006,0171,348,980,10,990,1525,123456,2,1,2,0,1,0,71.76 ,64.92,50.00 
02,000,03,006,0171,349,1163,22,1185,1743,123456,2,1,2,0,1,0,71.76 ,67.99,50.00 
02,000,03,006,0171,350,1030,17,1047,1502,123456,2,1,2,0,1,0,71.76 ,69.71,50.00 
02,000,03,006,0172,351,848,25,873,1305,123456,2,1,2,0,1,0,71.76 ,66.9,50.00 
02,000,03,006,0172,352,869,18,887,1343,123456,2,1,2,0,1,0,71.76 ,66.05,50.00 
02,000,03,006,0173,353,786,13,799,1273,123456,2,1,2,0,1,0,71.76 ,62.77,50.00 
02,000,03,006,0173,354,761,25,786,1244,123456,2,1,2,0,1,0,71.76 ,63.18,50.00 
02,000,03,006,0174,355,897,17,914,1465,123456,2,1,2,0,1,0,71.76 ,62.39,50.00 
02,000,03,006,0174,356,898,19,917,1439,123456,2,1,2,0,1,0,71.76 ,63.72,50.00 
02,000,03,006,0174,357,865,10,875,1341,123456,2,1,2,0,1,0,71.76 ,65.25,50.00 
02,000,03,006,0175,358,844,17,861,1261,123456,2,1,2,0,1,0,71.76 ,68.28,50.00 
02,000,03,006,0175,359,996,21,1017,1449,123456,2,1,2,0,1,0,71.76 ,70.19,50.00 
02,000,03,006,0175,360,966,16,982,1465,123456,2,1,2,0,1,0,71.76 ,67.03,50.00 
02,000,03,006,0176,361,1160,21,1181,1763,123456,2,1,2,0,1,0,71.76 ,66.99,50.00 
02,000,03,006,0176,362,867,15,882,1389,123456,2,1,2,0,1,0,71.76 ,63.5,50.00 
02,000,03,006,0176,363,883,13,896,1414,123456,2,1,2,0,1,0,71.76 ,63.37,50.00 
02,000,03,006,0176,364,892,12,904,1477,123456,2,1,2,0,1,0,71.76 ,61.21,50.00 
02,000,03,006,0177,365,918,12,930,1328,123456,2,1,2,0,1,0,71.76 ,70.03,50.00 
02,000,03,006,0177,366,829,11,840,1189,123456,2,1,2,0,1,0,71.76 ,70.65,50.00 
02,000,03,006,0177,367,903,19,922,1400,123456,2,1,2,0,1,0,71.76 ,65.86,50.00 
02,000,03,006,0178,368,822,7,829,2005,123456,2,1,2,0,1,0,71.76 ,41.35,50.00 
02,000,03,006,0178,369,1173,32,1205,1763,123456,2,1,2,0,1,0,71.76 ,68.35,50.00 
02,000,03,006,0178,370,1111,22,1133,1750,123456,2,1,2,0,1,0,71.76 ,64.74,50.00 
02,000,03,006,0179,371,1178,27,1205,1820,123456,2,1,2,0,1,0,71.76 ,66.21,50.00 
02,000,03,006,0179,372,1148,19,1167,1788,123456,2,1,2,0,1,0,71.76 ,65.27,50.00 
02,000,03,006,0179,373,1126,16,1142,1787,123456,2,1,2,0,1,0,71.76 ,63.91,50.00 
02,000,03,006,0179,374,1135,19,1154,1848,123456,2,1,2,0,1,0,71.76 ,62.45,50.00 
02,000,03,006,0180,375,1010,19,1029,1572,123456,2,1,2,0,1,0,71.76 ,65.46,50.00 
02,000,03,006,0180,376,906,17,923,1485,123456,2,1,2,0,1,0,71.76 ,62.15,50.00 
02,000,03,006,0181,377,896,21,917,1398,123456,2,1,2,0,1,0,71.76 ,65.59,50.00 
02,000,03,006,0181,378,929,20,949,1483,123456,2,1,2,0,1,0,71.76 ,63.99,50.00 
02,000,03,006,0182,379,971,18,989,1469,123456,2,1,2,0,1,0,71.76 ,67.32,50.00 
02,000,03,006,0182,380,795,9,804,1267,123456,2,1,2,0,1,0,71.76 ,63.46,50.00 
02,000,03,006,0182,381,830,19,849,1308,123456,2,1,2,0,1,0,71.76 ,64.91,50.00 
02,000,03,006,0183,382,784,12,796,1233,123456,2,1,2,0,1,0,71.76 ,64.56,50.00 
02,000,03,006,0183,383,834,10,844,1373,123456,2,1,2,0,1,0,71.76 ,61.47,50.00 
02,000,03,006,0184,384,685,10,695,997,123456,2,1,2,0,1,0,71.76 ,69.71,50.00 
02,000,03,006,0184,385,713,11,724,1013,123456,2,1,2,0,1,0,71.76 ,71.47,50.00 
02,000,03,006,0185,386,1124,19,1143,1696,123456,2,1,2,0,1,0,71.76 ,67.39,50.00 
02,000,03,006,0185,387,1031,23,1054,1516,123456,2,1,2,0,1,0,71.76 ,69.53,50.00 
02,000,03,006,0186,388,1067,15,1082,1814,123456,2,1,2,0,1,0,71.76 ,59.65,50.00 
02,000,03,006,0186,389,847,15,862,1226,123456,2,1,2,0,1,0,71.76 ,70.31,50.00 
02,000,03,006,0187,390,1161,20,1181,1971,123456,2,1,2,0,1,0,71.76 ,59.92,50.00 
02,000,03,006,0187,391,1140,11,1151,1737,123456,2,1,2,0,1,0,71.76 ,66.26,50.00 
02,000,03,006,0187,392,1057,16,1073,1665,123456,2,1,2,0,1,0,71.76 ,64.44,50.00 
02,000,03,006,0187,393,1262,13,1275,1945,123456,2,1,2,0,1,0,71.76 ,65.55,50.00 
02,000,03,006,0187,394,1163,19,1182,1826,123456,2,1,2,0,1,0,71.76 ,64.73,50.00 
02,000,03,006,0188,395,1024,15,1039,1549,123456,2,1,2,0,1,0,71.76 ,67.08,50.00 
02,000,03,006,0188,396,1133,22,1155,1722,123456,2,1,2,0,1,0,71.76 ,67.07,50.00 
02,000,03,006,0189,397,1138,20,1158,1625,123456,2,1,2,0,1,0,71.76 ,71.26,50.00 
02,000,03,006,0190,398,634,10,644,1078,123456,2,1,2,0,1,0,71.76 ,59.74,50.00 
02,000,03,006,0190,399,659,6,665,998,123456,2,1,2,0,1,0,71.76 ,66.63,50.00 
02,000,03,006,0191,400,944,11,955,1456,123456,2,1,2,0,1,0,71.76 ,65.59,50.00 
02,000,03,006,0191,401,931,20,951,1437,123456,2,1,2,0,1,0,71.76 ,66.18,50.00 
02,000,03,006,0192,402,658,15,673,981,123456,2,1,2,0,1,0,71.76 ,68.6,50.00 
02,000,03,006,0192,403,679,9,688,1009,123456,2,1,2,0,1,0,71.76 ,68.19,50.00 
02,000,03,006,0193,404,926,14,940,1521,123456,2,1,2,0,1,0,71.76 ,61.8,50.00 
02,000,03,006,0193,405,880,18,898,1347,123456,2,1,2,0,1,0,71.76 ,66.67,50.00 
02,000,03,006,0193,406,1002,13,1015,1524,123456,2,1,2,0,1,0,71.76 ,66.6,50.00 
02,000,03,006,0194,407,908,16,924,1407,123456,2,1,2,0,1,0,71.76 ,65.67,50.00 
02,000,03,006,0194,408,903,25,928,1418,123456,2,1,2,0,1,0,71.76 ,65.44,50.00 
02,000,03,006,0194,409,910,18,928,1418,123456,2,1,2,0,1,0,71.76 ,65.44,50.00 
02,000,03,006,0195,410,1085,15,1100,1549,123456,2,1,2,0,1,0,71.76 ,71.01,50.00 
02,000,03,006,0195,411,1063,27,1090,1529,123456,2,1,2,0,1,0,71.76 ,71.29,50.00 
02,000,03,006,0196,412,893,20,913,1238,123456,2,1,2,0,1,0,71.76 ,73.75,50.00 
02,000,03,006,0196,413,914,19,933,1352,123456,2,1,2,0,1,0,71.76 ,69.01,50.00 
02,000,03,006,0197,414,1021,18,1039,1406,123456,2,1,2,0,1,0,71.76 ,73.9,50.00 
02,000,03,006,0198,415,1166,22,1188,1630,123456,2,1,2,0,1,0,71.76 ,72.88,50.00 
02,000,03,006,0199,416,991,18,1009,1412,123456,2,1,2,0,1,0,71.76 ,71.46,50.00 
02,000,03,006,0200,417,729,14,743,1042,123456,2,1,2,0,1,0,71.76 ,71.31,50.00 
02,000,03,006,0201,418,970,15,985,1475,123456,2,1,2,0,1,0,71.76 ,66.78,50.00 
02,000,03,006,0201,419,906,18,924,1339,123456,2,1,2,0,1,0,71.76 ,69.01,50.00 
02,000,03,006,0202,420,808,12,820,1152,123456,2,1,2,0,1,0,71.76 ,71.18,50.00 
02,000,03,006,0202,421,835,14,849,1223,123456,2,1,2,0,1,0,71.76 ,69.42,50.00 
02,000,03,006,0203,422,1215,27,1242,1853,123456,2,1,2,0,1,0,71.76 ,67.03,50.00 
02,000,03,006,0204,423,1153,21,1174,1605,123456,2,1,2,0,1,0,71.76 ,73.15,50.00 
02,000,03,006,0205,424,615,8,623,852,123456,2,1,2,0,1,0,71.76 ,73.12,50.00 
02,000,03,006,0206,425,769,17,786,1086,123456,2,1,2,0,1,0,71.76 ,72.38,50.00 
02,000,03,006,0207,426,1094,32,1126,1569,123456,2,1,2,0,1,0,71.76 ,71.77,50.00 
02,000,03,006,0208,427,716,9,725,992,123456,2,1,2,0,1,0,71.76 ,73.08,50.00 
02,000,03,006,0208,428,741,12,753,1065,123456,2,1,2,0,1,0,71.76 ,70.7,50.00 
02,000,03,006,0209,429,1121,20,1141,1585,123456,2,1,2,0,1,0,71.76 ,71.99,50.00 
02,000,03,006,0209,430,1086,28,1114,1544,123456,2,1,2,0,1,0,71.76 ,72.15,50.00 
02,000,03,006,0210,431,797,10,807,1153,123456,2,1,2,0,1,0,71.76 ,69.99,50.00 
02,000,03,006,0210,432,792,15,807,1197,123456,2,1,2,0,1,0,71.76 ,67.42,50.00 
02,000,03,006,0210,433,971,17,988,1506,123456,2,1,2,0,1,0,71.76 ,65.6,50.00 
02,000,03,006,0211,434,735,10,745,1456,123456,2,1,2,0,1,0,71.76 ,51.17,50.00 
02,000,03,006,0211,435,890,19,909,1266,123456,2,1,2,0,1,0,71.76 ,71.8,50.00 
02,000,03,006,0211,436,803,9,812,1187,123456,2,1,2,0,1,0,71.76 ,68.41,50.00 
02,000,03,006,0212,437,1082,10,1092,1531,123456,2,1,2,0,1,0,71.76 ,71.33,50.00 
02,000,03,006,0213,438,517,8,525,750,123456,2,1,2,0,1,0,71.76 ,70,50.00 
02,000,03,006,0213,439,721,18,739,1064,123456,2,1,2,0,1,0,71.76 ,69.45,50.00 
02,000,03,006,0214,440,620,17,637,950,123456,2,1,2,0,1,0,71.76 ,67.05,50.00 
02,000,03,006,0214,441,720,11,731,1056,123456,2,1,2,0,1,0,71.76 ,69.22,50.00 
02,000,03,006,0215,442,636,12,648,881,123456,2,1,2,0,1,0,71.76 ,73.55,50.00 
02,000,03,006,0216,443,723,15,738,1035,123456,2,1,2,0,1,0,71.76 ,71.3,50.00 
02,000,03,006,0217,444,913,12,925,1351,123456,2,1,2,0,1,0,71.76 ,68.47,50.00 
02,000,03,006,0218,445,923,17,940,1386,123456,2,1,2,0,1,0,71.76 ,67.82,50.00 
02,000,03,006,0219,446,528,8,536,805,123456,2,1,2,0,1,0,71.76 ,66.58,50.00 
02,000,03,006,0220,447,172,3,175,248,123456,2,1,2,0,1,0,71.76 ,70.56,50.00 
02,000,03,006,0221,448,735,11,746,1142,123456,2,1,2,0,1,0,71.76 ,65.32,50.00 
02,000,03,006,0222,449,904,17,921,1345,123456,2,1,2,0,1,0,71.76 ,68.48,50.00 
02,000,03,006,0222,450,934,17,951,1374,123456,2,1,2,0,1,0,71.76 ,69.21,50.00 
02,000,03,006,0222,451,881,21,902,1288,123456,2,1,2,0,1,0,71.76 ,70.03,50.00 
02,000,03,006,0223,452,752,19,771,1131,123456,2,1,2,0,1,0,71.76 ,68.17,50.00 
02,000,03,006,0224,453,620,12,632,1088,123456,2,1,2,0,1,0,71.76 ,58.09,50.00 
02,000,03,006,0225,454,1106,28,1134,1669,123456,2,1,2,0,1,0,71.76 ,67.94,50.00 
02,000,03,006,0226,455,786,13,799,1109,123456,2,1,2,0,1,0,71.76 ,72.05,50.00 
02,000,03,006,0227,456,1222,21,1243,1724,123456,2,1,2,0,1,0,71.76 ,72.1,50.00 
02,000,03,006,0228,457,772,20,792,1168,123456,2,1,2,0,1,0,71.76 ,67.81,50.00 
02,000,03,006,0229,458,999,30,1029,1411,123456,2,1,2,0,1,0,71.76 ,72.93,50.00 
02,000,03,006,0229,459,832,22,854,1215,123456,2,1,2,0,1,0,71.76 ,70.29,50.00 
02,000,03,006,0230,460,605,15,620,913,123456,2,1,2,0,1,0,71.76 ,67.91,50.00 
02,000,03,006,0230,461,579,19,598,913,123456,2,1,2,0,1,0,71.76 ,65.5,50.00 
02,000,03,006,0231,462,808,33,841,1165,123456,2,1,2,0,1,0,71.76 ,72.19,50.00 
02,000,03,006,0232,463,853,13,866,1114,123456,2,1,2,0,1,0,71.76 ,77.74,50.00 
02,000,03,006,0233,464,795,16,811,1136,123456,2,1,2,0,1,0,71.76 ,71.39,50.00 
02,000,03,006,0234,465,911,18,929,1315,123456,2,1,2,0,1,0,71.76 ,70.65,50.00 
02,000,03,006,0235,466,925,30,955,1315,123456,2,1,2,0,1,0,71.76 ,72.62,50.00 
02,000,03,006,0236,467,729,20,749,1130,123456,2,1,2,0,1,0,71.76 ,66.28,50.00 
02,000,03,006,0236,468,749,12,761,1124,123456,2,1,2,0,1,0,71.76 ,67.7,50.00 
02,000,04,007,0237,469,739,11,750,1086,123456,2,1,2,0,1,0,71.76 ,69.06,50.00 
02,000,04,007,0237,470,534,9,543,811,123456,2,1,2,0,1,0,71.76 ,66.95,50.00 
02,000,04,007,0238,471,798,14,812,1249,123456,2,1,2,0,1,0,71.76 ,65.01,50.00 
02,000,04,007,0239,472,929,10,939,1413,123456,2,1,2,0,1,0,71.76 ,66.45,50.00 
02,000,04,007,0239,473,787,16,803,1274,123456,2,1,2,0,1,0,71.76 ,63.03,50.00 
02,000,04,007,0240,474,844,11,855,1268,123456,2,1,2,0,1,0,71.76 ,67.43,50.00 
02,000,04,007,0241,475,1052,19,1071,1553,123456,2,1,2,0,1,0,71.76 ,68.96,50.00 
02,000,04,007,0242,476,491,9,500,747,123456,2,1,2,0,1,0,71.76 ,66.93,50.00 
02,000,04,007,0243,477,537,11,548,908,123456,2,1,2,0,1,0,71.76 ,60.35,50.00 
02,000,04,007,0244,478,666,8,674,1025,123456,2,1,2,0,1,0,71.76 ,65.76,50.00 
02,000,04,007,0244,479,682,11,693,1019,123456,2,1,2,0,1,0,71.76 ,68.01,50.00 
02,000,04,007,0245,480,668,14,682,995,123456,2,1,2,0,1,0,71.76 ,68.54,50.00 
02,000,04,007,0246,481,540,9,549,762,123456,2,1,2,0,1,0,71.76 ,72.05,50.00 
02,000,04,007,0247,482,900,15,915,1405,123456,2,1,2,0,1,0,71.76 ,65.12,50.00 
02,000,04,007,0248,483,657,12,669,1027,123456,2,1,2,0,1,0,71.76 ,65.14,50.00 
02,000,04,007,0249,484,814,11,825,1132,123456,2,1,2,0,1,0,71.76 ,72.88,50.00 
02,000,04,007,0249,485,599,11,610,888,123456,2,1,2,0,1,0,71.76 ,68.69,50.00 
02,000,04,007,0250,486,980,20,1000,1478,123456,2,1,2,0,1,0,71.76 ,67.66,50.00 
02,000,04,007,0250,487,729,14,743,1102,123456,2,1,2,0,1,0,71.76 ,67.42,50.00 
02,000,04,007,0251,488,779,11,790,1179,123456,2,1,2,0,1,0,71.76 ,67.01,50.00 
02,000,04,007,0251,489,792,8,800,1147,123456,2,1,2,0,1,0,71.76 ,69.75,50.00 
02,000,04,007,0252,490,612,7,619,847,123456,2,1,2,0,1,0,71.76 ,73.08,50.00 
02,000,04,007,0252,491,573,14,587,894,123456,2,1,2,0,1,0,71.76 ,65.66,50.00 
02,000,04,007,0253,492,1008,18,1026,1488,123456,2,1,2,0,1,0,71.76 ,68.95,50.00 
02,000,04,007,0253,493,1065,30,1095,1547,123456,2,1,2,0,1,0,71.76 ,70.78,50.00 
02,000,04,007,0254,494,779,15,794,1160,123456,2,1,2,0,1,0,71.76 ,68.45,50.00 
02,000,04,007,0255,495,690,17,707,1112,123456,2,1,2,0,1,0,71.76 ,63.58,50.00 
02,000,04,007,0256,496,589,11,600,905,123456,2,1,2,0,1,0,71.76 ,66.3,50.00 
02,000,04,007,0257,497,550,6,556,857,123456,2,1,2,0,1,0,71.76 ,64.88,50.00 
02,000,04,007,0258,498,724,16,740,1038,123456,2,1,2,0,1,0,71.76 ,71.29,50.00 
02,000,04,007,0258,499,804,13,817,1146,123456,2,1,2,0,1,0,71.76 ,71.29,50.00 
02,000,04,007,0259,500,711,14,725,1400,123456,2,1,2,0,1,0,71.76 ,51.79,50.00 
02,000,04,007,0259,501,884,19,903,1425,123456,2,1,2,0,1,0,71.76 ,63.37,50.00 
02,000,04,007,0260,502,525,9,534,820,123456,2,1,2,0,1,0,71.76 ,65.12,50.00 
02,000,04,007,0261,503,750,15,765,1137,123456,2,1,2,0,1,0,71.76 ,67.28,50.00 
02,000,04,007,0262,504,625,10,635,948,123456,2,1,2,0,1,0,71.76 ,66.98,50.00 
02,000,04,007,0263,505,627,14,641,966,123456,2,1,2,0,1,0,71.76 ,66.36,50.00 
02,000,04,007,0264,506,577,11,588,881,123456,2,1,2,0,1,0,71.76 ,66.74,50.00 
02,000,04,007,0265,507,606,18,624,944,123456,2,1,2,0,1,0,71.76 ,66.1,50.00 
02,000,04,007,0266,508,599,18,617,850,123456,2,1,2,0,1,0,71.76 ,72.59,50.00 
02,000,04,007,0267,509,565,11,576,822,123456,2,1,2,0,1,0,71.76 ,70.07,50.00 
02,000,04,007,0268,510,861,13,874,1273,123456,2,1,2,0,1,0,71.76 ,68.66,50.00 
02,000,04,008,0269,511,519,11,530,753,123456,2,1,2,0,1,0,71.76 ,70.39,50.00 
02,000,04,008,0270,512,743,20,763,1118,123456,2,1,2,0,1,0,71.76 ,68.25,50.00 
02,000,04,008,0271,513,951,11,962,1395,123456,2,1,2,0,1,0,71.76 ,68.96,50.00 
02,000,04,008,0272,514,562,9,571,886,123456,2,1,2,0,1,0,71.76 ,64.45,50.00 
02,000,04,008,0273,515,619,12,631,948,123456,2,1,2,0,1,0,71.76 ,66.56,50.00 
02,000,04,008,0274,516,954,13,967,1403,123456,2,1,2,0,1,0,71.76 ,68.92,50.00 
02,000,04,008,0274,517,1060,24,1084,1640,123456,2,1,2,0,1,0,71.76 ,66.1,50.00 
02,000,04,008,0275,518,571,10,581,907,123456,2,1,2,0,1,0,71.76 ,64.06,50.00 
02,000,04,008,0276,519,712,6,718,1137,123456,2,1,2,0,1,0,71.76 ,63.15,50.00 
02,000,04,008,0277,520,893,16,909,1458,123456,2,1,2,0,1,0,71.76 ,62.35,50.00 
02,000,04,008,0278,521,467,8,475,732,123456,2,1,2,0,1,0,71.76 ,64.89,50.00 
02,000,04,008,0279,522,694,8,702,1055,123456,2,1,2,0,1,0,71.76 ,66.54,50.00 
02,000,04,008,0280,523,750,16,766,1262,123456,2,1,2,0,1,0,71.76 ,60.7,50.00 
02,000,04,008,0281,524,720,19,739,1073,123456,2,1,2,0,1,0,71.76 ,68.87,50.00 
02,000,04,008,0282,525,572,8,580,838,123456,2,1,2,0,1,0,71.76 ,69.21,50.00 
02,000,04,008,0282,526,584,11,595,852,123456,2,1,2,0,1,0,71.76 ,69.84,50.00 
02,000,04,008,0283,527,764,12,776,1169,123456,2,1,2,0,1,0,71.76 ,66.38,50.00 
02,000,04,008,0284,528,604,9,613,930,123456,2,1,2,0,1,0,71.76 ,65.91,50.00 
02,000,04,008,0285,529,954,18,972,1520,123456,2,1,2,0,1,0,71.76 ,63.95,50.00 
02,000,04,008,0286,530,851,19,870,1255,123456,2,1,2,0,1,0,71.76 ,69.32,50.00 
02,000,04,008,0287,531,729,7,736,1070,123456,2,1,2,0,1,0,71.76 ,68.79,50.00 
02,000,04,008,0288,532,864,25,889,1317,123456,2,1,2,0,1,0,71.76 ,67.5,50.00 
02,000,04,009,0289,533,434,9,443,605,123456,2,1,2,0,1,0,71.76 ,73.22,50.00 
02,000,04,009,0290,534,867,20,887,1271,123456,2,1,2,0,1,0,71.76 ,69.79,50.00 
02,000,04,009,0291,535,1008,9,1017,1383,123456,2,1,2,0,1,0,71.76 ,73.54,50.00 
02,000,04,009,0292,536,1082,16,1098,1627,123456,2,1,2,0,1,0,71.76 ,67.49,50.00 
02,000,04,009,0293,537,995,16,1011,1470,123456,2,1,2,0,1,0,71.76 ,68.78,50.00 
02,000,04,009,0294,538,1037,23,1060,1577,123456,2,1,2,0,1,0,71.76 ,67.22,50.00 
02,000,04,009,0295,539,1017,22,1039,1550,123456,2,1,2,0,1,0,71.76 ,67.03,50.00 
02,000,04,009,0296,540,457,10,467,673,123456,2,1,2,0,1,0,71.76 ,69.39,50.00 
02,000,04,009,0297,541,666,18,684,1113,123456,2,1,2,0,1,0,71.76 ,61.46,50.00 
02,000,04,009,0297,542,575,13,588,868,123456,2,1,2,0,1,0,71.76 ,67.74,50.00 
02,000,04,009,0298,543,838,12,850,1362,123456,2,1,2,0,1,0,71.76 ,62.41,50.00 
02,000,04,009,0298,544,904,19,923,1559,123456,2,1,2,0,1,0,71.76 ,59.2,50.00 
02,000,04,009,0299,545,777,16,793,1080,123456,2,1,2,0,1,0,71.76 ,73.43,50.00 
02,000,04,009,0300,546,953,10,963,1377,123456,2,1,2,0,1,0,71.76 ,69.93,50.00 
02,000,04,009,0301,547,659,11,670,976,123456,2,1,2,0,1,0,71.76 ,68.65,50.00 
02,000,04,009,0301,548,547,6,553,880,123456,2,1,2,0,1,0,71.76 ,62.84,50.00 
02,000,04,009,0302,549,854,15,869,1327,123456,2,1,2,0,1,0,71.76 ,65.49,50.00 
02,000,04,009,0303,550,753,14,767,1057,123456,2,1,2,0,1,0,71.76 ,72.56,50.00 
02,000,04,009,0303,551,672,16,688,921,123456,2,1,2,0,1,0,71.76 ,74.7,50.00 
02,000,04,009,0304,552,819,17,836,1231,123456,2,1,2,0,1,0,71.76 ,67.91,50.00 
02,000,04,009,0305,553,993,14,1007,1493,123456,2,1,2,0,1,0,71.76 ,67.45,50.00 
02,000,04,009,0305,554,948,14,962,1444,123456,2,1,2,0,1,0,71.76 ,66.62,50.00 
02,000,04,009,0306,555,801,28,829,1178,123456,2,1,2,0,1,0,71.76 ,70.37,50.00 
02,000,04,009,0306,556,682,15,697,1036,123456,2,1,2,0,1,0,71.76 ,67.28,50.00 
02,000,04,009,0307,557,851,15,866,1241,123456,2,1,2,0,1,0,71.76 ,69.78,50.00 
02,000,04,009,0307,558,878,15,893,1339,123456,2,1,2,0,1,0,71.76 ,66.69,50.00 
02,000,04,009,0308,559,684,9,693,975,123456,2,1,2,0,1,0,71.76 ,71.08,50.00 
02,000,04,009,0308,560,797,9,806,1159,123456,2,1,2,0,1,0,71.76 ,69.54,50.00 
02,000,04,009,0309,561,791,17,808,1899,123456,2,1,2,0,1,0,71.76 ,42.55,50.00 
02,000,04,009,0310,562,979,19,998,1466,123456,2,1,2,0,1,0,71.76 ,68.08,50.00 
02,000,04,009,0310,563,922,11,933,1389,123456,2,1,2,0,1,0,71.76 ,67.17,50.00 
02,000,04,009,0311,564,608,15,623,903,123456,2,1,2,0,1,0,71.76 ,68.99,50.00 
02,000,04,009,0311,565,644,11,655,942,123456,2,1,2,0,1,0,71.76 ,69.53,50.00 
02,000,04,009,0312,566,714,19,733,1083,123456,2,1,2,0,1,0,71.76 ,67.68,50.00 
02,000,04,009,0312,567,737,18,755,1106,123456,2,1,2,0,1,0,71.76 ,68.26,50.00 
02,000,04,009,0313,568,1062,14,1076,1540,123456,2,1,2,0,1,0,71.76 ,69.87,50.00 
02,000,04,009,0314,569,527,11,538,756,123456,2,1,2,0,1,0,71.76 ,71.16,50.00 
02,000,04,009,0315,570,985,19,1004,1405,123456,2,1,2,0,1,0,71.76 ,71.46,50.00 
02,000,04,009,0316,571,1031,25,1056,1519,123456,2,1,2,0,1,0,71.76 ,69.52,50.00 
02,000,04,009,0316,572,922,15,937,1420,123456,2,1,2,0,1,0,71.76 ,65.99,50.00 
02,000,04,009,0317,573,1120,24,1144,1710,123456,2,1,2,0,1,0,71.76 ,66.9,50.00 
02,000,04,009,0318,574,1029,24,1053,1530,123456,2,1,2,0,1,0,71.76 ,68.82,50.00 
02,000,04,009,0318,575,1108,22,1130,1642,123456,2,1,2,0,1,0,71.76 ,68.82,50.00 
02,000,04,009,0319,576,1230,20,1250,1834,123456,2,1,2,0,1,0,71.76 ,68.16,50.00 
02,000,04,009,0320,577,1003,19,1022,1530,123456,2,1,2,0,1,0,71.76 ,66.8,50.00 
02,000,04,009,0320,578,904,21,925,1369,123456,2,1,2,0,1,0,71.76 ,67.57,50.00 
02,000,04,009,0321,579,830,19,849,1276,123456,2,1,2,0,1,0,71.76 ,66.54,50.00 
02,000,04,009,0321,580,875,13,888,1331,123456,2,1,2,0,1,0,71.76 ,66.72,50.00 
02,000,04,009,0322,581,942,12,954,1429,123456,2,1,2,0,1,0,71.76 ,66.76,50.00 
02,000,04,009,0323,582,745,18,763,1092,123456,2,1,2,0,1,0,71.76 ,69.87,50.00 
02,000,04,009,0323,583,613,13,626,912,123456,2,1,2,0,1,0,71.76 ,68.64,50.00 
02,000,04,009,0324,584,1331,22,1353,1848,123456,2,1,2,0,1,0,71.76 ,73.21,50.00 
02,000,04,009,0325,585,669,17,686,1055,123456,2,1,2,0,1,0,71.76 ,65.02,50.00 
02,000,04,009,0325,586,890,25,915,1313,123456,2,1,2,0,1,0,71.76 ,69.69,50.00 
02,000,04,009,0326,587,1135,8,1143,1611,123456,2,1,2,0,1,0,71.76 ,70.95,50.00 
02,000,04,009,0327,588,1062,13,1075,1526,123456,2,1,2,0,1,0,71.76 ,70.45,50.00 
02,000,04,009,0328,589,785,13,798,1119,123456,2,1,2,0,1,0,71.76 ,71.31,50.00 
02,000,04,009,0328,590,759,13,772,1140,123456,2,1,2,0,1,0,71.76 ,67.72,50.00 
02,000,04,009,0329,591,639,11,650,949,123456,2,1,2,0,1,0,71.76 ,68.49,50.00 
02,000,04,009,0329,592,702,17,719,1008,123456,2,1,2,0,1,0,71.76 ,71.33,50.00 
02,000,04,009,0330,593,848,17,865,1292,123456,2,1,2,0,1,0,71.76 ,66.95,50.00 
02,000,04,009,0330,594,767,13,780,1185,123456,2,1,2,0,1,0,71.76 ,65.82,50.00 
02,000,04,009,0330,595,891,15,906,1345,123456,2,1,2,0,1,0,71.76 ,67.36,50.00 
02,000,04,009,0331,596,631,12,643,941,123456,2,1,2,0,1,0,71.76 ,68.33,50.00 
02,000,04,009,0331,597,573,7,580,877,123456,2,1,2,0,1,0,71.76 ,66.13,50.00 
02,000,04,009,0332,598,955,15,970,1349,123456,2,1,2,0,1,0,71.76 ,71.91,50.00 
02,000,04,009,0333,599,938,19,957,1382,123456,2,1,2,0,1,0,71.76 ,69.25,50.00 
02,000,04,009,0333,600,803,19,822,1182,123456,2,1,2,0,1,0,71.76 ,69.54,50.00 
02,000,04,009,0333,601,887,14,901,1349,123456,2,1,2,0,1,0,71.76 ,66.79,50.00 
02,000,04,009,0334,602,656,6,662,1012,123456,2,1,2,0,1,0,71.76 ,65.42,50.00 
02,000,04,009,0334,603,665,16,681,1016,123456,2,1,2,0,1,0,71.76 ,67.03,50.00 
02,000,04,009,0335,604,1077,9,1086,1538,123456,2,1,2,0,1,0,71.76 ,70.61,50.00 
02,000,04,009,0336,605,957,16,973,1458,123456,2,1,2,0,1,0,71.76 ,66.74,50.00 
02,000,04,009,0337,606,904,15,919,1444,123456,2,1,2,0,1,0,71.76 ,63.64,50.00 
02,000,04,009,0337,607,846,13,859,1249,123456,2,1,2,0,1,0,71.76 ,68.78,50.00 
02,000,04,009,0338,608,900,10,910,1308,123456,2,1,2,0,1,0,71.76 ,69.57,50.00 
02,000,04,009,0339,609,757,15,772,1075,123456,2,1,2,0,1,0,71.76 ,71.81,50.00 
02,000,04,009,0340,610,606,12,618,901,123456,2,1,2,0,1,0,71.76 ,68.59,50.00 
02,000,04,009,0340,611,682,9,691,991,123456,2,1,2,0,1,0,71.76 ,69.73,50.00 
02,000,04,009,0341,612,750,10,760,1085,123456,2,1,2,0,1,0,71.76 ,70.05,50.00 
02,000,04,009,0341,613,681,21,702,1000,123456,2,1,2,0,1,0,71.76 ,70.2,50.00 
02,000,04,009,0342,614,984,23,1007,1349,123456,2,1,2,0,1,0,71.76 ,74.65,50.00 
02,000,04,009,0342,615,986,17,1003,1469,123456,2,1,2,0,1,0,71.76 ,68.28,50.00 
02,000,04,009,0343,616,924,21,945,1319,123456,2,1,2,0,1,0,71.76 ,71.65,50.00 
02,000,04,009,0343,617,1020,22,1042,1472,123456,2,1,2,0,1,0,71.76 ,70.79,50.00 
02,000,04,009,0344,618,805,7,812,1159,123456,2,1,2,0,1,0,71.76 ,70.06,50.00 
02,000,04,009,0344,619,927,22,949,1389,123456,2,1,2,0,1,0,71.76 ,68.32,50.00 
02,000,04,009,0345,620,653,16,669,943,123456,2,1,2,0,1,0,71.76 ,70.94,50.00 
02,000,04,009,0345,621,670,19,689,979,123456,2,1,2,0,1,0,71.76 ,70.38,50.00 
02,000,04,009,0346,622,792,12,804,1143,123456,2,1,2,0,1,0,71.76 ,70.34,50.00 
02,000,04,009,0346,623,826,10,836,1228,123456,2,1,2,0,1,0,71.76 ,68.08,50.00 
02,000,04,009,0347,624,1219,20,1239,1826,123456,2,1,2,0,1,0,71.76 ,67.85,50.00 
02,000,04,009,0348,625,766,16,782,1143,123456,2,1,2,0,1,0,71.76 ,68.42,50.00 
02,000,04,009,0348,626,1076,23,1099,1561,123456,2,1,2,0,1,0,71.76 ,70.4,50.00 
02,000,04,009,0349,627,967,23,990,1540,123456,2,1,2,0,1,0,71.76 ,64.29,50.00 
02,000,04,009,0349,628,1029,17,1046,1536,123456,2,1,2,0,1,0,71.76 ,68.1,50.00 
02,000,04,009,0349,629,953,24,977,1522,123456,2,1,2,0,1,0,71.76 ,64.19,50.00 
02,000,04,009,0350,630,835,20,855,1216,123456,2,1,2,0,1,0,71.76 ,70.31,50.00 
02,000,04,009,0350,631,789,21,810,1263,123456,2,1,2,0,1,0,71.76 ,64.13,50.00 
02,000,04,009,0350,632,851,15,866,1321,123456,2,1,2,0,1,0,71.76 ,65.56,50.00 
02,000,04,009,0351,633,1148,26,1174,1820,123456,2,1,2,0,1,0,71.76 ,64.51,50.00 
02,000,04,009,0351,634,1188,17,1205,1790,123456,2,1,2,0,1,0,71.76 ,67.32,50.00 
02,000,04,009,0352,635,828,17,845,1297,123456,2,1,2,0,1,0,71.76 ,65.15,50.00 
02,000,04,009,0352,636,966,12,978,1456,123456,2,1,2,0,1,0,71.76 ,67.17,50.00 
02,000,04,009,0352,637,904,15,919,1418,123456,2,1,2,0,1,0,71.76 ,64.81,50.00 
02,000,04,009,0353,638,838,19,857,1230,123456,2,1,2,0,1,0,71.76 ,69.67,50.00 
02,000,04,009,0353,639,771,12,783,1174,123456,2,1,2,0,1,0,71.76 ,66.7,50.00 
02,000,04,009,0354,640,871,12,883,1244,123456,2,1,2,0,1,0,71.76 ,70.98,50.00 
02,000,04,009,0354,641,831,10,841,1277,123456,2,1,2,0,1,0,71.76 ,65.86,50.00 
02,000,04,009,0355,642,830,12,842,1176,123456,2,1,2,0,1,0,71.76 ,71.6,50.00 
02,000,04,009,0355,643,860,14,874,1272,123456,2,1,2,0,1,0,71.76 ,68.71,50.00 
02,000,04,009,0355,644,956,22,978,1361,123456,2,1,2,0,1,0,71.76 ,71.86,50.00 
02,000,04,009,0356,645,658,15,673,986,123456,2,1,2,0,1,0,71.76 ,68.26,50.00 
02,000,04,009,0356,646,724,14,738,1063,123456,2,1,2,0,1,0,71.76 ,69.43,50.00 
02,000,04,009,0357,647,682,9,691,1077,123456,2,1,2,0,1,0,71.76 ,64.16,50.00 
02,000,04,009,0357,648,662,10,672,1054,123456,2,1,2,0,1,0,71.76 ,63.76,50.00 
02,000,05,010,0358,649,904,21,925,1321,123456,2,1,2,0,1,0,71.76 ,70.02,50.00 
02,000,05,010,0358,650,1165,29,1194,1776,123456,2,1,2,0,1,0,71.76 ,67.23,50.00 
02,000,05,010,0358,651,1082,22,1104,1729,123456,2,1,2,0,1,0,71.76 ,63.85,50.00 
02,000,05,010,0358,652,1108,27,1135,1810,123456,2,1,2,0,1,0,71.76 ,62.71,50.00 
02,000,05,010,0358,653,1007,23,1030,1643,123456,2,1,2,0,1,0,71.76 ,62.69,50.00 
02,000,05,010,0359,654,1127,28,1155,1629,123456,2,1,2,0,1,0,71.76 ,70.9,50.00 
02,000,05,010,0359,655,547,17,564,851,123456,2,1,2,0,1,0,71.76 ,66.27,50.00 
02,000,05,010,0360,656,1146,19,1165,1668,123456,2,1,2,0,1,0,71.76 ,69.84,50.00 
02,000,05,010,0360,657,1048,25,1073,1598,123456,2,1,2,0,1,0,71.76 ,67.15,50.00 
02,000,05,010,0361,658,715,19,734,1017,123456,2,1,2,0,1,0,71.76 ,72.17,50.00 
02,000,05,010,0361,659,743,16,759,1051,123456,2,1,2,0,1,0,71.76 ,72.22,50.00 
02,000,05,010,0362,660,923,11,934,1381,123456,2,1,2,0,1,0,71.76 ,67.63,50.00 
02,000,05,010,0363,661,1214,23,1237,1807,123456,2,1,2,0,1,0,71.76 ,68.46,50.00 
02,000,05,010,0364,662,1167,19,1186,2404,123456,2,1,2,0,1,0,71.76 ,49.33,50.00 
02,000,05,010,0365,663,413,11,424,661,123456,2,1,2,0,1,0,71.76 ,64.15,50.00 
02,000,05,010,0366,664,1107,20,1127,1700,123456,2,1,2,0,1,0,71.76 ,66.29,50.00 
02,000,05,010,0367,665,1058,26,1084,1527,123456,2,1,2,0,1,0,71.76 ,70.99,50.00 
02,000,05,010,0368,666,682,15,697,1045,123456,2,1,2,0,1,0,71.76 ,66.7,50.00 
02,000,05,010,0368,667,851,15,866,1311,123456,2,1,2,0,1,0,71.76 ,66.06,50.00 
02,000,05,010,0369,668,869,15,884,1216,123456,2,1,2,0,1,0,71.76 ,72.7,50.00 
02,000,05,010,0370,669,544,8,552,750,123456,2,1,2,0,1,0,71.76 ,73.6,50.00 
02,000,05,010,0371,670,550,13,563,855,123456,2,1,2,0,1,0,71.76 ,65.85,50.00 
02,000,05,010,0372,671,1093,30,1123,1533,123456,2,1,2,0,1,0,71.76 ,73.26,50.00 
02,000,05,010,0373,672,1327,38,1365,1862,123456,2,1,2,0,1,0,71.76 ,73.31,50.00 
02,000,05,010,0374,673,901,17,918,1260,123456,2,1,2,0,1,0,71.76 ,72.86,50.00 
02,000,05,010,0374,674,643,17,660,989,123456,2,1,2,0,1,0,71.76 ,66.73,50.00 
02,000,05,010,0375,675,579,18,597,846,123456,2,1,2,0,1,0,71.76 ,70.57,50.00 
02,000,05,010,0375,676,792,19,811,1191,123456,2,1,2,0,1,0,71.76 ,68.09,50.00 
02,000,05,010,0376,677,668,21,689,1055,123456,2,1,2,0,1,0,71.76 ,65.31,50.00 
02,000,05,010,0376,678,868,22,890,1384,123456,2,1,2,0,1,0,71.76 ,64.31,50.00 
02,000,05,010,0376,679,988,18,1006,1561,123456,2,1,2,0,1,0,71.76 ,64.45,50.00 
02,000,05,010,0377,680,785,20,805,1075,123456,2,1,2,0,1,0,71.76 ,74.88,50.00 
02,000,05,010,0378,681,718,21,739,1063,123456,2,1,2,0,1,0,71.76 ,69.52,50.00 
02,000,05,010,0378,682,666,17,683,1006,123456,2,1,2,0,1,0,71.76 ,67.89,50.00 
02,000,05,010,0379,683,625,23,648,871,123456,2,1,2,0,1,0,71.76 ,74.4,50.00 
02,000,05,010,0380,684,792,22,814,1056,123456,2,1,2,0,1,0,71.76 ,77.08,50.00 
02,000,05,010,0381,685,1114,12,1126,1546,123456,2,1,2,0,1,0,71.76 ,72.83,50.00 
02,000,05,010,0381,686,1147,17,1164,1625,123456,2,1,2,0,1,0,71.76 ,71.63,50.00 
02,000,05,010,0381,687,1159,23,1182,1739,123456,2,1,2,0,1,0,71.76 ,67.97,50.00 
02,000,05,010,0382,688,746,17,763,1017,123456,2,1,2,0,1,0,71.76 ,75.02,50.00 
02,000,05,010,0382,689,778,16,794,1031,123456,2,1,2,0,1,0,71.76 ,77.01,50.00 
02,000,05,010,0383,690,1120,40,1160,1711,123456,2,1,2,0,1,0,71.76 ,67.8,50.00 
02,000,05,010,0383,691,1162,19,1181,1686,123456,2,1,2,0,1,0,71.76 ,70.05,50.00 
02,000,05,010,0384,692,849,24,873,1215,123456,2,1,2,0,1,0,71.76 ,71.85,50.00 
02,000,05,010,0384,693,960,24,984,1347,123456,2,1,2,0,1,0,71.76 ,73.05,50.00 
02,000,05,010,0384,694,853,25,878,1297,123456,2,1,2,0,1,0,71.76 ,67.69,50.00 
02,000,05,010,0385,695,566,16,582,835,123456,2,1,2,0,1,0,71.76 ,69.7,50.00 
02,000,05,010,0386,696,1412,34,1446,2056,123456,2,1,2,0,1,0,71.76 ,70.33,50.00 
02,000,05,010,0387,697,874,11,885,1264,123456,2,1,2,0,1,0,71.76 ,70.02,50.00 
02,000,05,010,0387,698,888,23,911,1351,123456,2,1,2,0,1,0,71.76 ,67.43,50.00 
02,000,05,010,0388,699,1298,27,1325,1904,123456,2,1,2,0,1,0,71.76 ,69.59,50.00 
02,000,05,010,0389,700,794,25,819,1285,123456,2,1,2,0,1,0,71.76 ,63.74,50.00 
02,000,05,010,0389,701,739,19,758,1212,123456,2,1,2,0,1,0,71.76 ,62.54,50.00 
02,000,05,010,0390,702,908,20,928,1404,123456,2,1,2,0,1,0,71.76 ,66.1,50.00 
02,000,05,010,0390,703,904,39,943,1479,123456,2,1,2,0,1,0,71.76 ,63.76,50.00 
02,000,05,010,0391,704,993,22,1015,1510,123456,2,1,2,0,1,0,71.76 ,67.22,50.00 
02,000,05,010,0391,705,826,24,850,1432,123456,2,1,2,0,1,0,71.76 ,59.36,50.00 
02,000,05,010,0392,706,993,22,1015,1533,123456,2,1,2,0,1,0,71.76 ,66.21,50.00 
02,000,05,010,0392,707,1006,28,1034,1576,123456,2,1,2,0,1,0,71.76 ,65.61,50.00 
02,000,05,010,0392,708,1053,38,1091,1654,123456,2,1,2,0,1,0,71.76 ,65.96,50.00 
02,000,05,010,0393,709,774,25,799,1164,123456,2,1,2,0,1,0,71.76 ,68.64,50.00 
02,000,05,010,0393,710,803,17,820,1149,123456,2,1,2,0,1,0,71.76 ,71.37,50.00 
02,000,05,010,0394,711,866,12,878,1305,123456,2,1,2,0,1,0,71.76 ,67.28,50.00 
02,000,05,010,0394,712,1025,19,1044,1464,123456,2,1,2,0,1,0,71.76 ,71.31,50.00 
02,000,05,010,0395,713,867,24,891,1212,123456,2,1,2,0,1,0,71.76 ,73.51,50.00 
02,000,05,010,0395,714,916,11,927,1314,123456,2,1,2,0,1,0,71.76 ,70.55,50.00 
02,000,05,010,0396,715,624,15,639,1052,123456,2,1,2,0,1,0,71.76 ,60.74,50.00 
02,000,05,010,0396,716,681,24,705,1040,123456,2,1,2,0,1,0,71.76 ,67.79,50.00 
02,000,05,010,0397,717,1029,35,1064,1731,123456,2,1,2,0,1,0,71.76 ,61.47,50.00 
02,000,05,010,0397,718,1165,24,1189,1755,123456,2,1,2,0,1,0,71.76 ,67.75,50.00 
02,000,05,010,0398,719,737,15,752,1131,123456,2,1,2,0,1,0,71.76 ,66.49,50.00 
02,000,05,010,0398,720,579,14,593,905,123456,2,1,2,0,1,0,71.76 ,65.52,50.00 
02,000,05,010,0399,721,845,29,874,1190,123456,2,1,2,0,1,0,71.76 ,73.45,50.00 
02,000,05,010,0399,722,915,24,939,1314,123456,2,1,2,0,1,0,71.76 ,71.46,50.00 
02,000,05,010,0399,723,902,26,928,1305,123456,2,1,2,0,1,0,71.76 ,71.11,50.00 
02,000,05,010,0400,724,925,27,952,1453,123456,2,1,2,0,1,0,71.76 ,65.52,50.00 
02,000,05,010,0400,725,1002,19,1021,1492,123456,2,1,2,0,1,0,71.76 ,68.43,50.00 
02,000,05,010,0401,726,876,37,913,1315,123456,2,1,2,0,1,0,71.76 ,69.43,50.00 
02,000,05,010,0402,727,1021,20,1041,1482,123456,2,1,2,0,1,0,71.76 ,70.24,50.00 
02,000,05,010,0402,728,921,22,943,1391,123456,2,1,2,0,1,0,71.76 ,67.79,50.00 
02,000,05,010,0402,729,1074,29,1103,1594,123456,2,1,2,0,1,0,71.76 ,69.2,50.00 
02,000,05,010,0403,730,973,26,999,1436,123456,2,1,2,0,1,0,71.76 ,69.57,50.00 
02,000,05,010,0403,731,814,18,832,1168,123456,2,1,2,0,1,0,71.76 ,71.23,50.00 
02,000,05,010,0404,732,1085,24,1109,1624,123456,2,1,2,0,1,0,71.76 ,68.29,50.00 
02,000,05,010,0404,733,1108,26,1134,1620,123456,2,1,2,0,1,0,71.76 ,70,50.00 
02,000,05,010,0404,734,953,18,971,1383,123456,2,1,2,0,1,0,71.76 ,70.21,50.00 
02,000,05,010,0405,735,800,16,816,1179,123456,2,1,2,0,1,0,71.76 ,69.21,50.00 
02,000,05,010,0405,736,833,24,857,1165,123456,2,1,2,0,1,0,71.76 ,73.56,50.00 
02,000,05,010,0406,737,611,14,625,908,123456,2,1,2,0,1,0,71.76 ,68.83,50.00 
02,000,05,010,0406,738,672,23,695,1054,123456,2,1,2,0,1,0,71.76 ,65.94,50.00 
02,000,05,010,0407,739,849,14,863,1208,123456,2,1,2,0,1,0,71.76 ,71.44,50.00 
02,000,05,010,0407,740,847,20,867,1190,123456,2,1,2,0,1,0,71.76 ,72.86,50.00 
02,000,05,010,0407,741,818,16,834,1241,123456,2,1,2,0,1,0,71.76 ,67.2,50.00 
02,000,05,010,0408,742,779,10,789,1183,123456,2,1,2,0,1,0,71.76 ,66.69,50.00 
02,000,05,010,0408,743,669,15,684,1014,123456,2,1,2,0,1,0,71.76 ,67.46,50.00 
02,000,05,010,0408,744,770,18,788,1201,123456,2,1,2,0,1,0,71.76 ,65.61,50.00 
02,000,05,010,0409,745,962,17,979,1431,123456,2,1,2,0,1,0,71.76 ,68.41,50.00 
02,000,05,010,0409,746,961,25,986,1485,123456,2,1,2,0,1,0,71.76 ,66.4,50.00 
02,000,05,010,0410,747,950,18,968,1369,123456,2,1,2,0,1,0,71.76 ,70.71,50.00 
02,000,05,010,0410,748,834,15,849,1166,123456,2,1,2,0,1,0,71.76 ,72.81,50.00 
02,000,05,010,0411,749,868,8,876,1217,123456,2,1,2,0,1,0,71.76 ,71.98,50.00 
02,000,05,010,0411,750,812,17,829,1273,123456,2,1,2,0,1,0,71.76 ,65.12,50.00 
02,000,05,010,0412,751,862,20,882,1330,123456,2,1,2,0,1,0,71.76 ,66.32,50.00 
02,000,05,010,0412,752,792,13,805,1229,123456,2,1,2,0,1,0,71.76 ,65.5,50.00 
02,000,05,010,0413,753,864,17,881,1314,123456,2,1,2,0,1,0,71.76 ,67.05,50.00 
02,000,05,010,0413,754,773,13,786,1182,123456,2,1,2,0,1,0,71.76 ,66.5,50.00 
02,000,05,010,0414,755,815,21,836,1251,123456,2,1,2,0,1,0,71.76 ,66.83,50.00 
02,000,05,010,0414,756,745,19,764,1140,123456,2,1,2,0,1,0,71.76 ,67.02,50.00 
02,000,05,010,0415,757,874,22,896,1401,123456,2,1,2,0,1,0,71.76 ,63.95,50.00 
02,000,05,010,0415,758,918,20,938,1450,123456,2,1,2,0,1,0,71.76 ,64.69,50.00 
02,000,05,010,0415,759,847,26,873,1351,123456,2,1,2,0,1,0,71.76 ,64.62,50.00 
02,000,05,010,0416,760,881,14,895,1332,123456,2,1,2,0,1,0,71.76 ,67.19,50.00 
02,000,05,010,0416,761,868,19,887,1380,123456,2,1,2,0,1,0,71.76 ,64.28,50.00 
02,000,05,011,0417,762,1336,18,1354,1960,123456,2,1,2,0,1,0,71.76 ,69.08,50.00 
02,000,05,011,0418,763,1112,19,1131,1729,123456,2,1,2,0,1,0,71.76 ,65.41,50.00 
02,000,05,011,0418,764,1008,22,1030,1510,123456,2,1,2,0,1,0,71.76 ,68.21,50.00 
02,000,05,011,0419,765,764,16,780,1177,123456,2,1,2,0,1,0,71.76 ,66.27,50.00 
02,000,05,011,0419,766,881,21,902,1290,123456,2,1,2,0,1,0,71.76 ,69.92,50.00 
02,000,05,011,0420,767,1120,19,1139,1568,123456,2,1,2,0,1,0,71.76 ,72.64,50.00 
02,000,05,011,0421,768,1053,19,1072,1519,123456,2,1,2,0,1,0,71.76 ,70.57,50.00 
02,000,05,011,0421,769,967,15,982,1391,123456,2,1,2,0,1,0,71.76 ,70.6,50.00 
02,000,05,011,0422,770,1393,19,1412,2006,123456,2,1,2,0,1,0,71.76 ,70.39,50.00 
02,000,05,011,0423,771,1125,23,1148,1922,123456,2,1,2,0,1,0,71.76 ,59.73,50.00 
02,000,05,011,0424,772,717,14,731,1043,123456,2,1,2,0,1,0,71.76 ,70.09,50.00 
02,000,05,011,0424,773,836,14,850,1205,123456,2,1,2,0,1,0,71.76 ,70.54,50.00 
02,000,05,011,0425,774,1235,25,1260,1984,123456,2,1,2,0,1,0,71.76 ,63.51,50.00 
02,000,05,011,0426,775,952,25,977,1502,123456,2,1,2,0,1,0,71.76 ,65.05,50.00 
02,000,05,011,0426,776,1143,19,1162,1745,123456,2,1,2,0,1,0,71.76 ,66.59,50.00 
02,000,05,011,0426,777,1175,9,1184,1828,123456,2,1,2,0,1,0,71.76 ,64.77,50.00 
02,000,05,011,0427,778,711,10,721,1101,123456,2,1,2,0,1,0,71.76 ,65.49,50.00 
02,000,05,011,0427,779,850,22,872,1257,123456,2,1,2,0,1,0,71.76 ,69.37,50.00 
02,000,05,011,0428,780,1112,24,1136,1676,123456,2,1,2,0,1,0,71.76 ,67.78,50.00 
02,000,05,011,0428,781,1162,21,1183,1769,123456,2,1,2,0,1,0,71.76 ,66.87,50.00 
02,000,05,011,0429,782,883,14,897,1368,123456,2,1,2,0,1,0,71.76 ,65.57,50.00 
02,000,05,011,0429,783,935,20,955,1351,123456,2,1,2,0,1,0,71.76 ,70.69,50.00 
02,000,05,011,0430,784,1147,23,1170,1813,123456,2,1,2,0,1,0,71.76 ,64.53,50.00 
02,000,05,011,0430,785,1213,16,1229,1802,123456,2,1,2,0,1,0,71.76 ,68.2,50.00 
02,000,05,011,0431,786,876,15,891,1428,123456,2,1,2,0,1,0,71.76 ,62.39,50.00 
02,000,05,011,0431,787,787,15,802,1219,123456,2,1,2,0,1,0,71.76 ,65.79,50.00 
02,000,05,011,0431,788,838,15,853,1299,123456,2,1,2,0,1,0,71.76 ,65.67,50.00 
02,000,05,011,0432,789,1440,21,1461,2096,123456,2,1,2,0,1,0,71.76 ,69.7,50.00 
02,000,05,011,0433,790,799,27,826,1242,123456,2,1,2,0,1,0,71.76 ,66.51,50.00 
02,000,05,011,0433,791,1074,17,1091,1633,123456,2,1,2,0,1,0,71.76 ,66.81,50.00 
02,000,05,011,0434,792,683,11,694,987,123456,2,1,2,0,1,0,71.76 ,70.31,50.00 
02,000,05,011,0434,793,877,20,897,1315,123456,2,1,2,0,1,0,71.76 ,68.21,50.00 
02,000,05,011,0435,794,1331,24,1355,1919,123456,2,1,2,0,1,0,71.76 ,70.61,50.00 
02,000,05,011,0436,795,1223,18,1241,1757,123456,2,1,2,0,1,0,71.76 ,70.63,50.00 
02,000,05,011,0436,796,1168,13,1181,1612,123456,2,1,2,0,1,0,71.76 ,73.26,50.00 
02,000,05,011,0437,797,838,10,848,1162,123456,2,1,2,0,1,0,71.76 ,72.98,50.00 
02,000,05,011,0437,798,978,25,1003,1420,123456,2,1,2,0,1,0,71.76 ,70.63,50.00 
02,000,05,011,0438,799,1030,13,1043,1588,123456,2,1,2,0,1,0,71.76 ,65.68,50.00 
02,000,05,011,0438,800,887,13,900,1361,123456,2,1,2,0,1,0,71.76 ,66.13,50.00 
02,000,05,011,0438,801,907,13,920,1368,123456,2,1,2,0,1,0,71.76 ,67.25,50.00 
02,000,05,011,0438,802,969,13,982,1437,123456,2,1,2,0,1,0,71.76 ,68.34,50.00 
02,000,05,011,0438,803,961,17,978,1484,123456,2,1,2,0,1,0,71.76 ,65.9,50.00 
02,000,05,011,0439,804,903,25,928,1484,123456,2,1,2,0,1,0,71.76 ,62.53,50.00 
02,000,05,011,0439,805,1153,23,1176,1704,123456,2,1,2,0,1,0,71.76 ,69.01,50.00 
02,000,05,011,0440,806,738,11,749,1073,123456,2,1,2,0,1,0,71.76 ,69.8,50.00 
02,000,05,011,0440,807,722,18,740,1153,123456,2,1,2,0,1,0,71.76 ,64.18,50.00 
02,000,05,011,0441,808,809,16,825,1175,123456,2,1,2,0,1,0,71.76 ,70.21,50.00 
02,000,05,011,0441,809,770,22,792,1119,123456,2,1,2,0,1,0,71.76 ,70.78,50.00 
02,000,05,011,0442,810,1008,18,1026,1515,123456,2,1,2,0,1,0,71.76 ,67.72,50.00 
02,000,05,011,0443,811,725,7,732,987,123456,2,1,2,0,1,0,71.76 ,74.16,50.00 
02,000,05,011,0443,812,962,21,983,1489,123456,2,1,2,0,1,0,71.76 ,66.02,50.00 
02,000,05,011,0444,813,805,11,816,1176,123456,2,1,2,0,1,0,71.76 ,69.39,50.00 
02,000,05,011,0444,814,701,10,711,1114,123456,2,1,2,0,1,0,71.76 ,63.82,50.00 
02,000,05,011,0444,815,577,13,590,910,123456,2,1,2,0,1,0,71.76 ,64.84,50.00 
02,000,05,011,0445,816,1324,34,1358,2054,123456,2,1,2,0,1,0,71.76 ,66.11,50.00 
02,000,05,011,0446,817,804,20,824,1164,123456,2,1,2,0,1,0,71.76 ,70.79,50.00 
02,000,05,011,0446,818,768,16,784,1128,123456,2,1,2,0,1,0,71.76 ,69.5,50.00 
02,000,05,011,0447,819,922,23,945,1447,123456,2,1,2,0,1,0,71.76 ,65.31,50.00 
02,000,05,011,0447,820,1053,28,1081,1591,123456,2,1,2,0,1,0,71.76 ,67.94,50.00 
02,000,05,011,0447,821,1010,21,1031,1651,123456,2,1,2,0,1,0,71.76 ,62.45,50.00 
02,000,05,011,0447,822,1013,18,1031,1549,123456,2,1,2,0,1,0,71.76 ,66.56,50.00 
02,000,05,011,0448,823,788,19,807,1245,123456,2,1,2,0,1,0,71.76 ,64.82,50.00 
02,000,05,011,0448,824,1006,25,1031,1627,123456,2,1,2,0,1,0,71.76 ,63.37,50.00 
02,000,05,011,0449,825,923,10,933,1238,123456,2,1,2,0,1,0,71.76 ,75.36,50.00 
02,000,05,011,0449,826,864,13,877,1186,123456,2,1,2,0,1,0,71.76 ,73.95,50.00 
02,000,05,011,0450,827,766,13,779,1086,123456,2,1,2,0,1,0,71.76 ,71.73,50.00 
02,000,05,011,0450,828,838,16,854,1191,123456,2,1,2,0,1,0,71.76 ,71.7,50.00 
02,000,05,011,0451,829,1179,19,1198,1727,123456,2,1,2,0,1,0,71.76 ,69.37,50.00 
02,000,05,011,0452,830,778,20,798,1150,123456,2,1,2,0,1,0,71.76 ,69.39,50.00 
02,000,05,011,0452,831,799,18,817,1165,123456,2,1,2,0,1,0,71.76 ,70.13,50.00 
02,000,05,011,0453,832,1299,23,1322,1787,123456,2,1,2,0,1,0,71.76 ,73.98,50.00 
02,000,05,011,0454,833,789,11,800,1088,123456,2,1,2,0,1,0,71.76 ,73.53,50.00 
02,000,05,011,0454,834,1048,19,1067,1602,123456,2,1,2,0,1,0,71.76 ,66.6,50.00 
02,000,05,011,0455,835,680,8,688,988,123456,2,1,2,0,1,0,71.76 ,69.64,50.00 
02,000,05,011,0456,836,377,1,378,548,123456,2,1,2,0,1,0,71.76 ,68.98,50.00 
02,000,05,011,0457,837,263,5,268,409,123456,2,1,2,0,1,0,71.76 ,65.53,50.00 
02,000,05,011,0458,838,354,5,359,549,123456,2,1,2,0,1,0,71.76 ,65.39,50.00 
02,000,05,011,0459,839,408,7,415,615,123456,2,1,2,0,1,0,71.76 ,67.48,50.00 
