00,000,00,000,0000,0,3741958 ,136621 ,3878579 ,7029578 ,9355283 ,8300 ,4074 ,7331 ,969 ,3658 ,416 ,75.14 ,55.18 ,49.08 
01,001,00,000,0000,0,201181 ,7918 ,209099 ,350480 ,461625 ,459 ,235 ,418 ,41 ,217 ,18 ,75.92 ,59.66 ,51.20 
01,002,00,000,0000,0,618232 ,21585 ,639817 ,1432871 ,1975721 ,963 ,482 ,801 ,162 ,400 ,82 ,72.52 ,44.65 ,50.05 
01,003,00,000,0000,0,197236 ,7812 ,205048 ,370160 ,510882 ,391 ,187 ,349 ,42 ,174 ,13 ,72.46 ,55.39 ,47.83 
01,004,00,000,0000,0,263474 ,9026 ,272500 ,425265 ,561744 ,586 ,274 ,541 ,45 ,258 ,16 ,75.70 ,64.08 ,46.76 
01,005,00,000,0000,0,591052 ,25554 ,616606 ,989345 ,1312467 ,1160 ,589 ,1058 ,102 ,536 ,53 ,75.38 ,62.32 ,50.78 
01,006,00,000,0000,0,234801 ,8338 ,243139 ,406951 ,530824 ,563 ,261 ,510 ,53 ,240 ,21 ,76.66 ,59.75 ,46.36 
01,007,00,000,0000,0,349046 ,14124 ,363170 ,557389 ,722795 ,749 ,386 ,680 ,69 ,360 ,26 ,77.12 ,65.16 ,51.54 
01,008,00,000,0000,0,277597 ,10465 ,288062 ,426630 ,547716 ,704 ,356 ,646 ,58 ,330 ,26 ,77.89 ,67.52 ,50.57 
01,009,00,000,0000,0,408321 ,14944 ,423265 ,679482 ,882640 ,958 ,464 ,833 ,125 ,416 ,48 ,76.98 ,62.29 ,48.43 
01,010,00,000,0000,0,103182 ,3807 ,106989 ,177801 ,232497 ,343 ,147 ,301 ,42 ,130 ,17 ,76.47 ,60.17 ,42.86 
01,011,00,000,0000,0,125160 ,5275 ,130435 ,258904 ,340964 ,414 ,177 ,345 ,69 ,142 ,35 ,75.93 ,50.38 ,42.75 
01,012,00,000,0000,0,43134 ,2637 ,45771 ,75632 ,96210 ,181 ,96 ,165 ,16 ,86 ,10 ,78.61 ,60.52 ,53.04 
01,013,00,000,0000,0,117283 ,1513 ,118796 ,297625 ,388321 ,296 ,157 ,233 ,63 ,137 ,20 ,73.31 ,41.35 ,42.00 
01,014,00,000,0000,0,94366 ,1302 ,95668 ,297872 ,413384 ,214 ,120 ,195 ,19 ,111 ,9 ,79.61 ,42.75 ,44.58 
01,015,00,000,0000,0,82140 ,836 ,82976 ,200688 ,273771 ,200 ,84 ,150 ,50 ,69 ,15 ,78.66 ,66.75 ,61.11 
02,001,00,000,0000,0,30734 ,1296 ,32030 ,74681 ,93803 ,83 ,37 ,78 ,5 ,36 ,1 ,79.61 ,42.89 ,44.58 
02,002,00,000,0000,0,5019 ,189 ,5208 ,7802 ,9919 ,36 ,22 ,28 ,8 ,16 ,6 ,78.66 ,66.75 ,61.11 
01,001,00,001,0000,0,32612 ,1583 ,34195 ,70246 ,95831 ,70 ,40 ,64 ,6 ,36 ,4 ,73.30 ,48.68 ,57.14 
01,001,00,002,0000,0,22243 ,1074 ,23317 ,52306 ,73038 ,42 ,23 ,35 ,7 ,20 ,3 ,71.61 ,44.58 ,54.76 
01,001,00,003,0000,0,22117 ,593 ,22710 ,34120 ,43305 ,57 ,26 ,53 ,4 ,25 ,1 ,78.79 ,66.56 ,45.61 
01,001,00,004,0000,0,17287 ,820 ,18107 ,24128 ,31161 ,46 ,24 ,44 ,2 ,23 ,1 ,77.43 ,75.05 ,52.17 
01,001,00,005,0000,0,18683 ,1005 ,19688 ,27958 ,35895 ,33 ,18 ,31 ,2 ,17 ,1 ,77.89 ,70.42 ,54.55 
01,001,00,006,0000,0,14300 ,435 ,14735 ,19661 ,25109 ,27 ,14 ,24 ,3 ,13 ,1 ,78.30 ,74.95 ,51.85 
01,001,00,007,0000,0,15066 ,512 ,15578 ,25224 ,32378 ,33 ,16 ,31 ,2 ,16 ,0 ,77.90 ,61.76 ,48.48 
01,001,00,008,0000,0,22170 ,906 ,23076 ,40338 ,52330 ,44 ,24 ,41 ,3 ,23 ,1 ,77.08 ,57.21 ,54.55 
01,001,00,009,0000,0,18733 ,485 ,19218 ,30587 ,38797 ,30 ,15 ,27 ,3 ,13 ,2 ,78.84 ,62.83 ,50.00 
01,001,00,010,0000,0,10735 ,410 ,11145 ,17279 ,21710 ,36 ,18 ,33 ,3 ,16 ,2 ,79.59 ,64.50 ,50.00 
01,001,00,011,0000,0,3697 ,49 ,3746 ,4407 ,6004 ,23 ,10 ,18 ,5 ,8 ,2 ,73.40 ,85.00 ,43.48 
01,001,00,012,0000,0,3538 ,46 ,3584 ,4226 ,6067 ,18 ,7 ,17 ,1 ,7 ,0 ,69.66 ,84.81 ,38.89 
01,002,00,001,0000,0,92540 ,3468 ,96008 ,286636 ,401096 ,158 ,76 ,124 ,34 ,57 ,19 ,71.46 ,33.49 ,48.10 
01,002,00,002,0000,0,39182 ,1635 ,40817 ,100654 ,135692 ,51 ,30 ,42 ,9 ,26 ,4 ,74.18 ,40.55 ,58.82 
01,002,00,003,0000,0,60096 ,2214 ,62310 ,130299 ,175319 ,91 ,48 ,77 ,14 ,44 ,4 ,74.32 ,47.82 ,52.75 
01,002,00,004,0000,0,41928 ,1193 ,43121 ,96446 ,138727 ,52 ,26 ,52 ,0 ,26 ,0 ,69.52 ,44.71 ,50.00 
01,002,00,005,0000,0,34346 ,1378 ,35724 ,58800 ,81309 ,33 ,18 ,32 ,1 ,18 ,0 ,72.32 ,60.76 ,54.55 
01,002,00,006,0000,0,35503 ,1253 ,36756 ,67426 ,91875 ,64 ,27 ,54 ,10 ,23 ,4 ,73.39 ,54.51 ,42.19 
01,002,00,007,0000,0,5896 ,164 ,6060 ,8047 ,10611 ,23 ,10 ,19 ,4 ,8 ,2 ,75.84 ,75.31 ,43.48 
01,002,00,008,0000,0,109923 ,3801 ,113724 ,264745 ,361386 ,164 ,84 ,139 ,25 ,71 ,13 ,73.26 ,42.96 ,51.22 
01,002,00,009,0000,0,61994 ,2744 ,64738 ,149217 ,206471 ,76 ,46 ,54 ,22 ,33 ,13 ,72.27 ,43.39 ,60.53 
01,002,00,010,0000,0,51468 ,1255 ,52723 ,106097 ,148562 ,98 ,41 ,79 ,19 ,30 ,11 ,71.42 ,49.69 ,41.84 
01,002,00,011,0000,0,35665 ,1549 ,37214 ,83472 ,114266 ,50 ,30 ,39 ,11 ,23 ,7 ,73.05 ,44.58 ,60.00 
01,002,00,012,0000,0,24268 ,535 ,24803 ,36959 ,49576 ,52 ,23 ,46 ,6 ,20 ,3 ,74.55 ,67.11 ,44.23 
01,002,00,013,0000,0,25423 ,396 ,25819 ,44073 ,60831 ,51 ,23 ,44 ,7 ,21 ,2 ,72.45 ,58.58 ,45.10 
01,003,00,001,0000,0,35454 ,1465 ,36919 ,94829 ,137861 ,47 ,26 ,43 ,4 ,25 ,1 ,68.79 ,38.93 ,55.32 
01,003,00,002,0000,0,33078 ,1514 ,34592 ,69109 ,97089 ,52 ,25 ,49 ,3 ,24 ,1 ,71.18 ,50.05 ,48.08 
01,003,00,003,0000,0,15884 ,482 ,16366 ,27899 ,36012 ,39 ,19 ,36 ,3 ,17 ,2 ,77.47 ,58.66 ,48.72 
01,003,00,004,0000,0,16726 ,571 ,17297 ,24849 ,32431 ,44 ,21 ,39 ,5 ,19 ,2 ,76.62 ,69.61 ,47.73 
01,003,00,005,0000,0,31166 ,1252 ,32418 ,54655 ,75546 ,47 ,20 ,36 ,11 ,16 ,4 ,72.35 ,59.31 ,42.55 
01,003,00,006,0000,0,20945 ,956 ,21901 ,37727 ,52761 ,41 ,17 ,36 ,5 ,16 ,1 ,71.51 ,58.05 ,41.46 
01,003,00,007,0000,0,10920 ,284 ,11204 ,15991 ,20963 ,24 ,12 ,23 ,1 ,12 ,0 ,76.28 ,70.06 ,50.00 
01,003,00,008,0000,0,8866 ,222 ,9088 ,11575 ,14772 ,21 ,11 ,19 ,2 ,11 ,0 ,78.36 ,78.51 ,52.38 
01,003,00,009,0000,0,5390 ,437 ,5827 ,8017 ,10289 ,13 ,9 ,13 ,0 ,9 ,0 ,77.92 ,72.68 ,69.23 
01,003,00,010,0000,0,6993 ,286 ,7279 ,10806 ,13998 ,19 ,10 ,15 ,4 ,9 ,1 ,77.20 ,67.36 ,52.63 
01,003,00,011,0000,0,4008 ,198 ,4206 ,5007 ,6133 ,13 ,6 ,13 ,0 ,6 ,0 ,81.64 ,84.00 ,46.15 
01,003,00,012,0000,0,4692 ,84 ,4776 ,5991 ,8351 ,20 ,7 ,20 ,0 ,7 ,0 ,71.74 ,79.72 ,35.00 
01,003,00,013,0000,0,3114 ,61 ,3175 ,3705 ,4676 ,11 ,4 ,7 ,4 ,3 ,1 ,79.23 ,85.70 ,36.36 
01,004,00,001,0000,0,34961 ,1309 ,36270 ,68651 ,90826 ,56 ,28 ,53 ,3 ,25 ,3 ,75.59 ,52.83 ,50.00 
01,004,00,002,0000,0,24386 ,577 ,24963 ,36824 ,49016 ,50 ,25 ,49 ,1 ,25 ,0 ,75.13 ,67.79 ,50.00 
01,004,00,003,0000,0,20141 ,393 ,20534 ,30064 ,38535 ,52 ,24 ,49 ,3 ,23 ,1 ,78.02 ,68.30 ,46.15 
01,004,00,004,0000,0,32121 ,1455 ,33576 ,56315 ,77344 ,60 ,25 ,52 ,8 ,23 ,2 ,72.81 ,59.62 ,41.67 
01,004,00,005,0000,0,37139 ,1051 ,38190 ,70401 ,96261 ,70 ,32 ,63 ,7 ,30 ,2 ,73.14 ,54.25 ,45.71 
01,004,00,006,0000,0,20565 ,821 ,21386 ,30456 ,39822 ,43 ,23 ,35 ,8 ,20 ,3 ,76.48 ,70.22 ,53.49 
01,004,00,007,0000,0,10205 ,439 ,10644 ,14681 ,18497 ,18 ,11 ,18 ,0 ,11 ,0 ,79.37 ,72.50 ,61.11 
01,004,00,008,0000,0,9410 ,333 ,9743 ,12591 ,16186 ,28 ,12 ,27 ,1 ,11 ,1 ,77.79 ,77.38 ,42.86 
01,004,00,009,0000,0,16461 ,490 ,16951 ,26310 ,34813 ,40 ,19 ,37 ,3 ,18 ,1 ,75.58 ,64.43 ,47.50 
01,004,00,010,0000,0,10235 ,410 ,10645 ,15212 ,19633 ,20 ,10 ,20 ,0 ,10 ,0 ,77.48 ,69.98 ,50.00 
01,004,00,011,0000,0,6028 ,226 ,6254 ,8919 ,11318 ,21 ,9 ,18 ,3 ,9 ,0 ,78.80 ,70.12 ,42.86 
01,004,00,012,0000,0,7075 ,214 ,7289 ,9275 ,11702 ,19 ,8 ,19 ,0 ,8 ,0 ,79.26 ,78.59 ,42.11 
01,004,00,013,0000,0,9517 ,503 ,10020 ,13521 ,17713 ,17 ,7 ,15 ,2 ,6 ,1 ,76.33 ,74.11 ,41.18 
01,004,00,014,0000,0,5129 ,253 ,5382 ,6469 ,7939 ,21 ,9 ,21 ,0 ,9 ,0 ,81.48 ,83.20 ,42.86 
01,004,00,015,0000,0,8232 ,195 ,8427 ,10731 ,13737 ,19 ,9 ,17 ,2 ,8 ,1 ,78.12 ,78.53 ,47.37 
01,004,00,016,0000,0,4409 ,132 ,4541 ,5897 ,7393 ,17 ,8 ,15 ,2 ,7 ,1 ,79.76 ,77.01 ,47.06 
01,004,00,017,0000,0,3276 ,177 ,3453 ,4257 ,5059 ,12 ,7 ,12 ,0 ,7 ,0 ,84.15 ,81.11 ,58.33 
01,004,00,018,0000,0,4184 ,48 ,4232 ,4691 ,5950 ,23 ,8 ,21 ,2 ,8 ,0 ,78.84 ,90.22 ,34.78 
01,005,00,001,0000,0,84130 ,3284 ,87414 ,174671 ,237160 ,150 ,73 ,135 ,15 ,67 ,6 ,73.65 ,50.04 ,48.67 
01,005,00,002,0000,0,20649 ,908 ,21557 ,35152 ,46238 ,42 ,18 ,38 ,4 ,16 ,2 ,76.02 ,61.33 ,42.86 
01,005,00,003,0000,0,15013 ,609 ,15622 ,19625 ,24980 ,36 ,15 ,33 ,3 ,13 ,2 ,78.56 ,79.60 ,41.67 
01,005,00,004,0000,0,35647 ,1732 ,37379 ,63355 ,85364 ,43 ,29 ,39 ,4 ,26 ,3 ,74.22 ,59.00 ,67.44 
01,005,00,005,0000,0,23460 ,1179 ,24639 ,36785 ,49130 ,40 ,22 ,38 ,2 ,20 ,2 ,74.87 ,66.98 ,55.00 
01,005,00,006,0000,0,18197 ,888 ,19085 ,28783 ,38985 ,31 ,14 ,28 ,3 ,13 ,1 ,73.83 ,66.31 ,45.16 
01,005,00,007,0000,0,36334 ,1704 ,38038 ,67249 ,89624 ,62 ,32 ,52 ,10 ,28 ,4 ,75.03 ,56.56 ,51.61 
01,005,00,008,0000,0,8842 ,348 ,9190 ,12955 ,17081 ,15 ,8 ,14 ,1 ,8 ,0 ,75.84 ,70.94 ,53.33 
01,005,00,009,0000,0,16366 ,772 ,17138 ,26603 ,35942 ,22 ,14 ,20 ,2 ,12 ,2 ,74.02 ,64.42 ,63.64 
01,005,00,010,0000,0,48541 ,1785 ,50326 ,93177 ,125838 ,86 ,41 ,72 ,14 ,32 ,9 ,74.05 ,54.01 ,47.67 
01,005,00,011,0000,0,18685 ,446 ,19131 ,28042 ,36646 ,34 ,16 ,33 ,1 ,15 ,1 ,76.52 ,68.22 ,47.06 
01,005,00,012,0000,0,20175 ,619 ,20794 ,30055 ,39607 ,57 ,24 ,56 ,1 ,23 ,1 ,75.88 ,69.19 ,42.11 
01,005,00,013,0000,0,28176 ,1209 ,29385 ,41412 ,56260 ,50 ,25 ,46 ,4 ,22 ,3 ,73.61 ,70.96 ,50.00 
01,005,00,014,0000,0,19125 ,609 ,19734 ,26637 ,34565 ,45 ,22 ,42 ,3 ,22 ,0 ,77.06 ,74.08 ,48.89 
01,005,00,015,0000,0,17516 ,728 ,18244 ,27304 ,35410 ,37 ,20 ,34 ,3 ,19 ,1 ,77.11 ,66.82 ,54.05 
01,005,00,016,0000,0,19209 ,1064 ,20273 ,34205 ,44499 ,47 ,22 ,40 ,7 ,17 ,5 ,76.87 ,59.27 ,46.81 
01,005,00,017,0000,0,20098 ,897 ,20995 ,34116 ,45038 ,48 ,24 ,44 ,4 ,22 ,2 ,75.75 ,61.54 ,50.00 
01,005,00,018,0000,0,9947 ,398 ,10345 ,13554 ,16749 ,39 ,17 ,34 ,5 ,15 ,2 ,80.92 ,76.32 ,43.59 
01,005,00,019,0000,0,15098 ,665 ,15763 ,25274 ,33631 ,25 ,15 ,23 ,2 ,14 ,1 ,75.15 ,62.37 ,60.00 
01,005,00,020,0000,0,16046 ,855 ,16901 ,24810 ,31862 ,35 ,19 ,33 ,2 ,19 ,0 ,77.87 ,68.12 ,54.29 
01,005,00,021,0000,0,14731 ,549 ,15280 ,21968 ,28890 ,36 ,20 ,36 ,0 ,20 ,0 ,76.04 ,69.56 ,55.56 
01,005,00,022,0000,0,16148 ,565 ,16713 ,24457 ,32008 ,34 ,17 ,30 ,4 ,14 ,3 ,76.41 ,68.34 ,50.00 
01,005,00,023,0000,0,27118 ,1803 ,28921 ,41686 ,54479 ,46 ,27 ,44 ,2 ,25 ,2 ,76.52 ,69.38 ,58.70 
01,005,00,024,0000,0,19945 ,1258 ,21203 ,29025 ,36637 ,41 ,26 ,40 ,1 ,26 ,0 ,79.22 ,73.05 ,63.41 
01,005,00,025,0000,0,11854 ,411 ,12265 ,15563 ,19151 ,28 ,15 ,25 ,3 ,14 ,1 ,81.26 ,78.81 ,53.57 
01,005,00,026,0000,0,10002 ,269 ,10271 ,12882 ,16693 ,31 ,14 ,29 ,2 ,14 ,0 ,77.17 ,79.73 ,45.16 
01,006,00,001,0000,0,39532 ,1987 ,41519 ,78543 ,104670 ,63 ,34 ,53 ,10 ,28 ,6 ,75.04 ,52.86 ,53.97 
01,006,00,002,0000,0,32828 ,1251 ,34079 ,65090 ,85779 ,68 ,33 ,65 ,3 ,32 ,1 ,75.88 ,52.36 ,48.53 
01,006,00,003,0000,0,41598 ,1399 ,42997 ,75588 ,100294 ,63 ,27 ,55 ,8 ,24 ,3 ,75.37 ,56.88 ,42.86 
01,006,00,004,0000,0,25467 ,629 ,26096 ,45711 ,58826 ,64 ,28 ,59 ,5 ,26 ,2 ,77.71 ,57.09 ,43.75 
01,006,00,005,0000,0,7221 ,283 ,7504 ,9677 ,12103 ,20 ,11 ,18 ,2 ,10 ,1 ,79.96 ,77.54 ,55.00 
01,006,00,006,0000,0,20045 ,557 ,20602 ,32220 ,41603 ,53 ,23 ,50 ,3 ,22 ,1 ,77.45 ,63.94 ,43.40 
01,006,00,007,0000,0,10189 ,430 ,10619 ,15707 ,19376 ,22 ,13 ,22 ,0 ,13 ,0 ,81.06 ,67.61 ,59.09 
01,006,00,008,0000,0,8563 ,285 ,8848 ,13340 ,16405 ,31 ,18 ,29 ,2 ,16 ,2 ,81.32 ,66.33 ,58.06 
01,006,00,009,0000,0,9253 ,283 ,9536 ,13946 ,17411 ,27 ,13 ,25 ,2 ,13 ,0 ,80.10 ,68.38 ,48.15 
01,006,00,010,0000,0,11632 ,294 ,11926 ,16809 ,20964 ,29 ,13 ,28 ,1 ,13 ,0 ,80.18 ,70.95 ,44.83 
01,006,00,011,0000,0,11158 ,363 ,11521 ,16247 ,20383 ,40 ,19 ,37 ,3 ,18 ,1 ,79.71 ,70.91 ,45.00 
01,006,00,012,0000,0,9177 ,465 ,9642 ,12615 ,17360 ,40 ,14 ,35 ,5 ,12 ,2 ,72.67 ,76.43 ,35.00 
01,006,00,013,0000,0,8138 ,112 ,8250 ,11458 ,15650 ,43 ,15 ,34 ,9 ,13 ,2 ,73.21 ,72.00 ,34.88 
01,007,00,001,0000,0,39329 ,2033 ,41362 ,78910 ,106723 ,75 ,38 ,71 ,4 ,37 ,1 ,73.94 ,52.42 ,50.67 
01,007,00,002,0000,0,22727 ,770 ,23497 ,36262 ,47461 ,50 ,22 ,46 ,4 ,20 ,2 ,76.40 ,64.80 ,44.00 
01,007,00,003,0000,0,31634 ,944 ,32578 ,52546 ,70259 ,62 ,29 ,56 ,6 ,28 ,1 ,74.79 ,62.00 ,46.77 
01,007,00,004,0000,0,23034 ,1021 ,24055 ,36689 ,48954 ,47 ,27 ,40 ,7 ,22 ,5 ,74.95 ,65.56 ,57.45 
01,007,00,005,0000,0,15873 ,798 ,16671 ,23740 ,30730 ,31 ,17 ,27 ,4 ,13 ,4 ,77.25 ,70.22 ,54.84 
01,007,00,006,0000,0,20187 ,1104 ,21291 ,33642 ,43537 ,55 ,28 ,46 ,9 ,24 ,4 ,77.27 ,63.29 ,50.91 
01,007,00,007,0000,0,16969 ,757 ,17726 ,26626 ,34598 ,36 ,20 ,35 ,1 ,20 ,0 ,76.96 ,66.57 ,55.56 
01,007,00,008,0000,0,11851 ,328 ,12179 ,16883 ,21533 ,29 ,15 ,24 ,5 ,13 ,2 ,78.41 ,72.14 ,51.72 
01,007,00,009,0000,0,16509 ,522 ,17031 ,23844 ,30715 ,29 ,14 ,24 ,5 ,13 ,1 ,77.63 ,71.43 ,48.28 
01,007,00,010,0000,0,10022 ,286 ,10308 ,15456 ,20089 ,23 ,10 ,19 ,4 ,10 ,0 ,76.94 ,66.69 ,43.48 
01,007,00,011,0000,0,15333 ,736 ,16069 ,23617 ,30076 ,34 ,18 ,32 ,2 ,18 ,0 ,78.52 ,68.04 ,52.94 
01,007,00,012,0000,0,12974 ,394 ,13368 ,21847 ,27755 ,29 ,14 ,29 ,0 ,14 ,0 ,78.71 ,61.19 ,48.28 
01,007,00,013,0000,0,17883 ,646 ,18529 ,25912 ,35053 ,24 ,12 ,23 ,1 ,12 ,0 ,73.92 ,71.51 ,50.00 
01,007,00,014,0000,0,9300 ,333 ,9633 ,14024 ,17170 ,20 ,12 ,20 ,0 ,12 ,0 ,81.68 ,68.69 ,60.00 
01,007,00,015,0000,0,7692 ,428 ,8120 ,11524 ,14623 ,16 ,9 ,16 ,0 ,9 ,0 ,78.81 ,70.46 ,56.25 
01,007,00,016,0000,0,12227 ,361 ,12588 ,20400 ,26563 ,25 ,14 ,23 ,2 ,14 ,0 ,76.80 ,61.71 ,56.00 
01,007,00,017,0000,0,15827 ,873 ,16700 ,23926 ,29325 ,38 ,21 ,33 ,5 ,19 ,2 ,81.59 ,69.80 ,55.26 
01,007,00,018,0000,0,14671 ,821 ,15492 ,22474 ,27252 ,36 ,21 ,35 ,1 ,20 ,1 ,82.47 ,68.93 ,58.33 
01,007,00,019,0000,0,17859 ,389 ,18248 ,24988 ,29485 ,44 ,21 ,41 ,3 ,19 ,2 ,84.75 ,73.03 ,47.73 
01,007,00,020,0000,0,17145 ,580 ,17725 ,24079 ,30894 ,46 ,24 ,40 ,6 ,23 ,1 ,77.94 ,73.61 ,52.17 
01,008,00,001,0000,0,18775 ,865 ,19640 ,26761 ,36210 ,42 ,18 ,39 ,3 ,17 ,1 ,73.90 ,73.39 ,42.86 
01,008,00,002,0000,0,19874 ,633 ,20507 ,33307 ,44326 ,51 ,27 ,47 ,4 ,25 ,2 ,75.14 ,61.57 ,52.94 
01,008,00,003,0000,0,16152 ,881 ,17033 ,24762 ,30824 ,43 ,23 ,36 ,7 ,19 ,4 ,80.33 ,68.79 ,53.49 
01,008,00,004,0000,0,17174 ,893 ,18067 ,26451 ,33982 ,39 ,21 ,34 ,5 ,20 ,1 ,77.84 ,68.30 ,53.85 
01,008,00,005,0000,0,34768 ,724 ,35492 ,55098 ,72793 ,63 ,28 ,61 ,2 ,27 ,1 ,75.69 ,64.42 ,44.44 
01,008,00,006,0000,0,9772 ,354 ,10126 ,13243 ,16563 ,28 ,14 ,27 ,1 ,13 ,1 ,79.96 ,76.46 ,50.00 
01,008,00,007,0000,0,18981 ,670 ,19651 ,26695 ,34995 ,47 ,23 ,39 ,8 ,18 ,5 ,76.28 ,73.61 ,48.94 
01,008,00,008,0000,0,15562 ,599 ,16161 ,21964 ,26890 ,51 ,25 ,48 ,3 ,24 ,1 ,81.68 ,73.58 ,49.02 
01,008,00,009,0000,0,15983 ,780 ,16763 ,23093 ,28224 ,41 ,23 ,36 ,5 ,20 ,3 ,81.82 ,72.59 ,56.10 
01,008,00,010,0000,0,10685 ,692 ,11377 ,17692 ,21617 ,33 ,22 ,30 ,3 ,20 ,2 ,81.84 ,64.31 ,66.67 
01,008,00,011,0000,0,10661 ,242 ,10903 ,14246 ,17405 ,28 ,15 ,28 ,0 ,15 ,0 ,81.85 ,76.53 ,53.57 
01,008,00,012,0000,0,25931 ,1058 ,26989 ,41503 ,52562 ,51 ,26 ,47 ,4 ,25 ,1 ,78.96 ,65.03 ,50.98 
01,008,00,013,0000,0,18587 ,462 ,19049 ,37385 ,47790 ,46 ,22 ,41 ,5 ,21 ,1 ,78.23 ,50.95 ,47.83 
01,008,00,014,0000,0,22137 ,480 ,22617 ,30749 ,38962 ,53 ,24 ,49 ,4 ,21 ,3 ,78.92 ,73.55 ,45.28 
01,008,00,015,0000,0,10737 ,423 ,11160 ,17523 ,22049 ,34 ,18 ,32 ,2 ,18 ,0 ,79.47 ,63.69 ,52.94 
01,008,00,016,0000,0,5594 ,483 ,6077 ,7712 ,11730 ,18 ,10 ,10 ,0 ,10 ,0 ,65.75 ,78.80 ,55.56 
01,008,00,017,0000,0,3016 ,132 ,3148 ,3679 ,4572 ,10 ,5 ,9 ,1 ,5 ,0 ,80.47 ,85.57 ,50.00 
01,008,00,018,0000,0,3208 ,94 ,3302 ,4767 ,6222 ,26 ,12 ,25 ,1 ,12 ,0 ,76.62 ,69.27 ,46.15 
01,009,00,001,0000,0,66948 ,3344 ,70292 ,161853 ,213614 ,149 ,79 ,121 ,28 ,67 ,12 ,75.77 ,43.43 ,53.02 
01,009,00,002,0000,0,24085 ,629 ,24714 ,42806 ,55969 ,47 ,21 ,37 ,10 ,18 ,3 ,76.48 ,57.73 ,44.68 
01,009,00,003,0000,0,21891 ,391 ,22282 ,36810 ,50234 ,51 ,23 ,48 ,3 ,22 ,1 ,73.28 ,60.53 ,45.10 
01,009,00,004,0000,0,14633 ,536 ,15169 ,23332 ,31170 ,37 ,17 ,30 ,7 ,13 ,4 ,74.85 ,65.01 ,45.95 
01,009,00,005,0000,0,26289 ,1056 ,27345 ,41232 ,54309 ,55 ,30 ,54 ,1 ,30 ,0 ,75.92 ,66.32 ,54.55 
01,009,00,006,0000,0,14404 ,667 ,15071 ,24459 ,30979 ,27 ,16 ,25 ,2 ,16 ,0 ,78.95 ,61.62 ,59.26 
01,009,00,007,0000,0,6369 ,214 ,6583 ,9567 ,11649 ,14 ,7 ,13 ,1 ,7 ,0 ,82.13 ,68.81 ,50.00 
01,009,00,008,0000,0,12808 ,427 ,13235 ,17637 ,23004 ,25 ,11 ,22 ,3 ,11 ,0 ,76.67 ,75.04 ,44.00 
01,009,00,009,0000,0,11321 ,548 ,11869 ,20233 ,26231 ,24 ,14 ,23 ,1 ,14 ,0 ,77.13 ,58.66 ,58.33 
01,009,00,010,0000,0,13821 ,791 ,14612 ,21449 ,27479 ,23 ,12 ,19 ,4 ,9 ,3 ,78.06 ,68.12 ,52.17 
01,009,00,011,0000,0,15901 ,277 ,16178 ,21922 ,27226 ,39 ,19 ,34 ,5 ,15 ,4 ,80.52 ,73.80 ,48.72 
01,009,00,012,0000,0,11872 ,341 ,12213 ,17566 ,22282 ,36 ,14 ,33 ,3 ,13 ,1 ,78.83 ,69.53 ,38.89 
01,009,00,013,0000,0,26693 ,834 ,27527 ,45484 ,58685 ,54 ,23 ,50 ,4 ,22 ,1 ,77.51 ,60.52 ,42.59 
01,009,00,014,0000,0,11361 ,262 ,11623 ,14930 ,18474 ,32 ,15 ,27 ,5 ,14 ,1 ,80.82 ,77.85 ,46.88 
01,009,00,015,0000,0,6774 ,198 ,6972 ,8935 ,10913 ,17 ,7 ,17 ,0 ,7 ,0 ,81.87 ,78.03 ,41.18 
01,009,00,016,0000,0,14663 ,757 ,15420 ,21344 ,26986 ,29 ,15 ,25 ,4 ,14 ,1 ,79.09 ,72.25 ,51.72 
01,009,00,017,0000,0,19892 ,478 ,20370 ,29967 ,38980 ,30 ,15 ,27 ,3 ,15 ,0 ,76.88 ,67.97 ,50.00 
01,009,00,018,0000,0,8327 ,528 ,8855 ,11855 ,17335 ,15 ,8 ,14 ,1 ,8 ,0 ,68.39 ,74.69 ,53.33 
01,009,00,019,0000,0,11842 ,426 ,12268 ,16628 ,21143 ,25 ,10 ,21 ,4 ,8 ,2 ,78.65 ,73.78 ,40.00 
01,009,00,020,0000,0,7404 ,166 ,7570 ,9617 ,11919 ,23 ,10 ,19 ,4 ,8 ,2 ,80.69 ,78.71 ,43.48 
01,009,00,021,0000,0,12258 ,484 ,12742 ,17257 ,21715 ,24 ,12 ,20 ,4 ,11 ,1 ,79.47 ,73.84 ,50.00 
01,009,00,022,0000,0,6123 ,209 ,6332 ,10023 ,12620 ,17 ,8 ,11 ,6 ,5 ,3 ,79.42 ,63.17 ,47.06 
01,009,00,023,0000,0,5997 ,139 ,6136 ,7954 ,9999 ,29 ,11 ,24 ,5 ,10 ,1 ,79.55 ,77.14 ,37.93 
01,009,00,024,0000,0,4853 ,279 ,5132 ,6980 ,8679 ,12 ,8 ,8 ,4 ,5 ,3 ,80.42 ,73.52 ,66.67 
01,009,00,025,0000,0,3770 ,113 ,3883 ,4865 ,6180 ,11 ,4 ,11 ,0 ,4 ,0 ,78.72 ,79.82 ,36.36 
01,009,00,026,0000,0,4898 ,60 ,4958 ,5850 ,7556 ,21 ,10 ,17 ,4 ,8 ,2 ,77.42 ,84.75 ,47.62 
01,009,00,027,0000,0,2214 ,34 ,2248 ,2460 ,2915 ,14 ,6 ,13 ,1 ,5 ,1 ,84.39 ,91.38 ,42.86 
01,009,00,028,0000,0,4046 ,223 ,4269 ,5172 ,6537 ,12 ,6 ,12 ,0 ,6 ,0 ,79.12 ,82.54 ,50.00 
01,009,00,029,0000,0,3169 ,91 ,3260 ,3868 ,5122 ,10 ,6 ,8 ,2 ,5 ,1 ,75.52 ,84.28 ,60.00 
01,009,00,030,0000,0,4536 ,162 ,4698 ,5916 ,7883 ,15 ,7 ,13 ,2 ,7 ,0 ,75.05 ,79.41 ,46.67 
01,009,00,031,0000,0,3012 ,133 ,3145 ,3645 ,4866 ,10 ,6 ,9 ,1 ,6 ,0 ,74.91 ,86.28 ,60.00 
01,009,00,032,0000,0,3068 ,110 ,3178 ,3843 ,4983 ,17 ,8 ,16 ,1 ,8 ,0 ,77.12 ,82.70 ,47.06 
01,009,00,033,0000,0,3079 ,37 ,3116 ,4023 ,5004 ,14 ,6 ,12 ,2 ,5 ,1 ,80.40 ,77.45 ,42.86 
01,010,00,001,0000,0,40395 ,1775 ,42170 ,80569 ,109576 ,99 ,46 ,82 ,17 ,38 ,8 ,73.53 ,52.34 ,46.46 
01,010,00,002,0000,0,7256 ,444 ,7700 ,12761 ,15984 ,20 ,8 ,18 ,2 ,8 ,0 ,79.84 ,60.34 ,40.00 
01,010,00,003,0000,0,4538 ,257 ,4795 ,7550 ,9849 ,12 ,7 ,10 ,2 ,6 ,1 ,76.66 ,63.51 ,58.33 
01,010,00,004,0000,0,9199 ,252 ,9451 ,14569 ,18379 ,36 ,13 ,33 ,3 ,13 ,0 ,79.27 ,64.87 ,36.11 
01,010,00,005,0000,0,4306 ,85 ,4391 ,6938 ,8676 ,15 ,7 ,15 ,0 ,7 ,0 ,79.97 ,63.29 ,46.67 
01,010,00,006,0000,0,4552 ,164 ,4716 ,7405 ,9356 ,21 ,10 ,17 ,4 ,8 ,2 ,79.15 ,63.69 ,47.62 
01,010,00,007,0000,0,4965 ,79 ,5044 ,7954 ,9523 ,18 ,7 ,17 ,1 ,7 ,0 ,83.52 ,63.41 ,38.89 
01,010,00,008,0000,0,4248 ,54 ,4302 ,7050 ,8477 ,18 ,6 ,16 ,2 ,6 ,0 ,83.17 ,61.02 ,33.33 
01,010,00,009,0000,0,6697 ,130 ,6827 ,9521 ,12094 ,23 ,9 ,21 ,2 ,8 ,1 ,78.72 ,71.70 ,39.13 
01,010,00,010,0000,0,4059 ,102 ,4161 ,5684 ,7160 ,9 ,5 ,8 ,1 ,4 ,1 ,79.39 ,73.21 ,55.56 
01,010,00,011,0000,0,1802 ,116 ,1918 ,2648 ,3331 ,5 ,3 ,5 ,0 ,3 ,0 ,79.50 ,72.43 ,60.00 
01,010,00,012,0000,0,2109 ,61 ,2170 ,3194 ,4535 ,14 ,6 ,11 ,3 ,5 ,1 ,70.43 ,67.94 ,42.86 
01,010,00,013,0000,0,2027 ,143 ,2170 ,2760 ,3621 ,9 ,5 ,8 ,1 ,5 ,0 ,76.22 ,78.62 ,55.56 
01,010,00,014,0000,0,2290 ,45 ,2335 ,2733 ,3526 ,9 ,5 ,9 ,0 ,5 ,0 ,77.51 ,85.44 ,55.56 
01,010,00,015,0000,0,2567 ,22 ,2589 ,3282 ,4103 ,17 ,6 ,15 ,2 ,4 ,2 ,79.99 ,78.88 ,35.29 
01,010,00,016,0000,0,2172 ,78 ,2250 ,3183 ,4307 ,18 ,4 ,16 ,2 ,3 ,1 ,73.90 ,70.69 ,22.22 
01,011,00,001,0000,0,29812 ,1816 ,31628 ,79549 ,109945 ,74 ,45 ,59 ,15 ,35 ,10 ,72.35 ,39.76 ,60.81 
01,011,00,002,0000,0,7039 ,218 ,7257 ,9853 ,12174 ,24 ,12 ,22 ,2 ,10 ,2 ,80.93 ,73.65 ,50.00 
01,011,00,003,0000,0,11912 ,466 ,12378 ,21325 ,27279 ,39 ,15 ,35 ,4 ,13 ,2 ,78.17 ,58.04 ,38.46 
01,011,00,004,0000,0,7457 ,627 ,8084 ,15472 ,20324 ,19 ,8 ,18 ,1 ,7 ,1 ,76.13 ,52.25 ,42.11 
01,011,00,005,0000,0,21797 ,1012 ,22809 ,61889 ,79445 ,38 ,18 ,33 ,5 ,16 ,2 ,77.90 ,36.85 ,47.37 
01,011,00,006,0000,0,9803 ,142 ,9945 ,15069 ,18908 ,45 ,15 ,37 ,8 ,11 ,4 ,79.70 ,66.00 ,33.33 
01,011,00,007,0000,0,7409 ,133 ,7542 ,11525 ,14271 ,48 ,14 ,40 ,8 ,12 ,2 ,80.76 ,65.44 ,29.17 
01,011,00,008,0000,0,3026 ,147 ,3173 ,4346 ,5135 ,11 ,5 ,10 ,1 ,5 ,0 ,84.63 ,73.01 ,45.45 
01,011,00,009,0000,0,6505 ,138 ,6643 ,10352 ,13086 ,30 ,11 ,28 ,2 ,10 ,1 ,79.11 ,64.17 ,36.67 
01,011,00,010,0000,0,5896 ,137 ,6033 ,9528 ,11869 ,28 ,13 ,27 ,1 ,12 ,1 ,80.28 ,63.32 ,46.43 
01,011,00,011,0000,0,8009 ,149 ,8158 ,10390 ,15107 ,24 ,9 ,15 ,9 ,6 ,3 ,68.78 ,78.52 ,37.50 
01,011,00,012,0000,0,3535 ,61 ,3596 ,4884 ,7001 ,21 ,6 ,16 ,5 ,4 ,2 ,69.76 ,73.63 ,28.57 
01,011,00,013,0000,0,2960 ,229 ,3189 ,4722 ,6420 ,13 ,6 ,5 ,8 ,1 ,5 ,73.55 ,67.53 ,46.15 
01,012,00,001,0000,0,22198 ,1357 ,23555 ,43313 ,56435 ,66 ,33 ,59 ,7 ,29 ,4 ,76.75 ,54.38 ,50.00 
01,012,00,002,0000,0,7513 ,295 ,7808 ,10930 ,13520 ,42 ,22 ,41 ,1 ,22 ,0 ,80.84 ,71.44 ,52.38 
01,012,00,003,0000,0,5104 ,245 ,5349 ,7712 ,9458 ,30 ,15 ,28 ,2 ,13 ,2 ,81.54 ,69.36 ,50.00 
01,012,00,004,0000,0,4085 ,367 ,4452 ,6878 ,8483 ,17 ,11 ,17 ,0 ,11 ,0 ,81.08 ,64.73 ,64.71 
01,012,00,005,0000,0,2437 ,105 ,2542 ,3908 ,4743 ,17 ,9 ,14 ,3 ,7 ,2 ,82.40 ,65.05 ,52.94 
01,012,00,006,0000,0,1797 ,268 ,2065 ,2891 ,3571 ,9 ,6 ,6 ,3 ,4 ,2 ,80.96 ,71.43 ,66.67 
02,001,00,001,0000,0,8571 ,618 ,9189 ,24780 ,31563 ,15 ,8 ,15 ,0 ,8 ,0 ,78.51 ,37.08 ,53.33 
02,001,00,002,0000,0,6830 ,274 ,7104 ,16384 ,20467 ,19 ,8 ,17 ,2 ,7 ,1 ,80.05 ,43.36 ,42.11 
02,001,00,003,0000,0,5242 ,108 ,5350 ,11959 ,14851 ,20 ,8 ,20 ,0 ,8 ,0 ,80.53 ,44.73 ,40.00 
02,001,00,004,0000,0,5599 ,197 ,5796 ,14055 ,17836 ,15 ,6 ,14 ,1 ,6 ,0 ,78.80 ,41.24 ,40.00 
02,001,00,005,0000,0,4195 ,99 ,4294 ,7142 ,8580 ,10 ,5 ,9 ,1 ,5 ,0 ,83.24 ,60.12 ,50.00 
02,001,00,006,0000,0,297 ,0 ,297 ,361 ,506 ,4 ,2 ,3 ,1 ,2 ,0 ,71.34 ,82.27 ,50.00 
02,002,00,001,0000,0,2902 ,103 ,3005 ,4604 ,5939 ,17 ,9 ,13 ,4 ,5 ,4 ,77.52 ,65.27 ,52.94 
02,002,00,002,0000,0,1051 ,35 ,1086 ,1393 ,1755 ,9 ,6 ,8 ,1 ,6 ,0 ,79.37 ,77.96 ,66.67 
02,002,00,003,0000,0,400 ,44 ,444 ,973 ,1166 ,6 ,5 ,3 ,3 ,3 ,2 ,83.45 ,45.63 ,83.33 
02,002,00,004,0000,0,666 ,7 ,673 ,832 ,1059 ,4 ,2 ,4 ,0 ,2 ,0 ,78.56 ,80.89 ,50.00 
01,013,00,001,0000,0,17444 ,248 ,17692 ,44093 ,56247 ,46 ,26 ,39 ,7 ,23 ,3 ,78.39 ,40.12 ,56.52 
01,013,00,002,0000,0,14230 ,132 ,14362 ,40488 ,51650 ,32 ,20 ,22 ,10 ,17 ,3 ,78.39 ,35.47 ,62.50 
01,013,00,003,0000,0,15751 ,219 ,15970 ,38035 ,50400 ,52 ,29 ,42 ,10 ,25 ,4 ,75.47 ,41.99 ,55.77 
01,013,00,004,0000,0,18527 ,263 ,18790 ,40304 ,51574 ,50 ,24 ,36 ,14 ,19 ,5 ,78.15 ,46.62 ,48.00 
01,013,00,005,0000,0,22372 ,276 ,22648 ,63764 ,84859 ,47 ,25 ,37 ,10 ,23 ,2 ,75.14 ,35.52 ,53.19 
01,013,00,006,0000,0,10785 ,131 ,10916 ,28680 ,38095 ,30 ,13 ,23 ,7 ,11 ,2 ,75.29 ,38.06 ,43.33 
01,013,00,007,0000,0,18174 ,244 ,18418 ,42261 ,55496 ,39 ,20 ,34 ,5 ,19 ,1 ,76.15 ,43.58 ,51.28 
01,014,00,001,0000,0,38765 ,544 ,332798 ,136682 ,196116 ,90 ,90 ,82 ,8 ,49 ,3 ,69.69 ,28.76 ,57.78 
01,014,00,002,0000,0,35002 ,453 ,252308 ,107373 ,144935 ,84 ,84 ,76 ,8 ,40 ,4 ,74.08 ,33.02 ,52.38 
01,014,00,003,0000,0,20599 ,305 ,126150 ,53817 ,72333 ,40 ,40 ,37 ,3 ,22 ,2 ,74.40 ,38.84 ,60.00 
01,015,00,001,0000,0,34714 ,354 ,35068 ,92825 ,126289 ,87 ,39 ,61 ,26 ,33 ,6 ,73.50 ,37.78 ,44.83 
01,015,00,002,0000,0,47426 ,482 ,47908 ,107863 ,147482 ,113 ,45 ,89 ,24 ,36 ,9 ,73.14 ,44.42 ,39.82 
