00,000,00,000,0000,0,7156011,127376,7283387,11627025,17236176,1803,838,1511,292,695,143,67.46 ,62.64 ,46.48 
01,001,00,000,0000,0,1050357,18830,1069187,2236797,3362866,151,63,122,29,50,13,66.51 ,47.80 ,41.72 
01,002,00,000,0000,0,203170,3020,206190,310850,455041,65,32,59,6,28,4,68.31 ,66.33 ,49.23 
01,003,00,000,0000,0,545425,10177,555602,1023276,1565245,158,54,137,21,44,10,65.37 ,54.30 ,34.18 
01,004,00,000,0000,0,172156,3756,175912,257743,386761,67,32,59,8,26,6,66.64 ,68.25 ,46.27 
01,005,00,000,0000,0,256887,4584,261471,386516,567868,85,36,73,12,30,6,68.06 ,67.65 ,43.53 
01,006,00,000,0000,0,610061,12866,622927,925076,1427228,110,55,86,24,43,12,64.82 ,67.34 ,50.00 
01,007,00,000,0000,0,639768,14482,654250,860280,1292791,93,54,74,19,41,13,66.54 ,76.05 ,58.06 
01,008,00,000,0000,0,242462,3644,246106,359702,522460,67,35,55,12,29,6,68.85 ,68.42 ,52.24 
01,009,00,000,0000,0,392744,6839,399583,525512,751537,81,43,67,14,36,7,69.92 ,76.04 ,53.09 
01,010,00,000,0000,0,289363,5535,294898,398683,562599,57,36,44,13,28,8,70.86 ,73.97 ,63.16 
01,011,00,000,0000,0,523901,8676,532577,757839,1092344,98,50,80,18,39,11,69.38 ,70.28 ,51.02 
01,012,00,000,0000,0 ,591470,10076,601546,829731,1204841,109,50,93,16,45,5,68.87 ,72.50 ,45.87 
01,013,00,000,0000,0 ,420975,6758,427733,596950,861626,112,46,98,14,41,5,69.28 ,71.65 ,41.07 
01,014,00,000,0000,0 ,79551,1432,80983,122682,173715,38,17,32,6,12,5,70.62 ,66.01 ,44.74 
01,015,00,000,0000,0 ,112048,2194,114242,191096,273194,59,23,49,10,19,4,69.95 ,59.78 ,38.98 
01,016,00,000,0000,0 ,47208,769,47977,63829,89731,41,19,38,3,18,1,71.13 ,75.16 ,46.34 
01,017,00,000,0000,0 ,134868,2041,136909,256545,371499,74,30,62,12,25,5,69.06 ,53.37 ,40.54 
01,018,00,000,0000,0 ,115514,1688,117202,233115,349150,53,29,45,8,23,6,66.77 ,50.28 ,54.72 
01,019,00,000,0000,0 ,306953,4708,311661,584748,891981,90,45,74,16,39,6,65.56 ,53.30 ,50.00 
01,020,00,000,0000,0 ,104900,1509,106409,185454,263085,38,23,32,6,21,2,70.49 ,57.38 ,60.53 
01,021,00,000,0000,0 ,285232,3180,288412,481106,715033,96,41,78,18,33,8,67.28 ,59.95 ,42.71 
01,022,00,000,0000,0 ,26310,519,26829,33216,48700,44,16,39,5,16,0,68.21 ,80.77 ,36.36 
01,023,00,000,0000,0 ,4688,93,4781,6279,6881,17,9,15,2,9,0,91.25 ,76.14 ,52.94 
01,001,01,000,0000,0 ,164549,2948,167497,338483,519671,26,10,21,5,7,3,65.13 ,49.48 ,38.46 
01,001,02,000,0000,0 ,119955,1992,121947,263728,382165,14,7,9,5,5,2,69.01 ,46.24 ,50.00 
01,001,03,000,0000,0 ,67302,1305,68607,157588,230146,10,4,7,3,2,2,68.47 ,43.54 ,40.00 
01,001,04,000,0000,0 ,145432,2488,147920,314237,492455,23,9,18,5,6,3,63.81 ,47.07 ,39.13 
01,001,05,000,0000,0 ,165523,2694,168217,341845,525363,28,10,22,6,9,1,65.07 ,49.21 ,35.71 
01,001,06,000,0000,0 ,146062,2302,148364,323883,515283,24,10,22,2,9,1,62.86 ,45.81 ,41.67 
01,001,07,000,0000,0 ,53571,1255,54826,109048,158122,8,3,8,0,3,0,68.96 ,50.28 ,37.50 
01,001,08,000,0000,0 ,58027,1329,59356,122215,170561,7,3,6,1,3,0,71.65 ,48.57 ,42.86 
01,001,09,000,0000,0 ,41113,1055,42168,59077,80109,3,2,3,0,2,0,73.75 ,71.38 ,66.67 
01,001,10,000,0000,0 ,88823,1462,90285,206693,288991,8,5,6,2,4,1,71.52 ,43.68 ,62.50 
01,002,01,000,0000,0 ,39462,539,40001,60852,92038,15,6,13,2,5,1,66.12 ,65.73 ,40.00 
01,002,02,000,0000,0 ,16135,284,16419,22913,33895,3,2,2,1,1,1,67.60 ,71.66 ,66.67 
01,002,03,000,0000,0 ,18890,281,19171,26284,38349,6,3,6,0,3,0,68.54 ,72.94 ,50.00 
01,002,04,000,0000,0 ,15226,278,15504,23511,33245,5,2,5,0,2,0,70.72 ,65.94 ,40.00 
01,002,05,000,0000,0 ,14361,216,14577,18883,26363,5,2,5,0,2,0,71.63 ,77.20 ,40.00 
01,002,06,000,0000,0 ,25137,306,25443,44533,67761,9,5,7,2,4,1,65.72 ,57.13 ,55.56 
01,002,07,000,0000,0 ,16391,208,16599,26559,38304,6,3,5,1,2,1,69.34 ,62.50 ,50.00 
01,002,08,000,0000,0 ,22540,315,22855,35569,51890,6,4,6,0,4,0,68.55 ,64.26 ,66.67 
01,002,09,000,0000,0 ,11788,204,11992,17382,23814,4,2,4,0,2,0,72.99 ,68.99 ,50.00 
01,002,10,000,0000,0 ,23240,389,23629,34364,49382,6,3,6,0,3,0,69.59 ,68.76 ,50.00 
01,003,01,000,0000,0 ,89967,1396,91363,185992,288714,34,10,27,7,8,2,64.42 ,49.12 ,29.41 
01,003,02,000,0000,0 ,33349,622,33971,70021,104650,10,4,9,1,4,0,66.91 ,48.52 ,40.00 
01,003,03,000,0000,0 ,52761,1466,54227,97703,149987,10,5,7,3,3,2,65.14 ,55.50 ,50.00 
01,003,04,000,0000,0 ,26677,456,27133,50025,77538,7,3,7,0,3,0,64.52 ,54.24 ,42.86 
01,003,05,000,0000,0 ,29337,575,29912,46083,71657,6,2,5,1,2,0,64.31 ,64.91 ,33.33 
01,003,06,000,0000,0 ,31214,700,31914,55328,81662,7,3,7,0,3,0,67.75 ,57.68 ,42.86 
01,003,07,000,0000,0 ,107788,1754,109542,201700,306298,34,10,31,3,9,1,65.85 ,54.31 ,29.41 
01,003,08,000,0000,0 ,56149,1127,57276,111651,175915,19,6,15,4,2,4,63.47 ,51.30 ,31.58 
01,003,09,000,0000,0 ,39968,788,40756,75725,115642,14,4,14,0,4,0,65.48 ,53.82 ,28.57 
01,003,10,000,0000,0 ,34121,597,34718,61316,94122,9,3,8,1,2,1,65.15 ,56.62 ,33.33 
01,003,11,000,0000,0 ,22748,327,23075,33553,48834,5,2,4,1,2,0,68.71 ,68.77 ,40.00 
01,003,12,000,0000,0 ,21346,369,21715,34179,50226,3,2,3,0,2,0,68.05 ,63.53 ,66.67 
01,004,01,000,0000,0 ,31815,652,32467,52546,81109,12,6,10,2,4,2,64.78 ,61.79 ,50.00 
01,004,02,000,0000,0 ,29027,623,29650,40816,62688,10,6,7,3,4,2,65.11 ,72.64 ,60.00 
01,004,03,000,0000,0 ,17424,316,17740,27553,42962,6,3,6,0,3,0,64.13 ,64.39 ,50.00 
01,004,04,000,0000,0 ,16552,318,16870,22682,32234,6,3,6,0,3,0,70.37 ,74.38 ,50.00 
01,004,05,000,0000,0 ,16983,302,17285,24925,36670,7,3,7,0,3,0,67.97 ,69.35 ,42.86 
01,004,06,000,0000,0 ,8777,212,8989,11978,16550,2,1,2,0,1,0,72.37 ,75.05 ,50.00 
01,004,07,000,0000,0 ,9442,219,9661,13235,19334,4,2,4,0,2,0,68.45 ,73.00 ,50.00 
01,004,08,000,0000,0 ,42136,1114,43250,64008,95214,20,7,17,3,5,2,67.23 ,67.57 ,35.00 
01,004,09,000,0000,0 ,10202,237,10439,12425,17128,2,1,2,0,1,0,72.54 ,84.02 ,50.00 
01,005,01,000,0000,0 ,60313,989,61302,92745,136577,23,9,19,4,7,2,67.91 ,66.10 ,39.13 
01,005,02,000,0000,0 ,24424,467,24891,33413,48427,6,3,6,0,3,0,69.00 ,74.49 ,50.00 
01,005,03,000,0000,0 ,43249,598,43847,62088,91608,15,6,12,3,5,1,67.78 ,70.62 ,40.00 
01,005,04,000,0000,0 ,52648,976,53624,83587,125022,15,8,13,2,6,2,66.86 ,64.15 ,53.33 
01,005,05,000,0000,0 ,43807,808,44615,69706,103725,16,7,14,2,6,1,67.20 ,64.00 ,43.75 
01,005,06,000,0000,0 ,22244,509,22753,32552,45381,8,3,7,1,3,0,71.73 ,69.90 ,37.50 
01,006,01,000,0000,0 ,84624,1666,86290,139198,213270,19,8,16,3,6,2,65.27 ,61.99 ,42.11 
01,006,02,000,0000,0 ,84355,2021,86376,136859,212092,13,8,10,3,6,2,64.53 ,63.11 ,61.54 
01,006,03,000,0000,0 ,55133,1153,56286,77162,109505,10,4,8,2,3,1,70.46 ,72.95 ,40.00 
01,006,04,000,0000,0 ,58348,1278,59626,83386,128996,11,5,8,3,4,1,64.64 ,71.51 ,45.45 
01,006,05,000,0000,0 ,98250,1945,100195,130441,202447,12,8,9,3,6,2,64.43 ,76.81 ,66.67 
01,006,06,000,0000,0 ,83868,1716,85584,112679,174431,14,7,11,3,6,1,64.60 ,75.95 ,50.00 
01,006,07,000,0000,0 ,145483,3087,148570,245351,386487,31,15,24,7,12,3,63.48 ,60.55 ,48.39 
01,007,01,000,0000,0 ,137402,3313,140715,193370,296118,21,12,17,4,10,2,65.30 ,72.77 ,57.14 
01,007,02,000,0000,0 ,82136,1655,83791,107516,165496,12,7,9,3,4,3,64.97 ,77.93 ,58.33 
01,007,03,000,0000,0 ,66349,1825,68174,84854,131688,10,6,8,2,5,1,64.44 ,80.34 ,60.00 
01,007,04,000,0000,0 ,95231,1938,97169,130790,200419,16,8,13,3,6,2,65.26 ,74.29 ,50.00 
01,007,05,000,0000,0 ,65766,1408,67174,82379,124111,8,5,6,2,3,2,66.38 ,81.54 ,62.50 
01,007,06,000,0000,0 ,57786,1209,58995,75576,110147,9,5,7,2,4,1,68.61 ,78.06 ,55.56 
01,007,07,000,0000,0 ,62667,1948,64615,88323,128462,8,5,7,1,4,1,68.75 ,73.16 ,62.50 
01,007,08,000,0000,0 ,72431,1186,73617,97472,136350,9,6,7,2,5,1,71.49 ,75.53 ,66.67 
01,008,01,000,0000,0 ,70716,1053,71769,98245,146489,18,10,14,4,9,1,67.07 ,73.05 ,55.56 
01,008,02,000,0000,0 ,53524,819,54343,77772,114477,15,8,13,2,7,1,67.94 ,69.87 ,53.33 
01,008,03,000,0000,0 ,30052,461,30513,45102,62756,9,4,7,2,3,1,71.87 ,67.65 ,44.44 
01,008,04,000,0000,0 ,38709,505,39214,58501,84089,7,5,5,2,4,1,69.57 ,67.03 ,71.43 
01,008,05,000,0000,0 ,49461,806,50267,80082,114649,18,8,16,2,6,2,69.85 ,62.77 ,44.44 
01,009,01,000,0000,0 ,75447,1535,76982,101495,151137,19,9,15,4,8,1,67.15 ,75.85 ,47.37 
01,009,02,000,0000,0 ,56077,1058,57135,75485,108168,10,6,9,1,5,1,69.78 ,75.69 ,60.00 
01,009,03,000,0000,0 ,74849,1336,76185,103924,148187,11,8,9,2,6,2,70.13 ,73.31 ,72.73 
01,009,04,000,0000,0 ,59320,789,60109,79814,113218,13,6,11,2,5,1,70.50 ,75.31 ,46.15 
01,009,05,000,0000,0 ,63205,1173,64378,81674,114304,14,7,11,3,6,1,71.45 ,78.82 ,50.00 
01,009,06,000,0000,0 ,63846,948,64794,83120,116523,14,7,12,2,6,1,71.33 ,77.95 ,50.00 
01,010,01,000,0000,0 ,54446,1266,55712,73089,104250,10,6,7,3,5,1,70.11 ,76.22 ,60.00 
01,010,02,000,0000,0 ,52863,1033,53896,71095,104331,13,7,10,3,5,2,68.14 ,75.81 ,53.85 
01,010,03,000,0000,0 ,41825,749,42574,57345,79319,7,5,5,2,4,1,72.30 ,74.24 ,71.43 
01,010,04,000,0000,0 ,52844,931,53775,77596,106670,9,7,7,2,5,2,72.74 ,69.30 ,77.78 
01,010,05,000,0000,0 ,34394,647,35041,43758,59490,6,4,5,1,3,1,73.56 ,80.08 ,66.67 
01,010,06,000,0000,0 ,52991,909,53900,75800,108539,12,7,10,2,6,1,69.84 ,71.11 ,58.33 
01,011,01,000,0000,0 ,60600,1403,62003,89653,129538,11,6,9,2,4,2,69.21 ,69.16 ,54.55 
01,011,02,000,0000,0 ,47986,786,48772,68178,91804,6,4,4,2,2,2,74.26 ,71.54 ,66.67 
01,011,03,000,0000,0 ,65482,1081,66563,88888,125779,12,6,9,3,5,1,70.67 ,74.88 ,50.00 
01,011,04,000,0000,0 ,56239,753,56992,75631,109296,11,5,8,3,4,1,69.20 ,75.36 ,45.45 
01,011,05,000,0000,0 ,38537,521,39058,49772,68798,6,3,6,0,3,0,72.35 ,78.47 ,50.00 
01,011,06,000,0000,0 ,34092,621,34713,46053,65069,7,3,7,0,3,0,70.78 ,75.38 ,42.86 
01,011,07,000,0000,0 ,36516,754,37270,49699,71166,5,3,4,1,3,0,69.84 ,74.99 ,60.00 
01,011,08,000,0000,0 ,27842,398,28240,34437,45827,4,2,4,0,2,0,75.15 ,82.00 ,50.00 
01,011,09,000,0000,0 ,83630,1306,84936,115287,170254,17,8,14,3,6,2,67.71 ,73.67 ,47.06 
01,011,10,000,0000,0 ,72977,1053,74030,140241,214813,19,10,15,4,7,3,65.29 ,52.79 ,52.63 
01,012,01,000,0000,0 ,123420,1882,125302,210330,312230,30,13,25,5,12,1,67.36 ,59.57 ,43.33 
01,012,02,000,0000,0 ,84322,1427,85749,111695,161808,15,7,12,3,6,1,69.03 ,76.77 ,46.67 
01,012,03,000,0000,0 ,93435,1540,94975,124149,184921,19,7,16,3,6,1,67.14 ,76.50 ,36.84 
01,012,04,000,0000,0 ,77271,1241,78512,111132,161832,13,7,11,2,6,1,68.67 ,70.65 ,53.85 
01,012,05,000,0000,0 ,20614,662,21276,28582,41090,2,2,2,0,2,0,69.56 ,74.44 ,100.00 
01,012,06,000,0000,0 ,106692,1891,108583,131573,189358,16,8,13,3,7,1,69.48 ,82.53 ,50.00 
01,012,07,000,0000,0 ,49791,772,50563,63471,86927,8,3,8,0,3,0,73.02 ,79.66 ,37.50 
01,012,08,000,0000,0 ,35925,661,36586,48799,66675,6,3,6,0,3,0,73.19 ,74.97 ,50.00 
01,013,01,000,0000,0 ,92996,1195,94191,144094,212110,39,11,34,5,10,1,67.93 ,65.37 ,28.21 
01,013,02,000,0000,0 ,80497,1473,81970,106890,152453,19,8,17,2,6,2,70.11 ,76.69 ,42.11 
01,013,03,000,0000,0 ,99525,1601,101126,145041,206953,25,11,21,4,10,1,70.08 ,69.72 ,44.00 
01,013,04,000,0000,0 ,72875,1042,73917,96156,144778,13,8,11,2,7,1,66.42 ,76.87 ,61.54 
01,013,05,000,0000,0 ,38407,657,39064,53410,75909,7,4,6,1,4,0,70.36 ,73.14 ,57.14 
01,013,06,000,0000,0 ,29393,597,29990,41751,56905,6,3,6,0,3,0,73.37 ,71.83 ,50.00 
01,013,07,000,0000,0 ,7282,193,7475,9608,12518,3,1,3,0,1,0,76.75 ,77.80 ,33.33 
01,014,01,000,0000,0 ,44828,807,45635,67219,97495,26,10,21,5,6,4,68.95 ,67.89 ,38.46 
01,014,02,000,0000,0 ,7373,179,7552,11681,15552,2,1,2,0,1,0,75.11 ,64.65 ,50.00 
01,014,03,000,0000,0 ,8812,122,8934,14706,20284,4,2,4,0,2,0,72.50 ,60.75 ,50.00 
01,014,04,000,0000,0 ,12713,223,12936,19338,26775,4,3,3,1,2,1,72.22 ,66.89 ,75.00 
01,014,05,000,0000,0 ,5825,101,5926,9738,13609,2,1,2,0,1,0,71.56 ,60.85 ,50.00 
01,015,01,000,0000,0 ,41180,603,41783,68729,102535,24,9,20,4,8,1,67.03 ,60.79 ,37.50 
01,015,02,000,0000,0 ,8323,174,8497,13868,19117,5,2,3,2,2,0,72.54 ,61.27 ,40.00 
01,015,03,000,0000,0 ,41844,809,42653,72176,101812,20,8,17,3,6,2,70.89 ,59.10 ,40.00 
01,015,04,000,0000,0 ,20701,608,21309,36323,49730,10,4,9,1,3,1,73.04 ,58.67 ,40.00 
01,016,01,000,0000,0 ,25560,354,25914,33999,52288,26,11,23,3,10,1,65.02 ,76.22 ,42.31 
01,016,02,000,0000,0 ,7095,86,7181,9564,12763,4,2,4,0,2,0,74.94 ,75.08 ,50.00 
01,016,03,000,0000,0 ,5355,64,5419,7037,8930,3,2,3,0,2,0,78.80 ,77.01 ,66.67 
01,016,04,000,0000,0 ,4502,83,4585,6795,8616,4,2,4,0,2,0,78.86 ,67.48 ,50.00 
01,016,05,000,0000,0 ,2890,152,3042,4031,3159,2,1,2,0,1,0,127.60 ,75.47 ,50.00 
01,016,06,000,0000,0 ,1806,30,1836,2403,3975,2,1,2,0,1,0,60.45 ,76.40 ,50.00 
01,017,01,000,0000,0 ,21385,310,21695,39670,57188,15,5,11,4,4,1,69.37 ,54.69 ,33.33 
01,017,02,000,0000,0 ,16649,224,16873,33099,47140,8,4,7,1,4,0,70.21 ,50.98 ,50.00 
01,017,03,000,0000,0 ,19386,333,19719,38084,55101,8,4,7,1,3,1,69.12 ,51.78 ,50.00 
01,017,04,000,0000,0 ,19294,366,19660,35903,50083,12,4,11,1,4,0,71.69 ,54.76 ,33.33 
01,017,05,000,0000,0 ,24769,313,25082,48553,73070,16,6,13,3,4,2,66.45 ,51.66 ,37.50 
01,017,06,000,0000,0 ,13559,229,13788,24362,33892,6,3,6,0,3,0,71.88 ,56.60 ,50.00 
01,017,07,000,0000,0 ,19826,266,20092,36874,55025,9,4,7,2,3,1,67.01 ,54.49 ,44.44 
01,018,01,000,0000,0 ,37424,529,37953,76936,117110,18,10,15,3,7,3,65.70 ,49.33 ,55.56 
01,018,02,000,0000,0 ,16471,238,16709,34298,50431,8,4,8,0,4,0,68.01 ,48.72 ,50.00 
01,018,03,000,0000,0 ,12717,219,12936,24949,36013,5,3,5,0,3,0,69.28 ,51.85 ,60.00 
01,018,04,000,0000,0 ,24422,302,24724,58647,87070,9,7,7,2,5,2,67.36 ,42.16 ,77.78 
01,018,05,000,0000,0 ,24480,400,24880,38285,58526,13,5,10,3,4,1,65.42 ,64.99 ,38.46 
01,019,01,000,0000,0 ,48462,810,49272,88292,136663,13,7,11,2,6,1,64.61 ,55.81 ,53.85 
01,019,02,000,0000,0 ,48587,643,49230,97783,146046,12,7,9,3,6,1,66.95 ,50.35 ,58.33 
01,019,03,000,0000,0 ,57011,986,57997,105225,157136,14,8,12,2,7,1,66.96 ,55.12 ,57.14 
01,019,04,000,0000,0 ,54124,863,54987,98971,153192,16,8,14,2,7,1,64.61 ,55.56 ,50.00 
01,019,05,000,0000,0 ,29654,351,30005,65130,100715,9,5,7,2,4,1,64.67 ,46.07 ,55.56 
01,019,06,000,0000,0 ,69115,1055,70170,129347,198229,26,10,21,5,9,1,65.25 ,54.25 ,38.46 
01,020,01,000,0000,0 ,50699,702,51401,96062,130115,20,11,17,3,10,1,73.83 ,53.51 ,55.00 
01,020,02,000,0000,0 ,54201,807,55008,89392,132970,18,12,15,3,11,1,67.23 ,61.54 ,66.67 
01,021,01,000,0000,0 ,64328,772,65100,114179,171721,24,10,20,4,9,1,66.49 ,57.02 ,41.67 
01,021,02,000,0000,0 ,53488,474,53962,92801,137110,21,8,16,5,6,2,67.68 ,58.15 ,38.10 
01,021,03,000,0000,0 ,34418,424,34842,65258,97101,7,5,4,3,3,2,67.21 ,53.39 ,71.43 
01,021,04,000,0000,0 ,51140,619,51759,82991,119899,18,7,15,3,6,1,69.22 ,62.37 ,38.89 
01,021,05,000,0000,0 ,66856,746,67602,98937,153101,20,9,18,2,7,2,64.62 ,68.33 ,45.00 
01,021,06,000,0000,0 ,15002,145,15147,26940,36101,6,2,5,1,2,0,74.62 ,56.22 ,33.33 
01,022,01,000,0000,0 ,26310,519,26829,33216,48700,44,16,39,5,16,0,68.21 ,80.77 ,36.36 
01,023,01,000,0000,0 ,2390,39,2429,3242,4020,10,5,8,2,5,0,80.65 ,74.92 ,50.00 
01,023,02,000,0000,0 ,1088,22,1110,1394,1787,3,2,3,0,2,0,78.01 ,79.63 ,66.67 
01,023,03,000,0000,0 ,822,26,848,1106,1446,2,1,2,0,1,0,76.49 ,76.67 ,50.00 
01,023,04,000,0000,0,388,6,394,537,715,2,1,2,0,1,0,75.10 ,73.37 ,50.00 
01,001,01,001,0000,0,164549,2948,167497,338483,1888 ,6,1,6,0,1,0,58.90 ,49.48 ,16.67 
01,001,02,002,0000,0,119955,1992,121947,263728,1888 ,6,1,6,0,1,0,58.90 ,46.24 ,16.67 
01,001,03,003,0000,0,67302,1305,68607,157588,1888 ,6,1,6,0,1,0,58.90 ,43.54 ,16.67 
01,001,04,004,0000,0,42437,722,43159,87889,1888 ,6,1,6,0,1,0,58.90 ,49.11 ,16.67 
01,001,04,005,0000,0,20713,281,20994,46228,1888 ,6,1,6,0,1,0,58.90 ,45.41 ,16.67 
01,001,04,006,0000,0,25153,403,25556,49194,1888 ,6,1,6,0,1,0,58.90 ,51.95 ,16.67 
01,001,04,007,0000,0,57129,1082,58211,130926,1888 ,6,1,6,0,1,0,58.90 ,44.46 ,16.67 
01,001,05,008,0000,0,118870,1973,120843,249428,1888 ,6,1,6,0,1,0,58.90 ,48.45 ,16.67 
01,001,05,009,0000,0,46653,721,47374,92417,1888 ,6,1,6,0,1,0,58.90 ,51.26 ,16.67 
01,001,06,010,0000,0,89060,1439,90499,215890,1888 ,6,1,6,0,1,0,58.90 ,41.92 ,16.67 
01,001,06,011,0000,0,20441,351,20792,40060,1888 ,6,1,6,0,1,0,58.90 ,51.90 ,16.67 
01,001,06,012,0000,0,20326,272,20598,37941,1888 ,6,1,6,0,1,0,58.90 ,54.29 ,16.67 
01,001,06,013,0000,0,16235,240,16475,29992,1888 ,6,1,6,0,1,0,58.90 ,54.93 ,16.67 
01,001,07,014,0000,0,31546,783,32329,70646,1888 ,6,1,6,0,1,0,58.90 ,45.76 ,16.67 
01,001,07,015,0000,0,8949,150,9099,14506,1888 ,6,1,6,0,1,0,58.90 ,62.73 ,16.67 
01,001,07,016,0000,0,5268,148,5416,7221,1888 ,6,1,6,0,1,0,58.90 ,75.00 ,16.67 
01,001,07,017,0000,0,7808,174,7982,16675,1888 ,6,1,6,0,1,0,58.90 ,47.87 ,16.67 
01,001,08,018,0000,0,38014,675,38689,94660,1888 ,6,1,6,0,1,0,58.90 ,40.87 ,16.67 
01,001,08,019,0000,0,10714,318,11032,14101,1888 ,6,1,6,0,1,0,58.90 ,78.24 ,16.67 
01,001,08,020,0000,0,9299,336,9635,13454,1888 ,6,1,6,0,1,0,58.90 ,71.61 ,16.67 
01,001,09,021,0000,0,23515,606,24121,35152,1888 ,6,1,6,0,1,0,58.90 ,68.62 ,16.67 
01,001,09,022,0000,0,3477,133,3610,4896,1888 ,6,1,6,0,1,0,58.90 ,73.73 ,16.67 
01,001,09,023,0000,0,6456,149,6605,8590,1888 ,6,1,6,0,1,0,58.90 ,76.89 ,16.67 
01,001,09,024,0000,0,7665,167,7832,10439,1888 ,6,1,6,0,1,0,58.90 ,75.03 ,16.67 
01,001,10,025,0000,0,73870,992,74862,181444,1888 ,6,1,6,0,1,0,58.90 ,41.26 ,16.67 
01,001,10,026,0000,0,6119,173,6292,13221,1888 ,6,1,6,0,1,0,58.90 ,47.59 ,16.67 
01,001,10,027,0000,0,3987,126,4113,5834,1888 ,6,1,6,0,1,0,58.90 ,70.50 ,16.67 
01,001,10,028,0000,0,3816,142,3958,4685,1888 ,6,1,6,0,1,0,58.90 ,84.48 ,16.67 
01,001,10,029,0000,0,1031,29,1060,1509,1888 ,6,1,6,0,1,0,58.90 ,70.25 ,16.67 
01,002,01,001,0000,0,39462,539,40001,60852,1888 ,6,1,6,0,1,0,58.90 ,65.73 ,16.67 
01,002,02,002,0000,0,16135,284,16419,22913,1888 ,6,1,6,0,1,0,58.90 ,71.66 ,16.67 
01,002,03,003,0000,0,18890,281,19171,26284,1888 ,6,1,6,0,1,0,58.90 ,72.94 ,16.67 
01,002,04,004,0000,0,15226,278,15504,23511,1888 ,6,1,6,0,1,0,58.90 ,65.94 ,16.67 
01,002,05,005,0000,0,14361,216,14577,18883,1888 ,6,1,6,0,1,0,58.90 ,77.20 ,16.67 
01,002,06,006,0000,0,25137,306,25443,44533,1888 ,6,1,6,0,1,0,58.90 ,57.13 ,16.67 
01,002,07,007,0000,0,16391,208,16599,26559,1888 ,6,1,6,0,1,0,58.90 ,62.50 ,16.67 
01,002,08,008,0000,0,22540,315,22855,35569,1888 ,6,1,6,0,1,0,58.90 ,64.26 ,16.67 
01,002,09,009,0000,0,11121,187,11308,16386,1888 ,6,1,6,0,1,0,58.90 ,69.01 ,16.67 
01,002,09,010,0000,0,667,17,684,996,1888 ,6,1,6,0,1,0,58.90 ,68.67 ,16.67 
01,002,10,011,0000,0,22707,357,23064,33487,1888 ,6,1,6,0,1,0,58.90 ,68.87 ,16.67 
01,002,10,012,0000,0,533,32,565,877,1888 ,6,1,6,0,1,0,58.90 ,64.42 ,16.67 
01,003,01,001,0000,0,89967,1396,91363,185992,1888 ,6,1,6,0,1,0,58.90 ,49.12 ,16.67 
01,003,02,002,0000,0,33349,622,33971,70021,1888 ,6,1,6,0,1,0,58.90 ,48.52 ,16.67 
01,003,03,003,0000,0,52761,1466,54227,97703,1888 ,6,1,6,0,1,0,58.90 ,55.50 ,16.67 
01,003,04,004,0000,0,26677,456,27133,50025,1888 ,6,1,6,0,1,0,58.90 ,54.24 ,16.67 
01,003,05,005,0000,0,29337,575,29912,46083,1888 ,6,1,6,0,1,0,58.90 ,64.91 ,16.67 
01,003,06,006,0000,0,29394,636,30030,52594,1888 ,6,1,6,0,1,0,58.90 ,57.10 ,16.67 
01,003,06,007,0000,0,1820,64,1884,2734,1888 ,6,1,6,0,1,0,58.90 ,68.91 ,16.67 
01,003,07,008,0000,0,107788,1754,109542,201700,1888 ,6,1,6,0,1,0,58.90 ,54.31 ,16.67 
01,003,08,009,0000,0,56149,1127,57276,111651,1888 ,6,1,6,0,1,0,58.90 ,51.30 ,16.67 
01,003,09,010,0000,0,39968,788,40756,75725,1888 ,6,1,6,0,1,0,58.90 ,53.82 ,16.67 
01,003,10,011,0000,0,34121,597,34718,61316,1888 ,6,1,6,0,1,0,58.90 ,56.62 ,16.67 
01,003,11,012,0000,0,22748,327,23075,33553,1888 ,6,1,6,0,1,0,58.90 ,68.77 ,16.67 
01,003,12,013,0000,0,21346,369,21715,34179,1888 ,6,1,6,0,1,0,58.90 ,63.53 ,16.67 
01,004,01,001,0000,0,31815,652,32467,52546,1888 ,6,1,6,0,1,0,58.90 ,61.79 ,16.67 
01,004,02,002,0000,0,29027,623,29650,40816,1888 ,6,1,6,0,1,0,58.90 ,72.64 ,16.67 
01,004,03,003,0000,0,17424,316,17740,27553,1888 ,6,1,6,0,1,0,58.90 ,64.39 ,16.67 
01,004,04,004,0000,0,16552,318,16870,22682,1888 ,6,1,6,0,1,0,58.90 ,74.38 ,16.67 
01,004,05,005,0000,0,16983,302,17285,24925,1888 ,6,1,6,0,1,0,58.90 ,69.35 ,16.67 
01,004,06,006,0000,0,8086,169,8255,10930,1888 ,6,1,6,0,1,0,58.90 ,75.53 ,16.67 
01,004,06,007,0000,0,691,43,734,1048,1888 ,6,1,6,0,1,0,58.90 ,70.04 ,16.67 
01,004,07,008,0000,0,9442,219,9661,13235,1888 ,6,1,6,0,1,0,58.90 ,73.00 ,16.67 
01,004,08,009,0000,0,35368,925,36293,54780,1888 ,6,1,6,0,1,0,58.90 ,66.25 ,16.67 
01,004,08,010,0000,0,6503,168,6671,8852,1888 ,6,1,6,0,1,0,58.90 ,75.36 ,16.67 
01,004,08,011,0000,0,265,21,286,376,1888 ,6,1,6,0,1,0,58.90 ,76.06 ,16.67 
01,004,09,012,0000,0,6120,152,6272,7483,1888 ,6,1,6,0,1,0,58.90 ,83.82 ,16.67 
01,004,09,013,0000,0,4082,85,4167,4942,1888 ,6,1,6,0,1,0,58.90 ,84.32 ,16.67 
01,005,01,001,0000,0,38172,624,38796,60619,1888 ,6,1,6,0,1,0,58.90 ,64.00 ,16.67 
01,005,01,002,0000,0,15083,218,15301,23300,1888 ,6,1,6,0,1,0,58.90 ,65.67 ,16.67 
01,005,01,003,0000,0,7058,147,7205,8826,1888 ,6,1,6,0,1,0,58.90 ,81.63 ,16.67 
01,005,02,004,0000,0,10798,236,11034,14638,1888 ,6,1,6,0,1,0,58.90 ,75.38 ,16.67 
01,005,02,005,0000,0,8957,118,9075,12043,1888 ,6,1,6,0,1,0,58.90 ,75.35 ,16.67 
01,005,02,006,0000,0,4669,113,4782,6732,1888 ,6,1,6,0,1,0,58.90 ,71.03 ,16.67 
01,005,03,007,0000,0,22524,340,22864,33122,1888 ,6,1,6,0,1,0,58.90 ,69.03 ,16.67 
01,005,03,008,0000,0,20725,258,20983,28966,1888 ,6,1,6,0,1,0,58.90 ,72.44 ,16.67 
01,005,04,009,0000,0,27754,517,28271,43585,1888 ,6,1,6,0,1,0,58.90 ,64.86 ,16.67 
01,005,04,010,0000,0,18820,377,19197,30036,1888 ,6,1,6,0,1,0,58.90 ,63.91 ,16.67 
01,005,04,011,0000,0,6074,82,6156,9966,1888 ,6,1,6,0,1,0,58.90 ,61.77 ,16.67 
01,005,05,012,0000,0,34064,642,34706,55744,1888 ,6,1,6,0,1,0,58.90 ,62.26 ,16.67 
01,005,05,013,0000,0,5432,108,5540,8081,1888 ,6,1,6,0,1,0,58.90 ,68.56 ,16.67 
01,005,05,014,0000,0,4311,58,4369,5881,1888 ,6,1,6,0,1,0,58.90 ,74.29 ,16.67 
01,005,06,015,0000,0,9707,159,9866,13874,1888 ,6,1,6,0,1,0,58.90 ,71.11 ,16.67 
01,005,06,016,0000,0,8304,152,8456,12869,1888 ,6,1,6,0,1,0,58.90 ,65.71 ,16.67 
01,005,06,017,0000,0,3091,157,3248,4353,1888 ,6,1,6,0,1,0,58.90 ,74.62 ,16.67 
01,005,06,018,0000,0,1142,41,1183,1456,1888 ,6,1,6,0,1,0,58.90 ,81.25 ,16.67 
01,006,01,001,0000,0,58146,1077,59223,102667,1888 ,6,1,6,0,1,0,58.90 ,57.68 ,16.67 
01,006,01,002,0000,0,26478,589,27067,36531,1888 ,6,1,6,0,1,0,58.90 ,74.09 ,16.67 
01,006,02,003,0000,0,27645,630,28275,38713,1888 ,6,1,6,0,1,0,58.90 ,73.04 ,16.67 
01,006,02,004,0000,0,27794,541,28335,52419,1888 ,6,1,6,0,1,0,58.90 ,54.05 ,16.67 
01,006,02,005,0000,0,28916,850,29766,45727,1888 ,6,1,6,0,1,0,58.90 ,65.10 ,16.67 
01,006,03,006,0000,0,27942,536,28478,41220,1888 ,6,1,6,0,1,0,58.90 ,69.09 ,16.67 
01,006,03,007,0000,0,14777,324,15101,19209,1888 ,6,1,6,0,1,0,58.90 ,78.61 ,16.67 
01,006,03,008,0000,0,8292,203,8495,10914,1888 ,6,1,6,0,1,0,58.90 ,77.84 ,16.67 
01,006,03,009,0000,0,4122,90,4212,5819,1888 ,6,1,6,0,1,0,58.90 ,72.38 ,16.67 
01,006,04,010,0000,0,32762,773,33535,49247,1888 ,6,1,6,0,1,0,58.90 ,68.10 ,16.67 
01,006,04,011,0000,0,15598,342,15940,19661,1888 ,6,1,6,0,1,0,58.90 ,81.07 ,16.67 
01,006,04,012,0000,0,9988,163,10151,14478,1888 ,6,1,6,0,1,0,58.90 ,70.11 ,16.67 
01,006,05,013,0000,0,39169,678,39847,55309,1888 ,6,1,6,0,1,0,58.90 ,72.04 ,16.67 
01,006,05,014,0000,0,35672,730,36402,44891,1888 ,6,1,6,0,1,0,58.90 ,81.09 ,16.67 
01,006,05,015,0000,0,23409,537,23946,30241,1888 ,6,1,6,0,1,0,58.90 ,79.18 ,16.67 
01,006,06,016,0000,0,29724,532,30256,40772,1888 ,6,1,6,0,1,0,58.90 ,74.21 ,16.67 
01,006,06,017,0000,0,24654,496,25150,33402,1888 ,6,1,6,0,1,0,58.90 ,75.29 ,16.67 
01,006,06,018,0000,0,29490,688,30178,38505,1888 ,6,1,6,0,1,0,58.90 ,78.37 ,16.67 
01,006,07,019,0000,0,30634,636,31270,44200,1888 ,6,1,6,0,1,0,58.90 ,70.75 ,16.67 
01,006,07,020,0000,0,56599,1393,57992,99365,1888 ,6,1,6,0,1,0,58.90 ,58.36 ,16.67 
01,006,07,021,0000,0,58250,1058,59308,101786,1888 ,6,1,6,0,1,0,58.90 ,58.27 ,16.67 
01,007,01,001,0000,0,101314,2622,103936,145328,1888 ,6,1,6,0,1,0,58.90 ,71.52 ,16.67 
01,007,01,002,0000,0,22283,448,22731,29547,1888 ,6,1,6,0,1,0,58.90 ,76.93 ,16.67 
01,007,01,003,0000,0,13805,243,14048,18495,1888 ,6,1,6,0,1,0,58.90 ,75.96 ,16.67 
01,007,02,004,0000,0,38212,727,38939,52926,1888 ,6,1,6,0,1,0,58.90 ,73.57 ,16.67 
01,007,02,005,0000,0,25236,507,25743,30915,1888 ,6,1,6,0,1,0,58.90 ,83.27 ,16.67 
01,007,02,006,0000,0,18688,421,19109,23675,1888 ,6,1,6,0,1,0,58.90 ,80.71 ,16.67 
01,007,03,007,0000,0,41085,1257,42342,53174,1888 ,6,1,6,0,1,0,58.90 ,79.63 ,16.67 
01,007,03,008,0000,0,7896,142,8038,10830,1888 ,6,1,6,0,1,0,58.90 ,74.22 ,16.67 
01,007,03,009,0000,0,17368,426,17794,20850,1888 ,6,1,6,0,1,0,58.90 ,85.34 ,16.67 
01,007,04,010,0000,0,56351,1177,57528,81030,1888 ,6,1,6,0,1,0,58.90 ,71.00 ,16.67 
01,007,04,011,0000,0,18408,362,18770,23185,1888 ,6,1,6,0,1,0,58.90 ,80.96 ,16.67 
01,007,04,012,0000,0,20472,399,20871,26575,1888 ,6,1,6,0,1,0,58.90 ,78.54 ,16.67 
01,007,05,013,0000,0,27617,544,28161,35109,1888 ,6,1,6,0,1,0,58.90 ,80.21 ,16.67 
01,007,05,014,0000,0,20462,460,20922,24299,1888 ,6,1,6,0,1,0,58.90 ,86.10 ,16.67 
01,007,05,015,0000,0,17687,404,18091,22971,1888 ,6,1,6,0,1,0,58.90 ,78.76 ,16.67 
01,007,06,016,0000,0,23793,552,24345,32375,1888 ,6,1,6,0,1,0,58.90 ,75.20 ,16.67 
01,007,06,017,0000,0,23528,496,24024,29596,1888 ,6,1,6,0,1,0,58.90 ,81.17 ,16.67 
01,007,06,018,0000,0,10465,161,10626,13605,1888 ,6,1,6,0,1,0,58.90 ,78.10 ,16.67 
01,007,07,019,0000,0,17050,456,17506,22260,1888 ,6,1,6,0,1,0,58.90 ,78.64 ,16.67 
01,007,07,020,0000,0,15932,607,16539,19961,1888 ,6,1,6,0,1,0,58.90 ,82.86 ,16.67 
01,007,07,021,0000,0,14749,523,15272,22565,1888 ,6,1,6,0,1,0,58.90 ,67.68 ,16.67 
01,007,07,022,0000,0,14936,362,15298,23537,1888 ,6,1,6,0,1,0,58.90 ,65.00 ,16.67 
01,007,08,023,0000,0,29345,506,29851,38732,1888 ,6,1,6,0,1,0,58.90 ,77.07 ,16.67 
01,007,08,024,0000,0,20850,305,21155,29585,1888 ,6,1,6,0,1,0,58.90 ,71.51 ,16.67 
01,007,08,025,0000,0,12533,243,12776,16408,1888 ,6,1,6,0,1,0,58.90 ,77.86 ,16.67 
01,007,08,026,0000,0,9703,132,9835,12747,1888 ,6,1,6,0,1,0,58.90 ,77.16 ,16.67 
01,008,01,001,0000,0,48131,708,48839,68328,1888 ,6,1,6,0,1,0,58.90 ,71.48 ,16.67 
01,008,01,002,0000,0,22585,345,22930,29917,1888 ,6,1,6,0,1,0,58.90 ,76.65 ,16.67 
01,008,02,003,0000,0,43094,654,43748,63954,1888 ,6,1,6,0,1,0,58.90 ,68.41 ,16.67 
01,008,02,004,0000,0,10430,165,10595,13818,1888 ,6,1,6,0,1,0,58.90 ,76.68 ,16.67 
01,008,03,005,0000,0,6628,111,6739,8979,1888 ,6,1,6,0,1,0,58.90 ,75.05 ,16.67 
01,008,03,006,0000,0,8076,91,8167,13267,1888 ,6,1,6,0,1,0,58.90 ,61.56 ,16.67 
01,008,03,007,0000,0,11535,208,11743,16817,1888 ,6,1,6,0,1,0,58.90 ,69.83 ,16.67 
01,008,03,008,0000,0,3813,51,3864,6039,1888 ,6,1,6,0,1,0,58.90 ,63.98 ,16.67 
01,008,04,009,0000,0,26782,337,27119,43102,1888 ,6,1,6,0,1,0,58.90 ,62.92 ,16.67 
01,008,04,010,0000,0,11927,168,12095,15399,1888 ,6,1,6,0,1,0,58.90 ,78.54 ,16.67 
01,008,05,011,0000,0,37034,584,37618,59387,1888 ,6,1,6,0,1,0,58.90 ,63.34 ,16.67 
01,008,05,012,0000,0,10819,171,10990,18020,1888 ,6,1,6,0,1,0,58.90 ,60.99 ,16.67 
01,008,05,013,0000,0,1608,51,1659,2675,1888 ,6,1,6,0,1,0,58.90 ,62.02 ,16.67 
01,009,01,001,0000,0,47048,948,47996,64807,1888 ,6,1,6,0,1,0,58.90 ,74.06 ,16.67 
01,009,01,002,0000,0,17108,275,17383,22047,1888 ,6,1,6,0,1,0,58.90 ,78.85 ,16.67 
01,009,01,003,0000,0,11291,312,11603,14641,1888 ,6,1,6,0,1,0,58.90 ,79.25 ,16.67 
01,009,02,004,0000,0,23595,493,24088,32554,1888 ,6,1,6,0,1,0,58.90 ,73.99 ,16.67 
01,009,02,005,0000,0,19518,341,19859,25958,1888 ,6,1,6,0,1,0,58.90 ,76.50 ,16.67 
01,009,02,006,0000,0,12964,224,13188,16973,1888 ,6,1,6,0,1,0,58.90 ,77.70 ,16.67 
01,009,03,007,0000,0,33308,737,34045,45515,1888 ,6,1,6,0,1,0,58.90 ,74.80 ,16.67 
01,009,03,008,0000,0,15591,203,15794,22930,1888 ,6,1,6,0,1,0,58.90 ,68.88 ,16.67 
01,009,03,009,0000,0,9022,156,9178,11103,1888 ,6,1,6,0,1,0,58.90 ,82.66 ,16.67 
01,009,03,010,0000,0,16928,240,17168,24376,1888 ,6,1,6,0,1,0,58.90 ,70.43 ,16.67 
01,009,04,011,0000,0,25355,336,25691,34807,1888 ,6,1,6,0,1,0,58.90 ,73.81 ,16.67 
01,009,04,012,0000,0,17655,221,17876,23938,1888 ,6,1,6,0,1,0,58.90 ,74.68 ,16.67 
01,009,04,013,0000,0,16310,232,16542,21069,1888 ,6,1,6,0,1,0,58.90 ,78.51 ,16.67 
01,009,05,014,0000,0,17795,370,18165,22185,1888 ,6,1,6,0,1,0,58.90 ,81.88 ,16.67 
01,009,05,015,0000,0,11543,218,11761,14368,1888 ,6,1,6,0,1,0,58.90 ,81.86 ,16.67 
01,009,05,016,0000,0,18115,267,18382,21820,1888 ,6,1,6,0,1,0,58.90 ,84.24 ,16.67 
01,009,05,017,0000,0,15752,318,16070,23301,1888 ,6,1,6,0,1,0,58.90 ,68.97 ,16.67 
01,009,06,018,0000,0,25002,378,25380,33359,1888 ,6,1,6,0,1,0,58.90 ,76.08 ,16.67 
01,009,06,019,0000,0,19385,289,19674,24488,1888 ,6,1,6,0,1,0,58.90 ,80.34 ,16.67 
01,009,06,020,0000,0,19459,281,19740,25273,1888 ,6,1,6,0,1,0,58.90 ,78.11 ,16.67 
01,010,01,001,0000,0,16210,351,16561,20588,1888 ,6,1,6,0,1,0,58.90 ,80.44 ,16.67 
01,010,01,002,0000,0,10643,192,10835,14252,1888 ,6,1,6,0,1,0,58.90 ,76.02 ,16.67 
01,010,01,003,0000,0,27593,723,28316,38249,1888 ,6,1,6,0,1,0,58.90 ,74.03 ,16.67 
01,010,02,004,0000,0,33896,679,34575,45890,1888 ,6,1,6,0,1,0,58.90 ,75.34 ,16.67 
01,010,02,005,0000,0,18967,354,19321,25205,1888 ,6,1,6,0,1,0,58.90 ,76.66 ,16.67 
01,010,03,006,0000,0,19131,379,19510,26217,1888 ,6,1,6,0,1,0,58.90 ,74.42 ,16.67 
01,010,03,007,0000,0,9368,178,9546,13983,1888 ,6,1,6,0,1,0,58.90 ,68.27 ,16.67 
01,010,03,008,0000,0,13326,192,13518,17145,1888 ,6,1,6,0,1,0,58.90 ,78.85 ,16.67 
01,010,04,009,0000,0,21469,389,21858,30997,1888 ,6,1,6,0,1,0,58.90 ,70.52 ,16.67 
01,010,04,010,0000,0,15895,302,16197,23139,1888 ,6,1,6,0,1,0,58.90 ,70.00 ,16.67 
01,010,04,011,0000,0,15480,240,15720,23460,1888 ,6,1,6,0,1,0,58.90 ,67.01 ,16.67 
01,010,05,012,0000,0,18838,370,19208,25150,1888 ,6,1,6,0,1,0,58.90 ,76.37 ,16.67 
01,010,05,013,0000,0,15556,277,15833,18608,1888 ,6,1,6,0,1,0,58.90 ,85.09 ,16.67 
01,010,06,014,0000,0,22648,405,23053,32906,1888 ,6,1,6,0,1,0,58.90 ,70.06 ,16.67 
01,010,06,015,0000,0,20415,338,20753,29209,1888 ,6,1,6,0,1,0,58.90 ,71.05 ,16.67 
01,010,06,016,0000,0,6636,107,6743,8893,1888 ,6,1,6,0,1,0,58.90 ,75.82 ,16.67 
01,010,06,017,0000,0,2147,37,2184,2861,1888 ,6,1,6,0,1,0,58.90 ,76.34 ,16.67 
01,010,06,018,0000,0,1145,22,1167,1931,1888 ,6,1,6,0,1,0,58.90 ,60.44 ,16.67 
01,011,01,001,0000,0,33638,873,34511,50866,1888 ,6,1,6,0,1,0,58.90 ,67.85 ,16.67 
01,011,01,002,0000,0,14772,333,15105,20989,1888 ,6,1,6,0,1,0,58.90 ,71.97 ,16.67 
01,011,01,003,0000,0,12190,197,12387,17798,1888 ,6,1,6,0,1,0,58.90 ,69.60 ,16.67 
01,011,02,004,0000,0,18148,329,18477,26879,1888 ,6,1,6,0,1,0,58.90 ,68.74 ,16.67 
01,011,02,005,0000,0,15695,197,15892,21862,1888 ,6,1,6,0,1,0,58.90 ,72.69 ,16.67 
01,011,02,006,0000,0,14143,260,14403,19437,1888 ,6,1,6,0,1,0,58.90 ,74.10 ,16.67 
01,011,03,007,0000,0,25361,462,25823,33481,1888 ,6,1,6,0,1,0,58.90 ,77.13 ,16.67 
01,011,03,008,0000,0,15613,234,15847,20340,1888 ,6,1,6,0,1,0,58.90 ,77.91 ,16.67 
01,011,03,009,0000,0,12697,201,12898,17523,1888 ,6,1,6,0,1,0,58.90 ,73.61 ,16.67 
01,011,03,010,0000,0,11811,184,11995,17544,1888 ,6,1,6,0,1,0,58.90 ,68.37 ,16.67 
01,011,04,011,0000,0,27707,364,28071,38425,1888 ,6,1,6,0,1,0,58.90 ,73.05 ,16.67 
01,011,04,012,0000,0,13978,203,14181,17576,1888 ,6,1,6,0,1,0,58.90 ,80.68 ,16.67 
01,011,04,013,0000,0,14554,186,14740,19630,1888 ,6,1,6,0,1,0,58.90 ,75.09 ,16.67 
01,011,05,014,0000,0,15978,266,16244,21451,1888 ,6,1,6,0,1,0,58.90 ,75.73 ,16.67 
01,011,05,015,0000,0,13846,162,14008,17931,1888 ,6,1,6,0,1,0,58.90 ,78.12 ,16.67 
01,011,05,016,0000,0,8713,93,8806,10390,1888 ,6,1,6,0,1,0,58.90 ,84.75 ,16.67 
01,011,06,017,0000,0,7693,127,7820,9561,1888 ,6,1,6,0,1,0,58.90 ,81.79 ,16.67 
01,011,06,018,0000,0,21205,402,21607,30535,1888 ,6,1,6,0,1,0,58.90 ,70.76 ,16.67 
01,011,06,019,0000,0,5194,92,5286,5957,1888 ,6,1,6,0,1,0,58.90 ,88.74 ,16.67 
01,011,07,020,0000,0,20296,414,20710,29231,1888 ,6,1,6,0,1,0,58.90 ,70.85 ,16.67 
01,011,07,021,0000,0,16220,340,16560,20468,1888 ,6,1,6,0,1,0,58.90 ,80.91 ,16.67 
01,011,08,022,0000,0,9584,128,9712,12632,1888 ,6,1,6,0,1,0,58.90 ,76.88 ,16.67 
01,011,08,023,0000,0,7938,132,8070,9265,1888 ,6,1,6,0,1,0,58.90 ,87.10 ,16.67 
01,011,08,024,0000,0,6144,87,6231,7459,1888 ,6,1,6,0,1,0,58.90 ,83.54 ,16.67 
01,011,08,025,0000,0,4176,51,4227,5081,1888 ,6,1,6,0,1,0,58.90 ,83.19 ,16.67 
01,011,09,026,0000,0,31911,626,32537,44344,1888 ,6,1,6,0,1,0,58.90 ,73.37 ,16.67 
01,011,09,027,0000,0,27995,417,28412,39940,1888 ,6,1,6,0,1,0,58.90 ,71.14 ,16.67 
01,011,09,028,0000,0,20664,227,20891,27323,1888 ,6,1,6,0,1,0,58.90 ,76.46 ,16.67 
01,011,09,029,0000,0,3060,36,3096,3680,1888 ,6,1,6,0,1,0,58.90 ,84.13 ,16.67 
01,011,10,030,0000,0,14869,205,15074,21128,1888 ,6,1,6,0,1,0,58.90 ,71.35 ,16.67 
01,011,10,031,0000,0,58108,848,58956,119113,1888 ,6,1,6,0,1,0,58.90 ,49.50 ,16.67 
01,012,01,001,0000,0,123420,1882,125302,210330,1888 ,6,1,6,0,1,0,58.90 ,59.57 ,16.67 
01,012,02,002,0000,0,25062,280,25342,32831,1888 ,6,1,6,0,1,0,58.90 ,77.19 ,16.67 
01,012,02,003,0000,0,17733,267,18000,22580,1888 ,6,1,6,0,1,0,58.90 ,79.72 ,16.67 
01,012,02,004,0000,0,22926,513,23439,31072,1888 ,6,1,6,0,1,0,58.90 ,75.43 ,16.67 
01,012,02,005,0000,0,18601,367,18968,25212,1888 ,6,1,6,0,1,0,58.90 ,75.23 ,16.67 
01,012,03,006,0000,0,37058,625,37683,46562,1888 ,6,1,6,0,1,0,58.90 ,80.93 ,16.67 
01,012,03,007,0000,0,56377,915,57292,77587,1888 ,6,1,6,0,1,0,58.90 ,73.84 ,16.67 
01,012,04,008,0000,0,38918,546,39464,61057,1888 ,6,1,6,0,1,0,58.90 ,64.63 ,16.67 
01,012,04,009,0000,0,20135,319,20454,26920,1888 ,6,1,6,0,1,0,58.90 ,75.98 ,16.67 
01,012,04,010,0000,0,18218,376,18594,23155,1888 ,6,1,6,0,1,0,58.90 ,80.30 ,16.67 
01,012,05,011,0000,0,6396,219,6615,7944,1888 ,6,1,6,0,1,0,58.90 ,83.27 ,16.67 
01,012,05,012,0000,0,14218,443,14661,20638,1888 ,6,1,6,0,1,0,58.90 ,71.04 ,16.67 
01,012,06,013,0000,0,29309,597,29906,35756,1888 ,6,1,6,0,1,0,58.90 ,83.64 ,16.67 
01,012,06,014,0000,0,14969,284,15253,19341,1888 ,6,1,6,0,1,0,58.90 ,78.86 ,16.67 
01,012,06,015,0000,0,18823,294,19117,22893,1888 ,6,1,6,0,1,0,58.90 ,83.51 ,16.67 
01,012,06,016,0000,0,9184,154,9338,10607,1888 ,6,1,6,0,1,0,58.90 ,88.04 ,16.67 
01,012,06,017,0000,0,13462,214,13676,15777,1888 ,6,1,6,0,1,0,58.90 ,86.68 ,16.67 
01,012,06,018,0000,0,20945,348,21293,27199,1888 ,6,1,6,0,1,0,58.90 ,78.29 ,16.67 
01,012,07,019,0000,0,24751,335,25086,32718,1888 ,6,1,6,0,1,0,58.90 ,76.67 ,16.67 
01,012,07,020,0000,0,5326,90,5416,6488,1888 ,6,1,6,0,1,0,58.90 ,83.48 ,16.67 
01,012,07,021,0000,0,7680,168,7848,10534,1888 ,6,1,6,0,1,0,58.90 ,74.50 ,16.67 
01,012,07,022,0000,0,11811,166,11977,13439,1888 ,6,1,6,0,1,0,58.90 ,89.12 ,16.67 
01,012,07,023,0000,0,223,13,236,292,1888 ,6,1,6,0,1,0,58.90 ,80.82 ,16.67 
01,012,08,024,0000,0,26957,402,27359,35183,1888 ,6,1,6,0,1,0,58.90 ,77.76 ,16.67 
01,012,08,025,0000,0,8622,234,8856,13070,1888 ,6,1,6,0,1,0,58.90 ,67.76 ,16.67 
01,012,08,026,0000,0,131,8,139,162,1888 ,6,1,6,0,1,0,58.90 ,85.80 ,16.67 
01,012,08,027,0000,0,215,17,232,384,1888 ,6,1,6,0,1,0,58.90 ,60.42 ,16.67 
01,013,01,001,0000,0,92996,1195,94191,144094,1888 ,6,1,6,0,1,0,58.90 ,65.37 ,16.67 
01,013,02,002,0000,0,14633,225,14858,20753,1888 ,6,1,6,0,1,0,58.90 ,71.59 ,16.67 
01,013,02,003,0000,0,6498,109,6607,8325,1888 ,6,1,6,0,1,0,58.90 ,79.36 ,16.67 
01,013,02,004,0000,0,12402,182,12584,15710,1888 ,6,1,6,0,1,0,58.90 ,80.10 ,16.67 
01,013,02,005,0000,0,15010,242,15252,18998,1888 ,6,1,6,0,1,0,58.90 ,80.28 ,16.67 
01,013,02,006,0000,0,15714,387,16101,19662,1888 ,6,1,6,0,1,0,58.90 ,81.89 ,16.67 
01,013,02,007,0000,0,15693,288,15981,22581,1888 ,6,1,6,0,1,0,58.90 ,70.77 ,16.67 
01,013,02,008,0000,0,236,20,256,383,1888 ,6,1,6,0,1,0,58.90 ,66.84 ,16.67 
01,013,02,009,0000,0,74,4,78,108,1888 ,6,1,6,0,1,0,58.90 ,72.22 ,16.67 
01,013,02,010,0000,0,237,16,253,370,1888 ,6,1,6,0,1,0,58.90 ,68.38 ,16.67 
01,013,03,011,0000,0,25401,374,25775,38584,1888 ,6,1,6,0,1,0,58.90 ,66.80 ,16.67 
01,013,03,012,0000,0,12669,208,12877,17432,1888 ,6,1,6,0,1,0,58.90 ,73.87 ,16.67 
01,013,03,013,0000,0,27750,435,28185,43570,1888 ,6,1,6,0,1,0,58.90 ,64.69 ,16.67 
01,013,03,014,0000,0,10780,164,10944,14205,1888 ,6,1,6,0,1,0,58.90 ,77.04 ,16.67 
01,013,03,015,0000,0,6649,113,6762,8944,1888 ,6,1,6,0,1,0,58.90 ,75.60 ,16.67 
01,013,03,016,0000,0,15738,260,15998,21346,1888 ,6,1,6,0,1,0,58.90 ,74.95 ,16.67 
01,013,03,017,0000,0,91,12,103,166,1888 ,6,1,6,0,1,0,58.90 ,62.05 ,16.67 
01,013,03,018,0000,0,191,22,213,395,1888 ,6,1,6,0,1,0,58.90 ,53.92 ,16.67 
01,013,03,019,0000,0,256,13,269,399,1888 ,6,1,6,0,1,0,58.90 ,67.42 ,16.67 
01,013,04,020,0000,0,22995,267,23262,32171,1888 ,6,1,6,0,1,0,58.90 ,72.31 ,16.67 
01,013,04,021,0000,0,26845,370,27215,36003,1888 ,6,1,6,0,1,0,58.90 ,75.59 ,16.67 
01,013,04,022,0000,0,23035,405,23440,27982,1888 ,6,1,6,0,1,0,58.90 ,83.77 ,16.67 
01,013,05,023,0000,0,7674,134,7808,9859,1888 ,6,1,6,0,1,0,58.90 ,79.20 ,16.67 
01,013,05,024,0000,0,11397,196,11593,16462,1888 ,6,1,6,0,1,0,58.90 ,70.42 ,16.67 
01,013,05,025,0000,0,6983,110,7093,9709,1888 ,6,1,6,0,1,0,58.90 ,73.06 ,16.67 
01,013,05,026,0000,0,12353,217,12570,17380,1888 ,6,1,6,0,1,0,58.90 ,72.32 ,16.67 
01,013,06,027,0000,0,15064,246,15310,22004,1888 ,6,1,6,0,1,0,58.90 ,69.58 ,16.67 
01,013,06,028,0000,0,5732,123,5855,8327,1888 ,6,1,6,0,1,0,58.90 ,70.31 ,16.67 
01,013,06,029,0000,0,4070,81,4151,5545,1888 ,6,1,6,0,1,0,58.90 ,74.86 ,16.67 
01,013,06,030,0000,0,4150,119,4269,5196,1888 ,6,1,6,0,1,0,58.90 ,82.16 ,16.67 
01,013,06,031,0000,0,179,13,192,310,1888 ,6,1,6,0,1,0,58.90 ,61.94 ,16.67 
01,013,06,032,0000,0,198,15,213,369,1888 ,6,1,6,0,1,0,58.90 ,57.72 ,16.67 
01,013,07,033,0000,0,7282,193,7475,9608,1888 ,6,1,6,0,1,0,58.90 ,77.80 ,16.67 
01,014,01,001,0000,0,43324,776,44100,65207,1888 ,6,1,6,0,1,0,58.90 ,67.63 ,16.67 
01,014,01,002,0000,0,1409,31,1440,1863,1888 ,6,1,6,0,1,0,58.90 ,77.29 ,16.67 
01,014,01,003,0000,0,95,0,95,149,1888 ,6,1,6,0,1,0,58.90 ,63.76 ,16.67 
01,014,02,004,0000,0,7223,176,7399,11392,1888 ,6,1,6,0,1,0,58.90 ,64.95 ,16.67 
01,014,02,005,0000,0,150,3,153,289,1888 ,6,1,6,0,1,0,58.90 ,52.94 ,16.67 
01,014,03,006,0000,0,4132,45,4177,6442,1888 ,6,1,6,0,1,0,58.90 ,64.84 ,16.67 
01,014,03,007,0000,0,2544,24,2568,4575,1888 ,6,1,6,0,1,0,58.90 ,56.13 ,16.67 
01,014,03,008,0000,0,2136,53,2189,3689,1888 ,6,1,6,0,1,0,58.90 ,59.34 ,16.67 
01,014,04,009,0000,0,4309,62,4371,6443,1888 ,6,1,6,0,1,0,58.90 ,67.84 ,16.67 
01,014,04,010,0000,0,3927,86,4013,5795,1888 ,6,1,6,0,1,0,58.90 ,69.25 ,16.67 
01,014,04,011,0000,0,4288,70,4358,6761,1888 ,6,1,6,0,1,0,58.90 ,64.46 ,16.67 
01,014,04,012,0000,0,189,5,194,339,1888 ,6,1,6,0,1,0,58.90 ,57.23 ,16.67 
01,014,05,013,0000,0,4076,71,4147,6551,1888 ,6,1,6,0,1,0,58.90 ,63.30 ,16.67 
01,014,05,014,0000,0,1443,20,1463,2564,1888 ,6,1,6,0,1,0,58.90 ,57.06 ,16.67 
01,014,05,015,0000,0,142,5,147,213,1888 ,6,1,6,0,1,0,58.90 ,69.01 ,16.67 
01,014,05,016,0000,0,164,5,169,410,1888 ,6,1,6,0,1,0,58.90 ,41.22 ,16.67 
01,015,01,001,0000,0,41180,603,41783,68729,1888 ,6,1,6,0,1,0,58.90 ,60.79 ,16.67 
01,015,02,002,0000,0,7150,140,7290,11953,1888 ,6,1,6,0,1,0,58.90 ,60.99 ,16.67 
01,015,02,003,0000,0,1173,34,1207,1915,1888 ,6,1,6,0,1,0,58.90 ,63.03 ,16.67 
01,015,03,004,0000,0,6245,93,6338,9754,1888 ,6,1,6,0,1,0,58.90 ,64.98 ,16.67 
01,015,03,005,0000,0,22512,413,22925,42410,1888 ,6,1,6,0,1,0,58.90 ,54.06 ,16.67 
01,015,03,006,0000,0,7829,172,8001,11472,1888 ,6,1,6,0,1,0,58.90 ,69.74 ,16.67 
01,015,03,007,0000,0,4292,91,4383,6855,1888 ,6,1,6,0,1,0,58.90 ,63.94 ,16.67 
01,015,03,008,0000,0,764,32,796,1325,1888 ,6,1,6,0,1,0,58.90 ,60.08 ,16.67 
01,015,03,009,0000,0,202,8,210,360,1888 ,6,1,6,0,1,0,58.90 ,58.33 ,16.67 
01,015,04,010,0000,0,10539,342,10881,18284,1888 ,6,1,6,0,1,0,58.90 ,59.51 ,16.67 
01,015,04,011,0000,0,4613,104,4717,7614,1888 ,6,1,6,0,1,0,58.90 ,61.95 ,16.67 
01,015,04,012,0000,0,5345,153,5498,10045,1888 ,6,1,6,0,1,0,58.90 ,54.73 ,16.67 
01,015,04,013,0000,0,204,9,213,380,1888 ,6,1,6,0,1,0,58.90 ,56.05 ,16.67 
01,016,01,001,0000,0,25560,354,25914,33999,1888 ,6,1,6,0,1,0,58.90 ,76.22 ,16.67 
01,016,02,002,0000,0,7095,86,7181,9564,1888 ,6,1,6,0,1,0,58.90 ,75.08 ,16.67 
01,016,03,003,0000,0,5355,64,5419,7037,1888 ,6,1,6,0,1,0,58.90 ,77.01 ,16.67 
01,016,04,004,0000,0,4502,83,4585,6795,1888 ,6,1,6,0,1,0,58.90 ,67.48 ,16.67 
01,016,05,005,0000,0,2890,152,3042,4031,1888 ,6,1,6,0,1,0,58.90 ,75.47 ,16.67 
01,016,06,006,0000,0,1806,30,1836,2403,1888 ,6,1,6,0,1,0,58.90 ,76.40 ,16.67 
01,017,01,001,0000,0,21385,310,21695,39670,1888 ,6,1,6,0,1,0,58.90 ,54.69 ,16.67 
01,017,02,002,0000,0,16649,224,16873,33099,1888 ,6,1,6,0,1,0,58.90 ,50.98 ,16.67 
01,017,03,003,0000,0,19386,333,19719,38084,1888 ,6,1,6,0,1,0,58.90 ,51.78 ,16.67 
01,017,04,004,0000,0,19294,366,19660,35903,1888 ,6,1,6,0,1,0,58.90 ,54.76 ,16.67 
01,017,05,005,0000,0,24769,313,25082,48553,1888 ,6,1,6,0,1,0,58.90 ,51.66 ,16.67 
01,017,06,006,0000,0,13559,229,13788,24362,1888 ,6,1,6,0,1,0,58.90 ,56.60 ,16.67 
01,017,07,007,0000,0,19826,266,20092,36874,1888 ,6,1,6,0,1,0,58.90 ,54.49 ,16.67 
01,018,01,001,0000,0,37424,529,37953,76936,1888 ,6,1,6,0,1,0,58.90 ,49.33 ,16.67 
01,018,02,001,0000,0,16471,238,16709,34298,1888 ,6,1,6,0,1,0,58.90 ,48.72 ,16.67 
01,018,03,002,0000,0,12717,219,12936,24949,1888 ,6,1,6,0,1,0,58.90 ,51.85 ,16.67 
01,018,04,002,0000,0,24422,302,24724,58647,1888 ,6,1,6,0,1,0,58.90 ,42.16 ,16.67 
01,018,05,003,0000,0,24480,400,24880,38285,1888 ,6,1,6,0,1,0,58.90 ,64.99 ,16.67 
01,019,01,001,0000,0,9126,158,9284,16359,1888 ,6,1,6,0,1,0,58.90 ,56.75 ,16.67 
01,019,01,002,0000,0,39336,652,39988,71933,1888 ,6,1,6,0,1,0,58.90 ,55.59 ,16.67 
01,019,02,003,0000,0,48587,643,49230,97783,1888 ,6,1,6,0,1,0,58.90 ,50.35 ,16.67 
01,019,03,004,0000,0,27672,468,28140,47497,1888 ,6,1,6,0,1,0,58.90 ,59.25 ,16.67 
01,019,03,005,0000,0,29339,518,29857,57728,1888 ,6,1,6,0,1,0,58.90 ,51.72 ,16.67 
01,019,04,006,0000,0,54124,863,54987,98971,1888 ,6,1,6,0,1,0,58.90 ,55.56 ,16.67 
01,019,05,007,0000,0,29654,351,30005,65130,1888 ,6,1,6,0,1,0,58.90 ,46.07 ,16.67 
01,019,06,008,0000,0,69115,1055,70170,129347,1888 ,6,1,6,0,1,0,58.90 ,54.25 ,16.67 
01,020,01,001,0000,0,50699,702,51401,96062,1888 ,6,1,6,0,1,0,58.90 ,53.51 ,16.67 
01,020,02,002,0000,0,54201,807,55008,89392,1888 ,6,1,6,0,1,0,58.90 ,61.54 ,16.67 
01,021,01,001,0000,0,64328,772,65100,114179,1888 ,6,1,6,0,1,0,58.90 ,57.02 ,16.67 
01,021,02,002,0000,0,53488,474,53962,92801,1888 ,6,1,6,0,1,0,58.90 ,58.15 ,16.67 
01,021,03,003,0000,0,18282,207,18489,32836,1888 ,6,1,6,0,1,0,58.90 ,56.31 ,16.67 
01,021,03,004,0000,0,16136,217,16353,32422,1888 ,6,1,6,0,1,0,58.90 ,50.44 ,16.67 
01,021,04,005,0000,0,51140,619,51759,82991,1888 ,6,1,6,0,1,0,58.90 ,62.37 ,16.67 
01,021,05,006,0000,0,66856,746,67602,98937,1888 ,6,1,6,0,1,0,58.90 ,68.33 ,16.67 
01,021,06,007,0000,0,15002,145,15147,26940,1888 ,6,1,6,0,1,0,58.90 ,56.22 ,16.67 
01,022,01,001,0000,0,8434,136,8570,10589,1888 ,6,1,6,0,1,0,58.90 ,80.93 ,16.67 
01,022,01,002,0000,0,4438,100,4538,5819,1888 ,6,1,6,0,1,0,58.90 ,77.99 ,16.67 
01,022,01,003,0000,0,6152,117,6269,7471,1888 ,6,1,6,0,1,0,58.90 ,83.91 ,16.67 
01,022,01,004,0000,0,4709,103,4812,5957,1888 ,6,1,6,0,1,0,58.90 ,80.78 ,16.67 
01,022,01,005,0000,0,2548,63,2611,3282,1888 ,6,1,6,0,1,0,58.90 ,79.56 ,16.67 
01,022,01,006,0000,0,29,0,29,98,1888 ,6,1,6,0,1,0,58.90 ,29.59 ,16.67 
01,023,01,001,0000,0,2390,39,2429,3242,1888 ,6,1,6,0,1,0,58.90 ,74.92 ,16.67 
01,023,02,002,0000,0,1088,22,1110,1394,1888 ,6,1,6,0,1,0,58.90 ,79.63 ,16.67 
01,023,03,003,0000,0,822,26,848,1106,1889 ,7,2,7,1,2,1,59.90 ,76.67 ,17.67 
01,023,04,004,0000,0,388,6,394,537,1890 ,8,3,8,2,3,2,60.90 ,73.37 ,18.67 
