00,000,00,000,0000,0,9311367,129318,9440685,13922373,20893361,314,122,276,38,104,18,66.64 ,67.81 ,38.85 
01,000,00,000,0000,0,1186799,13753,1200552,1818771,2642543,59,18,46,13,12,6,68.83,66.01 ,30.51
01,000,01,000,0000,0,602350,6663,609013,904686,1333669,23,9,17,6,6,3,67.83 ,67.32 ,39.13 
01,000,02,000,0000,0,584449,7090,591539,914085,1308874,36,9,29,7,6,3,69.84 ,64.71 ,25.00 
02,000,00,000,0000,0,660723,10007,670730,933732,1419715,28,12,25,3,11,1,65.77,71.83 ,42.86
02,000,01,000,0000,0,361828,5200,367028,506789,730898,12,6,11,1,5,1,69.34 ,72.42 ,50.00 
02,000,02,000,0000,0,298895,4807,303702,426943,688817,16,6,14,2,6,0,61.98 ,71.13 ,37.50 
03,001,00,000,0000,0,1414946,20531,1435477,2118533,3255380,50,17,46,4,15,2,65.08 ,67.76 ,34.00 
03,002,00,000,0000,0,170767,2301,173068,305581,453254,3,2,3,0,2,0,67.42 ,56.64 ,66.67 
03,003,00,000,0000,0,638291,10352,648643,956002,1477203,16,8,15,1,7,1,64.72 ,67.85 ,50.00 
03,004,00,000,0000,0,169713,2961,172674,258952,390009,4,2,3,1,2,0,66.40 ,66.68 ,50.00 
03,005,00,000,0000,0,271135,3965,275100,369518,550559,7,3,5,2,2,1,67.12 ,74.45 ,42.86 
03,006,00,000,0000,0,638502,10687,649189,881636,1382461,13,7,12,1,7,0,63.77 ,73.63 ,53.85 
03,007,00,000,0000,0,593242,10021,603263,835007,1281764,13,7,11,2,6,1,65.15 ,72.25 ,53.85 
03,008,00,000,0000,0,221102,2648,223750,355190,521146,7,3,7,0,3,0,68.16 ,62.99 ,42.86 
03,009,00,000,0000,0,344426,5055,349481,518878,752825,8,4,7,1,4,0,68.92 ,67.35 ,50.00 
03,010,00,000,0000,0,233647,3642,237289,393148,559956,7,3,7,0,3,0,70.21 ,60.36 ,42.86 
03,011,00,000,0000,0,495634,6176,501810,736214,1073742,13,6,11,2,5,1,68.57 ,68.16 ,46.15 
03,012,00,000,0000,0,544208,7191,551399,790659,1174446,17,6,15,2,4,2,67.32 ,69.74 ,35.29 
03,013,00,000,0000,0,389174,3803,392977,586043,860256,8,5,8,0,5,0,68.12 ,67.06 ,62.50 
03,014,00,000,0000,0,69137,980,70117,122477,174298,4,1,4,0,1,0,70.27 ,57.25 ,25.00 
03,015,00,000,0000,0,112149,1847,113996,189805,274657,9,2,8,1,2,0,69.11 ,60.06 ,22.22 
03,016,00,000,0000,0,39566,482,40048,63605,91375,4,1,4,0,1,0,69.61 ,62.96 ,25.00 
03,017,00,000,0000,0,160412,2324,162736,247729,360919,7,2,6,1,1,1,68.64 ,65.69 ,28.57 
03,018,00,000,0000,0,131502,1749,133251,223618,338331,4,2,4,0,2,0,66.09 ,59.59 ,50.00 
03,019,00,000,0000,0,353416,3932,357348,545276,840814,10,4,6,4,2,2,64.85 ,65.54 ,40.00 
03,020,00,000,0000,0,129626,929,130555,173433,261028,3,1,3,0,1,0,66.44 ,75.28 ,33.33 
03,021,00,000,0000,0,319203,3700,322903,464933,704037,11,4,11,0,4,0,66.04 ,69.45 ,36.36 
04,001,00,000,0000,0,20934,242,21176,29852,47035,5,1,5,0,1,0,63.47 ,70.94 ,20.00 
04,002,00,000,0000,0,3113,40,3153,3781,5608,4,1,4,0,1,0,67.42 ,83.39 ,25.00 
03,001,01,000,0000,0,1414946,20531,1435477,2118533,3255380,50,17,46,4,15,2,65.08 ,67.76 ,34.00 
03,002,01,000,0000,0,170767,2301,173068,305581,453254,3,2,3,0,2,0,67.42 ,56.64 ,66.67 
03,003,01,000,0000,0,638291,10352,648643,956002,1477203,16,8,15,1,7,1,64.72 ,67.85 ,50.00 
03,004,01,000,0000,0,169713,2961,172674,258952,390009,4,2,3,1,2,0,66.40 ,66.68 ,50.00 
03,005,01,000,0000,0,271135,3965,275100,369518,550559,7,3,5,2,2,1,67.12 ,74.45 ,42.86 
03,006,01,000,0000,0,638502,10687,649189,881636,1382461,13,7,12,1,7,0,63.77 ,73.63 ,53.85 
03,007,01,000,0000,0,593242,10021,603263,835007,1281764,13,7,11,2,6,1,65.15 ,72.25 ,53.85 
03,008,01,000,0000,0,221102,2648,223750,355190,521146,7,3,7,0,3,0,68.16 ,62.99 ,42.86 
03,009,01,000,0000,0,344426,5055,349481,518878,752825,8,4,7,1,4,0,68.92 ,67.35 ,50.00 
03,010,01,000,0000,0,233647,3642,237289,393148,559956,7,3,7,0,3,0,70.21 ,60.36 ,42.86 
03,011,01,000,0000,0,495634,6176,501810,736214,1073742,13,6,11,2,5,1,68.57 ,68.16 ,46.15 
03,012,01,000,0000,0,544208,7191,551399,790659,1174446,17,6,15,2,4,2,67.32 ,69.74 ,35.29 
03,013,01,000,0000,0,389174,3803,392977,586043,860256,8,5,8,0,5,0,68.12 ,67.06 ,62.50 
03,014,01,000,0000,0,69137,980,70117,122477,174298,4,1,4,0,1,0,70.27 ,57.25 ,25.00 
03,015,01,000,0000,0,112149,1847,113996,189805,274657,9,2,8,1,2,0,69.11 ,60.06 ,22.22 
03,016,01,000,0000,0,39566,482,40048,63605,91375,4,1,4,0,1,0,69.61 ,62.96 ,25.00 
03,017,01,000,0000,0,160412,2324,162736,247729,360919,7,2,6,1,1,1,68.64 ,65.69 ,28.57 
03,018,01,000,0000,0,131502,1749,133251,223618,338331,4,2,4,0,2,0,66.09 ,59.59 ,50.00 
03,019,01,000,0000,0,353416,3932,357348,545276,840814,10,4,6,4,2,2,64.85 ,65.54 ,40.00 
03,020,01,000,0000,0,129626,929,130555,173433,261028,3,1,3,0,1,0,66.44 ,75.28 ,33.33 
03,021,01,000,0000,0,319203,3700,322903,464933,704037,11,4,11,0,4,0,66.04 ,69.45 ,36.36 
04,001,01,000,0000,0,20934,242,21176,29852,47035,5,1,5,0,1,0,63.47 ,70.94 ,20.00 
04,002,01,000,0000,0,3113,40,3153,3781,5608,4,1,4,0,1,0,67.42 ,83.39 ,25.00 
01,000,01,001,0000,0,109871,1257,111128,164413,0,3,1,3,0,1,0,77.75,67.59 ,33.33
01,000,01,002,0000,0,133774,1451,135225,203855,0,3,1,3,0,1,0,77.75,66.33 ,33.33
01,000,01,003,0000,0,94762,889,95651,145600,0,3,1,3,0,1,0,77.75,65.69 ,33.33
01,000,01,004,0000,0,114323,1300,115623,172233,0,3,1,3,0,1,0,77.75,67.13 ,33.33
01,000,01,005,0000,0,99451,1067,100518,144539,0,3,1,3,0,1,0,77.75,69.54 ,33.33
01,000,01,006,0000,0,50169,699,50868,74046,0,3,1,3,0,1,0,77.75,68.70 ,33.33
01,000,02,007,0000,0,95903,1309,97212,157656,0,3,1,3,0,1,0,77.75,61.66 ,33.33
01,000,02,008,0000,0,60913,809,61722,93717,0,3,1,3,0,1,0,77.75,65.86 ,33.33
01,000,02,009,0000,0,148753,1424,150177,237251,0,3,1,3,0,1,0,77.75,63.30 ,33.33
01,000,02,010,0000,0,76895,862,77757,119294,0,3,1,3,0,1,0,77.75,65.18 ,33.33
01,000,02,011,0000,0,97436,1414,98850,150735,0,3,1,3,0,1,0,77.75,65.58 ,33.33
01,000,02,012,0000,0,104549,1272,105821,155432,0,3,1,3,0,1,0,77.75,68.08 ,33.33
02,000,01,001,0000,0,16858,294,17152,23766,0,3,1,3,0,1,0,77.75,72.17 ,33.33
02,000,01,002,0000,0,53941,725,54666,74484,0,3,1,3,0,1,0,77.75,73.39 ,33.33
02,000,01,003,0000,0,16130,326,16456,22624,0,3,1,3,0,1,0,77.75,72.74 ,33.33
02,000,01,004,0000,0,61397,799,62196,83928,0,3,1,3,0,1,0,77.75,74.11 ,33.33
02,000,01,005,0000,0,64754,902,65656,87407,0,3,1,3,0,1,0,77.75,75.12 ,33.33
02,000,01,006,0000,0,148748,2154,150902,214580,0,3,1,3,0,1,0,77.75,70.32 ,33.33
02,000,02,007,0000,0,31713,402,32115,44916,0,3,1,3,0,1,0,77.75,71.50 ,33.33
02,000,02,008,0000,0,17890,255,18145,25809,0,3,1,3,0,1,0,77.75,70.30 ,33.33
02,000,02,009,0000,0,97098,1670,98768,140803,0,3,1,3,0,1,0,77.75,70.15 ,33.33
02,000,02,010,0000,0,92219,1661,93880,131711,0,3,1,3,0,1,0,77.75,71.28 ,33.33
02,000,02,011,0000,0,59975,819,60794,83704,0,3,1,3,0,1,0,77.75,72.63 ,33.33
03,001,01,001,0000,0,224181,3282,227463,336079,0,3,1,3,0,1,0,77.75,67.68 ,33.33
03,001,01,002,0000,0,161495,2359,163854,245179,0,3,1,3,0,1,0,77.75,66.83 ,33.33
03,001,01,003,0000,0,174393,2474,176867,259323,0,3,1,3,0,1,0,77.75,68.20 ,33.33
03,001,01,004,0000,0,107497,1375,108872,157936,0,3,1,3,0,1,0,77.75,68.93 ,33.33
03,001,01,005,0000,0,127684,1765,129449,200137,0,3,1,3,0,1,0,77.75,64.68 ,33.33
03,001,01,006,0000,0,115596,1485,117081,173184,0,3,1,3,0,1,0,77.75,67.60 ,33.33
03,001,01,007,0000,0,73512,1207,74719,113072,0,3,1,3,0,1,0,77.75,66.08 ,33.33
03,001,01,008,0000,0,52871,841,53712,80507,0,3,1,3,0,1,0,77.75,66.72 ,33.33
03,001,01,009,0000,0,29847,532,30379,43216,0,3,1,3,0,1,0,77.75,70.30 ,33.33
03,001,01,010,0000,0,30446,540,30986,44816,0,3,1,3,0,1,0,77.75,69.14 ,33.33
03,001,01,011,0000,0,43593,737,44330,63428,0,3,1,3,0,1,0,77.75,69.89 ,33.33
03,001,01,012,0000,0,55780,627,56407,78168,0,3,1,3,0,1,0,77.75,72.16 ,33.33
03,001,01,013,0000,0,24743,366,25109,36543,0,3,1,3,0,1,0,77.75,68.71 ,33.33
03,001,01,014,0000,0,53958,808,54766,81809,0,3,1,3,0,1,0,77.75,66.94 ,33.33
03,001,01,015,0000,0,23308,346,23654,35152,0,3,1,3,0,1,0,77.75,67.29 ,33.33
03,001,01,016,0000,0,24132,343,24475,35892,0,3,1,3,0,1,0,77.75,68.19 ,33.33
03,001,01,017,0000,0,17308,257,17565,25346,0,3,1,3,0,1,0,77.75,69.30 ,33.33
03,001,01,018,0000,0,7671,118,7789,11472,0,3,1,3,0,1,0,77.75,67.90 ,33.33
03,001,01,019,0000,0,4128,72,4200,6010,0,3,1,3,0,1,0,77.75,69.88 ,33.33
03,001,01,020,0000,0,2905,30,2935,4617,0,3,1,3,0,1,0,77.75,63.57 ,33.33
03,001,01,021,0000,0,8956,166,9122,12829,0,3,1,3,0,1,0,77.75,71.10 ,33.33
03,001,01,022,0000,0,4905,76,4981,7021,0,3,1,3,0,1,0,77.75,70.94 ,33.33
03,001,01,023,0000,0,9869,200,10069,14178,0,3,1,3,0,1,0,77.75,71.02 ,33.33
03,001,01,024,0000,0,3671,42,3713,5190,0,3,1,3,0,1,0,77.75,71.54 ,33.33
03,001,01,025,0000,0,6026,59,6085,8443,0,3,1,3,0,1,0,77.75,72.07 ,33.33
03,001,01,026,0000,0,7083,108,7191,10456,0,3,1,3,0,1,0,77.75,68.77 ,33.33
03,001,01,027,0000,0,9142,135,9277,13440,0,3,1,3,0,1,0,76.14,69.03 ,33.33
03,001,01,028,0000,0,9299,171,9470,13685,0,3,1,3,0,1,0,76.14,69.20 ,33.33
03,001,01,029,0000,0,947,10,957,1405,0,3,1,3,0,1,0,76.14,68.11 ,33.33
03,002,01,001,0000,0,33927,570,34497,59670,0,3,1,3,0,1,0,76.14,57.81 ,33.33
03,002,01,002,0000,0,24873,311,25184,43167,0,3,1,3,0,1,0,76.14,58.34 ,33.33
03,002,01,003,0000,0,17672,232,17904,33660,0,3,1,3,0,1,0,76.14,53.19 ,33.33
03,002,01,004,0000,0,11852,153,12005,23238,0,3,1,3,0,1,0,76.14,51.66 ,33.33
03,002,01,005,0000,0,14444,198,14642,25877,0,3,1,3,0,1,0,76.14,56.58 ,33.33
03,002,01,006,0000,0,9240,111,9351,17566,0,3,1,3,0,1,0,76.14,53.23 ,33.33
03,002,01,007,0000,0,12532,168,12700,22853,0,3,1,3,0,1,0,76.14,55.57 ,33.33
03,002,01,008,0000,0,20247,260,20507,35018,0,3,1,3,0,1,0,76.14,58.56 ,33.33
03,002,01,009,0000,0,15713,163,15876,26337,0,3,1,3,0,1,0,76.14,60.28 ,33.33
03,002,01,010,0000,0,9343,123,9466,16280,0,3,1,3,0,1,0,76.14,58.14 ,33.33
03,002,01,011,0000,0,489,6,495,994,0,3,1,3,0,1,0,76.14,49.80 ,33.33
03,002,01,012,0000,0,435,6,441,921,0,3,1,3,0,1,0,76.14,47.88 ,33.33
03,003,01,001,0000,0,107261,1561,108822,167208,0,3,1,3,0,1,0,76.14,65.08 ,33.33
03,003,01,002,0000,0,40388,685,41073,66748,0,3,1,3,0,1,0,76.14,61.53 ,33.33
03,003,01,003,0000,0,62112,1123,63235,93056,0,3,1,3,0,1,0,76.14,67.95 ,33.33
03,003,01,004,0000,0,29289,528,29817,42992,0,3,1,3,0,1,0,76.14,69.35 ,33.33
03,003,01,005,0000,0,30195,435,30630,43212,0,3,1,3,0,1,0,76.14,70.88 ,33.33
03,003,01,006,0000,0,34877,615,35492,51638,0,3,1,3,0,1,0,76.14,68.73 ,33.33
03,003,01,007,0000,0,1584,18,1602,2720,0,3,1,3,0,1,0,76.14,58.90 ,33.33
03,003,01,008,0000,0,130878,2026,132904,193143,0,3,1,3,0,1,0,76.14,68.81 ,33.33
03,003,01,009,0000,0,70926,1265,72191,103743,0,3,1,3,0,1,0,76.14,69.59 ,33.33
03,003,01,010,0000,0,46096,814,46910,68890,0,3,1,3,0,1,0,76.14,68.09 ,33.33
03,003,01,011,0000,0,39186,643,39829,57015,0,3,1,3,0,1,0,76.14,69.86 ,33.33
03,003,01,012,0000,0,23018,307,23325,32780,0,3,1,3,0,1,0,76.14,71.16 ,33.33
03,003,01,013,0000,0,22481,332,22813,32857,0,3,1,3,0,1,0,76.14,69.43 ,33.33
03,004,01,001,0000,0,29616,520,30136,48194,0,3,1,3,0,1,0,76.14,62.53 ,33.33
03,004,01,002,0000,0,35580,591,36171,52581,0,3,1,3,0,1,0,76.14,68.79 ,33.33
03,004,01,003,0000,0,16701,288,16989,24518,0,3,1,3,0,1,0,76.14,69.29 ,33.33
03,004,01,004,0000,0,15102,259,15361,22567,0,3,1,3,0,1,0,76.14,68.07 ,33.33
03,004,01,005,0000,0,25391,491,25882,38838,0,3,1,3,0,1,0,76.14,66.64 ,33.33
03,004,01,006,0000,0,16290,283,16573,25837,0,3,1,3,0,1,0,76.14,64.14 ,33.33
03,004,01,007,0000,0,8638,169,8807,12802,0,3,1,3,0,1,0,76.14,68.79 ,33.33
03,004,01,008,0000,0,7688,131,7819,11102,0,3,1,3,0,1,0,76.14,70.43 ,33.33
03,004,01,009,0000,0,5150,85,5235,7629,0,3,1,3,0,1,0,76.14,68.62 ,33.33
03,004,01,010,0000,0,5405,83,5488,8363,0,3,1,3,0,1,0,76.14,65.62 ,33.33
03,004,01,011,0000,0,3283,42,3325,5026,0,3,1,3,0,1,0,76.14,66.16 ,33.33
03,004,01,012,0000,0,655,15,670,1087,0,3,1,3,0,1,0,76.14,61.64 ,33.33
03,004,01,013,0000,0,214,4,218,408,0,3,1,3,0,1,0,76.14,53.43 ,33.33
03,005,01,001,0000,0,42609,633,43242,59480,0,3,1,3,0,1,0,76.14,72.70 ,33.33
03,005,01,002,0000,0,23600,325,23925,32563,0,3,1,3,0,1,0,76.14,73.47 ,33.33
03,005,01,003,0000,0,21169,248,21417,28815,0,3,1,3,0,1,0,76.14,74.33 ,33.33
03,005,01,004,0000,0,31071,532,31603,41964,0,3,1,3,0,1,0,76.14,75.31 ,33.33
03,005,01,005,0000,0,38634,597,39231,53630,0,3,1,3,0,1,0,76.14,73.15 ,33.33
03,005,01,006,0000,0,21664,294,21958,30166,0,3,1,3,0,1,0,76.14,72.79 ,33.33
03,005,01,007,0000,0,10963,144,11107,13942,0,3,1,3,0,1,0,76.14,79.67 ,33.33
03,005,01,008,0000,0,9549,130,9679,13059,0,3,1,3,0,1,0,76.14,74.12 ,33.33
03,005,01,009,0000,0,17299,225,17524,23122,0,3,1,3,0,1,0,76.14,75.79 ,33.33
03,005,01,010,0000,0,10687,176,10863,14438,0,3,1,3,0,1,0,76.14,75.24 ,33.33
03,005,01,011,0000,0,5887,72,5959,8378,0,3,1,3,0,1,0,76.14,71.13 ,33.33
03,005,01,012,0000,0,6765,134,6899,8801,0,3,1,3,0,1,0,76.14,78.39 ,33.33
03,005,01,013,0000,0,9406,124,9530,12028,0,3,1,3,0,1,0,76.14,79.23 ,33.33
03,005,01,014,0000,0,5141,113,5254,7003,0,3,1,3,0,1,0,76.14,75.02 ,33.33
03,005,01,015,0000,0,7979,95,8074,10055,0,3,1,3,0,1,0,76.14,80.30 ,33.33
03,005,01,016,0000,0,4470,55,4525,5985,0,3,1,3,0,1,0,76.14,75.61 ,33.33
03,005,01,017,0000,0,3167,55,3222,4555,0,3,1,3,0,1,0,76.14,70.74 ,33.33
03,005,01,018,0000,0,1075,13,1088,1534,0,3,1,3,0,1,0,76.14,70.93 ,33.33
03,006,01,001,0000,0,71239,1217,72456,99767,0,3,1,3,0,1,0,76.14,72.63 ,33.33
03,006,01,002,0000,0,29449,445,29894,40901,0,3,1,3,0,1,0,76.14,73.09 ,33.33
03,006,01,003,0000,0,35524,565,36089,47854,0,3,1,3,0,1,0,76.14,75.41 ,33.33
03,006,01,004,0000,0,40042,603,40645,53824,0,3,1,3,0,1,0,76.14,75.51 ,33.33
03,006,01,005,0000,0,32653,467,33120,43133,0,3,1,3,0,1,0,76.14,76.79 ,33.33
03,006,01,006,0000,0,20813,336,21149,28720,0,3,1,3,0,1,0,76.14,73.64 ,33.33
03,006,01,007,0000,0,27910,500,28410,35824,0,3,1,3,0,1,0,76.14,79.30 ,33.33
03,006,01,008,0000,0,27835,532,28367,36940,0,3,1,3,0,1,0,76.14,76.79 ,33.33
03,006,01,009,0000,0,33500,584,34084,47496,0,3,1,3,0,1,0,76.14,71.76 ,33.33
03,006,01,010,0000,0,29885,609,30494,41762,0,3,1,3,0,1,0,76.14,73.02 ,33.33
03,006,01,011,0000,0,14860,238,15098,19112,0,3,1,3,0,1,0,76.14,79.00 ,33.33
03,006,01,012,0000,0,8345,145,8490,10868,0,3,1,3,0,1,0,76.14,78.12 ,33.33
03,006,01,013,0000,0,14873,280,15153,18863,0,3,1,3,0,1,0,76.14,80.33 ,33.33
03,006,01,014,0000,0,10712,131,10843,14108,0,3,1,3,0,1,0,76.14,76.86 ,33.33
03,006,01,015,0000,0,28088,479,28567,38624,0,3,1,3,0,1,0,76.14,73.96 ,33.33
03,006,01,016,0000,0,24172,375,24547,31970,0,3,1,3,0,1,0,76.14,76.78 ,33.33
03,006,01,017,0000,0,25571,428,25999,35268,0,3,1,3,0,1,0,76.14,73.72 ,33.33
03,006,01,018,0000,0,31319,493,31812,42787,0,3,1,3,0,1,0,76.14,74.35 ,33.33
03,006,01,019,0000,0,63204,1199,64403,92244,0,3,1,3,0,1,0,76.14,69.82 ,33.33
03,006,01,020,0000,0,64535,997,65532,95736,0,3,1,3,0,1,0,76.14,68.45 ,33.33
03,006,01,021,0000,0,3973,64,4037,5835,0,3,1,3,0,1,0,76.14,69.19 ,33.33
03,007,01,001,0000,0,99231,1676,100907,139867,0,3,1,3,0,1,0,76.14,72.14 ,33.33
03,007,01,002,0000,0,20766,290,21056,28258,0,3,1,3,0,1,0,76.14,74.51 ,33.33
03,007,01,003,0000,0,13897,201,14098,18213,0,3,1,3,0,1,0,76.14,77.41 ,33.33
03,007,01,004,0000,0,35121,526,35647,51466,0,3,1,3,0,1,0,76.14,69.26 ,33.33
03,007,01,005,0000,0,20749,358,21107,29920,0,3,1,3,0,1,0,76.14,70.54 ,33.33
03,007,01,006,0000,0,17065,295,17360,22610,0,3,1,3,0,1,0,76.14,76.78 ,33.33
03,007,01,007,0000,0,37815,680,38495,50986,0,3,1,3,0,1,0,76.14,75.50 ,33.33
03,007,01,008,0000,0,7919,129,8048,10511,0,3,1,3,0,1,0,76.14,76.57 ,33.33
03,007,01,009,0000,0,14638,222,14860,19925,0,3,1,3,0,1,0,76.14,74.58 ,33.33
03,007,01,010,0000,0,54723,916,55639,77921,0,3,1,3,0,1,0,76.14,71.40 ,33.33
03,007,01,011,0000,0,16764,316,17080,22463,0,3,1,3,0,1,0,76.14,76.04 ,33.33
03,007,01,012,0000,0,18873,370,19243,26022,0,3,1,3,0,1,0,76.14,73.95 ,33.33
03,007,01,013,0000,0,24333,353,24686,33977,0,3,1,3,0,1,0,76.14,72.66 ,33.33
03,007,01,014,0000,0,18008,288,18296,23625,0,3,1,3,0,1,0,76.14,77.44 ,33.33
03,007,01,015,0000,0,16727,264,16991,22467,0,3,1,3,0,1,0,76.14,75.63 ,33.33
03,007,01,016,0000,0,21667,436,22103,31648,0,3,1,3,0,1,0,76.14,69.84 ,33.33
03,007,01,017,0000,0,21006,398,21404,28695,0,3,1,3,0,1,0,76.14,74.59 ,33.33
03,007,01,018,0000,0,9865,177,10042,13685,0,3,1,3,0,1,0,76.14,73.38 ,33.33
03,007,01,019,0000,0,15036,266,15302,21328,0,3,1,3,0,1,0,76.14,71.75 ,33.33
03,007,01,020,0000,0,15654,325,15979,23295,0,3,1,3,0,1,0,76.14,68.59 ,33.33
03,007,01,021,0000,0,14077,231,14308,19383,0,3,1,3,0,1,0,76.14,73.82 ,33.33
03,007,01,022,0000,0,15436,313,15749,22426,0,3,1,3,0,1,0,76.14,70.23 ,33.33
03,007,01,023,0000,0,27029,411,27440,38276,0,3,1,3,0,1,0,76.14,71.69 ,33.33
03,007,01,024,0000,0,18261,297,18558,28977,0,3,1,3,0,1,0,76.14,64.04 ,33.33
03,007,01,025,0000,0,9809,173,9982,16266,0,3,1,3,0,1,0,76.14,61.37 ,33.33
03,007,01,026,0000,0,8773,110,8883,12797,0,3,1,3,0,1,0,76.14,69.41 ,33.33
03,008,01,001,0000,0,43270,574,43844,66572,0,3,1,3,0,1,0,76.14,65.86 ,33.33
03,008,01,002,0000,0,37018,379,37397,58340,0,3,1,3,0,1,0,76.14,64.10 ,33.33
03,008,01,003,0000,0,41665,479,42144,61843,0,3,1,3,0,1,0,76.14,68.15 ,33.33
03,008,01,004,0000,0,24354,297,24651,42615,0,3,1,3,0,1,0,76.14,57.85 ,33.33
03,008,01,005,0000,0,5537,78,5615,9036,0,3,1,3,0,1,0,76.14,62.14 ,33.33
03,008,01,006,0000,0,18104,222,18326,29583,0,3,1,3,0,1,0,76.14,61.95 ,33.33
03,008,01,007,0000,0,8853,82,8935,15493,0,3,1,3,0,1,0,76.14,57.67 ,33.33
03,008,01,008,0000,0,8630,118,8748,14102,0,3,1,3,0,1,0,76.14,62.03 ,33.33
03,008,01,009,0000,0,7513,68,7581,13279,0,3,1,3,0,1,0,76.14,57.09 ,33.33
03,008,01,010,0000,0,11213,137,11350,18345,0,3,1,3,0,1,0,76.14,61.87 ,33.33
03,008,01,011,0000,0,9912,142,10054,17112,0,3,1,3,0,1,0,76.14,58.75 ,33.33
03,008,01,012,0000,0,3523,38,3561,6184,0,3,1,3,0,1,0,76.14,57.58 ,33.33
03,008,01,013,0000,0,1510,34,1544,2686,0,3,1,3,0,1,0,76.14,57.48 ,33.33
03,009,01,001,0000,0,44973,838,45811,62505,0,3,1,3,0,1,0,76.14,73.29 ,33.33
03,009,01,002,0000,0,22733,371,23104,32095,0,3,1,3,0,1,0,76.14,71.99 ,33.33
03,009,01,003,0000,0,30487,455,30942,44471,0,3,1,3,0,1,0,76.14,69.58 ,33.33
03,009,01,004,0000,0,24046,259,24305,34430,0,3,1,3,0,1,0,76.14,70.59 ,33.33
03,009,01,005,0000,0,14808,201,15009,22668,0,3,1,3,0,1,0,76.14,66.21 ,33.33
03,009,01,006,0000,0,21420,333,21753,33281,0,3,1,3,0,1,0,76.14,65.36 ,33.33
03,009,01,007,0000,0,18577,243,18820,26048,0,3,1,3,0,1,0,76.14,72.25 ,33.33
03,009,01,008,0000,0,11558,165,11723,17040,0,3,1,3,0,1,0,76.14,68.80 ,33.33
03,009,01,009,0000,0,14896,248,15144,21451,0,3,1,3,0,1,0,76.14,70.60 ,33.33
03,009,01,010,0000,0,10506,219,10725,14496,0,3,1,3,0,1,0,76.14,73.99 ,33.33
03,009,01,011,0000,0,15692,185,15877,23917,0,3,1,3,0,1,0,76.14,66.38 ,33.33
03,009,01,012,0000,0,13888,203,14091,20748,0,3,1,3,0,1,0,76.14,67.91 ,33.33
03,009,01,013,0000,0,13468,196,13664,21573,0,3,1,3,0,1,0,76.14,63.34 ,33.33
03,009,01,014,0000,0,8409,107,8516,14235,0,3,1,3,0,1,0,76.14,59.82 ,33.33
03,009,01,015,0000,0,7030,92,7122,10767,0,3,1,3,0,1,0,76.14,66.15 ,33.33
03,009,01,016,0000,0,14976,205,15181,21521,0,3,1,3,0,1,0,76.14,70.54 ,33.33
03,009,01,017,0000,0,14376,137,14513,24433,0,3,1,3,0,1,0,76.14,59.40 ,33.33
03,009,01,018,0000,0,12862,178,13040,23776,0,3,1,3,0,1,0,76.14,54.85 ,33.33
03,009,01,019,0000,0,14391,184,14575,24159,0,3,1,3,0,1,0,76.14,60.33 ,33.33
03,009,01,020,0000,0,15330,236,15566,25264,0,3,1,3,0,1,0,76.14,61.61 ,33.33
03,010,01,001,0000,0,11751,190,11941,19937,0,3,1,3,0,1,0,76.14,59.89 ,33.33
03,010,01,002,0000,0,18666,259,18925,30657,0,3,1,3,0,1,0,76.14,61.73 ,33.33
03,010,01,003,0000,0,14537,222,14759,25075,0,3,1,3,0,1,0,76.14,58.86 ,33.33
03,010,01,004,0000,0,15929,238,16167,26125,0,3,1,3,0,1,0,76.14,61.88 ,33.33
03,010,01,005,0000,0,25993,422,26415,43852,0,3,1,3,0,1,0,76.14,60.24 ,33.33
03,010,01,006,0000,0,7723,113,7836,13715,0,3,1,3,0,1,0,76.14,57.13 ,33.33
03,010,01,007,0000,0,13536,234,13770,25703,0,3,1,3,0,1,0,76.14,53.57 ,33.33
03,010,01,008,0000,0,13042,193,13235,23278,0,3,1,3,0,1,0,76.14,56.86 ,33.33
03,010,01,009,0000,0,13482,175,13657,23501,0,3,1,3,0,1,0,76.14,58.11 ,33.33
03,010,01,010,0000,0,12116,160,12276,18366,0,3,1,3,0,1,0,76.14,66.84 ,33.33
03,010,01,011,0000,0,8697,143,8840,14427,0,3,1,3,0,1,0,76.14,61.27 ,33.33
03,010,01,012,0000,0,23192,412,23604,36839,0,3,1,3,0,1,0,76.14,64.07 ,33.33
03,010,01,013,0000,0,18840,276,19116,31866,0,3,1,3,0,1,0,76.14,59.99 ,33.33
03,010,01,014,0000,0,17901,224,18125,29099,0,3,1,3,0,1,0,76.14,62.29 ,33.33
03,010,01,015,0000,0,10458,174,10632,17344,0,3,1,3,0,1,0,76.14,61.30 ,33.33
03,010,01,016,0000,0,5400,61,5461,8557,0,3,1,3,0,1,0,76.14,63.82 ,33.33
03,010,01,017,0000,0,1385,136,1521,2834,0,3,1,3,0,1,0,76.14,53.67 ,33.33
03,010,01,018,0000,0,999,10,1009,1973,0,3,1,3,0,1,0,76.14,51.14 ,33.33
03,011,01,001,0000,0,30944,406,31350,49572,0,3,1,3,0,1,0,76.14,63.24 ,33.33
03,011,01,002,0000,0,13280,202,13482,20889,0,3,1,3,0,1,0,76.14,64.54 ,33.33
03,011,01,003,0000,0,17471,242,17713,27363,0,3,1,3,0,1,0,76.14,64.73 ,33.33
03,011,01,004,0000,0,11707,151,11858,17598,0,3,1,3,0,1,0,76.14,67.38 ,33.33
03,011,01,005,0000,0,14563,196,14759,21850,0,3,1,3,0,1,0,76.14,67.55 ,33.33
03,011,01,006,0000,0,11544,128,11672,19767,0,3,1,3,0,1,0,76.14,59.05 ,33.33
03,011,01,007,0000,0,23814,267,24081,32861,0,3,1,3,0,1,0,76.14,73.28 ,33.33
03,011,01,008,0000,0,13961,171,14132,20214,0,3,1,3,0,1,0,76.14,69.91 ,33.33
03,011,01,009,0000,0,11733,160,11893,17228,0,3,1,3,0,1,0,76.14,69.03 ,33.33
03,011,01,010,0000,0,12254,157,12411,17389,0,3,1,3,0,1,0,76.14,71.37 ,33.33
03,011,01,011,0000,0,6652,72,6724,9609,0,3,1,3,0,1,0,76.14,69.98 ,33.33
03,011,01,012,0000,0,25144,252,25396,36928,0,3,1,3,0,1,0,76.14,68.77 ,33.33
03,011,01,013,0000,0,13861,139,14000,21346,0,3,1,3,0,1,0,76.14,65.59 ,33.33
03,011,01,014,0000,0,12091,139,12230,17025,0,3,1,3,0,1,0,76.14,71.84 ,33.33
03,011,01,015,0000,0,13992,126,14118,19774,0,3,1,3,0,1,0,76.14,71.40 ,33.33
03,011,01,016,0000,0,12256,105,12361,17800,0,3,1,3,0,1,0,76.14,69.44 ,33.33
03,011,01,017,0000,0,6807,60,6867,10423,0,3,1,3,0,1,0,76.14,65.88 ,33.33
03,011,01,018,0000,0,20521,315,20836,29360,0,3,1,3,0,1,0,76.14,70.97 ,33.33
03,011,01,019,0000,0,20159,280,20439,28680,0,3,1,3,0,1,0,76.14,71.27 ,33.33
03,011,01,020,0000,0,13797,195,13992,19904,0,3,1,3,0,1,0,76.14,70.30 ,33.33
03,011,01,021,0000,0,14757,174,14931,20034,0,3,1,3,0,1,0,76.14,74.53 ,33.33
03,011,01,022,0000,0,4172,46,4218,5855,0,3,1,3,0,1,0,76.14,72.04 ,33.33
03,011,01,023,0000,0,8633,75,8708,12657,0,3,1,3,0,1,0,76.14,68.80 ,33.33
03,011,01,024,0000,0,5962,68,6030,9215,0,3,1,3,0,1,0,76.14,65.44 ,33.33
03,011,01,025,0000,0,4936,58,4994,7375,0,3,1,3,0,1,0,76.14,67.72 ,33.33
03,011,01,026,0000,0,3506,51,3557,5072,0,3,1,3,0,1,0,76.14,70.13 ,33.33
03,011,01,027,0000,0,28071,414,28485,42261,0,3,1,3,0,1,0,76.14,67.40 ,33.33
03,011,01,028,0000,0,25949,319,26268,37596,0,3,1,3,0,1,0,76.14,69.87 ,33.33
03,011,01,029,0000,0,18559,190,18749,26724,0,3,1,3,0,1,0,76.14,70.16 ,33.33
03,011,01,030,0000,0,2665,26,2691,3841,0,3,1,3,0,1,0,76.14,70.06 ,33.33
03,011,01,031,0000,0,71873,992,72865,110004,0,3,1,3,0,1,0,76.14,66.24 ,33.33
03,012,01,001,0000,0,128168,1592,129760,197859,0,3,1,3,0,1,0,76.14,65.58 ,33.33
03,012,01,002,0000,0,30974,452,31426,44511,0,3,1,3,0,1,0,76.14,70.60 ,33.33
03,012,01,003,0000,0,49998,660,50658,73330,0,3,1,3,0,1,0,76.14,69.08 ,33.33
03,012,01,004,0000,0,23013,254,23267,31668,0,3,1,3,0,1,0,76.14,73.47 ,33.33
03,012,01,005,0000,0,18790,302,19092,28272,0,3,1,3,0,1,0,76.14,67.53 ,33.33
03,012,01,006,0000,0,13850,196,14046,20493,0,3,1,3,0,1,0,76.14,68.54 ,33.33
03,012,01,007,0000,0,14741,190,14931,22130,0,3,1,3,0,1,0,76.14,67.47 ,33.33
03,012,01,008,0000,0,41737,516,42253,59203,0,3,1,3,0,1,0,76.14,71.37 ,33.33
03,012,01,009,0000,0,18741,231,18972,25519,0,3,1,3,0,1,0,76.14,74.34 ,33.33
03,012,01,010,0000,0,16610,274,16884,22964,0,3,1,3,0,1,0,76.14,73.52 ,33.33
03,012,01,011,0000,0,5244,91,5335,7770,0,3,1,3,0,1,0,76.14,68.66 ,33.33
03,012,01,012,0000,0,13855,217,14072,19958,0,3,1,3,0,1,0,76.14,70.51 ,33.33
03,012,01,013,0000,0,26535,304,26839,34699,0,3,1,3,0,1,0,76.14,77.35 ,33.33
03,012,01,014,0000,0,12834,184,13018,18211,0,3,1,3,0,1,0,76.14,71.48 ,33.33
03,012,01,015,0000,0,14828,173,15001,22340,0,3,1,3,0,1,0,76.14,67.15 ,33.33
03,012,01,016,0000,0,11019,144,11163,14533,0,3,1,3,0,1,0,76.14,76.81 ,33.33
03,012,01,017,0000,0,6592,58,6650,8909,0,3,1,3,0,1,0,76.14,74.64 ,33.33
03,012,01,018,0000,0,18323,259,18582,25661,0,3,1,3,0,1,0,76.14,72.41 ,33.33
03,012,01,019,0000,0,23485,291,23776,32908,0,3,1,3,0,1,0,76.14,72.25 ,33.33
03,012,01,020,0000,0,24763,351,25114,35516,0,3,1,3,0,1,0,76.14,70.71 ,33.33
03,012,01,021,0000,0,8492,157,8649,13240,0,3,1,3,0,1,0,76.14,65.32 ,33.33
03,012,01,022,0000,0,4593,45,4638,6491,0,3,1,3,0,1,0,76.14,71.45 ,33.33
03,012,01,023,0000,0,6610,106,6716,10329,0,3,1,3,0,1,0,76.14,65.02 ,33.33
03,012,01,024,0000,0,10045,140,10185,13468,0,3,1,3,0,1,0,76.14,75.62 ,33.33
03,012,01,025,0000,0,48,1,49,94,0,3,1,3,0,1,0,76.14,52.13 ,33.33
03,012,01,026,0000,0,203,3,206,340,0,3,1,3,0,1,0,76.14,60.59 ,33.33
03,012,01,027,0000,0,117,0,117,243,0,3,1,3,0,1,0,76.14,48.15 ,33.33
03,013,01,001,0000,0,92406,812,93218,140730,0,3,1,3,0,1,0,76.14,66.24 ,33.33
03,013,01,002,0000,0,23647,197,23844,37382,0,3,1,3,0,1,0,76.14,63.78 ,33.33
03,013,01,003,0000,0,21012,214,21226,31273,0,3,1,3,0,1,0,76.14,67.87 ,33.33
03,013,01,004,0000,0,12306,164,12470,21971,0,3,1,3,0,1,0,76.14,56.76 ,33.33
03,013,01,005,0000,0,25553,235,25788,34964,0,3,1,3,0,1,0,76.14,73.76 ,33.33
03,013,01,006,0000,0,13965,136,14101,20007,0,3,1,3,0,1,0,76.14,70.48 ,33.33
03,013,01,007,0000,0,5955,54,6009,8105,0,3,1,3,0,1,0,76.14,74.14 ,33.33
03,013,01,008,0000,0,10894,123,11017,15110,0,3,1,3,0,1,0,76.14,72.91 ,33.33
03,013,01,009,0000,0,13041,126,13167,18590,0,3,1,3,0,1,0,76.14,70.83 ,33.33
03,013,01,010,0000,0,14539,195,14734,19344,0,3,1,3,0,1,0,76.14,76.17 ,33.33
03,013,01,011,0000,0,14626,139,14765,22758,0,3,1,3,0,1,0,76.14,64.88 ,33.33
03,013,01,012,0000,0,11607,124,11731,17467,0,3,1,3,0,1,0,76.14,67.16 ,33.33
03,013,01,013,0000,0,28357,304,28661,43250,0,3,1,3,0,1,0,76.14,66.27 ,33.33
03,013,01,014,0000,0,9887,96,9983,14157,0,3,1,3,0,1,0,76.14,70.52 ,33.33
03,013,01,015,0000,0,5812,58,5870,9083,0,3,1,3,0,1,0,76.14,64.63 ,33.33
03,013,01,016,0000,0,13413,113,13526,21304,0,3,1,3,0,1,0,76.14,63.49 ,33.33
03,013,01,017,0000,0,18886,162,19048,27516,0,3,1,3,0,1,0,76.14,69.23 ,33.33
03,013,01,018,0000,0,6725,72,6797,9571,0,3,1,3,0,1,0,76.14,71.02 ,33.33
03,013,01,019,0000,0,11366,96,11462,16217,0,3,1,3,0,1,0,76.14,70.68 ,33.33
03,013,01,020,0000,0,6795,65,6860,9753,0,3,1,3,0,1,0,76.14,70.34 ,33.33
03,013,01,021,0000,0,11785,119,11904,17417,0,3,1,3,0,1,0,76.14,68.35 ,33.33
03,013,01,022,0000,0,4380,53,4433,8509,0,3,1,3,0,1,0,76.14,52.10 ,33.33
03,013,01,023,0000,0,4871,58,4929,8562,0,3,1,3,0,1,0,76.14,57.57 ,33.33
03,013,01,024,0000,0,3007,35,3042,5487,0,3,1,3,0,1,0,76.14,55.44 ,33.33
03,013,01,025,0000,0,2890,32,2922,5005,0,3,1,3,0,1,0,76.14,58.38 ,33.33
03,013,01,026,0000,0,208,3,211,372,0,3,1,3,0,1,0,76.14,56.72 ,33.33
03,013,01,027,0000,0,28,0,28,51,0,3,1,3,0,1,0,76.14,54.90 ,33.33
03,013,01,028,0000,0,221,4,225,362,0,3,1,3,0,1,0,76.14,62.15 ,33.33
03,013,01,029,0000,0,83,0,83,169,0,3,1,3,0,1,0,76.14,49.11 ,33.33
03,013,01,030,0000,0,250,7,257,431,0,3,1,3,0,1,0,76.14,59.63 ,33.33
03,013,01,031,0000,0,259,3,262,433,0,3,1,3,0,1,0,76.14,60.51 ,33.33
03,013,01,032,0000,0,165,0,165,292,0,3,1,3,0,1,0,76.14,56.51 ,33.33
03,013,01,033,0000,0,235,4,239,401,0,3,1,3,0,1,0,76.14,59.60 ,33.33
03,014,01,001,0000,0,37795,547,38342,63691,0,3,1,3,0,1,0,76.14,60.20 ,33.33
03,014,01,002,0000,0,3493,44,3537,6521,0,3,1,3,0,1,0,76.14,54.24 ,33.33
03,014,01,003,0000,0,3497,52,3549,6507,0,3,1,3,0,1,0,76.14,54.54 ,33.33
03,014,01,004,0000,0,6936,103,7039,11723,0,3,1,3,0,1,0,76.14,60.04 ,33.33
03,014,01,005,0000,0,3093,46,3139,5961,0,3,1,3,0,1,0,76.14,52.66 ,33.33
03,014,01,006,0000,0,3688,57,3745,6861,0,3,1,3,0,1,0,76.14,54.58 ,33.33
03,014,01,007,0000,0,2278,25,2303,5107,0,3,1,3,0,1,0,76.14,45.09 ,33.33
03,014,01,008,0000,0,1842,28,1870,3809,0,3,1,3,0,1,0,76.14,49.09 ,33.33
03,014,01,009,0000,0,3549,38,3587,6655,0,3,1,3,0,1,0,76.14,53.90 ,33.33
03,014,01,010,0000,0,1368,17,1385,2551,0,3,1,3,0,1,0,76.14,54.29 ,33.33
03,014,01,011,0000,0,899,13,912,1718,0,3,1,3,0,1,0,76.14,53.08 ,33.33
03,014,01,012,0000,0,194,6,200,349,0,3,1,3,0,1,0,76.14,57.31 ,33.33
03,014,01,013,0000,0,174,2,176,297,0,3,1,3,0,1,0,76.14,59.26 ,33.33
03,014,01,014,0000,0,109,0,109,231,0,3,1,3,0,1,0,76.14,47.19 ,33.33
03,014,01,015,0000,0,160,1,161,344,0,3,1,3,0,1,0,76.14,46.80 ,33.33
03,014,01,016,0000,0,62,1,63,152,0,3,1,3,0,1,0,76.14,41.45 ,33.33
03,015,01,001,0000,0,42248,544,42792,67706,0,3,1,3,0,1,0,76.14,63.20 ,33.33
03,015,01,002,0000,0,7276,125,7401,11837,0,3,1,3,0,1,0,76.14,62.52 ,33.33
03,015,01,003,0000,0,1069,22,1091,2018,0,3,1,3,0,1,0,76.14,54.06 ,33.33
03,015,01,004,0000,0,24433,368,24801,40434,0,3,1,3,0,1,0,76.14,61.34 ,33.33
03,015,01,005,0000,0,6648,122,6770,11634,0,3,1,3,0,1,0,76.14,58.19 ,33.33
03,015,01,006,0000,0,6127,80,6207,9990,0,3,1,3,0,1,0,76.14,62.13 ,33.33
03,015,01,007,0000,0,3864,53,3917,7123,0,3,1,3,0,1,0,76.14,54.99 ,33.33
03,015,01,008,0000,0,692,10,702,1376,0,3,1,3,0,1,0,76.14,51.02 ,33.33
03,015,01,009,0000,0,176,4,180,348,0,3,1,3,0,1,0,76.14,51.72 ,33.33
03,015,01,010,0000,0,4340,60,4400,7768,0,3,1,3,0,1,0,76.14,56.64 ,33.33
03,015,01,011,0000,0,9584,329,9913,18689,0,3,1,3,0,1,0,76.14,53.04 ,33.33
03,015,01,012,0000,0,5495,122,5617,10478,0,3,1,3,0,1,0,76.14,53.61 ,33.33
03,015,01,013,0000,0,197,8,205,404,0,3,1,3,0,1,0,76.14,50.74 ,33.33
03,016,01,001,0000,0,23779,280,24059,35450,0,3,1,3,0,1,0,76.14,67.87 ,33.33
03,016,01,002,0000,0,5987,86,6073,9765,0,3,1,3,0,1,0,76.14,62.19 ,33.33
03,016,01,003,0000,0,3913,37,3950,6857,0,3,1,3,0,1,0,76.14,57.61 ,33.33
03,016,01,004,0000,0,3571,40,3611,6542,0,3,1,3,0,1,0,76.14,55.20 ,33.33
03,016,01,005,0000,0,1222,23,1245,2747,0,3,1,3,0,1,0,76.14,45.32 ,33.33
03,016,01,006,0000,0,1094,16,1110,2244,0,3,1,3,0,1,0,76.14,49.47 ,33.33
03,017,01,001,0000,0,25084,339,25423,40141,0,3,1,3,0,1,0,76.14,63.33 ,33.33
03,017,01,002,0000,0,22687,334,23021,36340,0,3,1,3,0,1,0,76.14,63.35 ,33.33
03,017,01,003,0000,0,13355,220,13575,20630,0,3,1,3,0,1,0,76.14,65.80 ,33.33
03,017,01,004,0000,0,27083,368,27451,40602,0,3,1,3,0,1,0,76.14,67.61 ,33.33
03,017,01,005,0000,0,22905,360,23265,34771,0,3,1,3,0,1,0,76.14,66.91 ,33.33
03,017,01,006,0000,0,28315,432,28747,44119,0,3,1,3,0,1,0,76.14,65.16 ,33.33
03,017,01,007,0000,0,20983,271,21254,31126,0,3,1,3,0,1,0,76.14,68.28 ,33.33
03,018,01,001,0000,0,63774,813,64587,106437,0,3,1,3,0,1,0,76.14,60.68 ,33.33
03,018,01,002,0000,0,47697,649,48346,81221,0,3,1,3,0,1,0,76.14,59.52 ,33.33
03,018,01,003,0000,0,20031,287,20318,35960,0,3,1,3,0,1,0,76.14,56.50 ,33.33
03,019,01,001,0000,0,11092,119,11211,17416,0,3,1,3,0,1,0,76.14,64.37 ,33.33
03,019,01,002,0000,0,30618,389,31007,47227,0,3,1,3,0,1,0,76.14,65.66 ,33.33
03,019,01,003,0000,0,45711,456,46167,70703,0,3,1,3,0,1,0,76.14,65.30 ,33.33
03,019,01,004,0000,0,32515,373,32888,51164,0,3,1,3,0,1,0,76.14,64.28 ,33.33
03,019,01,005,0000,0,59936,607,60543,95245,0,3,1,3,0,1,0,76.14,63.57 ,33.33
03,019,01,006,0000,0,58481,665,59146,87816,0,3,1,3,0,1,0,76.14,67.35 ,33.33
03,019,01,007,0000,0,36802,421,37223,55613,0,3,1,3,0,1,0,76.14,66.93 ,33.33
03,019,01,008,0000,0,78261,902,79163,120092,0,3,1,3,0,1,0,76.14,65.92 ,33.33
03,020,01,001,0000,0,64303,439,64742,86419,0,3,1,3,0,1,0,76.14,74.92 ,33.33
03,020,01,002,0000,0,65323,490,65813,87014,0,3,1,3,0,1,0,76.14,75.63 ,33.33
03,021,01,001,0000,0,73256,893,74149,108854,0,3,1,3,0,1,0,76.14,68.12 ,33.33
03,021,01,002,0000,0,64773,692,65465,93562,0,3,1,3,0,1,0,76.14,69.97 ,33.33
03,021,01,003,0000,0,23072,291,23363,33280,0,3,1,3,0,1,0,76.14,70.20 ,33.33
03,021,01,004,0000,0,56131,637,56768,81699,0,3,1,3,0,1,0,76.14,69.48 ,33.33
03,021,01,005,0000,0,23494,227,23721,34146,0,3,1,3,0,1,0,76.14,69.47 ,33.33
03,021,01,006,0000,0,64851,804,65655,92681,0,3,1,3,0,1,0,76.14,70.84 ,33.33
03,021,01,007,0000,0,13626,156,13782,20711,0,3,1,3,0,1,0,76.14,66.54 ,33.33
04,001,01,001,0000,0,6720,72,6792,9546,0,3,1,3,0,1,0,76.14,71.15 ,33.33
04,001,01,002,0000,0,3570,52,3622,5341,0,3,1,3,0,1,0,76.14,67.82 ,33.33
04,001,01,003,0000,0,4846,45,4891,6612,0,3,1,3,0,1,0,76.14,73.97 ,33.33
04,001,01,004,0000,0,3582,50,3632,5274,0,3,1,3,0,1,0,76.14,68.87 ,33.33
04,001,01,005,0000,0,2183,23,2206,2997,0,3,1,3,0,1,0,76.14,73.61 ,33.33
04,001,01,006,0000,0,33,0,33,82,0,3,1,3,0,1,0,76.14,40.24 ,33.33
04,002,01,001,0000,0,1898,28,1926,2232,0,3,1,3,0,1,0,76.14,86.29 ,33.33
04,002,01,002,0000,0,603,7,610,749,0,3,1,3,0,1,0,76.14,81.44 ,33.33
04,002,01,003,0000,0,304,1,305,374,0,3,1,3,0,1,0,76.14,81.55 ,33.33
04,002,01,004,0000,0,308,4,312,426,1,4,2,4,1,2,1,77.14,73.24 ,34.33
01,000,01,001,0001,0,2458,24,2482,3636,0,3,1,3,0,1,0,76.14,68.26 ,33.33
01,000,01,001,0002,0,2117,22,2139,3132,0,3,1,3,0,1,0,76.14,68.30 ,33.33
01,000,01,001,0003,0,2644,31,2675,4161,0,3,1,3,0,1,0,76.14,64.29 ,33.33
01,000,01,001,0004,0,3453,23,3476,5216,0,3,1,3,0,1,0,76.14,66.64 ,33.33
01,000,01,001,0005,0,3240,30,3270,4728,0,3,1,3,0,1,0,76.14,69.16 ,33.33
01,000,01,001,0006,0,854,6,860,1149,0,3,1,3,0,1,0,76.14,74.85 ,33.33
01,000,01,001,0007,0,2578,20,2598,3697,0,3,1,3,0,1,0,76.14,70.27 ,33.33
01,000,01,001,0008,0,2967,37,3004,4382,0,3,1,3,0,1,0,76.14,68.55 ,33.33
01,000,01,001,0009,0,2296,27,2323,3507,0,3,1,3,0,1,0,76.14,66.24 ,33.33
01,000,01,001,0010,0,2508,25,2533,3687,0,3,1,3,0,1,0,76.14,68.70 ,33.33
01,000,01,001,0011,0,4062,48,4110,5907,0,3,1,3,0,1,0,76.14,69.58 ,33.33
01,000,01,001,0012,0,3325,37,3362,5250,0,3,1,3,0,1,0,76.14,64.04 ,33.33
01,000,01,001,0013,0,3072,26,3098,4368,0,3,1,3,0,1,0,76.14,70.92 ,33.33
01,000,01,001,0014,0,3493,29,3522,5174,0,3,1,3,0,1,0,76.14,68.07 ,33.33
01,000,01,001,0015,0,3253,34,3287,4729,0,3,1,3,0,1,0,76.14,69.51 ,33.33
01,000,01,001,0016,0,4077,38,4115,5984,0,3,1,3,0,1,0,76.14,68.77 ,33.33
01,000,01,001,0017,0,2115,33,2148,3018,0,3,1,3,0,1,0,76.14,71.17 ,33.33
01,000,01,001,0018,0,2647,34,2681,3646,0,3,1,3,0,1,0,76.14,73.53 ,33.33
01,000,01,001,0019,0,2041,30,2071,3190,0,3,1,3,0,1,0,76.14,64.92 ,33.33
01,000,01,001,0020,0,4196,40,4236,6146,0,3,1,3,0,1,0,76.14,68.92 ,33.33
01,000,01,001,0021,0,3691,44,3735,5652,0,3,1,3,0,1,0,76.14,66.08 ,33.33
01,000,01,001,0022,0,2400,29,2429,3640,0,3,1,3,0,1,0,76.14,66.73 ,33.33
01,000,01,001,0023,0,2613,31,2644,4028,0,3,1,3,0,1,0,76.14,65.64 ,33.33
01,000,01,001,0024,0,4389,49,4438,6426,0,3,1,3,0,1,0,76.14,69.06 ,33.33
01,000,01,001,0025,0,3130,45,3175,4766,0,3,1,3,0,1,0,76.14,66.62 ,33.33
01,000,01,001,0026,0,1746,17,1763,2758,0,3,1,3,0,1,0,76.14,63.92 ,33.33
01,000,01,001,0027,0,2632,21,2653,4229,0,3,1,3,0,1,0,76.14,62.73 ,33.33
01,000,01,001,0028,0,2881,27,2908,4419,0,3,1,3,0,1,0,76.14,65.81 ,33.33
01,000,01,001,0029,0,2233,44,2277,3330,0,3,1,3,0,1,0,76.14,68.38 ,33.33
01,000,01,001,0030,0,2652,32,2684,4115,0,3,1,3,0,1,0,76.14,65.22 ,33.33
01,000,01,001,0031,0,2025,29,2054,3016,0,3,1,3,0,1,0,76.14,68.10 ,33.33
01,000,01,001,0032,0,3141,49,3190,4560,0,3,1,3,0,1,0,76.14,69.96 ,33.33
01,000,01,001,0033,0,2067,22,2089,2942,0,3,1,3,0,1,0,76.14,71.01 ,33.33
01,000,01,001,0034,0,2117,23,2140,3169,0,3,1,3,0,1,0,76.14,67.53 ,33.33
01,000,01,001,0035,0,2270,23,2293,3452,0,3,1,3,0,1,0,76.14,66.43 ,33.33
01,000,01,001,0036,0,2444,21,2465,3749,0,3,1,3,0,1,0,76.14,65.75 ,33.33
01,000,01,001,0037,0,2773,46,2819,4405,0,3,1,3,0,1,0,76.14,64.00 ,33.33
01,000,01,001,0038,0,4581,85,4666,6972,0,3,1,3,0,1,0,76.14,66.92 ,33.33
01,000,01,001,0039,0,1166,8,1174,1764,0,3,1,3,0,1,0,76.14,66.55 ,33.33
01,000,01,001,0040,0,1524,18,1542,2314,0,3,1,3,0,1,0,76.14,66.64 ,33.33
01,000,01,002,0041,0,2589,30,2619,3790,0,3,1,3,0,1,0,76.14,69.10 ,33.33
01,000,01,002,0042,0,1440,22,1462,2249,0,3,1,3,0,1,0,76.14,65.01 ,33.33
01,000,01,002,0043,0,2416,26,2442,3639,0,3,1,3,0,1,0,76.14,67.11 ,33.33
01,000,01,002,0044,0,2142,19,2161,3253,0,3,1,3,0,1,0,76.14,66.43 ,33.33
01,000,01,002,0045,0,4167,32,4199,6079,0,3,1,3,0,1,0,76.14,69.07 ,33.33
01,000,01,002,0046,0,3662,29,3691,5391,0,3,1,3,0,1,0,76.14,68.47 ,33.33
01,000,01,002,0047,0,3869,39,3908,5803,0,3,1,3,0,1,0,76.14,67.34 ,33.33
01,000,01,002,0048,0,3820,43,3863,6101,0,3,1,3,0,1,0,76.14,63.32 ,33.33
01,000,01,002,0049,0,2574,34,2608,4030,0,3,1,3,0,1,0,76.14,64.71 ,33.33
01,000,01,002,0050,0,1888,27,1915,3038,0,3,1,3,0,1,0,76.14,63.03 ,33.33
01,000,01,002,0051,0,3593,42,3635,5381,0,3,1,3,0,1,0,76.14,67.55 ,33.33
01,000,01,002,0052,0,2063,17,2080,3096,0,3,1,3,0,1,0,76.14,67.18 ,33.33
01,000,01,002,0053,0,3459,60,3519,5546,0,3,1,3,0,1,0,76.14,63.45 ,33.33
01,000,01,002,0054,0,2519,40,2559,4010,0,3,1,3,0,1,0,76.14,63.82 ,33.33
01,000,01,002,0055,0,2850,37,2887,4278,0,3,1,3,0,1,0,76.14,67.48 ,33.33
01,000,01,002,0056,0,2874,45,2919,4499,0,3,1,3,0,1,0,76.14,64.88 ,33.33
01,000,01,002,0057,0,3776,48,3824,5656,0,3,1,3,0,1,0,76.14,67.61 ,33.33
01,000,01,002,0058,0,2016,19,2035,2992,0,3,1,3,0,1,0,76.14,68.01 ,33.33
01,000,01,002,0059,0,3056,39,3095,4616,0,3,1,3,0,1,0,76.14,67.05 ,33.33
01,000,01,002,0060,0,3730,66,3796,6038,0,3,1,3,0,1,0,76.14,62.87 ,33.33
01,000,01,002,0061,0,3295,35,3330,4881,0,3,1,3,0,1,0,76.14,68.22 ,33.33
01,000,01,002,0062,0,3636,30,3666,5594,0,3,1,3,0,1,0,76.14,65.53 ,33.33
01,000,01,002,0063,0,2434,35,2469,3632,0,3,1,3,0,1,0,76.14,67.98 ,33.33
01,000,01,002,0064,0,2608,32,2640,3995,0,3,1,3,0,1,0,76.14,66.08 ,33.33
01,000,01,002,0065,0,2244,27,2271,3476,0,3,1,3,0,1,0,76.14,65.33 ,33.33
01,000,01,002,0066,0,3306,35,3341,5000,0,3,1,3,0,1,0,76.14,66.82 ,33.33
01,000,01,002,0067,0,2059,18,2077,3174,0,3,1,3,0,1,0,76.14,65.44 ,33.33
01,000,01,002,0068,0,2831,28,2859,4280,0,3,1,3,0,1,0,76.14,66.80 ,33.33
01,000,01,002,0069,0,2562,18,2580,3724,0,3,1,3,0,1,0,76.14,69.28 ,33.33
01,000,01,002,0070,0,3072,31,3103,4356,0,3,1,3,0,1,0,76.14,71.24 ,33.33
01,000,01,002,0071,0,3296,27,3323,5011,0,3,1,3,0,1,0,76.14,66.31 ,33.33
01,000,01,002,0072,0,2659,31,2690,3798,0,3,1,3,0,1,0,76.14,70.83 ,33.33
01,000,01,002,0073,0,2754,25,2779,4127,0,3,1,3,0,1,0,76.14,67.34 ,33.33
01,000,01,002,0074,0,3223,23,3246,4857,0,3,1,3,0,1,0,76.14,66.83 ,33.33
01,000,01,002,0075,0,4030,34,4064,6260,0,3,1,3,0,1,0,76.14,64.92 ,33.33
01,000,01,002,0076,0,2899,28,2927,4481,0,3,1,3,0,1,0,76.14,65.32 ,33.33
01,000,01,002,0077,0,3147,30,3177,4625,0,3,1,3,0,1,0,76.14,68.69 ,33.33
01,000,01,002,0078,0,2462,24,2486,3827,0,3,1,3,0,1,0,76.14,64.96 ,33.33
01,000,01,002,0079,0,2162,16,2178,3310,0,3,1,3,0,1,0,76.14,65.80 ,33.33
01,000,01,002,0080,0,3485,27,3512,5442,0,3,1,3,0,1,0,76.14,64.54 ,33.33
01,000,01,002,0081,0,3295,20,3315,5277,0,3,1,3,0,1,0,76.14,62.82 ,33.33
01,000,01,002,0082,0,3977,37,4014,6080,0,3,1,3,0,1,0,76.14,66.02 ,33.33
01,000,01,002,0083,0,671,6,677,1048,0,3,1,3,0,1,0,76.14,64.60 ,33.33
01,000,01,002,0084,0,735,5,740,1108,0,3,1,3,0,1,0,76.14,66.79 ,33.33
01,000,01,002,0085,0,1031,26,1057,1663,0,3,1,3,0,1,0,76.14,63.56 ,33.33
01,000,01,002,0086,0,1570,28,1598,2640,0,3,1,3,0,1,0,76.14,60.53 ,33.33
01,000,01,002,0087,0,853,9,862,1262,0,3,1,3,0,1,0,76.14,68.30 ,33.33
01,000,01,002,0088,0,833,6,839,1137,0,3,1,3,0,1,0,76.14,73.79 ,33.33
01,000,01,002,0089,0,791,13,804,1218,0,3,1,3,0,1,0,76.14,66.01 ,33.33
01,000,01,002,0090,0,3351,33,3384,5087,0,3,1,3,0,1,0,76.14,66.52 ,33.33
01,000,01,003,0091,0,3236,20,3256,4775,0,3,1,3,0,1,0,76.14,68.19 ,33.33
01,000,01,003,0092,0,4569,28,4597,6947,0,3,1,3,0,1,0,76.14,66.17 ,33.33
01,000,01,003,0093,0,3483,25,3508,5441,0,3,1,3,0,1,0,76.14,64.47 ,33.33
01,000,01,003,0094,0,2459,23,2482,3791,0,3,1,3,0,1,0,76.14,65.47 ,33.33
01,000,01,003,0095,0,2829,23,2852,4298,0,3,1,3,0,1,0,76.14,66.36 ,33.33
01,000,01,003,0096,0,2469,25,2494,3757,0,3,1,3,0,1,0,76.14,66.38 ,33.33
01,000,01,003,0097,0,2228,15,2243,3541,0,3,1,3,0,1,0,76.14,63.34 ,33.33
01,000,01,003,0098,0,2518,18,2536,3985,0,3,1,3,0,1,0,76.14,63.64 ,33.33
01,000,01,003,0099,0,2389,15,2404,3730,0,3,1,3,0,1,0,76.14,64.45 ,33.33
01,000,01,003,0100,0,4042,48,4090,6154,0,3,1,3,0,1,0,76.14,66.46 ,33.33
01,000,01,003,0101,0,2159,16,2175,3317,0,3,1,3,0,1,0,76.14,65.57 ,33.33
01,000,01,003,0102,0,2500,19,2519,3880,0,3,1,3,0,1,0,76.14,64.92 ,33.33
01,000,01,003,0103,0,1757,21,1778,2759,0,3,1,3,0,1,0,76.14,64.44 ,33.33
01,000,01,003,0104,0,2446,16,2462,3618,0,3,1,3,0,1,0,76.14,68.05 ,33.33
01,000,01,003,0105,0,4224,37,4261,6728,0,3,1,3,0,1,0,76.14,63.33 ,33.33
01,000,01,003,0106,0,3425,31,3456,5189,0,3,1,3,0,1,0,76.14,66.60 ,33.33
01,000,01,003,0107,0,1847,26,1873,3005,0,3,1,3,0,1,0,76.14,62.33 ,33.33
01,000,01,003,0108,0,3087,36,3123,4569,0,3,1,3,0,1,0,76.14,68.35 ,33.33
01,000,01,003,0109,0,4738,58,4796,7104,0,3,1,3,0,1,0,76.14,67.51 ,33.33
01,000,01,003,0110,0,2788,30,2818,3947,0,3,1,3,0,1,0,76.14,71.40 ,33.33
01,000,01,003,0111,0,3845,32,3877,5595,0,3,1,3,0,1,0,76.14,69.29 ,33.33
01,000,01,003,0112,0,3737,45,3782,5892,0,3,1,3,0,1,0,76.14,64.19 ,33.33
01,000,01,003,0113,0,3629,34,3663,5631,0,3,1,3,0,1,0,76.14,65.05 ,33.33
01,000,01,003,0114,0,3266,30,3296,5053,0,3,1,3,0,1,0,76.14,65.23 ,33.33
01,000,01,003,0115,0,3652,38,3690,5997,0,3,1,3,0,1,0,76.14,61.53 ,33.33
01,000,01,003,0116,0,2033,20,2053,3158,0,3,1,3,0,1,0,76.14,65.01 ,33.33
01,000,01,003,0117,0,1762,20,1782,2795,0,3,1,3,0,1,0,76.14,63.76 ,33.33
01,000,01,003,0118,0,1925,21,1946,2989,0,3,1,3,0,1,0,76.14,65.11 ,33.33
01,000,01,003,0119,0,3749,35,3784,5687,0,3,1,3,0,1,0,76.14,66.54 ,33.33
01,000,01,003,0120,0,1708,13,1721,2591,0,3,1,3,0,1,0,76.14,66.42 ,33.33
01,000,01,003,0121,0,1727,22,1749,2709,0,3,1,3,0,1,0,76.14,64.56 ,33.33
01,000,01,003,0122,0,3163,35,3198,4739,0,3,1,3,0,1,0,76.14,67.48 ,33.33
01,000,01,003,0123,0,1373,14,1387,2229,0,3,1,3,0,1,0,76.14,62.23 ,33.33
01,000,01,004,0124,0,2690,19,2709,3795,0,3,1,3,0,1,0,76.14,71.38 ,33.33
01,000,01,004,0125,0,2628,21,2649,3973,0,3,1,3,0,1,0,76.14,66.68 ,33.33
01,000,01,004,0126,0,1591,14,1605,2535,0,3,1,3,0,1,0,76.14,63.31 ,33.33
01,000,01,004,0127,0,1446,14,1460,2302,0,3,1,3,0,1,0,76.14,63.42 ,33.33
01,000,01,004,0128,0,2283,18,2301,3520,0,3,1,3,0,1,0,76.14,65.37 ,33.33
01,000,01,004,0129,0,3209,35,3244,4908,0,3,1,3,0,1,0,76.14,66.10 ,33.33
01,000,01,004,0130,0,2267,19,2286,3722,0,3,1,3,0,1,0,76.14,61.42 ,33.33
01,000,01,004,0131,0,3137,27,3164,4823,0,3,1,3,0,1,0,76.14,65.60 ,33.33
01,000,01,004,0132,0,3457,36,3493,5246,0,3,1,3,0,1,0,76.14,66.58 ,33.33
01,000,01,004,0133,0,1910,26,1936,2862,0,3,1,3,0,1,0,76.14,67.65 ,33.33
01,000,01,004,0134,0,2456,28,2484,3775,0,3,1,3,0,1,0,76.14,65.80 ,33.33
01,000,01,004,0135,0,1890,23,1913,2914,0,3,1,3,0,1,0,76.14,65.65 ,33.33
01,000,01,004,0136,0,2770,32,2802,4193,0,3,1,3,0,1,0,76.14,66.83 ,33.33
01,000,01,004,0137,0,2174,26,2200,3622,0,3,1,3,0,1,0,76.14,60.74 ,33.33
01,000,01,004,0138,0,2495,32,2527,3772,0,3,1,3,0,1,0,76.14,66.99 ,33.33
01,000,01,004,0139,0,3093,39,3132,4497,0,3,1,3,0,1,0,76.14,69.65 ,33.33
01,000,01,004,0140,0,2927,37,2964,4492,0,3,1,3,0,1,0,76.14,65.98 ,33.33
01,000,01,004,0141,0,2958,23,2981,4377,0,3,1,3,0,1,0,76.14,68.11 ,33.33
01,000,01,004,0142,0,2134,22,2156,3092,0,3,1,3,0,1,0,76.14,69.73 ,33.33
01,000,01,004,0143,0,3597,43,3640,5310,0,3,1,3,0,1,0,76.14,68.55 ,33.33
01,000,01,004,0144,0,1415,24,1439,2233,0,3,1,3,0,1,0,76.14,64.44 ,33.33
01,000,01,004,0145,0,3126,31,3157,4696,0,3,1,3,0,1,0,76.14,67.23 ,33.33
01,000,01,004,0146,0,3061,31,3092,4633,0,3,1,3,0,1,0,76.14,66.74 ,33.33
01,000,01,004,0147,0,2501,37,2538,3723,0,3,1,3,0,1,0,76.14,68.17 ,33.33
01,000,01,004,0148,0,4213,51,4264,6274,0,3,1,3,0,1,0,76.14,67.96 ,33.33
01,000,01,004,0149,0,3384,49,3433,5116,0,3,1,3,0,1,0,76.14,67.10 ,33.33
01,000,01,004,0150,0,3391,66,3457,5118,0,3,1,3,0,1,0,76.14,67.55 ,33.33
01,000,01,004,0151,0,3128,21,3149,4430,0,3,1,3,0,1,0,76.14,71.08 ,33.33
01,000,01,004,0152,0,3850,46,3896,5549,0,3,1,3,0,1,0,76.14,70.21 ,33.33
01,000,01,004,0153,0,4555,40,4595,6877,0,3,1,3,0,1,0,76.14,66.82 ,33.33
01,000,01,004,0154,0,2432,31,2463,3710,0,3,1,3,0,1,0,76.14,66.39 ,33.33
01,000,01,004,0155,0,3253,33,3286,5014,0,3,1,3,0,1,0,76.14,65.54 ,33.33
01,000,01,004,0156,0,4312,34,4346,6389,0,3,1,3,0,1,0,76.14,68.02 ,33.33
01,000,01,004,0157,0,2625,32,2657,3968,0,3,1,3,0,1,0,76.14,66.96 ,33.33
01,000,01,004,0158,0,2619,34,2653,3860,0,3,1,3,0,1,0,76.14,68.73 ,33.33
01,000,01,004,0159,0,3581,35,3616,5191,0,3,1,3,0,1,0,76.14,69.66 ,33.33
01,000,01,004,0160,0,1649,21,1670,2535,0,3,1,3,0,1,0,76.14,65.88 ,33.33
01,000,01,004,0161,0,2302,27,2329,3505,0,3,1,3,0,1,0,76.14,66.45 ,33.33
01,000,01,004,0162,0,3558,44,3602,5374,0,3,1,3,0,1,0,76.14,67.03 ,33.33
01,000,01,004,0163,0,2545,34,2579,3847,0,3,1,3,0,1,0,76.14,67.04 ,33.33
01,000,01,004,0164,0,1711,45,1756,2461,0,3,1,3,0,1,0,76.14,71.35 ,33.33
01,000,01,005,0165,0,3750,48,3798,5357,0,3,1,3,0,1,0,76.14,70.90 ,33.33
01,000,01,005,0166,0,2939,33,2972,4126,0,3,1,3,0,1,0,76.14,72.03 ,33.33
01,000,01,005,0167,0,3974,39,4013,5819,0,3,1,3,0,1,0,76.14,68.96 ,33.33
01,000,01,005,0168,0,2333,27,2360,3270,0,3,1,3,0,1,0,76.14,72.17 ,33.33
01,000,01,005,0169,0,3789,35,3824,5448,0,3,1,3,0,1,0,76.14,70.19 ,33.33
01,000,01,005,0170,0,5310,44,5354,7654,0,3,1,3,0,1,0,76.14,69.95 ,33.33
01,000,01,005,0171,0,4382,63,4445,6404,0,3,1,3,0,1,0,76.14,69.41 ,33.33
01,000,01,005,0172,0,2369,19,2388,3268,0,3,1,3,0,1,0,76.14,73.07 ,33.33
01,000,01,005,0173,0,4065,49,4114,5428,0,3,1,3,0,1,0,76.14,75.79 ,33.33
01,000,01,005,0174,0,3198,30,3228,4646,0,3,1,3,0,1,0,76.14,69.48 ,33.33
01,000,01,005,0175,0,3559,42,3601,5115,0,3,1,3,0,1,0,76.14,70.40 ,33.33
01,000,01,005,0176,0,2135,19,2154,3078,0,3,1,3,0,1,0,76.14,69.98 ,33.33
01,000,01,005,0177,0,1656,22,1678,2475,0,3,1,3,0,1,0,76.14,67.80 ,33.33
01,000,01,005,0178,0,2101,32,2133,3305,0,3,1,3,0,1,0,76.14,64.54 ,33.33
01,000,01,005,0179,0,2953,24,2977,4142,0,3,1,3,0,1,0,76.14,71.87 ,33.33
01,000,01,005,0180,0,3064,35,3099,4367,0,3,1,3,0,1,0,76.14,70.96 ,33.33
01,000,01,005,0181,0,3161,39,3200,4536,0,3,1,3,0,1,0,76.14,70.55 ,33.33
01,000,01,005,0182,0,1714,25,1739,2441,0,3,1,3,0,1,0,76.14,71.24 ,33.33
01,000,01,005,0183,0,2420,34,2454,3483,0,3,1,3,0,1,0,76.14,70.46 ,33.33
01,000,01,005,0184,0,4026,57,4083,5840,0,3,1,3,0,1,0,76.14,69.91 ,33.33
01,000,01,005,0185,0,2673,27,2700,3772,0,3,1,3,0,1,0,76.14,71.58 ,33.33
01,000,01,005,0186,0,2007,24,2031,2827,0,3,1,3,0,1,0,76.14,71.84 ,33.33
01,000,01,005,0187,0,4056,32,4088,6190,0,3,1,3,0,1,0,76.14,66.04 ,33.33
01,000,01,005,0188,0,3102,27,3129,4464,0,3,1,3,0,1,0,76.14,70.09 ,33.33
01,000,01,005,0189,0,8475,67,8542,12520,0,3,1,3,0,1,0,76.14,68.23 ,33.33
01,000,01,005,0190,0,3526,42,3568,5343,0,3,1,3,0,1,0,76.14,66.78 ,33.33
01,000,01,005,0191,0,3210,43,3253,4868,0,3,1,3,0,1,0,76.14,66.82 ,33.33
01,000,01,005,0192,0,6014,56,6070,9127,0,3,1,3,0,1,0,76.14,66.51 ,33.33
01,000,01,005,0193,0,3490,33,3523,5226,0,3,1,3,0,1,0,76.14,67.41 ,33.33
01,000,01,006,0194,0,2696,36,2732,4053,0,3,1,3,0,1,0,76.14,67.41 ,33.33
01,000,01,006,0195,0,2067,34,2101,3220,0,3,1,3,0,1,0,76.14,65.25 ,33.33
01,000,01,006,0196,0,2152,43,2195,3180,0,3,1,3,0,1,0,76.14,69.03 ,33.33
01,000,01,006,0197,0,1670,24,1694,2609,0,3,1,3,0,1,0,76.14,64.93 ,33.33
01,000,01,006,0198,0,3341,43,3384,5079,0,3,1,3,0,1,0,76.14,66.63 ,33.33
01,000,01,006,0199,0,2457,32,2489,3514,0,3,1,3,0,1,0,76.14,70.83 ,33.33
01,000,01,006,0200,0,2165,39,2204,3261,0,3,1,3,0,1,0,76.14,67.59 ,33.33
01,000,01,006,0201,0,2336,28,2364,3485,0,3,1,3,0,1,0,76.14,67.83 ,33.33
01,000,01,006,0202,0,2392,25,2417,3574,0,3,1,3,0,1,0,76.14,67.63 ,33.33
01,000,01,006,0203,0,3207,39,3246,4643,0,3,1,3,0,1,0,76.14,69.91 ,33.33
01,000,01,006,0204,0,3746,47,3793,5337,0,3,1,3,0,1,0,76.14,71.07 ,33.33
01,000,01,006,0205,0,2417,41,2458,3546,0,3,1,3,0,1,0,76.14,69.32 ,33.33
01,000,01,006,0206,0,2374,26,2400,3285,0,3,1,3,0,1,0,76.14,73.06 ,33.33
01,000,01,006,0207,0,2560,41,2601,3814,0,3,1,3,0,1,0,76.14,68.20 ,33.33
01,000,01,006,0208,0,2805,50,2855,3996,0,3,1,3,0,1,0,76.14,71.45 ,33.33
01,000,01,006,0209,0,3807,66,3873,6024,0,3,1,3,0,1,0,76.14,64.29 ,33.33
01,000,01,006,0210,0,4705,54,4759,6670,0,3,1,3,0,1,0,76.14,71.35 ,33.33
01,000,01,006,0211,0,3272,31,3303,4756,0,3,1,3,0,1,0,76.14,69.45 ,33.33
01,000,02,007,0212,0,1850,31,1881,3114,0,3,1,3,0,1,0,76.14,60.40 ,33.33
01,000,02,007,0213,0,1739,24,1763,3344,0,3,1,3,0,1,0,76.14,52.72 ,33.33
01,000,02,007,0214,0,1507,21,1528,2762,0,3,1,3,0,1,0,76.14,55.32 ,33.33
01,000,02,007,0215,0,2491,30,2521,4225,0,3,1,3,0,1,0,76.14,59.67 ,33.33
01,000,02,007,0216,0,2470,40,2510,4406,0,3,1,3,0,1,0,76.14,56.97 ,33.33
01,000,02,007,0217,0,2113,24,2137,3876,0,3,1,3,0,1,0,76.14,55.13 ,33.33
01,000,02,007,0218,0,1353,24,1377,2637,0,3,1,3,0,1,0,76.14,52.22 ,33.33
01,000,02,007,0219,0,2713,39,2752,4575,0,3,1,3,0,1,0,76.14,60.15 ,33.33
01,000,02,007,0220,0,1713,41,1754,2987,0,3,1,3,0,1,0,76.14,58.72 ,33.33
01,000,02,007,0221,0,1382,18,1400,2435,0,3,1,3,0,1,0,76.14,57.49 ,33.33
01,000,02,007,0222,0,1565,29,1594,3152,0,3,1,3,0,1,0,76.14,50.57 ,33.33
01,000,02,007,0223,0,2273,31,2304,3922,0,3,1,3,0,1,0,76.14,58.75 ,33.33
01,000,02,007,0224,0,2380,32,2412,4045,0,3,1,3,0,1,0,76.14,59.63 ,33.33
01,000,02,007,0225,0,1604,13,1617,2358,0,3,1,3,0,1,0,76.14,68.58 ,33.33
01,000,02,007,0226,0,5238,65,5303,7705,0,3,1,3,0,1,0,76.14,68.83 ,33.33
01,000,02,007,0227,0,2668,31,2699,3824,0,3,1,3,0,1,0,76.14,70.58 ,33.33
01,000,02,007,0228,0,2657,25,2682,3881,0,3,1,3,0,1,0,76.14,69.11 ,33.33
01,000,02,007,0229,0,2370,36,2406,3798,0,3,1,3,0,1,0,76.14,63.35 ,33.33
01,000,02,007,0230,0,573,8,581,874,0,3,1,3,0,1,0,76.14,66.48 ,33.33
01,000,02,007,0231,0,2450,52,2502,4094,0,3,1,3,0,1,0,76.14,61.11 ,33.33
01,000,02,007,0232,0,3136,43,3179,5085,0,3,1,3,0,1,0,76.14,62.52 ,33.33
01,000,02,007,0233,0,2273,26,2299,3892,0,3,1,3,0,1,0,76.14,59.07 ,33.33
01,000,02,007,0234,0,2656,46,2702,4529,0,3,1,3,0,1,0,76.14,59.66 ,33.33
01,000,02,007,0235,0,2455,24,2479,3977,0,3,1,3,0,1,0,76.14,62.33 ,33.33
01,000,02,007,0236,0,3902,55,3957,6245,0,3,1,3,0,1,0,76.14,63.36 ,33.33
01,000,02,007,0237,0,1845,39,1884,3054,0,3,1,3,0,1,0,76.14,61.69 ,33.33
01,000,02,007,0238,0,3449,36,3485,5545,0,3,1,3,0,1,0,76.14,62.85 ,33.33
01,000,02,007,0239,0,3047,27,3074,4887,0,3,1,3,0,1,0,76.14,62.90 ,33.33
01,000,02,007,0240,0,3713,41,3754,5884,0,3,1,3,0,1,0,76.14,63.80 ,33.33
01,000,02,007,0241,0,2457,33,2490,4140,0,3,1,3,0,1,0,76.14,60.14 ,33.33
01,000,02,007,0242,0,2119,32,2151,3635,0,3,1,3,0,1,0,76.14,59.17 ,33.33
01,000,02,007,0243,0,2472,24,2496,4188,0,3,1,3,0,1,0,76.14,59.60 ,33.33
01,000,02,007,0244,0,1820,24,1844,2976,0,3,1,3,0,1,0,76.14,61.96 ,33.33
01,000,02,007,0245,0,3143,49,3192,5135,0,3,1,3,0,1,0,76.14,62.16 ,33.33
01,000,02,007,0246,0,3130,33,3163,4447,0,3,1,3,0,1,0,76.14,71.13 ,33.33
01,000,02,007,0247,0,2146,24,2170,3403,0,3,1,3,0,1,0,76.14,63.77 ,33.33
01,000,02,007,0248,0,2339,31,2370,3651,0,3,1,3,0,1,0,76.14,64.91 ,33.33
01,000,02,007,0249,0,1705,37,1742,2757,0,3,1,3,0,1,0,76.14,63.18 ,33.33
01,000,02,007,0250,0,3143,35,3178,5180,0,3,1,3,0,1,0,76.14,61.35 ,33.33
01,000,02,007,0251,0,1844,36,1880,3032,0,3,1,3,0,1,0,76.14,62.01 ,33.33
01,000,02,008,0252,0,2023,33,2056,3231,0,3,1,3,0,1,0,76.14,63.63 ,33.33
01,000,02,008,0253,0,1917,26,1943,3094,0,3,1,3,0,1,0,76.14,62.80 ,33.33
01,000,02,008,0254,0,2063,29,2092,3208,0,3,1,3,0,1,0,76.14,65.21 ,33.33
01,000,02,008,0255,0,1789,28,1817,2777,0,3,1,3,0,1,0,76.14,65.43 ,33.33
01,000,02,008,0256,0,2635,26,2661,3979,0,3,1,3,0,1,0,76.14,66.88 ,33.33
01,000,02,008,0257,0,1751,19,1770,2775,0,3,1,3,0,1,0,76.14,63.78 ,33.33
01,000,02,008,0258,0,2172,24,2196,3330,0,3,1,3,0,1,0,76.14,65.95 ,33.33
01,000,02,008,0259,0,2883,47,2930,4291,0,3,1,3,0,1,0,76.14,68.28 ,33.33
01,000,02,008,0260,0,2704,30,2734,3955,0,3,1,3,0,1,0,76.14,69.13 ,33.33
01,000,02,008,0261,0,1844,23,1867,2977,0,3,1,3,0,1,0,76.14,62.71 ,33.33
01,000,02,008,0262,0,4419,65,4484,6907,0,3,1,3,0,1,0,76.14,64.92 ,33.33
01,000,02,008,0263,0,2071,31,2102,3250,0,3,1,3,0,1,0,76.14,64.68 ,33.33
01,000,02,008,0264,0,3341,45,3386,5192,0,3,1,3,0,1,0,76.14,65.22 ,33.33
01,000,02,008,0265,0,1577,26,1603,2507,0,3,1,3,0,1,0,76.14,63.94 ,33.33
01,000,02,008,0266,0,1680,22,1702,2550,0,3,1,3,0,1,0,76.14,66.75 ,33.33
01,000,02,008,0267,0,2406,32,2438,3835,0,3,1,3,0,1,0,76.14,63.57 ,33.33
01,000,02,008,0268,0,2329,41,2370,3525,0,3,1,3,0,1,0,76.14,67.23 ,33.33
01,000,02,008,0269,0,1293,16,1309,1919,0,3,1,3,0,1,0,76.14,68.21 ,33.33
01,000,02,008,0270,0,1593,27,1620,2518,0,3,1,3,0,1,0,76.14,64.34 ,33.33
01,000,02,008,0271,0,2614,36,2650,4137,0,3,1,3,0,1,0,76.14,64.06 ,33.33
01,000,02,008,0272,0,3430,44,3474,5119,0,3,1,3,0,1,0,76.14,67.86 ,33.33
01,000,02,008,0273,0,4133,45,4178,6296,0,3,1,3,0,1,0,76.14,66.36 ,33.33
01,000,02,008,0274,0,644,5,649,967,0,3,1,3,0,1,0,76.14,67.11 ,33.33
01,000,02,008,0275,0,2325,22,2347,3585,0,3,1,3,0,1,0,76.14,65.47 ,33.33
01,000,02,008,0276,0,2127,29,2156,3140,0,3,1,3,0,1,0,76.14,68.66 ,33.33
01,000,02,008,0277,0,3150,38,3188,4653,0,3,1,3,0,1,0,76.14,68.51 ,33.33
01,000,02,009,0278,0,2458,24,2482,4209,0,3,1,3,0,1,0,76.14,58.97 ,33.33
01,000,02,009,0279,0,2295,17,2312,3742,0,3,1,3,0,1,0,76.14,61.79 ,33.33
01,000,02,009,0280,0,3305,36,3341,5193,0,3,1,3,0,1,0,76.14,64.34 ,33.33
01,000,02,009,0281,0,3913,39,3952,6339,0,3,1,3,0,1,0,76.14,62.34 ,33.33
01,000,02,009,0282,0,2592,18,2610,4812,0,3,1,3,0,1,0,76.14,54.24 ,33.33
01,000,02,009,0283,0,3777,29,3806,5678,0,3,1,3,0,1,0,76.14,67.03 ,33.33
01,000,02,009,0284,0,2855,23,2878,4730,0,3,1,3,0,1,0,76.14,60.85 ,33.33
01,000,02,009,0285,0,2127,23,2150,3564,0,3,1,3,0,1,0,76.14,60.33 ,33.33
01,000,02,009,0286,0,2330,27,2357,3719,0,3,1,3,0,1,0,76.14,63.38 ,33.33
01,000,02,009,0287,0,3551,46,3597,6174,0,3,1,3,0,1,0,76.14,58.26 ,33.33
01,000,02,009,0288,0,2838,20,2858,4348,0,3,1,3,0,1,0,76.14,65.73 ,33.33
01,000,02,009,0289,0,2125,17,2142,3549,0,3,1,3,0,1,0,76.14,60.36 ,33.33
01,000,02,009,0290,0,2077,17,2094,3305,0,3,1,3,0,1,0,76.14,63.36 ,33.33
01,000,02,009,0291,0,3186,32,3218,5069,0,3,1,3,0,1,0,76.14,63.48 ,33.33
01,000,02,009,0292,0,2594,18,2612,4039,0,3,1,3,0,1,0,76.14,64.67 ,33.33
01,000,02,009,0293,0,2542,16,2558,4054,0,3,1,3,0,1,0,76.14,63.10 ,33.33
01,000,02,009,0294,0,2243,12,2255,3671,0,3,1,3,0,1,0,76.14,61.43 ,33.33
01,000,02,009,0295,0,1742,18,1760,2679,0,3,1,3,0,1,0,76.14,65.70 ,33.33
01,000,02,009,0296,0,2238,22,2260,3398,0,3,1,3,0,1,0,76.14,66.51 ,33.33
01,000,02,009,0297,0,2881,20,2901,4233,0,3,1,3,0,1,0,76.14,68.53 ,33.33
01,000,02,009,0298,0,2850,26,2876,4168,0,3,1,3,0,1,0,76.14,69.00 ,33.33
01,000,02,009,0299,0,3267,33,3300,5147,0,3,1,3,0,1,0,76.14,64.12 ,33.33
01,000,02,009,0300,0,3409,22,3431,5037,0,3,1,3,0,1,0,76.14,68.12 ,33.33
01,000,02,009,0301,0,1926,20,1946,3179,0,3,1,3,0,1,0,76.14,61.21 ,33.33
01,000,02,009,0302,0,2692,18,2710,4189,0,3,1,3,0,1,0,76.14,64.69 ,33.33
01,000,02,009,0303,0,3208,33,3241,4929,0,3,1,3,0,1,0,76.14,65.75 ,33.33
01,000,02,009,0304,0,2942,36,2978,4665,0,3,1,3,0,1,0,76.14,63.84 ,33.33
01,000,02,009,0305,0,2752,21,2773,4432,0,3,1,3,0,1,0,76.14,62.57 ,33.33
01,000,02,009,0306,0,3168,53,3221,5102,0,3,1,3,0,1,0,76.14,63.13 ,33.33
01,000,02,009,0307,0,3138,36,3174,4873,0,3,1,3,0,1,0,76.14,65.13 ,33.33
01,000,02,009,0308,0,2278,39,2317,3695,0,3,1,3,0,1,0,76.14,62.71 ,33.33
01,000,02,009,0309,0,2085,19,2104,3333,0,3,1,3,0,1,0,76.14,63.13 ,33.33
01,000,02,009,0310,0,2202,24,2226,3484,0,3,1,3,0,1,0,76.14,63.89 ,33.33
01,000,02,009,0311,0,3133,31,3164,5031,0,3,1,3,0,1,0,76.14,62.89 ,33.33
01,000,02,009,0312,0,4223,27,4250,6038,0,3,1,3,0,1,0,76.14,70.39 ,33.33
01,000,02,009,0313,0,1741,9,1750,2761,0,3,1,3,0,1,0,76.14,63.38 ,33.33
01,000,02,009,0314,0,1750,20,1770,2725,0,3,1,3,0,1,0,76.14,64.95 ,33.33
01,000,02,009,0315,0,4398,33,4431,6885,0,3,1,3,0,1,0,76.14,64.36 ,33.33
01,000,02,009,0316,0,2360,34,2394,4007,0,3,1,3,0,1,0,76.14,59.75 ,33.33
01,000,02,009,0317,0,1412,6,1418,2326,0,3,1,3,0,1,0,76.14,60.96 ,33.33
01,000,02,009,0318,0,4136,26,4162,6587,0,3,1,3,0,1,0,76.14,63.19 ,33.33
01,000,02,009,0319,0,3499,39,3538,5182,0,3,1,3,0,1,0,76.14,68.27 ,33.33
01,000,02,009,0320,0,1287,20,1307,2078,0,3,1,3,0,1,0,76.14,62.90 ,33.33
01,000,02,009,0321,0,2888,31,2919,4464,0,3,1,3,0,1,0,76.14,65.39 ,33.33
01,000,02,009,0322,0,3901,58,3959,5869,0,3,1,3,0,1,0,76.14,67.46 ,33.33
01,000,02,009,0323,0,2132,34,2166,3265,0,3,1,3,0,1,0,76.14,66.34 ,33.33
01,000,02,009,0324,0,2362,30,2392,4133,0,3,1,3,0,1,0,76.14,57.88 ,33.33
01,000,02,009,0325,0,2788,23,2811,4783,0,3,1,3,0,1,0,76.14,58.77 ,33.33
01,000,02,009,0326,0,2962,34,2996,5001,0,3,1,3,0,1,0,76.14,59.91 ,33.33
01,000,02,009,0327,0,2316,16,2332,3964,0,3,1,3,0,1,0,76.14,58.83 ,33.33
01,000,02,009,0328,0,2922,26,2948,4763,0,3,1,3,0,1,0,76.14,61.89 ,33.33
01,000,02,009,0329,0,2167,23,2190,3547,0,3,1,3,0,1,0,76.14,61.74 ,33.33
01,000,02,009,0330,0,3199,21,3220,5386,0,3,1,3,0,1,0,76.14,59.78 ,33.33
01,000,02,009,0331,0,3591,29,3620,5718,0,3,1,3,0,1,0,76.14,63.31 ,33.33
01,000,02,010,0332,0,1926,24,1950,2951,0,3,1,3,0,1,0,76.14,66.08 ,33.33
01,000,02,010,0333,0,1467,16,1483,2383,0,3,1,3,0,1,0,76.14,62.23 ,33.33
01,000,02,010,0334,0,1425,15,1440,2150,0,3,1,3,0,1,0,76.14,66.98 ,33.33
01,000,02,010,0335,0,2607,28,2635,3969,0,3,1,3,0,1,0,76.14,66.39 ,33.33
01,000,02,010,0336,0,2567,27,2594,4126,0,3,1,3,0,1,0,76.14,62.87 ,33.33
01,000,02,010,0337,0,2944,25,2969,4611,0,3,1,3,0,1,0,76.14,64.39 ,33.33
01,000,02,010,0338,0,2990,37,3027,4579,0,3,1,3,0,1,0,76.14,66.11 ,33.33
01,000,02,010,0339,0,1816,26,1842,2860,0,3,1,3,0,1,0,76.14,64.41 ,33.33
01,000,02,010,0340,0,2811,23,2834,4122,0,3,1,3,0,1,0,76.14,68.75 ,33.33
01,000,02,010,0341,0,2355,25,2380,3616,0,3,1,3,0,1,0,76.14,65.82 ,33.33
01,000,02,010,0342,0,3558,35,3593,5525,0,3,1,3,0,1,0,76.14,65.03 ,33.33
01,000,02,010,0343,0,2916,38,2954,4437,0,3,1,3,0,1,0,76.14,66.58 ,33.33
01,000,02,010,0344,0,2515,35,2550,3783,0,3,1,3,0,1,0,76.14,67.41 ,33.33
01,000,02,010,0345,0,3779,77,3856,6025,0,3,1,3,0,1,0,76.14,64.00 ,33.33
01,000,02,010,0346,0,1772,20,1792,2635,0,3,1,3,0,1,0,76.14,68.01 ,33.33
01,000,02,010,0347,0,1830,22,1852,2852,0,3,1,3,0,1,0,76.14,64.94 ,33.33
01,000,02,010,0348,0,2206,27,2233,3471,0,3,1,3,0,1,0,76.14,64.33 ,33.33
01,000,02,010,0349,0,2385,23,2408,3645,0,3,1,3,0,1,0,76.14,66.06 ,33.33
01,000,02,010,0350,0,4005,39,4044,5951,0,3,1,3,0,1,0,76.14,67.95 ,33.33
01,000,02,010,0351,0,2977,32,3009,4449,0,3,1,3,0,1,0,76.14,67.63 ,33.33
01,000,02,010,0352,0,4443,46,4489,6360,0,3,1,3,0,1,0,76.14,70.58 ,33.33
01,000,02,010,0353,0,714,5,719,1274,0,3,1,3,0,1,0,76.14,56.44 ,33.33
01,000,02,010,0354,0,1712,19,1731,3018,0,3,1,3,0,1,0,76.14,57.36 ,33.33
01,000,02,010,0355,0,1176,16,1192,2076,0,3,1,3,0,1,0,76.14,57.42 ,33.33
01,000,02,010,0356,0,1940,21,1961,2946,0,3,1,3,0,1,0,76.14,66.56 ,33.33
01,000,02,010,0357,0,2197,22,2219,3651,0,3,1,3,0,1,0,76.14,60.78 ,33.33
01,000,02,010,0358,0,2209,29,2238,3689,0,3,1,3,0,1,0,76.14,60.67 ,33.33
01,000,02,010,0359,0,1633,26,1659,2725,0,3,1,3,0,1,0,76.14,60.88 ,33.33
01,000,02,010,0360,0,2494,21,2515,4005,0,3,1,3,0,1,0,76.14,62.80 ,33.33
01,000,02,010,0361,0,3550,26,3576,5227,0,3,1,3,0,1,0,76.14,68.41 ,33.33
01,000,02,010,0362,0,3976,37,4013,6183,0,3,1,3,0,1,0,76.14,64.90 ,33.33
01,000,02,011,0363,0,2238,34,2272,3907,0,3,1,3,0,1,0,76.14,58.15 ,33.33
01,000,02,011,0364,0,1469,23,1492,2570,0,3,1,3,0,1,0,76.14,58.05 ,33.33
01,000,02,011,0365,0,1628,27,1655,2820,0,3,1,3,0,1,0,76.14,58.69 ,33.33
01,000,02,011,0366,0,3573,57,3630,5408,0,3,1,3,0,1,0,76.14,67.12 ,33.33
01,000,02,011,0367,0,2874,60,2934,4514,0,3,1,3,0,1,0,76.14,65.00 ,33.33
01,000,02,011,0368,0,2631,43,2674,4195,0,3,1,3,0,1,0,76.14,63.74 ,33.33
01,000,02,011,0369,0,2567,33,2600,3921,0,3,1,3,0,1,0,76.14,66.31 ,33.33
01,000,02,011,0370,0,2186,20,2206,3252,0,3,1,3,0,1,0,76.14,67.84 ,33.33
01,000,02,011,0371,0,2513,40,2553,3599,0,3,1,3,0,1,0,76.14,70.94 ,33.33
01,000,02,011,0372,0,2538,27,2565,3750,0,3,1,3,0,1,0,76.14,68.40 ,33.33
01,000,02,011,0373,0,4283,78,4361,6497,0,3,1,3,0,1,0,76.14,67.12 ,33.33
01,000,02,011,0374,0,2610,43,2653,4032,0,3,1,3,0,1,0,76.14,65.80 ,33.33
01,000,02,011,0375,0,2386,19,2405,3523,0,3,1,3,0,1,0,76.14,68.27 ,33.33
01,000,02,011,0376,0,5025,49,5074,7199,0,3,1,3,0,1,0,76.14,70.48 ,33.33
01,000,02,011,0377,0,2214,37,2251,3508,0,3,1,3,0,1,0,76.14,64.17 ,33.33
01,000,02,011,0378,0,3903,51,3954,5999,0,3,1,3,0,1,0,76.14,65.91 ,33.33
01,000,02,011,0379,0,3008,36,3044,4917,0,3,1,3,0,1,0,76.14,61.91 ,33.33
01,000,02,011,0380,0,4474,57,4531,6886,0,3,1,3,0,1,0,76.14,65.80 ,33.33
01,000,02,011,0381,0,2911,39,2950,4613,0,3,1,3,0,1,0,76.14,63.95 ,33.33
01,000,02,011,0382,0,1949,34,1983,3033,0,3,1,3,0,1,0,76.14,65.38 ,33.33
01,000,02,011,0383,0,3718,61,3779,5723,0,3,1,3,0,1,0,76.14,66.03 ,33.33
01,000,02,011,0384,0,2339,25,2364,3565,0,3,1,3,0,1,0,76.14,66.31 ,33.33
01,000,02,011,0385,0,1754,18,1772,2673,0,3,1,3,0,1,0,76.14,66.29 ,33.33
01,000,02,011,0386,0,3629,69,3698,5838,0,3,1,3,0,1,0,76.14,63.34 ,33.33
01,000,02,011,0387,0,2693,42,2735,4194,0,3,1,3,0,1,0,76.14,65.21 ,33.33
01,000,02,011,0388,0,2095,28,2123,3286,0,3,1,3,0,1,0,76.14,64.61 ,33.33
01,000,02,011,0389,0,1676,24,1700,2496,0,3,1,3,0,1,0,76.14,68.11 ,33.33
01,000,02,011,0390,0,2488,42,2530,3844,0,3,1,3,0,1,0,76.14,65.82 ,33.33
01,000,02,011,0391,0,2154,40,2194,3268,0,3,1,3,0,1,0,76.14,67.14 ,33.33
01,000,02,011,0392,0,2613,35,2648,3994,0,3,1,3,0,1,0,76.14,66.30 ,33.33
01,000,02,011,0393,0,2359,40,2399,3808,0,3,1,3,0,1,0,76.14,63.00 ,33.33
01,000,02,011,0394,0,3368,50,3418,5308,0,3,1,3,0,1,0,76.14,64.39 ,33.33
01,000,02,011,0395,0,2654,24,2678,4008,0,3,1,3,0,1,0,76.14,66.82 ,33.33
01,000,02,011,0396,0,2815,52,2867,4426,0,3,1,3,0,1,0,76.14,64.78 ,33.33
01,000,02,011,0397,0,2469,39,2508,3731,0,3,1,3,0,1,0,76.14,67.22 ,33.33
01,000,02,011,0398,0,1632,18,1650,2430,0,3,1,3,0,1,0,76.14,67.90 ,33.33
01,000,02,012,0399,0,2481,38,2519,3765,0,3,1,3,0,1,0,76.14,66.91 ,33.33
01,000,02,012,0400,0,2757,20,2777,4197,0,3,1,3,0,1,0,76.14,66.17 ,33.33
01,000,02,012,0401,0,2185,25,2210,3288,0,3,1,3,0,1,0,76.14,67.21 ,33.33
01,000,02,012,0402,0,3124,33,3157,4566,0,3,1,3,0,1,0,76.14,69.14 ,33.33
01,000,02,012,0403,0,2118,26,2144,3167,0,3,1,3,0,1,0,76.14,67.70 ,33.33
01,000,02,012,0404,0,2907,26,2933,4410,0,3,1,3,0,1,0,76.14,66.51 ,33.33
01,000,02,012,0405,0,2438,22,2460,3561,0,3,1,3,0,1,0,76.14,69.08 ,33.33
01,000,02,012,0406,0,2540,32,2572,3728,0,3,1,3,0,1,0,76.14,68.99 ,33.33
01,000,02,012,0407,0,2795,18,2813,4128,0,3,1,3,0,1,0,76.14,68.14 ,33.33
01,000,02,012,0408,0,2714,25,2739,4202,0,3,1,3,0,1,0,76.14,65.18 ,33.33
01,000,02,012,0409,0,2208,22,2230,2936,0,3,1,3,0,1,0,76.14,75.95 ,33.33
01,000,02,012,0410,0,2451,23,2474,3679,0,3,1,3,0,1,0,76.14,67.25 ,33.33
01,000,02,012,0411,0,3444,27,3471,5029,0,3,1,3,0,1,0,76.14,69.02 ,33.33
01,000,02,012,0412,0,1980,20,2000,3146,0,3,1,3,0,1,0,76.14,63.57 ,33.33
01,000,02,012,0413,0,1837,18,1855,2695,0,3,1,3,0,1,0,76.14,68.83 ,33.33
01,000,02,012,0414,0,3953,52,4005,6084,0,3,1,3,0,1,0,76.14,65.83 ,33.33
01,000,02,012,0415,0,2683,27,2710,3931,0,3,1,3,0,1,0,76.14,68.94 ,33.33
01,000,02,012,0416,0,2429,37,2466,3722,0,3,1,3,0,1,0,76.14,66.25 ,33.33
01,000,02,012,0417,0,2967,43,3010,4360,0,3,1,3,0,1,0,76.14,69.04 ,33.33
01,000,02,012,0418,0,2566,31,2597,3813,0,3,1,3,0,1,0,76.14,68.11 ,33.33
01,000,02,012,0419,0,1730,25,1755,2575,0,3,1,3,0,1,0,76.14,68.16 ,33.33
01,000,02,012,0420,0,1985,17,2002,2962,0,3,1,3,0,1,0,76.14,67.59 ,33.33
01,000,02,012,0421,0,3063,30,3093,4432,0,3,1,3,0,1,0,76.14,69.79 ,33.33
01,000,02,012,0422,0,3388,34,3422,5010,0,3,1,3,0,1,0,76.14,68.30 ,33.33
01,000,02,012,0423,0,2132,69,2201,3433,0,3,1,3,0,1,0,76.14,64.11 ,33.33
01,000,02,012,0424,0,2875,37,2912,4246,0,3,1,3,0,1,0,76.14,68.58 ,33.33
01,000,02,012,0425,0,3654,41,3695,5163,0,3,1,3,0,1,0,76.14,71.57 ,33.33
01,000,02,012,0426,0,3797,59,3856,5819,0,3,1,3,0,1,0,76.14,66.27 ,33.33
01,000,02,012,0427,0,4782,54,4836,6889,0,3,1,3,0,1,0,76.14,70.20 ,33.33
01,000,02,012,0428,0,4179,41,4220,6104,0,3,1,3,0,1,0,76.14,69.13 ,33.33
01,000,02,012,0429,0,4782,87,4869,7066,0,3,1,3,0,1,0,76.14,68.91 ,33.33
01,000,02,012,0430,0,4423,55,4478,6446,0,3,1,3,0,1,0,76.14,69.47 ,33.33
01,000,02,012,0431,0,4714,47,4761,6816,0,3,1,3,0,1,0,76.14,69.85 ,33.33
01,000,02,012,0432,0,1793,40,1833,2839,0,3,1,3,0,1,0,76.14,64.56 ,33.33
01,000,02,012,0433,0,3086,45,3131,4777,0,3,1,3,0,1,0,76.14,65.54 ,33.33
01,000,02,012,0434,0,1211,20,1231,1870,0,3,1,3,0,1,0,76.14,65.83 ,33.33
01,000,02,012,0435,0,378,6,384,578,0,3,1,3,0,1,0,76.14,66.44 ,33.33
02,000,01,001,0001,0,704,13,717,978,0,3,1,3,0,1,0,76.14,73.31 ,33.33
02,000,01,001,0002,0,933,23,956,1302,0,3,1,3,0,1,0,76.14,73.43 ,33.33
02,000,01,001,0003,0,497,12,509,691,0,3,1,3,0,1,0,76.14,73.66 ,33.33
02,000,01,001,0004,0,587,8,595,749,0,3,1,3,0,1,0,76.14,79.44 ,33.33
02,000,01,001,0005,0,982,15,997,1384,0,3,1,3,0,1,0,76.14,72.04 ,33.33
02,000,01,001,0006,0,869,14,883,1239,0,3,1,3,0,1,0,76.14,71.27 ,33.33
02,000,01,001,0007,0,498,16,514,705,0,3,1,3,0,1,0,76.14,72.91 ,33.33
02,000,01,001,0008,0,1162,13,1175,1742,0,3,1,3,0,1,0,76.14,67.45 ,33.33
02,000,01,001,0009,0,571,7,578,760,0,3,1,3,0,1,0,76.14,76.05 ,33.33
02,000,01,001,0010,0,556,9,565,760,0,3,1,3,0,1,0,76.14,74.34 ,33.33
02,000,01,001,0011,0,1583,27,1610,2212,0,3,1,3,0,1,0,76.14,72.78 ,33.33
02,000,01,001,0012,0,895,12,907,1307,0,3,1,3,0,1,0,76.14,69.40 ,33.33
02,000,01,001,0013,0,532,8,540,716,0,3,1,3,0,1,0,76.14,75.42 ,33.33
02,000,01,001,0014,0,880,20,900,1223,0,3,1,3,0,1,0,76.14,73.59 ,33.33
02,000,01,001,0015,0,664,11,675,942,0,3,1,3,0,1,0,76.14,71.66 ,33.33
02,000,01,001,0016,0,613,21,634,853,0,3,1,3,0,1,0,76.14,74.33 ,33.33
02,000,01,001,0017,0,1340,15,1355,1908,0,3,1,3,0,1,0,76.14,71.02 ,33.33
02,000,01,001,0018,0,851,10,861,1209,0,3,1,3,0,1,0,76.14,71.22 ,33.33
02,000,01,001,0019,0,782,11,793,1155,0,3,1,3,0,1,0,76.14,68.66 ,33.33
02,000,01,001,0020,0,632,16,648,911,0,3,1,3,0,1,0,76.14,71.13 ,33.33
02,000,01,001,0021,0,727,13,740,1020,0,3,1,3,0,1,0,76.14,72.55 ,33.33
02,000,01,002,0022,0,1465,31,1496,2083,0,3,1,3,0,1,0,76.14,71.82 ,33.33
02,000,01,002,0023,0,1509,15,1524,2038,0,3,1,3,0,1,0,76.14,74.78 ,33.33
02,000,01,002,0024,0,3123,31,3154,4016,0,3,1,3,0,1,0,76.14,78.54 ,33.33
02,000,01,002,0025,0,2917,30,2947,3907,0,3,1,3,0,1,0,76.14,75.43 ,33.33
02,000,01,002,0026,0,1067,29,1096,1494,0,3,1,3,0,1,0,76.14,73.36 ,33.33
02,000,01,002,0027,0,658,5,663,876,0,3,1,3,0,1,0,76.14,75.68 ,33.33
02,000,01,002,0028,0,899,12,911,1206,0,3,1,3,0,1,0,76.14,75.54 ,33.33
02,000,01,002,0029,0,1582,20,1602,2059,0,3,1,3,0,1,0,76.14,77.80 ,33.33
02,000,01,002,0030,0,1169,13,1182,1555,0,3,1,3,0,1,0,76.14,76.01 ,33.33
02,000,01,002,0031,0,3237,42,3279,4489,0,3,1,3,0,1,0,76.14,73.05 ,33.33
02,000,01,002,0032,0,1087,11,1098,1499,0,3,1,3,0,1,0,76.14,73.25 ,33.33
02,000,01,002,0033,0,2100,27,2127,2820,0,3,1,3,0,1,0,76.14,75.43 ,33.33
02,000,01,002,0034,0,1519,23,1542,2042,0,3,1,3,0,1,0,76.14,75.51 ,33.33
02,000,01,002,0035,0,1497,11,1508,1968,0,3,1,3,0,1,0,76.14,76.63 ,33.33
02,000,01,002,0036,0,2566,43,2609,3670,0,3,1,3,0,1,0,76.14,71.09 ,33.33
02,000,01,002,0037,0,3713,47,3760,5176,0,3,1,3,0,1,0,76.14,72.64 ,33.33
02,000,01,002,0038,0,937,7,944,1349,0,3,1,3,0,1,0,76.14,69.98 ,33.33
02,000,01,002,0039,0,2283,18,2301,3093,0,3,1,3,0,1,0,76.14,74.39 ,33.33
02,000,01,002,0040,0,1633,8,1641,2228,0,3,1,3,0,1,0,76.14,73.65 ,33.33
02,000,01,002,0041,0,1585,21,1606,2192,0,3,1,3,0,1,0,76.14,73.27 ,33.33
02,000,01,002,0042,0,1336,17,1353,1805,0,3,1,3,0,1,0,76.14,74.96 ,33.33
02,000,01,002,0043,0,759,6,765,1006,0,3,1,3,0,1,0,76.14,76.04 ,33.33
02,000,01,002,0044,0,688,10,698,961,0,3,1,3,0,1,0,76.14,72.63 ,33.33
02,000,01,002,0045,0,1258,18,1276,1722,0,3,1,3,0,1,0,76.14,74.10 ,33.33
02,000,01,002,0046,0,1301,15,1316,1901,0,3,1,3,0,1,0,76.14,69.23 ,33.33
02,000,01,002,0047,0,1151,15,1166,1561,0,3,1,3,0,1,0,76.14,74.70 ,33.33
02,000,01,002,0048,0,1175,15,1190,1702,0,3,1,3,0,1,0,76.14,69.92 ,33.33
02,000,01,002,0049,0,1140,14,1154,1609,0,3,1,3,0,1,0,76.14,71.72 ,33.33
02,000,01,002,0050,0,592,12,604,878,0,3,1,3,0,1,0,76.14,68.79 ,33.33
02,000,01,002,0051,0,857,48,905,1265,0,3,1,3,0,1,0,76.14,71.54 ,33.33
02,000,01,002,0052,0,929,14,943,1296,0,3,1,3,0,1,0,76.14,72.76 ,33.33
02,000,01,002,0053,0,773,25,798,1128,0,3,1,3,0,1,0,76.14,70.74 ,33.33
02,000,01,002,0054,0,1160,17,1177,1672,0,3,1,3,0,1,0,76.14,70.39 ,33.33
02,000,01,002,0055,0,886,11,897,1295,0,3,1,3,0,1,0,76.14,69.27 ,33.33
02,000,01,002,0056,0,981,17,998,1493,0,3,1,3,0,1,0,76.14,66.85 ,33.33
02,000,01,002,0057,0,1232,18,1250,1772,0,3,1,3,0,1,0,76.14,70.54 ,33.33
02,000,01,002,0058,0,779,5,784,1133,0,3,1,3,0,1,0,76.14,69.20 ,33.33
02,000,01,002,0059,0,398,4,402,525,0,3,1,3,0,1,0,76.14,76.57 ,33.33
02,000,01,003,0060,0,972,28,1000,1328,0,3,1,3,0,1,0,76.14,75.30 ,33.33
02,000,01,003,0061,0,845,13,858,1231,0,3,1,3,0,1,0,76.14,69.70 ,33.33
02,000,01,003,0062,0,1269,30,1299,1745,0,3,1,3,0,1,0,76.14,74.44 ,33.33
02,000,01,003,0063,0,1505,25,1530,2145,0,3,1,3,0,1,0,76.14,71.33 ,33.33
02,000,01,003,0064,0,1900,33,1933,2624,0,3,1,3,0,1,0,76.14,73.67 ,33.33
02,000,01,003,0065,0,806,13,819,1060,0,3,1,3,0,1,0,76.14,77.26 ,33.33
02,000,01,003,0066,0,1171,14,1185,1687,0,3,1,3,0,1,0,76.14,70.24 ,33.33
02,000,01,003,0067,0,1656,40,1696,2355,0,3,1,3,0,1,0,76.14,72.02 ,33.33
02,000,01,003,0068,0,1145,37,1182,1621,0,3,1,3,0,1,0,76.14,72.92 ,33.33
02,000,01,003,0069,0,1571,32,1603,2306,0,3,1,3,0,1,0,76.14,69.51 ,33.33
02,000,01,003,0070,0,1147,16,1163,1565,0,3,1,3,0,1,0,76.14,74.31 ,33.33
02,000,01,003,0071,0,725,15,740,1088,0,3,1,3,0,1,0,76.14,68.01 ,33.33
02,000,01,003,0072,0,1418,30,1448,1869,0,3,1,3,0,1,0,76.14,77.47 ,33.33
02,000,01,004,0073,0,1317,21,1338,1823,0,3,1,3,0,1,0,76.14,73.40 ,33.33
02,000,01,004,0074,0,1024,17,1041,1389,0,3,1,3,0,1,0,76.14,74.95 ,33.33
02,000,01,004,0075,0,569,9,578,790,0,3,1,3,0,1,0,76.14,73.16 ,33.33
02,000,01,004,0076,0,586,6,592,735,0,3,1,3,0,1,0,76.14,80.54 ,33.33
02,000,01,004,0077,0,501,4,505,666,0,3,1,3,0,1,0,76.14,75.83 ,33.33
02,000,01,004,0078,0,745,9,754,1010,0,3,1,3,0,1,0,76.14,74.65 ,33.33
02,000,01,004,0079,0,776,16,792,1109,0,3,1,3,0,1,0,76.14,71.42 ,33.33
02,000,01,004,0080,0,717,6,723,963,0,3,1,3,0,1,0,76.14,75.08 ,33.33
02,000,01,004,0081,0,1864,29,1893,2602,0,3,1,3,0,1,0,76.14,72.75 ,33.33
02,000,01,004,0082,0,1322,21,1343,1752,0,3,1,3,0,1,0,76.14,76.66 ,33.33
02,000,01,004,0083,0,1486,22,1508,1993,0,3,1,3,0,1,0,76.14,75.66 ,33.33
02,000,01,004,0084,0,685,15,700,851,0,3,1,3,0,1,0,76.14,82.26 ,33.33
02,000,01,004,0085,0,1392,24,1416,1769,0,3,1,3,0,1,0,76.14,80.05 ,33.33
02,000,01,004,0086,0,1036,22,1058,1369,0,3,1,3,0,1,0,76.14,77.28 ,33.33
02,000,01,004,0087,0,1277,11,1288,1772,0,3,1,3,0,1,0,76.14,72.69 ,33.33
02,000,01,004,0088,0,1890,26,1916,2548,0,3,1,3,0,1,0,76.14,75.20 ,33.33
02,000,01,004,0089,0,1114,8,1122,1438,0,3,1,3,0,1,0,76.14,78.03 ,33.33
02,000,01,004,0090,0,1556,17,1573,1964,0,3,1,3,0,1,0,76.14,80.09 ,33.33
02,000,01,004,0091,0,1234,16,1250,1588,0,3,1,3,0,1,0,76.14,78.72 ,33.33
02,000,01,004,0092,0,782,16,798,1003,0,3,1,3,0,1,0,76.14,79.56 ,33.33
02,000,01,004,0093,0,985,6,991,1291,0,3,1,3,0,1,0,76.14,76.76 ,33.33
02,000,01,004,0094,0,756,13,769,1042,0,3,1,3,0,1,0,76.14,73.80 ,33.33
02,000,01,004,0095,0,361,2,363,487,0,3,1,3,0,1,0,76.14,74.54 ,33.33
02,000,01,004,0096,0,463,12,475,598,0,3,1,3,0,1,0,76.14,79.43 ,33.33
02,000,01,004,0097,0,473,5,478,609,0,3,1,3,0,1,0,76.14,78.49 ,33.33
02,000,01,004,0098,0,620,5,625,814,0,3,1,3,0,1,0,76.14,76.78 ,33.33
02,000,01,004,0099,0,453,6,459,584,0,3,1,3,0,1,0,76.14,78.60 ,33.33
02,000,01,004,0100,0,642,10,652,822,0,3,1,3,0,1,0,76.14,79.32 ,33.33
02,000,01,004,0101,0,952,9,961,1255,0,3,1,3,0,1,0,76.14,76.57 ,33.33
02,000,01,004,0102,0,1142,16,1158,1567,0,3,1,3,0,1,0,76.14,73.90 ,33.33
02,000,01,004,0103,0,1077,15,1092,1436,0,3,1,3,0,1,0,76.14,76.04 ,33.33
02,000,01,004,0104,0,1146,9,1155,1470,0,3,1,3,0,1,0,76.14,78.57 ,33.33
02,000,01,004,0105,0,1525,16,1541,1887,0,3,1,3,0,1,0,76.14,81.66 ,33.33
02,000,01,004,0106,0,982,7,989,1224,0,3,1,3,0,1,0,76.14,80.80 ,33.33
02,000,01,004,0107,0,1989,32,2021,2617,0,3,1,3,0,1,0,76.14,77.23 ,33.33
02,000,01,004,0108,0,1641,18,1659,2192,0,3,1,3,0,1,0,76.14,75.68 ,33.33
02,000,01,004,0109,0,1176,18,1194,1662,0,3,1,3,0,1,0,76.14,71.84 ,33.33
02,000,01,004,0110,0,1531,12,1543,1960,0,3,1,3,0,1,0,76.14,78.72 ,33.33
02,000,01,004,0111,0,3813,51,3864,5268,0,3,1,3,0,1,0,76.14,73.35 ,33.33
02,000,01,004,0112,0,6620,76,6696,10035,0,3,1,3,0,1,0,76.14,66.73 ,33.33
02,000,01,004,0113,0,2761,29,2790,3729,0,3,1,3,0,1,0,76.14,74.82 ,33.33
02,000,01,004,0114,0,2661,31,2692,3618,0,3,1,3,0,1,0,76.14,74.41 ,33.33
02,000,01,004,0115,0,3090,51,3141,4597,0,3,1,3,0,1,0,76.14,68.33 ,33.33
02,000,01,004,0116,0,2665,35,2700,4030,0,3,1,3,0,1,0,76.14,67.00 ,33.33
02,000,01,005,0117,0,3975,52,4027,5649,0,3,1,3,0,1,0,76.14,71.29 ,33.33
02,000,01,005,0118,0,1317,14,1331,1930,0,3,1,3,0,1,0,76.14,68.96 ,33.33
02,000,01,005,0119,0,2143,26,2169,3226,0,3,1,3,0,1,0,76.14,67.23 ,33.33
02,000,01,005,0120,0,1533,12,1545,1996,0,3,1,3,0,1,0,76.14,77.40 ,33.33
02,000,01,005,0121,0,1748,61,1809,2558,0,3,1,3,0,1,0,76.14,70.72 ,33.33
02,000,01,005,0122,0,1342,17,1359,1844,0,3,1,3,0,1,0,76.14,73.70 ,33.33
02,000,01,005,0123,0,2132,28,2160,2796,0,3,1,3,0,1,0,76.14,77.25 ,33.33
02,000,01,005,0124,0,1141,17,1158,1643,0,3,1,3,0,1,0,76.14,70.48 ,33.33
02,000,01,005,0125,0,2245,21,2266,3016,0,3,1,3,0,1,0,76.14,75.13 ,33.33
02,000,01,005,0126,0,1526,56,1582,2006,0,3,1,3,0,1,0,76.14,78.86 ,33.33
02,000,01,005,0127,0,1991,31,2022,2611,0,3,1,3,0,1,0,76.14,77.44 ,33.33
02,000,01,005,0128,0,4241,58,4299,6017,0,3,1,3,0,1,0,76.14,71.45 ,33.33
02,000,01,005,0129,0,2002,25,2027,2727,0,3,1,3,0,1,0,76.14,74.33 ,33.33
02,000,01,005,0130,0,1050,13,1063,1455,0,3,1,3,0,1,0,76.14,73.06 ,33.33
02,000,01,005,0131,0,1386,16,1402,1761,0,3,1,3,0,1,0,76.14,79.61 ,33.33
02,000,01,005,0132,0,2401,24,2425,3015,0,3,1,3,0,1,0,76.14,80.43 ,33.33
02,000,01,005,0133,0,1244,9,1253,1556,0,3,1,3,0,1,0,76.14,80.53 ,33.33
02,000,01,005,0134,0,2231,48,2279,2874,0,3,1,3,0,1,0,76.14,79.30 ,33.33
02,000,01,005,0135,0,1330,20,1350,1929,0,3,1,3,0,1,0,76.14,69.98 ,33.33
02,000,01,005,0136,0,1575,17,1592,2125,0,3,1,3,0,1,0,76.14,74.92 ,33.33
02,000,01,005,0137,0,1325,13,1338,1674,0,3,1,3,0,1,0,76.14,79.93 ,33.33
02,000,01,005,0138,0,1895,22,1917,2562,0,3,1,3,0,1,0,76.14,74.82 ,33.33
02,000,01,005,0139,0,1164,16,1180,1481,0,3,1,3,0,1,0,76.14,79.68 ,33.33
02,000,01,005,0140,0,1684,17,1701,2150,0,3,1,3,0,1,0,76.14,79.12 ,33.33
02,000,01,005,0141,0,1671,14,1685,2279,0,3,1,3,0,1,0,76.14,73.94 ,33.33
02,000,01,005,0142,0,1255,12,1267,1647,0,3,1,3,0,1,0,76.14,76.93 ,33.33
02,000,01,005,0143,0,1601,14,1615,2102,0,3,1,3,0,1,0,76.14,76.83 ,33.33
02,000,01,005,0144,0,2054,38,2092,2759,0,3,1,3,0,1,0,76.14,75.82 ,33.33
02,000,01,005,0145,0,2384,23,2407,3066,0,3,1,3,0,1,0,76.14,78.51 ,33.33
02,000,01,005,0146,0,1278,20,1298,1705,0,3,1,3,0,1,0,76.14,76.13 ,33.33
02,000,01,005,0147,0,1197,20,1217,1638,0,3,1,3,0,1,0,76.14,74.30 ,33.33
02,000,01,005,0148,0,1624,16,1640,2220,0,3,1,3,0,1,0,76.14,73.87 ,33.33
02,000,01,005,0149,0,2894,57,2951,3963,0,3,1,3,0,1,0,76.14,74.46 ,33.33
02,000,01,005,0150,0,1920,32,1952,2537,0,3,1,3,0,1,0,76.14,76.94 ,33.33
02,000,01,005,0151,0,667,5,672,802,0,3,1,3,0,1,0,76.14,83.79 ,33.33
02,000,01,005,0152,0,970,12,982,1297,0,3,1,3,0,1,0,76.14,75.71 ,33.33
02,000,01,005,0153,0,618,6,624,791,0,3,1,3,0,1,0,76.14,78.89 ,33.33
02,000,01,006,0154,0,1659,25,1684,2445,0,3,1,3,0,1,0,76.14,68.88 ,33.33
02,000,01,006,0155,0,2503,23,2526,3625,0,3,1,3,0,1,0,76.14,69.68 ,33.33
02,000,01,006,0156,0,2005,32,2037,2841,0,3,1,3,0,1,0,76.14,71.70 ,33.33
02,000,01,006,0157,0,1937,42,1979,2823,0,3,1,3,0,1,0,76.14,70.10 ,33.33
02,000,01,006,0158,0,2271,46,2317,3269,0,3,1,3,0,1,0,76.14,70.88 ,33.33
02,000,01,006,0159,0,1928,36,1964,2597,0,3,1,3,0,1,0,76.14,75.63 ,33.33
02,000,01,006,0160,0,4062,62,4124,5866,0,3,1,3,0,1,0,76.14,70.30 ,33.33
02,000,01,006,0161,0,4058,41,4099,5676,0,3,1,3,0,1,0,76.14,72.22 ,33.33
02,000,01,006,0162,0,2690,41,2731,3654,0,3,1,3,0,1,0,76.14,74.74 ,33.33
02,000,01,006,0163,0,1260,12,1272,1743,0,3,1,3,0,1,0,76.14,72.98 ,33.33
02,000,01,006,0164,0,993,14,1007,1412,0,3,1,3,0,1,0,76.14,71.32 ,33.33
02,000,01,006,0165,0,2693,56,2749,3791,0,3,1,3,0,1,0,76.14,72.51 ,33.33
02,000,01,006,0166,0,2134,23,2157,2943,0,3,1,3,0,1,0,76.14,73.29 ,33.33
02,000,01,006,0167,0,2265,17,2282,3295,0,3,1,3,0,1,0,76.14,69.26 ,33.33
02,000,01,006,0168,0,3099,38,3137,4573,0,3,1,3,0,1,0,76.14,68.60 ,33.33
02,000,01,006,0169,0,1996,16,2012,2992,0,3,1,3,0,1,0,76.14,67.25 ,33.33
02,000,01,006,0170,0,2319,26,2345,3483,0,3,1,3,0,1,0,76.14,67.33 ,33.33
02,000,01,006,0171,0,1371,12,1383,2062,0,3,1,3,0,1,0,76.14,67.07 ,33.33
02,000,01,006,0172,0,2709,24,2733,4014,0,3,1,3,0,1,0,76.14,68.09 ,33.33
02,000,01,006,0173,0,1762,29,1791,2487,0,3,1,3,0,1,0,76.14,72.01 ,33.33
02,000,01,006,0174,0,1520,14,1534,2227,0,3,1,3,0,1,0,76.14,68.88 ,33.33
02,000,01,006,0175,0,2796,33,2829,4196,0,3,1,3,0,1,0,76.14,67.42 ,33.33
02,000,01,006,0176,0,1393,19,1412,1998,0,3,1,3,0,1,0,76.14,70.67 ,33.33
02,000,01,006,0177,0,1554,18,1572,2228,0,3,1,3,0,1,0,76.14,70.56 ,33.33
02,000,01,006,0178,0,2168,20,2188,3176,0,3,1,3,0,1,0,76.14,68.89 ,33.33
02,000,01,006,0179,0,1980,19,1999,2812,0,3,1,3,0,1,0,76.14,71.09 ,33.33
02,000,01,006,0180,0,2696,40,2736,3975,0,3,1,3,0,1,0,76.14,68.83 ,33.33
02,000,01,006,0181,0,2216,42,2258,3199,0,3,1,3,0,1,0,76.14,70.58 ,33.33
02,000,01,006,0182,0,2570,45,2615,3757,0,3,1,3,0,1,0,76.14,69.60 ,33.33
02,000,01,006,0183,0,2907,48,2955,4402,0,3,1,3,0,1,0,76.14,67.13 ,33.33
02,000,01,006,0184,0,1624,13,1637,2438,0,3,1,3,0,1,0,76.14,67.15 ,33.33
02,000,01,006,0185,0,1699,36,1735,2503,0,3,1,3,0,1,0,76.14,69.32 ,33.33
02,000,01,006,0186,0,2269,37,2306,3454,0,3,1,3,0,1,0,76.14,66.76 ,33.33
02,000,01,006,0187,0,1411,20,1431,1898,0,3,1,3,0,1,0,76.14,75.40 ,33.33
02,000,01,006,0188,0,1418,14,1432,1942,0,3,1,3,0,1,0,76.14,73.74 ,33.33
02,000,01,006,0189,0,2275,26,2301,3172,0,3,1,3,0,1,0,76.14,72.54 ,33.33
02,000,01,006,0190,0,1612,23,1635,2444,0,3,1,3,0,1,0,76.14,66.90 ,33.33
02,000,01,006,0191,0,3447,42,3489,5088,0,3,1,3,0,1,0,76.14,68.57 ,33.33
02,000,01,006,0192,0,2036,17,2053,2946,0,3,1,3,0,1,0,76.14,69.69 ,33.33
02,000,01,006,0193,0,995,15,1010,1441,0,3,1,3,0,1,0,76.14,70.09 ,33.33
02,000,01,006,0194,0,967,10,977,1366,0,3,1,3,0,1,0,76.14,71.52 ,33.33
02,000,01,006,0195,0,1953,83,2036,3148,0,3,1,3,0,1,0,76.14,64.68 ,33.33
02,000,01,006,0196,0,1448,33,1481,2264,0,3,1,3,0,1,0,76.14,65.42 ,33.33
02,000,01,006,0197,0,1938,29,1967,2952,0,3,1,3,0,1,0,76.14,66.63 ,33.33
02,000,01,006,0198,0,2335,31,2366,3571,0,3,1,3,0,1,0,76.14,66.26 ,33.33
02,000,01,006,0199,0,2346,28,2374,3292,0,3,1,3,0,1,0,76.14,72.11 ,33.33
02,000,01,006,0200,0,1911,23,1934,2676,0,3,1,3,0,1,0,76.14,72.27 ,33.33
02,000,01,006,0201,0,1150,7,1157,1572,0,3,1,3,0,1,0,76.14,73.60 ,33.33
02,000,01,006,0202,0,1305,19,1324,1809,0,3,1,3,0,1,0,76.14,73.19 ,33.33
02,000,01,006,0203,0,1064,11,1075,1541,0,3,1,3,0,1,0,76.14,69.76 ,33.33
02,000,01,006,0204,0,857,11,868,1143,0,3,1,3,0,1,0,76.14,75.94 ,33.33
02,000,01,006,0205,0,2114,14,2128,2956,0,3,1,3,0,1,0,76.14,71.99 ,33.33
02,000,01,006,0206,0,1644,9,1653,2362,0,3,1,3,0,1,0,76.14,69.98 ,33.33
02,000,01,006,0207,0,1192,108,1300,1902,0,3,1,3,0,1,0,76.14,68.35 ,33.33
02,000,01,006,0208,0,1252,20,1272,1856,0,3,1,3,0,1,0,76.14,68.53 ,33.33
02,000,01,006,0209,0,681,13,694,952,0,3,1,3,0,1,0,76.14,72.90 ,33.33
02,000,01,006,0210,0,888,7,895,1197,0,3,1,3,0,1,0,76.14,74.77 ,33.33
02,000,01,006,0211,0,1323,17,1340,1874,0,3,1,3,0,1,0,76.14,71.50 ,33.33
02,000,01,006,0212,0,1529,14,1543,2119,0,3,1,3,0,1,0,76.14,72.82 ,33.33
02,000,01,006,0213,0,2238,24,2262,3185,0,3,1,3,0,1,0,76.14,71.02 ,33.33
02,000,01,006,0214,0,2688,62,2750,3800,0,3,1,3,0,1,0,76.14,72.37 ,33.33
02,000,01,006,0215,0,2480,33,2513,3412,0,3,1,3,0,1,0,76.14,73.65 ,33.33
02,000,01,006,0216,0,1026,11,1037,1421,0,3,1,3,0,1,0,76.14,72.98 ,33.33
02,000,01,006,0217,0,1245,14,1259,1699,0,3,1,3,0,1,0,76.14,74.10 ,33.33
02,000,01,006,0218,0,1399,22,1421,1938,0,3,1,3,0,1,0,76.14,73.32 ,33.33
02,000,01,006,0219,0,859,10,869,1165,0,3,1,3,0,1,0,76.14,74.59 ,33.33
02,000,01,006,0220,0,821,10,831,1143,0,3,1,3,0,1,0,76.14,72.70 ,33.33
02,000,01,006,0221,0,942,14,956,1428,0,3,1,3,0,1,0,76.14,66.95 ,33.33
02,000,01,006,0222,0,1042,10,1052,1556,0,3,1,3,0,1,0,76.14,67.61 ,33.33
02,000,01,006,0223,0,602,10,612,924,0,3,1,3,0,1,0,76.14,66.23 ,33.33
02,000,01,006,0224,0,477,5,482,597,0,3,1,3,0,1,0,76.14,80.74 ,33.33
02,000,01,006,0225,0,773,12,785,1188,0,3,1,3,0,1,0,76.14,66.08 ,33.33
02,000,01,006,0226,0,2664,31,2695,3987,0,3,1,3,0,1,0,76.14,67.59 ,33.33
02,000,01,006,0227,0,926,13,939,1321,0,3,1,3,0,1,0,76.14,71.08 ,33.33
02,000,01,006,0228,0,673,11,684,1037,0,3,1,3,0,1,0,76.14,65.96 ,33.33
02,000,01,006,0229,0,871,8,879,1285,0,3,1,3,0,1,0,76.14,68.40 ,33.33
02,000,01,006,0230,0,815,5,820,1148,0,3,1,3,0,1,0,76.14,71.43 ,33.33
02,000,01,006,0231,0,1535,29,1564,2154,0,3,1,3,0,1,0,76.14,72.61 ,33.33
02,000,01,006,0232,0,851,8,859,1212,0,3,1,3,0,1,0,76.14,70.87 ,33.33
02,000,01,006,0233,0,317,6,323,440,0,3,1,3,0,1,0,76.14,73.41 ,33.33
02,000,01,006,0234,0,1995,22,2017,2761,0,3,1,3,0,1,0,76.14,73.05 ,33.33
02,000,01,006,0235,0,1272,22,1294,1819,0,3,1,3,0,1,0,76.14,71.14 ,33.33
02,000,01,006,0236,0,601,14,615,801,0,3,1,3,0,1,0,76.14,76.78 ,33.33
02,000,01,006,0237,0,991,4,995,1312,0,3,1,3,0,1,0,76.14,75.84 ,33.33
02,000,01,006,0238,0,863,16,879,1241,0,3,1,3,0,1,0,76.14,70.83 ,33.33
02,000,01,006,0239,0,943,13,956,1365,0,3,1,3,0,1,0,76.14,70.04 ,33.33
02,000,01,006,0240,0,920,13,933,1281,0,3,1,3,0,1,0,76.14,72.83 ,33.33
02,000,01,006,0241,0,1722,59,1781,2521,0,3,1,3,0,1,0,76.14,70.65 ,33.33
02,000,02,007,0242,0,1438,11,1449,1900,0,3,1,3,0,1,0,76.14,76.26 ,33.33
02,000,02,007,0243,0,1570,15,1585,2247,0,3,1,3,0,1,0,76.14,70.54 ,33.33
02,000,02,007,0244,0,471,6,477,706,0,3,1,3,0,1,0,76.14,67.56 ,33.33
02,000,02,007,0245,0,822,15,837,1224,0,3,1,3,0,1,0,76.14,68.38 ,33.33
02,000,02,007,0246,0,739,7,746,1038,0,3,1,3,0,1,0,76.14,71.87 ,33.33
02,000,02,007,0247,0,748,11,759,1009,0,3,1,3,0,1,0,76.14,75.22 ,33.33
02,000,02,007,0248,0,700,9,709,978,0,3,1,3,0,1,0,76.14,72.49 ,33.33
02,000,02,007,0249,0,920,9,929,1295,0,3,1,3,0,1,0,76.14,71.74 ,33.33
02,000,02,007,0250,0,1026,13,1039,1405,0,3,1,3,0,1,0,76.14,73.95 ,33.33
02,000,02,007,0251,0,849,11,860,1222,0,3,1,3,0,1,0,76.14,70.38 ,33.33
02,000,02,007,0252,0,671,22,693,916,0,3,1,3,0,1,0,76.14,75.66 ,33.33
02,000,02,007,0253,0,650,13,663,934,0,3,1,3,0,1,0,76.14,70.99 ,33.33
02,000,02,007,0254,0,587,3,590,881,0,3,1,3,0,1,0,76.14,66.97 ,33.33
02,000,02,007,0255,0,627,10,637,915,0,3,1,3,0,1,0,76.14,69.62 ,33.33
02,000,02,007,0256,0,1575,15,1590,2430,0,3,1,3,0,1,0,76.14,65.43 ,33.33
02,000,02,007,0257,0,1648,24,1672,2242,0,3,1,3,0,1,0,76.14,74.58 ,33.33
02,000,02,007,0258,0,1235,15,1250,1800,0,3,1,3,0,1,0,76.14,69.44 ,33.33
02,000,02,007,0259,0,406,6,412,573,0,3,1,3,0,1,0,76.14,71.90 ,33.33
02,000,02,007,0260,0,1375,9,1384,2018,0,3,1,3,0,1,0,76.14,68.58 ,33.33
02,000,02,007,0261,0,1046,20,1066,1468,0,3,1,3,0,1,0,76.14,72.62 ,33.33
02,000,02,007,0262,0,1578,18,1596,2231,0,3,1,3,0,1,0,76.14,71.54 ,33.33
02,000,02,007,0263,0,645,10,655,944,0,3,1,3,0,1,0,76.14,69.39 ,33.33
02,000,02,007,0264,0,570,7,577,819,0,3,1,3,0,1,0,76.14,70.45 ,33.33
02,000,02,007,0265,0,1642,17,1659,2206,0,3,1,3,0,1,0,76.14,75.20 ,33.33
02,000,02,007,0266,0,851,7,858,1170,0,3,1,3,0,1,0,76.14,73.33 ,33.33
02,000,02,007,0267,0,532,15,547,763,0,3,1,3,0,1,0,76.14,71.69 ,33.33
02,000,02,007,0268,0,890,16,906,1202,0,3,1,3,0,1,0,76.14,75.37 ,33.33
02,000,02,007,0269,0,1173,15,1188,1614,0,3,1,3,0,1,0,76.14,73.61 ,33.33
02,000,02,007,0270,0,837,8,845,1265,0,3,1,3,0,1,0,76.14,66.80 ,33.33
02,000,02,007,0271,0,599,8,607,833,0,3,1,3,0,1,0,76.14,72.87 ,33.33
02,000,02,007,0272,0,1471,16,1487,2073,0,3,1,3,0,1,0,76.14,71.73 ,33.33
02,000,02,007,0273,0,1822,21,1843,2595,0,3,1,3,0,1,0,76.14,71.02 ,33.33
02,000,02,008,0274,0,630,14,644,921,0,3,1,3,0,1,0,76.14,69.92 ,33.33
02,000,02,008,0275,0,830,13,843,1190,0,3,1,3,0,1,0,76.14,70.84 ,33.33
02,000,02,008,0276,0,1092,13,1105,1600,0,3,1,3,0,1,0,76.14,69.06 ,33.33
02,000,02,008,0277,0,710,10,720,1064,0,3,1,3,0,1,0,76.14,67.67 ,33.33
02,000,02,008,0278,0,922,5,927,1322,0,3,1,3,0,1,0,76.14,70.12 ,33.33
02,000,02,008,0279,0,632,11,643,991,0,3,1,3,0,1,0,76.14,64.88 ,33.33
02,000,02,008,0280,0,558,9,567,814,0,3,1,3,0,1,0,76.14,69.66 ,33.33
02,000,02,008,0281,0,1859,26,1885,2740,0,3,1,3,0,1,0,76.14,68.80 ,33.33
02,000,02,008,0282,0,826,13,839,1122,0,3,1,3,0,1,0,76.14,74.78 ,33.33
02,000,02,008,0283,0,1036,12,1048,1436,0,3,1,3,0,1,0,76.14,72.98 ,33.33
02,000,02,008,0284,0,512,2,514,766,0,3,1,3,0,1,0,76.14,67.10 ,33.33
02,000,02,008,0285,0,714,7,721,995,0,3,1,3,0,1,0,76.14,72.46 ,33.33
02,000,02,008,0286,0,729,22,751,1063,0,3,1,3,0,1,0,76.14,70.65 ,33.33
02,000,02,008,0287,0,1295,13,1308,1805,0,3,1,3,0,1,0,76.14,72.47 ,33.33
02,000,02,008,0288,0,882,9,891,1220,0,3,1,3,0,1,0,76.14,73.03 ,33.33
02,000,02,008,0289,0,1207,14,1221,1724,0,3,1,3,0,1,0,76.14,70.82 ,33.33
02,000,02,008,0290,0,989,22,1011,1350,0,3,1,3,0,1,0,76.14,74.89 ,33.33
02,000,02,008,0291,0,639,6,645,1045,0,3,1,3,0,1,0,76.14,61.72 ,33.33
02,000,02,008,0292,0,874,22,896,1271,0,3,1,3,0,1,0,76.14,70.50 ,33.33
02,000,02,008,0293,0,954,12,966,1370,0,3,1,3,0,1,0,76.14,70.51 ,33.33
02,000,02,009,0294,0,454,3,457,650,0,3,1,3,0,1,0,76.14,70.31 ,33.33
02,000,02,009,0295,0,920,20,940,1351,0,3,1,3,0,1,0,76.14,69.58 ,33.33
02,000,02,009,0296,0,956,13,969,1419,0,3,1,3,0,1,0,76.14,68.29 ,33.33
02,000,02,009,0297,0,1078,17,1095,1529,0,3,1,3,0,1,0,76.14,71.62 ,33.33
02,000,02,009,0298,0,863,14,877,1291,0,3,1,3,0,1,0,76.14,67.93 ,33.33
02,000,02,009,0299,0,928,58,986,1468,0,3,1,3,0,1,0,76.14,67.17 ,33.33
02,000,02,009,0300,0,1034,20,1054,1518,0,3,1,3,0,1,0,76.14,69.43 ,33.33
02,000,02,009,0301,0,565,9,574,798,0,3,1,3,0,1,0,76.14,71.93 ,33.33
02,000,02,009,0302,0,1137,11,1148,1658,0,3,1,3,0,1,0,76.14,69.24 ,33.33
02,000,02,009,0303,0,987,15,1002,1591,0,3,1,3,0,1,0,76.14,62.98 ,33.33
02,000,02,009,0304,0,987,20,1007,1352,0,3,1,3,0,1,0,76.14,74.48 ,33.33
02,000,02,009,0305,0,1119,49,1168,1537,0,3,1,3,0,1,0,76.14,75.99 ,33.33
02,000,02,009,0306,0,1202,14,1216,1737,0,3,1,3,0,1,0,76.14,70.01 ,33.33
02,000,02,009,0307,0,1118,30,1148,1709,0,3,1,3,0,1,0,76.14,67.17 ,33.33
02,000,02,009,0308,0,1440,17,1457,2031,0,3,1,3,0,1,0,76.14,71.74 ,33.33
02,000,02,009,0309,0,871,16,887,1299,0,3,1,3,0,1,0,76.14,68.28 ,33.33
02,000,02,009,0310,0,1859,27,1886,2938,0,3,1,3,0,1,0,76.14,64.19 ,33.33
02,000,02,009,0311,0,1658,34,1692,2398,0,3,1,3,0,1,0,76.14,70.56 ,33.33
02,000,02,009,0312,0,1675,17,1692,2372,0,3,1,3,0,1,0,76.14,71.33 ,33.33
02,000,02,009,0313,0,1522,28,1550,2215,0,3,1,3,0,1,0,76.14,69.98 ,33.33
02,000,02,009,0314,0,692,11,703,997,0,3,1,3,0,1,0,76.14,70.51 ,33.33
02,000,02,009,0315,0,1752,16,1768,2619,0,3,1,3,0,1,0,76.14,67.51 ,33.33
02,000,02,009,0316,0,1046,30,1076,1493,0,3,1,3,0,1,0,76.14,72.07 ,33.33
02,000,02,009,0317,0,1336,15,1351,1877,0,3,1,3,0,1,0,76.14,71.98 ,33.33
02,000,02,009,0318,0,1081,8,1089,1496,0,3,1,3,0,1,0,76.14,72.79 ,33.33
02,000,02,009,0319,0,606,5,611,852,0,3,1,3,0,1,0,76.14,71.71 ,33.33
02,000,02,009,0320,0,997,6,1003,1402,0,3,1,3,0,1,0,76.14,71.54 ,33.33
02,000,02,009,0321,0,2168,28,2196,3161,0,3,1,3,0,1,0,76.14,69.47 ,33.33
02,000,02,009,0322,0,1433,28,1461,2055,0,3,1,3,0,1,0,76.14,71.09 ,33.33
02,000,02,009,0323,0,2449,45,2494,3405,0,3,1,3,0,1,0,76.14,73.25 ,33.33
02,000,02,009,0324,0,1154,7,1161,1646,0,3,1,3,0,1,0,76.14,70.53 ,33.33
02,000,02,009,0325,0,1859,22,1881,2763,0,3,1,3,0,1,0,76.14,68.08 ,33.33
02,000,02,009,0326,0,1568,14,1582,2347,0,3,1,3,0,1,0,76.14,67.41 ,33.33
02,000,02,009,0327,0,998,28,1026,1477,0,3,1,3,0,1,0,76.14,69.47 ,33.33
02,000,02,009,0328,0,1117,13,1130,1623,0,3,1,3,0,1,0,76.14,69.62 ,33.33
02,000,02,009,0329,0,1439,26,1465,1942,0,3,1,3,0,1,0,76.14,75.44 ,33.33
02,000,02,009,0330,0,1539,27,1566,2341,0,3,1,3,0,1,0,76.14,66.89 ,33.33
02,000,02,009,0331,0,1269,24,1293,1803,0,3,1,3,0,1,0,76.14,71.71 ,33.33
02,000,02,009,0332,0,1138,43,1181,1582,0,3,1,3,0,1,0,76.14,74.65 ,33.33
02,000,02,009,0333,0,1660,20,1680,2393,0,3,1,3,0,1,0,76.14,70.20 ,33.33
02,000,02,009,0334,0,1208,21,1229,1783,0,3,1,3,0,1,0,76.14,68.93 ,33.33
02,000,02,009,0335,0,2332,28,2360,3462,0,3,1,3,0,1,0,76.14,68.17 ,33.33
02,000,02,009,0336,0,1332,53,1385,1938,0,3,1,3,0,1,0,76.14,71.47 ,33.33
02,000,02,009,0337,0,1000,10,1010,1439,0,3,1,3,0,1,0,76.14,70.19 ,33.33
02,000,02,009,0338,0,2636,31,2667,3831,0,3,1,3,0,1,0,76.14,69.62 ,33.33
02,000,02,009,0339,0,1413,29,1442,2116,0,3,1,3,0,1,0,76.14,68.15 ,33.33
02,000,02,009,0340,0,886,16,902,1229,0,3,1,3,0,1,0,76.14,73.39 ,33.33
02,000,02,009,0341,0,1118,12,1130,1574,0,3,1,3,0,1,0,76.14,71.79 ,33.33
02,000,02,009,0342,0,1925,79,2004,2852,0,3,1,3,0,1,0,76.14,70.27 ,33.33
02,000,02,009,0343,0,1034,9,1043,1422,0,3,1,3,0,1,0,76.14,73.35 ,33.33
02,000,02,009,0344,0,741,21,762,1077,0,3,1,3,0,1,0,76.14,70.75 ,33.33
02,000,02,009,0345,0,1334,19,1353,1948,0,3,1,3,0,1,0,76.14,69.46 ,33.33
02,000,02,009,0346,0,1621,26,1647,2248,0,3,1,3,0,1,0,76.14,73.27 ,33.33
02,000,02,009,0347,0,1908,27,1935,2850,0,3,1,3,0,1,0,76.14,67.89 ,33.33
02,000,02,009,0348,0,2092,45,2137,2963,0,3,1,3,0,1,0,76.14,72.12 ,33.33
02,000,02,009,0349,0,1387,27,1414,2162,0,3,1,3,0,1,0,76.14,65.40 ,33.33
02,000,02,009,0350,0,1658,22,1680,2419,0,3,1,3,0,1,0,76.14,69.45 ,33.33
02,000,02,009,0351,0,1449,39,1488,2146,0,3,1,3,0,1,0,76.14,69.34 ,33.33
02,000,02,009,0352,0,1082,12,1094,1503,0,3,1,3,0,1,0,76.14,72.79 ,33.33
02,000,02,009,0353,0,1397,13,1410,2149,0,3,1,3,0,1,0,76.14,65.61 ,33.33
02,000,02,009,0354,0,2431,34,2465,3640,0,3,1,3,0,1,0,76.14,67.72 ,33.33
02,000,02,009,0355,0,2520,41,2561,3746,0,3,1,3,0,1,0,76.14,68.37 ,33.33
02,000,02,009,0356,0,2246,51,2297,3243,0,3,1,3,0,1,0,76.14,70.83 ,33.33
02,000,02,009,0357,0,2380,35,2415,3436,0,3,1,3,0,1,0,76.14,70.29 ,33.33
02,000,02,009,0358,0,1392,22,1414,1942,0,3,1,3,0,1,0,76.14,72.81 ,33.33
02,000,02,009,0359,0,1622,26,1648,2186,0,3,1,3,0,1,0,76.14,75.39 ,33.33
02,000,02,009,0360,0,2504,30,2534,3463,0,3,1,3,0,1,0,76.14,73.17 ,33.33
02,000,02,009,0361,0,1298,10,1308,1791,0,3,1,3,0,1,0,76.14,73.03 ,33.33
02,000,02,009,0362,0,1478,34,1512,2110,0,3,1,3,0,1,0,76.14,71.66 ,33.33
02,000,02,010,0363,0,4147,63,4210,6348,0,3,1,3,0,1,0,76.14,66.32 ,33.33
02,000,02,010,0364,0,1537,28,1565,2279,0,3,1,3,0,1,0,76.14,68.67 ,33.33
02,000,02,010,0365,0,2289,34,2323,3238,0,3,1,3,0,1,0,76.14,71.74 ,33.33
02,000,02,010,0366,0,1346,19,1365,1802,0,3,1,3,0,1,0,76.14,75.75 ,33.33
02,000,02,010,0367,0,1067,17,1084,1509,0,3,1,3,0,1,0,76.14,71.84 ,33.33
02,000,02,010,0368,0,1430,27,1457,2073,0,3,1,3,0,1,0,76.14,70.28 ,33.33
02,000,02,010,0369,0,1083,24,1107,1624,0,3,1,3,0,1,0,76.14,68.17 ,33.33
02,000,02,010,0370,0,645,7,652,913,0,3,1,3,0,1,0,76.14,71.41 ,33.33
02,000,02,010,0371,0,1270,25,1295,1792,0,3,1,3,0,1,0,76.14,72.27 ,33.33
02,000,02,010,0372,0,1038,16,1054,1513,0,3,1,3,0,1,0,76.14,69.66 ,33.33
02,000,02,010,0373,0,1855,27,1882,2730,0,3,1,3,0,1,0,76.14,68.94 ,33.33
02,000,02,010,0374,0,1024,14,1038,1396,0,3,1,3,0,1,0,76.14,74.36 ,33.33
02,000,02,010,0375,0,592,10,602,814,0,3,1,3,0,1,0,76.14,73.96 ,33.33
02,000,02,010,0376,0,718,11,729,980,0,3,1,3,0,1,0,76.14,74.39 ,33.33
02,000,02,010,0377,0,1359,34,1393,1759,0,3,1,3,0,1,0,76.14,79.19 ,33.33
02,000,02,010,0378,0,1407,26,1433,1897,0,3,1,3,0,1,0,76.14,75.54 ,33.33
02,000,02,010,0379,0,1749,46,1795,2408,0,3,1,3,0,1,0,76.14,74.54 ,33.33
02,000,02,010,0380,0,1373,42,1415,1951,0,3,1,3,0,1,0,76.14,72.53 ,33.33
02,000,02,010,0381,0,2273,27,2300,3205,0,3,1,3,0,1,0,76.14,71.76 ,33.33
02,000,02,010,0382,0,655,9,664,841,0,3,1,3,0,1,0,76.14,78.95 ,33.33
02,000,02,010,0383,0,772,22,794,994,0,3,1,3,0,1,0,76.14,79.88 ,33.33
02,000,02,010,0384,0,919,15,934,1216,0,3,1,3,0,1,0,76.14,76.81 ,33.33
02,000,02,010,0385,0,959,16,975,1233,0,3,1,3,0,1,0,76.14,79.08 ,33.33
02,000,02,010,0386,0,1971,31,2002,2515,0,3,1,3,0,1,0,76.14,79.60 ,33.33
02,000,02,010,0387,0,1505,18,1523,1890,0,3,1,3,0,1,0,76.14,80.58 ,33.33
02,000,02,010,0388,0,153,2,155,200,0,3,1,3,0,1,0,76.14,77.50 ,33.33
02,000,02,010,0389,0,29,1,30,58,0,3,1,3,0,1,0,76.14,51.72 ,33.33
02,000,02,010,0390,0,2139,26,2165,3014,0,3,1,3,0,1,0,76.14,71.83 ,33.33
02,000,02,010,0391,0,1386,21,1407,1801,0,3,1,3,0,1,0,76.14,78.12 ,33.33
02,000,02,010,0392,0,703,19,722,969,0,3,1,3,0,1,0,76.14,74.51 ,33.33
02,000,02,010,0393,0,872,13,885,1169,0,3,1,3,0,1,0,76.14,75.71 ,33.33
02,000,02,010,0394,0,1411,95,1506,2105,0,3,1,3,0,1,0,76.14,71.54 ,33.33
02,000,02,010,0395,0,1560,30,1590,2159,0,3,1,3,0,1,0,76.14,73.65 ,33.33
02,000,02,010,0396,0,1333,14,1347,2130,0,3,1,3,0,1,0,76.14,63.24 ,33.33
02,000,02,010,0397,0,1976,29,2005,2979,0,3,1,3,0,1,0,76.14,67.30 ,33.33
02,000,02,010,0398,0,2089,31,2120,3127,0,3,1,3,0,1,0,76.14,67.80 ,33.33
02,000,02,010,0399,0,1184,15,1199,1776,0,3,1,3,0,1,0,76.14,67.51 ,33.33
02,000,02,010,0400,0,1746,24,1770,2544,0,3,1,3,0,1,0,76.14,69.58 ,33.33
02,000,02,010,0401,0,1876,14,1890,2654,0,3,1,3,0,1,0,76.14,71.21 ,33.33
02,000,02,010,0402,0,1726,27,1753,2569,0,3,1,3,0,1,0,76.14,68.24 ,33.33
02,000,02,010,0403,0,1263,14,1277,1912,0,3,1,3,0,1,0,76.14,66.79 ,33.33
02,000,02,010,0404,0,1610,37,1647,2311,0,3,1,3,0,1,0,76.14,71.27 ,33.33
02,000,02,010,0405,0,1350,8,1358,2048,0,3,1,3,0,1,0,76.14,66.31 ,33.33
02,000,02,010,0406,0,2003,40,2043,2832,0,3,1,3,0,1,0,76.14,72.14 ,33.33
02,000,02,010,0407,0,1832,31,1863,2550,0,3,1,3,0,1,0,76.14,73.06 ,33.33
02,000,02,010,0408,0,876,81,957,1377,0,3,1,3,0,1,0,76.14,69.50 ,33.33
02,000,02,010,0409,0,3217,59,3276,4508,0,3,1,3,0,1,0,76.14,72.67 ,33.33
02,000,02,010,0410,0,1642,18,1660,2310,0,3,1,3,0,1,0,76.14,71.86 ,33.33
02,000,02,010,0411,0,2663,29,2692,3819,0,3,1,3,0,1,0,76.14,70.49 ,33.33
02,000,02,010,0412,0,1645,25,1670,2466,0,3,1,3,0,1,0,76.14,67.72 ,33.33
02,000,02,010,0413,0,1424,21,1445,2031,0,3,1,3,0,1,0,76.14,71.15 ,33.33
02,000,02,010,0414,0,1876,61,1937,2921,0,3,1,3,0,1,0,76.14,66.31 ,33.33
02,000,02,010,0415,0,2005,20,2025,2997,0,3,1,3,0,1,0,76.14,67.57 ,33.33
02,000,02,010,0416,0,1947,35,1982,2719,0,3,1,3,0,1,0,76.14,72.89 ,33.33
02,000,02,010,0417,0,1979,40,2019,2627,0,3,1,3,0,1,0,76.14,76.86 ,33.33
02,000,02,010,0418,0,1751,28,1779,2513,0,3,1,3,0,1,0,76.14,70.79 ,33.33
02,000,02,010,0419,0,1643,27,1670,2377,0,3,1,3,0,1,0,76.14,70.26 ,33.33
02,000,02,010,0420,0,1236,15,1251,1790,0,3,1,3,0,1,0,76.14,69.89 ,33.33
02,000,02,010,0421,0,1306,32,1338,1932,0,3,1,3,0,1,0,76.14,69.25 ,33.33
02,000,02,010,0422,0,2073,32,2105,3001,0,3,1,3,0,1,0,76.14,70.14 ,33.33
02,000,02,010,0423,0,1712,39,1751,2496,0,3,1,3,0,1,0,76.14,70.15 ,33.33
02,000,02,011,0424,0,1204,12,1216,1752,0,3,1,3,0,1,0,76.14,69.41 ,33.33
02,000,02,011,0425,0,1801,9,1810,2427,0,3,1,3,0,1,0,76.14,74.58 ,33.33
02,000,02,011,0426,0,1283,11,1294,1722,0,3,1,3,0,1,0,76.14,75.15 ,33.33
02,000,02,011,0427,0,1755,34,1789,2473,0,3,1,3,0,1,0,76.14,72.34 ,33.33
02,000,02,011,0428,0,941,15,956,1339,0,3,1,3,0,1,0,76.14,71.40 ,33.33
02,000,02,011,0429,0,959,14,973,1341,0,3,1,3,0,1,0,76.14,72.56 ,33.33
02,000,02,011,0430,0,899,14,913,1295,0,3,1,3,0,1,0,76.14,70.50 ,33.33
02,000,02,011,0431,0,1229,15,1244,1686,0,3,1,3,0,1,0,76.14,73.78 ,33.33
02,000,02,011,0432,0,1395,12,1407,1903,0,3,1,3,0,1,0,76.14,73.94 ,33.33
02,000,02,011,0433,0,1735,22,1757,2445,0,3,1,3,0,1,0,76.14,71.86 ,33.33
02,000,02,011,0434,0,1528,29,1557,2087,0,3,1,3,0,1,0,76.14,74.60 ,33.33
02,000,02,011,0435,0,860,11,871,1280,0,3,1,3,0,1,0,76.14,68.05 ,33.33
02,000,02,011,0436,0,2466,31,2497,3531,0,3,1,3,0,1,0,76.14,70.72 ,33.33
02,000,02,011,0437,0,1884,27,1911,2847,0,3,1,3,0,1,0,76.14,67.12 ,33.33
02,000,02,011,0438,0,1651,24,1675,2411,0,3,1,3,0,1,0,76.14,69.47 ,33.33
02,000,02,011,0439,0,523,3,526,703,0,3,1,3,0,1,0,76.14,74.82 ,33.33
02,000,02,011,0440,0,960,23,983,1415,0,3,1,3,0,1,0,76.14,69.47 ,33.33
02,000,02,011,0441,0,1920,40,1960,2774,0,3,1,3,0,1,0,76.14,70.66 ,33.33
02,000,02,011,0442,0,1580,19,1599,2261,0,3,1,3,0,1,0,76.14,70.72 ,33.33
02,000,02,011,0443,0,1014,9,1023,1387,0,3,1,3,0,1,0,76.14,73.76 ,33.33
02,000,02,011,0444,0,1398,12,1410,1910,0,3,1,3,0,1,0,76.14,73.82 ,33.33
02,000,02,011,0445,0,1061,14,1075,1454,0,3,1,3,0,1,0,76.14,73.93 ,33.33
02,000,02,011,0446,0,984,11,995,1370,0,3,1,3,0,1,0,76.14,72.63 ,33.33
02,000,02,011,0447,0,955,22,977,1252,0,3,1,3,0,1,0,76.14,78.04 ,33.33
02,000,02,011,0448,0,1966,44,2010,2564,0,3,1,3,0,1,0,76.14,78.39 ,33.33
02,000,02,011,0449,0,715,12,727,938,0,3,1,3,0,1,0,76.14,77.51 ,33.33
02,000,02,011,0450,0,685,8,693,958,0,3,1,3,0,1,0,76.14,72.34 ,33.33
02,000,02,011,0451,0,1715,32,1747,2483,0,3,1,3,0,1,0,76.14,70.36 ,33.33
02,000,02,011,0452,0,1179,12,1191,1691,0,3,1,3,0,1,0,76.14,70.43 ,33.33
02,000,02,011,0453,0,926,17,943,1292,0,3,1,3,0,1,0,76.14,72.99 ,33.33
02,000,02,011,0454,0,2739,41,2780,3889,0,3,1,3,0,1,0,76.14,71.48 ,33.33
02,000,02,011,0455,0,1418,32,1450,1955,0,3,1,3,0,1,0,76.14,74.17 ,33.33
02,000,02,011,0456,0,1392,15,1407,1722,0,3,1,3,0,1,0,76.14,81.71 ,33.33
02,000,02,011,0457,0,1500,13,1513,1859,0,3,1,3,0,1,0,76.14,81.39 ,33.33
02,000,02,011,0458,0,1075,11,1086,1374,0,3,1,3,0,1,0,76.14,79.04 ,33.33
02,000,02,011,0459,0,1534,21,1555,2067,0,3,1,3,0,1,0,76.14,75.23 ,33.33
02,000,02,011,0460,0,1417,17,1434,1964,0,3,1,3,0,1,0,76.14,73.01 ,33.33
02,000,02,011,0461,0,1056,12,1068,1358,0,3,1,3,0,1,0,76.14,78.65 ,33.33
02,000,02,011,0462,0,2577,22,2599,3703,0,3,1,3,0,1,0,76.14,70.19 ,33.33
02,000,02,011,0463,0,1372,18,1390,1986,0,3,1,3,0,1,0,76.14,69.99 ,33.33
02,000,02,011,0464,0,1475,15,1490,2117,0,3,1,3,0,1,0,76.14,70.38 ,33.33
02,000,02,011,0465,0,1622,18,1640,2357,0,3,1,3,0,1,0,76.14,69.58 ,33.33
02,000,02,011,0466,0,1627,26,1653,2362,0,3,1,3,0,1,0,76.14,69.98 ,33.33
03,001,01,001,0001,0,842,10,852,1239,0,3,1,3,0,1,0,76.14,68.77 ,33.33
03,001,01,001,0002,0,907,10,917,1292,0,3,1,3,0,1,0,76.14,70.98 ,33.33
03,001,01,001,0003,0,403,6,409,553,0,3,1,3,0,1,0,76.14,73.96 ,33.33
03,001,01,001,0004,0,781,11,792,1133,0,3,1,3,0,1,0,76.14,69.90 ,33.33
03,001,01,001,0005,0,1110,9,1119,1644,0,3,1,3,0,1,0,76.14,68.07 ,33.33
03,001,01,001,0006,0,2553,49,2602,3889,0,3,1,3,0,1,0,76.14,66.91 ,33.33
03,001,01,001,0007,0,1694,19,1713,2490,0,3,1,3,0,1,0,76.14,68.80 ,33.33
03,001,01,001,0008,0,2957,48,3005,4492,0,3,1,3,0,1,0,76.14,66.90 ,33.33
03,001,01,001,0009,0,2067,29,2096,3052,0,3,1,3,0,1,0,76.14,68.68 ,33.33
03,001,01,001,0010,0,1322,12,1334,1996,0,3,1,3,0,1,0,76.14,66.83 ,33.33
03,001,01,001,0011,0,2268,56,2324,3549,0,3,1,3,0,1,0,76.14,65.48 ,33.33
03,001,01,001,0012,0,3062,29,3091,4302,0,3,1,3,0,1,0,76.14,71.85 ,33.33
03,001,01,001,0013,0,1584,15,1599,2382,0,3,1,3,0,1,0,76.14,67.13 ,33.33
03,001,01,001,0014,0,1413,13,1426,2108,0,3,1,3,0,1,0,76.14,67.65 ,33.33
03,001,01,001,0015,0,1508,24,1532,2175,0,3,1,3,0,1,0,76.14,70.44 ,33.33
03,001,01,001,0016,0,1836,13,1849,2442,0,3,1,3,0,1,0,76.14,75.72 ,33.33
03,001,01,001,0017,0,956,9,965,1434,0,3,1,3,0,1,0,76.14,67.29 ,33.33
03,001,01,001,0018,0,2258,34,2292,3349,0,3,1,3,0,1,0,76.14,68.44 ,33.33
03,001,01,001,0019,0,2003,34,2037,3091,0,3,1,3,0,1,0,76.14,65.90 ,33.33
03,001,01,001,0020,0,2546,37,2583,3951,0,3,1,3,0,1,0,76.14,65.38 ,33.33
03,001,01,001,0021,0,1750,21,1771,2496,0,3,1,3,0,1,0,76.14,70.95 ,33.33
03,001,01,001,0022,0,1243,14,1257,1815,0,3,1,3,0,1,0,76.14,69.26 ,33.33
03,001,01,001,0023,0,2122,30,2152,3209,0,3,1,3,0,1,0,76.14,67.06 ,33.33
03,001,01,001,0024,0,2660,28,2688,3748,0,3,1,3,0,1,0,76.14,71.72 ,33.33
03,001,01,001,0025,0,2144,36,2180,3007,0,3,1,3,0,1,0,76.14,72.50 ,33.33
03,001,01,001,0026,0,2511,30,2541,3644,0,3,1,3,0,1,0,76.14,69.73 ,33.33
03,001,01,001,0027,0,2054,28,2082,3019,0,3,1,3,0,1,0,76.14,68.96 ,33.33
03,001,01,001,0028,0,1217,22,1239,1808,0,3,1,3,0,1,0,76.14,68.53 ,33.33
03,001,01,001,0029,0,1463,5,1468,1953,0,3,1,3,0,1,0,76.14,75.17 ,33.33
03,001,01,001,0030,0,1552,21,1573,2233,0,3,1,3,0,1,0,76.14,70.44 ,33.33
03,001,01,001,0031,0,1381,20,1401,1949,0,3,1,3,0,1,0,76.14,71.88 ,33.33
03,001,01,001,0032,0,1569,8,1577,2336,0,3,1,3,0,1,0,76.14,67.51 ,33.33
03,001,01,001,0033,0,1360,21,1381,1991,0,3,1,3,0,1,0,76.14,69.36 ,33.33
03,001,01,001,0034,0,1745,20,1765,2637,0,3,1,3,0,1,0,76.14,66.93 ,33.33
03,001,01,001,0035,0,2336,23,2359,3504,0,3,1,3,0,1,0,76.14,67.32 ,33.33
03,001,01,001,0036,0,1999,29,2028,2967,0,3,1,3,0,1,0,76.14,68.35 ,33.33
03,001,01,001,0037,0,2470,32,2502,3860,0,3,1,3,0,1,0,76.14,64.82 ,33.33
03,001,01,001,0038,0,1351,16,1367,2043,0,3,1,3,0,1,0,76.14,66.91 ,33.33
03,001,01,001,0039,0,1670,24,1694,2486,0,3,1,3,0,1,0,76.14,68.14 ,33.33
03,001,01,001,0040,0,1463,29,1492,2166,0,3,1,3,0,1,0,76.14,68.88 ,33.33
03,001,01,001,0041,0,1658,32,1690,2442,0,3,1,3,0,1,0,76.14,69.21 ,33.33
03,001,01,001,0042,0,2345,35,2380,3491,0,3,1,3,0,1,0,76.14,68.18 ,33.33
03,001,01,001,0043,0,1682,25,1707,2586,0,3,1,3,0,1,0,76.14,66.01 ,33.33
03,001,01,001,0044,0,1818,26,1844,2697,0,3,1,3,0,1,0,76.14,68.37 ,33.33
03,001,01,001,0045,0,1499,19,1518,2332,0,3,1,3,0,1,0,76.14,65.09 ,33.33
03,001,01,001,0046,0,1594,26,1620,2598,0,3,1,3,0,1,0,76.14,62.36 ,33.33
03,001,01,001,0047,0,1781,26,1807,2635,0,3,1,3,0,1,0,76.14,68.58 ,33.33
03,001,01,001,0048,0,2805,27,2832,4159,0,3,1,3,0,1,0,76.14,68.09 ,33.33
03,001,01,001,0049,0,1571,21,1592,2445,0,3,1,3,0,1,0,76.14,65.11 ,33.33
03,001,01,001,0050,0,1745,22,1767,2557,0,3,1,3,0,1,0,76.14,69.10 ,33.33
03,001,01,001,0051,0,1987,23,2010,3004,0,3,1,3,0,1,0,76.14,66.91 ,33.33
03,001,01,001,0052,0,1330,7,1337,2021,0,3,1,3,0,1,0,76.14,66.16 ,33.33
03,001,01,001,0053,0,1642,18,1660,2438,0,3,1,3,0,1,0,76.14,68.09 ,33.33
03,001,01,001,0054,0,1425,12,1437,2181,0,3,1,3,0,1,0,76.14,65.89 ,33.33
03,001,01,001,0055,0,2242,40,2282,3344,0,3,1,3,0,1,0,76.14,68.24 ,33.33
03,001,01,001,0056,0,1375,23,1398,2195,0,3,1,3,0,1,0,76.14,63.69 ,33.33
03,001,01,001,0057,0,1329,22,1351,1970,0,3,1,3,0,1,0,76.14,68.58 ,33.33
03,001,01,001,0058,0,1962,30,1992,2884,0,3,1,3,0,1,0,76.14,69.07 ,33.33
03,001,01,001,0059,0,1635,24,1659,2589,0,3,1,3,0,1,0,76.14,64.08 ,33.33
03,001,01,001,0060,0,2187,37,2224,3493,0,3,1,3,0,1,0,76.14,63.67 ,33.33
03,001,01,001,0061,0,1176,19,1195,1760,0,3,1,3,0,1,0,76.14,67.90 ,33.33
03,001,01,001,0062,0,2744,34,2778,4147,0,3,1,3,0,1,0,76.14,66.99 ,33.33
03,001,01,001,0063,0,2287,40,2327,3255,0,3,1,3,0,1,0,76.14,71.49 ,33.33
03,001,01,001,0064,0,2006,37,2043,3041,0,3,1,3,0,1,0,76.14,67.18 ,33.33
03,001,01,001,0065,0,1564,34,1598,2394,0,3,1,3,0,1,0,76.14,66.75 ,33.33
03,001,01,001,0066,0,2492,44,2536,3782,0,3,1,3,0,1,0,76.14,67.05 ,33.33
03,001,01,001,0067,0,1032,11,1043,1576,0,3,1,3,0,1,0,76.14,66.18 ,33.33
03,001,01,001,0068,0,1475,31,1506,2180,0,3,1,3,0,1,0,76.14,69.08 ,33.33
03,001,01,001,0069,0,1363,20,1383,2005,0,3,1,3,0,1,0,76.14,68.98 ,33.33
03,001,01,001,0070,0,1651,30,1681,2339,0,3,1,3,0,1,0,76.14,71.87 ,33.33
03,001,01,001,0071,0,2667,43,2710,3881,0,3,1,3,0,1,0,76.14,69.83 ,33.33
03,001,01,001,0072,0,1517,22,1539,2340,0,3,1,3,0,1,0,76.14,65.77 ,33.33
03,001,01,001,0073,0,1471,18,1489,2124,0,3,1,3,0,1,0,76.14,70.10 ,33.33
03,001,01,001,0074,0,2236,31,2267,3368,0,3,1,3,0,1,0,76.14,67.31 ,33.33
03,001,01,001,0075,0,1633,15,1648,2341,0,3,1,3,0,1,0,76.14,70.40 ,33.33
03,001,01,001,0076,0,1726,23,1749,2630,0,3,1,3,0,1,0,76.14,66.50 ,33.33
03,001,01,001,0077,0,917,9,926,1359,0,3,1,3,0,1,0,76.14,68.14 ,33.33
03,001,01,001,0078,0,1325,17,1342,2080,0,3,1,3,0,1,0,76.14,64.52 ,33.33
03,001,01,001,0079,0,1510,31,1541,2489,0,3,1,3,0,1,0,76.14,61.91 ,33.33
03,001,01,001,0080,0,1820,26,1846,2887,0,3,1,3,0,1,0,76.14,63.94 ,33.33
03,001,01,001,0081,0,2684,18,2702,3915,0,3,1,3,0,1,0,76.14,69.02 ,33.33
03,001,01,001,0082,0,1855,27,1882,2689,0,3,1,3,0,1,0,76.14,69.99 ,33.33
03,001,01,001,0083,0,1268,15,1283,1892,0,3,1,3,0,1,0,76.14,67.81 ,33.33
03,001,01,001,0084,0,2120,34,2154,3199,0,3,1,3,0,1,0,76.14,67.33 ,33.33
03,001,01,001,0085,0,894,12,906,1398,0,3,1,3,0,1,0,76.14,64.81 ,33.33
03,001,01,001,0086,0,1603,23,1626,2462,0,3,1,3,0,1,0,76.14,66.04 ,33.33
03,001,01,001,0087,0,1293,20,1313,1918,0,3,1,3,0,1,0,76.14,68.46 ,33.33
03,001,01,001,0088,0,1060,16,1076,1604,0,3,1,3,0,1,0,76.14,67.08 ,33.33
03,001,01,001,0089,0,1580,29,1609,2351,0,3,1,3,0,1,0,76.14,68.44 ,33.33
03,001,01,001,0090,0,2158,19,2177,3174,0,3,1,3,0,1,0,76.14,68.59 ,33.33
03,001,01,001,0091,0,1404,25,1429,2175,0,3,1,3,0,1,0,76.14,65.70 ,33.33
03,001,01,001,0092,0,1569,17,1586,2354,0,3,1,3,0,1,0,76.14,67.37 ,33.33
03,001,01,001,0093,0,2461,34,2495,3626,0,3,1,3,0,1,0,76.14,68.81 ,33.33
03,001,01,001,0094,0,1656,16,1672,2422,0,3,1,3,0,1,0,76.14,69.03 ,33.33
03,001,01,001,0095,0,1471,17,1488,2194,0,3,1,3,0,1,0,76.14,67.82 ,33.33
03,001,01,001,0096,0,1719,33,1752,2373,0,3,1,3,0,1,0,76.14,73.83 ,33.33
03,001,01,001,0097,0,2636,26,2662,3851,0,3,1,3,0,1,0,76.14,69.12 ,33.33
03,001,01,001,0098,0,2322,43,2365,3518,0,3,1,3,0,1,0,76.14,67.23 ,33.33
03,001,01,001,0099,0,2903,53,2956,4289,0,3,1,3,0,1,0,76.14,68.92 ,33.33
03,001,01,001,0100,0,1950,19,1969,2745,0,3,1,3,0,1,0,76.14,71.73 ,33.33
03,001,01,001,0101,0,596,12,608,880,0,3,1,3,0,1,0,76.14,69.09 ,33.33
03,001,01,001,0102,0,1351,26,1377,2086,0,3,1,3,0,1,0,76.14,66.01 ,33.33
03,001,01,001,0103,0,2320,27,2347,3464,0,3,1,3,0,1,0,76.14,67.75 ,33.33
03,001,01,001,0104,0,1426,17,1443,2207,0,3,1,3,0,1,0,76.14,65.38 ,33.33
03,001,01,001,0105,0,1553,14,1567,2240,0,3,1,3,0,1,0,76.14,69.96 ,33.33
03,001,01,001,0106,0,1113,22,1135,1637,0,3,1,3,0,1,0,76.14,69.33 ,33.33
03,001,01,001,0107,0,2366,37,2403,3667,0,3,1,3,0,1,0,76.14,65.53 ,33.33
03,001,01,001,0108,0,2349,32,2381,3336,0,3,1,3,0,1,0,76.14,71.37 ,33.33
03,001,01,001,0109,0,2166,40,2206,3141,0,3,1,3,0,1,0,76.14,70.23 ,33.33
03,001,01,001,0110,0,1986,29,2015,3551,0,3,1,3,0,1,0,76.14,56.74 ,33.33
03,001,01,001,0111,0,2219,42,2261,3630,0,3,1,3,0,1,0,76.14,62.29 ,33.33
03,001,01,001,0112,0,1762,25,1787,2551,0,3,1,3,0,1,0,76.14,70.05 ,33.33
03,001,01,001,0113,0,1593,30,1623,2392,0,3,1,3,0,1,0,76.14,67.85 ,33.33
03,001,01,001,0114,0,731,13,744,1058,0,3,1,3,0,1,0,76.14,70.32 ,33.33
03,001,01,001,0115,0,2551,49,2600,3991,0,3,1,3,0,1,0,76.14,65.15 ,33.33
03,001,01,001,0116,0,2282,63,2345,3271,0,3,1,3,0,1,0,76.14,71.69 ,33.33
03,001,01,001,0117,0,2157,31,2188,3295,0,3,1,3,0,1,0,76.14,66.40 ,33.33
03,001,01,001,0118,0,1483,31,1514,2336,0,3,1,3,0,1,0,76.14,64.81 ,33.33
03,001,01,001,0119,0,2310,40,2350,3685,0,3,1,3,0,1,0,76.14,63.77 ,33.33
03,001,01,001,0120,0,1559,33,1592,2407,0,3,1,3,0,1,0,76.14,66.14 ,33.33
03,001,01,001,0121,0,2383,49,2432,3665,0,3,1,3,0,1,0,76.14,66.36 ,33.33
03,001,01,001,0122,0,1455,37,1492,2335,0,3,1,3,0,1,0,76.14,63.90 ,33.33
03,001,01,001,0123,0,2282,33,2315,3594,0,3,1,3,0,1,0,76.14,64.41 ,33.33
03,001,01,001,0124,0,2203,40,2243,3421,0,3,1,3,0,1,0,76.14,65.57 ,33.33
03,001,01,001,0125,0,1547,30,1577,2306,0,3,1,3,0,1,0,76.14,68.39 ,33.33
03,001,01,001,0126,0,1478,30,1508,2311,0,3,1,3,0,1,0,76.14,65.25 ,33.33
03,001,01,002,0127,0,1988,32,2020,2971,0,3,1,3,0,1,0,76.14,67.99 ,33.33
03,001,01,002,0128,0,1999,27,2026,2933,0,3,1,3,0,1,0,76.14,69.08 ,33.33
03,001,01,002,0129,0,1104,22,1126,1754,0,3,1,3,0,1,0,76.14,64.20 ,33.33
03,001,01,002,0130,0,938,19,957,1456,0,3,1,3,0,1,0,76.14,65.73 ,33.33
03,001,01,002,0131,0,856,12,868,1233,0,3,1,3,0,1,0,76.14,70.40 ,33.33
03,001,01,002,0132,0,1323,21,1344,1885,0,3,1,3,0,1,0,76.14,71.30 ,33.33
03,001,01,002,0133,0,1839,33,1872,2753,0,3,1,3,0,1,0,76.14,68.00 ,33.33
03,001,01,002,0134,0,293,6,299,382,0,3,1,3,0,1,0,76.14,78.27 ,33.33
03,001,01,002,0135,0,1468,23,1491,2310,0,3,1,3,0,1,0,76.14,64.55 ,33.33
03,001,01,002,0136,0,1786,19,1805,2678,0,3,1,3,0,1,0,76.14,67.40 ,33.33
03,001,01,002,0137,0,1563,20,1583,2427,0,3,1,3,0,1,0,76.14,65.22 ,33.33
03,001,01,002,0138,0,1679,14,1693,2422,0,3,1,3,0,1,0,76.14,69.90 ,33.33
03,001,01,002,0139,0,1984,35,2019,3061,0,3,1,3,0,1,0,76.14,65.96 ,33.33
03,001,01,002,0140,0,1295,16,1311,1899,0,3,1,3,0,1,0,76.14,69.04 ,33.33
03,001,01,002,0141,0,1391,18,1409,2064,0,3,1,3,0,1,0,76.14,68.27 ,33.33
03,001,01,002,0142,0,1981,16,1997,2915,0,3,1,3,0,1,0,76.14,68.51 ,33.33
03,001,01,002,0143,0,2294,31,2325,3390,0,3,1,3,0,1,0,76.14,68.58 ,33.33
03,001,01,002,0144,0,2284,21,2305,3449,0,3,1,3,0,1,0,76.14,66.83 ,33.33
03,001,01,002,0145,0,1511,19,1530,2270,0,3,1,3,0,1,0,76.14,67.40 ,33.33
03,001,01,002,0146,0,2615,30,2645,3977,0,3,1,3,0,1,0,76.14,66.51 ,33.33
03,001,01,002,0147,0,2365,36,2401,3633,0,3,1,3,0,1,0,76.14,66.09 ,33.33
03,001,01,002,0148,0,1316,18,1334,1938,0,3,1,3,0,1,0,76.14,68.83 ,33.33
03,001,01,002,0149,0,2195,29,2224,3525,0,3,1,3,0,1,0,76.14,63.09 ,33.33
03,001,01,002,0150,0,691,10,701,1151,0,3,1,3,0,1,0,76.14,60.90 ,33.33
03,001,01,002,0151,0,967,16,983,1570,0,3,1,3,0,1,0,76.14,62.61 ,33.33
03,001,01,002,0152,0,862,19,881,1429,0,3,1,3,0,1,0,76.14,61.65 ,33.33
03,001,01,002,0153,0,1174,17,1191,1735,0,3,1,3,0,1,0,76.14,68.65 ,33.33
03,001,01,002,0154,0,815,17,832,1188,0,3,1,3,0,1,0,76.14,70.03 ,33.33
03,001,01,002,0155,0,752,12,764,1105,0,3,1,3,0,1,0,76.14,69.14 ,33.33
03,001,01,002,0156,0,875,20,895,1380,0,3,1,3,0,1,0,76.14,64.86 ,33.33
03,001,01,002,0157,0,879,15,894,1368,0,3,1,3,0,1,0,76.14,65.35 ,33.33
03,001,01,002,0158,0,819,14,833,1232,0,3,1,3,0,1,0,76.14,67.61 ,33.33
03,001,01,002,0159,0,1049,18,1067,1545,0,3,1,3,0,1,0,76.14,69.06 ,33.33
03,001,01,002,0160,0,864,17,881,1385,0,3,1,3,0,1,0,76.14,63.61 ,33.33
03,001,01,002,0161,0,1317,20,1337,2005,0,3,1,3,0,1,0,76.14,66.68 ,33.33
03,001,01,002,0162,0,1034,15,1049,1630,0,3,1,3,0,1,0,76.14,64.36 ,33.33
03,001,01,002,0163,0,745,14,759,1100,0,3,1,3,0,1,0,76.14,69.00 ,33.33
03,001,01,002,0164,0,658,11,669,1000,0,3,1,3,0,1,0,76.14,66.90 ,33.33
03,001,01,002,0165,0,1177,9,1186,1683,0,3,1,3,0,1,0,76.14,70.47 ,33.33
03,001,01,002,0166,0,642,9,651,896,0,3,1,3,0,1,0,76.14,72.66 ,33.33
03,001,01,002,0167,0,539,13,552,885,0,3,1,3,0,1,0,76.14,62.37 ,33.33
03,001,01,002,0168,0,1021,12,1033,1542,0,3,1,3,0,1,0,76.14,66.99 ,33.33
03,001,01,002,0169,0,485,7,492,737,0,3,1,3,0,1,0,76.14,66.76 ,33.33
03,001,01,002,0170,0,1374,18,1392,2034,0,3,1,3,0,1,0,76.14,68.44 ,33.33
03,001,01,002,0171,0,1323,13,1336,2047,0,3,1,3,0,1,0,76.14,65.27 ,33.33
03,001,01,002,0172,0,1033,10,1043,1575,0,3,1,3,0,1,0,76.14,66.22 ,33.33
03,001,01,002,0173,0,1607,22,1629,2488,0,3,1,3,0,1,0,76.14,65.47 ,33.33
03,001,01,002,0174,0,2360,19,2379,3423,0,3,1,3,0,1,0,76.14,69.50 ,33.33
03,001,01,002,0175,0,1017,10,1027,1442,0,3,1,3,0,1,0,76.14,71.22 ,33.33
03,001,01,002,0176,0,764,8,772,1105,0,3,1,3,0,1,0,76.14,69.86 ,33.33
03,001,01,002,0177,0,854,4,858,1231,0,3,1,3,0,1,0,76.14,69.70 ,33.33
03,001,01,002,0178,0,1072,12,1084,1618,0,3,1,3,0,1,0,76.14,67.00 ,33.33
03,001,01,002,0179,0,995,10,1005,1518,0,3,1,3,0,1,0,76.14,66.21 ,33.33
03,001,01,002,0180,0,1579,18,1597,2386,0,3,1,3,0,1,0,76.14,66.93 ,33.33
03,001,01,002,0181,0,909,14,923,1390,0,3,1,3,0,1,0,76.14,66.40 ,33.33
03,001,01,002,0182,0,674,15,689,1011,0,3,1,3,0,1,0,76.14,68.15 ,33.33
03,001,01,002,0183,0,1031,34,1065,1621,0,3,1,3,0,1,0,76.14,65.70 ,33.33
03,001,01,002,0184,0,1235,11,1246,1798,0,3,1,3,0,1,0,76.14,69.30 ,33.33
03,001,01,002,0185,0,1169,16,1185,1844,0,3,1,3,0,1,0,76.14,64.26 ,33.33
03,001,01,002,0186,0,1029,17,1046,1535,0,3,1,3,0,1,0,76.14,68.14 ,33.33
03,001,01,002,0187,0,445,4,449,694,0,3,1,3,0,1,0,76.14,64.70 ,33.33
03,001,01,002,0188,0,1039,16,1055,1552,0,3,1,3,0,1,0,76.14,67.98 ,33.33
03,001,01,002,0189,0,418,4,422,616,0,3,1,3,0,1,0,76.14,68.51 ,33.33
03,001,01,002,0190,0,1122,18,1140,1688,0,3,1,3,0,1,0,76.14,67.54 ,33.33
03,001,01,002,0191,0,1012,10,1022,1555,0,3,1,3,0,1,0,76.14,65.72 ,33.33
03,001,01,002,0192,0,1289,19,1308,1896,0,3,1,3,0,1,0,76.14,68.99 ,33.33
03,001,01,002,0193,0,998,14,1012,1451,0,3,1,3,0,1,0,76.14,69.75 ,33.33
03,001,01,002,0194,0,694,14,708,1060,0,3,1,3,0,1,0,76.14,66.79 ,33.33
03,001,01,002,0195,0,935,10,945,1398,0,3,1,3,0,1,0,76.14,67.60 ,33.33
03,001,01,002,0196,0,1413,30,1443,2209,0,3,1,3,0,1,0,76.14,65.32 ,33.33
03,001,01,002,0197,0,1475,27,1502,2300,0,3,1,3,0,1,0,76.14,65.30 ,33.33
03,001,01,002,0198,0,982,14,996,1519,0,3,1,3,0,1,0,76.14,65.57 ,33.33
03,001,01,002,0199,0,821,8,829,1176,0,3,1,3,0,1,0,76.14,70.49 ,33.33
03,001,01,002,0200,0,993,11,1004,1448,0,3,1,3,0,1,0,76.14,69.34 ,33.33
03,001,01,002,0201,0,1506,24,1530,2300,0,3,1,3,0,1,0,76.14,66.52 ,33.33
03,001,01,002,0202,0,1466,25,1491,2198,0,3,1,3,0,1,0,76.14,67.83 ,33.33
03,001,01,002,0203,0,774,14,788,1125,0,3,1,3,0,1,0,76.14,70.04 ,33.33
03,001,01,002,0204,0,1198,22,1220,1742,0,3,1,3,0,1,0,76.14,70.03 ,33.33
03,001,01,002,0205,0,2337,37,2374,3596,0,3,1,3,0,1,0,76.14,66.02 ,33.33
03,001,01,002,0206,0,1969,21,1990,3022,0,3,1,3,0,1,0,76.14,65.85 ,33.33
03,001,01,002,0207,0,2396,33,2429,3601,0,3,1,3,0,1,0,76.14,67.45 ,33.33
03,001,01,002,0208,0,1382,12,1394,2034,0,3,1,3,0,1,0,76.14,68.53 ,33.33
03,001,01,002,0209,0,1160,15,1175,1685,0,3,1,3,0,1,0,76.14,69.73 ,33.33
03,001,01,002,0210,0,1449,22,1471,2114,0,3,1,3,0,1,0,76.14,69.58 ,33.33
03,001,01,002,0211,0,2199,32,2231,3461,0,3,1,3,0,1,0,76.14,64.46 ,33.33
03,001,01,002,0212,0,1552,20,1572,2219,0,3,1,3,0,1,0,76.14,70.84 ,33.33
03,001,01,002,0213,0,1410,24,1434,2193,0,3,1,3,0,1,0,76.14,65.39 ,33.33
03,001,01,002,0214,0,1768,32,1800,2647,0,3,1,3,0,1,0,76.14,68.00 ,33.33
03,001,01,002,0215,0,1647,17,1664,2478,0,3,1,3,0,1,0,76.14,67.15 ,33.33
03,001,01,002,0216,0,1502,14,1516,2295,0,3,1,3,0,1,0,76.14,66.06 ,33.33
03,001,01,002,0217,0,2662,36,2698,3923,0,3,1,3,0,1,0,76.14,68.77 ,33.33
03,001,01,002,0218,0,1309,16,1325,1985,0,3,1,3,0,1,0,76.14,66.75 ,33.33
03,001,01,002,0219,0,1834,29,1863,2776,0,3,1,3,0,1,0,76.14,67.11 ,33.33
03,001,01,002,0220,0,1735,24,1759,2554,0,3,1,3,0,1,0,76.14,68.87 ,33.33
03,001,01,002,0221,0,1312,17,1329,2047,0,3,1,3,0,1,0,76.14,64.92 ,33.33
03,001,01,002,0222,0,1305,19,1324,1972,0,3,1,3,0,1,0,76.14,67.14 ,33.33
03,001,01,002,0223,0,1886,32,1918,2984,0,3,1,3,0,1,0,76.14,64.28 ,33.33
03,001,01,002,0224,0,2070,32,2102,3291,0,3,1,3,0,1,0,76.14,63.87 ,33.33
03,001,01,002,0225,0,2285,43,2328,3728,0,3,1,3,0,1,0,76.14,62.45 ,33.33
03,001,01,002,0226,0,1689,20,1709,2662,0,3,1,3,0,1,0,76.14,64.20 ,33.33
03,001,01,002,0227,0,2606,35,2641,3967,0,3,1,3,0,1,0,76.14,66.57 ,33.33
03,001,01,002,0228,0,2981,28,3009,4649,0,3,1,3,0,1,0,76.14,64.72 ,33.33
03,001,01,002,0229,0,3138,50,3188,4786,0,3,1,3,0,1,0,76.14,66.61 ,33.33
03,001,01,002,0230,0,1313,24,1337,2126,0,3,1,3,0,1,0,76.14,62.89 ,33.33
03,001,01,002,0231,0,1572,27,1599,2511,0,3,1,3,0,1,0,76.14,63.68 ,33.33
03,001,01,002,0232,0,1244,25,1269,1959,0,3,1,3,0,1,0,76.14,64.78 ,33.33
03,001,01,002,0233,0,1404,22,1426,2092,0,3,1,3,0,1,0,76.14,68.16 ,33.33
03,001,01,002,0234,0,1242,20,1262,1792,0,3,1,3,0,1,0,76.14,70.42 ,33.33
03,001,01,002,0235,0,2004,34,2038,2910,0,3,1,3,0,1,0,76.14,70.03 ,33.33
03,001,01,002,0236,0,1261,28,1289,1853,0,3,1,3,0,1,0,76.14,69.56 ,33.33
03,001,01,002,0237,0,2099,39,2138,3211,0,3,1,3,0,1,0,76.14,66.58 ,33.33
03,001,01,002,0238,0,1354,23,1377,2070,0,3,1,3,0,1,0,76.14,66.52 ,33.33
03,001,01,002,0239,0,1399,32,1431,2179,0,3,1,3,0,1,0,76.14,65.67 ,33.33
03,001,01,002,0240,0,1043,17,1060,1654,0,3,1,3,0,1,0,76.14,64.09 ,33.33
03,001,01,002,0241,0,1436,30,1466,2136,0,3,1,3,0,1,0,76.14,68.63 ,33.33
03,001,01,002,0242,0,2504,41,2545,4133,0,3,1,3,0,1,0,76.14,61.58 ,33.33
03,001,01,003,0243,0,1603,25,1628,2562,0,3,1,3,0,1,0,76.14,63.54 ,33.33
03,001,01,003,0244,0,872,9,881,1335,0,3,1,3,0,1,0,76.14,65.99 ,33.33
03,001,01,003,0245,0,2751,25,2776,3964,0,3,1,3,0,1,0,76.14,70.03 ,33.33
03,001,01,003,0246,0,1733,18,1751,2618,0,3,1,3,0,1,0,76.14,66.88 ,33.33
03,001,01,003,0247,0,1260,18,1278,1853,0,3,1,3,0,1,0,76.14,68.97 ,33.33
03,001,01,003,0248,0,1732,36,1768,2601,0,3,1,3,0,1,0,76.14,67.97 ,33.33
03,001,01,003,0249,0,1908,16,1924,2814,0,3,1,3,0,1,0,76.14,68.37 ,33.33
03,001,01,003,0250,0,1794,29,1823,2623,0,3,1,3,0,1,0,76.14,69.50 ,33.33
03,001,01,003,0251,0,2515,27,2542,3609,0,3,1,3,0,1,0,76.14,70.44 ,33.33
03,001,01,003,0252,0,1959,38,1997,3033,0,3,1,3,0,1,0,76.14,65.84 ,33.33
03,001,01,003,0253,0,2030,27,2057,3035,0,3,1,3,0,1,0,76.14,67.78 ,33.33
03,001,01,003,0254,0,2653,44,2697,3798,0,3,1,3,0,1,0,76.14,71.01 ,33.33
03,001,01,003,0255,0,2036,47,2083,3034,0,3,1,3,0,1,0,76.14,68.66 ,33.33
03,001,01,003,0256,0,2499,38,2537,3739,0,3,1,3,0,1,0,76.14,67.85 ,33.33
03,001,01,003,0257,0,2077,28,2105,3001,0,3,1,3,0,1,0,76.14,70.14 ,33.33
03,001,01,003,0258,0,2467,39,2506,3653,0,3,1,3,0,1,0,76.14,68.60 ,33.33
03,001,01,003,0259,0,2241,26,2267,3393,0,3,1,3,0,1,0,76.14,66.81 ,33.33
03,001,01,003,0260,0,2085,23,2108,2944,0,3,1,3,0,1,0,76.14,71.60 ,33.33
03,001,01,003,0261,0,1031,10,1041,1571,0,3,1,3,0,1,0,76.14,66.26 ,33.33
03,001,01,003,0262,0,1676,21,1697,2373,0,3,1,3,0,1,0,76.14,71.51 ,33.33
03,001,01,003,0263,0,1329,17,1346,1920,0,3,1,3,0,1,0,76.14,70.10 ,33.33
03,001,01,003,0264,0,1829,24,1853,2714,0,3,1,3,0,1,0,76.14,68.28 ,33.33
03,001,01,003,0265,0,2640,30,2670,3874,0,3,1,3,0,1,0,76.14,68.92 ,33.33
03,001,01,003,0266,0,1792,16,1808,2678,0,3,1,3,0,1,0,76.14,67.51 ,33.33
03,001,01,003,0267,0,2188,35,2223,3247,0,3,1,3,0,1,0,76.14,68.46 ,33.33
03,001,01,003,0268,0,2175,25,2200,3203,0,3,1,3,0,1,0,76.14,68.69 ,33.33
03,001,01,003,0269,0,1902,26,1928,2807,0,3,1,3,0,1,0,76.14,68.69 ,33.33
03,001,01,003,0270,0,1520,36,1556,2225,0,3,1,3,0,1,0,76.14,69.93 ,33.33
03,001,01,003,0271,0,2396,24,2420,3535,0,3,1,3,0,1,0,76.14,68.46 ,33.33
03,001,01,003,0272,0,2385,38,2423,3555,0,3,1,3,0,1,0,76.14,68.16 ,33.33
03,001,01,003,0273,0,1994,26,2020,2924,0,3,1,3,0,1,0,76.14,69.08 ,33.33
03,001,01,003,0274,0,1425,13,1438,2027,0,3,1,3,0,1,0,76.14,70.94 ,33.33
03,001,01,003,0275,0,1439,20,1459,2159,0,3,1,3,0,1,0,76.14,67.58 ,33.33
03,001,01,003,0276,0,2480,36,2516,3676,0,3,1,3,0,1,0,76.14,68.44 ,33.33
03,001,01,003,0277,0,1641,20,1661,2372,0,3,1,3,0,1,0,76.14,70.03 ,33.33
03,001,01,003,0278,0,2118,41,2159,3278,0,3,1,3,0,1,0,76.14,65.86 ,33.33
03,001,01,003,0279,0,1603,23,1626,2402,0,3,1,3,0,1,0,76.14,67.69 ,33.33
03,001,01,003,0280,0,1860,30,1890,2895,0,3,1,3,0,1,0,76.14,65.28 ,33.33
03,001,01,003,0281,0,2950,40,2990,4242,0,3,1,3,0,1,0,76.14,70.49 ,33.33
03,001,01,003,0282,0,1943,47,1990,2898,0,3,1,3,0,1,0,76.14,68.67 ,33.33
03,001,01,003,0283,0,2735,42,2777,4299,0,3,1,3,0,1,0,76.14,64.60 ,33.33
03,001,01,003,0284,0,1333,12,1345,1923,0,3,1,3,0,1,0,76.14,69.94 ,33.33
03,001,01,003,0285,0,2121,33,2154,3205,0,3,1,3,0,1,0,76.14,67.21 ,33.33
03,001,01,003,0286,0,1885,22,1907,2771,0,3,1,3,0,1,0,76.14,68.82 ,33.33
03,001,01,003,0287,0,1350,13,1363,1938,0,3,1,3,0,1,0,76.14,70.33 ,33.33
03,001,01,003,0288,0,167,1,168,232,0,3,1,3,0,1,0,76.14,72.41 ,33.33
03,001,01,003,0289,0,2744,44,2788,4140,0,3,1,3,0,1,0,76.14,67.34 ,33.33
03,001,01,003,0290,0,1531,26,1557,2274,0,3,1,3,0,1,0,76.14,68.47 ,33.33
03,001,01,003,0291,0,1847,25,1872,2883,0,3,1,3,0,1,0,76.14,64.93 ,33.33
03,001,01,003,0292,0,1764,27,1791,2594,0,3,1,3,0,1,0,76.14,69.04 ,33.33
03,001,01,003,0293,0,1813,18,1831,2645,0,3,1,3,0,1,0,76.14,69.22 ,33.33
03,001,01,003,0294,0,1229,22,1251,1958,0,3,1,3,0,1,0,76.14,63.89 ,33.33
03,001,01,003,0295,0,3060,43,3103,4548,0,3,1,3,0,1,0,76.14,68.23 ,33.33
03,001,01,003,0296,0,1893,36,1929,2812,0,3,1,3,0,1,0,76.14,68.60 ,33.33
03,001,01,003,0297,0,2153,26,2179,3336,0,3,1,3,0,1,0,76.14,65.32 ,33.33
03,001,01,003,0298,0,1963,33,1996,3088,0,3,1,3,0,1,0,76.14,64.64 ,33.33
03,001,01,003,0299,0,2805,60,2865,4306,0,3,1,3,0,1,0,76.14,66.54 ,33.33
03,001,01,003,0300,0,2718,41,2759,3974,0,3,1,3,0,1,0,76.14,69.43 ,33.33
03,001,01,003,0301,0,1472,25,1497,2192,0,3,1,3,0,1,0,76.14,68.29 ,33.33
03,001,01,003,0302,0,1987,33,2020,3020,0,3,1,3,0,1,0,76.14,66.89 ,33.33
03,001,01,003,0303,0,1941,33,1974,2887,0,3,1,3,0,1,0,76.14,68.38 ,33.33
03,001,01,003,0304,0,2319,30,2349,3408,0,3,1,3,0,1,0,76.14,68.93 ,33.33
03,001,01,003,0305,0,2020,31,2051,3030,0,3,1,3,0,1,0,76.14,67.69 ,33.33
03,001,01,003,0306,0,1167,11,1178,1846,0,3,1,3,0,1,0,76.14,63.81 ,33.33
03,001,01,003,0307,0,2342,34,2376,3344,0,3,1,3,0,1,0,76.14,71.05 ,33.33
03,001,01,003,0308,0,1454,11,1465,2178,0,3,1,3,0,1,0,76.14,67.26 ,33.33
03,001,01,003,0309,0,1460,9,1469,2125,0,3,1,3,0,1,0,76.14,69.13 ,33.33
03,001,01,003,0310,0,1805,27,1832,2700,0,3,1,3,0,1,0,76.14,67.85 ,33.33
03,001,01,003,0311,0,997,11,1008,1441,0,3,1,3,0,1,0,76.14,69.95 ,33.33
03,001,01,003,0312,0,1751,18,1769,2656,0,3,1,3,0,1,0,76.14,66.60 ,33.33
03,001,01,003,0313,0,320,5,325,466,0,3,1,3,0,1,0,76.14,69.74 ,33.33
03,001,01,003,0314,0,2225,28,2253,3416,0,3,1,3,0,1,0,76.14,65.95 ,33.33
03,001,01,003,0315,0,1492,18,1510,1996,0,3,1,3,0,1,0,76.14,75.65 ,33.33
03,001,01,003,0316,0,1788,18,1806,2561,0,3,1,3,0,1,0,76.14,70.52 ,33.33
03,001,01,003,0317,0,1933,28,1961,2861,0,3,1,3,0,1,0,76.14,68.54 ,33.33
03,001,01,003,0318,0,1244,20,1264,1936,0,3,1,3,0,1,0,76.14,65.29 ,33.33
03,001,01,003,0319,0,1399,20,1419,2118,0,3,1,3,0,1,0,76.14,67.00 ,33.33
03,001,01,003,0320,0,1667,28,1695,2725,0,3,1,3,0,1,0,76.14,62.20 ,33.33
03,001,01,003,0321,0,2675,33,2708,4033,0,3,1,3,0,1,0,76.14,67.15 ,33.33
03,001,01,003,0322,0,1705,26,1731,2623,0,3,1,3,0,1,0,76.14,65.99 ,33.33
03,001,01,003,0323,0,2284,31,2315,3495,0,3,1,3,0,1,0,76.14,66.24 ,33.33
03,001,01,003,0324,0,1750,27,1777,2756,0,3,1,3,0,1,0,76.14,64.48 ,33.33
03,001,01,003,0325,0,1311,12,1323,1816,0,3,1,3,0,1,0,76.14,72.85 ,33.33
03,001,01,003,0326,0,1869,31,1900,2748,0,3,1,3,0,1,0,76.14,69.14 ,33.33
03,001,01,003,0327,0,2114,38,2152,3039,0,3,1,3,0,1,0,76.14,70.81 ,33.33
03,001,01,003,0328,0,1597,25,1622,2334,0,3,1,3,0,1,0,76.14,69.49 ,33.33
03,001,01,003,0329,0,2294,39,2333,3386,0,3,1,3,0,1,0,76.14,68.90 ,33.33
03,001,01,003,0330,0,2739,37,2776,3862,0,3,1,3,0,1,0,76.14,71.88 ,33.33
03,001,01,003,0331,0,1694,22,1716,2424,0,3,1,3,0,1,0,76.14,70.79 ,33.33
03,001,01,003,0332,0,1655,18,1673,2443,0,3,1,3,0,1,0,76.14,68.48 ,33.33
03,001,01,003,0333,0,1298,15,1313,1906,0,3,1,3,0,1,0,76.14,68.89 ,33.33
03,001,01,003,0334,0,1018,14,1032,1520,0,3,1,3,0,1,0,76.14,67.89 ,33.33
03,001,01,003,0335,0,1965,33,1998,2922,0,3,1,3,0,1,0,76.14,68.38 ,33.33
03,001,01,004,0336,0,1142,16,1158,1640,0,3,1,3,0,1,0,76.14,70.61 ,33.33
03,001,01,004,0337,0,752,11,763,1147,0,3,1,3,0,1,0,76.14,66.52 ,33.33
03,001,01,004,0338,0,1390,14,1404,2111,0,3,1,3,0,1,0,76.14,66.51 ,33.33
03,001,01,004,0339,0,2290,30,2320,3429,0,3,1,3,0,1,0,76.14,67.66 ,33.33
03,001,01,004,0340,0,1995,33,2028,2936,0,3,1,3,0,1,0,76.14,69.07 ,33.33
03,001,01,004,0341,0,2249,22,2271,3351,0,3,1,3,0,1,0,76.14,67.77 ,33.33
03,001,01,004,0342,0,2151,21,2172,3186,0,3,1,3,0,1,0,76.14,68.17 ,33.33
03,001,01,004,0343,0,871,15,886,1245,0,3,1,3,0,1,0,76.14,71.16 ,33.33
03,001,01,004,0344,0,1960,22,1982,2903,0,3,1,3,0,1,0,76.14,68.27 ,33.33
03,001,01,004,0345,0,2123,36,2159,3268,0,3,1,3,0,1,0,76.14,66.06 ,33.33
03,001,01,004,0346,0,1318,15,1333,1994,0,3,1,3,0,1,0,76.14,66.85 ,33.33
03,001,01,004,0347,0,1901,34,1935,2954,0,3,1,3,0,1,0,76.14,65.50 ,33.33
03,001,01,004,0348,0,1705,15,1720,2535,0,3,1,3,0,1,0,76.14,67.85 ,33.33
03,001,01,004,0349,0,2404,29,2433,3622,0,3,1,3,0,1,0,76.14,67.17 ,33.33
03,001,01,004,0350,0,2399,23,2422,3389,0,3,1,3,0,1,0,76.14,71.47 ,33.33
03,001,01,004,0351,0,2163,19,2182,3118,0,3,1,3,0,1,0,76.14,69.98 ,33.33
03,001,01,004,0352,0,1850,21,1871,2622,0,3,1,3,0,1,0,76.14,71.36 ,33.33
03,001,01,004,0353,0,1773,26,1799,2610,0,3,1,3,0,1,0,76.14,68.93 ,33.33
03,001,01,004,0354,0,2291,25,2316,3377,0,3,1,3,0,1,0,76.14,68.58 ,33.33
03,001,01,004,0355,0,2703,38,2741,3875,0,3,1,3,0,1,0,76.14,70.74 ,33.33
03,001,01,004,0356,0,2151,22,2173,3015,0,3,1,3,0,1,0,76.14,72.07 ,33.33
03,001,01,004,0357,0,2564,24,2588,3635,0,3,1,3,0,1,0,76.14,71.20 ,33.33
03,001,01,004,0358,0,2069,39,2108,3147,0,3,1,3,0,1,0,76.14,66.98 ,33.33
03,001,01,004,0359,0,1646,20,1666,2421,0,3,1,3,0,1,0,76.14,68.81 ,33.33
03,001,01,004,0360,0,2006,21,2027,2905,0,3,1,3,0,1,0,76.14,69.78 ,33.33
03,001,01,004,0361,0,3202,38,3240,4665,0,3,1,3,0,1,0,76.14,69.45 ,33.33
03,001,01,004,0362,0,2487,25,2512,3562,0,3,1,3,0,1,0,76.14,70.52 ,33.33
03,001,01,004,0363,0,3129,44,3173,4588,0,3,1,3,0,1,0,76.14,69.16 ,33.33
03,001,01,004,0364,0,2258,30,2288,3239,0,3,1,3,0,1,0,76.14,70.64 ,33.33
03,001,01,004,0365,0,1602,27,1629,2398,0,3,1,3,0,1,0,76.14,67.93 ,33.33
03,001,01,004,0366,0,2221,31,2252,3298,0,3,1,3,0,1,0,76.14,68.28 ,33.33
03,001,01,004,0367,0,2361,25,2386,3561,0,3,1,3,0,1,0,76.14,67.00 ,33.33
03,001,01,004,0368,0,2347,34,2381,3493,0,3,1,3,0,1,0,76.14,68.16 ,33.33
03,001,01,004,0369,0,1898,22,1920,2877,0,3,1,3,0,1,0,76.14,66.74 ,33.33
03,001,01,004,0370,0,1201,9,1210,1861,0,3,1,3,0,1,0,76.14,65.02 ,33.33
03,001,01,004,0371,0,2617,24,2641,3847,0,3,1,3,0,1,0,76.14,68.65 ,33.33
03,001,01,004,0372,0,2168,29,2197,3148,0,3,1,3,0,1,0,76.14,69.79 ,33.33
03,001,01,004,0373,0,1821,28,1849,2763,0,3,1,3,0,1,0,76.14,66.92 ,33.33
03,001,01,004,0374,0,1814,20,1834,2629,0,3,1,3,0,1,0,76.14,69.76 ,33.33
03,001,01,004,0375,0,1876,30,1906,2753,0,3,1,3,0,1,0,76.14,69.23 ,33.33
03,001,01,004,0376,0,1203,16,1219,1727,0,3,1,3,0,1,0,76.14,70.58 ,33.33
03,001,01,004,0377,0,2210,27,2237,3325,0,3,1,3,0,1,0,76.14,67.28 ,33.33
03,001,01,004,0378,0,2330,18,2348,3318,0,3,1,3,0,1,0,76.14,70.77 ,33.33
03,001,01,004,0379,0,2247,27,2274,3324,0,3,1,3,0,1,0,76.14,68.41 ,33.33
03,001,01,004,0380,0,2856,30,2886,4299,0,3,1,3,0,1,0,76.14,67.13 ,33.33
03,001,01,004,0381,0,1917,28,1945,2841,0,3,1,3,0,1,0,76.14,68.46 ,33.33
03,001,01,004,0382,0,808,27,835,1055,0,3,1,3,0,1,0,76.14,79.15 ,33.33
03,001,01,004,0383,0,640,18,658,855,0,3,1,3,0,1,0,76.14,76.96 ,33.33
03,001,01,004,0384,0,750,18,768,1034,0,3,1,3,0,1,0,76.14,74.27 ,33.33
03,001,01,004,0385,0,586,9,595,789,0,3,1,3,0,1,0,76.14,75.41 ,33.33
03,001,01,004,0386,0,1783,28,1811,2545,0,3,1,3,0,1,0,76.14,71.16 ,33.33
03,001,01,004,0387,0,1377,18,1395,2121,0,3,1,3,0,1,0,76.14,65.77 ,33.33
03,001,01,004,0388,0,1299,15,1314,1921,0,3,1,3,0,1,0,76.14,68.40 ,33.33
03,001,01,004,0389,0,1001,13,1014,1531,0,3,1,3,0,1,0,76.14,66.23 ,33.33
03,001,01,004,0390,0,1259,30,1289,1895,0,3,1,3,0,1,0,76.14,68.02 ,33.33
03,001,01,004,0391,0,1494,15,1509,2151,0,3,1,3,0,1,0,76.14,70.15 ,33.33
03,001,01,004,0392,0,1271,11,1282,1797,0,3,1,3,0,1,0,76.14,71.34 ,33.33
03,001,01,004,0393,0,1598,20,1618,2291,0,3,1,3,0,1,0,76.14,70.62 ,33.33
03,001,01,005,0394,0,2712,30,2742,4092,0,3,1,3,0,1,0,76.14,67.01 ,33.33
03,001,01,005,0395,0,2013,24,2037,2963,0,3,1,3,0,1,0,76.14,68.75 ,33.33
03,001,01,005,0396,0,2336,23,2359,3492,0,3,1,3,0,1,0,76.14,67.55 ,33.33
03,001,01,005,0397,0,1019,10,1029,1437,0,3,1,3,0,1,0,76.14,71.61 ,33.33
03,001,01,005,0398,0,2082,19,2101,3094,0,3,1,3,0,1,0,76.14,67.91 ,33.33
03,001,01,005,0399,0,1945,23,1968,2841,0,3,1,3,0,1,0,76.14,69.27 ,33.33
03,001,01,005,0400,0,1830,23,1853,2668,0,3,1,3,0,1,0,76.14,69.45 ,33.33
03,001,01,005,0401,0,1007,12,1019,1448,0,3,1,3,0,1,0,76.14,70.37 ,33.33
03,001,01,005,0402,0,739,5,744,1083,0,3,1,3,0,1,0,76.14,68.70 ,33.33
03,001,01,005,0403,0,2273,19,2292,3404,0,3,1,3,0,1,0,76.14,67.33 ,33.33
03,001,01,005,0404,0,1676,22,1698,2529,0,3,1,3,0,1,0,76.14,67.14 ,33.33
03,001,01,005,0405,0,2213,33,2246,3480,0,3,1,3,0,1,0,76.14,64.54 ,33.33
03,001,01,005,0406,0,2324,36,2360,3557,0,3,1,3,0,1,0,76.14,66.35 ,33.33
03,001,01,005,0407,0,1584,27,1611,2395,0,3,1,3,0,1,0,76.14,67.27 ,33.33
03,001,01,005,0408,0,1405,17,1422,2253,0,3,1,3,0,1,0,76.14,63.12 ,33.33
03,001,01,005,0409,0,1470,32,1502,2393,0,3,1,3,0,1,0,76.14,62.77 ,33.33
03,001,01,005,0410,0,1937,32,1969,3234,0,3,1,3,0,1,0,76.14,60.88 ,33.33
03,001,01,005,0411,0,2069,34,2103,3409,0,3,1,3,0,1,0,76.14,61.69 ,33.33
03,001,01,005,0412,0,1965,36,2001,3028,0,3,1,3,0,1,0,76.14,66.08 ,33.33
03,001,01,005,0413,0,1137,18,1155,1878,0,3,1,3,0,1,0,76.14,61.50 ,33.33
03,001,01,005,0414,0,1795,30,1825,2920,0,3,1,3,0,1,0,76.14,62.50 ,33.33
03,001,01,005,0415,0,939,15,954,1478,0,3,1,3,0,1,0,76.14,64.55 ,33.33
03,001,01,005,0416,0,1328,20,1348,1998,0,3,1,3,0,1,0,76.14,67.47 ,33.33
03,001,01,005,0417,0,1949,35,1984,2943,0,3,1,3,0,1,0,76.14,67.41 ,33.33
03,001,01,005,0418,0,2276,47,2323,3380,0,3,1,3,0,1,0,76.14,68.73 ,33.33
03,001,01,005,0419,0,2200,23,2223,3343,0,3,1,3,0,1,0,76.14,66.50 ,33.33
03,001,01,005,0420,0,1097,15,1112,1574,0,3,1,3,0,1,0,76.14,70.65 ,33.33
03,001,01,005,0421,0,2578,30,2608,3962,0,3,1,3,0,1,0,76.14,65.83 ,33.33
03,001,01,005,0422,0,731,12,743,1139,0,3,1,3,0,1,0,76.14,65.23 ,33.33
03,001,01,005,0423,0,959,15,974,1531,0,3,1,3,0,1,0,76.14,63.62 ,33.33
03,001,01,005,0424,0,2237,45,2282,3478,0,3,1,3,0,1,0,76.14,65.61 ,33.33
03,001,01,005,0425,0,2535,26,2561,3993,0,3,1,3,0,1,0,76.14,64.14 ,33.33
03,001,01,005,0426,0,2150,39,2189,3596,0,3,1,3,0,1,0,76.14,60.87 ,33.33
03,001,01,005,0427,0,1009,21,1030,1626,0,3,1,3,0,1,0,76.14,63.35 ,33.33
03,001,01,005,0428,0,2457,35,2492,3840,0,3,1,3,0,1,0,76.14,64.90 ,33.33
03,001,01,005,0429,0,1095,15,1110,1748,0,3,1,3,0,1,0,76.14,63.50 ,33.33
03,001,01,005,0430,0,1519,18,1537,2452,0,3,1,3,0,1,0,76.14,62.68 ,33.33
03,001,01,005,0431,0,2298,42,2340,3506,0,3,1,3,0,1,0,76.14,66.74 ,33.33
03,001,01,005,0432,0,1849,13,1862,2859,0,3,1,3,0,1,0,76.14,65.13 ,33.33
03,001,01,005,0433,0,2447,22,2469,3830,0,3,1,3,0,1,0,76.14,64.46 ,33.33
03,001,01,005,0434,0,1883,27,1910,3017,0,3,1,3,0,1,0,76.14,63.31 ,33.33
03,001,01,005,0435,0,1771,26,1797,2666,0,3,1,3,0,1,0,76.14,67.40 ,33.33
03,001,01,005,0436,0,1250,12,1262,1911,0,3,1,3,0,1,0,76.14,66.04 ,33.33
03,001,01,005,0437,0,2190,27,2217,3357,0,3,1,3,0,1,0,76.14,66.04 ,33.33
03,001,01,005,0438,0,2563,49,2612,4037,0,3,1,3,0,1,0,76.14,64.70 ,33.33
03,001,01,005,0439,0,1002,18,1020,1436,0,3,1,3,0,1,0,76.14,71.03 ,33.33
03,001,01,005,0440,0,1233,17,1250,2146,0,3,1,3,0,1,0,76.14,58.25 ,33.33
03,001,01,005,0441,0,1322,17,1339,1897,0,3,1,3,0,1,0,76.14,70.59 ,33.33
03,001,01,005,0442,0,2209,30,2239,3607,0,3,1,3,0,1,0,76.14,62.07 ,33.33
03,001,01,005,0443,0,2846,43,2889,4299,0,3,1,3,0,1,0,76.14,67.20 ,33.33
03,001,01,005,0444,0,1844,35,1879,3012,0,3,1,3,0,1,0,76.14,62.38 ,33.33
03,001,01,005,0445,0,2775,42,2817,4358,0,3,1,3,0,1,0,76.14,64.64 ,33.33
03,001,01,005,0446,0,1789,19,1808,2792,0,3,1,3,0,1,0,76.14,64.76 ,33.33
03,001,01,005,0447,0,2304,27,2331,3740,0,3,1,3,0,1,0,76.14,62.33 ,33.33
03,001,01,005,0448,0,2355,45,2400,3840,0,3,1,3,0,1,0,76.14,62.50 ,33.33
03,001,01,005,0449,0,1018,7,1025,1566,0,3,1,3,0,1,0,76.14,65.45 ,33.33
03,001,01,005,0450,0,1706,15,1721,2730,0,3,1,3,0,1,0,76.14,63.04 ,33.33
03,001,01,005,0451,0,1863,29,1892,3158,0,3,1,3,0,1,0,76.14,59.91 ,33.33
03,001,01,005,0452,0,1947,21,1968,3279,0,3,1,3,0,1,0,76.14,60.02 ,33.33
03,001,01,005,0453,0,1117,9,1126,1769,0,3,1,3,0,1,0,76.14,63.65 ,33.33
03,001,01,005,0454,0,1390,23,1413,2284,0,3,1,3,0,1,0,76.14,61.87 ,33.33
03,001,01,005,0455,0,1115,11,1126,1699,0,3,1,3,0,1,0,76.14,66.27 ,33.33
03,001,01,005,0456,0,1314,11,1325,2124,0,3,1,3,0,1,0,76.14,62.38 ,33.33
03,001,01,005,0457,0,1401,19,1420,2316,0,3,1,3,0,1,0,76.14,61.31 ,33.33
03,001,01,005,0458,0,2235,29,2264,3741,0,3,1,3,0,1,0,76.14,60.52 ,33.33
03,001,01,005,0459,0,2578,38,2616,4115,0,3,1,3,0,1,0,76.14,63.57 ,33.33
03,001,01,005,0460,0,1422,23,1445,2310,0,3,1,3,0,1,0,76.14,62.55 ,33.33
03,001,01,005,0461,0,1207,17,1224,1957,0,3,1,3,0,1,0,76.14,62.54 ,33.33
03,001,01,005,0462,0,1687,22,1709,2861,0,3,1,3,0,1,0,76.14,59.73 ,33.33
03,001,01,005,0463,0,3064,41,3105,4814,0,3,1,3,0,1,0,76.14,64.50 ,33.33
03,001,01,005,0464,0,2100,23,2123,3425,0,3,1,3,0,1,0,76.14,61.99 ,33.33
03,001,01,006,0465,0,935,19,954,1339,0,3,1,3,0,1,0,76.14,71.25 ,33.33
03,001,01,006,0466,0,758,14,772,1095,0,3,1,3,0,1,0,76.14,70.50 ,33.33
03,001,01,006,0467,0,1257,17,1274,1990,0,3,1,3,0,1,0,76.14,64.02 ,33.33
03,001,01,006,0468,0,812,8,820,1259,0,3,1,3,0,1,0,76.14,65.13 ,33.33
03,001,01,006,0469,0,587,11,598,882,0,3,1,3,0,1,0,76.14,67.80 ,33.33
03,001,01,006,0470,0,1558,14,1572,2158,0,3,1,3,0,1,0,76.14,72.85 ,33.33
03,001,01,006,0471,0,2645,23,2668,3931,0,3,1,3,0,1,0,76.14,67.87 ,33.33
03,001,01,006,0472,0,2783,38,2821,3943,0,3,1,3,0,1,0,76.14,71.54 ,33.33
03,001,01,006,0473,0,1723,24,1747,2489,0,3,1,3,0,1,0,76.14,70.19 ,33.33
03,001,01,006,0474,0,3561,48,3609,5341,0,3,1,3,0,1,0,76.14,67.57 ,33.33
03,001,01,006,0475,0,3874,28,3902,5844,0,3,1,3,0,1,0,76.14,66.77 ,33.33
03,001,01,006,0476,0,2019,27,2046,3085,0,3,1,3,0,1,0,76.14,66.32 ,33.33
03,001,01,006,0477,0,1425,7,1432,2113,0,3,1,3,0,1,0,76.14,67.77 ,33.33
03,001,01,006,0478,0,3713,34,3747,5451,0,3,1,3,0,1,0,76.14,68.74 ,33.33
03,001,01,006,0479,0,2354,30,2384,3538,0,3,1,3,0,1,0,76.14,67.38 ,33.33
03,001,01,006,0480,0,3358,44,3402,5096,0,3,1,3,0,1,0,76.14,66.76 ,33.33
03,001,01,006,0481,0,2423,18,2441,3559,0,3,1,3,0,1,0,76.14,68.59 ,33.33
03,001,01,006,0482,0,1550,20,1570,2388,0,3,1,3,0,1,0,76.14,65.75 ,33.33
03,001,01,006,0483,0,2203,23,2226,3241,0,3,1,3,0,1,0,76.14,68.68 ,33.33
03,001,01,006,0484,0,1728,19,1747,2506,0,3,1,3,0,1,0,76.14,69.71 ,33.33
03,001,01,006,0485,0,1882,22,1904,2816,0,3,1,3,0,1,0,76.14,67.61 ,33.33
03,001,01,006,0486,0,865,15,880,1359,0,3,1,3,0,1,0,76.14,64.75 ,33.33
03,001,01,006,0487,0,635,13,648,863,0,3,1,3,0,1,0,76.14,75.09 ,33.33
03,001,01,006,0488,0,1640,14,1654,2498,0,3,1,3,0,1,0,76.14,66.21 ,33.33
03,001,01,006,0489,0,2195,24,2219,3314,0,3,1,3,0,1,0,76.14,66.96 ,33.33
03,001,01,006,0490,0,2261,21,2282,3391,0,3,1,3,0,1,0,76.14,67.30 ,33.33
03,001,01,006,0491,0,2029,18,2047,2901,0,3,1,3,0,1,0,76.14,70.56 ,33.33
03,001,01,006,0492,0,2225,18,2243,3190,0,3,1,3,0,1,0,76.14,70.31 ,33.33
03,001,01,006,0493,0,3793,64,3857,5798,0,3,1,3,0,1,0,76.14,66.52 ,33.33
03,001,01,006,0494,0,2110,32,2142,3137,0,3,1,3,0,1,0,76.14,68.28 ,33.33
03,001,01,006,0495,0,2525,31,2556,3748,0,3,1,3,0,1,0,76.14,68.20 ,33.33
03,001,01,006,0496,0,2874,29,2903,4284,0,3,1,3,0,1,0,76.14,67.76 ,33.33
03,001,01,006,0497,0,2832,37,2869,4273,0,3,1,3,0,1,0,76.14,67.14 ,33.33
03,001,01,006,0498,0,1371,18,1389,1994,0,3,1,3,0,1,0,76.14,69.66 ,33.33
03,001,01,006,0499,0,319,6,325,524,0,3,1,3,0,1,0,76.14,62.02 ,33.33
03,001,01,006,0500,0,2754,35,2789,4028,0,3,1,3,0,1,0,76.14,69.24 ,33.33
03,001,01,006,0501,0,888,23,911,1484,0,3,1,3,0,1,0,76.14,61.39 ,33.33
03,001,01,006,0502,0,1114,21,1135,1704,0,3,1,3,0,1,0,76.14,66.61 ,33.33
03,001,01,006,0503,0,2153,43,2196,3253,0,3,1,3,0,1,0,76.14,67.51 ,33.33
03,001,01,006,0504,0,2238,33,2271,3413,0,3,1,3,0,1,0,76.14,66.54 ,33.33
03,001,01,006,0505,0,4898,78,4976,7539,0,3,1,3,0,1,0,76.14,66.00 ,33.33
03,001,01,006,0506,0,3701,49,3750,5760,0,3,1,3,0,1,0,76.14,65.10 ,33.33
03,001,01,006,0507,0,2357,40,2397,3556,0,3,1,3,0,1,0,76.14,67.41 ,33.33
03,001,01,006,0508,0,3193,25,3218,4677,0,3,1,3,0,1,0,76.14,68.80 ,33.33
03,001,01,006,0509,0,3567,47,3614,5485,0,3,1,3,0,1,0,76.14,65.89 ,33.33
03,001,01,006,0510,0,2412,37,2449,3667,0,3,1,3,0,1,0,76.14,66.78 ,33.33
03,001,01,006,0511,0,2468,23,2491,3686,0,3,1,3,0,1,0,76.14,67.58 ,33.33
03,001,01,006,0512,0,2066,14,2080,3089,0,3,1,3,0,1,0,76.14,67.34 ,33.33
03,001,01,006,0513,0,655,9,664,1058,0,3,1,3,0,1,0,76.14,62.76 ,33.33
03,001,01,006,0514,0,1800,26,1826,2710,0,3,1,3,0,1,0,76.14,67.38 ,33.33
03,001,01,006,0515,0,2064,35,2099,2967,0,3,1,3,0,1,0,76.14,70.74 ,33.33
03,001,01,006,0516,0,1251,24,1275,1961,0,3,1,3,0,1,0,76.14,65.02 ,33.33
03,001,01,006,0517,0,485,5,490,790,0,3,1,3,0,1,0,76.14,62.03 ,33.33
03,001,01,006,0518,0,1254,12,1266,1934,0,3,1,3,0,1,0,76.14,65.46 ,33.33
03,001,01,006,0519,0,1444,35,1479,2079,0,3,1,3,0,1,0,76.14,71.14 ,33.33
03,001,01,006,0520,0,913,23,936,1365,0,3,1,3,0,1,0,76.14,68.57 ,33.33
03,001,01,006,0521,0,717,10,727,1043,0,3,1,3,0,1,0,76.14,69.70 ,33.33
03,001,01,006,0522,0,382,10,392,598,0,3,1,3,0,1,0,76.14,65.55 ,33.33
03,001,01,007,0523,0,702,12,714,1081,0,3,1,3,0,1,0,76.14,66.05 ,33.33
03,001,01,007,0524,0,880,13,893,1178,0,3,1,3,0,1,0,76.14,75.81 ,33.33
03,001,01,007,0525,0,1882,41,1923,2790,0,3,1,3,0,1,0,76.14,68.92 ,33.33
03,001,01,007,0526,0,1415,30,1445,2221,0,3,1,3,0,1,0,76.14,65.06 ,33.33
03,001,01,007,0527,0,1239,38,1277,1942,0,3,1,3,0,1,0,76.14,65.76 ,33.33
03,001,01,007,0528,0,2446,43,2489,3796,0,3,1,3,0,1,0,76.14,65.57 ,33.33
03,001,01,007,0529,0,1649,26,1675,2473,0,3,1,3,0,1,0,76.14,67.73 ,33.33
03,001,01,007,0530,0,2006,32,2038,3250,0,3,1,3,0,1,0,76.14,62.71 ,33.33
03,001,01,007,0531,0,1188,19,1207,1764,0,3,1,3,0,1,0,76.14,68.42 ,33.33
03,001,01,007,0532,0,877,8,885,1311,0,3,1,3,0,1,0,76.14,67.51 ,33.33
03,001,01,007,0533,0,602,6,608,805,0,3,1,3,0,1,0,76.14,75.53 ,33.33
03,001,01,007,0534,0,1510,25,1535,2347,0,3,1,3,0,1,0,76.14,65.40 ,33.33
03,001,01,007,0535,0,2164,28,2192,3372,0,3,1,3,0,1,0,76.14,65.01 ,33.33
03,001,01,007,0536,0,2369,37,2406,3545,0,3,1,3,0,1,0,76.14,67.87 ,33.33
03,001,01,007,0537,0,2299,48,2347,3377,0,3,1,3,0,1,0,76.14,69.50 ,33.33
03,001,01,007,0538,0,2102,46,2148,3173,0,3,1,3,0,1,0,76.14,67.70 ,33.33
03,001,01,007,0539,0,2098,37,2135,3160,0,3,1,3,0,1,0,76.14,67.56 ,33.33
03,001,01,007,0540,0,1741,30,1771,2751,0,3,1,3,0,1,0,76.14,64.38 ,33.33
03,001,01,007,0541,0,1449,22,1471,2091,0,3,1,3,0,1,0,76.14,70.35 ,33.33
03,001,01,007,0542,0,1752,22,1774,2724,0,3,1,3,0,1,0,76.14,65.12 ,33.33
03,001,01,007,0543,0,1897,30,1927,2856,0,3,1,3,0,1,0,76.14,67.47 ,33.33
03,001,01,007,0544,0,1285,15,1300,1992,0,3,1,3,0,1,0,76.14,65.26 ,33.33
03,001,01,007,0545,0,3040,43,3083,4823,0,3,1,3,0,1,0,76.14,63.92 ,33.33
03,001,01,007,0546,0,2041,24,2065,3108,0,3,1,3,0,1,0,76.14,66.44 ,33.33
03,001,01,007,0547,0,1312,29,1341,2080,0,3,1,3,0,1,0,76.14,64.47 ,33.33
03,001,01,007,0548,0,3136,47,3183,5211,0,3,1,3,0,1,0,76.14,61.08 ,33.33
03,001,01,007,0549,0,1100,16,1116,1557,0,3,1,3,0,1,0,76.14,71.68 ,33.33
03,001,01,007,0550,0,2386,49,2435,3699,0,3,1,3,0,1,0,76.14,65.83 ,33.33
03,001,01,007,0551,0,658,8,666,984,0,3,1,3,0,1,0,76.14,67.68 ,33.33
03,001,01,007,0552,0,2557,38,2595,3885,0,3,1,3,0,1,0,76.14,66.80 ,33.33
03,001,01,007,0553,0,3591,49,3640,5591,0,3,1,3,0,1,0,76.14,65.10 ,33.33
03,001,01,007,0554,0,1365,19,1384,1950,0,3,1,3,0,1,0,76.14,70.97 ,33.33
03,001,01,007,0555,0,1894,35,1929,2985,0,3,1,3,0,1,0,76.14,64.62 ,33.33
03,001,01,007,0556,0,2015,30,2045,3087,0,3,1,3,0,1,0,76.14,66.25 ,33.33
03,001,01,007,0557,0,1862,26,1888,2979,0,3,1,3,0,1,0,76.14,63.38 ,33.33
03,001,01,007,0558,0,2536,39,2575,4048,0,3,1,3,0,1,0,76.14,63.61 ,33.33
03,001,01,007,0559,0,1661,36,1697,2566,0,3,1,3,0,1,0,76.14,66.13 ,33.33
03,001,01,007,0560,0,2681,36,2717,4196,0,3,1,3,0,1,0,76.14,64.75 ,33.33
03,001,01,007,0561,0,2570,42,2612,3946,0,3,1,3,0,1,0,76.14,66.19 ,33.33
03,001,01,007,0562,0,1555,33,1588,2378,0,3,1,3,0,1,0,76.14,66.78 ,33.33
03,001,01,008,0563,0,2580,32,2612,3804,0,3,1,3,0,1,0,76.14,68.66 ,33.33
03,001,01,008,0564,0,1623,26,1649,2485,0,3,1,3,0,1,0,76.14,66.36 ,33.33
03,001,01,008,0565,0,1815,30,1845,3090,0,3,1,3,0,1,0,76.14,59.71 ,33.33
03,001,01,008,0566,0,2245,36,2281,3551,0,3,1,3,0,1,0,76.14,64.24 ,33.33
03,001,01,008,0567,0,1832,32,1864,2789,0,3,1,3,0,1,0,76.14,66.83 ,33.33
03,001,01,008,0568,0,1981,37,2018,3373,0,3,1,3,0,1,0,76.14,59.83 ,33.33
03,001,01,008,0569,0,1363,21,1384,2164,0,3,1,3,0,1,0,76.14,63.96 ,33.33
03,001,01,008,0570,0,1127,16,1143,1822,0,3,1,3,0,1,0,76.14,62.73 ,33.33
03,001,01,008,0571,0,1199,27,1226,1810,0,3,1,3,0,1,0,76.14,67.73 ,33.33
03,001,01,008,0572,0,1921,30,1951,2898,0,3,1,3,0,1,0,76.14,67.32 ,33.33
03,001,01,008,0573,0,1240,19,1259,1938,0,3,1,3,0,1,0,76.14,64.96 ,33.33
03,001,01,008,0574,0,639,7,646,878,0,3,1,3,0,1,0,76.14,73.58 ,33.33
03,001,01,008,0575,0,752,16,768,1064,0,3,1,3,0,1,0,76.14,72.18 ,33.33
03,001,01,008,0576,0,1220,18,1238,1756,0,3,1,3,0,1,0,76.14,70.50 ,33.33
03,001,01,008,0577,0,1744,27,1771,2513,0,3,1,3,0,1,0,76.14,70.47 ,33.33
03,001,01,008,0578,0,2407,32,2439,3388,0,3,1,3,0,1,0,76.14,71.99 ,33.33
03,001,01,008,0579,0,1358,17,1375,1950,0,3,1,3,0,1,0,76.14,70.51 ,33.33
03,001,01,008,0580,0,1743,18,1761,2490,0,3,1,3,0,1,0,76.14,70.72 ,33.33
03,001,01,008,0581,0,1445,31,1476,2161,0,3,1,3,0,1,0,76.14,68.30 ,33.33
03,001,01,008,0582,0,1683,17,1700,2497,0,3,1,3,0,1,0,76.14,68.08 ,33.33
03,001,01,008,0583,0,745,9,754,1048,0,3,1,3,0,1,0,76.14,71.95 ,33.33
03,001,01,008,0584,0,2298,33,2331,3703,0,3,1,3,0,1,0,76.14,62.95 ,33.33
03,001,01,008,0585,0,1852,30,1882,2700,0,3,1,3,0,1,0,76.14,69.70 ,33.33
03,001,01,008,0586,0,1806,41,1847,3051,0,3,1,3,0,1,0,76.14,60.54 ,33.33
03,001,01,008,0587,0,1363,26,1389,2234,0,3,1,3,0,1,0,76.14,62.18 ,33.33
03,001,01,008,0588,0,1594,33,1627,2405,0,3,1,3,0,1,0,76.14,67.65 ,33.33
03,001,01,008,0589,0,1503,21,1524,2289,0,3,1,3,0,1,0,76.14,66.58 ,33.33
03,001,01,008,0590,0,1691,23,1714,2627,0,3,1,3,0,1,0,76.14,65.25 ,33.33
03,001,01,008,0591,0,1200,17,1217,1834,0,3,1,3,0,1,0,76.14,66.36 ,33.33
03,001,01,008,0592,0,1124,21,1145,1797,0,3,1,3,0,1,0,76.14,63.72 ,33.33
03,001,01,008,0593,0,1591,25,1616,2381,0,3,1,3,0,1,0,76.14,67.87 ,33.33
03,001,01,008,0594,0,717,13,730,1029,0,3,1,3,0,1,0,76.14,70.94 ,33.33
03,001,01,008,0595,0,735,13,748,1045,0,3,1,3,0,1,0,76.14,71.58 ,33.33
03,001,01,008,0596,0,738,9,747,1073,0,3,1,3,0,1,0,76.14,69.62 ,33.33
03,001,01,008,0597,0,743,18,761,1083,0,3,1,3,0,1,0,76.14,70.27 ,33.33
03,001,01,008,0598,0,539,4,543,740,0,3,1,3,0,1,0,76.14,73.38 ,33.33
03,001,01,008,0599,0,715,16,731,1047,0,3,1,3,0,1,0,76.14,69.82 ,33.33
03,001,01,009,0600,0,328,5,333,438,0,3,1,3,0,1,0,76.14,76.03 ,33.33
03,001,01,009,0601,0,555,5,560,762,0,3,1,3,0,1,0,76.14,73.49 ,33.33
03,001,01,009,0602,0,950,10,960,1254,0,3,1,3,0,1,0,76.14,76.56 ,33.33
03,001,01,009,0603,0,1191,21,1212,1594,0,3,1,3,0,1,0,76.14,76.04 ,33.33
03,001,01,009,0604,0,587,12,599,772,0,3,1,3,0,1,0,76.14,77.59 ,33.33
03,001,01,009,0605,0,2312,38,2350,3206,0,3,1,3,0,1,0,76.14,73.30 ,33.33
03,001,01,009,0606,0,1761,35,1796,2697,0,3,1,3,0,1,0,76.14,66.59 ,33.33
03,001,01,009,0607,0,1655,36,1691,2239,0,3,1,3,0,1,0,76.14,75.52 ,33.33
03,001,01,009,0608,0,1808,18,1826,2436,0,3,1,3,0,1,0,76.14,74.96 ,33.33
03,001,01,009,0609,0,2469,46,2515,3349,0,3,1,3,0,1,0,76.14,75.10 ,33.33
03,001,01,009,0610,0,542,12,554,688,0,3,1,3,0,1,0,76.14,80.52 ,33.33
03,001,01,009,0611,0,743,8,751,1021,0,3,1,3,0,1,0,76.14,73.56 ,33.33
03,001,01,009,0612,0,2738,40,2778,4184,0,3,1,3,0,1,0,76.14,66.40 ,33.33
03,001,01,009,0613,0,2025,47,2072,2894,0,3,1,3,0,1,0,76.14,71.60 ,33.33
03,001,01,009,0614,0,1745,35,1780,2596,0,3,1,3,0,1,0,76.14,68.57 ,33.33
03,001,01,009,0615,0,1789,39,1828,2896,0,3,1,3,0,1,0,76.14,63.12 ,33.33
03,001,01,009,0616,0,1808,36,1844,2772,0,3,1,3,0,1,0,76.14,66.52 ,33.33
03,001,01,009,0617,0,2310,37,2347,3556,0,3,1,3,0,1,0,76.14,66.00 ,33.33
03,001,01,009,0618,0,2354,48,2402,3608,0,3,1,3,0,1,0,76.14,66.57 ,33.33
03,001,01,009,0619,0,177,4,181,254,0,3,1,3,0,1,0,76.14,71.26 ,33.33
03,001,01,010,0620,0,295,5,300,403,0,3,1,3,0,1,0,76.14,74.44 ,33.33
03,001,01,010,0621,0,347,4,351,465,0,3,1,3,0,1,0,76.14,75.48 ,33.33
03,001,01,010,0622,0,1256,25,1281,1838,0,3,1,3,0,1,0,76.14,69.70 ,33.33
03,001,01,010,0623,0,516,10,526,700,0,3,1,3,0,1,0,76.14,75.14 ,33.33
03,001,01,010,0624,0,637,13,650,842,0,3,1,3,0,1,0,76.14,77.20 ,33.33
03,001,01,010,0625,0,2354,32,2386,3384,0,3,1,3,0,1,0,76.14,70.51 ,33.33
03,001,01,010,0626,0,1447,27,1474,2301,0,3,1,3,0,1,0,76.14,64.06 ,33.33
03,001,01,010,0627,0,1077,13,1090,1529,0,3,1,3,0,1,0,76.14,71.29 ,33.33
03,001,01,010,0628,0,1394,19,1413,2144,0,3,1,3,0,1,0,76.14,65.90 ,33.33
03,001,01,010,0629,0,1707,35,1742,2595,0,3,1,3,0,1,0,76.14,67.13 ,33.33
03,001,01,010,0630,0,2827,45,2872,4288,0,3,1,3,0,1,0,76.14,66.98 ,33.33
03,001,01,010,0631,0,2795,62,2857,4350,0,3,1,3,0,1,0,76.14,65.68 ,33.33
03,001,01,010,0632,0,3010,58,3068,4575,0,3,1,3,0,1,0,76.14,67.06 ,33.33
03,001,01,010,0633,0,1952,31,1983,2728,0,3,1,3,0,1,0,76.14,72.69 ,33.33
03,001,01,010,0634,0,593,13,606,819,0,3,1,3,0,1,0,76.14,73.99 ,33.33
03,001,01,010,0635,0,696,14,710,954,0,3,1,3,0,1,0,76.14,74.42 ,33.33
03,001,01,010,0636,0,331,6,337,464,0,3,1,3,0,1,0,76.14,72.63 ,33.33
03,001,01,010,0637,0,577,12,589,872,0,3,1,3,0,1,0,76.14,67.55 ,33.33
03,001,01,010,0638,0,544,9,553,837,0,3,1,3,0,1,0,76.14,66.07 ,33.33
03,001,01,010,0639,0,824,13,837,1108,0,3,1,3,0,1,0,76.14,75.54 ,33.33
03,001,01,010,0640,0,1210,17,1227,1714,0,3,1,3,0,1,0,76.14,71.59 ,33.33
03,001,01,010,0641,0,1568,32,1600,2195,0,3,1,3,0,1,0,76.14,72.89 ,33.33
03,001,01,010,0642,0,627,5,632,838,0,3,1,3,0,1,0,76.14,75.42 ,33.33
03,001,01,010,0643,0,846,19,865,1296,0,3,1,3,0,1,0,76.14,66.74 ,33.33
03,001,01,010,0644,0,1016,21,1037,1577,0,3,1,3,0,1,0,76.14,65.76 ,33.33
03,001,01,011,0645,0,472,6,478,591,0,3,1,3,0,1,0,76.14,80.88 ,33.33
03,001,01,011,0646,0,747,7,754,926,0,3,1,3,0,1,0,76.14,81.43 ,33.33
03,001,01,011,0647,0,915,21,936,1211,0,3,1,3,0,1,0,76.14,77.29 ,33.33
03,001,01,011,0648,0,967,16,983,1328,0,3,1,3,0,1,0,76.14,74.02 ,33.33
03,001,01,011,0649,0,389,3,392,559,0,3,1,3,0,1,0,76.14,70.13 ,33.33
03,001,01,011,0650,0,1540,29,1569,2231,0,3,1,3,0,1,0,76.14,70.33 ,33.33
03,001,01,011,0651,0,552,15,567,698,0,3,1,3,0,1,0,76.14,81.23 ,33.33
03,001,01,011,0652,0,894,13,907,1236,0,3,1,3,0,1,0,76.14,73.38 ,33.33
03,001,01,011,0653,0,832,9,841,1105,0,3,1,3,0,1,0,76.14,76.11 ,33.33
03,001,01,011,0654,0,4512,72,4584,6771,0,3,1,3,0,1,0,76.14,67.70 ,33.33
03,001,01,011,0655,0,3318,56,3374,4790,0,3,1,3,0,1,0,76.14,70.44 ,33.33
03,001,01,011,0656,0,910,13,923,1275,0,3,1,3,0,1,0,76.14,72.39 ,33.33
03,001,01,011,0657,0,953,13,966,1447,0,3,1,3,0,1,0,76.14,66.76 ,33.33
03,001,01,011,0658,0,652,14,666,880,0,3,1,3,0,1,0,76.14,75.68 ,33.33
03,001,01,011,0659,0,443,11,454,665,0,3,1,3,0,1,0,76.14,68.27 ,33.33
03,001,01,011,0660,0,537,9,546,765,0,3,1,3,0,1,0,76.14,71.37 ,33.33
03,001,01,011,0661,0,2223,23,2246,3354,0,3,1,3,0,1,0,76.14,66.96 ,33.33
03,001,01,011,0662,0,2354,37,2391,3621,0,3,1,3,0,1,0,76.14,66.03 ,33.33
03,001,01,011,0663,0,1984,42,2026,2892,0,3,1,3,0,1,0,76.14,70.06 ,33.33
03,001,01,011,0664,0,598,10,608,864,0,3,1,3,0,1,0,76.14,70.37 ,33.33
03,001,01,011,0665,0,1061,16,1077,1780,0,3,1,3,0,1,0,76.14,60.51 ,33.33
03,001,01,011,0666,0,4719,87,4806,7084,0,3,1,3,0,1,0,76.14,67.84 ,33.33
03,001,01,011,0667,0,2417,49,2466,3664,0,3,1,3,0,1,0,76.14,67.30 ,33.33
03,001,01,011,0668,0,1187,18,1205,1672,0,3,1,3,0,1,0,76.14,72.07 ,33.33
03,001,01,011,0669,0,689,12,701,991,0,3,1,3,0,1,0,76.14,70.74 ,33.33
03,001,01,011,0670,0,610,10,620,844,0,3,1,3,0,1,0,76.14,73.46 ,33.33
03,001,01,011,0671,0,888,21,909,1361,0,3,1,3,0,1,0,76.14,66.79 ,33.33
03,001,01,011,0672,0,538,7,545,741,0,3,1,3,0,1,0,76.14,73.55 ,33.33
03,001,01,011,0673,0,558,7,565,775,0,3,1,3,0,1,0,76.14,72.90 ,33.33
03,001,01,011,0674,0,427,6,433,600,0,3,1,3,0,1,0,76.14,72.17 ,33.33
03,001,01,011,0675,0,753,11,764,1082,0,3,1,3,0,1,0,76.14,70.61 ,33.33
03,001,01,011,0676,0,1862,29,1891,2636,0,3,1,3,0,1,0,76.14,71.74 ,33.33
03,001,01,011,0677,0,2092,45,2137,2989,0,3,1,3,0,1,0,76.14,71.50 ,33.33
03,001,01,012,0678,0,982,15,997,1253,0,3,1,3,0,1,0,76.14,79.57 ,33.33
03,001,01,012,0679,0,883,4,887,1238,0,3,1,3,0,1,0,76.14,71.65 ,33.33
03,001,01,012,0680,0,741,7,748,987,0,3,1,3,0,1,0,76.14,75.79 ,33.33
03,001,01,012,0681,0,1721,14,1735,2496,0,3,1,3,0,1,0,76.14,69.51 ,33.33
03,001,01,012,0682,0,441,4,445,596,0,3,1,3,0,1,0,76.14,74.66 ,33.33
03,001,01,012,0683,0,3396,36,3432,4371,0,3,1,3,0,1,0,76.14,78.52 ,33.33
03,001,01,012,0684,0,3218,34,3252,4248,0,3,1,3,0,1,0,76.14,76.55 ,33.33
03,001,01,012,0685,0,1534,13,1547,1996,0,3,1,3,0,1,0,76.14,77.51 ,33.33
03,001,01,012,0686,0,1783,15,1798,2332,0,3,1,3,0,1,0,76.14,77.10 ,33.33
03,001,01,012,0687,0,1563,24,1587,2161,0,3,1,3,0,1,0,76.14,73.44 ,33.33
03,001,01,012,0688,0,1126,17,1143,1598,0,3,1,3,0,1,0,76.14,71.53 ,33.33
03,001,01,012,0689,0,3288,37,3325,4473,0,3,1,3,0,1,0,76.14,74.33 ,33.33
03,001,01,012,0690,0,1812,14,1826,2368,0,3,1,3,0,1,0,76.14,77.11 ,33.33
03,001,01,012,0691,0,960,12,972,1314,0,3,1,3,0,1,0,76.14,73.97 ,33.33
03,001,01,012,0692,0,859,6,865,1159,0,3,1,3,0,1,0,76.14,74.63 ,33.33
03,001,01,012,0693,0,311,3,314,407,0,3,1,3,0,1,0,76.14,77.15 ,33.33
03,001,01,012,0694,0,1699,25,1724,2226,0,3,1,3,0,1,0,76.14,77.45 ,33.33
03,001,01,012,0695,0,1027,14,1041,1369,0,3,1,3,0,1,0,76.14,76.04 ,33.33
03,001,01,012,0696,0,2408,21,2429,3254,0,3,1,3,0,1,0,76.14,74.65 ,33.33
03,001,01,012,0697,0,1579,16,1595,2375,0,3,1,3,0,1,0,76.14,67.16 ,33.33
03,001,01,012,0698,0,744,9,753,1105,0,3,1,3,0,1,0,76.14,68.14 ,33.33
03,001,01,012,0699,0,1064,9,1073,1547,0,3,1,3,0,1,0,76.14,69.36 ,33.33
03,001,01,012,0700,0,2948,34,2982,4308,0,3,1,3,0,1,0,76.14,69.22 ,33.33
03,001,01,012,0701,0,1014,13,1027,1494,0,3,1,3,0,1,0,76.14,68.74 ,33.33
03,001,01,012,0702,0,1921,29,1950,2736,0,3,1,3,0,1,0,76.14,71.27 ,33.33
03,001,01,012,0703,0,1117,17,1134,1639,0,3,1,3,0,1,0,76.14,69.19 ,33.33
03,001,01,012,0704,0,3675,54,3729,5379,0,3,1,3,0,1,0,76.14,69.33 ,33.33
03,001,01,012,0705,0,2205,19,2224,3341,0,3,1,3,0,1,0,76.14,66.57 ,33.33
03,001,01,012,0706,0,3698,41,3739,5563,0,3,1,3,0,1,0,76.14,67.21 ,33.33
03,001,01,012,0707,0,2591,42,2633,3811,0,3,1,3,0,1,0,76.14,69.09 ,33.33
03,001,01,012,0708,0,1385,14,1399,2030,0,3,1,3,0,1,0,76.14,68.92 ,33.33
03,001,01,012,0709,0,2087,15,2102,2994,0,3,1,3,0,1,0,76.14,70.21 ,33.33
03,001,01,013,0710,0,631,5,636,847,0,3,1,3,0,1,0,76.14,75.09 ,33.33
03,001,01,013,0711,0,1167,9,1176,1643,0,3,1,3,0,1,0,76.14,71.58 ,33.33
03,001,01,013,0712,0,1025,11,1036,1494,0,3,1,3,0,1,0,76.14,69.34 ,33.33
03,001,01,013,0713,0,451,8,459,646,0,3,1,3,0,1,0,76.14,71.05 ,33.33
03,001,01,013,0714,0,1093,21,1114,1606,0,3,1,3,0,1,0,76.14,69.36 ,33.33
03,001,01,013,0715,0,906,15,921,1304,0,3,1,3,0,1,0,76.14,70.63 ,33.33
03,001,01,013,0716,0,3982,44,4026,5803,0,3,1,3,0,1,0,76.14,69.38 ,33.33
03,001,01,013,0717,0,1539,16,1555,2199,0,3,1,3,0,1,0,76.14,70.71 ,33.33
03,001,01,013,0718,0,888,14,902,1255,0,3,1,3,0,1,0,76.14,71.87 ,33.33
03,001,01,013,0719,0,198,1,199,333,0,3,1,3,0,1,0,76.14,59.76 ,33.33
03,001,01,013,0720,0,378,4,382,598,0,3,1,3,0,1,0,76.14,63.88 ,33.33
03,001,01,013,0721,0,248,3,251,408,0,3,1,3,0,1,0,76.14,61.52 ,33.33
03,001,01,013,0722,0,78,1,79,114,0,3,1,3,0,1,0,76.14,69.30 ,33.33
03,001,01,013,0723,0,1194,21,1215,1755,0,3,1,3,0,1,0,76.14,69.23 ,33.33
03,001,01,013,0724,0,1953,41,1994,3031,0,3,1,3,0,1,0,76.14,65.79 ,33.33
03,001,01,013,0725,0,967,18,985,1400,0,3,1,3,0,1,0,76.14,70.36 ,33.33
03,001,01,013,0726,0,1360,18,1378,1975,0,3,1,3,0,1,0,76.14,69.77 ,33.33
03,001,01,013,0727,0,412,3,415,631,0,3,1,3,0,1,0,76.14,65.77 ,33.33
03,001,01,013,0728,0,460,6,466,709,0,3,1,3,0,1,0,76.14,65.73 ,33.33
03,001,01,013,0729,0,329,7,336,543,0,3,1,3,0,1,0,76.14,61.88 ,33.33
03,001,01,013,0730,0,214,2,216,315,0,3,1,3,0,1,0,76.14,68.57 ,33.33
03,001,01,013,0731,0,320,8,328,494,0,3,1,3,0,1,0,76.14,66.40 ,33.33
03,001,01,013,0732,0,241,6,247,364,0,3,1,3,0,1,0,76.14,67.86 ,33.33
03,001,01,013,0733,0,231,8,239,327,0,3,1,3,0,1,0,76.14,73.09 ,33.33
03,001,01,013,0734,0,342,10,352,523,0,3,1,3,0,1,0,76.14,67.30 ,33.33
03,001,01,013,0735,0,344,8,352,502,0,3,1,3,0,1,0,76.14,70.12 ,33.33
03,001,01,013,0736,0,518,3,521,775,0,3,1,3,0,1,0,76.14,67.23 ,33.33
03,001,01,013,0737,0,245,5,250,391,0,3,1,3,0,1,0,76.14,63.94 ,33.33
03,001,01,013,0738,0,153,0,153,209,0,3,1,3,0,1,0,76.14,73.21 ,33.33
03,001,01,013,0739,0,328,5,333,530,0,3,1,3,0,1,0,76.14,62.83 ,33.33
03,001,01,013,0740,0,721,16,737,1051,0,3,1,3,0,1,0,76.14,70.12 ,33.33
03,001,01,013,0741,0,1144,16,1160,1723,0,3,1,3,0,1,0,76.14,67.32 ,33.33
03,001,01,013,0742,0,683,13,696,1045,0,3,1,3,0,1,0,76.14,66.60 ,33.33
03,001,01,014,0743,0,2113,33,2146,3080,0,3,1,3,0,1,0,76.14,69.68 ,33.33
03,001,01,014,0744,0,1630,23,1653,2557,0,3,1,3,0,1,0,76.14,64.65 ,33.33
03,001,01,014,0745,0,1459,16,1475,2021,0,3,1,3,0,1,0,76.14,72.98 ,33.33
03,001,01,014,0746,0,1611,18,1629,2246,0,3,1,3,0,1,0,76.14,72.53 ,33.33
03,001,01,014,0747,0,941,10,951,1332,0,3,1,3,0,1,0,76.14,71.40 ,33.33
03,001,01,014,0748,0,1323,25,1348,1957,0,3,1,3,0,1,0,76.14,68.88 ,33.33
03,001,01,014,0749,0,1432,22,1454,2200,0,3,1,3,0,1,0,76.14,66.09 ,33.33
03,001,01,014,0750,0,894,9,903,1317,0,3,1,3,0,1,0,76.14,68.56 ,33.33
03,001,01,014,0751,0,1450,21,1471,2184,0,3,1,3,0,1,0,76.14,67.35 ,33.33
03,001,01,014,0752,0,1831,25,1856,2934,0,3,1,3,0,1,0,76.14,63.26 ,33.33
03,001,01,014,0753,0,3023,42,3065,4866,0,3,1,3,0,1,0,76.14,62.99 ,33.33
03,001,01,014,0754,0,2504,35,2539,3881,0,3,1,3,0,1,0,76.14,65.42 ,33.33
03,001,01,014,0755,0,444,3,447,615,0,3,1,3,0,1,0,76.14,72.68 ,33.33
03,001,01,014,0756,0,1605,29,1634,2453,0,3,1,3,0,1,0,76.14,66.61 ,33.33
03,001,01,014,0757,0,1322,21,1343,2169,0,3,1,3,0,1,0,76.14,61.92 ,33.33
03,001,01,014,0758,0,1053,15,1068,1612,0,3,1,3,0,1,0,76.14,66.25 ,33.33
03,001,01,014,0759,0,1108,17,1125,1643,0,3,1,3,0,1,0,76.14,68.47 ,33.33
03,001,01,014,0760,0,1840,29,1869,2636,0,3,1,3,0,1,0,76.14,70.90 ,33.33
03,001,01,014,0761,0,919,17,936,1367,0,3,1,3,0,1,0,76.14,68.47 ,33.33
03,001,01,014,0762,0,1474,17,1491,2340,0,3,1,3,0,1,0,76.14,63.72 ,33.33
03,001,01,014,0763,0,1976,28,2004,3082,0,3,1,3,0,1,0,76.14,65.02 ,33.33
03,001,01,014,0764,0,1540,19,1559,2256,0,3,1,3,0,1,0,76.14,69.10 ,33.33
03,001,01,014,0765,0,1426,23,1449,2124,0,3,1,3,0,1,0,76.14,68.22 ,33.33
03,001,01,014,0766,0,1149,13,1162,1779,0,3,1,3,0,1,0,76.14,65.32 ,33.33
03,001,01,014,0767,0,1375,24,1399,1959,0,3,1,3,0,1,0,76.14,71.41 ,33.33
03,001,01,014,0768,0,1892,25,1917,2675,0,3,1,3,0,1,0,76.14,71.66 ,33.33
03,001,01,014,0769,0,1027,16,1043,1474,0,3,1,3,0,1,0,76.14,70.76 ,33.33
03,001,01,014,0770,0,1114,14,1128,1665,0,3,1,3,0,1,0,76.14,67.75 ,33.33
03,001,01,014,0771,0,2010,27,2037,3107,0,3,1,3,0,1,0,76.14,65.56 ,33.33
03,001,01,014,0772,0,1020,11,1031,1668,0,3,1,3,0,1,0,76.14,61.81 ,33.33
03,001,01,014,0773,0,1984,46,2030,3087,0,3,1,3,0,1,0,76.14,65.76 ,33.33
03,001,01,014,0774,0,2067,39,2106,3314,0,3,1,3,0,1,0,76.14,63.55 ,33.33
03,001,01,014,0775,0,1366,30,1396,2024,0,3,1,3,0,1,0,76.14,68.97 ,33.33
03,001,01,014,0776,0,811,17,828,1291,0,3,1,3,0,1,0,76.14,64.14 ,33.33
03,001,01,014,0777,0,1585,26,1611,2398,0,3,1,3,0,1,0,76.14,67.18 ,33.33
03,001,01,014,0778,0,1640,23,1663,2496,0,3,1,3,0,1,0,76.14,66.63 ,33.33
03,001,01,015,0779,0,2199,35,2234,3282,0,3,1,3,0,1,0,76.14,68.07 ,33.33
03,001,01,015,0780,0,750,18,768,1073,0,3,1,3,0,1,0,76.14,71.58 ,33.33
03,001,01,015,0781,0,1482,24,1506,2394,0,3,1,3,0,1,0,76.14,62.91 ,33.33
03,001,01,015,0782,0,767,13,780,1141,0,3,1,3,0,1,0,76.14,68.36 ,33.33
03,001,01,015,0783,0,1368,27,1395,2109,0,3,1,3,0,1,0,76.14,66.15 ,33.33
03,001,01,015,0784,0,2082,28,2110,3215,0,3,1,3,0,1,0,76.14,65.63 ,33.33
03,001,01,015,0785,0,2091,32,2123,3586,0,3,1,3,0,1,0,76.14,59.20 ,33.33
03,001,01,015,0786,0,2282,34,2316,3558,0,3,1,3,0,1,0,76.14,65.09 ,33.33
03,001,01,015,0787,0,606,9,615,873,0,3,1,3,0,1,0,76.14,70.45 ,33.33
03,001,01,015,0788,0,2697,26,2723,3834,0,3,1,3,0,1,0,76.14,71.02 ,33.33
03,001,01,015,0789,0,2993,40,3033,4484,0,3,1,3,0,1,0,76.14,67.64 ,33.33
03,001,01,015,0790,0,1483,25,1508,2228,0,3,1,3,0,1,0,76.14,67.68 ,33.33
03,001,01,015,0791,0,1625,25,1650,2201,0,3,1,3,0,1,0,76.14,74.97 ,33.33
03,001,01,015,0792,0,883,10,893,1174,0,3,1,3,0,1,0,76.14,76.06 ,33.33
03,001,01,016,0793,0,574,10,584,862,0,3,1,3,0,1,0,76.14,67.75 ,33.33
03,001,01,016,0794,0,1348,23,1371,2011,0,3,1,3,0,1,0,76.14,68.18 ,33.33
03,001,01,016,0795,0,2531,42,2573,3945,0,3,1,3,0,1,0,76.14,65.22 ,33.33
03,001,01,016,0796,0,2582,42,2624,3781,0,3,1,3,0,1,0,76.14,69.40 ,33.33
03,001,01,016,0797,0,1642,20,1662,2445,0,3,1,3,0,1,0,76.14,67.98 ,33.33
03,001,01,016,0798,0,1633,17,1650,2417,0,3,1,3,0,1,0,76.14,68.27 ,33.33
03,001,01,016,0799,0,1273,15,1288,1731,0,3,1,3,0,1,0,76.14,74.41 ,33.33
03,001,01,016,0800,0,1549,20,1569,2238,0,3,1,3,0,1,0,76.14,70.11 ,33.33
03,001,01,016,0801,0,1780,17,1797,2664,0,3,1,3,0,1,0,76.14,67.45 ,33.33
03,001,01,016,0802,0,1576,27,1603,2391,0,3,1,3,0,1,0,76.14,67.04 ,33.33
03,001,01,016,0803,0,1047,13,1060,1612,0,3,1,3,0,1,0,76.14,65.76 ,33.33
03,001,01,016,0804,0,1436,25,1461,2140,0,3,1,3,0,1,0,76.14,68.27 ,33.33
03,001,01,016,0805,0,1628,21,1649,2509,0,3,1,3,0,1,0,76.14,65.72 ,33.33
03,001,01,016,0806,0,1656,26,1682,2335,0,3,1,3,0,1,0,76.14,72.03 ,33.33
03,001,01,016,0807,0,1877,25,1902,2811,0,3,1,3,0,1,0,76.14,67.66 ,33.33
03,001,01,017,0808,0,2046,17,2063,3071,0,3,1,3,0,1,0,76.14,67.18 ,33.33
03,001,01,017,0809,0,1953,26,1979,3001,0,3,1,3,0,1,0,76.14,65.94 ,33.33
03,001,01,017,0810,0,1842,33,1875,2747,0,3,1,3,0,1,0,76.14,68.26 ,33.33
03,001,01,017,0811,0,1858,39,1897,2559,0,3,1,3,0,1,0,76.14,74.13 ,33.33
03,001,01,017,0812,0,1679,18,1697,2313,0,3,1,3,0,1,0,76.14,73.37 ,33.33
03,001,01,017,0813,0,761,14,775,1049,0,3,1,3,0,1,0,76.14,73.88 ,33.33
03,001,01,017,0814,0,953,22,975,1303,0,3,1,3,0,1,0,76.14,74.83 ,33.33
03,001,01,017,0815,0,1855,26,1881,2978,0,3,1,3,0,1,0,76.14,63.16 ,33.33
03,001,01,017,0816,0,1695,25,1720,2663,0,3,1,3,0,1,0,76.14,64.59 ,33.33
03,001,01,017,0817,0,669,7,676,895,0,3,1,3,0,1,0,76.14,75.53 ,33.33
03,001,01,017,0818,0,686,9,695,904,0,3,1,3,0,1,0,76.14,76.88 ,33.33
03,001,01,017,0819,0,467,8,475,608,0,3,1,3,0,1,0,76.14,78.13 ,33.33
03,001,01,017,0820,0,345,8,353,472,0,3,1,3,0,1,0,76.14,74.79 ,33.33
03,001,01,017,0821,0,499,5,504,783,0,3,1,3,0,1,0,76.14,64.37 ,33.33
03,001,01,018,0822,0,2817,34,2851,4171,0,3,1,3,0,1,0,76.14,68.35 ,33.33
03,001,01,018,0823,0,2022,41,2063,3065,0,3,1,3,0,1,0,76.14,67.31 ,33.33
03,001,01,018,0824,0,1755,30,1785,2647,0,3,1,3,0,1,0,76.14,67.43 ,33.33
03,001,01,018,0825,0,766,10,776,1157,0,3,1,3,0,1,0,76.14,67.07 ,33.33
03,001,01,018,0826,0,311,3,314,432,0,3,1,3,0,1,0,76.14,72.69 ,33.33
03,001,01,019,0827,0,294,2,296,395,0,3,1,3,0,1,0,76.14,74.94 ,33.33
03,001,01,019,0828,0,417,6,423,622,0,3,1,3,0,1,0,76.14,68.01 ,33.33
03,001,01,019,0829,0,399,10,409,569,0,3,1,3,0,1,0,76.14,71.88 ,33.33
03,001,01,019,0830,0,173,0,173,256,0,3,1,3,0,1,0,76.14,67.58 ,33.33
03,001,01,019,0831,0,245,5,250,366,0,3,1,3,0,1,0,76.14,68.31 ,33.33
03,001,01,019,0832,0,488,16,504,709,0,3,1,3,0,1,0,76.14,71.09 ,33.33
03,001,01,019,0833,0,175,1,176,254,0,3,1,3,0,1,0,76.14,69.29 ,33.33
03,001,01,019,0834,0,544,14,558,756,0,3,1,3,0,1,0,76.14,73.81 ,33.33
03,001,01,019,0835,0,374,4,378,530,0,3,1,3,0,1,0,76.14,71.32 ,33.33
03,001,01,019,0836,0,137,1,138,203,0,3,1,3,0,1,0,76.14,67.98 ,33.33
03,001,01,019,0837,0,268,3,271,399,0,3,1,3,0,1,0,76.14,67.92 ,33.33
03,001,01,019,0838,0,400,6,406,572,0,3,1,3,0,1,0,76.14,70.98 ,33.33
03,001,01,019,0839,0,214,4,218,379,0,3,1,3,0,1,0,76.14,57.52 ,33.33
03,001,01,020,0840,0,676,3,679,944,0,3,1,3,0,1,0,76.14,71.93 ,33.33
03,001,01,020,0841,0,301,0,301,468,0,3,1,3,0,1,0,76.14,64.32 ,33.33
03,001,01,020,0842,0,498,5,503,878,0,3,1,3,0,1,0,76.14,57.29 ,33.33
03,001,01,020,0843,0,219,2,221,369,0,3,1,3,0,1,0,76.14,59.89 ,33.33
03,001,01,020,0844,0,400,10,410,654,0,3,1,3,0,1,0,76.14,62.69 ,33.33
03,001,01,020,0845,0,444,4,448,702,0,3,1,3,0,1,0,76.14,63.82 ,33.33
03,001,01,020,0846,0,367,6,373,602,0,3,1,3,0,1,0,76.14,61.96 ,33.33
03,001,01,021,0847,0,228,3,231,312,0,3,1,3,0,1,0,76.14,74.04 ,33.33
03,001,01,021,0848,0,1726,35,1761,2470,0,3,1,3,0,1,0,76.14,71.30 ,33.33
03,001,01,021,0849,0,532,8,540,733,0,3,1,3,0,1,0,76.14,73.67 ,33.33
03,001,01,021,0850,0,535,11,546,783,0,3,1,3,0,1,0,76.14,69.73 ,33.33
03,001,01,021,0851,0,2188,40,2228,3133,0,3,1,3,0,1,0,76.14,71.11 ,33.33
03,001,01,021,0852,0,234,3,237,359,0,3,1,3,0,1,0,76.14,66.02 ,33.33
03,001,01,021,0853,0,406,1,407,549,0,3,1,3,0,1,0,76.14,74.13 ,33.33
03,001,01,021,0854,0,527,8,535,784,0,3,1,3,0,1,0,76.14,68.24 ,33.33
03,001,01,021,0855,0,805,12,817,1093,0,3,1,3,0,1,0,76.14,74.75 ,33.33
03,001,01,021,0856,0,332,16,348,463,0,3,1,3,0,1,0,76.14,75.16 ,33.33
03,001,01,021,0857,0,311,3,314,465,0,3,1,3,0,1,0,76.14,67.53 ,33.33
03,001,01,021,0858,0,419,7,426,634,0,3,1,3,0,1,0,76.14,67.19 ,33.33
03,001,01,021,0859,0,713,19,732,1051,0,3,1,3,0,1,0,76.14,69.65 ,33.33
03,001,01,022,0860,0,505,7,512,692,0,3,1,3,0,1,0,76.14,73.99 ,33.33
03,001,01,022,0861,0,681,11,692,940,0,3,1,3,0,1,0,76.14,73.62 ,33.33
03,001,01,022,0862,0,989,27,1016,1453,0,3,1,3,0,1,0,76.14,69.92 ,33.33
03,001,01,022,0863,0,384,5,389,579,0,3,1,3,0,1,0,76.14,67.18 ,33.33
03,001,01,022,0864,0,710,9,719,1026,0,3,1,3,0,1,0,76.14,70.08 ,33.33
03,001,01,022,0865,0,763,8,771,1074,0,3,1,3,0,1,0,76.14,71.79 ,33.33
03,001,01,022,0866,0,135,1,136,212,0,3,1,3,0,1,0,76.14,64.15 ,33.33
03,001,01,022,0867,0,327,2,329,427,0,3,1,3,0,1,0,76.14,77.05 ,33.33
03,001,01,022,0868,0,411,6,417,618,0,3,1,3,0,1,0,76.14,67.48 ,33.33
03,001,01,023,0869,0,1807,37,1844,2640,0,3,1,3,0,1,0,76.14,69.85 ,33.33
03,001,01,023,0870,0,1120,25,1145,1665,0,3,1,3,0,1,0,76.14,68.77 ,33.33
03,001,01,023,0871,0,671,15,686,928,0,3,1,3,0,1,0,76.14,73.92 ,33.33
03,001,01,023,0872,0,1023,27,1050,1561,0,3,1,3,0,1,0,76.14,67.26 ,33.33
03,001,01,023,0873,0,563,15,578,780,0,3,1,3,0,1,0,76.14,74.10 ,33.33
03,001,01,023,0874,0,1286,17,1303,1940,0,3,1,3,0,1,0,76.14,67.16 ,33.33
03,001,01,023,0875,0,1292,30,1322,1855,0,3,1,3,0,1,0,76.14,71.27 ,33.33
03,001,01,023,0876,0,625,10,635,882,0,3,1,3,0,1,0,76.14,72.00 ,33.33
03,001,01,023,0877,0,748,12,760,922,0,3,1,3,0,1,0,76.14,82.43 ,33.33
03,001,01,023,0878,0,734,12,746,1005,0,3,1,3,0,1,0,76.14,74.23 ,33.33
03,001,01,024,0879,0,336,3,339,457,0,3,1,3,0,1,0,76.14,74.18 ,33.33
03,001,01,024,0880,0,239,1,240,315,0,3,1,3,0,1,0,76.14,76.19 ,33.33
03,001,01,024,0881,0,266,8,274,352,0,3,1,3,0,1,0,76.14,77.84 ,33.33
03,001,01,024,0882,0,381,4,385,564,0,3,1,3,0,1,0,76.14,68.26 ,33.33
03,001,01,024,0883,0,238,2,240,326,0,3,1,3,0,1,0,76.14,73.62 ,33.33
03,001,01,024,0884,0,536,1,537,717,0,3,1,3,0,1,0,76.14,74.90 ,33.33
03,001,01,024,0885,0,239,5,244,350,0,3,1,3,0,1,0,76.14,69.71 ,33.33
03,001,01,024,0886,0,813,7,820,1185,0,3,1,3,0,1,0,76.14,69.20 ,33.33
03,001,01,024,0887,0,72,1,73,103,0,3,1,3,0,1,0,76.14,70.87 ,33.33
03,001,01,024,0888,0,366,8,374,530,0,3,1,3,0,1,0,76.14,70.57 ,33.33
03,001,01,024,0889,0,105,2,107,171,0,3,1,3,0,1,0,76.14,62.57 ,33.33
03,001,01,024,0890,0,80,0,80,120,0,3,1,3,0,1,0,76.14,66.67 ,33.33
03,001,01,025,0891,0,460,6,466,623,0,3,1,3,0,1,0,76.14,74.80 ,33.33
03,001,01,025,0892,0,773,11,784,1049,0,3,1,3,0,1,0,76.14,74.74 ,33.33
03,001,01,025,0893,0,321,5,326,477,0,3,1,3,0,1,0,76.14,68.34 ,33.33
03,001,01,025,0894,0,1434,13,1447,1959,0,3,1,3,0,1,0,76.14,73.86 ,33.33
03,001,01,025,0895,0,223,4,227,325,0,3,1,3,0,1,0,76.14,69.85 ,33.33
03,001,01,025,0896,0,664,3,667,892,0,3,1,3,0,1,0,76.14,74.78 ,33.33
03,001,01,025,0897,0,540,6,546,763,0,3,1,3,0,1,0,76.14,71.56 ,33.33
03,001,01,025,0898,0,308,2,310,526,0,3,1,3,0,1,0,76.14,58.94 ,33.33
03,001,01,025,0899,0,292,1,293,395,0,3,1,3,0,1,0,76.14,74.18 ,33.33
03,001,01,025,0900,0,382,4,386,517,0,3,1,3,0,1,0,76.14,74.66 ,33.33
03,001,01,025,0901,0,427,4,431,614,0,3,1,3,0,1,0,76.14,70.20 ,33.33
03,001,01,025,0902,0,202,0,202,303,0,3,1,3,0,1,0,76.14,66.67 ,33.33
03,001,01,026,0903,0,701,10,711,968,0,3,1,3,0,1,0,76.14,73.45 ,33.33
03,001,01,026,0904,0,276,7,283,422,0,3,1,3,0,1,0,76.14,67.06 ,33.33
03,001,01,026,0905,0,259,4,263,414,0,3,1,3,0,1,0,76.14,63.53 ,33.33
03,001,01,026,0906,0,557,9,566,807,0,3,1,3,0,1,0,76.14,70.14 ,33.33
03,001,01,026,0907,0,1085,23,1108,1527,0,3,1,3,0,1,0,76.14,72.56 ,33.33
03,001,01,026,0908,0,455,7,462,730,0,3,1,3,0,1,0,76.14,63.29 ,33.33
03,001,01,026,0909,0,435,5,440,652,0,3,1,3,0,1,0,76.14,67.48 ,33.33
03,001,01,026,0910,0,1003,13,1016,1392,0,3,1,3,0,1,0,76.14,72.99 ,33.33
03,001,01,026,0911,0,1223,18,1241,1809,0,3,1,3,0,1,0,76.14,68.60 ,33.33
03,001,01,026,0912,0,531,4,535,819,0,3,1,3,0,1,0,76.14,65.32 ,33.33
03,001,01,026,0913,0,558,8,566,916,0,3,1,3,0,1,0,76.14,61.79 ,33.33
03,001,01,027,0914,0,289,5,294,425,0,3,1,3,0,1,0,76.14,69.18 ,33.33
03,001,01,027,0915,0,493,7,500,674,0,3,1,3,0,1,0,76.14,74.18 ,33.33
03,001,01,027,0916,0,292,3,295,441,0,3,1,3,0,1,0,76.14,66.89 ,33.33
03,001,01,027,0917,0,861,6,867,1342,0,3,1,3,0,1,0,76.14,64.61 ,33.33
03,001,01,027,0918,0,3550,47,3597,5117,0,3,1,3,0,1,0,76.14,70.30 ,33.33
03,001,01,027,0919,0,917,19,936,1355,0,3,1,3,0,1,0,76.14,69.08 ,33.33
03,001,01,027,0920,0,513,9,522,749,0,3,1,3,0,1,0,76.14,69.69 ,33.33
03,001,01,027,0921,0,222,7,229,338,0,3,1,3,0,1,0,76.14,67.75 ,33.33
03,001,01,027,0922,0,343,7,350,510,0,3,1,3,0,1,0,76.14,68.63 ,33.33
03,001,01,027,0923,0,373,5,378,567,0,3,1,3,0,1,0,76.14,66.67 ,33.33
03,001,01,027,0924,0,511,12,523,753,0,3,1,3,0,1,0,76.14,69.46 ,33.33
03,001,01,027,0925,0,141,0,141,216,0,3,1,3,0,1,0,76.14,65.28 ,33.33
03,001,01,027,0926,0,307,4,311,426,0,3,1,3,0,1,0,76.14,73.00 ,33.33
03,001,01,027,0927,0,330,4,334,527,0,3,1,3,0,1,0,76.14,63.38 ,33.33
03,001,01,028,0928,0,2031,36,2067,2877,0,3,1,3,0,1,0,76.14,71.85 ,33.33
03,001,01,028,0929,0,1062,26,1088,1605,0,3,1,3,0,1,0,76.14,67.79 ,33.33
03,001,01,028,0930,0,1557,24,1581,2127,0,3,1,3,0,1,0,76.14,74.33 ,33.33
03,001,01,028,0931,0,1430,21,1451,2085,0,3,1,3,0,1,0,76.14,69.59 ,33.33
03,001,01,028,0932,0,317,7,324,474,0,3,1,3,0,1,0,76.14,68.35 ,33.33
03,001,01,028,0933,0,518,11,529,784,0,3,1,3,0,1,0,76.14,67.47 ,33.33
03,001,01,028,0934,0,341,1,342,530,0,3,1,3,0,1,0,76.14,64.53 ,33.33
03,001,01,028,0935,0,352,6,358,561,0,3,1,3,0,1,0,76.14,63.81 ,33.33
03,001,01,028,0936,0,511,17,528,800,0,3,1,3,0,1,0,76.14,66.00 ,33.33
03,001,01,028,0937,0,1180,22,1202,1842,0,3,1,3,0,1,0,76.14,65.26 ,33.33
03,001,01,029,0938,0,250,2,252,366,0,3,1,3,0,1,0,76.14,68.85 ,33.33
03,001,01,029,0939,0,519,7,526,773,0,3,1,3,0,1,0,76.14,68.05 ,33.33
03,001,01,029,0940,0,47,0,47,64,0,3,1,3,0,1,0,76.14,73.44 ,33.33
03,001,01,029,0941,0,95,1,96,148,0,3,1,3,0,1,0,76.14,64.86 ,33.33
03,001,01,029,0942,0,36,0,36,54,0,3,1,3,0,1,0,76.14,66.67 ,33.33
03,002,01,001,0001,0,460,12,472,864,0,3,1,3,0,1,0,76.14,54.63 ,33.33
03,002,01,001,0002,0,1326,20,1346,2170,0,3,1,3,0,1,0,76.14,62.03 ,33.33
03,002,01,001,0003,0,1349,29,1378,2330,0,3,1,3,0,1,0,76.14,59.14 ,33.33
03,002,01,001,0004,0,1216,26,1242,2213,0,3,1,3,0,1,0,76.14,56.12 ,33.33
03,002,01,001,0005,0,1656,28,1684,2862,0,3,1,3,0,1,0,76.14,58.84 ,33.33
03,002,01,001,0006,0,1459,31,1490,2529,0,3,1,3,0,1,0,76.14,58.92 ,33.33
03,002,01,001,0007,0,1417,31,1448,2372,0,3,1,3,0,1,0,76.14,61.05 ,33.33
03,002,01,001,0008,0,471,5,476,794,0,3,1,3,0,1,0,76.14,59.95 ,33.33
03,002,01,001,0009,0,834,14,848,1430,0,3,1,3,0,1,0,76.14,59.30 ,33.33
03,002,01,001,0010,0,326,3,329,533,0,3,1,3,0,1,0,76.14,61.73 ,33.33
03,002,01,001,0011,0,457,6,463,747,0,3,1,3,0,1,0,76.14,61.98 ,33.33
03,002,01,001,0012,0,331,4,335,569,0,3,1,3,0,1,0,76.14,58.88 ,33.33
03,002,01,001,0013,0,357,5,362,648,0,3,1,3,0,1,0,76.14,55.86 ,33.33
03,002,01,001,0014,0,1067,24,1091,1994,0,3,1,3,0,1,0,76.14,54.71 ,33.33
03,002,01,001,0015,0,2130,35,2165,3583,0,3,1,3,0,1,0,76.14,60.42 ,33.33
03,002,01,001,0016,0,275,1,276,511,0,3,1,3,0,1,0,76.14,54.01 ,33.33
03,002,01,001,0017,0,519,7,526,1047,0,3,1,3,0,1,0,76.14,50.24 ,33.33
03,002,01,001,0018,0,406,7,413,763,0,3,1,3,0,1,0,76.14,54.13 ,33.33
03,002,01,001,0019,0,634,5,639,1169,0,3,1,3,0,1,0,76.14,54.66 ,33.33
03,002,01,001,0020,0,618,12,630,1098,0,3,1,3,0,1,0,76.14,57.38 ,33.33
03,002,01,001,0021,0,1601,34,1635,2855,0,3,1,3,0,1,0,76.14,57.27 ,33.33
03,002,01,001,0022,0,1640,29,1669,2950,0,3,1,3,0,1,0,76.14,56.58 ,33.33
03,002,01,001,0023,0,606,3,609,1007,0,3,1,3,0,1,0,76.14,60.48 ,33.33
03,002,01,001,0024,0,1876,32,1908,3589,0,3,1,3,0,1,0,76.14,53.16 ,33.33
03,002,01,001,0025,0,409,7,416,669,0,3,1,3,0,1,0,76.14,62.18 ,33.33
03,002,01,001,0026,0,375,7,382,590,0,3,1,3,0,1,0,76.14,64.75 ,33.33
03,002,01,001,0027,0,456,5,461,703,0,3,1,3,0,1,0,76.14,65.58 ,33.33
03,002,01,001,0028,0,748,21,769,1330,0,3,1,3,0,1,0,76.14,57.82 ,33.33
03,002,01,001,0029,0,797,11,808,1346,0,3,1,3,0,1,0,76.14,60.03 ,33.33
03,002,01,001,0030,0,664,5,669,1152,0,3,1,3,0,1,0,76.14,58.07 ,33.33
03,002,01,001,0031,0,1088,14,1102,2011,0,3,1,3,0,1,0,76.14,54.80 ,33.33
03,002,01,001,0032,0,763,9,772,1490,0,3,1,3,0,1,0,76.14,51.81 ,33.33
03,002,01,001,0033,0,691,12,703,1257,0,3,1,3,0,1,0,76.14,55.93 ,33.33
03,002,01,001,0034,0,1295,18,1313,2272,0,3,1,3,0,1,0,76.14,57.79 ,33.33
03,002,01,001,0035,0,543,10,553,977,0,3,1,3,0,1,0,76.14,56.60 ,33.33
03,002,01,001,0036,0,521,15,536,818,0,3,1,3,0,1,0,76.14,65.53 ,33.33
03,002,01,001,0037,0,510,7,517,866,0,3,1,3,0,1,0,76.14,59.70 ,33.33
03,002,01,001,0038,0,768,10,778,1302,0,3,1,3,0,1,0,76.14,59.75 ,33.33
03,002,01,001,0039,0,520,5,525,891,0,3,1,3,0,1,0,76.14,58.92 ,33.33
03,002,01,001,0040,0,748,11,759,1369,0,3,1,3,0,1,0,76.14,55.44 ,33.33
03,002,01,002,0041,0,312,0,312,474,0,3,1,3,0,1,0,76.14,65.82 ,33.33
03,002,01,002,0042,0,385,6,391,594,0,3,1,3,0,1,0,76.14,65.82 ,33.33
03,002,01,002,0043,0,338,3,341,581,0,3,1,3,0,1,0,76.14,58.69 ,33.33
03,002,01,002,0044,0,657,6,663,1179,0,3,1,3,0,1,0,76.14,56.23 ,33.33
03,002,01,002,0045,0,847,14,861,1467,0,3,1,3,0,1,0,76.14,58.69 ,33.33
03,002,01,002,0046,0,1027,12,1039,1707,0,3,1,3,0,1,0,76.14,60.87 ,33.33
03,002,01,002,0047,0,586,6,592,1138,0,3,1,3,0,1,0,76.14,52.02 ,33.33
03,002,01,002,0048,0,1237,26,1263,2104,0,3,1,3,0,1,0,76.14,60.03 ,33.33
03,002,01,002,0049,0,804,7,811,1395,0,3,1,3,0,1,0,76.14,58.14 ,33.33
03,002,01,002,0050,0,759,9,768,1228,0,3,1,3,0,1,0,76.14,62.54 ,33.33
03,002,01,002,0051,0,522,5,527,862,0,3,1,3,0,1,0,76.14,61.14 ,33.33
03,002,01,002,0052,0,424,4,428,709,0,3,1,3,0,1,0,76.14,60.37 ,33.33
03,002,01,002,0053,0,559,2,561,974,0,3,1,3,0,1,0,76.14,57.60 ,33.33
03,002,01,002,0054,0,425,5,430,707,0,3,1,3,0,1,0,76.14,60.82 ,33.33
03,002,01,002,0055,0,438,11,449,713,0,3,1,3,0,1,0,76.14,62.97 ,33.33
03,002,01,002,0056,0,1920,24,1944,3414,0,3,1,3,0,1,0,76.14,56.94 ,33.33
03,002,01,002,0057,0,2350,27,2377,4108,0,3,1,3,0,1,0,76.14,57.86 ,33.33
03,002,01,002,0058,0,2240,25,2265,3869,0,3,1,3,0,1,0,76.14,58.54 ,33.33
03,002,01,002,0059,0,1862,20,1882,3309,0,3,1,3,0,1,0,76.14,56.88 ,33.33
03,002,01,002,0060,0,942,11,953,1720,0,3,1,3,0,1,0,76.14,55.41 ,33.33
03,002,01,002,0061,0,571,8,579,1004,0,3,1,3,0,1,0,76.14,57.67 ,33.33
03,002,01,002,0062,0,1450,23,1473,2518,0,3,1,3,0,1,0,76.14,58.50 ,33.33
03,002,01,002,0063,0,1582,17,1599,2797,0,3,1,3,0,1,0,76.14,57.17 ,33.33
03,002,01,002,0064,0,1452,26,1478,2555,0,3,1,3,0,1,0,76.14,57.85 ,33.33
03,002,01,002,0065,0,1184,14,1198,2041,0,3,1,3,0,1,0,76.14,58.70 ,33.33
03,002,01,003,0066,0,1512,17,1529,2788,0,3,1,3,0,1,0,76.14,54.84 ,33.33
03,002,01,003,0067,0,392,4,396,688,0,3,1,3,0,1,0,76.14,57.56 ,33.33
03,002,01,003,0068,0,1413,15,1428,2516,0,3,1,3,0,1,0,76.14,56.76 ,33.33
03,002,01,003,0069,0,607,4,611,1086,0,3,1,3,0,1,0,76.14,56.26 ,33.33
03,002,01,003,0070,0,767,6,773,1373,0,3,1,3,0,1,0,76.14,56.30 ,33.33
03,002,01,003,0071,0,129,15,144,390,0,3,1,3,0,1,0,76.14,36.92 ,33.33
03,002,01,003,0072,0,1073,9,1082,1906,0,3,1,3,0,1,0,76.14,56.77 ,33.33
03,002,01,003,0073,0,529,7,536,1024,0,3,1,3,0,1,0,76.14,52.34 ,33.33
03,002,01,003,0074,0,2304,32,2336,4378,0,3,1,3,0,1,0,76.14,53.36 ,33.33
03,002,01,003,0075,0,1200,13,1213,2186,0,3,1,3,0,1,0,76.14,55.49 ,33.33
03,002,01,003,0076,0,731,6,737,1315,0,3,1,3,0,1,0,76.14,56.05 ,33.33
03,002,01,003,0077,0,357,3,360,632,0,3,1,3,0,1,0,76.14,56.96 ,33.33
03,002,01,003,0078,0,293,7,300,607,0,3,1,3,0,1,0,76.14,49.42 ,33.33
03,002,01,003,0079,0,366,8,374,664,0,3,1,3,0,1,0,76.14,56.33 ,33.33
03,002,01,003,0080,0,415,6,421,678,0,3,1,3,0,1,0,76.14,62.09 ,33.33
03,002,01,003,0081,0,363,13,376,703,0,3,1,3,0,1,0,76.14,53.49 ,33.33
03,002,01,003,0082,0,352,5,357,568,0,3,1,3,0,1,0,76.14,62.85 ,33.33
03,002,01,003,0083,0,613,9,622,1209,0,3,1,3,0,1,0,76.14,51.45 ,33.33
03,002,01,003,0084,0,573,10,583,1185,0,3,1,3,0,1,0,76.14,49.20 ,33.33
03,002,01,003,0085,0,614,11,625,1344,0,3,1,3,0,1,0,76.14,46.50 ,33.33
03,002,01,003,0086,0,750,6,756,1720,0,3,1,3,0,1,0,76.14,43.95 ,33.33
03,002,01,003,0087,0,598,5,603,1259,0,3,1,3,0,1,0,76.14,47.90 ,33.33
03,002,01,003,0088,0,603,10,613,1353,0,3,1,3,0,1,0,76.14,45.31 ,33.33
03,002,01,003,0089,0,209,1,210,369,0,3,1,3,0,1,0,76.14,56.91 ,33.33
03,002,01,003,0090,0,466,5,471,883,0,3,1,3,0,1,0,76.14,53.34 ,33.33
03,002,01,003,0091,0,443,5,448,836,0,3,1,3,0,1,0,76.14,53.59 ,33.33
03,002,01,004,0092,0,206,1,207,413,0,3,1,3,0,1,0,76.14,50.12 ,33.33
03,002,01,004,0093,0,239,5,244,696,0,3,1,3,0,1,0,76.14,35.06 ,33.33
03,002,01,004,0094,0,607,8,615,1532,0,3,1,3,0,1,0,76.14,40.14 ,33.33
03,002,01,004,0095,0,196,7,203,428,0,3,1,3,0,1,0,76.14,47.43 ,33.33
03,002,01,004,0096,0,645,6,651,1307,0,3,1,3,0,1,0,76.14,49.81 ,33.33
03,002,01,004,0097,0,438,6,444,880,0,3,1,3,0,1,0,76.14,50.45 ,33.33
03,002,01,004,0098,0,316,10,326,611,0,3,1,3,0,1,0,76.14,53.36 ,33.33
03,002,01,004,0099,0,686,6,692,1315,0,3,1,3,0,1,0,76.14,52.62 ,33.33
03,002,01,004,0100,0,612,9,621,1099,0,3,1,3,0,1,0,76.14,56.51 ,33.33
03,002,01,004,0101,0,433,3,436,761,0,3,1,3,0,1,0,76.14,57.29 ,33.33
03,002,01,004,0102,0,350,5,355,651,0,3,1,3,0,1,0,76.14,54.53 ,33.33
03,002,01,004,0103,0,407,4,411,712,0,3,1,3,0,1,0,76.14,57.72 ,33.33
03,002,01,004,0104,0,325,5,330,615,0,3,1,3,0,1,0,76.14,53.66 ,33.33
03,002,01,004,0105,0,936,11,947,1848,0,3,1,3,0,1,0,76.14,51.24 ,33.33
03,002,01,004,0106,0,909,19,928,1687,0,3,1,3,0,1,0,76.14,55.01 ,33.33
03,002,01,004,0107,0,646,7,653,1182,0,3,1,3,0,1,0,76.14,55.25 ,33.33
03,002,01,004,0108,0,509,6,515,980,0,3,1,3,0,1,0,76.14,52.55 ,33.33
03,002,01,004,0109,0,761,8,769,1576,0,3,1,3,0,1,0,76.14,48.79 ,33.33
03,002,01,004,0110,0,374,5,379,720,0,3,1,3,0,1,0,76.14,52.64 ,33.33
03,002,01,004,0111,0,660,7,667,1298,0,3,1,3,0,1,0,76.14,51.39 ,33.33
03,002,01,004,0112,0,489,3,492,945,0,3,1,3,0,1,0,76.14,52.06 ,33.33
03,002,01,004,0113,0,546,4,550,913,0,3,1,3,0,1,0,76.14,60.24 ,33.33
03,002,01,004,0114,0,562,8,570,1069,0,3,1,3,0,1,0,76.14,53.32 ,33.33
03,002,01,005,0115,0,758,8,766,1400,0,3,1,3,0,1,0,76.14,54.71 ,33.33
03,002,01,005,0116,0,904,12,916,1621,0,3,1,3,0,1,0,76.14,56.51 ,33.33
03,002,01,005,0117,0,1770,32,1802,3262,0,3,1,3,0,1,0,76.14,55.24 ,33.33
03,002,01,005,0118,0,1125,12,1137,1897,0,3,1,3,0,1,0,76.14,59.94 ,33.33
03,002,01,005,0119,0,427,3,430,676,0,3,1,3,0,1,0,76.14,63.61 ,33.33
03,002,01,005,0120,0,789,7,796,1334,0,3,1,3,0,1,0,76.14,59.67 ,33.33
03,002,01,005,0121,0,594,8,602,1125,0,3,1,3,0,1,0,76.14,53.51 ,33.33
03,002,01,005,0122,0,606,4,610,1253,0,3,1,3,0,1,0,76.14,48.68 ,33.33
03,002,01,005,0123,0,940,14,954,1694,0,3,1,3,0,1,0,76.14,56.32 ,33.33
03,002,01,005,0124,0,1217,27,1244,2166,0,3,1,3,0,1,0,76.14,57.43 ,33.33
03,002,01,005,0125,0,594,9,603,1039,0,3,1,3,0,1,0,76.14,58.04 ,33.33
03,002,01,005,0126,0,366,2,368,649,0,3,1,3,0,1,0,76.14,56.70 ,33.33
03,002,01,005,0127,0,474,8,482,877,0,3,1,3,0,1,0,76.14,54.96 ,33.33
03,002,01,005,0128,0,586,9,595,1056,0,3,1,3,0,1,0,76.14,56.34 ,33.33
03,002,01,005,0129,0,1204,9,1213,2029,0,3,1,3,0,1,0,76.14,59.78 ,33.33
03,002,01,005,0130,0,1409,17,1426,2528,0,3,1,3,0,1,0,76.14,56.41 ,33.33
03,002,01,005,0131,0,482,10,492,882,0,3,1,3,0,1,0,76.14,55.78 ,33.33
03,002,01,005,0132,0,199,7,206,389,0,3,1,3,0,1,0,76.14,52.96 ,33.33
03,002,01,006,0133,0,1270,21,1291,2416,0,3,1,3,0,1,0,76.14,53.44 ,33.33
03,002,01,006,0134,0,742,10,752,1440,0,3,1,3,0,1,0,76.14,52.22 ,33.33
03,002,01,006,0135,0,425,5,430,827,0,3,1,3,0,1,0,76.14,52.00 ,33.33
03,002,01,006,0136,0,510,7,517,983,0,3,1,3,0,1,0,76.14,52.59 ,33.33
03,002,01,006,0137,0,793,11,804,1547,0,3,1,3,0,1,0,76.14,51.97 ,33.33
03,002,01,006,0138,0,719,4,723,1417,0,3,1,3,0,1,0,76.14,51.02 ,33.33
03,002,01,006,0139,0,375,4,379,820,0,3,1,3,0,1,0,76.14,46.22 ,33.33
03,002,01,006,0140,0,998,11,1009,1728,0,3,1,3,0,1,0,76.14,58.39 ,33.33
03,002,01,006,0141,0,603,12,615,1155,0,3,1,3,0,1,0,76.14,53.25 ,33.33
03,002,01,006,0142,0,540,6,546,936,0,3,1,3,0,1,0,76.14,58.33 ,33.33
03,002,01,006,0143,0,924,4,928,1731,0,3,1,3,0,1,0,76.14,53.61 ,33.33
03,002,01,006,0144,0,530,5,535,1079,0,3,1,3,0,1,0,76.14,49.58 ,33.33
03,002,01,006,0145,0,811,11,822,1487,0,3,1,3,0,1,0,76.14,55.28 ,33.33
03,002,01,007,0146,0,1927,22,1949,3558,0,3,1,3,0,1,0,76.14,54.78 ,33.33
03,002,01,007,0147,0,963,17,980,1729,0,3,1,3,0,1,0,76.14,56.68 ,33.33
03,002,01,007,0148,0,644,9,653,1110,0,3,1,3,0,1,0,76.14,58.83 ,33.33
03,002,01,007,0149,0,495,4,499,955,0,3,1,3,0,1,0,76.14,52.25 ,33.33
03,002,01,007,0150,0,709,9,718,1282,0,3,1,3,0,1,0,76.14,56.01 ,33.33
03,002,01,007,0151,0,581,9,590,1069,0,3,1,3,0,1,0,76.14,55.19 ,33.33
03,002,01,007,0152,0,852,12,864,1455,0,3,1,3,0,1,0,76.14,59.38 ,33.33
03,002,01,007,0153,0,350,4,354,758,0,3,1,3,0,1,0,76.14,46.70 ,33.33
03,002,01,007,0154,0,804,14,818,1504,0,3,1,3,0,1,0,76.14,54.39 ,33.33
03,002,01,007,0155,0,606,8,614,1010,0,3,1,3,0,1,0,76.14,60.79 ,33.33
03,002,01,007,0156,0,1168,14,1182,2004,0,3,1,3,0,1,0,76.14,58.98 ,33.33
03,002,01,007,0157,0,1250,19,1269,2218,0,3,1,3,0,1,0,76.14,57.21 ,33.33
03,002,01,007,0158,0,439,6,445,835,0,3,1,3,0,1,0,76.14,53.29 ,33.33
03,002,01,007,0159,0,445,4,449,828,0,3,1,3,0,1,0,76.14,54.23 ,33.33
03,002,01,007,0160,0,514,6,520,978,0,3,1,3,0,1,0,76.14,53.17 ,33.33
03,002,01,007,0161,0,785,11,796,1560,0,3,1,3,0,1,0,76.14,51.03 ,33.33
03,002,01,008,0162,0,600,5,605,1046,0,3,1,3,0,1,0,76.14,57.84 ,33.33
03,002,01,008,0163,0,661,8,669,1093,0,3,1,3,0,1,0,76.14,61.21 ,33.33
03,002,01,008,0164,0,555,2,557,913,0,3,1,3,0,1,0,76.14,61.01 ,33.33
03,002,01,008,0165,0,454,9,463,779,0,3,1,3,0,1,0,76.14,59.44 ,33.33
03,002,01,008,0166,0,564,10,574,905,0,3,1,3,0,1,0,76.14,63.43 ,33.33
03,002,01,008,0167,0,628,8,636,1112,0,3,1,3,0,1,0,76.14,57.19 ,33.33
03,002,01,008,0168,0,1034,14,1048,1689,0,3,1,3,0,1,0,76.14,62.05 ,33.33
03,002,01,008,0169,0,983,16,999,1697,0,3,1,3,0,1,0,76.14,58.87 ,33.33
03,002,01,008,0170,0,539,7,546,855,0,3,1,3,0,1,0,76.14,63.86 ,33.33
03,002,01,008,0171,0,418,5,423,688,0,3,1,3,0,1,0,76.14,61.48 ,33.33
03,002,01,008,0172,0,758,10,768,1282,0,3,1,3,0,1,0,76.14,59.91 ,33.33
03,002,01,008,0173,0,473,6,479,798,0,3,1,3,0,1,0,76.14,60.03 ,33.33
03,002,01,008,0174,0,646,10,656,1187,0,3,1,3,0,1,0,76.14,55.27 ,33.33
03,002,01,008,0175,0,246,7,253,414,0,3,1,3,0,1,0,76.14,61.11 ,33.33
03,002,01,008,0176,0,2116,21,2137,3803,0,3,1,3,0,1,0,76.14,56.19 ,33.33
03,002,01,008,0177,0,1088,11,1099,1899,0,3,1,3,0,1,0,76.14,57.87 ,33.33
03,002,01,008,0178,0,2521,41,2562,4510,0,3,1,3,0,1,0,76.14,56.81 ,33.33
03,002,01,008,0179,0,1482,17,1499,2554,0,3,1,3,0,1,0,76.14,58.69 ,33.33
03,002,01,008,0180,0,1207,12,1219,2076,0,3,1,3,0,1,0,76.14,58.72 ,33.33
03,002,01,008,0181,0,562,8,570,1029,0,3,1,3,0,1,0,76.14,55.39 ,33.33
03,002,01,008,0182,0,1148,12,1160,2049,0,3,1,3,0,1,0,76.14,56.61 ,33.33
03,002,01,008,0183,0,643,8,651,1070,0,3,1,3,0,1,0,76.14,60.84 ,33.33
03,002,01,008,0184,0,478,7,485,804,0,3,1,3,0,1,0,76.14,60.32 ,33.33
03,002,01,008,0185,0,443,6,449,766,0,3,1,3,0,1,0,76.14,58.62 ,33.33
03,002,01,009,0186,0,991,6,997,1592,0,3,1,3,0,1,0,76.14,62.63 ,33.33
03,002,01,009,0187,0,882,14,896,1396,0,3,1,3,0,1,0,76.14,64.18 ,33.33
03,002,01,009,0188,0,1124,12,1136,1825,0,3,1,3,0,1,0,76.14,62.25 ,33.33
03,002,01,009,0189,0,880,11,891,1438,0,3,1,3,0,1,0,76.14,61.96 ,33.33
03,002,01,009,0190,0,538,6,544,890,0,3,1,3,0,1,0,76.14,61.12 ,33.33
03,002,01,009,0191,0,1256,13,1269,2098,0,3,1,3,0,1,0,76.14,60.49 ,33.33
03,002,01,009,0192,0,973,6,979,1533,0,3,1,3,0,1,0,76.14,63.86 ,33.33
03,002,01,009,0193,0,1398,18,1416,2369,0,3,1,3,0,1,0,76.14,59.77 ,33.33
03,002,01,009,0194,0,1430,15,1445,2436,0,3,1,3,0,1,0,76.14,59.32 ,33.33
03,002,01,009,0195,0,1159,13,1172,1919,0,3,1,3,0,1,0,76.14,61.07 ,33.33
03,002,01,009,0196,0,742,5,747,1216,0,3,1,3,0,1,0,76.14,61.43 ,33.33
03,002,01,009,0197,0,810,4,814,1463,0,3,1,3,0,1,0,76.14,55.64 ,33.33
03,002,01,009,0198,0,1220,19,1239,2033,0,3,1,3,0,1,0,76.14,60.94 ,33.33
03,002,01,009,0199,0,1256,15,1271,2241,0,3,1,3,0,1,0,76.14,56.72 ,33.33
03,002,01,009,0200,0,1054,6,1060,1888,0,3,1,3,0,1,0,76.14,56.14 ,33.33
03,002,01,010,0201,0,138,1,139,243,0,3,1,3,0,1,0,76.14,57.20 ,33.33
03,002,01,010,0202,0,342,7,349,666,0,3,1,3,0,1,0,76.14,52.40 ,33.33
03,002,01,010,0203,0,446,4,450,861,0,3,1,3,0,1,0,76.14,52.26 ,33.33
03,002,01,010,0204,0,369,3,372,662,0,3,1,3,0,1,0,76.14,56.19 ,33.33
03,002,01,010,0205,0,295,3,298,485,0,3,1,3,0,1,0,76.14,61.44 ,33.33
03,002,01,010,0206,0,660,11,671,1180,0,3,1,3,0,1,0,76.14,56.86 ,33.33
03,002,01,010,0207,0,628,9,637,1095,0,3,1,3,0,1,0,76.14,58.17 ,33.33
03,002,01,010,0208,0,481,9,490,843,0,3,1,3,0,1,0,76.14,58.13 ,33.33
03,002,01,010,0209,0,557,3,560,1185,0,3,1,3,0,1,0,76.14,47.26 ,33.33
03,002,01,010,0210,0,1526,21,1547,2583,0,3,1,3,0,1,0,76.14,59.89 ,33.33
03,002,01,010,0211,0,360,5,365,660,0,3,1,3,0,1,0,76.14,55.30 ,33.33
03,002,01,010,0212,0,306,10,316,555,0,3,1,3,0,1,0,76.14,56.94 ,33.33
03,002,01,010,0213,0,248,1,249,468,0,3,1,3,0,1,0,76.14,53.21 ,33.33
03,002,01,010,0214,0,363,3,366,658,0,3,1,3,0,1,0,76.14,55.62 ,33.33
03,002,01,010,0215,0,644,12,656,1039,0,3,1,3,0,1,0,76.14,63.14 ,33.33
03,002,01,010,0216,0,461,4,465,790,0,3,1,3,0,1,0,76.14,58.86 ,33.33
03,002,01,010,0217,0,846,11,857,1232,0,3,1,3,0,1,0,76.14,69.56 ,33.33
03,002,01,010,0218,0,673,6,679,1075,0,3,1,3,0,1,0,76.14,63.16 ,33.33
03,002,01,011,0219,0,52,0,52,98,0,3,1,3,0,1,0,76.14,53.06 ,33.33
03,002,01,011,0220,0,46,0,46,101,0,3,1,3,0,1,0,76.14,45.54 ,33.33
03,002,01,011,0221,0,109,1,110,223,0,3,1,3,0,1,0,76.14,49.33 ,33.33
03,002,01,011,0222,0,118,2,120,222,0,3,1,3,0,1,0,76.14,54.05 ,33.33
03,002,01,011,0223,0,39,0,39,89,0,3,1,3,0,1,0,76.14,43.82 ,33.33
03,002,01,011,0224,0,27,2,29,73,0,3,1,3,0,1,0,76.14,39.73 ,33.33
03,002,01,011,0225,0,38,1,39,65,0,3,1,3,0,1,0,76.14,60.00 ,33.33
03,002,01,011,0226,0,11,0,11,14,0,3,1,3,0,1,0,76.14,78.57 ,33.33
03,002,01,011,0227,0,22,0,22,49,0,3,1,3,0,1,0,76.14,44.90 ,33.33
03,002,01,011,0228,0,27,0,27,60,0,3,1,3,0,1,0,76.14,45.00 ,33.33
03,002,01,012,0229,0,46,1,47,82,0,3,1,3,0,1,0,76.14,57.32 ,33.33
03,002,01,012,0230,0,144,3,147,299,0,3,1,3,0,1,0,76.14,49.16 ,33.33
03,002,01,012,0231,0,38,0,38,105,0,3,1,3,0,1,0,76.14,36.19 ,33.33
03,002,01,012,0232,0,32,1,33,57,0,3,1,3,0,1,0,76.14,57.89 ,33.33
03,002,01,012,0233,0,66,1,67,143,0,3,1,3,0,1,0,76.14,46.85 ,33.33
03,002,01,012,0234,0,21,0,21,41,0,3,1,3,0,1,0,76.14,51.22 ,33.33
03,002,01,012,0235,0,88,0,88,194,0,3,1,3,0,1,0,76.14,45.36 ,33.33
03,003,01,001,0001,0,955,9,964,1531,0,3,1,3,0,1,0,76.14,62.97 ,33.33
03,003,01,001,0002,0,955,11,966,1400,0,3,1,3,0,1,0,76.14,69.00 ,33.33
03,003,01,001,0003,0,1363,15,1378,2161,0,3,1,3,0,1,0,76.14,63.77 ,33.33
03,003,01,001,0004,0,1248,14,1262,1937,0,3,1,3,0,1,0,76.14,65.15 ,33.33
03,003,01,001,0005,0,665,12,677,1009,0,3,1,3,0,1,0,76.14,67.10 ,33.33
03,003,01,001,0006,0,1805,19,1824,2820,0,3,1,3,0,1,0,76.14,64.68 ,33.33
03,003,01,001,0007,0,2264,29,2293,3536,0,3,1,3,0,1,0,76.14,64.85 ,33.33
03,003,01,001,0008,0,2402,36,2438,3813,0,3,1,3,0,1,0,76.14,63.94 ,33.33
03,003,01,001,0009,0,3102,46,3148,4634,0,3,1,3,0,1,0,76.14,67.93 ,33.33
03,003,01,001,0010,0,2767,38,2805,4058,0,3,1,3,0,1,0,76.14,69.12 ,33.33
03,003,01,001,0011,0,1940,19,1959,2846,0,3,1,3,0,1,0,76.14,68.83 ,33.33
03,003,01,001,0012,0,2702,39,2741,4234,0,3,1,3,0,1,0,76.14,64.74 ,33.33
03,003,01,001,0013,0,567,7,574,861,0,3,1,3,0,1,0,76.14,66.67 ,33.33
03,003,01,001,0014,0,1020,7,1027,1504,0,3,1,3,0,1,0,76.14,68.28 ,33.33
03,003,01,001,0015,0,760,18,778,1154,0,3,1,3,0,1,0,76.14,67.42 ,33.33
03,003,01,001,0016,0,2606,41,2647,4042,0,3,1,3,0,1,0,76.14,65.49 ,33.33
03,003,01,001,0017,0,971,13,984,1495,0,3,1,3,0,1,0,76.14,65.82 ,33.33
03,003,01,001,0018,0,2874,47,2921,4587,0,3,1,3,0,1,0,76.14,63.68 ,33.33
03,003,01,001,0019,0,3864,44,3908,6332,0,3,1,3,0,1,0,76.14,61.72 ,33.33
03,003,01,001,0020,0,2076,32,2108,3077,0,3,1,3,0,1,0,76.14,68.51 ,33.33
03,003,01,001,0021,0,2621,42,2663,4088,0,3,1,3,0,1,0,76.14,65.14 ,33.33
03,003,01,001,0022,0,1711,24,1735,2632,0,3,1,3,0,1,0,76.14,65.92 ,33.33
03,003,01,001,0023,0,1672,17,1689,2618,0,3,1,3,0,1,0,76.14,64.51 ,33.33
03,003,01,001,0024,0,2482,38,2520,3765,0,3,1,3,0,1,0,76.14,66.93 ,33.33
03,003,01,001,0025,0,1866,29,1895,2731,0,3,1,3,0,1,0,76.14,69.39 ,33.33
03,003,01,001,0026,0,2818,32,2850,4324,0,3,1,3,0,1,0,76.14,65.91 ,33.33
03,003,01,001,0027,0,2877,37,2914,4345,0,3,1,3,0,1,0,76.14,67.07 ,33.33
03,003,01,001,0028,0,3438,50,3488,5382,0,3,1,3,0,1,0,76.14,64.81 ,33.33
03,003,01,001,0029,0,1870,26,1896,2798,0,3,1,3,0,1,0,76.14,67.76 ,33.33
03,003,01,001,0030,0,2165,51,2216,3267,0,3,1,3,0,1,0,76.14,67.83 ,33.33
03,003,01,001,0031,0,731,9,740,1131,0,3,1,3,0,1,0,76.14,65.43 ,33.33
03,003,01,001,0032,0,1225,5,1230,1868,0,3,1,3,0,1,0,76.14,65.85 ,33.33
03,003,01,001,0033,0,952,6,958,1520,0,3,1,3,0,1,0,76.14,63.03 ,33.33
03,003,01,001,0034,0,814,12,826,1208,0,3,1,3,0,1,0,76.14,68.38 ,33.33
03,003,01,001,0035,0,2179,34,2213,3576,0,3,1,3,0,1,0,76.14,61.88 ,33.33
03,003,01,001,0036,0,2071,34,2105,3400,0,3,1,3,0,1,0,76.14,61.91 ,33.33
03,003,01,001,0037,0,2309,37,2346,3640,0,3,1,3,0,1,0,76.14,64.45 ,33.33
03,003,01,001,0038,0,2984,36,3020,4752,0,3,1,3,0,1,0,76.14,63.55 ,33.33
03,003,01,001,0039,0,1301,17,1318,1876,0,3,1,3,0,1,0,76.14,70.26 ,33.33
03,003,01,001,0040,0,3777,69,3846,6002,0,3,1,3,0,1,0,76.14,64.08 ,33.33
03,003,01,001,0041,0,1778,23,1801,2862,0,3,1,3,0,1,0,76.14,62.93 ,33.33
03,003,01,001,0042,0,1991,29,2020,3058,0,3,1,3,0,1,0,76.14,66.06 ,33.33
03,003,01,001,0043,0,1630,54,1684,2671,0,3,1,3,0,1,0,76.14,63.05 ,33.33
03,003,01,001,0044,0,1967,30,1997,3156,0,3,1,3,0,1,0,76.14,63.28 ,33.33
03,003,01,001,0045,0,2217,42,2259,3580,0,3,1,3,0,1,0,76.14,63.10 ,33.33
03,003,01,001,0046,0,1079,11,1090,1614,0,3,1,3,0,1,0,76.14,67.53 ,33.33
03,003,01,001,0047,0,1019,15,1034,1582,0,3,1,3,0,1,0,76.14,65.36 ,33.33
03,003,01,001,0048,0,2502,40,2542,4003,0,3,1,3,0,1,0,76.14,63.50 ,33.33
03,003,01,001,0049,0,1045,13,1058,1625,0,3,1,3,0,1,0,76.14,65.11 ,33.33
03,003,01,001,0050,0,1874,15,1889,2829,0,3,1,3,0,1,0,76.14,66.77 ,33.33
03,003,01,001,0051,0,1866,19,1885,2716,0,3,1,3,0,1,0,76.14,69.40 ,33.33
03,003,01,001,0052,0,2402,35,2437,4099,0,3,1,3,0,1,0,76.14,59.45 ,33.33
03,003,01,001,0053,0,2224,41,2265,3668,0,3,1,3,0,1,0,76.14,61.75 ,33.33
03,003,01,001,0054,0,1562,33,1595,2446,0,3,1,3,0,1,0,76.14,65.21 ,33.33
03,003,01,001,0055,0,1565,34,1599,2602,0,3,1,3,0,1,0,76.14,61.45 ,33.33
03,003,01,001,0056,0,1771,26,1797,2743,0,3,1,3,0,1,0,76.14,65.51 ,33.33
03,003,01,002,0057,0,2639,34,2673,4079,0,3,1,3,0,1,0,76.14,65.53 ,33.33
03,003,01,002,0058,0,2148,37,2185,3164,0,3,1,3,0,1,0,76.14,69.06 ,33.33
03,003,01,002,0059,0,2466,32,2498,3676,0,3,1,3,0,1,0,76.14,67.95 ,33.33
03,003,01,002,0060,0,3967,66,4033,6245,0,3,1,3,0,1,0,76.14,64.58 ,33.33
03,003,01,002,0061,0,1921,42,1963,2540,0,3,1,3,0,1,0,76.14,77.28 ,33.33
03,003,01,002,0062,0,1793,22,1815,2386,0,3,1,3,0,1,0,76.14,76.07 ,33.33
03,003,01,002,0063,0,1524,39,1563,2563,0,3,1,3,0,1,0,76.14,60.98 ,33.33
03,003,01,002,0064,0,3244,60,3304,5877,0,3,1,3,0,1,0,76.14,56.22 ,33.33
03,003,01,002,0065,0,2528,64,2592,4461,0,3,1,3,0,1,0,76.14,58.10 ,33.33
03,003,01,002,0066,0,1107,13,1120,1729,0,3,1,3,0,1,0,76.14,64.78 ,33.33
03,003,01,002,0067,0,2869,58,2927,4544,0,3,1,3,0,1,0,76.14,64.41 ,33.33
03,003,01,002,0068,0,1981,24,2005,5301,0,3,1,3,0,1,0,76.14,37.82 ,33.33
03,003,01,002,0069,0,3730,67,3797,6388,0,3,1,3,0,1,0,76.14,59.44 ,33.33
03,003,01,002,0070,0,2542,37,2579,4013,0,3,1,3,0,1,0,76.14,64.27 ,33.33
03,003,01,002,0071,0,1210,20,1230,2010,0,3,1,3,0,1,0,76.14,61.19 ,33.33
03,003,01,002,0072,0,1539,20,1559,2836,0,3,1,3,0,1,0,76.14,54.97 ,33.33
03,003,01,002,0073,0,665,12,677,1037,0,3,1,3,0,1,0,76.14,65.28 ,33.33
03,003,01,002,0074,0,1303,20,1323,2065,0,3,1,3,0,1,0,76.14,64.07 ,33.33
03,003,01,002,0075,0,1212,18,1230,1834,0,3,1,3,0,1,0,76.14,67.07 ,33.33
03,003,01,003,0076,0,1491,27,1518,2343,0,3,1,3,0,1,0,76.14,64.79 ,33.33
03,003,01,003,0077,0,1573,47,1620,2243,0,3,1,3,0,1,0,76.14,72.22 ,33.33
03,003,01,003,0078,0,1977,38,2015,2829,0,3,1,3,0,1,0,76.14,71.23 ,33.33
03,003,01,003,0079,0,1658,24,1682,2610,0,3,1,3,0,1,0,76.14,64.44 ,33.33
03,003,01,003,0080,0,2135,33,2168,3025,0,3,1,3,0,1,0,76.14,71.67 ,33.33
03,003,01,003,0081,0,2066,38,2104,2916,0,3,1,3,0,1,0,76.14,72.15 ,33.33
03,003,01,003,0082,0,1921,28,1949,2684,0,3,1,3,0,1,0,76.14,72.62 ,33.33
03,003,01,003,0083,0,2208,53,2261,3318,0,3,1,3,0,1,0,76.14,68.14 ,33.33
03,003,01,003,0084,0,1814,31,1845,2517,0,3,1,3,0,1,0,76.14,73.30 ,33.33
03,003,01,003,0085,0,1414,27,1441,2161,0,3,1,3,0,1,0,76.14,66.68 ,33.33
03,003,01,003,0086,0,2513,60,2573,3624,0,3,1,3,0,1,0,76.14,71.00 ,33.33
03,003,01,003,0087,0,3029,66,3095,4697,0,3,1,3,0,1,0,76.14,65.89 ,33.33
03,003,01,003,0088,0,2870,53,2923,4357,0,3,1,3,0,1,0,76.14,67.09 ,33.33
03,003,01,003,0089,0,1278,33,1311,1826,0,3,1,3,0,1,0,76.14,71.80 ,33.33
03,003,01,003,0090,0,1223,20,1243,2016,0,3,1,3,0,1,0,76.14,61.66 ,33.33
03,003,01,003,0091,0,883,7,890,1267,0,3,1,3,0,1,0,76.14,70.24 ,33.33
03,003,01,003,0092,0,1590,31,1621,2502,0,3,1,3,0,1,0,76.14,64.79 ,33.33
03,003,01,003,0093,0,1094,19,1113,1832,0,3,1,3,0,1,0,76.14,60.75 ,33.33
03,003,01,003,0094,0,806,20,826,1173,0,3,1,3,0,1,0,76.14,70.42 ,33.33
03,003,01,003,0095,0,713,7,720,1059,0,3,1,3,0,1,0,76.14,67.99 ,33.33
03,003,01,003,0096,0,1981,38,2019,3082,0,3,1,3,0,1,0,76.14,65.51 ,33.33
03,003,01,003,0097,0,2299,37,2336,3466,0,3,1,3,0,1,0,76.14,67.40 ,33.33
03,003,01,003,0098,0,3673,78,3751,5989,0,3,1,3,0,1,0,76.14,62.63 ,33.33
03,003,01,003,0099,0,1118,18,1136,1706,0,3,1,3,0,1,0,76.14,66.59 ,33.33
03,003,01,003,0100,0,1573,28,1601,2365,0,3,1,3,0,1,0,76.14,67.70 ,33.33
03,003,01,003,0101,0,1483,25,1508,2073,0,3,1,3,0,1,0,76.14,72.74 ,33.33
03,003,01,003,0102,0,3019,50,3069,4517,0,3,1,3,0,1,0,76.14,67.94 ,33.33
03,003,01,003,0103,0,2655,30,2685,4001,0,3,1,3,0,1,0,76.14,67.11 ,33.33
03,003,01,003,0104,0,1249,19,1268,1797,0,3,1,3,0,1,0,76.14,70.56 ,33.33
03,003,01,003,0105,0,2438,33,2471,3532,0,3,1,3,0,1,0,76.14,69.96 ,33.33
03,003,01,003,0106,0,1573,28,1601,2315,0,3,1,3,0,1,0,76.14,69.16 ,33.33
03,003,01,003,0107,0,1648,24,1672,2542,0,3,1,3,0,1,0,76.14,65.77 ,33.33
03,003,01,003,0108,0,1316,22,1338,1934,0,3,1,3,0,1,0,76.14,69.18 ,33.33
03,003,01,003,0109,0,1831,31,1862,2738,0,3,1,3,0,1,0,76.14,68.01 ,33.33
03,003,01,004,0110,0,1567,25,1592,2371,0,3,1,3,0,1,0,76.14,67.14 ,33.33
03,003,01,004,0111,0,1487,29,1516,2148,0,3,1,3,0,1,0,76.14,70.58 ,33.33
03,003,01,004,0112,0,1610,28,1638,2295,0,3,1,3,0,1,0,76.14,71.37 ,33.33
03,003,01,004,0113,0,574,9,583,790,0,3,1,3,0,1,0,76.14,73.80 ,33.33
03,003,01,004,0114,0,1019,14,1033,1471,0,3,1,3,0,1,0,76.14,70.22 ,33.33
03,003,01,004,0115,0,1168,28,1196,1702,0,3,1,3,0,1,0,76.14,70.27 ,33.33
03,003,01,004,0116,0,1235,17,1252,1753,0,3,1,3,0,1,0,76.14,71.42 ,33.33
03,003,01,004,0117,0,1468,25,1493,1861,0,3,1,3,0,1,0,76.14,80.23 ,33.33
03,003,01,004,0118,0,1937,35,1972,2666,0,3,1,3,0,1,0,76.14,73.97 ,33.33
03,003,01,004,0119,0,1215,23,1238,1816,0,3,1,3,0,1,0,76.14,68.17 ,33.33
03,003,01,004,0120,0,930,18,948,1464,0,3,1,3,0,1,0,76.14,64.75 ,33.33
03,003,01,004,0121,0,1222,29,1251,1875,0,3,1,3,0,1,0,76.14,66.72 ,33.33
03,003,01,004,0122,0,1210,25,1235,1900,0,3,1,3,0,1,0,76.14,65.00 ,33.33
03,003,01,004,0123,0,1042,22,1064,1551,0,3,1,3,0,1,0,76.14,68.60 ,33.33
03,003,01,004,0124,0,591,11,602,897,0,3,1,3,0,1,0,76.14,67.11 ,33.33
03,003,01,004,0125,0,2314,40,2354,3883,0,3,1,3,0,1,0,76.14,60.62 ,33.33
03,003,01,004,0126,0,1116,16,1132,1579,0,3,1,3,0,1,0,76.14,71.69 ,33.33
03,003,01,004,0127,0,769,12,781,1155,0,3,1,3,0,1,0,76.14,67.62 ,33.33
03,003,01,004,0128,0,1013,13,1026,1511,0,3,1,3,0,1,0,76.14,67.90 ,33.33
03,003,01,004,0129,0,822,12,834,1155,0,3,1,3,0,1,0,76.14,72.21 ,33.33
03,003,01,004,0130,0,1896,46,1942,2720,0,3,1,3,0,1,0,76.14,71.40 ,33.33
03,003,01,004,0131,0,1363,20,1383,1888,0,3,1,3,0,1,0,76.14,73.25 ,33.33
03,003,01,004,0132,0,1721,31,1752,2541,0,3,1,3,0,1,0,76.14,68.95 ,33.33
03,003,01,005,0133,0,3465,52,3517,4676,0,3,1,3,0,1,0,76.14,75.21 ,33.33
03,003,01,005,0134,0,2418,21,2439,3430,0,3,1,3,0,1,0,76.14,71.11 ,33.33
03,003,01,005,0135,0,1440,26,1466,2174,0,3,1,3,0,1,0,76.14,67.43 ,33.33
03,003,01,005,0136,0,968,8,976,1393,0,3,1,3,0,1,0,76.14,70.06 ,33.33
03,003,01,005,0137,0,2860,39,2899,4233,0,3,1,3,0,1,0,76.14,68.49 ,33.33
03,003,01,005,0138,0,2070,35,2105,2942,0,3,1,3,0,1,0,76.14,71.55 ,33.33
03,003,01,005,0139,0,2569,44,2613,3640,0,3,1,3,0,1,0,76.14,71.79 ,33.33
03,003,01,005,0140,0,877,13,890,1178,0,3,1,3,0,1,0,76.14,75.55 ,33.33
03,003,01,005,0141,0,779,12,791,984,0,3,1,3,0,1,0,76.14,80.39 ,33.33
03,003,01,005,0142,0,1639,23,1662,2181,0,3,1,3,0,1,0,76.14,76.20 ,33.33
03,003,01,005,0143,0,2279,43,2322,3383,0,3,1,3,0,1,0,76.14,68.64 ,33.33
03,003,01,005,0144,0,1447,11,1458,2068,0,3,1,3,0,1,0,76.14,70.50 ,33.33
03,003,01,005,0145,0,854,22,876,1261,0,3,1,3,0,1,0,76.14,69.47 ,33.33
03,003,01,005,0146,0,1421,22,1443,2147,0,3,1,3,0,1,0,76.14,67.21 ,33.33
03,003,01,005,0147,0,855,12,867,1244,0,3,1,3,0,1,0,76.14,69.69 ,33.33
03,003,01,005,0148,0,1160,17,1177,1683,0,3,1,3,0,1,0,76.14,69.93 ,33.33
03,003,01,005,0149,0,1125,13,1138,1609,0,3,1,3,0,1,0,76.14,70.73 ,33.33
03,003,01,005,0150,0,952,13,965,1393,0,3,1,3,0,1,0,76.14,69.27 ,33.33
03,003,01,005,0151,0,1017,9,1026,1593,0,3,1,3,0,1,0,76.14,64.41 ,33.33
03,003,01,006,0152,0,1180,12,1192,1710,0,3,1,3,0,1,0,76.14,69.71 ,33.33
03,003,01,006,0153,0,796,15,811,1148,0,3,1,3,0,1,0,76.14,70.64 ,33.33
03,003,01,006,0154,0,3603,57,3660,5467,0,3,1,3,0,1,0,76.14,66.95 ,33.33
03,003,01,006,0155,0,2105,32,2137,3286,0,3,1,3,0,1,0,76.14,65.03 ,33.33
03,003,01,006,0156,0,644,15,659,964,0,3,1,3,0,1,0,76.14,68.36 ,33.33
03,003,01,006,0157,0,601,10,611,891,0,3,1,3,0,1,0,76.14,68.57 ,33.33
03,003,01,006,0158,0,690,11,701,993,0,3,1,3,0,1,0,76.14,70.59 ,33.33
03,003,01,006,0159,0,1067,13,1080,1582,0,3,1,3,0,1,0,76.14,68.27 ,33.33
03,003,01,006,0160,0,1366,27,1393,2178,0,3,1,3,0,1,0,76.14,63.96 ,33.33
03,003,01,006,0161,0,1405,18,1423,2091,0,3,1,3,0,1,0,76.14,68.05 ,33.33
03,003,01,006,0162,0,586,16,602,950,0,3,1,3,0,1,0,76.14,63.37 ,33.33
03,003,01,006,0163,0,645,11,656,1003,0,3,1,3,0,1,0,76.14,65.40 ,33.33
03,003,01,006,0164,0,1038,24,1062,1544,0,3,1,3,0,1,0,76.14,68.78 ,33.33
03,003,01,006,0165,0,1300,31,1331,1912,0,3,1,3,0,1,0,76.14,69.61 ,33.33
03,003,01,006,0166,0,1474,30,1504,2199,0,3,1,3,0,1,0,76.14,68.39 ,33.33
03,003,01,006,0167,0,1107,13,1120,1446,0,3,1,3,0,1,0,76.14,77.46 ,33.33
03,003,01,006,0168,0,1885,53,1938,2691,0,3,1,3,0,1,0,76.14,72.02 ,33.33
03,003,01,006,0169,0,2178,44,2222,3258,0,3,1,3,0,1,0,76.14,68.20 ,33.33
03,003,01,006,0170,0,3632,55,3687,5335,0,3,1,3,0,1,0,76.14,69.11 ,33.33
03,003,01,006,0171,0,2306,50,2356,3398,0,3,1,3,0,1,0,76.14,69.33 ,33.33
03,003,01,006,0172,0,3662,56,3718,5155,0,3,1,3,0,1,0,76.14,72.12 ,33.33
03,003,01,006,0173,0,1607,22,1629,2437,0,3,1,3,0,1,0,76.14,66.84 ,33.33
03,003,01,007,0174,0,711,12,723,1228,0,3,1,3,0,1,0,76.14,58.88 ,33.33
03,003,01,007,0175,0,411,2,413,604,0,3,1,3,0,1,0,76.14,68.38 ,33.33
03,003,01,007,0176,0,67,1,68,121,0,3,1,3,0,1,0,76.14,56.20 ,33.33
03,003,01,007,0177,0,23,0,23,41,0,3,1,3,0,1,0,76.14,56.10 ,33.33
03,003,01,007,0178,0,183,1,184,302,0,3,1,3,0,1,0,76.14,60.93 ,33.33
03,003,01,007,0179,0,23,0,23,40,0,3,1,3,0,1,0,76.14,57.50 ,33.33
03,003,01,007,0180,0,26,1,27,42,0,3,1,3,0,1,0,76.14,64.29 ,33.33
03,003,01,007,0181,0,25,1,26,53,0,3,1,3,0,1,0,76.14,49.06 ,33.33
03,003,01,007,0182,0,26,0,26,58,0,3,1,3,0,1,0,76.14,44.83 ,33.33
03,003,01,007,0183,0,89,0,89,231,0,3,1,3,0,1,0,76.14,38.53 ,33.33
03,003,01,008,0184,0,4556,66,4622,6927,0,3,1,3,0,1,0,76.14,66.72 ,33.33
03,003,01,008,0185,0,3894,57,3951,5672,0,3,1,3,0,1,0,76.14,69.66 ,33.33
03,003,01,008,0186,0,2362,45,2407,3336,0,3,1,3,0,1,0,76.14,72.15 ,33.33
03,003,01,008,0187,0,2789,46,2835,3882,0,3,1,3,0,1,0,76.14,73.03 ,33.33
03,003,01,008,0188,0,2524,52,2576,3605,0,3,1,3,0,1,0,76.14,71.46 ,33.33
03,003,01,008,0189,0,3855,71,3926,5375,0,3,1,3,0,1,0,76.14,73.04 ,33.33
03,003,01,008,0190,0,3718,71,3789,5431,0,3,1,3,0,1,0,76.14,69.77 ,33.33
03,003,01,008,0191,0,2009,42,2051,3045,0,3,1,3,0,1,0,76.14,67.36 ,33.33
03,003,01,008,0192,0,2463,47,2510,3664,0,3,1,3,0,1,0,76.14,68.50 ,33.33
03,003,01,008,0193,0,3394,58,3452,5052,0,3,1,3,0,1,0,76.14,68.33 ,33.33
03,003,01,008,0194,0,2745,48,2793,3750,0,3,1,3,0,1,0,76.14,74.48 ,33.33
03,003,01,008,0195,0,4476,64,4540,6890,0,3,1,3,0,1,0,76.14,65.89 ,33.33
03,003,01,008,0196,0,1552,24,1576,2342,0,3,1,3,0,1,0,76.14,67.29 ,33.33
03,003,01,008,0197,0,3704,53,3757,5506,0,3,1,3,0,1,0,76.14,68.23 ,33.33
03,003,01,008,0198,0,3622,44,3666,5535,0,3,1,3,0,1,0,76.14,66.23 ,33.33
03,003,01,008,0199,0,946,13,959,1447,0,3,1,3,0,1,0,76.14,66.28 ,33.33
03,003,01,008,0200,0,2406,38,2444,3537,0,3,1,3,0,1,0,76.14,69.10 ,33.33
03,003,01,008,0201,0,2737,44,2781,4102,0,3,1,3,0,1,0,76.14,67.80 ,33.33
03,003,01,008,0202,0,1089,22,1111,1514,0,3,1,3,0,1,0,76.14,73.38 ,33.33
03,003,01,008,0203,0,1773,39,1812,2530,0,3,1,3,0,1,0,76.14,71.62 ,33.33
03,003,01,008,0204,0,3162,41,3203,4598,0,3,1,3,0,1,0,76.14,69.66 ,33.33
03,003,01,008,0205,0,3408,51,3459,4819,0,3,1,3,0,1,0,76.14,71.78 ,33.33
03,003,01,008,0206,0,3834,54,3888,5609,0,3,1,3,0,1,0,76.14,69.32 ,33.33
03,003,01,008,0207,0,3320,68,3388,5000,0,3,1,3,0,1,0,76.14,67.76 ,33.33
03,003,01,008,0208,0,2142,23,2165,2831,0,3,1,3,0,1,0,76.14,76.47 ,33.33
03,003,01,008,0209,0,3250,35,3285,4399,0,3,1,3,0,1,0,76.14,74.68 ,33.33
03,003,01,008,0210,0,1640,28,1668,2298,0,3,1,3,0,1,0,76.14,72.58 ,33.33
03,003,01,008,0211,0,1213,24,1237,2039,0,3,1,3,0,1,0,76.14,60.67 ,33.33
03,003,01,008,0212,0,2303,31,2334,3468,0,3,1,3,0,1,0,76.14,67.30 ,33.33
03,003,01,008,0213,0,2747,41,2788,4060,0,3,1,3,0,1,0,76.14,68.67 ,33.33
03,003,01,008,0214,0,2332,47,2379,3368,0,3,1,3,0,1,0,76.14,70.64 ,33.33
03,003,01,008,0215,0,3138,37,3175,4698,0,3,1,3,0,1,0,76.14,67.58 ,33.33
03,003,01,008,0216,0,2188,25,2213,3312,0,3,1,3,0,1,0,76.14,66.82 ,33.33
03,003,01,008,0217,0,6183,88,6271,9743,0,3,1,3,0,1,0,76.14,64.36 ,33.33
03,003,01,008,0218,0,920,9,929,1283,0,3,1,3,0,1,0,76.14,72.41 ,33.33
03,003,01,008,0219,0,1189,15,1204,1762,0,3,1,3,0,1,0,76.14,68.33 ,33.33
03,003,01,008,0220,0,980,18,998,1493,0,3,1,3,0,1,0,76.14,66.85 ,33.33
03,003,01,008,0221,0,2755,27,2782,4198,0,3,1,3,0,1,0,76.14,66.27 ,33.33
03,003,01,008,0222,0,1583,27,1610,2285,0,3,1,3,0,1,0,76.14,70.46 ,33.33
03,003,01,008,0223,0,689,14,703,1099,0,3,1,3,0,1,0,76.14,63.97 ,33.33
03,003,01,008,0224,0,644,11,655,979,0,3,1,3,0,1,0,76.14,66.91 ,33.33
03,003,01,008,0225,0,752,6,758,1190,0,3,1,3,0,1,0,76.14,63.70 ,33.33
03,003,01,008,0226,0,803,2,805,1145,0,3,1,3,0,1,0,76.14,70.31 ,33.33
03,003,01,008,0227,0,1615,19,1634,2276,0,3,1,3,0,1,0,76.14,71.79 ,33.33
03,003,01,008,0228,0,2348,33,2381,3528,0,3,1,3,0,1,0,76.14,67.49 ,33.33
03,003,01,008,0229,0,2743,35,2778,4147,0,3,1,3,0,1,0,76.14,66.99 ,33.33
03,003,01,008,0230,0,1737,22,1759,2616,0,3,1,3,0,1,0,76.14,67.24 ,33.33
03,003,01,008,0231,0,1527,25,1552,2309,0,3,1,3,0,1,0,76.14,67.22 ,33.33
03,003,01,008,0232,0,4317,81,4398,6716,0,3,1,3,0,1,0,76.14,65.49 ,33.33
03,003,01,008,0233,0,1280,19,1299,1776,0,3,1,3,0,1,0,76.14,73.14 ,33.33
03,003,01,008,0234,0,905,28,933,1277,0,3,1,3,0,1,0,76.14,73.06 ,33.33
03,003,01,008,0235,0,1854,27,1881,2795,0,3,1,3,0,1,0,76.14,67.30 ,33.33
03,003,01,008,0236,0,1674,20,1694,2382,0,3,1,3,0,1,0,76.14,71.12 ,33.33
03,003,01,008,0237,0,1644,35,1679,2398,0,3,1,3,0,1,0,76.14,70.02 ,33.33
03,003,01,008,0238,0,1445,16,1461,2105,0,3,1,3,0,1,0,76.14,69.41 ,33.33
03,003,01,009,0239,0,2058,30,2088,3021,0,3,1,3,0,1,0,76.14,69.12 ,33.33
03,003,01,009,0240,0,1892,39,1931,2713,0,3,1,3,0,1,0,76.14,71.18 ,33.33
03,003,01,009,0241,0,1537,19,1556,2400,0,3,1,3,0,1,0,76.14,64.83 ,33.33
03,003,01,009,0242,0,1187,21,1208,1728,0,3,1,3,0,1,0,76.14,69.91 ,33.33
03,003,01,009,0243,0,1106,16,1122,1581,0,3,1,3,0,1,0,76.14,70.97 ,33.33
03,003,01,009,0244,0,1467,14,1481,2084,0,3,1,3,0,1,0,76.14,71.07 ,33.33
03,003,01,009,0245,0,1524,22,1546,2255,0,3,1,3,0,1,0,76.14,68.56 ,33.33
03,003,01,009,0246,0,1106,9,1115,1481,0,3,1,3,0,1,0,76.14,75.29 ,33.33
03,003,01,009,0247,0,1961,32,1993,2834,0,3,1,3,0,1,0,76.14,70.32 ,33.33
03,003,01,009,0248,0,1744,21,1765,2430,0,3,1,3,0,1,0,76.14,72.63 ,33.33
03,003,01,009,0249,0,1325,19,1344,1927,0,3,1,3,0,1,0,76.14,69.75 ,33.33
03,003,01,009,0250,0,1660,48,1708,2391,0,3,1,3,0,1,0,76.14,71.43 ,33.33
03,003,01,009,0251,0,1999,35,2034,2776,0,3,1,3,0,1,0,76.14,73.27 ,33.33
03,003,01,009,0252,0,1513,39,1552,2217,0,3,1,3,0,1,0,76.14,70.00 ,33.33
03,003,01,009,0253,0,963,26,989,1339,0,3,1,3,0,1,0,76.14,73.86 ,33.33
03,003,01,009,0254,0,903,12,915,1198,0,3,1,3,0,1,0,76.14,76.38 ,33.33
03,003,01,009,0255,0,1837,41,1878,2417,0,3,1,3,0,1,0,76.14,77.70 ,33.33
03,003,01,009,0256,0,1755,28,1783,2559,0,3,1,3,0,1,0,76.14,69.68 ,33.33
03,003,01,009,0257,0,1748,41,1789,2505,0,3,1,3,0,1,0,76.14,71.42 ,33.33
03,003,01,009,0258,0,1335,25,1360,1917,0,3,1,3,0,1,0,76.14,70.94 ,33.33
03,003,01,009,0259,0,1510,35,1545,2217,0,3,1,3,0,1,0,76.14,69.69 ,33.33
03,003,01,009,0260,0,2046,34,2080,2998,0,3,1,3,0,1,0,76.14,69.38 ,33.33
03,003,01,009,0261,0,2548,47,2595,3759,0,3,1,3,0,1,0,76.14,69.03 ,33.33
03,003,01,009,0262,0,895,18,913,1273,0,3,1,3,0,1,0,76.14,71.72 ,33.33
03,003,01,009,0263,0,2751,60,2811,3916,0,3,1,3,0,1,0,76.14,71.78 ,33.33
03,003,01,009,0264,0,1530,23,1553,2329,0,3,1,3,0,1,0,76.14,66.68 ,33.33
03,003,01,009,0265,0,2069,32,2101,3024,0,3,1,3,0,1,0,76.14,69.48 ,33.33
03,003,01,009,0266,0,1835,18,1853,2700,0,3,1,3,0,1,0,76.14,68.63 ,33.33
03,003,01,009,0267,0,2507,46,2553,3907,0,3,1,3,0,1,0,76.14,65.34 ,33.33
03,003,01,009,0268,0,2468,49,2517,3695,0,3,1,3,0,1,0,76.14,68.12 ,33.33
03,003,01,009,0269,0,1741,30,1771,2682,0,3,1,3,0,1,0,76.14,66.03 ,33.33
03,003,01,009,0270,0,1581,29,1610,2385,0,3,1,3,0,1,0,76.14,67.51 ,33.33
03,003,01,009,0271,0,1871,40,1911,3019,0,3,1,3,0,1,0,76.14,63.30 ,33.33
03,003,01,009,0272,0,2089,40,2129,3084,0,3,1,3,0,1,0,76.14,69.03 ,33.33
03,003,01,009,0273,0,1396,13,1409,2119,0,3,1,3,0,1,0,76.14,66.49 ,33.33
03,003,01,009,0274,0,1991,46,2037,2902,0,3,1,3,0,1,0,76.14,70.19 ,33.33
03,003,01,009,0275,0,1353,25,1378,1931,0,3,1,3,0,1,0,76.14,71.36 ,33.33
03,003,01,009,0276,0,3485,64,3549,5279,0,3,1,3,0,1,0,76.14,67.23 ,33.33
03,003,01,009,0277,0,1858,22,1880,2773,0,3,1,3,0,1,0,76.14,67.80 ,33.33
03,003,01,009,0278,0,1304,28,1332,1796,0,3,1,3,0,1,0,76.14,74.16 ,33.33
03,003,01,009,0279,0,1478,29,1507,2182,0,3,1,3,0,1,0,76.14,69.07 ,33.33
03,003,01,010,0280,0,2547,42,2589,3669,0,3,1,3,0,1,0,76.14,70.56 ,33.33
03,003,01,010,0281,0,1125,19,1144,1580,0,3,1,3,0,1,0,76.14,72.41 ,33.33
03,003,01,010,0282,0,1761,34,1795,2485,0,3,1,3,0,1,0,76.14,72.23 ,33.33
03,003,01,010,0283,0,1247,24,1271,1661,0,3,1,3,0,1,0,76.14,76.52 ,33.33
03,003,01,010,0284,0,1267,16,1283,1722,0,3,1,3,0,1,0,76.14,74.51 ,33.33
03,003,01,010,0285,0,3359,58,3417,5269,0,3,1,3,0,1,0,76.14,64.85 ,33.33
03,003,01,010,0286,0,3087,50,3137,4993,0,3,1,3,0,1,0,76.14,62.83 ,33.33
03,003,01,010,0287,0,2589,41,2630,3731,0,3,1,3,0,1,0,76.14,70.49 ,33.33
03,003,01,010,0288,0,1950,22,1972,2745,0,3,1,3,0,1,0,76.14,71.84 ,33.33
03,003,01,010,0289,0,794,7,801,1140,0,3,1,3,0,1,0,76.14,70.26 ,33.33
03,003,01,010,0290,0,1044,19,1063,1639,0,3,1,3,0,1,0,76.14,64.86 ,33.33
03,003,01,010,0291,0,1381,25,1406,2047,0,3,1,3,0,1,0,76.14,68.69 ,33.33
03,003,01,010,0292,0,2037,34,2071,2904,0,3,1,3,0,1,0,76.14,71.32 ,33.33
03,003,01,010,0293,0,3565,66,3631,5243,0,3,1,3,0,1,0,76.14,69.25 ,33.33
03,003,01,010,0294,0,998,16,1014,1406,0,3,1,3,0,1,0,76.14,72.12 ,33.33
03,003,01,010,0295,0,1810,31,1841,2721,0,3,1,3,0,1,0,76.14,67.66 ,33.33
03,003,01,010,0296,0,2569,44,2613,3844,0,3,1,3,0,1,0,76.14,67.98 ,33.33
03,003,01,010,0297,0,956,21,977,1488,0,3,1,3,0,1,0,76.14,65.66 ,33.33
03,003,01,010,0298,0,1035,14,1049,1497,0,3,1,3,0,1,0,76.14,70.07 ,33.33
03,003,01,010,0299,0,1465,38,1503,2347,0,3,1,3,0,1,0,76.14,64.04 ,33.33
03,003,01,010,0300,0,1192,22,1214,1842,0,3,1,3,0,1,0,76.14,65.91 ,33.33
03,003,01,010,0301,0,2054,48,2102,3349,0,3,1,3,0,1,0,76.14,62.77 ,33.33
03,003,01,010,0302,0,2825,54,2879,4372,0,3,1,3,0,1,0,76.14,65.85 ,33.33
03,003,01,010,0303,0,1813,33,1846,2678,0,3,1,3,0,1,0,76.14,68.93 ,33.33
03,003,01,010,0304,0,1626,36,1662,2518,0,3,1,3,0,1,0,76.14,66.00 ,33.33
03,003,01,011,0305,0,3161,52,3213,4772,0,3,1,3,0,1,0,76.14,67.33 ,33.33
03,003,01,011,0306,0,2257,24,2281,3115,0,3,1,3,0,1,0,76.14,73.23 ,33.33
03,003,01,011,0307,0,2873,57,2930,4247,0,3,1,3,0,1,0,76.14,68.99 ,33.33
03,003,01,011,0308,0,574,11,585,735,0,3,1,3,0,1,0,76.14,79.59 ,33.33
03,003,01,011,0309,0,3219,42,3261,4685,0,3,1,3,0,1,0,76.14,69.61 ,33.33
03,003,01,011,0310,0,2809,50,2859,4320,0,3,1,3,0,1,0,76.14,66.18 ,33.33
03,003,01,011,0311,0,1329,30,1359,1979,0,3,1,3,0,1,0,76.14,68.67 ,33.33
03,003,01,011,0312,0,1489,12,1501,2022,0,3,1,3,0,1,0,76.14,74.23 ,33.33
03,003,01,011,0313,0,3700,65,3765,5283,0,3,1,3,0,1,0,76.14,71.27 ,33.33
03,003,01,011,0314,0,2266,48,2314,3497,0,3,1,3,0,1,0,76.14,66.17 ,33.33
03,003,01,011,0315,0,4332,98,4430,6485,0,3,1,3,0,1,0,76.14,68.31 ,33.33
03,003,01,011,0316,0,1973,18,1991,2709,0,3,1,3,0,1,0,76.14,73.50 ,33.33
03,003,01,011,0317,0,840,14,854,1264,0,3,1,3,0,1,0,76.14,67.56 ,33.33
03,003,01,011,0318,0,488,7,495,759,0,3,1,3,0,1,0,76.14,65.22 ,33.33
03,003,01,011,0319,0,4341,48,4389,6007,0,3,1,3,0,1,0,76.14,73.06 ,33.33
03,003,01,011,0320,0,1211,23,1234,1810,0,3,1,3,0,1,0,76.14,68.18 ,33.33
03,003,01,011,0321,0,1253,23,1276,1855,0,3,1,3,0,1,0,76.14,68.79 ,33.33
03,003,01,011,0322,0,579,13,592,818,0,3,1,3,0,1,0,76.14,72.37 ,33.33
03,003,01,011,0323,0,492,8,500,653,0,3,1,3,0,1,0,76.14,76.57 ,33.33
03,003,01,012,0324,0,1626,17,1643,2257,0,3,1,3,0,1,0,76.14,72.80 ,33.33
03,003,01,012,0325,0,1929,21,1950,2615,0,3,1,3,0,1,0,76.14,74.57 ,33.33
03,003,01,012,0326,0,757,10,767,1036,0,3,1,3,0,1,0,76.14,74.03 ,33.33
03,003,01,012,0327,0,1717,24,1741,2429,0,3,1,3,0,1,0,76.14,71.68 ,33.33
03,003,01,012,0328,0,1109,13,1122,1525,0,3,1,3,0,1,0,76.14,73.57 ,33.33
03,003,01,012,0329,0,742,10,752,1017,0,3,1,3,0,1,0,76.14,73.94 ,33.33
03,003,01,012,0330,0,972,12,984,1303,0,3,1,3,0,1,0,76.14,75.52 ,33.33
03,003,01,012,0331,0,1190,22,1212,1783,0,3,1,3,0,1,0,76.14,67.98 ,33.33
03,003,01,012,0332,0,1088,15,1103,1565,0,3,1,3,0,1,0,76.14,70.48 ,33.33
03,003,01,012,0333,0,1704,34,1738,2493,0,3,1,3,0,1,0,76.14,69.72 ,33.33
03,003,01,012,0334,0,953,9,962,1370,0,3,1,3,0,1,0,76.14,70.22 ,33.33
03,003,01,012,0335,0,1110,10,1120,1536,0,3,1,3,0,1,0,76.14,72.92 ,33.33
03,003,01,012,0336,0,749,16,765,1127,0,3,1,3,0,1,0,76.14,67.88 ,33.33
03,003,01,012,0337,0,527,11,538,796,0,3,1,3,0,1,0,76.14,67.59 ,33.33
03,003,01,012,0338,0,473,6,479,716,0,3,1,3,0,1,0,76.14,66.90 ,33.33
03,003,01,012,0339,0,725,2,727,1079,0,3,1,3,0,1,0,76.14,67.38 ,33.33
03,003,01,012,0340,0,771,18,789,1102,0,3,1,3,0,1,0,76.14,71.60 ,33.33
03,003,01,012,0341,0,1485,9,1494,2063,0,3,1,3,0,1,0,76.14,72.42 ,33.33
03,003,01,012,0342,0,546,5,551,939,0,3,1,3,0,1,0,76.14,58.68 ,33.33
03,003,01,012,0343,0,501,10,511,737,0,3,1,3,0,1,0,76.14,69.34 ,33.33
03,003,01,012,0344,0,594,5,599,827,0,3,1,3,0,1,0,76.14,72.43 ,33.33
03,003,01,012,0345,0,1022,12,1034,1433,0,3,1,3,0,1,0,76.14,72.16 ,33.33
03,003,01,012,0346,0,728,16,744,1032,0,3,1,3,0,1,0,76.14,72.09 ,33.33
03,003,01,013,0347,0,1503,24,1527,2138,0,3,1,3,0,1,0,76.14,71.42 ,33.33
03,003,01,013,0348,0,819,11,830,1150,0,3,1,3,0,1,0,76.14,72.17 ,33.33
03,003,01,013,0349,0,844,15,859,1280,0,3,1,3,0,1,0,76.14,67.11 ,33.33
03,003,01,013,0350,0,763,12,775,1084,0,3,1,3,0,1,0,76.14,71.49 ,33.33
03,003,01,013,0351,0,1015,19,1034,1376,0,3,1,3,0,1,0,76.14,75.15 ,33.33
03,003,01,013,0352,0,477,8,485,688,0,3,1,3,0,1,0,76.14,70.49 ,33.33
03,003,01,013,0353,0,552,6,558,736,0,3,1,3,0,1,0,76.14,75.82 ,33.33
03,003,01,013,0354,0,470,9,479,675,0,3,1,3,0,1,0,76.14,70.96 ,33.33
03,003,01,013,0355,0,763,13,776,1032,0,3,1,3,0,1,0,76.14,75.19 ,33.33
03,003,01,013,0356,0,1003,18,1021,1508,0,3,1,3,0,1,0,76.14,67.71 ,33.33
03,003,01,013,0357,0,1080,15,1095,1540,0,3,1,3,0,1,0,76.14,71.10 ,33.33
03,003,01,013,0358,0,980,8,988,1465,0,3,1,3,0,1,0,76.14,67.44 ,33.33
03,003,01,013,0359,0,585,10,595,862,0,3,1,3,0,1,0,76.14,69.03 ,33.33
03,003,01,013,0360,0,2025,35,2060,3011,0,3,1,3,0,1,0,76.14,68.42 ,33.33
03,003,01,013,0361,0,955,13,968,1447,0,3,1,3,0,1,0,76.14,66.90 ,33.33
03,003,01,013,0362,0,890,9,899,1289,0,3,1,3,0,1,0,76.14,69.74 ,33.33
03,003,01,013,0363,0,1601,14,1615,2440,0,3,1,3,0,1,0,76.14,66.19 ,33.33
03,003,01,013,0364,0,1116,19,1135,1614,0,3,1,3,0,1,0,76.14,70.32 ,33.33
03,003,01,013,0365,0,1709,23,1732,2454,0,3,1,3,0,1,0,76.14,70.58 ,33.33
03,003,01,013,0366,0,1647,19,1666,2492,0,3,1,3,0,1,0,76.14,66.85 ,33.33
03,003,01,013,0367,0,854,18,872,1370,0,3,1,3,0,1,0,76.14,63.65 ,33.33
03,003,01,013,0368,0,830,14,844,1206,0,3,1,3,0,1,0,76.14,69.98 ,33.33
03,004,01,001,0001,0,682,13,695,943,0,3,1,3,0,1,0,76.14,73.70 ,33.33
03,004,01,001,0002,0,343,6,349,433,0,3,1,3,0,1,0,76.14,80.60 ,33.33
03,004,01,001,0003,0,829,19,848,1184,0,3,1,3,0,1,0,76.14,71.62 ,33.33
03,004,01,001,0004,0,527,4,531,738,0,3,1,3,0,1,0,76.14,71.95 ,33.33
03,004,01,001,0005,0,1426,16,1442,2104,0,3,1,3,0,1,0,76.14,68.54 ,33.33
03,004,01,001,0006,0,2260,44,2304,3384,0,3,1,3,0,1,0,76.14,68.09 ,33.33
03,004,01,001,0007,0,3264,59,3323,5316,0,3,1,3,0,1,0,76.14,62.51 ,33.33
03,004,01,001,0008,0,1461,23,1484,2381,0,3,1,3,0,1,0,76.14,62.33 ,33.33
03,004,01,001,0009,0,2675,42,2717,4512,0,3,1,3,0,1,0,76.14,60.22 ,33.33
03,004,01,001,0010,0,3467,56,3523,5624,0,3,1,3,0,1,0,76.14,62.64 ,33.33
03,004,01,001,0011,0,1638,16,1654,2623,0,3,1,3,0,1,0,76.14,63.06 ,33.33
03,004,01,001,0012,0,2040,42,2082,3640,0,3,1,3,0,1,0,76.14,57.20 ,33.33
03,004,01,001,0013,0,1484,28,1512,2695,0,3,1,3,0,1,0,76.14,56.10 ,33.33
03,004,01,001,0014,0,1425,33,1458,2257,0,3,1,3,0,1,0,76.14,64.60 ,33.33
03,004,01,001,0015,0,667,18,685,991,0,3,1,3,0,1,0,76.14,69.12 ,33.33
03,004,01,001,0016,0,777,17,794,1400,0,3,1,3,0,1,0,76.14,56.71 ,33.33
03,004,01,001,0017,0,437,9,446,713,0,3,1,3,0,1,0,76.14,62.55 ,33.33
03,004,01,001,0018,0,771,22,793,1347,0,3,1,3,0,1,0,76.14,58.87 ,33.33
03,004,01,001,0019,0,538,12,550,962,0,3,1,3,0,1,0,76.14,57.17 ,33.33
03,004,01,001,0020,0,662,19,681,1194,0,3,1,3,0,1,0,76.14,57.04 ,33.33
03,004,01,001,0021,0,717,9,726,1188,0,3,1,3,0,1,0,76.14,61.11 ,33.33
03,004,01,001,0022,0,730,9,739,1241,0,3,1,3,0,1,0,76.14,59.55 ,33.33
03,004,01,001,0023,0,796,4,800,1324,0,3,1,3,0,1,0,76.14,60.42 ,33.33
03,004,01,002,0024,0,325,2,327,464,0,3,1,3,0,1,0,76.14,70.47 ,33.33
03,004,01,002,0025,0,235,3,238,359,0,3,1,3,0,1,0,76.14,66.30 ,33.33
03,004,01,002,0026,0,283,6,289,400,0,3,1,3,0,1,0,76.14,72.25 ,33.33
03,004,01,002,0027,0,1085,15,1100,1626,0,3,1,3,0,1,0,76.14,67.65 ,33.33
03,004,01,002,0028,0,3113,58,3171,4684,0,3,1,3,0,1,0,76.14,67.70 ,33.33
03,004,01,002,0029,0,1701,22,1723,2550,0,3,1,3,0,1,0,76.14,67.57 ,33.33
03,004,01,002,0030,0,1014,19,1033,1440,0,3,1,3,0,1,0,76.14,71.74 ,33.33
03,004,01,002,0031,0,1883,36,1919,2733,0,3,1,3,0,1,0,76.14,70.22 ,33.33
03,004,01,002,0032,0,1376,14,1390,1922,0,3,1,3,0,1,0,76.14,72.32 ,33.33
03,004,01,002,0033,0,867,12,879,1201,0,3,1,3,0,1,0,76.14,73.19 ,33.33
03,004,01,002,0034,0,572,7,579,822,0,3,1,3,0,1,0,76.14,70.44 ,33.33
03,004,01,002,0035,0,1375,27,1402,2003,0,3,1,3,0,1,0,76.14,70.00 ,33.33
03,004,01,002,0036,0,2177,44,2221,3207,0,3,1,3,0,1,0,76.14,69.25 ,33.33
03,004,01,002,0037,0,1607,25,1632,2391,0,3,1,3,0,1,0,76.14,68.26 ,33.33
03,004,01,002,0038,0,1122,14,1136,1526,0,3,1,3,0,1,0,76.14,74.44 ,33.33
03,004,01,002,0039,0,818,16,834,1246,0,3,1,3,0,1,0,76.14,66.93 ,33.33
03,004,01,002,0040,0,997,12,1009,1435,0,3,1,3,0,1,0,76.14,70.31 ,33.33
03,004,01,002,0041,0,3264,59,3323,4871,0,3,1,3,0,1,0,76.14,68.22 ,33.33
03,004,01,002,0042,0,2297,35,2332,3477,0,3,1,3,0,1,0,76.14,67.07 ,33.33
03,004,01,002,0043,0,308,3,311,439,0,3,1,3,0,1,0,76.14,70.84 ,33.33
03,004,01,002,0044,0,2465,42,2507,3784,0,3,1,3,0,1,0,76.14,66.25 ,33.33
03,004,01,002,0045,0,3253,58,3311,4950,0,3,1,3,0,1,0,76.14,66.89 ,33.33
03,004,01,002,0046,0,2084,34,2118,3060,0,3,1,3,0,1,0,76.14,69.22 ,33.33
03,004,01,002,0047,0,897,20,917,1286,0,3,1,3,0,1,0,76.14,71.31 ,33.33
03,004,01,002,0048,0,462,8,470,705,0,3,1,3,0,1,0,76.14,66.67 ,33.33
03,004,01,003,0049,0,702,7,709,976,0,3,1,3,0,1,0,76.14,72.64 ,33.33
03,004,01,003,0050,0,463,3,466,659,0,3,1,3,0,1,0,76.14,70.71 ,33.33
03,004,01,003,0051,0,681,12,693,1004,0,3,1,3,0,1,0,76.14,69.02 ,33.33
03,004,01,003,0052,0,1532,17,1549,2212,0,3,1,3,0,1,0,76.14,70.03 ,33.33
03,004,01,003,0053,0,1182,24,1206,1581,0,3,1,3,0,1,0,76.14,76.28 ,33.33
03,004,01,003,0054,0,1082,24,1106,1572,0,3,1,3,0,1,0,76.14,70.36 ,33.33
03,004,01,003,0055,0,1661,33,1694,2470,0,3,1,3,0,1,0,76.14,68.58 ,33.33
03,004,01,003,0056,0,956,14,970,1393,0,3,1,3,0,1,0,76.14,69.63 ,33.33
03,004,01,003,0057,0,333,3,336,438,0,3,1,3,0,1,0,76.14,76.71 ,33.33
03,004,01,003,0058,0,467,7,474,712,0,3,1,3,0,1,0,76.14,66.57 ,33.33
03,004,01,003,0059,0,395,11,406,613,0,3,1,3,0,1,0,76.14,66.23 ,33.33
03,004,01,003,0060,0,736,19,755,1122,0,3,1,3,0,1,0,76.14,67.29 ,33.33
03,004,01,003,0061,0,739,15,754,1112,0,3,1,3,0,1,0,76.14,67.81 ,33.33
03,004,01,003,0062,0,479,8,487,697,0,3,1,3,0,1,0,76.14,69.87 ,33.33
03,004,01,003,0063,0,2084,37,2121,3283,0,3,1,3,0,1,0,76.14,64.61 ,33.33
03,004,01,003,0064,0,997,20,1017,1479,0,3,1,3,0,1,0,76.14,68.76 ,33.33
03,004,01,003,0065,0,1100,17,1117,1603,0,3,1,3,0,1,0,76.14,69.68 ,33.33
03,004,01,003,0066,0,637,13,650,945,0,3,1,3,0,1,0,76.14,68.78 ,33.33
03,004,01,003,0067,0,475,4,479,647,0,3,1,3,0,1,0,76.14,74.03 ,33.33
03,004,01,004,0068,0,443,6,449,618,0,3,1,3,0,1,0,76.14,72.65 ,33.33
03,004,01,004,0069,0,1008,24,1032,1458,0,3,1,3,0,1,0,76.14,70.78 ,33.33
03,004,01,004,0070,0,503,8,511,737,0,3,1,3,0,1,0,76.14,69.34 ,33.33
03,004,01,004,0071,0,2228,25,2253,3299,0,3,1,3,0,1,0,76.14,68.29 ,33.33
03,004,01,004,0072,0,533,8,541,764,0,3,1,3,0,1,0,76.14,70.81 ,33.33
03,004,01,004,0073,0,592,17,609,885,0,3,1,3,0,1,0,76.14,68.81 ,33.33
03,004,01,004,0074,0,688,7,695,1038,0,3,1,3,0,1,0,76.14,66.96 ,33.33
03,004,01,004,0075,0,1538,33,1571,2388,0,3,1,3,0,1,0,76.14,65.79 ,33.33
03,004,01,004,0076,0,495,11,506,728,0,3,1,3,0,1,0,76.14,69.51 ,33.33
03,004,01,004,0077,0,757,13,770,1109,0,3,1,3,0,1,0,76.14,69.43 ,33.33
03,004,01,004,0078,0,655,13,668,1010,0,3,1,3,0,1,0,76.14,66.14 ,33.33
03,004,01,004,0079,0,383,6,389,608,0,3,1,3,0,1,0,76.14,63.98 ,33.33
03,004,01,004,0080,0,340,4,344,546,0,3,1,3,0,1,0,76.14,63.00 ,33.33
03,004,01,004,0081,0,422,6,428,671,0,3,1,3,0,1,0,76.14,63.79 ,33.33
03,004,01,004,0082,0,594,17,611,936,0,3,1,3,0,1,0,76.14,65.28 ,33.33
03,004,01,004,0083,0,511,4,515,709,0,3,1,3,0,1,0,76.14,72.64 ,33.33
03,004,01,004,0084,0,1223,19,1242,1839,0,3,1,3,0,1,0,76.14,67.54 ,33.33
03,004,01,004,0085,0,639,18,657,991,0,3,1,3,0,1,0,76.14,66.30 ,33.33
03,004,01,004,0086,0,603,7,610,864,0,3,1,3,0,1,0,76.14,70.60 ,33.33
03,004,01,004,0087,0,412,7,419,601,0,3,1,3,0,1,0,76.14,69.72 ,33.33
03,004,01,004,0088,0,535,6,541,768,0,3,1,3,0,1,0,76.14,70.44 ,33.33
03,004,01,005,0089,0,2669,44,2713,4146,0,3,1,3,0,1,0,76.14,65.44 ,33.33
03,004,01,005,0090,0,1801,30,1831,2713,0,3,1,3,0,1,0,76.14,67.49 ,33.33
03,004,01,005,0091,0,2295,47,2342,3431,0,3,1,3,0,1,0,76.14,68.26 ,33.33
03,004,01,005,0092,0,519,10,529,812,0,3,1,3,0,1,0,76.14,65.15 ,33.33
03,004,01,005,0093,0,736,21,757,1066,0,3,1,3,0,1,0,76.14,71.01 ,33.33
03,004,01,005,0094,0,2714,41,2755,4025,0,3,1,3,0,1,0,76.14,68.45 ,33.33
03,004,01,005,0095,0,2842,46,2888,4278,0,3,1,3,0,1,0,76.14,67.51 ,33.33
03,004,01,005,0096,0,518,4,522,812,0,3,1,3,0,1,0,76.14,64.29 ,33.33
03,004,01,005,0097,0,1294,40,1334,2014,0,3,1,3,0,1,0,76.14,66.24 ,33.33
03,004,01,005,0098,0,659,14,673,982,0,3,1,3,0,1,0,76.14,68.53 ,33.33
03,004,01,005,0099,0,1283,25,1308,1948,0,3,1,3,0,1,0,76.14,67.15 ,33.33
03,004,01,005,0100,0,1324,20,1344,1980,0,3,1,3,0,1,0,76.14,67.88 ,33.33
03,004,01,005,0101,0,755,14,769,1243,0,3,1,3,0,1,0,76.14,61.87 ,33.33
03,004,01,005,0102,0,1969,47,2016,2876,0,3,1,3,0,1,0,76.14,70.10 ,33.33
03,004,01,005,0103,0,2593,54,2647,4160,0,3,1,3,0,1,0,76.14,63.63 ,33.33
03,004,01,005,0104,0,1420,34,1454,2352,0,3,1,3,0,1,0,76.14,61.82 ,33.33
03,004,01,006,0105,0,540,11,551,747,0,3,1,3,0,1,0,76.14,73.76 ,33.33
03,004,01,006,0106,0,1055,17,1072,1529,0,3,1,3,0,1,0,76.14,70.11 ,33.33
03,004,01,006,0107,0,902,24,926,1261,0,3,1,3,0,1,0,76.14,73.43 ,33.33
03,004,01,006,0108,0,1081,11,1092,1909,0,3,1,3,0,1,0,76.14,57.20 ,33.33
03,004,01,006,0109,0,453,9,462,717,0,3,1,3,0,1,0,76.14,64.44 ,33.33
03,004,01,006,0110,0,1199,18,1217,1964,0,3,1,3,0,1,0,76.14,61.97 ,33.33
03,004,01,006,0111,0,756,13,769,1080,0,3,1,3,0,1,0,76.14,71.20 ,33.33
03,004,01,006,0112,0,938,19,957,1467,0,3,1,3,0,1,0,76.14,65.24 ,33.33
03,004,01,006,0113,0,2797,57,2854,4648,0,3,1,3,0,1,0,76.14,61.40 ,33.33
03,004,01,006,0114,0,692,8,700,1137,0,3,1,3,0,1,0,76.14,61.57 ,33.33
03,004,01,006,0115,0,614,20,634,899,0,3,1,3,0,1,0,76.14,70.52 ,33.33
03,004,01,006,0116,0,3270,47,3317,5044,0,3,1,3,0,1,0,76.14,65.76 ,33.33
03,004,01,006,0117,0,1993,29,2022,3435,0,3,1,3,0,1,0,76.14,58.86 ,33.33
03,004,01,007,0118,0,291,3,294,419,0,3,1,3,0,1,0,76.14,70.17 ,33.33
03,004,01,007,0119,0,367,8,375,495,0,3,1,3,0,1,0,76.14,75.76 ,33.33
03,004,01,007,0120,0,498,12,510,738,0,3,1,3,0,1,0,76.14,69.11 ,33.33
03,004,01,007,0121,0,296,6,302,400,0,3,1,3,0,1,0,76.14,75.50 ,33.33
03,004,01,007,0122,0,1352,30,1382,2068,0,3,1,3,0,1,0,76.14,66.83 ,33.33
03,004,01,007,0123,0,982,19,1001,1443,0,3,1,3,0,1,0,76.14,69.37 ,33.33
03,004,01,007,0124,0,344,7,351,521,0,3,1,3,0,1,0,76.14,67.37 ,33.33
03,004,01,007,0125,0,399,13,412,597,0,3,1,3,0,1,0,76.14,69.01 ,33.33
03,004,01,007,0126,0,1191,18,1209,1770,0,3,1,3,0,1,0,76.14,68.31 ,33.33
03,004,01,007,0127,0,928,22,950,1357,0,3,1,3,0,1,0,76.14,70.01 ,33.33
03,004,01,007,0128,0,1295,19,1314,2011,0,3,1,3,0,1,0,76.14,65.34 ,33.33
03,004,01,007,0129,0,695,12,707,983,0,3,1,3,0,1,0,76.14,71.92 ,33.33
03,004,01,008,0130,0,2177,38,2215,3219,0,3,1,3,0,1,0,76.14,68.81 ,33.33
03,004,01,008,0131,0,584,6,590,821,0,3,1,3,0,1,0,76.14,71.86 ,33.33
03,004,01,008,0132,0,97,1,98,139,0,3,1,3,0,1,0,76.14,70.50 ,33.33
03,004,01,008,0133,0,96,0,96,128,0,3,1,3,0,1,0,76.14,75.00 ,33.33
03,004,01,008,0134,0,215,4,219,317,0,3,1,3,0,1,0,76.14,69.09 ,33.33
03,004,01,008,0135,0,796,16,812,1180,0,3,1,3,0,1,0,76.14,68.81 ,33.33
03,004,01,008,0136,0,573,17,590,847,0,3,1,3,0,1,0,76.14,69.66 ,33.33
03,004,01,008,0137,0,337,2,339,480,0,3,1,3,0,1,0,76.14,70.63 ,33.33
03,004,01,008,0138,0,809,12,821,1149,0,3,1,3,0,1,0,76.14,71.45 ,33.33
03,004,01,008,0139,0,1114,16,1130,1533,0,3,1,3,0,1,0,76.14,73.71 ,33.33
03,004,01,008,0140,0,890,19,909,1289,0,3,1,3,0,1,0,76.14,70.52 ,33.33
03,004,01,009,0141,0,749,9,758,1125,0,3,1,3,0,1,0,76.14,67.38 ,33.33
03,004,01,009,0142,0,922,17,939,1321,0,3,1,3,0,1,0,76.14,71.08 ,33.33
03,004,01,009,0143,0,312,2,314,466,0,3,1,3,0,1,0,76.14,67.38 ,33.33
03,004,01,009,0144,0,1587,26,1613,2344,0,3,1,3,0,1,0,76.14,68.81 ,33.33
03,004,01,009,0145,0,476,14,490,785,0,3,1,3,0,1,0,76.14,62.42 ,33.33
03,004,01,009,0146,0,257,5,262,337,0,3,1,3,0,1,0,76.14,77.74 ,33.33
03,004,01,009,0147,0,433,6,439,614,0,3,1,3,0,1,0,76.14,71.50 ,33.33
03,004,01,009,0148,0,229,3,232,341,0,3,1,3,0,1,0,76.14,68.04 ,33.33
03,004,01,009,0149,0,185,3,188,296,0,3,1,3,0,1,0,76.14,63.51 ,33.33
03,004,01,010,0150,0,1695,21,1716,2652,0,3,1,3,0,1,0,76.14,64.71 ,33.33
03,004,01,010,0151,0,563,9,572,890,0,3,1,3,0,1,0,76.14,64.27 ,33.33
03,004,01,010,0152,0,484,12,496,728,0,3,1,3,0,1,0,76.14,68.13 ,33.33
03,004,01,010,0153,0,668,9,677,1076,0,3,1,3,0,1,0,76.14,62.92 ,33.33
03,004,01,010,0154,0,396,5,401,654,0,3,1,3,0,1,0,76.14,61.31 ,33.33
03,004,01,010,0155,0,422,6,428,693,0,3,1,3,0,1,0,76.14,61.76 ,33.33
03,004,01,010,0156,0,430,9,439,597,0,3,1,3,0,1,0,76.14,73.53 ,33.33
03,004,01,010,0157,0,379,8,387,557,0,3,1,3,0,1,0,76.14,69.48 ,33.33
03,004,01,010,0158,0,368,4,372,516,0,3,1,3,0,1,0,76.14,72.09 ,33.33
03,004,01,011,0159,0,615,7,622,874,0,3,1,3,0,1,0,76.14,71.17 ,33.33
03,004,01,011,0160,0,483,9,492,708,0,3,1,3,0,1,0,76.14,69.49 ,33.33
03,004,01,011,0161,0,424,5,429,618,0,3,1,3,0,1,0,76.14,69.42 ,33.33
03,004,01,011,0162,0,432,6,438,640,0,3,1,3,0,1,0,76.14,68.44 ,33.33
03,004,01,011,0163,0,744,6,750,1208,0,3,1,3,0,1,0,76.14,62.09 ,33.33
03,004,01,011,0164,0,585,9,594,978,0,3,1,3,0,1,0,76.14,60.74 ,33.33
03,004,01,012,0165,0,299,7,306,425,0,3,1,3,0,1,0,76.14,72.00 ,33.33
03,004,01,012,0166,0,14,2,16,31,0,3,1,3,0,1,0,76.14,51.61 ,33.33
03,004,01,012,0167,0,92,2,94,150,0,3,1,3,0,1,0,76.14,62.67 ,33.33
03,004,01,012,0168,0,96,0,96,178,0,3,1,3,0,1,0,76.14,53.93 ,33.33
03,004,01,012,0169,0,75,2,77,148,0,3,1,3,0,1,0,76.14,52.03 ,33.33
03,004,01,012,0170,0,31,1,32,50,0,3,1,3,0,1,0,76.14,64.00 ,33.33
03,004,01,012,0171,0,18,1,19,35,0,3,1,3,0,1,0,76.14,54.29 ,33.33
03,004,01,012,0172,0,30,0,30,70,0,3,1,3,0,1,0,76.14,42.86 ,33.33
03,004,01,013,0173,0,105,1,106,193,0,3,1,3,0,1,0,76.14,54.92 ,33.33
03,004,01,013,0174,0,53,0,53,88,0,3,1,3,0,1,0,76.14,60.23 ,33.33
03,004,01,013,0175,0,7,0,7,14,0,3,1,3,0,1,0,76.14,50.00 ,33.33
03,004,01,013,0176,0,49,3,52,113,0,3,1,3,0,1,0,76.14,46.02 ,33.33
03,005,01,001,0001,0,606,12,618,830,0,3,1,3,0,1,0,76.14,74.46 ,33.33
03,005,01,001,0002,0,766,6,772,1081,0,3,1,3,0,1,0,76.14,71.42 ,33.33
03,005,01,001,0003,0,2004,26,2030,2791,0,3,1,3,0,1,0,76.14,72.73 ,33.33
03,005,01,001,0004,0,2521,32,2553,3543,0,3,1,3,0,1,0,76.14,72.06 ,33.33
03,005,01,001,0005,0,1501,21,1522,2084,0,3,1,3,0,1,0,76.14,73.03 ,33.33
03,005,01,001,0006,0,2287,35,2322,3172,0,3,1,3,0,1,0,76.14,73.20 ,33.33
03,005,01,001,0007,0,633,9,642,895,0,3,1,3,0,1,0,76.14,71.73 ,33.33
03,005,01,001,0008,0,1629,33,1662,2413,0,3,1,3,0,1,0,76.14,68.88 ,33.33
03,005,01,001,0009,0,731,6,737,1000,0,3,1,3,0,1,0,76.14,73.70 ,33.33
03,005,01,001,0010,0,845,13,858,1200,0,3,1,3,0,1,0,76.14,71.50 ,33.33
03,005,01,001,0011,0,434,14,448,682,0,3,1,3,0,1,0,76.14,65.69 ,33.33
03,005,01,001,0012,0,1070,11,1081,1489,0,3,1,3,0,1,0,76.14,72.60 ,33.33
03,005,01,001,0013,0,1637,19,1656,2202,0,3,1,3,0,1,0,76.14,75.20 ,33.33
03,005,01,001,0014,0,2532,34,2566,3545,0,3,1,3,0,1,0,76.14,72.38 ,33.33
03,005,01,001,0015,0,2148,23,2171,2866,0,3,1,3,0,1,0,76.14,75.75 ,33.33
03,005,01,001,0016,0,1310,17,1327,1783,0,3,1,3,0,1,0,76.14,74.43 ,33.33
03,005,01,001,0017,0,2381,41,2422,3464,0,3,1,3,0,1,0,76.14,69.92 ,33.33
03,005,01,001,0018,0,3819,64,3883,5154,0,3,1,3,0,1,0,76.14,75.34 ,33.33
03,005,01,001,0019,0,3447,51,3498,4827,0,3,1,3,0,1,0,76.14,72.47 ,33.33
03,005,01,001,0020,0,2354,24,2378,3219,0,3,1,3,0,1,0,76.14,73.87 ,33.33
03,005,01,001,0021,0,2643,41,2684,3859,0,3,1,3,0,1,0,76.14,69.55 ,33.33
03,005,01,001,0022,0,2640,46,2686,3602,0,3,1,3,0,1,0,76.14,74.57 ,33.33
03,005,01,001,0023,0,775,13,788,1043,0,3,1,3,0,1,0,76.14,75.55 ,33.33
03,005,01,001,0024,0,1896,42,1938,2736,0,3,1,3,0,1,0,76.14,70.83 ,33.33
03,005,01,002,0025,0,1128,12,1140,1530,0,3,1,3,0,1,0,76.14,74.51 ,33.33
03,005,01,002,0026,0,1117,13,1130,1566,0,3,1,3,0,1,0,76.14,72.16 ,33.33
03,005,01,002,0027,0,701,6,707,931,0,3,1,3,0,1,0,76.14,75.94 ,33.33
03,005,01,002,0028,0,931,11,942,1270,0,3,1,3,0,1,0,76.14,74.17 ,33.33
03,005,01,002,0029,0,743,4,747,1048,0,3,1,3,0,1,0,76.14,71.28 ,33.33
03,005,01,002,0030,0,1072,12,1084,1444,0,3,1,3,0,1,0,76.14,75.07 ,33.33
03,005,01,002,0031,0,707,7,714,965,0,3,1,3,0,1,0,76.14,73.99 ,33.33
03,005,01,002,0032,0,1380,21,1401,1883,0,3,1,3,0,1,0,76.14,74.40 ,33.33
03,005,01,002,0033,0,1999,23,2022,2685,0,3,1,3,0,1,0,76.14,75.31 ,33.33
03,005,01,002,0034,0,1227,12,1239,1712,0,3,1,3,0,1,0,76.14,72.37 ,33.33
03,005,01,002,0035,0,653,14,667,991,0,3,1,3,0,1,0,76.14,67.31 ,33.33
03,005,01,002,0036,0,426,4,430,614,0,3,1,3,0,1,0,76.14,70.03 ,33.33
03,005,01,002,0037,0,773,15,788,1094,0,3,1,3,0,1,0,76.14,72.03 ,33.33
03,005,01,002,0038,0,1115,18,1133,1627,0,3,1,3,0,1,0,76.14,69.64 ,33.33
03,005,01,002,0039,0,1054,23,1077,1451,0,3,1,3,0,1,0,76.14,74.22 ,33.33
03,005,01,002,0040,0,909,19,928,1285,0,3,1,3,0,1,0,76.14,72.22 ,33.33
03,005,01,002,0041,0,500,8,508,638,0,3,1,3,0,1,0,76.14,79.62 ,33.33
03,005,01,002,0042,0,722,7,729,967,0,3,1,3,0,1,0,76.14,75.39 ,33.33
03,005,01,002,0043,0,545,9,554,757,0,3,1,3,0,1,0,76.14,73.18 ,33.33
03,005,01,002,0044,0,993,7,1000,1317,0,3,1,3,0,1,0,76.14,75.93 ,33.33
03,005,01,002,0045,0,1127,28,1155,1539,0,3,1,3,0,1,0,76.14,75.05 ,33.33
03,005,01,002,0046,0,918,13,931,1346,0,3,1,3,0,1,0,76.14,69.17 ,33.33
03,005,01,002,0047,0,1298,26,1324,1805,0,3,1,3,0,1,0,76.14,73.35 ,33.33
03,005,01,002,0048,0,728,3,731,1008,0,3,1,3,0,1,0,76.14,72.52 ,33.33
03,005,01,002,0049,0,834,10,844,1090,0,3,1,3,0,1,0,76.14,77.43 ,33.33
03,005,01,003,0050,0,926,11,937,1274,0,3,1,3,0,1,0,76.14,73.55 ,33.33
03,005,01,003,0051,0,1620,19,1639,2136,0,3,1,3,0,1,0,76.14,76.73 ,33.33
03,005,01,003,0052,0,2276,24,2300,3112,0,3,1,3,0,1,0,76.14,73.91 ,33.33
03,005,01,003,0053,0,971,14,985,1255,0,3,1,3,0,1,0,76.14,78.49 ,33.33
03,005,01,003,0054,0,1019,12,1031,1377,0,3,1,3,0,1,0,76.14,74.87 ,33.33
03,005,01,003,0055,0,1027,17,1044,1382,0,3,1,3,0,1,0,76.14,75.54 ,33.33
03,005,01,003,0056,0,1581,14,1595,2229,0,3,1,3,0,1,0,76.14,71.56 ,33.33
03,005,01,003,0057,0,867,16,883,1230,0,3,1,3,0,1,0,76.14,71.79 ,33.33
03,005,01,003,0058,0,481,6,487,701,0,3,1,3,0,1,0,76.14,69.47 ,33.33
03,005,01,003,0059,0,642,6,648,853,0,3,1,3,0,1,0,76.14,75.97 ,33.33
03,005,01,003,0060,0,781,13,794,1069,0,3,1,3,0,1,0,76.14,74.28 ,33.33
03,005,01,003,0061,0,545,12,557,732,0,3,1,3,0,1,0,76.14,76.09 ,33.33
03,005,01,003,0062,0,609,6,615,783,0,3,1,3,0,1,0,76.14,78.54 ,33.33
03,005,01,003,0063,0,1289,9,1298,1679,0,3,1,3,0,1,0,76.14,77.31 ,33.33
03,005,01,003,0064,0,459,4,463,592,0,3,1,3,0,1,0,76.14,78.21 ,33.33
03,005,01,003,0065,0,750,8,758,976,0,3,1,3,0,1,0,76.14,77.66 ,33.33
03,005,01,003,0066,0,354,0,354,539,0,3,1,3,0,1,0,76.14,65.68 ,33.33
03,005,01,003,0067,0,480,7,487,640,0,3,1,3,0,1,0,76.14,76.09 ,33.33
03,005,01,003,0068,0,1510,13,1523,2039,0,3,1,3,0,1,0,76.14,74.69 ,33.33
03,005,01,003,0069,0,884,12,896,1249,0,3,1,3,0,1,0,76.14,71.74 ,33.33
03,005,01,003,0070,0,564,8,572,768,0,3,1,3,0,1,0,76.14,74.48 ,33.33
03,005,01,003,0071,0,919,13,932,1348,0,3,1,3,0,1,0,76.14,69.14 ,33.33
03,005,01,003,0072,0,615,4,619,852,0,3,1,3,0,1,0,76.14,72.65 ,33.33
03,005,01,004,0073,0,1158,17,1175,1568,0,3,1,3,0,1,0,76.14,74.94 ,33.33
03,005,01,004,0074,0,1700,22,1722,2282,0,3,1,3,0,1,0,76.14,75.46 ,33.33
03,005,01,004,0075,0,1500,23,1523,1990,0,3,1,3,0,1,0,76.14,76.53 ,33.33
03,005,01,004,0076,0,1795,33,1828,2475,0,3,1,3,0,1,0,76.14,73.86 ,33.33
03,005,01,004,0077,0,2159,34,2193,2912,0,3,1,3,0,1,0,76.14,75.31 ,33.33
03,005,01,004,0078,0,1514,14,1528,2155,0,3,1,3,0,1,0,76.14,70.90 ,33.33
03,005,01,004,0079,0,1440,27,1467,1951,0,3,1,3,0,1,0,76.14,75.19 ,33.33
03,005,01,004,0080,0,1812,33,1845,2539,0,3,1,3,0,1,0,76.14,72.67 ,33.33
03,005,01,004,0081,0,2405,59,2464,3098,0,3,1,3,0,1,0,76.14,79.54 ,33.33
03,005,01,004,0082,0,2940,50,2990,4132,0,3,1,3,0,1,0,76.14,72.36 ,33.33
03,005,01,004,0083,0,700,10,710,933,0,3,1,3,0,1,0,76.14,76.10 ,33.33
03,005,01,004,0084,0,1305,27,1332,1724,0,3,1,3,0,1,0,76.14,77.26 ,33.33
03,005,01,004,0085,0,780,10,790,1051,0,3,1,3,0,1,0,76.14,75.17 ,33.33
03,005,01,004,0086,0,896,13,909,1151,0,3,1,3,0,1,0,76.14,78.97 ,33.33
03,005,01,004,0087,0,394,3,397,502,0,3,1,3,0,1,0,76.14,79.08 ,33.33
03,005,01,004,0088,0,1287,30,1317,1791,0,3,1,3,0,1,0,76.14,73.53 ,33.33
03,005,01,004,0089,0,922,3,925,1160,0,3,1,3,0,1,0,76.14,79.74 ,33.33
03,005,01,004,0090,0,748,14,762,983,0,3,1,3,0,1,0,76.14,77.52 ,33.33
03,005,01,004,0091,0,2090,38,2128,2736,0,3,1,3,0,1,0,76.14,77.78 ,33.33
03,005,01,004,0092,0,1466,37,1503,2005,0,3,1,3,0,1,0,76.14,74.96 ,33.33
03,005,01,004,0093,0,1445,22,1467,1969,0,3,1,3,0,1,0,76.14,74.50 ,33.33
03,005,01,004,0094,0,615,13,628,857,0,3,1,3,0,1,0,76.14,73.28 ,33.33
03,005,01,005,0095,0,1337,23,1360,1858,0,3,1,3,0,1,0,76.14,73.20 ,33.33
03,005,01,005,0096,0,1351,20,1371,1868,0,3,1,3,0,1,0,76.14,73.39 ,33.33
03,005,01,005,0097,0,1986,38,2024,2690,0,3,1,3,0,1,0,76.14,75.24 ,33.33
03,005,01,005,0098,0,2502,36,2538,3396,0,3,1,3,0,1,0,76.14,74.73 ,33.33
03,005,01,005,0099,0,1742,27,1769,2573,0,3,1,3,0,1,0,76.14,68.75 ,33.33
03,005,01,005,0100,0,1595,29,1624,2113,0,3,1,3,0,1,0,76.14,76.86 ,33.33
03,005,01,005,0101,0,599,14,613,850,0,3,1,3,0,1,0,76.14,72.12 ,33.33
03,005,01,005,0102,0,1400,20,1420,1966,0,3,1,3,0,1,0,76.14,72.23 ,33.33
03,005,01,005,0103,0,2588,37,2625,3739,0,3,1,3,0,1,0,76.14,70.21 ,33.33
03,005,01,005,0104,0,558,4,562,754,0,3,1,3,0,1,0,76.14,74.54 ,33.33
03,005,01,005,0105,0,1093,20,1113,1442,0,3,1,3,0,1,0,76.14,77.18 ,33.33
03,005,01,005,0106,0,775,7,782,999,0,3,1,3,0,1,0,76.14,78.28 ,33.33
03,005,01,005,0107,0,1215,15,1230,1616,0,3,1,3,0,1,0,76.14,76.11 ,33.33
03,005,01,005,0108,0,1297,12,1309,1760,0,3,1,3,0,1,0,76.14,74.38 ,33.33
03,005,01,005,0109,0,2163,38,2201,3063,0,3,1,3,0,1,0,76.14,71.86 ,33.33
03,005,01,005,0110,0,3774,71,3845,5403,0,3,1,3,0,1,0,76.14,71.16 ,33.33
03,005,01,005,0111,0,1453,15,1468,2120,0,3,1,3,0,1,0,76.14,69.25 ,33.33
03,005,01,005,0112,0,828,4,832,1070,0,3,1,3,0,1,0,76.14,77.76 ,33.33
03,005,01,005,0113,0,3078,43,3121,4446,0,3,1,3,0,1,0,76.14,70.20 ,33.33
03,005,01,005,0114,0,1758,30,1788,2498,0,3,1,3,0,1,0,76.14,71.58 ,33.33
03,005,01,005,0115,0,1059,14,1073,1337,0,3,1,3,0,1,0,76.14,80.25 ,33.33
03,005,01,005,0116,0,977,26,1003,1311,0,3,1,3,0,1,0,76.14,76.51 ,33.33
03,005,01,005,0117,0,605,7,612,799,0,3,1,3,0,1,0,76.14,76.60 ,33.33
03,005,01,005,0118,0,1709,22,1731,2361,0,3,1,3,0,1,0,76.14,73.32 ,33.33
03,005,01,005,0119,0,1192,25,1217,1598,0,3,1,3,0,1,0,76.14,76.16 ,33.33
03,005,01,006,0120,0,1011,16,1027,1489,0,3,1,3,0,1,0,76.14,68.97 ,33.33
03,005,01,006,0121,0,734,8,742,950,0,3,1,3,0,1,0,76.14,78.11 ,33.33
03,005,01,006,0122,0,1062,12,1074,1438,0,3,1,3,0,1,0,76.14,74.69 ,33.33
03,005,01,006,0123,0,2023,20,2043,2796,0,3,1,3,0,1,0,76.14,73.07 ,33.33
03,005,01,006,0124,0,1434,14,1448,2009,0,3,1,3,0,1,0,76.14,72.08 ,33.33
03,005,01,006,0125,0,957,6,963,1265,0,3,1,3,0,1,0,76.14,76.13 ,33.33
03,005,01,006,0126,0,905,13,918,1164,0,3,1,3,0,1,0,76.14,78.87 ,33.33
03,005,01,006,0127,0,1524,22,1546,2015,0,3,1,3,0,1,0,76.14,76.72 ,33.33
03,005,01,006,0128,0,1005,14,1019,1291,0,3,1,3,0,1,0,76.14,78.93 ,33.33
03,005,01,006,0129,0,505,6,511,656,0,3,1,3,0,1,0,76.14,77.90 ,33.33
03,005,01,006,0130,0,942,11,953,1311,0,3,1,3,0,1,0,76.14,72.69 ,33.33
03,005,01,006,0131,0,1159,17,1176,1631,0,3,1,3,0,1,0,76.14,72.10 ,33.33
03,005,01,006,0132,0,985,17,1002,1412,0,3,1,3,0,1,0,76.14,70.96 ,33.33
03,005,01,006,0133,0,752,7,759,1034,0,3,1,3,0,1,0,76.14,73.40 ,33.33
03,005,01,006,0134,0,832,11,843,1186,0,3,1,3,0,1,0,76.14,71.08 ,33.33
03,005,01,006,0135,0,759,10,769,1120,0,3,1,3,0,1,0,76.14,68.66 ,33.33
03,005,01,006,0136,0,599,5,604,809,0,3,1,3,0,1,0,76.14,74.66 ,33.33
03,005,01,006,0137,0,799,27,826,1123,0,3,1,3,0,1,0,76.14,73.55 ,33.33
03,005,01,006,0138,0,480,7,487,650,0,3,1,3,0,1,0,76.14,74.92 ,33.33
03,005,01,006,0139,0,863,17,880,1278,0,3,1,3,0,1,0,76.14,68.86 ,33.33
03,005,01,006,0140,0,597,5,602,859,0,3,1,3,0,1,0,76.14,70.08 ,33.33
03,005,01,006,0141,0,853,13,866,1341,0,3,1,3,0,1,0,76.14,64.58 ,33.33
03,005,01,006,0142,0,884,16,900,1339,0,3,1,3,0,1,0,76.14,67.21 ,33.33
03,005,01,007,0143,0,1691,19,1710,2079,0,3,1,3,0,1,0,76.14,82.25 ,33.33
03,005,01,007,0144,0,913,6,919,1153,0,3,1,3,0,1,0,76.14,79.71 ,33.33
03,005,01,007,0145,0,629,2,631,790,0,3,1,3,0,1,0,76.14,79.87 ,33.33
03,005,01,007,0146,0,1123,12,1135,1474,0,3,1,3,0,1,0,76.14,77.00 ,33.33
03,005,01,007,0147,0,807,7,814,1010,0,3,1,3,0,1,0,76.14,80.59 ,33.33
03,005,01,007,0148,0,449,11,460,579,0,3,1,3,0,1,0,76.14,79.45 ,33.33
03,005,01,007,0149,0,554,9,563,687,0,3,1,3,0,1,0,76.14,81.95 ,33.33
03,005,01,007,0150,0,1474,14,1488,1870,0,3,1,3,0,1,0,76.14,79.57 ,33.33
03,005,01,007,0151,0,1646,29,1675,2061,0,3,1,3,0,1,0,76.14,81.27 ,33.33
03,005,01,007,0152,0,1152,27,1179,1496,0,3,1,3,0,1,0,76.14,78.81 ,33.33
03,005,01,007,0153,0,525,8,533,743,0,3,1,3,0,1,0,76.14,71.74 ,33.33
03,005,01,008,0154,0,1254,19,1273,1745,0,3,1,3,0,1,0,76.14,72.95 ,33.33
03,005,01,008,0155,0,586,11,597,741,0,3,1,3,0,1,0,76.14,80.57 ,33.33
03,005,01,008,0156,0,1201,12,1213,1629,0,3,1,3,0,1,0,76.14,74.46 ,33.33
03,005,01,008,0157,0,1014,10,1024,1368,0,3,1,3,0,1,0,76.14,74.85 ,33.33
03,005,01,008,0158,0,486,8,494,733,0,3,1,3,0,1,0,76.14,67.39 ,33.33
03,005,01,008,0159,0,973,12,985,1302,0,3,1,3,0,1,0,76.14,75.65 ,33.33
03,005,01,008,0160,0,581,8,589,781,0,3,1,3,0,1,0,76.14,75.42 ,33.33
03,005,01,008,0161,0,1094,16,1110,1492,0,3,1,3,0,1,0,76.14,74.40 ,33.33
03,005,01,008,0162,0,580,14,594,786,0,3,1,3,0,1,0,76.14,75.57 ,33.33
03,005,01,008,0163,0,407,2,409,566,0,3,1,3,0,1,0,76.14,72.26 ,33.33
03,005,01,008,0164,0,722,10,732,988,0,3,1,3,0,1,0,76.14,74.09 ,33.33
03,005,01,008,0165,0,651,8,659,928,0,3,1,3,0,1,0,76.14,71.01 ,33.33
03,005,01,009,0166,0,1121,15,1136,1470,0,3,1,3,0,1,0,76.14,77.28 ,33.33
03,005,01,009,0167,0,1594,18,1612,2148,0,3,1,3,0,1,0,76.14,75.05 ,33.33
03,005,01,009,0168,0,1670,23,1693,2337,0,3,1,3,0,1,0,76.14,72.44 ,33.33
03,005,01,009,0169,0,1320,23,1343,1766,0,3,1,3,0,1,0,76.14,76.05 ,33.33
03,005,01,009,0170,0,1102,10,1112,1532,0,3,1,3,0,1,0,76.14,72.58 ,33.33
03,005,01,009,0171,0,637,15,652,930,0,3,1,3,0,1,0,76.14,70.11 ,33.33
03,005,01,009,0172,0,823,9,832,1070,0,3,1,3,0,1,0,76.14,77.76 ,33.33
03,005,01,009,0173,0,320,4,324,439,0,3,1,3,0,1,0,76.14,73.80 ,33.33
03,005,01,009,0174,0,974,11,985,1341,0,3,1,3,0,1,0,76.14,73.45 ,33.33
03,005,01,009,0175,0,1063,17,1080,1386,0,3,1,3,0,1,0,76.14,77.92 ,33.33
03,005,01,009,0176,0,289,2,291,356,0,3,1,3,0,1,0,76.14,81.74 ,33.33
03,005,01,009,0177,0,1174,13,1187,1636,0,3,1,3,0,1,0,76.14,72.56 ,33.33
03,005,01,009,0178,0,782,11,793,988,0,3,1,3,0,1,0,76.14,80.26 ,33.33
03,005,01,009,0179,0,1026,15,1041,1322,0,3,1,3,0,1,0,76.14,78.74 ,33.33
03,005,01,009,0180,0,1000,11,1011,1319,0,3,1,3,0,1,0,76.14,76.65 ,33.33
03,005,01,009,0181,0,1044,10,1054,1338,0,3,1,3,0,1,0,76.14,78.77 ,33.33
03,005,01,009,0182,0,925,12,937,1191,0,3,1,3,0,1,0,76.14,78.67 ,33.33
03,005,01,009,0183,0,160,3,163,217,0,3,1,3,0,1,0,76.14,75.12 ,33.33
03,005,01,009,0184,0,275,3,278,336,0,3,1,3,0,1,0,76.14,82.74 ,33.33
03,005,01,010,0185,0,806,11,817,1057,0,3,1,3,0,1,0,76.14,77.29 ,33.33
03,005,01,010,0186,0,1206,19,1225,1609,0,3,1,3,0,1,0,76.14,76.13 ,33.33
03,005,01,010,0187,0,766,13,779,1119,0,3,1,3,0,1,0,76.14,69.62 ,33.33
03,005,01,010,0188,0,2907,43,2950,3816,0,3,1,3,0,1,0,76.14,77.31 ,33.33
03,005,01,010,0189,0,932,15,947,1234,0,3,1,3,0,1,0,76.14,76.74 ,33.33
03,005,01,010,0190,0,952,19,971,1315,0,3,1,3,0,1,0,76.14,73.84 ,33.33
03,005,01,010,0191,0,1784,32,1816,2391,0,3,1,3,0,1,0,76.14,75.95 ,33.33
03,005,01,010,0192,0,456,13,469,646,0,3,1,3,0,1,0,76.14,72.60 ,33.33
03,005,01,010,0193,0,400,4,404,585,0,3,1,3,0,1,0,76.14,69.06 ,33.33
03,005,01,010,0194,0,478,7,485,666,0,3,1,3,0,1,0,76.14,72.82 ,33.33
03,005,01,011,0195,0,1071,12,1083,1423,0,3,1,3,0,1,0,76.14,76.11 ,33.33
03,005,01,011,0196,0,521,4,525,712,0,3,1,3,0,1,0,76.14,73.74 ,33.33
03,005,01,011,0197,0,802,10,812,1177,0,3,1,3,0,1,0,76.14,68.99 ,33.33
03,005,01,011,0198,0,658,7,665,938,0,3,1,3,0,1,0,76.14,70.90 ,33.33
03,005,01,011,0199,0,769,14,783,1129,0,3,1,3,0,1,0,76.14,69.35 ,33.33
03,005,01,011,0200,0,804,14,818,1127,0,3,1,3,0,1,0,76.14,72.58 ,33.33
03,005,01,011,0201,0,730,6,736,1087,0,3,1,3,0,1,0,76.14,67.71 ,33.33
03,005,01,011,0202,0,316,4,320,477,0,3,1,3,0,1,0,76.14,67.09 ,33.33
03,005,01,011,0203,0,216,1,217,308,0,3,1,3,0,1,0,76.14,70.45 ,33.33
03,005,01,012,0204,0,1741,27,1768,2269,0,3,1,3,0,1,0,76.14,77.92 ,33.33
03,005,01,012,0205,0,1327,25,1352,1750,0,3,1,3,0,1,0,76.14,77.26 ,33.33
03,005,01,012,0206,0,434,7,441,569,0,3,1,3,0,1,0,76.14,77.50 ,33.33
03,005,01,012,0207,0,1146,19,1165,1450,0,3,1,3,0,1,0,76.14,80.34 ,33.33
03,005,01,012,0208,0,661,31,692,879,0,3,1,3,0,1,0,76.14,78.73 ,33.33
03,005,01,012,0209,0,269,5,274,359,0,3,1,3,0,1,0,76.14,76.32 ,33.33
03,005,01,012,0210,0,911,18,929,1155,0,3,1,3,0,1,0,76.14,80.43 ,33.33
03,005,01,012,0211,0,276,2,278,370,0,3,1,3,0,1,0,76.14,75.14 ,33.33
03,005,01,013,0212,0,3012,43,3055,3883,0,3,1,3,0,1,0,76.14,78.68 ,33.33
03,005,01,013,0213,0,1862,23,1885,2385,0,3,1,3,0,1,0,76.14,79.04 ,33.33
03,005,01,013,0214,0,1247,22,1269,1620,0,3,1,3,0,1,0,76.14,78.33 ,33.33
03,005,01,013,0215,0,1095,12,1107,1380,0,3,1,3,0,1,0,76.14,80.22 ,33.33
03,005,01,013,0216,0,990,13,1003,1257,0,3,1,3,0,1,0,76.14,79.79 ,33.33
03,005,01,013,0217,0,317,5,322,386,0,3,1,3,0,1,0,76.14,83.42 ,33.33
03,005,01,013,0218,0,883,6,889,1117,0,3,1,3,0,1,0,76.14,79.59 ,33.33
03,005,01,014,0219,0,488,7,495,654,0,3,1,3,0,1,0,76.14,75.69 ,33.33
03,005,01,014,0220,0,470,10,480,609,0,3,1,3,0,1,0,76.14,78.82 ,33.33
03,005,01,014,0221,0,701,15,716,972,0,3,1,3,0,1,0,76.14,73.66 ,33.33
03,005,01,014,0222,0,582,4,586,702,0,3,1,3,0,1,0,76.14,83.48 ,33.33
03,005,01,014,0223,0,767,5,772,1088,0,3,1,3,0,1,0,76.14,70.96 ,33.33
03,005,01,014,0224,0,425,5,430,554,0,3,1,3,0,1,0,76.14,77.62 ,33.33
03,005,01,014,0225,0,418,11,429,566,0,3,1,3,0,1,0,76.14,75.80 ,33.33
03,005,01,014,0226,0,783,47,830,1144,0,3,1,3,0,1,0,76.14,72.55 ,33.33
03,005,01,014,0227,0,507,9,516,714,0,3,1,3,0,1,0,76.14,72.27 ,33.33
03,005,01,015,0228,0,1215,12,1227,1556,0,3,1,3,0,1,0,76.14,78.86 ,33.33
03,005,01,015,0229,0,447,7,454,556,0,3,1,3,0,1,0,76.14,81.65 ,33.33
03,005,01,015,0230,0,738,5,743,946,0,3,1,3,0,1,0,76.14,78.54 ,33.33
03,005,01,015,0231,0,2274,22,2296,2784,0,3,1,3,0,1,0,76.14,82.47 ,33.33
03,005,01,015,0232,0,479,4,483,574,0,3,1,3,0,1,0,76.14,84.15 ,33.33
03,005,01,015,0233,0,454,7,461,546,0,3,1,3,0,1,0,76.14,84.43 ,33.33
03,005,01,015,0234,0,983,18,1001,1319,0,3,1,3,0,1,0,76.14,75.89 ,33.33
03,005,01,015,0235,0,571,8,579,721,0,3,1,3,0,1,0,76.14,80.31 ,33.33
03,005,01,015,0236,0,818,12,830,1053,0,3,1,3,0,1,0,76.14,78.82 ,33.33
03,005,01,016,0237,0,1561,19,1580,2116,0,3,1,3,0,1,0,76.14,74.67 ,33.33
03,005,01,016,0238,0,456,5,461,580,0,3,1,3,0,1,0,76.14,79.48 ,33.33
03,005,01,016,0239,0,650,8,658,877,0,3,1,3,0,1,0,76.14,75.03 ,33.33
03,005,01,016,0240,0,204,3,207,254,0,3,1,3,0,1,0,76.14,81.50 ,33.33
03,005,01,016,0241,0,437,4,441,608,0,3,1,3,0,1,0,76.14,72.53 ,33.33
03,005,01,016,0242,0,500,7,507,705,0,3,1,3,0,1,0,76.14,71.91 ,33.33
03,005,01,016,0243,0,401,5,406,508,0,3,1,3,0,1,0,76.14,79.92 ,33.33
03,005,01,016,0244,0,261,4,265,337,0,3,1,3,0,1,0,76.14,78.64 ,33.33
03,005,01,017,0245,0,216,0,216,302,0,3,1,3,0,1,0,76.14,71.52 ,33.33
03,005,01,017,0246,0,478,11,489,683,0,3,1,3,0,1,0,76.14,71.60 ,33.33
03,005,01,017,0247,0,692,11,703,1032,0,3,1,3,0,1,0,76.14,68.12 ,33.33
03,005,01,017,0248,0,417,9,426,632,0,3,1,3,0,1,0,76.14,67.41 ,33.33
03,005,01,017,0249,0,469,7,476,695,0,3,1,3,0,1,0,76.14,68.49 ,33.33
03,005,01,017,0250,0,295,0,295,391,0,3,1,3,0,1,0,76.14,75.45 ,33.33
03,005,01,017,0251,0,600,17,617,820,0,3,1,3,0,1,0,76.14,75.24 ,33.33
03,005,01,018,0252,0,98,1,99,126,0,3,1,3,0,1,0,76.14,78.57 ,33.33
03,005,01,018,0253,0,231,1,232,368,0,3,1,3,0,1,0,76.14,63.04 ,33.33
03,005,01,018,0254,0,502,6,508,679,0,3,1,3,0,1,0,76.14,74.82 ,33.33
03,005,01,018,0255,0,81,1,82,107,0,3,1,3,0,1,0,76.14,76.64 ,33.33
03,005,01,018,0256,0,91,3,94,133,0,3,1,3,0,1,0,76.14,70.68 ,33.33
03,005,01,018,0257,0,17,0,17,25,0,3,1,3,0,1,0,76.14,68.00 ,33.33
03,005,01,018,0258,0,39,1,40,62,0,3,1,3,0,1,0,76.14,64.52 ,33.33
03,005,01,018,0259,0,16,0,16,34,0,3,1,3,0,1,0,76.14,47.06 ,33.33
03,006,01,001,0001,0,1481,26,1507,2052,0,3,1,3,0,1,0,76.14,73.44 ,33.33
03,006,01,001,0002,0,639,8,647,918,0,3,1,3,0,1,0,76.14,70.48 ,33.33
03,006,01,001,0003,0,556,4,560,789,0,3,1,3,0,1,0,76.14,70.98 ,33.33
03,006,01,001,0004,0,716,16,732,1011,0,3,1,3,0,1,0,76.14,72.40 ,33.33
03,006,01,001,0005,0,664,11,675,859,0,3,1,3,0,1,0,76.14,78.58 ,33.33
03,006,01,001,0006,0,3090,39,3129,4265,0,3,1,3,0,1,0,76.14,73.36 ,33.33
03,006,01,001,0007,0,1492,22,1514,2025,0,3,1,3,0,1,0,76.14,74.77 ,33.33
03,006,01,001,0008,0,1504,30,1534,1966,0,3,1,3,0,1,0,76.14,78.03 ,33.33
03,006,01,001,0009,0,2353,48,2401,3278,0,3,1,3,0,1,0,76.14,73.25 ,33.33
03,006,01,001,0010,0,3480,84,3564,5118,0,3,1,3,0,1,0,76.14,69.64 ,33.33
03,006,01,001,0011,0,1136,15,1151,1601,0,3,1,3,0,1,0,76.14,71.89 ,33.33
03,006,01,001,0012,0,903,8,911,1152,0,3,1,3,0,1,0,76.14,79.08 ,33.33
03,006,01,001,0013,0,1828,31,1859,2479,0,3,1,3,0,1,0,76.14,74.99 ,33.33
03,006,01,001,0014,0,693,9,702,911,0,3,1,3,0,1,0,76.14,77.06 ,33.33
03,006,01,001,0015,0,685,4,689,929,0,3,1,3,0,1,0,76.14,74.17 ,33.33
03,006,01,001,0016,0,3227,52,3279,4573,0,3,1,3,0,1,0,76.14,71.70 ,33.33
03,006,01,001,0017,0,1526,22,1548,2096,0,3,1,3,0,1,0,76.14,73.85 ,33.33
03,006,01,001,0018,0,1970,26,1996,2729,0,3,1,3,0,1,0,76.14,73.14 ,33.33
03,006,01,001,0019,0,4230,79,4309,6171,0,3,1,3,0,1,0,76.14,69.83 ,33.33
03,006,01,001,0020,0,2608,59,2667,3773,0,3,1,3,0,1,0,76.14,70.69 ,33.33
03,006,01,001,0021,0,1006,17,1023,1432,0,3,1,3,0,1,0,76.14,71.44 ,33.33
03,006,01,001,0022,0,776,9,785,1130,0,3,1,3,0,1,0,76.14,69.47 ,33.33
03,006,01,001,0023,0,2860,50,2910,4094,0,3,1,3,0,1,0,76.14,71.08 ,33.33
03,006,01,001,0024,0,5042,84,5126,7188,0,3,1,3,0,1,0,76.14,71.31 ,33.33
03,006,01,001,0025,0,2209,46,2255,3036,0,3,1,3,0,1,0,76.14,74.28 ,33.33
03,006,01,001,0026,0,1648,28,1676,2329,0,3,1,3,0,1,0,76.14,71.96 ,33.33
03,006,01,001,0027,0,3508,52,3560,4971,0,3,1,3,0,1,0,76.14,71.62 ,33.33
03,006,01,001,0028,0,6134,88,6222,8681,0,3,1,3,0,1,0,76.14,71.67 ,33.33
03,006,01,001,0029,0,1146,18,1164,1510,0,3,1,3,0,1,0,76.14,77.09 ,33.33
03,006,01,001,0030,0,2343,43,2386,3250,0,3,1,3,0,1,0,76.14,73.42 ,33.33
03,006,01,001,0031,0,2162,36,2198,2921,0,3,1,3,0,1,0,76.14,75.25 ,33.33
03,006,01,001,0032,0,1908,28,1936,2668,0,3,1,3,0,1,0,76.14,72.56 ,33.33
03,006,01,001,0033,0,993,25,1018,1355,0,3,1,3,0,1,0,76.14,75.13 ,33.33
03,006,01,001,0034,0,1564,30,1594,2175,0,3,1,3,0,1,0,76.14,73.29 ,33.33
03,006,01,001,0035,0,1289,36,1325,1749,0,3,1,3,0,1,0,76.14,75.76 ,33.33
03,006,01,001,0036,0,1870,34,1904,2583,0,3,1,3,0,1,0,76.14,73.71 ,33.33
03,006,01,002,0037,0,808,7,815,1125,0,3,1,3,0,1,0,76.14,72.44 ,33.33
03,006,01,002,0038,0,674,8,682,898,0,3,1,3,0,1,0,76.14,75.95 ,33.33
03,006,01,002,0039,0,1143,14,1157,1562,0,3,1,3,0,1,0,76.14,74.07 ,33.33
03,006,01,002,0040,0,1470,30,1500,1959,0,3,1,3,0,1,0,76.14,76.57 ,33.33
03,006,01,002,0041,0,1622,23,1645,2297,0,3,1,3,0,1,0,76.14,71.62 ,33.33
03,006,01,002,0042,0,786,5,791,1059,0,3,1,3,0,1,0,76.14,74.69 ,33.33
03,006,01,002,0043,0,1126,26,1152,1575,0,3,1,3,0,1,0,76.14,73.14 ,33.33
03,006,01,002,0044,0,2273,24,2297,3191,0,3,1,3,0,1,0,76.14,71.98 ,33.33
03,006,01,002,0045,0,1262,17,1279,1838,0,3,1,3,0,1,0,76.14,69.59 ,33.33
03,006,01,002,0046,0,1669,30,1699,2381,0,3,1,3,0,1,0,76.14,71.36 ,33.33
03,006,01,002,0047,0,1031,18,1049,1477,0,3,1,3,0,1,0,76.14,71.02 ,33.33
03,006,01,002,0048,0,3042,50,3092,4233,0,3,1,3,0,1,0,76.14,73.05 ,33.33
03,006,01,002,0049,0,1114,24,1138,1492,0,3,1,3,0,1,0,76.14,76.27 ,33.33
03,006,01,002,0050,0,735,8,743,998,0,3,1,3,0,1,0,76.14,74.45 ,33.33
03,006,01,002,0051,0,697,7,704,899,0,3,1,3,0,1,0,76.14,78.31 ,33.33
03,006,01,002,0052,0,1462,11,1473,1951,0,3,1,3,0,1,0,76.14,75.50 ,33.33
03,006,01,002,0053,0,906,14,920,1393,0,3,1,3,0,1,0,76.14,66.04 ,33.33
03,006,01,002,0054,0,1211,24,1235,1705,0,3,1,3,0,1,0,76.14,72.43 ,33.33
03,006,01,002,0055,0,1373,22,1395,1834,0,3,1,3,0,1,0,76.14,76.06 ,33.33
03,006,01,002,0056,0,1106,18,1124,1492,0,3,1,3,0,1,0,76.14,75.34 ,33.33
03,006,01,002,0057,0,866,8,874,1221,0,3,1,3,0,1,0,76.14,71.58 ,33.33
03,006,01,002,0058,0,1045,18,1063,1543,0,3,1,3,0,1,0,76.14,68.89 ,33.33
03,006,01,002,0059,0,547,8,555,754,0,3,1,3,0,1,0,76.14,73.61 ,33.33
03,006,01,002,0060,0,532,7,539,674,0,3,1,3,0,1,0,76.14,79.97 ,33.33
03,006,01,002,0061,0,949,24,973,1350,0,3,1,3,0,1,0,76.14,72.07 ,33.33
03,006,01,003,0062,0,814,18,832,1155,0,3,1,3,0,1,0,76.14,72.03 ,33.33
03,006,01,003,0063,0,878,8,886,1209,0,3,1,3,0,1,0,76.14,73.28 ,33.33
03,006,01,003,0064,0,1291,17,1308,1773,0,3,1,3,0,1,0,76.14,73.77 ,33.33
03,006,01,003,0065,0,524,9,533,717,0,3,1,3,0,1,0,76.14,74.34 ,33.33
03,006,01,003,0066,0,1245,15,1260,1645,0,3,1,3,0,1,0,76.14,76.60 ,33.33
03,006,01,003,0067,0,1272,17,1289,1830,0,3,1,3,0,1,0,76.14,70.44 ,33.33
03,006,01,003,0068,0,2147,34,2181,2975,0,3,1,3,0,1,0,76.14,73.31 ,33.33
03,006,01,003,0069,0,1150,21,1171,1457,0,3,1,3,0,1,0,76.14,80.37 ,33.33
03,006,01,003,0070,0,1899,30,1929,2649,0,3,1,3,0,1,0,76.14,72.82 ,33.33
03,006,01,003,0071,0,640,13,653,903,0,3,1,3,0,1,0,76.14,72.31 ,33.33
03,006,01,003,0072,0,663,4,667,908,0,3,1,3,0,1,0,76.14,73.46 ,33.33
03,006,01,003,0073,0,1721,29,1750,2294,0,3,1,3,0,1,0,76.14,76.29 ,33.33
03,006,01,003,0074,0,813,15,828,1001,0,3,1,3,0,1,0,76.14,82.72 ,33.33
03,006,01,003,0075,0,813,12,825,1038,0,3,1,3,0,1,0,76.14,79.48 ,33.33
03,006,01,003,0076,0,1024,18,1042,1295,0,3,1,3,0,1,0,76.14,80.46 ,33.33
03,006,01,003,0077,0,2707,40,2747,3662,0,3,1,3,0,1,0,76.14,75.01 ,33.33
03,006,01,003,0078,0,753,16,769,983,0,3,1,3,0,1,0,76.14,78.23 ,33.33
03,006,01,003,0079,0,1015,14,1029,1316,0,3,1,3,0,1,0,76.14,78.19 ,33.33
03,006,01,003,0080,0,634,8,642,805,0,3,1,3,0,1,0,76.14,79.75 ,33.33
03,006,01,003,0081,0,2194,42,2236,2852,0,3,1,3,0,1,0,76.14,78.40 ,33.33
03,006,01,003,0082,0,849,9,858,1136,0,3,1,3,0,1,0,76.14,75.53 ,33.33
03,006,01,003,0083,0,2094,40,2134,2761,0,3,1,3,0,1,0,76.14,77.29 ,33.33
03,006,01,003,0084,0,1627,24,1651,2239,0,3,1,3,0,1,0,76.14,73.74 ,33.33
03,006,01,003,0085,0,2123,40,2163,3207,0,3,1,3,0,1,0,76.14,67.45 ,33.33
03,006,01,003,0086,0,994,11,1005,1254,0,3,1,3,0,1,0,76.14,80.14 ,33.33
03,006,01,003,0087,0,1068,19,1087,1457,0,3,1,3,0,1,0,76.14,74.61 ,33.33
03,006,01,003,0088,0,846,17,863,1128,0,3,1,3,0,1,0,76.14,76.51 ,33.33
03,006,01,003,0089,0,839,12,851,1033,0,3,1,3,0,1,0,76.14,82.38 ,33.33
03,006,01,003,0090,0,887,13,900,1172,0,3,1,3,0,1,0,76.14,76.79 ,33.33
03,006,01,004,0091,0,868,17,885,1250,0,3,1,3,0,1,0,76.14,70.80 ,33.33
03,006,01,004,0092,0,815,10,825,1069,0,3,1,3,0,1,0,76.14,77.17 ,33.33
03,006,01,004,0093,0,1424,21,1445,1994,0,3,1,3,0,1,0,76.14,72.47 ,33.33
03,006,01,004,0094,0,543,6,549,753,0,3,1,3,0,1,0,76.14,72.91 ,33.33
03,006,01,004,0095,0,1441,19,1460,2003,0,3,1,3,0,1,0,76.14,72.89 ,33.33
03,006,01,004,0096,0,1032,16,1048,1345,0,3,1,3,0,1,0,76.14,77.92 ,33.33
03,006,01,004,0097,0,544,4,548,719,0,3,1,3,0,1,0,76.14,76.22 ,33.33
03,006,01,004,0098,0,335,6,341,495,0,3,1,3,0,1,0,76.14,68.89 ,33.33
03,006,01,004,0099,0,1763,22,1785,2355,0,3,1,3,0,1,0,76.14,75.80 ,33.33
03,006,01,004,0100,0,2481,32,2513,3323,0,3,1,3,0,1,0,76.14,75.62 ,33.33
03,006,01,004,0101,0,736,12,748,967,0,3,1,3,0,1,0,76.14,77.35 ,33.33
03,006,01,004,0102,0,988,29,1017,1310,0,3,1,3,0,1,0,76.14,77.63 ,33.33
03,006,01,004,0103,0,2228,45,2273,2925,0,3,1,3,0,1,0,76.14,77.71 ,33.33
03,006,01,004,0104,0,1829,30,1859,2371,0,3,1,3,0,1,0,76.14,78.41 ,33.33
03,006,01,004,0105,0,1346,18,1364,1665,0,3,1,3,0,1,0,76.14,81.92 ,33.33
03,006,01,004,0106,0,1908,25,1933,2565,0,3,1,3,0,1,0,76.14,75.36 ,33.33
03,006,01,004,0107,0,1517,16,1533,1989,0,3,1,3,0,1,0,76.14,77.07 ,33.33
03,006,01,004,0108,0,971,16,987,1243,0,3,1,3,0,1,0,76.14,79.40 ,33.33
03,006,01,004,0109,0,924,9,933,1213,0,3,1,3,0,1,0,76.14,76.92 ,33.33
03,006,01,004,0110,0,923,21,944,1230,0,3,1,3,0,1,0,76.14,76.75 ,33.33
03,006,01,004,0111,0,762,16,778,961,0,3,1,3,0,1,0,76.14,80.96 ,33.33
03,006,01,004,0112,0,962,8,970,1220,0,3,1,3,0,1,0,76.14,79.51 ,33.33
03,006,01,004,0113,0,1351,11,1362,1897,0,3,1,3,0,1,0,76.14,71.80 ,33.33
03,006,01,004,0114,0,1561,25,1586,2019,0,3,1,3,0,1,0,76.14,78.55 ,33.33
03,006,01,004,0115,0,1201,21,1222,1653,0,3,1,3,0,1,0,76.14,73.93 ,33.33
03,006,01,004,0116,0,1402,26,1428,1971,0,3,1,3,0,1,0,76.14,72.45 ,33.33
03,006,01,004,0117,0,3039,49,3088,4481,0,3,1,3,0,1,0,76.14,68.91 ,33.33
03,006,01,004,0118,0,1966,27,1993,2746,0,3,1,3,0,1,0,76.14,72.58 ,33.33
03,006,01,004,0119,0,863,15,878,1059,0,3,1,3,0,1,0,76.14,82.91 ,33.33
03,006,01,004,0120,0,797,6,803,1034,0,3,1,3,0,1,0,76.14,77.66 ,33.33
03,006,01,004,0121,0,718,15,733,949,0,3,1,3,0,1,0,76.14,77.24 ,33.33
03,006,01,004,0122,0,804,10,814,1050,0,3,1,3,0,1,0,76.14,77.52 ,33.33
03,006,01,005,0123,0,1003,14,1017,1296,0,3,1,3,0,1,0,76.14,78.47 ,33.33
03,006,01,005,0124,0,1746,22,1768,2229,0,3,1,3,0,1,0,76.14,79.32 ,33.33
03,006,01,005,0125,0,874,12,886,1167,0,3,1,3,0,1,0,76.14,75.92 ,33.33
03,006,01,005,0126,0,468,4,472,564,0,3,1,3,0,1,0,76.14,83.69 ,33.33
03,006,01,005,0127,0,1593,23,1616,2199,0,3,1,3,0,1,0,76.14,73.49 ,33.33
03,006,01,005,0128,0,1767,29,1796,2334,0,3,1,3,0,1,0,76.14,76.95 ,33.33
03,006,01,005,0129,0,2222,32,2254,2990,0,3,1,3,0,1,0,76.14,75.38 ,33.33
03,006,01,005,0130,0,2520,40,2560,3298,0,3,1,3,0,1,0,76.14,77.62 ,33.33
03,006,01,005,0131,0,3225,37,3262,4266,0,3,1,3,0,1,0,76.14,76.47 ,33.33
03,006,01,005,0132,0,3291,41,3332,4370,0,3,1,3,0,1,0,76.14,76.25 ,33.33
03,006,01,005,0133,0,670,10,680,838,0,3,1,3,0,1,0,76.14,81.15 ,33.33
03,006,01,005,0134,0,1359,16,1375,1791,0,3,1,3,0,1,0,76.14,76.77 ,33.33
03,006,01,005,0135,0,1920,29,1949,2559,0,3,1,3,0,1,0,76.14,76.16 ,33.33
03,006,01,005,0136,0,841,13,854,1095,0,3,1,3,0,1,0,76.14,77.99 ,33.33
03,006,01,005,0137,0,859,14,873,1222,0,3,1,3,0,1,0,76.14,71.44 ,33.33
03,006,01,005,0138,0,1079,22,1101,1423,0,3,1,3,0,1,0,76.14,77.37 ,33.33
03,006,01,005,0139,0,2287,30,2317,2996,0,3,1,3,0,1,0,76.14,77.34 ,33.33
03,006,01,005,0140,0,2399,35,2434,3234,0,3,1,3,0,1,0,76.14,75.26 ,33.33
03,006,01,005,0141,0,1111,20,1131,1373,0,3,1,3,0,1,0,76.14,82.37 ,33.33
03,006,01,005,0142,0,1419,24,1443,1889,0,3,1,3,0,1,0,76.14,76.39 ,33.33
03,006,01,006,0143,0,1263,17,1280,1817,0,3,1,3,0,1,0,76.14,70.45 ,33.33
03,006,01,006,0144,0,1516,24,1540,2043,0,3,1,3,0,1,0,76.14,75.38 ,33.33
03,006,01,006,0145,0,1918,31,1949,2873,0,3,1,3,0,1,0,76.14,67.84 ,33.33
03,006,01,006,0146,0,392,7,399,549,0,3,1,3,0,1,0,76.14,72.68 ,33.33
03,006,01,006,0147,0,828,17,845,1096,0,3,1,3,0,1,0,76.14,77.10 ,33.33
03,006,01,006,0148,0,561,8,569,748,0,3,1,3,0,1,0,76.14,76.07 ,33.33
03,006,01,006,0149,0,2740,53,2793,3658,0,3,1,3,0,1,0,76.14,76.35 ,33.33
03,006,01,006,0150,0,1258,21,1279,1678,0,3,1,3,0,1,0,76.14,76.22 ,33.33
03,006,01,006,0151,0,1594,18,1612,2185,0,3,1,3,0,1,0,76.14,73.78 ,33.33
03,006,01,006,0152,0,2886,53,2939,4091,0,3,1,3,0,1,0,76.14,71.84 ,33.33
03,006,01,006,0153,0,1956,18,1974,2693,0,3,1,3,0,1,0,76.14,73.30 ,33.33
03,006,01,006,0154,0,1125,13,1138,1585,0,3,1,3,0,1,0,76.14,71.80 ,33.33
03,006,01,006,0155,0,1392,35,1427,1867,0,3,1,3,0,1,0,76.14,76.43 ,33.33
03,006,01,006,0156,0,1384,21,1405,1837,0,3,1,3,0,1,0,76.14,76.48 ,33.33
03,006,01,007,0157,0,1353,28,1381,1844,0,3,1,3,0,1,0,76.14,74.89 ,33.33
03,006,01,007,0158,0,1823,26,1849,2257,0,3,1,3,0,1,0,76.14,81.92 ,33.33
03,006,01,007,0159,0,3356,66,3422,4622,0,3,1,3,0,1,0,76.14,74.04 ,33.33
03,006,01,007,0160,0,2385,40,2425,3027,0,3,1,3,0,1,0,76.14,80.11 ,33.33
03,006,01,007,0161,0,1280,11,1291,1570,0,3,1,3,0,1,0,76.14,82.23 ,33.33
03,006,01,007,0162,0,2757,59,2816,3493,0,3,1,3,0,1,0,76.14,80.62 ,33.33
03,006,01,007,0163,0,1433,20,1453,1779,0,3,1,3,0,1,0,76.14,81.68 ,33.33
03,006,01,007,0164,0,1593,36,1629,2112,0,3,1,3,0,1,0,76.14,77.13 ,33.33
03,006,01,007,0165,0,2071,38,2109,2578,0,3,1,3,0,1,0,76.14,81.81 ,33.33
03,006,01,007,0166,0,1333,25,1358,1673,0,3,1,3,0,1,0,76.14,81.17 ,33.33
03,006,01,007,0167,0,861,18,879,1084,0,3,1,3,0,1,0,76.14,81.09 ,33.33
03,006,01,007,0168,0,1128,25,1153,1411,0,3,1,3,0,1,0,76.14,81.72 ,33.33
03,006,01,007,0169,0,1400,27,1427,1740,0,3,1,3,0,1,0,76.14,82.01 ,33.33
03,006,01,007,0170,0,1581,29,1610,2040,0,3,1,3,0,1,0,76.14,78.92 ,33.33
03,006,01,007,0171,0,265,6,271,330,0,3,1,3,0,1,0,76.14,82.12 ,33.33
03,006,01,007,0172,0,1104,17,1121,1394,0,3,1,3,0,1,0,76.14,80.42 ,33.33
03,006,01,007,0173,0,1251,20,1271,1655,0,3,1,3,0,1,0,76.14,76.80 ,33.33
03,006,01,007,0174,0,936,9,945,1215,0,3,1,3,0,1,0,76.14,77.78 ,33.33
03,006,01,008,0175,0,1548,33,1581,2116,0,3,1,3,0,1,0,76.14,74.72 ,33.33
03,006,01,008,0176,0,957,18,975,1238,0,3,1,3,0,1,0,76.14,78.76 ,33.33
03,006,01,008,0177,0,1456,23,1479,1897,0,3,1,3,0,1,0,76.14,77.97 ,33.33
03,006,01,008,0178,0,1367,26,1393,1741,0,3,1,3,0,1,0,76.14,80.01 ,33.33
03,006,01,008,0179,0,1540,21,1561,2018,0,3,1,3,0,1,0,76.14,77.35 ,33.33
03,006,01,008,0180,0,1470,31,1501,1898,0,3,1,3,0,1,0,76.14,79.08 ,33.33
03,006,01,008,0181,0,2331,46,2377,3062,0,3,1,3,0,1,0,76.14,77.63 ,33.33
03,006,01,008,0182,0,715,9,724,891,0,3,1,3,0,1,0,76.14,81.26 ,33.33
03,006,01,008,0183,0,3128,55,3183,4063,0,3,1,3,0,1,0,76.14,78.34 ,33.33
03,006,01,008,0184,0,2257,33,2290,3078,0,3,1,3,0,1,0,76.14,74.40 ,33.33
03,006,01,008,0185,0,1336,22,1358,1780,0,3,1,3,0,1,0,76.14,76.29 ,33.33
03,006,01,008,0186,0,1094,26,1120,1540,0,3,1,3,0,1,0,76.14,72.73 ,33.33
03,006,01,008,0187,0,1494,23,1517,2111,0,3,1,3,0,1,0,76.14,71.86 ,33.33
03,006,01,008,0188,0,3935,93,4028,5350,0,3,1,3,0,1,0,76.14,75.29 ,33.33
03,006,01,008,0189,0,1541,28,1569,1986,0,3,1,3,0,1,0,76.14,79.00 ,33.33
03,006,01,008,0190,0,1666,45,1711,2171,0,3,1,3,0,1,0,76.14,78.81 ,33.33
03,006,01,009,0191,0,1081,12,1093,1484,0,3,1,3,0,1,0,76.14,73.65 ,33.33
03,006,01,009,0192,0,1324,17,1341,1854,0,3,1,3,0,1,0,76.14,72.33 ,33.33
03,006,01,009,0193,0,4577,68,4645,6691,0,3,1,3,0,1,0,76.14,69.42 ,33.33
03,006,01,009,0194,0,3441,58,3499,4892,0,3,1,3,0,1,0,76.14,71.52 ,33.33
03,006,01,009,0195,0,6075,106,6181,9225,0,3,1,3,0,1,0,76.14,67.00 ,33.33
03,006,01,009,0196,0,1942,32,1974,2820,0,3,1,3,0,1,0,76.14,70.00 ,33.33
03,006,01,009,0197,0,4827,101,4928,6637,0,3,1,3,0,1,0,76.14,74.25 ,33.33
03,006,01,009,0198,0,946,19,965,1140,0,3,1,3,0,1,0,76.14,84.65 ,33.33
03,006,01,009,0199,0,1514,29,1543,2126,0,3,1,3,0,1,0,76.14,72.58 ,33.33
03,006,01,009,0200,0,2661,44,2705,3690,0,3,1,3,0,1,0,76.14,73.31 ,33.33
03,006,01,009,0201,0,2119,35,2154,2861,0,3,1,3,0,1,0,76.14,75.29 ,33.33
03,006,01,009,0202,0,1073,21,1094,1458,0,3,1,3,0,1,0,76.14,75.03 ,33.33
03,006,01,009,0203,0,1920,42,1962,2618,0,3,1,3,0,1,0,76.14,74.94 ,33.33
03,006,01,010,0204,0,6587,111,6698,9447,0,3,1,3,0,1,0,76.14,70.90 ,33.33
03,006,01,010,0205,0,4699,100,4799,6702,0,3,1,3,0,1,0,76.14,71.61 ,33.33
03,006,01,010,0206,0,1498,23,1521,2053,0,3,1,3,0,1,0,76.14,74.09 ,33.33
03,006,01,010,0207,0,4570,95,4665,6800,0,3,1,3,0,1,0,76.14,68.60 ,33.33
03,006,01,010,0208,0,3109,76,3185,4161,0,3,1,3,0,1,0,76.14,76.54 ,33.33
03,006,01,010,0209,0,3432,73,3505,4651,0,3,1,3,0,1,0,76.14,75.36 ,33.33
03,006,01,010,0210,0,1805,32,1837,2310,0,3,1,3,0,1,0,76.14,79.52 ,33.33
03,006,01,010,0211,0,1927,46,1973,2526,0,3,1,3,0,1,0,76.14,78.11 ,33.33
03,006,01,010,0212,0,2258,53,2311,3112,0,3,1,3,0,1,0,76.14,74.26 ,33.33
03,006,01,011,0213,0,1819,31,1850,2393,0,3,1,3,0,1,0,76.14,77.31 ,33.33
03,006,01,011,0214,0,1302,22,1324,1666,0,3,1,3,0,1,0,76.14,79.47 ,33.33
03,006,01,011,0215,0,938,18,956,1179,0,3,1,3,0,1,0,76.14,81.09 ,33.33
03,006,01,011,0216,0,690,10,700,848,0,3,1,3,0,1,0,76.14,82.55 ,33.33
03,006,01,011,0217,0,939,17,956,1219,0,3,1,3,0,1,0,76.14,78.42 ,33.33
03,006,01,011,0218,0,1524,26,1550,1954,0,3,1,3,0,1,0,76.14,79.32 ,33.33
03,006,01,011,0219,0,1880,41,1921,2380,0,3,1,3,0,1,0,76.14,80.71 ,33.33
03,006,01,011,0220,0,687,4,691,878,0,3,1,3,0,1,0,76.14,78.70 ,33.33
03,006,01,011,0221,0,1860,30,1890,2414,0,3,1,3,0,1,0,76.14,78.29 ,33.33
03,006,01,011,0222,0,1011,14,1025,1264,0,3,1,3,0,1,0,76.14,81.09 ,33.33
03,006,01,011,0223,0,710,11,721,908,0,3,1,3,0,1,0,76.14,79.41 ,33.33
03,006,01,011,0224,0,474,1,475,618,0,3,1,3,0,1,0,76.14,76.86 ,33.33
03,006,01,011,0225,0,1026,13,1039,1391,0,3,1,3,0,1,0,76.14,74.69 ,33.33
03,006,01,012,0226,0,674,11,685,881,0,3,1,3,0,1,0,76.14,77.75 ,33.33
03,006,01,012,0227,0,817,16,833,1078,0,3,1,3,0,1,0,76.14,77.27 ,33.33
03,006,01,012,0228,0,711,12,723,932,0,3,1,3,0,1,0,76.14,77.58 ,33.33
03,006,01,012,0229,0,780,10,790,1051,0,3,1,3,0,1,0,76.14,75.17 ,33.33
03,006,01,012,0230,0,480,6,486,632,0,3,1,3,0,1,0,76.14,76.90 ,33.33
03,006,01,012,0231,0,945,23,968,1193,0,3,1,3,0,1,0,76.14,81.14 ,33.33
03,006,01,012,0232,0,1211,26,1237,1599,0,3,1,3,0,1,0,76.14,77.36 ,33.33
03,006,01,012,0233,0,751,12,763,966,0,3,1,3,0,1,0,76.14,78.99 ,33.33
03,006,01,012,0234,0,982,16,998,1264,0,3,1,3,0,1,0,76.14,78.96 ,33.33
03,006,01,012,0235,0,994,13,1007,1272,0,3,1,3,0,1,0,76.14,79.17 ,33.33
03,006,01,013,0236,0,775,10,785,930,0,3,1,3,0,1,0,76.14,84.41 ,33.33
03,006,01,013,0237,0,986,20,1006,1244,0,3,1,3,0,1,0,76.14,80.87 ,33.33
03,006,01,013,0238,0,1193,22,1215,1507,0,3,1,3,0,1,0,76.14,80.62 ,33.33
03,006,01,013,0239,0,2406,46,2452,3122,0,3,1,3,0,1,0,76.14,78.54 ,33.33
03,006,01,013,0240,0,1538,29,1567,2004,0,3,1,3,0,1,0,76.14,78.19 ,33.33
03,006,01,013,0241,0,2746,69,2815,3574,0,3,1,3,0,1,0,76.14,78.76 ,33.33
03,006,01,013,0242,0,1012,15,1027,1264,0,3,1,3,0,1,0,76.14,81.25 ,33.33
03,006,01,013,0243,0,725,8,733,865,0,3,1,3,0,1,0,76.14,84.74 ,33.33
03,006,01,013,0244,0,1473,23,1496,1848,0,3,1,3,0,1,0,76.14,80.95 ,33.33
03,006,01,013,0245,0,1159,23,1182,1425,0,3,1,3,0,1,0,76.14,82.95 ,33.33
03,006,01,013,0246,0,860,15,875,1080,0,3,1,3,0,1,0,76.14,81.02 ,33.33
03,006,01,014,0247,0,814,7,821,1009,0,3,1,3,0,1,0,76.14,81.37 ,33.33
03,006,01,014,0248,0,780,12,792,1036,0,3,1,3,0,1,0,76.14,76.45 ,33.33
03,006,01,014,0249,0,1492,18,1510,2093,0,3,1,3,0,1,0,76.14,72.15 ,33.33
03,006,01,014,0250,0,887,11,898,1116,0,3,1,3,0,1,0,76.14,80.47 ,33.33
03,006,01,014,0251,0,786,6,792,999,0,3,1,3,0,1,0,76.14,79.28 ,33.33
03,006,01,014,0252,0,1232,16,1248,1600,0,3,1,3,0,1,0,76.14,78.00 ,33.33
03,006,01,014,0253,0,616,4,620,802,0,3,1,3,0,1,0,76.14,77.31 ,33.33
03,006,01,014,0254,0,1074,17,1091,1443,0,3,1,3,0,1,0,76.14,75.61 ,33.33
03,006,01,014,0255,0,668,11,679,922,0,3,1,3,0,1,0,76.14,73.64 ,33.33
03,006,01,014,0256,0,1034,12,1046,1311,0,3,1,3,0,1,0,76.14,79.79 ,33.33
03,006,01,014,0257,0,828,12,840,1147,0,3,1,3,0,1,0,76.14,73.23 ,33.33
03,006,01,014,0258,0,501,5,506,630,0,3,1,3,0,1,0,76.14,80.32 ,33.33
03,006,01,015,0259,0,3259,48,3307,4552,0,3,1,3,0,1,0,76.14,72.65 ,33.33
03,006,01,015,0260,0,1527,30,1557,2278,0,3,1,3,0,1,0,76.14,68.35 ,33.33
03,006,01,015,0261,0,2597,65,2662,3631,0,3,1,3,0,1,0,76.14,73.31 ,33.33
03,006,01,015,0262,0,1897,31,1928,2501,0,3,1,3,0,1,0,76.14,77.09 ,33.33
03,006,01,015,0263,0,1504,26,1530,1944,0,3,1,3,0,1,0,76.14,78.70 ,33.33
03,006,01,015,0264,0,4578,68,4646,6621,0,3,1,3,0,1,0,76.14,70.17 ,33.33
03,006,01,015,0265,0,2672,40,2712,3791,0,3,1,3,0,1,0,76.14,71.54 ,33.33
03,006,01,015,0266,0,1396,21,1417,1907,0,3,1,3,0,1,0,76.14,74.31 ,33.33
03,006,01,015,0267,0,933,12,945,1198,0,3,1,3,0,1,0,76.14,78.88 ,33.33
03,006,01,015,0268,0,1315,25,1340,1830,0,3,1,3,0,1,0,76.14,73.22 ,33.33
03,006,01,015,0269,0,1051,10,1061,1343,0,3,1,3,0,1,0,76.14,79.00 ,33.33
03,006,01,015,0270,0,2224,41,2265,2820,0,3,1,3,0,1,0,76.14,80.32 ,33.33
03,006,01,015,0271,0,1049,17,1066,1347,0,3,1,3,0,1,0,76.14,79.14 ,33.33
03,006,01,015,0272,0,810,19,829,1127,0,3,1,3,0,1,0,76.14,73.56 ,33.33
03,006,01,015,0273,0,673,16,689,927,0,3,1,3,0,1,0,76.14,74.33 ,33.33
03,006,01,015,0274,0,603,10,613,807,0,3,1,3,0,1,0,76.14,75.96 ,33.33
03,006,01,016,0275,0,2254,32,2286,3035,0,3,1,3,0,1,0,76.14,75.32 ,33.33
03,006,01,016,0276,0,627,7,634,722,0,3,1,3,0,1,0,76.14,87.81 ,33.33
03,006,01,016,0277,0,2077,29,2106,2751,0,3,1,3,0,1,0,76.14,76.55 ,33.33
03,006,01,016,0278,0,857,12,869,1053,0,3,1,3,0,1,0,76.14,82.53 ,33.33
03,006,01,016,0279,0,1591,25,1616,1944,0,3,1,3,0,1,0,76.14,83.13 ,33.33
03,006,01,016,0280,0,1286,16,1302,1820,0,3,1,3,0,1,0,76.14,71.54 ,33.33
03,006,01,016,0281,0,1605,22,1627,2043,0,3,1,3,0,1,0,76.14,79.64 ,33.33
03,006,01,016,0282,0,1349,15,1364,1738,0,3,1,3,0,1,0,76.14,78.48 ,33.33
03,006,01,016,0283,0,644,11,655,800,0,3,1,3,0,1,0,76.14,81.88 ,33.33
03,006,01,016,0284,0,961,9,970,1171,0,3,1,3,0,1,0,76.14,82.84 ,33.33
03,006,01,016,0285,0,1120,13,1133,1445,0,3,1,3,0,1,0,76.14,78.41 ,33.33
03,006,01,016,0286,0,667,3,670,777,0,3,1,3,0,1,0,76.14,86.23 ,33.33
03,006,01,016,0287,0,1014,20,1034,1312,0,3,1,3,0,1,0,76.14,78.81 ,33.33
03,006,01,016,0288,0,2003,32,2035,2607,0,3,1,3,0,1,0,76.14,78.06 ,33.33
03,006,01,016,0289,0,2323,63,2386,3274,0,3,1,3,0,1,0,76.14,72.88 ,33.33
03,006,01,016,0290,0,3794,66,3860,5478,0,3,1,3,0,1,0,76.14,70.46 ,33.33
03,006,01,017,0291,0,1034,22,1056,1440,0,3,1,3,0,1,0,76.14,73.33 ,33.33
03,006,01,017,0292,0,1403,23,1426,1851,0,3,1,3,0,1,0,76.14,77.04 ,33.33
03,006,01,017,0293,0,1056,19,1075,1299,0,3,1,3,0,1,0,76.14,82.76 ,33.33
03,006,01,017,0294,0,1419,25,1444,1994,0,3,1,3,0,1,0,76.14,72.42 ,33.33
03,006,01,017,0295,0,696,8,704,902,0,3,1,3,0,1,0,76.14,78.05 ,33.33
03,006,01,017,0296,0,1393,18,1411,1760,0,3,1,3,0,1,0,76.14,80.17 ,33.33
03,006,01,017,0297,0,2751,56,2807,3537,0,3,1,3,0,1,0,76.14,79.36 ,33.33
03,006,01,017,0298,0,1516,14,1530,1959,0,3,1,3,0,1,0,76.14,78.10 ,33.33
03,006,01,017,0299,0,2272,30,2302,3168,0,3,1,3,0,1,0,76.14,72.66 ,33.33
03,006,01,017,0300,0,1710,28,1738,2359,0,3,1,3,0,1,0,76.14,73.68 ,33.33
03,006,01,017,0301,0,2299,55,2354,3161,0,3,1,3,0,1,0,76.14,74.47 ,33.33
03,006,01,017,0302,0,1069,18,1087,1421,0,3,1,3,0,1,0,76.14,76.50 ,33.33
03,006,01,017,0303,0,2270,41,2311,3274,0,3,1,3,0,1,0,76.14,70.59 ,33.33
03,006,01,017,0304,0,862,11,873,1105,0,3,1,3,0,1,0,76.14,79.00 ,33.33
03,006,01,017,0305,0,3821,60,3881,6038,0,3,1,3,0,1,0,76.14,64.28 ,33.33
03,006,01,018,0306,0,803,15,818,1120,0,3,1,3,0,1,0,76.14,73.04 ,33.33
03,006,01,018,0307,0,4190,58,4248,5956,0,3,1,3,0,1,0,76.14,71.32 ,33.33
03,006,01,018,0308,0,2773,45,2818,3946,0,3,1,3,0,1,0,76.14,71.41 ,33.33
03,006,01,018,0309,0,1235,17,1252,1816,0,3,1,3,0,1,0,76.14,68.94 ,33.33
03,006,01,018,0310,0,1042,17,1059,1452,0,3,1,3,0,1,0,76.14,72.93 ,33.33
03,006,01,018,0311,0,616,14,630,816,0,3,1,3,0,1,0,76.14,77.21 ,33.33
03,006,01,018,0312,0,788,15,803,1135,0,3,1,3,0,1,0,76.14,70.75 ,33.33
03,006,01,018,0313,0,3300,45,3345,4674,0,3,1,3,0,1,0,76.14,71.57 ,33.33
03,006,01,018,0314,0,1864,50,1914,2506,0,3,1,3,0,1,0,76.14,76.38 ,33.33
03,006,01,018,0315,0,1005,12,1017,1266,0,3,1,3,0,1,0,76.14,80.33 ,33.33
03,006,01,018,0316,0,1414,19,1433,1865,0,3,1,3,0,1,0,76.14,76.84 ,33.33
03,006,01,018,0317,0,1619,27,1646,2076,0,3,1,3,0,1,0,76.14,79.29 ,33.33
03,006,01,018,0318,0,1219,30,1249,1637,0,3,1,3,0,1,0,76.14,76.30 ,33.33
03,006,01,018,0319,0,1100,14,1114,1357,0,3,1,3,0,1,0,76.14,82.09 ,33.33
03,006,01,018,0320,0,741,11,752,966,0,3,1,3,0,1,0,76.14,77.85 ,33.33
03,006,01,018,0321,0,1671,14,1685,2361,0,3,1,3,0,1,0,76.14,71.37 ,33.33
03,006,01,018,0322,0,1440,15,1455,1913,0,3,1,3,0,1,0,76.14,76.06 ,33.33
03,006,01,018,0323,0,2118,32,2150,2825,0,3,1,3,0,1,0,76.14,76.11 ,33.33
03,006,01,018,0324,0,817,12,829,1089,0,3,1,3,0,1,0,76.14,76.12 ,33.33
03,006,01,018,0325,0,1564,31,1595,2011,0,3,1,3,0,1,0,76.14,79.31 ,33.33
03,006,01,019,0326,0,3269,53,3322,4606,0,3,1,3,0,1,0,76.14,72.12 ,33.33
03,006,01,019,0327,0,3429,77,3506,5167,0,3,1,3,0,1,0,76.14,67.85 ,33.33
03,006,01,019,0328,0,3526,75,3601,5208,0,3,1,3,0,1,0,76.14,69.14 ,33.33
03,006,01,019,0329,0,3281,52,3333,4630,0,3,1,3,0,1,0,76.14,71.99 ,33.33
03,006,01,019,0330,0,4725,92,4817,6670,0,3,1,3,0,1,0,76.14,72.22 ,33.33
03,006,01,019,0331,0,2795,59,2854,4073,0,3,1,3,0,1,0,76.14,70.07 ,33.33
03,006,01,019,0332,0,4766,84,4850,6625,0,3,1,3,0,1,0,76.14,73.21 ,33.33
03,006,01,019,0333,0,4309,81,4390,6143,0,3,1,3,0,1,0,76.14,71.46 ,33.33
03,006,01,019,0334,0,3950,73,4023,5640,0,3,1,3,0,1,0,76.14,71.33 ,33.33
03,006,01,019,0335,0,6235,112,6347,9669,0,3,1,3,0,1,0,76.14,65.64 ,33.33
03,006,01,019,0336,0,4569,93,4662,7530,0,3,1,3,0,1,0,76.14,61.91 ,33.33
03,006,01,019,0337,0,4158,81,4239,6336,0,3,1,3,0,1,0,76.14,66.90 ,33.33
03,006,01,019,0338,0,1976,43,2019,2906,0,3,1,3,0,1,0,76.14,69.48 ,33.33
03,006,01,019,0339,0,2471,40,2511,3461,0,3,1,3,0,1,0,76.14,72.55 ,33.33
03,006,01,019,0340,0,916,21,937,1271,0,3,1,3,0,1,0,76.14,73.72 ,33.33
03,006,01,019,0341,0,3312,73,3385,4640,0,3,1,3,0,1,0,76.14,72.95 ,33.33
03,006,01,019,0342,0,719,7,726,921,0,3,1,3,0,1,0,76.14,78.83 ,33.33
03,006,01,019,0343,0,2894,53,2947,4001,0,3,1,3,0,1,0,76.14,73.66 ,33.33
03,006,01,019,0344,0,1904,30,1934,2747,0,3,1,3,0,1,0,76.14,70.40 ,33.33
03,006,01,020,0345,0,1853,25,1878,2420,0,3,1,3,0,1,0,76.14,77.60 ,33.33
03,006,01,020,0346,0,4116,62,4178,5889,0,3,1,3,0,1,0,76.14,70.95 ,33.33
03,006,01,020,0347,0,1815,36,1851,2424,0,3,1,3,0,1,0,76.14,76.36 ,33.33
03,006,01,020,0348,0,3352,49,3401,5173,0,3,1,3,0,1,0,76.14,65.75 ,33.33
03,006,01,020,0349,0,4696,69,4765,7020,0,3,1,3,0,1,0,76.14,67.88 ,33.33
03,006,01,020,0350,0,1808,30,1838,2504,0,3,1,3,0,1,0,76.14,73.40 ,33.33
03,006,01,020,0351,0,1892,24,1916,2757,0,3,1,3,0,1,0,76.14,69.50 ,33.33
03,006,01,020,0352,0,983,22,1005,1292,0,3,1,3,0,1,0,76.14,77.79 ,33.33
03,006,01,020,0353,0,747,3,750,898,0,3,1,3,0,1,0,76.14,83.52 ,33.33
03,006,01,020,0354,0,4955,69,5024,7233,0,3,1,3,0,1,0,76.14,69.46 ,33.33
03,006,01,020,0355,0,2384,40,2424,3209,0,3,1,3,0,1,0,76.14,75.54 ,33.33
03,006,01,020,0356,0,3489,62,3551,5233,0,3,1,3,0,1,0,76.14,67.86 ,33.33
03,006,01,020,0357,0,3432,48,3480,5254,0,3,1,3,0,1,0,76.14,66.24 ,33.33
03,006,01,020,0358,0,4825,77,4902,7257,0,3,1,3,0,1,0,76.14,67.55 ,33.33
03,006,01,020,0359,0,1948,47,1995,2816,0,3,1,3,0,1,0,76.14,70.85 ,33.33
03,006,01,020,0360,0,6236,102,6338,9460,0,3,1,3,0,1,0,76.14,67.00 ,33.33
03,006,01,020,0361,0,4700,54,4754,7388,0,3,1,3,0,1,0,76.14,64.35 ,33.33
03,006,01,020,0362,0,3930,72,4002,6215,0,3,1,3,0,1,0,76.14,64.39 ,33.33
03,006,01,020,0363,0,3112,48,3160,4797,0,3,1,3,0,1,0,76.14,65.87 ,33.33
03,006,01,020,0364,0,4262,58,4320,6497,0,3,1,3,0,1,0,76.14,66.49 ,33.33
03,006,01,021,0365,0,1023,14,1037,1369,0,3,1,3,0,1,0,76.14,75.75 ,33.33
03,006,01,021,0366,0,295,11,306,450,0,3,1,3,0,1,0,76.14,68.00 ,33.33
03,006,01,021,0367,0,763,14,777,1093,0,3,1,3,0,1,0,76.14,71.09 ,33.33
03,006,01,021,0368,0,346,5,351,484,0,3,1,3,0,1,0,76.14,72.52 ,33.33
03,006,01,021,0369,0,319,4,323,472,0,3,1,3,0,1,0,76.14,68.43 ,33.33
03,006,01,021,0370,0,204,2,206,257,0,3,1,3,0,1,0,76.14,80.16 ,33.33
03,006,01,021,0371,0,803,11,814,1337,0,3,1,3,0,1,0,76.14,60.88 ,33.33
03,006,01,021,0372,0,220,3,223,373,0,3,1,3,0,1,0,76.14,59.79 ,33.33
03,007,01,001,0001,0,1939,28,1967,2661,0,3,1,3,0,1,0,76.14,73.92 ,33.33
03,007,01,001,0002,0,1567,28,1595,2184,0,3,1,3,0,1,0,76.14,73.03 ,33.33
03,007,01,001,0003,0,1022,10,1032,1470,0,3,1,3,0,1,0,76.14,70.20 ,33.33
03,007,01,001,0004,0,1161,19,1180,1650,0,3,1,3,0,1,0,76.14,71.52 ,33.33
03,007,01,001,0005,0,1546,32,1578,2229,0,3,1,3,0,1,0,76.14,70.79 ,33.33
03,007,01,001,0006,0,1641,28,1669,2325,0,3,1,3,0,1,0,76.14,71.78 ,33.33
03,007,01,001,0007,0,897,10,907,1249,0,3,1,3,0,1,0,76.14,72.62 ,33.33
03,007,01,001,0008,0,1366,19,1385,1901,0,3,1,3,0,1,0,76.14,72.86 ,33.33
03,007,01,001,0009,0,2799,33,2832,4141,0,3,1,3,0,1,0,76.14,68.39 ,33.33
03,007,01,001,0010,0,1998,39,2037,2817,0,3,1,3,0,1,0,76.14,72.31 ,33.33
03,007,01,001,0011,0,2390,48,2438,3433,0,3,1,3,0,1,0,76.14,71.02 ,33.33
03,007,01,001,0012,0,3493,63,3556,5341,0,3,1,3,0,1,0,76.14,66.58 ,33.33
03,007,01,001,0013,0,989,17,1006,1437,0,3,1,3,0,1,0,76.14,70.01 ,33.33
03,007,01,001,0014,0,906,12,918,1243,0,3,1,3,0,1,0,76.14,73.85 ,33.33
03,007,01,001,0015,0,1083,16,1099,1535,0,3,1,3,0,1,0,76.14,71.60 ,33.33
03,007,01,001,0016,0,808,10,818,1102,0,3,1,3,0,1,0,76.14,74.23 ,33.33
03,007,01,001,0017,0,1659,13,1672,2456,0,3,1,3,0,1,0,76.14,68.08 ,33.33
03,007,01,001,0018,0,2015,29,2044,2938,0,3,1,3,0,1,0,76.14,69.57 ,33.33
03,007,01,001,0019,0,699,9,708,985,0,3,1,3,0,1,0,76.14,71.88 ,33.33
03,007,01,001,0020,0,753,10,763,1091,0,3,1,3,0,1,0,76.14,69.94 ,33.33
03,007,01,001,0021,0,1023,11,1034,1347,0,3,1,3,0,1,0,76.14,76.76 ,33.33
03,007,01,001,0022,0,959,11,970,1367,0,3,1,3,0,1,0,76.14,70.96 ,33.33
03,007,01,001,0023,0,763,11,774,1090,0,3,1,3,0,1,0,76.14,71.01 ,33.33
03,007,01,001,0024,0,1285,21,1306,1851,0,3,1,3,0,1,0,76.14,70.56 ,33.33
03,007,01,001,0025,0,5227,88,5315,7759,0,3,1,3,0,1,0,76.14,68.50 ,33.33
03,007,01,001,0026,0,1393,27,1420,1911,0,3,1,3,0,1,0,76.14,74.31 ,33.33
03,007,01,001,0027,0,1060,15,1075,1362,0,3,1,3,0,1,0,76.14,78.93 ,33.33
03,007,01,001,0028,0,1093,27,1120,1475,0,3,1,3,0,1,0,76.14,75.93 ,33.33
03,007,01,001,0029,0,1874,33,1907,2447,0,3,1,3,0,1,0,76.14,77.93 ,33.33
03,007,01,001,0030,0,1707,28,1735,2326,0,3,1,3,0,1,0,76.14,74.59 ,33.33
03,007,01,001,0031,0,1434,27,1461,2044,0,3,1,3,0,1,0,76.14,71.48 ,33.33
03,007,01,001,0032,0,1257,20,1277,1838,0,3,1,3,0,1,0,76.14,69.48 ,33.33
03,007,01,001,0033,0,800,36,836,1177,0,3,1,3,0,1,0,76.14,71.03 ,33.33
03,007,01,001,0034,0,1636,14,1650,2409,0,3,1,3,0,1,0,76.14,68.49 ,33.33
03,007,01,001,0035,0,2403,35,2438,3448,0,3,1,3,0,1,0,76.14,70.71 ,33.33
03,007,01,001,0036,0,1324,20,1344,1901,0,3,1,3,0,1,0,76.14,70.70 ,33.33
03,007,01,001,0037,0,956,12,968,1384,0,3,1,3,0,1,0,76.14,69.94 ,33.33
03,007,01,001,0038,0,726,13,739,1024,0,3,1,3,0,1,0,76.14,72.17 ,33.33
03,007,01,001,0039,0,992,12,1004,1387,0,3,1,3,0,1,0,76.14,72.39 ,33.33
03,007,01,001,0040,0,602,10,612,820,0,3,1,3,0,1,0,76.14,74.63 ,33.33
03,007,01,001,0041,0,768,15,783,1056,0,3,1,3,0,1,0,76.14,74.15 ,33.33
03,007,01,001,0042,0,676,8,684,947,0,3,1,3,0,1,0,76.14,72.23 ,33.33
03,007,01,001,0043,0,904,13,917,1230,0,3,1,3,0,1,0,76.14,74.55 ,33.33
03,007,01,001,0044,0,625,11,636,898,0,3,1,3,0,1,0,76.14,70.82 ,33.33
03,007,01,001,0045,0,1507,23,1530,2135,0,3,1,3,0,1,0,76.14,71.66 ,33.33
03,007,01,001,0046,0,995,19,1014,1429,0,3,1,3,0,1,0,76.14,70.96 ,33.33
03,007,01,001,0047,0,1416,18,1434,1936,0,3,1,3,0,1,0,76.14,74.07 ,33.33
03,007,01,001,0048,0,2264,36,2300,3171,0,3,1,3,0,1,0,76.14,72.53 ,33.33
03,007,01,001,0049,0,2279,48,2327,3111,0,3,1,3,0,1,0,76.14,74.80 ,33.33
03,007,01,001,0050,0,574,15,589,750,0,3,1,3,0,1,0,76.14,78.53 ,33.33
03,007,01,001,0051,0,1211,20,1231,1676,0,3,1,3,0,1,0,76.14,73.45 ,33.33
03,007,01,001,0052,0,777,20,797,1013,0,3,1,3,0,1,0,76.14,78.68 ,33.33
03,007,01,001,0053,0,1370,24,1394,1816,0,3,1,3,0,1,0,76.14,76.76 ,33.33
03,007,01,001,0054,0,2285,62,2347,2987,0,3,1,3,0,1,0,76.14,78.57 ,33.33
03,007,01,001,0055,0,1445,21,1466,2096,0,3,1,3,0,1,0,76.14,69.94 ,33.33
03,007,01,001,0056,0,2398,43,2441,3369,0,3,1,3,0,1,0,76.14,72.45 ,33.33
03,007,01,001,0057,0,1201,25,1226,1816,0,3,1,3,0,1,0,76.14,67.51 ,33.33
03,007,01,001,0058,0,1537,32,1569,2057,0,3,1,3,0,1,0,76.14,76.28 ,33.33
03,007,01,001,0059,0,3344,63,3407,4859,0,3,1,3,0,1,0,76.14,70.12 ,33.33
03,007,01,001,0060,0,569,11,580,800,0,3,1,3,0,1,0,76.14,72.50 ,33.33
03,007,01,001,0061,0,1104,18,1122,1523,0,3,1,3,0,1,0,76.14,73.67 ,33.33
03,007,01,001,0062,0,733,7,740,928,0,3,1,3,0,1,0,76.14,79.74 ,33.33
03,007,01,001,0063,0,1549,33,1582,2153,0,3,1,3,0,1,0,76.14,73.48 ,33.33
03,007,01,001,0064,0,1471,24,1495,1907,0,3,1,3,0,1,0,76.14,78.40 ,33.33
03,007,01,001,0065,0,1882,27,1909,2521,0,3,1,3,0,1,0,76.14,75.72 ,33.33
03,007,01,001,0066,0,1669,46,1715,2647,0,3,1,3,0,1,0,76.14,64.79 ,33.33
03,007,01,001,0067,0,592,8,600,749,0,3,1,3,0,1,0,76.14,80.11 ,33.33
03,007,01,001,0068,0,700,11,711,934,0,3,1,3,0,1,0,76.14,76.12 ,33.33
03,007,01,001,0069,0,561,7,568,711,0,3,1,3,0,1,0,76.14,79.89 ,33.33
03,007,01,001,0070,0,785,13,798,1039,0,3,1,3,0,1,0,76.14,76.80 ,33.33
03,007,01,001,0071,0,795,11,806,1048,0,3,1,3,0,1,0,76.14,76.91 ,33.33
03,007,01,002,0072,0,1912,28,1940,2623,0,3,1,3,0,1,0,76.14,73.96 ,33.33
03,007,01,002,0073,0,1144,12,1156,1470,0,3,1,3,0,1,0,76.14,78.64 ,33.33
03,007,01,002,0074,0,1442,26,1468,1960,0,3,1,3,0,1,0,76.14,74.90 ,33.33
03,007,01,002,0075,0,825,12,837,984,0,3,1,3,0,1,0,76.14,85.06 ,33.33
03,007,01,002,0076,0,936,13,949,1195,0,3,1,3,0,1,0,76.14,79.41 ,33.33
03,007,01,002,0077,0,946,10,956,1285,0,3,1,3,0,1,0,76.14,74.40 ,33.33
03,007,01,002,0078,0,536,5,541,671,0,3,1,3,0,1,0,76.14,80.63 ,33.33
03,007,01,002,0079,0,1071,12,1083,1427,0,3,1,3,0,1,0,76.14,75.89 ,33.33
03,007,01,002,0080,0,2101,28,2129,2965,0,3,1,3,0,1,0,76.14,71.80 ,33.33
03,007,01,002,0081,0,1339,27,1366,1821,0,3,1,3,0,1,0,76.14,75.01 ,33.33
03,007,01,002,0082,0,1867,37,1904,2597,0,3,1,3,0,1,0,76.14,73.32 ,33.33
03,007,01,002,0083,0,885,14,899,1270,0,3,1,3,0,1,0,76.14,70.79 ,33.33
03,007,01,002,0084,0,1844,25,1869,2569,0,3,1,3,0,1,0,76.14,72.75 ,33.33
03,007,01,002,0085,0,586,8,594,791,0,3,1,3,0,1,0,76.14,75.09 ,33.33
03,007,01,002,0086,0,688,9,697,948,0,3,1,3,0,1,0,76.14,73.52 ,33.33
03,007,01,002,0087,0,1073,9,1082,1420,0,3,1,3,0,1,0,76.14,76.20 ,33.33
03,007,01,002,0088,0,703,5,708,994,0,3,1,3,0,1,0,76.14,71.23 ,33.33
03,007,01,002,0089,0,868,10,878,1268,0,3,1,3,0,1,0,76.14,69.24 ,33.33
03,007,01,003,0090,0,1226,20,1246,1565,0,3,1,3,0,1,0,76.14,79.62 ,33.33
03,007,01,003,0091,0,992,12,1004,1298,0,3,1,3,0,1,0,76.14,77.35 ,33.33
03,007,01,003,0092,0,1165,23,1188,1466,0,3,1,3,0,1,0,76.14,81.04 ,33.33
03,007,01,003,0093,0,460,4,464,555,0,3,1,3,0,1,0,76.14,83.60 ,33.33
03,007,01,003,0094,0,1424,20,1444,1899,0,3,1,3,0,1,0,76.14,76.04 ,33.33
03,007,01,003,0095,0,1467,28,1495,1968,0,3,1,3,0,1,0,76.14,75.97 ,33.33
03,007,01,003,0096,0,1044,16,1060,1374,0,3,1,3,0,1,0,76.14,77.15 ,33.33
03,007,01,003,0097,0,652,12,664,839,0,3,1,3,0,1,0,76.14,79.14 ,33.33
03,007,01,003,0098,0,676,7,683,916,0,3,1,3,0,1,0,76.14,74.56 ,33.33
03,007,01,003,0099,0,751,10,761,957,0,3,1,3,0,1,0,76.14,79.52 ,33.33
03,007,01,003,0100,0,567,5,572,715,0,3,1,3,0,1,0,76.14,80.00 ,33.33
03,007,01,003,0101,0,1118,12,1130,1367,0,3,1,3,0,1,0,76.14,82.66 ,33.33
03,007,01,003,0102,0,910,8,918,1263,0,3,1,3,0,1,0,76.14,72.68 ,33.33
03,007,01,003,0103,0,694,12,706,999,0,3,1,3,0,1,0,76.14,70.67 ,33.33
03,007,01,003,0104,0,751,12,763,1032,0,3,1,3,0,1,0,76.14,73.93 ,33.33
03,007,01,004,0105,0,726,9,735,1168,0,3,1,3,0,1,0,76.14,62.93 ,33.33
03,007,01,004,0106,0,396,6,402,576,0,3,1,3,0,1,0,76.14,69.79 ,33.33
03,007,01,004,0107,0,729,4,733,1146,0,3,1,3,0,1,0,76.14,63.96 ,33.33
03,007,01,004,0108,0,677,14,691,996,0,3,1,3,0,1,0,76.14,69.38 ,33.33
03,007,01,004,0109,0,653,7,660,1059,0,3,1,3,0,1,0,76.14,62.32 ,33.33
03,007,01,004,0110,0,1082,21,1103,1752,0,3,1,3,0,1,0,76.14,62.96 ,33.33
03,007,01,004,0111,0,838,6,844,1238,0,3,1,3,0,1,0,76.14,68.17 ,33.33
03,007,01,004,0112,0,230,3,233,354,0,3,1,3,0,1,0,76.14,65.82 ,33.33
03,007,01,004,0113,0,483,8,491,759,0,3,1,3,0,1,0,76.14,64.69 ,33.33
03,007,01,004,0114,0,543,8,551,858,0,3,1,3,0,1,0,76.14,64.22 ,33.33
03,007,01,004,0115,0,822,10,832,1223,0,3,1,3,0,1,0,76.14,68.03 ,33.33
03,007,01,004,0116,0,428,10,438,595,0,3,1,3,0,1,0,76.14,73.61 ,33.33
03,007,01,004,0117,0,683,10,693,1013,0,3,1,3,0,1,0,76.14,68.41 ,33.33
03,007,01,004,0118,0,822,11,833,1320,0,3,1,3,0,1,0,76.14,63.11 ,33.33
03,007,01,004,0119,0,1696,16,1712,2555,0,3,1,3,0,1,0,76.14,67.01 ,33.33
03,007,01,004,0120,0,3386,48,3434,5300,0,3,1,3,0,1,0,76.14,64.79 ,33.33
03,007,01,004,0121,0,2734,45,2779,3954,0,3,1,3,0,1,0,76.14,70.28 ,33.33
03,007,01,004,0122,0,2003,27,2030,2878,0,3,1,3,0,1,0,76.14,70.54 ,33.33
03,007,01,004,0123,0,1859,29,1888,2568,0,3,1,3,0,1,0,76.14,73.52 ,33.33
03,007,01,004,0124,0,964,11,975,1429,0,3,1,3,0,1,0,76.14,68.23 ,33.33
03,007,01,004,0125,0,1587,30,1617,2359,0,3,1,3,0,1,0,76.14,68.55 ,33.33
03,007,01,004,0126,0,1452,16,1468,2119,0,3,1,3,0,1,0,76.14,69.28 ,33.33
03,007,01,004,0127,0,1883,30,1913,2680,0,3,1,3,0,1,0,76.14,71.38 ,33.33
03,007,01,004,0128,0,1814,26,1840,2546,0,3,1,3,0,1,0,76.14,72.27 ,33.33
03,007,01,004,0129,0,1153,20,1173,1584,0,3,1,3,0,1,0,76.14,74.05 ,33.33
03,007,01,004,0130,0,1533,24,1557,1926,0,3,1,3,0,1,0,76.14,80.84 ,33.33
03,007,01,004,0131,0,1922,37,1959,2720,0,3,1,3,0,1,0,76.14,72.02 ,33.33
03,007,01,004,0132,0,2023,40,2063,2791,0,3,1,3,0,1,0,76.14,73.92 ,33.33
03,007,01,005,0133,0,1169,24,1193,1748,0,3,1,3,0,1,0,76.14,68.25 ,33.33
03,007,01,005,0134,0,751,13,764,1067,0,3,1,3,0,1,0,76.14,71.60 ,33.33
03,007,01,005,0135,0,655,12,667,906,0,3,1,3,0,1,0,76.14,73.62 ,33.33
03,007,01,005,0136,0,847,5,852,1133,0,3,1,3,0,1,0,76.14,75.20 ,33.33
03,007,01,005,0137,0,449,5,454,615,0,3,1,3,0,1,0,76.14,73.82 ,33.33
03,007,01,005,0138,0,836,10,846,1103,0,3,1,3,0,1,0,76.14,76.70 ,33.33
03,007,01,005,0139,0,690,15,705,965,0,3,1,3,0,1,0,76.14,73.06 ,33.33
03,007,01,005,0140,0,1221,14,1235,1716,0,3,1,3,0,1,0,76.14,71.97 ,33.33
03,007,01,005,0141,0,739,17,756,1148,0,3,1,3,0,1,0,76.14,65.85 ,33.33
03,007,01,005,0142,0,820,19,839,1167,0,3,1,3,0,1,0,76.14,71.89 ,33.33
03,007,01,005,0143,0,1147,19,1166,1699,0,3,1,3,0,1,0,76.14,68.63 ,33.33
03,007,01,005,0144,0,905,23,928,1439,0,3,1,3,0,1,0,76.14,64.49 ,33.33
03,007,01,005,0145,0,1142,19,1161,1677,0,3,1,3,0,1,0,76.14,69.23 ,33.33
03,007,01,005,0146,0,684,14,698,1004,0,3,1,3,0,1,0,76.14,69.52 ,33.33
03,007,01,005,0147,0,676,3,679,1024,0,3,1,3,0,1,0,76.14,66.31 ,33.33
03,007,01,005,0148,0,1227,20,1247,1884,0,3,1,3,0,1,0,76.14,66.19 ,33.33
03,007,01,005,0149,0,1145,20,1165,1568,0,3,1,3,0,1,0,76.14,74.30 ,33.33
03,007,01,005,0150,0,1364,23,1387,1777,0,3,1,3,0,1,0,76.14,78.05 ,33.33
03,007,01,005,0151,0,703,18,721,1014,0,3,1,3,0,1,0,76.14,71.10 ,33.33
03,007,01,005,0152,0,798,14,812,1144,0,3,1,3,0,1,0,76.14,70.98 ,33.33
03,007,01,005,0153,0,1607,37,1644,2321,0,3,1,3,0,1,0,76.14,70.83 ,33.33
03,007,01,005,0154,0,1174,14,1188,1801,0,3,1,3,0,1,0,76.14,65.96 ,33.33
03,007,01,006,0155,0,1069,20,1089,1414,0,3,1,3,0,1,0,76.14,77.02 ,33.33
03,007,01,006,0156,0,929,20,949,1272,0,3,1,3,0,1,0,76.14,74.61 ,33.33
03,007,01,006,0157,0,1220,25,1245,1687,0,3,1,3,0,1,0,76.14,73.80 ,33.33
03,007,01,006,0158,0,824,13,837,1008,0,3,1,3,0,1,0,76.14,83.04 ,33.33
03,007,01,006,0159,0,1118,11,1129,1445,0,3,1,3,0,1,0,76.14,78.13 ,33.33
03,007,01,006,0160,0,2054,40,2094,2731,0,3,1,3,0,1,0,76.14,76.68 ,33.33
03,007,01,006,0161,0,1641,23,1664,2232,0,3,1,3,0,1,0,76.14,74.55 ,33.33
03,007,01,006,0162,0,1232,26,1258,1624,0,3,1,3,0,1,0,76.14,77.46 ,33.33
03,007,01,006,0163,0,748,15,763,974,0,3,1,3,0,1,0,76.14,78.34 ,33.33
03,007,01,006,0164,0,1917,35,1952,2580,0,3,1,3,0,1,0,76.14,75.66 ,33.33
03,007,01,006,0165,0,1093,20,1113,1513,0,3,1,3,0,1,0,76.14,73.56 ,33.33
03,007,01,006,0166,0,896,18,914,1185,0,3,1,3,0,1,0,76.14,77.13 ,33.33
03,007,01,006,0167,0,962,14,976,1240,0,3,1,3,0,1,0,76.14,78.71 ,33.33
03,007,01,006,0168,0,1362,15,1377,1705,0,3,1,3,0,1,0,76.14,80.76 ,33.33
03,007,01,007,0169,0,2146,35,2181,2895,0,3,1,3,0,1,0,76.14,75.34 ,33.33
03,007,01,007,0170,0,1973,34,2007,2776,0,3,1,3,0,1,0,76.14,72.30 ,33.33
03,007,01,007,0171,0,392,1,393,474,0,3,1,3,0,1,0,76.14,82.91 ,33.33
03,007,01,007,0172,0,917,21,938,1228,0,3,1,3,0,1,0,76.14,76.38 ,33.33
03,007,01,007,0173,0,1975,28,2003,2845,0,3,1,3,0,1,0,76.14,70.40 ,33.33
03,007,01,007,0174,0,1312,20,1332,1879,0,3,1,3,0,1,0,76.14,70.89 ,33.33
03,007,01,007,0175,0,714,19,733,1006,0,3,1,3,0,1,0,76.14,72.86 ,33.33
03,007,01,007,0176,0,561,9,570,692,0,3,1,3,0,1,0,76.14,82.37 ,33.33
03,007,01,007,0177,0,1099,12,1111,1378,0,3,1,3,0,1,0,76.14,80.62 ,33.33
03,007,01,007,0178,0,1458,27,1485,1979,0,3,1,3,0,1,0,76.14,75.04 ,33.33
03,007,01,007,0179,0,831,19,850,1060,0,3,1,3,0,1,0,76.14,80.19 ,33.33
03,007,01,007,0180,0,1060,29,1089,1397,0,3,1,3,0,1,0,76.14,77.95 ,33.33
03,007,01,007,0181,0,1014,25,1039,1311,0,3,1,3,0,1,0,76.14,79.25 ,33.33
03,007,01,007,0182,0,935,18,953,1148,0,3,1,3,0,1,0,76.14,83.01 ,33.33
03,007,01,007,0183,0,2726,34,2760,3770,0,3,1,3,0,1,0,76.14,73.21 ,33.33
03,007,01,007,0184,0,926,20,946,1296,0,3,1,3,0,1,0,76.14,72.99 ,33.33
03,007,01,007,0185,0,896,13,909,1226,0,3,1,3,0,1,0,76.14,74.14 ,33.33
03,007,01,007,0186,0,1494,29,1523,2000,0,3,1,3,0,1,0,76.14,76.15 ,33.33
03,007,01,007,0187,0,1796,34,1830,2375,0,3,1,3,0,1,0,76.14,77.05 ,33.33
03,007,01,007,0188,0,554,7,561,674,0,3,1,3,0,1,0,76.14,83.23 ,33.33
03,007,01,007,0189,0,1425,42,1467,1927,0,3,1,3,0,1,0,76.14,76.13 ,33.33
03,007,01,007,0190,0,1451,25,1476,1887,0,3,1,3,0,1,0,76.14,78.22 ,33.33
03,007,01,007,0191,0,758,15,773,1050,0,3,1,3,0,1,0,76.14,73.62 ,33.33
03,007,01,007,0192,0,1591,34,1625,2262,0,3,1,3,0,1,0,76.14,71.84 ,33.33
03,007,01,007,0193,0,827,19,846,1187,0,3,1,3,0,1,0,76.14,71.27 ,33.33
03,007,01,007,0194,0,1169,21,1190,1550,0,3,1,3,0,1,0,76.14,76.77 ,33.33
03,007,01,007,0195,0,655,7,662,852,0,3,1,3,0,1,0,76.14,77.70 ,33.33
03,007,01,007,0196,0,896,8,904,1150,0,3,1,3,0,1,0,76.14,78.61 ,33.33
03,007,01,007,0197,0,1182,23,1205,1589,0,3,1,3,0,1,0,76.14,75.83 ,33.33
03,007,01,007,0198,0,1873,35,1908,2612,0,3,1,3,0,1,0,76.14,73.05 ,33.33
03,007,01,007,0199,0,1209,17,1226,1511,0,3,1,3,0,1,0,76.14,81.14 ,33.33
03,007,01,008,0200,0,1286,15,1301,1698,0,3,1,3,0,1,0,76.14,76.62 ,33.33
03,007,01,008,0201,0,809,10,819,1055,0,3,1,3,0,1,0,76.14,77.63 ,33.33
03,007,01,008,0202,0,1139,12,1151,1593,0,3,1,3,0,1,0,76.14,72.25 ,33.33
03,007,01,008,0203,0,832,8,840,1098,0,3,1,3,0,1,0,76.14,76.50 ,33.33
03,007,01,008,0204,0,653,16,669,909,0,3,1,3,0,1,0,76.14,73.60 ,33.33
03,007,01,008,0205,0,1085,18,1103,1475,0,3,1,3,0,1,0,76.14,74.78 ,33.33
03,007,01,008,0206,0,1384,34,1418,1796,0,3,1,3,0,1,0,76.14,78.95 ,33.33
03,007,01,008,0207,0,731,16,747,887,0,3,1,3,0,1,0,76.14,84.22 ,33.33
03,007,01,009,0208,0,2363,39,2402,3394,0,3,1,3,0,1,0,76.14,70.77 ,33.33
03,007,01,009,0209,0,966,14,980,1339,0,3,1,3,0,1,0,76.14,73.19 ,33.33
03,007,01,009,0210,0,811,12,823,1045,0,3,1,3,0,1,0,76.14,78.76 ,33.33
03,007,01,009,0211,0,1070,17,1087,1405,0,3,1,3,0,1,0,76.14,77.37 ,33.33
03,007,01,009,0212,0,923,17,940,1217,0,3,1,3,0,1,0,76.14,77.24 ,33.33
03,007,01,009,0213,0,1061,13,1074,1359,0,3,1,3,0,1,0,76.14,79.03 ,33.33
03,007,01,009,0214,0,1214,30,1244,1737,0,3,1,3,0,1,0,76.14,71.62 ,33.33
03,007,01,009,0215,0,1008,12,1020,1325,0,3,1,3,0,1,0,76.14,76.98 ,33.33
03,007,01,009,0216,0,667,6,673,967,0,3,1,3,0,1,0,76.14,69.60 ,33.33
03,007,01,009,0217,0,1007,13,1020,1393,0,3,1,3,0,1,0,76.14,73.22 ,33.33
03,007,01,009,0218,0,790,14,804,1087,0,3,1,3,0,1,0,76.14,73.97 ,33.33
03,007,01,009,0219,0,460,4,464,619,0,3,1,3,0,1,0,76.14,74.96 ,33.33
03,007,01,009,0220,0,993,15,1008,1378,0,3,1,3,0,1,0,76.14,73.15 ,33.33
03,007,01,009,0221,0,1305,16,1321,1660,0,3,1,3,0,1,0,76.14,79.58 ,33.33
03,007,01,010,0222,0,836,12,848,1134,0,3,1,3,0,1,0,76.14,74.78 ,33.33
03,007,01,010,0223,0,1711,25,1736,2501,0,3,1,3,0,1,0,76.14,69.41 ,33.33
03,007,01,010,0224,0,1106,10,1116,1572,0,3,1,3,0,1,0,76.14,70.99 ,33.33
03,007,01,010,0225,0,1829,23,1852,2631,0,3,1,3,0,1,0,76.14,70.39 ,33.33
03,007,01,010,0226,0,588,15,603,815,0,3,1,3,0,1,0,76.14,73.99 ,33.33
03,007,01,010,0227,0,1706,21,1727,2475,0,3,1,3,0,1,0,76.14,69.78 ,33.33
03,007,01,010,0228,0,769,10,779,1012,0,3,1,3,0,1,0,76.14,76.98 ,33.33
03,007,01,010,0229,0,559,2,561,786,0,3,1,3,0,1,0,76.14,71.37 ,33.33
03,007,01,010,0230,0,1210,21,1231,1729,0,3,1,3,0,1,0,76.14,71.20 ,33.33
03,007,01,010,0231,0,2349,45,2394,3559,0,3,1,3,0,1,0,76.14,67.27 ,33.33
03,007,01,010,0232,0,1447,18,1465,2157,0,3,1,3,0,1,0,76.14,67.92 ,33.33
03,007,01,010,0233,0,2445,45,2490,3480,0,3,1,3,0,1,0,76.14,71.55 ,33.33
03,007,01,010,0234,0,1982,52,2034,2882,0,3,1,3,0,1,0,76.14,70.58 ,33.33
03,007,01,010,0235,0,2737,42,2779,3890,0,3,1,3,0,1,0,76.14,71.44 ,33.33
03,007,01,010,0236,0,1107,16,1123,1470,0,3,1,3,0,1,0,76.14,76.39 ,33.33
03,007,01,010,0237,0,1008,19,1027,1298,0,3,1,3,0,1,0,76.14,79.12 ,33.33
03,007,01,010,0238,0,3189,50,3239,4565,0,3,1,3,0,1,0,76.14,70.95 ,33.33
03,007,01,010,0239,0,2968,43,3011,4200,0,3,1,3,0,1,0,76.14,71.69 ,33.33
03,007,01,010,0240,0,1548,22,1570,2178,0,3,1,3,0,1,0,76.14,72.08 ,33.33
03,007,01,010,0241,0,1234,15,1249,1820,0,3,1,3,0,1,0,76.14,68.63 ,33.33
03,007,01,010,0242,0,1303,14,1317,1839,0,3,1,3,0,1,0,76.14,71.62 ,33.33
03,007,01,010,0243,0,1131,10,1141,1675,0,3,1,3,0,1,0,76.14,68.12 ,33.33
03,007,01,010,0244,0,968,16,984,1287,0,3,1,3,0,1,0,76.14,76.46 ,33.33
03,007,01,010,0245,0,1246,31,1277,1799,0,3,1,3,0,1,0,76.14,70.98 ,33.33
03,007,01,010,0246,0,1463,35,1498,2035,0,3,1,3,0,1,0,76.14,73.61 ,33.33
03,007,01,010,0247,0,1222,20,1242,1697,0,3,1,3,0,1,0,76.14,73.19 ,33.33
03,007,01,010,0248,0,1873,34,1907,2652,0,3,1,3,0,1,0,76.14,71.91 ,33.33
03,007,01,010,0249,0,1504,19,1523,2030,0,3,1,3,0,1,0,76.14,75.02 ,33.33
03,007,01,010,0250,0,1252,20,1272,1764,0,3,1,3,0,1,0,76.14,72.11 ,33.33
03,007,01,010,0251,0,1339,29,1368,1957,0,3,1,3,0,1,0,76.14,69.90 ,33.33
03,007,01,010,0252,0,1023,19,1042,1616,0,3,1,3,0,1,0,76.14,64.48 ,33.33
03,007,01,010,0253,0,911,13,924,1261,0,3,1,3,0,1,0,76.14,73.28 ,33.33
03,007,01,010,0254,0,480,10,490,739,0,3,1,3,0,1,0,76.14,66.31 ,33.33
03,007,01,010,0255,0,1179,20,1199,1691,0,3,1,3,0,1,0,76.14,70.90 ,33.33
03,007,01,010,0256,0,1294,18,1312,1820,0,3,1,3,0,1,0,76.14,72.09 ,33.33
03,007,01,010,0257,0,984,18,1002,1384,0,3,1,3,0,1,0,76.14,72.40 ,33.33
03,007,01,010,0258,0,1015,19,1034,1542,0,3,1,3,0,1,0,76.14,67.06 ,33.33
03,007,01,010,0259,0,871,33,904,1262,0,3,1,3,0,1,0,76.14,71.63 ,33.33
03,007,01,010,0260,0,1337,32,1369,1717,0,3,1,3,0,1,0,76.14,79.73 ,33.33
03,007,01,011,0261,0,1181,25,1206,1588,0,3,1,3,0,1,0,76.14,75.94 ,33.33
03,007,01,011,0262,0,1150,26,1176,1498,0,3,1,3,0,1,0,76.14,78.50 ,33.33
03,007,01,011,0263,0,589,6,595,750,0,3,1,3,0,1,0,76.14,79.33 ,33.33
03,007,01,011,0264,0,854,12,866,1155,0,3,1,3,0,1,0,76.14,74.98 ,33.33
03,007,01,011,0265,0,826,10,836,1128,0,3,1,3,0,1,0,76.14,74.11 ,33.33
03,007,01,011,0266,0,1083,18,1101,1431,0,3,1,3,0,1,0,76.14,76.94 ,33.33
03,007,01,011,0267,0,750,12,762,1073,0,3,1,3,0,1,0,76.14,71.02 ,33.33
03,007,01,011,0268,0,755,12,767,983,0,3,1,3,0,1,0,76.14,78.03 ,33.33
03,007,01,011,0269,0,1328,21,1349,1823,0,3,1,3,0,1,0,76.14,74.00 ,33.33
03,007,01,011,0270,0,1022,8,1030,1332,0,3,1,3,0,1,0,76.14,77.33 ,33.33
03,007,01,011,0271,0,1208,29,1237,1684,0,3,1,3,0,1,0,76.14,73.46 ,33.33
03,007,01,011,0272,0,833,12,845,1063,0,3,1,3,0,1,0,76.14,79.49 ,33.33
03,007,01,011,0273,0,1656,36,1692,2209,0,3,1,3,0,1,0,76.14,76.60 ,33.33
03,007,01,011,0274,0,1081,19,1100,1441,0,3,1,3,0,1,0,76.14,76.34 ,33.33
03,007,01,011,0275,0,1087,46,1133,1544,0,3,1,3,0,1,0,76.14,73.38 ,33.33
03,007,01,011,0276,0,1361,24,1385,1761,0,3,1,3,0,1,0,76.14,78.65 ,33.33
03,007,01,012,0277,0,585,10,595,779,0,3,1,3,0,1,0,76.14,76.38 ,33.33
03,007,01,012,0278,0,928,18,946,1334,0,3,1,3,0,1,0,76.14,70.91 ,33.33
03,007,01,012,0279,0,1217,29,1246,1692,0,3,1,3,0,1,0,76.14,73.64 ,33.33
03,007,01,012,0280,0,1071,20,1091,1496,0,3,1,3,0,1,0,76.14,72.93 ,33.33
03,007,01,012,0281,0,1066,28,1094,1539,0,3,1,3,0,1,0,76.14,71.09 ,33.33
03,007,01,012,0282,0,817,20,837,1198,0,3,1,3,0,1,0,76.14,69.87 ,33.33
03,007,01,012,0283,0,563,8,571,770,0,3,1,3,0,1,0,76.14,74.16 ,33.33
03,007,01,012,0284,0,561,7,568,764,0,3,1,3,0,1,0,76.14,74.35 ,33.33
03,007,01,012,0285,0,1268,25,1293,1755,0,3,1,3,0,1,0,76.14,73.68 ,33.33
03,007,01,012,0286,0,855,11,866,1170,0,3,1,3,0,1,0,76.14,74.02 ,33.33
03,007,01,012,0287,0,674,10,684,955,0,3,1,3,0,1,0,76.14,71.62 ,33.33
03,007,01,012,0288,0,904,18,922,1263,0,3,1,3,0,1,0,76.14,73.00 ,33.33
03,007,01,012,0289,0,1032,19,1051,1428,0,3,1,3,0,1,0,76.14,73.60 ,33.33
03,007,01,012,0290,0,1024,18,1042,1353,0,3,1,3,0,1,0,76.14,77.01 ,33.33
03,007,01,012,0291,0,746,16,762,1008,0,3,1,3,0,1,0,76.14,75.60 ,33.33
03,007,01,012,0292,0,608,15,623,844,0,3,1,3,0,1,0,76.14,73.82 ,33.33
03,007,01,012,0293,0,438,9,447,592,0,3,1,3,0,1,0,76.14,75.51 ,33.33
03,007,01,012,0294,0,505,21,526,680,0,3,1,3,0,1,0,76.14,77.35 ,33.33
03,007,01,012,0295,0,426,7,433,554,0,3,1,3,0,1,0,76.14,78.16 ,33.33
03,007,01,012,0296,0,690,12,702,905,0,3,1,3,0,1,0,76.14,77.57 ,33.33
03,007,01,012,0297,0,576,18,594,801,0,3,1,3,0,1,0,76.14,74.16 ,33.33
03,007,01,012,0298,0,504,9,513,688,0,3,1,3,0,1,0,76.14,74.56 ,33.33
03,007,01,012,0299,0,873,7,880,1121,0,3,1,3,0,1,0,76.14,78.50 ,33.33
03,007,01,012,0300,0,942,15,957,1333,0,3,1,3,0,1,0,76.14,71.79 ,33.33
03,007,01,013,0301,0,845,2,847,1177,0,3,1,3,0,1,0,76.14,71.96 ,33.33
03,007,01,013,0302,0,554,3,557,747,0,3,1,3,0,1,0,76.14,74.56 ,33.33
03,007,01,013,0303,0,816,12,828,1136,0,3,1,3,0,1,0,76.14,72.89 ,33.33
03,007,01,013,0304,0,407,3,410,556,0,3,1,3,0,1,0,76.14,73.74 ,33.33
03,007,01,013,0305,0,1750,30,1780,2467,0,3,1,3,0,1,0,76.14,72.15 ,33.33
03,007,01,013,0306,0,1152,16,1168,1563,0,3,1,3,0,1,0,76.14,74.73 ,33.33
03,007,01,013,0307,0,1204,25,1229,1671,0,3,1,3,0,1,0,76.14,73.55 ,33.33
03,007,01,013,0308,0,850,18,868,1191,0,3,1,3,0,1,0,76.14,72.88 ,33.33
03,007,01,013,0309,0,1073,14,1087,1553,0,3,1,3,0,1,0,76.14,69.99 ,33.33
03,007,01,013,0310,0,1560,20,1580,2155,0,3,1,3,0,1,0,76.14,73.32 ,33.33
03,007,01,013,0311,0,1117,14,1131,1577,0,3,1,3,0,1,0,76.14,71.72 ,33.33
03,007,01,013,0312,0,538,5,543,722,0,3,1,3,0,1,0,76.14,75.21 ,33.33
03,007,01,013,0313,0,1038,24,1062,1454,0,3,1,3,0,1,0,76.14,73.04 ,33.33
03,007,01,013,0314,0,1548,16,1564,2099,0,3,1,3,0,1,0,76.14,74.51 ,33.33
03,007,01,013,0315,0,496,9,505,675,0,3,1,3,0,1,0,76.14,74.81 ,33.33
03,007,01,013,0316,0,748,13,761,1157,0,3,1,3,0,1,0,76.14,65.77 ,33.33
03,007,01,013,0317,0,918,14,932,1285,0,3,1,3,0,1,0,76.14,72.53 ,33.33
03,007,01,013,0318,0,2102,31,2133,3021,0,3,1,3,0,1,0,76.14,70.61 ,33.33
03,007,01,013,0319,0,429,8,437,630,0,3,1,3,0,1,0,76.14,69.37 ,33.33
03,007,01,013,0320,0,879,9,888,1084,0,3,1,3,0,1,0,76.14,81.92 ,33.33
03,007,01,013,0321,0,559,7,566,690,0,3,1,3,0,1,0,76.14,82.03 ,33.33
03,007,01,013,0322,0,835,16,851,1081,0,3,1,3,0,1,0,76.14,78.72 ,33.33
03,007,01,013,0323,0,894,13,907,1289,0,3,1,3,0,1,0,76.14,70.36 ,33.33
03,007,01,013,0324,0,1133,11,1144,1600,0,3,1,3,0,1,0,76.14,71.50 ,33.33
03,007,01,013,0325,0,888,20,908,1397,0,3,1,3,0,1,0,76.14,65.00 ,33.33
03,007,01,014,0326,0,990,26,1016,1338,0,3,1,3,0,1,0,76.14,75.93 ,33.33
03,007,01,014,0327,0,963,12,975,1257,0,3,1,3,0,1,0,76.14,77.57 ,33.33
03,007,01,014,0328,0,799,17,816,1052,0,3,1,3,0,1,0,76.14,77.57 ,33.33
03,007,01,014,0329,0,556,13,569,708,0,3,1,3,0,1,0,76.14,80.37 ,33.33
03,007,01,014,0330,0,1184,24,1208,1474,0,3,1,3,0,1,0,76.14,81.95 ,33.33
03,007,01,014,0331,0,697,17,714,893,0,3,1,3,0,1,0,76.14,79.96 ,33.33
03,007,01,014,0332,0,853,15,868,1167,0,3,1,3,0,1,0,76.14,74.38 ,33.33
03,007,01,014,0333,0,735,12,747,957,0,3,1,3,0,1,0,76.14,78.06 ,33.33
03,007,01,014,0334,0,527,7,534,634,0,3,1,3,0,1,0,76.14,84.23 ,33.33
03,007,01,014,0335,0,747,9,756,966,0,3,1,3,0,1,0,76.14,78.26 ,33.33
03,007,01,014,0336,0,841,10,851,1087,0,3,1,3,0,1,0,76.14,78.29 ,33.33
03,007,01,014,0337,0,1369,21,1390,1837,0,3,1,3,0,1,0,76.14,75.67 ,33.33
03,007,01,014,0338,0,943,16,959,1189,0,3,1,3,0,1,0,76.14,80.66 ,33.33
03,007,01,014,0339,0,282,2,284,367,0,3,1,3,0,1,0,76.14,77.38 ,33.33
03,007,01,014,0340,0,698,10,708,957,0,3,1,3,0,1,0,76.14,73.98 ,33.33
03,007,01,014,0341,0,538,5,543,689,0,3,1,3,0,1,0,76.14,78.81 ,33.33
03,007,01,014,0342,0,930,10,940,1248,0,3,1,3,0,1,0,76.14,75.32 ,33.33
03,007,01,014,0343,0,632,12,644,816,0,3,1,3,0,1,0,76.14,78.92 ,33.33
03,007,01,014,0344,0,987,18,1005,1397,0,3,1,3,0,1,0,76.14,71.94 ,33.33
03,007,01,014,0345,0,892,11,903,1196,0,3,1,3,0,1,0,76.14,75.50 ,33.33
03,007,01,014,0346,0,939,11,950,1214,0,3,1,3,0,1,0,76.14,78.25 ,33.33
03,007,01,014,0347,0,906,10,916,1182,0,3,1,3,0,1,0,76.14,77.50 ,33.33
03,007,01,015,0348,0,1628,23,1651,2142,0,3,1,3,0,1,0,76.14,77.08 ,33.33
03,007,01,015,0349,0,810,14,824,1114,0,3,1,3,0,1,0,76.14,73.97 ,33.33
03,007,01,015,0350,0,964,19,983,1285,0,3,1,3,0,1,0,76.14,76.50 ,33.33
03,007,01,015,0351,0,751,14,765,964,0,3,1,3,0,1,0,76.14,79.36 ,33.33
03,007,01,015,0352,0,1087,12,1099,1405,0,3,1,3,0,1,0,76.14,78.22 ,33.33
03,007,01,015,0353,0,1136,18,1154,1448,0,3,1,3,0,1,0,76.14,79.70 ,33.33
03,007,01,015,0354,0,944,15,959,1204,0,3,1,3,0,1,0,76.14,79.65 ,33.33
03,007,01,015,0355,0,920,8,928,1238,0,3,1,3,0,1,0,76.14,74.96 ,33.33
03,007,01,015,0356,0,1085,25,1110,1497,0,3,1,3,0,1,0,76.14,74.15 ,33.33
03,007,01,015,0357,0,443,8,451,598,0,3,1,3,0,1,0,76.14,75.42 ,33.33
03,007,01,015,0358,0,638,12,650,894,0,3,1,3,0,1,0,76.14,72.71 ,33.33
03,007,01,015,0359,0,675,9,684,947,0,3,1,3,0,1,0,76.14,72.23 ,33.33
03,007,01,015,0360,0,456,9,465,687,0,3,1,3,0,1,0,76.14,67.69 ,33.33
03,007,01,015,0361,0,539,13,552,765,0,3,1,3,0,1,0,76.14,72.16 ,33.33
03,007,01,015,0362,0,1020,17,1037,1526,0,3,1,3,0,1,0,76.14,67.96 ,33.33
03,007,01,015,0363,0,889,14,903,1271,0,3,1,3,0,1,0,76.14,71.05 ,33.33
03,007,01,015,0364,0,667,5,672,851,0,3,1,3,0,1,0,76.14,78.97 ,33.33
03,007,01,015,0365,0,872,13,885,1102,0,3,1,3,0,1,0,76.14,80.31 ,33.33
03,007,01,015,0366,0,551,8,559,696,0,3,1,3,0,1,0,76.14,80.32 ,33.33
03,007,01,015,0367,0,652,8,660,833,0,3,1,3,0,1,0,76.14,79.23 ,33.33
03,007,01,016,0368,0,594,9,603,864,0,3,1,3,0,1,0,76.14,69.79 ,33.33
03,007,01,016,0369,0,1875,61,1936,2771,0,3,1,3,0,1,0,76.14,69.87 ,33.33
03,007,01,016,0370,0,411,6,417,651,0,3,1,3,0,1,0,76.14,64.06 ,33.33
03,007,01,016,0371,0,954,14,968,1368,0,3,1,3,0,1,0,76.14,70.76 ,33.33
03,007,01,016,0372,0,929,21,950,1433,0,3,1,3,0,1,0,76.14,66.29 ,33.33
03,007,01,016,0373,0,732,19,751,1043,0,3,1,3,0,1,0,76.14,72.00 ,33.33
03,007,01,016,0374,0,1063,14,1077,1561,0,3,1,3,0,1,0,76.14,68.99 ,33.33
03,007,01,016,0375,0,468,7,475,673,0,3,1,3,0,1,0,76.14,70.58 ,33.33
03,007,01,016,0376,0,1598,22,1620,2307,0,3,1,3,0,1,0,76.14,70.22 ,33.33
03,007,01,016,0377,0,1302,25,1327,1860,0,3,1,3,0,1,0,76.14,71.34 ,33.33
03,007,01,016,0378,0,786,13,799,1108,0,3,1,3,0,1,0,76.14,72.11 ,33.33
03,007,01,016,0379,0,916,11,927,1314,0,3,1,3,0,1,0,76.14,70.55 ,33.33
03,007,01,016,0380,0,1331,16,1347,1993,0,3,1,3,0,1,0,76.14,67.59 ,33.33
03,007,01,016,0381,0,1114,28,1142,1663,0,3,1,3,0,1,0,76.14,68.67 ,33.33
03,007,01,016,0382,0,1067,33,1100,1559,0,3,1,3,0,1,0,76.14,70.56 ,33.33
03,007,01,016,0383,0,818,22,840,1165,0,3,1,3,0,1,0,76.14,72.10 ,33.33
03,007,01,016,0384,0,938,22,960,1422,0,3,1,3,0,1,0,76.14,67.51 ,33.33
03,007,01,016,0385,0,1784,40,1824,2650,0,3,1,3,0,1,0,76.14,68.83 ,33.33
03,007,01,016,0386,0,890,18,908,1285,0,3,1,3,0,1,0,76.14,70.66 ,33.33
03,007,01,016,0387,0,962,18,980,1353,0,3,1,3,0,1,0,76.14,72.43 ,33.33
03,007,01,016,0388,0,636,8,644,876,0,3,1,3,0,1,0,76.14,73.52 ,33.33
03,007,01,016,0389,0,499,9,508,729,0,3,1,3,0,1,0,76.14,69.68 ,33.33
03,007,01,017,0390,0,1624,24,1648,2376,0,3,1,3,0,1,0,76.14,69.36 ,33.33
03,007,01,017,0391,0,2138,48,2186,2899,0,3,1,3,0,1,0,76.14,75.41 ,33.33
03,007,01,017,0392,0,1475,26,1501,2152,0,3,1,3,0,1,0,76.14,69.75 ,33.33
03,007,01,017,0393,0,476,15,491,700,0,3,1,3,0,1,0,76.14,70.14 ,33.33
03,007,01,017,0394,0,691,11,702,927,0,3,1,3,0,1,0,76.14,75.73 ,33.33
03,007,01,017,0395,0,727,13,740,995,0,3,1,3,0,1,0,76.14,74.37 ,33.33
03,007,01,017,0396,0,881,11,892,1241,0,3,1,3,0,1,0,76.14,71.88 ,33.33
03,007,01,017,0397,0,607,14,621,806,0,3,1,3,0,1,0,76.14,77.05 ,33.33
03,007,01,017,0398,0,783,13,796,1116,0,3,1,3,0,1,0,76.14,71.33 ,33.33
03,007,01,017,0399,0,577,8,585,757,0,3,1,3,0,1,0,76.14,77.28 ,33.33
03,007,01,017,0400,0,1242,32,1274,1693,0,3,1,3,0,1,0,76.14,75.25 ,33.33
03,007,01,017,0401,0,982,18,1000,1270,0,3,1,3,0,1,0,76.14,78.74 ,33.33
03,007,01,017,0402,0,979,19,998,1322,0,3,1,3,0,1,0,76.14,75.49 ,33.33
03,007,01,017,0403,0,749,14,763,990,0,3,1,3,0,1,0,76.14,77.07 ,33.33
03,007,01,017,0404,0,767,12,779,945,0,3,1,3,0,1,0,76.14,82.43 ,33.33
03,007,01,017,0405,0,734,12,746,965,0,3,1,3,0,1,0,76.14,77.31 ,33.33
03,007,01,017,0406,0,665,11,676,863,0,3,1,3,0,1,0,76.14,78.33 ,33.33
03,007,01,017,0407,0,634,10,644,883,0,3,1,3,0,1,0,76.14,72.93 ,33.33
03,007,01,017,0408,0,459,14,473,605,0,3,1,3,0,1,0,76.14,78.18 ,33.33
03,007,01,017,0409,0,589,12,601,757,0,3,1,3,0,1,0,76.14,79.39 ,33.33
03,007,01,017,0410,0,592,15,607,774,0,3,1,3,0,1,0,76.14,78.42 ,33.33
03,007,01,017,0411,0,567,4,571,733,0,3,1,3,0,1,0,76.14,77.90 ,33.33
03,007,01,017,0412,0,912,15,927,1243,0,3,1,3,0,1,0,76.14,74.58 ,33.33
03,007,01,017,0413,0,1156,27,1183,1683,0,3,1,3,0,1,0,76.14,70.29 ,33.33
03,007,01,018,0414,0,742,15,757,1047,0,3,1,3,0,1,0,76.14,72.30 ,33.33
03,007,01,018,0415,0,471,7,478,710,0,3,1,3,0,1,0,76.14,67.32 ,33.33
03,007,01,018,0416,0,596,13,609,836,0,3,1,3,0,1,0,76.14,72.85 ,33.33
03,007,01,018,0417,0,717,13,730,1016,0,3,1,3,0,1,0,76.14,71.85 ,33.33
03,007,01,018,0418,0,496,9,505,682,0,3,1,3,0,1,0,76.14,74.05 ,33.33
03,007,01,018,0419,0,548,8,556,742,0,3,1,3,0,1,0,76.14,74.93 ,33.33
03,007,01,018,0420,0,677,18,695,932,0,3,1,3,0,1,0,76.14,74.57 ,33.33
03,007,01,018,0421,0,656,11,667,886,0,3,1,3,0,1,0,76.14,75.28 ,33.33
03,007,01,018,0422,0,612,9,621,843,0,3,1,3,0,1,0,76.14,73.67 ,33.33
03,007,01,018,0423,0,411,1,412,553,0,3,1,3,0,1,0,76.14,74.50 ,33.33
03,007,01,018,0424,0,635,9,644,878,0,3,1,3,0,1,0,76.14,73.35 ,33.33
03,007,01,018,0425,0,642,11,653,909,0,3,1,3,0,1,0,76.14,71.84 ,33.33
03,007,01,018,0426,0,512,11,523,681,0,3,1,3,0,1,0,76.14,76.80 ,33.33
03,007,01,018,0427,0,592,9,601,800,0,3,1,3,0,1,0,76.14,75.13 ,33.33
03,007,01,018,0428,0,594,7,601,856,0,3,1,3,0,1,0,76.14,70.21 ,33.33
03,007,01,018,0429,0,481,15,496,661,0,3,1,3,0,1,0,76.14,75.04 ,33.33
03,007,01,018,0430,0,483,11,494,653,0,3,1,3,0,1,0,76.14,75.65 ,33.33
03,007,01,019,0431,0,1511,32,1543,2136,0,3,1,3,0,1,0,76.14,72.24 ,33.33
03,007,01,019,0432,0,1121,15,1136,1537,0,3,1,3,0,1,0,76.14,73.91 ,33.33
03,007,01,019,0433,0,2286,36,2322,3190,0,3,1,3,0,1,0,76.14,72.79 ,33.33
03,007,01,019,0434,0,1008,19,1027,1461,0,3,1,3,0,1,0,76.14,70.29 ,33.33
03,007,01,019,0435,0,808,18,826,1191,0,3,1,3,0,1,0,76.14,69.35 ,33.33
03,007,01,019,0436,0,602,4,606,820,0,3,1,3,0,1,0,76.14,73.90 ,33.33
03,007,01,019,0437,0,476,11,487,701,0,3,1,3,0,1,0,76.14,69.47 ,33.33
03,007,01,019,0438,0,581,6,587,802,0,3,1,3,0,1,0,76.14,73.19 ,33.33
03,007,01,019,0439,0,923,5,928,1317,0,3,1,3,0,1,0,76.14,70.46 ,33.33
03,007,01,019,0440,0,958,12,970,1315,0,3,1,3,0,1,0,76.14,73.76 ,33.33
03,007,01,019,0441,0,970,21,991,1392,0,3,1,3,0,1,0,76.14,71.19 ,33.33
03,007,01,019,0442,0,1196,30,1226,1722,0,3,1,3,0,1,0,76.14,71.20 ,33.33
03,007,01,019,0443,0,737,11,748,1007,0,3,1,3,0,1,0,76.14,74.28 ,33.33
03,007,01,019,0444,0,1076,28,1104,1520,0,3,1,3,0,1,0,76.14,72.63 ,33.33
03,007,01,019,0445,0,783,18,801,1217,0,3,1,3,0,1,0,76.14,65.82 ,33.33
03,007,01,020,0446,0,1092,52,1144,1722,0,3,1,3,0,1,0,76.14,66.43 ,33.33
03,007,01,020,0447,0,414,9,423,626,0,3,1,3,0,1,0,76.14,67.57 ,33.33
03,007,01,020,0448,0,656,10,666,955,0,3,1,3,0,1,0,76.14,69.74 ,33.33
03,007,01,020,0449,0,1143,13,1156,1597,0,3,1,3,0,1,0,76.14,72.39 ,33.33
03,007,01,020,0450,0,840,14,854,1151,0,3,1,3,0,1,0,76.14,74.20 ,33.33
03,007,01,020,0451,0,1145,18,1163,1695,0,3,1,3,0,1,0,76.14,68.61 ,33.33
03,007,01,020,0452,0,833,8,841,1159,0,3,1,3,0,1,0,76.14,72.56 ,33.33
03,007,01,020,0453,0,891,8,899,1336,0,3,1,3,0,1,0,76.14,67.29 ,33.33
03,007,01,020,0454,0,1260,26,1286,1932,0,3,1,3,0,1,0,76.14,66.56 ,33.33
03,007,01,020,0455,0,1067,16,1083,1698,0,3,1,3,0,1,0,76.14,63.78 ,33.33
03,007,01,020,0456,0,1248,24,1272,1879,0,3,1,3,0,1,0,76.14,67.70 ,33.33
03,007,01,020,0457,0,546,14,560,787,0,3,1,3,0,1,0,76.14,71.16 ,33.33
03,007,01,020,0458,0,727,14,741,1037,0,3,1,3,0,1,0,76.14,71.46 ,33.33
03,007,01,020,0459,0,582,14,596,951,0,3,1,3,0,1,0,76.14,62.67 ,33.33
03,007,01,020,0460,0,459,7,466,726,0,3,1,3,0,1,0,76.14,64.19 ,33.33
03,007,01,020,0461,0,570,8,578,863,0,3,1,3,0,1,0,76.14,66.98 ,33.33
03,007,01,020,0462,0,776,21,797,1160,0,3,1,3,0,1,0,76.14,68.71 ,33.33
03,007,01,020,0463,0,618,17,635,871,0,3,1,3,0,1,0,76.14,72.90 ,33.33
03,007,01,020,0464,0,787,32,819,1150,0,3,1,3,0,1,0,76.14,71.22 ,33.33
03,007,01,021,0465,0,786,14,800,1160,0,3,1,3,0,1,0,76.14,68.97 ,33.33
03,007,01,021,0466,0,414,3,417,582,0,3,1,3,0,1,0,76.14,71.65 ,33.33
03,007,01,021,0467,0,1168,22,1190,1557,0,3,1,3,0,1,0,76.14,76.43 ,33.33
03,007,01,021,0468,0,754,14,768,1026,0,3,1,3,0,1,0,76.14,74.85 ,33.33
03,007,01,021,0469,0,816,17,833,1089,0,3,1,3,0,1,0,76.14,76.49 ,33.33
03,007,01,021,0470,0,684,14,698,965,0,3,1,3,0,1,0,76.14,72.33 ,33.33
03,007,01,021,0471,0,786,9,795,1045,0,3,1,3,0,1,0,76.14,76.08 ,33.33
03,007,01,021,0472,0,561,6,567,769,0,3,1,3,0,1,0,76.14,73.73 ,33.33
03,007,01,021,0473,0,441,11,452,618,0,3,1,3,0,1,0,76.14,73.14 ,33.33
03,007,01,021,0474,0,608,15,623,850,0,3,1,3,0,1,0,76.14,73.29 ,33.33
03,007,01,021,0475,0,708,6,714,937,0,3,1,3,0,1,0,76.14,76.20 ,33.33
03,007,01,021,0476,0,843,12,855,1121,0,3,1,3,0,1,0,76.14,76.27 ,33.33
03,007,01,021,0477,0,1148,27,1175,1626,0,3,1,3,0,1,0,76.14,72.26 ,33.33
03,007,01,021,0478,0,574,11,585,755,0,3,1,3,0,1,0,76.14,77.48 ,33.33
03,007,01,021,0479,0,601,7,608,824,0,3,1,3,0,1,0,76.14,73.79 ,33.33
03,007,01,021,0480,0,1020,13,1033,1468,0,3,1,3,0,1,0,76.14,70.37 ,33.33
03,007,01,021,0481,0,1050,17,1067,1438,0,3,1,3,0,1,0,76.14,74.20 ,33.33
03,007,01,021,0482,0,226,4,230,324,0,3,1,3,0,1,0,76.14,70.99 ,33.33
03,007,01,021,0483,0,453,4,457,627,0,3,1,3,0,1,0,76.14,72.89 ,33.33
03,007,01,021,0484,0,436,5,441,602,0,3,1,3,0,1,0,76.14,73.26 ,33.33
03,007,01,022,0485,0,1456,41,1497,2150,0,3,1,3,0,1,0,76.14,69.63 ,33.33
03,007,01,022,0486,0,970,16,986,1389,0,3,1,3,0,1,0,76.14,70.99 ,33.33
03,007,01,022,0487,0,1044,22,1066,1484,0,3,1,3,0,1,0,76.14,71.83 ,33.33
03,007,01,022,0488,0,1391,25,1416,1955,0,3,1,3,0,1,0,76.14,72.43 ,33.33
03,007,01,022,0489,0,727,14,741,1087,0,3,1,3,0,1,0,76.14,68.17 ,33.33
03,007,01,022,0490,0,1006,32,1038,1442,0,3,1,3,0,1,0,76.14,71.98 ,33.33
03,007,01,022,0491,0,1915,29,1944,2660,0,3,1,3,0,1,0,76.14,73.08 ,33.33
03,007,01,022,0492,0,1088,22,1110,1514,0,3,1,3,0,1,0,76.14,73.32 ,33.33
03,007,01,022,0493,0,443,2,445,665,0,3,1,3,0,1,0,76.14,66.92 ,33.33
03,007,01,022,0494,0,411,6,417,606,0,3,1,3,0,1,0,76.14,68.81 ,33.33
03,007,01,022,0495,0,1052,25,1077,1566,0,3,1,3,0,1,0,76.14,68.77 ,33.33
03,007,01,022,0496,0,808,17,825,1222,0,3,1,3,0,1,0,76.14,67.51 ,33.33
03,007,01,022,0497,0,555,7,562,818,0,3,1,3,0,1,0,76.14,68.70 ,33.33
03,007,01,022,0498,0,507,17,524,751,0,3,1,3,0,1,0,76.14,69.77 ,33.33
03,007,01,022,0499,0,817,14,831,1211,0,3,1,3,0,1,0,76.14,68.62 ,33.33
03,007,01,022,0500,0,596,12,608,930,0,3,1,3,0,1,0,76.14,65.38 ,33.33
03,007,01,022,0501,0,650,12,662,976,0,3,1,3,0,1,0,76.14,67.83 ,33.33
03,007,01,023,0502,0,1514,15,1529,2105,0,3,1,3,0,1,0,76.14,72.64 ,33.33
03,007,01,023,0503,0,1792,28,1820,2510,0,3,1,3,0,1,0,76.14,72.51 ,33.33
03,007,01,023,0504,0,987,11,998,1411,0,3,1,3,0,1,0,76.14,70.73 ,33.33
03,007,01,023,0505,0,1461,28,1489,2090,0,3,1,3,0,1,0,76.14,71.24 ,33.33
03,007,01,023,0506,0,1089,20,1109,1556,0,3,1,3,0,1,0,76.14,71.27 ,33.33
03,007,01,023,0507,0,976,13,989,1482,0,3,1,3,0,1,0,76.14,66.73 ,33.33
03,007,01,023,0508,0,770,13,783,1195,0,3,1,3,0,1,0,76.14,65.52 ,33.33
03,007,01,023,0509,0,812,3,815,1097,0,3,1,3,0,1,0,76.14,74.29 ,33.33
03,007,01,023,0510,0,645,13,658,1040,0,3,1,3,0,1,0,76.14,63.27 ,33.33
03,007,01,023,0511,0,766,8,774,1123,0,3,1,3,0,1,0,76.14,68.92 ,33.33
03,007,01,023,0512,0,1265,19,1284,1954,0,3,1,3,0,1,0,76.14,65.71 ,33.33
03,007,01,023,0513,0,1343,19,1362,2048,0,3,1,3,0,1,0,76.14,66.50 ,33.33
03,007,01,023,0514,0,853,13,866,1249,0,3,1,3,0,1,0,76.14,69.34 ,33.33
03,007,01,023,0515,0,1124,32,1156,1613,0,3,1,3,0,1,0,76.14,71.67 ,33.33
03,007,01,023,0516,0,908,11,919,1204,0,3,1,3,0,1,0,76.14,76.33 ,33.33
03,007,01,023,0517,0,569,8,577,758,0,3,1,3,0,1,0,76.14,76.12 ,33.33
03,007,01,023,0518,0,999,14,1013,1366,0,3,1,3,0,1,0,76.14,74.16 ,33.33
03,007,01,023,0519,0,793,13,806,1085,0,3,1,3,0,1,0,76.14,74.29 ,33.33
03,007,01,023,0520,0,801,16,817,1018,0,3,1,3,0,1,0,76.14,80.26 ,33.33
03,007,01,023,0521,0,2499,50,2549,3276,0,3,1,3,0,1,0,76.14,77.81 ,33.33
03,007,01,023,0522,0,918,8,926,1303,0,3,1,3,0,1,0,76.14,71.07 ,33.33
03,007,01,023,0523,0,721,16,737,999,0,3,1,3,0,1,0,76.14,73.77 ,33.33
03,007,01,023,0524,0,608,6,614,869,0,3,1,3,0,1,0,76.14,70.66 ,33.33
03,007,01,023,0525,0,835,11,846,1174,0,3,1,3,0,1,0,76.14,72.06 ,33.33
03,007,01,023,0526,0,709,9,718,1013,0,3,1,3,0,1,0,76.14,70.88 ,33.33
03,007,01,023,0527,0,732,6,738,974,0,3,1,3,0,1,0,76.14,75.77 ,33.33
03,007,01,023,0528,0,540,8,548,764,0,3,1,3,0,1,0,76.14,71.73 ,33.33
03,007,01,024,0529,0,664,15,679,1113,0,3,1,3,0,1,0,76.14,61.01 ,33.33
03,007,01,024,0530,0,341,5,346,605,0,3,1,3,0,1,0,76.14,57.19 ,33.33
03,007,01,024,0531,0,604,8,612,968,0,3,1,3,0,1,0,76.14,63.22 ,33.33
03,007,01,024,0532,0,364,5,369,716,0,3,1,3,0,1,0,76.14,51.54 ,33.33
03,007,01,024,0533,0,568,8,576,881,0,3,1,3,0,1,0,76.14,65.38 ,33.33
03,007,01,024,0534,0,1119,25,1144,1595,0,3,1,3,0,1,0,76.14,71.72 ,33.33
03,007,01,024,0535,0,883,3,886,1458,0,3,1,3,0,1,0,76.14,60.77 ,33.33
03,007,01,024,0536,0,681,16,697,1143,0,3,1,3,0,1,0,76.14,60.98 ,33.33
03,007,01,024,0537,0,455,6,461,796,0,3,1,3,0,1,0,76.14,57.91 ,33.33
03,007,01,024,0538,0,535,8,543,787,0,3,1,3,0,1,0,76.14,69.00 ,33.33
03,007,01,024,0539,0,680,11,691,1008,0,3,1,3,0,1,0,76.14,68.55 ,33.33
03,007,01,024,0540,0,443,5,448,736,0,3,1,3,0,1,0,76.14,60.87 ,33.33
03,007,01,024,0541,0,434,7,441,701,0,3,1,3,0,1,0,76.14,62.91 ,33.33
03,007,01,024,0542,0,555,6,561,824,0,3,1,3,0,1,0,76.14,68.08 ,33.33
03,007,01,024,0543,0,486,2,488,832,0,3,1,3,0,1,0,76.14,58.65 ,33.33
03,007,01,024,0544,0,728,20,748,1330,0,3,1,3,0,1,0,76.14,56.24 ,33.33
03,007,01,024,0545,0,471,6,477,766,0,3,1,3,0,1,0,76.14,62.27 ,33.33
03,007,01,024,0546,0,873,8,881,1327,0,3,1,3,0,1,0,76.14,66.39 ,33.33
03,007,01,024,0547,0,329,8,337,638,0,3,1,3,0,1,0,76.14,52.82 ,33.33
03,007,01,024,0548,0,855,13,868,1304,0,3,1,3,0,1,0,76.14,66.56 ,33.33
03,007,01,024,0549,0,1360,21,1381,1926,0,3,1,3,0,1,0,76.14,71.70 ,33.33
03,007,01,024,0550,0,524,7,531,727,0,3,1,3,0,1,0,76.14,73.04 ,33.33
03,007,01,024,0551,0,672,10,682,980,0,3,1,3,0,1,0,76.14,69.59 ,33.33
03,007,01,024,0552,0,820,17,837,1310,0,3,1,3,0,1,0,76.14,63.89 ,33.33
03,007,01,024,0553,0,1631,31,1662,2524,0,3,1,3,0,1,0,76.14,65.85 ,33.33
03,007,01,024,0554,0,1186,26,1212,1982,0,3,1,3,0,1,0,76.14,61.15 ,33.33
03,007,01,025,0555,0,882,24,906,1454,0,3,1,3,0,1,0,76.14,62.31 ,33.33
03,007,01,025,0556,0,804,22,826,1414,0,3,1,3,0,1,0,76.14,58.42 ,33.33
03,007,01,025,0557,0,515,8,523,851,0,3,1,3,0,1,0,76.14,61.46 ,33.33
03,007,01,025,0558,0,833,12,845,1244,0,3,1,3,0,1,0,76.14,67.93 ,33.33
03,007,01,025,0559,0,717,13,730,1052,0,3,1,3,0,1,0,76.14,69.39 ,33.33
03,007,01,025,0560,0,742,10,752,1151,0,3,1,3,0,1,0,76.14,65.33 ,33.33
03,007,01,025,0561,0,456,12,468,784,0,3,1,3,0,1,0,76.14,59.69 ,33.33
03,007,01,025,0562,0,756,12,768,1227,0,3,1,3,0,1,0,76.14,62.59 ,33.33
03,007,01,025,0563,0,525,4,529,860,0,3,1,3,0,1,0,76.14,61.51 ,33.33
03,007,01,025,0564,0,411,5,416,763,0,3,1,3,0,1,0,76.14,54.52 ,33.33
03,007,01,025,0565,0,739,17,756,1185,0,3,1,3,0,1,0,76.14,63.80 ,33.33
03,007,01,025,0566,0,732,12,744,1301,0,3,1,3,0,1,0,76.14,57.19 ,33.33
03,007,01,025,0567,0,629,8,637,1081,0,3,1,3,0,1,0,76.14,58.93 ,33.33
03,007,01,025,0568,0,477,4,481,859,0,3,1,3,0,1,0,76.14,56.00 ,33.33
03,007,01,025,0569,0,591,10,601,1040,0,3,1,3,0,1,0,76.14,57.79 ,33.33
03,007,01,026,0570,0,638,6,644,999,0,3,1,3,0,1,0,76.14,64.46 ,33.33
03,007,01,026,0571,0,1136,14,1150,1527,0,3,1,3,0,1,0,76.14,75.31 ,33.33
03,007,01,026,0572,0,562,4,566,836,0,3,1,3,0,1,0,76.14,67.70 ,33.33
03,007,01,026,0573,0,564,7,571,816,0,3,1,3,0,1,0,76.14,69.98 ,33.33
03,007,01,026,0574,0,953,18,971,1426,0,3,1,3,0,1,0,76.14,68.09 ,33.33
03,007,01,026,0575,0,410,7,417,631,0,3,1,3,0,1,0,76.14,66.09 ,33.33
03,007,01,026,0576,0,623,7,630,930,0,3,1,3,0,1,0,76.14,67.74 ,33.33
03,007,01,026,0577,0,854,10,864,1214,0,3,1,3,0,1,0,76.14,71.17 ,33.33
03,007,01,026,0578,0,426,5,431,583,0,3,1,3,0,1,0,76.14,73.93 ,33.33
03,007,01,026,0579,0,611,13,624,894,0,3,1,3,0,1,0,76.14,69.80 ,33.33
03,007,01,026,0580,0,517,9,526,754,0,3,1,3,0,1,0,76.14,69.76 ,33.33
03,007,01,026,0581,0,462,1,463,661,0,3,1,3,0,1,0,76.14,70.05 ,33.33
03,007,01,026,0582,0,531,5,536,787,0,3,1,3,0,1,0,76.14,68.11 ,33.33
03,007,01,026,0583,0,486,4,490,739,0,3,1,3,0,1,0,76.14,66.31 ,33.33
03,008,01,001,0001,0,648,4,652,986,0,3,1,3,0,1,0,76.14,66.13 ,33.33
03,008,01,001,0002,0,829,9,838,1297,0,3,1,3,0,1,0,76.14,64.61 ,33.33
03,008,01,001,0003,0,494,7,501,769,0,3,1,3,0,1,0,76.14,65.15 ,33.33
03,008,01,001,0004,0,417,2,419,578,0,3,1,3,0,1,0,76.14,72.49 ,33.33
03,008,01,001,0005,0,501,10,511,739,0,3,1,3,0,1,0,76.14,69.15 ,33.33
03,008,01,001,0006,0,277,6,283,439,0,3,1,3,0,1,0,76.14,64.46 ,33.33
03,008,01,001,0007,0,697,8,705,1069,0,3,1,3,0,1,0,76.14,65.95 ,33.33
03,008,01,001,0008,0,2198,32,2230,3596,0,3,1,3,0,1,0,76.14,62.01 ,33.33
03,008,01,001,0009,0,1743,21,1764,2757,0,3,1,3,0,1,0,76.14,63.98 ,33.33
03,008,01,001,0010,0,928,27,955,1527,0,3,1,3,0,1,0,76.14,62.54 ,33.33
03,008,01,001,0011,0,1477,20,1497,2259,0,3,1,3,0,1,0,76.14,66.27 ,33.33
03,008,01,001,0012,0,3078,27,3105,4743,0,3,1,3,0,1,0,76.14,65.46 ,33.33
03,008,01,001,0013,0,1256,20,1276,1966,0,3,1,3,0,1,0,76.14,64.90 ,33.33
03,008,01,001,0014,0,521,4,525,815,0,3,1,3,0,1,0,76.14,64.42 ,33.33
03,008,01,001,0015,0,2228,29,2257,3334,0,3,1,3,0,1,0,76.14,67.70 ,33.33
03,008,01,001,0016,0,286,7,293,467,0,3,1,3,0,1,0,76.14,62.74 ,33.33
03,008,01,001,0017,0,1237,16,1253,1819,0,3,1,3,0,1,0,76.14,68.88 ,33.33
03,008,01,001,0018,0,2904,26,2930,4128,0,3,1,3,0,1,0,76.14,70.98 ,33.33
03,008,01,001,0019,0,2534,30,2564,3821,0,3,1,3,0,1,0,76.14,67.10 ,33.33
03,008,01,001,0020,0,893,8,901,1250,0,3,1,3,0,1,0,76.14,72.08 ,33.33
03,008,01,001,0021,0,448,5,453,618,0,3,1,3,0,1,0,76.14,73.30 ,33.33
03,008,01,001,0022,0,1407,20,1427,2079,0,3,1,3,0,1,0,76.14,68.64 ,33.33
03,008,01,001,0023,0,1664,18,1682,2315,0,3,1,3,0,1,0,76.14,72.66 ,33.33
03,008,01,001,0024,0,1273,16,1289,1738,0,3,1,3,0,1,0,76.14,74.17 ,33.33
03,008,01,001,0025,0,1349,13,1362,2035,0,3,1,3,0,1,0,76.14,66.93 ,33.33
03,008,01,001,0026,0,3147,41,3188,5037,0,3,1,3,0,1,0,76.14,63.29 ,33.33
03,008,01,001,0027,0,1918,24,1942,3245,0,3,1,3,0,1,0,76.14,59.85 ,33.33
03,008,01,001,0028,0,1639,21,1660,2530,0,3,1,3,0,1,0,76.14,65.61 ,33.33
03,008,01,001,0029,0,1175,35,1210,2002,0,3,1,3,0,1,0,76.14,60.44 ,33.33
03,008,01,001,0030,0,1392,24,1416,2336,0,3,1,3,0,1,0,76.14,60.62 ,33.33
03,008,01,001,0031,0,716,11,727,1244,0,3,1,3,0,1,0,76.14,58.44 ,33.33
03,008,01,001,0032,0,491,7,498,736,0,3,1,3,0,1,0,76.14,67.66 ,33.33
03,008,01,001,0033,0,507,10,517,787,0,3,1,3,0,1,0,76.14,65.69 ,33.33
03,008,01,001,0034,0,998,16,1014,1511,0,3,1,3,0,1,0,76.14,67.11 ,33.33
03,008,01,002,0035,0,1957,21,1978,3068,0,3,1,3,0,1,0,76.14,64.47 ,33.33
03,008,01,002,0036,0,1925,13,1938,3182,0,3,1,3,0,1,0,76.14,60.91 ,33.33
03,008,01,002,0037,0,668,1,669,983,0,3,1,3,0,1,0,76.14,68.06 ,33.33
03,008,01,002,0038,0,1489,11,1500,2411,0,3,1,3,0,1,0,76.14,62.21 ,33.33
03,008,01,002,0039,0,1877,11,1888,2886,0,3,1,3,0,1,0,76.14,65.42 ,33.33
03,008,01,002,0040,0,995,8,1003,1632,0,3,1,3,0,1,0,76.14,61.46 ,33.33
03,008,01,002,0041,0,1108,8,1116,1727,0,3,1,3,0,1,0,76.14,64.62 ,33.33
03,008,01,002,0042,0,1388,34,1422,2159,0,3,1,3,0,1,0,76.14,65.86 ,33.33
03,008,01,002,0043,0,2125,24,2149,3478,0,3,1,3,0,1,0,76.14,61.79 ,33.33
03,008,01,002,0044,0,933,13,946,1378,0,3,1,3,0,1,0,76.14,68.65 ,33.33
03,008,01,002,0045,0,3145,41,3186,5034,0,3,1,3,0,1,0,76.14,63.29 ,33.33
03,008,01,002,0046,0,534,1,535,746,0,3,1,3,0,1,0,76.14,71.72 ,33.33
03,008,01,002,0047,0,1495,17,1512,2054,0,3,1,3,0,1,0,76.14,73.61 ,33.33
03,008,01,002,0048,0,2879,31,2910,4646,0,3,1,3,0,1,0,76.14,62.63 ,33.33
03,008,01,002,0049,0,1532,21,1553,2532,0,3,1,3,0,1,0,76.14,61.33 ,33.33
03,008,01,002,0050,0,593,8,601,916,0,3,1,3,0,1,0,76.14,65.61 ,33.33
03,008,01,002,0051,0,619,8,627,910,0,3,1,3,0,1,0,76.14,68.90 ,33.33
03,008,01,002,0052,0,454,6,460,707,0,3,1,3,0,1,0,76.14,65.06 ,33.33
03,008,01,002,0053,0,540,5,545,945,0,3,1,3,0,1,0,76.14,57.67 ,33.33
03,008,01,002,0054,0,202,1,203,371,0,3,1,3,0,1,0,76.14,54.72 ,33.33
03,008,01,002,0055,0,748,7,755,1197,0,3,1,3,0,1,0,76.14,63.07 ,33.33
03,008,01,002,0056,0,788,5,793,1200,0,3,1,3,0,1,0,76.14,66.08 ,33.33
03,008,01,002,0057,0,951,11,962,1469,0,3,1,3,0,1,0,76.14,65.49 ,33.33
03,008,01,002,0058,0,744,5,749,1159,0,3,1,3,0,1,0,76.14,64.62 ,33.33
03,008,01,002,0059,0,465,1,466,683,0,3,1,3,0,1,0,76.14,68.23 ,33.33
03,008,01,002,0060,0,487,4,491,805,0,3,1,3,0,1,0,76.14,60.99 ,33.33
03,008,01,002,0061,0,932,8,940,1495,0,3,1,3,0,1,0,76.14,62.88 ,33.33
03,008,01,002,0062,0,667,7,674,1125,0,3,1,3,0,1,0,76.14,59.91 ,33.33
03,008,01,002,0063,0,402,0,402,640,0,3,1,3,0,1,0,76.14,62.81 ,33.33
03,008,01,002,0064,0,599,4,603,941,0,3,1,3,0,1,0,76.14,64.08 ,33.33
03,008,01,002,0065,0,1576,13,1589,2362,0,3,1,3,0,1,0,76.14,67.27 ,33.33
03,008,01,002,0066,0,678,10,688,1069,0,3,1,3,0,1,0,76.14,64.36 ,33.33
03,008,01,002,0067,0,1523,21,1544,2430,0,3,1,3,0,1,0,76.14,63.54 ,33.33
03,008,01,003,0068,0,1165,12,1177,1686,0,3,1,3,0,1,0,76.14,69.81 ,33.33
03,008,01,003,0069,0,2037,22,2059,3030,0,3,1,3,0,1,0,76.14,67.95 ,33.33
03,008,01,003,0070,0,1375,10,1385,1902,0,3,1,3,0,1,0,76.14,72.82 ,33.33
03,008,01,003,0071,0,524,4,528,728,0,3,1,3,0,1,0,76.14,72.53 ,33.33
03,008,01,003,0072,0,1065,11,1076,1470,0,3,1,3,0,1,0,76.14,73.20 ,33.33
03,008,01,003,0073,0,1594,17,1611,2289,0,3,1,3,0,1,0,76.14,70.38 ,33.33
03,008,01,003,0074,0,3045,33,3078,4499,0,3,1,3,0,1,0,76.14,68.42 ,33.33
03,008,01,003,0075,0,3182,38,3220,4739,0,3,1,3,0,1,0,76.14,67.95 ,33.33
03,008,01,003,0076,0,1834,14,1848,2621,0,3,1,3,0,1,0,76.14,70.51 ,33.33
03,008,01,003,0077,0,1418,10,1428,2023,0,3,1,3,0,1,0,76.14,70.59 ,33.33
03,008,01,003,0078,0,1823,23,1846,2806,0,3,1,3,0,1,0,76.14,65.79 ,33.33
03,008,01,003,0079,0,1006,13,1019,1452,0,3,1,3,0,1,0,76.14,70.18 ,33.33
03,008,01,003,0080,0,1730,20,1750,2637,0,3,1,3,0,1,0,76.14,66.36 ,33.33
03,008,01,003,0081,0,2747,29,2776,4175,0,3,1,3,0,1,0,76.14,66.49 ,33.33
03,008,01,003,0082,0,2052,19,2071,3044,0,3,1,3,0,1,0,76.14,68.04 ,33.33
03,008,01,003,0083,0,1601,39,1640,2443,0,3,1,3,0,1,0,76.14,67.13 ,33.33
03,008,01,003,0084,0,1105,13,1118,1706,0,3,1,3,0,1,0,76.14,65.53 ,33.33
03,008,01,003,0085,0,748,12,760,1052,0,3,1,3,0,1,0,76.14,72.24 ,33.33
03,008,01,003,0086,0,1363,28,1391,2010,0,3,1,3,0,1,0,76.14,69.20 ,33.33
03,008,01,003,0087,0,2386,22,2408,3602,0,3,1,3,0,1,0,76.14,66.85 ,33.33
03,008,01,003,0088,0,1222,10,1232,1793,0,3,1,3,0,1,0,76.14,68.71 ,33.33
03,008,01,003,0089,0,1163,11,1174,1684,0,3,1,3,0,1,0,76.14,69.71 ,33.33
03,008,01,003,0090,0,1831,18,1849,2749,0,3,1,3,0,1,0,76.14,67.26 ,33.33
03,008,01,003,0091,0,674,7,681,976,0,3,1,3,0,1,0,76.14,69.77 ,33.33
03,008,01,003,0092,0,954,16,970,1523,0,3,1,3,0,1,0,76.14,63.69 ,33.33
03,008,01,003,0093,0,635,5,640,935,0,3,1,3,0,1,0,76.14,68.45 ,33.33
03,008,01,003,0094,0,1386,23,1409,2269,0,3,1,3,0,1,0,76.14,62.10 ,33.33
03,008,01,004,0095,0,1414,14,1428,2309,0,3,1,3,0,1,0,76.14,61.84 ,33.33
03,008,01,004,0096,0,452,5,457,777,0,3,1,3,0,1,0,76.14,58.82 ,33.33
03,008,01,004,0097,0,2384,30,2414,4212,0,3,1,3,0,1,0,76.14,57.31 ,33.33
03,008,01,004,0098,0,1791,18,1809,3113,0,3,1,3,0,1,0,76.14,58.11 ,33.33
03,008,01,004,0099,0,1060,22,1082,1950,0,3,1,3,0,1,0,76.14,55.49 ,33.33
03,008,01,004,0100,0,1784,16,1800,3171,0,3,1,3,0,1,0,76.14,56.76 ,33.33
03,008,01,004,0101,0,486,6,492,880,0,3,1,3,0,1,0,76.14,55.91 ,33.33
03,008,01,004,0102,0,606,2,608,947,0,3,1,3,0,1,0,76.14,64.20 ,33.33
03,008,01,004,0103,0,705,5,710,1170,0,3,1,3,0,1,0,76.14,60.68 ,33.33
03,008,01,004,0104,0,516,3,519,858,0,3,1,3,0,1,0,76.14,60.49 ,33.33
03,008,01,004,0105,0,104,0,104,174,0,3,1,3,0,1,0,76.14,59.77 ,33.33
03,008,01,004,0106,0,1998,24,2022,3605,0,3,1,3,0,1,0,76.14,56.09 ,33.33
03,008,01,004,0107,0,1596,28,1624,2766,0,3,1,3,0,1,0,76.14,58.71 ,33.33
03,008,01,004,0108,0,917,16,933,1596,0,3,1,3,0,1,0,76.14,58.46 ,33.33
03,008,01,004,0109,0,1593,19,1612,2583,0,3,1,3,0,1,0,76.14,62.41 ,33.33
03,008,01,004,0110,0,340,1,341,668,0,3,1,3,0,1,0,76.14,51.05 ,33.33
03,008,01,004,0111,0,1039,8,1047,1923,0,3,1,3,0,1,0,76.14,54.45 ,33.33
03,008,01,004,0112,0,517,5,522,862,0,3,1,3,0,1,0,76.14,60.56 ,33.33
03,008,01,004,0113,0,864,6,870,1500,0,3,1,3,0,1,0,76.14,58.00 ,33.33
03,008,01,004,0114,0,420,8,428,749,0,3,1,3,0,1,0,76.14,57.14 ,33.33
03,008,01,004,0115,0,366,4,370,687,0,3,1,3,0,1,0,76.14,53.86 ,33.33
03,008,01,004,0116,0,649,11,660,1140,0,3,1,3,0,1,0,76.14,57.89 ,33.33
03,008,01,004,0117,0,562,6,568,890,0,3,1,3,0,1,0,76.14,63.82 ,33.33
03,008,01,004,0118,0,358,7,365,584,0,3,1,3,0,1,0,76.14,62.50 ,33.33
03,008,01,004,0119,0,532,9,541,992,0,3,1,3,0,1,0,76.14,54.54 ,33.33
03,008,01,004,0120,0,321,6,327,611,0,3,1,3,0,1,0,76.14,53.52 ,33.33
03,008,01,004,0121,0,451,6,457,821,0,3,1,3,0,1,0,76.14,55.66 ,33.33
03,008,01,004,0122,0,529,12,541,1077,0,3,1,3,0,1,0,76.14,50.23 ,33.33
03,008,01,005,0123,0,572,7,579,882,0,3,1,3,0,1,0,76.14,65.65 ,33.33
03,008,01,005,0124,0,545,13,558,1008,0,3,1,3,0,1,0,76.14,55.36 ,33.33
03,008,01,005,0125,0,397,5,402,597,0,3,1,3,0,1,0,76.14,67.34 ,33.33
03,008,01,005,0126,0,695,12,707,1162,0,3,1,3,0,1,0,76.14,60.84 ,33.33
03,008,01,005,0127,0,354,1,355,546,0,3,1,3,0,1,0,76.14,65.02 ,33.33
03,008,01,005,0128,0,285,5,290,454,0,3,1,3,0,1,0,76.14,63.88 ,33.33
03,008,01,005,0129,0,589,7,596,929,0,3,1,3,0,1,0,76.14,64.16 ,33.33
03,008,01,005,0130,0,760,9,769,1261,0,3,1,3,0,1,0,76.14,60.98 ,33.33
03,008,01,005,0131,0,538,10,548,818,0,3,1,3,0,1,0,76.14,66.99 ,33.33
03,008,01,005,0132,0,553,7,560,946,0,3,1,3,0,1,0,76.14,59.20 ,33.33
03,008,01,005,0133,0,249,2,251,433,0,3,1,3,0,1,0,76.14,57.97 ,33.33
03,008,01,006,0134,0,579,4,583,992,0,3,1,3,0,1,0,76.14,58.77 ,33.33
03,008,01,006,0135,0,1547,24,1571,2590,0,3,1,3,0,1,0,76.14,60.66 ,33.33
03,008,01,006,0136,0,1093,15,1108,1788,0,3,1,3,0,1,0,76.14,61.97 ,33.33
03,008,01,006,0137,0,956,10,966,1522,0,3,1,3,0,1,0,76.14,63.47 ,33.33
03,008,01,006,0138,0,635,8,643,999,0,3,1,3,0,1,0,76.14,64.36 ,33.33
03,008,01,006,0139,0,606,5,611,980,0,3,1,3,0,1,0,76.14,62.35 ,33.33
03,008,01,006,0140,0,1842,27,1869,3002,0,3,1,3,0,1,0,76.14,62.26 ,33.33
03,008,01,006,0141,0,952,20,972,1565,0,3,1,3,0,1,0,76.14,62.11 ,33.33
03,008,01,006,0142,0,535,3,538,755,0,3,1,3,0,1,0,76.14,71.26 ,33.33
03,008,01,006,0143,0,702,11,713,1052,0,3,1,3,0,1,0,76.14,67.78 ,33.33
03,008,01,006,0144,0,654,6,660,1034,0,3,1,3,0,1,0,76.14,63.83 ,33.33
03,008,01,006,0145,0,536,5,541,841,0,3,1,3,0,1,0,76.14,64.33 ,33.33
03,008,01,006,0146,0,1170,14,1184,1904,0,3,1,3,0,1,0,76.14,62.18 ,33.33
03,008,01,006,0147,0,453,6,459,781,0,3,1,3,0,1,0,76.14,58.77 ,33.33
03,008,01,006,0148,0,742,11,753,1244,0,3,1,3,0,1,0,76.14,60.53 ,33.33
03,008,01,006,0149,0,559,4,563,881,0,3,1,3,0,1,0,76.14,63.90 ,33.33
03,008,01,006,0150,0,879,13,892,1433,0,3,1,3,0,1,0,76.14,62.25 ,33.33
03,008,01,006,0151,0,1277,14,1291,2298,0,3,1,3,0,1,0,76.14,56.18 ,33.33
03,008,01,006,0152,0,454,8,462,741,0,3,1,3,0,1,0,76.14,62.35 ,33.33
03,008,01,006,0153,0,484,2,486,832,0,3,1,3,0,1,0,76.14,58.41 ,33.33
03,008,01,006,0154,0,540,2,542,847,0,3,1,3,0,1,0,76.14,63.99 ,33.33
03,008,01,006,0155,0,909,10,919,1502,0,3,1,3,0,1,0,76.14,61.19 ,33.33
03,008,01,007,0156,0,811,7,818,1492,0,3,1,3,0,1,0,76.14,54.83 ,33.33
03,008,01,007,0157,0,917,7,924,1567,0,3,1,3,0,1,0,76.14,58.97 ,33.33
03,008,01,007,0158,0,663,10,673,1071,0,3,1,3,0,1,0,76.14,62.84 ,33.33
03,008,01,007,0159,0,1039,16,1055,1762,0,3,1,3,0,1,0,76.14,59.88 ,33.33
03,008,01,007,0160,0,596,7,603,1107,0,3,1,3,0,1,0,76.14,54.47 ,33.33
03,008,01,007,0161,0,372,2,374,687,0,3,1,3,0,1,0,76.14,54.44 ,33.33
03,008,01,007,0162,0,826,3,829,1580,0,3,1,3,0,1,0,76.14,52.47 ,33.33
03,008,01,007,0163,0,537,3,540,910,0,3,1,3,0,1,0,76.14,59.34 ,33.33
03,008,01,007,0164,0,836,8,844,1283,0,3,1,3,0,1,0,76.14,65.78 ,33.33
03,008,01,007,0165,0,976,7,983,1670,0,3,1,3,0,1,0,76.14,58.86 ,33.33
03,008,01,007,0166,0,385,5,390,727,0,3,1,3,0,1,0,76.14,53.65 ,33.33
03,008,01,007,0167,0,426,2,428,800,0,3,1,3,0,1,0,76.14,53.50 ,33.33
03,008,01,007,0168,0,469,5,474,837,0,3,1,3,0,1,0,76.14,56.63 ,33.33
03,008,01,008,0169,0,551,7,558,930,0,3,1,3,0,1,0,76.14,60.00 ,33.33
03,008,01,008,0170,0,383,3,386,561,0,3,1,3,0,1,0,76.14,68.81 ,33.33
03,008,01,008,0171,0,481,5,486,801,0,3,1,3,0,1,0,76.14,60.67 ,33.33
03,008,01,008,0172,0,467,9,476,905,0,3,1,3,0,1,0,76.14,52.60 ,33.33
03,008,01,008,0173,0,424,2,426,746,0,3,1,3,0,1,0,76.14,57.10 ,33.33
03,008,01,008,0174,0,178,1,179,298,0,3,1,3,0,1,0,76.14,60.07 ,33.33
03,008,01,008,0175,0,1161,20,1181,1880,0,3,1,3,0,1,0,76.14,62.82 ,33.33
03,008,01,008,0176,0,429,6,435,728,0,3,1,3,0,1,0,76.14,59.75 ,33.33
03,008,01,008,0177,0,344,4,348,574,0,3,1,3,0,1,0,76.14,60.63 ,33.33
03,008,01,008,0178,0,618,6,624,984,0,3,1,3,0,1,0,76.14,63.41 ,33.33
03,008,01,008,0179,0,690,13,703,1120,0,3,1,3,0,1,0,76.14,62.77 ,33.33
03,008,01,008,0180,0,564,9,573,966,0,3,1,3,0,1,0,76.14,59.32 ,33.33
03,008,01,008,0181,0,333,4,337,498,0,3,1,3,0,1,0,76.14,67.67 ,33.33
03,008,01,008,0182,0,519,5,524,764,0,3,1,3,0,1,0,76.14,68.59 ,33.33
03,008,01,008,0183,0,375,13,388,609,0,3,1,3,0,1,0,76.14,63.71 ,33.33
03,008,01,008,0184,0,455,7,462,715,0,3,1,3,0,1,0,76.14,64.62 ,33.33
03,008,01,008,0185,0,267,2,269,424,0,3,1,3,0,1,0,76.14,63.44 ,33.33
03,008,01,008,0186,0,391,2,393,599,0,3,1,3,0,1,0,76.14,65.61 ,33.33
03,008,01,009,0187,0,1030,7,1037,1777,0,3,1,3,0,1,0,76.14,58.36 ,33.33
03,008,01,009,0188,0,834,8,842,1518,0,3,1,3,0,1,0,76.14,55.47 ,33.33
03,008,01,009,0189,0,596,4,600,1038,0,3,1,3,0,1,0,76.14,57.80 ,33.33
03,008,01,009,0190,0,654,11,665,1193,0,3,1,3,0,1,0,76.14,55.74 ,33.33
03,008,01,009,0191,0,147,1,148,247,0,3,1,3,0,1,0,76.14,59.92 ,33.33
03,008,01,009,0192,0,287,2,289,539,0,3,1,3,0,1,0,76.14,53.62 ,33.33
03,008,01,009,0193,0,126,1,127,217,0,3,1,3,0,1,0,76.14,58.53 ,33.33
03,008,01,009,0194,0,720,5,725,1230,0,3,1,3,0,1,0,76.14,58.94 ,33.33
03,008,01,009,0195,0,398,1,399,622,0,3,1,3,0,1,0,76.14,64.15 ,33.33
03,008,01,009,0196,0,433,3,436,744,0,3,1,3,0,1,0,76.14,58.60 ,33.33
03,008,01,009,0197,0,562,4,566,975,0,3,1,3,0,1,0,76.14,58.05 ,33.33
03,008,01,009,0198,0,457,4,461,756,0,3,1,3,0,1,0,76.14,60.98 ,33.33
03,008,01,009,0199,0,323,2,325,539,0,3,1,3,0,1,0,76.14,60.30 ,33.33
03,008,01,009,0200,0,508,6,514,1065,0,3,1,3,0,1,0,76.14,48.26 ,33.33
03,008,01,009,0201,0,438,9,447,819,0,3,1,3,0,1,0,76.14,54.58 ,33.33
03,008,01,010,0202,0,1062,8,1070,1735,0,3,1,3,0,1,0,76.14,61.67 ,33.33
03,008,01,010,0203,0,952,18,970,1546,0,3,1,3,0,1,0,76.14,62.74 ,33.33
03,008,01,010,0204,0,511,5,516,821,0,3,1,3,0,1,0,76.14,62.85 ,33.33
03,008,01,010,0205,0,918,13,931,1626,0,3,1,3,0,1,0,76.14,57.26 ,33.33
03,008,01,010,0206,0,476,5,481,783,0,3,1,3,0,1,0,76.14,61.43 ,33.33
03,008,01,010,0207,0,526,11,537,957,0,3,1,3,0,1,0,76.14,56.11 ,33.33
03,008,01,010,0208,0,1226,16,1242,2148,0,3,1,3,0,1,0,76.14,57.82 ,33.33
03,008,01,010,0209,0,1365,17,1382,1996,0,3,1,3,0,1,0,76.14,69.24 ,33.33
03,008,01,010,0210,0,599,3,602,922,0,3,1,3,0,1,0,76.14,65.29 ,33.33
03,008,01,010,0211,0,825,7,832,1246,0,3,1,3,0,1,0,76.14,66.77 ,33.33
03,008,01,010,0212,0,509,7,516,847,0,3,1,3,0,1,0,76.14,60.92 ,33.33
03,008,01,010,0213,0,1104,14,1118,1695,0,3,1,3,0,1,0,76.14,65.96 ,33.33
03,008,01,010,0214,0,1140,13,1153,2023,0,3,1,3,0,1,0,76.14,56.99 ,33.33
03,008,01,011,0215,0,470,10,480,924,0,3,1,3,0,1,0,76.14,51.95 ,33.33
03,008,01,011,0216,0,969,20,989,1750,0,3,1,3,0,1,0,76.14,56.51 ,33.33
03,008,01,011,0217,0,442,7,449,740,0,3,1,3,0,1,0,76.14,60.68 ,33.33
03,008,01,011,0218,0,585,8,593,1030,0,3,1,3,0,1,0,76.14,57.57 ,33.33
03,008,01,011,0219,0,354,1,355,559,0,3,1,3,0,1,0,76.14,63.51 ,33.33
03,008,01,011,0220,0,642,9,651,1085,0,3,1,3,0,1,0,76.14,60.00 ,33.33
03,008,01,011,0221,0,720,8,728,1257,0,3,1,3,0,1,0,76.14,57.92 ,33.33
03,008,01,011,0222,0,701,10,711,1130,0,3,1,3,0,1,0,76.14,62.92 ,33.33
03,008,01,011,0223,0,828,14,842,1346,0,3,1,3,0,1,0,76.14,62.56 ,33.33
03,008,01,011,0224,0,619,4,623,1050,0,3,1,3,0,1,0,76.14,59.33 ,33.33
03,008,01,011,0225,0,609,9,618,1122,0,3,1,3,0,1,0,76.14,55.08 ,33.33
03,008,01,011,0226,0,240,3,243,417,0,3,1,3,0,1,0,76.14,58.27 ,33.33
03,008,01,011,0227,0,285,4,289,415,0,3,1,3,0,1,0,76.14,69.64 ,33.33
03,008,01,011,0228,0,676,7,683,1287,0,3,1,3,0,1,0,76.14,53.07 ,33.33
03,008,01,011,0229,0,219,2,221,366,0,3,1,3,0,1,0,76.14,60.38 ,33.33
03,008,01,011,0230,0,232,6,238,383,0,3,1,3,0,1,0,76.14,62.14 ,33.33
03,008,01,011,0231,0,582,8,590,923,0,3,1,3,0,1,0,76.14,63.92 ,33.33
03,008,01,011,0232,0,368,9,377,636,0,3,1,3,0,1,0,76.14,59.28 ,33.33
03,008,01,011,0233,0,371,3,374,692,0,3,1,3,0,1,0,76.14,54.05 ,33.33
03,008,01,012,0234,0,674,2,676,1146,0,3,1,3,0,1,0,76.14,58.99 ,33.33
03,008,01,012,0235,0,312,3,315,567,0,3,1,3,0,1,0,76.14,55.56 ,33.33
03,008,01,012,0236,0,447,10,457,752,0,3,1,3,0,1,0,76.14,60.77 ,33.33
03,008,01,012,0237,0,207,1,208,330,0,3,1,3,0,1,0,76.14,63.03 ,33.33
03,008,01,012,0238,0,42,0,42,84,0,3,1,3,0,1,0,76.14,50.00 ,33.33
03,008,01,012,0239,0,110,2,112,224,0,3,1,3,0,1,0,76.14,50.00 ,33.33
03,008,01,012,0240,0,144,1,145,287,0,3,1,3,0,1,0,76.14,50.52 ,33.33
03,008,01,012,0241,0,120,0,120,231,0,3,1,3,0,1,0,76.14,51.95 ,33.33
03,008,01,012,0242,0,441,9,450,778,0,3,1,3,0,1,0,76.14,57.84 ,33.33
03,008,01,012,0243,0,818,5,823,1373,0,3,1,3,0,1,0,76.14,59.94 ,33.33
03,008,01,012,0244,0,111,3,114,260,0,3,1,3,0,1,0,76.14,43.85 ,33.33
03,008,01,012,0245,0,12,0,12,18,0,3,1,3,0,1,0,76.14,66.67 ,33.33
03,008,01,012,0246,0,60,2,62,93,0,3,1,3,0,1,0,76.14,66.67 ,33.33
03,008,01,012,0247,0,25,0,25,41,0,3,1,3,0,1,0,76.14,60.98 ,33.33
03,008,01,013,0248,0,299,2,301,536,0,3,1,3,0,1,0,76.14,56.16 ,33.33
03,008,01,013,0249,0,614,13,627,1062,0,3,1,3,0,1,0,76.14,59.04 ,33.33
03,008,01,013,0250,0,63,0,63,89,0,3,1,3,0,1,0,76.14,70.79 ,33.33
03,008,01,013,0251,0,23,1,24,50,0,3,1,3,0,1,0,76.14,48.00 ,33.33
03,008,01,013,0252,0,88,2,90,149,0,3,1,3,0,1,0,76.14,60.40 ,33.33
03,008,01,013,0253,0,15,1,16,27,0,3,1,3,0,1,0,76.14,59.26 ,33.33
03,008,01,013,0254,0,167,4,171,255,0,3,1,3,0,1,0,76.14,67.06 ,33.33
03,008,01,013,0255,0,23,0,23,54,0,3,1,3,0,1,0,76.14,42.59 ,33.33
03,008,01,013,0256,0,36,1,37,88,0,3,1,3,0,1,0,76.14,42.05 ,33.33
03,008,01,013,0257,0,32,0,32,65,0,3,1,3,0,1,0,76.14,49.23 ,33.33
03,008,01,013,0258,0,18,3,21,44,0,3,1,3,0,1,0,76.14,47.73 ,33.33
03,008,01,013,0259,0,44,1,45,85,0,3,1,3,0,1,0,76.14,52.94 ,33.33
03,008,01,013,0260,0,50,5,55,120,0,3,1,3,0,1,0,76.14,45.83 ,33.33
03,008,01,013,0261,0,38,1,39,62,0,3,1,3,0,1,0,76.14,62.90 ,33.33
03,009,01,001,0001,0,708,2,710,978,0,3,1,3,0,1,0,76.14,72.60 ,33.33
03,009,01,001,0002,0,529,4,533,689,0,3,1,3,0,1,0,76.14,77.36 ,33.33
03,009,01,001,0003,0,564,8,572,775,0,3,1,3,0,1,0,76.14,73.81 ,33.33
03,009,01,001,0004,0,496,4,500,655,0,3,1,3,0,1,0,76.14,76.34 ,33.33
03,009,01,001,0005,0,690,13,703,1001,0,3,1,3,0,1,0,76.14,70.23 ,33.33
03,009,01,001,0006,0,1548,27,1575,2236,0,3,1,3,0,1,0,76.14,70.44 ,33.33
03,009,01,001,0007,0,2368,34,2402,3225,0,3,1,3,0,1,0,76.14,74.48 ,33.33
03,009,01,001,0008,0,1899,38,1937,2712,0,3,1,3,0,1,0,76.14,71.42 ,33.33
03,009,01,001,0009,0,3421,65,3486,4972,0,3,1,3,0,1,0,76.14,70.11 ,33.33
03,009,01,001,0010,0,1168,17,1185,1603,0,3,1,3,0,1,0,76.14,73.92 ,33.33
03,009,01,001,0011,0,811,17,828,1157,0,3,1,3,0,1,0,76.14,71.56 ,33.33
03,009,01,001,0012,0,1487,38,1525,2125,0,3,1,3,0,1,0,76.14,71.76 ,33.33
03,009,01,001,0013,0,1212,24,1236,1774,0,3,1,3,0,1,0,76.14,69.67 ,33.33
03,009,01,001,0014,0,1290,24,1314,1822,0,3,1,3,0,1,0,76.14,72.12 ,33.33
03,009,01,001,0015,0,3458,58,3516,4828,0,3,1,3,0,1,0,76.14,72.83 ,33.33
03,009,01,001,0016,0,1950,23,1973,2792,0,3,1,3,0,1,0,76.14,70.67 ,33.33
03,009,01,001,0017,0,1513,29,1542,2072,0,3,1,3,0,1,0,76.14,74.42 ,33.33
03,009,01,001,0018,0,595,11,606,822,0,3,1,3,0,1,0,76.14,73.72 ,33.33
03,009,01,001,0019,0,463,4,467,579,0,3,1,3,0,1,0,76.14,80.66 ,33.33
03,009,01,001,0020,0,1157,20,1177,1539,0,3,1,3,0,1,0,76.14,76.48 ,33.33
03,009,01,001,0021,0,397,7,404,516,0,3,1,3,0,1,0,76.14,78.29 ,33.33
03,009,01,001,0022,0,742,15,757,1061,0,3,1,3,0,1,0,76.14,71.35 ,33.33
03,009,01,001,0023,0,457,12,469,633,0,3,1,3,0,1,0,76.14,74.09 ,33.33
03,009,01,001,0024,0,1207,20,1227,1599,0,3,1,3,0,1,0,76.14,76.74 ,33.33
03,009,01,001,0025,0,2659,56,2715,3660,0,3,1,3,0,1,0,76.14,74.18 ,33.33
03,009,01,001,0026,0,1870,35,1905,2531,0,3,1,3,0,1,0,76.14,75.27 ,33.33
03,009,01,001,0027,0,1029,11,1040,1345,0,3,1,3,0,1,0,76.14,77.32 ,33.33
03,009,01,001,0028,0,2287,53,2340,3225,0,3,1,3,0,1,0,76.14,72.56 ,33.33
03,009,01,001,0029,0,590,12,602,809,0,3,1,3,0,1,0,76.14,74.41 ,33.33
03,009,01,001,0030,0,560,9,569,753,0,3,1,3,0,1,0,76.14,75.56 ,33.33
03,009,01,001,0031,0,1313,37,1350,1758,0,3,1,3,0,1,0,76.14,76.79 ,33.33
03,009,01,001,0032,0,879,22,901,1217,0,3,1,3,0,1,0,76.14,74.03 ,33.33
03,009,01,001,0033,0,1549,39,1588,2078,0,3,1,3,0,1,0,76.14,76.42 ,33.33
03,009,01,001,0034,0,1310,35,1345,1893,0,3,1,3,0,1,0,76.14,71.05 ,33.33
03,009,01,001,0035,0,797,15,812,1071,0,3,1,3,0,1,0,76.14,75.82 ,33.33
03,009,01,002,0036,0,810,19,829,1118,0,3,1,3,0,1,0,76.14,74.15 ,33.33
03,009,01,002,0037,0,2332,40,2372,3425,0,3,1,3,0,1,0,76.14,69.26 ,33.33
03,009,01,002,0038,0,1245,22,1267,1886,0,3,1,3,0,1,0,76.14,67.18 ,33.33
03,009,01,002,0039,0,851,9,860,1198,0,3,1,3,0,1,0,76.14,71.79 ,33.33
03,009,01,002,0040,0,928,15,943,1334,0,3,1,3,0,1,0,76.14,70.69 ,33.33
03,009,01,002,0041,0,927,15,942,1412,0,3,1,3,0,1,0,76.14,66.71 ,33.33
03,009,01,002,0042,0,753,6,759,1053,0,3,1,3,0,1,0,76.14,72.08 ,33.33
03,009,01,002,0043,0,615,6,621,831,0,3,1,3,0,1,0,76.14,74.73 ,33.33
03,009,01,002,0044,0,654,12,666,903,0,3,1,3,0,1,0,76.14,73.75 ,33.33
03,009,01,002,0045,0,675,9,684,890,0,3,1,3,0,1,0,76.14,76.85 ,33.33
03,009,01,002,0046,0,502,5,507,714,0,3,1,3,0,1,0,76.14,71.01 ,33.33
03,009,01,002,0047,0,915,9,924,1180,0,3,1,3,0,1,0,76.14,78.31 ,33.33
03,009,01,002,0048,0,985,13,998,1320,0,3,1,3,0,1,0,76.14,75.61 ,33.33
03,009,01,002,0049,0,689,18,707,971,0,3,1,3,0,1,0,76.14,72.81 ,33.33
03,009,01,002,0050,0,1557,36,1593,2167,0,3,1,3,0,1,0,76.14,73.51 ,33.33
03,009,01,002,0051,0,1409,29,1438,1928,0,3,1,3,0,1,0,76.14,74.59 ,33.33
03,009,01,002,0052,0,2682,54,2736,3853,0,3,1,3,0,1,0,76.14,71.01 ,33.33
03,009,01,002,0053,0,708,10,718,992,0,3,1,3,0,1,0,76.14,72.38 ,33.33
03,009,01,002,0054,0,622,7,629,889,0,3,1,3,0,1,0,76.14,70.75 ,33.33
03,009,01,002,0055,0,669,14,683,922,0,3,1,3,0,1,0,76.14,74.08 ,33.33
03,009,01,002,0056,0,1125,11,1136,1576,0,3,1,3,0,1,0,76.14,72.08 ,33.33
03,009,01,002,0057,0,1080,12,1092,1533,0,3,1,3,0,1,0,76.14,71.23 ,33.33
03,009,01,003,0058,0,1586,25,1611,2302,0,3,1,3,0,1,0,76.14,69.98 ,33.33
03,009,01,003,0059,0,1141,19,1160,1653,0,3,1,3,0,1,0,76.14,70.18 ,33.33
03,009,01,003,0060,0,1669,21,1690,2457,0,3,1,3,0,1,0,76.14,68.78 ,33.33
03,009,01,003,0061,0,1608,21,1629,2459,0,3,1,3,0,1,0,76.14,66.25 ,33.33
03,009,01,003,0062,0,779,11,790,1136,0,3,1,3,0,1,0,76.14,69.54 ,33.33
03,009,01,003,0063,0,1865,30,1895,2782,0,3,1,3,0,1,0,76.14,68.12 ,33.33
03,009,01,003,0064,0,1965,35,2000,2873,0,3,1,3,0,1,0,76.14,69.61 ,33.33
03,009,01,003,0065,0,911,11,922,1241,0,3,1,3,0,1,0,76.14,74.29 ,33.33
03,009,01,003,0066,0,697,9,706,1007,0,3,1,3,0,1,0,76.14,70.11 ,33.33
03,009,01,003,0067,0,800,8,808,1362,0,3,1,3,0,1,0,76.14,59.32 ,33.33
03,009,01,003,0068,0,1056,19,1075,1574,0,3,1,3,0,1,0,76.14,68.30 ,33.33
03,009,01,003,0069,0,1060,11,1071,1514,0,3,1,3,0,1,0,76.14,70.74 ,33.33
03,009,01,003,0070,0,541,12,553,750,0,3,1,3,0,1,0,76.14,73.73 ,33.33
03,009,01,003,0071,0,470,8,478,716,0,3,1,3,0,1,0,76.14,66.76 ,33.33
03,009,01,003,0072,0,1410,20,1430,1964,0,3,1,3,0,1,0,76.14,72.81 ,33.33
03,009,01,003,0073,0,561,9,570,726,0,3,1,3,0,1,0,76.14,78.51 ,33.33
03,009,01,003,0074,0,1048,15,1063,1448,0,3,1,3,0,1,0,76.14,73.41 ,33.33
03,009,01,003,0075,0,992,31,1023,1413,0,3,1,3,0,1,0,76.14,72.40 ,33.33
03,009,01,003,0076,0,1704,28,1732,2613,0,3,1,3,0,1,0,76.14,66.28 ,33.33
03,009,01,003,0077,0,1368,18,1386,2120,0,3,1,3,0,1,0,76.14,65.38 ,33.33
03,009,01,003,0078,0,1409,25,1434,2090,0,3,1,3,0,1,0,76.14,68.61 ,33.33
03,009,01,003,0079,0,730,10,740,1139,0,3,1,3,0,1,0,76.14,64.97 ,33.33
03,009,01,003,0080,0,874,5,879,1192,0,3,1,3,0,1,0,76.14,73.74 ,33.33
03,009,01,003,0081,0,791,11,802,1044,0,3,1,3,0,1,0,76.14,76.82 ,33.33
03,009,01,003,0082,0,1057,11,1068,1400,0,3,1,3,0,1,0,76.14,76.29 ,33.33
03,009,01,003,0083,0,604,8,612,853,0,3,1,3,0,1,0,76.14,71.75 ,33.33
03,009,01,003,0084,0,654,12,666,926,0,3,1,3,0,1,0,76.14,71.92 ,33.33
03,009,01,003,0085,0,508,6,514,740,0,3,1,3,0,1,0,76.14,69.46 ,33.33
03,009,01,003,0086,0,629,6,635,977,0,3,1,3,0,1,0,76.14,64.99 ,33.33
03,009,01,004,0087,0,1047,10,1057,1485,0,3,1,3,0,1,0,76.14,71.18 ,33.33
03,009,01,004,0088,0,905,14,919,1225,0,3,1,3,0,1,0,76.14,75.02 ,33.33
03,009,01,004,0089,0,1136,14,1150,1545,0,3,1,3,0,1,0,76.14,74.43 ,33.33
03,009,01,004,0090,0,1730,19,1749,2527,0,3,1,3,0,1,0,76.14,69.21 ,33.33
03,009,01,004,0091,0,387,2,389,533,0,3,1,3,0,1,0,76.14,72.98 ,33.33
03,009,01,004,0092,0,556,4,560,811,0,3,1,3,0,1,0,76.14,69.05 ,33.33
03,009,01,004,0093,0,494,5,499,711,0,3,1,3,0,1,0,76.14,70.18 ,33.33
03,009,01,004,0094,0,721,7,728,1020,0,3,1,3,0,1,0,76.14,71.37 ,33.33
03,009,01,004,0095,0,1401,12,1413,2033,0,3,1,3,0,1,0,76.14,69.50 ,33.33
03,009,01,004,0096,0,2034,21,2055,2909,0,3,1,3,0,1,0,76.14,70.64 ,33.33
03,009,01,004,0097,0,851,8,859,1172,0,3,1,3,0,1,0,76.14,73.29 ,33.33
03,009,01,004,0098,0,964,8,972,1334,0,3,1,3,0,1,0,76.14,72.86 ,33.33
03,009,01,004,0099,0,1205,15,1220,1738,0,3,1,3,0,1,0,76.14,70.20 ,33.33
03,009,01,004,0100,0,623,4,627,906,0,3,1,3,0,1,0,76.14,69.21 ,33.33
03,009,01,004,0101,0,810,14,824,1168,0,3,1,3,0,1,0,76.14,70.55 ,33.33
03,009,01,004,0102,0,993,16,1009,1414,0,3,1,3,0,1,0,76.14,71.36 ,33.33
03,009,01,004,0103,0,600,8,608,855,0,3,1,3,0,1,0,76.14,71.11 ,33.33
03,009,01,004,0104,0,714,7,721,1003,0,3,1,3,0,1,0,76.14,71.88 ,33.33
03,009,01,004,0105,0,905,7,912,1348,0,3,1,3,0,1,0,76.14,67.66 ,33.33
03,009,01,004,0106,0,490,5,495,709,0,3,1,3,0,1,0,76.14,69.82 ,33.33
03,009,01,004,0107,0,574,5,579,764,0,3,1,3,0,1,0,76.14,75.79 ,33.33
03,009,01,004,0108,0,677,10,687,1016,0,3,1,3,0,1,0,76.14,67.62 ,33.33
03,009,01,004,0109,0,947,9,956,1311,0,3,1,3,0,1,0,76.14,72.92 ,33.33
03,009,01,004,0110,0,636,6,642,951,0,3,1,3,0,1,0,76.14,67.51 ,33.33
03,009,01,004,0111,0,598,8,606,896,0,3,1,3,0,1,0,76.14,67.63 ,33.33
03,009,01,004,0112,0,1062,11,1073,1694,0,3,1,3,0,1,0,76.14,63.34 ,33.33
03,009,01,004,0113,0,986,10,996,1352,0,3,1,3,0,1,0,76.14,73.67 ,33.33
03,009,01,005,0114,0,662,6,668,921,0,3,1,3,0,1,0,76.14,72.53 ,33.33
03,009,01,005,0115,0,765,15,780,1055,0,3,1,3,0,1,0,76.14,73.93 ,33.33
03,009,01,005,0116,0,945,16,961,1327,0,3,1,3,0,1,0,76.14,72.42 ,33.33
03,009,01,005,0117,0,576,10,586,798,0,3,1,3,0,1,0,76.14,73.43 ,33.33
03,009,01,005,0118,0,818,6,824,1116,0,3,1,3,0,1,0,76.14,73.84 ,33.33
03,009,01,005,0119,0,881,26,907,1327,0,3,1,3,0,1,0,76.14,68.35 ,33.33
03,009,01,005,0120,0,744,7,751,1118,0,3,1,3,0,1,0,76.14,67.17 ,33.33
03,009,01,005,0121,0,855,9,864,1449,0,3,1,3,0,1,0,76.14,59.63 ,33.33
03,009,01,005,0122,0,955,11,966,1488,0,3,1,3,0,1,0,76.14,64.92 ,33.33
03,009,01,005,0123,0,1487,20,1507,2249,0,3,1,3,0,1,0,76.14,67.01 ,33.33
03,009,01,005,0124,0,906,12,918,1410,0,3,1,3,0,1,0,76.14,65.11 ,33.33
03,009,01,005,0125,0,500,6,506,809,0,3,1,3,0,1,0,76.14,62.55 ,33.33
03,009,01,005,0126,0,999,9,1008,1699,0,3,1,3,0,1,0,76.14,59.33 ,33.33
03,009,01,005,0127,0,1111,14,1125,1744,0,3,1,3,0,1,0,76.14,64.51 ,33.33
03,009,01,005,0128,0,1021,21,1042,1773,0,3,1,3,0,1,0,76.14,58.77 ,33.33
03,009,01,005,0129,0,639,3,642,986,0,3,1,3,0,1,0,76.14,65.11 ,33.33
03,009,01,005,0130,0,944,10,954,1399,0,3,1,3,0,1,0,76.14,68.19 ,33.33
03,009,01,006,0131,0,593,7,600,881,0,3,1,3,0,1,0,76.14,68.10 ,33.33
03,009,01,006,0132,0,564,9,573,801,0,3,1,3,0,1,0,76.14,71.54 ,33.33
03,009,01,006,0133,0,427,2,429,586,0,3,1,3,0,1,0,76.14,73.21 ,33.33
03,009,01,006,0134,0,723,13,736,1080,0,3,1,3,0,1,0,76.14,68.15 ,33.33
03,009,01,006,0135,0,317,4,321,460,0,3,1,3,0,1,0,76.14,69.78 ,33.33
03,009,01,006,0136,0,344,6,350,482,0,3,1,3,0,1,0,76.14,72.61 ,33.33
03,009,01,006,0137,0,377,7,384,559,0,3,1,3,0,1,0,76.14,68.69 ,33.33
03,009,01,006,0138,0,513,4,517,764,0,3,1,3,0,1,0,76.14,67.67 ,33.33
03,009,01,006,0139,0,422,4,426,595,0,3,1,3,0,1,0,76.14,71.60 ,33.33
03,009,01,006,0140,0,293,5,298,453,0,3,1,3,0,1,0,76.14,65.78 ,33.33
03,009,01,006,0141,0,484,14,498,704,0,3,1,3,0,1,0,76.14,70.74 ,33.33
03,009,01,006,0142,0,890,10,900,1383,0,3,1,3,0,1,0,76.14,65.08 ,33.33
03,009,01,006,0143,0,353,1,354,534,0,3,1,3,0,1,0,76.14,66.29 ,33.33
03,009,01,006,0144,0,3164,49,3213,4835,0,3,1,3,0,1,0,76.14,66.45 ,33.33
03,009,01,006,0145,0,805,9,814,1208,0,3,1,3,0,1,0,76.14,67.38 ,33.33
03,009,01,006,0146,0,2826,45,2871,4208,0,3,1,3,0,1,0,76.14,68.23 ,33.33
03,009,01,006,0147,0,703,14,717,1127,0,3,1,3,0,1,0,76.14,63.62 ,33.33
03,009,01,006,0148,0,551,6,557,972,0,3,1,3,0,1,0,76.14,57.30 ,33.33
03,009,01,006,0149,0,265,2,267,403,0,3,1,3,0,1,0,76.14,66.25 ,33.33
03,009,01,006,0150,0,511,2,513,868,0,3,1,3,0,1,0,76.14,59.10 ,33.33
03,009,01,006,0151,0,879,20,899,1399,0,3,1,3,0,1,0,76.14,64.26 ,33.33
03,009,01,006,0152,0,696,11,707,1272,0,3,1,3,0,1,0,76.14,55.58 ,33.33
03,009,01,006,0153,0,684,12,696,1137,0,3,1,3,0,1,0,76.14,61.21 ,33.33
03,009,01,006,0154,0,380,7,387,711,0,3,1,3,0,1,0,76.14,54.43 ,33.33
03,009,01,006,0155,0,1080,25,1105,1602,0,3,1,3,0,1,0,76.14,68.98 ,33.33
03,009,01,006,0156,0,1575,29,1604,2567,0,3,1,3,0,1,0,76.14,62.49 ,33.33
03,009,01,006,0157,0,636,12,648,1090,0,3,1,3,0,1,0,76.14,59.45 ,33.33
03,009,01,006,0158,0,365,4,369,600,0,3,1,3,0,1,0,76.14,61.50 ,33.33
03,009,01,007,0159,0,1420,21,1441,2075,0,3,1,3,0,1,0,76.14,69.45 ,33.33
03,009,01,007,0160,0,1019,14,1033,1564,0,3,1,3,0,1,0,76.14,66.05 ,33.33
03,009,01,007,0161,0,1695,28,1723,2430,0,3,1,3,0,1,0,76.14,70.91 ,33.33
03,009,01,007,0162,0,1009,19,1028,1405,0,3,1,3,0,1,0,76.14,73.17 ,33.33
03,009,01,007,0163,0,827,13,840,1105,0,3,1,3,0,1,0,76.14,76.02 ,33.33
03,009,01,007,0164,0,935,12,947,1237,0,3,1,3,0,1,0,76.14,76.56 ,33.33
03,009,01,007,0165,0,639,9,648,848,0,3,1,3,0,1,0,76.14,76.42 ,33.33
03,009,01,007,0166,0,1434,20,1454,1970,0,3,1,3,0,1,0,76.14,73.81 ,33.33
03,009,01,007,0167,0,1295,18,1313,1822,0,3,1,3,0,1,0,76.14,72.06 ,33.33
03,009,01,007,0168,0,978,8,986,1387,0,3,1,3,0,1,0,76.14,71.09 ,33.33
03,009,01,007,0169,0,561,3,564,726,0,3,1,3,0,1,0,76.14,77.69 ,33.33
03,009,01,007,0170,0,1374,11,1385,1863,0,3,1,3,0,1,0,76.14,74.34 ,33.33
03,009,01,007,0171,0,1414,26,1440,1979,0,3,1,3,0,1,0,76.14,72.76 ,33.33
03,009,01,007,0172,0,517,5,522,662,0,3,1,3,0,1,0,76.14,78.85 ,33.33
03,009,01,007,0173,0,979,15,994,1340,0,3,1,3,0,1,0,76.14,74.18 ,33.33
03,009,01,007,0174,0,267,3,270,339,0,3,1,3,0,1,0,76.14,79.65 ,33.33
03,009,01,007,0175,0,674,8,682,1050,0,3,1,3,0,1,0,76.14,64.95 ,33.33
03,009,01,007,0176,0,635,6,641,960,0,3,1,3,0,1,0,76.14,66.77 ,33.33
03,009,01,007,0177,0,385,1,386,571,0,3,1,3,0,1,0,76.14,67.60 ,33.33
03,009,01,007,0178,0,520,3,523,715,0,3,1,3,0,1,0,76.14,73.15 ,33.33
03,009,01,008,0179,0,543,11,554,825,0,3,1,3,0,1,0,76.14,67.15 ,33.33
03,009,01,008,0180,0,1391,21,1412,1972,0,3,1,3,0,1,0,76.14,71.60 ,33.33
03,009,01,008,0181,0,739,14,753,1134,0,3,1,3,0,1,0,76.14,66.40 ,33.33
03,009,01,008,0182,0,745,8,753,1095,0,3,1,3,0,1,0,76.14,68.77 ,33.33
03,009,01,008,0183,0,1134,15,1149,1754,0,3,1,3,0,1,0,76.14,65.51 ,33.33
03,009,01,008,0184,0,1299,18,1317,1760,0,3,1,3,0,1,0,76.14,74.83 ,33.33
03,009,01,008,0185,0,719,15,734,1048,0,3,1,3,0,1,0,76.14,70.04 ,33.33
03,009,01,008,0186,0,862,11,873,1267,0,3,1,3,0,1,0,76.14,68.90 ,33.33
03,009,01,008,0187,0,523,7,530,834,0,3,1,3,0,1,0,76.14,63.55 ,33.33
03,009,01,008,0188,0,525,6,531,759,0,3,1,3,0,1,0,76.14,69.96 ,33.33
03,009,01,008,0189,0,846,17,863,1239,0,3,1,3,0,1,0,76.14,69.65 ,33.33
03,009,01,008,0190,0,598,3,601,844,0,3,1,3,0,1,0,76.14,71.21 ,33.33
03,009,01,008,0191,0,466,6,472,733,0,3,1,3,0,1,0,76.14,64.39 ,33.33
03,009,01,008,0192,0,556,8,564,870,0,3,1,3,0,1,0,76.14,64.83 ,33.33
03,009,01,008,0193,0,612,5,617,906,0,3,1,3,0,1,0,76.14,68.10 ,33.33
03,009,01,009,0194,0,2131,36,2167,2953,0,3,1,3,0,1,0,76.14,73.38 ,33.33
03,009,01,009,0195,0,680,10,690,919,0,3,1,3,0,1,0,76.14,75.08 ,33.33
03,009,01,009,0196,0,1000,11,1011,1513,0,3,1,3,0,1,0,76.14,66.82 ,33.33
03,009,01,009,0197,0,893,18,911,1334,0,3,1,3,0,1,0,76.14,68.29 ,33.33
03,009,01,009,0198,0,772,11,783,1112,0,3,1,3,0,1,0,76.14,70.41 ,33.33
03,009,01,009,0199,0,1105,21,1126,1626,0,3,1,3,0,1,0,76.14,69.25 ,33.33
03,009,01,009,0200,0,1450,22,1472,2028,0,3,1,3,0,1,0,76.14,72.58 ,33.33
03,009,01,009,0201,0,839,10,849,1119,0,3,1,3,0,1,0,76.14,75.87 ,33.33
03,009,01,009,0202,0,1224,23,1247,1774,0,3,1,3,0,1,0,76.14,70.29 ,33.33
03,009,01,009,0203,0,826,19,845,1124,0,3,1,3,0,1,0,76.14,75.18 ,33.33
03,009,01,009,0204,0,1070,20,1090,1622,0,3,1,3,0,1,0,76.14,67.20 ,33.33
03,009,01,009,0205,0,1032,14,1046,1502,0,3,1,3,0,1,0,76.14,69.64 ,33.33
03,009,01,009,0206,0,808,20,828,1260,0,3,1,3,0,1,0,76.14,65.71 ,33.33
03,009,01,009,0207,0,1066,13,1079,1565,0,3,1,3,0,1,0,76.14,68.95 ,33.33
03,009,01,010,0208,0,777,10,787,1012,0,3,1,3,0,1,0,76.14,77.77 ,33.33
03,009,01,010,0209,0,2184,42,2226,2957,0,3,1,3,0,1,0,76.14,75.28 ,33.33
03,009,01,010,0210,0,1412,36,1448,2047,0,3,1,3,0,1,0,76.14,70.74 ,33.33
03,009,01,010,0211,0,506,4,510,657,0,3,1,3,0,1,0,76.14,77.63 ,33.33
03,009,01,010,0212,0,708,26,734,999,0,3,1,3,0,1,0,76.14,73.47 ,33.33
03,009,01,010,0213,0,1727,40,1767,2392,0,3,1,3,0,1,0,76.14,73.87 ,33.33
03,009,01,010,0214,0,407,13,420,609,0,3,1,3,0,1,0,76.14,68.97 ,33.33
03,009,01,010,0215,0,1630,23,1653,2195,0,3,1,3,0,1,0,76.14,75.31 ,33.33
03,009,01,010,0216,0,1155,25,1180,1628,0,3,1,3,0,1,0,76.14,72.48 ,33.33
03,009,01,011,0217,0,879,8,887,1335,0,3,1,3,0,1,0,76.14,66.44 ,33.33
03,009,01,011,0218,0,1001,10,1011,1520,0,3,1,3,0,1,0,76.14,66.51 ,33.33
03,009,01,011,0219,0,1194,10,1204,1840,0,3,1,3,0,1,0,76.14,65.43 ,33.33
03,009,01,011,0220,0,1134,20,1154,1762,0,3,1,3,0,1,0,76.14,65.49 ,33.33
03,009,01,011,0221,0,828,13,841,1221,0,3,1,3,0,1,0,76.14,68.88 ,33.33
03,009,01,011,0222,0,1301,15,1316,1903,0,3,1,3,0,1,0,76.14,69.15 ,33.33
03,009,01,011,0223,0,606,12,618,946,0,3,1,3,0,1,0,76.14,65.33 ,33.33
03,009,01,011,0224,0,863,10,873,1258,0,3,1,3,0,1,0,76.14,69.40 ,33.33
03,009,01,011,0225,0,634,5,639,949,0,3,1,3,0,1,0,76.14,67.33 ,33.33
03,009,01,011,0226,0,479,4,483,796,0,3,1,3,0,1,0,76.14,60.68 ,33.33
03,009,01,011,0227,0,998,9,1007,1449,0,3,1,3,0,1,0,76.14,69.50 ,33.33
03,009,01,011,0228,0,1248,12,1260,1978,0,3,1,3,0,1,0,76.14,63.70 ,33.33
03,009,01,011,0229,0,571,9,580,907,0,3,1,3,0,1,0,76.14,63.95 ,33.33
03,009,01,011,0230,0,1187,13,1200,1762,0,3,1,3,0,1,0,76.14,68.10 ,33.33
03,009,01,011,0231,0,897,14,911,1435,0,3,1,3,0,1,0,76.14,63.48 ,33.33
03,009,01,011,0232,0,602,5,607,1031,0,3,1,3,0,1,0,76.14,58.87 ,33.33
03,009,01,011,0233,0,571,8,579,810,0,3,1,3,0,1,0,76.14,71.48 ,33.33
03,009,01,011,0234,0,699,8,707,1015,0,3,1,3,0,1,0,76.14,69.66 ,33.33
03,009,01,012,0235,0,926,17,943,1286,0,3,1,3,0,1,0,76.14,73.33 ,33.33
03,009,01,012,0236,0,924,17,941,1235,0,3,1,3,0,1,0,76.14,76.19 ,33.33
03,009,01,012,0237,0,1545,19,1564,2066,0,3,1,3,0,1,0,76.14,75.70 ,33.33
03,009,01,012,0238,0,1227,17,1244,1875,0,3,1,3,0,1,0,76.14,66.35 ,33.33
03,009,01,012,0239,0,1169,14,1183,1786,0,3,1,3,0,1,0,76.14,66.24 ,33.33
03,009,01,012,0240,0,834,11,845,1318,0,3,1,3,0,1,0,76.14,64.11 ,33.33
03,009,01,012,0241,0,1242,13,1255,1852,0,3,1,3,0,1,0,76.14,67.76 ,33.33
03,009,01,012,0242,0,554,3,557,876,0,3,1,3,0,1,0,76.14,63.58 ,33.33
03,009,01,012,0243,0,1131,21,1152,1730,0,3,1,3,0,1,0,76.14,66.59 ,33.33
03,009,01,012,0244,0,1178,20,1198,2011,0,3,1,3,0,1,0,76.14,59.57 ,33.33
03,009,01,012,0245,0,949,20,969,1402,0,3,1,3,0,1,0,76.14,69.12 ,33.33
03,009,01,012,0246,0,767,12,779,1165,0,3,1,3,0,1,0,76.14,66.87 ,33.33
03,009,01,012,0247,0,809,12,821,1248,0,3,1,3,0,1,0,76.14,65.79 ,33.33
03,009,01,012,0248,0,633,7,640,898,0,3,1,3,0,1,0,76.14,71.27 ,33.33
03,009,01,013,0249,0,1786,21,1807,2733,0,3,1,3,0,1,0,76.14,66.12 ,33.33
03,009,01,013,0250,0,1431,19,1450,2278,0,3,1,3,0,1,0,76.14,63.65 ,33.33
03,009,01,013,0251,0,775,8,783,1308,0,3,1,3,0,1,0,76.14,59.86 ,33.33
03,009,01,013,0252,0,1075,7,1082,1832,0,3,1,3,0,1,0,76.14,59.06 ,33.33
03,009,01,013,0253,0,856,8,864,1330,0,3,1,3,0,1,0,76.14,64.96 ,33.33
03,009,01,013,0254,0,1220,15,1235,1868,0,3,1,3,0,1,0,76.14,66.11 ,33.33
03,009,01,013,0255,0,1187,20,1207,1953,0,3,1,3,0,1,0,76.14,61.80 ,33.33
03,009,01,013,0256,0,1058,25,1083,1800,0,3,1,3,0,1,0,76.14,60.17 ,33.33
03,009,01,013,0257,0,1540,26,1566,2350,0,3,1,3,0,1,0,76.14,66.64 ,33.33
03,009,01,013,0258,0,460,7,467,757,0,3,1,3,0,1,0,76.14,61.69 ,33.33
03,009,01,013,0259,0,1306,17,1323,2001,0,3,1,3,0,1,0,76.14,66.12 ,33.33
03,009,01,013,0260,0,774,23,797,1363,0,3,1,3,0,1,0,76.14,58.47 ,33.33
03,009,01,014,0261,0,712,13,725,1350,0,3,1,3,0,1,0,76.14,53.70 ,33.33
03,009,01,014,0262,0,292,2,294,456,0,3,1,3,0,1,0,76.14,64.47 ,33.33
03,009,01,014,0263,0,992,15,1007,1765,0,3,1,3,0,1,0,76.14,57.05 ,33.33
03,009,01,014,0264,0,864,11,875,1410,0,3,1,3,0,1,0,76.14,62.06 ,33.33
03,009,01,014,0265,0,698,4,702,1143,0,3,1,3,0,1,0,76.14,61.42 ,33.33
03,009,01,014,0266,0,563,7,570,963,0,3,1,3,0,1,0,76.14,59.19 ,33.33
03,009,01,014,0267,0,1272,24,1296,2085,0,3,1,3,0,1,0,76.14,62.16 ,33.33
03,009,01,014,0268,0,872,8,880,1261,0,3,1,3,0,1,0,76.14,69.79 ,33.33
03,009,01,014,0269,0,661,5,666,1212,0,3,1,3,0,1,0,76.14,54.95 ,33.33
03,009,01,014,0270,0,550,8,558,975,0,3,1,3,0,1,0,76.14,57.23 ,33.33
03,009,01,014,0271,0,581,4,585,1036,0,3,1,3,0,1,0,76.14,56.47 ,33.33
03,009,01,014,0272,0,352,6,358,579,0,3,1,3,0,1,0,76.14,61.83 ,33.33
03,009,01,015,0273,0,1197,14,1211,1688,0,3,1,3,0,1,0,76.14,71.74 ,33.33
03,009,01,015,0274,0,853,6,859,1275,0,3,1,3,0,1,0,76.14,67.37 ,33.33
03,009,01,015,0275,0,871,12,883,1274,0,3,1,3,0,1,0,76.14,69.31 ,33.33
03,009,01,015,0276,0,834,11,845,1315,0,3,1,3,0,1,0,76.14,64.26 ,33.33
03,009,01,015,0277,0,811,12,823,1252,0,3,1,3,0,1,0,76.14,65.73 ,33.33
03,009,01,015,0278,0,549,8,557,891,0,3,1,3,0,1,0,76.14,62.51 ,33.33
03,009,01,015,0279,0,572,13,585,858,0,3,1,3,0,1,0,76.14,68.18 ,33.33
03,009,01,015,0280,0,760,10,770,1241,0,3,1,3,0,1,0,76.14,62.05 ,33.33
03,009,01,015,0281,0,583,6,589,973,0,3,1,3,0,1,0,76.14,60.53 ,33.33
03,009,01,016,0282,0,969,12,981,1347,0,3,1,3,0,1,0,76.14,72.83 ,33.33
03,009,01,016,0283,0,655,11,666,985,0,3,1,3,0,1,0,76.14,67.61 ,33.33
03,009,01,016,0284,0,717,11,728,964,0,3,1,3,0,1,0,76.14,75.52 ,33.33
03,009,01,016,0285,0,1341,25,1366,1822,0,3,1,3,0,1,0,76.14,74.97 ,33.33
03,009,01,016,0286,0,673,9,682,968,0,3,1,3,0,1,0,76.14,70.45 ,33.33
03,009,01,016,0287,0,803,15,818,1557,0,3,1,3,0,1,0,76.14,52.54 ,33.33
03,009,01,016,0288,0,1246,22,1268,2113,0,3,1,3,0,1,0,76.14,60.01 ,33.33
03,009,01,016,0289,0,394,7,401,621,0,3,1,3,0,1,0,76.14,64.57 ,33.33
03,009,01,016,0290,0,351,2,353,578,0,3,1,3,0,1,0,76.14,61.07 ,33.33
03,009,01,016,0291,0,516,14,530,696,0,3,1,3,0,1,0,76.14,76.15 ,33.33
03,009,01,016,0292,0,1372,9,1381,1788,0,3,1,3,0,1,0,76.14,77.24 ,33.33
03,009,01,016,0293,0,1133,12,1145,1539,0,3,1,3,0,1,0,76.14,74.40 ,33.33
03,009,01,016,0294,0,1039,16,1055,1390,0,3,1,3,0,1,0,76.14,75.90 ,33.33
03,009,01,016,0295,0,2254,28,2282,3229,0,3,1,3,0,1,0,76.14,70.67 ,33.33
03,009,01,016,0296,0,1513,12,1525,1924,0,3,1,3,0,1,0,76.14,79.26 ,33.33
03,009,01,017,0297,0,1794,19,1813,2890,0,3,1,3,0,1,0,76.14,62.73 ,33.33
03,009,01,017,0298,0,927,11,938,1584,0,3,1,3,0,1,0,76.14,59.22 ,33.33
03,009,01,017,0299,0,831,6,837,1449,0,3,1,3,0,1,0,76.14,57.76 ,33.33
03,009,01,017,0300,0,482,4,486,765,0,3,1,3,0,1,0,76.14,63.53 ,33.33
03,009,01,017,0301,0,678,5,683,1032,0,3,1,3,0,1,0,76.14,66.18 ,33.33
03,009,01,017,0302,0,646,3,649,1165,0,3,1,3,0,1,0,76.14,55.71 ,33.33
03,009,01,017,0303,0,584,5,589,1059,0,3,1,3,0,1,0,76.14,55.62 ,33.33
03,009,01,017,0304,0,524,6,530,1005,0,3,1,3,0,1,0,76.14,52.74 ,33.33
03,009,01,017,0305,0,434,2,436,720,0,3,1,3,0,1,0,76.14,60.56 ,33.33
03,009,01,017,0306,0,456,3,459,832,0,3,1,3,0,1,0,76.14,55.17 ,33.33
03,009,01,017,0307,0,280,4,284,483,0,3,1,3,0,1,0,76.14,58.80 ,33.33
03,009,01,017,0308,0,688,7,695,1236,0,3,1,3,0,1,0,76.14,56.23 ,33.33
03,009,01,017,0309,0,801,7,808,1491,0,3,1,3,0,1,0,76.14,54.19 ,33.33
03,009,01,017,0310,0,664,5,669,1147,0,3,1,3,0,1,0,76.14,58.33 ,33.33
03,009,01,017,0311,0,519,10,529,931,0,3,1,3,0,1,0,76.14,56.82 ,33.33
03,009,01,017,0312,0,892,7,899,1381,0,3,1,3,0,1,0,76.14,65.10 ,33.33
03,009,01,017,0313,0,630,3,633,1067,0,3,1,3,0,1,0,76.14,59.33 ,33.33
03,009,01,017,0314,0,1040,13,1053,1714,0,3,1,3,0,1,0,76.14,61.44 ,33.33
03,009,01,017,0315,0,433,3,436,741,0,3,1,3,0,1,0,76.14,58.84 ,33.33
03,009,01,017,0316,0,586,11,597,994,0,3,1,3,0,1,0,76.14,60.06 ,33.33
03,009,01,017,0317,0,487,3,490,747,0,3,1,3,0,1,0,76.14,65.60 ,33.33
03,009,01,018,0318,0,937,9,946,1691,0,3,1,3,0,1,0,76.14,55.94 ,33.33
03,009,01,018,0319,0,1232,17,1249,2092,0,3,1,3,0,1,0,76.14,59.70 ,33.33
03,009,01,018,0320,0,425,7,432,777,0,3,1,3,0,1,0,76.14,55.60 ,33.33
03,009,01,018,0321,0,706,10,716,1225,0,3,1,3,0,1,0,76.14,58.45 ,33.33
03,009,01,018,0322,0,572,5,577,1176,0,3,1,3,0,1,0,76.14,49.06 ,33.33
03,009,01,018,0323,0,562,4,566,1042,0,3,1,3,0,1,0,76.14,54.32 ,33.33
03,009,01,018,0324,0,418,6,424,917,0,3,1,3,0,1,0,76.14,46.24 ,33.33
03,009,01,018,0325,0,625,8,633,1330,0,3,1,3,0,1,0,76.14,47.59 ,33.33
03,009,01,018,0326,0,583,10,593,1148,0,3,1,3,0,1,0,76.14,51.66 ,33.33
03,009,01,018,0327,0,396,7,403,1009,0,3,1,3,0,1,0,76.14,39.94 ,33.33
03,009,01,018,0328,0,474,3,477,705,0,3,1,3,0,1,0,76.14,67.66 ,33.33
03,009,01,018,0329,0,848,12,860,1060,0,3,1,3,0,1,0,76.14,81.13 ,33.33
03,009,01,018,0330,0,222,5,227,421,0,3,1,3,0,1,0,76.14,53.92 ,33.33
03,009,01,018,0331,0,959,15,974,1796,0,3,1,3,0,1,0,76.14,54.23 ,33.33
03,009,01,018,0332,0,489,10,499,983,0,3,1,3,0,1,0,76.14,50.76 ,33.33
03,009,01,018,0333,0,454,6,460,784,0,3,1,3,0,1,0,76.14,58.67 ,33.33
03,009,01,018,0334,0,670,8,678,1050,0,3,1,3,0,1,0,76.14,64.57 ,33.33
03,009,01,018,0335,0,726,11,737,1177,0,3,1,3,0,1,0,76.14,62.62 ,33.33
03,009,01,018,0336,0,634,10,644,1347,0,3,1,3,0,1,0,76.14,47.81 ,33.33
03,009,01,018,0337,0,516,9,525,1129,0,3,1,3,0,1,0,76.14,46.50 ,33.33
03,009,01,018,0338,0,414,6,420,917,0,3,1,3,0,1,0,76.14,45.80 ,33.33
03,009,01,019,0339,0,602,4,606,942,0,3,1,3,0,1,0,76.14,64.33 ,33.33
03,009,01,019,0340,0,785,16,801,1252,0,3,1,3,0,1,0,76.14,63.98 ,33.33
03,009,01,019,0341,0,491,5,496,779,0,3,1,3,0,1,0,76.14,63.67 ,33.33
03,009,01,019,0342,0,408,2,410,651,0,3,1,3,0,1,0,76.14,62.98 ,33.33
03,009,01,019,0343,0,481,8,489,957,0,3,1,3,0,1,0,76.14,51.10 ,33.33
03,009,01,019,0344,0,562,8,570,939,0,3,1,3,0,1,0,76.14,60.70 ,33.33
03,009,01,019,0345,0,878,14,892,1419,0,3,1,3,0,1,0,76.14,62.86 ,33.33
03,009,01,019,0346,0,988,20,1008,1960,0,3,1,3,0,1,0,76.14,51.43 ,33.33
03,009,01,019,0347,0,970,17,987,1761,0,3,1,3,0,1,0,76.14,56.05 ,33.33
03,009,01,019,0348,0,861,11,872,1500,0,3,1,3,0,1,0,76.14,58.13 ,33.33
03,009,01,019,0349,0,338,1,339,556,0,3,1,3,0,1,0,76.14,60.97 ,33.33
03,009,01,019,0350,0,899,10,909,1344,0,3,1,3,0,1,0,76.14,67.63 ,33.33
03,009,01,019,0351,0,520,8,528,780,0,3,1,3,0,1,0,76.14,67.69 ,33.33
03,009,01,019,0352,0,965,11,976,1492,0,3,1,3,0,1,0,76.14,65.42 ,33.33
03,009,01,019,0353,0,697,12,709,1042,0,3,1,3,0,1,0,76.14,68.04 ,33.33
03,009,01,019,0354,0,1081,12,1093,1835,0,3,1,3,0,1,0,76.14,59.56 ,33.33
03,009,01,019,0355,0,743,6,749,1344,0,3,1,3,0,1,0,76.14,55.73 ,33.33
03,009,01,019,0356,0,627,4,631,1058,0,3,1,3,0,1,0,76.14,59.64 ,33.33
03,009,01,019,0357,0,464,3,467,808,0,3,1,3,0,1,0,76.14,57.80 ,33.33
03,009,01,019,0358,0,560,8,568,993,0,3,1,3,0,1,0,76.14,57.20 ,33.33
03,009,01,019,0359,0,471,4,475,747,0,3,1,3,0,1,0,76.14,63.59 ,33.33
03,009,01,020,0360,0,1388,29,1417,2148,0,3,1,3,0,1,0,76.14,65.97 ,33.33
03,009,01,020,0361,0,1220,22,1242,1770,0,3,1,3,0,1,0,76.14,70.17 ,33.33
03,009,01,020,0362,0,497,9,506,818,0,3,1,3,0,1,0,76.14,61.86 ,33.33
03,009,01,020,0363,0,460,6,466,728,0,3,1,3,0,1,0,76.14,64.01 ,33.33
03,009,01,020,0364,0,737,12,749,1109,0,3,1,3,0,1,0,76.14,67.54 ,33.33
03,009,01,020,0365,0,490,16,506,935,0,3,1,3,0,1,0,76.14,54.12 ,33.33
03,009,01,020,0366,0,802,8,810,1248,0,3,1,3,0,1,0,76.14,64.90 ,33.33
03,009,01,020,0367,0,519,15,534,851,0,3,1,3,0,1,0,76.14,62.75 ,33.33
03,009,01,020,0368,0,628,5,633,1130,0,3,1,3,0,1,0,76.14,56.02 ,33.33
03,009,01,020,0369,0,425,7,432,719,0,3,1,3,0,1,0,76.14,60.08 ,33.33
03,009,01,020,0370,0,409,6,415,722,0,3,1,3,0,1,0,76.14,57.48 ,33.33
03,009,01,020,0371,0,741,11,752,1310,0,3,1,3,0,1,0,76.14,57.40 ,33.33
03,009,01,020,0372,0,443,3,446,801,0,3,1,3,0,1,0,76.14,55.68 ,33.33
03,009,01,020,0373,0,627,8,635,1121,0,3,1,3,0,1,0,76.14,56.65 ,33.33
03,009,01,020,0374,0,598,5,603,1089,0,3,1,3,0,1,0,76.14,55.37 ,33.33
03,009,01,020,0375,0,555,11,566,918,0,3,1,3,0,1,0,76.14,61.66 ,33.33
03,009,01,020,0376,0,764,11,775,1256,0,3,1,3,0,1,0,76.14,61.70 ,33.33
03,009,01,020,0377,0,387,3,390,668,0,3,1,3,0,1,0,76.14,58.38 ,33.33
03,009,01,020,0378,0,500,12,512,915,0,3,1,3,0,1,0,76.14,55.96 ,33.33
03,009,01,020,0379,0,532,6,538,916,0,3,1,3,0,1,0,76.14,58.73 ,33.33
03,009,01,020,0380,0,494,7,501,834,0,3,1,3,0,1,0,76.14,60.07 ,33.33
03,009,01,020,0381,0,727,9,736,1118,0,3,1,3,0,1,0,76.14,65.83 ,33.33
03,009,01,020,0382,0,856,8,864,1300,0,3,1,3,0,1,0,76.14,66.46 ,33.33
03,009,01,020,0383,0,531,7,538,840,0,3,1,3,0,1,0,76.14,64.05 ,33.33
03,010,01,001,0001,0,898,15,913,1478,0,3,1,3,0,1,0,76.14,61.77 ,33.33
03,010,01,001,0002,0,287,3,290,438,0,3,1,3,0,1,0,76.14,66.21 ,33.33
03,010,01,001,0003,0,832,8,840,1354,0,3,1,3,0,1,0,76.14,62.04 ,33.33
03,010,01,001,0004,0,811,10,821,1362,0,3,1,3,0,1,0,76.14,60.28 ,33.33
03,010,01,001,0005,0,740,12,752,1058,0,3,1,3,0,1,0,76.14,71.08 ,33.33
03,010,01,001,0006,0,438,5,443,752,0,3,1,3,0,1,0,76.14,58.91 ,33.33
03,010,01,001,0007,0,523,10,533,772,0,3,1,3,0,1,0,76.14,69.04 ,33.33
03,010,01,001,0008,0,438,3,441,669,0,3,1,3,0,1,0,76.14,65.92 ,33.33
03,010,01,001,0009,0,520,5,525,856,0,3,1,3,0,1,0,76.14,61.33 ,33.33
03,010,01,001,0010,0,658,14,672,1169,0,3,1,3,0,1,0,76.14,57.49 ,33.33
03,010,01,001,0011,0,478,5,483,904,0,3,1,3,0,1,0,76.14,53.43 ,33.33
03,010,01,001,0012,0,449,11,460,729,0,3,1,3,0,1,0,76.14,63.10 ,33.33
03,010,01,001,0013,0,364,7,371,584,0,3,1,3,0,1,0,76.14,63.53 ,33.33
03,010,01,001,0014,0,871,12,883,1532,0,3,1,3,0,1,0,76.14,57.64 ,33.33
03,010,01,001,0015,0,1186,30,1216,2068,0,3,1,3,0,1,0,76.14,58.80 ,33.33
03,010,01,001,0016,0,852,13,865,1597,0,3,1,3,0,1,0,76.14,54.16 ,33.33
03,010,01,001,0017,0,1002,18,1020,1891,0,3,1,3,0,1,0,76.14,53.94 ,33.33
03,010,01,001,0018,0,404,9,413,724,0,3,1,3,0,1,0,76.14,57.04 ,33.33
03,010,01,002,0019,0,1059,13,1072,1810,0,3,1,3,0,1,0,76.14,59.23 ,33.33
03,010,01,002,0020,0,1023,10,1033,1718,0,3,1,3,0,1,0,76.14,60.13 ,33.33
03,010,01,002,0021,0,726,6,732,1142,0,3,1,3,0,1,0,76.14,64.10 ,33.33
03,010,01,002,0022,0,353,1,354,562,0,3,1,3,0,1,0,76.14,62.99 ,33.33
03,010,01,002,0023,0,435,9,444,782,0,3,1,3,0,1,0,76.14,56.78 ,33.33
03,010,01,002,0024,0,490,5,495,746,0,3,1,3,0,1,0,76.14,66.35 ,33.33
03,010,01,002,0025,0,514,7,521,791,0,3,1,3,0,1,0,76.14,65.87 ,33.33
03,010,01,002,0026,0,1119,8,1127,1881,0,3,1,3,0,1,0,76.14,59.91 ,33.33
03,010,01,002,0027,0,1396,24,1420,2254,0,3,1,3,0,1,0,76.14,63.00 ,33.33
03,010,01,002,0028,0,1889,26,1915,3099,0,3,1,3,0,1,0,76.14,61.79 ,33.33
03,010,01,002,0029,0,395,9,404,600,0,3,1,3,0,1,0,76.14,67.33 ,33.33
03,010,01,002,0030,0,498,1,499,776,0,3,1,3,0,1,0,76.14,64.30 ,33.33
03,010,01,002,0031,0,520,3,523,806,0,3,1,3,0,1,0,76.14,64.89 ,33.33
03,010,01,002,0032,0,621,5,626,955,0,3,1,3,0,1,0,76.14,65.55 ,33.33
03,010,01,002,0033,0,260,8,268,428,0,3,1,3,0,1,0,76.14,62.62 ,33.33
03,010,01,002,0034,0,1538,32,1570,2427,0,3,1,3,0,1,0,76.14,64.69 ,33.33
03,010,01,002,0035,0,944,24,968,1494,0,3,1,3,0,1,0,76.14,64.79 ,33.33
03,010,01,002,0036,0,359,5,364,559,0,3,1,3,0,1,0,76.14,65.12 ,33.33
03,010,01,002,0037,0,505,7,512,921,0,3,1,3,0,1,0,76.14,55.59 ,33.33
03,010,01,002,0038,0,586,8,594,1005,0,3,1,3,0,1,0,76.14,59.10 ,33.33
03,010,01,002,0039,0,516,10,526,911,0,3,1,3,0,1,0,76.14,57.74 ,33.33
03,010,01,002,0040,0,202,1,203,308,0,3,1,3,0,1,0,76.14,65.91 ,33.33
03,010,01,002,0041,0,462,9,471,811,0,3,1,3,0,1,0,76.14,58.08 ,33.33
03,010,01,002,0042,0,366,3,369,569,0,3,1,3,0,1,0,76.14,64.85 ,33.33
03,010,01,002,0043,0,715,9,724,1204,0,3,1,3,0,1,0,76.14,60.13 ,33.33
03,010,01,002,0044,0,830,12,842,1517,0,3,1,3,0,1,0,76.14,55.50 ,33.33
03,010,01,002,0045,0,345,4,349,581,0,3,1,3,0,1,0,76.14,60.07 ,33.33
03,010,01,003,0046,0,443,5,448,809,0,3,1,3,0,1,0,76.14,55.38 ,33.33
03,010,01,003,0047,0,261,5,266,449,0,3,1,3,0,1,0,76.14,59.24 ,33.33
03,010,01,003,0048,0,710,8,718,1170,0,3,1,3,0,1,0,76.14,61.37 ,33.33
03,010,01,003,0049,0,696,19,715,1225,0,3,1,3,0,1,0,76.14,58.37 ,33.33
03,010,01,003,0050,0,1078,16,1094,1805,0,3,1,3,0,1,0,76.14,60.61 ,33.33
03,010,01,003,0051,0,568,7,575,901,0,3,1,3,0,1,0,76.14,63.82 ,33.33
03,010,01,003,0052,0,457,12,469,791,0,3,1,3,0,1,0,76.14,59.29 ,33.33
03,010,01,003,0053,0,514,17,531,921,0,3,1,3,0,1,0,76.14,57.65 ,33.33
03,010,01,003,0054,0,841,7,848,1528,0,3,1,3,0,1,0,76.14,55.50 ,33.33
03,010,01,003,0055,0,865,12,877,1641,0,3,1,3,0,1,0,76.14,53.44 ,33.33
03,010,01,003,0056,0,929,8,937,1608,0,3,1,3,0,1,0,76.14,58.27 ,33.33
03,010,01,003,0057,0,384,9,393,596,0,3,1,3,0,1,0,76.14,65.94 ,33.33
03,010,01,003,0058,0,449,4,453,764,0,3,1,3,0,1,0,76.14,59.29 ,33.33
03,010,01,003,0059,0,747,13,760,1332,0,3,1,3,0,1,0,76.14,57.06 ,33.33
03,010,01,003,0060,0,1141,26,1167,1923,0,3,1,3,0,1,0,76.14,60.69 ,33.33
03,010,01,003,0061,0,228,5,233,399,0,3,1,3,0,1,0,76.14,58.40 ,33.33
03,010,01,003,0062,0,289,5,294,483,0,3,1,3,0,1,0,76.14,60.87 ,33.33
03,010,01,003,0063,0,251,1,252,394,0,3,1,3,0,1,0,76.14,63.96 ,33.33
03,010,01,003,0064,0,567,12,579,845,0,3,1,3,0,1,0,76.14,68.52 ,33.33
03,010,01,003,0065,0,648,6,654,994,0,3,1,3,0,1,0,76.14,65.79 ,33.33
03,010,01,003,0066,0,637,6,643,1178,0,3,1,3,0,1,0,76.14,54.58 ,33.33
03,010,01,003,0067,0,1209,11,1220,2275,0,3,1,3,0,1,0,76.14,53.63 ,33.33
03,010,01,003,0068,0,625,8,633,1044,0,3,1,3,0,1,0,76.14,60.63 ,33.33
03,010,01,004,0069,0,335,8,343,546,0,3,1,3,0,1,0,76.14,62.82 ,33.33
03,010,01,004,0070,0,1132,16,1148,1868,0,3,1,3,0,1,0,76.14,61.46 ,33.33
03,010,01,004,0071,0,606,5,611,1032,0,3,1,3,0,1,0,76.14,59.21 ,33.33
03,010,01,004,0072,0,2225,41,2266,3908,0,3,1,3,0,1,0,76.14,57.98 ,33.33
03,010,01,004,0073,0,745,10,755,1209,0,3,1,3,0,1,0,76.14,62.45 ,33.33
03,010,01,004,0074,0,763,2,765,1155,0,3,1,3,0,1,0,76.14,66.23 ,33.33
03,010,01,004,0075,0,438,1,439,714,0,3,1,3,0,1,0,76.14,61.48 ,33.33
03,010,01,004,0076,0,452,5,457,890,0,3,1,3,0,1,0,76.14,51.35 ,33.33
03,010,01,004,0077,0,493,11,504,717,0,3,1,3,0,1,0,76.14,70.29 ,33.33
03,010,01,004,0078,0,254,4,258,368,0,3,1,3,0,1,0,76.14,70.11 ,33.33
03,010,01,004,0079,0,1100,21,1121,1806,0,3,1,3,0,1,0,76.14,62.07 ,33.33
03,010,01,004,0080,0,949,19,968,1527,0,3,1,3,0,1,0,76.14,63.39 ,33.33
03,010,01,004,0081,0,1043,21,1064,1673,0,3,1,3,0,1,0,76.14,63.60 ,33.33
03,010,01,004,0082,0,613,6,619,972,0,3,1,3,0,1,0,76.14,63.68 ,33.33
03,010,01,004,0083,0,895,12,907,1564,0,3,1,3,0,1,0,76.14,57.99 ,33.33
03,010,01,004,0084,0,1053,7,1060,1719,0,3,1,3,0,1,0,76.14,61.66 ,33.33
03,010,01,004,0085,0,639,13,652,1034,0,3,1,3,0,1,0,76.14,63.06 ,33.33
03,010,01,004,0086,0,434,6,440,701,0,3,1,3,0,1,0,76.14,62.77 ,33.33
03,010,01,004,0087,0,558,8,566,826,0,3,1,3,0,1,0,76.14,68.52 ,33.33
03,010,01,004,0088,0,770,15,785,1191,0,3,1,3,0,1,0,76.14,65.91 ,33.33
03,010,01,004,0089,0,432,7,439,705,0,3,1,3,0,1,0,76.14,62.27 ,33.33
03,010,01,005,0090,0,1208,13,1221,1993,0,3,1,3,0,1,0,76.14,61.26 ,33.33
03,010,01,005,0091,0,876,13,889,1518,0,3,1,3,0,1,0,76.14,58.56 ,33.33
03,010,01,005,0092,0,1552,14,1566,2661,0,3,1,3,0,1,0,76.14,58.85 ,33.33
03,010,01,005,0093,0,1042,20,1062,1812,0,3,1,3,0,1,0,76.14,58.61 ,33.33
03,010,01,005,0094,0,652,9,661,1033,0,3,1,3,0,1,0,76.14,63.99 ,33.33
03,010,01,005,0095,0,1161,17,1178,1748,0,3,1,3,0,1,0,76.14,67.39 ,33.33
03,010,01,005,0096,0,772,12,784,1294,0,3,1,3,0,1,0,76.14,60.59 ,33.33
03,010,01,005,0097,0,1135,21,1156,1741,0,3,1,3,0,1,0,76.14,66.40 ,33.33
03,010,01,005,0098,0,495,12,507,794,0,3,1,3,0,1,0,76.14,63.85 ,33.33
03,010,01,005,0099,0,331,0,331,626,0,3,1,3,0,1,0,76.14,52.88 ,33.33
03,010,01,005,0100,0,492,8,500,753,0,3,1,3,0,1,0,76.14,66.40 ,33.33
03,010,01,005,0101,0,953,14,967,1624,0,3,1,3,0,1,0,76.14,59.54 ,33.33
03,010,01,005,0102,0,426,11,437,674,0,3,1,3,0,1,0,76.14,64.84 ,33.33
03,010,01,005,0103,0,407,3,410,621,0,3,1,3,0,1,0,76.14,66.02 ,33.33
03,010,01,005,0104,0,411,4,415,695,0,3,1,3,0,1,0,76.14,59.71 ,33.33
03,010,01,005,0105,0,834,20,854,1467,0,3,1,3,0,1,0,76.14,58.21 ,33.33
03,010,01,005,0106,0,989,26,1015,1853,0,3,1,3,0,1,0,76.14,54.78 ,33.33
03,010,01,005,0107,0,1191,17,1208,2066,0,3,1,3,0,1,0,76.14,58.47 ,33.33
03,010,01,005,0108,0,883,23,906,1523,0,3,1,3,0,1,0,76.14,59.49 ,33.33
03,010,01,005,0109,0,1021,18,1039,1783,0,3,1,3,0,1,0,76.14,58.27 ,33.33
03,010,01,005,0110,0,1869,25,1894,2906,0,3,1,3,0,1,0,76.14,65.18 ,33.33
03,010,01,005,0111,0,751,4,755,1090,0,3,1,3,0,1,0,76.14,69.27 ,33.33
03,010,01,005,0112,0,1441,25,1466,2618,0,3,1,3,0,1,0,76.14,56.00 ,33.33
03,010,01,005,0113,0,852,15,867,1376,0,3,1,3,0,1,0,76.14,63.01 ,33.33
03,010,01,005,0114,0,1395,29,1424,2577,0,3,1,3,0,1,0,76.14,55.26 ,33.33
03,010,01,005,0115,0,1055,25,1080,1743,0,3,1,3,0,1,0,76.14,61.96 ,33.33
03,010,01,005,0116,0,1025,17,1042,1758,0,3,1,3,0,1,0,76.14,59.27 ,33.33
03,010,01,005,0117,0,774,7,781,1505,0,3,1,3,0,1,0,76.14,51.89 ,33.33
03,010,01,006,0118,0,806,8,814,1352,0,3,1,3,0,1,0,76.14,60.21 ,33.33
03,010,01,006,0119,0,452,9,461,826,0,3,1,3,0,1,0,76.14,55.81 ,33.33
03,010,01,006,0120,0,410,4,414,745,0,3,1,3,0,1,0,76.14,55.57 ,33.33
03,010,01,006,0121,0,463,3,466,875,0,3,1,3,0,1,0,76.14,53.26 ,33.33
03,010,01,006,0122,0,509,6,515,976,0,3,1,3,0,1,0,76.14,52.77 ,33.33
03,010,01,006,0123,0,671,11,682,1222,0,3,1,3,0,1,0,76.14,55.81 ,33.33
03,010,01,006,0124,0,528,11,539,1023,0,3,1,3,0,1,0,76.14,52.69 ,33.33
03,010,01,006,0125,0,629,8,637,957,0,3,1,3,0,1,0,76.14,66.56 ,33.33
03,010,01,006,0126,0,622,10,632,1121,0,3,1,3,0,1,0,76.14,56.38 ,33.33
03,010,01,006,0127,0,409,7,416,802,0,3,1,3,0,1,0,76.14,51.87 ,33.33
03,010,01,006,0128,0,739,12,751,1242,0,3,1,3,0,1,0,76.14,60.47 ,33.33
03,010,01,006,0129,0,522,5,527,949,0,3,1,3,0,1,0,76.14,55.53 ,33.33
03,010,01,006,0130,0,430,3,433,764,0,3,1,3,0,1,0,76.14,56.68 ,33.33
03,010,01,006,0131,0,533,16,549,861,0,3,1,3,0,1,0,76.14,63.76 ,33.33
03,010,01,007,0132,0,908,8,916,1574,0,3,1,3,0,1,0,76.14,58.20 ,33.33
03,010,01,007,0133,0,904,16,920,1697,0,3,1,3,0,1,0,76.14,54.21 ,33.33
03,010,01,007,0134,0,819,11,830,1350,0,3,1,3,0,1,0,76.14,61.48 ,33.33
03,010,01,007,0135,0,749,12,761,1412,0,3,1,3,0,1,0,76.14,53.90 ,33.33
03,010,01,007,0136,0,648,6,654,1178,0,3,1,3,0,1,0,76.14,55.52 ,33.33
03,010,01,007,0137,0,869,9,878,1507,0,3,1,3,0,1,0,76.14,58.26 ,33.33
03,010,01,007,0138,0,906,19,925,1571,0,3,1,3,0,1,0,76.14,58.88 ,33.33
03,010,01,007,0139,0,489,7,496,920,0,3,1,3,0,1,0,76.14,53.91 ,33.33
03,010,01,007,0140,0,921,24,945,1605,0,3,1,3,0,1,0,76.14,58.88 ,33.33
03,010,01,007,0141,0,858,17,875,1434,0,3,1,3,0,1,0,76.14,61.02 ,33.33
03,010,01,007,0142,0,809,12,821,1397,0,3,1,3,0,1,0,76.14,58.77 ,33.33
03,010,01,007,0143,0,489,4,493,808,0,3,1,3,0,1,0,76.14,61.01 ,33.33
03,010,01,007,0144,0,71,8,79,957,0,3,1,3,0,1,0,76.14,8.25 ,33.33
03,010,01,007,0145,0,55,1,56,692,0,3,1,3,0,1,0,76.14,8.09 ,33.33
03,010,01,007,0146,0,674,15,689,1153,0,3,1,3,0,1,0,76.14,59.76 ,33.33
03,010,01,007,0147,0,599,10,609,1155,0,3,1,3,0,1,0,76.14,52.73 ,33.33
03,010,01,007,0148,0,541,27,568,1104,0,3,1,3,0,1,0,76.14,51.45 ,33.33
03,010,01,007,0149,0,380,6,386,666,0,3,1,3,0,1,0,76.14,57.96 ,33.33
03,010,01,007,0150,0,395,4,399,797,0,3,1,3,0,1,0,76.14,50.06 ,33.33
03,010,01,007,0151,0,317,6,323,599,0,3,1,3,0,1,0,76.14,53.92 ,33.33
03,010,01,007,0152,0,517,8,525,979,0,3,1,3,0,1,0,76.14,53.63 ,33.33
03,010,01,007,0153,0,329,2,331,646,0,3,1,3,0,1,0,76.14,51.24 ,33.33
03,010,01,007,0154,0,289,2,291,502,0,3,1,3,0,1,0,76.14,57.97 ,33.33
03,010,01,008,0155,0,784,13,797,1275,0,3,1,3,0,1,0,76.14,62.51 ,33.33
03,010,01,008,0156,0,509,4,513,964,0,3,1,3,0,1,0,76.14,53.22 ,33.33
03,010,01,008,0157,0,500,12,512,867,0,3,1,3,0,1,0,76.14,59.05 ,33.33
03,010,01,008,0158,0,286,14,300,403,0,3,1,3,0,1,0,76.14,74.44 ,33.33
03,010,01,008,0159,0,765,12,777,1251,0,3,1,3,0,1,0,76.14,62.11 ,33.33
03,010,01,008,0160,0,760,8,768,1382,0,3,1,3,0,1,0,76.14,55.57 ,33.33
03,010,01,008,0161,0,490,5,495,869,0,3,1,3,0,1,0,76.14,56.96 ,33.33
03,010,01,008,0162,0,488,4,492,760,0,3,1,3,0,1,0,76.14,64.74 ,33.33
03,010,01,008,0163,0,442,6,448,813,0,3,1,3,0,1,0,76.14,55.10 ,33.33
03,010,01,008,0164,0,812,8,820,1400,0,3,1,3,0,1,0,76.14,58.57 ,33.33
03,010,01,008,0165,0,379,8,387,676,0,3,1,3,0,1,0,76.14,57.25 ,33.33
03,010,01,008,0166,0,445,9,454,805,0,3,1,3,0,1,0,76.14,56.40 ,33.33
03,010,01,008,0167,0,578,9,587,1132,0,3,1,3,0,1,0,76.14,51.86 ,33.33
03,010,01,008,0168,0,461,14,475,825,0,3,1,3,0,1,0,76.14,57.58 ,33.33
03,010,01,008,0169,0,555,7,562,1046,0,3,1,3,0,1,0,76.14,53.73 ,33.33
03,010,01,008,0170,0,753,7,760,1396,0,3,1,3,0,1,0,76.14,54.44 ,33.33
03,010,01,008,0171,0,390,5,395,752,0,3,1,3,0,1,0,76.14,52.53 ,33.33
03,010,01,008,0172,0,333,5,338,618,0,3,1,3,0,1,0,76.14,54.69 ,33.33
03,010,01,008,0173,0,455,3,458,870,0,3,1,3,0,1,0,76.14,52.64 ,33.33
03,010,01,008,0174,0,547,9,556,998,0,3,1,3,0,1,0,76.14,55.71 ,33.33
03,010,01,008,0175,0,539,7,546,975,0,3,1,3,0,1,0,76.14,56.00 ,33.33
03,010,01,008,0176,0,399,5,404,725,0,3,1,3,0,1,0,76.14,55.72 ,33.33
03,010,01,008,0177,0,459,6,465,835,0,3,1,3,0,1,0,76.14,55.69 ,33.33
03,010,01,008,0178,0,512,9,521,936,0,3,1,3,0,1,0,76.14,55.66 ,33.33
03,010,01,008,0179,0,401,4,405,705,0,3,1,3,0,1,0,76.14,57.45 ,33.33
03,010,01,009,0180,0,893,14,907,1617,0,3,1,3,0,1,0,76.14,56.09 ,33.33
03,010,01,009,0181,0,540,6,546,1010,0,3,1,3,0,1,0,76.14,54.06 ,33.33
03,010,01,009,0182,0,825,15,840,1477,0,3,1,3,0,1,0,76.14,56.87 ,33.33
03,010,01,009,0183,0,869,13,882,1476,0,3,1,3,0,1,0,76.14,59.76 ,33.33
03,010,01,009,0184,0,672,5,677,1251,0,3,1,3,0,1,0,76.14,54.12 ,33.33
03,010,01,009,0185,0,405,4,409,715,0,3,1,3,0,1,0,76.14,57.20 ,33.33
03,010,01,009,0186,0,265,1,266,475,0,3,1,3,0,1,0,76.14,56.00 ,33.33
03,010,01,009,0187,0,602,5,607,1094,0,3,1,3,0,1,0,76.14,55.48 ,33.33
03,010,01,009,0188,0,771,12,783,1132,0,3,1,3,0,1,0,76.14,69.17 ,33.33
03,010,01,009,0189,0,506,9,515,937,0,3,1,3,0,1,0,76.14,54.96 ,33.33
03,010,01,009,0190,0,246,0,246,480,0,3,1,3,0,1,0,76.14,51.25 ,33.33
03,010,01,009,0191,0,616,9,625,1136,0,3,1,3,0,1,0,76.14,55.02 ,33.33
03,010,01,009,0192,0,223,0,223,418,0,3,1,3,0,1,0,76.14,53.35 ,33.33
03,010,01,009,0193,0,834,13,847,1384,0,3,1,3,0,1,0,76.14,61.20 ,33.33
03,010,01,009,0194,0,811,14,825,1298,0,3,1,3,0,1,0,76.14,63.56 ,33.33
03,010,01,009,0195,0,601,3,604,938,0,3,1,3,0,1,0,76.14,64.39 ,33.33
03,010,01,009,0196,0,433,11,444,830,0,3,1,3,0,1,0,76.14,53.49 ,33.33
03,010,01,009,0197,0,548,7,555,936,0,3,1,3,0,1,0,76.14,59.29 ,33.33
03,010,01,009,0198,0,489,9,498,848,0,3,1,3,0,1,0,76.14,58.73 ,33.33
03,010,01,009,0199,0,600,13,613,991,0,3,1,3,0,1,0,76.14,61.86 ,33.33
03,010,01,009,0200,0,589,5,594,1022,0,3,1,3,0,1,0,76.14,58.12 ,33.33
03,010,01,009,0201,0,636,3,639,1211,0,3,1,3,0,1,0,76.14,52.77 ,33.33
03,010,01,009,0202,0,508,4,512,825,0,3,1,3,0,1,0,76.14,62.06 ,33.33
03,010,01,010,0203,0,575,17,592,869,0,3,1,3,0,1,0,76.14,68.12 ,33.33
03,010,01,010,0204,0,993,18,1011,1597,0,3,1,3,0,1,0,76.14,63.31 ,33.33
03,010,01,010,0205,0,959,9,968,1382,0,3,1,3,0,1,0,76.14,70.04 ,33.33
03,010,01,010,0206,0,677,7,684,898,0,3,1,3,0,1,0,76.14,76.17 ,33.33
03,010,01,010,0207,0,429,8,437,695,0,3,1,3,0,1,0,76.14,62.88 ,33.33
03,010,01,010,0208,0,921,15,936,1316,0,3,1,3,0,1,0,76.14,71.12 ,33.33
03,010,01,010,0209,0,269,2,271,403,0,3,1,3,0,1,0,76.14,67.25 ,33.33
03,010,01,010,0210,0,348,2,350,533,0,3,1,3,0,1,0,76.14,65.67 ,33.33
03,010,01,010,0211,0,570,9,579,819,0,3,1,3,0,1,0,76.14,70.70 ,33.33
03,010,01,010,0212,0,296,2,298,434,0,3,1,3,0,1,0,76.14,68.66 ,33.33
03,010,01,010,0213,0,376,6,382,546,0,3,1,3,0,1,0,76.14,69.96 ,33.33
03,010,01,010,0214,0,394,2,396,569,0,3,1,3,0,1,0,76.14,69.60 ,33.33
03,010,01,010,0215,0,964,7,971,1479,0,3,1,3,0,1,0,76.14,65.65 ,33.33
03,010,01,010,0216,0,538,8,546,871,0,3,1,3,0,1,0,76.14,62.69 ,33.33
03,010,01,010,0217,0,563,9,572,947,0,3,1,3,0,1,0,76.14,60.40 ,33.33
03,010,01,010,0218,0,552,6,558,835,0,3,1,3,0,1,0,76.14,66.83 ,33.33
03,010,01,010,0219,0,335,5,340,570,0,3,1,3,0,1,0,76.14,59.65 ,33.33
03,010,01,010,0220,0,415,7,422,546,0,3,1,3,0,1,0,76.14,77.29 ,33.33
03,010,01,010,0221,0,606,8,614,913,0,3,1,3,0,1,0,76.14,67.25 ,33.33
03,010,01,010,0222,0,345,5,350,531,0,3,1,3,0,1,0,76.14,65.91 ,33.33
03,010,01,010,0223,0,479,4,483,773,0,3,1,3,0,1,0,76.14,62.48 ,33.33
03,010,01,010,0224,0,512,4,516,840,0,3,1,3,0,1,0,76.14,61.43 ,33.33
03,010,01,011,0225,0,294,4,298,493,0,3,1,3,0,1,0,76.14,60.45 ,33.33
03,010,01,011,0226,0,408,7,415,659,0,3,1,3,0,1,0,76.14,62.97 ,33.33
03,010,01,011,0227,0,795,10,805,1250,0,3,1,3,0,1,0,76.14,64.40 ,33.33
03,010,01,011,0228,0,689,15,704,1162,0,3,1,3,0,1,0,76.14,60.59 ,33.33
03,010,01,011,0229,0,250,2,252,413,0,3,1,3,0,1,0,76.14,61.02 ,33.33
03,010,01,011,0230,0,739,10,749,1179,0,3,1,3,0,1,0,76.14,63.53 ,33.33
03,010,01,011,0231,0,326,8,334,561,0,3,1,3,0,1,0,76.14,59.54 ,33.33
03,010,01,011,0232,0,593,6,599,1017,0,3,1,3,0,1,0,76.14,58.90 ,33.33
03,010,01,011,0233,0,680,14,694,1173,0,3,1,3,0,1,0,76.14,59.16 ,33.33
03,010,01,011,0234,0,668,16,684,1149,0,3,1,3,0,1,0,76.14,59.53 ,33.33
03,010,01,011,0235,0,553,11,564,973,0,3,1,3,0,1,0,76.14,57.97 ,33.33
03,010,01,011,0236,0,535,8,543,937,0,3,1,3,0,1,0,76.14,57.95 ,33.33
03,010,01,011,0237,0,859,15,874,1350,0,3,1,3,0,1,0,76.14,64.74 ,33.33
03,010,01,011,0238,0,939,13,952,1533,0,3,1,3,0,1,0,76.14,62.10 ,33.33
03,010,01,011,0239,0,369,4,373,578,0,3,1,3,0,1,0,76.14,64.53 ,33.33
03,010,01,012,0240,0,1584,31,1615,2526,0,3,1,3,0,1,0,76.14,63.94 ,33.33
03,010,01,012,0241,0,1125,18,1143,1734,0,3,1,3,0,1,0,76.14,65.92 ,33.33
03,010,01,012,0242,0,842,15,857,1274,0,3,1,3,0,1,0,76.14,67.27 ,33.33
03,010,01,012,0243,0,1082,22,1104,1746,0,3,1,3,0,1,0,76.14,63.23 ,33.33
03,010,01,012,0244,0,471,5,476,765,0,3,1,3,0,1,0,76.14,62.22 ,33.33
03,010,01,012,0245,0,867,9,876,1364,0,3,1,3,0,1,0,76.14,64.22 ,33.33
03,010,01,012,0246,0,961,21,982,1481,0,3,1,3,0,1,0,76.14,66.31 ,33.33
03,010,01,012,0247,0,1068,21,1089,1577,0,3,1,3,0,1,0,76.14,69.06 ,33.33
03,010,01,012,0248,0,434,9,443,662,0,3,1,3,0,1,0,76.14,66.92 ,33.33
03,010,01,012,0249,0,438,13,451,691,0,3,1,3,0,1,0,76.14,65.27 ,33.33
03,010,01,012,0250,0,394,4,398,549,0,3,1,3,0,1,0,76.14,72.50 ,33.33
03,010,01,012,0251,0,750,23,773,1164,0,3,1,3,0,1,0,76.14,66.41 ,33.33
03,010,01,012,0252,0,1052,11,1063,1596,0,3,1,3,0,1,0,76.14,66.60 ,33.33
03,010,01,012,0253,0,646,7,653,998,0,3,1,3,0,1,0,76.14,65.43 ,33.33
03,010,01,012,0254,0,1292,40,1332,2004,0,3,1,3,0,1,0,76.14,66.47 ,33.33
03,010,01,012,0255,0,955,18,973,1645,0,3,1,3,0,1,0,76.14,59.15 ,33.33
03,010,01,012,0256,0,994,10,1004,1574,0,3,1,3,0,1,0,76.14,63.79 ,33.33
03,010,01,012,0257,0,567,11,578,888,0,3,1,3,0,1,0,76.14,65.09 ,33.33
03,010,01,012,0258,0,1548,18,1566,2634,0,3,1,3,0,1,0,76.14,59.45 ,33.33
03,010,01,012,0259,0,1576,35,1611,2622,0,3,1,3,0,1,0,76.14,61.44 ,33.33
03,010,01,012,0260,0,487,6,493,729,0,3,1,3,0,1,0,76.14,67.63 ,33.33
03,010,01,012,0261,0,1125,16,1141,1738,0,3,1,3,0,1,0,76.14,65.65 ,33.33
03,010,01,012,0262,0,1094,27,1121,1768,0,3,1,3,0,1,0,76.14,63.40 ,33.33
03,010,01,012,0263,0,475,4,479,830,0,3,1,3,0,1,0,76.14,57.71 ,33.33
03,010,01,012,0264,0,650,8,658,1017,0,3,1,3,0,1,0,76.14,64.70 ,33.33
03,010,01,012,0265,0,715,10,725,1263,0,3,1,3,0,1,0,76.14,57.40 ,33.33
03,010,01,013,0266,0,981,21,1002,1533,0,3,1,3,0,1,0,76.14,65.36 ,33.33
03,010,01,013,0267,0,430,6,436,746,0,3,1,3,0,1,0,76.14,58.45 ,33.33
03,010,01,013,0268,0,450,12,462,712,0,3,1,3,0,1,0,76.14,64.89 ,33.33
03,010,01,013,0269,0,455,14,469,818,0,3,1,3,0,1,0,76.14,57.33 ,33.33
03,010,01,013,0270,0,747,13,760,1278,0,3,1,3,0,1,0,76.14,59.47 ,33.33
03,010,01,013,0271,0,1256,14,1270,2151,0,3,1,3,0,1,0,76.14,59.04 ,33.33
03,010,01,013,0272,0,1121,15,1136,2105,0,3,1,3,0,1,0,76.14,53.97 ,33.33
03,010,01,013,0273,0,2555,46,2601,4681,0,3,1,3,0,1,0,76.14,55.57 ,33.33
03,010,01,013,0274,0,2161,36,2197,4277,0,3,1,3,0,1,0,76.14,51.37 ,33.33
03,010,01,013,0275,0,958,17,975,1588,0,3,1,3,0,1,0,76.14,61.40 ,33.33
03,010,01,013,0276,0,745,12,757,1208,0,3,1,3,0,1,0,76.14,62.67 ,33.33
03,010,01,013,0277,0,1174,8,1182,1968,0,3,1,3,0,1,0,76.14,60.06 ,33.33
03,010,01,013,0278,0,721,7,728,1111,0,3,1,3,0,1,0,76.14,65.53 ,33.33
03,010,01,013,0279,0,814,10,824,1154,0,3,1,3,0,1,0,76.14,71.40 ,33.33
03,010,01,013,0280,0,570,7,577,907,0,3,1,3,0,1,0,76.14,63.62 ,33.33
03,010,01,013,0281,0,1144,17,1161,1818,0,3,1,3,0,1,0,76.14,63.86 ,33.33
03,010,01,013,0282,0,521,6,527,726,0,3,1,3,0,1,0,76.14,72.59 ,33.33
03,010,01,013,0283,0,407,3,410,622,0,3,1,3,0,1,0,76.14,65.92 ,33.33
03,010,01,013,0284,0,475,2,477,703,0,3,1,3,0,1,0,76.14,67.85 ,33.33
03,010,01,013,0285,0,738,6,744,1112,0,3,1,3,0,1,0,76.14,66.91 ,33.33
03,010,01,013,0286,0,200,2,202,317,0,3,1,3,0,1,0,76.14,63.72 ,33.33
03,010,01,013,0287,0,217,2,219,331,0,3,1,3,0,1,0,76.14,66.16 ,33.33
03,010,01,014,0288,0,1247,32,1279,2038,0,3,1,3,0,1,0,76.14,62.76 ,33.33
03,010,01,014,0289,0,1085,15,1100,1686,0,3,1,3,0,1,0,76.14,65.24 ,33.33
03,010,01,014,0290,0,414,2,416,737,0,3,1,3,0,1,0,76.14,56.45 ,33.33
03,010,01,014,0291,0,543,12,555,840,0,3,1,3,0,1,0,76.14,66.07 ,33.33
03,010,01,014,0292,0,731,5,736,1256,0,3,1,3,0,1,0,76.14,58.60 ,33.33
03,010,01,014,0293,0,366,3,369,542,0,3,1,3,0,1,0,76.14,68.08 ,33.33
03,010,01,014,0294,0,642,6,648,1027,0,3,1,3,0,1,0,76.14,63.10 ,33.33
03,010,01,014,0295,0,2504,21,2525,4149,0,3,1,3,0,1,0,76.14,60.86 ,33.33
03,010,01,014,0296,0,754,13,767,1256,0,3,1,3,0,1,0,76.14,61.07 ,33.33
03,010,01,014,0297,0,845,5,850,1292,0,3,1,3,0,1,0,76.14,65.79 ,33.33
03,010,01,014,0298,0,1010,10,1020,1560,0,3,1,3,0,1,0,76.14,65.38 ,33.33
03,010,01,014,0299,0,1128,21,1149,1671,0,3,1,3,0,1,0,76.14,68.76 ,33.33
03,010,01,014,0300,0,723,4,727,1108,0,3,1,3,0,1,0,76.14,65.61 ,33.33
03,010,01,014,0301,0,481,5,486,737,0,3,1,3,0,1,0,76.14,65.94 ,33.33
03,010,01,014,0302,0,582,6,588,893,0,3,1,3,0,1,0,76.14,65.85 ,33.33
03,010,01,014,0303,0,343,3,346,535,0,3,1,3,0,1,0,76.14,64.67 ,33.33
03,010,01,014,0304,0,145,0,145,234,0,3,1,3,0,1,0,76.14,61.97 ,33.33
03,010,01,014,0305,0,828,15,843,1358,0,3,1,3,0,1,0,76.14,62.08 ,33.33
03,010,01,014,0306,0,485,10,495,844,0,3,1,3,0,1,0,76.14,58.65 ,33.33
03,010,01,014,0307,0,1338,15,1353,2294,0,3,1,3,0,1,0,76.14,58.98 ,33.33
03,010,01,014,0308,0,572,12,584,1125,0,3,1,3,0,1,0,76.14,51.91 ,33.33
03,010,01,014,0309,0,167,1,168,349,0,3,1,3,0,1,0,76.14,48.14 ,33.33
03,010,01,014,0310,0,506,4,510,809,0,3,1,3,0,1,0,76.14,63.04 ,33.33
03,010,01,014,0311,0,462,4,466,759,0,3,1,3,0,1,0,76.14,61.40 ,33.33
03,010,01,015,0312,0,1421,28,1449,2499,0,3,1,3,0,1,0,76.14,57.98 ,33.33
03,010,01,015,0313,0,654,14,668,1010,0,3,1,3,0,1,0,76.14,66.14 ,33.33
03,010,01,015,0314,0,1971,26,1997,3424,0,3,1,3,0,1,0,76.14,58.32 ,33.33
03,010,01,015,0315,0,394,6,400,597,0,3,1,3,0,1,0,76.14,67.00 ,33.33
03,010,01,015,0316,0,334,4,338,547,0,3,1,3,0,1,0,76.14,61.79 ,33.33
03,010,01,015,0317,0,438,3,441,720,0,3,1,3,0,1,0,76.14,61.25 ,33.33
03,010,01,015,0318,0,410,4,414,589,0,3,1,3,0,1,0,76.14,70.29 ,33.33
03,010,01,015,0319,0,999,16,1015,1701,0,3,1,3,0,1,0,76.14,59.67 ,33.33
03,010,01,015,0320,0,552,9,561,972,0,3,1,3,0,1,0,76.14,57.72 ,33.33
03,010,01,015,0321,0,276,2,278,535,0,3,1,3,0,1,0,76.14,51.96 ,33.33
03,010,01,015,0322,0,296,4,300,489,0,3,1,3,0,1,0,76.14,61.35 ,33.33
03,010,01,015,0323,0,331,10,341,532,0,3,1,3,0,1,0,76.14,64.10 ,33.33
03,010,01,015,0324,0,280,1,281,413,0,3,1,3,0,1,0,76.14,68.04 ,33.33
03,010,01,015,0325,0,319,7,326,489,0,3,1,3,0,1,0,76.14,66.67 ,33.33
03,010,01,015,0326,0,198,3,201,353,0,3,1,3,0,1,0,76.14,56.94 ,33.33
03,010,01,015,0327,0,457,4,461,717,0,3,1,3,0,1,0,76.14,64.30 ,33.33
03,010,01,015,0328,0,478,20,498,730,0,3,1,3,0,1,0,76.14,68.22 ,33.33
03,010,01,015,0329,0,650,13,663,1027,0,3,1,3,0,1,0,76.14,64.56 ,33.33
03,010,01,016,0330,0,573,8,581,878,0,3,1,3,0,1,0,76.14,66.17 ,33.33
03,010,01,016,0331,0,213,2,215,352,0,3,1,3,0,1,0,76.14,61.08 ,33.33
03,010,01,016,0332,0,510,3,513,743,0,3,1,3,0,1,0,76.14,69.04 ,33.33
03,010,01,016,0333,0,925,10,935,1450,0,3,1,3,0,1,0,76.14,64.48 ,33.33
03,010,01,016,0334,0,529,8,537,794,0,3,1,3,0,1,0,76.14,67.63 ,33.33
03,010,01,016,0335,0,503,9,512,783,0,3,1,3,0,1,0,76.14,65.39 ,33.33
03,010,01,016,0336,0,597,8,605,865,0,3,1,3,0,1,0,76.14,69.94 ,33.33
03,010,01,016,0337,0,486,1,487,884,0,3,1,3,0,1,0,76.14,55.09 ,33.33
03,010,01,016,0338,0,505,8,513,883,0,3,1,3,0,1,0,76.14,58.10 ,33.33
03,010,01,016,0339,0,310,4,314,575,0,3,1,3,0,1,0,76.14,54.61 ,33.33
03,010,01,016,0340,0,249,0,249,350,0,3,1,3,0,1,0,76.14,71.14 ,33.33
03,010,01,017,0341,0,454,64,518,981,0,3,1,3,0,1,0,76.14,52.80 ,33.33
03,010,01,017,0342,0,227,37,264,490,0,3,1,3,0,1,0,76.14,53.88 ,33.33
03,010,01,017,0343,0,170,13,183,305,0,3,1,3,0,1,0,76.14,60.00 ,33.33
03,010,01,017,0344,0,332,17,349,700,0,3,1,3,0,1,0,76.14,49.86 ,33.33
03,010,01,017,0345,0,202,5,207,358,0,3,1,3,0,1,0,76.14,57.82 ,33.33
03,010,01,018,0346,0,213,2,215,374,0,3,1,3,0,1,0,76.14,57.49 ,33.33
03,010,01,018,0347,0,104,2,106,206,0,3,1,3,0,1,0,76.14,51.46 ,33.33
03,010,01,018,0348,0,121,2,123,238,0,3,1,3,0,1,0,76.14,51.68 ,33.33
03,010,01,018,0349,0,115,2,117,238,0,3,1,3,0,1,0,76.14,49.16 ,33.33
03,010,01,018,0350,0,58,0,58,149,0,3,1,3,0,1,0,76.14,38.93 ,33.33
03,010,01,018,0351,0,129,0,129,234,0,3,1,3,0,1,0,76.14,55.13 ,33.33
03,010,01,018,0352,0,14,0,14,99,0,3,1,3,0,1,0,76.14,14.14 ,33.33
03,010,01,018,0353,0,162,1,163,264,0,3,1,3,0,1,0,76.14,61.74 ,33.33
03,010,01,018,0354,0,8,0,8,27,0,3,1,3,0,1,0,76.14,29.63 ,33.33
03,010,01,018,0355,0,12,1,13,24,0,3,1,3,0,1,0,76.14,54.17 ,33.33
03,010,01,018,0356,0,8,0,8,20,0,3,1,3,0,1,0,76.14,40.00 ,33.33
03,010,01,018,0357,0,55,0,55,100,0,3,1,3,0,1,0,76.14,55.00 ,33.33
03,011,01,001,0001,0,3078,34,3112,4816,0,3,1,3,0,1,0,76.14,64.62 ,33.33
03,011,01,001,0002,0,886,9,895,1379,0,3,1,3,0,1,0,76.14,64.90 ,33.33
03,011,01,001,0003,0,1499,18,1517,2494,0,3,1,3,0,1,0,76.14,60.83 ,33.33
03,011,01,001,0004,0,527,10,537,952,0,3,1,3,0,1,0,76.14,56.41 ,33.33
03,011,01,001,0005,0,790,15,805,1382,0,3,1,3,0,1,0,76.14,58.25 ,33.33
03,011,01,001,0006,0,732,4,736,1051,0,3,1,3,0,1,0,76.14,70.03 ,33.33
03,011,01,001,0007,0,1876,23,1899,3095,0,3,1,3,0,1,0,76.14,61.36 ,33.33
03,011,01,001,0008,0,2596,30,2626,4263,0,3,1,3,0,1,0,76.14,61.60 ,33.33
03,011,01,001,0009,0,1008,20,1028,1646,0,3,1,3,0,1,0,76.14,62.45 ,33.33
03,011,01,001,0010,0,979,13,992,1465,0,3,1,3,0,1,0,76.14,67.71 ,33.33
03,011,01,001,0011,0,81,1,82,121,0,3,1,3,0,1,0,76.14,67.77 ,33.33
03,011,01,001,0012,0,1563,23,1586,2482,0,3,1,3,0,1,0,76.14,63.90 ,33.33
03,011,01,001,0013,0,790,16,806,1153,0,3,1,3,0,1,0,76.14,69.90 ,33.33
03,011,01,001,0014,0,4336,54,4390,7383,0,3,1,3,0,1,0,76.14,59.46 ,33.33
03,011,01,001,0015,0,2037,25,2062,3407,0,3,1,3,0,1,0,76.14,60.52 ,33.33
03,011,01,001,0016,0,1383,17,1400,2007,0,3,1,3,0,1,0,76.14,69.76 ,33.33
03,011,01,001,0017,0,732,9,741,1161,0,3,1,3,0,1,0,76.14,63.82 ,33.33
03,011,01,001,0018,0,882,15,897,1336,0,3,1,3,0,1,0,76.14,67.14 ,33.33
03,011,01,001,0019,0,912,9,921,1405,0,3,1,3,0,1,0,76.14,65.55 ,33.33
03,011,01,001,0020,0,1278,23,1301,2008,0,3,1,3,0,1,0,76.14,64.79 ,33.33
03,011,01,001,0021,0,813,18,831,1336,0,3,1,3,0,1,0,76.14,62.20 ,33.33
03,011,01,001,0022,0,271,0,271,391,0,3,1,3,0,1,0,76.14,69.31 ,33.33
03,011,01,001,0023,0,346,1,347,462,0,3,1,3,0,1,0,76.14,75.11 ,33.33
03,011,01,001,0024,0,499,6,505,783,0,3,1,3,0,1,0,76.14,64.50 ,33.33
03,011,01,001,0025,0,626,10,636,986,0,3,1,3,0,1,0,76.14,64.50 ,33.33
03,011,01,001,0026,0,424,3,427,608,0,3,1,3,0,1,0,76.14,70.23 ,33.33
03,011,01,002,0027,0,846,10,856,1340,0,3,1,3,0,1,0,76.14,63.88 ,33.33
03,011,01,002,0028,0,366,4,370,549,0,3,1,3,0,1,0,76.14,67.40 ,33.33
03,011,01,002,0029,0,248,4,252,372,0,3,1,3,0,1,0,76.14,67.74 ,33.33
03,011,01,002,0030,0,394,6,400,604,0,3,1,3,0,1,0,76.14,66.23 ,33.33
03,011,01,002,0031,0,356,30,386,581,0,3,1,3,0,1,0,76.14,66.44 ,33.33
03,011,01,002,0032,0,274,2,276,433,0,3,1,3,0,1,0,76.14,63.74 ,33.33
03,011,01,002,0033,0,516,5,521,764,0,3,1,3,0,1,0,76.14,68.19 ,33.33
03,011,01,002,0034,0,1601,18,1619,2611,0,3,1,3,0,1,0,76.14,62.01 ,33.33
03,011,01,002,0035,0,462,7,469,687,0,3,1,3,0,1,0,76.14,68.27 ,33.33
03,011,01,002,0036,0,628,13,641,1083,0,3,1,3,0,1,0,76.14,59.19 ,33.33
03,011,01,002,0037,0,1804,27,1831,2921,0,3,1,3,0,1,0,76.14,62.68 ,33.33
03,011,01,002,0038,0,405,5,410,589,0,3,1,3,0,1,0,76.14,69.61 ,33.33
03,011,01,002,0039,0,496,9,505,781,0,3,1,3,0,1,0,76.14,64.66 ,33.33
03,011,01,002,0040,0,848,10,858,1494,0,3,1,3,0,1,0,76.14,57.43 ,33.33
03,011,01,002,0041,0,346,1,347,569,0,3,1,3,0,1,0,76.14,60.98 ,33.33
03,011,01,002,0042,0,189,1,190,297,0,3,1,3,0,1,0,76.14,63.97 ,33.33
03,011,01,002,0043,0,465,8,473,686,0,3,1,3,0,1,0,76.14,68.95 ,33.33
03,011,01,002,0044,0,333,4,337,521,0,3,1,3,0,1,0,76.14,64.68 ,33.33
03,011,01,002,0045,0,617,10,627,876,0,3,1,3,0,1,0,76.14,71.58 ,33.33
03,011,01,002,0046,0,261,3,264,439,0,3,1,3,0,1,0,76.14,60.14 ,33.33
03,011,01,002,0047,0,207,5,212,290,0,3,1,3,0,1,0,76.14,73.10 ,33.33
03,011,01,002,0048,0,255,1,256,383,0,3,1,3,0,1,0,76.14,66.84 ,33.33
03,011,01,002,0049,0,286,1,287,427,0,3,1,3,0,1,0,76.14,67.21 ,33.33
03,011,01,002,0050,0,405,4,409,641,0,3,1,3,0,1,0,76.14,63.81 ,33.33
03,011,01,002,0051,0,672,14,686,951,0,3,1,3,0,1,0,76.14,72.13 ,33.33
03,011,01,003,0052,0,1242,16,1258,1944,0,3,1,3,0,1,0,76.14,64.71 ,33.33
03,011,01,003,0053,0,1618,10,1628,2554,0,3,1,3,0,1,0,76.14,63.74 ,33.33
03,011,01,003,0054,0,909,17,926,1458,0,3,1,3,0,1,0,76.14,63.51 ,33.33
03,011,01,003,0055,0,914,16,930,1489,0,3,1,3,0,1,0,76.14,62.46 ,33.33
03,011,01,003,0056,0,528,8,536,811,0,3,1,3,0,1,0,76.14,66.09 ,33.33
03,011,01,003,0057,0,838,8,846,1388,0,3,1,3,0,1,0,76.14,60.95 ,33.33
03,011,01,003,0058,0,301,5,306,493,0,3,1,3,0,1,0,76.14,62.07 ,33.33
03,011,01,003,0059,0,369,5,374,637,0,3,1,3,0,1,0,76.14,58.71 ,33.33
03,011,01,003,0060,0,340,2,342,495,0,3,1,3,0,1,0,76.14,69.09 ,33.33
03,011,01,003,0061,0,366,4,370,658,0,3,1,3,0,1,0,76.14,56.23 ,33.33
03,011,01,003,0062,0,796,10,806,1325,0,3,1,3,0,1,0,76.14,60.83 ,33.33
03,011,01,003,0063,0,1709,37,1746,2598,0,3,1,3,0,1,0,76.14,67.21 ,33.33
03,011,01,003,0064,0,765,8,773,1174,0,3,1,3,0,1,0,76.14,65.84 ,33.33
03,011,01,003,0065,0,881,4,885,1349,0,3,1,3,0,1,0,76.14,65.60 ,33.33
03,011,01,003,0066,0,617,11,628,898,0,3,1,3,0,1,0,76.14,69.93 ,33.33
03,011,01,003,0067,0,442,9,451,691,0,3,1,3,0,1,0,76.14,65.27 ,33.33
03,011,01,003,0068,0,658,8,666,938,0,3,1,3,0,1,0,76.14,71.00 ,33.33
03,011,01,003,0069,0,686,6,692,982,0,3,1,3,0,1,0,76.14,70.47 ,33.33
03,011,01,003,0070,0,529,9,538,872,0,3,1,3,0,1,0,76.14,61.70 ,33.33
03,011,01,003,0071,0,778,14,792,1257,0,3,1,3,0,1,0,76.14,63.01 ,33.33
03,011,01,003,0072,0,509,10,519,814,0,3,1,3,0,1,0,76.14,63.76 ,33.33
03,011,01,003,0073,0,586,8,594,815,0,3,1,3,0,1,0,76.14,72.88 ,33.33
03,011,01,003,0074,0,632,7,639,960,0,3,1,3,0,1,0,76.14,66.56 ,33.33
03,011,01,003,0075,0,458,10,468,763,0,3,1,3,0,1,0,76.14,61.34 ,33.33
03,011,01,004,0076,0,828,9,837,1267,0,3,1,3,0,1,0,76.14,66.06 ,33.33
03,011,01,004,0077,0,1157,24,1181,1738,0,3,1,3,0,1,0,76.14,67.95 ,33.33
03,011,01,004,0078,0,488,4,492,693,0,3,1,3,0,1,0,76.14,71.00 ,33.33
03,011,01,004,0079,0,1582,17,1599,2264,0,3,1,3,0,1,0,76.14,70.63 ,33.33
03,011,01,004,0080,0,780,11,791,1191,0,3,1,3,0,1,0,76.14,66.41 ,33.33
03,011,01,004,0081,0,527,3,530,792,0,3,1,3,0,1,0,76.14,66.92 ,33.33
03,011,01,004,0082,0,1052,12,1064,1489,0,3,1,3,0,1,0,76.14,71.46 ,33.33
03,011,01,004,0083,0,1092,8,1100,1734,0,3,1,3,0,1,0,76.14,63.44 ,33.33
03,011,01,004,0084,0,862,14,876,1390,0,3,1,3,0,1,0,76.14,63.02 ,33.33
03,011,01,004,0085,0,457,7,464,652,0,3,1,3,0,1,0,76.14,71.17 ,33.33
03,011,01,004,0086,0,889,12,901,1420,0,3,1,3,0,1,0,76.14,63.45 ,33.33
03,011,01,004,0087,0,823,14,837,1260,0,3,1,3,0,1,0,76.14,66.43 ,33.33
03,011,01,004,0088,0,1170,16,1186,1708,0,3,1,3,0,1,0,76.14,69.44 ,33.33
03,011,01,005,0089,0,927,12,939,1434,0,3,1,3,0,1,0,76.14,65.48 ,33.33
03,011,01,005,0090,0,841,7,848,1202,0,3,1,3,0,1,0,76.14,70.55 ,33.33
03,011,01,005,0091,0,847,8,855,1309,0,3,1,3,0,1,0,76.14,65.32 ,33.33
03,011,01,005,0092,0,915,18,933,1300,0,3,1,3,0,1,0,76.14,71.77 ,33.33
03,011,01,005,0093,0,732,6,738,1176,0,3,1,3,0,1,0,76.14,62.76 ,33.33
03,011,01,005,0094,0,805,17,822,1229,0,3,1,3,0,1,0,76.14,66.88 ,33.33
03,011,01,005,0095,0,581,5,586,832,0,3,1,3,0,1,0,76.14,70.43 ,33.33
03,011,01,005,0096,0,396,4,400,566,0,3,1,3,0,1,0,76.14,70.67 ,33.33
03,011,01,005,0097,0,365,24,389,654,0,3,1,3,0,1,0,76.14,59.48 ,33.33
03,011,01,005,0098,0,584,9,593,862,0,3,1,3,0,1,0,76.14,68.79 ,33.33
03,011,01,005,0099,0,357,3,360,501,0,3,1,3,0,1,0,76.14,71.86 ,33.33
03,011,01,005,0100,0,769,9,778,1227,0,3,1,3,0,1,0,76.14,63.41 ,33.33
03,011,01,005,0101,0,392,1,393,537,0,3,1,3,0,1,0,76.14,73.18 ,33.33
03,011,01,005,0102,0,765,10,775,1071,0,3,1,3,0,1,0,76.14,72.36 ,33.33
03,011,01,005,0103,0,389,1,390,584,0,3,1,3,0,1,0,76.14,66.78 ,33.33
03,011,01,005,0104,0,1007,13,1020,1446,0,3,1,3,0,1,0,76.14,70.54 ,33.33
03,011,01,005,0105,0,892,15,907,1406,0,3,1,3,0,1,0,76.14,64.51 ,33.33
03,011,01,005,0106,0,743,12,755,1086,0,3,1,3,0,1,0,76.14,69.52 ,33.33
03,011,01,005,0107,0,948,9,957,1411,0,3,1,3,0,1,0,76.14,67.82 ,33.33
03,011,01,005,0108,0,728,4,732,1065,0,3,1,3,0,1,0,76.14,68.73 ,33.33
03,011,01,005,0109,0,443,5,448,743,0,3,1,3,0,1,0,76.14,60.30 ,33.33
03,011,01,005,0110,0,137,4,141,209,0,3,1,3,0,1,0,76.14,67.46 ,33.33
03,011,01,006,0111,0,826,6,832,1442,0,3,1,3,0,1,0,76.14,57.70 ,33.33
03,011,01,006,0112,0,1436,9,1445,2258,0,3,1,3,0,1,0,76.14,63.99 ,33.33
03,011,01,006,0113,0,924,11,935,1605,0,3,1,3,0,1,0,76.14,58.26 ,33.33
03,011,01,006,0114,0,606,2,608,1005,0,3,1,3,0,1,0,76.14,60.50 ,33.33
03,011,01,006,0115,0,707,12,719,1204,0,3,1,3,0,1,0,76.14,59.72 ,33.33
03,011,01,006,0116,0,945,15,960,1466,0,3,1,3,0,1,0,76.14,65.48 ,33.33
03,011,01,006,0117,0,543,7,550,957,0,3,1,3,0,1,0,76.14,57.47 ,33.33
03,011,01,006,0118,0,1172,14,1186,1845,0,3,1,3,0,1,0,76.14,64.28 ,33.33
03,011,01,006,0119,0,370,4,374,582,0,3,1,3,0,1,0,76.14,64.26 ,33.33
03,011,01,006,0120,0,296,4,300,563,0,3,1,3,0,1,0,76.14,53.29 ,33.33
03,011,01,006,0121,0,237,2,239,406,0,3,1,3,0,1,0,76.14,58.87 ,33.33
03,011,01,006,0122,0,1285,18,1303,2309,0,3,1,3,0,1,0,76.14,56.43 ,33.33
03,011,01,006,0123,0,392,4,396,796,0,3,1,3,0,1,0,76.14,49.75 ,33.33
03,011,01,006,0124,0,665,8,673,1151,0,3,1,3,0,1,0,76.14,58.47 ,33.33
03,011,01,006,0125,0,636,5,641,1156,0,3,1,3,0,1,0,76.14,55.45 ,33.33
03,011,01,006,0126,0,504,7,511,1022,0,3,1,3,0,1,0,76.14,50.00 ,33.33
03,011,01,007,0127,0,499,4,503,664,0,3,1,3,0,1,0,76.14,75.75 ,33.33
03,011,01,007,0128,0,436,2,438,599,0,3,1,3,0,1,0,76.14,73.12 ,33.33
03,011,01,007,0129,0,1212,15,1227,1695,0,3,1,3,0,1,0,76.14,72.39 ,33.33
03,011,01,007,0130,0,1540,11,1551,2248,0,3,1,3,0,1,0,76.14,68.99 ,33.33
03,011,01,007,0131,0,966,10,976,1301,0,3,1,3,0,1,0,76.14,75.02 ,33.33
03,011,01,007,0132,0,1216,9,1225,1681,0,3,1,3,0,1,0,76.14,72.87 ,33.33
03,011,01,007,0133,0,823,13,836,1133,0,3,1,3,0,1,0,76.14,73.79 ,33.33
03,011,01,007,0134,0,671,7,678,903,0,3,1,3,0,1,0,76.14,75.08 ,33.33
03,011,01,007,0135,0,1786,14,1800,2650,0,3,1,3,0,1,0,76.14,67.92 ,33.33
03,011,01,007,0136,0,822,14,836,1185,0,3,1,3,0,1,0,76.14,70.55 ,33.33
03,011,01,007,0137,0,1589,17,1606,2306,0,3,1,3,0,1,0,76.14,69.64 ,33.33
03,011,01,007,0138,0,459,6,465,624,0,3,1,3,0,1,0,76.14,74.52 ,33.33
03,011,01,007,0139,0,537,8,545,702,0,3,1,3,0,1,0,76.14,77.64 ,33.33
03,011,01,007,0140,0,1573,21,1594,2218,0,3,1,3,0,1,0,76.14,71.87 ,33.33
03,011,01,007,0141,0,978,8,986,1351,0,3,1,3,0,1,0,76.14,72.98 ,33.33
03,011,01,007,0142,0,527,6,533,706,0,3,1,3,0,1,0,76.14,75.50 ,33.33
03,011,01,007,0143,0,944,10,954,1270,0,3,1,3,0,1,0,76.14,75.12 ,33.33
03,011,01,007,0144,0,420,3,423,518,0,3,1,3,0,1,0,76.14,81.66 ,33.33
03,011,01,007,0145,0,752,9,761,1013,0,3,1,3,0,1,0,76.14,75.12 ,33.33
03,011,01,007,0146,0,415,5,420,563,0,3,1,3,0,1,0,76.14,74.60 ,33.33
03,011,01,007,0147,0,822,14,836,1168,0,3,1,3,0,1,0,76.14,71.58 ,33.33
03,011,01,007,0148,0,692,12,704,962,0,3,1,3,0,1,0,76.14,73.18 ,33.33
03,011,01,007,0149,0,449,7,456,584,0,3,1,3,0,1,0,76.14,78.08 ,33.33
03,011,01,007,0150,0,483,13,496,658,0,3,1,3,0,1,0,76.14,75.38 ,33.33
03,011,01,007,0151,0,471,4,475,622,0,3,1,3,0,1,0,76.14,76.37 ,33.33
03,011,01,007,0152,0,678,5,683,827,0,3,1,3,0,1,0,76.14,82.59 ,33.33
03,011,01,007,0153,0,628,5,633,795,0,3,1,3,0,1,0,76.14,79.62 ,33.33
03,011,01,007,0154,0,555,7,562,763,0,3,1,3,0,1,0,76.14,73.66 ,33.33
03,011,01,007,0155,0,871,8,879,1152,0,3,1,3,0,1,0,76.14,76.30 ,33.33
03,011,01,008,0156,0,736,14,750,1079,0,3,1,3,0,1,0,76.14,69.51 ,33.33
03,011,01,008,0157,0,1612,21,1633,2410,0,3,1,3,0,1,0,76.14,67.76 ,33.33
03,011,01,008,0158,0,815,5,820,1164,0,3,1,3,0,1,0,76.14,70.45 ,33.33
03,011,01,008,0159,0,1061,15,1076,1494,0,3,1,3,0,1,0,76.14,72.02 ,33.33
03,011,01,008,0160,0,1357,11,1368,1945,0,3,1,3,0,1,0,76.14,70.33 ,33.33
03,011,01,008,0161,0,1353,19,1372,2002,0,3,1,3,0,1,0,76.14,68.53 ,33.33
03,011,01,008,0162,0,582,10,592,806,0,3,1,3,0,1,0,76.14,73.45 ,33.33
03,011,01,008,0163,0,593,3,596,805,0,3,1,3,0,1,0,76.14,74.04 ,33.33
03,011,01,008,0164,0,801,13,814,1166,0,3,1,3,0,1,0,76.14,69.81 ,33.33
03,011,01,008,0165,0,732,6,738,1048,0,3,1,3,0,1,0,76.14,70.42 ,33.33
03,011,01,008,0166,0,1096,15,1111,1687,0,3,1,3,0,1,0,76.14,65.86 ,33.33
03,011,01,008,0167,0,637,11,648,884,0,3,1,3,0,1,0,76.14,73.30 ,33.33
03,011,01,008,0168,0,857,9,866,1269,0,3,1,3,0,1,0,76.14,68.24 ,33.33
03,011,01,008,0169,0,825,5,830,1210,0,3,1,3,0,1,0,76.14,68.60 ,33.33
03,011,01,008,0170,0,904,14,918,1245,0,3,1,3,0,1,0,76.14,73.73 ,33.33
03,011,01,009,0171,0,1767,41,1808,2570,0,3,1,3,0,1,0,76.14,70.35 ,33.33
03,011,01,009,0172,0,1639,21,1660,2411,0,3,1,3,0,1,0,76.14,68.85 ,33.33
03,011,01,009,0173,0,888,10,898,1280,0,3,1,3,0,1,0,76.14,70.16 ,33.33
03,011,01,009,0174,0,712,7,719,1031,0,3,1,3,0,1,0,76.14,69.74 ,33.33
03,011,01,009,0175,0,592,4,596,846,0,3,1,3,0,1,0,76.14,70.45 ,33.33
03,011,01,009,0176,0,1703,19,1722,2548,0,3,1,3,0,1,0,76.14,67.58 ,33.33
03,011,01,009,0177,0,1204,17,1221,1708,0,3,1,3,0,1,0,76.14,71.49 ,33.33
03,011,01,009,0178,0,1071,17,1088,1491,0,3,1,3,0,1,0,76.14,72.97 ,33.33
03,011,01,009,0179,0,712,7,719,1017,0,3,1,3,0,1,0,76.14,70.70 ,33.33
03,011,01,009,0180,0,390,3,393,542,0,3,1,3,0,1,0,76.14,72.51 ,33.33
03,011,01,009,0181,0,573,8,581,958,0,3,1,3,0,1,0,76.14,60.65 ,33.33
03,011,01,009,0182,0,482,6,488,826,0,3,1,3,0,1,0,76.14,59.08 ,33.33
03,011,01,010,0183,0,1382,16,1398,1949,0,3,1,3,0,1,0,76.14,71.73 ,33.33
03,011,01,010,0184,0,1413,8,1421,1999,0,3,1,3,0,1,0,76.14,71.09 ,33.33
03,011,01,010,0185,0,726,12,738,1040,0,3,1,3,0,1,0,76.14,70.96 ,33.33
03,011,01,010,0186,0,527,7,534,686,0,3,1,3,0,1,0,76.14,77.84 ,33.33
03,011,01,010,0187,0,344,1,345,499,0,3,1,3,0,1,0,76.14,69.14 ,33.33
03,011,01,010,0188,0,1281,18,1299,1795,0,3,1,3,0,1,0,76.14,72.37 ,33.33
03,011,01,010,0189,0,1783,25,1808,2521,0,3,1,3,0,1,0,76.14,71.72 ,33.33
03,011,01,010,0190,0,654,15,669,958,0,3,1,3,0,1,0,76.14,69.83 ,33.33
03,011,01,010,0191,0,955,11,966,1389,0,3,1,3,0,1,0,76.14,69.55 ,33.33
03,011,01,010,0192,0,480,5,485,692,0,3,1,3,0,1,0,76.14,70.09 ,33.33
03,011,01,010,0193,0,466,5,471,627,0,3,1,3,0,1,0,76.14,75.12 ,33.33
03,011,01,010,0194,0,1586,24,1610,2321,0,3,1,3,0,1,0,76.14,69.37 ,33.33
03,011,01,010,0195,0,657,10,667,913,0,3,1,3,0,1,0,76.14,73.06 ,33.33
03,011,01,011,0196,0,816,4,820,1207,0,3,1,3,0,1,0,76.14,67.94 ,33.33
03,011,01,011,0197,0,594,6,600,817,0,3,1,3,0,1,0,76.14,73.44 ,33.33
03,011,01,011,0198,0,975,7,982,1392,0,3,1,3,0,1,0,76.14,70.55 ,33.33
03,011,01,011,0199,0,780,9,789,1069,0,3,1,3,0,1,0,76.14,73.81 ,33.33
03,011,01,011,0200,0,620,6,626,842,0,3,1,3,0,1,0,76.14,74.35 ,33.33
03,011,01,011,0201,0,449,8,457,668,0,3,1,3,0,1,0,76.14,68.41 ,33.33
03,011,01,011,0202,0,699,7,706,1059,0,3,1,3,0,1,0,76.14,66.67 ,33.33
03,011,01,011,0203,0,584,11,595,920,0,3,1,3,0,1,0,76.14,64.67 ,33.33
03,011,01,011,0204,0,663,6,669,953,0,3,1,3,0,1,0,76.14,70.20 ,33.33
03,011,01,011,0205,0,472,8,480,682,0,3,1,3,0,1,0,76.14,70.38 ,33.33
03,011,01,012,0206,0,1150,17,1167,1693,0,3,1,3,0,1,0,76.14,68.93 ,33.33
03,011,01,012,0207,0,1610,18,1628,2419,0,3,1,3,0,1,0,76.14,67.30 ,33.33
03,011,01,012,0208,0,2579,17,2596,3898,0,3,1,3,0,1,0,76.14,66.60 ,33.33
03,011,01,012,0209,0,3169,22,3191,4818,0,3,1,3,0,1,0,76.14,66.23 ,33.33
03,011,01,012,0210,0,4621,40,4661,6760,0,3,1,3,0,1,0,76.14,68.95 ,33.33
03,011,01,012,0211,0,1875,22,1897,2819,0,3,1,3,0,1,0,76.14,67.29 ,33.33
03,011,01,012,0212,0,1190,16,1206,1741,0,3,1,3,0,1,0,76.14,69.27 ,33.33
03,011,01,012,0213,0,621,6,627,839,0,3,1,3,0,1,0,76.14,74.73 ,33.33
03,011,01,012,0214,0,938,6,944,1351,0,3,1,3,0,1,0,76.14,69.87 ,33.33
03,011,01,012,0215,0,457,3,460,654,0,3,1,3,0,1,0,76.14,70.34 ,33.33
03,011,01,012,0216,0,282,3,285,381,0,3,1,3,0,1,0,76.14,74.80 ,33.33
03,011,01,012,0217,0,691,14,705,1062,0,3,1,3,0,1,0,76.14,66.38 ,33.33
03,011,01,012,0218,0,405,5,410,572,0,3,1,3,0,1,0,76.14,71.68 ,33.33
03,011,01,012,0219,0,457,5,462,670,0,3,1,3,0,1,0,76.14,68.96 ,33.33
03,011,01,012,0220,0,679,7,686,962,0,3,1,3,0,1,0,76.14,71.31 ,33.33
03,011,01,012,0221,0,762,2,764,1065,0,3,1,3,0,1,0,76.14,71.74 ,33.33
03,011,01,012,0222,0,591,6,597,835,0,3,1,3,0,1,0,76.14,71.50 ,33.33
03,011,01,012,0223,0,706,9,715,962,0,3,1,3,0,1,0,76.14,74.32 ,33.33
03,011,01,012,0224,0,798,14,812,1180,0,3,1,3,0,1,0,76.14,68.81 ,33.33
03,011,01,012,0225,0,989,13,1002,1440,0,3,1,3,0,1,0,76.14,69.58 ,33.33
03,011,01,012,0226,0,574,7,581,807,0,3,1,3,0,1,0,76.14,72.00 ,33.33
03,011,01,013,0227,0,674,9,683,1028,0,3,1,3,0,1,0,76.14,66.44 ,33.33
03,011,01,013,0228,0,728,10,738,1164,0,3,1,3,0,1,0,76.14,63.40 ,33.33
03,011,01,013,0229,0,355,2,357,545,0,3,1,3,0,1,0,76.14,65.50 ,33.33
03,011,01,013,0230,0,540,4,544,849,0,3,1,3,0,1,0,76.14,64.08 ,33.33
03,011,01,013,0231,0,420,5,425,610,0,3,1,3,0,1,0,76.14,69.67 ,33.33
03,011,01,013,0232,0,1990,16,2006,3168,0,3,1,3,0,1,0,76.14,63.32 ,33.33
03,011,01,013,0233,0,910,9,919,1374,0,3,1,3,0,1,0,76.14,66.89 ,33.33
03,011,01,013,0234,0,847,4,851,1248,0,3,1,3,0,1,0,76.14,68.19 ,33.33
03,011,01,013,0235,0,777,7,784,1148,0,3,1,3,0,1,0,76.14,68.29 ,33.33
03,011,01,013,0236,0,349,4,353,492,0,3,1,3,0,1,0,76.14,71.75 ,33.33
03,011,01,013,0237,0,349,3,352,517,0,3,1,3,0,1,0,76.14,68.09 ,33.33
03,011,01,013,0238,0,530,7,537,811,0,3,1,3,0,1,0,76.14,66.21 ,33.33
03,011,01,013,0239,0,240,4,244,361,0,3,1,3,0,1,0,76.14,67.59 ,33.33
03,011,01,013,0240,0,508,8,516,710,0,3,1,3,0,1,0,76.14,72.68 ,33.33
03,011,01,013,0241,0,218,3,221,369,0,3,1,3,0,1,0,76.14,59.89 ,33.33
03,011,01,013,0242,0,276,6,282,450,0,3,1,3,0,1,0,76.14,62.67 ,33.33
03,011,01,013,0243,0,330,4,334,546,0,3,1,3,0,1,0,76.14,61.17 ,33.33
03,011,01,013,0244,0,244,3,247,347,0,3,1,3,0,1,0,76.14,71.18 ,33.33
03,011,01,013,0245,0,525,7,532,737,0,3,1,3,0,1,0,76.14,72.18 ,33.33
03,011,01,013,0246,0,382,1,383,596,0,3,1,3,0,1,0,76.14,64.26 ,33.33
03,011,01,013,0247,0,763,11,774,1233,0,3,1,3,0,1,0,76.14,62.77 ,33.33
03,011,01,013,0248,0,350,2,352,558,0,3,1,3,0,1,0,76.14,63.08 ,33.33
03,011,01,013,0249,0,443,2,445,777,0,3,1,3,0,1,0,76.14,57.27 ,33.33
03,011,01,013,0250,0,475,4,479,667,0,3,1,3,0,1,0,76.14,71.81 ,33.33
03,011,01,013,0251,0,323,0,323,542,0,3,1,3,0,1,0,76.14,59.59 ,33.33
03,011,01,013,0252,0,315,4,319,499,0,3,1,3,0,1,0,76.14,63.93 ,33.33
03,011,01,014,0253,0,1609,11,1620,2274,0,3,1,3,0,1,0,76.14,71.24 ,33.33
03,011,01,014,0254,0,1936,26,1962,2774,0,3,1,3,0,1,0,76.14,70.73 ,33.33
03,011,01,014,0255,0,1272,20,1292,1761,0,3,1,3,0,1,0,76.14,73.37 ,33.33
03,011,01,014,0256,0,872,9,881,1226,0,3,1,3,0,1,0,76.14,71.86 ,33.33
03,011,01,014,0257,0,1092,11,1103,1546,0,3,1,3,0,1,0,76.14,71.35 ,33.33
03,011,01,014,0258,0,865,7,872,1244,0,3,1,3,0,1,0,76.14,70.10 ,33.33
03,011,01,014,0259,0,850,10,860,1203,0,3,1,3,0,1,0,76.14,71.49 ,33.33
03,011,01,014,0260,0,603,5,608,828,0,3,1,3,0,1,0,76.14,73.43 ,33.33
03,011,01,014,0261,0,775,21,796,1114,0,3,1,3,0,1,0,76.14,71.45 ,33.33
03,011,01,014,0262,0,816,6,822,1141,0,3,1,3,0,1,0,76.14,72.04 ,33.33
03,011,01,014,0263,0,636,7,643,843,0,3,1,3,0,1,0,76.14,76.28 ,33.33
03,011,01,014,0264,0,315,2,317,421,0,3,1,3,0,1,0,76.14,75.30 ,33.33
03,011,01,014,0265,0,450,4,454,650,0,3,1,3,0,1,0,76.14,69.85 ,33.33
03,011,01,015,0266,0,428,4,432,577,0,3,1,3,0,1,0,76.14,74.87 ,33.33
03,011,01,015,0267,0,509,3,512,786,0,3,1,3,0,1,0,76.14,65.14 ,33.33
03,011,01,015,0268,0,388,4,392,499,0,3,1,3,0,1,0,76.14,78.56 ,33.33
03,011,01,015,0269,0,595,5,600,851,0,3,1,3,0,1,0,76.14,70.51 ,33.33
03,011,01,015,0270,0,694,7,701,984,0,3,1,3,0,1,0,76.14,71.24 ,33.33
03,011,01,015,0271,0,384,1,385,555,0,3,1,3,0,1,0,76.14,69.37 ,33.33
03,011,01,015,0272,0,337,3,340,470,0,3,1,3,0,1,0,76.14,72.34 ,33.33
03,011,01,015,0273,0,592,3,595,762,0,3,1,3,0,1,0,76.14,78.08 ,33.33
03,011,01,015,0274,0,1102,11,1113,1626,0,3,1,3,0,1,0,76.14,68.45 ,33.33
03,011,01,015,0275,0,262,2,264,349,0,3,1,3,0,1,0,76.14,75.64 ,33.33
03,011,01,015,0276,0,538,7,545,839,0,3,1,3,0,1,0,76.14,64.96 ,33.33
03,011,01,015,0277,0,514,3,517,778,0,3,1,3,0,1,0,76.14,66.45 ,33.33
03,011,01,015,0278,0,774,11,785,1236,0,3,1,3,0,1,0,76.14,63.51 ,33.33
03,011,01,015,0279,0,661,6,667,987,0,3,1,3,0,1,0,76.14,67.58 ,33.33
03,011,01,015,0280,0,403,3,406,560,0,3,1,3,0,1,0,76.14,72.50 ,33.33
03,011,01,015,0281,0,699,3,702,919,0,3,1,3,0,1,0,76.14,76.39 ,33.33
03,011,01,015,0282,0,967,7,974,1312,0,3,1,3,0,1,0,76.14,74.24 ,33.33
03,011,01,015,0283,0,596,5,601,812,0,3,1,3,0,1,0,76.14,74.01 ,33.33
03,011,01,015,0284,0,468,2,470,634,0,3,1,3,0,1,0,76.14,74.13 ,33.33
03,011,01,015,0285,0,555,2,557,772,0,3,1,3,0,1,0,76.14,72.15 ,33.33
03,011,01,015,0286,0,1631,22,1653,2199,0,3,1,3,0,1,0,76.14,75.17 ,33.33
03,011,01,015,0287,0,895,12,907,1267,0,3,1,3,0,1,0,76.14,71.59 ,33.33
03,011,01,016,0288,0,594,4,598,809,0,3,1,3,0,1,0,76.14,73.92 ,33.33
03,011,01,016,0289,0,808,5,813,1187,0,3,1,3,0,1,0,76.14,68.49 ,33.33
03,011,01,016,0290,0,763,11,774,1101,0,3,1,3,0,1,0,76.14,70.30 ,33.33
03,011,01,016,0291,0,1041,3,1044,1461,0,3,1,3,0,1,0,76.14,71.46 ,33.33
03,011,01,016,0292,0,679,8,687,925,0,3,1,3,0,1,0,76.14,74.27 ,33.33
03,011,01,016,0293,0,754,7,761,1054,0,3,1,3,0,1,0,76.14,72.20 ,33.33
03,011,01,016,0294,0,652,5,657,965,0,3,1,3,0,1,0,76.14,68.08 ,33.33
03,011,01,016,0295,0,526,2,528,846,0,3,1,3,0,1,0,76.14,62.41 ,33.33
03,011,01,016,0296,0,447,4,451,663,0,3,1,3,0,1,0,76.14,68.02 ,33.33
03,011,01,016,0297,0,501,5,506,746,0,3,1,3,0,1,0,76.14,67.83 ,33.33
03,011,01,016,0298,0,482,1,483,650,0,3,1,3,0,1,0,76.14,74.31 ,33.33
03,011,01,016,0299,0,294,2,296,438,0,3,1,3,0,1,0,76.14,67.58 ,33.33
03,011,01,016,0300,0,642,4,646,925,0,3,1,3,0,1,0,76.14,69.84 ,33.33
03,011,01,016,0301,0,510,6,516,790,0,3,1,3,0,1,0,76.14,65.32 ,33.33
03,011,01,016,0302,0,970,8,978,1374,0,3,1,3,0,1,0,76.14,71.18 ,33.33
03,011,01,016,0303,0,817,10,827,1177,0,3,1,3,0,1,0,76.14,70.26 ,33.33
03,011,01,016,0304,0,1202,13,1215,1745,0,3,1,3,0,1,0,76.14,69.63 ,33.33
03,011,01,016,0305,0,574,7,581,944,0,3,1,3,0,1,0,76.14,61.55 ,33.33
03,011,01,017,0306,0,642,8,650,943,0,3,1,3,0,1,0,76.14,68.93 ,33.33
03,011,01,017,0307,0,341,7,348,521,0,3,1,3,0,1,0,76.14,66.79 ,33.33
03,011,01,017,0308,0,254,2,256,379,0,3,1,3,0,1,0,76.14,67.55 ,33.33
03,011,01,017,0309,0,580,2,582,855,0,3,1,3,0,1,0,76.14,68.07 ,33.33
03,011,01,017,0310,0,880,6,886,1271,0,3,1,3,0,1,0,76.14,69.71 ,33.33
03,011,01,017,0311,0,460,5,465,689,0,3,1,3,0,1,0,76.14,67.49 ,33.33
03,011,01,017,0312,0,498,2,500,763,0,3,1,3,0,1,0,76.14,65.53 ,33.33
03,011,01,017,0313,0,353,0,353,579,0,3,1,3,0,1,0,76.14,60.97 ,33.33
03,011,01,017,0314,0,651,8,659,1112,0,3,1,3,0,1,0,76.14,59.26 ,33.33
03,011,01,017,0315,0,413,2,415,661,0,3,1,3,0,1,0,76.14,62.78 ,33.33
03,011,01,017,0316,0,746,10,756,1135,0,3,1,3,0,1,0,76.14,66.61 ,33.33
03,011,01,017,0317,0,488,3,491,766,0,3,1,3,0,1,0,76.14,64.10 ,33.33
03,011,01,017,0318,0,501,5,506,749,0,3,1,3,0,1,0,76.14,67.56 ,33.33
03,011,01,018,0319,0,1035,12,1047,1503,0,3,1,3,0,1,0,76.14,69.66 ,33.33
03,011,01,018,0320,0,2339,34,2373,3453,0,3,1,3,0,1,0,76.14,68.72 ,33.33
03,011,01,018,0321,0,882,21,903,1526,0,3,1,3,0,1,0,76.14,59.17 ,33.33
03,011,01,018,0322,0,2299,36,2335,3170,0,3,1,3,0,1,0,76.14,73.66 ,33.33
03,011,01,018,0323,0,357,5,362,500,0,3,1,3,0,1,0,76.14,72.40 ,33.33
03,011,01,018,0324,0,440,7,447,634,0,3,1,3,0,1,0,76.14,70.50 ,33.33
03,011,01,018,0325,0,345,4,349,473,0,3,1,3,0,1,0,76.14,73.78 ,33.33
03,011,01,018,0326,0,653,6,659,924,0,3,1,3,0,1,0,76.14,71.32 ,33.33
03,011,01,018,0327,0,1774,23,1797,2575,0,3,1,3,0,1,0,76.14,69.79 ,33.33
03,011,01,018,0328,0,879,13,892,1239,0,3,1,3,0,1,0,76.14,71.99 ,33.33
03,011,01,018,0329,0,598,6,604,784,0,3,1,3,0,1,0,76.14,77.04 ,33.33
03,011,01,018,0330,0,1381,15,1396,1889,0,3,1,3,0,1,0,76.14,73.90 ,33.33
03,011,01,018,0331,0,972,15,987,1360,0,3,1,3,0,1,0,76.14,72.57 ,33.33
03,011,01,018,0332,0,1220,16,1236,1649,0,3,1,3,0,1,0,76.14,74.95 ,33.33
03,011,01,018,0333,0,1439,38,1477,2068,0,3,1,3,0,1,0,76.14,71.42 ,33.33
03,011,01,018,0334,0,884,17,901,1149,0,3,1,3,0,1,0,76.14,78.42 ,33.33
03,011,01,018,0335,0,367,6,373,529,0,3,1,3,0,1,0,76.14,70.51 ,33.33
03,011,01,018,0336,0,1366,25,1391,1981,0,3,1,3,0,1,0,76.14,70.22 ,33.33
03,011,01,018,0337,0,559,9,568,858,0,3,1,3,0,1,0,76.14,66.20 ,33.33
03,011,01,018,0338,0,732,7,739,1096,0,3,1,3,0,1,0,76.14,67.43 ,33.33
03,011,01,019,0339,0,704,8,712,1035,0,3,1,3,0,1,0,76.14,68.79 ,33.33
03,011,01,019,0340,0,1668,19,1687,2343,0,3,1,3,0,1,0,76.14,72.00 ,33.33
03,011,01,019,0341,0,2531,41,2572,3545,0,3,1,3,0,1,0,76.14,72.55 ,33.33
03,011,01,019,0342,0,1269,15,1284,1854,0,3,1,3,0,1,0,76.14,69.26 ,33.33
03,011,01,019,0343,0,817,15,832,1193,0,3,1,3,0,1,0,76.14,69.74 ,33.33
03,011,01,019,0344,0,498,3,501,691,0,3,1,3,0,1,0,76.14,72.50 ,33.33
03,011,01,019,0345,0,343,3,346,495,0,3,1,3,0,1,0,76.14,69.90 ,33.33
03,011,01,019,0346,0,702,9,711,988,0,3,1,3,0,1,0,76.14,71.96 ,33.33
03,011,01,019,0347,0,910,4,914,1254,0,3,1,3,0,1,0,76.14,72.89 ,33.33
03,011,01,019,0348,0,1396,34,1430,1934,0,3,1,3,0,1,0,76.14,73.94 ,33.33
03,011,01,019,0349,0,564,10,574,794,0,3,1,3,0,1,0,76.14,72.29 ,33.33
03,011,01,019,0350,0,1126,19,1145,1586,0,3,1,3,0,1,0,76.14,72.19 ,33.33
03,011,01,019,0351,0,462,7,469,677,0,3,1,3,0,1,0,76.14,69.28 ,33.33
03,011,01,019,0352,0,727,9,736,1039,0,3,1,3,0,1,0,76.14,70.84 ,33.33
03,011,01,019,0353,0,1124,9,1133,1668,0,3,1,3,0,1,0,76.14,67.93 ,33.33
03,011,01,019,0354,0,531,11,542,778,0,3,1,3,0,1,0,76.14,69.67 ,33.33
03,011,01,019,0355,0,632,10,642,957,0,3,1,3,0,1,0,76.14,67.08 ,33.33
03,011,01,019,0356,0,952,12,964,1375,0,3,1,3,0,1,0,76.14,70.11 ,33.33
03,011,01,019,0357,0,950,13,963,1337,0,3,1,3,0,1,0,76.14,72.03 ,33.33
03,011,01,019,0358,0,701,6,707,971,0,3,1,3,0,1,0,76.14,72.81 ,33.33
03,011,01,019,0359,0,1552,23,1575,2166,0,3,1,3,0,1,0,76.14,72.71 ,33.33
03,011,01,020,0360,0,1303,19,1322,1945,0,3,1,3,0,1,0,76.14,67.97 ,33.33
03,011,01,020,0361,0,3027,42,3069,4442,0,3,1,3,0,1,0,76.14,69.09 ,33.33
03,011,01,020,0362,0,1191,13,1204,1643,0,3,1,3,0,1,0,76.14,73.28 ,33.33
03,011,01,020,0363,0,467,2,469,610,0,3,1,3,0,1,0,76.14,76.89 ,33.33
03,011,01,020,0364,0,532,7,539,816,0,3,1,3,0,1,0,76.14,66.05 ,33.33
03,011,01,020,0365,0,620,9,629,881,0,3,1,3,0,1,0,76.14,71.40 ,33.33
03,011,01,020,0366,0,1422,16,1438,1929,0,3,1,3,0,1,0,76.14,74.55 ,33.33
03,011,01,020,0367,0,1765,26,1791,2673,0,3,1,3,0,1,0,76.14,67.00 ,33.33
03,011,01,020,0368,0,911,18,929,1338,0,3,1,3,0,1,0,76.14,69.43 ,33.33
03,011,01,020,0369,0,1666,28,1694,2432,0,3,1,3,0,1,0,76.14,69.65 ,33.33
03,011,01,020,0370,0,893,15,908,1195,0,3,1,3,0,1,0,76.14,75.98 ,33.33
03,011,01,021,0371,0,1474,12,1486,1983,0,3,1,3,0,1,0,76.14,74.94 ,33.33
03,011,01,021,0372,0,1169,18,1187,1638,0,3,1,3,0,1,0,76.14,72.47 ,33.33
03,011,01,021,0373,0,928,11,939,1275,0,3,1,3,0,1,0,76.14,73.65 ,33.33
03,011,01,021,0374,0,835,8,843,1121,0,3,1,3,0,1,0,76.14,75.20 ,33.33
03,011,01,021,0375,0,516,6,522,687,0,3,1,3,0,1,0,76.14,75.98 ,33.33
03,011,01,021,0376,0,971,11,982,1329,0,3,1,3,0,1,0,76.14,73.89 ,33.33
03,011,01,021,0377,0,728,11,739,968,0,3,1,3,0,1,0,76.14,76.34 ,33.33
03,011,01,021,0378,0,1327,17,1344,1855,0,3,1,3,0,1,0,76.14,72.45 ,33.33
03,011,01,021,0379,0,1402,17,1419,1941,0,3,1,3,0,1,0,76.14,73.11 ,33.33
03,011,01,021,0380,0,439,9,448,585,0,3,1,3,0,1,0,76.14,76.58 ,33.33
03,011,01,021,0381,0,905,12,917,1247,0,3,1,3,0,1,0,76.14,73.54 ,33.33
03,011,01,021,0382,0,507,2,509,689,0,3,1,3,0,1,0,76.14,73.88 ,33.33
03,011,01,021,0383,0,1103,10,1113,1466,0,3,1,3,0,1,0,76.14,75.92 ,33.33
03,011,01,021,0384,0,1458,17,1475,1926,0,3,1,3,0,1,0,76.14,76.58 ,33.33
03,011,01,021,0385,0,646,9,655,887,0,3,1,3,0,1,0,76.14,73.84 ,33.33
03,011,01,021,0386,0,349,4,353,437,0,3,1,3,0,1,0,76.14,80.78 ,33.33
03,011,01,022,0387,0,1151,9,1160,1631,0,3,1,3,0,1,0,76.14,71.12 ,33.33
03,011,01,022,0388,0,1037,11,1048,1460,0,3,1,3,0,1,0,76.14,71.78 ,33.33
03,011,01,022,0389,0,605,14,619,860,0,3,1,3,0,1,0,76.14,71.98 ,33.33
03,011,01,022,0390,0,450,3,453,661,0,3,1,3,0,1,0,76.14,68.53 ,33.33
03,011,01,022,0391,0,413,4,417,567,0,3,1,3,0,1,0,76.14,73.54 ,33.33
03,011,01,022,0392,0,292,2,294,369,0,3,1,3,0,1,0,76.14,79.67 ,33.33
03,011,01,022,0393,0,224,3,227,307,0,3,1,3,0,1,0,76.14,73.94 ,33.33
03,011,01,023,0394,0,732,6,738,1054,0,3,1,3,0,1,0,76.14,70.02 ,33.33
03,011,01,023,0395,0,2707,23,2730,3986,0,3,1,3,0,1,0,76.14,68.49 ,33.33
03,011,01,023,0396,0,882,9,891,1282,0,3,1,3,0,1,0,76.14,69.50 ,33.33
03,011,01,023,0397,0,833,7,840,1260,0,3,1,3,0,1,0,76.14,66.67 ,33.33
03,011,01,023,0398,0,339,5,344,496,0,3,1,3,0,1,0,76.14,69.35 ,33.33
03,011,01,023,0399,0,308,2,310,501,0,3,1,3,0,1,0,76.14,61.88 ,33.33
03,011,01,023,0400,0,556,5,561,772,0,3,1,3,0,1,0,76.14,72.67 ,33.33
03,011,01,023,0401,0,1025,10,1035,1523,0,3,1,3,0,1,0,76.14,67.96 ,33.33
03,011,01,023,0402,0,514,2,516,710,0,3,1,3,0,1,0,76.14,72.68 ,33.33
03,011,01,023,0403,0,737,6,743,1073,0,3,1,3,0,1,0,76.14,69.25 ,33.33
03,011,01,024,0404,0,1211,10,1221,1872,0,3,1,3,0,1,0,76.14,65.22 ,33.33
03,011,01,024,0405,0,814,12,826,1305,0,3,1,3,0,1,0,76.14,63.30 ,33.33
03,011,01,024,0406,0,583,11,594,903,0,3,1,3,0,1,0,76.14,65.78 ,33.33
03,011,01,024,0407,0,664,3,667,1102,0,3,1,3,0,1,0,76.14,60.53 ,33.33
03,011,01,024,0408,0,743,11,754,1108,0,3,1,3,0,1,0,76.14,68.05 ,33.33
03,011,01,024,0409,0,466,4,470,689,0,3,1,3,0,1,0,76.14,68.21 ,33.33
03,011,01,024,0410,0,1481,17,1498,2236,0,3,1,3,0,1,0,76.14,66.99 ,33.33
03,011,01,025,0411,0,932,13,945,1404,0,3,1,3,0,1,0,76.14,67.31 ,33.33
03,011,01,025,0412,0,548,5,553,789,0,3,1,3,0,1,0,76.14,70.09 ,33.33
03,011,01,025,0413,0,360,5,365,493,0,3,1,3,0,1,0,76.14,74.04 ,33.33
03,011,01,025,0414,0,385,3,388,550,0,3,1,3,0,1,0,76.14,70.55 ,33.33
03,011,01,025,0415,0,397,10,407,670,0,3,1,3,0,1,0,76.14,60.75 ,33.33
03,011,01,025,0416,0,571,8,579,846,0,3,1,3,0,1,0,76.14,68.44 ,33.33
03,011,01,025,0417,0,815,6,821,1184,0,3,1,3,0,1,0,76.14,69.34 ,33.33
03,011,01,025,0418,0,668,3,671,921,0,3,1,3,0,1,0,76.14,72.86 ,33.33
03,011,01,025,0419,0,260,5,265,518,0,3,1,3,0,1,0,76.14,51.16 ,33.33
03,011,01,026,0420,0,319,9,328,489,0,3,1,3,0,1,0,76.14,67.08 ,33.33
03,011,01,026,0421,0,488,7,495,747,0,3,1,3,0,1,0,76.14,66.27 ,33.33
03,011,01,026,0422,0,382,7,389,549,0,3,1,3,0,1,0,76.14,70.86 ,33.33
03,011,01,026,0423,0,681,5,686,916,0,3,1,3,0,1,0,76.14,74.89 ,33.33
03,011,01,026,0424,0,258,1,259,333,0,3,1,3,0,1,0,76.14,77.78 ,33.33
03,011,01,026,0425,0,331,6,337,481,0,3,1,3,0,1,0,76.14,70.06 ,33.33
03,011,01,026,0426,0,290,6,296,431,0,3,1,3,0,1,0,76.14,68.68 ,33.33
03,011,01,026,0427,0,220,2,222,303,0,3,1,3,0,1,0,76.14,73.27 ,33.33
03,011,01,026,0428,0,156,2,158,217,0,3,1,3,0,1,0,76.14,72.81 ,33.33
03,011,01,026,0429,0,381,6,387,606,0,3,1,3,0,1,0,76.14,63.86 ,33.33
03,011,01,027,0430,0,2500,27,2527,3620,0,3,1,3,0,1,0,76.14,69.81 ,33.33
03,011,01,027,0431,0,1431,11,1442,2049,0,3,1,3,0,1,0,76.14,70.38 ,33.33
03,011,01,027,0432,0,1006,13,1019,1519,0,3,1,3,0,1,0,76.14,67.08 ,33.33
03,011,01,027,0433,0,2097,26,2123,3202,0,3,1,3,0,1,0,76.14,66.30 ,33.33
03,011,01,027,0434,0,3575,49,3624,5246,0,3,1,3,0,1,0,76.14,69.08 ,33.33
03,011,01,027,0435,0,1365,18,1383,2068,0,3,1,3,0,1,0,76.14,66.88 ,33.33
03,011,01,027,0436,0,2937,52,2989,4724,0,3,1,3,0,1,0,76.14,63.27 ,33.33
03,011,01,027,0437,0,2065,37,2102,3230,0,3,1,3,0,1,0,76.14,65.08 ,33.33
03,011,01,027,0438,0,855,15,870,1162,0,3,1,3,0,1,0,76.14,74.87 ,33.33
03,011,01,027,0439,0,451,5,456,625,0,3,1,3,0,1,0,76.14,72.96 ,33.33
03,011,01,027,0440,0,1250,12,1262,1949,0,3,1,3,0,1,0,76.14,64.75 ,33.33
03,011,01,027,0441,0,2275,42,2317,3468,0,3,1,3,0,1,0,76.14,66.81 ,33.33
03,011,01,027,0442,0,868,20,888,1249,0,3,1,3,0,1,0,76.14,71.10 ,33.33
03,011,01,027,0443,0,1351,18,1369,1964,0,3,1,3,0,1,0,76.14,69.70 ,33.33
03,011,01,027,0444,0,1251,28,1279,1897,0,3,1,3,0,1,0,76.14,67.42 ,33.33
03,011,01,027,0445,0,1240,21,1261,1763,0,3,1,3,0,1,0,76.14,71.53 ,33.33
03,011,01,027,0446,0,727,6,733,1219,0,3,1,3,0,1,0,76.14,60.13 ,33.33
03,011,01,027,0447,0,827,14,841,1307,0,3,1,3,0,1,0,76.14,64.35 ,33.33
03,011,01,028,0448,0,2560,39,2599,3667,0,3,1,3,0,1,0,76.14,70.88 ,33.33
03,011,01,028,0449,0,1433,19,1452,2141,0,3,1,3,0,1,0,76.14,67.82 ,33.33
03,011,01,028,0450,0,2927,37,2964,4344,0,3,1,3,0,1,0,76.14,68.23 ,33.33
03,011,01,028,0451,0,2935,24,2959,4258,0,3,1,3,0,1,0,76.14,69.49 ,33.33
03,011,01,028,0452,0,2626,31,2657,3917,0,3,1,3,0,1,0,76.14,67.83 ,33.33
03,011,01,028,0453,0,1716,12,1728,2381,0,3,1,3,0,1,0,76.14,72.57 ,33.33
03,011,01,028,0454,0,859,9,868,1200,0,3,1,3,0,1,0,76.14,72.33 ,33.33
03,011,01,028,0455,0,857,17,874,1194,0,3,1,3,0,1,0,76.14,73.20 ,33.33
03,011,01,028,0456,0,1236,9,1245,1624,0,3,1,3,0,1,0,76.14,76.66 ,33.33
03,011,01,028,0457,0,334,4,338,484,0,3,1,3,0,1,0,76.14,69.83 ,33.33
03,011,01,028,0458,0,1091,11,1102,1545,0,3,1,3,0,1,0,76.14,71.33 ,33.33
03,011,01,028,0459,0,746,17,763,1348,0,3,1,3,0,1,0,76.14,56.60 ,33.33
03,011,01,028,0460,0,1092,12,1104,1604,0,3,1,3,0,1,0,76.14,68.83 ,33.33
03,011,01,028,0461,0,1201,9,1210,1697,0,3,1,3,0,1,0,76.14,71.30 ,33.33
03,011,01,028,0462,0,960,8,968,1397,0,3,1,3,0,1,0,76.14,69.29 ,33.33
03,011,01,028,0463,0,1147,17,1164,1652,0,3,1,3,0,1,0,76.14,70.46 ,33.33
03,011,01,028,0464,0,887,15,902,1226,0,3,1,3,0,1,0,76.14,73.57 ,33.33
03,011,01,028,0465,0,1342,29,1371,1917,0,3,1,3,0,1,0,76.14,71.52 ,33.33
03,011,01,029,0466,0,1246,10,1256,1743,0,3,1,3,0,1,0,76.14,72.06 ,33.33
03,011,01,029,0467,0,1195,10,1205,1685,0,3,1,3,0,1,0,76.14,71.51 ,33.33
03,011,01,029,0468,0,2324,23,2347,3419,0,3,1,3,0,1,0,76.14,68.65 ,33.33
03,011,01,029,0469,0,1649,20,1669,2464,0,3,1,3,0,1,0,76.14,67.74 ,33.33
03,011,01,029,0470,0,538,4,542,758,0,3,1,3,0,1,0,76.14,71.50 ,33.33
03,011,01,029,0471,0,531,7,538,794,0,3,1,3,0,1,0,76.14,67.76 ,33.33
03,011,01,029,0472,0,1614,22,1636,2255,0,3,1,3,0,1,0,76.14,72.55 ,33.33
03,011,01,029,0473,0,1754,13,1767,2562,0,3,1,3,0,1,0,76.14,68.97 ,33.33
03,011,01,029,0474,0,1301,13,1314,1885,0,3,1,3,0,1,0,76.14,69.71 ,33.33
03,011,01,029,0475,0,878,11,889,1278,0,3,1,3,0,1,0,76.14,69.56 ,33.33
03,011,01,029,0476,0,1450,15,1465,2075,0,3,1,3,0,1,0,76.14,70.60 ,33.33
03,011,01,029,0477,0,1049,9,1058,1412,0,3,1,3,0,1,0,76.14,74.93 ,33.33
03,011,01,029,0478,0,768,10,778,1170,0,3,1,3,0,1,0,76.14,66.50 ,33.33
03,011,01,029,0479,0,513,5,518,774,0,3,1,3,0,1,0,76.14,66.93 ,33.33
03,011,01,029,0480,0,526,5,531,719,0,3,1,3,0,1,0,76.14,73.85 ,33.33
03,011,01,029,0481,0,924,7,931,1335,0,3,1,3,0,1,0,76.14,69.74 ,33.33
03,011,01,029,0482,0,299,6,305,396,0,3,1,3,0,1,0,76.14,77.02 ,33.33
03,011,01,030,0483,0,811,8,819,1200,0,3,1,3,0,1,0,76.14,68.25 ,33.33
03,011,01,030,0484,0,501,6,507,693,0,3,1,3,0,1,0,76.14,73.16 ,33.33
03,011,01,030,0485,0,111,1,112,202,0,3,1,3,0,1,0,76.14,55.45 ,33.33
03,011,01,030,0486,0,224,4,228,306,0,3,1,3,0,1,0,76.14,74.51 ,33.33
03,011,01,030,0487,0,213,2,215,285,0,3,1,3,0,1,0,76.14,75.44 ,33.33
03,011,01,030,0488,0,230,0,230,325,0,3,1,3,0,1,0,76.14,70.77 ,33.33
03,011,01,030,0489,0,322,2,324,437,0,3,1,3,0,1,0,76.14,74.14 ,33.33
03,011,01,030,0490,0,253,3,256,393,0,3,1,3,0,1,0,76.14,65.14 ,33.33
03,011,01,031,0491,0,2063,22,2085,3427,0,3,1,3,0,1,0,76.14,60.84 ,33.33
03,011,01,031,0492,0,1368,29,1397,2229,0,3,1,3,0,1,0,76.14,62.67 ,33.33
03,011,01,031,0493,0,1117,18,1135,1779,0,3,1,3,0,1,0,76.14,63.80 ,33.33
03,011,01,031,0494,0,1754,23,1777,2872,0,3,1,3,0,1,0,76.14,61.87 ,33.33
03,011,01,031,0495,0,2712,28,2740,4339,0,3,1,3,0,1,0,76.14,63.15 ,33.33
03,011,01,031,0496,0,3033,29,3062,4611,0,3,1,3,0,1,0,76.14,66.41 ,33.33
03,011,01,031,0497,0,2346,41,2387,3419,0,3,1,3,0,1,0,76.14,69.82 ,33.33
03,011,01,031,0498,0,2970,32,3002,4537,0,3,1,3,0,1,0,76.14,66.17 ,33.33
03,011,01,031,0499,0,2181,30,2211,3564,0,3,1,3,0,1,0,76.14,62.04 ,33.33
03,011,01,031,0500,0,1398,19,1417,2182,0,3,1,3,0,1,0,76.14,64.94 ,33.33
03,011,01,031,0501,0,1269,25,1294,2110,0,3,1,3,0,1,0,76.14,61.33 ,33.33
03,011,01,031,0502,0,1229,22,1251,2083,0,3,1,3,0,1,0,76.14,60.06 ,33.33
03,011,01,031,0503,0,822,11,833,1171,0,3,1,3,0,1,0,76.14,71.14 ,33.33
03,011,01,031,0504,0,729,9,738,1010,0,3,1,3,0,1,0,76.14,73.07 ,33.33
03,011,01,031,0505,0,3262,48,3310,4921,0,3,1,3,0,1,0,76.14,67.26 ,33.33
03,011,01,031,0506,0,2196,37,2233,3245,0,3,1,3,0,1,0,76.14,68.81 ,33.33
03,011,01,031,0507,0,1501,11,1512,2228,0,3,1,3,0,1,0,76.14,67.86 ,33.33
03,011,01,031,0508,0,1734,19,1753,2655,0,3,1,3,0,1,0,76.14,66.03 ,33.33
03,011,01,031,0509,0,2809,42,2851,4405,0,3,1,3,0,1,0,76.14,64.72 ,33.33
03,011,01,031,0510,0,1029,12,1041,1506,0,3,1,3,0,1,0,76.14,69.12 ,33.33
03,011,01,031,0511,0,789,6,795,1162,0,3,1,3,0,1,0,76.14,68.42 ,33.33
03,011,01,031,0512,0,2094,38,2132,3082,0,3,1,3,0,1,0,76.14,69.18 ,33.33
03,011,01,031,0513,0,769,11,780,1133,0,3,1,3,0,1,0,76.14,68.84 ,33.33
03,011,01,031,0514,0,1950,25,1975,2694,0,3,1,3,0,1,0,76.14,73.31 ,33.33
03,011,01,031,0515,0,1873,20,1893,2742,0,3,1,3,0,1,0,76.14,69.04 ,33.33
03,011,01,031,0516,0,2535,43,2578,3789,0,3,1,3,0,1,0,76.14,68.04 ,33.33
03,011,01,031,0517,0,2258,19,2277,3152,0,3,1,3,0,1,0,76.14,72.24 ,33.33
03,011,01,031,0518,0,2813,46,2859,4325,0,3,1,3,0,1,0,76.14,66.10 ,33.33
03,011,01,031,0519,0,2647,36,2683,3999,0,3,1,3,0,1,0,76.14,67.09 ,33.33
03,011,01,031,0520,0,1331,32,1363,1947,0,3,1,3,0,1,0,76.14,70.01 ,33.33
03,011,01,031,0521,0,1530,26,1556,2098,0,3,1,3,0,1,0,76.14,74.17 ,33.33
03,011,01,031,0522,0,1272,11,1283,1894,0,3,1,3,0,1,0,76.14,67.74 ,33.33
03,011,01,031,0523,0,3543,51,3594,5929,0,3,1,3,0,1,0,76.14,60.62 ,33.33
03,011,01,031,0524,0,904,15,919,1259,0,3,1,3,0,1,0,76.14,72.99 ,33.33
03,011,01,031,0525,0,1270,15,1285,1826,0,3,1,3,0,1,0,76.14,70.37 ,33.33
03,011,01,031,0526,0,1619,25,1644,2360,0,3,1,3,0,1,0,76.14,69.66 ,33.33
03,011,01,031,0527,0,986,5,991,1597,0,3,1,3,0,1,0,76.14,62.05 ,33.33
03,011,01,031,0528,0,1727,30,1757,2726,0,3,1,3,0,1,0,76.14,64.45 ,33.33
03,011,01,031,0529,0,2441,31,2472,3997,0,3,1,3,0,1,0,76.14,61.85 ,33.33
03,012,01,001,0001,0,980,11,991,1444,0,3,1,3,0,1,0,76.14,68.63 ,33.33
03,012,01,001,0002,0,584,6,590,924,0,3,1,3,0,1,0,76.14,63.85 ,33.33
03,012,01,001,0003,0,1536,16,1552,2305,0,3,1,3,0,1,0,76.14,67.33 ,33.33
03,012,01,001,0004,0,3359,34,3393,5163,0,3,1,3,0,1,0,76.14,65.72 ,33.33
03,012,01,001,0005,0,2727,43,2770,4161,0,3,1,3,0,1,0,76.14,66.57 ,33.33
03,012,01,001,0006,0,3549,38,3587,5709,0,3,1,3,0,1,0,76.14,62.83 ,33.33
03,012,01,001,0007,0,1506,16,1522,2280,0,3,1,3,0,1,0,76.14,66.75 ,33.33
03,012,01,001,0008,0,1353,13,1366,2085,0,3,1,3,0,1,0,76.14,65.52 ,33.33
03,012,01,001,0009,0,2783,22,2805,4219,0,3,1,3,0,1,0,76.14,66.48 ,33.33
03,012,01,001,0010,0,2725,28,2753,4162,0,3,1,3,0,1,0,76.14,66.15 ,33.33
03,012,01,001,0011,0,4836,51,4887,8030,0,3,1,3,0,1,0,76.14,60.86 ,33.33
03,012,01,001,0012,0,681,10,691,949,0,3,1,3,0,1,0,76.14,72.81 ,33.33
03,012,01,001,0013,0,387,3,390,549,0,3,1,3,0,1,0,76.14,71.04 ,33.33
03,012,01,001,0014,0,1016,18,1034,1492,0,3,1,3,0,1,0,76.14,69.30 ,33.33
03,012,01,001,0015,0,1113,12,1125,1642,0,3,1,3,0,1,0,76.14,68.51 ,33.33
03,012,01,001,0016,0,3118,24,3142,4644,0,3,1,3,0,1,0,76.14,67.66 ,33.33
03,012,01,001,0017,0,714,11,725,1064,0,3,1,3,0,1,0,76.14,68.14 ,33.33
03,012,01,001,0018,0,784,13,797,1181,0,3,1,3,0,1,0,76.14,67.49 ,33.33
03,012,01,001,0019,0,799,9,808,1128,0,3,1,3,0,1,0,76.14,71.63 ,33.33
03,012,01,001,0020,0,2566,20,2586,3816,0,3,1,3,0,1,0,76.14,67.77 ,33.33
03,012,01,001,0021,0,559,8,567,831,0,3,1,3,0,1,0,76.14,68.23 ,33.33
03,012,01,001,0022,0,2441,41,2482,3618,0,3,1,3,0,1,0,76.14,68.60 ,33.33
03,012,01,001,0023,0,2022,21,2043,3130,0,3,1,3,0,1,0,76.14,65.27 ,33.33
03,012,01,001,0024,0,2877,35,2912,4437,0,3,1,3,0,1,0,76.14,65.63 ,33.33
03,012,01,001,0025,0,2254,20,2274,3228,0,3,1,3,0,1,0,76.14,70.45 ,33.33
03,012,01,001,0026,0,893,7,900,1157,0,3,1,3,0,1,0,76.14,77.79 ,33.33
03,012,01,001,0027,0,479,2,481,649,0,3,1,3,0,1,0,76.14,74.11 ,33.33
03,012,01,001,0028,0,1053,17,1070,1454,0,3,1,3,0,1,0,76.14,73.59 ,33.33
03,012,01,001,0029,0,1441,13,1454,2283,0,3,1,3,0,1,0,76.14,63.69 ,33.33
03,012,01,001,0030,0,3174,51,3225,4743,0,3,1,3,0,1,0,76.14,67.99 ,33.33
03,012,01,001,0031,0,1512,18,1530,2316,0,3,1,3,0,1,0,76.14,66.06 ,33.33
03,012,01,001,0032,0,2262,25,2287,3376,0,3,1,3,0,1,0,76.14,67.74 ,33.33
03,012,01,001,0033,0,3075,27,3102,4698,0,3,1,3,0,1,0,76.14,66.03 ,33.33
03,012,01,001,0034,0,2392,36,2428,3628,0,3,1,3,0,1,0,76.14,66.92 ,33.33
03,012,01,001,0035,0,2841,36,2877,4215,0,3,1,3,0,1,0,76.14,68.26 ,33.33
03,012,01,001,0036,0,753,11,764,989,0,3,1,3,0,1,0,76.14,77.25 ,33.33
03,012,01,001,0037,0,1550,19,1569,2166,0,3,1,3,0,1,0,76.14,72.44 ,33.33
03,012,01,001,0038,0,2839,41,2880,4112,0,3,1,3,0,1,0,76.14,70.04 ,33.33
03,012,01,001,0039,0,2066,15,2081,2678,0,3,1,3,0,1,0,76.14,77.71 ,33.33
03,012,01,001,0040,0,2389,30,2419,3594,0,3,1,3,0,1,0,76.14,67.31 ,33.33
03,012,01,001,0041,0,2621,24,2645,4044,0,3,1,3,0,1,0,76.14,65.41 ,33.33
03,012,01,001,0042,0,1865,26,1891,3157,0,3,1,3,0,1,0,76.14,59.90 ,33.33
03,012,01,001,0043,0,3194,46,3240,5249,0,3,1,3,0,1,0,76.14,61.73 ,33.33
03,012,01,001,0044,0,4051,61,4112,7110,0,3,1,3,0,1,0,76.14,57.83 ,33.33
03,012,01,001,0045,0,1989,25,2014,2991,0,3,1,3,0,1,0,76.14,67.34 ,33.33
03,012,01,001,0046,0,3069,46,3115,5288,0,3,1,3,0,1,0,76.14,58.91 ,33.33
03,012,01,001,0047,0,3636,55,3691,5892,0,3,1,3,0,1,0,76.14,62.64 ,33.33
03,012,01,001,0048,0,1361,26,1387,2116,0,3,1,3,0,1,0,76.14,65.55 ,33.33
03,012,01,001,0049,0,3233,54,3287,5128,0,3,1,3,0,1,0,76.14,64.10 ,33.33
03,012,01,001,0050,0,3562,51,3613,5656,0,3,1,3,0,1,0,76.14,63.88 ,33.33
03,012,01,001,0051,0,3676,44,3720,5666,0,3,1,3,0,1,0,76.14,65.65 ,33.33
03,012,01,001,0052,0,4183,62,4245,6761,0,3,1,3,0,1,0,76.14,62.79 ,33.33
03,012,01,001,0053,0,3563,49,3612,5514,0,3,1,3,0,1,0,76.14,65.51 ,33.33
03,012,01,001,0054,0,2279,23,2302,3492,0,3,1,3,0,1,0,76.14,65.92 ,33.33
03,012,01,001,0055,0,1777,25,1802,2879,0,3,1,3,0,1,0,76.14,62.59 ,33.33
03,012,01,001,0056,0,2161,30,2191,3245,0,3,1,3,0,1,0,76.14,67.52 ,33.33
03,012,01,001,0057,0,3437,45,3482,5270,0,3,1,3,0,1,0,76.14,66.07 ,33.33
03,012,01,001,0058,0,2523,29,2552,4152,0,3,1,3,0,1,0,76.14,61.46 ,33.33
03,012,01,002,0059,0,3266,43,3309,4724,0,3,1,3,0,1,0,76.14,70.05 ,33.33
03,012,01,002,0060,0,2615,25,2640,4026,0,3,1,3,0,1,0,76.14,65.57 ,33.33
03,012,01,002,0061,0,2843,52,2895,4316,0,3,1,3,0,1,0,76.14,67.08 ,33.33
03,012,01,002,0062,0,1515,16,1531,2110,0,3,1,3,0,1,0,76.14,72.56 ,33.33
03,012,01,002,0063,0,1747,37,1784,2444,0,3,1,3,0,1,0,76.14,73.00 ,33.33
03,012,01,002,0064,0,1216,18,1234,1690,0,3,1,3,0,1,0,76.14,73.02 ,33.33
03,012,01,002,0065,0,3221,59,3280,4560,0,3,1,3,0,1,0,76.14,71.93 ,33.33
03,012,01,002,0066,0,1004,13,1017,1279,0,3,1,3,0,1,0,76.14,79.52 ,33.33
03,012,01,002,0067,0,990,15,1005,1411,0,3,1,3,0,1,0,76.14,71.23 ,33.33
03,012,01,002,0068,0,1320,29,1349,1776,0,3,1,3,0,1,0,76.14,75.96 ,33.33
03,012,01,002,0069,0,1884,28,1912,2686,0,3,1,3,0,1,0,76.14,71.18 ,33.33
03,012,01,002,0070,0,1084,12,1096,1494,0,3,1,3,0,1,0,76.14,73.36 ,33.33
03,012,01,002,0071,0,821,11,832,1124,0,3,1,3,0,1,0,76.14,74.02 ,33.33
03,012,01,002,0072,0,1667,21,1688,2318,0,3,1,3,0,1,0,76.14,72.82 ,33.33
03,012,01,002,0073,0,1175,11,1186,1645,0,3,1,3,0,1,0,76.14,72.10 ,33.33
03,012,01,002,0074,0,1128,14,1142,1540,0,3,1,3,0,1,0,76.14,74.16 ,33.33
03,012,01,002,0075,0,641,12,653,897,0,3,1,3,0,1,0,76.14,72.80 ,33.33
03,012,01,002,0076,0,533,3,536,820,0,3,1,3,0,1,0,76.14,65.37 ,33.33
03,012,01,002,0077,0,2304,33,2337,3651,0,3,1,3,0,1,0,76.14,64.01 ,33.33
03,012,01,003,0078,0,1322,18,1340,1847,0,3,1,3,0,1,0,76.14,72.55 ,33.33
03,012,01,003,0079,0,843,8,851,1227,0,3,1,3,0,1,0,76.14,69.36 ,33.33
03,012,01,003,0080,0,945,13,958,1386,0,3,1,3,0,1,0,76.14,69.12 ,33.33
03,012,01,003,0081,0,4775,66,4841,7308,0,3,1,3,0,1,0,76.14,66.24 ,33.33
03,012,01,003,0082,0,2514,34,2548,4019,0,3,1,3,0,1,0,76.14,63.40 ,33.33
03,012,01,003,0083,0,1229,21,1250,1756,0,3,1,3,0,1,0,76.14,71.18 ,33.33
03,012,01,003,0084,0,1427,12,1439,1827,0,3,1,3,0,1,0,76.14,78.76 ,33.33
03,012,01,003,0085,0,1871,21,1892,2703,0,3,1,3,0,1,0,76.14,70.00 ,33.33
03,012,01,003,0086,0,3763,49,3812,5473,0,3,1,3,0,1,0,76.14,69.65 ,33.33
03,012,01,003,0087,0,1935,21,1956,2662,0,3,1,3,0,1,0,76.14,73.48 ,33.33
03,012,01,003,0088,0,1763,12,1775,2286,0,3,1,3,0,1,0,76.14,77.65 ,33.33
03,012,01,003,0089,0,3209,45,3254,4122,0,3,1,3,0,1,0,76.14,78.94 ,33.33
03,012,01,003,0090,0,3064,37,3101,4585,0,3,1,3,0,1,0,76.14,67.63 ,33.33
03,012,01,003,0091,0,2857,41,2898,4397,0,3,1,3,0,1,0,76.14,65.91 ,33.33
03,012,01,003,0092,0,2803,39,2842,4120,0,3,1,3,0,1,0,76.14,68.98 ,33.33
03,012,01,003,0093,0,2365,30,2395,3474,0,3,1,3,0,1,0,76.14,68.94 ,33.33
03,012,01,003,0094,0,1229,11,1240,1778,0,3,1,3,0,1,0,76.14,69.74 ,33.33
03,012,01,003,0095,0,2660,48,2708,4441,0,3,1,3,0,1,0,76.14,60.98 ,33.33
03,012,01,003,0096,0,756,8,764,1056,0,3,1,3,0,1,0,76.14,72.35 ,33.33
03,012,01,003,0097,0,1452,16,1468,2405,0,3,1,3,0,1,0,76.14,61.04 ,33.33
03,012,01,003,0098,0,786,11,797,1211,0,3,1,3,0,1,0,76.14,65.81 ,33.33
03,012,01,003,0099,0,898,11,909,1284,0,3,1,3,0,1,0,76.14,70.79 ,33.33
03,012,01,003,0100,0,1750,26,1776,2462,0,3,1,3,0,1,0,76.14,72.14 ,33.33
03,012,01,003,0101,0,886,16,902,1158,0,3,1,3,0,1,0,76.14,77.89 ,33.33
03,012,01,003,0102,0,1752,30,1782,2631,0,3,1,3,0,1,0,76.14,67.73 ,33.33
03,012,01,003,0103,0,1144,16,1160,1712,0,3,1,3,0,1,0,76.14,67.76 ,33.33
03,012,01,004,0104,0,1363,19,1382,1883,0,3,1,3,0,1,0,76.14,73.39 ,33.33
03,012,01,004,0105,0,2121,19,2140,2897,0,3,1,3,0,1,0,76.14,73.87 ,33.33
03,012,01,004,0106,0,2945,34,2979,3899,0,3,1,3,0,1,0,76.14,76.40 ,33.33
03,012,01,004,0107,0,1465,14,1479,2083,0,3,1,3,0,1,0,76.14,71.00 ,33.33
03,012,01,004,0108,0,1665,10,1675,2241,0,3,1,3,0,1,0,76.14,74.74 ,33.33
03,012,01,004,0109,0,1163,17,1180,1514,0,3,1,3,0,1,0,76.14,77.94 ,33.33
03,012,01,004,0110,0,856,15,871,1132,0,3,1,3,0,1,0,76.14,76.94 ,33.33
03,012,01,004,0111,0,1160,15,1175,1519,0,3,1,3,0,1,0,76.14,77.35 ,33.33
03,012,01,004,0112,0,1493,20,1513,2189,0,3,1,3,0,1,0,76.14,69.12 ,33.33
03,012,01,004,0113,0,2065,21,2086,2933,0,3,1,3,0,1,0,76.14,71.12 ,33.33
03,012,01,004,0114,0,730,3,733,1032,0,3,1,3,0,1,0,76.14,71.03 ,33.33
03,012,01,004,0115,0,674,9,683,959,0,3,1,3,0,1,0,76.14,71.22 ,33.33
03,012,01,004,0116,0,726,10,736,1001,0,3,1,3,0,1,0,76.14,73.53 ,33.33
03,012,01,004,0117,0,639,5,644,917,0,3,1,3,0,1,0,76.14,70.23 ,33.33
03,012,01,004,0118,0,824,6,830,1194,0,3,1,3,0,1,0,76.14,69.51 ,33.33
03,012,01,004,0119,0,1408,11,1419,1854,0,3,1,3,0,1,0,76.14,76.54 ,33.33
03,012,01,004,0120,0,1209,20,1229,1727,0,3,1,3,0,1,0,76.14,71.16 ,33.33
03,012,01,004,0121,0,507,6,513,694,0,3,1,3,0,1,0,76.14,73.92 ,33.33
03,012,01,005,0122,0,2449,50,2499,3532,0,3,1,3,0,1,0,76.14,70.75 ,33.33
03,012,01,005,0123,0,1799,25,1824,2557,0,3,1,3,0,1,0,76.14,71.33 ,33.33
03,012,01,005,0124,0,1072,32,1104,1684,0,3,1,3,0,1,0,76.14,65.56 ,33.33
03,012,01,005,0125,0,2139,41,2180,3219,0,3,1,3,0,1,0,76.14,67.72 ,33.33
03,012,01,005,0126,0,2483,32,2515,4032,0,3,1,3,0,1,0,76.14,62.38 ,33.33
03,012,01,005,0127,0,1182,22,1204,1587,0,3,1,3,0,1,0,76.14,75.87 ,33.33
03,012,01,005,0128,0,769,6,775,1167,0,3,1,3,0,1,0,76.14,66.41 ,33.33
03,012,01,005,0129,0,2862,39,2901,4523,0,3,1,3,0,1,0,76.14,64.14 ,33.33
03,012,01,005,0130,0,2102,27,2129,3240,0,3,1,3,0,1,0,76.14,65.71 ,33.33
03,012,01,005,0131,0,1604,26,1630,2266,0,3,1,3,0,1,0,76.14,71.93 ,33.33
03,012,01,005,0132,0,329,2,331,465,0,3,1,3,0,1,0,76.14,71.18 ,33.33
03,012,01,006,0133,0,590,8,598,861,0,3,1,3,0,1,0,76.14,69.45 ,33.33
03,012,01,006,0134,0,1018,10,1028,1369,0,3,1,3,0,1,0,76.14,75.09 ,33.33
03,012,01,006,0135,0,3599,44,3643,5701,0,3,1,3,0,1,0,76.14,63.90 ,33.33
03,012,01,006,0136,0,1679,32,1711,2365,0,3,1,3,0,1,0,76.14,72.35 ,33.33
03,012,01,006,0137,0,2699,35,2734,4007,0,3,1,3,0,1,0,76.14,68.23 ,33.33
03,012,01,006,0138,0,1764,29,1793,2671,0,3,1,3,0,1,0,76.14,67.13 ,33.33
03,012,01,006,0139,0,1579,26,1605,2261,0,3,1,3,0,1,0,76.14,70.99 ,33.33
03,012,01,006,0140,0,922,12,934,1258,0,3,1,3,0,1,0,76.14,74.24 ,33.33
03,012,01,007,0141,0,3341,31,3372,5119,0,3,1,3,0,1,0,76.14,65.87 ,33.33
03,012,01,007,0142,0,1095,16,1111,1527,0,3,1,3,0,1,0,76.14,72.76 ,33.33
03,012,01,007,0143,0,3442,42,3484,5328,0,3,1,3,0,1,0,76.14,65.39 ,33.33
03,012,01,007,0144,0,1557,13,1570,2160,0,3,1,3,0,1,0,76.14,72.69 ,33.33
03,012,01,007,0145,0,3121,40,3161,4766,0,3,1,3,0,1,0,76.14,66.32 ,33.33
03,012,01,007,0146,0,1803,32,1835,2689,0,3,1,3,0,1,0,76.14,68.24 ,33.33
03,012,01,007,0147,0,382,16,398,541,0,3,1,3,0,1,0,76.14,73.57 ,33.33
03,012,01,008,0148,0,2056,22,2078,3061,0,3,1,3,0,1,0,76.14,67.89 ,33.33
03,012,01,008,0149,0,959,15,974,1354,0,3,1,3,0,1,0,76.14,71.94 ,33.33
03,012,01,008,0150,0,1859,35,1894,2768,0,3,1,3,0,1,0,76.14,68.42 ,33.33
03,012,01,008,0151,0,961,17,978,1420,0,3,1,3,0,1,0,76.14,68.87 ,33.33
03,012,01,008,0152,0,818,9,827,1115,0,3,1,3,0,1,0,76.14,74.17 ,33.33
03,012,01,008,0153,0,840,1,841,1122,0,3,1,3,0,1,0,76.14,74.96 ,33.33
03,012,01,008,0154,0,1232,20,1252,1778,0,3,1,3,0,1,0,76.14,70.42 ,33.33
03,012,01,008,0155,0,1741,24,1765,2509,0,3,1,3,0,1,0,76.14,70.35 ,33.33
03,012,01,008,0156,0,1638,22,1660,2444,0,3,1,3,0,1,0,76.14,67.92 ,33.33
03,012,01,008,0157,0,1771,20,1791,2629,0,3,1,3,0,1,0,76.14,68.12 ,33.33
03,012,01,008,0158,0,1721,22,1743,2501,0,3,1,3,0,1,0,76.14,69.69 ,33.33
03,012,01,008,0159,0,438,4,442,547,0,3,1,3,0,1,0,76.14,80.80 ,33.33
03,012,01,008,0160,0,1637,19,1656,2451,0,3,1,3,0,1,0,76.14,67.56 ,33.33
03,012,01,008,0161,0,1044,11,1055,1448,0,3,1,3,0,1,0,76.14,72.86 ,33.33
03,012,01,008,0162,0,2215,23,2238,3196,0,3,1,3,0,1,0,76.14,70.03 ,33.33
03,012,01,008,0163,0,2053,25,2078,2915,0,3,1,3,0,1,0,76.14,71.29 ,33.33
03,012,01,008,0164,0,853,5,858,1156,0,3,1,3,0,1,0,76.14,74.22 ,33.33
03,012,01,008,0165,0,2550,32,2582,3698,0,3,1,3,0,1,0,76.14,69.82 ,33.33
03,012,01,008,0166,0,1240,15,1255,1770,0,3,1,3,0,1,0,76.14,70.90 ,33.33
03,012,01,008,0167,0,845,10,855,1201,0,3,1,3,0,1,0,76.14,71.19 ,33.33
03,012,01,008,0168,0,496,4,500,673,0,3,1,3,0,1,0,76.14,74.29 ,33.33
03,012,01,008,0169,0,852,13,865,1187,0,3,1,3,0,1,0,76.14,72.87 ,33.33
03,012,01,008,0170,0,661,7,668,970,0,3,1,3,0,1,0,76.14,68.87 ,33.33
03,012,01,008,0171,0,1979,34,2013,2949,0,3,1,3,0,1,0,76.14,68.26 ,33.33
03,012,01,008,0172,0,1121,19,1140,1445,0,3,1,3,0,1,0,76.14,78.89 ,33.33
03,012,01,008,0173,0,540,10,550,722,0,3,1,3,0,1,0,76.14,76.18 ,33.33
03,012,01,008,0174,0,950,10,960,1253,0,3,1,3,0,1,0,76.14,76.62 ,33.33
03,012,01,008,0175,0,510,5,515,694,0,3,1,3,0,1,0,76.14,74.21 ,33.33
03,012,01,008,0176,0,599,9,608,838,0,3,1,3,0,1,0,76.14,72.55 ,33.33
03,012,01,008,0177,0,730,7,737,984,0,3,1,3,0,1,0,76.14,74.90 ,33.33
03,012,01,008,0178,0,686,13,699,919,0,3,1,3,0,1,0,76.14,76.06 ,33.33
03,012,01,008,0179,0,1577,10,1587,2151,0,3,1,3,0,1,0,76.14,73.78 ,33.33
03,012,01,008,0180,0,1088,10,1098,1421,0,3,1,3,0,1,0,76.14,77.27 ,33.33
03,012,01,008,0181,0,1120,12,1132,1446,0,3,1,3,0,1,0,76.14,78.28 ,33.33
03,012,01,008,0182,0,357,2,359,468,0,3,1,3,0,1,0,76.14,76.71 ,33.33
03,012,01,009,0183,0,1081,15,1096,1493,0,3,1,3,0,1,0,76.14,73.41 ,33.33
03,012,01,009,0184,0,712,4,716,919,0,3,1,3,0,1,0,76.14,77.91 ,33.33
03,012,01,009,0185,0,261,3,264,357,0,3,1,3,0,1,0,76.14,73.95 ,33.33
03,012,01,009,0186,0,1590,17,1607,2209,0,3,1,3,0,1,0,76.14,72.75 ,33.33
03,012,01,009,0187,0,1383,17,1400,1897,0,3,1,3,0,1,0,76.14,73.80 ,33.33
03,012,01,009,0188,0,1892,20,1912,2606,0,3,1,3,0,1,0,76.14,73.37 ,33.33
03,012,01,009,0189,0,930,7,937,1224,0,3,1,3,0,1,0,76.14,76.55 ,33.33
03,012,01,009,0190,0,1344,23,1367,1869,0,3,1,3,0,1,0,76.14,73.14 ,33.33
03,012,01,009,0191,0,1413,20,1433,1995,0,3,1,3,0,1,0,76.14,71.83 ,33.33
03,012,01,009,0192,0,595,15,610,874,0,3,1,3,0,1,0,76.14,69.79 ,33.33
03,012,01,009,0193,0,1695,21,1716,2220,0,3,1,3,0,1,0,76.14,77.30 ,33.33
03,012,01,009,0194,0,1293,12,1305,1716,0,3,1,3,0,1,0,76.14,76.05 ,33.33
03,012,01,009,0195,0,1068,21,1089,1464,0,3,1,3,0,1,0,76.14,74.39 ,33.33
03,012,01,009,0196,0,1420,17,1437,1922,0,3,1,3,0,1,0,76.14,74.77 ,33.33
03,012,01,009,0197,0,626,5,631,854,0,3,1,3,0,1,0,76.14,73.89 ,33.33
03,012,01,009,0198,0,973,14,987,1290,0,3,1,3,0,1,0,76.14,76.51 ,33.33
03,012,01,009,0199,0,465,0,465,610,0,3,1,3,0,1,0,76.14,76.23 ,33.33
03,012,01,010,0200,0,358,1,359,441,0,3,1,3,0,1,0,76.14,81.41 ,33.33
03,012,01,010,0201,0,733,17,750,1018,0,3,1,3,0,1,0,76.14,73.67 ,33.33
03,012,01,010,0202,0,1513,14,1527,2036,0,3,1,3,0,1,0,76.14,75.00 ,33.33
03,012,01,010,0203,0,2014,33,2047,2788,0,3,1,3,0,1,0,76.14,73.42 ,33.33
03,012,01,010,0204,0,1802,30,1832,2455,0,3,1,3,0,1,0,76.14,74.62 ,33.33
03,012,01,010,0205,0,1089,16,1105,1476,0,3,1,3,0,1,0,76.14,74.86 ,33.33
03,012,01,010,0206,0,3188,43,3231,4280,0,3,1,3,0,1,0,76.14,75.49 ,33.33
03,012,01,010,0207,0,1432,39,1471,2026,0,3,1,3,0,1,0,76.14,72.61 ,33.33
03,012,01,010,0208,0,1652,35,1687,2177,0,3,1,3,0,1,0,76.14,77.49 ,33.33
03,012,01,010,0209,0,1204,16,1220,1747,0,3,1,3,0,1,0,76.14,69.83 ,33.33
03,012,01,010,0210,0,1625,30,1655,2520,0,3,1,3,0,1,0,76.14,65.67 ,33.33
03,012,01,011,0211,0,266,1,267,382,0,3,1,3,0,1,0,76.14,69.90 ,33.33
03,012,01,011,0212,0,426,9,435,696,0,3,1,3,0,1,0,76.14,62.50 ,33.33
03,012,01,011,0213,0,746,7,753,1017,0,3,1,3,0,1,0,76.14,74.04 ,33.33
03,012,01,011,0214,0,286,4,290,426,0,3,1,3,0,1,0,76.14,68.08 ,33.33
03,012,01,011,0215,0,628,21,649,975,0,3,1,3,0,1,0,76.14,66.56 ,33.33
03,012,01,011,0216,0,944,16,960,1412,0,3,1,3,0,1,0,76.14,67.99 ,33.33
03,012,01,011,0217,0,292,6,298,434,0,3,1,3,0,1,0,76.14,68.66 ,33.33
03,012,01,011,0218,0,283,7,290,444,0,3,1,3,0,1,0,76.14,65.32 ,33.33
03,012,01,011,0219,0,460,12,472,695,0,3,1,3,0,1,0,76.14,67.91 ,33.33
03,012,01,011,0220,0,913,8,921,1289,0,3,1,3,0,1,0,76.14,71.45 ,33.33
03,012,01,012,0221,0,2292,39,2331,3630,0,3,1,3,0,1,0,76.14,64.21 ,33.33
03,012,01,012,0222,0,1663,24,1687,2478,0,3,1,3,0,1,0,76.14,68.08 ,33.33
03,012,01,012,0223,0,1565,20,1585,2186,0,3,1,3,0,1,0,76.14,72.51 ,33.33
03,012,01,012,0224,0,1213,15,1228,1799,0,3,1,3,0,1,0,76.14,68.26 ,33.33
03,012,01,012,0225,0,845,11,856,1276,0,3,1,3,0,1,0,76.14,67.08 ,33.33
03,012,01,012,0226,0,865,16,881,1213,0,3,1,3,0,1,0,76.14,72.63 ,33.33
03,012,01,012,0227,0,1284,16,1300,1789,0,3,1,3,0,1,0,76.14,72.67 ,33.33
03,012,01,012,0228,0,798,14,812,1070,0,3,1,3,0,1,0,76.14,75.89 ,33.33
03,012,01,012,0229,0,1152,21,1173,1523,0,3,1,3,0,1,0,76.14,77.02 ,33.33
03,012,01,012,0230,0,479,12,491,656,0,3,1,3,0,1,0,76.14,74.85 ,33.33
03,012,01,012,0231,0,1026,20,1046,1434,0,3,1,3,0,1,0,76.14,72.94 ,33.33
03,012,01,012,0232,0,673,9,682,904,0,3,1,3,0,1,0,76.14,75.44 ,33.33
03,012,01,013,0233,0,1282,12,1294,1630,0,3,1,3,0,1,0,76.14,79.39 ,33.33
03,012,01,013,0234,0,1983,33,2016,2393,0,3,1,3,0,1,0,76.14,84.25 ,33.33
03,012,01,013,0235,0,1968,21,1989,2637,0,3,1,3,0,1,0,76.14,75.43 ,33.33
03,012,01,013,0236,0,1430,8,1438,1760,0,3,1,3,0,1,0,76.14,81.70 ,33.33
03,012,01,013,0237,0,1122,11,1133,1456,0,3,1,3,0,1,0,76.14,77.82 ,33.33
03,012,01,013,0238,0,744,7,751,973,0,3,1,3,0,1,0,76.14,77.18 ,33.33
03,012,01,013,0239,0,1565,31,1596,2117,0,3,1,3,0,1,0,76.14,75.39 ,33.33
03,012,01,013,0240,0,2120,23,2143,2877,0,3,1,3,0,1,0,76.14,74.49 ,33.33
03,012,01,013,0241,0,1744,20,1764,2347,0,3,1,3,0,1,0,76.14,75.16 ,33.33
03,012,01,013,0242,0,1770,23,1793,2525,0,3,1,3,0,1,0,76.14,71.01 ,33.33
03,012,01,013,0243,0,1514,14,1528,1959,0,3,1,3,0,1,0,76.14,78.00 ,33.33
03,012,01,013,0244,0,1366,10,1376,1816,0,3,1,3,0,1,0,76.14,75.77 ,33.33
03,012,01,013,0245,0,1809,17,1826,2246,0,3,1,3,0,1,0,76.14,81.30 ,33.33
03,012,01,013,0246,0,1411,22,1433,1885,0,3,1,3,0,1,0,76.14,76.02 ,33.33
03,012,01,013,0247,0,831,2,833,1137,0,3,1,3,0,1,0,76.14,73.26 ,33.33
03,012,01,013,0248,0,849,10,859,1121,0,3,1,3,0,1,0,76.14,76.63 ,33.33
03,012,01,013,0249,0,645,9,654,833,0,3,1,3,0,1,0,76.14,78.51 ,33.33
03,012,01,013,0250,0,789,11,800,969,0,3,1,3,0,1,0,76.14,82.56 ,33.33
03,012,01,013,0251,0,647,9,656,805,0,3,1,3,0,1,0,76.14,81.49 ,33.33
03,012,01,013,0252,0,946,11,957,1213,0,3,1,3,0,1,0,76.14,78.90 ,33.33
03,012,01,014,0253,0,1563,16,1579,2081,0,3,1,3,0,1,0,76.14,75.88 ,33.33
03,012,01,014,0254,0,727,12,739,1008,0,3,1,3,0,1,0,76.14,73.31 ,33.33
03,012,01,014,0255,0,2100,35,2135,3072,0,3,1,3,0,1,0,76.14,69.50 ,33.33
03,012,01,014,0256,0,1054,16,1070,1618,0,3,1,3,0,1,0,76.14,66.13 ,33.33
03,012,01,014,0257,0,833,12,845,1150,0,3,1,3,0,1,0,76.14,73.48 ,33.33
03,012,01,014,0258,0,748,18,766,1107,0,3,1,3,0,1,0,76.14,69.20 ,33.33
03,012,01,014,0259,0,587,5,592,801,0,3,1,3,0,1,0,76.14,73.91 ,33.33
03,012,01,014,0260,0,979,10,989,1340,0,3,1,3,0,1,0,76.14,73.81 ,33.33
03,012,01,014,0261,0,1084,12,1096,1532,0,3,1,3,0,1,0,76.14,71.54 ,33.33
03,012,01,014,0262,0,754,19,773,1099,0,3,1,3,0,1,0,76.14,70.34 ,33.33
03,012,01,014,0263,0,1286,13,1299,1845,0,3,1,3,0,1,0,76.14,70.41 ,33.33
03,012,01,014,0264,0,573,10,583,834,0,3,1,3,0,1,0,76.14,69.90 ,33.33
03,012,01,014,0265,0,546,6,552,724,0,3,1,3,0,1,0,76.14,76.24 ,33.33
03,012,01,015,0266,0,690,4,694,1036,0,3,1,3,0,1,0,76.14,66.99 ,33.33
03,012,01,015,0267,0,553,6,559,847,0,3,1,3,0,1,0,76.14,66.00 ,33.33
03,012,01,015,0268,0,1061,15,1076,1537,0,3,1,3,0,1,0,76.14,70.01 ,33.33
03,012,01,015,0269,0,1517,15,1532,2359,0,3,1,3,0,1,0,76.14,64.94 ,33.33
03,012,01,015,0270,0,875,8,883,1266,0,3,1,3,0,1,0,76.14,69.75 ,33.33
03,012,01,015,0271,0,1254,15,1269,1785,0,3,1,3,0,1,0,76.14,71.09 ,33.33
03,012,01,015,0272,0,827,12,839,1278,0,3,1,3,0,1,0,76.14,65.65 ,33.33
03,012,01,015,0273,0,725,7,732,1090,0,3,1,3,0,1,0,76.14,67.16 ,33.33
03,012,01,015,0274,0,760,9,769,1197,0,3,1,3,0,1,0,76.14,64.24 ,33.33
03,012,01,015,0275,0,895,7,902,1307,0,3,1,3,0,1,0,76.14,69.01 ,33.33
03,012,01,015,0276,0,1657,16,1673,2693,0,3,1,3,0,1,0,76.14,62.12 ,33.33
03,012,01,015,0277,0,742,10,752,1158,0,3,1,3,0,1,0,76.14,64.94 ,33.33
03,012,01,015,0278,0,678,10,688,1027,0,3,1,3,0,1,0,76.14,66.99 ,33.33
03,012,01,015,0279,0,758,8,766,1110,0,3,1,3,0,1,0,76.14,69.01 ,33.33
03,012,01,015,0280,0,1836,31,1867,2650,0,3,1,3,0,1,0,76.14,70.45 ,33.33
03,012,01,016,0281,0,1045,10,1055,1340,0,3,1,3,0,1,0,76.14,78.73 ,33.33
03,012,01,016,0282,0,1241,17,1258,1698,0,3,1,3,0,1,0,76.14,74.09 ,33.33
03,012,01,016,0283,0,1295,20,1315,1734,0,3,1,3,0,1,0,76.14,75.84 ,33.33
03,012,01,016,0284,0,700,16,716,860,0,3,1,3,0,1,0,76.14,83.26 ,33.33
03,012,01,016,0285,0,735,8,743,993,0,3,1,3,0,1,0,76.14,74.82 ,33.33
03,012,01,016,0286,0,1265,11,1276,1682,0,3,1,3,0,1,0,76.14,75.86 ,33.33
03,012,01,016,0287,0,440,3,443,575,0,3,1,3,0,1,0,76.14,77.04 ,33.33
03,012,01,016,0288,0,544,7,551,724,0,3,1,3,0,1,0,76.14,76.10 ,33.33
03,012,01,016,0289,0,1052,23,1075,1403,0,3,1,3,0,1,0,76.14,76.62 ,33.33
03,012,01,016,0290,0,611,13,624,802,0,3,1,3,0,1,0,76.14,77.81 ,33.33
03,012,01,016,0291,0,745,5,750,901,0,3,1,3,0,1,0,76.14,83.24 ,33.33
03,012,01,016,0292,0,1346,11,1357,1821,0,3,1,3,0,1,0,76.14,74.52 ,33.33
03,012,01,017,0293,0,980,6,986,1333,0,3,1,3,0,1,0,76.14,73.97 ,33.33
03,012,01,017,0294,0,1124,15,1139,1513,0,3,1,3,0,1,0,76.14,75.28 ,33.33
03,012,01,017,0295,0,1510,11,1521,2090,0,3,1,3,0,1,0,76.14,72.78 ,33.33
03,012,01,017,0296,0,287,2,289,429,0,3,1,3,0,1,0,76.14,67.37 ,33.33
03,012,01,017,0297,0,1177,15,1192,1520,0,3,1,3,0,1,0,76.14,78.42 ,33.33
03,012,01,017,0298,0,1514,9,1523,2024,0,3,1,3,0,1,0,76.14,75.25 ,33.33
03,012,01,018,0299,0,1180,25,1205,1714,0,3,1,3,0,1,0,76.14,70.30 ,33.33
03,012,01,018,0300,0,1348,19,1367,1920,0,3,1,3,0,1,0,76.14,71.20 ,33.33
03,012,01,018,0301,0,1470,23,1493,2093,0,3,1,3,0,1,0,76.14,71.33 ,33.33
03,012,01,018,0302,0,743,7,750,996,0,3,1,3,0,1,0,76.14,75.30 ,33.33
03,012,01,018,0303,0,619,10,629,861,0,3,1,3,0,1,0,76.14,73.05 ,33.33
03,012,01,018,0304,0,601,5,606,784,0,3,1,3,0,1,0,76.14,77.30 ,33.33
03,012,01,018,0305,0,2201,35,2236,3127,0,3,1,3,0,1,0,76.14,71.51 ,33.33
03,012,01,018,0306,0,1356,26,1382,1890,0,3,1,3,0,1,0,76.14,73.12 ,33.33
03,012,01,018,0307,0,1756,26,1782,2391,0,3,1,3,0,1,0,76.14,74.53 ,33.33
03,012,01,018,0308,0,444,4,448,639,0,3,1,3,0,1,0,76.14,70.11 ,33.33
03,012,01,018,0309,0,1559,19,1578,2236,0,3,1,3,0,1,0,76.14,70.57 ,33.33
03,012,01,018,0310,0,1313,21,1334,1892,0,3,1,3,0,1,0,76.14,70.51 ,33.33
03,012,01,018,0311,0,781,5,786,1157,0,3,1,3,0,1,0,76.14,67.93 ,33.33
03,012,01,018,0312,0,1534,17,1551,2104,0,3,1,3,0,1,0,76.14,73.72 ,33.33
03,012,01,018,0313,0,1418,17,1435,1857,0,3,1,3,0,1,0,76.14,77.28 ,33.33
03,012,01,019,0314,0,1546,18,1564,2286,0,3,1,3,0,1,0,76.14,68.42 ,33.33
03,012,01,019,0315,0,1741,15,1756,2426,0,3,1,3,0,1,0,76.14,72.38 ,33.33
03,012,01,019,0316,0,642,5,647,896,0,3,1,3,0,1,0,76.14,72.21 ,33.33
03,012,01,019,0317,0,482,7,489,635,0,3,1,3,0,1,0,76.14,77.01 ,33.33
03,012,01,019,0318,0,672,3,675,915,0,3,1,3,0,1,0,76.14,73.77 ,33.33
03,012,01,019,0319,0,466,8,474,671,0,3,1,3,0,1,0,76.14,70.64 ,33.33
03,012,01,019,0320,0,365,5,370,495,0,3,1,3,0,1,0,76.14,74.75 ,33.33
03,012,01,019,0321,0,1271,9,1280,1869,0,3,1,3,0,1,0,76.14,68.49 ,33.33
03,012,01,019,0322,0,1959,28,1987,2812,0,3,1,3,0,1,0,76.14,70.66 ,33.33
03,012,01,019,0323,0,1018,14,1032,1770,0,3,1,3,0,1,0,76.14,58.31 ,33.33
03,012,01,019,0324,0,1284,32,1316,1885,0,3,1,3,0,1,0,76.14,69.81 ,33.33
03,012,01,019,0325,0,1044,22,1066,1521,0,3,1,3,0,1,0,76.14,70.09 ,33.33
03,012,01,019,0326,0,1197,15,1212,1678,0,3,1,3,0,1,0,76.14,72.23 ,33.33
03,012,01,019,0327,0,721,9,730,954,0,3,1,3,0,1,0,76.14,76.52 ,33.33
03,012,01,019,0328,0,767,7,774,986,0,3,1,3,0,1,0,76.14,78.50 ,33.33
03,012,01,019,0329,0,1061,14,1075,1402,0,3,1,3,0,1,0,76.14,76.68 ,33.33
03,012,01,019,0330,0,825,14,839,1103,0,3,1,3,0,1,0,76.14,76.07 ,33.33
03,012,01,019,0331,0,1124,10,1134,1452,0,3,1,3,0,1,0,76.14,78.10 ,33.33
03,012,01,019,0332,0,762,3,765,988,0,3,1,3,0,1,0,76.14,77.43 ,33.33
03,012,01,019,0333,0,1844,25,1869,2406,0,3,1,3,0,1,0,76.14,77.68 ,33.33
03,012,01,019,0334,0,1323,14,1337,1849,0,3,1,3,0,1,0,76.14,72.31 ,33.33
03,012,01,019,0335,0,492,8,500,709,0,3,1,3,0,1,0,76.14,70.52 ,33.33
03,012,01,019,0336,0,283,3,286,387,0,3,1,3,0,1,0,76.14,73.90 ,33.33
03,012,01,019,0337,0,457,3,460,612,0,3,1,3,0,1,0,76.14,75.16 ,33.33
03,012,01,019,0338,0,139,0,139,201,0,3,1,3,0,1,0,76.14,69.15 ,33.33
03,012,01,020,0339,0,1177,13,1190,1610,0,3,1,3,0,1,0,76.14,73.91 ,33.33
03,012,01,020,0340,0,1109,14,1123,1575,0,3,1,3,0,1,0,76.14,71.30 ,33.33
03,012,01,020,0341,0,993,8,1001,1422,0,3,1,3,0,1,0,76.14,70.39 ,33.33
03,012,01,020,0342,0,1554,25,1579,2230,0,3,1,3,0,1,0,76.14,70.81 ,33.33
03,012,01,020,0343,0,1514,18,1532,2216,0,3,1,3,0,1,0,76.14,69.13 ,33.33
03,012,01,020,0344,0,1755,20,1775,2547,0,3,1,3,0,1,0,76.14,69.69 ,33.33
03,012,01,020,0345,0,1723,22,1745,2458,0,3,1,3,0,1,0,76.14,70.99 ,33.33
03,012,01,020,0346,0,1488,13,1501,2097,0,3,1,3,0,1,0,76.14,71.58 ,33.33
03,012,01,020,0347,0,1088,9,1097,1532,0,3,1,3,0,1,0,76.14,71.61 ,33.33
03,012,01,020,0348,0,1188,17,1205,1744,0,3,1,3,0,1,0,76.14,69.09 ,33.33
03,012,01,020,0349,0,1070,12,1082,1459,0,3,1,3,0,1,0,76.14,74.16 ,33.33
03,012,01,020,0350,0,1441,16,1457,2126,0,3,1,3,0,1,0,76.14,68.53 ,33.33
03,012,01,020,0351,0,1185,16,1201,1638,0,3,1,3,0,1,0,76.14,73.32 ,33.33
03,012,01,020,0352,0,1567,32,1599,2306,0,3,1,3,0,1,0,76.14,69.34 ,33.33
03,012,01,020,0353,0,1673,59,1732,2384,0,3,1,3,0,1,0,76.14,72.65 ,33.33
03,012,01,020,0354,0,1142,17,1159,1694,0,3,1,3,0,1,0,76.14,68.42 ,33.33
03,012,01,020,0355,0,1035,18,1053,1477,0,3,1,3,0,1,0,76.14,71.29 ,33.33
03,012,01,020,0356,0,899,5,904,1232,0,3,1,3,0,1,0,76.14,73.38 ,33.33
03,012,01,020,0357,0,1162,17,1179,1769,0,3,1,3,0,1,0,76.14,66.65 ,33.33
03,012,01,021,0358,0,672,13,685,1146,0,3,1,3,0,1,0,76.14,59.77 ,33.33
03,012,01,021,0359,0,845,8,853,1191,0,3,1,3,0,1,0,76.14,71.62 ,33.33
03,012,01,021,0360,0,1031,24,1055,1670,0,3,1,3,0,1,0,76.14,63.17 ,33.33
03,012,01,021,0361,0,889,20,909,1416,0,3,1,3,0,1,0,76.14,64.19 ,33.33
03,012,01,021,0362,0,634,12,646,1000,0,3,1,3,0,1,0,76.14,64.60 ,33.33
03,012,01,021,0363,0,591,9,600,871,0,3,1,3,0,1,0,76.14,68.89 ,33.33
03,012,01,021,0364,0,549,4,553,809,0,3,1,3,0,1,0,76.14,68.36 ,33.33
03,012,01,021,0365,0,499,7,506,651,0,3,1,3,0,1,0,76.14,77.73 ,33.33
03,012,01,021,0366,0,276,5,281,382,0,3,1,3,0,1,0,76.14,73.56 ,33.33
03,012,01,021,0367,0,853,8,861,1510,0,3,1,3,0,1,0,76.14,57.02 ,33.33
03,012,01,021,0368,0,977,32,1009,1570,0,3,1,3,0,1,0,76.14,64.27 ,33.33
03,012,01,021,0369,0,676,15,691,1024,0,3,1,3,0,1,0,76.14,67.48 ,33.33
03,012,01,022,0370,0,435,6,441,630,0,3,1,3,0,1,0,76.14,70.00 ,33.33
03,012,01,022,0371,0,813,5,818,1057,0,3,1,3,0,1,0,76.14,77.39 ,33.33
03,012,01,022,0372,0,559,6,565,764,0,3,1,3,0,1,0,76.14,73.95 ,33.33
03,012,01,022,0373,0,1064,11,1075,1472,0,3,1,3,0,1,0,76.14,73.03 ,33.33
03,012,01,022,0374,0,494,5,499,712,0,3,1,3,0,1,0,76.14,70.08 ,33.33
03,012,01,022,0375,0,494,4,498,693,0,3,1,3,0,1,0,76.14,71.86 ,33.33
03,012,01,022,0376,0,734,8,742,1163,0,3,1,3,0,1,0,76.14,63.80 ,33.33
03,012,01,023,0377,0,583,5,588,878,0,3,1,3,0,1,0,76.14,66.97 ,33.33
03,012,01,023,0378,0,483,4,487,812,0,3,1,3,0,1,0,76.14,59.98 ,33.33
03,012,01,023,0379,0,1089,26,1115,1902,0,3,1,3,0,1,0,76.14,58.62 ,33.33
03,012,01,023,0380,0,1188,19,1207,1852,0,3,1,3,0,1,0,76.14,65.17 ,33.33
03,012,01,023,0381,0,1124,17,1141,1638,0,3,1,3,0,1,0,76.14,69.66 ,33.33
03,012,01,023,0382,0,1205,22,1227,1836,0,3,1,3,0,1,0,76.14,66.83 ,33.33
03,012,01,023,0383,0,938,13,951,1411,0,3,1,3,0,1,0,76.14,67.40 ,33.33
03,012,01,024,0384,0,573,14,587,778,0,3,1,3,0,1,0,76.14,75.45 ,33.33
03,012,01,024,0385,0,722,10,732,1055,0,3,1,3,0,1,0,76.14,69.38 ,33.33
03,012,01,024,0386,0,344,4,348,510,0,3,1,3,0,1,0,76.14,68.24 ,33.33
03,012,01,024,0387,0,373,7,380,483,0,3,1,3,0,1,0,76.14,78.67 ,33.33
03,012,01,024,0388,0,752,16,768,1001,0,3,1,3,0,1,0,76.14,76.72 ,33.33
03,012,01,024,0389,0,1275,27,1302,1747,0,3,1,3,0,1,0,76.14,74.53 ,33.33
03,012,01,024,0390,0,477,5,482,623,0,3,1,3,0,1,0,76.14,77.37 ,33.33
03,012,01,024,0391,0,291,3,294,386,0,3,1,3,0,1,0,76.14,76.17 ,33.33
03,012,01,024,0392,0,281,3,284,364,0,3,1,3,0,1,0,76.14,78.02 ,33.33
03,012,01,024,0393,0,665,6,671,844,0,3,1,3,0,1,0,76.14,79.50 ,33.33
03,012,01,024,0394,0,507,7,514,656,0,3,1,3,0,1,0,76.14,78.35 ,33.33
03,012,01,024,0395,0,344,3,347,476,0,3,1,3,0,1,0,76.14,72.90 ,33.33
03,012,01,024,0396,0,885,3,888,1130,0,3,1,3,0,1,0,76.14,78.58 ,33.33
03,012,01,024,0397,0,759,5,764,928,0,3,1,3,0,1,0,76.14,82.33 ,33.33
03,012,01,024,0398,0,379,9,388,508,0,3,1,3,0,1,0,76.14,76.38 ,33.33
03,012,01,024,0399,0,502,7,509,675,0,3,1,3,0,1,0,76.14,75.41 ,33.33
03,012,01,024,0400,0,469,8,477,685,0,3,1,3,0,1,0,76.14,69.64 ,33.33
03,012,01,024,0401,0,447,3,450,619,0,3,1,3,0,1,0,76.14,72.70 ,33.33
03,012,01,025,0402,0,29,1,30,59,0,3,1,3,0,1,0,76.14,50.85 ,33.33
03,012,01,025,0403,0,12,0,12,18,0,3,1,3,0,1,0,76.14,66.67 ,33.33
03,012,01,025,0404,0,7,0,7,17,0,3,1,3,0,1,0,76.14,41.18 ,33.33
03,012,01,026,0405,0,12,2,14,29,0,3,1,3,0,1,0,76.14,48.28 ,33.33
03,012,01,026,0406,0,27,1,28,42,0,3,1,3,0,1,0,76.14,66.67 ,33.33
03,012,01,026,0407,0,46,0,46,72,0,3,1,3,0,1,0,76.14,63.89 ,33.33
03,012,01,026,0408,0,87,0,87,130,0,3,1,3,0,1,0,76.14,66.92 ,33.33
03,012,01,026,0409,0,7,0,7,17,0,3,1,3,0,1,0,76.14,41.18 ,33.33
03,012,01,026,0410,0,9,0,9,19,0,3,1,3,0,1,0,76.14,47.37 ,33.33
03,012,01,026,0411,0,7,0,7,13,0,3,1,3,0,1,0,76.14,53.85 ,33.33
03,012,01,026,0412,0,8,0,8,18,0,3,1,3,0,1,0,76.14,44.44 ,33.33
03,012,01,027,0413,0,53,0,53,133,0,3,1,3,0,1,0,76.14,39.85 ,33.33
03,012,01,027,0414,0,15,0,15,31,0,3,1,3,0,1,0,76.14,48.39 ,33.33
03,012,01,027,0415,0,49,0,49,79,0,3,1,3,0,1,0,76.14,62.03 ,33.33
03,013,01,001,0001,0,922,4,926,1348,0,3,1,3,0,1,0,76.14,68.69 ,33.33
03,013,01,001,0002,0,1092,7,1099,1561,0,3,1,3,0,1,0,76.14,70.40 ,33.33
03,013,01,001,0003,0,622,2,624,882,0,3,1,3,0,1,0,76.14,70.75 ,33.33
03,013,01,001,0004,0,913,3,916,1412,0,3,1,3,0,1,0,76.14,64.87 ,33.33
03,013,01,001,0005,0,1974,14,1988,2985,0,3,1,3,0,1,0,76.14,66.60 ,33.33
03,013,01,001,0006,0,988,10,998,1521,0,3,1,3,0,1,0,76.14,65.61 ,33.33
03,013,01,001,0007,0,674,4,678,972,0,3,1,3,0,1,0,76.14,69.75 ,33.33
03,013,01,001,0008,0,629,4,633,968,0,3,1,3,0,1,0,76.14,65.39 ,33.33
03,013,01,001,0009,0,883,4,887,1355,0,3,1,3,0,1,0,76.14,65.46 ,33.33
03,013,01,001,0010,0,688,2,690,1007,0,3,1,3,0,1,0,76.14,68.52 ,33.33
03,013,01,001,0011,0,780,5,785,1128,0,3,1,3,0,1,0,76.14,69.59 ,33.33
03,013,01,001,0012,0,915,7,922,1640,0,3,1,3,0,1,0,76.14,56.22 ,33.33
03,013,01,001,0013,0,729,6,735,1128,0,3,1,3,0,1,0,76.14,65.16 ,33.33
03,013,01,001,0014,0,1299,12,1311,2044,0,3,1,3,0,1,0,76.14,64.14 ,33.33
03,013,01,001,0015,0,1562,6,1568,2315,0,3,1,3,0,1,0,76.14,67.73 ,33.33
03,013,01,001,0016,0,2410,13,2423,3752,0,3,1,3,0,1,0,76.14,64.58 ,33.33
03,013,01,001,0017,0,4562,38,4600,7001,0,3,1,3,0,1,0,76.14,65.70 ,33.33
03,013,01,001,0018,0,2155,20,2175,3377,0,3,1,3,0,1,0,76.14,64.41 ,33.33
03,013,01,001,0019,0,613,7,620,881,0,3,1,3,0,1,0,76.14,70.37 ,33.33
03,013,01,001,0020,0,862,5,867,1251,0,3,1,3,0,1,0,76.14,69.30 ,33.33
03,013,01,001,0021,0,713,8,721,1034,0,3,1,3,0,1,0,76.14,69.73 ,33.33
03,013,01,001,0022,0,3563,45,3608,5513,0,3,1,3,0,1,0,76.14,65.45 ,33.33
03,013,01,001,0023,0,940,12,952,1380,0,3,1,3,0,1,0,76.14,68.99 ,33.33
03,013,01,001,0024,0,902,7,909,1488,0,3,1,3,0,1,0,76.14,61.09 ,33.33
03,013,01,001,0025,0,485,5,490,774,0,3,1,3,0,1,0,76.14,63.31 ,33.33
03,013,01,001,0026,0,534,5,539,838,0,3,1,3,0,1,0,76.14,64.32 ,33.33
03,013,01,001,0027,0,1778,17,1795,2944,0,3,1,3,0,1,0,76.14,60.97 ,33.33
03,013,01,001,0028,0,3462,26,3488,5790,0,3,1,3,0,1,0,76.14,60.24 ,33.33
03,013,01,001,0029,0,2406,29,2435,3652,0,3,1,3,0,1,0,76.14,66.68 ,33.33
03,013,01,001,0030,0,363,5,368,544,0,3,1,3,0,1,0,76.14,67.65 ,33.33
03,013,01,001,0031,0,653,6,659,907,0,3,1,3,0,1,0,76.14,72.66 ,33.33
03,013,01,001,0032,0,1578,13,1591,2230,0,3,1,3,0,1,0,76.14,71.35 ,33.33
03,013,01,001,0033,0,899,9,908,1278,0,3,1,3,0,1,0,76.14,71.05 ,33.33
03,013,01,001,0034,0,1372,7,1379,1956,0,3,1,3,0,1,0,76.14,70.50 ,33.33
03,013,01,001,0035,0,1024,9,1033,1435,0,3,1,3,0,1,0,76.14,71.99 ,33.33
03,013,01,001,0036,0,815,7,822,1161,0,3,1,3,0,1,0,76.14,70.80 ,33.33
03,013,01,001,0037,0,763,14,777,1129,0,3,1,3,0,1,0,76.14,68.82 ,33.33
03,013,01,001,0038,0,1249,10,1259,1879,0,3,1,3,0,1,0,76.14,67.00 ,33.33
03,013,01,001,0039,0,856,11,867,1293,0,3,1,3,0,1,0,76.14,67.05 ,33.33
03,013,01,001,0040,0,1269,22,1291,1959,0,3,1,3,0,1,0,76.14,65.90 ,33.33
03,013,01,001,0041,0,826,7,833,1169,0,3,1,3,0,1,0,76.14,71.26 ,33.33
03,013,01,001,0042,0,3547,44,3591,5487,0,3,1,3,0,1,0,76.14,65.45 ,33.33
03,013,01,001,0043,0,2213,21,2234,3453,0,3,1,3,0,1,0,76.14,64.70 ,33.33
03,013,01,001,0044,0,747,4,751,1092,0,3,1,3,0,1,0,76.14,68.77 ,33.33
03,013,01,001,0045,0,644,5,649,891,0,3,1,3,0,1,0,76.14,72.84 ,33.33
03,013,01,001,0046,0,1074,6,1080,1528,0,3,1,3,0,1,0,76.14,70.68 ,33.33
03,013,01,001,0047,0,1058,13,1071,1446,0,3,1,3,0,1,0,76.14,74.07 ,33.33
03,013,01,001,0048,0,734,7,741,1108,0,3,1,3,0,1,0,76.14,66.88 ,33.33
03,013,01,001,0049,0,1260,14,1274,1863,0,3,1,3,0,1,0,76.14,68.38 ,33.33
03,013,01,001,0050,0,662,8,670,995,0,3,1,3,0,1,0,76.14,67.34 ,33.33
03,013,01,001,0051,0,2604,21,2625,3881,0,3,1,3,0,1,0,76.14,67.64 ,33.33
03,013,01,001,0052,0,1642,5,1647,2543,0,3,1,3,0,1,0,76.14,64.77 ,33.33
03,013,01,001,0053,0,1680,16,1696,2657,0,3,1,3,0,1,0,76.14,63.83 ,33.33
03,013,01,001,0054,0,1174,8,1182,1987,0,3,1,3,0,1,0,76.14,59.49 ,33.33
03,013,01,001,0055,0,2927,28,2955,4594,0,3,1,3,0,1,0,76.14,64.32 ,33.33
03,013,01,001,0056,0,1476,12,1488,2153,0,3,1,3,0,1,0,76.14,69.11 ,33.33
03,013,01,001,0057,0,2389,25,2414,3783,0,3,1,3,0,1,0,76.14,63.81 ,33.33
03,013,01,001,0058,0,1536,15,1551,2434,0,3,1,3,0,1,0,76.14,63.72 ,33.33
03,013,01,001,0059,0,3271,20,3291,5008,0,3,1,3,0,1,0,76.14,65.71 ,33.33
03,013,01,001,0060,0,1245,18,1263,1700,0,3,1,3,0,1,0,76.14,74.29 ,33.33
03,013,01,001,0061,0,1025,9,1034,1538,0,3,1,3,0,1,0,76.14,67.23 ,33.33
03,013,01,001,0062,0,543,8,551,786,0,3,1,3,0,1,0,76.14,70.10 ,33.33
03,013,01,001,0063,0,3575,23,3598,5667,0,3,1,3,0,1,0,76.14,63.49 ,33.33
03,013,01,001,0064,0,822,16,838,1188,0,3,1,3,0,1,0,76.14,70.54 ,33.33
03,013,01,001,0065,0,565,1,566,817,0,3,1,3,0,1,0,76.14,69.28 ,33.33
03,013,01,001,0066,0,695,7,702,947,0,3,1,3,0,1,0,76.14,74.13 ,33.33
03,013,01,001,0067,0,936,6,942,1360,0,3,1,3,0,1,0,76.14,69.26 ,33.33
03,013,01,001,0068,0,640,5,645,943,0,3,1,3,0,1,0,76.14,68.40 ,33.33
03,013,01,002,0069,0,447,0,447,696,0,3,1,3,0,1,0,76.14,64.22 ,33.33
03,013,01,002,0070,0,2026,15,2041,3315,0,3,1,3,0,1,0,76.14,61.57 ,33.33
03,013,01,002,0071,0,550,2,552,806,0,3,1,3,0,1,0,76.14,68.49 ,33.33
03,013,01,002,0072,0,841,5,846,1320,0,3,1,3,0,1,0,76.14,64.09 ,33.33
03,013,01,002,0073,0,922,5,927,1459,0,3,1,3,0,1,0,76.14,63.54 ,33.33
03,013,01,002,0074,0,559,0,559,781,0,3,1,3,0,1,0,76.14,71.57 ,33.33
03,013,01,002,0075,0,2211,13,2224,3562,0,3,1,3,0,1,0,76.14,62.44 ,33.33
03,013,01,002,0076,0,2933,22,2955,4794,0,3,1,3,0,1,0,76.14,61.64 ,33.33
03,013,01,002,0077,0,1011,7,1018,1606,0,3,1,3,0,1,0,76.14,63.39 ,33.33
03,013,01,002,0078,0,617,6,623,932,0,3,1,3,0,1,0,76.14,66.85 ,33.33
03,013,01,002,0079,0,1156,15,1171,1747,0,3,1,3,0,1,0,76.14,67.03 ,33.33
03,013,01,002,0080,0,1209,9,1218,1830,0,3,1,3,0,1,0,76.14,66.56 ,33.33
03,013,01,002,0081,0,2517,14,2531,4127,0,3,1,3,0,1,0,76.14,61.33 ,33.33
03,013,01,002,0082,0,905,8,913,1414,0,3,1,3,0,1,0,76.14,64.57 ,33.33
03,013,01,002,0083,0,819,12,831,1254,0,3,1,3,0,1,0,76.14,66.27 ,33.33
03,013,01,002,0084,0,470,5,475,746,0,3,1,3,0,1,0,76.14,63.67 ,33.33
03,013,01,002,0085,0,385,2,387,612,0,3,1,3,0,1,0,76.14,63.24 ,33.33
03,013,01,002,0086,0,956,15,971,1557,0,3,1,3,0,1,0,76.14,62.36 ,33.33
03,013,01,002,0087,0,925,10,935,1420,0,3,1,3,0,1,0,76.14,65.85 ,33.33
03,013,01,002,0088,0,1227,17,1244,1859,0,3,1,3,0,1,0,76.14,66.92 ,33.33
03,013,01,002,0089,0,961,15,976,1545,0,3,1,3,0,1,0,76.14,63.17 ,33.33
03,013,01,003,0090,0,1737,13,1750,2375,0,3,1,3,0,1,0,76.14,73.68 ,33.33
03,013,01,003,0091,0,393,4,397,559,0,3,1,3,0,1,0,76.14,71.02 ,33.33
03,013,01,003,0092,0,367,3,370,488,0,3,1,3,0,1,0,76.14,75.82 ,33.33
03,013,01,003,0093,0,491,2,493,776,0,3,1,3,0,1,0,76.14,63.53 ,33.33
03,013,01,003,0094,0,460,5,465,651,0,3,1,3,0,1,0,76.14,71.43 ,33.33
03,013,01,003,0095,0,2787,35,2822,4263,0,3,1,3,0,1,0,76.14,66.20 ,33.33
03,013,01,003,0096,0,508,8,516,700,0,3,1,3,0,1,0,76.14,73.71 ,33.33
03,013,01,003,0097,0,447,3,450,615,0,3,1,3,0,1,0,76.14,73.17 ,33.33
03,013,01,003,0098,0,1253,10,1263,1928,0,3,1,3,0,1,0,76.14,65.51 ,33.33
03,013,01,003,0099,0,587,10,597,925,0,3,1,3,0,1,0,76.14,64.54 ,33.33
03,013,01,003,0100,0,982,8,990,1384,0,3,1,3,0,1,0,76.14,71.53 ,33.33
03,013,01,003,0101,0,507,2,509,735,0,3,1,3,0,1,0,76.14,69.25 ,33.33
03,013,01,003,0102,0,728,10,738,1184,0,3,1,3,0,1,0,76.14,62.33 ,33.33
03,013,01,003,0103,0,1187,15,1202,1824,0,3,1,3,0,1,0,76.14,65.90 ,33.33
03,013,01,003,0104,0,1478,19,1497,2287,0,3,1,3,0,1,0,76.14,65.46 ,33.33
03,013,01,003,0105,0,814,7,821,1266,0,3,1,3,0,1,0,76.14,64.85 ,33.33
03,013,01,003,0106,0,956,9,965,1452,0,3,1,3,0,1,0,76.14,66.46 ,33.33
03,013,01,003,0107,0,1765,16,1781,2631,0,3,1,3,0,1,0,76.14,67.69 ,33.33
03,013,01,003,0108,0,1151,6,1157,1718,0,3,1,3,0,1,0,76.14,67.35 ,33.33
03,013,01,003,0109,0,1055,7,1062,1542,0,3,1,3,0,1,0,76.14,68.87 ,33.33
03,013,01,003,0110,0,574,12,586,817,0,3,1,3,0,1,0,76.14,71.73 ,33.33
03,013,01,003,0111,0,529,8,537,771,0,3,1,3,0,1,0,76.14,69.65 ,33.33
03,013,01,003,0112,0,256,2,258,382,0,3,1,3,0,1,0,76.14,67.54 ,33.33
03,013,01,004,0113,0,652,8,660,1033,0,3,1,3,0,1,0,76.14,63.89 ,33.33
03,013,01,004,0114,0,1050,17,1067,1845,0,3,1,3,0,1,0,76.14,57.83 ,33.33
03,013,01,004,0115,0,710,7,717,1127,0,3,1,3,0,1,0,76.14,63.62 ,33.33
03,013,01,004,0116,0,1742,27,1769,3167,0,3,1,3,0,1,0,76.14,55.86 ,33.33
03,013,01,004,0117,0,1284,13,1297,2419,0,3,1,3,0,1,0,76.14,53.62 ,33.33
03,013,01,004,0118,0,433,9,442,786,0,3,1,3,0,1,0,76.14,56.23 ,33.33
03,013,01,004,0119,0,280,10,290,516,0,3,1,3,0,1,0,76.14,56.20 ,33.33
03,013,01,004,0120,0,237,3,240,504,0,3,1,3,0,1,0,76.14,47.62 ,33.33
03,013,01,004,0121,0,502,5,507,916,0,3,1,3,0,1,0,76.14,55.35 ,33.33
03,013,01,004,0122,0,315,8,323,534,0,3,1,3,0,1,0,76.14,60.49 ,33.33
03,013,01,004,0123,0,514,9,523,922,0,3,1,3,0,1,0,76.14,56.72 ,33.33
03,013,01,004,0124,0,854,8,862,1475,0,3,1,3,0,1,0,76.14,58.44 ,33.33
03,013,01,004,0125,0,991,10,1001,1728,0,3,1,3,0,1,0,76.14,57.93 ,33.33
03,013,01,004,0126,0,709,10,719,1474,0,3,1,3,0,1,0,76.14,48.78 ,33.33
03,013,01,004,0127,0,727,10,737,1347,0,3,1,3,0,1,0,76.14,54.71 ,33.33
03,013,01,004,0128,0,706,4,710,1134,0,3,1,3,0,1,0,76.14,62.61 ,33.33
03,013,01,004,0129,0,600,6,606,1044,0,3,1,3,0,1,0,76.14,58.05 ,33.33
03,013,01,005,0130,0,776,14,790,1138,0,3,1,3,0,1,0,76.14,69.42 ,33.33
03,013,01,005,0131,0,857,6,863,1238,0,3,1,3,0,1,0,76.14,69.71 ,33.33
03,013,01,005,0132,0,1085,13,1098,1625,0,3,1,3,0,1,0,76.14,67.57 ,33.33
03,013,01,005,0133,0,611,12,623,786,0,3,1,3,0,1,0,76.14,79.26 ,33.33
03,013,01,005,0134,0,748,8,756,1029,0,3,1,3,0,1,0,76.14,73.47 ,33.33
03,013,01,005,0135,0,774,7,781,1004,0,3,1,3,0,1,0,76.14,77.79 ,33.33
03,013,01,005,0136,0,449,5,454,582,0,3,1,3,0,1,0,76.14,78.01 ,33.33
03,013,01,005,0137,0,1003,9,1012,1506,0,3,1,3,0,1,0,76.14,67.20 ,33.33
03,013,01,005,0138,0,885,7,892,1271,0,3,1,3,0,1,0,76.14,70.18 ,33.33
03,013,01,005,0139,0,888,10,898,1217,0,3,1,3,0,1,0,76.14,73.79 ,33.33
03,013,01,005,0140,0,573,4,577,708,0,3,1,3,0,1,0,76.14,81.50 ,33.33
03,013,01,005,0141,0,805,5,810,956,0,3,1,3,0,1,0,76.14,84.73 ,33.33
03,013,01,005,0142,0,853,5,858,1106,0,3,1,3,0,1,0,76.14,77.58 ,33.33
03,013,01,005,0143,0,960,10,970,1360,0,3,1,3,0,1,0,76.14,71.32 ,33.33
03,013,01,005,0144,0,1269,14,1283,1711,0,3,1,3,0,1,0,76.14,74.99 ,33.33
03,013,01,005,0145,0,1292,13,1305,1694,0,3,1,3,0,1,0,76.14,77.04 ,33.33
03,013,01,005,0146,0,369,3,372,481,0,3,1,3,0,1,0,76.14,77.34 ,33.33
03,013,01,005,0147,0,595,5,600,756,0,3,1,3,0,1,0,76.14,79.37 ,33.33
03,013,01,005,0148,0,807,4,811,1063,0,3,1,3,0,1,0,76.14,76.29 ,33.33
03,013,01,005,0149,0,245,1,246,351,0,3,1,3,0,1,0,76.14,70.09 ,33.33
03,013,01,005,0150,0,907,8,915,1270,0,3,1,3,0,1,0,76.14,72.05 ,33.33
03,013,01,005,0151,0,948,11,959,1368,0,3,1,3,0,1,0,76.14,70.10 ,33.33
03,013,01,005,0152,0,1165,9,1174,1612,0,3,1,3,0,1,0,76.14,72.83 ,33.33
03,013,01,005,0153,0,1096,3,1099,1496,0,3,1,3,0,1,0,76.14,73.46 ,33.33
03,013,01,005,0154,0,1297,16,1313,1807,0,3,1,3,0,1,0,76.14,72.66 ,33.33
03,013,01,005,0155,0,880,8,888,1194,0,3,1,3,0,1,0,76.14,74.37 ,33.33
03,013,01,005,0156,0,567,3,570,697,0,3,1,3,0,1,0,76.14,81.78 ,33.33
03,013,01,005,0157,0,338,1,339,468,0,3,1,3,0,1,0,76.14,72.44 ,33.33
03,013,01,005,0158,0,315,2,317,413,0,3,1,3,0,1,0,76.14,76.76 ,33.33
03,013,01,005,0159,0,2196,19,2215,3057,0,3,1,3,0,1,0,76.14,72.46 ,33.33
03,013,01,006,0160,0,1216,15,1231,1822,0,3,1,3,0,1,0,76.14,67.56 ,33.33
03,013,01,006,0161,0,1422,13,1435,2173,0,3,1,3,0,1,0,76.14,66.04 ,33.33
03,013,01,006,0162,0,995,4,999,1399,0,3,1,3,0,1,0,76.14,71.41 ,33.33
03,013,01,006,0163,0,885,8,893,1300,0,3,1,3,0,1,0,76.14,68.69 ,33.33
03,013,01,006,0164,0,602,6,608,903,0,3,1,3,0,1,0,76.14,67.33 ,33.33
03,013,01,006,0165,0,983,5,988,1345,0,3,1,3,0,1,0,76.14,73.46 ,33.33
03,013,01,006,0166,0,696,3,699,971,0,3,1,3,0,1,0,76.14,71.99 ,33.33
03,013,01,006,0167,0,551,8,559,743,0,3,1,3,0,1,0,76.14,75.24 ,33.33
03,013,01,006,0168,0,930,14,944,1323,0,3,1,3,0,1,0,76.14,71.35 ,33.33
03,013,01,006,0169,0,589,3,592,818,0,3,1,3,0,1,0,76.14,72.37 ,33.33
03,013,01,006,0170,0,698,8,706,1015,0,3,1,3,0,1,0,76.14,69.56 ,33.33
03,013,01,006,0171,0,836,7,843,1204,0,3,1,3,0,1,0,76.14,70.02 ,33.33
03,013,01,006,0172,0,1103,11,1114,1535,0,3,1,3,0,1,0,76.14,72.57 ,33.33
03,013,01,006,0173,0,672,6,678,942,0,3,1,3,0,1,0,76.14,71.97 ,33.33
03,013,01,006,0174,0,1426,20,1446,2016,0,3,1,3,0,1,0,76.14,71.73 ,33.33
03,013,01,006,0175,0,361,5,366,498,0,3,1,3,0,1,0,76.14,73.49 ,33.33
03,013,01,007,0176,0,1142,7,1149,1585,0,3,1,3,0,1,0,76.14,72.49 ,33.33
03,013,01,007,0177,0,549,3,552,730,0,3,1,3,0,1,0,76.14,75.62 ,33.33
03,013,01,007,0178,0,1030,9,1039,1417,0,3,1,3,0,1,0,76.14,73.32 ,33.33
03,013,01,007,0179,0,1453,21,1474,2025,0,3,1,3,0,1,0,76.14,72.79 ,33.33
03,013,01,007,0180,0,745,4,749,975,0,3,1,3,0,1,0,76.14,76.82 ,33.33
03,013,01,007,0181,0,521,5,526,689,0,3,1,3,0,1,0,76.14,76.34 ,33.33
03,013,01,007,0182,0,515,5,520,684,0,3,1,3,0,1,0,76.14,76.02 ,33.33
03,013,01,008,0183,0,1050,8,1058,1472,0,3,1,3,0,1,0,76.14,71.88 ,33.33
03,013,01,008,0184,0,863,7,870,1174,0,3,1,3,0,1,0,76.14,74.11 ,33.33
03,013,01,008,0185,0,932,16,948,1304,0,3,1,3,0,1,0,76.14,72.70 ,33.33
03,013,01,008,0186,0,857,10,867,1161,0,3,1,3,0,1,0,76.14,74.68 ,33.33
03,013,01,008,0187,0,924,16,940,1320,0,3,1,3,0,1,0,76.14,71.21 ,33.33
03,013,01,008,0188,0,2052,27,2079,2904,0,3,1,3,0,1,0,76.14,71.59 ,33.33
03,013,01,008,0189,0,667,4,671,893,0,3,1,3,0,1,0,76.14,75.14 ,33.33
03,013,01,008,0190,0,780,12,792,1121,0,3,1,3,0,1,0,76.14,70.65 ,33.33
03,013,01,008,0191,0,1114,7,1121,1504,0,3,1,3,0,1,0,76.14,74.53 ,33.33
03,013,01,008,0192,0,801,10,811,1060,0,3,1,3,0,1,0,76.14,76.51 ,33.33
03,013,01,008,0193,0,854,6,860,1197,0,3,1,3,0,1,0,76.14,71.85 ,33.33
03,013,01,009,0194,0,1150,14,1164,1677,0,3,1,3,0,1,0,76.14,69.41 ,33.33
03,013,01,009,0195,0,834,3,837,1120,0,3,1,3,0,1,0,76.14,74.73 ,33.33
03,013,01,009,0196,0,580,4,584,806,0,3,1,3,0,1,0,76.14,72.46 ,33.33
03,013,01,009,0197,0,763,3,766,1115,0,3,1,3,0,1,0,76.14,68.70 ,33.33
03,013,01,009,0198,0,994,7,1001,1494,0,3,1,3,0,1,0,76.14,67.00 ,33.33
03,013,01,009,0199,0,746,8,754,1058,0,3,1,3,0,1,0,76.14,71.27 ,33.33
03,013,01,009,0200,0,877,7,884,1259,0,3,1,3,0,1,0,76.14,70.21 ,33.33
03,013,01,009,0201,0,843,12,855,1233,0,3,1,3,0,1,0,76.14,69.34 ,33.33
03,013,01,009,0202,0,1136,10,1146,1563,0,3,1,3,0,1,0,76.14,73.32 ,33.33
03,013,01,009,0203,0,1576,13,1589,2201,0,3,1,3,0,1,0,76.14,72.19 ,33.33
03,013,01,009,0204,0,1485,24,1509,2084,0,3,1,3,0,1,0,76.14,72.41 ,33.33
03,013,01,009,0205,0,1166,11,1177,1718,0,3,1,3,0,1,0,76.14,68.51 ,33.33
03,013,01,009,0206,0,523,5,528,763,0,3,1,3,0,1,0,76.14,69.20 ,33.33
03,013,01,009,0207,0,368,5,373,499,0,3,1,3,0,1,0,76.14,74.75 ,33.33
03,013,01,010,0208,0,1163,10,1173,1536,0,3,1,3,0,1,0,76.14,76.37 ,33.33
03,013,01,010,0209,0,1605,22,1627,2154,0,3,1,3,0,1,0,76.14,75.53 ,33.33
03,013,01,010,0210,0,1086,8,1094,1445,0,3,1,3,0,1,0,76.14,75.71 ,33.33
03,013,01,010,0211,0,747,5,752,865,0,3,1,3,0,1,0,76.14,86.94 ,33.33
03,013,01,010,0212,0,1860,20,1880,2464,0,3,1,3,0,1,0,76.14,76.30 ,33.33
03,013,01,010,0213,0,1311,34,1345,1864,0,3,1,3,0,1,0,76.14,72.16 ,33.33
03,013,01,010,0214,0,632,7,639,810,0,3,1,3,0,1,0,76.14,78.89 ,33.33
03,013,01,010,0215,0,1972,31,2003,2619,0,3,1,3,0,1,0,76.14,76.48 ,33.33
03,013,01,010,0216,0,1996,28,2024,2778,0,3,1,3,0,1,0,76.14,72.86 ,33.33
03,013,01,010,0217,0,706,2,708,897,0,3,1,3,0,1,0,76.14,78.93 ,33.33
03,013,01,010,0218,0,1025,17,1042,1321,0,3,1,3,0,1,0,76.14,78.88 ,33.33
03,013,01,010,0219,0,436,11,447,591,0,3,1,3,0,1,0,76.14,75.63 ,33.33
03,013,01,011,0220,0,1391,7,1398,2160,0,3,1,3,0,1,0,76.14,64.72 ,33.33
03,013,01,011,0221,0,862,3,865,1336,0,3,1,3,0,1,0,76.14,64.75 ,33.33
03,013,01,011,0222,0,560,2,562,864,0,3,1,3,0,1,0,76.14,65.05 ,33.33
03,013,01,011,0223,0,414,4,418,686,0,3,1,3,0,1,0,76.14,60.93 ,33.33
03,013,01,011,0224,0,641,4,645,950,0,3,1,3,0,1,0,76.14,67.89 ,33.33
03,013,01,011,0225,0,730,4,734,1224,0,3,1,3,0,1,0,76.14,59.97 ,33.33
03,013,01,011,0226,0,463,8,471,749,0,3,1,3,0,1,0,76.14,62.88 ,33.33
03,013,01,011,0227,0,560,6,566,904,0,3,1,3,0,1,0,76.14,62.61 ,33.33
03,013,01,011,0228,0,494,6,500,747,0,3,1,3,0,1,0,76.14,66.93 ,33.33
03,013,01,011,0229,0,898,6,904,1366,0,3,1,3,0,1,0,76.14,66.18 ,33.33
03,013,01,011,0230,0,905,15,920,1550,0,3,1,3,0,1,0,76.14,59.35 ,33.33
03,013,01,011,0231,0,1203,16,1219,1997,0,3,1,3,0,1,0,76.14,61.04 ,33.33
03,013,01,011,0232,0,815,8,823,1228,0,3,1,3,0,1,0,76.14,67.02 ,33.33
03,013,01,011,0233,0,612,3,615,995,0,3,1,3,0,1,0,76.14,61.81 ,33.33
03,013,01,011,0234,0,709,11,720,1032,0,3,1,3,0,1,0,76.14,69.77 ,33.33
03,013,01,011,0235,0,696,9,705,1027,0,3,1,3,0,1,0,76.14,68.65 ,33.33
03,013,01,011,0236,0,827,7,834,1144,0,3,1,3,0,1,0,76.14,72.90 ,33.33
03,013,01,011,0237,0,899,14,913,1397,0,3,1,3,0,1,0,76.14,65.35 ,33.33
03,013,01,011,0238,0,947,6,953,1402,0,3,1,3,0,1,0,76.14,67.97 ,33.33
03,013,01,012,0239,0,864,3,867,1226,0,3,1,3,0,1,0,76.14,70.72 ,33.33
03,013,01,012,0240,0,572,4,576,817,0,3,1,3,0,1,0,76.14,70.50 ,33.33
03,013,01,012,0241,0,878,10,888,1365,0,3,1,3,0,1,0,76.14,65.05 ,33.33
03,013,01,012,0242,0,682,8,690,929,0,3,1,3,0,1,0,76.14,74.27 ,33.33
03,013,01,012,0243,0,395,1,396,532,0,3,1,3,0,1,0,76.14,74.44 ,33.33
03,013,01,012,0244,0,903,10,913,1305,0,3,1,3,0,1,0,76.14,69.96 ,33.33
03,013,01,012,0245,0,903,6,909,1162,0,3,1,3,0,1,0,76.14,78.23 ,33.33
03,013,01,012,0246,0,901,12,913,1371,0,3,1,3,0,1,0,76.14,66.59 ,33.33
03,013,01,012,0247,0,934,20,954,1645,0,3,1,3,0,1,0,76.14,57.99 ,33.33
03,013,01,012,0248,0,1210,20,1230,1873,0,3,1,3,0,1,0,76.14,65.67 ,33.33
03,013,01,012,0249,0,988,12,1000,1510,0,3,1,3,0,1,0,76.14,66.23 ,33.33
03,013,01,012,0250,0,1036,6,1042,1461,0,3,1,3,0,1,0,76.14,71.32 ,33.33
03,013,01,012,0251,0,668,8,676,1052,0,3,1,3,0,1,0,76.14,64.26 ,33.33
03,013,01,012,0252,0,673,4,677,1219,0,3,1,3,0,1,0,76.14,55.54 ,33.33
03,013,01,013,0253,0,1897,17,1914,2931,0,3,1,3,0,1,0,76.14,65.30 ,33.33
03,013,01,013,0254,0,1599,15,1614,2629,0,3,1,3,0,1,0,76.14,61.39 ,33.33
03,013,01,013,0255,0,981,5,986,1343,0,3,1,3,0,1,0,76.14,73.42 ,33.33
03,013,01,013,0256,0,380,5,385,568,0,3,1,3,0,1,0,76.14,67.78 ,33.33
03,013,01,013,0257,0,1286,12,1298,1873,0,3,1,3,0,1,0,76.14,69.30 ,33.33
03,013,01,013,0258,0,1101,10,1111,1613,0,3,1,3,0,1,0,76.14,68.88 ,33.33
03,013,01,013,0259,0,2371,14,2385,3631,0,3,1,3,0,1,0,76.14,65.68 ,33.33
03,013,01,013,0260,0,1338,18,1356,2208,0,3,1,3,0,1,0,76.14,61.41 ,33.33
03,013,01,013,0261,0,1142,12,1154,1673,0,3,1,3,0,1,0,76.14,68.98 ,33.33
03,013,01,013,0262,0,1281,8,1289,1913,0,3,1,3,0,1,0,76.14,67.38 ,33.33
03,013,01,013,0263,0,800,11,811,1344,0,3,1,3,0,1,0,76.14,60.34 ,33.33
03,013,01,013,0264,0,2005,22,2027,2910,0,3,1,3,0,1,0,76.14,69.66 ,33.33
03,013,01,013,0265,0,631,4,635,883,0,3,1,3,0,1,0,76.14,71.91 ,33.33
03,013,01,013,0266,0,672,8,680,970,0,3,1,3,0,1,0,76.14,70.10 ,33.33
03,013,01,013,0267,0,1273,11,1284,2275,0,3,1,3,0,1,0,76.14,56.44 ,33.33
03,013,01,013,0268,0,839,11,850,1331,0,3,1,3,0,1,0,76.14,63.86 ,33.33
03,013,01,013,0269,0,1632,24,1656,2492,0,3,1,3,0,1,0,76.14,66.45 ,33.33
03,013,01,013,0270,0,1696,22,1718,2565,0,3,1,3,0,1,0,76.14,66.98 ,33.33
03,013,01,013,0271,0,1647,27,1674,2328,0,3,1,3,0,1,0,76.14,71.91 ,33.33
03,013,01,013,0272,0,1137,16,1153,1689,0,3,1,3,0,1,0,76.14,68.27 ,33.33
03,013,01,013,0273,0,1452,19,1471,2106,0,3,1,3,0,1,0,76.14,69.85 ,33.33
03,013,01,013,0274,0,713,9,722,1191,0,3,1,3,0,1,0,76.14,60.62 ,33.33
03,013,01,013,0275,0,484,4,488,784,0,3,1,3,0,1,0,76.14,62.24 ,33.33
03,013,01,014,0276,0,942,10,952,1402,0,3,1,3,0,1,0,76.14,67.90 ,33.33
03,013,01,014,0277,0,578,8,586,856,0,3,1,3,0,1,0,76.14,68.46 ,33.33
03,013,01,014,0278,0,488,1,489,656,0,3,1,3,0,1,0,76.14,74.54 ,33.33
03,013,01,014,0279,0,431,6,437,580,0,3,1,3,0,1,0,76.14,75.34 ,33.33
03,013,01,014,0280,0,901,10,911,1294,0,3,1,3,0,1,0,76.14,70.40 ,33.33
03,013,01,014,0281,0,652,1,653,965,0,3,1,3,0,1,0,76.14,67.67 ,33.33
03,013,01,014,0282,0,422,4,426,626,0,3,1,3,0,1,0,76.14,68.05 ,33.33
03,013,01,014,0283,0,339,2,341,461,0,3,1,3,0,1,0,76.14,73.97 ,33.33
03,013,01,014,0284,0,1830,16,1846,2580,0,3,1,3,0,1,0,76.14,71.55 ,33.33
03,013,01,014,0285,0,324,1,325,426,0,3,1,3,0,1,0,76.14,76.29 ,33.33
03,013,01,014,0286,0,377,3,380,526,0,3,1,3,0,1,0,76.14,72.24 ,33.33
03,013,01,014,0287,0,455,8,463,641,0,3,1,3,0,1,0,76.14,72.23 ,33.33
03,013,01,014,0288,0,734,11,745,1145,0,3,1,3,0,1,0,76.14,65.07 ,33.33
03,013,01,014,0289,0,723,6,729,1066,0,3,1,3,0,1,0,76.14,68.39 ,33.33
03,013,01,014,0290,0,691,9,700,933,0,3,1,3,0,1,0,76.14,75.03 ,33.33
03,013,01,015,0291,0,1252,9,1261,1916,0,3,1,3,0,1,0,76.14,65.81 ,33.33
03,013,01,015,0292,0,829,3,832,1253,0,3,1,3,0,1,0,76.14,66.40 ,33.33
03,013,01,015,0293,0,710,5,715,1086,0,3,1,3,0,1,0,76.14,65.84 ,33.33
03,013,01,015,0294,0,516,5,521,793,0,3,1,3,0,1,0,76.14,65.70 ,33.33
03,013,01,015,0295,0,1064,15,1079,1676,0,3,1,3,0,1,0,76.14,64.38 ,33.33
03,013,01,015,0296,0,773,8,781,1306,0,3,1,3,0,1,0,76.14,59.80 ,33.33
03,013,01,015,0297,0,668,13,681,1053,0,3,1,3,0,1,0,76.14,64.67 ,33.33
03,013,01,016,0298,0,916,6,922,1415,0,3,1,3,0,1,0,76.14,65.16 ,33.33
03,013,01,016,0299,0,550,5,555,816,0,3,1,3,0,1,0,76.14,68.01 ,33.33
03,013,01,016,0300,0,685,6,691,1011,0,3,1,3,0,1,0,76.14,68.35 ,33.33
03,013,01,016,0301,0,473,3,476,752,0,3,1,3,0,1,0,76.14,63.30 ,33.33
03,013,01,016,0302,0,1166,16,1182,1832,0,3,1,3,0,1,0,76.14,64.52 ,33.33
03,013,01,016,0303,0,1989,14,2003,3294,0,3,1,3,0,1,0,76.14,60.81 ,33.33
03,013,01,016,0304,0,1301,8,1309,1908,0,3,1,3,0,1,0,76.14,68.61 ,33.33
03,013,01,016,0305,0,1101,9,1110,1712,0,3,1,3,0,1,0,76.14,64.84 ,33.33
03,013,01,016,0306,0,1403,10,1413,2210,0,3,1,3,0,1,0,76.14,63.94 ,33.33
03,013,01,016,0307,0,428,1,429,804,0,3,1,3,0,1,0,76.14,53.36 ,33.33
03,013,01,016,0308,0,543,3,546,1044,0,3,1,3,0,1,0,76.14,52.30 ,33.33
03,013,01,016,0309,0,1681,20,1701,2590,0,3,1,3,0,1,0,76.14,65.68 ,33.33
03,013,01,016,0310,0,389,0,389,555,0,3,1,3,0,1,0,76.14,70.09 ,33.33
03,013,01,016,0311,0,533,8,541,925,0,3,1,3,0,1,0,76.14,58.49 ,33.33
03,013,01,016,0312,0,255,4,259,436,0,3,1,3,0,1,0,76.14,59.40 ,33.33
03,013,01,017,0313,0,1071,5,1076,1505,0,3,1,3,0,1,0,76.14,71.50 ,33.33
03,013,01,017,0314,0,1471,12,1483,2141,0,3,1,3,0,1,0,76.14,69.27 ,33.33
03,013,01,017,0315,0,1293,12,1305,1858,0,3,1,3,0,1,0,76.14,70.24 ,33.33
03,013,01,017,0316,0,467,6,473,648,0,3,1,3,0,1,0,76.14,72.99 ,33.33
03,013,01,017,0317,0,588,3,591,752,0,3,1,3,0,1,0,76.14,78.59 ,33.33
03,013,01,017,0318,0,1539,16,1555,2142,0,3,1,3,0,1,0,76.14,72.60 ,33.33
03,013,01,017,0319,0,1380,11,1391,1909,0,3,1,3,0,1,0,76.14,72.87 ,33.33
03,013,01,017,0320,0,1625,15,1640,2104,0,3,1,3,0,1,0,76.14,77.95 ,33.33
03,013,01,017,0321,0,1826,17,1843,2723,0,3,1,3,0,1,0,76.14,67.68 ,33.33
03,013,01,017,0322,0,882,9,891,1211,0,3,1,3,0,1,0,76.14,73.58 ,33.33
03,013,01,017,0323,0,1348,10,1358,1967,0,3,1,3,0,1,0,76.14,69.04 ,33.33
03,013,01,017,0324,0,1054,8,1062,1602,0,3,1,3,0,1,0,76.14,66.29 ,33.33
03,013,01,017,0325,0,916,9,925,1308,0,3,1,3,0,1,0,76.14,70.72 ,33.33
03,013,01,017,0326,0,2132,17,2149,3526,0,3,1,3,0,1,0,76.14,60.95 ,33.33
03,013,01,017,0327,0,1294,12,1306,2120,0,3,1,3,0,1,0,76.14,61.60 ,33.33
03,013,01,018,0328,0,1213,12,1225,1722,0,3,1,3,0,1,0,76.14,71.14 ,33.33
03,013,01,018,0329,0,909,9,918,1385,0,3,1,3,0,1,0,76.14,66.28 ,33.33
03,013,01,018,0330,0,675,7,682,969,0,3,1,3,0,1,0,76.14,70.38 ,33.33
03,013,01,018,0331,0,783,5,788,1011,0,3,1,3,0,1,0,76.14,77.94 ,33.33
03,013,01,018,0332,0,591,7,598,798,0,3,1,3,0,1,0,76.14,74.94 ,33.33
03,013,01,018,0333,0,983,12,995,1407,0,3,1,3,0,1,0,76.14,70.72 ,33.33
03,013,01,018,0334,0,467,9,476,655,0,3,1,3,0,1,0,76.14,72.67 ,33.33
03,013,01,018,0335,0,1104,11,1115,1624,0,3,1,3,0,1,0,76.14,68.66 ,33.33
03,013,01,019,0336,0,996,10,1006,1380,0,3,1,3,0,1,0,76.14,72.90 ,33.33
03,013,01,019,0337,0,1120,7,1127,1617,0,3,1,3,0,1,0,76.14,69.70 ,33.33
03,013,01,019,0338,0,665,6,671,897,0,3,1,3,0,1,0,76.14,74.80 ,33.33
03,013,01,019,0339,0,1063,7,1070,1473,0,3,1,3,0,1,0,76.14,72.64 ,33.33
03,013,01,019,0340,0,2128,21,2149,2961,0,3,1,3,0,1,0,76.14,72.58 ,33.33
03,013,01,019,0341,0,628,4,632,889,0,3,1,3,0,1,0,76.14,71.09 ,33.33
03,013,01,019,0342,0,825,5,830,1266,0,3,1,3,0,1,0,76.14,65.56 ,33.33
03,013,01,019,0343,0,1131,14,1145,1737,0,3,1,3,0,1,0,76.14,65.92 ,33.33
03,013,01,019,0344,0,2003,17,2020,2842,0,3,1,3,0,1,0,76.14,71.08 ,33.33
03,013,01,019,0345,0,807,5,812,1155,0,3,1,3,0,1,0,76.14,70.30 ,33.33
03,013,01,020,0346,0,1228,14,1242,1724,0,3,1,3,0,1,0,76.14,72.04 ,33.33
03,013,01,020,0347,0,703,7,710,992,0,3,1,3,0,1,0,76.14,71.57 ,33.33
03,013,01,020,0348,0,423,3,426,607,0,3,1,3,0,1,0,76.14,70.18 ,33.33
03,013,01,020,0349,0,554,5,559,756,0,3,1,3,0,1,0,76.14,73.94 ,33.33
03,013,01,020,0350,0,679,4,683,1042,0,3,1,3,0,1,0,76.14,65.55 ,33.33
03,013,01,020,0351,0,707,8,715,998,0,3,1,3,0,1,0,76.14,71.64 ,33.33
03,013,01,020,0352,0,746,7,753,1068,0,3,1,3,0,1,0,76.14,70.51 ,33.33
03,013,01,020,0353,0,758,7,765,1085,0,3,1,3,0,1,0,76.14,70.51 ,33.33
03,013,01,020,0354,0,589,5,594,873,0,3,1,3,0,1,0,76.14,68.04 ,33.33
03,013,01,020,0355,0,408,5,413,608,0,3,1,3,0,1,0,76.14,67.93 ,33.33
03,013,01,021,0356,0,1049,10,1059,1508,0,3,1,3,0,1,0,76.14,70.23 ,33.33
03,013,01,021,0357,0,1270,14,1284,1789,0,3,1,3,0,1,0,76.14,71.77 ,33.33
03,013,01,021,0358,0,678,9,687,1001,0,3,1,3,0,1,0,76.14,68.63 ,33.33
03,013,01,021,0359,0,1060,9,1069,1687,0,3,1,3,0,1,0,76.14,63.37 ,33.33
03,013,01,021,0360,0,1210,13,1223,1827,0,3,1,3,0,1,0,76.14,66.94 ,33.33
03,013,01,021,0361,0,1408,15,1423,2211,0,3,1,3,0,1,0,76.14,64.36 ,33.33
03,013,01,021,0362,0,799,4,803,1173,0,3,1,3,0,1,0,76.14,68.46 ,33.33
03,013,01,021,0363,0,582,8,590,895,0,3,1,3,0,1,0,76.14,65.92 ,33.33
03,013,01,021,0364,0,880,3,883,1204,0,3,1,3,0,1,0,76.14,73.34 ,33.33
03,013,01,021,0365,0,692,4,696,943,0,3,1,3,0,1,0,76.14,73.81 ,33.33
03,013,01,021,0366,0,749,13,762,1089,0,3,1,3,0,1,0,76.14,69.97 ,33.33
03,013,01,021,0367,0,1408,17,1425,2090,0,3,1,3,0,1,0,76.14,68.18 ,33.33
03,013,01,022,0368,0,885,10,895,1629,0,3,1,3,0,1,0,76.14,54.94 ,33.33
03,013,01,022,0369,0,543,11,554,949,0,3,1,3,0,1,0,76.14,58.38 ,33.33
03,013,01,022,0370,0,425,6,431,762,0,3,1,3,0,1,0,76.14,56.56 ,33.33
03,013,01,022,0371,0,662,3,665,1332,0,3,1,3,0,1,0,76.14,49.92 ,33.33
03,013,01,022,0372,0,472,6,478,1023,0,3,1,3,0,1,0,76.14,46.73 ,33.33
03,013,01,022,0373,0,453,6,459,942,0,3,1,3,0,1,0,76.14,48.73 ,33.33
03,013,01,022,0374,0,610,7,617,1197,0,3,1,3,0,1,0,76.14,51.55 ,33.33
03,013,01,022,0375,0,330,4,334,675,0,3,1,3,0,1,0,76.14,49.48 ,33.33
03,013,01,023,0376,0,861,11,872,1369,0,3,1,3,0,1,0,76.14,63.70 ,33.33
03,013,01,023,0377,0,363,0,363,576,0,3,1,3,0,1,0,76.14,63.02 ,33.33
03,013,01,023,0378,0,426,2,428,798,0,3,1,3,0,1,0,76.14,53.63 ,33.33
03,013,01,023,0379,0,472,4,476,849,0,3,1,3,0,1,0,76.14,56.07 ,33.33
03,013,01,023,0380,0,253,3,256,450,0,3,1,3,0,1,0,76.14,56.89 ,33.33
03,013,01,023,0381,0,589,13,602,1078,0,3,1,3,0,1,0,76.14,55.84 ,33.33
03,013,01,023,0382,0,775,7,782,1484,0,3,1,3,0,1,0,76.14,52.70 ,33.33
03,013,01,023,0383,0,276,4,280,438,0,3,1,3,0,1,0,76.14,63.93 ,33.33
03,013,01,023,0384,0,257,4,261,448,0,3,1,3,0,1,0,76.14,58.26 ,33.33
03,013,01,023,0385,0,307,3,310,534,0,3,1,3,0,1,0,76.14,58.05 ,33.33
03,013,01,023,0386,0,292,7,299,538,0,3,1,3,0,1,0,76.14,55.58 ,33.33
03,013,01,024,0387,0,793,9,802,1391,0,3,1,3,0,1,0,76.14,57.66 ,33.33
03,013,01,024,0388,0,126,2,128,260,0,3,1,3,0,1,0,76.14,49.23 ,33.33
03,013,01,024,0389,0,608,4,612,1123,0,3,1,3,0,1,0,76.14,54.50 ,33.33
03,013,01,024,0390,0,597,6,603,1043,0,3,1,3,0,1,0,76.14,57.81 ,33.33
03,013,01,024,0391,0,240,1,241,452,0,3,1,3,0,1,0,76.14,53.32 ,33.33
03,013,01,024,0392,0,340,9,349,683,0,3,1,3,0,1,0,76.14,51.10 ,33.33
03,013,01,024,0393,0,127,1,128,239,0,3,1,3,0,1,0,76.14,53.56 ,33.33
03,013,01,024,0394,0,176,3,179,296,0,3,1,3,0,1,0,76.14,60.47 ,33.33
03,013,01,025,0395,0,643,6,649,1042,0,3,1,3,0,1,0,76.14,62.28 ,33.33
03,013,01,025,0396,0,1161,12,1173,1769,0,3,1,3,0,1,0,76.14,66.31 ,33.33
03,013,01,025,0397,0,593,7,600,1164,0,3,1,3,0,1,0,76.14,51.55 ,33.33
03,013,01,025,0398,0,493,7,500,1030,0,3,1,3,0,1,0,76.14,48.54 ,33.33
03,013,01,026,0399,0,70,1,71,112,0,3,1,3,0,1,0,76.14,63.39 ,33.33
03,013,01,026,0400,0,19,1,20,37,0,3,1,3,0,1,0,76.14,54.05 ,33.33
03,013,01,026,0401,0,28,0,28,48,0,3,1,3,0,1,0,76.14,58.33 ,33.33
03,013,01,026,0402,0,2,0,2,5,0,3,1,3,0,1,0,76.14,40.00 ,33.33
03,013,01,026,0403,0,21,0,21,38,0,3,1,3,0,1,0,76.14,55.26 ,33.33
03,013,01,026,0404,0,28,1,29,46,0,3,1,3,0,1,0,76.14,63.04 ,33.33
03,013,01,026,0405,0,21,0,21,39,0,3,1,3,0,1,0,76.14,53.85 ,33.33
03,013,01,026,0406,0,8,0,8,14,0,3,1,3,0,1,0,76.14,57.14 ,33.33
03,013,01,026,0407,0,6,0,6,11,0,3,1,3,0,1,0,76.14,54.55 ,33.33
03,013,01,026,0408,0,5,0,5,22,0,3,1,3,0,1,0,76.14,22.73 ,33.33
03,013,01,027,0409,0,14,0,14,25,0,3,1,3,0,1,0,76.14,56.00 ,33.33
03,013,01,027,0410,0,4,0,4,5,0,3,1,3,0,1,0,76.14,80.00 ,33.33
03,013,01,027,0411,0,2,0,2,4,0,3,1,3,0,1,0,76.14,50.00 ,33.33
03,013,01,027,0412,0,2,0,2,5,0,3,1,3,0,1,0,76.14,40.00 ,33.33
03,013,01,027,0413,0,4,0,4,8,0,3,1,3,0,1,0,76.14,50.00 ,33.33
03,013,01,027,0414,0,2,0,2,4,0,3,1,3,0,1,0,76.14,50.00 ,33.33
03,013,01,028,0415,0,5,1,6,12,0,3,1,3,0,1,0,76.14,50.00 ,33.33
03,013,01,028,0416,0,57,0,57,87,0,3,1,3,0,1,0,76.14,65.52 ,33.33
03,013,01,028,0417,0,33,1,34,46,0,3,1,3,0,1,0,76.14,73.91 ,33.33
03,013,01,028,0418,0,31,1,32,51,0,3,1,3,0,1,0,76.14,62.75 ,33.33
03,013,01,028,0419,0,8,0,8,17,0,3,1,3,0,1,0,76.14,47.06 ,33.33
03,013,01,028,0420,0,87,1,88,149,0,3,1,3,0,1,0,76.14,59.06 ,33.33
03,013,01,029,0421,0,25,0,25,47,0,3,1,3,0,1,0,76.14,53.19 ,33.33
03,013,01,029,0422,0,16,0,16,36,0,3,1,3,0,1,0,76.14,44.44 ,33.33
03,013,01,029,0423,0,17,0,17,33,0,3,1,3,0,1,0,76.14,51.52 ,33.33
03,013,01,029,0424,0,6,0,6,14,0,3,1,3,0,1,0,76.14,42.86 ,33.33
03,013,01,029,0425,0,1,0,1,6,0,3,1,3,0,1,0,76.14,16.67 ,33.33
03,013,01,029,0426,0,18,0,18,33,0,3,1,3,0,1,0,76.14,54.55 ,33.33
03,013,01,030,0427,0,17,3,20,39,0,3,1,3,0,1,0,76.14,51.28 ,33.33
03,013,01,030,0428,0,23,0,23,39,0,3,1,3,0,1,0,76.14,58.97 ,33.33
03,013,01,030,0429,0,48,1,49,74,0,3,1,3,0,1,0,76.14,66.22 ,33.33
03,013,01,030,0430,0,53,0,53,106,0,3,1,3,0,1,0,76.14,50.00 ,33.33
03,013,01,030,0431,0,30,1,31,46,0,3,1,3,0,1,0,76.14,67.39 ,33.33
03,013,01,030,0432,0,44,1,45,57,0,3,1,3,0,1,0,76.14,78.95 ,33.33
03,013,01,030,0433,0,35,1,36,70,0,3,1,3,0,1,0,76.14,51.43 ,33.33
03,013,01,031,0434,0,36,0,36,68,0,3,1,3,0,1,0,76.14,52.94 ,33.33
03,013,01,031,0435,0,32,1,33,59,0,3,1,3,0,1,0,76.14,55.93 ,33.33
03,013,01,031,0436,0,6,0,6,9,0,3,1,3,0,1,0,76.14,66.67 ,33.33
03,013,01,031,0437,0,95,0,95,153,0,3,1,3,0,1,0,76.14,62.09 ,33.33
03,013,01,031,0438,0,76,2,78,124,0,3,1,3,0,1,0,76.14,62.90 ,33.33
03,013,01,031,0439,0,14,0,14,20,0,3,1,3,0,1,0,76.14,70.00 ,33.33
03,013,01,032,0440,0,9,0,9,14,0,3,1,3,0,1,0,76.14,64.29 ,33.33
03,013,01,032,0441,0,22,0,22,38,0,3,1,3,0,1,0,76.14,57.89 ,33.33
03,013,01,032,0442,0,9,0,9,14,0,3,1,3,0,1,0,76.14,64.29 ,33.33
03,013,01,032,0443,0,18,0,18,29,0,3,1,3,0,1,0,76.14,62.07 ,33.33
03,013,01,032,0444,0,30,0,30,45,0,3,1,3,0,1,0,76.14,66.67 ,33.33
03,013,01,032,0445,0,32,0,32,72,0,3,1,3,0,1,0,76.14,44.44 ,33.33
03,013,01,032,0446,0,34,0,34,58,0,3,1,3,0,1,0,76.14,58.62 ,33.33
03,013,01,032,0447,0,11,0,11,22,0,3,1,3,0,1,0,76.14,50.00 ,33.33
03,013,01,033,0448,0,112,2,114,176,0,3,1,3,0,1,0,76.14,64.77 ,33.33
03,013,01,033,0449,0,36,0,36,64,0,3,1,3,0,1,0,76.14,56.25 ,33.33
03,013,01,033,0450,0,8,0,8,19,0,3,1,3,0,1,0,76.14,42.11 ,33.33
03,013,01,033,0451,0,48,1,49,91,0,3,1,3,0,1,0,76.14,53.85 ,33.33
03,013,01,033,0452,0,15,0,15,24,0,3,1,3,0,1,0,76.14,62.50 ,33.33
03,013,01,033,0453,0,16,1,17,27,0,3,1,3,0,1,0,76.14,62.96 ,33.33
03,014,01,001,0001,0,854,15,869,1397,0,3,1,3,0,1,0,76.14,62.20 ,33.33
03,014,01,001,0002,0,1244,15,1259,1900,0,3,1,3,0,1,0,76.14,66.26 ,33.33
03,014,01,001,0003,0,1958,15,1973,3103,0,3,1,3,0,1,0,76.14,63.58 ,33.33
03,014,01,001,0004,0,1503,22,1525,2538,0,3,1,3,0,1,0,76.14,60.09 ,33.33
03,014,01,001,0005,0,432,7,439,717,0,3,1,3,0,1,0,76.14,61.23 ,33.33
03,014,01,001,0006,0,681,5,686,1117,0,3,1,3,0,1,0,76.14,61.41 ,33.33
03,014,01,001,0007,0,248,1,249,444,0,3,1,3,0,1,0,76.14,56.08 ,33.33
03,014,01,001,0008,0,1057,8,1065,1750,0,3,1,3,0,1,0,76.14,60.86 ,33.33
03,014,01,001,0009,0,484,9,493,797,0,3,1,3,0,1,0,76.14,61.86 ,33.33
03,014,01,001,0010,0,422,2,424,677,0,3,1,3,0,1,0,76.14,62.63 ,33.33
03,014,01,001,0011,0,458,11,469,770,0,3,1,3,0,1,0,76.14,60.91 ,33.33
03,014,01,001,0012,0,563,9,572,991,0,3,1,3,0,1,0,76.14,57.72 ,33.33
03,014,01,001,0013,0,885,17,902,1514,0,3,1,3,0,1,0,76.14,59.58 ,33.33
03,014,01,001,0014,0,544,3,547,889,0,3,1,3,0,1,0,76.14,61.53 ,33.33
03,014,01,001,0015,0,702,7,709,1116,0,3,1,3,0,1,0,76.14,63.53 ,33.33
03,014,01,001,0016,0,523,3,526,823,0,3,1,3,0,1,0,76.14,63.91 ,33.33
03,014,01,001,0017,0,283,1,284,489,0,3,1,3,0,1,0,76.14,58.08 ,33.33
03,014,01,001,0018,0,1237,20,1257,2062,0,3,1,3,0,1,0,76.14,60.96 ,33.33
03,014,01,001,0019,0,453,13,466,790,0,3,1,3,0,1,0,76.14,58.99 ,33.33
03,014,01,001,0020,0,311,4,315,585,0,3,1,3,0,1,0,76.14,53.85 ,33.33
03,014,01,001,0021,0,737,13,750,1247,0,3,1,3,0,1,0,76.14,60.14 ,33.33
03,014,01,001,0022,0,2143,27,2170,3628,0,3,1,3,0,1,0,76.14,59.81 ,33.33
03,014,01,001,0023,0,1154,21,1175,1900,0,3,1,3,0,1,0,76.14,61.84 ,33.33
03,014,01,001,0024,0,2084,18,2102,3313,0,3,1,3,0,1,0,76.14,63.45 ,33.33
03,014,01,001,0025,0,446,6,452,788,0,3,1,3,0,1,0,76.14,57.36 ,33.33
03,014,01,001,0026,0,900,18,918,1591,0,3,1,3,0,1,0,76.14,57.70 ,33.33
03,014,01,001,0027,0,453,12,465,782,0,3,1,3,0,1,0,76.14,59.46 ,33.33
03,014,01,001,0028,0,506,13,519,786,0,3,1,3,0,1,0,76.14,66.03 ,33.33
03,014,01,001,0029,0,551,9,560,941,0,3,1,3,0,1,0,76.14,59.51 ,33.33
03,014,01,001,0030,0,3108,43,3151,5615,0,3,1,3,0,1,0,76.14,56.12 ,33.33
03,014,01,001,0031,0,941,14,955,1623,0,3,1,3,0,1,0,76.14,58.84 ,33.33
03,014,01,001,0032,0,823,10,833,1376,0,3,1,3,0,1,0,76.14,60.54 ,33.33
03,014,01,001,0033,0,561,13,574,973,0,3,1,3,0,1,0,76.14,58.99 ,33.33
03,014,01,001,0034,0,635,11,646,1101,0,3,1,3,0,1,0,76.14,58.67 ,33.33
03,014,01,001,0035,0,248,5,253,478,0,3,1,3,0,1,0,76.14,52.93 ,33.33
03,014,01,001,0036,0,1144,45,1189,1785,0,3,1,3,0,1,0,76.14,66.61 ,33.33
03,014,01,001,0037,0,523,6,529,1061,0,3,1,3,0,1,0,76.14,49.86 ,33.33
03,014,01,001,0038,0,949,10,959,1390,0,3,1,3,0,1,0,76.14,68.99 ,33.33
03,014,01,001,0039,0,770,7,777,1340,0,3,1,3,0,1,0,76.14,57.99 ,33.33
03,014,01,001,0040,0,1037,12,1049,1738,0,3,1,3,0,1,0,76.14,60.36 ,33.33
03,014,01,001,0041,0,662,4,666,1063,0,3,1,3,0,1,0,76.14,62.65 ,33.33
03,014,01,001,0042,0,516,7,523,973,0,3,1,3,0,1,0,76.14,53.75 ,33.33
03,014,01,001,0043,0,468,4,472,832,0,3,1,3,0,1,0,76.14,56.73 ,33.33
03,014,01,001,0044,0,496,3,499,899,0,3,1,3,0,1,0,76.14,55.51 ,33.33
03,014,01,001,0045,0,458,5,463,844,0,3,1,3,0,1,0,76.14,54.86 ,33.33
03,014,01,001,0046,0,640,24,664,1155,0,3,1,3,0,1,0,76.14,57.49 ,33.33
03,014,01,002,0047,0,287,3,290,514,0,3,1,3,0,1,0,76.14,56.42 ,33.33
03,014,01,002,0048,0,110,1,111,204,0,3,1,3,0,1,0,76.14,54.41 ,33.33
03,014,01,002,0049,0,1292,18,1310,2394,0,3,1,3,0,1,0,76.14,54.72 ,33.33
03,014,01,002,0050,0,643,2,645,1129,0,3,1,3,0,1,0,76.14,57.13 ,33.33
03,014,01,002,0051,0,499,6,505,992,0,3,1,3,0,1,0,76.14,50.91 ,33.33
03,014,01,002,0052,0,298,6,304,574,0,3,1,3,0,1,0,76.14,52.96 ,33.33
03,014,01,002,0053,0,291,8,299,575,0,3,1,3,0,1,0,76.14,52.00 ,33.33
03,014,01,002,0054,0,73,0,73,139,0,3,1,3,0,1,0,76.14,52.52 ,33.33
03,014,01,003,0055,0,941,15,956,1720,0,3,1,3,0,1,0,76.14,55.58 ,33.33
03,014,01,003,0056,0,538,10,548,876,0,3,1,3,0,1,0,76.14,62.56 ,33.33
03,014,01,003,0057,0,375,12,387,652,0,3,1,3,0,1,0,76.14,59.36 ,33.33
03,014,01,003,0058,0,498,5,503,922,0,3,1,3,0,1,0,76.14,54.56 ,33.33
03,014,01,003,0059,0,363,4,367,737,0,3,1,3,0,1,0,76.14,49.80 ,33.33
03,014,01,003,0060,0,663,6,669,1343,0,3,1,3,0,1,0,76.14,49.81 ,33.33
03,014,01,003,0061,0,119,0,119,257,0,3,1,3,0,1,0,76.14,46.30 ,33.33
03,014,01,004,0062,0,1033,12,1045,1699,0,3,1,3,0,1,0,76.14,61.51 ,33.33
03,014,01,004,0063,0,589,5,594,1013,0,3,1,3,0,1,0,76.14,58.64 ,33.33
03,014,01,004,0064,0,644,10,654,1066,0,3,1,3,0,1,0,76.14,61.35 ,33.33
03,014,01,004,0065,0,576,10,586,1062,0,3,1,3,0,1,0,76.14,55.18 ,33.33
03,014,01,004,0066,0,130,3,133,241,0,3,1,3,0,1,0,76.14,55.19 ,33.33
03,014,01,004,0067,0,1972,34,2006,2996,0,3,1,3,0,1,0,76.14,66.96 ,33.33
03,014,01,004,0068,0,438,11,449,741,0,3,1,3,0,1,0,76.14,60.59 ,33.33
03,014,01,004,0069,0,221,1,222,418,0,3,1,3,0,1,0,76.14,53.11 ,33.33
03,014,01,004,0070,0,172,1,173,306,0,3,1,3,0,1,0,76.14,56.54 ,33.33
03,014,01,004,0071,0,580,7,587,1065,0,3,1,3,0,1,0,76.14,55.12 ,33.33
03,014,01,004,0072,0,241,5,246,473,0,3,1,3,0,1,0,76.14,52.01 ,33.33
03,014,01,004,0073,0,197,2,199,374,0,3,1,3,0,1,0,76.14,53.21 ,33.33
03,014,01,004,0074,0,143,2,145,269,0,3,1,3,0,1,0,76.14,53.90 ,33.33
03,014,01,005,0075,0,420,10,430,827,0,3,1,3,0,1,0,76.14,52.00 ,33.33
03,014,01,005,0076,0,563,6,569,1088,0,3,1,3,0,1,0,76.14,52.30 ,33.33
03,014,01,005,0077,0,535,10,545,1077,0,3,1,3,0,1,0,76.14,50.60 ,33.33
03,014,01,005,0078,0,449,6,455,852,0,3,1,3,0,1,0,76.14,53.40 ,33.33
03,014,01,005,0079,0,348,4,352,677,0,3,1,3,0,1,0,76.14,51.99 ,33.33
03,014,01,005,0080,0,222,6,228,409,0,3,1,3,0,1,0,76.14,55.75 ,33.33
03,014,01,005,0081,0,556,4,560,1031,0,3,1,3,0,1,0,76.14,54.32 ,33.33
03,014,01,006,0082,0,1055,11,1066,1820,0,3,1,3,0,1,0,76.14,58.57 ,33.33
03,014,01,006,0083,0,714,16,730,1426,0,3,1,3,0,1,0,76.14,51.19 ,33.33
03,014,01,006,0084,0,357,6,363,703,0,3,1,3,0,1,0,76.14,51.64 ,33.33
03,014,01,006,0085,0,56,1,57,128,0,3,1,3,0,1,0,76.14,44.53 ,33.33
03,014,01,006,0086,0,249,3,252,412,0,3,1,3,0,1,0,76.14,61.17 ,33.33
03,014,01,006,0087,0,484,8,492,882,0,3,1,3,0,1,0,76.14,55.78 ,33.33
03,014,01,006,0088,0,256,4,260,487,0,3,1,3,0,1,0,76.14,53.39 ,33.33
03,014,01,006,0089,0,207,3,210,406,0,3,1,3,0,1,0,76.14,51.72 ,33.33
03,014,01,006,0090,0,219,4,223,405,0,3,1,3,0,1,0,76.14,55.06 ,33.33
03,014,01,006,0091,0,91,1,92,192,0,3,1,3,0,1,0,76.14,47.92 ,33.33
03,014,01,007,0092,0,639,5,644,1306,0,3,1,3,0,1,0,76.14,49.31 ,33.33
03,014,01,007,0093,0,353,2,355,708,0,3,1,3,0,1,0,76.14,50.14 ,33.33
03,014,01,007,0094,0,99,2,101,212,0,3,1,3,0,1,0,76.14,47.64 ,33.33
03,014,01,007,0095,0,173,4,177,369,0,3,1,3,0,1,0,76.14,47.97 ,33.33
03,014,01,007,0096,0,421,3,424,720,0,3,1,3,0,1,0,76.14,58.89 ,33.33
03,014,01,007,0097,0,485,7,492,1568,0,3,1,3,0,1,0,76.14,31.38 ,33.33
03,014,01,007,0098,0,108,2,110,224,0,3,1,3,0,1,0,76.14,49.11 ,33.33
03,014,01,008,0099,0,193,3,196,468,0,3,1,3,0,1,0,76.14,41.88 ,33.33
03,014,01,008,0100,0,205,4,209,443,0,3,1,3,0,1,0,76.14,47.18 ,33.33
03,014,01,008,0101,0,675,10,685,1218,0,3,1,3,0,1,0,76.14,56.24 ,33.33
03,014,01,008,0102,0,244,5,249,567,0,3,1,3,0,1,0,76.14,43.92 ,33.33
03,014,01,008,0103,0,105,1,106,238,0,3,1,3,0,1,0,76.14,44.54 ,33.33
03,014,01,008,0104,0,251,2,253,547,0,3,1,3,0,1,0,76.14,46.25 ,33.33
03,014,01,008,0105,0,169,3,172,328,0,3,1,3,0,1,0,76.14,52.44 ,33.33
03,014,01,009,0106,0,792,6,798,1349,0,3,1,3,0,1,0,76.14,59.15 ,33.33
03,014,01,009,0107,0,81,0,81,160,0,3,1,3,0,1,0,76.14,50.63 ,33.33
03,014,01,009,0108,0,392,6,398,749,0,3,1,3,0,1,0,76.14,53.14 ,33.33
03,014,01,009,0109,0,209,1,210,389,0,3,1,3,0,1,0,76.14,53.98 ,33.33
03,014,01,009,0110,0,581,11,592,1185,0,3,1,3,0,1,0,76.14,49.96 ,33.33
03,014,01,009,0111,0,735,6,741,1341,0,3,1,3,0,1,0,76.14,55.26 ,33.33
03,014,01,009,0112,0,301,3,304,590,0,3,1,3,0,1,0,76.14,51.53 ,33.33
03,014,01,009,0113,0,317,5,322,638,0,3,1,3,0,1,0,76.14,50.47 ,33.33
03,014,01,009,0114,0,141,0,141,254,0,3,1,3,0,1,0,76.14,55.51 ,33.33
03,014,01,010,0115,0,157,0,157,272,0,3,1,3,0,1,0,76.14,57.72 ,33.33
03,014,01,010,0116,0,622,4,626,1148,0,3,1,3,0,1,0,76.14,54.53 ,33.33
03,014,01,010,0117,0,493,10,503,904,0,3,1,3,0,1,0,76.14,55.64 ,33.33
03,014,01,010,0118,0,54,2,56,137,0,3,1,3,0,1,0,76.14,40.88 ,33.33
03,014,01,010,0119,0,42,1,43,90,0,3,1,3,0,1,0,76.14,47.78 ,33.33
03,014,01,011,0120,0,297,7,304,596,0,3,1,3,0,1,0,76.14,51.01 ,33.33
03,014,01,011,0121,0,336,2,338,630,0,3,1,3,0,1,0,76.14,53.65 ,33.33
03,014,01,011,0122,0,266,4,270,492,0,3,1,3,0,1,0,76.14,54.88 ,33.33
03,014,01,012,0123,0,11,0,11,20,0,3,1,3,0,1,0,76.14,55.00 ,33.33
03,014,01,012,0124,0,30,2,32,46,0,3,1,3,0,1,0,76.14,69.57 ,33.33
03,014,01,012,0125,0,56,0,56,130,0,3,1,3,0,1,0,76.14,43.08 ,33.33
03,014,01,012,0126,0,60,1,61,90,0,3,1,3,0,1,0,76.14,67.78 ,33.33
03,014,01,012,0127,0,18,1,19,30,0,3,1,3,0,1,0,76.14,63.33 ,33.33
03,014,01,012,0128,0,19,2,21,33,0,3,1,3,0,1,0,76.14,63.64 ,33.33
03,014,01,013,0129,0,58,0,58,108,0,3,1,3,0,1,0,76.14,53.70 ,33.33
03,014,01,013,0130,0,18,0,18,27,0,3,1,3,0,1,0,76.14,66.67 ,33.33
03,014,01,013,0131,0,16,1,17,21,0,3,1,3,0,1,0,76.14,80.95 ,33.33
03,014,01,013,0132,0,19,0,19,33,0,3,1,3,0,1,0,76.14,57.58 ,33.33
03,014,01,013,0133,0,63,1,64,108,0,3,1,3,0,1,0,76.14,59.26 ,33.33
03,014,01,014,0134,0,52,0,52,109,0,3,1,3,0,1,0,76.14,47.71 ,33.33
03,014,01,014,0135,0,18,0,18,46,0,3,1,3,0,1,0,76.14,39.13 ,33.33
03,014,01,014,0136,0,22,0,22,35,0,3,1,3,0,1,0,76.14,62.86 ,33.33
03,014,01,014,0137,0,11,0,11,20,0,3,1,3,0,1,0,76.14,55.00 ,33.33
03,014,01,014,0138,0,6,0,6,21,0,3,1,3,0,1,0,76.14,28.57 ,33.33
03,014,01,015,0139,0,105,0,105,184,0,3,1,3,0,1,0,76.14,57.07 ,33.33
03,014,01,015,0140,0,16,0,16,37,0,3,1,3,0,1,0,76.14,43.24 ,33.33
03,014,01,015,0141,0,26,1,27,67,0,3,1,3,0,1,0,76.14,40.30 ,33.33
03,014,01,015,0142,0,2,0,2,15,0,3,1,3,0,1,0,76.14,13.33 ,33.33
03,014,01,015,0143,0,6,0,6,30,0,3,1,3,0,1,0,76.14,20.00 ,33.33
03,014,01,015,0144,0,5,0,5,11,0,3,1,3,0,1,0,76.14,45.45 ,33.33
03,014,01,016,0145,0,25,0,25,62,0,3,1,3,0,1,0,76.14,40.32 ,33.33
03,014,01,016,0146,0,31,1,32,66,0,3,1,3,0,1,0,76.14,48.48 ,33.33
03,014,01,016,0147,0,1,0,1,10,0,3,1,3,0,1,0,76.14,10.00 ,33.33
03,014,01,016,0148,0,5,0,5,14,0,3,1,3,0,1,0,76.14,35.71 ,33.33
03,015,01,001,0001,0,955,6,961,1494,0,3,1,3,0,1,0,76.14,64.32 ,33.33
03,015,01,001,0002,0,2135,26,2161,3350,0,3,1,3,0,1,0,76.14,64.51 ,33.33
03,015,01,001,0003,0,1982,43,2025,3178,0,3,1,3,0,1,0,76.14,63.72 ,33.33
03,015,01,001,0004,0,386,8,394,657,0,3,1,3,0,1,0,76.14,59.97 ,33.33
03,015,01,001,0005,0,1511,17,1528,2596,0,3,1,3,0,1,0,76.14,58.86 ,33.33
03,015,01,001,0006,0,1057,22,1079,1710,0,3,1,3,0,1,0,76.14,63.10 ,33.33
03,015,01,001,0007,0,1480,28,1508,2401,0,3,1,3,0,1,0,76.14,62.81 ,33.33
03,015,01,001,0008,0,994,17,1011,1483,0,3,1,3,0,1,0,76.14,68.17 ,33.33
03,015,01,001,0009,0,213,0,213,344,0,3,1,3,0,1,0,76.14,61.92 ,33.33
03,015,01,001,0010,0,421,4,425,655,0,3,1,3,0,1,0,76.14,64.89 ,33.33
03,015,01,001,0011,0,400,7,407,687,0,3,1,3,0,1,0,76.14,59.24 ,33.33
03,015,01,001,0012,0,337,6,343,535,0,3,1,3,0,1,0,76.14,64.11 ,33.33
03,015,01,001,0013,0,403,0,403,646,0,3,1,3,0,1,0,76.14,62.38 ,33.33
03,015,01,001,0014,0,910,13,923,1411,0,3,1,3,0,1,0,76.14,65.41 ,33.33
03,015,01,001,0015,0,339,6,345,550,0,3,1,3,0,1,0,76.14,62.73 ,33.33
03,015,01,001,0016,0,573,9,582,833,0,3,1,3,0,1,0,76.14,69.87 ,33.33
03,015,01,001,0017,0,678,8,686,1094,0,3,1,3,0,1,0,76.14,62.71 ,33.33
03,015,01,001,0018,0,499,6,505,724,0,3,1,3,0,1,0,76.14,69.75 ,33.33
03,015,01,001,0019,0,497,7,504,776,0,3,1,3,0,1,0,76.14,64.95 ,33.33
03,015,01,001,0020,0,619,7,626,1004,0,3,1,3,0,1,0,76.14,62.35 ,33.33
03,015,01,001,0021,0,466,7,473,796,0,3,1,3,0,1,0,76.14,59.42 ,33.33
03,015,01,001,0022,0,1691,23,1714,2746,0,3,1,3,0,1,0,76.14,62.42 ,33.33
03,015,01,001,0023,0,1025,8,1033,1572,0,3,1,3,0,1,0,76.14,65.71 ,33.33
03,015,01,001,0024,0,2943,33,2976,4642,0,3,1,3,0,1,0,76.14,64.11 ,33.33
03,015,01,001,0025,0,1894,18,1912,3134,0,3,1,3,0,1,0,76.14,61.01 ,33.33
03,015,01,001,0026,0,1439,18,1457,2222,0,3,1,3,0,1,0,76.14,65.57 ,33.33
03,015,01,001,0027,0,1857,20,1877,3040,0,3,1,3,0,1,0,76.14,61.74 ,33.33
03,015,01,001,0028,0,1011,8,1019,1530,0,3,1,3,0,1,0,76.14,66.60 ,33.33
03,015,01,001,0029,0,709,11,720,1087,0,3,1,3,0,1,0,76.14,66.24 ,33.33
03,015,01,001,0030,0,297,3,300,460,0,3,1,3,0,1,0,76.14,65.22 ,33.33
03,015,01,001,0031,0,930,24,954,1456,0,3,1,3,0,1,0,76.14,65.52 ,33.33
03,015,01,001,0032,0,491,3,494,780,0,3,1,3,0,1,0,76.14,63.33 ,33.33
03,015,01,001,0033,0,1395,15,1410,2163,0,3,1,3,0,1,0,76.14,65.19 ,33.33
03,015,01,001,0034,0,1098,13,1111,1748,0,3,1,3,0,1,0,76.14,63.56 ,33.33
03,015,01,001,0035,0,2176,26,2202,3704,0,3,1,3,0,1,0,76.14,59.45 ,33.33
03,015,01,001,0036,0,489,3,492,809,0,3,1,3,0,1,0,76.14,60.82 ,33.33
03,015,01,001,0037,0,2417,31,2448,3751,0,3,1,3,0,1,0,76.14,65.26 ,33.33
03,015,01,001,0038,0,1517,17,1534,2455,0,3,1,3,0,1,0,76.14,62.48 ,33.33
03,015,01,001,0039,0,1630,16,1646,2750,0,3,1,3,0,1,0,76.14,59.85 ,33.33
03,015,01,001,0040,0,384,7,391,733,0,3,1,3,0,1,0,76.14,53.34 ,33.33
03,015,01,002,0041,0,826,12,838,1294,0,3,1,3,0,1,0,76.14,64.76 ,33.33
03,015,01,002,0042,0,471,3,474,840,0,3,1,3,0,1,0,76.14,56.43 ,33.33
03,015,01,002,0043,0,1241,14,1255,1974,0,3,1,3,0,1,0,76.14,63.58 ,33.33
03,015,01,002,0044,0,2150,36,2186,3672,0,3,1,3,0,1,0,76.14,59.53 ,33.33
03,015,01,002,0045,0,317,4,321,541,0,3,1,3,0,1,0,76.14,59.33 ,33.33
03,015,01,002,0046,0,1579,38,1617,2463,0,3,1,3,0,1,0,76.14,65.65 ,33.33
03,015,01,002,0047,0,692,18,710,1053,0,3,1,3,0,1,0,76.14,67.43 ,33.33
03,015,01,003,0048,0,227,6,233,444,0,3,1,3,0,1,0,76.14,52.48 ,33.33
03,015,01,003,0049,0,186,3,189,334,0,3,1,3,0,1,0,76.14,56.59 ,33.33
03,015,01,003,0050,0,239,7,246,496,0,3,1,3,0,1,0,76.14,49.60 ,33.33
03,015,01,003,0051,0,59,3,62,124,0,3,1,3,0,1,0,76.14,50.00 ,33.33
03,015,01,003,0052,0,78,1,79,168,0,3,1,3,0,1,0,76.14,47.02 ,33.33
03,015,01,003,0053,0,76,0,76,124,0,3,1,3,0,1,0,76.14,61.29 ,33.33
03,015,01,003,0054,0,79,1,80,114,0,3,1,3,0,1,0,76.14,70.18 ,33.33
03,015,01,003,0055,0,78,1,79,122,0,3,1,3,0,1,0,76.14,64.75 ,33.33
03,015,01,003,0056,0,47,0,47,92,0,3,1,3,0,1,0,76.14,51.09 ,33.33
03,015,01,004,0057,0,1565,25,1590,2606,0,3,1,3,0,1,0,76.14,61.01 ,33.33
03,015,01,004,0058,0,1236,16,1252,2067,0,3,1,3,0,1,0,76.14,60.57 ,33.33
03,015,01,004,0059,0,2010,39,2049,3341,0,3,1,3,0,1,0,76.14,61.33 ,33.33
03,015,01,004,0060,0,1368,13,1381,2254,0,3,1,3,0,1,0,76.14,61.27 ,33.33
03,015,01,004,0061,0,1001,8,1009,1652,0,3,1,3,0,1,0,76.14,61.08 ,33.33
03,015,01,004,0062,0,710,9,719,1133,0,3,1,3,0,1,0,76.14,63.46 ,33.33
03,015,01,004,0063,0,517,17,534,1034,0,3,1,3,0,1,0,76.14,51.64 ,33.33
03,015,01,004,0064,0,884,13,897,1425,0,3,1,3,0,1,0,76.14,62.95 ,33.33
03,015,01,004,0065,0,1252,25,1277,1984,0,3,1,3,0,1,0,76.14,64.36 ,33.33
03,015,01,004,0066,0,899,24,923,1599,0,3,1,3,0,1,0,76.14,57.72 ,33.33
03,015,01,004,0067,0,1446,15,1461,2314,0,3,1,3,0,1,0,76.14,63.14 ,33.33
03,015,01,004,0068,0,3159,36,3195,4946,0,3,1,3,0,1,0,76.14,64.60 ,33.33
03,015,01,004,0069,0,1662,19,1681,2673,0,3,1,3,0,1,0,76.14,62.89 ,33.33
03,015,01,004,0070,0,2421,31,2452,4034,0,3,1,3,0,1,0,76.14,60.78 ,33.33
03,015,01,004,0071,0,1461,18,1479,2469,0,3,1,3,0,1,0,76.14,59.90 ,33.33
03,015,01,004,0072,0,703,10,713,1301,0,3,1,3,0,1,0,76.14,54.80 ,33.33
03,015,01,004,0073,0,1640,29,1669,2746,0,3,1,3,0,1,0,76.14,60.78 ,33.33
03,015,01,004,0074,0,499,21,520,856,0,3,1,3,0,1,0,76.14,60.75 ,33.33
03,015,01,005,0075,0,453,9,462,769,0,3,1,3,0,1,0,76.14,60.08 ,33.33
03,015,01,005,0076,0,177,1,178,326,0,3,1,3,0,1,0,76.14,54.60 ,33.33
03,015,01,005,0077,0,1064,17,1081,1843,0,3,1,3,0,1,0,76.14,58.65 ,33.33
03,015,01,005,0078,0,679,11,690,1163,0,3,1,3,0,1,0,76.14,59.33 ,33.33
03,015,01,005,0079,0,410,3,413,666,0,3,1,3,0,1,0,76.14,62.01 ,33.33
03,015,01,005,0080,0,627,10,637,1088,0,3,1,3,0,1,0,76.14,58.55 ,33.33
03,015,01,005,0081,0,380,5,385,604,0,3,1,3,0,1,0,76.14,63.74 ,33.33
03,015,01,005,0082,0,87,2,89,156,0,3,1,3,0,1,0,76.14,57.05 ,33.33
03,015,01,005,0083,0,328,5,333,561,0,3,1,3,0,1,0,76.14,59.36 ,33.33
03,015,01,005,0084,0,634,14,648,1113,0,3,1,3,0,1,0,76.14,58.22 ,33.33
03,015,01,005,0085,0,1170,31,1201,2046,0,3,1,3,0,1,0,76.14,58.70 ,33.33
03,015,01,005,0086,0,92,3,95,142,0,3,1,3,0,1,0,76.14,66.90 ,33.33
03,015,01,005,0087,0,108,1,109,270,0,3,1,3,0,1,0,76.14,40.37 ,33.33
03,015,01,005,0088,0,173,6,179,388,0,3,1,3,0,1,0,76.14,46.13 ,33.33
03,015,01,005,0089,0,266,4,270,499,0,3,1,3,0,1,0,76.14,54.11 ,33.33
03,015,01,006,0090,0,705,6,711,1124,0,3,1,3,0,1,0,76.14,63.26 ,33.33
03,015,01,006,0091,0,417,6,423,722,0,3,1,3,0,1,0,76.14,58.59 ,33.33
03,015,01,006,0092,0,493,4,497,739,0,3,1,3,0,1,0,76.14,67.25 ,33.33
03,015,01,006,0093,0,804,9,813,1244,0,3,1,3,0,1,0,76.14,65.35 ,33.33
03,015,01,006,0094,0,597,1,598,935,0,3,1,3,0,1,0,76.14,63.96 ,33.33
03,015,01,006,0095,0,164,3,167,295,0,3,1,3,0,1,0,76.14,56.61 ,33.33
03,015,01,006,0096,0,724,13,737,1320,0,3,1,3,0,1,0,76.14,55.83 ,33.33
03,015,01,006,0097,0,437,9,446,684,0,3,1,3,0,1,0,76.14,65.20 ,33.33
03,015,01,006,0098,0,441,1,442,739,0,3,1,3,0,1,0,76.14,59.81 ,33.33
03,015,01,006,0099,0,602,10,612,905,0,3,1,3,0,1,0,76.14,67.62 ,33.33
03,015,01,006,0100,0,635,16,651,1087,0,3,1,3,0,1,0,76.14,59.89 ,33.33
03,015,01,006,0101,0,108,2,110,196,0,3,1,3,0,1,0,76.14,56.12 ,33.33
03,015,01,007,0102,0,535,8,543,931,0,3,1,3,0,1,0,76.14,58.32 ,33.33
03,015,01,007,0103,0,540,2,542,912,0,3,1,3,0,1,0,76.14,59.43 ,33.33
03,015,01,007,0104,0,250,4,254,456,0,3,1,3,0,1,0,76.14,55.70 ,33.33
03,015,01,007,0105,0,139,3,142,324,0,3,1,3,0,1,0,76.14,43.83 ,33.33
03,015,01,007,0106,0,405,7,412,735,0,3,1,3,0,1,0,76.14,56.05 ,33.33
03,015,01,007,0107,0,116,2,118,266,0,3,1,3,0,1,0,76.14,44.36 ,33.33
03,015,01,007,0108,0,67,0,67,134,0,3,1,3,0,1,0,76.14,50.00 ,33.33
03,015,01,007,0109,0,55,1,56,127,0,3,1,3,0,1,0,76.14,44.09 ,33.33
03,015,01,007,0110,0,89,1,90,237,0,3,1,3,0,1,0,76.14,37.97 ,33.33
03,015,01,007,0111,0,129,2,131,258,0,3,1,3,0,1,0,76.14,50.78 ,33.33
03,015,01,007,0112,0,366,3,369,566,0,3,1,3,0,1,0,76.14,65.19 ,33.33
03,015,01,007,0113,0,385,6,391,722,0,3,1,3,0,1,0,76.14,54.16 ,33.33
03,015,01,007,0114,0,211,1,212,386,0,3,1,3,0,1,0,76.14,54.92 ,33.33
03,015,01,007,0115,0,232,5,237,427,0,3,1,3,0,1,0,76.14,55.50 ,33.33
03,015,01,007,0116,0,345,8,353,642,0,3,1,3,0,1,0,76.14,54.98 ,33.33
03,015,01,008,0117,0,54,0,54,148,0,3,1,3,0,1,0,76.14,36.49 ,33.33
03,015,01,008,0118,0,68,2,70,160,0,3,1,3,0,1,0,76.14,43.75 ,33.33
03,015,01,008,0119,0,440,7,447,807,0,3,1,3,0,1,0,76.14,55.39 ,33.33
03,015,01,008,0120,0,57,1,58,145,0,3,1,3,0,1,0,76.14,40.00 ,33.33
03,015,01,008,0121,0,73,0,73,116,0,3,1,3,0,1,0,76.14,62.93 ,33.33
03,015,01,009,0122,0,29,2,31,63,0,3,1,3,0,1,0,76.14,49.21 ,33.33
03,015,01,009,0123,0,15,0,15,29,0,3,1,3,0,1,0,76.14,51.72 ,33.33
03,015,01,009,0124,0,30,1,31,47,0,3,1,3,0,1,0,76.14,65.96 ,33.33
03,015,01,009,0125,0,34,0,34,64,0,3,1,3,0,1,0,76.14,53.13 ,33.33
03,015,01,009,0126,0,12,0,12,27,0,3,1,3,0,1,0,76.14,44.44 ,33.33
03,015,01,009,0127,0,56,1,57,118,0,3,1,3,0,1,0,76.14,48.31 ,33.33
03,015,01,010,0128,0,1126,12,1138,1954,0,3,1,3,0,1,0,76.14,58.24 ,33.33
03,015,01,010,0129,0,948,9,957,1591,0,3,1,3,0,1,0,76.14,60.15 ,33.33
03,015,01,010,0130,0,281,2,283,442,0,3,1,3,0,1,0,76.14,64.03 ,33.33
03,015,01,010,0131,0,472,8,480,844,0,3,1,3,0,1,0,76.14,56.87 ,33.33
03,015,01,010,0132,0,240,2,242,452,0,3,1,3,0,1,0,76.14,53.54 ,33.33
03,015,01,010,0133,0,262,9,271,504,0,3,1,3,0,1,0,76.14,53.77 ,33.33
03,015,01,010,0134,0,159,2,161,364,0,3,1,3,0,1,0,76.14,44.23 ,33.33
03,015,01,010,0135,0,19,0,19,52,0,3,1,3,0,1,0,76.14,36.54 ,33.33
03,015,01,010,0136,0,426,7,433,716,0,3,1,3,0,1,0,76.14,60.47 ,33.33
03,015,01,010,0137,0,273,3,276,538,0,3,1,3,0,1,0,76.14,51.30 ,33.33
03,015,01,010,0138,0,134,6,140,311,0,3,1,3,0,1,0,76.14,45.02 ,33.33
03,015,01,011,0139,0,2226,42,2268,3951,0,3,1,3,0,1,0,76.14,57.40 ,33.33
03,015,01,011,0140,0,833,5,838,1422,0,3,1,3,0,1,0,76.14,58.93 ,33.33
03,015,01,011,0141,0,1051,16,1067,1911,0,3,1,3,0,1,0,76.14,55.83 ,33.33
03,015,01,011,0142,0,1404,147,1551,3091,0,3,1,3,0,1,0,76.14,50.18 ,33.33
03,015,01,011,0143,0,624,15,639,1127,0,3,1,3,0,1,0,76.14,56.70 ,33.33
03,015,01,011,0144,0,583,9,592,1150,0,3,1,3,0,1,0,76.14,51.48 ,33.33
03,015,01,011,0145,0,350,46,396,769,0,3,1,3,0,1,0,76.14,51.50 ,33.33
03,015,01,011,0146,0,185,4,189,406,0,3,1,3,0,1,0,76.14,46.55 ,33.33
03,015,01,011,0147,0,193,2,195,379,0,3,1,3,0,1,0,76.14,51.45 ,33.33
03,015,01,011,0148,0,489,17,506,1106,0,3,1,3,0,1,0,76.14,45.75 ,33.33
03,015,01,011,0149,0,249,7,256,600,0,3,1,3,0,1,0,76.14,42.67 ,33.33
03,015,01,011,0150,0,247,3,250,531,0,3,1,3,0,1,0,76.14,47.08 ,33.33
03,015,01,011,0151,0,43,1,44,97,0,3,1,3,0,1,0,76.14,45.36 ,33.33
03,015,01,011,0152,0,520,8,528,1030,0,3,1,3,0,1,0,76.14,51.26 ,33.33
03,015,01,011,0153,0,587,7,594,1119,0,3,1,3,0,1,0,76.14,53.08 ,33.33
03,015,01,012,0154,0,244,4,248,508,0,3,1,3,0,1,0,76.14,48.82 ,33.33
03,015,01,012,0155,0,633,20,653,1308,0,3,1,3,0,1,0,76.14,49.92 ,33.33
03,015,01,012,0156,0,619,43,662,1134,0,3,1,3,0,1,0,76.14,58.38 ,33.33
03,015,01,012,0157,0,324,6,330,674,0,3,1,3,0,1,0,76.14,48.96 ,33.33
03,015,01,012,0158,0,630,11,641,1133,0,3,1,3,0,1,0,76.14,56.58 ,33.33
03,015,01,012,0159,0,224,0,224,482,0,3,1,3,0,1,0,76.14,46.47 ,33.33
03,015,01,012,0160,0,517,4,521,931,0,3,1,3,0,1,0,76.14,55.96 ,33.33
03,015,01,012,0161,0,255,3,258,440,0,3,1,3,0,1,0,76.14,58.64 ,33.33
03,015,01,012,0162,0,922,13,935,1744,0,3,1,3,0,1,0,76.14,53.61 ,33.33
03,015,01,012,0163,0,302,1,303,589,0,3,1,3,0,1,0,76.14,51.44 ,33.33
03,015,01,012,0164,0,212,5,217,397,0,3,1,3,0,1,0,76.14,54.66 ,33.33
03,015,01,012,0165,0,281,8,289,555,0,3,1,3,0,1,0,76.14,52.07 ,33.33
03,015,01,012,0166,0,332,4,336,583,0,3,1,3,0,1,0,76.14,57.63 ,33.33
03,015,01,013,0167,0,14,0,14,34,0,3,1,3,0,1,0,76.14,41.18 ,33.33
03,015,01,013,0168,0,18,2,20,49,0,3,1,3,0,1,0,76.14,40.82 ,33.33
03,015,01,013,0169,0,18,1,19,36,0,3,1,3,0,1,0,76.14,52.78 ,33.33
03,015,01,013,0170,0,41,1,42,81,0,3,1,3,0,1,0,76.14,51.85 ,33.33
03,015,01,013,0171,0,58,4,62,107,0,3,1,3,0,1,0,76.14,57.94 ,33.33
03,015,01,013,0172,0,48,0,48,97,0,3,1,3,0,1,0,76.14,49.48 ,33.33
03,016,01,001,0001,0,259,3,262,405,0,3,1,3,0,1,0,76.14,64.69 ,33.33
03,016,01,001,0002,0,266,5,271,353,0,3,1,3,0,1,0,76.14,76.77 ,33.33
03,016,01,001,0003,0,418,6,424,644,0,3,1,3,0,1,0,76.14,65.84 ,33.33
03,016,01,001,0004,0,392,5,397,553,0,3,1,3,0,1,0,76.14,71.79 ,33.33
03,016,01,001,0005,0,645,4,649,944,0,3,1,3,0,1,0,76.14,68.75 ,33.33
03,016,01,001,0006,0,808,4,812,1154,0,3,1,3,0,1,0,76.14,70.36 ,33.33
03,016,01,001,0007,0,557,5,562,789,0,3,1,3,0,1,0,76.14,71.23 ,33.33
03,016,01,001,0008,0,1242,13,1255,1814,0,3,1,3,0,1,0,76.14,69.18 ,33.33
03,016,01,001,0009,0,951,16,967,1424,0,3,1,3,0,1,0,76.14,67.91 ,33.33
03,016,01,001,0010,0,1447,18,1465,2169,0,3,1,3,0,1,0,76.14,67.54 ,33.33
03,016,01,001,0011,0,2628,28,2656,3932,0,3,1,3,0,1,0,76.14,67.55 ,33.33
03,016,01,001,0012,0,1452,23,1475,2276,0,3,1,3,0,1,0,76.14,64.81 ,33.33
03,016,01,001,0013,0,563,9,572,810,0,3,1,3,0,1,0,76.14,70.62 ,33.33
03,016,01,001,0014,0,1421,16,1437,2107,0,3,1,3,0,1,0,76.14,68.20 ,33.33
03,016,01,001,0015,0,1167,9,1176,1728,0,3,1,3,0,1,0,76.14,68.06 ,33.33
03,016,01,001,0016,0,934,11,945,1369,0,3,1,3,0,1,0,76.14,69.03 ,33.33
03,016,01,001,0017,0,808,14,822,1125,0,3,1,3,0,1,0,76.14,73.07 ,33.33
03,016,01,001,0018,0,321,2,323,509,0,3,1,3,0,1,0,76.14,63.46 ,33.33
03,016,01,001,0019,0,342,3,345,467,0,3,1,3,0,1,0,76.14,73.88 ,33.33
03,016,01,001,0020,0,694,8,702,1026,0,3,1,3,0,1,0,76.14,68.42 ,33.33
03,016,01,001,0021,0,247,0,247,330,0,3,1,3,0,1,0,76.14,74.85 ,33.33
03,016,01,001,0022,0,768,12,780,1119,0,3,1,3,0,1,0,76.14,69.71 ,33.33
03,016,01,001,0023,0,305,5,310,434,0,3,1,3,0,1,0,76.14,71.43 ,33.33
03,016,01,001,0024,0,348,7,355,533,0,3,1,3,0,1,0,76.14,66.60 ,33.33
03,016,01,001,0025,0,484,3,487,770,0,3,1,3,0,1,0,76.14,63.25 ,33.33
03,016,01,001,0026,0,242,1,243,323,0,3,1,3,0,1,0,76.14,75.23 ,33.33
03,016,01,001,0027,0,1134,16,1150,1859,0,3,1,3,0,1,0,76.14,61.86 ,33.33
03,016,01,001,0028,0,821,6,827,1248,0,3,1,3,0,1,0,76.14,66.27 ,33.33
03,016,01,001,0029,0,113,2,115,171,0,3,1,3,0,1,0,76.14,67.25 ,33.33
03,016,01,001,0030,0,215,3,218,321,0,3,1,3,0,1,0,76.14,67.91 ,33.33
03,016,01,001,0031,0,799,5,804,967,0,3,1,3,0,1,0,76.14,83.14 ,33.33
03,016,01,001,0032,0,731,17,748,1080,0,3,1,3,0,1,0,76.14,69.26 ,33.33
03,016,01,001,0033,0,203,1,204,550,0,3,1,3,0,1,0,76.14,37.09 ,33.33
03,016,01,001,0034,0,54,0,54,147,0,3,1,3,0,1,0,76.14,36.73 ,33.33
03,016,01,002,0035,0,526,13,539,797,0,3,1,3,0,1,0,76.14,67.63 ,33.33
03,016,01,002,0036,0,168,4,172,262,0,3,1,3,0,1,0,76.14,65.65 ,33.33
03,016,01,002,0037,0,130,1,131,210,0,3,1,3,0,1,0,76.14,62.38 ,33.33
03,016,01,002,0038,0,153,5,158,244,0,3,1,3,0,1,0,76.14,64.75 ,33.33
03,016,01,002,0039,0,344,3,347,596,0,3,1,3,0,1,0,76.14,58.22 ,33.33
03,016,01,002,0040,0,179,0,179,264,0,3,1,3,0,1,0,76.14,67.80 ,33.33
03,016,01,002,0041,0,339,3,342,507,0,3,1,3,0,1,0,76.14,67.46 ,33.33
03,016,01,002,0042,0,239,7,246,404,0,3,1,3,0,1,0,76.14,60.89 ,33.33
03,016,01,002,0043,0,263,2,265,384,0,3,1,3,0,1,0,76.14,69.01 ,33.33
03,016,01,002,0044,0,72,1,73,108,0,3,1,3,0,1,0,76.14,67.59 ,33.33
03,016,01,002,0045,0,454,4,458,733,0,3,1,3,0,1,0,76.14,62.48 ,33.33
03,016,01,002,0046,0,101,1,102,160,0,3,1,3,0,1,0,76.14,63.75 ,33.33
03,016,01,002,0047,0,210,3,213,449,0,3,1,3,0,1,0,76.14,47.44 ,33.33
03,016,01,002,0048,0,176,3,179,230,0,3,1,3,0,1,0,76.14,77.83 ,33.33
03,016,01,002,0049,0,115,4,119,186,0,3,1,3,0,1,0,76.14,63.98 ,33.33
03,016,01,002,0050,0,127,1,128,192,0,3,1,3,0,1,0,76.14,66.67 ,33.33
03,016,01,002,0051,0,56,0,56,77,0,3,1,3,0,1,0,76.14,72.73 ,33.33
03,016,01,002,0052,0,401,4,405,617,0,3,1,3,0,1,0,76.14,65.64 ,33.33
03,016,01,002,0053,0,518,8,526,786,0,3,1,3,0,1,0,76.14,66.92 ,33.33
03,016,01,002,0054,0,683,9,692,1205,0,3,1,3,0,1,0,76.14,57.43 ,33.33
03,016,01,002,0055,0,379,4,383,746,0,3,1,3,0,1,0,76.14,51.34 ,33.33
03,016,01,002,0056,0,354,6,360,608,0,3,1,3,0,1,0,76.14,59.21 ,33.33
03,016,01,003,0057,0,270,4,274,408,0,3,1,3,0,1,0,76.14,67.16 ,33.33
03,016,01,003,0058,0,337,4,341,485,0,3,1,3,0,1,0,76.14,70.31 ,33.33
03,016,01,003,0059,0,63,0,63,87,0,3,1,3,0,1,0,76.14,72.41 ,33.33
03,016,01,003,0060,0,72,0,72,103,0,3,1,3,0,1,0,76.14,69.90 ,33.33
03,016,01,003,0061,0,170,3,173,264,0,3,1,3,0,1,0,76.14,65.53 ,33.33
03,016,01,003,0062,0,115,2,117,179,0,3,1,3,0,1,0,76.14,65.36 ,33.33
03,016,01,003,0063,0,106,2,108,160,0,3,1,3,0,1,0,76.14,67.50 ,33.33
03,016,01,003,0064,0,818,9,827,1235,0,3,1,3,0,1,0,76.14,66.96 ,33.33
03,016,01,003,0065,0,178,1,179,276,0,3,1,3,0,1,0,76.14,64.86 ,33.33
03,016,01,003,0066,0,362,2,364,640,0,3,1,3,0,1,0,76.14,56.88 ,33.33
03,016,01,003,0067,0,429,3,432,705,0,3,1,3,0,1,0,76.14,61.28 ,33.33
03,016,01,003,0068,0,443,5,448,1149,0,3,1,3,0,1,0,76.14,38.99 ,33.33
03,016,01,003,0069,0,379,2,381,828,0,3,1,3,0,1,0,76.14,46.01 ,33.33
03,016,01,003,0070,0,85,0,85,180,0,3,1,3,0,1,0,76.14,47.22 ,33.33
03,016,01,003,0071,0,86,0,86,158,0,3,1,3,0,1,0,76.14,54.43 ,33.33
03,016,01,004,0072,0,122,3,125,230,0,3,1,3,0,1,0,76.14,54.35 ,33.33
03,016,01,004,0073,0,230,2,232,422,0,3,1,3,0,1,0,76.14,54.98 ,33.33
03,016,01,004,0074,0,438,8,446,793,0,3,1,3,0,1,0,76.14,56.24 ,33.33
03,016,01,004,0075,0,151,0,151,242,0,3,1,3,0,1,0,76.14,62.40 ,33.33
03,016,01,004,0076,0,326,6,332,604,0,3,1,3,0,1,0,76.14,54.97 ,33.33
03,016,01,004,0077,0,51,1,52,104,0,3,1,3,0,1,0,76.14,50.00 ,33.33
03,016,01,004,0078,0,310,3,313,498,0,3,1,3,0,1,0,76.14,62.85 ,33.33
03,016,01,004,0079,0,111,1,112,202,0,3,1,3,0,1,0,76.14,55.45 ,33.33
03,016,01,004,0080,0,315,3,318,618,0,3,1,3,0,1,0,76.14,51.46 ,33.33
03,016,01,004,0081,0,669,6,675,1179,0,3,1,3,0,1,0,76.14,57.25 ,33.33
03,016,01,004,0082,0,848,7,855,1650,0,3,1,3,0,1,0,76.14,51.82 ,33.33
03,016,01,005,0083,0,168,7,175,371,0,3,1,3,0,1,0,76.14,47.17 ,33.33
03,016,01,005,0084,0,162,4,166,326,0,3,1,3,0,1,0,76.14,50.92 ,33.33
03,016,01,005,0085,0,87,2,89,198,0,3,1,3,0,1,0,76.14,44.95 ,33.33
03,016,01,005,0086,0,95,2,97,228,0,3,1,3,0,1,0,76.14,42.54 ,33.33
03,016,01,005,0087,0,470,6,476,1049,0,3,1,3,0,1,0,76.14,45.38 ,33.33
03,016,01,005,0088,0,16,0,16,66,0,3,1,3,0,1,0,76.14,24.24 ,33.33
03,016,01,005,0089,0,63,1,64,172,0,3,1,3,0,1,0,76.14,37.21 ,33.33
03,016,01,005,0090,0,41,0,41,104,0,3,1,3,0,1,0,76.14,39.42 ,33.33
03,016,01,005,0091,0,120,1,121,233,0,3,1,3,0,1,0,76.14,51.93 ,33.33
03,016,01,006,0092,0,110,3,113,230,0,3,1,3,0,1,0,76.14,49.13 ,33.33
03,016,01,006,0093,0,178,1,179,373,0,3,1,3,0,1,0,76.14,47.99 ,33.33
03,016,01,006,0094,0,207,2,209,422,0,3,1,3,0,1,0,76.14,49.53 ,33.33
03,016,01,006,0095,0,95,2,97,220,0,3,1,3,0,1,0,76.14,44.09 ,33.33
03,016,01,006,0096,0,91,0,91,238,0,3,1,3,0,1,0,76.14,38.24 ,33.33
03,016,01,006,0097,0,413,8,421,761,0,3,1,3,0,1,0,76.14,55.32 ,33.33
03,017,01,001,0001,0,505,11,516,754,0,3,1,3,0,1,0,76.14,68.44 ,33.33
03,017,01,001,0002,0,1152,15,1167,1975,0,3,1,3,0,1,0,76.14,59.09 ,33.33
03,017,01,001,0003,0,1054,16,1070,1658,0,3,1,3,0,1,0,76.14,64.54 ,33.33
03,017,01,001,0004,0,1668,32,1700,3220,0,3,1,3,0,1,0,76.14,52.80 ,33.33
03,017,01,001,0005,0,1073,15,1088,1667,0,3,1,3,0,1,0,76.14,65.27 ,33.33
03,017,01,001,0006,0,1384,18,1402,2187,0,3,1,3,0,1,0,76.14,64.11 ,33.33
03,017,01,001,0007,0,663,7,670,1033,0,3,1,3,0,1,0,76.14,64.86 ,33.33
03,017,01,001,0008,0,671,18,689,1088,0,3,1,3,0,1,0,76.14,63.33 ,33.33
03,017,01,001,0009,0,925,15,940,1466,0,3,1,3,0,1,0,76.14,64.12 ,33.33
03,017,01,001,0010,0,1325,21,1346,2154,0,3,1,3,0,1,0,76.14,62.49 ,33.33
03,017,01,001,0011,0,1013,7,1020,1638,0,3,1,3,0,1,0,76.14,62.27 ,33.33
03,017,01,001,0012,0,1526,18,1544,2285,0,3,1,3,0,1,0,76.14,67.57 ,33.33
03,017,01,001,0013,0,1363,20,1383,2209,0,3,1,3,0,1,0,76.14,62.61 ,33.33
03,017,01,001,0014,0,1004,13,1017,1578,0,3,1,3,0,1,0,76.14,64.45 ,33.33
03,017,01,001,0015,0,1591,12,1603,2472,0,3,1,3,0,1,0,76.14,64.85 ,33.33
03,017,01,001,0016,0,1046,11,1057,1584,0,3,1,3,0,1,0,76.14,66.73 ,33.33
03,017,01,001,0017,0,958,15,973,1529,0,3,1,3,0,1,0,76.14,63.64 ,33.33
03,017,01,001,0018,0,1040,11,1051,1667,0,3,1,3,0,1,0,76.14,63.05 ,33.33
03,017,01,001,0019,0,999,12,1011,1615,0,3,1,3,0,1,0,76.14,62.60 ,33.33
03,017,01,001,0020,0,915,14,929,1412,0,3,1,3,0,1,0,76.14,65.79 ,33.33
03,017,01,001,0021,0,829,11,840,1299,0,3,1,3,0,1,0,76.14,64.67 ,33.33
03,017,01,001,0022,0,788,12,800,1222,0,3,1,3,0,1,0,76.14,65.47 ,33.33
03,017,01,001,0023,0,974,10,984,1517,0,3,1,3,0,1,0,76.14,64.86 ,33.33
03,017,01,001,0024,0,618,5,623,912,0,3,1,3,0,1,0,76.14,68.31 ,33.33
03,017,01,002,0025,0,2445,39,2484,3910,0,3,1,3,0,1,0,76.14,63.53 ,33.33
03,017,01,002,0026,0,1348,26,1374,2051,0,3,1,3,0,1,0,76.14,66.99 ,33.33
03,017,01,002,0027,0,1501,27,1528,2296,0,3,1,3,0,1,0,76.14,66.55 ,33.33
03,017,01,002,0028,0,2403,33,2436,3640,0,3,1,3,0,1,0,76.14,66.92 ,33.33
03,017,01,002,0029,0,1466,15,1481,2251,0,3,1,3,0,1,0,76.14,65.79 ,33.33
03,017,01,002,0030,0,1510,25,1535,2276,0,3,1,3,0,1,0,76.14,67.44 ,33.33
03,017,01,002,0031,0,931,10,941,1542,0,3,1,3,0,1,0,76.14,61.02 ,33.33
03,017,01,002,0032,0,499,6,505,873,0,3,1,3,0,1,0,76.14,57.85 ,33.33
03,017,01,002,0033,0,1414,21,1435,2270,0,3,1,3,0,1,0,76.14,63.22 ,33.33
03,017,01,002,0034,0,650,11,661,1068,0,3,1,3,0,1,0,76.14,61.89 ,33.33
03,017,01,002,0035,0,1573,13,1586,2679,0,3,1,3,0,1,0,76.14,59.20 ,33.33
03,017,01,002,0036,0,1455,35,1490,2442,0,3,1,3,0,1,0,76.14,61.02 ,33.33
03,017,01,002,0037,0,2006,31,2037,3382,0,3,1,3,0,1,0,76.14,60.23 ,33.33
03,017,01,002,0038,0,1863,28,1891,3164,0,3,1,3,0,1,0,76.14,59.77 ,33.33
03,017,01,002,0039,0,285,3,288,432,0,3,1,3,0,1,0,76.14,66.67 ,33.33
03,017,01,002,0040,0,208,4,212,344,0,3,1,3,0,1,0,76.14,61.63 ,33.33
03,017,01,002,0041,0,277,2,279,396,0,3,1,3,0,1,0,76.14,70.45 ,33.33
03,017,01,002,0042,0,563,5,568,884,0,3,1,3,0,1,0,76.14,64.25 ,33.33
03,017,01,002,0043,0,290,0,290,440,0,3,1,3,0,1,0,76.14,65.91 ,33.33
03,017,01,003,0044,0,789,20,809,1267,0,3,1,3,0,1,0,76.14,63.85 ,33.33
03,017,01,003,0045,0,433,13,446,691,0,3,1,3,0,1,0,76.14,64.54 ,33.33
03,017,01,003,0046,0,622,9,631,943,0,3,1,3,0,1,0,76.14,66.91 ,33.33
03,017,01,003,0047,0,356,4,360,573,0,3,1,3,0,1,0,76.14,62.83 ,33.33
03,017,01,003,0048,0,1773,30,1803,2716,0,3,1,3,0,1,0,76.14,66.38 ,33.33
03,017,01,003,0049,0,1243,14,1257,1905,0,3,1,3,0,1,0,76.14,65.98 ,33.33
03,017,01,003,0050,0,1079,17,1096,1664,0,3,1,3,0,1,0,76.14,65.87 ,33.33
03,017,01,003,0051,0,272,3,275,396,0,3,1,3,0,1,0,76.14,69.44 ,33.33
03,017,01,003,0052,0,1879,37,1916,3040,0,3,1,3,0,1,0,76.14,63.03 ,33.33
03,017,01,003,0053,0,1288,27,1315,1964,0,3,1,3,0,1,0,76.14,66.96 ,33.33
03,017,01,003,0054,0,1693,21,1714,2619,0,3,1,3,0,1,0,76.14,65.44 ,33.33
03,017,01,003,0055,0,1928,25,1953,2852,0,3,1,3,0,1,0,76.14,68.48 ,33.33
03,017,01,004,0056,0,1262,18,1280,1988,0,3,1,3,0,1,0,76.14,64.39 ,33.33
03,017,01,004,0057,0,762,12,774,1049,0,3,1,3,0,1,0,76.14,73.78 ,33.33
03,017,01,004,0058,0,1154,17,1171,1717,0,3,1,3,0,1,0,76.14,68.20 ,33.33
03,017,01,004,0059,0,1272,21,1293,1934,0,3,1,3,0,1,0,76.14,66.86 ,33.33
03,017,01,004,0060,0,1714,18,1732,2556,0,3,1,3,0,1,0,76.14,67.76 ,33.33
03,017,01,004,0061,0,882,11,893,1350,0,3,1,3,0,1,0,76.14,66.15 ,33.33
03,017,01,004,0062,0,772,10,782,1213,0,3,1,3,0,1,0,76.14,64.47 ,33.33
03,017,01,004,0063,0,880,7,887,1273,0,3,1,3,0,1,0,76.14,69.68 ,33.33
03,017,01,004,0064,0,793,7,800,1168,0,3,1,3,0,1,0,76.14,68.49 ,33.33
03,017,01,004,0065,0,1265,18,1283,1810,0,3,1,3,0,1,0,76.14,70.88 ,33.33
03,017,01,004,0066,0,632,4,636,976,0,3,1,3,0,1,0,76.14,65.16 ,33.33
03,017,01,004,0067,0,727,19,746,1134,0,3,1,3,0,1,0,76.14,65.78 ,33.33
03,017,01,004,0068,0,2204,33,2237,3358,0,3,1,3,0,1,0,76.14,66.62 ,33.33
03,017,01,004,0069,0,591,5,596,922,0,3,1,3,0,1,0,76.14,64.64 ,33.33
03,017,01,004,0070,0,1072,12,1084,1672,0,3,1,3,0,1,0,76.14,64.83 ,33.33
03,017,01,004,0071,0,595,14,609,963,0,3,1,3,0,1,0,76.14,63.24 ,33.33
03,017,01,004,0072,0,913,14,927,1335,0,3,1,3,0,1,0,76.14,69.44 ,33.33
03,017,01,004,0073,0,735,4,739,1055,0,3,1,3,0,1,0,76.14,70.05 ,33.33
03,017,01,004,0074,0,653,8,661,1001,0,3,1,3,0,1,0,76.14,66.03 ,33.33
03,017,01,004,0075,0,865,10,875,1288,0,3,1,3,0,1,0,76.14,67.93 ,33.33
03,017,01,004,0076,0,524,11,535,792,0,3,1,3,0,1,0,76.14,67.55 ,33.33
03,017,01,004,0077,0,910,8,918,1343,0,3,1,3,0,1,0,76.14,68.35 ,33.33
03,017,01,004,0078,0,913,10,923,1296,0,3,1,3,0,1,0,76.14,71.22 ,33.33
03,017,01,004,0079,0,1191,27,1218,1870,0,3,1,3,0,1,0,76.14,65.13 ,33.33
03,017,01,004,0080,0,1403,14,1417,2061,0,3,1,3,0,1,0,76.14,68.75 ,33.33
03,017,01,004,0081,0,584,9,593,840,0,3,1,3,0,1,0,76.14,70.60 ,33.33
03,017,01,004,0082,0,545,7,552,783,0,3,1,3,0,1,0,76.14,70.50 ,33.33
03,017,01,004,0083,0,665,6,671,953,0,3,1,3,0,1,0,76.14,70.41 ,33.33
03,017,01,004,0084,0,605,14,619,902,0,3,1,3,0,1,0,76.14,68.63 ,33.33
03,017,01,005,0085,0,647,5,652,937,0,3,1,3,0,1,0,76.14,69.58 ,33.33
03,017,01,005,0086,0,840,8,848,1255,0,3,1,3,0,1,0,76.14,67.57 ,33.33
03,017,01,005,0087,0,697,19,716,1046,0,3,1,3,0,1,0,76.14,68.45 ,33.33
03,017,01,005,0088,0,862,10,872,1276,0,3,1,3,0,1,0,76.14,68.34 ,33.33
03,017,01,005,0089,0,773,12,785,1202,0,3,1,3,0,1,0,76.14,65.31 ,33.33
03,017,01,005,0090,0,1047,12,1059,1559,0,3,1,3,0,1,0,76.14,67.93 ,33.33
03,017,01,005,0091,0,607,11,618,915,0,3,1,3,0,1,0,76.14,67.54 ,33.33
03,017,01,005,0092,0,1202,21,1223,1811,0,3,1,3,0,1,0,76.14,67.53 ,33.33
03,017,01,005,0093,0,938,15,953,1419,0,3,1,3,0,1,0,76.14,67.16 ,33.33
03,017,01,005,0094,0,1261,13,1274,2006,0,3,1,3,0,1,0,76.14,63.51 ,33.33
03,017,01,005,0095,0,1527,32,1559,2226,0,3,1,3,0,1,0,76.14,70.04 ,33.33
03,017,01,005,0096,0,593,5,598,880,0,3,1,3,0,1,0,76.14,67.95 ,33.33
03,017,01,005,0097,0,542,8,550,897,0,3,1,3,0,1,0,76.14,61.32 ,33.33
03,017,01,005,0098,0,744,15,759,1108,0,3,1,3,0,1,0,76.14,68.50 ,33.33
03,017,01,005,0099,0,1162,19,1181,1722,0,3,1,3,0,1,0,76.14,68.58 ,33.33
03,017,01,005,0100,0,784,16,800,1173,0,3,1,3,0,1,0,76.14,68.20 ,33.33
03,017,01,005,0101,0,1409,24,1433,2212,0,3,1,3,0,1,0,76.14,64.78 ,33.33
03,017,01,005,0102,0,2167,33,2200,3160,0,3,1,3,0,1,0,76.14,69.62 ,33.33
03,017,01,005,0103,0,1624,33,1657,2650,0,3,1,3,0,1,0,76.14,62.53 ,33.33
03,017,01,005,0104,0,1272,26,1298,2007,0,3,1,3,0,1,0,76.14,64.67 ,33.33
03,017,01,005,0105,0,760,7,767,1154,0,3,1,3,0,1,0,76.14,66.46 ,33.33
03,017,01,005,0106,0,802,8,810,1199,0,3,1,3,0,1,0,76.14,67.56 ,33.33
03,017,01,005,0107,0,645,8,653,957,0,3,1,3,0,1,0,76.14,68.23 ,33.33
03,017,01,006,0108,0,1151,11,1162,1824,0,3,1,3,0,1,0,76.14,63.71 ,33.33
03,017,01,006,0109,0,1010,15,1025,1571,0,3,1,3,0,1,0,76.14,65.25 ,33.33
03,017,01,006,0110,0,893,13,906,1412,0,3,1,3,0,1,0,76.14,64.16 ,33.33
03,017,01,006,0111,0,965,23,988,1511,0,3,1,3,0,1,0,76.14,65.39 ,33.33
03,017,01,006,0112,0,1791,24,1815,2672,0,3,1,3,0,1,0,76.14,67.93 ,33.33
03,017,01,006,0113,0,1327,23,1350,2134,0,3,1,3,0,1,0,76.14,63.26 ,33.33
03,017,01,006,0114,0,713,14,727,1168,0,3,1,3,0,1,0,76.14,62.24 ,33.33
03,017,01,006,0115,0,639,8,647,950,0,3,1,3,0,1,0,76.14,68.11 ,33.33
03,017,01,006,0116,0,608,19,627,853,0,3,1,3,0,1,0,76.14,73.51 ,33.33
03,017,01,006,0117,0,2183,30,2213,3445,0,3,1,3,0,1,0,76.14,64.24 ,33.33
03,017,01,006,0118,0,1706,14,1720,2574,0,3,1,3,0,1,0,76.14,66.82 ,33.33
03,017,01,006,0119,0,1993,26,2019,3055,0,3,1,3,0,1,0,76.14,66.09 ,33.33
03,017,01,006,0120,0,2330,35,2365,3475,0,3,1,3,0,1,0,76.14,68.06 ,33.33
03,017,01,006,0121,0,1024,17,1041,1514,0,3,1,3,0,1,0,76.14,68.76 ,33.33
03,017,01,006,0122,0,2368,51,2419,3518,0,3,1,3,0,1,0,76.14,68.76 ,33.33
03,017,01,006,0123,0,2324,24,2348,3523,0,3,1,3,0,1,0,76.14,66.65 ,33.33
03,017,01,006,0124,0,1642,29,1671,2774,0,3,1,3,0,1,0,76.14,60.24 ,33.33
03,017,01,006,0125,0,1701,28,1729,2872,0,3,1,3,0,1,0,76.14,60.20 ,33.33
03,017,01,006,0126,0,631,10,641,1081,0,3,1,3,0,1,0,76.14,59.30 ,33.33
03,017,01,006,0127,0,1316,18,1334,2193,0,3,1,3,0,1,0,76.14,60.83 ,33.33
03,017,01,007,0128,0,853,11,864,1264,0,3,1,3,0,1,0,76.14,68.35 ,33.33
03,017,01,007,0129,0,978,13,991,1333,0,3,1,3,0,1,0,76.14,74.34 ,33.33
03,017,01,007,0130,0,839,5,844,1222,0,3,1,3,0,1,0,76.14,69.07 ,33.33
03,017,01,007,0131,0,1834,26,1860,2556,0,3,1,3,0,1,0,76.14,72.77 ,33.33
03,017,01,007,0132,0,620,7,627,896,0,3,1,3,0,1,0,76.14,69.98 ,33.33
03,017,01,007,0133,0,1012,14,1026,1495,0,3,1,3,0,1,0,76.14,68.63 ,33.33
03,017,01,007,0134,0,585,7,592,826,0,3,1,3,0,1,0,76.14,71.67 ,33.33
03,017,01,007,0135,0,1321,17,1338,1909,0,3,1,3,0,1,0,76.14,70.09 ,33.33
03,017,01,007,0136,0,1079,14,1093,1592,0,3,1,3,0,1,0,76.14,68.66 ,33.33
03,017,01,007,0137,0,1139,12,1151,1694,0,3,1,3,0,1,0,76.14,67.95 ,33.33
03,017,01,007,0138,0,1651,17,1668,2412,0,3,1,3,0,1,0,76.14,69.15 ,33.33
03,017,01,007,0139,0,1414,16,1430,2172,0,3,1,3,0,1,0,76.14,65.84 ,33.33
03,017,01,007,0140,0,1142,13,1155,1660,0,3,1,3,0,1,0,76.14,69.58 ,33.33
03,017,01,007,0141,0,1708,32,1740,2760,0,3,1,3,0,1,0,76.14,63.04 ,33.33
03,017,01,007,0142,0,1887,30,1917,2766,0,3,1,3,0,1,0,76.14,69.31 ,33.33
03,017,01,007,0143,0,2465,33,2498,3821,0,3,1,3,0,1,0,76.14,65.38 ,33.33
03,017,01,007,0144,0,456,4,460,748,0,3,1,3,0,1,0,76.14,61.50 ,33.33
03,018,01,001,0001,0,661,4,665,1121,0,3,1,3,0,1,0,76.14,59.32 ,33.33
03,018,01,001,0002,0,1172,11,1183,1914,0,3,1,3,0,1,0,76.14,61.81 ,33.33
03,018,01,001,0003,0,528,5,533,884,0,3,1,3,0,1,0,76.14,60.29 ,33.33
03,018,01,001,0004,0,491,4,495,873,0,3,1,3,0,1,0,76.14,56.70 ,33.33
03,018,01,001,0005,0,329,3,332,584,0,3,1,3,0,1,0,76.14,56.85 ,33.33
03,018,01,001,0006,0,350,2,352,630,0,3,1,3,0,1,0,76.14,55.87 ,33.33
03,018,01,001,0007,0,1208,15,1223,1870,0,3,1,3,0,1,0,76.14,65.40 ,33.33
03,018,01,001,0008,0,1765,25,1790,2883,0,3,1,3,0,1,0,76.14,62.09 ,33.33
03,018,01,001,0009,0,1841,19,1860,3096,0,3,1,3,0,1,0,76.14,60.08 ,33.33
03,018,01,001,0010,0,1391,20,1411,2388,0,3,1,3,0,1,0,76.14,59.09 ,33.33
03,018,01,001,0011,0,2172,24,2196,3560,0,3,1,3,0,1,0,76.14,61.69 ,33.33
03,018,01,001,0012,0,1144,10,1154,1869,0,3,1,3,0,1,0,76.14,61.74 ,33.33
03,018,01,001,0013,0,1068,8,1076,1805,0,3,1,3,0,1,0,76.14,59.61 ,33.33
03,018,01,001,0014,0,1240,11,1251,2108,0,3,1,3,0,1,0,76.14,59.35 ,33.33
03,018,01,001,0015,0,1678,16,1694,2769,0,3,1,3,0,1,0,76.14,61.18 ,33.33
03,018,01,001,0016,0,2404,26,2430,3844,0,3,1,3,0,1,0,76.14,63.22 ,33.33
03,018,01,001,0017,0,901,12,913,1620,0,3,1,3,0,1,0,76.14,56.36 ,33.33
03,018,01,001,0018,0,584,6,590,984,0,3,1,3,0,1,0,76.14,59.96 ,33.33
03,018,01,001,0019,0,1153,35,1188,2204,0,3,1,3,0,1,0,76.14,53.90 ,33.33
03,018,01,001,0020,0,1660,29,1689,2803,0,3,1,3,0,1,0,76.14,60.26 ,33.33
03,018,01,001,0021,0,867,26,893,1394,0,3,1,3,0,1,0,76.14,64.06 ,33.33
03,018,01,001,0022,0,1743,22,1765,2713,0,3,1,3,0,1,0,76.14,65.06 ,33.33
03,018,01,001,0023,0,519,4,523,785,0,3,1,3,0,1,0,76.14,66.62 ,33.33
03,018,01,001,0024,0,320,6,326,539,0,3,1,3,0,1,0,76.14,60.48 ,33.33
03,018,01,001,0025,0,1972,23,1995,2947,0,3,1,3,0,1,0,76.14,67.70 ,33.33
03,018,01,001,0026,0,833,14,847,1249,0,3,1,3,0,1,0,76.14,67.81 ,33.33
03,018,01,001,0027,0,1633,17,1650,2344,0,3,1,3,0,1,0,76.14,70.39 ,33.33
03,018,01,001,0028,0,1576,10,1586,2491,0,3,1,3,0,1,0,76.14,63.67 ,33.33
03,018,01,001,0029,0,1259,14,1273,1997,0,3,1,3,0,1,0,76.14,63.75 ,33.33
03,018,01,001,0030,0,2789,27,2816,4224,0,3,1,3,0,1,0,76.14,66.67 ,33.33
03,018,01,001,0031,0,985,23,1008,1730,0,3,1,3,0,1,0,76.14,58.27 ,33.33
03,018,01,001,0032,0,2204,33,2237,3661,0,3,1,3,0,1,0,76.14,61.10 ,33.33
03,018,01,001,0033,0,1867,27,1894,3129,0,3,1,3,0,1,0,76.14,60.53 ,33.33
03,018,01,001,0034,0,1478,14,1492,2327,0,3,1,3,0,1,0,76.14,64.12 ,33.33
03,018,01,001,0035,0,1396,13,1409,2279,0,3,1,3,0,1,0,76.14,61.83 ,33.33
03,018,01,001,0036,0,297,5,302,532,0,3,1,3,0,1,0,76.14,56.77 ,33.33
03,018,01,001,0037,0,365,6,371,668,0,3,1,3,0,1,0,76.14,55.54 ,33.33
03,018,01,001,0038,0,410,5,415,690,0,3,1,3,0,1,0,76.14,60.14 ,33.33
03,018,01,001,0039,0,569,11,580,981,0,3,1,3,0,1,0,76.14,59.12 ,33.33
03,018,01,001,0040,0,733,12,745,1248,0,3,1,3,0,1,0,76.14,59.70 ,33.33
03,018,01,001,0041,0,1946,25,1971,3488,0,3,1,3,0,1,0,76.14,56.51 ,33.33
03,018,01,001,0042,0,1798,31,1829,3126,0,3,1,3,0,1,0,76.14,58.51 ,33.33
03,018,01,001,0043,0,466,6,472,862,0,3,1,3,0,1,0,76.14,54.76 ,33.33
03,018,01,001,0044,0,530,5,535,896,0,3,1,3,0,1,0,76.14,59.71 ,33.33
03,018,01,001,0045,0,809,14,823,1305,0,3,1,3,0,1,0,76.14,63.07 ,33.33
03,018,01,001,0046,0,1766,16,1782,3113,0,3,1,3,0,1,0,76.14,57.24 ,33.33
03,018,01,001,0047,0,880,14,894,1679,0,3,1,3,0,1,0,76.14,53.25 ,33.33
03,018,01,001,0048,0,1353,19,1372,2359,0,3,1,3,0,1,0,76.14,58.16 ,33.33
03,018,01,001,0049,0,1499,25,1524,2621,0,3,1,3,0,1,0,76.14,58.15 ,33.33
03,018,01,001,0050,0,2299,28,2327,4071,0,3,1,3,0,1,0,76.14,57.16 ,33.33
03,018,01,001,0051,0,2873,33,2906,5180,0,3,1,3,0,1,0,76.14,56.10 ,33.33
03,018,01,002,0052,0,314,3,317,558,0,3,1,3,0,1,0,76.14,56.81 ,33.33
03,018,01,002,0053,0,446,2,448,771,0,3,1,3,0,1,0,76.14,58.11 ,33.33
03,018,01,002,0054,0,359,2,361,601,0,3,1,3,0,1,0,76.14,60.07 ,33.33
03,018,01,002,0055,0,298,4,302,499,0,3,1,3,0,1,0,76.14,60.52 ,33.33
03,018,01,002,0056,0,524,11,535,938,0,3,1,3,0,1,0,76.14,57.04 ,33.33
03,018,01,002,0057,0,699,7,706,1112,0,3,1,3,0,1,0,76.14,63.49 ,33.33
03,018,01,002,0058,0,809,8,817,1374,0,3,1,3,0,1,0,76.14,59.46 ,33.33
03,018,01,002,0059,0,2160,31,2191,3781,0,3,1,3,0,1,0,76.14,57.95 ,33.33
03,018,01,002,0060,0,3350,63,3413,5343,0,3,1,3,0,1,0,76.14,63.88 ,33.33
03,018,01,002,0061,0,1369,17,1386,2450,0,3,1,3,0,1,0,76.14,56.57 ,33.33
03,018,01,002,0062,0,1979,20,1999,3194,0,3,1,3,0,1,0,76.14,62.59 ,33.33
03,018,01,002,0063,0,1858,28,1886,3095,0,3,1,3,0,1,0,76.14,60.94 ,33.33
03,018,01,002,0064,0,1278,16,1294,1691,0,3,1,3,0,1,0,76.14,76.52 ,33.33
03,018,01,002,0065,0,511,4,515,862,0,3,1,3,0,1,0,76.14,59.74 ,33.33
03,018,01,002,0066,0,423,3,426,696,0,3,1,3,0,1,0,76.14,61.21 ,33.33
03,018,01,002,0067,0,335,6,341,625,0,3,1,3,0,1,0,76.14,54.56 ,33.33
03,018,01,002,0068,0,731,14,745,1299,0,3,1,3,0,1,0,76.14,57.35 ,33.33
03,018,01,002,0069,0,582,10,592,960,0,3,1,3,0,1,0,76.14,61.67 ,33.33
03,018,01,002,0070,0,578,5,583,995,0,3,1,3,0,1,0,76.14,58.59 ,33.33
03,018,01,002,0071,0,2089,23,2112,3965,0,3,1,3,0,1,0,76.14,53.27 ,33.33
03,018,01,002,0072,0,1702,23,1725,3075,0,3,1,3,0,1,0,76.14,56.10 ,33.33
03,018,01,002,0073,0,1897,27,1924,3277,0,3,1,3,0,1,0,76.14,58.71 ,33.33
03,018,01,002,0074,0,1666,22,1688,2717,0,3,1,3,0,1,0,76.14,62.13 ,33.33
03,018,01,002,0075,0,1328,12,1340,2255,0,3,1,3,0,1,0,76.14,59.42 ,33.33
03,018,01,002,0076,0,1213,24,1237,2051,0,3,1,3,0,1,0,76.14,60.31 ,33.33
03,018,01,002,0077,0,1281,15,1296,2322,0,3,1,3,0,1,0,76.14,55.81 ,33.33
03,018,01,002,0078,0,1473,16,1489,2611,0,3,1,3,0,1,0,76.14,57.03 ,33.33
03,018,01,002,0079,0,2299,37,2336,4017,0,3,1,3,0,1,0,76.14,58.15 ,33.33
03,018,01,002,0080,0,1770,27,1797,2961,0,3,1,3,0,1,0,76.14,60.69 ,33.33
03,018,01,002,0081,0,1688,19,1707,2865,0,3,1,3,0,1,0,76.14,59.58 ,33.33
03,018,01,002,0082,0,782,6,788,1147,0,3,1,3,0,1,0,76.14,68.70 ,33.33
03,018,01,002,0083,0,1573,29,1602,2603,0,3,1,3,0,1,0,76.14,61.54 ,33.33
03,018,01,002,0084,0,1653,28,1681,2893,0,3,1,3,0,1,0,76.14,58.11 ,33.33
03,018,01,002,0085,0,1937,15,1952,2927,0,3,1,3,0,1,0,76.14,66.69 ,33.33
03,018,01,002,0086,0,430,12,442,757,0,3,1,3,0,1,0,76.14,58.39 ,33.33
03,018,01,002,0087,0,1562,22,1584,3132,0,3,1,3,0,1,0,76.14,50.57 ,33.33
03,018,01,002,0088,0,739,8,747,1240,0,3,1,3,0,1,0,76.14,60.24 ,33.33
03,018,01,002,0089,0,503,9,512,847,0,3,1,3,0,1,0,76.14,60.45 ,33.33
03,018,01,002,0090,0,628,10,638,1185,0,3,1,3,0,1,0,76.14,53.84 ,33.33
03,018,01,002,0091,0,567,7,574,1014,0,3,1,3,0,1,0,76.14,56.61 ,33.33
03,018,01,002,0092,0,314,4,318,516,0,3,1,3,0,1,0,76.14,61.63 ,33.33
03,018,01,003,0093,0,2406,33,2439,4176,0,3,1,3,0,1,0,76.14,58.41 ,33.33
03,018,01,003,0094,0,1064,16,1080,1824,0,3,1,3,0,1,0,76.14,59.21 ,33.33
03,018,01,003,0095,0,742,10,752,1350,0,3,1,3,0,1,0,76.14,55.70 ,33.33
03,018,01,003,0096,0,1125,10,1135,2004,0,3,1,3,0,1,0,76.14,56.64 ,33.33
03,018,01,003,0097,0,906,10,916,1574,0,3,1,3,0,1,0,76.14,58.20 ,33.33
03,018,01,003,0098,0,719,15,734,1293,0,3,1,3,0,1,0,76.14,56.77 ,33.33
03,018,01,003,0099,0,845,10,855,1445,0,3,1,3,0,1,0,76.14,59.17 ,33.33
03,018,01,003,0100,0,1867,27,1894,3655,0,3,1,3,0,1,0,76.14,51.82 ,33.33
03,018,01,003,0101,0,887,12,899,1560,0,3,1,3,0,1,0,76.14,57.63 ,33.33
03,018,01,003,0102,0,528,4,532,1044,0,3,1,3,0,1,0,76.14,50.96 ,33.33
03,018,01,003,0103,0,764,14,778,1484,0,3,1,3,0,1,0,76.14,52.43 ,33.33
03,018,01,003,0104,0,1272,15,1287,2258,0,3,1,3,0,1,0,76.14,57.00 ,33.33
03,018,01,003,0105,0,890,10,900,1549,0,3,1,3,0,1,0,76.14,58.10 ,33.33
03,018,01,003,0106,0,475,3,478,884,0,3,1,3,0,1,0,76.14,54.07 ,33.33
03,018,01,003,0107,0,798,11,809,1427,0,3,1,3,0,1,0,76.14,56.69 ,33.33
03,018,01,003,0108,0,722,20,742,1293,0,3,1,3,0,1,0,76.14,57.39 ,33.33
03,018,01,003,0109,0,555,4,559,935,0,3,1,3,0,1,0,76.14,59.79 ,33.33
03,018,01,003,0110,0,1380,22,1402,2601,0,3,1,3,0,1,0,76.14,53.90 ,33.33
03,018,01,003,0111,0,421,4,425,677,0,3,1,3,0,1,0,76.14,62.78 ,33.33
03,018,01,003,0112,0,604,14,618,1053,0,3,1,3,0,1,0,76.14,58.69 ,33.33
03,018,01,003,0113,0,347,5,352,577,0,3,1,3,0,1,0,76.14,61.01 ,33.33
03,018,01,003,0114,0,384,10,394,643,0,3,1,3,0,1,0,76.14,61.28 ,33.33
03,018,01,003,0115,0,330,8,338,654,0,3,1,3,0,1,0,76.14,51.68 ,33.33
03,019,01,001,0001,0,602,7,609,966,0,3,1,3,0,1,0,76.14,63.04 ,33.33
03,019,01,001,0002,0,678,3,681,1083,0,3,1,3,0,1,0,76.14,62.88 ,33.33
03,019,01,001,0003,0,784,4,788,1296,0,3,1,3,0,1,0,76.14,60.80 ,33.33
03,019,01,001,0004,0,950,10,960,1584,0,3,1,3,0,1,0,76.14,60.61 ,33.33
03,019,01,001,0005,0,647,6,653,993,0,3,1,3,0,1,0,76.14,65.76 ,33.33
03,019,01,001,0006,0,945,10,955,1390,0,3,1,3,0,1,0,76.14,68.71 ,33.33
03,019,01,001,0007,0,835,1,836,1310,0,3,1,3,0,1,0,76.14,63.82 ,33.33
03,019,01,001,0008,0,944,7,951,1442,0,3,1,3,0,1,0,76.14,65.95 ,33.33
03,019,01,001,0009,0,765,15,780,1238,0,3,1,3,0,1,0,76.14,63.00 ,33.33
03,019,01,001,0010,0,745,10,755,1114,0,3,1,3,0,1,0,76.14,67.77 ,33.33
03,019,01,001,0011,0,733,10,743,1125,0,3,1,3,0,1,0,76.14,66.04 ,33.33
03,019,01,001,0012,0,807,12,819,1307,0,3,1,3,0,1,0,76.14,62.66 ,33.33
03,019,01,001,0013,0,903,7,910,1301,0,3,1,3,0,1,0,76.14,69.95 ,33.33
03,019,01,001,0014,0,754,17,771,1267,0,3,1,3,0,1,0,76.14,60.85 ,33.33
03,019,01,002,0015,0,734,7,741,1123,0,3,1,3,0,1,0,76.14,65.98 ,33.33
03,019,01,002,0016,0,428,6,434,624,0,3,1,3,0,1,0,76.14,69.55 ,33.33
03,019,01,002,0017,0,646,6,652,998,0,3,1,3,0,1,0,76.14,65.33 ,33.33
03,019,01,002,0018,0,669,6,675,1044,0,3,1,3,0,1,0,76.14,64.66 ,33.33
03,019,01,002,0019,0,783,10,793,1283,0,3,1,3,0,1,0,76.14,61.81 ,33.33
03,019,01,002,0020,0,762,7,769,1178,0,3,1,3,0,1,0,76.14,65.28 ,33.33
03,019,01,002,0021,0,878,6,884,1298,0,3,1,3,0,1,0,76.14,68.10 ,33.33
03,019,01,002,0022,0,663,7,670,992,0,3,1,3,0,1,0,76.14,67.54 ,33.33
03,019,01,002,0023,0,2224,26,2250,3549,0,3,1,3,0,1,0,76.14,63.40 ,33.33
03,019,01,002,0024,0,1293,19,1312,1931,0,3,1,3,0,1,0,76.14,67.94 ,33.33
03,019,01,002,0025,0,689,14,703,1014,0,3,1,3,0,1,0,76.14,69.33 ,33.33
03,019,01,002,0026,0,634,7,641,916,0,3,1,3,0,1,0,76.14,69.98 ,33.33
03,019,01,002,0027,0,767,9,776,1213,0,3,1,3,0,1,0,76.14,63.97 ,33.33
03,019,01,002,0028,0,540,5,545,842,0,3,1,3,0,1,0,76.14,64.73 ,33.33
03,019,01,002,0029,0,709,8,717,1070,0,3,1,3,0,1,0,76.14,67.01 ,33.33
03,019,01,002,0030,0,950,14,964,1384,0,3,1,3,0,1,0,76.14,69.65 ,33.33
03,019,01,002,0031,0,2450,32,2482,3657,0,3,1,3,0,1,0,76.14,67.87 ,33.33
03,019,01,002,0032,0,3363,46,3409,5322,0,3,1,3,0,1,0,76.14,64.05 ,33.33
03,019,01,002,0033,0,2030,22,2052,3108,0,3,1,3,0,1,0,76.14,66.02 ,33.33
03,019,01,002,0034,0,1045,10,1055,1671,0,3,1,3,0,1,0,76.14,63.14 ,33.33
03,019,01,002,0035,0,540,5,545,884,0,3,1,3,0,1,0,76.14,61.65 ,33.33
03,019,01,002,0036,0,1617,25,1642,2533,0,3,1,3,0,1,0,76.14,64.82 ,33.33
03,019,01,002,0037,0,586,5,591,921,0,3,1,3,0,1,0,76.14,64.17 ,33.33
03,019,01,002,0038,0,2012,36,2048,3016,0,3,1,3,0,1,0,76.14,67.90 ,33.33
03,019,01,002,0039,0,672,9,681,967,0,3,1,3,0,1,0,76.14,70.42 ,33.33
03,019,01,002,0040,0,439,4,443,756,0,3,1,3,0,1,0,76.14,58.60 ,33.33
03,019,01,002,0041,0,1525,28,1553,2450,0,3,1,3,0,1,0,76.14,63.39 ,33.33
03,019,01,002,0042,0,970,10,980,1483,0,3,1,3,0,1,0,76.14,66.08 ,33.33
03,019,01,003,0043,0,1053,11,1064,1538,0,3,1,3,0,1,0,76.14,69.18 ,33.33
03,019,01,003,0044,0,727,6,733,1107,0,3,1,3,0,1,0,76.14,66.21 ,33.33
03,019,01,003,0045,0,1356,9,1365,2396,0,3,1,3,0,1,0,76.14,56.97 ,33.33
03,019,01,003,0046,0,993,4,997,1522,0,3,1,3,0,1,0,76.14,65.51 ,33.33
03,019,01,003,0047,0,2285,16,2301,3577,0,3,1,3,0,1,0,76.14,64.33 ,33.33
03,019,01,003,0048,0,1089,8,1097,1550,0,3,1,3,0,1,0,76.14,70.77 ,33.33
03,019,01,003,0049,0,1555,19,1574,2278,0,3,1,3,0,1,0,76.14,69.10 ,33.33
03,019,01,003,0050,0,2587,42,2629,3794,0,3,1,3,0,1,0,76.14,69.29 ,33.33
03,019,01,003,0051,0,554,6,560,856,0,3,1,3,0,1,0,76.14,65.42 ,33.33
03,019,01,003,0052,0,963,12,975,1571,0,3,1,3,0,1,0,76.14,62.06 ,33.33
03,019,01,003,0053,0,1631,11,1642,2522,0,3,1,3,0,1,0,76.14,65.11 ,33.33
03,019,01,003,0054,0,1095,7,1102,1681,0,3,1,3,0,1,0,76.14,65.56 ,33.33
03,019,01,003,0055,0,953,6,959,1444,0,3,1,3,0,1,0,76.14,66.41 ,33.33
03,019,01,003,0056,0,1145,10,1155,1791,0,3,1,3,0,1,0,76.14,64.49 ,33.33
03,019,01,003,0057,0,909,4,913,1381,0,3,1,3,0,1,0,76.14,66.11 ,33.33
03,019,01,003,0058,0,1122,8,1130,1813,0,3,1,3,0,1,0,76.14,62.33 ,33.33
03,019,01,003,0059,0,1259,10,1269,1974,0,3,1,3,0,1,0,76.14,64.29 ,33.33
03,019,01,003,0060,0,648,7,655,891,0,3,1,3,0,1,0,76.14,73.51 ,33.33
03,019,01,003,0061,0,1302,14,1316,2050,0,3,1,3,0,1,0,76.14,64.20 ,33.33
03,019,01,003,0062,0,2754,30,2784,4279,0,3,1,3,0,1,0,76.14,65.06 ,33.33
03,019,01,003,0063,0,2112,18,2130,3331,0,3,1,3,0,1,0,76.14,63.94 ,33.33
03,019,01,003,0064,0,2488,30,2518,3978,0,3,1,3,0,1,0,76.14,63.30 ,33.33
03,019,01,003,0065,0,2993,18,3011,4659,0,3,1,3,0,1,0,76.14,64.63 ,33.33
03,019,01,003,0066,0,4845,63,4908,7680,0,3,1,3,0,1,0,76.14,63.91 ,33.33
03,019,01,003,0067,0,1699,28,1727,2505,0,3,1,3,0,1,0,76.14,68.94 ,33.33
03,019,01,003,0068,0,1887,19,1906,2814,0,3,1,3,0,1,0,76.14,67.73 ,33.33
03,019,01,003,0069,0,3707,40,3747,5721,0,3,1,3,0,1,0,76.14,65.50 ,33.33
03,019,01,004,0070,0,488,4,492,750,0,3,1,3,0,1,0,76.14,65.60 ,33.33
03,019,01,004,0071,0,543,8,551,865,0,3,1,3,0,1,0,76.14,63.70 ,33.33
03,019,01,004,0072,0,650,5,655,995,0,3,1,3,0,1,0,76.14,65.83 ,33.33
03,019,01,004,0073,0,1074,11,1085,1579,0,3,1,3,0,1,0,76.14,68.71 ,33.33
03,019,01,004,0074,0,772,11,783,1159,0,3,1,3,0,1,0,76.14,67.56 ,33.33
03,019,01,004,0075,0,698,9,707,1059,0,3,1,3,0,1,0,76.14,66.76 ,33.33
03,019,01,004,0076,0,939,5,944,1488,0,3,1,3,0,1,0,76.14,63.44 ,33.33
03,019,01,004,0077,0,744,3,747,1147,0,3,1,3,0,1,0,76.14,65.13 ,33.33
03,019,01,004,0078,0,2018,22,2040,3181,0,3,1,3,0,1,0,76.14,64.13 ,33.33
03,019,01,004,0079,0,1919,17,1936,3020,0,3,1,3,0,1,0,76.14,64.11 ,33.33
03,019,01,004,0080,0,1394,16,1410,2051,0,3,1,3,0,1,0,76.14,68.75 ,33.33
03,019,01,004,0081,0,1598,30,1628,2675,0,3,1,3,0,1,0,76.14,60.86 ,33.33
03,019,01,004,0082,0,1159,12,1171,1720,0,3,1,3,0,1,0,76.14,68.08 ,33.33
03,019,01,004,0083,0,808,5,813,1270,0,3,1,3,0,1,0,76.14,64.02 ,33.33
03,019,01,004,0084,0,1473,13,1486,2219,0,3,1,3,0,1,0,76.14,66.97 ,33.33
03,019,01,004,0085,0,3571,42,3613,5696,0,3,1,3,0,1,0,76.14,63.43 ,33.33
03,019,01,004,0086,0,3110,44,3154,4902,0,3,1,3,0,1,0,76.14,64.34 ,33.33
03,019,01,004,0087,0,2517,25,2542,4208,0,3,1,3,0,1,0,76.14,60.41 ,33.33
03,019,01,004,0088,0,2902,36,2938,4683,0,3,1,3,0,1,0,76.14,62.74 ,33.33
03,019,01,004,0089,0,1188,14,1202,1892,0,3,1,3,0,1,0,76.14,63.53 ,33.33
03,019,01,004,0090,0,2950,41,2991,4605,0,3,1,3,0,1,0,76.14,64.95 ,33.33
03,019,01,005,0091,0,1038,10,1048,1496,0,3,1,3,0,1,0,76.14,70.05 ,33.33
03,019,01,005,0092,0,579,7,586,882,0,3,1,3,0,1,0,76.14,66.44 ,33.33
03,019,01,005,0093,0,710,8,718,1075,0,3,1,3,0,1,0,76.14,66.79 ,33.33
03,019,01,005,0094,0,504,9,513,893,0,3,1,3,0,1,0,76.14,57.45 ,33.33
03,019,01,005,0095,0,1227,17,1244,1934,0,3,1,3,0,1,0,76.14,64.32 ,33.33
03,019,01,005,0096,0,1242,16,1258,1994,0,3,1,3,0,1,0,76.14,63.09 ,33.33
03,019,01,005,0097,0,658,11,669,1082,0,3,1,3,0,1,0,76.14,61.83 ,33.33
03,019,01,005,0098,0,487,7,494,709,0,3,1,3,0,1,0,76.14,69.68 ,33.33
03,019,01,005,0099,0,615,3,618,980,0,3,1,3,0,1,0,76.14,63.06 ,33.33
03,019,01,005,0100,0,951,13,964,1563,0,3,1,3,0,1,0,76.14,61.68 ,33.33
03,019,01,005,0101,0,556,8,564,837,0,3,1,3,0,1,0,76.14,67.38 ,33.33
03,019,01,005,0102,0,673,11,684,1030,0,3,1,3,0,1,0,76.14,66.41 ,33.33
03,019,01,005,0103,0,775,6,781,1251,0,3,1,3,0,1,0,76.14,62.43 ,33.33
03,019,01,005,0104,0,611,5,616,1000,0,3,1,3,0,1,0,76.14,61.60 ,33.33
03,019,01,005,0105,0,1543,19,1562,2422,0,3,1,3,0,1,0,76.14,64.49 ,33.33
03,019,01,005,0106,0,2241,18,2259,3316,0,3,1,3,0,1,0,76.14,68.12 ,33.33
03,019,01,005,0107,0,2021,12,2033,3059,0,3,1,3,0,1,0,76.14,66.46 ,33.33
03,019,01,005,0108,0,3889,51,3940,6207,0,3,1,3,0,1,0,76.14,63.48 ,33.33
03,019,01,005,0109,0,1851,13,1864,2840,0,3,1,3,0,1,0,76.14,65.63 ,33.33
03,019,01,005,0110,0,1757,12,1769,2983,0,3,1,3,0,1,0,76.14,59.30 ,33.33
03,019,01,005,0111,0,1017,8,1025,1553,0,3,1,3,0,1,0,76.14,66.00 ,33.33
03,019,01,005,0112,0,2681,22,2703,4199,0,3,1,3,0,1,0,76.14,64.37 ,33.33
03,019,01,005,0113,0,1313,7,1320,2235,0,3,1,3,0,1,0,76.14,59.06 ,33.33
03,019,01,005,0114,0,2834,28,2862,4533,0,3,1,3,0,1,0,76.14,63.14 ,33.33
03,019,01,005,0115,0,2964,28,2992,4711,0,3,1,3,0,1,0,76.14,63.51 ,33.33
03,019,01,005,0116,0,2155,20,2175,3264,0,3,1,3,0,1,0,76.14,66.64 ,33.33
03,019,01,005,0117,0,2293,23,2316,3663,0,3,1,3,0,1,0,76.14,63.23 ,33.33
03,019,01,005,0118,0,2775,34,2809,4649,0,3,1,3,0,1,0,76.14,60.42 ,33.33
03,019,01,005,0119,0,2046,30,2076,3297,0,3,1,3,0,1,0,76.14,62.97 ,33.33
03,019,01,005,0120,0,1733,20,1753,2792,0,3,1,3,0,1,0,76.14,62.79 ,33.33
03,019,01,005,0121,0,1959,21,1980,3143,0,3,1,3,0,1,0,76.14,63.00 ,33.33
03,019,01,005,0122,0,3247,32,3279,5036,0,3,1,3,0,1,0,76.14,65.11 ,33.33
03,019,01,005,0123,0,3533,34,3567,5629,0,3,1,3,0,1,0,76.14,63.37 ,33.33
03,019,01,005,0124,0,3808,31,3839,6325,0,3,1,3,0,1,0,76.14,60.70 ,33.33
03,019,01,005,0125,0,1650,13,1663,2663,0,3,1,3,0,1,0,76.14,62.45 ,33.33
03,019,01,006,0126,0,2995,26,3021,4406,0,3,1,3,0,1,0,76.14,68.57 ,33.33
03,019,01,006,0127,0,2359,35,2394,3523,0,3,1,3,0,1,0,76.14,67.95 ,33.33
03,019,01,006,0128,0,2237,25,2262,3193,0,3,1,3,0,1,0,76.14,70.84 ,33.33
03,019,01,006,0129,0,741,10,751,1052,0,3,1,3,0,1,0,76.14,71.39 ,33.33
03,019,01,006,0130,0,676,10,686,883,0,3,1,3,0,1,0,76.14,77.69 ,33.33
03,019,01,006,0131,0,2058,27,2085,2974,0,3,1,3,0,1,0,76.14,70.11 ,33.33
03,019,01,006,0132,0,2980,32,3012,4600,0,3,1,3,0,1,0,76.14,65.48 ,33.33
03,019,01,006,0133,0,3516,39,3555,5263,0,3,1,3,0,1,0,76.14,67.55 ,33.33
03,019,01,006,0134,0,1489,20,1509,1944,0,3,1,3,0,1,0,76.14,77.62 ,33.33
03,019,01,006,0135,0,2856,24,2880,4555,0,3,1,3,0,1,0,76.14,63.23 ,33.33
03,019,01,006,0136,0,2873,36,2909,4345,0,3,1,3,0,1,0,76.14,66.95 ,33.33
03,019,01,006,0137,0,2210,21,2231,3296,0,3,1,3,0,1,0,76.14,67.69 ,33.33
03,019,01,006,0138,0,2404,23,2427,3733,0,3,1,3,0,1,0,76.14,65.01 ,33.33
03,019,01,006,0139,0,2767,21,2788,4251,0,3,1,3,0,1,0,76.14,65.58 ,33.33
03,019,01,006,0140,0,2297,24,2321,3618,0,3,1,3,0,1,0,76.14,64.15 ,33.33
03,019,01,006,0141,0,2104,29,2133,3081,0,3,1,3,0,1,0,76.14,69.23 ,33.33
03,019,01,006,0142,0,782,8,790,1019,0,3,1,3,0,1,0,76.14,77.53 ,33.33
03,019,01,006,0143,0,1895,30,1925,2672,0,3,1,3,0,1,0,76.14,72.04 ,33.33
03,019,01,006,0144,0,2439,20,2459,3704,0,3,1,3,0,1,0,76.14,66.39 ,33.33
03,019,01,006,0145,0,2878,37,2915,3961,0,3,1,3,0,1,0,76.14,73.59 ,33.33
03,019,01,006,0146,0,1255,22,1277,1773,0,3,1,3,0,1,0,76.14,72.02 ,33.33
03,019,01,006,0147,0,1379,27,1406,2019,0,3,1,3,0,1,0,76.14,69.64 ,33.33
03,019,01,006,0148,0,1965,19,1984,3011,0,3,1,3,0,1,0,76.14,65.89 ,33.33
03,019,01,006,0149,0,7786,76,7862,12585,0,3,1,3,0,1,0,76.14,62.47 ,33.33
03,019,01,006,0150,0,1540,24,1564,2355,0,3,1,3,0,1,0,76.14,66.41 ,33.33
03,019,01,007,0151,0,2381,43,2424,3400,0,3,1,3,0,1,0,76.14,71.29 ,33.33
03,019,01,007,0152,0,1936,25,1961,2882,0,3,1,3,0,1,0,76.14,68.04 ,33.33
03,019,01,007,0153,0,2174,29,2203,3185,0,3,1,3,0,1,0,76.14,69.17 ,33.33
03,019,01,007,0154,0,2203,31,2234,3134,0,3,1,3,0,1,0,76.14,71.28 ,33.33
03,019,01,007,0155,0,1090,17,1107,1498,0,3,1,3,0,1,0,76.14,73.90 ,33.33
03,019,01,007,0156,0,1493,15,1508,2304,0,3,1,3,0,1,0,76.14,65.45 ,33.33
03,019,01,007,0157,0,2560,35,2595,4999,0,3,1,3,0,1,0,76.14,51.91 ,33.33
03,019,01,007,0158,0,1693,22,1715,2201,0,3,1,3,0,1,0,76.14,77.92 ,33.33
03,019,01,007,0159,0,2885,36,2921,4424,0,3,1,3,0,1,0,76.14,66.03 ,33.33
03,019,01,007,0160,0,896,15,911,1219,0,3,1,3,0,1,0,76.14,74.73 ,33.33
03,019,01,007,0161,0,2130,15,2145,3232,0,3,1,3,0,1,0,76.14,66.37 ,33.33
03,019,01,007,0162,0,1000,7,1007,1345,0,3,1,3,0,1,0,76.14,74.87 ,33.33
03,019,01,007,0163,0,1631,12,1643,2366,0,3,1,3,0,1,0,76.14,69.44 ,33.33
03,019,01,007,0164,0,4822,47,4869,7309,0,3,1,3,0,1,0,76.14,66.62 ,33.33
03,019,01,007,0165,0,3771,47,3818,5843,0,3,1,3,0,1,0,76.14,65.34 ,33.33
03,019,01,007,0166,0,4137,25,4162,6272,0,3,1,3,0,1,0,76.14,66.36 ,33.33
03,019,01,008,0167,0,3144,29,3173,4816,0,3,1,3,0,1,0,76.14,65.88 ,33.33
03,019,01,008,0168,0,2073,19,2092,2997,0,3,1,3,0,1,0,76.14,69.80 ,33.33
03,019,01,008,0169,0,4812,65,4877,7652,0,3,1,3,0,1,0,76.14,63.73 ,33.33
03,019,01,008,0170,0,4428,40,4468,7072,0,3,1,3,0,1,0,76.14,63.18 ,33.33
03,019,01,008,0171,0,2939,25,2964,4786,0,3,1,3,0,1,0,76.14,61.93 ,33.33
03,019,01,008,0172,0,2250,31,2281,3540,0,3,1,3,0,1,0,76.14,64.44 ,33.33
03,019,01,008,0173,0,3178,44,3222,5017,0,3,1,3,0,1,0,76.14,64.22 ,33.33
03,019,01,008,0174,0,2043,26,2069,3207,0,3,1,3,0,1,0,76.14,64.52 ,33.33
03,019,01,008,0175,0,1757,16,1773,2721,0,3,1,3,0,1,0,76.14,65.16 ,33.33
03,019,01,008,0176,0,2479,34,2513,3957,0,3,1,3,0,1,0,76.14,63.51 ,33.33
03,019,01,008,0177,0,2975,42,3017,4635,0,3,1,3,0,1,0,76.14,65.09 ,33.33
03,019,01,008,0178,0,3463,50,3513,5398,0,3,1,3,0,1,0,76.14,65.08 ,33.33
03,019,01,008,0179,0,2625,31,2656,3827,0,3,1,3,0,1,0,76.14,69.40 ,33.33
03,019,01,008,0180,0,942,11,953,1401,0,3,1,3,0,1,0,76.14,68.02 ,33.33
03,019,01,008,0181,0,536,4,540,859,0,3,1,3,0,1,0,76.14,62.86 ,33.33
03,019,01,008,0182,0,1196,32,1228,1825,0,3,1,3,0,1,0,76.14,67.29 ,33.33
03,019,01,008,0183,0,840,8,848,1255,0,3,1,3,0,1,0,76.14,67.57 ,33.33
03,019,01,008,0184,0,464,7,471,693,0,3,1,3,0,1,0,76.14,67.97 ,33.33
03,019,01,008,0185,0,2178,27,2205,3394,0,3,1,3,0,1,0,76.14,64.97 ,33.33
03,019,01,008,0186,0,3729,36,3765,6038,0,3,1,3,0,1,0,76.14,62.36 ,33.33
03,019,01,008,0187,0,4350,48,4398,6773,0,3,1,3,0,1,0,76.14,64.93 ,33.33
03,019,01,008,0188,0,3832,29,3861,5583,0,3,1,3,0,1,0,76.14,69.16 ,33.33
03,019,01,008,0189,0,3376,40,3416,4734,0,3,1,3,0,1,0,76.14,72.16 ,33.33
03,019,01,008,0190,0,723,10,733,1021,0,3,1,3,0,1,0,76.14,71.79 ,33.33
03,019,01,008,0191,0,2981,29,3010,4386,0,3,1,3,0,1,0,76.14,68.63 ,33.33
03,019,01,008,0192,0,2636,31,2667,3868,0,3,1,3,0,1,0,76.14,68.95 ,33.33
03,019,01,008,0193,0,3266,32,3298,5174,0,3,1,3,0,1,0,76.14,63.74 ,33.33
03,019,01,008,0194,0,2350,21,2371,3459,0,3,1,3,0,1,0,76.14,68.55 ,33.33
03,019,01,008,0195,0,2785,40,2825,4121,0,3,1,3,0,1,0,76.14,68.55 ,33.33
03,019,01,008,0196,0,620,4,624,857,0,3,1,3,0,1,0,76.14,72.81 ,33.33
03,019,01,008,0197,0,3291,41,3332,5026,0,3,1,3,0,1,0,76.14,66.30 ,33.33
03,020,01,001,0001,0,2345,14,2359,3244,0,3,1,3,0,1,0,76.14,72.72 ,33.33
03,020,01,001,0002,0,1778,10,1788,2437,0,3,1,3,0,1,0,76.14,73.37 ,33.33
03,020,01,001,0003,0,428,3,431,590,0,3,1,3,0,1,0,76.14,73.05 ,33.33
03,020,01,001,0004,0,1309,16,1325,1827,0,3,1,3,0,1,0,76.14,72.52 ,33.33
03,020,01,001,0005,0,731,8,739,958,0,3,1,3,0,1,0,76.14,77.14 ,33.33
03,020,01,001,0006,0,2242,17,2259,3025,0,3,1,3,0,1,0,76.14,74.68 ,33.33
03,020,01,001,0007,0,1578,10,1588,2047,0,3,1,3,0,1,0,76.14,77.58 ,33.33
03,020,01,001,0008,0,1440,5,1445,1892,0,3,1,3,0,1,0,76.14,76.37 ,33.33
03,020,01,001,0009,0,2146,14,2160,2778,0,3,1,3,0,1,0,76.14,77.75 ,33.33
03,020,01,001,0010,0,2216,13,2229,2952,0,3,1,3,0,1,0,76.14,75.51 ,33.33
03,020,01,001,0011,0,2720,18,2738,3656,0,3,1,3,0,1,0,76.14,74.89 ,33.33
03,020,01,001,0012,0,970,3,973,1340,0,3,1,3,0,1,0,76.14,72.61 ,33.33
03,020,01,001,0013,0,261,2,263,351,0,3,1,3,0,1,0,76.14,74.93 ,33.33
03,020,01,001,0014,0,391,6,397,518,0,3,1,3,0,1,0,76.14,76.64 ,33.33
03,020,01,001,0015,0,461,4,465,601,0,3,1,3,0,1,0,76.14,77.37 ,33.33
03,020,01,001,0016,0,436,3,439,564,0,3,1,3,0,1,0,76.14,77.84 ,33.33
03,020,01,001,0017,0,499,4,503,642,0,3,1,3,0,1,0,76.14,78.35 ,33.33
03,020,01,001,0018,0,447,4,451,603,0,3,1,3,0,1,0,76.14,74.79 ,33.33
03,020,01,001,0019,0,390,2,392,524,0,3,1,3,0,1,0,76.14,74.81 ,33.33
03,020,01,001,0020,0,1036,3,1039,1377,0,3,1,3,0,1,0,76.14,75.45 ,33.33
03,020,01,001,0021,0,498,1,499,675,0,3,1,3,0,1,0,76.14,73.93 ,33.33
03,020,01,001,0022,0,787,1,788,1023,0,3,1,3,0,1,0,76.14,77.03 ,33.33
03,020,01,001,0023,0,297,3,300,411,0,3,1,3,0,1,0,76.14,72.99 ,33.33
03,020,01,001,0024,0,842,3,845,1126,0,3,1,3,0,1,0,76.14,75.04 ,33.33
03,020,01,001,0025,0,509,3,512,681,0,3,1,3,0,1,0,76.14,75.18 ,33.33
03,020,01,001,0026,0,594,1,595,784,0,3,1,3,0,1,0,76.14,75.89 ,33.33
03,020,01,001,0027,0,617,3,620,828,0,3,1,3,0,1,0,76.14,74.88 ,33.33
03,020,01,001,0028,0,585,2,587,754,0,3,1,3,0,1,0,76.14,77.85 ,33.33
03,020,01,001,0029,0,1474,13,1487,1939,0,3,1,3,0,1,0,76.14,76.69 ,33.33
03,020,01,001,0030,0,882,10,892,1231,0,3,1,3,0,1,0,76.14,72.46 ,33.33
03,020,01,001,0031,0,951,7,958,1262,0,3,1,3,0,1,0,76.14,75.91 ,33.33
03,020,01,001,0032,0,692,10,702,931,0,3,1,3,0,1,0,76.14,75.40 ,33.33
03,020,01,001,0033,0,1823,14,1837,2469,0,3,1,3,0,1,0,76.14,74.40 ,33.33
03,020,01,001,0034,0,1200,9,1209,1673,0,3,1,3,0,1,0,76.14,72.27 ,33.33
03,020,01,001,0035,0,592,1,593,781,0,3,1,3,0,1,0,76.14,75.93 ,33.33
03,020,01,001,0036,0,1228,9,1237,1674,0,3,1,3,0,1,0,76.14,73.89 ,33.33
03,020,01,001,0037,0,2189,19,2208,2997,0,3,1,3,0,1,0,76.14,73.67 ,33.33
03,020,01,001,0038,0,1574,9,1583,2092,0,3,1,3,0,1,0,76.14,75.67 ,33.33
03,020,01,001,0039,0,1390,8,1398,1820,0,3,1,3,0,1,0,76.14,76.81 ,33.33
03,020,01,001,0040,0,3194,23,3217,4310,0,3,1,3,0,1,0,76.14,74.64 ,33.33
03,020,01,001,0041,0,1772,10,1782,2441,0,3,1,3,0,1,0,76.14,73.00 ,33.33
03,020,01,001,0042,0,1389,14,1403,1981,0,3,1,3,0,1,0,76.14,70.82 ,33.33
03,020,01,001,0043,0,1840,20,1860,2482,0,3,1,3,0,1,0,76.14,74.94 ,33.33
03,020,01,001,0044,0,642,8,650,853,0,3,1,3,0,1,0,76.14,76.20 ,33.33
03,020,01,001,0045,0,529,5,534,710,0,3,1,3,0,1,0,76.14,75.21 ,33.33
03,020,01,001,0046,0,863,2,865,1179,0,3,1,3,0,1,0,76.14,73.37 ,33.33
03,020,01,001,0047,0,1145,3,1148,1523,0,3,1,3,0,1,0,76.14,75.38 ,33.33
03,020,01,001,0048,0,739,4,743,954,0,3,1,3,0,1,0,76.14,77.88 ,33.33
03,020,01,001,0049,0,398,5,403,496,0,3,1,3,0,1,0,76.14,81.25 ,33.33
03,020,01,001,0050,0,1807,15,1822,2486,0,3,1,3,0,1,0,76.14,73.29 ,33.33
03,020,01,001,0051,0,1463,12,1475,1941,0,3,1,3,0,1,0,76.14,75.99 ,33.33
03,020,01,001,0052,0,1893,11,1904,2538,0,3,1,3,0,1,0,76.14,75.02 ,33.33
03,020,01,001,0053,0,1183,4,1187,1564,0,3,1,3,0,1,0,76.14,75.90 ,33.33
03,020,01,001,0054,0,2898,18,2916,3884,0,3,1,3,0,1,0,76.14,75.08 ,33.33
03,020,01,002,0055,0,840,3,843,1096,0,3,1,3,0,1,0,76.14,76.92 ,33.33
03,020,01,002,0056,0,553,1,554,722,0,3,1,3,0,1,0,76.14,76.73 ,33.33
03,020,01,002,0057,0,397,3,400,519,0,3,1,3,0,1,0,76.14,77.07 ,33.33
03,020,01,002,0058,0,488,5,493,661,0,3,1,3,0,1,0,76.14,74.58 ,33.33
03,020,01,002,0059,0,461,4,465,603,0,3,1,3,0,1,0,76.14,77.11 ,33.33
03,020,01,002,0060,0,696,5,701,873,0,3,1,3,0,1,0,76.14,80.30 ,33.33
03,020,01,002,0061,0,464,1,465,581,0,3,1,3,0,1,0,76.14,80.03 ,33.33
03,020,01,002,0062,0,769,12,781,1022,0,3,1,3,0,1,0,76.14,76.42 ,33.33
03,020,01,002,0063,0,758,1,759,1006,0,3,1,3,0,1,0,76.14,75.45 ,33.33
03,020,01,002,0064,0,637,2,639,853,0,3,1,3,0,1,0,76.14,74.91 ,33.33
03,020,01,002,0065,0,443,5,448,548,0,3,1,3,0,1,0,76.14,81.75 ,33.33
03,020,01,002,0066,0,613,3,616,821,0,3,1,3,0,1,0,76.14,75.03 ,33.33
03,020,01,002,0067,0,423,1,424,574,0,3,1,3,0,1,0,76.14,73.87 ,33.33
03,020,01,002,0068,0,432,7,439,573,0,3,1,3,0,1,0,76.14,76.61 ,33.33
03,020,01,002,0069,0,355,3,358,475,0,3,1,3,0,1,0,76.14,75.37 ,33.33
03,020,01,002,0070,0,360,4,364,483,0,3,1,3,0,1,0,76.14,75.36 ,33.33
03,020,01,002,0071,0,481,4,485,659,0,3,1,3,0,1,0,76.14,73.60 ,33.33
03,020,01,002,0072,0,606,4,610,749,0,3,1,3,0,1,0,76.14,81.44 ,33.33
03,020,01,002,0073,0,531,2,533,689,0,3,1,3,0,1,0,76.14,77.36 ,33.33
03,020,01,002,0074,0,3160,27,3187,4317,0,3,1,3,0,1,0,76.14,73.82 ,33.33
03,020,01,002,0075,0,734,10,744,979,0,3,1,3,0,1,0,76.14,76.00 ,33.33
03,020,01,002,0076,0,1985,19,2004,2705,0,3,1,3,0,1,0,76.14,74.09 ,33.33
03,020,01,002,0077,0,913,10,923,1180,0,3,1,3,0,1,0,76.14,78.22 ,33.33
03,020,01,002,0078,0,768,8,776,976,0,3,1,3,0,1,0,76.14,79.51 ,33.33
03,020,01,002,0079,0,951,4,955,1231,0,3,1,3,0,1,0,76.14,77.58 ,33.33
03,020,01,002,0080,0,1237,2,1239,1621,0,3,1,3,0,1,0,76.14,76.43 ,33.33
03,020,01,002,0081,0,1826,13,1839,2425,0,3,1,3,0,1,0,76.14,75.84 ,33.33
03,020,01,002,0082,0,1603,10,1613,2161,0,3,1,3,0,1,0,76.14,74.64 ,33.33
03,020,01,002,0083,0,621,4,625,816,0,3,1,3,0,1,0,76.14,76.59 ,33.33
03,020,01,002,0084,0,984,6,990,1356,0,3,1,3,0,1,0,76.14,73.01 ,33.33
03,020,01,002,0085,0,818,5,823,1096,0,3,1,3,0,1,0,76.14,75.09 ,33.33
03,020,01,002,0086,0,1479,10,1489,2050,0,3,1,3,0,1,0,76.14,72.63 ,33.33
03,020,01,002,0087,0,2499,23,2522,3364,0,3,1,3,0,1,0,76.14,74.97 ,33.33
03,020,01,002,0088,0,2233,10,2243,2877,0,3,1,3,0,1,0,76.14,77.96 ,33.33
03,020,01,002,0089,0,3660,32,3692,5011,0,3,1,3,0,1,0,76.14,73.68 ,33.33
03,020,01,002,0090,0,2283,21,2304,3053,0,3,1,3,0,1,0,76.14,75.47 ,33.33
03,020,01,002,0091,0,2735,17,2752,3626,0,3,1,3,0,1,0,76.14,75.90 ,33.33
03,020,01,002,0092,0,1784,8,1792,2385,0,3,1,3,0,1,0,76.14,75.14 ,33.33
03,020,01,002,0093,0,511,3,514,671,0,3,1,3,0,1,0,76.14,76.60 ,33.33
03,020,01,002,0094,0,398,4,402,522,0,3,1,3,0,1,0,76.14,77.01 ,33.33
03,020,01,002,0095,0,1329,9,1338,1790,0,3,1,3,0,1,0,76.14,74.75 ,33.33
03,020,01,002,0096,0,1002,6,1008,1324,0,3,1,3,0,1,0,76.14,76.13 ,33.33
03,020,01,002,0097,0,1235,7,1242,1710,0,3,1,3,0,1,0,76.14,72.63 ,33.33
03,020,01,002,0098,0,1531,18,1549,2116,0,3,1,3,0,1,0,76.14,73.20 ,33.33
03,020,01,002,0099,0,472,3,475,612,0,3,1,3,0,1,0,76.14,77.61 ,33.33
03,020,01,002,0100,0,519,6,525,728,0,3,1,3,0,1,0,76.14,72.12 ,33.33
03,020,01,002,0101,0,1110,7,1117,1516,0,3,1,3,0,1,0,76.14,73.68 ,33.33
03,020,01,002,0102,0,938,10,948,1293,0,3,1,3,0,1,0,76.14,73.32 ,33.33
03,020,01,002,0103,0,1307,6,1313,1730,0,3,1,3,0,1,0,76.14,75.90 ,33.33
03,020,01,002,0104,0,2446,22,2468,3265,0,3,1,3,0,1,0,76.14,75.59 ,33.33
03,020,01,002,0105,0,4748,43,4791,6142,0,3,1,3,0,1,0,76.14,78.00 ,33.33
03,020,01,002,0106,0,2136,18,2154,2874,0,3,1,3,0,1,0,76.14,74.95 ,33.33
03,020,01,002,0107,0,1617,8,1625,2064,0,3,1,3,0,1,0,76.14,78.73 ,33.33
03,020,01,002,0108,0,772,5,777,1037,0,3,1,3,0,1,0,76.14,74.93 ,33.33
03,020,01,002,0109,0,672,6,678,884,0,3,1,3,0,1,0,76.14,76.70 ,33.33
03,021,01,001,0001,0,3358,41,3399,5228,0,3,1,3,0,1,0,76.14,65.02 ,33.33
03,021,01,001,0002,0,2128,26,2154,3119,0,3,1,3,0,1,0,76.14,69.06 ,33.33
03,021,01,001,0003,0,1563,14,1577,2459,0,3,1,3,0,1,0,76.14,64.13 ,33.33
03,021,01,001,0004,0,2816,31,2847,4243,0,3,1,3,0,1,0,76.14,67.10 ,33.33
03,021,01,001,0005,0,2639,30,2669,3798,0,3,1,3,0,1,0,76.14,70.27 ,33.33
03,021,01,001,0006,0,1174,14,1188,1751,0,3,1,3,0,1,0,76.14,67.85 ,33.33
03,021,01,001,0007,0,1578,26,1604,2475,0,3,1,3,0,1,0,76.14,64.81 ,33.33
03,021,01,001,0008,0,1364,14,1378,2016,0,3,1,3,0,1,0,76.14,68.35 ,33.33
03,021,01,001,0009,0,1336,21,1357,1988,0,3,1,3,0,1,0,76.14,68.26 ,33.33
03,021,01,001,0010,0,2908,26,2934,4307,0,3,1,3,0,1,0,76.14,68.12 ,33.33
03,021,01,001,0011,0,2945,36,2981,4401,0,3,1,3,0,1,0,76.14,67.73 ,33.33
03,021,01,001,0012,0,1240,6,1246,1879,0,3,1,3,0,1,0,76.14,66.31 ,33.33
03,021,01,001,0013,0,1593,33,1626,2426,0,3,1,3,0,1,0,76.14,67.02 ,33.33
03,021,01,001,0014,0,1759,13,1772,2563,0,3,1,3,0,1,0,76.14,69.14 ,33.33
03,021,01,001,0015,0,1732,21,1753,2250,0,3,1,3,0,1,0,76.14,77.91 ,33.33
03,021,01,001,0016,0,1493,27,1520,1924,0,3,1,3,0,1,0,76.14,79.00 ,33.33
03,021,01,001,0017,0,2154,19,2173,3101,0,3,1,3,0,1,0,76.14,70.07 ,33.33
03,021,01,001,0018,0,2017,18,2035,2942,0,3,1,3,0,1,0,76.14,69.17 ,33.33
03,021,01,001,0019,0,1791,22,1813,2576,0,3,1,3,0,1,0,76.14,70.38 ,33.33
03,021,01,001,0020,0,2341,33,2374,3512,0,3,1,3,0,1,0,76.14,67.60 ,33.33
03,021,01,001,0021,0,1118,16,1134,1674,0,3,1,3,0,1,0,76.14,67.74 ,33.33
03,021,01,001,0022,0,699,5,704,1022,0,3,1,3,0,1,0,76.14,68.88 ,33.33
03,021,01,001,0023,0,576,12,588,871,0,3,1,3,0,1,0,76.14,67.51 ,33.33
03,021,01,001,0024,0,832,10,842,1309,0,3,1,3,0,1,0,76.14,64.32 ,33.33
03,021,01,001,0025,0,691,9,700,1077,0,3,1,3,0,1,0,76.14,65.00 ,33.33
03,021,01,001,0026,0,527,6,533,830,0,3,1,3,0,1,0,76.14,64.22 ,33.33
03,021,01,001,0027,0,1182,15,1197,1762,0,3,1,3,0,1,0,76.14,67.93 ,33.33
03,021,01,001,0028,0,2918,34,2952,4472,0,3,1,3,0,1,0,76.14,66.01 ,33.33
03,021,01,001,0029,0,1610,16,1626,2332,0,3,1,3,0,1,0,76.14,69.73 ,33.33
03,021,01,001,0030,0,1886,28,1914,2752,0,3,1,3,0,1,0,76.14,69.55 ,33.33
03,021,01,001,0031,0,989,11,1000,1510,0,3,1,3,0,1,0,76.14,66.23 ,33.33
03,021,01,001,0032,0,1745,22,1767,2534,0,3,1,3,0,1,0,76.14,69.73 ,33.33
03,021,01,001,0033,0,1281,17,1298,1928,0,3,1,3,0,1,0,76.14,67.32 ,33.33
03,021,01,001,0034,0,2406,32,2438,3428,0,3,1,3,0,1,0,76.14,71.12 ,33.33
03,021,01,001,0035,0,1106,11,1117,1662,0,3,1,3,0,1,0,76.14,67.21 ,33.33
03,021,01,001,0036,0,1168,20,1188,1816,0,3,1,3,0,1,0,76.14,65.42 ,33.33
03,021,01,001,0037,0,3158,45,3203,4764,0,3,1,3,0,1,0,76.14,67.23 ,33.33
03,021,01,001,0038,0,1294,15,1309,1998,0,3,1,3,0,1,0,76.14,65.52 ,33.33
03,021,01,001,0039,0,725,6,731,1060,0,3,1,3,0,1,0,76.14,68.96 ,33.33
03,021,01,001,0040,0,828,11,839,1242,0,3,1,3,0,1,0,76.14,67.55 ,33.33
03,021,01,001,0041,0,585,5,590,871,0,3,1,3,0,1,0,76.14,67.74 ,33.33
03,021,01,001,0042,0,713,9,722,1087,0,3,1,3,0,1,0,76.14,66.42 ,33.33
03,021,01,001,0043,0,2460,27,2487,3713,0,3,1,3,0,1,0,76.14,66.98 ,33.33
03,021,01,001,0044,0,2830,40,2870,4182,0,3,1,3,0,1,0,76.14,68.63 ,33.33
03,021,01,002,0045,0,1968,35,2003,2904,0,3,1,3,0,1,0,76.14,68.97 ,33.33
03,021,01,002,0046,0,1296,12,1308,1957,0,3,1,3,0,1,0,76.14,66.84 ,33.33
03,021,01,002,0047,0,2786,32,2818,4107,0,3,1,3,0,1,0,76.14,68.61 ,33.33
03,021,01,002,0048,0,798,11,809,1166,0,3,1,3,0,1,0,76.14,69.38 ,33.33
03,021,01,002,0049,0,943,12,955,1411,0,3,1,3,0,1,0,76.14,67.68 ,33.33
03,021,01,002,0050,0,854,14,868,1204,0,3,1,3,0,1,0,76.14,72.09 ,33.33
03,021,01,002,0051,0,948,11,959,1289,0,3,1,3,0,1,0,76.14,74.40 ,33.33
03,021,01,002,0052,0,1089,13,1102,1527,0,3,1,3,0,1,0,76.14,72.17 ,33.33
03,021,01,002,0053,0,723,9,732,1042,0,3,1,3,0,1,0,76.14,70.25 ,33.33
03,021,01,002,0054,0,2285,24,2309,3345,0,3,1,3,0,1,0,76.14,69.03 ,33.33
03,021,01,002,0055,0,1707,17,1724,2530,0,3,1,3,0,1,0,76.14,68.14 ,33.33
03,021,01,002,0056,0,1449,11,1460,2055,0,3,1,3,0,1,0,76.14,71.05 ,33.33
03,021,01,002,0057,0,1969,18,1987,2640,0,3,1,3,0,1,0,76.14,75.27 ,33.33
03,021,01,002,0058,0,1635,12,1647,2445,0,3,1,3,0,1,0,76.14,67.36 ,33.33
03,021,01,002,0059,0,2055,21,2076,2992,0,3,1,3,0,1,0,76.14,69.39 ,33.33
03,021,01,002,0060,0,2156,19,2175,2994,0,3,1,3,0,1,0,76.14,72.65 ,33.33
03,021,01,002,0061,0,3046,23,3069,4380,0,3,1,3,0,1,0,76.14,70.07 ,33.33
03,021,01,002,0062,0,2092,22,2114,3047,0,3,1,3,0,1,0,76.14,69.38 ,33.33
03,021,01,002,0063,0,1367,14,1381,2001,0,3,1,3,0,1,0,76.14,69.02 ,33.33
03,021,01,002,0064,0,2600,27,2627,3696,0,3,1,3,0,1,0,76.14,71.08 ,33.33
03,021,01,002,0065,0,1453,13,1466,1975,0,3,1,3,0,1,0,76.14,74.23 ,33.33
03,021,01,002,0066,0,2224,29,2253,3250,0,3,1,3,0,1,0,76.14,69.32 ,33.33
03,021,01,002,0067,0,2290,32,2322,3467,0,3,1,3,0,1,0,76.14,66.97 ,33.33
03,021,01,002,0068,0,2132,26,2158,2919,0,3,1,3,0,1,0,76.14,73.93 ,33.33
03,021,01,002,0069,0,2281,25,2306,3203,0,3,1,3,0,1,0,76.14,72.00 ,33.33
03,021,01,002,0070,0,2081,20,2101,3046,0,3,1,3,0,1,0,76.14,68.98 ,33.33
03,021,01,002,0071,0,2771,26,2797,4102,0,3,1,3,0,1,0,76.14,68.19 ,33.33
03,021,01,002,0072,0,2191,34,2225,3371,0,3,1,3,0,1,0,76.14,66.00 ,33.33
03,021,01,002,0073,0,1308,6,1314,1970,0,3,1,3,0,1,0,76.14,66.70 ,33.33
03,021,01,002,0074,0,697,9,706,1003,0,3,1,3,0,1,0,76.14,70.39 ,33.33
03,021,01,002,0075,0,688,10,698,949,0,3,1,3,0,1,0,76.14,73.55 ,33.33
03,021,01,002,0076,0,1416,13,1429,2006,0,3,1,3,0,1,0,76.14,71.24 ,33.33
03,021,01,002,0077,0,1081,10,1091,1552,0,3,1,3,0,1,0,76.14,70.30 ,33.33
03,021,01,002,0078,0,943,11,954,1377,0,3,1,3,0,1,0,76.14,69.28 ,33.33
03,021,01,002,0079,0,1595,13,1608,2281,0,3,1,3,0,1,0,76.14,70.50 ,33.33
03,021,01,002,0080,0,451,4,455,606,0,3,1,3,0,1,0,76.14,75.08 ,33.33
03,021,01,002,0081,0,401,9,410,588,0,3,1,3,0,1,0,76.14,69.73 ,33.33
03,021,01,002,0082,0,666,4,670,986,0,3,1,3,0,1,0,76.14,67.95 ,33.33
03,021,01,002,0083,0,495,3,498,708,0,3,1,3,0,1,0,76.14,70.34 ,33.33
03,021,01,002,0084,0,967,13,980,1398,0,3,1,3,0,1,0,76.14,70.10 ,33.33
03,021,01,002,0085,0,1169,9,1178,1699,0,3,1,3,0,1,0,76.14,69.33 ,33.33
03,021,01,002,0086,0,525,6,531,737,0,3,1,3,0,1,0,76.14,72.05 ,33.33
03,021,01,002,0087,0,1182,10,1192,1637,0,3,1,3,0,1,0,76.14,72.82 ,33.33
03,021,01,003,0088,0,555,8,563,788,0,3,1,3,0,1,0,76.14,71.45 ,33.33
03,021,01,003,0089,0,504,3,507,683,0,3,1,3,0,1,0,76.14,74.23 ,33.33
03,021,01,003,0090,0,461,9,470,666,0,3,1,3,0,1,0,76.14,70.57 ,33.33
03,021,01,003,0091,0,553,3,556,788,0,3,1,3,0,1,0,76.14,70.56 ,33.33
03,021,01,003,0092,0,545,4,549,841,0,3,1,3,0,1,0,76.14,65.28 ,33.33
03,021,01,003,0093,0,1570,23,1593,2168,0,3,1,3,0,1,0,76.14,73.48 ,33.33
03,021,01,003,0094,0,921,9,930,1370,0,3,1,3,0,1,0,76.14,67.88 ,33.33
03,021,01,003,0095,0,1593,15,1608,2202,0,3,1,3,0,1,0,76.14,73.02 ,33.33
03,021,01,003,0096,0,1564,12,1576,2253,0,3,1,3,0,1,0,76.14,69.95 ,33.33
03,021,01,003,0097,0,1682,18,1700,2479,0,3,1,3,0,1,0,76.14,68.58 ,33.33
03,021,01,003,0098,0,1565,18,1583,2281,0,3,1,3,0,1,0,76.14,69.40 ,33.33
03,021,01,003,0099,0,790,14,804,1115,0,3,1,3,0,1,0,76.14,72.11 ,33.33
03,021,01,003,0100,0,678,12,690,938,0,3,1,3,0,1,0,76.14,73.56 ,33.33
03,021,01,003,0101,0,634,24,658,927,0,3,1,3,0,1,0,76.14,70.98 ,33.33
03,021,01,003,0102,0,669,7,676,1005,0,3,1,3,0,1,0,76.14,67.26 ,33.33
03,021,01,003,0103,0,408,8,416,569,0,3,1,3,0,1,0,76.14,73.11 ,33.33
03,021,01,003,0104,0,658,9,667,960,0,3,1,3,0,1,0,76.14,69.48 ,33.33
03,021,01,003,0105,0,431,10,441,633,0,3,1,3,0,1,0,76.14,69.67 ,33.33
03,021,01,003,0106,0,597,7,604,936,0,3,1,3,0,1,0,76.14,64.53 ,33.33
03,021,01,003,0107,0,1362,16,1378,2114,0,3,1,3,0,1,0,76.14,65.18 ,33.33
03,021,01,003,0108,0,590,9,599,904,0,3,1,3,0,1,0,76.14,66.26 ,33.33
03,021,01,003,0109,0,416,7,423,604,0,3,1,3,0,1,0,76.14,70.03 ,33.33
03,021,01,003,0110,0,199,0,199,248,0,3,1,3,0,1,0,76.14,80.24 ,33.33
03,021,01,003,0111,0,346,2,348,466,0,3,1,3,0,1,0,76.14,74.68 ,33.33
03,021,01,003,0112,0,385,1,386,507,0,3,1,3,0,1,0,76.14,76.13 ,33.33
03,021,01,003,0113,0,1046,10,1056,1552,0,3,1,3,0,1,0,76.14,68.04 ,33.33
03,021,01,003,0114,0,217,3,220,306,0,3,1,3,0,1,0,76.14,71.90 ,33.33
03,021,01,003,0115,0,619,11,630,821,0,3,1,3,0,1,0,76.14,76.74 ,33.33
03,021,01,003,0116,0,669,9,678,1005,0,3,1,3,0,1,0,76.14,67.46 ,33.33
03,021,01,003,0117,0,845,10,855,1151,0,3,1,3,0,1,0,76.14,74.28 ,33.33
03,021,01,004,0118,0,654,6,660,958,0,3,1,3,0,1,0,76.14,68.89 ,33.33
03,021,01,004,0119,0,698,8,706,1051,0,3,1,3,0,1,0,76.14,67.17 ,33.33
03,021,01,004,0120,0,638,6,644,971,0,3,1,3,0,1,0,76.14,66.32 ,33.33
03,021,01,004,0121,0,822,7,829,1270,0,3,1,3,0,1,0,76.14,65.28 ,33.33
03,021,01,004,0122,0,679,9,688,985,0,3,1,3,0,1,0,76.14,69.85 ,33.33
03,021,01,004,0123,0,753,8,761,1143,0,3,1,3,0,1,0,76.14,66.58 ,33.33
03,021,01,004,0124,0,798,7,805,1203,0,3,1,3,0,1,0,76.14,66.92 ,33.33
03,021,01,004,0125,0,647,9,656,951,0,3,1,3,0,1,0,76.14,68.98 ,33.33
03,021,01,004,0126,0,846,13,859,1191,0,3,1,3,0,1,0,76.14,72.12 ,33.33
03,021,01,004,0127,0,740,5,745,1037,0,3,1,3,0,1,0,76.14,71.84 ,33.33
03,021,01,004,0128,0,1156,12,1168,1734,0,3,1,3,0,1,0,76.14,67.36 ,33.33
03,021,01,004,0129,0,1376,9,1385,2043,0,3,1,3,0,1,0,76.14,67.79 ,33.33
03,021,01,004,0130,0,1447,22,1469,2040,0,3,1,3,0,1,0,76.14,72.01 ,33.33
03,021,01,004,0131,0,1676,29,1705,2420,0,3,1,3,0,1,0,76.14,70.45 ,33.33
03,021,01,004,0132,0,1391,19,1410,2135,0,3,1,3,0,1,0,76.14,66.04 ,33.33
03,021,01,004,0133,0,1370,16,1386,2017,0,3,1,3,0,1,0,76.14,68.72 ,33.33
03,021,01,004,0134,0,1002,9,1011,1418,0,3,1,3,0,1,0,76.14,71.30 ,33.33
03,021,01,004,0135,0,1300,15,1315,1918,0,3,1,3,0,1,0,76.14,68.56 ,33.33
03,021,01,004,0136,0,1962,20,1982,2870,0,3,1,3,0,1,0,76.14,69.06 ,33.33
03,021,01,004,0137,0,778,11,789,1004,0,3,1,3,0,1,0,76.14,78.59 ,33.33
03,021,01,004,0138,0,458,5,463,608,0,3,1,3,0,1,0,76.14,76.15 ,33.33
03,021,01,004,0139,0,934,7,941,1369,0,3,1,3,0,1,0,76.14,68.74 ,33.33
03,021,01,004,0140,0,838,7,845,1168,0,3,1,3,0,1,0,76.14,72.35 ,33.33
03,021,01,004,0141,0,1036,24,1060,1477,0,3,1,3,0,1,0,76.14,71.77 ,33.33
03,021,01,004,0142,0,1037,8,1045,1360,0,3,1,3,0,1,0,76.14,76.84 ,33.33
03,021,01,004,0143,0,711,11,722,994,0,3,1,3,0,1,0,76.14,72.64 ,33.33
03,021,01,004,0144,0,1405,13,1418,1964,0,3,1,3,0,1,0,76.14,72.20 ,33.33
03,021,01,004,0145,0,3254,35,3289,4680,0,3,1,3,0,1,0,76.14,70.28 ,33.33
03,021,01,004,0146,0,1060,15,1075,1544,0,3,1,3,0,1,0,76.14,69.62 ,33.33
03,021,01,004,0147,0,1357,16,1373,1999,0,3,1,3,0,1,0,76.14,68.68 ,33.33
03,021,01,004,0148,0,1146,13,1159,1666,0,3,1,3,0,1,0,76.14,69.57 ,33.33
03,021,01,004,0149,0,938,11,949,1379,0,3,1,3,0,1,0,76.14,68.82 ,33.33
03,021,01,004,0150,0,1096,8,1104,1601,0,3,1,3,0,1,0,76.14,68.96 ,33.33
03,021,01,004,0151,0,1235,13,1248,1867,0,3,1,3,0,1,0,76.14,66.85 ,33.33
03,021,01,004,0152,0,2258,23,2281,3372,0,3,1,3,0,1,0,76.14,67.65 ,33.33
03,021,01,004,0153,0,2917,35,2952,4329,0,3,1,3,0,1,0,76.14,68.19 ,33.33
03,021,01,004,0154,0,2071,19,2090,2991,0,3,1,3,0,1,0,76.14,69.88 ,33.33
03,021,01,004,0155,0,873,8,881,1229,0,3,1,3,0,1,0,76.14,71.68 ,33.33
03,021,01,004,0156,0,919,13,932,1368,0,3,1,3,0,1,0,76.14,68.13 ,33.33
03,021,01,004,0157,0,2884,28,2912,4229,0,3,1,3,0,1,0,76.14,68.86 ,33.33
03,021,01,004,0158,0,3769,44,3813,5400,0,3,1,3,0,1,0,76.14,70.61 ,33.33
03,021,01,004,0159,0,3202,41,3243,4746,0,3,1,3,0,1,0,76.14,68.33 ,33.33
03,021,01,005,0160,0,957,9,966,1348,0,3,1,3,0,1,0,76.14,71.66 ,33.33
03,021,01,005,0161,0,821,8,829,1136,0,3,1,3,0,1,0,76.14,72.98 ,33.33
03,021,01,005,0162,0,781,7,788,1127,0,3,1,3,0,1,0,76.14,69.92 ,33.33
03,021,01,005,0163,0,995,15,1010,1481,0,3,1,3,0,1,0,76.14,68.20 ,33.33
03,021,01,005,0164,0,543,3,546,795,0,3,1,3,0,1,0,76.14,68.68 ,33.33
03,021,01,005,0165,0,455,4,459,684,0,3,1,3,0,1,0,76.14,67.11 ,33.33
03,021,01,005,0166,0,329,2,331,485,0,3,1,3,0,1,0,76.14,68.25 ,33.33
03,021,01,005,0167,0,361,3,364,536,0,3,1,3,0,1,0,76.14,67.91 ,33.33
03,021,01,005,0168,0,916,6,922,1294,0,3,1,3,0,1,0,76.14,71.25 ,33.33
03,021,01,005,0169,0,302,3,305,431,0,3,1,3,0,1,0,76.14,70.77 ,33.33
03,021,01,005,0170,0,417,4,421,559,0,3,1,3,0,1,0,76.14,75.31 ,33.33
03,021,01,005,0171,0,427,5,432,589,0,3,1,3,0,1,0,76.14,73.34 ,33.33
03,021,01,005,0172,0,531,7,538,715,0,3,1,3,0,1,0,76.14,75.24 ,33.33
03,021,01,005,0173,0,536,4,540,766,0,3,1,3,0,1,0,76.14,70.50 ,33.33
03,021,01,005,0174,0,757,6,763,1138,0,3,1,3,0,1,0,76.14,67.05 ,33.33
03,021,01,005,0175,0,393,5,398,576,0,3,1,3,0,1,0,76.14,69.10 ,33.33
03,021,01,005,0176,0,462,5,467,657,0,3,1,3,0,1,0,76.14,71.08 ,33.33
03,021,01,005,0177,0,395,6,401,560,0,3,1,3,0,1,0,76.14,71.61 ,33.33
03,021,01,005,0178,0,454,6,460,705,0,3,1,3,0,1,0,76.14,65.25 ,33.33
03,021,01,005,0179,0,551,6,557,843,0,3,1,3,0,1,0,76.14,66.07 ,33.33
03,021,01,005,0180,0,586,9,595,844,0,3,1,3,0,1,0,76.14,70.50 ,33.33
03,021,01,005,0181,0,430,2,432,600,0,3,1,3,0,1,0,76.14,72.00 ,33.33
03,021,01,005,0182,0,645,7,652,987,0,3,1,3,0,1,0,76.14,66.06 ,33.33
03,021,01,005,0183,0,374,3,377,512,0,3,1,3,0,1,0,76.14,73.63 ,33.33
03,021,01,005,0184,0,352,7,359,512,0,3,1,3,0,1,0,76.14,70.12 ,33.33
03,021,01,005,0185,0,832,8,840,1233,0,3,1,3,0,1,0,76.14,68.13 ,33.33
03,021,01,005,0186,0,1608,13,1621,2406,0,3,1,3,0,1,0,76.14,67.37 ,33.33
03,021,01,005,0187,0,774,2,776,1096,0,3,1,3,0,1,0,76.14,70.80 ,33.33
03,021,01,005,0188,0,1012,13,1025,1510,0,3,1,3,0,1,0,76.14,67.88 ,33.33
03,021,01,005,0189,0,503,7,510,727,0,3,1,3,0,1,0,76.14,70.15 ,33.33
03,021,01,005,0190,0,563,9,572,830,0,3,1,3,0,1,0,76.14,68.92 ,33.33
03,021,01,005,0191,0,1065,8,1073,1609,0,3,1,3,0,1,0,76.14,66.69 ,33.33
03,021,01,005,0192,0,1253,10,1263,1756,0,3,1,3,0,1,0,76.14,71.92 ,33.33
03,021,01,005,0193,0,2114,15,2129,3099,0,3,1,3,0,1,0,76.14,68.70 ,33.33
03,021,01,006,0194,0,1808,22,1830,2649,0,3,1,3,0,1,0,76.14,69.08 ,33.33
03,021,01,006,0195,0,1344,24,1368,1947,0,3,1,3,0,1,0,76.14,70.26 ,33.33
03,021,01,006,0196,0,1314,17,1331,1820,0,3,1,3,0,1,0,76.14,73.13 ,33.33
03,021,01,006,0197,0,1432,16,1448,1957,0,3,1,3,0,1,0,76.14,73.99 ,33.33
03,021,01,006,0198,0,1685,24,1709,2445,0,3,1,3,0,1,0,76.14,69.90 ,33.33
03,021,01,006,0199,0,2241,30,2271,3257,0,3,1,3,0,1,0,76.14,69.73 ,33.33
03,021,01,006,0200,0,1466,16,1482,2014,0,3,1,3,0,1,0,76.14,73.58 ,33.33
03,021,01,006,0201,0,1486,16,1502,2407,0,3,1,3,0,1,0,76.14,62.40 ,33.33
03,021,01,006,0202,0,1575,17,1592,2362,0,3,1,3,0,1,0,76.14,67.40 ,33.33
03,021,01,006,0203,0,1262,12,1274,1875,0,3,1,3,0,1,0,76.14,67.95 ,33.33
03,021,01,006,0204,0,1204,10,1214,1805,0,3,1,3,0,1,0,76.14,67.26 ,33.33
03,021,01,006,0205,0,2687,37,2724,3850,0,3,1,3,0,1,0,76.14,70.75 ,33.33
03,021,01,006,0206,0,349,3,352,468,0,3,1,3,0,1,0,76.14,75.21 ,33.33
03,021,01,006,0207,0,1636,18,1654,2338,0,3,1,3,0,1,0,76.14,70.74 ,33.33
03,021,01,006,0208,0,1973,28,2001,2851,0,3,1,3,0,1,0,76.14,70.19 ,33.33
03,021,01,006,0209,0,670,10,680,951,0,3,1,3,0,1,0,76.14,71.50 ,33.33
03,021,01,006,0210,0,1095,7,1102,1448,0,3,1,3,0,1,0,76.14,76.10 ,33.33
03,021,01,006,0211,0,870,11,881,1144,0,3,1,3,0,1,0,76.14,77.01 ,33.33
03,021,01,006,0212,0,1727,22,1749,2424,0,3,1,3,0,1,0,76.14,72.15 ,33.33
03,021,01,006,0213,0,592,13,605,790,0,3,1,3,0,1,0,76.14,76.58 ,33.33
03,021,01,006,0214,0,1242,12,1254,1708,0,3,1,3,0,1,0,76.14,73.42 ,33.33
03,021,01,006,0215,0,757,7,764,1059,0,3,1,3,0,1,0,76.14,72.14 ,33.33
03,021,01,006,0216,0,610,4,614,765,0,3,1,3,0,1,0,76.14,80.26 ,33.33
03,021,01,006,0217,0,722,7,729,1026,0,3,1,3,0,1,0,76.14,71.05 ,33.33
03,021,01,006,0218,0,1039,11,1050,1511,0,3,1,3,0,1,0,76.14,69.49 ,33.33
03,021,01,006,0219,0,732,6,738,916,0,3,1,3,0,1,0,76.14,80.57 ,33.33
03,021,01,006,0220,0,804,17,821,1017,0,3,1,3,0,1,0,76.14,80.73 ,33.33
03,021,01,006,0221,0,579,7,586,763,0,3,1,3,0,1,0,76.14,76.80 ,33.33
03,021,01,006,0222,0,1429,21,1450,1949,0,3,1,3,0,1,0,76.14,74.40 ,33.33
03,021,01,006,0223,0,436,3,439,556,0,3,1,3,0,1,0,76.14,78.96 ,33.33
03,021,01,006,0224,0,782,7,789,1039,0,3,1,3,0,1,0,76.14,75.94 ,33.33
03,021,01,006,0225,0,906,4,910,1245,0,3,1,3,0,1,0,76.14,73.09 ,33.33
03,021,01,006,0226,0,707,8,715,943,0,3,1,3,0,1,0,76.14,75.82 ,33.33
03,021,01,006,0227,0,422,5,427,558,0,3,1,3,0,1,0,76.14,76.52 ,33.33
03,021,01,006,0228,0,923,9,932,1236,0,3,1,3,0,1,0,76.14,75.40 ,33.33
03,021,01,006,0229,0,400,3,403,486,0,3,1,3,0,1,0,76.14,82.92 ,33.33
03,021,01,006,0230,0,1240,15,1255,1822,0,3,1,3,0,1,0,76.14,68.88 ,33.33
03,021,01,006,0231,0,1576,19,1595,2318,0,3,1,3,0,1,0,76.14,68.81 ,33.33
03,021,01,006,0232,0,1538,27,1565,2282,0,3,1,3,0,1,0,76.14,68.58 ,33.33
03,021,01,006,0233,0,1286,21,1307,1872,0,3,1,3,0,1,0,76.14,69.82 ,33.33
03,021,01,006,0234,0,1384,17,1401,2041,0,3,1,3,0,1,0,76.14,68.64 ,33.33
03,021,01,006,0235,0,1547,21,1568,2316,0,3,1,3,0,1,0,76.14,67.70 ,33.33
03,021,01,006,0236,0,3340,56,3396,5026,0,3,1,3,0,1,0,76.14,67.57 ,33.33
03,021,01,006,0237,0,3263,44,3307,4615,0,3,1,3,0,1,0,76.14,71.66 ,33.33
03,021,01,006,0238,0,2125,25,2150,3105,0,3,1,3,0,1,0,76.14,69.24 ,33.33
03,021,01,006,0239,0,1284,10,1294,1862,0,3,1,3,0,1,0,76.14,69.50 ,33.33
03,021,01,006,0240,0,1693,21,1714,2464,0,3,1,3,0,1,0,76.14,69.56 ,33.33
03,021,01,006,0241,0,3669,44,3713,5379,0,3,1,3,0,1,0,76.14,69.03 ,33.33
03,021,01,007,0242,0,5921,56,5977,9699,0,3,1,3,0,1,0,76.14,61.62 ,33.33
03,021,01,007,0243,0,2697,38,2735,3944,0,3,1,3,0,1,0,76.14,69.35 ,33.33
03,021,01,007,0244,0,300,4,304,374,0,3,1,3,0,1,0,76.14,81.28 ,33.33
03,021,01,007,0245,0,345,8,353,488,0,3,1,3,0,1,0,76.14,72.34 ,33.33
03,021,01,007,0246,0,271,1,272,371,0,3,1,3,0,1,0,76.14,73.32 ,33.33
03,021,01,007,0247,0,253,2,255,399,0,3,1,3,0,1,0,76.14,63.91 ,33.33
03,021,01,007,0248,0,606,7,613,879,0,3,1,3,0,1,0,76.14,69.74 ,33.33
03,021,01,007,0249,0,1620,25,1645,2202,0,3,1,3,0,1,0,76.14,74.70 ,33.33
03,021,01,007,0250,0,1300,10,1310,1930,0,3,1,3,0,1,0,76.14,67.88 ,33.33
03,021,01,007,0251,0,313,5,318,425,0,3,1,3,0,1,0,76.14,74.82 ,33.33
04,001,01,001,0001,0,946,10,956,1342,0,3,1,3,0,1,0,76.14,71.24 ,33.33
04,001,01,001,0002,0,1294,8,1302,1789,0,3,1,3,0,1,0,76.14,72.78 ,33.33
04,001,01,001,0003,0,1665,16,1681,2358,0,3,1,3,0,1,0,76.14,71.29 ,33.33
04,001,01,001,0004,0,855,10,865,1195,0,3,1,3,0,1,0,76.14,72.38 ,33.33
04,001,01,001,0005,0,585,9,594,844,0,3,1,3,0,1,0,76.14,70.38 ,33.33
04,001,01,001,0006,0,380,1,381,541,0,3,1,3,0,1,0,76.14,70.43 ,33.33
04,001,01,001,0007,0,688,14,702,1005,0,3,1,3,0,1,0,76.14,69.85 ,33.33
04,001,01,001,0008,0,307,4,311,472,0,3,1,3,0,1,0,76.14,65.89 ,33.33
04,001,01,002,0009,0,619,8,627,961,0,3,1,3,0,1,0,76.14,65.24 ,33.33
04,001,01,002,0010,0,784,8,792,1156,0,3,1,3,0,1,0,76.14,68.51 ,33.33
04,001,01,002,0011,0,626,10,636,886,0,3,1,3,0,1,0,76.14,71.78 ,33.33
04,001,01,002,0012,0,702,20,722,1112,0,3,1,3,0,1,0,76.14,64.93 ,33.33
04,001,01,002,0013,0,576,4,580,824,0,3,1,3,0,1,0,76.14,70.39 ,33.33
04,001,01,002,0014,0,263,2,265,402,0,3,1,3,0,1,0,76.14,65.92 ,33.33
04,001,01,003,0015,0,1085,13,1098,1497,0,3,1,3,0,1,0,76.14,73.35 ,33.33
04,001,01,003,0016,0,788,9,797,1055,0,3,1,3,0,1,0,76.14,75.55 ,33.33
04,001,01,003,0017,0,335,6,341,456,0,3,1,3,0,1,0,76.14,74.78 ,33.33
04,001,01,003,0018,0,304,1,305,434,0,3,1,3,0,1,0,76.14,70.28 ,33.33
04,001,01,003,0019,0,326,1,327,477,0,3,1,3,0,1,0,76.14,68.55 ,33.33
04,001,01,003,0020,0,788,6,794,1026,0,3,1,3,0,1,0,76.14,77.39 ,33.33
04,001,01,003,0021,0,556,5,561,709,0,3,1,3,0,1,0,76.14,79.13 ,33.33
04,001,01,003,0022,0,664,4,668,958,0,3,1,3,0,1,0,76.14,69.73 ,33.33
04,001,01,004,0023,0,1053,16,1069,1490,0,3,1,3,0,1,0,76.14,71.74 ,33.33
04,001,01,004,0024,0,444,7,451,620,0,3,1,3,0,1,0,76.14,72.74 ,33.33
04,001,01,004,0025,0,445,11,456,698,0,3,1,3,0,1,0,76.14,65.33 ,33.33
04,001,01,004,0026,0,306,4,310,445,0,3,1,3,0,1,0,76.14,69.66 ,33.33
04,001,01,004,0027,0,331,1,332,529,0,3,1,3,0,1,0,76.14,62.76 ,33.33
04,001,01,004,0028,0,356,3,359,531,0,3,1,3,0,1,0,76.14,67.61 ,33.33
04,001,01,004,0029,0,258,2,260,372,0,3,1,3,0,1,0,76.14,69.89 ,33.33
04,001,01,004,0030,0,389,6,395,589,0,3,1,3,0,1,0,76.14,67.06 ,33.33
04,001,01,005,0031,0,708,5,713,921,0,3,1,3,0,1,0,76.14,77.42 ,33.33
04,001,01,005,0032,0,267,1,268,387,0,3,1,3,0,1,0,76.14,69.25 ,33.33
04,001,01,005,0033,0,370,9,379,548,0,3,1,3,0,1,0,76.14,69.16 ,33.33
04,001,01,005,0034,0,272,2,274,373,0,3,1,3,0,1,0,76.14,73.46 ,33.33
04,001,01,005,0035,0,566,6,572,768,0,3,1,3,0,1,0,76.14,74.48 ,33.33
04,001,01,006,0036,0,33,0,33,82,0,3,1,3,0,1,0,76.14,40.24 ,33.33
04,002,01,001,0001,0,1297,18,1315,1508,0,3,1,3,0,1,0,76.14,87.20 ,33.33
04,002,01,001,0002,0,601,10,611,724,0,3,1,3,0,1,0,76.14,84.39 ,33.33
04,002,01,002,0003,0,420,4,424,515,0,3,1,3,0,1,0,76.14,82.33 ,33.33
04,002,01,002,0004,0,183,3,186,234,0,3,1,3,0,1,0,76.14,79.49 ,33.33
04,002,01,003,0005,0,177,0,177,219,0,3,1,3,0,1,0,76.14,80.82 ,33.33
04,002,01,003,0006,0,127,1,128,155,0,3,1,3,0,1,0,76.14,82.58 ,33.33
04,002,01,004,0007,0,308,4,312,426,0,3,1,3,0,1,0,76.14,73.24 ,33.33
01,000,01,001,0001,1,761,9,770,1068,0,3,1,3,0,1,0,76.14,72.10 ,33.33
01,000,01,001,0001,2,880,5,885,1348,0,3,1,3,0,1,0,76.14,65.65 ,33.33
01,000,01,001,0001,3,817,10,827,1220,0,3,1,3,0,1,0,76.14,67.79 ,33.33
01,000,01,001,0002,4,1182,17,1199,1756,0,3,1,3,0,1,0,76.14,68.28 ,33.33
01,000,01,001,0002,5,935,5,940,1376,0,3,1,3,0,1,0,76.14,68.31 ,33.33
01,000,01,001,0003,6,836,7,843,1311,0,3,1,3,0,1,0,76.14,64.30 ,33.33
01,000,01,001,0003,7,868,12,880,1410,0,3,1,3,0,1,0,76.14,62.41 ,33.33
01,000,01,001,0003,8,940,12,952,1440,0,3,1,3,0,1,0,76.14,66.11 ,33.33
01,000,01,001,0004,9,829,9,838,1296,0,3,1,3,0,1,0,76.14,64.66 ,33.33
01,000,01,001,0004,10,901,8,909,1357,0,3,1,3,0,1,0,76.14,66.99 ,33.33
01,000,01,001,0004,11,928,5,933,1382,0,3,1,3,0,1,0,76.14,67.51 ,33.33
01,000,01,001,0004,12,795,1,796,1181,0,3,1,3,0,1,0,76.14,67.40 ,33.33
01,000,01,001,0005,13,1019,12,1031,1490,0,3,1,3,0,1,0,76.14,69.19 ,33.33
01,000,01,001,0005,14,1044,7,1051,1490,0,3,1,3,0,1,0,76.14,70.54 ,33.33
01,000,01,001,0005,15,1177,11,1188,1748,0,3,1,3,0,1,0,76.14,67.96 ,33.33
01,000,01,001,0006,16,854,6,860,1149,0,3,1,3,0,1,0,76.14,74.85 ,33.33
01,000,01,001,0007,17,826,10,836,1235,0,3,1,3,0,1,0,76.14,67.69 ,33.33
01,000,01,001,0007,18,839,6,845,1208,0,3,1,3,0,1,0,76.14,69.95 ,33.33
01,000,01,001,0007,19,913,4,917,1254,0,3,1,3,0,1,0,76.14,73.13 ,33.33
01,000,01,001,0008,20,995,13,1008,1442,0,3,1,3,0,1,0,76.14,69.90 ,33.33
01,000,01,001,0008,21,1018,16,1034,1592,0,3,1,3,0,1,0,76.14,64.95 ,33.33
01,000,01,001,0008,22,954,8,962,1348,0,3,1,3,0,1,0,76.14,71.36 ,33.33
01,000,01,001,0009,23,715,10,725,1080,0,3,1,3,0,1,0,76.14,67.13 ,33.33
01,000,01,001,0009,24,823,10,833,1282,0,3,1,3,0,1,0,76.14,64.98 ,33.33
01,000,01,001,0009,25,758,7,765,1145,0,3,1,3,0,1,0,76.14,66.81 ,33.33
01,000,01,001,0010,26,819,9,828,1185,0,3,1,3,0,1,0,76.14,69.87 ,33.33
01,000,01,001,0010,27,885,8,893,1335,0,3,1,3,0,1,0,76.14,66.89 ,33.33
01,000,01,001,0010,28,804,8,812,1167,0,3,1,3,0,1,0,76.14,69.58 ,33.33
01,000,01,001,0011,29,1098,14,1112,1615,0,3,1,3,0,1,0,76.14,68.85 ,33.33
01,000,01,001,0011,30,949,5,954,1400,0,3,1,3,0,1,0,76.14,68.14 ,33.33
01,000,01,001,0011,31,949,13,962,1358,0,3,1,3,0,1,0,76.14,70.84 ,33.33
01,000,01,001,0011,32,1066,16,1082,1534,0,3,1,3,0,1,0,76.14,70.53 ,33.33
01,000,01,001,0012,33,863,18,881,1282,0,3,1,3,0,1,0,76.14,68.72 ,33.33
01,000,01,001,0012,34,815,5,820,1334,0,3,1,3,0,1,0,76.14,61.47 ,33.33
01,000,01,001,0012,35,861,9,870,1399,0,3,1,3,0,1,0,76.14,62.19 ,33.33
01,000,01,001,0012,36,786,5,791,1235,0,3,1,3,0,1,0,76.14,64.05 ,33.33
01,000,01,001,0013,37,1114,6,1120,1530,0,3,1,3,0,1,0,76.14,73.20 ,33.33
01,000,01,001,0013,38,987,11,998,1465,0,3,1,3,0,1,0,76.14,68.12 ,33.33
01,000,01,001,0013,39,971,9,980,1373,0,3,1,3,0,1,0,76.14,71.38 ,33.33
01,000,01,001,0014,40,1132,13,1145,1670,0,3,1,3,0,1,0,76.14,68.56 ,33.33
01,000,01,001,0014,41,1207,9,1216,1810,0,3,1,3,0,1,0,76.14,67.18 ,33.33
01,000,01,001,0014,42,1154,7,1161,1694,0,3,1,3,0,1,0,76.14,68.54 ,33.33
01,000,01,001,0015,43,1126,16,1142,1622,0,3,1,3,0,1,0,76.14,70.41 ,33.33
01,000,01,001,0015,44,1021,10,1031,1533,0,3,1,3,0,1,0,76.14,67.25 ,33.33
01,000,01,001,0015,45,1106,8,1114,1574,0,3,1,3,0,1,0,76.14,70.78 ,33.33
01,000,01,001,0016,46,1144,6,1150,1650,0,3,1,3,0,1,0,76.14,69.70 ,33.33
01,000,01,001,0016,47,991,7,998,1413,0,3,1,3,0,1,0,76.14,70.63 ,33.33
01,000,01,001,0016,48,845,12,857,1235,0,3,1,3,0,1,0,76.14,69.39 ,33.33
01,000,01,001,0016,49,1097,13,1110,1686,0,3,1,3,0,1,0,76.14,65.84 ,33.33
01,000,01,001,0017,50,1013,14,1027,1444,0,3,1,3,0,1,0,76.14,71.12 ,33.33
01,000,01,001,0017,51,1102,19,1121,1574,0,3,1,3,0,1,0,76.14,71.22 ,33.33
01,000,01,001,0018,52,725,5,730,1024,0,3,1,3,0,1,0,76.14,71.29 ,33.33
01,000,01,001,0018,53,986,13,999,1326,0,3,1,3,0,1,0,76.14,75.34 ,33.33
01,000,01,001,0018,54,936,16,952,1296,0,3,1,3,0,1,0,76.14,73.46 ,33.33
01,000,01,001,0019,55,968,16,984,1536,0,3,1,3,0,1,0,76.14,64.06 ,33.33
01,000,01,001,0019,56,1073,14,1087,1654,0,3,1,3,0,1,0,76.14,65.72 ,33.33
01,000,01,001,0020,57,912,8,920,1369,0,3,1,3,0,1,0,76.14,67.20 ,33.33
01,000,01,001,0020,58,1096,14,1110,1632,0,3,1,3,0,1,0,76.14,68.01 ,33.33
01,000,01,001,0020,59,1138,5,1143,1640,0,3,1,3,0,1,0,76.14,69.70 ,33.33
01,000,01,001,0020,60,1050,13,1063,1505,0,3,1,3,0,1,0,76.14,70.63 ,33.33
01,000,01,001,0021,61,915,9,924,1338,0,3,1,3,0,1,0,76.14,69.06 ,33.33
01,000,01,001,0021,62,928,9,937,1446,0,3,1,3,0,1,0,76.14,64.80 ,33.33
01,000,01,001,0021,63,832,11,843,1327,0,3,1,3,0,1,0,76.14,63.53 ,33.33
01,000,01,001,0021,64,1016,15,1031,1541,0,3,1,3,0,1,0,76.14,66.90 ,33.33
01,000,01,001,0022,65,856,10,866,1229,0,3,1,3,0,1,0,76.14,70.46 ,33.33
01,000,01,001,0022,66,626,13,639,911,0,3,1,3,0,1,0,76.14,70.14 ,33.33
01,000,01,001,0022,67,918,6,924,1500,0,3,1,3,0,1,0,76.14,61.60 ,33.33
01,000,01,001,0023,68,779,12,791,1170,0,3,1,3,0,1,0,76.14,67.61 ,33.33
01,000,01,001,0023,69,781,5,786,1152,0,3,1,3,0,1,0,76.14,68.23 ,33.33
01,000,01,001,0023,70,1053,14,1067,1706,0,3,1,3,0,1,0,76.14,62.54 ,33.33
01,000,01,001,0024,71,1084,14,1098,1569,0,3,1,3,0,1,0,76.14,69.98 ,33.33
01,000,01,001,0024,72,1110,10,1120,1602,0,3,1,3,0,1,0,76.14,69.91 ,33.33
01,000,01,001,0024,73,1124,16,1140,1616,0,3,1,3,0,1,0,76.14,70.54 ,33.33
01,000,01,001,0024,74,1071,9,1080,1639,0,3,1,3,0,1,0,76.14,65.89 ,33.33
01,000,01,001,0025,75,1034,18,1052,1463,0,3,1,3,0,1,0,76.14,71.91 ,33.33
01,000,01,001,0025,76,996,10,1006,1539,0,3,1,3,0,1,0,76.14,65.37 ,33.33
01,000,01,001,0025,77,1100,17,1117,1764,0,3,1,3,0,1,0,76.14,63.32 ,33.33
01,000,01,001,0026,78,878,4,882,1302,0,3,1,3,0,1,0,76.14,67.74 ,33.33
01,000,01,001,0026,79,868,13,881,1456,0,3,1,3,0,1,0,76.14,60.51 ,33.33
01,000,01,001,0027,80,960,11,971,1500,0,3,1,3,0,1,0,76.14,64.73 ,33.33
01,000,01,001,0027,81,893,7,900,1487,0,3,1,3,0,1,0,76.14,60.52 ,33.33
01,000,01,001,0027,82,779,3,782,1242,0,3,1,3,0,1,0,76.14,62.96 ,33.33
01,000,01,001,0028,83,912,12,924,1453,0,3,1,3,0,1,0,76.14,63.59 ,33.33
01,000,01,001,0028,84,946,10,956,1421,0,3,1,3,0,1,0,76.14,67.28 ,33.33
01,000,01,001,0028,85,1023,5,1028,1545,0,3,1,3,0,1,0,76.14,66.54 ,33.33
01,000,01,001,0029,86,1069,13,1082,1583,0,3,1,3,0,1,0,76.14,68.35 ,33.33
01,000,01,001,0029,87,1164,31,1195,1747,0,3,1,3,0,1,0,76.14,68.40 ,33.33
01,000,01,001,0030,88,991,14,1005,1505,0,3,1,3,0,1,0,76.14,66.78 ,33.33
01,000,01,001,0030,89,1294,9,1303,1895,0,3,1,3,0,1,0,76.14,68.76 ,33.33
01,000,01,001,0030,90,367,9,376,715,0,3,1,3,0,1,0,76.14,52.59 ,33.33
01,000,01,001,0031,91,1031,15,1046,1597,0,3,1,3,0,1,0,76.14,65.50 ,33.33
01,000,01,001,0031,92,994,14,1008,1419,0,3,1,3,0,1,0,76.14,71.04 ,33.33
01,000,01,001,0032,93,1187,13,1200,1696,0,3,1,3,0,1,0,76.14,70.75 ,33.33
01,000,01,001,0032,94,1083,17,1100,1573,0,3,1,3,0,1,0,76.14,69.93 ,33.33
01,000,01,001,0032,95,871,19,890,1291,0,3,1,3,0,1,0,76.14,68.94 ,33.33
01,000,01,001,0033,96,1078,8,1086,1456,0,3,1,3,0,1,0,76.14,74.59 ,33.33
01,000,01,001,0033,97,989,14,1003,1486,0,3,1,3,0,1,0,76.14,67.50 ,33.33
01,000,01,001,0034,98,1064,7,1071,1593,0,3,1,3,0,1,0,76.14,67.23 ,33.33
01,000,01,001,0034,99,1053,16,1069,1576,0,3,1,3,0,1,0,76.14,67.83 ,33.33
01,000,01,001,0035,100,1174,12,1186,1747,0,3,1,3,0,1,0,76.14,67.89 ,33.33
01,000,01,001,0035,101,1096,11,1107,1705,0,3,1,3,0,1,0,76.14,64.93 ,33.33
01,000,01,001,0036,102,898,6,904,1359,0,3,1,3,0,1,0,76.14,66.52 ,33.33
01,000,01,001,0036,103,852,7,859,1304,0,3,1,3,0,1,0,76.14,65.87 ,33.33
01,000,01,001,0036,104,694,8,702,1086,0,3,1,3,0,1,0,76.14,64.64 ,33.33
01,000,01,001,0037,105,1027,21,1048,1605,0,3,1,3,0,1,0,76.14,65.30 ,33.33
01,000,01,001,0037,106,891,13,904,1512,0,3,1,3,0,1,0,76.14,59.79 ,33.33
01,000,01,001,0037,107,855,12,867,1288,0,3,1,3,0,1,0,76.14,67.31 ,33.33
01,000,01,001,0038,108,931,11,942,1472,0,3,1,3,0,1,0,76.14,63.99 ,33.33
01,000,01,001,0038,109,712,18,730,1146,0,3,1,3,0,1,0,76.14,63.70 ,33.33
01,000,01,001,0038,110,930,28,958,1369,0,3,1,3,0,1,0,76.14,69.98 ,33.33
01,000,01,001,0038,111,1066,11,1077,1571,0,3,1,3,0,1,0,76.14,68.56 ,33.33
01,000,01,001,0038,112,942,17,959,1414,0,3,1,3,0,1,0,76.14,67.82 ,33.33
01,000,01,001,0039,113,1166,8,1174,1764,0,3,1,3,0,1,0,76.14,66.55 ,33.33
01,000,01,001,0040,114,464,5,469,674,0,3,1,3,0,1,0,76.14,69.58 ,33.33
01,000,01,001,0040,115,612,9,621,922,0,3,1,3,0,1,0,76.14,67.35 ,33.33
01,000,01,001,0040,116,448,4,452,718,0,3,1,3,0,1,0,76.14,62.95 ,33.33
01,000,01,002,0041,117,604,6,610,922,0,3,1,3,0,1,0,76.14,66.16 ,33.33
01,000,01,002,0041,118,1139,12,1151,1655,0,3,1,3,0,1,0,76.14,69.55 ,33.33
01,000,01,002,0041,119,846,12,858,1213,0,3,1,3,0,1,0,76.14,70.73 ,33.33
01,000,01,002,0042,120,676,7,683,1081,0,3,1,3,0,1,0,76.14,63.18 ,33.33
01,000,01,002,0042,121,764,15,779,1168,0,3,1,3,0,1,0,76.14,66.70 ,33.33
01,000,01,002,0043,122,794,10,804,1266,0,3,1,3,0,1,0,76.14,63.51 ,33.33
01,000,01,002,0043,123,1046,10,1056,1498,0,3,1,3,0,1,0,76.14,70.49 ,33.33
01,000,01,002,0043,124,576,6,582,875,0,3,1,3,0,1,0,76.14,66.51 ,33.33
01,000,01,002,0044,125,970,9,979,1445,0,3,1,3,0,1,0,76.14,67.75 ,33.33
01,000,01,002,0044,126,1172,10,1182,1808,0,3,1,3,0,1,0,76.14,65.38 ,33.33
01,000,01,002,0045,127,999,6,1005,1424,0,3,1,3,0,1,0,76.14,70.58 ,33.33
01,000,01,002,0045,128,1052,9,1061,1608,0,3,1,3,0,1,0,76.14,65.98 ,33.33
01,000,01,002,0045,129,1040,8,1048,1548,0,3,1,3,0,1,0,76.14,67.70 ,33.33
01,000,01,002,0045,130,1076,9,1085,1499,0,3,1,3,0,1,0,76.14,72.38 ,33.33
01,000,01,002,0046,131,1350,11,1361,1974,0,3,1,3,0,1,0,76.14,68.95 ,33.33
01,000,01,002,0046,132,1178,7,1185,1736,0,3,1,3,0,1,0,76.14,68.26 ,33.33
01,000,01,002,0046,133,1134,11,1145,1681,0,3,1,3,0,1,0,76.14,68.11 ,33.33
01,000,01,002,0047,134,1254,10,1264,1888,0,3,1,3,0,1,0,76.14,66.95 ,33.33
01,000,01,002,0047,135,1158,8,1166,1721,0,3,1,3,0,1,0,76.14,67.75 ,33.33
01,000,01,002,0047,136,1457,21,1478,2194,0,3,1,3,0,1,0,76.14,67.37 ,33.33
01,000,01,002,0048,137,1042,14,1056,1605,0,3,1,3,0,1,0,76.14,65.79 ,33.33
01,000,01,002,0048,138,938,13,951,1518,0,3,1,3,0,1,0,76.14,62.65 ,33.33
01,000,01,002,0048,139,978,10,988,1582,0,3,1,3,0,1,0,76.14,62.45 ,33.33
01,000,01,002,0048,140,862,6,868,1396,0,3,1,3,0,1,0,76.14,62.18 ,33.33
01,000,01,002,0049,141,787,13,800,1282,0,3,1,3,0,1,0,76.14,62.40 ,33.33
01,000,01,002,0049,142,877,10,887,1347,0,3,1,3,0,1,0,76.14,65.85 ,33.33
01,000,01,002,0049,143,910,11,921,1401,0,3,1,3,0,1,0,76.14,65.74 ,33.33
01,000,01,002,0050,144,864,12,876,1473,0,3,1,3,0,1,0,76.14,59.47 ,33.33
01,000,01,002,0050,145,1024,15,1039,1565,0,3,1,3,0,1,0,76.14,66.39 ,33.33
01,000,01,002,0051,146,1143,8,1151,1764,0,3,1,3,0,1,0,76.14,65.25 ,33.33
01,000,01,002,0051,147,1191,14,1205,1713,0,3,1,3,0,1,0,76.14,70.34 ,33.33
01,000,01,002,0051,148,1259,20,1279,1904,0,3,1,3,0,1,0,76.14,67.17 ,33.33
01,000,01,002,0052,149,1044,5,1049,1587,0,3,1,3,0,1,0,76.14,66.10 ,33.33
01,000,01,002,0052,150,1019,12,1031,1509,0,3,1,3,0,1,0,76.14,68.32 ,33.33
01,000,01,002,0053,151,1509,25,1534,2297,0,3,1,3,0,1,0,76.14,66.78 ,33.33
01,000,01,002,0053,152,1091,19,1110,1837,0,3,1,3,0,1,0,76.14,60.42 ,33.33
01,000,01,002,0053,153,859,16,875,1412,0,3,1,3,0,1,0,76.14,61.97 ,33.33
01,000,01,002,0054,154,875,13,888,1392,0,3,1,3,0,1,0,76.14,63.79 ,33.33
01,000,01,002,0054,155,769,13,782,1192,0,3,1,3,0,1,0,76.14,65.60 ,33.33
01,000,01,002,0054,156,875,14,889,1426,0,3,1,3,0,1,0,76.14,62.34 ,33.33
01,000,01,002,0055,157,1094,12,1106,1625,0,3,1,3,0,1,0,76.14,68.06 ,33.33
01,000,01,002,0055,158,925,12,937,1459,0,3,1,3,0,1,0,76.14,64.22 ,33.33
01,000,01,002,0055,159,831,13,844,1194,0,3,1,3,0,1,0,76.14,70.69 ,33.33
01,000,01,002,0056,160,844,16,860,1326,0,3,1,3,0,1,0,76.14,64.86 ,33.33
01,000,01,002,0056,161,854,12,866,1377,0,3,1,3,0,1,0,76.14,62.89 ,33.33
01,000,01,002,0056,162,1176,17,1193,1796,0,3,1,3,0,1,0,76.14,66.43 ,33.33
01,000,01,002,0057,163,954,13,967,1449,0,3,1,3,0,1,0,76.14,66.74 ,33.33
01,000,01,002,0057,164,921,9,930,1394,0,3,1,3,0,1,0,76.14,66.71 ,33.33
01,000,01,002,0057,165,921,14,935,1402,0,3,1,3,0,1,0,76.14,66.69 ,33.33
01,000,01,002,0057,166,980,12,992,1411,0,3,1,3,0,1,0,76.14,70.30 ,33.33
01,000,01,002,0058,167,829,7,836,1261,0,3,1,3,0,1,0,76.14,66.30 ,33.33
01,000,01,002,0058,168,1187,12,1199,1731,0,3,1,3,0,1,0,76.14,69.27 ,33.33
01,000,01,002,0059,169,1044,14,1058,1586,0,3,1,3,0,1,0,76.14,66.71 ,33.33
01,000,01,002,0059,170,1036,12,1048,1565,0,3,1,3,0,1,0,76.14,66.96 ,33.33
01,000,01,002,0059,171,976,13,989,1465,0,3,1,3,0,1,0,76.14,67.51 ,33.33
01,000,01,002,0060,172,951,12,963,1547,0,3,1,3,0,1,0,76.14,62.25 ,33.33
01,000,01,002,0060,173,921,22,943,1475,0,3,1,3,0,1,0,76.14,63.93 ,33.33
01,000,01,002,0060,174,815,12,827,1347,0,3,1,3,0,1,0,76.14,61.40 ,33.33
01,000,01,002,0060,175,1043,20,1063,1669,0,3,1,3,0,1,0,76.14,63.69 ,33.33
01,000,01,002,0061,176,1077,10,1087,1556,0,3,1,3,0,1,0,76.14,69.86 ,33.33
01,000,01,002,0061,177,973,14,987,1484,0,3,1,3,0,1,0,76.14,66.51 ,33.33
01,000,01,002,0061,178,1245,11,1256,1841,0,3,1,3,0,1,0,76.14,68.22 ,33.33
01,000,01,002,0062,179,994,7,1001,1589,0,3,1,3,0,1,0,76.14,63.00 ,33.33
01,000,01,002,0062,180,1016,6,1022,1534,0,3,1,3,0,1,0,76.14,66.62 ,33.33
01,000,01,002,0062,181,629,8,637,935,0,3,1,3,0,1,0,76.14,68.13 ,33.33
01,000,01,002,0062,182,997,9,1006,1536,0,3,1,3,0,1,0,76.14,65.49 ,33.33
01,000,01,002,0063,183,1229,16,1245,1807,0,3,1,3,0,1,0,76.14,68.90 ,33.33
01,000,01,002,0063,184,1205,19,1224,1825,0,3,1,3,0,1,0,76.14,67.07 ,33.33
01,000,01,002,0064,185,1344,20,1364,2097,0,3,1,3,0,1,0,76.14,65.05 ,33.33
01,000,01,002,0064,186,1264,12,1276,1898,0,3,1,3,0,1,0,76.14,67.23 ,33.33
01,000,01,002,0065,187,980,16,996,1613,0,3,1,3,0,1,0,76.14,61.75 ,33.33
01,000,01,002,0065,188,1264,11,1275,1863,0,3,1,3,0,1,0,76.14,68.44 ,33.33
01,000,01,002,0066,189,1097,11,1108,1594,0,3,1,3,0,1,0,76.14,69.51 ,33.33
01,000,01,002,0066,190,1175,15,1190,1785,0,3,1,3,0,1,0,76.14,66.67 ,33.33
01,000,01,002,0066,191,1034,9,1043,1621,0,3,1,3,0,1,0,76.14,64.34 ,33.33
01,000,01,002,0067,192,966,5,971,1481,0,3,1,3,0,1,0,76.14,65.56 ,33.33
01,000,01,002,0067,193,1093,13,1106,1693,0,3,1,3,0,1,0,76.14,65.33 ,33.33
01,000,01,002,0068,194,925,11,936,1347,0,3,1,3,0,1,0,76.14,69.49 ,33.33
01,000,01,002,0068,195,776,6,782,1239,0,3,1,3,0,1,0,76.14,63.12 ,33.33
01,000,01,002,0068,196,1130,11,1141,1694,0,3,1,3,0,1,0,76.14,67.36 ,33.33
01,000,01,002,0069,197,1313,11,1324,1954,0,3,1,3,0,1,0,76.14,67.76 ,33.33
01,000,01,002,0069,198,1249,7,1256,1770,0,3,1,3,0,1,0,76.14,70.96 ,33.33
01,000,01,002,0070,199,1126,12,1138,1512,0,3,1,3,0,1,0,76.14,75.26 ,33.33
01,000,01,002,0070,200,940,16,956,1446,0,3,1,3,0,1,0,76.14,66.11 ,33.33
01,000,01,002,0070,201,1006,3,1009,1398,0,3,1,3,0,1,0,76.14,72.17 ,33.33
01,000,01,002,0071,202,1042,6,1048,1625,0,3,1,3,0,1,0,76.14,64.49 ,33.33
01,000,01,002,0071,203,1077,12,1089,1599,0,3,1,3,0,1,0,76.14,68.11 ,33.33
01,000,01,002,0071,204,1177,9,1186,1787,0,3,1,3,0,1,0,76.14,66.37 ,33.33
01,000,01,002,0072,205,1343,19,1362,1881,0,3,1,3,0,1,0,76.14,72.41 ,33.33
01,000,01,002,0072,206,1316,12,1328,1917,0,3,1,3,0,1,0,76.14,69.27 ,33.33
01,000,01,002,0073,207,1018,9,1027,1507,0,3,1,3,0,1,0,76.14,68.15 ,33.33
01,000,01,002,0073,208,873,9,882,1286,0,3,1,3,0,1,0,76.14,68.58 ,33.33
01,000,01,002,0073,209,863,7,870,1334,0,3,1,3,0,1,0,76.14,65.22 ,33.33
01,000,01,002,0074,210,1071,10,1081,1625,0,3,1,3,0,1,0,76.14,66.52 ,33.33
01,000,01,002,0074,211,1277,7,1284,1908,0,3,1,3,0,1,0,76.14,67.30 ,33.33
01,000,01,002,0074,212,875,6,881,1324,0,3,1,3,0,1,0,76.14,66.54 ,33.33
01,000,01,002,0075,213,1036,7,1043,1614,0,3,1,3,0,1,0,76.14,64.62 ,33.33
01,000,01,002,0075,214,899,13,912,1381,0,3,1,3,0,1,0,76.14,66.04 ,33.33
01,000,01,002,0075,215,1129,5,1134,1757,0,3,1,3,0,1,0,76.14,64.54 ,33.33
01,000,01,002,0075,216,966,9,975,1508,0,3,1,3,0,1,0,76.14,64.66 ,33.33
01,000,01,002,0076,217,1078,9,1087,1623,0,3,1,3,0,1,0,76.14,66.97 ,33.33
01,000,01,002,0076,218,985,6,991,1480,0,3,1,3,0,1,0,76.14,66.96 ,33.33
01,000,01,002,0076,219,836,13,849,1378,0,3,1,3,0,1,0,76.14,61.61 ,33.33
01,000,01,002,0077,220,1128,13,1141,1685,0,3,1,3,0,1,0,76.14,67.72 ,33.33
01,000,01,002,0077,221,1035,9,1044,1479,0,3,1,3,0,1,0,76.14,70.59 ,33.33
01,000,01,002,0077,222,984,8,992,1461,0,3,1,3,0,1,0,76.14,67.90 ,33.33
01,000,01,002,0078,223,1163,10,1173,1829,0,3,1,3,0,1,0,76.14,64.13 ,33.33
01,000,01,002,0078,224,1299,14,1313,1998,0,3,1,3,0,1,0,76.14,65.72 ,33.33
01,000,01,002,0079,225,1179,12,1191,1801,0,3,1,3,0,1,0,76.14,66.13 ,33.33
01,000,01,002,0079,226,983,4,987,1509,0,3,1,3,0,1,0,76.14,65.41 ,33.33
01,000,01,002,0080,227,1202,10,1212,1839,0,3,1,3,0,1,0,76.14,65.91 ,33.33
01,000,01,002,0080,228,1253,10,1263,1918,0,3,1,3,0,1,0,76.14,65.85 ,33.33
01,000,01,002,0080,229,1030,7,1037,1685,0,3,1,3,0,1,0,76.14,61.54 ,33.33
01,000,01,002,0081,230,1072,3,1075,1696,0,3,1,3,0,1,0,76.14,63.38 ,33.33
01,000,01,002,0081,231,1060,5,1065,1721,0,3,1,3,0,1,0,76.14,61.88 ,33.33
01,000,01,002,0081,232,1163,12,1175,1860,0,3,1,3,0,1,0,76.14,63.17 ,33.33
01,000,01,002,0082,233,1184,6,1190,1839,0,3,1,3,0,1,0,76.14,64.71 ,33.33
01,000,01,002,0082,234,1538,16,1554,2347,0,3,1,3,0,1,0,76.14,66.21 ,33.33
01,000,01,002,0082,235,1255,15,1270,1894,0,3,1,3,0,1,0,76.14,67.05 ,33.33
01,000,01,002,0083,236,671,6,677,1048,0,3,1,3,0,1,0,76.14,64.60 ,33.33
01,000,01,002,0084,237,735,5,740,1108,0,3,1,3,0,1,0,76.14,66.79 ,33.33
01,000,01,002,0085,238,1031,26,1057,1663,0,3,1,3,0,1,0,76.14,63.56 ,33.33
01,000,01,002,0086,239,1048,17,1065,1803,0,3,1,3,0,1,0,76.14,59.07 ,33.33
01,000,01,002,0086,240,522,11,533,837,0,3,1,3,0,1,0,76.14,63.68 ,33.33
01,000,01,002,0087,241,853,9,862,1262,0,3,1,3,0,1,0,76.14,68.30 ,33.33
01,000,01,002,0088,242,833,6,839,1137,0,3,1,3,0,1,0,76.14,73.79 ,33.33
01,000,01,002,0089,243,791,13,804,1218,0,3,1,3,0,1,0,76.14,66.01 ,33.33
01,000,01,002,0090,244,1008,7,1015,1463,0,3,1,3,0,1,0,76.14,69.38 ,33.33
01,000,01,002,0090,245,925,7,932,1386,0,3,1,3,0,1,0,76.14,67.24 ,33.33
01,000,01,002,0090,246,519,5,524,844,0,3,1,3,0,1,0,76.14,62.09 ,33.33
01,000,01,002,0090,247,899,14,913,1394,0,3,1,3,0,1,0,76.14,65.49 ,33.33
01,000,01,003,0091,248,1090,6,1096,1551,0,3,1,3,0,1,0,76.14,70.66 ,33.33
01,000,01,003,0091,249,1069,8,1077,1605,0,3,1,3,0,1,0,76.14,67.10 ,33.33
01,000,01,003,0091,250,1077,6,1083,1619,0,3,1,3,0,1,0,76.14,66.89 ,33.33
01,000,01,003,0092,251,1134,7,1141,1744,0,3,1,3,0,1,0,76.14,65.42 ,33.33
01,000,01,003,0092,252,1245,7,1252,1814,0,3,1,3,0,1,0,76.14,69.02 ,33.33
01,000,01,003,0092,253,1065,10,1075,1706,0,3,1,3,0,1,0,76.14,63.01 ,33.33
01,000,01,003,0092,254,1125,4,1129,1683,0,3,1,3,0,1,0,76.14,67.08 ,33.33
01,000,01,003,0093,255,1217,15,1232,1774,0,3,1,3,0,1,0,76.14,69.45 ,33.33
01,000,01,003,0093,256,1015,2,1017,1859,0,3,1,3,0,1,0,76.14,54.71 ,33.33
01,000,01,003,0093,257,1251,8,1259,1808,0,3,1,3,0,1,0,76.14,69.63 ,33.33
01,000,01,003,0094,258,1242,7,1249,1853,0,3,1,3,0,1,0,76.14,67.40 ,33.33
01,000,01,003,0094,259,1217,16,1233,1938,0,3,1,3,0,1,0,76.14,63.62 ,33.33
01,000,01,003,0095,260,960,5,965,1535,0,3,1,3,0,1,0,76.14,62.87 ,33.33
01,000,01,003,0095,261,759,7,766,1094,0,3,1,3,0,1,0,76.14,70.02 ,33.33
01,000,01,003,0095,262,1110,11,1121,1669,0,3,1,3,0,1,0,76.14,67.17 ,33.33
01,000,01,003,0096,263,1195,8,1203,1851,0,3,1,3,0,1,0,76.14,64.99 ,33.33
01,000,01,003,0096,264,1274,17,1291,1906,0,3,1,3,0,1,0,76.14,67.73 ,33.33
01,000,01,003,0097,265,1113,4,1117,1729,0,3,1,3,0,1,0,76.14,64.60 ,33.33
01,000,01,003,0097,266,1115,11,1126,1812,0,3,1,3,0,1,0,76.14,62.14 ,33.33
01,000,01,003,0098,267,1370,12,1382,2149,0,3,1,3,0,1,0,76.14,64.31 ,33.33
01,000,01,003,0098,268,1148,6,1154,1836,0,3,1,3,0,1,0,76.14,62.85 ,33.33
01,000,01,003,0099,269,1209,9,1218,1838,0,3,1,3,0,1,0,76.14,66.27 ,33.33
01,000,01,003,0099,270,1180,6,1186,1892,0,3,1,3,0,1,0,76.14,62.68 ,33.33
01,000,01,003,0100,271,1464,26,1490,2292,0,3,1,3,0,1,0,76.14,65.01 ,33.33
01,000,01,003,0100,272,1273,14,1287,1890,0,3,1,3,0,1,0,76.14,68.10 ,33.33
01,000,01,003,0100,273,634,4,638,923,0,3,1,3,0,1,0,76.14,69.12 ,33.33
01,000,01,003,0100,274,671,4,675,1049,0,3,1,3,0,1,0,76.14,64.35 ,33.33
01,000,01,003,0101,275,1221,9,1230,1822,0,3,1,3,0,1,0,76.14,67.51 ,33.33
01,000,01,003,0101,276,938,7,945,1495,0,3,1,3,0,1,0,76.14,63.21 ,33.33
01,000,01,003,0102,277,1276,12,1288,2007,0,3,1,3,0,1,0,76.14,64.18 ,33.33
01,000,01,003,0102,278,1224,7,1231,1873,0,3,1,3,0,1,0,76.14,65.72 ,33.33
01,000,01,003,0103,279,897,8,905,1450,0,3,1,3,0,1,0,76.14,62.41 ,33.33
01,000,01,003,0103,280,860,13,873,1309,0,3,1,3,0,1,0,76.14,66.69 ,33.33
01,000,01,003,0104,281,1304,12,1316,1902,0,3,1,3,0,1,0,76.14,69.19 ,33.33
01,000,01,003,0104,282,1142,4,1146,1716,0,3,1,3,0,1,0,76.14,66.78 ,33.33
01,000,01,003,0105,283,1028,11,1039,1724,0,3,1,3,0,1,0,76.14,60.27 ,33.33
01,000,01,003,0105,284,1119,5,1124,1693,0,3,1,3,0,1,0,76.14,66.39 ,33.33
01,000,01,003,0105,285,974,9,983,1548,0,3,1,3,0,1,0,76.14,63.50 ,33.33
01,000,01,003,0105,286,1103,12,1115,1763,0,3,1,3,0,1,0,76.14,63.24 ,33.33
01,000,01,003,0106,287,1187,13,1200,1751,0,3,1,3,0,1,0,76.14,68.53 ,33.33
01,000,01,003,0106,288,1212,9,1221,1837,0,3,1,3,0,1,0,76.14,66.47 ,33.33
01,000,01,003,0106,289,1026,9,1035,1601,0,3,1,3,0,1,0,76.14,64.65 ,33.33
01,000,01,003,0107,290,1313,18,1331,2166,0,3,1,3,0,1,0,76.14,61.45 ,33.33
01,000,01,003,0107,291,534,8,542,839,0,3,1,3,0,1,0,76.14,64.60 ,33.33
01,000,01,003,0108,292,1082,9,1091,1588,0,3,1,3,0,1,0,76.14,68.70 ,33.33
01,000,01,003,0108,293,1386,12,1398,2046,0,3,1,3,0,1,0,76.14,68.33 ,33.33
01,000,01,003,0108,294,619,15,634,935,0,3,1,3,0,1,0,76.14,67.81 ,33.33
01,000,01,003,0109,295,1185,15,1200,1770,0,3,1,3,0,1,0,76.14,67.80 ,33.33
01,000,01,003,0109,296,1113,12,1125,1676,0,3,1,3,0,1,0,76.14,67.12 ,33.33
01,000,01,003,0109,297,1167,10,1177,1749,0,3,1,3,0,1,0,76.14,67.30 ,33.33
01,000,01,003,0109,298,1273,21,1294,1909,0,3,1,3,0,1,0,76.14,67.78 ,33.33
01,000,01,003,0110,299,1109,15,1124,1596,0,3,1,3,0,1,0,76.14,70.43 ,33.33
01,000,01,003,0110,300,1679,15,1694,2351,0,3,1,3,0,1,0,76.14,72.05 ,33.33
01,000,01,003,0111,301,1290,5,1295,1756,0,3,1,3,0,1,0,76.14,73.75 ,33.33
01,000,01,003,0111,302,867,5,872,1298,0,3,1,3,0,1,0,76.14,67.18 ,33.33
01,000,01,003,0111,303,902,13,915,1300,0,3,1,3,0,1,0,76.14,70.38 ,33.33
01,000,01,003,0111,304,786,9,795,1241,0,3,1,3,0,1,0,76.14,64.06 ,33.33
01,000,01,003,0112,305,1297,15,1312,2079,0,3,1,3,0,1,0,76.14,63.11 ,33.33
01,000,01,003,0112,306,1253,17,1270,1989,0,3,1,3,0,1,0,76.14,63.85 ,33.33
01,000,01,003,0112,307,1187,13,1200,1824,0,3,1,3,0,1,0,76.14,65.79 ,33.33
01,000,01,003,0113,308,1227,12,1239,1957,0,3,1,3,0,1,0,76.14,63.31 ,33.33
01,000,01,003,0113,309,1146,16,1162,1838,0,3,1,3,0,1,0,76.14,63.22 ,33.33
01,000,01,003,0113,310,1256,6,1262,1836,0,3,1,3,0,1,0,76.14,68.74 ,33.33
01,000,01,003,0114,311,1238,13,1251,1850,0,3,1,3,0,1,0,76.14,67.62 ,33.33
01,000,01,003,0114,312,949,6,955,1549,0,3,1,3,0,1,0,76.14,61.65 ,33.33
01,000,01,003,0114,313,1079,11,1090,1654,0,3,1,3,0,1,0,76.14,65.90 ,33.33
01,000,01,003,0115,314,905,12,917,1502,0,3,1,3,0,1,0,76.14,61.05 ,33.33
01,000,01,003,0115,315,914,9,923,1574,0,3,1,3,0,1,0,76.14,58.64 ,33.33
01,000,01,003,0115,316,1001,6,1007,1505,0,3,1,3,0,1,0,76.14,66.91 ,33.33
01,000,01,003,0115,317,832,11,843,1416,0,3,1,3,0,1,0,76.14,59.53 ,33.33
01,000,01,003,0116,318,987,14,1001,1565,0,3,1,3,0,1,0,76.14,63.96 ,33.33
01,000,01,003,0116,319,1046,6,1052,1593,0,3,1,3,0,1,0,76.14,66.04 ,33.33
01,000,01,003,0117,320,792,8,800,1263,0,3,1,3,0,1,0,76.14,63.34 ,33.33
01,000,01,003,0117,321,970,12,982,1532,0,3,1,3,0,1,0,76.14,64.10 ,33.33
01,000,01,003,0118,322,953,12,965,1461,0,3,1,3,0,1,0,76.14,66.05 ,33.33
01,000,01,003,0118,323,972,9,981,1528,0,3,1,3,0,1,0,76.14,64.20 ,33.33
01,000,01,003,0119,324,1300,7,1307,1927,0,3,1,3,0,1,0,76.14,67.83 ,33.33
01,000,01,003,0119,325,1243,15,1258,1884,0,3,1,3,0,1,0,76.14,66.77 ,33.33
01,000,01,003,0119,326,1206,13,1219,1876,0,3,1,3,0,1,0,76.14,64.98 ,33.33
01,000,01,003,0120,327,783,8,791,1135,0,3,1,3,0,1,0,76.14,69.69 ,33.33
01,000,01,003,0120,328,925,5,930,1456,0,3,1,3,0,1,0,76.14,63.87 ,33.33
01,000,01,003,0121,329,865,8,873,1355,0,3,1,3,0,1,0,76.14,64.43 ,33.33
01,000,01,003,0121,330,862,14,876,1354,0,3,1,3,0,1,0,76.14,64.70 ,33.33
01,000,01,003,0122,331,1061,16,1077,1583,0,3,1,3,0,1,0,76.14,68.04 ,33.33
01,000,01,003,0122,332,1170,12,1182,1748,0,3,1,3,0,1,0,76.14,67.62 ,33.33
01,000,01,003,0122,333,932,7,939,1408,0,3,1,3,0,1,0,76.14,66.69 ,33.33
01,000,01,003,0123,334,680,6,686,1036,0,3,1,3,0,1,0,76.14,66.22 ,33.33
01,000,01,003,0123,335,693,8,701,1193,0,3,1,3,0,1,0,76.14,58.76 ,33.33
01,000,01,004,0124,336,1321,9,1330,1851,0,3,1,3,0,1,0,76.14,71.85 ,33.33
01,000,01,004,0124,337,1369,10,1379,1944,0,3,1,3,0,1,0,76.14,70.94 ,33.33
01,000,01,004,0125,338,1284,9,1293,1944,0,3,1,3,0,1,0,76.14,66.51 ,33.33
01,000,01,004,0125,339,1344,12,1356,2029,0,3,1,3,0,1,0,76.14,66.83 ,33.33
01,000,01,004,0126,340,830,9,839,1250,0,3,1,3,0,1,0,76.14,67.12 ,33.33
01,000,01,004,0126,341,761,5,766,1285,0,3,1,3,0,1,0,76.14,59.61 ,33.33
01,000,01,004,0127,342,1446,14,1460,2302,0,3,1,3,0,1,0,76.14,63.42 ,33.33
01,000,01,004,0128,343,1250,10,1260,1875,0,3,1,3,0,1,0,76.14,67.20 ,33.33
01,000,01,004,0128,344,1033,8,1041,1645,0,3,1,3,0,1,0,76.14,63.28 ,33.33
01,000,01,004,0129,345,1104,16,1120,1806,0,3,1,3,0,1,0,76.14,62.02 ,33.33
01,000,01,004,0129,346,1249,8,1257,1850,0,3,1,3,0,1,0,76.14,67.95 ,33.33
01,000,01,004,0129,347,856,11,867,1252,0,3,1,3,0,1,0,76.14,69.25 ,33.33
01,000,01,004,0130,348,1173,10,1183,1898,0,3,1,3,0,1,0,76.14,62.33 ,33.33
01,000,01,004,0130,349,1094,9,1103,1824,0,3,1,3,0,1,0,76.14,60.47 ,33.33
01,000,01,004,0131,350,1072,11,1083,1560,0,3,1,3,0,1,0,76.14,69.42 ,33.33
01,000,01,004,0131,351,946,8,954,1503,0,3,1,3,0,1,0,76.14,63.47 ,33.33
01,000,01,004,0131,352,1119,8,1127,1760,0,3,1,3,0,1,0,76.14,64.03 ,33.33
01,000,01,004,0132,353,1135,16,1151,1635,0,3,1,3,0,1,0,76.14,70.40 ,33.33
01,000,01,004,0132,354,1168,11,1179,1805,0,3,1,3,0,1,0,76.14,65.32 ,33.33
01,000,01,004,0132,355,1154,9,1163,1806,0,3,1,3,0,1,0,76.14,64.40 ,33.33
01,000,01,004,0133,356,797,19,816,1266,0,3,1,3,0,1,0,76.14,64.45 ,33.33
01,000,01,004,0133,357,1113,7,1120,1596,0,3,1,3,0,1,0,76.14,70.18 ,33.33
01,000,01,004,0134,358,1227,13,1240,1968,0,3,1,3,0,1,0,76.14,63.01 ,33.33
01,000,01,004,0134,359,1229,15,1244,1807,0,3,1,3,0,1,0,76.14,68.84 ,33.33
01,000,01,004,0135,360,1005,9,1014,1529,0,3,1,3,0,1,0,76.14,66.32 ,33.33
01,000,01,004,0135,361,885,14,899,1385,0,3,1,3,0,1,0,76.14,64.91 ,33.33
01,000,01,004,0136,362,1543,17,1560,2303,0,3,1,3,0,1,0,76.14,67.74 ,33.33
01,000,01,004,0136,363,1227,15,1242,1890,0,3,1,3,0,1,0,76.14,65.71 ,33.33
01,000,01,004,0137,364,1174,12,1186,1917,0,3,1,3,0,1,0,76.14,61.87 ,33.33
01,000,01,004,0137,365,1000,14,1014,1705,0,3,1,3,0,1,0,76.14,59.47 ,33.33
01,000,01,004,0138,366,1397,21,1418,2125,0,3,1,3,0,1,0,76.14,66.73 ,33.33
01,000,01,004,0138,367,1098,11,1109,1647,0,3,1,3,0,1,0,76.14,67.33 ,33.33
01,000,01,004,0139,368,1544,15,1559,2277,0,3,1,3,0,1,0,76.14,68.47 ,33.33
01,000,01,004,0139,369,1549,24,1573,2220,0,3,1,3,0,1,0,76.14,70.86 ,33.33
01,000,01,004,0140,370,1575,17,1592,2334,0,3,1,3,0,1,0,76.14,68.21 ,33.33
01,000,01,004,0140,371,1352,20,1372,2158,0,3,1,3,0,1,0,76.14,63.58 ,33.33
01,000,01,004,0141,372,1410,11,1421,2092,0,3,1,3,0,1,0,76.14,67.93 ,33.33
01,000,01,004,0141,373,1548,12,1560,2285,0,3,1,3,0,1,0,76.14,68.27 ,33.33
01,000,01,004,0142,374,1130,10,1140,1627,0,3,1,3,0,1,0,76.14,70.07 ,33.33
01,000,01,004,0142,375,1004,12,1016,1465,0,3,1,3,0,1,0,76.14,69.35 ,33.33
01,000,01,004,0143,376,1382,16,1398,2067,0,3,1,3,0,1,0,76.14,67.63 ,33.33
01,000,01,004,0143,377,1143,9,1152,1686,0,3,1,3,0,1,0,76.14,68.33 ,33.33
01,000,01,004,0143,378,1072,18,1090,1557,0,3,1,3,0,1,0,76.14,70.01 ,33.33
01,000,01,004,0144,379,1415,24,1439,2233,0,3,1,3,0,1,0,76.14,64.44 ,33.33
01,000,01,004,0145,380,1605,22,1627,2488,0,3,1,3,0,1,0,76.14,65.39 ,33.33
01,000,01,004,0145,381,1521,9,1530,2208,0,3,1,3,0,1,0,76.14,69.29 ,33.33
01,000,01,004,0146,382,1002,14,1016,1560,0,3,1,3,0,1,0,76.14,65.13 ,33.33
01,000,01,004,0146,383,932,10,942,1362,0,3,1,3,0,1,0,76.14,69.16 ,33.33
01,000,01,004,0146,384,1127,7,1134,1711,0,3,1,3,0,1,0,76.14,66.28 ,33.33
01,000,01,004,0147,385,1216,21,1237,1786,0,3,1,3,0,1,0,76.14,69.26 ,33.33
01,000,01,004,0147,386,1285,16,1301,1937,0,3,1,3,0,1,0,76.14,67.17 ,33.33
01,000,01,004,0148,387,1424,13,1437,2121,0,3,1,3,0,1,0,76.14,67.75 ,33.33
01,000,01,004,0148,388,1347,14,1361,1985,0,3,1,3,0,1,0,76.14,68.56 ,33.33
01,000,01,004,0148,389,1442,24,1466,2168,0,3,1,3,0,1,0,76.14,67.62 ,33.33
01,000,01,004,0149,390,1174,23,1197,1758,0,3,1,3,0,1,0,76.14,68.09 ,33.33
01,000,01,004,0149,391,1089,15,1104,1674,0,3,1,3,0,1,0,76.14,65.95 ,33.33
01,000,01,004,0149,392,1121,11,1132,1684,0,3,1,3,0,1,0,76.14,67.22 ,33.33
01,000,01,004,0150,393,1108,21,1129,1610,0,3,1,3,0,1,0,76.14,70.12 ,33.33
01,000,01,004,0150,394,1245,32,1277,1999,0,3,1,3,0,1,0,76.14,63.88 ,33.33
01,000,01,004,0150,395,1038,13,1051,1509,0,3,1,3,0,1,0,76.14,69.65 ,33.33
01,000,01,004,0151,396,926,6,932,1385,0,3,1,3,0,1,0,76.14,67.29 ,33.33
01,000,01,004,0151,397,1157,10,1167,1615,0,3,1,3,0,1,0,76.14,72.26 ,33.33
01,000,01,004,0151,398,1045,5,1050,1430,0,3,1,3,0,1,0,76.14,73.43 ,33.33
01,000,01,004,0152,399,1392,17,1409,2010,0,3,1,3,0,1,0,76.14,70.10 ,33.33
01,000,01,004,0152,400,1125,10,1135,1567,0,3,1,3,0,1,0,76.14,72.43 ,33.33
01,000,01,004,0152,401,1333,19,1352,1972,0,3,1,3,0,1,0,76.14,68.56 ,33.33
01,000,01,004,0153,402,1211,8,1219,1864,0,3,1,3,0,1,0,76.14,65.40 ,33.33
01,000,01,004,0153,403,1243,16,1259,1871,0,3,1,3,0,1,0,76.14,67.29 ,33.33
01,000,01,004,0153,404,1043,10,1053,1589,0,3,1,3,0,1,0,76.14,66.27 ,33.33
01,000,01,004,0153,405,1058,6,1064,1553,0,3,1,3,0,1,0,76.14,68.51 ,33.33
01,000,01,004,0154,406,1251,20,1271,1886,0,3,1,3,0,1,0,76.14,67.39 ,33.33
01,000,01,004,0154,407,1181,11,1192,1824,0,3,1,3,0,1,0,76.14,65.35 ,33.33
01,000,01,004,0155,408,1327,9,1336,2003,0,3,1,3,0,1,0,76.14,66.70 ,33.33
01,000,01,004,0155,409,1166,17,1183,1798,0,3,1,3,0,1,0,76.14,65.80 ,33.33
01,000,01,004,0155,410,760,7,767,1213,0,3,1,3,0,1,0,76.14,63.23 ,33.33
01,000,01,004,0156,411,1560,15,1575,2392,0,3,1,3,0,1,0,76.14,65.84 ,33.33
01,000,01,004,0156,412,1268,9,1277,1864,0,3,1,3,0,1,0,76.14,68.51 ,33.33
01,000,01,004,0156,413,1484,10,1494,2133,0,3,1,3,0,1,0,76.14,70.04 ,33.33
01,000,01,004,0157,414,1187,17,1204,1893,0,3,1,3,0,1,0,76.14,63.60 ,33.33
01,000,01,004,0157,415,1438,15,1453,2075,0,3,1,3,0,1,0,76.14,70.02 ,33.33
01,000,01,004,0158,416,1333,19,1352,2027,0,3,1,3,0,1,0,76.14,66.70 ,33.33
01,000,01,004,0158,417,1286,15,1301,1833,0,3,1,3,0,1,0,76.14,70.98 ,33.33
01,000,01,004,0159,418,1456,19,1475,2145,0,3,1,3,0,1,0,76.14,68.76 ,33.33
01,000,01,004,0159,419,1011,9,1020,1472,0,3,1,3,0,1,0,76.14,69.29 ,33.33
01,000,01,004,0159,420,1114,7,1121,1574,0,3,1,3,0,1,0,76.14,71.22 ,33.33
01,000,01,004,0160,421,875,10,885,1317,0,3,1,3,0,1,0,76.14,67.20 ,33.33
01,000,01,004,0160,422,774,11,785,1218,0,3,1,3,0,1,0,76.14,64.45 ,33.33
01,000,01,004,0161,423,1146,13,1159,1735,0,3,1,3,0,1,0,76.14,66.80 ,33.33
01,000,01,004,0161,424,1156,14,1170,1770,0,3,1,3,0,1,0,76.14,66.10 ,33.33
01,000,01,004,0162,425,1165,15,1180,1764,0,3,1,3,0,1,0,76.14,66.89 ,33.33
01,000,01,004,0162,426,1191,14,1205,1806,0,3,1,3,0,1,0,76.14,66.72 ,33.33
01,000,01,004,0162,427,1202,15,1217,1804,0,3,1,3,0,1,0,76.14,67.46 ,33.33
01,000,01,004,0163,428,1291,21,1312,1953,0,3,1,3,0,1,0,76.14,67.18 ,33.33
01,000,01,004,0163,429,1254,13,1267,1894,0,3,1,3,0,1,0,76.14,66.90 ,33.33
01,000,01,004,0164,430,1711,45,1756,2461,0,3,1,3,0,1,0,76.14,71.35 ,33.33
01,000,01,005,0165,431,1020,24,1044,1538,0,3,1,3,0,1,0,76.14,67.88 ,33.33
01,000,01,005,0165,432,1472,14,1486,2137,0,3,1,3,0,1,0,76.14,69.54 ,33.33
01,000,01,005,0165,433,1258,10,1268,1682,0,3,1,3,0,1,0,76.14,75.39 ,33.33
01,000,01,005,0166,434,992,17,1009,1343,0,3,1,3,0,1,0,76.14,75.13 ,33.33
01,000,01,005,0166,435,819,7,826,1185,0,3,1,3,0,1,0,76.14,69.70 ,33.33
01,000,01,005,0166,436,1128,9,1137,1598,0,3,1,3,0,1,0,76.14,71.15 ,33.33
01,000,01,005,0167,437,1359,15,1374,1993,0,3,1,3,0,1,0,76.14,68.94 ,33.33
01,000,01,005,0167,438,1384,13,1397,2026,0,3,1,3,0,1,0,76.14,68.95 ,33.33
01,000,01,005,0167,439,1231,11,1242,1800,0,3,1,3,0,1,0,76.14,69.00 ,33.33
01,000,01,005,0168,440,1213,10,1223,1676,0,3,1,3,0,1,0,76.14,72.97 ,33.33
01,000,01,005,0168,441,1120,17,1137,1594,0,3,1,3,0,1,0,76.14,71.33 ,33.33
01,000,01,005,0169,442,1207,9,1216,1734,0,3,1,3,0,1,0,76.14,70.13 ,33.33
01,000,01,005,0169,443,1274,13,1287,1816,0,3,1,3,0,1,0,76.14,70.87 ,33.33
01,000,01,005,0169,444,1308,13,1321,1898,0,3,1,3,0,1,0,76.14,69.60 ,33.33
01,000,01,005,0170,445,1348,5,1353,1955,0,3,1,3,0,1,0,76.14,69.21 ,33.33
01,000,01,005,0170,446,1210,11,1221,1755,0,3,1,3,0,1,0,76.14,69.57 ,33.33
01,000,01,005,0170,447,1342,12,1354,1909,0,3,1,3,0,1,0,76.14,70.93 ,33.33
01,000,01,005,0170,448,1410,16,1426,2035,0,3,1,3,0,1,0,76.14,70.07 ,33.33
01,000,01,005,0171,449,940,10,950,1355,0,3,1,3,0,1,0,76.14,70.11 ,33.33
01,000,01,005,0171,450,1283,31,1314,1988,0,3,1,3,0,1,0,76.14,66.10 ,33.33
01,000,01,005,0171,451,1027,12,1039,1451,0,3,1,3,0,1,0,76.14,71.61 ,33.33
01,000,01,005,0171,452,1132,10,1142,1610,0,3,1,3,0,1,0,76.14,70.93 ,33.33
01,000,01,005,0172,453,1163,7,1170,1649,0,3,1,3,0,1,0,76.14,70.95 ,33.33
01,000,01,005,0172,454,1206,12,1218,1619,0,3,1,3,0,1,0,76.14,75.23 ,33.33
01,000,01,005,0173,455,1489,17,1506,1961,0,3,1,3,0,1,0,76.14,76.80 ,33.33
01,000,01,005,0173,456,1263,19,1282,1704,0,3,1,3,0,1,0,76.14,75.23 ,33.33
01,000,01,005,0173,457,1313,13,1326,1763,0,3,1,3,0,1,0,76.14,75.21 ,33.33
01,000,01,005,0174,458,1144,14,1158,1667,0,3,1,3,0,1,0,76.14,69.47 ,33.33
01,000,01,005,0174,459,1058,6,1064,1496,0,3,1,3,0,1,0,76.14,71.12 ,33.33
01,000,01,005,0174,460,996,10,1006,1483,0,3,1,3,0,1,0,76.14,67.84 ,33.33
01,000,01,005,0175,461,1360,20,1380,1952,0,3,1,3,0,1,0,76.14,70.70 ,33.33
01,000,01,005,0175,462,1139,6,1145,1639,0,3,1,3,0,1,0,76.14,69.86 ,33.33
01,000,01,005,0175,463,1060,16,1076,1524,0,3,1,3,0,1,0,76.14,70.60 ,33.33
01,000,01,005,0176,464,1118,9,1127,1590,0,3,1,3,0,1,0,76.14,70.88 ,33.33
01,000,01,005,0176,465,1017,10,1027,1488,0,3,1,3,0,1,0,76.14,69.02 ,33.33
01,000,01,005,0177,466,858,13,871,1272,0,3,1,3,0,1,0,76.14,68.47 ,33.33
01,000,01,005,0177,467,798,9,807,1203,0,3,1,3,0,1,0,76.14,67.08 ,33.33
01,000,01,005,0178,468,1145,23,1168,1774,0,3,1,3,0,1,0,76.14,65.84 ,33.33
01,000,01,005,0178,469,956,9,965,1531,0,3,1,3,0,1,0,76.14,63.03 ,33.33
01,000,01,005,0179,470,1001,9,1010,1374,0,3,1,3,0,1,0,76.14,73.51 ,33.33
01,000,01,005,0179,471,995,9,1004,1423,0,3,1,3,0,1,0,76.14,70.56 ,33.33
01,000,01,005,0179,472,957,6,963,1345,0,3,1,3,0,1,0,76.14,71.60 ,33.33
01,000,01,005,0180,473,982,4,986,1385,0,3,1,3,0,1,0,76.14,71.19 ,33.33
01,000,01,005,0180,474,896,5,901,1307,0,3,1,3,0,1,0,76.14,68.94 ,33.33
01,000,01,005,0180,475,1186,26,1212,1675,0,3,1,3,0,1,0,76.14,72.36 ,33.33
01,000,01,005,0181,476,249,1,250,364,0,3,1,3,0,1,0,76.14,68.68 ,33.33
01,000,01,005,0181,477,1005,8,1013,1451,0,3,1,3,0,1,0,76.14,69.81 ,33.33
01,000,01,005,0181,478,1025,14,1039,1411,0,3,1,3,0,1,0,76.14,73.64 ,33.33
01,000,01,005,0181,479,882,16,898,1310,0,3,1,3,0,1,0,76.14,68.55 ,33.33
01,000,01,005,0182,480,908,17,925,1275,0,3,1,3,0,1,0,76.14,72.55 ,33.33
01,000,01,005,0182,481,806,8,814,1166,0,3,1,3,0,1,0,76.14,69.81 ,33.33
01,000,01,005,0183,482,1073,18,1091,1588,0,3,1,3,0,1,0,76.14,68.70 ,33.33
01,000,01,005,0183,483,1347,16,1363,1895,0,3,1,3,0,1,0,76.14,71.93 ,33.33
01,000,01,005,0184,484,938,29,967,1411,0,3,1,3,0,1,0,76.14,68.53 ,33.33
01,000,01,005,0184,485,896,6,902,1291,0,3,1,3,0,1,0,76.14,69.87 ,33.33
01,000,01,005,0184,486,1111,10,1121,1597,0,3,1,3,0,1,0,76.14,70.19 ,33.33
01,000,01,005,0184,487,1081,12,1093,1541,0,3,1,3,0,1,0,76.14,70.93 ,33.33
01,000,01,005,0185,488,820,5,825,1118,0,3,1,3,0,1,0,76.14,73.79 ,33.33
01,000,01,005,0185,489,1072,14,1086,1532,0,3,1,3,0,1,0,76.14,70.89 ,33.33
01,000,01,005,0185,490,781,8,789,1122,0,3,1,3,0,1,0,76.14,70.32 ,33.33
01,000,01,005,0186,491,719,11,730,1043,0,3,1,3,0,1,0,76.14,69.99 ,33.33
01,000,01,005,0186,492,1288,13,1301,1784,0,3,1,3,0,1,0,76.14,72.93 ,33.33
01,000,01,005,0187,493,1109,10,1119,1641,0,3,1,3,0,1,0,76.14,68.19 ,33.33
01,000,01,005,0187,494,723,2,725,1113,0,3,1,3,0,1,0,76.14,65.14 ,33.33
01,000,01,005,0187,495,1667,16,1683,2553,0,3,1,3,0,1,0,76.14,65.92 ,33.33
01,000,01,005,0187,496,557,4,561,883,0,3,1,3,0,1,0,76.14,63.53 ,33.33
01,000,01,005,0188,497,981,9,990,1415,0,3,1,3,0,1,0,76.14,69.96 ,33.33
01,000,01,005,0188,498,1131,12,1143,1627,0,3,1,3,0,1,0,76.14,70.25 ,33.33
01,000,01,005,0188,499,990,6,996,1422,0,3,1,3,0,1,0,76.14,70.04 ,33.33
01,000,01,005,0189,500,1228,10,1238,1756,0,3,1,3,0,1,0,76.14,70.50 ,33.33
01,000,01,005,0189,501,1393,9,1402,1963,0,3,1,3,0,1,0,76.14,71.42 ,33.33
01,000,01,005,0189,502,478,11,489,786,0,3,1,3,0,1,0,76.14,62.21 ,33.33
01,000,01,005,0189,503,1316,13,1329,1938,0,3,1,3,0,1,0,76.14,68.58 ,33.33
01,000,01,005,0189,504,988,5,993,1494,0,3,1,3,0,1,0,76.14,66.47 ,33.33
01,000,01,005,0189,505,1457,8,1465,2213,0,3,1,3,0,1,0,76.14,66.20 ,33.33
01,000,01,005,0189,506,1615,11,1626,2370,0,3,1,3,0,1,0,76.14,68.61 ,33.33
01,000,01,005,0190,507,1090,10,1100,1717,0,3,1,3,0,1,0,76.14,64.07 ,33.33
01,000,01,005,0190,508,1188,14,1202,1759,0,3,1,3,0,1,0,76.14,68.33 ,33.33
01,000,01,005,0190,509,1248,18,1266,1867,0,3,1,3,0,1,0,76.14,67.81 ,33.33
01,000,01,005,0191,510,1054,20,1074,1629,0,3,1,3,0,1,0,76.14,65.93 ,33.33
01,000,01,005,0191,511,1134,11,1145,1665,0,3,1,3,0,1,0,76.14,68.77 ,33.33
01,000,01,005,0191,512,1022,12,1034,1574,0,3,1,3,0,1,0,76.14,65.69 ,33.33
01,000,01,005,0192,513,1206,12,1218,1823,0,3,1,3,0,1,0,76.14,66.81 ,33.33
01,000,01,005,0192,514,1198,11,1209,1806,0,3,1,3,0,1,0,76.14,66.94 ,33.33
01,000,01,005,0192,515,1306,10,1316,1927,0,3,1,3,0,1,0,76.14,68.29 ,33.33
01,000,01,005,0192,516,1174,13,1187,1795,0,3,1,3,0,1,0,76.14,66.13 ,33.33
01,000,01,005,0192,517,1130,10,1140,1776,0,3,1,3,0,1,0,76.14,64.19 ,33.33
01,000,01,005,0193,518,396,4,400,599,0,3,1,3,0,1,0,76.14,66.78 ,33.33
01,000,01,005,0193,519,1183,10,1193,1808,0,3,1,3,0,1,0,76.14,65.98 ,33.33
01,000,01,005,0193,520,1010,13,1023,1500,0,3,1,3,0,1,0,76.14,68.20 ,33.33
01,000,01,005,0193,521,901,6,907,1319,0,3,1,3,0,1,0,76.14,68.76 ,33.33
01,000,01,006,0194,522,880,9,889,1287,0,3,1,3,0,1,0,76.14,69.08 ,33.33
01,000,01,006,0194,523,882,14,896,1342,0,3,1,3,0,1,0,76.14,66.77 ,33.33
01,000,01,006,0194,524,934,13,947,1424,0,3,1,3,0,1,0,76.14,66.50 ,33.33
01,000,01,006,0195,525,999,21,1020,1515,0,3,1,3,0,1,0,76.14,67.33 ,33.33
01,000,01,006,0195,526,1068,13,1081,1705,0,3,1,3,0,1,0,76.14,63.40 ,33.33
01,000,01,006,0196,527,1004,20,1024,1475,0,3,1,3,0,1,0,76.14,69.42 ,33.33
01,000,01,006,0196,528,1148,23,1171,1705,0,3,1,3,0,1,0,76.14,68.68 ,33.33
01,000,01,006,0197,529,754,14,768,1186,0,3,1,3,0,1,0,76.14,64.76 ,33.33
01,000,01,006,0197,530,916,10,926,1423,0,3,1,3,0,1,0,76.14,65.07 ,33.33
01,000,01,006,0198,531,1352,19,1371,2036,0,3,1,3,0,1,0,76.14,67.34 ,33.33
01,000,01,006,0198,532,1102,17,1119,1656,0,3,1,3,0,1,0,76.14,67.57 ,33.33
01,000,01,006,0198,533,887,7,894,1387,0,3,1,3,0,1,0,76.14,64.46 ,33.33
01,000,01,006,0199,534,1290,22,1312,1820,0,3,1,3,0,1,0,76.14,72.09 ,33.33
01,000,01,006,0199,535,1167,10,1177,1694,0,3,1,3,0,1,0,76.14,69.48 ,33.33
01,000,01,006,0200,536,1193,17,1210,1770,0,3,1,3,0,1,0,76.14,68.36 ,33.33
01,000,01,006,0200,537,972,22,994,1491,0,3,1,3,0,1,0,76.14,66.67 ,33.33
01,000,01,006,0201,538,1197,12,1209,1818,0,3,1,3,0,1,0,76.14,66.50 ,33.33
01,000,01,006,0201,539,1139,16,1155,1667,0,3,1,3,0,1,0,76.14,69.29 ,33.33
01,000,01,006,0202,540,1145,11,1156,1804,0,3,1,3,0,1,0,76.14,64.08 ,33.33
01,000,01,006,0202,541,1247,14,1261,1770,0,3,1,3,0,1,0,76.14,71.24 ,33.33
01,000,01,006,0203,542,978,13,991,1412,0,3,1,3,0,1,0,76.14,70.18 ,33.33
01,000,01,006,0203,543,851,10,861,1203,0,3,1,3,0,1,0,76.14,71.57 ,33.33
01,000,01,006,0203,544,1378,16,1394,2028,0,3,1,3,0,1,0,76.14,68.74 ,33.33
01,000,01,006,0204,545,1202,22,1224,1708,0,3,1,3,0,1,0,76.14,71.66 ,33.33
01,000,01,006,0204,546,1311,15,1326,1880,0,3,1,3,0,1,0,76.14,70.53 ,33.33
01,000,01,006,0204,547,1233,10,1243,1749,0,3,1,3,0,1,0,76.14,71.07 ,33.33
01,000,01,006,0205,548,1195,24,1219,1777,0,3,1,3,0,1,0,76.14,68.60 ,33.33
01,000,01,006,0205,549,1222,17,1239,1769,0,3,1,3,0,1,0,76.14,70.04 ,33.33
01,000,01,006,0206,550,1247,15,1262,1768,0,3,1,3,0,1,0,76.14,71.38 ,33.33
01,000,01,006,0206,551,1127,11,1138,1517,0,3,1,3,0,1,0,76.14,75.02 ,33.33
01,000,01,006,0207,552,1350,21,1371,1955,0,3,1,3,0,1,0,76.14,70.13 ,33.33
01,000,01,006,0207,553,1210,20,1230,1859,0,3,1,3,0,1,0,76.14,66.16 ,33.33
01,000,01,006,0208,554,1484,15,1499,2088,0,3,1,3,0,1,0,76.14,71.79 ,33.33
01,000,01,006,0208,555,1321,35,1356,1908,0,3,1,3,0,1,0,76.14,71.07 ,33.33
01,000,01,006,0209,556,1089,19,1108,1702,0,3,1,3,0,1,0,76.14,65.10 ,33.33
01,000,01,006,0209,557,755,9,764,1180,0,3,1,3,0,1,0,76.14,64.75 ,33.33
01,000,01,006,0209,558,833,6,839,1297,0,3,1,3,0,1,0,76.14,64.69 ,33.33
01,000,01,006,0209,559,1130,32,1162,1845,0,3,1,3,0,1,0,76.14,62.98 ,33.33
01,000,01,006,0210,560,1211,16,1227,1773,0,3,1,3,0,1,0,76.14,69.20 ,33.33
01,000,01,006,0210,561,1143,13,1156,1591,0,3,1,3,0,1,0,76.14,72.66 ,33.33
01,000,01,006,0210,562,1219,6,1225,1732,0,3,1,3,0,1,0,76.14,70.73 ,33.33
01,000,01,006,0210,563,1132,19,1151,1574,0,3,1,3,0,1,0,76.14,73.13 ,33.33
01,000,01,006,0211,564,1265,12,1277,1795,0,3,1,3,0,1,0,76.14,71.14 ,33.33
01,000,01,006,0211,565,961,11,972,1407,0,3,1,3,0,1,0,76.14,69.08 ,33.33
01,000,01,006,0211,566,1046,8,1054,1554,0,3,1,3,0,1,0,76.14,67.82 ,33.33
01,000,02,007,0212,567,893,17,910,1542,0,3,1,3,0,1,0,76.14,59.01 ,33.33
01,000,02,007,0212,568,957,14,971,1572,0,3,1,3,0,1,0,76.14,61.77 ,33.33
01,000,02,007,0213,569,846,10,856,1713,0,3,1,3,0,1,0,76.14,49.97 ,33.33
01,000,02,007,0213,570,893,14,907,1631,0,3,1,3,0,1,0,76.14,55.61 ,33.33
01,000,02,007,0214,571,683,9,692,1146,0,3,1,3,0,1,0,76.14,60.38 ,33.33
01,000,02,007,0214,572,824,12,836,1616,0,3,1,3,0,1,0,76.14,51.73 ,33.33
01,000,02,007,0215,573,874,5,879,1372,0,3,1,3,0,1,0,76.14,64.07 ,33.33
01,000,02,007,0215,574,796,10,806,1458,0,3,1,3,0,1,0,76.14,55.28 ,33.33
01,000,02,007,0215,575,821,15,836,1395,0,3,1,3,0,1,0,76.14,59.93 ,33.33
01,000,02,007,0216,576,1285,24,1309,2315,0,3,1,3,0,1,0,76.14,56.54 ,33.33
01,000,02,007,0216,577,1185,16,1201,2091,0,3,1,3,0,1,0,76.14,57.44 ,33.33
01,000,02,007,0217,578,717,6,723,1300,0,3,1,3,0,1,0,76.14,55.62 ,33.33
01,000,02,007,0217,579,655,11,666,1163,0,3,1,3,0,1,0,76.14,57.27 ,33.33
01,000,02,007,0217,580,741,7,748,1413,0,3,1,3,0,1,0,76.14,52.94 ,33.33
01,000,02,007,0218,581,714,13,727,1344,0,3,1,3,0,1,0,76.14,54.09 ,33.33
01,000,02,007,0218,582,639,11,650,1293,0,3,1,3,0,1,0,76.14,50.27 ,33.33
01,000,02,007,0219,583,884,15,899,1395,0,3,1,3,0,1,0,76.14,64.44 ,33.33
01,000,02,007,0219,584,985,14,999,1664,0,3,1,3,0,1,0,76.14,60.04 ,33.33
01,000,02,007,0219,585,844,10,854,1516,0,3,1,3,0,1,0,76.14,56.33 ,33.33
01,000,02,007,0220,586,850,18,868,1521,0,3,1,3,0,1,0,76.14,57.07 ,33.33
01,000,02,007,0220,587,863,23,886,1466,0,3,1,3,0,1,0,76.14,60.44 ,33.33
01,000,02,007,0221,588,810,14,824,1394,0,3,1,3,0,1,0,76.14,59.11 ,33.33
01,000,02,007,0221,589,572,4,576,1041,0,3,1,3,0,1,0,76.14,55.33 ,33.33
01,000,02,007,0222,590,710,14,724,1460,0,3,1,3,0,1,0,76.14,49.59 ,33.33
01,000,02,007,0222,591,855,15,870,1692,0,3,1,3,0,1,0,76.14,51.42 ,33.33
01,000,02,007,0223,592,1001,9,1010,1760,0,3,1,3,0,1,0,76.14,57.39 ,33.33
01,000,02,007,0223,593,685,12,697,1265,0,3,1,3,0,1,0,76.14,55.10 ,33.33
01,000,02,007,0223,594,587,10,597,897,0,3,1,3,0,1,0,76.14,66.56 ,33.33
01,000,02,007,0224,595,1098,19,1117,2016,0,3,1,3,0,1,0,76.14,55.41 ,33.33
01,000,02,007,0224,596,1282,13,1295,2029,0,3,1,3,0,1,0,76.14,63.82 ,33.33
01,000,02,007,0225,597,1604,13,1617,2358,0,3,1,3,0,1,0,76.14,68.58 ,33.33
01,000,02,007,0226,598,1359,10,1369,2034,0,3,1,3,0,1,0,76.14,67.31 ,33.33
01,000,02,007,0226,599,1301,32,1333,1913,0,3,1,3,0,1,0,76.14,69.68 ,33.33
01,000,02,007,0226,600,1345,6,1351,1943,0,3,1,3,0,1,0,76.14,69.53 ,33.33
01,000,02,007,0226,601,1233,17,1250,1815,0,3,1,3,0,1,0,76.14,68.87 ,33.33
01,000,02,007,0227,602,1594,19,1613,2247,0,3,1,3,0,1,0,76.14,71.78 ,33.33
01,000,02,007,0227,603,1074,12,1086,1577,0,3,1,3,0,1,0,76.14,68.86 ,33.33
01,000,02,007,0228,604,763,7,770,1098,0,3,1,3,0,1,0,76.14,70.13 ,33.33
01,000,02,007,0228,605,757,8,765,1107,0,3,1,3,0,1,0,76.14,69.11 ,33.33
01,000,02,007,0228,606,1137,10,1147,1676,0,3,1,3,0,1,0,76.14,68.44 ,33.33
01,000,02,007,0229,607,1192,21,1213,1857,0,3,1,3,0,1,0,76.14,65.32 ,33.33
01,000,02,007,0229,608,1178,15,1193,1941,0,3,1,3,0,1,0,76.14,61.46 ,33.33
01,000,02,007,0230,609,573,8,581,874,0,3,1,3,0,1,0,76.14,66.48 ,33.33
01,000,02,007,0231,610,1306,36,1342,2146,0,3,1,3,0,1,0,76.14,62.53 ,33.33
01,000,02,007,0231,611,1144,16,1160,1948,0,3,1,3,0,1,0,76.14,59.55 ,33.33
01,000,02,007,0232,612,1071,21,1092,1711,0,3,1,3,0,1,0,76.14,63.82 ,33.33
01,000,02,007,0232,613,1031,9,1040,1701,0,3,1,3,0,1,0,76.14,61.14 ,33.33
01,000,02,007,0232,614,1034,13,1047,1673,0,3,1,3,0,1,0,76.14,62.58 ,33.33
01,000,02,007,0233,615,1228,10,1238,2089,0,3,1,3,0,1,0,76.14,59.26 ,33.33
01,000,02,007,0233,616,1045,16,1061,1803,0,3,1,3,0,1,0,76.14,58.85 ,33.33
01,000,02,007,0234,617,1213,20,1233,2033,0,3,1,3,0,1,0,76.14,60.65 ,33.33
01,000,02,007,0234,618,1443,26,1469,2496,0,3,1,3,0,1,0,76.14,58.85 ,33.33
01,000,02,007,0235,619,975,9,984,1597,0,3,1,3,0,1,0,76.14,61.62 ,33.33
01,000,02,007,0235,620,1480,15,1495,2380,0,3,1,3,0,1,0,76.14,62.82 ,33.33
01,000,02,007,0236,621,1307,19,1326,2075,0,3,1,3,0,1,0,76.14,63.90 ,33.33
01,000,02,007,0236,622,1318,18,1336,2084,0,3,1,3,0,1,0,76.14,64.11 ,33.33
01,000,02,007,0236,623,1277,18,1295,2086,0,3,1,3,0,1,0,76.14,62.08 ,33.33
01,000,02,007,0237,624,794,22,816,1287,0,3,1,3,0,1,0,76.14,63.40 ,33.33
01,000,02,007,0237,625,1051,17,1068,1767,0,3,1,3,0,1,0,76.14,60.44 ,33.33
01,000,02,007,0238,626,1152,10,1162,1854,0,3,1,3,0,1,0,76.14,62.68 ,33.33
01,000,02,007,0238,627,1199,12,1211,1934,0,3,1,3,0,1,0,76.14,62.62 ,33.33
01,000,02,007,0238,628,1098,14,1112,1757,0,3,1,3,0,1,0,76.14,63.29 ,33.33
01,000,02,007,0239,629,1490,18,1508,2425,0,3,1,3,0,1,0,76.14,62.19 ,33.33
01,000,02,007,0239,630,1557,9,1566,2462,0,3,1,3,0,1,0,76.14,63.61 ,33.33
01,000,02,007,0240,631,1106,13,1119,1847,0,3,1,3,0,1,0,76.14,60.58 ,33.33
01,000,02,007,0240,632,1354,16,1370,2174,0,3,1,3,0,1,0,76.14,63.02 ,33.33
01,000,02,007,0240,633,1253,12,1265,1863,0,3,1,3,0,1,0,76.14,67.90 ,33.33
01,000,02,007,0241,634,800,12,812,1331,0,3,1,3,0,1,0,76.14,61.01 ,33.33
01,000,02,007,0241,635,850,9,859,1442,0,3,1,3,0,1,0,76.14,59.57 ,33.33
01,000,02,007,0241,636,807,12,819,1367,0,3,1,3,0,1,0,76.14,59.91 ,33.33
01,000,02,007,0242,637,1057,20,1077,1821,0,3,1,3,0,1,0,76.14,59.14 ,33.33
01,000,02,007,0242,638,1062,12,1074,1814,0,3,1,3,0,1,0,76.14,59.21 ,33.33
01,000,02,007,0243,639,1279,13,1292,2204,0,3,1,3,0,1,0,76.14,58.62 ,33.33
01,000,02,007,0243,640,1193,11,1204,1984,0,3,1,3,0,1,0,76.14,60.69 ,33.33
01,000,02,007,0244,641,871,14,885,1478,0,3,1,3,0,1,0,76.14,59.88 ,33.33
01,000,02,007,0244,642,949,10,959,1498,0,3,1,3,0,1,0,76.14,64.02 ,33.33
01,000,02,007,0245,643,1034,18,1052,1658,0,3,1,3,0,1,0,76.14,63.45 ,33.33
01,000,02,007,0245,644,942,9,951,1537,0,3,1,3,0,1,0,76.14,61.87 ,33.33
01,000,02,007,0245,645,1167,22,1189,1940,0,3,1,3,0,1,0,76.14,61.29 ,33.33
01,000,02,007,0246,646,1236,13,1249,1841,0,3,1,3,0,1,0,76.14,67.84 ,33.33
01,000,02,007,0246,647,1894,20,1914,2606,0,3,1,3,0,1,0,76.14,73.45 ,33.33
01,000,02,007,0247,648,1045,11,1056,1678,0,3,1,3,0,1,0,76.14,62.93 ,33.33
01,000,02,007,0247,649,1101,13,1114,1725,0,3,1,3,0,1,0,76.14,64.58 ,33.33
01,000,02,007,0248,650,1303,18,1321,2028,0,3,1,3,0,1,0,76.14,65.14 ,33.33
01,000,02,007,0248,651,1036,13,1049,1623,0,3,1,3,0,1,0,76.14,64.63 ,33.33
01,000,02,007,0249,652,862,14,876,1394,0,3,1,3,0,1,0,76.14,62.84 ,33.33
01,000,02,007,0249,653,843,23,866,1363,0,3,1,3,0,1,0,76.14,63.54 ,33.33
01,000,02,007,0250,654,1143,9,1152,1827,0,3,1,3,0,1,0,76.14,63.05 ,33.33
01,000,02,007,0250,655,1000,18,1018,1724,0,3,1,3,0,1,0,76.14,59.05 ,33.33
01,000,02,007,0250,656,1000,8,1008,1629,0,3,1,3,0,1,0,76.14,61.88 ,33.33
01,000,02,007,0251,657,1102,29,1131,1808,0,3,1,3,0,1,0,76.14,62.56 ,33.33
01,000,02,007,0251,658,742,7,749,1224,0,3,1,3,0,1,0,76.14,61.19 ,33.33
01,000,02,008,0252,659,1308,22,1330,2123,0,3,1,3,0,1,0,76.14,62.65 ,33.33
01,000,02,008,0252,660,715,11,726,1108,0,3,1,3,0,1,0,76.14,65.52 ,33.33
01,000,02,008,0253,661,978,14,992,1599,0,3,1,3,0,1,0,76.14,62.04 ,33.33
01,000,02,008,0253,662,939,12,951,1495,0,3,1,3,0,1,0,76.14,63.61 ,33.33
01,000,02,008,0254,663,1010,13,1023,1610,0,3,1,3,0,1,0,76.14,63.54 ,33.33
01,000,02,008,0254,664,1053,16,1069,1598,0,3,1,3,0,1,0,76.14,66.90 ,33.33
01,000,02,008,0255,665,1019,17,1036,1650,0,3,1,3,0,1,0,76.14,62.79 ,33.33
01,000,02,008,0255,666,770,11,781,1127,0,3,1,3,0,1,0,76.14,69.30 ,33.33
01,000,02,008,0256,667,1297,13,1310,2021,0,3,1,3,0,1,0,76.14,64.82 ,33.33
01,000,02,008,0256,668,1338,13,1351,1958,0,3,1,3,0,1,0,76.14,69.00 ,33.33
01,000,02,008,0257,669,918,8,926,1436,0,3,1,3,0,1,0,76.14,64.48 ,33.33
01,000,02,008,0257,670,833,11,844,1339,0,3,1,3,0,1,0,76.14,63.03 ,33.33
01,000,02,008,0258,671,1094,12,1106,1746,0,3,1,3,0,1,0,76.14,63.34 ,33.33
01,000,02,008,0258,672,1078,12,1090,1584,0,3,1,3,0,1,0,76.14,68.81 ,33.33
01,000,02,008,0259,673,919,17,936,1366,0,3,1,3,0,1,0,76.14,68.52 ,33.33
01,000,02,008,0259,674,1038,11,1049,1516,0,3,1,3,0,1,0,76.14,69.20 ,33.33
01,000,02,008,0259,675,926,19,945,1409,0,3,1,3,0,1,0,76.14,67.07 ,33.33
01,000,02,008,0260,676,949,8,957,1412,0,3,1,3,0,1,0,76.14,67.78 ,33.33
01,000,02,008,0260,677,823,12,835,1184,0,3,1,3,0,1,0,76.14,70.52 ,33.33
01,000,02,008,0260,678,932,10,942,1359,0,3,1,3,0,1,0,76.14,69.32 ,33.33
01,000,02,008,0261,679,963,15,978,1507,0,3,1,3,0,1,0,76.14,64.90 ,33.33
01,000,02,008,0261,680,881,8,889,1470,0,3,1,3,0,1,0,76.14,60.48 ,33.33
01,000,02,008,0262,681,950,17,967,1563,0,3,1,3,0,1,0,76.14,61.87 ,33.33
01,000,02,008,0262,682,971,8,979,1448,0,3,1,3,0,1,0,76.14,67.61 ,33.33
01,000,02,008,0262,683,1103,16,1119,1701,0,3,1,3,0,1,0,76.14,65.78 ,33.33
01,000,02,008,0262,684,814,16,830,1298,0,3,1,3,0,1,0,76.14,63.94 ,33.33
01,000,02,008,0262,685,581,8,589,897,0,3,1,3,0,1,0,76.14,65.66 ,33.33
01,000,02,008,0263,686,991,17,1008,1592,0,3,1,3,0,1,0,76.14,63.32 ,33.33
01,000,02,008,0263,687,1080,14,1094,1658,0,3,1,3,0,1,0,76.14,65.98 ,33.33
01,000,02,008,0264,688,1073,10,1083,1588,0,3,1,3,0,1,0,76.14,68.20 ,33.33
01,000,02,008,0264,689,1152,17,1169,1832,0,3,1,3,0,1,0,76.14,63.81 ,33.33
01,000,02,008,0264,690,1116,18,1134,1772,0,3,1,3,0,1,0,76.14,64.00 ,33.33
01,000,02,008,0265,691,789,12,801,1254,0,3,1,3,0,1,0,76.14,63.88 ,33.33
01,000,02,008,0265,692,788,14,802,1253,0,3,1,3,0,1,0,76.14,64.01 ,33.33
01,000,02,008,0266,693,832,11,843,1290,0,3,1,3,0,1,0,76.14,65.35 ,33.33
01,000,02,008,0266,694,848,11,859,1260,0,3,1,3,0,1,0,76.14,68.17 ,33.33
01,000,02,008,0267,695,1124,13,1137,1875,0,3,1,3,0,1,0,76.14,60.64 ,33.33
01,000,02,008,0267,696,1282,19,1301,1960,0,3,1,3,0,1,0,76.14,66.38 ,33.33
01,000,02,008,0268,697,1251,24,1275,1934,0,3,1,3,0,1,0,76.14,65.93 ,33.33
01,000,02,008,0268,698,1078,17,1095,1591,0,3,1,3,0,1,0,76.14,68.82 ,33.33
01,000,02,008,0269,699,1293,16,1309,1919,0,3,1,3,0,1,0,76.14,68.21 ,33.33
01,000,02,008,0270,700,789,15,804,1262,0,3,1,3,0,1,0,76.14,63.71 ,33.33
01,000,02,008,0270,701,804,12,816,1256,0,3,1,3,0,1,0,76.14,64.97 ,33.33
01,000,02,008,0271,702,1188,20,1208,1966,0,3,1,3,0,1,0,76.14,61.44 ,33.33
01,000,02,008,0271,703,1426,16,1442,2171,0,3,1,3,0,1,0,76.14,66.42 ,33.33
01,000,02,008,0272,704,1226,22,1248,1840,0,3,1,3,0,1,0,76.14,67.83 ,33.33
01,000,02,008,0272,705,1035,9,1044,1533,0,3,1,3,0,1,0,76.14,68.10 ,33.33
01,000,02,008,0272,706,1169,13,1182,1746,0,3,1,3,0,1,0,76.14,67.70 ,33.33
01,000,02,008,0273,707,1121,12,1133,1714,0,3,1,3,0,1,0,76.14,66.10 ,33.33
01,000,02,008,0273,708,1095,13,1108,1697,0,3,1,3,0,1,0,76.14,65.29 ,33.33
01,000,02,008,0273,709,986,10,996,1486,0,3,1,3,0,1,0,76.14,67.03 ,33.33
01,000,02,008,0273,710,931,10,941,1399,0,3,1,3,0,1,0,76.14,67.26 ,33.33
01,000,02,008,0274,711,644,5,649,967,0,3,1,3,0,1,0,76.14,67.11 ,33.33
01,000,02,008,0275,712,1259,11,1270,1984,0,3,1,3,0,1,0,76.14,64.01 ,33.33
01,000,02,008,0275,713,1066,11,1077,1601,0,3,1,3,0,1,0,76.14,67.27 ,33.33
01,000,02,008,0276,714,1022,17,1039,1494,0,3,1,3,0,1,0,76.14,69.54 ,33.33
01,000,02,008,0276,715,1105,12,1117,1646,0,3,1,3,0,1,0,76.14,67.86 ,33.33
01,000,02,008,0277,716,1078,12,1090,1568,0,3,1,3,0,1,0,76.14,69.52 ,33.33
01,000,02,008,0277,717,1088,14,1102,1581,0,3,1,3,0,1,0,76.14,69.70 ,33.33
01,000,02,008,0277,718,984,12,996,1504,0,3,1,3,0,1,0,76.14,66.22 ,33.33
01,000,02,009,0278,719,1186,5,1191,2077,0,3,1,3,0,1,0,76.14,57.34 ,33.33
01,000,02,009,0278,720,1272,19,1291,2132,0,3,1,3,0,1,0,76.14,60.55 ,33.33
01,000,02,009,0279,721,1150,10,1160,1898,0,3,1,3,0,1,0,76.14,61.12 ,33.33
01,000,02,009,0279,722,1145,7,1152,1844,0,3,1,3,0,1,0,76.14,62.47 ,33.33
01,000,02,009,0280,723,1015,7,1022,1685,0,3,1,3,0,1,0,76.14,60.65 ,33.33
01,000,02,009,0280,724,1013,16,1029,1649,0,3,1,3,0,1,0,76.14,62.40 ,33.33
01,000,02,009,0280,725,1277,13,1290,1859,0,3,1,3,0,1,0,76.14,69.39 ,33.33
01,000,02,009,0281,726,899,9,908,1470,0,3,1,3,0,1,0,76.14,61.77 ,33.33
01,000,02,009,0281,727,1102,14,1116,1714,0,3,1,3,0,1,0,76.14,65.11 ,33.33
01,000,02,009,0281,728,940,10,950,1548,0,3,1,3,0,1,0,76.14,61.37 ,33.33
01,000,02,009,0281,729,972,6,978,1607,0,3,1,3,0,1,0,76.14,60.86 ,33.33
01,000,02,009,0282,730,900,7,907,1679,0,3,1,3,0,1,0,76.14,54.02 ,33.33
01,000,02,009,0282,731,843,5,848,1611,0,3,1,3,0,1,0,76.14,52.64 ,33.33
01,000,02,009,0282,732,849,6,855,1522,0,3,1,3,0,1,0,76.14,56.18 ,33.33
01,000,02,009,0283,733,1258,8,1266,1876,0,3,1,3,0,1,0,76.14,67.48 ,33.33
01,000,02,009,0283,734,1310,13,1323,1967,0,3,1,3,0,1,0,76.14,67.26 ,33.33
01,000,02,009,0283,735,1209,8,1217,1835,0,3,1,3,0,1,0,76.14,66.32 ,33.33
01,000,02,009,0284,736,1002,9,1011,1656,0,3,1,3,0,1,0,76.14,61.05 ,33.33
01,000,02,009,0284,737,919,6,925,1479,0,3,1,3,0,1,0,76.14,62.54 ,33.33
01,000,02,009,0284,738,934,8,942,1595,0,3,1,3,0,1,0,76.14,59.06 ,33.33
01,000,02,009,0285,739,1026,9,1035,1738,0,3,1,3,0,1,0,76.14,59.55 ,33.33
01,000,02,009,0285,740,1101,14,1115,1826,0,3,1,3,0,1,0,76.14,61.06 ,33.33
01,000,02,009,0286,741,1201,14,1215,1891,0,3,1,3,0,1,0,76.14,64.25 ,33.33
01,000,02,009,0286,742,1129,13,1142,1828,0,3,1,3,0,1,0,76.14,62.47 ,33.33
01,000,02,009,0287,743,864,9,873,1548,0,3,1,3,0,1,0,76.14,56.40 ,33.33
01,000,02,009,0287,744,891,12,903,1560,0,3,1,3,0,1,0,76.14,57.88 ,33.33
01,000,02,009,0287,745,900,14,914,1542,0,3,1,3,0,1,0,76.14,59.27 ,33.33
01,000,02,009,0287,746,896,11,907,1524,0,3,1,3,0,1,0,76.14,59.51 ,33.33
01,000,02,009,0288,747,1003,5,1008,1563,0,3,1,3,0,1,0,76.14,64.49 ,33.33
01,000,02,009,0288,748,945,6,951,1451,0,3,1,3,0,1,0,76.14,65.54 ,33.33
01,000,02,009,0288,749,890,9,899,1334,0,3,1,3,0,1,0,76.14,67.39 ,33.33
01,000,02,009,0289,750,960,7,967,1665,0,3,1,3,0,1,0,76.14,58.08 ,33.33
01,000,02,009,0289,751,1165,10,1175,1884,0,3,1,3,0,1,0,76.14,62.37 ,33.33
01,000,02,009,0290,752,1005,10,1015,1604,0,3,1,3,0,1,0,76.14,63.28 ,33.33
01,000,02,009,0290,753,1072,7,1079,1701,0,3,1,3,0,1,0,76.14,63.43 ,33.33
01,000,02,009,0291,754,1689,17,1706,2654,0,3,1,3,0,1,0,76.14,64.28 ,33.33
01,000,02,009,0291,755,1497,15,1512,2415,0,3,1,3,0,1,0,76.14,62.61 ,33.33
01,000,02,009,0292,756,856,7,863,1330,0,3,1,3,0,1,0,76.14,64.89 ,33.33
01,000,02,009,0292,757,829,3,832,1300,0,3,1,3,0,1,0,76.14,64.00 ,33.33
01,000,02,009,0292,758,909,8,917,1409,0,3,1,3,0,1,0,76.14,65.08 ,33.33
01,000,02,009,0293,759,1322,7,1329,2064,0,3,1,3,0,1,0,76.14,64.39 ,33.33
01,000,02,009,0293,760,1220,9,1229,1990,0,3,1,3,0,1,0,76.14,61.76 ,33.33
01,000,02,009,0294,761,1091,5,1096,1878,0,3,1,3,0,1,0,76.14,58.36 ,33.33
01,000,02,009,0294,762,1152,7,1159,1793,0,3,1,3,0,1,0,76.14,64.64 ,33.33
01,000,02,009,0295,763,895,5,900,1362,0,3,1,3,0,1,0,76.14,66.08 ,33.33
01,000,02,009,0295,764,847,13,860,1317,0,3,1,3,0,1,0,76.14,65.30 ,33.33
01,000,02,009,0296,765,1189,10,1199,1778,0,3,1,3,0,1,0,76.14,67.44 ,33.33
01,000,02,009,0296,766,1049,12,1061,1620,0,3,1,3,0,1,0,76.14,65.49 ,33.33
01,000,02,009,0297,767,1418,11,1429,2023,0,3,1,3,0,1,0,76.14,70.64 ,33.33
01,000,02,009,0297,768,1463,9,1472,2210,0,3,1,3,0,1,0,76.14,66.61 ,33.33
01,000,02,009,0298,769,882,8,890,1300,0,3,1,3,0,1,0,76.14,68.46 ,33.33
01,000,02,009,0298,770,926,7,933,1331,0,3,1,3,0,1,0,76.14,70.10 ,33.33
01,000,02,009,0298,771,1042,11,1053,1537,0,3,1,3,0,1,0,76.14,68.51 ,33.33
01,000,02,009,0299,772,1045,11,1056,1677,0,3,1,3,0,1,0,76.14,62.97 ,33.33
01,000,02,009,0299,773,1180,12,1192,1893,0,3,1,3,0,1,0,76.14,62.97 ,33.33
01,000,02,009,0299,774,1042,10,1052,1577,0,3,1,3,0,1,0,76.14,66.71 ,33.33
01,000,02,009,0300,775,1004,5,1009,1587,0,3,1,3,0,1,0,76.14,63.58 ,33.33
01,000,02,009,0300,776,1434,8,1442,2048,0,3,1,3,0,1,0,76.14,70.41 ,33.33
01,000,02,009,0300,777,971,9,980,1402,0,3,1,3,0,1,0,76.14,69.90 ,33.33
01,000,02,009,0301,778,910,8,918,1534,0,3,1,3,0,1,0,76.14,59.84 ,33.33
01,000,02,009,0301,779,1016,12,1028,1645,0,3,1,3,0,1,0,76.14,62.49 ,33.33
01,000,02,009,0302,780,1415,8,1423,2127,0,3,1,3,0,1,0,76.14,66.90 ,33.33
01,000,02,009,0302,781,1277,10,1287,2062,0,3,1,3,0,1,0,76.14,62.42 ,33.33
01,000,02,009,0303,782,1192,15,1207,1776,0,3,1,3,0,1,0,76.14,67.96 ,33.33
01,000,02,009,0303,783,981,8,989,1554,0,3,1,3,0,1,0,76.14,63.64 ,33.33
01,000,02,009,0303,784,1035,10,1045,1599,0,3,1,3,0,1,0,76.14,65.35 ,33.33
01,000,02,009,0304,785,996,5,1001,1532,0,3,1,3,0,1,0,76.14,65.34 ,33.33
01,000,02,009,0304,786,876,20,896,1426,0,3,1,3,0,1,0,76.14,62.83 ,33.33
01,000,02,009,0304,787,1070,11,1081,1707,0,3,1,3,0,1,0,76.14,63.33 ,33.33
01,000,02,009,0305,788,800,5,805,1284,0,3,1,3,0,1,0,76.14,62.69 ,33.33
01,000,02,009,0305,789,950,10,960,1499,0,3,1,3,0,1,0,76.14,64.04 ,33.33
01,000,02,009,0305,790,1002,6,1008,1649,0,3,1,3,0,1,0,76.14,61.13 ,33.33
01,000,02,009,0306,791,943,15,958,1549,0,3,1,3,0,1,0,76.14,61.85 ,33.33
01,000,02,009,0306,792,1113,22,1135,1773,0,3,1,3,0,1,0,76.14,64.02 ,33.33
01,000,02,009,0306,793,1112,16,1128,1780,0,3,1,3,0,1,0,76.14,63.37 ,33.33
01,000,02,009,0307,794,1142,15,1157,1839,0,3,1,3,0,1,0,76.14,62.91 ,33.33
01,000,02,009,0307,795,1045,10,1055,1605,0,3,1,3,0,1,0,76.14,65.73 ,33.33
01,000,02,009,0307,796,951,11,962,1429,0,3,1,3,0,1,0,76.14,67.32 ,33.33
01,000,02,009,0308,797,1183,22,1205,1910,0,3,1,3,0,1,0,76.14,63.09 ,33.33
01,000,02,009,0308,798,1095,17,1112,1785,0,3,1,3,0,1,0,76.14,62.30 ,33.33
01,000,02,009,0309,799,1111,12,1123,1760,0,3,1,3,0,1,0,76.14,63.81 ,33.33
01,000,02,009,0309,800,974,7,981,1573,0,3,1,3,0,1,0,76.14,62.36 ,33.33
01,000,02,009,0310,801,1185,10,1195,1882,0,3,1,3,0,1,0,76.14,63.50 ,33.33
01,000,02,009,0310,802,1017,14,1031,1602,0,3,1,3,0,1,0,76.14,64.36 ,33.33
01,000,02,009,0311,803,1136,9,1145,1763,0,3,1,3,0,1,0,76.14,64.95 ,33.33
01,000,02,009,0311,804,925,13,938,1513,0,3,1,3,0,1,0,76.14,62.00 ,33.33
01,000,02,009,0311,805,1072,9,1081,1755,0,3,1,3,0,1,0,76.14,61.60 ,33.33
01,000,02,009,0312,806,1039,3,1042,1460,0,3,1,3,0,1,0,76.14,71.37 ,33.33
01,000,02,009,0312,807,1051,6,1057,1523,0,3,1,3,0,1,0,76.14,69.40 ,33.33
01,000,02,009,0312,808,1055,8,1063,1527,0,3,1,3,0,1,0,76.14,69.61 ,33.33
01,000,02,009,0312,809,1078,10,1088,1528,0,3,1,3,0,1,0,76.14,71.20 ,33.33
01,000,02,009,0313,810,904,2,906,1427,0,3,1,3,0,1,0,76.14,63.49 ,33.33
01,000,02,009,0313,811,837,7,844,1334,0,3,1,3,0,1,0,76.14,63.27 ,33.33
01,000,02,009,0314,812,946,13,959,1473,0,3,1,3,0,1,0,76.14,65.11 ,33.33
01,000,02,009,0314,813,804,7,811,1252,0,3,1,3,0,1,0,76.14,64.78 ,33.33
01,000,02,009,0315,814,1078,12,1090,1678,0,3,1,3,0,1,0,76.14,64.96 ,33.33
01,000,02,009,0315,815,1193,11,1204,1807,0,3,1,3,0,1,0,76.14,66.63 ,33.33
01,000,02,009,0315,816,1037,3,1040,1661,0,3,1,3,0,1,0,76.14,62.61 ,33.33
01,000,02,009,0315,817,1090,7,1097,1739,0,3,1,3,0,1,0,76.14,63.08 ,33.33
01,000,02,009,0316,818,1116,23,1139,2125,0,3,1,3,0,1,0,76.14,53.60 ,33.33
01,000,02,009,0316,819,1244,11,1255,1882,0,3,1,3,0,1,0,76.14,66.68 ,33.33
01,000,02,009,0317,820,1011,4,1015,1474,0,3,1,3,0,1,0,76.14,68.86 ,33.33
01,000,02,009,0317,821,401,2,403,852,0,3,1,3,0,1,0,76.14,47.30 ,33.33
01,000,02,009,0318,822,1330,12,1342,2174,0,3,1,3,0,1,0,76.14,61.73 ,33.33
01,000,02,009,0318,823,1400,9,1409,2193,0,3,1,3,0,1,0,76.14,64.25 ,33.33
01,000,02,009,0318,824,1406,5,1411,2220,0,3,1,3,0,1,0,76.14,63.56 ,33.33
01,000,02,009,0319,825,1156,14,1170,1730,0,3,1,3,0,1,0,76.14,67.63 ,33.33
01,000,02,009,0319,826,1167,10,1177,1737,0,3,1,3,0,1,0,76.14,67.76 ,33.33
01,000,02,009,0319,827,1176,15,1191,1715,0,3,1,3,0,1,0,76.14,69.45 ,33.33
01,000,02,009,0320,828,655,16,671,984,0,3,1,3,0,1,0,76.14,68.19 ,33.33
01,000,02,009,0320,829,632,4,636,1094,0,3,1,3,0,1,0,76.14,58.14 ,33.33
01,000,02,009,0321,830,1500,18,1518,2271,0,3,1,3,0,1,0,76.14,66.84 ,33.33
01,000,02,009,0321,831,1388,13,1401,2193,0,3,1,3,0,1,0,76.14,63.89 ,33.33
01,000,02,009,0322,832,1388,23,1411,2115,0,3,1,3,0,1,0,76.14,66.71 ,33.33
01,000,02,009,0322,833,1143,17,1160,1741,0,3,1,3,0,1,0,76.14,66.63 ,33.33
01,000,02,009,0322,834,1370,18,1388,2013,0,3,1,3,0,1,0,76.14,68.95 ,33.33
01,000,02,009,0323,835,1066,14,1080,1628,0,3,1,3,0,1,0,76.14,66.34 ,33.33
01,000,02,009,0323,836,1066,20,1086,1637,0,3,1,3,0,1,0,76.14,66.34 ,33.33
01,000,02,009,0324,837,1300,14,1314,2218,0,3,1,3,0,1,0,76.14,59.24 ,33.33
01,000,02,009,0324,838,1062,16,1078,1915,0,3,1,3,0,1,0,76.14,56.29 ,33.33
01,000,02,009,0325,839,984,11,995,1688,0,3,1,3,0,1,0,76.14,58.95 ,33.33
01,000,02,009,0325,840,945,3,948,1566,0,3,1,3,0,1,0,76.14,60.54 ,33.33
01,000,02,009,0325,841,859,9,868,1529,0,3,1,3,0,1,0,76.14,56.77 ,33.33
01,000,02,009,0326,842,872,10,882,1533,0,3,1,3,0,1,0,76.14,57.53 ,33.33
01,000,02,009,0326,843,1117,12,1129,1786,0,3,1,3,0,1,0,76.14,63.21 ,33.33
01,000,02,009,0326,844,973,12,985,1682,0,3,1,3,0,1,0,76.14,58.56 ,33.33
01,000,02,009,0327,845,1211,7,1218,2018,0,3,1,3,0,1,0,76.14,60.36 ,33.33
01,000,02,009,0327,846,1105,9,1114,1946,0,3,1,3,0,1,0,76.14,57.25 ,33.33
01,000,02,009,0328,847,1052,7,1059,1703,0,3,1,3,0,1,0,76.14,62.18 ,33.33
01,000,02,009,0328,848,973,14,987,1602,0,3,1,3,0,1,0,76.14,61.61 ,33.33
01,000,02,009,0328,849,897,5,902,1458,0,3,1,3,0,1,0,76.14,61.87 ,33.33
01,000,02,009,0329,850,1053,12,1065,1765,0,3,1,3,0,1,0,76.14,60.34 ,33.33
01,000,02,009,0329,851,1114,11,1125,1782,0,3,1,3,0,1,0,76.14,63.13 ,33.33
01,000,02,009,0330,852,801,7,808,1262,0,3,1,3,0,1,0,76.14,64.03 ,33.33
01,000,02,009,0330,853,1230,7,1237,2141,0,3,1,3,0,1,0,76.14,57.78 ,33.33
01,000,02,009,0330,854,1168,7,1175,1983,0,3,1,3,0,1,0,76.14,59.25 ,33.33
01,000,02,009,0331,855,1104,4,1108,1703,0,3,1,3,0,1,0,76.14,65.06 ,33.33
01,000,02,009,0331,856,1218,10,1228,1903,0,3,1,3,0,1,0,76.14,64.53 ,33.33
01,000,02,009,0331,857,1269,15,1284,2112,0,3,1,3,0,1,0,76.14,60.80 ,33.33
01,000,02,010,0332,858,981,9,990,1502,0,3,1,3,0,1,0,76.14,65.91 ,33.33
01,000,02,010,0332,859,945,15,960,1449,0,3,1,3,0,1,0,76.14,66.25 ,33.33
01,000,02,010,0333,860,615,4,619,1067,0,3,1,3,0,1,0,76.14,58.01 ,33.33
01,000,02,010,0333,861,852,12,864,1316,0,3,1,3,0,1,0,76.14,65.65 ,33.33
01,000,02,010,0334,862,752,2,754,1098,0,3,1,3,0,1,0,76.14,68.67 ,33.33
01,000,02,010,0334,863,673,13,686,1052,0,3,1,3,0,1,0,76.14,65.21 ,33.33
01,000,02,010,0335,864,917,10,927,1381,0,3,1,3,0,1,0,76.14,67.13 ,33.33
01,000,02,010,0335,865,757,10,767,1162,0,3,1,3,0,1,0,76.14,66.01 ,33.33
01,000,02,010,0335,866,933,8,941,1426,0,3,1,3,0,1,0,76.14,65.99 ,33.33
01,000,02,010,0336,867,835,8,843,1302,0,3,1,3,0,1,0,76.14,64.75 ,33.33
01,000,02,010,0336,868,874,9,883,1394,0,3,1,3,0,1,0,76.14,63.34 ,33.33
01,000,02,010,0336,869,858,10,868,1430,0,3,1,3,0,1,0,76.14,60.70 ,33.33
01,000,02,010,0337,870,1054,5,1059,1652,0,3,1,3,0,1,0,76.14,64.10 ,33.33
01,000,02,010,0337,871,1025,7,1032,1605,0,3,1,3,0,1,0,76.14,64.30 ,33.33
01,000,02,010,0337,872,865,13,878,1354,0,3,1,3,0,1,0,76.14,64.84 ,33.33
01,000,02,010,0338,873,952,9,961,1485,0,3,1,3,0,1,0,76.14,64.71 ,33.33
01,000,02,010,0338,874,1025,9,1034,1542,0,3,1,3,0,1,0,76.14,67.06 ,33.33
01,000,02,010,0338,875,1013,19,1032,1552,0,3,1,3,0,1,0,76.14,66.49 ,33.33
01,000,02,010,0339,876,847,14,861,1337,0,3,1,3,0,1,0,76.14,64.40 ,33.33
01,000,02,010,0339,877,969,12,981,1523,0,3,1,3,0,1,0,76.14,64.41 ,33.33
01,000,02,010,0340,878,870,6,876,1310,0,3,1,3,0,1,0,76.14,66.87 ,33.33
01,000,02,010,0340,879,1017,9,1026,1472,0,3,1,3,0,1,0,76.14,69.70 ,33.33
01,000,02,010,0340,880,924,8,932,1340,0,3,1,3,0,1,0,76.14,69.55 ,33.33
01,000,02,010,0341,881,795,8,803,1232,0,3,1,3,0,1,0,76.14,65.18 ,33.33
01,000,02,010,0341,882,812,7,819,1215,0,3,1,3,0,1,0,76.14,67.41 ,33.33
01,000,02,010,0341,883,748,10,758,1169,0,3,1,3,0,1,0,76.14,64.84 ,33.33
01,000,02,010,0342,884,931,13,944,1377,0,3,1,3,0,1,0,76.14,68.55 ,33.33
01,000,02,010,0342,885,919,9,928,1506,0,3,1,3,0,1,0,76.14,61.62 ,33.33
01,000,02,010,0342,886,940,9,949,1428,0,3,1,3,0,1,0,76.14,66.46 ,33.33
01,000,02,010,0342,887,768,4,772,1214,0,3,1,3,0,1,0,76.14,63.59 ,33.33
01,000,02,010,0343,888,957,11,968,1446,0,3,1,3,0,1,0,76.14,66.94 ,33.33
01,000,02,010,0343,889,937,12,949,1456,0,3,1,3,0,1,0,76.14,65.18 ,33.33
01,000,02,010,0343,890,1022,15,1037,1535,0,3,1,3,0,1,0,76.14,67.56 ,33.33
01,000,02,010,0344,891,1222,24,1246,1816,0,3,1,3,0,1,0,76.14,68.61 ,33.33
01,000,02,010,0344,892,1293,11,1304,1967,0,3,1,3,0,1,0,76.14,66.29 ,33.33
01,000,02,010,0345,893,893,17,910,1450,0,3,1,3,0,1,0,76.14,62.76 ,33.33
01,000,02,010,0345,894,962,26,988,1527,0,3,1,3,0,1,0,76.14,64.70 ,33.33
01,000,02,010,0345,895,831,16,847,1366,0,3,1,3,0,1,0,76.14,62.01 ,33.33
01,000,02,010,0345,896,1093,18,1111,1682,0,3,1,3,0,1,0,76.14,66.05 ,33.33
01,000,02,010,0346,897,839,11,850,1203,0,3,1,3,0,1,0,76.14,70.66 ,33.33
01,000,02,010,0346,898,933,9,942,1432,0,3,1,3,0,1,0,76.14,65.78 ,33.33
01,000,02,010,0347,899,942,10,952,1448,0,3,1,3,0,1,0,76.14,65.75 ,33.33
01,000,02,010,0347,900,888,12,900,1404,0,3,1,3,0,1,0,76.14,64.10 ,33.33
01,000,02,010,0348,901,821,5,826,1191,0,3,1,3,0,1,0,76.14,69.35 ,33.33
01,000,02,010,0348,902,679,11,690,1110,0,3,1,3,0,1,0,76.14,62.16 ,33.33
01,000,02,010,0348,903,706,11,717,1170,0,3,1,3,0,1,0,76.14,61.28 ,33.33
01,000,02,010,0349,904,730,7,737,1141,0,3,1,3,0,1,0,76.14,64.59 ,33.33
01,000,02,010,0349,905,790,9,799,1256,0,3,1,3,0,1,0,76.14,63.61 ,33.33
01,000,02,010,0349,906,865,7,872,1248,0,3,1,3,0,1,0,76.14,69.87 ,33.33
01,000,02,010,0350,907,1003,12,1015,1483,0,3,1,3,0,1,0,76.14,68.44 ,33.33
01,000,02,010,0350,908,852,12,864,1355,0,3,1,3,0,1,0,76.14,63.76 ,33.33
01,000,02,010,0350,909,885,10,895,1378,0,3,1,3,0,1,0,76.14,64.95 ,33.33
01,000,02,010,0350,910,1265,5,1270,1735,0,3,1,3,0,1,0,76.14,73.20 ,33.33
01,000,02,010,0351,911,1005,11,1016,1520,0,3,1,3,0,1,0,76.14,66.84 ,33.33
01,000,02,010,0351,912,1003,5,1008,1492,0,3,1,3,0,1,0,76.14,67.56 ,33.33
01,000,02,010,0351,913,969,16,985,1437,0,3,1,3,0,1,0,76.14,68.55 ,33.33
01,000,02,010,0352,914,1143,7,1150,1613,0,3,1,3,0,1,0,76.14,71.30 ,33.33
01,000,02,010,0352,915,1228,13,1241,1729,0,3,1,3,0,1,0,76.14,71.78 ,33.33
01,000,02,010,0352,916,961,8,969,1412,0,3,1,3,0,1,0,76.14,68.63 ,33.33
01,000,02,010,0352,917,1111,18,1129,1606,0,3,1,3,0,1,0,76.14,70.30 ,33.33
01,000,02,010,0353,918,714,5,719,1274,0,3,1,3,0,1,0,76.14,56.44 ,33.33
01,000,02,010,0354,919,861,12,873,1559,0,3,1,3,0,1,0,76.14,56.00 ,33.33
01,000,02,010,0354,920,851,7,858,1459,0,3,1,3,0,1,0,76.14,58.81 ,33.33
01,000,02,010,0355,921,1176,16,1192,2076,0,3,1,3,0,1,0,76.14,57.42 ,33.33
01,000,02,010,0356,922,1125,10,1135,1733,0,3,1,3,0,1,0,76.14,65.49 ,33.33
01,000,02,010,0356,923,815,11,826,1213,0,3,1,3,0,1,0,76.14,68.10 ,33.33
01,000,02,010,0357,924,758,8,766,1291,0,3,1,3,0,1,0,76.14,59.33 ,33.33
01,000,02,010,0357,925,721,5,726,1190,0,3,1,3,0,1,0,76.14,61.01 ,33.33
01,000,02,010,0357,926,718,9,727,1170,0,3,1,3,0,1,0,76.14,62.14 ,33.33
01,000,02,010,0358,927,793,9,802,1364,0,3,1,3,0,1,0,76.14,58.80 ,33.33
01,000,02,010,0358,928,567,7,574,950,0,3,1,3,0,1,0,76.14,60.42 ,33.33
01,000,02,010,0358,929,849,13,862,1375,0,3,1,3,0,1,0,76.14,62.69 ,33.33
01,000,02,010,0359,930,766,15,781,1266,0,3,1,3,0,1,0,76.14,61.69 ,33.33
01,000,02,010,0359,931,867,11,878,1459,0,3,1,3,0,1,0,76.14,60.18 ,33.33
01,000,02,010,0360,932,909,7,916,1382,0,3,1,3,0,1,0,76.14,66.28 ,33.33
01,000,02,010,0360,933,769,5,774,1275,0,3,1,3,0,1,0,76.14,60.71 ,33.33
01,000,02,010,0360,934,816,9,825,1348,0,3,1,3,0,1,0,76.14,61.20 ,33.33
01,000,02,010,0361,935,921,5,926,1331,0,3,1,3,0,1,0,76.14,69.57 ,33.33
01,000,02,010,0361,936,747,12,759,1129,0,3,1,3,0,1,0,76.14,67.23 ,33.33
01,000,02,010,0361,937,861,3,864,1274,0,3,1,3,0,1,0,76.14,67.82 ,33.33
01,000,02,010,0361,938,1021,6,1027,1493,0,3,1,3,0,1,0,76.14,68.79 ,33.33
01,000,02,010,0362,939,873,7,880,1303,0,3,1,3,0,1,0,76.14,67.54 ,33.33
01,000,02,010,0362,940,711,5,716,1062,0,3,1,3,0,1,0,76.14,67.42 ,33.33
01,000,02,010,0362,941,1092,11,1103,1769,0,3,1,3,0,1,0,76.14,62.35 ,33.33
01,000,02,010,0362,942,1300,14,1314,2049,0,3,1,3,0,1,0,76.14,64.13 ,33.33
01,000,02,011,0363,943,1181,20,1201,2019,0,3,1,3,0,1,0,76.14,59.48 ,33.33
01,000,02,011,0363,944,1057,14,1071,1888,0,3,1,3,0,1,0,76.14,56.73 ,33.33
01,000,02,011,0364,945,790,9,799,1376,0,3,1,3,0,1,0,76.14,58.07 ,33.33
01,000,02,011,0364,946,679,14,693,1194,0,3,1,3,0,1,0,76.14,58.04 ,33.33
01,000,02,011,0365,947,790,10,800,1371,0,3,1,3,0,1,0,76.14,58.35 ,33.33
01,000,02,011,0365,948,838,17,855,1449,0,3,1,3,0,1,0,76.14,59.01 ,33.33
01,000,02,011,0366,949,1216,15,1231,1788,0,3,1,3,0,1,0,76.14,68.85 ,33.33
01,000,02,011,0366,950,1177,21,1198,1764,0,3,1,3,0,1,0,76.14,67.91 ,33.33
01,000,02,011,0366,951,1180,21,1201,1856,0,3,1,3,0,1,0,76.14,64.71 ,33.33
01,000,02,011,0367,952,871,16,887,1488,0,3,1,3,0,1,0,76.14,59.61 ,33.33
01,000,02,011,0367,953,799,18,817,1148,0,3,1,3,0,1,0,76.14,71.17 ,33.33
01,000,02,011,0367,954,1204,26,1230,1878,0,3,1,3,0,1,0,76.14,65.50 ,33.33
01,000,02,011,0368,955,873,7,880,1372,0,3,1,3,0,1,0,76.14,64.14 ,33.33
01,000,02,011,0368,956,962,18,980,1517,0,3,1,3,0,1,0,76.14,64.60 ,33.33
01,000,02,011,0368,957,796,18,814,1306,0,3,1,3,0,1,0,76.14,62.33 ,33.33
01,000,02,011,0369,958,866,9,875,1292,0,3,1,3,0,1,0,76.14,67.72 ,33.33
01,000,02,011,0369,959,881,17,898,1393,0,3,1,3,0,1,0,76.14,64.47 ,33.33
01,000,02,011,0369,960,820,7,827,1236,0,3,1,3,0,1,0,76.14,66.91 ,33.33
01,000,02,011,0370,961,1212,14,1226,1776,0,3,1,3,0,1,0,76.14,69.03 ,33.33
01,000,02,011,0370,962,974,6,980,1476,0,3,1,3,0,1,0,76.14,66.40 ,33.33
01,000,02,011,0371,963,1319,20,1339,1862,0,3,1,3,0,1,0,76.14,71.91 ,33.33
01,000,02,011,0371,964,1194,20,1214,1737,0,3,1,3,0,1,0,76.14,69.89 ,33.33
01,000,02,011,0372,965,816,7,823,1193,0,3,1,3,0,1,0,76.14,68.99 ,33.33
01,000,02,011,0372,966,863,9,872,1252,0,3,1,3,0,1,0,76.14,69.65 ,33.33
01,000,02,011,0372,967,859,11,870,1305,0,3,1,3,0,1,0,76.14,66.67 ,33.33
01,000,02,011,0373,968,1302,21,1323,2035,0,3,1,3,0,1,0,76.14,65.01 ,33.33
01,000,02,011,0373,969,1051,21,1072,1543,0,3,1,3,0,1,0,76.14,69.48 ,33.33
01,000,02,011,0373,970,1019,22,1041,1500,0,3,1,3,0,1,0,76.14,69.40 ,33.33
01,000,02,011,0373,971,911,14,925,1419,0,3,1,3,0,1,0,76.14,65.19 ,33.33
01,000,02,011,0374,972,737,9,746,1107,0,3,1,3,0,1,0,76.14,67.39 ,33.33
01,000,02,011,0374,973,703,12,715,1077,0,3,1,3,0,1,0,76.14,66.39 ,33.33
01,000,02,011,0374,974,1170,22,1192,1848,0,3,1,3,0,1,0,76.14,64.50 ,33.33
01,000,02,011,0375,975,1060,12,1072,1669,0,3,1,3,0,1,0,76.14,64.23 ,33.33
01,000,02,011,0375,976,1326,7,1333,1854,0,3,1,3,0,1,0,76.14,71.90 ,33.33
01,000,02,011,0376,977,1332,11,1343,1789,0,3,1,3,0,1,0,76.14,75.07 ,33.33
01,000,02,011,0376,978,1220,13,1233,1734,0,3,1,3,0,1,0,76.14,71.11 ,33.33
01,000,02,011,0376,979,1306,13,1319,1907,0,3,1,3,0,1,0,76.14,69.17 ,33.33
01,000,02,011,0376,980,1167,12,1179,1769,0,3,1,3,0,1,0,76.14,66.65 ,33.33
01,000,02,011,0377,981,977,21,998,1595,0,3,1,3,0,1,0,76.14,62.57 ,33.33
01,000,02,011,0377,982,1237,16,1253,1913,0,3,1,3,0,1,0,76.14,65.50 ,33.33
01,000,02,011,0378,983,1085,12,1097,1685,0,3,1,3,0,1,0,76.14,65.10 ,33.33
01,000,02,011,0378,984,1073,11,1084,1643,0,3,1,3,0,1,0,76.14,65.98 ,33.33
01,000,02,011,0378,985,797,14,811,1208,0,3,1,3,0,1,0,76.14,67.14 ,33.33
01,000,02,011,0378,986,948,14,962,1463,0,3,1,3,0,1,0,76.14,65.76 ,33.33
01,000,02,011,0379,987,1085,10,1095,1704,0,3,1,3,0,1,0,76.14,64.26 ,33.33
01,000,02,011,0379,988,888,8,896,1565,0,3,1,3,0,1,0,76.14,57.25 ,33.33
01,000,02,011,0379,989,1035,18,1053,1648,0,3,1,3,0,1,0,76.14,63.90 ,33.33
01,000,02,011,0380,990,1256,12,1268,1946,0,3,1,3,0,1,0,76.14,65.16 ,33.33
01,000,02,011,0380,991,1243,12,1255,1811,0,3,1,3,0,1,0,76.14,69.30 ,33.33
01,000,02,011,0380,992,981,14,995,1483,0,3,1,3,0,1,0,76.14,67.09 ,33.33
01,000,02,011,0380,993,994,19,1013,1646,0,3,1,3,0,1,0,76.14,61.54 ,33.33
01,000,02,011,0381,994,1499,21,1520,2412,0,3,1,3,0,1,0,76.14,63.02 ,33.33
01,000,02,011,0381,995,1412,18,1430,2201,0,3,1,3,0,1,0,76.14,64.97 ,33.33
01,000,02,011,0382,996,1091,20,1111,1726,0,3,1,3,0,1,0,76.14,64.37 ,33.33
01,000,02,011,0382,997,858,14,872,1307,0,3,1,3,0,1,0,76.14,66.72 ,33.33
01,000,02,011,0383,998,1095,23,1118,1850,0,3,1,3,0,1,0,76.14,60.43 ,33.33
01,000,02,011,0383,999,1258,16,1274,1950,0,3,1,3,0,1,0,76.14,65.33 ,33.33
01,000,02,011,0383,1000,1365,22,1387,1923,0,3,1,3,0,1,0,76.14,72.13 ,33.33
01,000,02,011,0384,1001,1302,14,1316,2071,0,3,1,3,0,1,0,76.14,63.54 ,33.33
01,000,02,011,0384,1002,1037,11,1048,1494,0,3,1,3,0,1,0,76.14,70.15 ,33.33
01,000,02,011,0385,1003,942,9,951,1442,0,3,1,3,0,1,0,76.14,65.95 ,33.33
01,000,02,011,0385,1004,812,9,821,1231,0,3,1,3,0,1,0,76.14,66.69 ,33.33
01,000,02,011,0386,1005,1204,16,1220,1891,0,3,1,3,0,1,0,76.14,64.52 ,33.33
01,000,02,011,0386,1006,1227,35,1262,2038,0,3,1,3,0,1,0,76.14,61.92 ,33.33
01,000,02,011,0386,1007,1198,18,1216,1909,0,3,1,3,0,1,0,76.14,63.70 ,33.33
01,000,02,011,0387,1008,1485,27,1512,2302,0,3,1,3,0,1,0,76.14,65.68 ,33.33
01,000,02,011,0387,1009,1208,15,1223,1892,0,3,1,3,0,1,0,76.14,64.64 ,33.33
01,000,02,011,0388,1010,1109,16,1125,1721,0,3,1,3,0,1,0,76.14,65.37 ,33.33
01,000,02,011,0388,1011,986,12,998,1565,0,3,1,3,0,1,0,76.14,63.77 ,33.33
01,000,02,011,0389,1012,831,12,843,1248,0,3,1,3,0,1,0,76.14,67.55 ,33.33
01,000,02,011,0389,1013,845,12,857,1248,0,3,1,3,0,1,0,76.14,68.67 ,33.33
01,000,02,011,0390,1014,1316,15,1331,1993,0,3,1,3,0,1,0,76.14,66.78 ,33.33
01,000,02,011,0390,1015,1172,27,1199,1851,0,3,1,3,0,1,0,76.14,64.78 ,33.33
01,000,02,011,0391,1016,1135,17,1152,1751,0,3,1,3,0,1,0,76.14,65.79 ,33.33
01,000,02,011,0391,1017,1019,23,1042,1517,0,3,1,3,0,1,0,76.14,68.69 ,33.33
01,000,02,011,0392,1018,1005,12,1017,1476,0,3,1,3,0,1,0,76.14,68.90 ,33.33
01,000,02,011,0392,1019,719,11,730,1133,0,3,1,3,0,1,0,76.14,64.43 ,33.33
01,000,02,011,0392,1020,889,12,901,1385,0,3,1,3,0,1,0,76.14,65.05 ,33.33
01,000,02,011,0393,1021,1247,15,1262,1937,0,3,1,3,0,1,0,76.14,65.15 ,33.33
01,000,02,011,0393,1022,1112,25,1137,1871,0,3,1,3,0,1,0,76.14,60.77 ,33.33
01,000,02,011,0394,1023,1218,20,1238,1935,0,3,1,3,0,1,0,76.14,63.98 ,33.33
01,000,02,011,0394,1024,1116,14,1130,1792,0,3,1,3,0,1,0,76.14,63.06 ,33.33
01,000,02,011,0394,1025,1034,16,1050,1581,0,3,1,3,0,1,0,76.14,66.41 ,33.33
01,000,02,011,0395,1026,800,11,811,1234,0,3,1,3,0,1,0,76.14,65.72 ,33.33
01,000,02,011,0395,1027,953,10,963,1491,0,3,1,3,0,1,0,76.14,64.59 ,33.33
01,000,02,011,0395,1028,901,3,904,1283,0,3,1,3,0,1,0,76.14,70.46 ,33.33
01,000,02,011,0396,1029,1579,23,1602,2184,0,3,1,3,0,1,0,76.14,73.35 ,33.33
01,000,02,011,0396,1030,1236,29,1265,2242,0,3,1,3,0,1,0,76.14,56.42 ,33.33
01,000,02,011,0397,1031,1148,18,1166,1787,0,3,1,3,0,1,0,76.14,65.25 ,33.33
01,000,02,011,0397,1032,1321,21,1342,1944,0,3,1,3,0,1,0,76.14,69.03 ,33.33
01,000,02,011,0398,1033,809,9,818,1187,0,3,1,3,0,1,0,76.14,68.91 ,33.33
01,000,02,011,0398,1034,823,9,832,1243,0,3,1,3,0,1,0,76.14,66.93 ,33.33
01,000,02,012,0399,1035,843,17,860,1257,0,3,1,3,0,1,0,76.14,68.42 ,33.33
01,000,02,012,0399,1036,747,11,758,1141,0,3,1,3,0,1,0,76.14,66.43 ,33.33
01,000,02,012,0399,1037,891,10,901,1367,0,3,1,3,0,1,0,76.14,65.91 ,33.33
01,000,02,012,0400,1038,816,9,825,1249,0,3,1,3,0,1,0,76.14,66.05 ,33.33
01,000,02,012,0400,1039,825,5,830,1297,0,3,1,3,0,1,0,76.14,63.99 ,33.33
01,000,02,012,0400,1040,1116,6,1122,1651,0,3,1,3,0,1,0,76.14,67.96 ,33.33
01,000,02,012,0401,1041,1145,11,1156,1684,0,3,1,3,0,1,0,76.14,68.65 ,33.33
01,000,02,012,0401,1042,1040,14,1054,1604,0,3,1,3,0,1,0,76.14,65.71 ,33.33
01,000,02,012,0402,1043,956,15,971,1358,0,3,1,3,0,1,0,76.14,71.50 ,33.33
01,000,02,012,0402,1044,1073,10,1083,1607,0,3,1,3,0,1,0,76.14,67.39 ,33.33
01,000,02,012,0402,1045,1095,8,1103,1601,0,3,1,3,0,1,0,76.14,68.89 ,33.33
01,000,02,012,0403,1046,697,11,708,1103,0,3,1,3,0,1,0,76.14,64.19 ,33.33
01,000,02,012,0403,1047,1421,15,1436,2064,0,3,1,3,0,1,0,76.14,69.57 ,33.33
01,000,02,012,0404,1048,1062,12,1074,1690,0,3,1,3,0,1,0,76.14,63.55 ,33.33
01,000,02,012,0404,1049,859,8,867,1300,0,3,1,3,0,1,0,76.14,66.69 ,33.33
01,000,02,012,0404,1050,986,6,992,1420,0,3,1,3,0,1,0,76.14,69.86 ,33.33
01,000,02,012,0405,1051,1128,13,1141,1624,0,3,1,3,0,1,0,76.14,70.26 ,33.33
01,000,02,012,0405,1052,1310,9,1319,1937,0,3,1,3,0,1,0,76.14,68.09 ,33.33
01,000,02,012,0406,1053,844,15,859,1231,0,3,1,3,0,1,0,76.14,69.78 ,33.33
01,000,02,012,0406,1054,768,7,775,1180,0,3,1,3,0,1,0,76.14,65.68 ,33.33
01,000,02,012,0406,1055,928,10,938,1317,0,3,1,3,0,1,0,76.14,71.22 ,33.33
01,000,02,012,0407,1056,834,9,843,1243,0,3,1,3,0,1,0,76.14,67.82 ,33.33
01,000,02,012,0407,1057,912,5,917,1357,0,3,1,3,0,1,0,76.14,67.58 ,33.33
01,000,02,012,0407,1058,1049,4,1053,1528,0,3,1,3,0,1,0,76.14,68.91 ,33.33
01,000,02,012,0408,1059,911,9,920,1479,0,3,1,3,0,1,0,76.14,62.20 ,33.33
01,000,02,012,0408,1060,827,10,837,1312,0,3,1,3,0,1,0,76.14,63.80 ,33.33
01,000,02,012,0408,1061,976,6,982,1411,0,3,1,3,0,1,0,76.14,69.60 ,33.33
01,000,02,012,0409,1062,1116,11,1127,1510,0,3,1,3,0,1,0,76.14,74.64 ,33.33
01,000,02,012,0409,1063,1092,11,1103,1426,0,3,1,3,0,1,0,76.14,77.35 ,33.33
01,000,02,012,0410,1064,829,3,832,1250,0,3,1,3,0,1,0,76.14,66.56 ,33.33
01,000,02,012,0410,1065,734,12,746,1114,0,3,1,3,0,1,0,76.14,66.97 ,33.33
01,000,02,012,0410,1066,888,8,896,1315,0,3,1,3,0,1,0,76.14,68.14 ,33.33
01,000,02,012,0411,1067,1141,10,1151,1697,0,3,1,3,0,1,0,76.14,67.83 ,33.33
01,000,02,012,0411,1068,1137,10,1147,1623,0,3,1,3,0,1,0,76.14,70.67 ,33.33
01,000,02,012,0411,1069,1166,7,1173,1709,0,3,1,3,0,1,0,76.14,68.64 ,33.33
01,000,02,012,0412,1070,962,12,974,1533,0,3,1,3,0,1,0,76.14,63.54 ,33.33
01,000,02,012,0412,1071,1018,8,1026,1613,0,3,1,3,0,1,0,76.14,63.61 ,33.33
01,000,02,012,0413,1072,854,8,862,1258,0,3,1,3,0,1,0,76.14,68.52 ,33.33
01,000,02,012,0413,1073,983,10,993,1437,0,3,1,3,0,1,0,76.14,69.10 ,33.33
01,000,02,012,0414,1074,993,22,1015,1495,0,3,1,3,0,1,0,76.14,67.89 ,33.33
01,000,02,012,0414,1075,1140,12,1152,1732,0,3,1,3,0,1,0,76.14,66.51 ,33.33
01,000,02,012,0414,1076,967,8,975,1483,0,3,1,3,0,1,0,76.14,65.75 ,33.33
01,000,02,012,0414,1077,853,10,863,1374,0,3,1,3,0,1,0,76.14,62.81 ,33.33
01,000,02,012,0415,1078,836,7,843,1230,0,3,1,3,0,1,0,76.14,68.54 ,33.33
01,000,02,012,0415,1079,940,11,951,1362,0,3,1,3,0,1,0,76.14,69.82 ,33.33
01,000,02,012,0415,1080,907,9,916,1339,0,3,1,3,0,1,0,76.14,68.41 ,33.33
01,000,02,012,0416,1081,907,13,920,1351,0,3,1,3,0,1,0,76.14,68.10 ,33.33
01,000,02,012,0416,1082,718,10,728,1119,0,3,1,3,0,1,0,76.14,65.06 ,33.33
01,000,02,012,0416,1083,804,14,818,1252,0,3,1,3,0,1,0,76.14,65.34 ,33.33
01,000,02,012,0417,1084,944,14,958,1405,0,3,1,3,0,1,0,76.14,68.19 ,33.33
01,000,02,012,0417,1085,991,14,1005,1452,0,3,1,3,0,1,0,76.14,69.21 ,33.33
01,000,02,012,0417,1086,1032,15,1047,1503,0,3,1,3,0,1,0,76.14,69.66 ,33.33
01,000,02,012,0418,1087,1289,19,1308,1870,0,3,1,3,0,1,0,76.14,69.95 ,33.33
01,000,02,012,0418,1088,1277,12,1289,1943,0,3,1,3,0,1,0,76.14,66.34 ,33.33
01,000,02,012,0419,1089,834,9,843,1246,0,3,1,3,0,1,0,76.14,67.66 ,33.33
01,000,02,012,0419,1090,896,16,912,1329,0,3,1,3,0,1,0,76.14,68.62 ,33.33
01,000,02,012,0420,1091,926,11,937,1408,0,3,1,3,0,1,0,76.14,66.55 ,33.33
01,000,02,012,0420,1092,1059,6,1065,1554,0,3,1,3,0,1,0,76.14,68.53 ,33.33
01,000,02,012,0421,1093,1115,12,1127,1552,0,3,1,3,0,1,0,76.14,72.62 ,33.33
01,000,02,012,0421,1094,865,6,871,1274,0,3,1,3,0,1,0,76.14,68.37 ,33.33
01,000,02,012,0421,1095,1083,12,1095,1606,0,3,1,3,0,1,0,76.14,68.18 ,33.33
01,000,02,012,0422,1096,1222,8,1230,1759,0,3,1,3,0,1,0,76.14,69.93 ,33.33
01,000,02,012,0422,1097,1089,19,1108,1661,0,3,1,3,0,1,0,76.14,66.71 ,33.33
01,000,02,012,0422,1098,1077,7,1084,1590,0,3,1,3,0,1,0,76.14,68.18 ,33.33
01,000,02,012,0423,1099,1041,35,1076,1659,0,3,1,3,0,1,0,76.14,64.86 ,33.33
01,000,02,012,0423,1100,1091,34,1125,1774,0,3,1,3,0,1,0,76.14,63.42 ,33.33
01,000,02,012,0424,1101,1038,17,1055,1532,0,3,1,3,0,1,0,76.14,68.86 ,33.33
01,000,02,012,0424,1102,920,9,929,1376,0,3,1,3,0,1,0,76.14,67.51 ,33.33
01,000,02,012,0424,1103,917,11,928,1338,0,3,1,3,0,1,0,76.14,69.36 ,33.33
01,000,02,012,0425,1104,1144,13,1157,1664,0,3,1,3,0,1,0,76.14,69.53 ,33.33
01,000,02,012,0425,1105,1334,9,1343,1774,0,3,1,3,0,1,0,76.14,75.70 ,33.33
01,000,02,012,0425,1106,1176,19,1195,1725,0,3,1,3,0,1,0,76.14,69.28 ,33.33
01,000,02,012,0426,1107,920,19,939,1456,0,3,1,3,0,1,0,76.14,64.49 ,33.33
01,000,02,012,0426,1108,859,19,878,1346,0,3,1,3,0,1,0,76.14,65.23 ,33.33
01,000,02,012,0426,1109,992,12,1004,1464,0,3,1,3,0,1,0,76.14,68.58 ,33.33
01,000,02,012,0426,1110,1026,9,1035,1553,0,3,1,3,0,1,0,76.14,66.65 ,33.33
01,000,02,012,0427,1111,1468,11,1479,2161,0,3,1,3,0,1,0,76.14,68.44 ,33.33
01,000,02,012,0427,1112,1414,14,1428,2038,0,3,1,3,0,1,0,76.14,70.07 ,33.33
01,000,02,012,0427,1113,1215,21,1236,1742,0,3,1,3,0,1,0,76.14,70.95 ,33.33
01,000,02,012,0427,1114,685,8,693,948,0,3,1,3,0,1,0,76.14,73.10 ,33.33
01,000,02,012,0428,1115,980,4,984,1419,0,3,1,3,0,1,0,76.14,69.34 ,33.33
01,000,02,012,0428,1116,1047,13,1060,1504,0,3,1,3,0,1,0,76.14,70.48 ,33.33
01,000,02,012,0428,1117,1044,9,1053,1532,0,3,1,3,0,1,0,76.14,68.73 ,33.33
01,000,02,012,0428,1118,1108,15,1123,1649,0,3,1,3,0,1,0,76.14,68.10 ,33.33
01,000,02,012,0429,1119,1022,12,1034,1500,0,3,1,3,0,1,0,76.14,68.93 ,33.33
01,000,02,012,0429,1120,849,20,869,1272,0,3,1,3,0,1,0,76.14,68.32 ,33.33
01,000,02,012,0429,1121,1183,38,1221,1819,0,3,1,3,0,1,0,76.14,67.12 ,33.33
01,000,02,012,0429,1122,1728,17,1745,2475,0,3,1,3,0,1,0,76.14,70.51 ,33.33
01,000,02,012,0430,1123,1114,6,1120,1667,0,3,1,3,0,1,0,76.14,67.19 ,33.33
01,000,02,012,0430,1124,1137,16,1153,1606,0,3,1,3,0,1,0,76.14,71.79 ,33.33
01,000,02,012,0430,1125,1035,19,1054,1519,0,3,1,3,0,1,0,76.14,69.39 ,33.33
01,000,02,012,0430,1126,1137,14,1151,1654,0,3,1,3,0,1,0,76.14,69.59 ,33.33
01,000,02,012,0431,1127,1086,10,1096,1588,0,3,1,3,0,1,0,76.14,69.02 ,33.33
01,000,02,012,0431,1128,1187,16,1203,1722,0,3,1,3,0,1,0,76.14,69.86 ,33.33
01,000,02,012,0431,1129,1305,12,1317,1788,0,3,1,3,0,1,0,76.14,73.66 ,33.33
01,000,02,012,0431,1130,1136,9,1145,1718,0,3,1,3,0,1,0,76.14,66.65 ,33.33
01,000,02,012,0432,1131,761,26,787,1291,0,3,1,3,0,1,0,76.14,60.96 ,33.33
01,000,02,012,0432,1132,1032,14,1046,1548,0,3,1,3,0,1,0,76.14,67.57 ,33.33
01,000,02,012,0433,1133,854,13,867,1393,0,3,1,3,0,1,0,76.14,62.24 ,33.33
01,000,02,012,0433,1134,1151,17,1168,1701,0,3,1,3,0,1,0,76.14,68.67 ,33.33
01,000,02,012,0433,1135,1081,15,1096,1683,0,3,1,3,0,1,0,76.14,65.12 ,33.33
01,000,02,012,0434,1136,1211,20,1231,1870,0,3,1,3,0,1,0,76.14,65.83 ,33.33
01,000,02,012,0435,1137,378,6,384,578,0,3,1,3,0,1,0,76.14,66.44 ,33.33
02,000,01,001,0001,1,704,13,717,978,0,3,1,3,0,1,0,76.14,73.31 ,33.33
02,000,01,001,0002,2,933,23,956,1302,0,3,1,3,0,1,0,76.14,73.43 ,33.33
02,000,01,001,0003,3,497,12,509,691,0,3,1,3,0,1,0,76.14,73.66 ,33.33
02,000,01,001,0004,4,587,8,595,749,0,3,1,3,0,1,0,76.14,79.44 ,33.33
02,000,01,001,0005,5,982,15,997,1384,0,3,1,3,0,1,0,76.14,72.04 ,33.33
02,000,01,001,0006,6,869,14,883,1239,0,3,1,3,0,1,0,76.14,71.27 ,33.33
02,000,01,001,0007,7,498,16,514,705,0,3,1,3,0,1,0,76.14,72.91 ,33.33
02,000,01,001,0008,8,1162,13,1175,1742,0,3,1,3,0,1,0,76.14,67.45 ,33.33
02,000,01,001,0009,9,571,7,578,760,0,3,1,3,0,1,0,76.14,76.05 ,33.33
02,000,01,001,0010,10,556,9,565,760,0,3,1,3,0,1,0,76.14,74.34 ,33.33
02,000,01,001,0011,11,1583,27,1610,2212,0,3,1,3,0,1,0,76.14,72.78 ,33.33
02,000,01,001,0012,12,895,12,907,1307,0,3,1,3,0,1,0,76.14,69.40 ,33.33
02,000,01,001,0013,13,532,8,540,716,0,3,1,3,0,1,0,76.14,75.42 ,33.33
02,000,01,001,0014,14,880,20,900,1223,0,3,1,3,0,1,0,76.14,73.59 ,33.33
02,000,01,001,0015,15,664,11,675,942,0,3,1,3,0,1,0,76.14,71.66 ,33.33
02,000,01,001,0016,16,613,21,634,853,0,3,1,3,0,1,0,76.14,74.33 ,33.33
02,000,01,001,0017,17,1340,15,1355,1908,0,3,1,3,0,1,0,76.14,71.02 ,33.33
02,000,01,001,0018,18,851,10,861,1209,0,3,1,3,0,1,0,76.14,71.22 ,33.33
02,000,01,001,0019,19,782,11,793,1155,0,3,1,3,0,1,0,76.14,68.66 ,33.33
02,000,01,001,0020,20,632,16,648,911,0,3,1,3,0,1,0,76.14,71.13 ,33.33
02,000,01,001,0021,21,727,13,740,1020,0,3,1,3,0,1,0,76.14,72.55 ,33.33
02,000,01,002,0022,22,1465,31,1496,2083,0,3,1,3,0,1,0,76.14,71.82 ,33.33
02,000,01,002,0023,23,742,9,751,989,0,3,1,3,0,1,0,76.14,75.94 ,33.33
02,000,01,002,0023,24,767,6,773,1049,0,3,1,3,0,1,0,76.14,73.69 ,33.33
02,000,01,002,0024,25,1016,13,1029,1334,0,3,1,3,0,1,0,76.14,77.14 ,33.33
02,000,01,002,0024,26,1204,12,1216,1497,0,3,1,3,0,1,0,76.14,81.23 ,33.33
02,000,01,002,0024,27,903,6,909,1185,0,3,1,3,0,1,0,76.14,76.71 ,33.33
02,000,01,002,0025,28,841,11,852,1173,0,3,1,3,0,1,0,76.14,72.63 ,33.33
02,000,01,002,0025,29,1130,11,1141,1504,0,3,1,3,0,1,0,76.14,75.86 ,33.33
02,000,01,002,0025,30,946,8,954,1230,0,3,1,3,0,1,0,76.14,77.56 ,33.33
02,000,01,002,0026,31,1067,29,1096,1494,0,3,1,3,0,1,0,76.14,73.36 ,33.33
02,000,01,002,0027,32,658,5,663,876,0,3,1,3,0,1,0,76.14,75.68 ,33.33
02,000,01,002,0028,33,899,12,911,1206,0,3,1,3,0,1,0,76.14,75.54 ,33.33
02,000,01,002,0029,34,841,7,848,1063,0,3,1,3,0,1,0,76.14,79.77 ,33.33
02,000,01,002,0029,35,741,13,754,996,0,3,1,3,0,1,0,76.14,75.70 ,33.33
02,000,01,002,0030,36,1169,13,1182,1555,0,3,1,3,0,1,0,76.14,76.01 ,33.33
02,000,01,002,0031,37,913,13,926,1299,0,3,1,3,0,1,0,76.14,71.29 ,33.33
02,000,01,002,0031,38,1275,22,1297,1788,0,3,1,3,0,1,0,76.14,72.54 ,33.33
02,000,01,002,0031,39,1049,7,1056,1402,0,3,1,3,0,1,0,76.14,75.32 ,33.33
02,000,01,002,0032,40,1087,11,1098,1499,0,3,1,3,0,1,0,76.14,73.25 ,33.33
02,000,01,002,0033,41,995,12,1007,1333,0,3,1,3,0,1,0,76.14,75.54 ,33.33
02,000,01,002,0033,42,1105,15,1120,1487,0,3,1,3,0,1,0,76.14,75.32 ,33.33
02,000,01,002,0034,43,1519,23,1542,2042,0,3,1,3,0,1,0,76.14,75.51 ,33.33
02,000,01,002,0035,44,1497,11,1508,1968,0,3,1,3,0,1,0,76.14,76.63 ,33.33
02,000,01,002,0036,45,1186,22,1208,1705,0,3,1,3,0,1,0,76.14,70.85 ,33.33
02,000,01,002,0036,46,1380,21,1401,1965,0,3,1,3,0,1,0,76.14,71.30 ,33.33
02,000,01,002,0037,47,1705,17,1722,2305,0,3,1,3,0,1,0,76.14,74.71 ,33.33
02,000,01,002,0037,48,2008,30,2038,2871,0,3,1,3,0,1,0,76.14,70.99 ,33.33
02,000,01,002,0038,49,937,7,944,1349,0,3,1,3,0,1,0,76.14,69.98 ,33.33
02,000,01,002,0039,50,1072,8,1080,1461,0,3,1,3,0,1,0,76.14,73.92 ,33.33
02,000,01,002,0039,51,1211,10,1221,1632,0,3,1,3,0,1,0,76.14,74.82 ,33.33
02,000,01,002,0040,52,728,3,731,981,0,3,1,3,0,1,0,76.14,74.52 ,33.33
02,000,01,002,0040,53,905,5,910,1247,0,3,1,3,0,1,0,76.14,72.98 ,33.33
02,000,01,002,0041,54,855,13,868,1180,0,3,1,3,0,1,0,76.14,73.56 ,33.33
02,000,01,002,0041,55,730,8,738,1012,0,3,1,3,0,1,0,76.14,72.92 ,33.33
02,000,01,002,0042,56,702,5,707,920,0,3,1,3,0,1,0,76.14,76.85 ,33.33
02,000,01,002,0042,57,634,12,646,885,0,3,1,3,0,1,0,76.14,72.99 ,33.33
02,000,01,002,0043,58,759,6,765,1006,0,3,1,3,0,1,0,76.14,76.04 ,33.33
02,000,01,002,0044,59,688,10,698,961,0,3,1,3,0,1,0,76.14,72.63 ,33.33
02,000,01,002,0045,60,1258,18,1276,1722,0,3,1,3,0,1,0,76.14,74.10 ,33.33
02,000,01,002,0046,61,1301,15,1316,1901,0,3,1,3,0,1,0,76.14,69.23 ,33.33
02,000,01,002,0047,62,1151,15,1166,1561,0,3,1,3,0,1,0,76.14,74.70 ,33.33
02,000,01,002,0048,63,1175,15,1190,1702,0,3,1,3,0,1,0,76.14,69.92 ,33.33
02,000,01,002,0049,64,1140,14,1154,1609,0,3,1,3,0,1,0,76.14,71.72 ,33.33
02,000,01,002,0050,65,592,12,604,878,0,3,1,3,0,1,0,76.14,68.79 ,33.33
02,000,01,002,0051,66,857,48,905,1265,0,3,1,3,0,1,0,76.14,71.54 ,33.33
02,000,01,002,0052,67,929,14,943,1296,0,3,1,3,0,1,0,76.14,72.76 ,33.33
02,000,01,002,0053,68,773,25,798,1128,0,3,1,3,0,1,0,76.14,70.74 ,33.33
02,000,01,002,0054,69,1160,17,1177,1672,0,3,1,3,0,1,0,76.14,70.39 ,33.33
02,000,01,002,0055,70,886,11,897,1295,0,3,1,3,0,1,0,76.14,69.27 ,33.33
02,000,01,002,0056,71,981,17,998,1493,0,3,1,3,0,1,0,76.14,66.85 ,33.33
02,000,01,002,0057,72,1232,18,1250,1772,0,3,1,3,0,1,0,76.14,70.54 ,33.33
02,000,01,002,0058,73,779,5,784,1133,0,3,1,3,0,1,0,76.14,69.20 ,33.33
02,000,01,002,0059,74,398,4,402,525,0,3,1,3,0,1,0,76.14,76.57 ,33.33
02,000,01,003,0060,75,972,28,1000,1328,0,3,1,3,0,1,0,76.14,75.30 ,33.33
02,000,01,003,0061,76,845,13,858,1231,0,3,1,3,0,1,0,76.14,69.70 ,33.33
02,000,01,003,0062,77,1269,30,1299,1745,0,3,1,3,0,1,0,76.14,74.44 ,33.33
02,000,01,003,0063,78,846,13,859,1154,0,3,1,3,0,1,0,76.14,74.44 ,33.33
02,000,01,003,0063,79,659,12,671,991,0,3,1,3,0,1,0,76.14,67.71 ,33.33
02,000,01,003,0064,80,987,17,1004,1342,0,3,1,3,0,1,0,76.14,74.81 ,33.33
02,000,01,003,0064,81,913,16,929,1282,0,3,1,3,0,1,0,76.14,72.46 ,33.33
02,000,01,003,0065,82,806,13,819,1060,0,3,1,3,0,1,0,76.14,77.26 ,33.33
02,000,01,003,0066,83,1171,14,1185,1687,0,3,1,3,0,1,0,76.14,70.24 ,33.33
02,000,01,003,0067,84,821,13,834,1203,0,3,1,3,0,1,0,76.14,69.33 ,33.33
02,000,01,003,0067,85,835,27,862,1152,0,3,1,3,0,1,0,76.14,74.83 ,33.33
02,000,01,003,0068,86,1145,37,1182,1621,0,3,1,3,0,1,0,76.14,72.92 ,33.33
02,000,01,003,0069,87,512,21,533,815,0,3,1,3,0,1,0,76.14,65.40 ,33.33
02,000,01,003,0069,88,1059,11,1070,1491,0,3,1,3,0,1,0,76.14,71.76 ,33.33
02,000,01,003,0070,89,1147,16,1163,1565,0,3,1,3,0,1,0,76.14,74.31 ,33.33
02,000,01,003,0071,90,725,15,740,1088,0,3,1,3,0,1,0,76.14,68.01 ,33.33
02,000,01,003,0072,91,656,13,669,878,0,3,1,3,0,1,0,76.14,76.20 ,33.33
02,000,01,003,0072,92,762,17,779,991,0,3,1,3,0,1,0,76.14,78.61 ,33.33
02,000,01,004,0073,93,712,9,721,976,0,3,1,3,0,1,0,76.14,73.87 ,33.33
02,000,01,004,0073,94,605,12,617,847,0,3,1,3,0,1,0,76.14,72.85 ,33.33
02,000,01,004,0074,95,1024,17,1041,1389,0,3,1,3,0,1,0,76.14,74.95 ,33.33
02,000,01,004,0075,96,569,9,578,790,0,3,1,3,0,1,0,76.14,73.16 ,33.33
02,000,01,004,0076,97,586,6,592,735,0,3,1,3,0,1,0,76.14,80.54 ,33.33
02,000,01,004,0077,98,501,4,505,666,0,3,1,3,0,1,0,76.14,75.83 ,33.33
02,000,01,004,0078,99,745,9,754,1010,0,3,1,3,0,1,0,76.14,74.65 ,33.33
02,000,01,004,0079,100,776,16,792,1109,0,3,1,3,0,1,0,76.14,71.42 ,33.33
02,000,01,004,0080,101,717,6,723,963,0,3,1,3,0,1,0,76.14,75.08 ,33.33
02,000,01,004,0081,102,837,15,852,1158,0,3,1,3,0,1,0,76.14,73.58 ,33.33
02,000,01,004,0081,103,1027,14,1041,1444,0,3,1,3,0,1,0,76.14,72.09 ,33.33
02,000,01,004,0082,104,1322,21,1343,1752,0,3,1,3,0,1,0,76.14,76.66 ,33.33
02,000,01,004,0083,105,912,12,924,1219,0,3,1,3,0,1,0,76.14,75.80 ,33.33
02,000,01,004,0083,106,574,10,584,774,0,3,1,3,0,1,0,76.14,75.45 ,33.33
02,000,01,004,0084,107,685,15,700,851,0,3,1,3,0,1,0,76.14,82.26 ,33.33
02,000,01,004,0085,108,1392,24,1416,1769,0,3,1,3,0,1,0,76.14,80.05 ,33.33
02,000,01,004,0086,109,1036,22,1058,1369,0,3,1,3,0,1,0,76.14,77.28 ,33.33
02,000,01,004,0087,110,652,6,658,900,0,3,1,3,0,1,0,76.14,73.11 ,33.33
02,000,01,004,0087,111,625,5,630,872,0,3,1,3,0,1,0,76.14,72.25 ,33.33
02,000,01,004,0088,112,858,15,873,1195,0,3,1,3,0,1,0,76.14,73.05 ,33.33
02,000,01,004,0088,113,1032,11,1043,1353,0,3,1,3,0,1,0,76.14,77.09 ,33.33
02,000,01,004,0089,114,1114,8,1122,1438,0,3,1,3,0,1,0,76.14,78.03 ,33.33
02,000,01,004,0090,115,708,7,715,887,0,3,1,3,0,1,0,76.14,80.61 ,33.33
02,000,01,004,0090,116,848,10,858,1077,0,3,1,3,0,1,0,76.14,79.67 ,33.33
02,000,01,004,0091,117,1234,16,1250,1588,0,3,1,3,0,1,0,76.14,78.72 ,33.33
02,000,01,004,0092,118,782,16,798,1003,0,3,1,3,0,1,0,76.14,79.56 ,33.33
02,000,01,004,0093,119,985,6,991,1291,0,3,1,3,0,1,0,76.14,76.76 ,33.33
02,000,01,004,0094,120,756,13,769,1042,0,3,1,3,0,1,0,76.14,73.80 ,33.33
02,000,01,004,0095,121,361,2,363,487,0,3,1,3,0,1,0,76.14,74.54 ,33.33
02,000,01,004,0096,122,463,12,475,598,0,3,1,3,0,1,0,76.14,79.43 ,33.33
02,000,01,004,0097,123,473,5,478,609,0,3,1,3,0,1,0,76.14,78.49 ,33.33
02,000,01,004,0098,124,620,5,625,814,0,3,1,3,0,1,0,76.14,76.78 ,33.33
02,000,01,004,0099,125,453,6,459,584,0,3,1,3,0,1,0,76.14,78.60 ,33.33
02,000,01,004,0100,126,642,10,652,822,0,3,1,3,0,1,0,76.14,79.32 ,33.33
02,000,01,004,0101,127,952,9,961,1255,0,3,1,3,0,1,0,76.14,76.57 ,33.33
02,000,01,004,0102,128,1142,16,1158,1567,0,3,1,3,0,1,0,76.14,73.90 ,33.33
02,000,01,004,0103,129,566,4,570,757,0,3,1,3,0,1,0,76.14,75.30 ,33.33
02,000,01,004,0103,130,511,11,522,679,0,3,1,3,0,1,0,76.14,76.88 ,33.33
02,000,01,004,0104,131,1146,9,1155,1470,0,3,1,3,0,1,0,76.14,78.57 ,33.33
02,000,01,004,0105,132,1525,16,1541,1887,0,3,1,3,0,1,0,76.14,81.66 ,33.33
02,000,01,004,0106,133,982,7,989,1224,0,3,1,3,0,1,0,76.14,80.80 ,33.33
02,000,01,004,0107,134,1463,25,1488,1932,0,3,1,3,0,1,0,76.14,77.02 ,33.33
02,000,01,004,0107,135,526,7,533,685,0,3,1,3,0,1,0,76.14,77.81 ,33.33
02,000,01,004,0108,136,775,10,785,1030,0,3,1,3,0,1,0,76.14,76.21 ,33.33
02,000,01,004,0108,137,866,8,874,1162,0,3,1,3,0,1,0,76.14,75.22 ,33.33
02,000,01,004,0109,138,1176,18,1194,1662,0,3,1,3,0,1,0,76.14,71.84 ,33.33
02,000,01,004,0110,139,823,6,829,1056,0,3,1,3,0,1,0,76.14,78.50 ,33.33
02,000,01,004,0110,140,708,6,714,904,0,3,1,3,0,1,0,76.14,78.98 ,33.33
02,000,01,004,0111,141,1482,24,1506,2069,0,3,1,3,0,1,0,76.14,72.79 ,33.33
02,000,01,004,0111,142,1468,19,1487,2066,0,3,1,3,0,1,0,76.14,71.97 ,33.33
02,000,01,004,0111,143,863,8,871,1133,0,3,1,3,0,1,0,76.14,76.88 ,33.33
02,000,01,004,0112,144,1544,22,1566,2023,0,3,1,3,0,1,0,76.14,77.41 ,33.33
02,000,01,004,0112,145,987,5,992,1572,0,3,1,3,0,1,0,76.14,63.10 ,33.33
02,000,01,004,0112,146,880,12,892,1434,0,3,1,3,0,1,0,76.14,62.20 ,33.33
02,000,01,004,0112,147,1106,16,1122,1678,0,3,1,3,0,1,0,76.14,66.87 ,33.33
02,000,01,004,0112,148,1017,7,1024,1632,0,3,1,3,0,1,0,76.14,62.75 ,33.33
02,000,01,004,0112,149,1086,14,1100,1696,0,3,1,3,0,1,0,76.14,64.86 ,33.33
02,000,01,004,0113,150,1146,12,1158,1546,0,3,1,3,0,1,0,76.14,74.90 ,33.33
02,000,01,004,0113,151,540,3,543,671,0,3,1,3,0,1,0,76.14,80.92 ,33.33
02,000,01,004,0113,152,1075,14,1089,1512,0,3,1,3,0,1,0,76.14,72.02 ,33.33
02,000,01,004,0114,153,1215,12,1227,1584,0,3,1,3,0,1,0,76.14,77.46 ,33.33
02,000,01,004,0114,154,1446,19,1465,2034,0,3,1,3,0,1,0,76.14,72.03 ,33.33
02,000,01,004,0115,155,1124,26,1150,1703,0,3,1,3,0,1,0,76.14,67.53 ,33.33
02,000,01,004,0115,156,778,16,794,1145,0,3,1,3,0,1,0,76.14,69.34 ,33.33
02,000,01,004,0115,157,1188,9,1197,1749,0,3,1,3,0,1,0,76.14,68.44 ,33.33
02,000,01,004,0116,158,1710,23,1733,2683,0,3,1,3,0,1,0,76.14,64.59 ,33.33
02,000,01,004,0116,159,955,12,967,1347,0,3,1,3,0,1,0,76.14,71.79 ,33.33
02,000,01,005,0117,160,1274,25,1299,1706,0,3,1,3,0,1,0,76.14,76.14 ,33.33
02,000,01,005,0117,161,1141,11,1152,1576,0,3,1,3,0,1,0,76.14,73.10 ,33.33
02,000,01,005,0117,162,1560,16,1576,2367,0,3,1,3,0,1,0,76.14,66.58 ,33.33
02,000,01,005,0118,163,1317,14,1331,1930,0,3,1,3,0,1,0,76.14,68.96 ,33.33
02,000,01,005,0119,164,778,12,790,1097,0,3,1,3,0,1,0,76.14,72.01 ,33.33
02,000,01,005,0119,165,1365,14,1379,2129,0,3,1,3,0,1,0,76.14,64.77 ,33.33
02,000,01,005,0120,166,1533,12,1545,1996,0,3,1,3,0,1,0,76.14,77.40 ,33.33
02,000,01,005,0121,167,964,12,976,1379,0,3,1,3,0,1,0,76.14,70.78 ,33.33
02,000,01,005,0121,168,784,49,833,1179,0,3,1,3,0,1,0,76.14,70.65 ,33.33
02,000,01,005,0122,169,1342,17,1359,1844,0,3,1,3,0,1,0,76.14,73.70 ,33.33
02,000,01,005,0123,170,1092,18,1110,1487,0,3,1,3,0,1,0,76.14,74.65 ,33.33
02,000,01,005,0123,171,1040,10,1050,1309,0,3,1,3,0,1,0,76.14,80.21 ,33.33
02,000,01,005,0124,172,1141,17,1158,1643,0,3,1,3,0,1,0,76.14,70.48 ,33.33
02,000,01,005,0125,173,1183,12,1195,1603,0,3,1,3,0,1,0,76.14,74.55 ,33.33
02,000,01,005,0125,174,1062,9,1071,1413,0,3,1,3,0,1,0,76.14,75.80 ,33.33
02,000,01,005,0126,175,682,33,715,908,0,3,1,3,0,1,0,76.14,78.74 ,33.33
02,000,01,005,0126,176,844,23,867,1098,0,3,1,3,0,1,0,76.14,78.96 ,33.33
02,000,01,005,0127,177,998,15,1013,1316,0,3,1,3,0,1,0,76.14,76.98 ,33.33
02,000,01,005,0127,178,993,16,1009,1295,0,3,1,3,0,1,0,76.14,77.92 ,33.33
02,000,01,005,0128,179,868,11,879,1225,0,3,1,3,0,1,0,76.14,71.76 ,33.33
02,000,01,005,0128,180,1831,27,1858,2590,0,3,1,3,0,1,0,76.14,71.74 ,33.33
02,000,01,005,0128,181,1542,20,1562,2202,0,3,1,3,0,1,0,76.14,70.94 ,33.33
02,000,01,005,0129,182,996,11,1007,1372,0,3,1,3,0,1,0,76.14,73.40 ,33.33
02,000,01,005,0129,183,1006,14,1020,1355,0,3,1,3,0,1,0,76.14,75.28 ,33.33
02,000,01,005,0130,184,1050,13,1063,1455,0,3,1,3,0,1,0,76.14,73.06 ,33.33
02,000,01,005,0131,185,575,6,581,684,0,3,1,3,0,1,0,76.14,84.94 ,33.33
02,000,01,005,0131,186,811,10,821,1077,0,3,1,3,0,1,0,76.14,76.23 ,33.33
02,000,01,005,0132,187,1206,6,1212,1516,0,3,1,3,0,1,0,76.14,79.95 ,33.33
02,000,01,005,0132,188,1195,18,1213,1499,0,3,1,3,0,1,0,76.14,80.92 ,33.33
02,000,01,005,0133,189,1244,9,1253,1556,0,3,1,3,0,1,0,76.14,80.53 ,33.33
02,000,01,005,0134,190,1119,19,1138,1422,0,3,1,3,0,1,0,76.14,80.03 ,33.33
02,000,01,005,0134,191,1112,29,1141,1452,0,3,1,3,0,1,0,76.14,78.58 ,33.33
02,000,01,005,0135,192,1330,20,1350,1929,0,3,1,3,0,1,0,76.14,69.98 ,33.33
02,000,01,005,0136,193,786,6,792,1075,0,3,1,3,0,1,0,76.14,73.67 ,33.33
02,000,01,005,0136,194,789,11,800,1050,0,3,1,3,0,1,0,76.14,76.19 ,33.33
02,000,01,005,0137,195,1325,13,1338,1674,0,3,1,3,0,1,0,76.14,79.93 ,33.33
02,000,01,005,0138,196,721,6,727,935,0,3,1,3,0,1,0,76.14,77.75 ,33.33
02,000,01,005,0138,197,1174,16,1190,1627,0,3,1,3,0,1,0,76.14,73.14 ,33.33
02,000,01,005,0139,198,1164,16,1180,1481,0,3,1,3,0,1,0,76.14,79.68 ,33.33
02,000,01,005,0140,199,899,8,907,1127,0,3,1,3,0,1,0,76.14,80.48 ,33.33
02,000,01,005,0140,200,785,9,794,1023,0,3,1,3,0,1,0,76.14,77.61 ,33.33
02,000,01,005,0141,201,856,7,863,1189,0,3,1,3,0,1,0,76.14,72.58 ,33.33
02,000,01,005,0141,202,815,7,822,1090,0,3,1,3,0,1,0,76.14,75.41 ,33.33
02,000,01,005,0142,203,1255,12,1267,1647,0,3,1,3,0,1,0,76.14,76.93 ,33.33
02,000,01,005,0143,204,829,9,838,1059,0,3,1,3,0,1,0,76.14,79.13 ,33.33
02,000,01,005,0143,205,772,5,777,1043,0,3,1,3,0,1,0,76.14,74.50 ,33.33
02,000,01,005,0144,206,1024,20,1044,1397,0,3,1,3,0,1,0,76.14,74.73 ,33.33
02,000,01,005,0144,207,1030,18,1048,1362,0,3,1,3,0,1,0,76.14,76.95 ,33.33
02,000,01,005,0145,208,1356,18,1374,1734,0,3,1,3,0,1,0,76.14,79.24 ,33.33
02,000,01,005,0145,209,1028,5,1033,1332,0,3,1,3,0,1,0,76.14,77.55 ,33.33
02,000,01,005,0146,210,1278,20,1298,1705,0,3,1,3,0,1,0,76.14,76.13 ,33.33
02,000,01,005,0147,211,1197,20,1217,1638,0,3,1,3,0,1,0,76.14,74.30 ,33.33
02,000,01,005,0148,212,901,6,907,1206,0,3,1,3,0,1,0,76.14,75.21 ,33.33
02,000,01,005,0148,213,723,10,733,1014,0,3,1,3,0,1,0,76.14,72.29 ,33.33
02,000,01,005,0149,214,796,10,806,1093,0,3,1,3,0,1,0,76.14,73.74 ,33.33
02,000,01,005,0149,215,1070,14,1084,1402,0,3,1,3,0,1,0,76.14,77.32 ,33.33
02,000,01,005,0149,216,1028,33,1061,1468,0,3,1,3,0,1,0,76.14,72.28 ,33.33
02,000,01,005,0150,217,821,18,839,1093,0,3,1,3,0,1,0,76.14,76.76 ,33.33
02,000,01,005,0150,218,1099,14,1113,1444,0,3,1,3,0,1,0,76.14,77.08 ,33.33
02,000,01,005,0151,219,667,5,672,802,0,3,1,3,0,1,0,76.14,83.79 ,33.33
02,000,01,005,0152,220,970,12,982,1297,0,3,1,3,0,1,0,76.14,75.71 ,33.33
02,000,01,005,0153,221,618,6,624,791,0,3,1,3,0,1,0,76.14,78.89 ,33.33
02,000,01,006,0154,222,741,11,752,1106,0,3,1,3,0,1,0,76.14,67.99 ,33.33
02,000,01,006,0154,223,918,14,932,1339,0,3,1,3,0,1,0,76.14,69.60 ,33.33
02,000,01,006,0155,224,1330,10,1340,1859,0,3,1,3,0,1,0,76.14,72.08 ,33.33
02,000,01,006,0155,225,1173,13,1186,1766,0,3,1,3,0,1,0,76.14,67.16 ,33.33
02,000,01,006,0156,226,1072,7,1079,1443,0,3,1,3,0,1,0,76.14,74.77 ,33.33
02,000,01,006,0156,227,933,25,958,1398,0,3,1,3,0,1,0,76.14,68.53 ,33.33
02,000,01,006,0157,228,945,24,969,1439,0,3,1,3,0,1,0,76.14,67.34 ,33.33
02,000,01,006,0157,229,992,18,1010,1384,0,3,1,3,0,1,0,76.14,72.98 ,33.33
02,000,01,006,0158,230,1223,27,1250,1692,0,3,1,3,0,1,0,76.14,73.88 ,33.33
02,000,01,006,0158,231,1048,19,1067,1577,0,3,1,3,0,1,0,76.14,67.66 ,33.33
02,000,01,006,0159,232,983,26,1009,1348,0,3,1,3,0,1,0,76.14,74.85 ,33.33
02,000,01,006,0159,233,945,10,955,1249,0,3,1,3,0,1,0,76.14,76.46 ,33.33
02,000,01,006,0160,234,1069,13,1082,1539,0,3,1,3,0,1,0,76.14,70.31 ,33.33
02,000,01,006,0160,235,1030,13,1043,1514,0,3,1,3,0,1,0,76.14,68.89 ,33.33
02,000,01,006,0160,236,1089,26,1115,1538,0,3,1,3,0,1,0,76.14,72.50 ,33.33
02,000,01,006,0160,237,874,10,884,1275,0,3,1,3,0,1,0,76.14,69.33 ,33.33
02,000,01,006,0161,238,1267,9,1276,1748,0,3,1,3,0,1,0,76.14,73.00 ,33.33
02,000,01,006,0161,239,1434,16,1450,2072,0,3,1,3,0,1,0,76.14,69.98 ,33.33
02,000,01,006,0161,240,1357,16,1373,1856,0,3,1,3,0,1,0,76.14,73.98 ,33.33
02,000,01,006,0162,241,1522,18,1540,2097,0,3,1,3,0,1,0,76.14,73.44 ,33.33
02,000,01,006,0162,242,1168,23,1191,1557,0,3,1,3,0,1,0,76.14,76.49 ,33.33
02,000,01,006,0163,243,1260,12,1272,1743,0,3,1,3,0,1,0,76.14,72.98 ,33.33
02,000,01,006,0164,244,993,14,1007,1412,0,3,1,3,0,1,0,76.14,71.32 ,33.33
02,000,01,006,0165,245,1566,18,1584,2169,0,3,1,3,0,1,0,76.14,73.03 ,33.33
02,000,01,006,0165,246,1127,38,1165,1622,0,3,1,3,0,1,0,76.14,71.82 ,33.33
02,000,01,006,0166,247,974,13,987,1384,0,3,1,3,0,1,0,76.14,71.32 ,33.33
02,000,01,006,0166,248,1160,10,1170,1559,0,3,1,3,0,1,0,76.14,75.05 ,33.33
02,000,01,006,0167,249,1234,14,1248,1802,0,3,1,3,0,1,0,76.14,69.26 ,33.33
02,000,01,006,0167,250,1031,3,1034,1493,0,3,1,3,0,1,0,76.14,69.26 ,33.33
02,000,01,006,0168,251,931,16,947,1355,0,3,1,3,0,1,0,76.14,69.89 ,33.33
02,000,01,006,0168,252,1124,6,1130,1664,0,3,1,3,0,1,0,76.14,67.91 ,33.33
02,000,01,006,0168,253,1044,16,1060,1554,0,3,1,3,0,1,0,76.14,68.21 ,33.33
02,000,01,006,0169,254,1006,8,1014,1527,0,3,1,3,0,1,0,76.14,66.40 ,33.33
02,000,01,006,0169,255,990,8,998,1465,0,3,1,3,0,1,0,76.14,68.12 ,33.33
02,000,01,006,0170,256,1174,12,1186,1714,0,3,1,3,0,1,0,76.14,69.19 ,33.33
02,000,01,006,0170,257,1145,14,1159,1769,0,3,1,3,0,1,0,76.14,65.52 ,33.33
02,000,01,006,0171,258,719,2,721,1102,0,3,1,3,0,1,0,76.14,65.43 ,33.33
02,000,01,006,0171,259,652,10,662,960,0,3,1,3,0,1,0,76.14,68.96 ,33.33
02,000,01,006,0172,260,919,7,926,1357,0,3,1,3,0,1,0,76.14,68.24 ,33.33
02,000,01,006,0172,261,904,10,914,1342,0,3,1,3,0,1,0,76.14,68.11 ,33.33
02,000,01,006,0172,262,886,7,893,1315,0,3,1,3,0,1,0,76.14,67.91 ,33.33
02,000,01,006,0173,263,868,14,882,1194,0,3,1,3,0,1,0,76.14,73.87 ,33.33
02,000,01,006,0173,264,894,15,909,1293,0,3,1,3,0,1,0,76.14,70.30 ,33.33
02,000,01,006,0174,265,828,9,837,1208,0,3,1,3,0,1,0,76.14,69.29 ,33.33
02,000,01,006,0174,266,692,5,697,1019,0,3,1,3,0,1,0,76.14,68.40 ,33.33
02,000,01,006,0175,267,969,9,978,1454,0,3,1,3,0,1,0,76.14,67.26 ,33.33
02,000,01,006,0175,268,806,10,816,1240,0,3,1,3,0,1,0,76.14,65.81 ,33.33
02,000,01,006,0175,269,1021,14,1035,1502,0,3,1,3,0,1,0,76.14,68.91 ,33.33
02,000,01,006,0176,270,1393,19,1412,1998,0,3,1,3,0,1,0,76.14,70.67 ,33.33
02,000,01,006,0177,271,750,6,756,1061,0,3,1,3,0,1,0,76.14,71.25 ,33.33
02,000,01,006,0177,272,804,12,816,1167,0,3,1,3,0,1,0,76.14,69.92 ,33.33
02,000,01,006,0178,273,1027,13,1040,1502,0,3,1,3,0,1,0,76.14,69.24 ,33.33
02,000,01,006,0178,274,1141,7,1148,1674,0,3,1,3,0,1,0,76.14,68.58 ,33.33
02,000,01,006,0179,275,905,13,918,1335,0,3,1,3,0,1,0,76.14,68.76 ,33.33
02,000,01,006,0179,276,1075,6,1081,1477,0,3,1,3,0,1,0,76.14,73.19 ,33.33
02,000,01,006,0180,277,812,2,814,1152,0,3,1,3,0,1,0,76.14,70.66 ,33.33
02,000,01,006,0180,278,925,12,937,1350,0,3,1,3,0,1,0,76.14,69.41 ,33.33
02,000,01,006,0180,279,959,26,985,1473,0,3,1,3,0,1,0,76.14,66.87 ,33.33
02,000,01,006,0181,280,1090,18,1108,1518,0,3,1,3,0,1,0,76.14,72.99 ,33.33
02,000,01,006,0181,281,1126,24,1150,1681,0,3,1,3,0,1,0,76.14,68.41 ,33.33
02,000,01,006,0182,282,1274,23,1297,1884,0,3,1,3,0,1,0,76.14,68.84 ,33.33
02,000,01,006,0182,283,1296,22,1318,1873,0,3,1,3,0,1,0,76.14,70.37 ,33.33
02,000,01,006,0183,284,910,10,920,1354,0,3,1,3,0,1,0,76.14,67.95 ,33.33
02,000,01,006,0183,285,932,17,949,1391,0,3,1,3,0,1,0,76.14,68.22 ,33.33
02,000,01,006,0183,286,1065,21,1086,1657,0,3,1,3,0,1,0,76.14,65.54 ,33.33
02,000,01,006,0184,287,908,8,916,1328,0,3,1,3,0,1,0,76.14,68.98 ,33.33
02,000,01,006,0184,288,716,5,721,1110,0,3,1,3,0,1,0,76.14,64.95 ,33.33
02,000,01,006,0185,289,846,20,866,1290,0,3,1,3,0,1,0,76.14,67.13 ,33.33
02,000,01,006,0185,290,853,16,869,1213,0,3,1,3,0,1,0,76.14,71.64 ,33.33
02,000,01,006,0186,291,1053,15,1068,1657,0,3,1,3,0,1,0,76.14,64.45 ,33.33
02,000,01,006,0186,292,1216,22,1238,1797,0,3,1,3,0,1,0,76.14,68.89 ,33.33
02,000,01,006,0187,293,1411,20,1431,1898,0,3,1,3,0,1,0,76.14,75.40 ,33.33
02,000,01,006,0188,294,1418,14,1432,1942,0,3,1,3,0,1,0,76.14,73.74 ,33.33
02,000,01,006,0189,295,1248,10,1258,1789,0,3,1,3,0,1,0,76.14,70.32 ,33.33
02,000,01,006,0189,296,1027,16,1043,1383,0,3,1,3,0,1,0,76.14,75.42 ,33.33
02,000,01,006,0190,297,1612,23,1635,2444,0,3,1,3,0,1,0,76.14,66.90 ,33.33
02,000,01,006,0191,298,1327,9,1336,1949,0,3,1,3,0,1,0,76.14,68.55 ,33.33
02,000,01,006,0191,299,993,15,1008,1531,0,3,1,3,0,1,0,76.14,65.84 ,33.33
02,000,01,006,0191,300,1127,18,1145,1608,0,3,1,3,0,1,0,76.14,71.21 ,33.33
02,000,01,006,0192,301,1064,6,1070,1538,0,3,1,3,0,1,0,76.14,69.57 ,33.33
02,000,01,006,0192,302,972,11,983,1408,0,3,1,3,0,1,0,76.14,69.82 ,33.33
02,000,01,006,0193,303,995,15,1010,1441,0,3,1,3,0,1,0,76.14,70.09 ,33.33
02,000,01,006,0194,304,967,10,977,1366,0,3,1,3,0,1,0,76.14,71.52 ,33.33
02,000,01,006,0195,305,946,60,1006,1592,0,3,1,3,0,1,0,76.14,63.19 ,33.33
02,000,01,006,0195,306,1007,23,1030,1556,0,3,1,3,0,1,0,76.14,66.20 ,33.33
02,000,01,006,0196,307,1448,33,1481,2264,0,3,1,3,0,1,0,76.14,65.42 ,33.33
02,000,01,006,0197,308,916,20,936,1400,0,3,1,3,0,1,0,76.14,66.86 ,33.33
02,000,01,006,0197,309,1022,9,1031,1552,0,3,1,3,0,1,0,76.14,66.43 ,33.33
02,000,01,006,0198,310,1071,7,1078,1666,0,3,1,3,0,1,0,76.14,64.71 ,33.33
02,000,01,006,0198,311,1264,24,1288,1905,0,3,1,3,0,1,0,76.14,67.61 ,33.33
02,000,01,006,0199,312,1225,20,1245,1663,0,3,1,3,0,1,0,76.14,74.86 ,33.33
02,000,01,006,0199,313,1121,8,1129,1629,0,3,1,3,0,1,0,76.14,69.31 ,33.33
02,000,01,006,0200,314,879,10,889,1224,0,3,1,3,0,1,0,76.14,72.63 ,33.33
02,000,01,006,0200,315,1032,13,1045,1452,0,3,1,3,0,1,0,76.14,71.97 ,33.33
02,000,01,006,0201,316,1150,7,1157,1572,0,3,1,3,0,1,0,76.14,73.60 ,33.33
02,000,01,006,0202,317,1305,19,1324,1809,0,3,1,3,0,1,0,76.14,73.19 ,33.33
02,000,01,006,0203,318,1064,11,1075,1541,0,3,1,3,0,1,0,76.14,69.76 ,33.33
02,000,01,006,0204,319,857,11,868,1143,0,3,1,3,0,1,0,76.14,75.94 ,33.33
02,000,01,006,0205,320,1026,8,1034,1415,0,3,1,3,0,1,0,76.14,73.07 ,33.33
02,000,01,006,0205,321,1088,6,1094,1541,0,3,1,3,0,1,0,76.14,70.99 ,33.33
02,000,01,006,0206,322,877,2,879,1234,0,3,1,3,0,1,0,76.14,71.23 ,33.33
02,000,01,006,0206,323,767,7,774,1128,0,3,1,3,0,1,0,76.14,68.62 ,33.33
02,000,01,006,0207,324,1192,108,1300,1902,0,3,1,3,0,1,0,76.14,68.35 ,33.33
02,000,01,006,0208,325,1252,20,1272,1856,0,3,1,3,0,1,0,76.14,68.53 ,33.33
02,000,01,006,0209,326,681,13,694,952,0,3,1,3,0,1,0,76.14,72.90 ,33.33
02,000,01,006,0210,327,888,7,895,1197,0,3,1,3,0,1,0,76.14,74.77 ,33.33
02,000,01,006,0211,328,1323,17,1340,1874,0,3,1,3,0,1,0,76.14,71.50 ,33.33
02,000,01,006,0212,329,682,5,687,959,0,3,1,3,0,1,0,76.14,71.64 ,33.33
02,000,01,006,0212,330,847,9,856,1160,0,3,1,3,0,1,0,76.14,73.79 ,33.33
02,000,01,006,0213,331,1132,11,1143,1571,0,3,1,3,0,1,0,76.14,72.76 ,33.33
02,000,01,006,0213,332,1106,13,1119,1614,0,3,1,3,0,1,0,76.14,69.33 ,33.33
02,000,01,006,0214,333,1385,49,1434,1901,0,3,1,3,0,1,0,76.14,75.43 ,33.33
02,000,01,006,0214,334,1303,13,1316,1899,0,3,1,3,0,1,0,76.14,69.30 ,33.33
02,000,01,006,0215,335,1254,16,1270,1677,0,3,1,3,0,1,0,76.14,75.73 ,33.33
02,000,01,006,0215,336,1226,17,1243,1735,0,3,1,3,0,1,0,76.14,71.64 ,33.33
02,000,01,006,0216,337,1026,11,1037,1421,0,3,1,3,0,1,0,76.14,72.98 ,33.33
02,000,01,006,0217,338,1245,14,1259,1699,0,3,1,3,0,1,0,76.14,74.10 ,33.33
02,000,01,006,0218,339,1399,22,1421,1938,0,3,1,3,0,1,0,76.14,73.32 ,33.33
02,000,01,006,0219,340,859,10,869,1165,0,3,1,3,0,1,0,76.14,74.59 ,33.33
02,000,01,006,0220,341,821,10,831,1143,0,3,1,3,0,1,0,76.14,72.70 ,33.33
02,000,01,006,0221,342,942,14,956,1428,0,3,1,3,0,1,0,76.14,66.95 ,33.33
02,000,01,006,0222,343,1042,10,1052,1556,0,3,1,3,0,1,0,76.14,67.61 ,33.33
02,000,01,006,0223,344,602,10,612,924,0,3,1,3,0,1,0,76.14,66.23 ,33.33
02,000,01,006,0224,345,477,5,482,597,0,3,1,3,0,1,0,76.14,80.74 ,33.33
02,000,01,006,0225,346,773,12,785,1188,0,3,1,3,0,1,0,76.14,66.08 ,33.33
02,000,01,006,0226,347,1320,16,1336,1970,0,3,1,3,0,1,0,76.14,67.82 ,33.33
02,000,01,006,0226,348,1344,15,1359,2017,0,3,1,3,0,1,0,76.14,67.38 ,33.33
02,000,01,006,0227,349,926,13,939,1321,0,3,1,3,0,1,0,76.14,71.08 ,33.33
02,000,01,006,0228,350,673,11,684,1037,0,3,1,3,0,1,0,76.14,65.96 ,33.33
02,000,01,006,0229,351,871,8,879,1285,0,3,1,3,0,1,0,76.14,68.40 ,33.33
02,000,01,006,0230,352,815,5,820,1148,0,3,1,3,0,1,0,76.14,71.43 ,33.33
02,000,01,006,0231,353,736,17,753,1020,0,3,1,3,0,1,0,76.14,73.82 ,33.33
02,000,01,006,0231,354,799,12,811,1134,0,3,1,3,0,1,0,76.14,71.52 ,33.33
02,000,01,006,0232,355,851,8,859,1212,0,3,1,3,0,1,0,76.14,70.87 ,33.33
02,000,01,006,0233,356,317,6,323,440,0,3,1,3,0,1,0,76.14,73.41 ,33.33
02,000,01,006,0234,357,1034,7,1041,1437,0,3,1,3,0,1,0,76.14,72.44 ,33.33
02,000,01,006,0234,358,961,15,976,1324,0,3,1,3,0,1,0,76.14,73.72 ,33.33
02,000,01,006,0235,359,1272,22,1294,1819,0,3,1,3,0,1,0,76.14,71.14 ,33.33
02,000,01,006,0236,360,601,14,615,801,0,3,1,3,0,1,0,76.14,76.78 ,33.33
02,000,01,006,0237,361,991,4,995,1312,0,3,1,3,0,1,0,76.14,75.84 ,33.33
02,000,01,006,0238,362,863,16,879,1241,0,3,1,3,0,1,0,76.14,70.83 ,33.33
02,000,01,006,0239,363,943,13,956,1365,0,3,1,3,0,1,0,76.14,70.04 ,33.33
02,000,01,006,0240,364,920,13,933,1281,0,3,1,3,0,1,0,76.14,72.83 ,33.33
02,000,01,006,0241,365,875,35,910,1313,0,3,1,3,0,1,0,76.14,69.31 ,33.33
02,000,01,006,0241,366,847,24,871,1208,0,3,1,3,0,1,0,76.14,72.10 ,33.33
02,000,02,007,0242,367,623,4,627,796,0,3,1,3,0,1,0,76.14,78.77 ,33.33
02,000,02,007,0242,368,815,7,822,1104,0,3,1,3,0,1,0,76.14,74.46 ,33.33
02,000,02,007,0243,369,593,3,596,866,0,3,1,3,0,1,0,76.14,68.82 ,33.33
02,000,02,007,0243,370,977,12,989,1381,0,3,1,3,0,1,0,76.14,71.61 ,33.33
02,000,02,007,0244,371,471,6,477,706,0,3,1,3,0,1,0,76.14,67.56 ,33.33
02,000,02,007,0245,372,822,15,837,1224,0,3,1,3,0,1,0,76.14,68.38 ,33.33
02,000,02,007,0246,373,739,7,746,1038,0,3,1,3,0,1,0,76.14,71.87 ,33.33
02,000,02,007,0247,374,748,11,759,1009,0,3,1,3,0,1,0,76.14,75.22 ,33.33
02,000,02,007,0248,375,700,9,709,978,0,3,1,3,0,1,0,76.14,72.49 ,33.33
02,000,02,007,0249,376,920,9,929,1295,0,3,1,3,0,1,0,76.14,71.74 ,33.33
02,000,02,007,0250,377,1026,13,1039,1405,0,3,1,3,0,1,0,76.14,73.95 ,33.33
02,000,02,007,0251,378,849,11,860,1222,0,3,1,3,0,1,0,76.14,70.38 ,33.33
02,000,02,007,0252,379,671,22,693,916,0,3,1,3,0,1,0,76.14,75.66 ,33.33
02,000,02,007,0253,380,650,13,663,934,0,3,1,3,0,1,0,76.14,70.99 ,33.33
02,000,02,007,0254,381,587,3,590,881,0,3,1,3,0,1,0,76.14,66.97 ,33.33
02,000,02,007,0255,382,627,10,637,915,0,3,1,3,0,1,0,76.14,69.62 ,33.33
02,000,02,007,0256,383,736,4,740,1147,0,3,1,3,0,1,0,76.14,64.52 ,33.33
02,000,02,007,0256,384,839,11,850,1283,0,3,1,3,0,1,0,76.14,66.25 ,33.33
02,000,02,007,0257,385,712,9,721,1005,0,3,1,3,0,1,0,76.14,71.74 ,33.33
02,000,02,007,0257,386,936,15,951,1237,0,3,1,3,0,1,0,76.14,76.88 ,33.33
02,000,02,007,0258,387,1235,15,1250,1800,0,3,1,3,0,1,0,76.14,69.44 ,33.33
02,000,02,007,0259,388,406,6,412,573,0,3,1,3,0,1,0,76.14,71.90 ,33.33
02,000,02,007,0260,389,571,2,573,867,0,3,1,3,0,1,0,76.14,66.09 ,33.33
02,000,02,007,0260,390,804,7,811,1151,0,3,1,3,0,1,0,76.14,70.46 ,33.33
02,000,02,007,0261,391,1046,20,1066,1468,0,3,1,3,0,1,0,76.14,72.62 ,33.33
02,000,02,007,0262,392,804,9,813,1100,0,3,1,3,0,1,0,76.14,73.91 ,33.33
02,000,02,007,0262,393,774,9,783,1131,0,3,1,3,0,1,0,76.14,69.23 ,33.33
02,000,02,007,0263,394,645,10,655,944,0,3,1,3,0,1,0,76.14,69.39 ,33.33
02,000,02,007,0264,395,570,7,577,819,0,3,1,3,0,1,0,76.14,70.45 ,33.33
02,000,02,007,0265,396,742,7,749,976,0,3,1,3,0,1,0,76.14,76.74 ,33.33
02,000,02,007,0265,397,900,10,910,1230,0,3,1,3,0,1,0,76.14,73.98 ,33.33
02,000,02,007,0266,398,851,7,858,1170,0,3,1,3,0,1,0,76.14,73.33 ,33.33
02,000,02,007,0267,399,532,15,547,763,0,3,1,3,0,1,0,76.14,71.69 ,33.33
02,000,02,007,0268,400,890,16,906,1202,0,3,1,3,0,1,0,76.14,75.37 ,33.33
02,000,02,007,0269,401,1173,15,1188,1614,0,3,1,3,0,1,0,76.14,73.61 ,33.33
02,000,02,007,0270,402,837,8,845,1265,0,3,1,3,0,1,0,76.14,66.80 ,33.33
02,000,02,007,0271,403,599,8,607,833,0,3,1,3,0,1,0,76.14,72.87 ,33.33
02,000,02,007,0272,404,751,6,757,1099,0,3,1,3,0,1,0,76.14,68.88 ,33.33
02,000,02,007,0272,405,720,10,730,974,0,3,1,3,0,1,0,76.14,74.95 ,33.33
02,000,02,007,0273,406,883,8,891,1296,0,3,1,3,0,1,0,76.14,68.75 ,33.33
02,000,02,007,0273,407,939,13,952,1299,0,3,1,3,0,1,0,76.14,73.29 ,33.33
02,000,02,008,0274,408,630,14,644,921,0,3,1,3,0,1,0,76.14,69.92 ,33.33
02,000,02,008,0275,409,830,13,843,1190,0,3,1,3,0,1,0,76.14,70.84 ,33.33
02,000,02,008,0276,410,1092,13,1105,1600,0,3,1,3,0,1,0,76.14,69.06 ,33.33
02,000,02,008,0277,411,710,10,720,1064,0,3,1,3,0,1,0,76.14,67.67 ,33.33
02,000,02,008,0278,412,922,5,927,1322,0,3,1,3,0,1,0,76.14,70.12 ,33.33
02,000,02,008,0279,413,632,11,643,991,0,3,1,3,0,1,0,76.14,64.88 ,33.33
02,000,02,008,0280,414,558,9,567,814,0,3,1,3,0,1,0,76.14,69.66 ,33.33
02,000,02,008,0281,415,1061,14,1075,1462,0,3,1,3,0,1,0,76.14,73.53 ,33.33
02,000,02,008,0281,416,798,12,810,1278,0,3,1,3,0,1,0,76.14,63.38 ,33.33
02,000,02,008,0282,417,826,13,839,1122,0,3,1,3,0,1,0,76.14,74.78 ,33.33
02,000,02,008,0283,418,1036,12,1048,1436,0,3,1,3,0,1,0,76.14,72.98 ,33.33
02,000,02,008,0284,419,512,2,514,766,0,3,1,3,0,1,0,76.14,67.10 ,33.33
02,000,02,008,0285,420,714,7,721,995,0,3,1,3,0,1,0,76.14,72.46 ,33.33
02,000,02,008,0286,421,729,22,751,1063,0,3,1,3,0,1,0,76.14,70.65 ,33.33
02,000,02,008,0287,422,1295,13,1308,1805,0,3,1,3,0,1,0,76.14,72.47 ,33.33
02,000,02,008,0288,423,882,9,891,1220,0,3,1,3,0,1,0,76.14,73.03 ,33.33
02,000,02,008,0289,424,1207,14,1221,1724,0,3,1,3,0,1,0,76.14,70.82 ,33.33
02,000,02,008,0290,425,989,22,1011,1350,0,3,1,3,0,1,0,76.14,74.89 ,33.33
02,000,02,008,0291,426,639,6,645,1045,0,3,1,3,0,1,0,76.14,61.72 ,33.33
02,000,02,008,0292,427,874,22,896,1271,0,3,1,3,0,1,0,76.14,70.50 ,33.33
02,000,02,008,0293,428,954,12,966,1370,0,3,1,3,0,1,0,76.14,70.51 ,33.33
02,000,02,009,0294,429,454,3,457,650,0,3,1,3,0,1,0,76.14,70.31 ,33.33
02,000,02,009,0295,430,920,20,940,1351,0,3,1,3,0,1,0,76.14,69.58 ,33.33
02,000,02,009,0296,431,956,13,969,1419,0,3,1,3,0,1,0,76.14,68.29 ,33.33
02,000,02,009,0297,432,1078,17,1095,1529,0,3,1,3,0,1,0,76.14,71.62 ,33.33
02,000,02,009,0298,433,863,14,877,1291,0,3,1,3,0,1,0,76.14,67.93 ,33.33
02,000,02,009,0299,434,928,58,986,1468,0,3,1,3,0,1,0,76.14,67.17 ,33.33
02,000,02,009,0300,435,1034,20,1054,1518,0,3,1,3,0,1,0,76.14,69.43 ,33.33
02,000,02,009,0301,436,565,9,574,798,0,3,1,3,0,1,0,76.14,71.93 ,33.33
02,000,02,009,0302,437,1137,11,1148,1658,0,3,1,3,0,1,0,76.14,69.24 ,33.33
02,000,02,009,0303,438,987,15,1002,1591,0,3,1,3,0,1,0,76.14,62.98 ,33.33
02,000,02,009,0304,439,987,20,1007,1352,0,3,1,3,0,1,0,76.14,74.48 ,33.33
02,000,02,009,0305,440,1119,49,1168,1537,0,3,1,3,0,1,0,76.14,75.99 ,33.33
02,000,02,009,0306,441,1202,14,1216,1737,0,3,1,3,0,1,0,76.14,70.01 ,33.33
02,000,02,009,0307,442,1118,30,1148,1709,0,3,1,3,0,1,0,76.14,67.17 ,33.33
02,000,02,009,0308,443,1440,17,1457,2031,0,3,1,3,0,1,0,76.14,71.74 ,33.33
02,000,02,009,0309,444,871,16,887,1299,0,3,1,3,0,1,0,76.14,68.28 ,33.33
02,000,02,009,0310,445,1054,17,1071,1626,0,3,1,3,0,1,0,76.14,65.87 ,33.33
02,000,02,009,0310,446,805,10,815,1312,0,3,1,3,0,1,0,76.14,62.12 ,33.33
02,000,02,009,0311,447,828,11,839,1187,0,3,1,3,0,1,0,76.14,70.68 ,33.33
02,000,02,009,0311,448,830,23,853,1211,0,3,1,3,0,1,0,76.14,70.44 ,33.33
02,000,02,009,0312,449,886,7,893,1218,0,3,1,3,0,1,0,76.14,73.32 ,33.33
02,000,02,009,0312,450,789,10,799,1154,0,3,1,3,0,1,0,76.14,69.24 ,33.33
02,000,02,009,0313,451,1522,28,1550,2215,0,3,1,3,0,1,0,76.14,69.98 ,33.33
02,000,02,009,0314,452,692,11,703,997,0,3,1,3,0,1,0,76.14,70.51 ,33.33
02,000,02,009,0315,453,932,8,940,1349,0,3,1,3,0,1,0,76.14,69.68 ,33.33
02,000,02,009,0315,454,820,8,828,1270,0,3,1,3,0,1,0,76.14,65.20 ,33.33
02,000,02,009,0316,455,1046,30,1076,1493,0,3,1,3,0,1,0,76.14,72.07 ,33.33
02,000,02,009,0317,456,1336,15,1351,1877,0,3,1,3,0,1,0,76.14,71.98 ,33.33
02,000,02,009,0318,457,1081,8,1089,1496,0,3,1,3,0,1,0,76.14,72.79 ,33.33
02,000,02,009,0319,458,606,5,611,852,0,3,1,3,0,1,0,76.14,71.71 ,33.33
02,000,02,009,0320,459,997,6,1003,1402,0,3,1,3,0,1,0,76.14,71.54 ,33.33
02,000,02,009,0321,460,1022,14,1036,1497,0,3,1,3,0,1,0,76.14,69.21 ,33.33
02,000,02,009,0321,461,1146,14,1160,1664,0,3,1,3,0,1,0,76.14,69.71 ,33.33
02,000,02,009,0322,462,1433,28,1461,2055,0,3,1,3,0,1,0,76.14,71.09 ,33.33
02,000,02,009,0323,463,1125,25,1150,1566,0,3,1,3,0,1,0,76.14,73.44 ,33.33
02,000,02,009,0323,464,1324,20,1344,1839,0,3,1,3,0,1,0,76.14,73.08 ,33.33
02,000,02,009,0324,465,1154,7,1161,1646,0,3,1,3,0,1,0,76.14,70.53 ,33.33
02,000,02,009,0325,466,1031,13,1044,1489,0,3,1,3,0,1,0,76.14,70.11 ,33.33
02,000,02,009,0325,467,828,9,837,1274,0,3,1,3,0,1,0,76.14,65.70 ,33.33
02,000,02,009,0326,468,769,7,776,1131,0,3,1,3,0,1,0,76.14,68.61 ,33.33
02,000,02,009,0326,469,799,7,806,1216,0,3,1,3,0,1,0,76.14,66.28 ,33.33
02,000,02,009,0327,470,998,28,1026,1477,0,3,1,3,0,1,0,76.14,69.47 ,33.33
02,000,02,009,0328,471,1117,13,1130,1623,0,3,1,3,0,1,0,76.14,69.62 ,33.33
02,000,02,009,0329,472,1439,26,1465,1942,0,3,1,3,0,1,0,76.14,75.44 ,33.33
02,000,02,009,0330,473,635,22,657,987,0,3,1,3,0,1,0,76.14,66.57 ,33.33
02,000,02,009,0330,474,904,5,909,1354,0,3,1,3,0,1,0,76.14,67.13 ,33.33
02,000,02,009,0331,475,1269,24,1293,1803,0,3,1,3,0,1,0,76.14,71.71 ,33.33
02,000,02,009,0332,476,1138,43,1181,1582,0,3,1,3,0,1,0,76.14,74.65 ,33.33
02,000,02,009,0333,477,796,9,805,1154,0,3,1,3,0,1,0,76.14,69.76 ,33.33
02,000,02,009,0333,478,864,11,875,1239,0,3,1,3,0,1,0,76.14,70.62 ,33.33
02,000,02,009,0334,479,1208,21,1229,1783,0,3,1,3,0,1,0,76.14,68.93 ,33.33
02,000,02,009,0335,480,1116,9,1125,1683,0,3,1,3,0,1,0,76.14,66.84 ,33.33
02,000,02,009,0335,481,1216,19,1235,1779,0,3,1,3,0,1,0,76.14,69.42 ,33.33
02,000,02,009,0336,482,1332,53,1385,1938,0,3,1,3,0,1,0,76.14,71.47 ,33.33
02,000,02,009,0337,483,1000,10,1010,1439,0,3,1,3,0,1,0,76.14,70.19 ,33.33
02,000,02,009,0338,484,1362,15,1377,1979,0,3,1,3,0,1,0,76.14,69.58 ,33.33
02,000,02,009,0338,485,1274,16,1290,1852,0,3,1,3,0,1,0,76.14,69.65 ,33.33
02,000,02,009,0339,486,685,16,701,1050,0,3,1,3,0,1,0,76.14,66.76 ,33.33
02,000,02,009,0339,487,728,13,741,1066,0,3,1,3,0,1,0,76.14,69.51 ,33.33
02,000,02,009,0340,488,886,16,902,1229,0,3,1,3,0,1,0,76.14,73.39 ,33.33
02,000,02,009,0341,489,1118,12,1130,1574,0,3,1,3,0,1,0,76.14,71.79 ,33.33
02,000,02,009,0342,490,880,71,951,1353,0,3,1,3,0,1,0,76.14,70.29 ,33.33
02,000,02,009,0342,491,1045,8,1053,1499,0,3,1,3,0,1,0,76.14,70.25 ,33.33
02,000,02,009,0343,492,1034,9,1043,1422,0,3,1,3,0,1,0,76.14,73.35 ,33.33
02,000,02,009,0344,493,741,21,762,1077,0,3,1,3,0,1,0,76.14,70.75 ,33.33
02,000,02,009,0345,494,1334,19,1353,1948,0,3,1,3,0,1,0,76.14,69.46 ,33.33
02,000,02,009,0346,495,1621,26,1647,2248,0,3,1,3,0,1,0,76.14,73.27 ,33.33
02,000,02,009,0347,496,1013,19,1032,1479,0,3,1,3,0,1,0,76.14,69.78 ,33.33
02,000,02,009,0347,497,895,8,903,1371,0,3,1,3,0,1,0,76.14,65.86 ,33.33
02,000,02,009,0348,498,1003,24,1027,1379,0,3,1,3,0,1,0,76.14,74.47 ,33.33
02,000,02,009,0348,499,1089,21,1110,1584,0,3,1,3,0,1,0,76.14,70.08 ,33.33
02,000,02,009,0349,500,1387,27,1414,2162,0,3,1,3,0,1,0,76.14,65.40 ,33.33
02,000,02,009,0350,501,867,8,875,1277,0,3,1,3,0,1,0,76.14,68.52 ,33.33
02,000,02,009,0350,502,791,14,805,1142,0,3,1,3,0,1,0,76.14,70.49 ,33.33
02,000,02,009,0351,503,1449,39,1488,2146,0,3,1,3,0,1,0,76.14,69.34 ,33.33
02,000,02,009,0352,504,1082,12,1094,1503,0,3,1,3,0,1,0,76.14,72.79 ,33.33
02,000,02,009,0353,505,1397,13,1410,2149,0,3,1,3,0,1,0,76.14,65.61 ,33.33
02,000,02,009,0354,506,1157,15,1172,1712,0,3,1,3,0,1,0,76.14,68.46 ,33.33
02,000,02,009,0354,507,1274,19,1293,1928,0,3,1,3,0,1,0,76.14,67.06 ,33.33
02,000,02,009,0355,508,1260,19,1279,1824,0,3,1,3,0,1,0,76.14,70.12 ,33.33
02,000,02,009,0355,509,1260,22,1282,1922,0,3,1,3,0,1,0,76.14,66.70 ,33.33
02,000,02,009,0356,510,1130,30,1160,1650,0,3,1,3,0,1,0,76.14,70.30 ,33.33
02,000,02,009,0356,511,1116,21,1137,1593,0,3,1,3,0,1,0,76.14,71.37 ,33.33
02,000,02,009,0357,512,1273,23,1296,1854,0,3,1,3,0,1,0,76.14,69.90 ,33.33
02,000,02,009,0357,513,1107,12,1119,1582,0,3,1,3,0,1,0,76.14,70.73 ,33.33
02,000,02,009,0358,514,1392,22,1414,1942,0,3,1,3,0,1,0,76.14,72.81 ,33.33
02,000,02,009,0359,515,951,13,964,1247,0,3,1,3,0,1,0,76.14,77.31 ,33.33
02,000,02,009,0359,516,671,13,684,939,0,3,1,3,0,1,0,76.14,72.84 ,33.33
02,000,02,009,0360,517,1307,20,1327,1809,0,3,1,3,0,1,0,76.14,73.36 ,33.33
02,000,02,009,0360,518,1197,10,1207,1654,0,3,1,3,0,1,0,76.14,72.97 ,33.33
02,000,02,009,0361,519,1298,10,1308,1791,0,3,1,3,0,1,0,76.14,73.03 ,33.33
02,000,02,009,0362,520,1478,34,1512,2110,0,3,1,3,0,1,0,76.14,71.66 ,33.33
02,000,02,010,0363,521,1299,18,1317,1855,0,3,1,3,0,1,0,76.14,71.00 ,33.33
02,000,02,010,0363,522,1210,27,1237,1889,0,3,1,3,0,1,0,76.14,65.48 ,33.33
02,000,02,010,0363,523,1638,18,1656,2604,0,3,1,3,0,1,0,76.14,63.59 ,33.33
02,000,02,010,0364,524,1000,17,1017,1395,0,3,1,3,0,1,0,76.14,72.90 ,33.33
02,000,02,010,0364,525,537,11,548,884,0,3,1,3,0,1,0,76.14,61.99 ,33.33
02,000,02,010,0365,526,1098,14,1112,1478,0,3,1,3,0,1,0,76.14,75.24 ,33.33
02,000,02,010,0365,527,1191,20,1211,1760,0,3,1,3,0,1,0,76.14,68.81 ,33.33
02,000,02,010,0366,528,793,16,809,1031,0,3,1,3,0,1,0,76.14,78.47 ,33.33
02,000,02,010,0366,529,553,3,556,771,0,3,1,3,0,1,0,76.14,72.11 ,33.33
02,000,02,010,0367,530,1067,17,1084,1509,0,3,1,3,0,1,0,76.14,71.84 ,33.33
02,000,02,010,0368,531,809,16,825,1172,0,3,1,3,0,1,0,76.14,70.39 ,33.33
02,000,02,010,0368,532,621,11,632,901,0,3,1,3,0,1,0,76.14,70.14 ,33.33
02,000,02,010,0369,533,1083,24,1107,1624,0,3,1,3,0,1,0,76.14,68.17 ,33.33
02,000,02,010,0370,534,645,7,652,913,0,3,1,3,0,1,0,76.14,71.41 ,33.33
02,000,02,010,0371,535,1270,25,1295,1792,0,3,1,3,0,1,0,76.14,72.27 ,33.33
02,000,02,010,0372,536,1038,16,1054,1513,0,3,1,3,0,1,0,76.14,69.66 ,33.33
02,000,02,010,0373,537,838,14,852,1248,0,3,1,3,0,1,0,76.14,68.27 ,33.33
02,000,02,010,0373,538,1017,13,1030,1482,0,3,1,3,0,1,0,76.14,69.50 ,33.33
02,000,02,010,0374,539,1024,14,1038,1396,0,3,1,3,0,1,0,76.14,74.36 ,33.33
02,000,02,010,0375,540,592,10,602,814,0,3,1,3,0,1,0,76.14,73.96 ,33.33
02,000,02,010,0376,541,718,11,729,980,0,3,1,3,0,1,0,76.14,74.39 ,33.33
02,000,02,010,0377,542,1359,34,1393,1759,0,3,1,3,0,1,0,76.14,79.19 ,33.33
02,000,02,010,0378,543,1407,26,1433,1897,0,3,1,3,0,1,0,76.14,75.54 ,33.33
02,000,02,010,0379,544,884,17,901,1177,0,3,1,3,0,1,0,76.14,76.55 ,33.33
02,000,02,010,0379,545,865,29,894,1231,0,3,1,3,0,1,0,76.14,72.62 ,33.33
02,000,02,010,0380,546,837,30,867,1187,0,3,1,3,0,1,0,76.14,73.04 ,33.33
02,000,02,010,0380,547,536,12,548,764,0,3,1,3,0,1,0,76.14,71.73 ,33.33
02,000,02,010,0381,548,1220,19,1239,1663,0,3,1,3,0,1,0,76.14,74.50 ,33.33
02,000,02,010,0381,549,1053,8,1061,1542,0,3,1,3,0,1,0,76.14,68.81 ,33.33
02,000,02,010,0382,550,655,9,664,841,0,3,1,3,0,1,0,76.14,78.95 ,33.33
02,000,02,010,0383,551,772,22,794,994,0,3,1,3,0,1,0,76.14,79.88 ,33.33
02,000,02,010,0384,552,919,15,934,1216,0,3,1,3,0,1,0,76.14,76.81 ,33.33
02,000,02,010,0385,553,959,16,975,1233,0,3,1,3,0,1,0,76.14,79.08 ,33.33
02,000,02,010,0386,554,1971,31,2002,2515,0,3,1,3,0,1,0,76.14,79.60 ,33.33
02,000,02,010,0387,555,1505,18,1523,1890,0,3,1,3,0,1,0,76.14,80.58 ,33.33
02,000,02,010,0388,556,153,2,155,200,0,3,1,3,0,1,0,76.14,77.50 ,33.33
02,000,02,010,0389,557,29,1,30,58,0,3,1,3,0,1,0,76.14,51.72 ,33.33
02,000,02,010,0390,558,962,16,978,1357,0,3,1,3,0,1,0,76.14,72.07 ,33.33
02,000,02,010,0390,559,1177,10,1187,1657,0,3,1,3,0,1,0,76.14,71.64 ,33.33
02,000,02,010,0391,560,1386,21,1407,1801,0,3,1,3,0,1,0,76.14,78.12 ,33.33
02,000,02,010,0392,561,703,19,722,969,0,3,1,3,0,1,0,76.14,74.51 ,33.33
02,000,02,010,0393,562,872,13,885,1169,0,3,1,3,0,1,0,76.14,75.71 ,33.33
02,000,02,010,0394,563,716,9,725,917,0,3,1,3,0,1,0,76.14,79.06 ,33.33
02,000,02,010,0394,564,695,86,781,1188,0,3,1,3,0,1,0,76.14,65.74 ,33.33
02,000,02,010,0395,565,779,14,793,1062,0,3,1,3,0,1,0,76.14,74.67 ,33.33
02,000,02,010,0395,566,781,16,797,1097,0,3,1,3,0,1,0,76.14,72.65 ,33.33
02,000,02,010,0396,567,702,6,708,1135,0,3,1,3,0,1,0,76.14,62.38 ,33.33
02,000,02,010,0396,568,631,8,639,995,0,3,1,3,0,1,0,76.14,64.22 ,33.33
02,000,02,010,0397,569,1075,16,1091,1588,0,3,1,3,0,1,0,76.14,68.70 ,33.33
02,000,02,010,0397,570,901,13,914,1391,0,3,1,3,0,1,0,76.14,65.71 ,33.33
02,000,02,010,0398,571,1076,13,1089,1554,0,3,1,3,0,1,0,76.14,70.08 ,33.33
02,000,02,010,0398,572,1013,18,1031,1573,0,3,1,3,0,1,0,76.14,65.54 ,33.33
02,000,02,010,0399,573,1184,15,1199,1776,0,3,1,3,0,1,0,76.14,67.51 ,33.33
02,000,02,010,0400,574,892,14,906,1302,0,3,1,3,0,1,0,76.14,69.59 ,33.33
02,000,02,010,0400,575,854,10,864,1242,0,3,1,3,0,1,0,76.14,69.57 ,33.33
02,000,02,010,0401,576,966,10,976,1335,0,3,1,3,0,1,0,76.14,73.11 ,33.33
02,000,02,010,0401,577,910,4,914,1319,0,3,1,3,0,1,0,76.14,69.29 ,33.33
02,000,02,010,0402,578,799,13,812,1201,0,3,1,3,0,1,0,76.14,67.61 ,33.33
02,000,02,010,0402,579,927,14,941,1368,0,3,1,3,0,1,0,76.14,68.79 ,33.33
02,000,02,010,0403,580,607,8,615,973,0,3,1,3,0,1,0,76.14,63.21 ,33.33
02,000,02,010,0403,581,656,6,662,939,0,3,1,3,0,1,0,76.14,70.50 ,33.33
02,000,02,010,0404,582,788,25,813,1147,0,3,1,3,0,1,0,76.14,70.88 ,33.33
02,000,02,010,0404,583,822,12,834,1164,0,3,1,3,0,1,0,76.14,71.65 ,33.33
02,000,02,010,0405,584,701,5,706,1078,0,3,1,3,0,1,0,76.14,65.49 ,33.33
02,000,02,010,0405,585,649,3,652,970,0,3,1,3,0,1,0,76.14,67.22 ,33.33
02,000,02,010,0406,586,955,15,970,1342,0,3,1,3,0,1,0,76.14,72.28 ,33.33
02,000,02,010,0406,587,1048,25,1073,1490,0,3,1,3,0,1,0,76.14,72.01 ,33.33
02,000,02,010,0407,588,933,14,947,1336,0,3,1,3,0,1,0,76.14,70.88 ,33.33
02,000,02,010,0407,589,899,17,916,1214,0,3,1,3,0,1,0,76.14,75.45 ,33.33
02,000,02,010,0408,590,876,81,957,1377,0,3,1,3,0,1,0,76.14,69.50 ,33.33
02,000,02,010,0409,591,1044,22,1066,1480,0,3,1,3,0,1,0,76.14,72.03 ,33.33
02,000,02,010,0409,592,1175,19,1194,1573,0,3,1,3,0,1,0,76.14,75.91 ,33.33
02,000,02,010,0409,593,998,18,1016,1455,0,3,1,3,0,1,0,76.14,69.83 ,33.33
02,000,02,010,0410,594,858,7,865,1184,0,3,1,3,0,1,0,76.14,73.06 ,33.33
02,000,02,010,0410,595,784,11,795,1126,0,3,1,3,0,1,0,76.14,70.60 ,33.33
02,000,02,010,0411,596,1308,17,1325,1874,0,3,1,3,0,1,0,76.14,70.70 ,33.33
02,000,02,010,0411,597,1355,12,1367,1945,0,3,1,3,0,1,0,76.14,70.28 ,33.33
02,000,02,010,0412,598,772,10,782,1157,0,3,1,3,0,1,0,76.14,67.59 ,33.33
02,000,02,010,0412,599,873,15,888,1309,0,3,1,3,0,1,0,76.14,67.84 ,33.33
02,000,02,010,0413,600,740,10,750,1036,0,3,1,3,0,1,0,76.14,72.39 ,33.33
02,000,02,010,0413,601,684,11,695,995,0,3,1,3,0,1,0,76.14,69.85 ,33.33
02,000,02,010,0414,602,894,22,916,1388,0,3,1,3,0,1,0,76.14,65.99 ,33.33
02,000,02,010,0414,603,982,39,1021,1533,0,3,1,3,0,1,0,76.14,66.60 ,33.33
02,000,02,010,0415,604,923,7,930,1401,0,3,1,3,0,1,0,76.14,66.38 ,33.33
02,000,02,010,0415,605,1082,13,1095,1596,0,3,1,3,0,1,0,76.14,68.61 ,33.33
02,000,02,010,0416,606,1015,17,1032,1373,0,3,1,3,0,1,0,76.14,75.16 ,33.33
02,000,02,010,0416,607,932,18,950,1346,0,3,1,3,0,1,0,76.14,70.58 ,33.33
02,000,02,010,0417,608,1025,16,1041,1350,0,3,1,3,0,1,0,76.14,77.11 ,33.33
02,000,02,010,0417,609,954,24,978,1277,0,3,1,3,0,1,0,76.14,76.59 ,33.33
02,000,02,010,0418,610,974,18,992,1386,0,3,1,3,0,1,0,76.14,71.57 ,33.33
02,000,02,010,0418,611,777,10,787,1127,0,3,1,3,0,1,0,76.14,69.83 ,33.33
02,000,02,010,0419,612,771,15,786,1086,0,3,1,3,0,1,0,76.14,72.38 ,33.33
02,000,02,010,0419,613,872,12,884,1291,0,3,1,3,0,1,0,76.14,68.47 ,33.33
02,000,02,010,0420,614,1236,15,1251,1790,0,3,1,3,0,1,0,76.14,69.89 ,33.33
02,000,02,010,0421,615,583,16,599,879,0,3,1,3,0,1,0,76.14,68.15 ,33.33
02,000,02,010,0421,616,723,16,739,1053,0,3,1,3,0,1,0,76.14,70.18 ,33.33
02,000,02,010,0422,617,1200,14,1214,1740,0,3,1,3,0,1,0,76.14,69.77 ,33.33
02,000,02,010,0422,618,873,18,891,1261,0,3,1,3,0,1,0,76.14,70.66 ,33.33
02,000,02,010,0423,619,856,10,866,1215,0,3,1,3,0,1,0,76.14,71.28 ,33.33
02,000,02,010,0423,620,856,29,885,1281,0,3,1,3,0,1,0,76.14,69.09 ,33.33
02,000,02,011,0424,621,1204,12,1216,1752,0,3,1,3,0,1,0,76.14,69.41 ,33.33
02,000,02,011,0425,622,753,5,758,970,0,3,1,3,0,1,0,76.14,78.14 ,33.33
02,000,02,011,0425,623,1048,4,1052,1457,0,3,1,3,0,1,0,76.14,72.20 ,33.33
02,000,02,011,0426,624,1283,11,1294,1722,0,3,1,3,0,1,0,76.14,75.15 ,33.33
02,000,02,011,0427,625,828,15,843,1147,0,3,1,3,0,1,0,76.14,73.50 ,33.33
02,000,02,011,0427,626,927,19,946,1326,0,3,1,3,0,1,0,76.14,71.34 ,33.33
02,000,02,011,0428,627,941,15,956,1339,0,3,1,3,0,1,0,76.14,71.40 ,33.33
02,000,02,011,0429,628,959,14,973,1341,0,3,1,3,0,1,0,76.14,72.56 ,33.33
02,000,02,011,0430,629,899,14,913,1295,0,3,1,3,0,1,0,76.14,70.50 ,33.33
02,000,02,011,0431,630,1229,15,1244,1686,0,3,1,3,0,1,0,76.14,73.78 ,33.33
02,000,02,011,0432,631,688,6,694,942,0,3,1,3,0,1,0,76.14,73.67 ,33.33
02,000,02,011,0432,632,707,6,713,961,0,3,1,3,0,1,0,76.14,74.19 ,33.33
02,000,02,011,0433,633,694,11,705,981,0,3,1,3,0,1,0,76.14,71.87 ,33.33
02,000,02,011,0433,634,1041,11,1052,1464,0,3,1,3,0,1,0,76.14,71.86 ,33.33
02,000,02,011,0434,635,988,16,1004,1361,0,3,1,3,0,1,0,76.14,73.77 ,33.33
02,000,02,011,0434,636,540,13,553,726,0,3,1,3,0,1,0,76.14,76.17 ,33.33
02,000,02,011,0435,637,860,11,871,1280,0,3,1,3,0,1,0,76.14,68.05 ,33.33
02,000,02,011,0436,638,1208,20,1228,1717,0,3,1,3,0,1,0,76.14,71.52 ,33.33
02,000,02,011,0436,639,1258,11,1269,1814,0,3,1,3,0,1,0,76.14,69.96 ,33.33
02,000,02,011,0437,640,874,9,883,1293,0,3,1,3,0,1,0,76.14,68.29 ,33.33
02,000,02,011,0437,641,1010,18,1028,1554,0,3,1,3,0,1,0,76.14,66.15 ,33.33
02,000,02,011,0438,642,727,13,740,1082,0,3,1,3,0,1,0,76.14,68.39 ,33.33
02,000,02,011,0438,643,924,11,935,1329,0,3,1,3,0,1,0,76.14,70.35 ,33.33
02,000,02,011,0439,644,523,3,526,703,0,3,1,3,0,1,0,76.14,74.82 ,33.33
02,000,02,011,0440,645,960,23,983,1415,0,3,1,3,0,1,0,76.14,69.47 ,33.33
02,000,02,011,0441,646,997,21,1018,1433,0,3,1,3,0,1,0,76.14,71.04 ,33.33
02,000,02,011,0441,647,923,19,942,1341,0,3,1,3,0,1,0,76.14,70.25 ,33.33
02,000,02,011,0442,648,881,12,893,1247,0,3,1,3,0,1,0,76.14,71.61 ,33.33
02,000,02,011,0442,649,699,7,706,1014,0,3,1,3,0,1,0,76.14,69.63 ,33.33
02,000,02,011,0443,650,1014,9,1023,1387,0,3,1,3,0,1,0,76.14,73.76 ,33.33
02,000,02,011,0444,651,1398,12,1410,1910,0,3,1,3,0,1,0,76.14,73.82 ,33.33
02,000,02,011,0445,652,1061,14,1075,1454,0,3,1,3,0,1,0,76.14,73.93 ,33.33
02,000,02,011,0446,653,984,11,995,1370,0,3,1,3,0,1,0,76.14,72.63 ,33.33
02,000,02,011,0447,654,955,22,977,1252,0,3,1,3,0,1,0,76.14,78.04 ,33.33
02,000,02,011,0448,655,889,24,913,1200,0,3,1,3,0,1,0,76.14,76.08 ,33.33
02,000,02,011,0448,656,1077,20,1097,1364,0,3,1,3,0,1,0,76.14,80.43 ,33.33
02,000,02,011,0449,657,715,12,727,938,0,3,1,3,0,1,0,76.14,77.51 ,33.33
02,000,02,011,0450,658,685,8,693,958,0,3,1,3,0,1,0,76.14,72.34 ,33.33
02,000,02,011,0451,659,713,4,717,971,0,3,1,3,0,1,0,76.14,73.84 ,33.33
02,000,02,011,0451,660,1002,28,1030,1512,0,3,1,3,0,1,0,76.14,68.12 ,33.33
02,000,02,011,0452,661,1179,12,1191,1691,0,3,1,3,0,1,0,76.14,70.43 ,33.33
02,000,02,011,0453,662,926,17,943,1292,0,3,1,3,0,1,0,76.14,72.99 ,33.33
02,000,02,011,0454,663,1146,20,1166,1548,0,3,1,3,0,1,0,76.14,75.32 ,33.33
02,000,02,011,0454,664,1593,21,1614,2341,0,3,1,3,0,1,0,76.14,68.94 ,33.33
02,000,02,011,0455,665,623,11,634,855,0,3,1,3,0,1,0,76.14,74.15 ,33.33
02,000,02,011,0455,666,795,21,816,1100,0,3,1,3,0,1,0,76.14,74.18 ,33.33
02,000,02,011,0456,667,1392,15,1407,1722,0,3,1,3,0,1,0,76.14,81.71 ,33.33
02,000,02,011,0457,668,1500,13,1513,1859,0,3,1,3,0,1,0,76.14,81.39 ,33.33
02,000,02,011,0458,669,1075,11,1086,1374,0,3,1,3,0,1,0,76.14,79.04 ,33.33
02,000,02,011,0459,670,742,9,751,951,0,3,1,3,0,1,0,76.14,78.97 ,33.33
02,000,02,011,0459,671,792,12,804,1116,0,3,1,3,0,1,0,76.14,72.04 ,33.33
02,000,02,011,0460,672,1417,17,1434,1964,0,3,1,3,0,1,0,76.14,73.01 ,33.33
02,000,02,011,0461,673,1056,12,1068,1358,0,3,1,3,0,1,0,76.14,78.65 ,33.33
02,000,02,011,0462,674,1350,13,1363,1870,0,3,1,3,0,1,0,76.14,72.89 ,33.33
02,000,02,011,0462,675,1227,9,1236,1833,0,3,1,3,0,1,0,76.14,67.43 ,33.33
02,000,02,011,0463,676,1372,18,1390,1986,0,3,1,3,0,1,0,76.14,69.99 ,33.33
02,000,02,011,0464,677,822,10,832,1185,0,3,1,3,0,1,0,76.14,70.21 ,33.33
02,000,02,011,0464,678,653,5,658,932,0,3,1,3,0,1,0,76.14,70.60 ,33.33
02,000,02,011,0465,679,763,8,771,1134,0,3,1,3,0,1,0,76.14,67.99 ,33.33
02,000,02,011,0465,680,859,10,869,1223,0,3,1,3,0,1,0,76.14,71.05 ,33.33
02,000,02,011,0466,681,1009,16,1025,1471,0,3,1,3,0,1,0,76.14,69.68 ,33.33
02,000,02,011,0466,682,618,10,628,891,0,3,1,3,0,1,0,76.14,70.48 ,33.33
03,001,01,001,0001,1,842,10,852,1239,0,3,1,3,0,1,0,76.14,68.77 ,33.33
03,001,01,001,0002,2,907,10,917,1292,0,3,1,3,0,1,0,76.14,70.98 ,33.33
03,001,01,001,0003,3,403,6,409,553,0,3,1,3,0,1,0,76.14,73.96 ,33.33
03,001,01,001,0004,4,781,11,792,1133,0,3,1,3,0,1,0,76.14,69.90 ,33.33
03,001,01,001,0005,5,603,4,607,865,0,3,1,3,0,1,0,76.14,70.17 ,33.33
03,001,01,001,0005,6,507,5,512,779,0,3,1,3,0,1,0,76.14,65.73 ,33.33
03,001,01,001,0006,7,723,16,739,1129,0,3,1,3,0,1,0,76.14,65.46 ,33.33
03,001,01,001,0006,8,924,13,937,1411,0,3,1,3,0,1,0,76.14,66.41 ,33.33
03,001,01,001,0006,9,906,20,926,1349,0,3,1,3,0,1,0,76.14,68.64 ,33.33
03,001,01,001,0007,10,906,10,916,1289,0,3,1,3,0,1,0,76.14,71.06 ,33.33
03,001,01,001,0007,11,788,9,797,1201,0,3,1,3,0,1,0,76.14,66.36 ,33.33
03,001,01,001,0008,12,721,6,727,1021,0,3,1,3,0,1,0,76.14,71.20 ,33.33
03,001,01,001,0008,13,886,19,905,1391,0,3,1,3,0,1,0,76.14,65.06 ,33.33
03,001,01,001,0008,14,724,13,737,1115,0,3,1,3,0,1,0,76.14,66.10 ,33.33
03,001,01,001,0008,15,626,10,636,965,0,3,1,3,0,1,0,76.14,65.91 ,33.33
03,001,01,001,0009,16,694,10,704,1045,0,3,1,3,0,1,0,76.14,67.37 ,33.33
03,001,01,001,0009,17,700,7,707,1017,0,3,1,3,0,1,0,76.14,69.52 ,33.33
03,001,01,001,0009,18,673,12,685,990,0,3,1,3,0,1,0,76.14,69.19 ,33.33
03,001,01,001,0010,19,642,6,648,948,0,3,1,3,0,1,0,76.14,68.35 ,33.33
03,001,01,001,0010,20,680,6,686,1048,0,3,1,3,0,1,0,76.14,65.46 ,33.33
03,001,01,001,0011,21,736,19,755,1175,0,3,1,3,0,1,0,76.14,64.26 ,33.33
03,001,01,001,0011,22,793,21,814,1229,0,3,1,3,0,1,0,76.14,66.23 ,33.33
03,001,01,001,0011,23,739,16,755,1145,0,3,1,3,0,1,0,76.14,65.94 ,33.33
03,001,01,001,0012,24,778,6,784,1088,0,3,1,3,0,1,0,76.14,72.06 ,33.33
03,001,01,001,0012,25,703,4,707,980,0,3,1,3,0,1,0,76.14,72.14 ,33.33
03,001,01,001,0012,26,802,11,813,1152,0,3,1,3,0,1,0,76.14,70.57 ,33.33
03,001,01,001,0012,27,779,8,787,1082,0,3,1,3,0,1,0,76.14,72.74 ,33.33
03,001,01,001,0013,28,856,7,863,1270,0,3,1,3,0,1,0,76.14,67.95 ,33.33
03,001,01,001,0013,29,728,8,736,1112,0,3,1,3,0,1,0,76.14,66.19 ,33.33
03,001,01,001,0014,30,733,9,742,1165,0,3,1,3,0,1,0,76.14,63.69 ,33.33
03,001,01,001,0014,31,680,4,684,943,0,3,1,3,0,1,0,76.14,72.53 ,33.33
03,001,01,001,0015,32,739,10,749,1082,0,3,1,3,0,1,0,76.14,69.22 ,33.33
03,001,01,001,0015,33,769,14,783,1093,0,3,1,3,0,1,0,76.14,71.64 ,33.33
03,001,01,001,0016,34,1836,13,1849,2442,0,3,1,3,0,1,0,76.14,75.72 ,33.33
03,001,01,001,0017,35,956,9,965,1434,0,3,1,3,0,1,0,76.14,67.29 ,33.33
03,001,01,001,0018,36,791,13,804,1171,0,3,1,3,0,1,0,76.14,68.66 ,33.33
03,001,01,001,0018,37,780,15,795,1165,0,3,1,3,0,1,0,76.14,68.24 ,33.33
03,001,01,001,0018,38,687,6,693,1013,0,3,1,3,0,1,0,76.14,68.41 ,33.33
03,001,01,001,0019,39,668,12,680,1092,0,3,1,3,0,1,0,76.14,62.27 ,33.33
03,001,01,001,0019,40,731,13,744,1111,0,3,1,3,0,1,0,76.14,66.97 ,33.33
03,001,01,001,0019,41,604,9,613,888,0,3,1,3,0,1,0,76.14,69.03 ,33.33
03,001,01,001,0020,42,753,15,768,1132,0,3,1,3,0,1,0,76.14,67.84 ,33.33
03,001,01,001,0020,43,670,8,678,1055,0,3,1,3,0,1,0,76.14,64.27 ,33.33
03,001,01,001,0020,44,524,6,530,812,0,3,1,3,0,1,0,76.14,65.27 ,33.33
03,001,01,001,0020,45,599,8,607,952,0,3,1,3,0,1,0,76.14,63.76 ,33.33
03,001,01,001,0021,46,814,10,824,1193,0,3,1,3,0,1,0,76.14,69.07 ,33.33
03,001,01,001,0021,47,936,11,947,1303,0,3,1,3,0,1,0,76.14,72.68 ,33.33
03,001,01,001,0022,48,654,9,663,983,0,3,1,3,0,1,0,76.14,67.45 ,33.33
03,001,01,001,0022,49,589,5,594,832,0,3,1,3,0,1,0,76.14,71.39 ,33.33
03,001,01,001,0023,50,702,10,712,996,0,3,1,3,0,1,0,76.14,71.49 ,33.33
03,001,01,001,0023,51,693,7,700,1020,0,3,1,3,0,1,0,76.14,68.63 ,33.33
03,001,01,001,0023,52,727,13,740,1193,0,3,1,3,0,1,0,76.14,62.03 ,33.33
03,001,01,001,0024,53,887,8,895,1299,0,3,1,3,0,1,0,76.14,68.90 ,33.33
03,001,01,001,0024,54,987,6,993,1355,0,3,1,3,0,1,0,76.14,73.28 ,33.33
03,001,01,001,0024,55,786,14,800,1094,0,3,1,3,0,1,0,76.14,73.13 ,33.33
03,001,01,001,0025,56,575,13,588,806,0,3,1,3,0,1,0,76.14,72.95 ,33.33
03,001,01,001,0025,57,626,8,634,856,0,3,1,3,0,1,0,76.14,74.07 ,33.33
03,001,01,001,0025,58,943,15,958,1345,0,3,1,3,0,1,0,76.14,71.23 ,33.33
03,001,01,001,0026,59,805,6,811,1194,0,3,1,3,0,1,0,76.14,67.92 ,33.33
03,001,01,001,0026,60,799,5,804,1133,0,3,1,3,0,1,0,76.14,70.96 ,33.33
03,001,01,001,0026,61,907,19,926,1317,0,3,1,3,0,1,0,76.14,70.31 ,33.33
03,001,01,001,0027,62,644,9,653,898,0,3,1,3,0,1,0,76.14,72.72 ,33.33
03,001,01,001,0027,63,763,15,778,1150,0,3,1,3,0,1,0,76.14,67.65 ,33.33
03,001,01,001,0027,64,647,4,651,971,0,3,1,3,0,1,0,76.14,67.04 ,33.33
03,001,01,001,0028,65,599,14,613,889,0,3,1,3,0,1,0,76.14,68.95 ,33.33
03,001,01,001,0028,66,618,8,626,919,0,3,1,3,0,1,0,76.14,68.12 ,33.33
03,001,01,001,0029,67,720,1,721,972,0,3,1,3,0,1,0,76.14,74.18 ,33.33
03,001,01,001,0029,68,743,4,747,981,0,3,1,3,0,1,0,76.14,76.15 ,33.33
03,001,01,001,0030,69,816,5,821,1135,0,3,1,3,0,1,0,76.14,72.33 ,33.33
03,001,01,001,0030,70,736,16,752,1098,0,3,1,3,0,1,0,76.14,68.49 ,33.33
03,001,01,001,0031,71,678,15,693,956,0,3,1,3,0,1,0,76.14,72.49 ,33.33
03,001,01,001,0031,72,703,5,708,993,0,3,1,3,0,1,0,76.14,71.30 ,33.33
03,001,01,001,0032,73,736,4,740,1068,0,3,1,3,0,1,0,76.14,69.29 ,33.33
03,001,01,001,0032,74,833,4,837,1268,0,3,1,3,0,1,0,76.14,66.01 ,33.33
03,001,01,001,0033,75,608,12,620,919,0,3,1,3,0,1,0,76.14,67.46 ,33.33
03,001,01,001,0033,76,752,9,761,1072,0,3,1,3,0,1,0,76.14,70.99 ,33.33
03,001,01,001,0034,77,441,9,450,721,0,3,1,3,0,1,0,76.14,62.41 ,33.33
03,001,01,001,0034,78,605,5,610,922,0,3,1,3,0,1,0,76.14,66.16 ,33.33
03,001,01,001,0034,79,699,6,705,994,0,3,1,3,0,1,0,76.14,70.93 ,33.33
03,001,01,001,0035,80,741,6,747,1117,0,3,1,3,0,1,0,76.14,66.88 ,33.33
03,001,01,001,0035,81,791,11,802,1198,0,3,1,3,0,1,0,76.14,66.94 ,33.33
03,001,01,001,0035,82,804,6,810,1189,0,3,1,3,0,1,0,76.14,68.12 ,33.33
03,001,01,001,0036,83,704,8,712,1046,0,3,1,3,0,1,0,76.14,68.07 ,33.33
03,001,01,001,0036,84,745,10,755,1098,0,3,1,3,0,1,0,76.14,68.76 ,33.33
03,001,01,001,0036,85,550,11,561,823,0,3,1,3,0,1,0,76.14,68.17 ,33.33
03,001,01,001,0037,86,770,7,777,1133,0,3,1,3,0,1,0,76.14,68.58 ,33.33
03,001,01,001,0037,87,488,7,495,835,0,3,1,3,0,1,0,76.14,59.28 ,33.33
03,001,01,001,0037,88,641,13,654,1055,0,3,1,3,0,1,0,76.14,61.99 ,33.33
03,001,01,001,0037,89,571,5,576,837,0,3,1,3,0,1,0,76.14,68.82 ,33.33
03,001,01,001,0038,90,593,7,600,908,0,3,1,3,0,1,0,76.14,66.08 ,33.33
03,001,01,001,0038,91,758,9,767,1135,0,3,1,3,0,1,0,76.14,67.58 ,33.33
03,001,01,001,0039,92,828,10,838,1218,0,3,1,3,0,1,0,76.14,68.80 ,33.33
03,001,01,001,0039,93,842,14,856,1268,0,3,1,3,0,1,0,76.14,67.51 ,33.33
03,001,01,001,0040,94,740,13,753,1092,0,3,1,3,0,1,0,76.14,68.96 ,33.33
03,001,01,001,0040,95,723,16,739,1074,0,3,1,3,0,1,0,76.14,68.81 ,33.33
03,001,01,001,0041,96,789,20,809,1172,0,3,1,3,0,1,0,76.14,69.03 ,33.33
03,001,01,001,0041,97,869,12,881,1270,0,3,1,3,0,1,0,76.14,69.37 ,33.33
03,001,01,001,0042,98,625,13,638,975,0,3,1,3,0,1,0,76.14,65.44 ,33.33
03,001,01,001,0042,99,904,12,916,1289,0,3,1,3,0,1,0,76.14,71.06 ,33.33
03,001,01,001,0042,100,816,10,826,1227,0,3,1,3,0,1,0,76.14,67.32 ,33.33
03,001,01,001,0043,101,524,8,532,781,0,3,1,3,0,1,0,76.14,68.12 ,33.33
03,001,01,001,0043,102,496,4,500,743,0,3,1,3,0,1,0,76.14,67.29 ,33.33
03,001,01,001,0043,103,662,13,675,1062,0,3,1,3,0,1,0,76.14,63.56 ,33.33
03,001,01,001,0044,104,895,11,906,1311,0,3,1,3,0,1,0,76.14,69.11 ,33.33
03,001,01,001,0044,105,923,15,938,1386,0,3,1,3,0,1,0,76.14,67.68 ,33.33
03,001,01,001,0045,106,778,13,791,1228,0,3,1,3,0,1,0,76.14,64.41 ,33.33
03,001,01,001,0045,107,721,6,727,1104,0,3,1,3,0,1,0,76.14,65.85 ,33.33
03,001,01,001,0046,108,814,15,829,1319,0,3,1,3,0,1,0,76.14,62.85 ,33.33
03,001,01,001,0046,109,780,11,791,1279,0,3,1,3,0,1,0,76.14,61.85 ,33.33
03,001,01,001,0047,110,409,9,418,615,0,3,1,3,0,1,0,76.14,67.97 ,33.33
03,001,01,001,0047,111,489,7,496,733,0,3,1,3,0,1,0,76.14,67.67 ,33.33
03,001,01,001,0047,112,883,10,893,1287,0,3,1,3,0,1,0,76.14,69.39 ,33.33
03,001,01,001,0048,113,564,6,570,883,0,3,1,3,0,1,0,76.14,64.55 ,33.33
03,001,01,001,0048,114,699,11,710,1038,0,3,1,3,0,1,0,76.14,68.40 ,33.33
03,001,01,001,0048,115,617,5,622,897,0,3,1,3,0,1,0,76.14,69.34 ,33.33
03,001,01,001,0048,116,925,5,930,1341,0,3,1,3,0,1,0,76.14,69.35 ,33.33
03,001,01,001,0049,117,850,11,861,1290,0,3,1,3,0,1,0,76.14,66.74 ,33.33
03,001,01,001,0049,118,721,10,731,1155,0,3,1,3,0,1,0,76.14,63.29 ,33.33
03,001,01,001,0050,119,845,8,853,1221,0,3,1,3,0,1,0,76.14,69.86 ,33.33
03,001,01,001,0050,120,900,14,914,1336,0,3,1,3,0,1,0,76.14,68.41 ,33.33
03,001,01,001,0051,121,583,3,586,929,0,3,1,3,0,1,0,76.14,63.08 ,33.33
03,001,01,001,0051,122,691,13,704,1059,0,3,1,3,0,1,0,76.14,66.48 ,33.33
03,001,01,001,0051,123,713,7,720,1016,0,3,1,3,0,1,0,76.14,70.87 ,33.33
03,001,01,001,0052,124,746,3,749,1096,0,3,1,3,0,1,0,76.14,68.34 ,33.33
03,001,01,001,0052,125,584,4,588,925,0,3,1,3,0,1,0,76.14,63.57 ,33.33
03,001,01,001,0053,126,746,13,759,1145,0,3,1,3,0,1,0,76.14,66.29 ,33.33
03,001,01,001,0053,127,896,5,901,1293,0,3,1,3,0,1,0,76.14,69.68 ,33.33
03,001,01,001,0054,128,804,8,812,1205,0,3,1,3,0,1,0,76.14,67.39 ,33.33
03,001,01,001,0054,129,621,4,625,976,0,3,1,3,0,1,0,76.14,64.04 ,33.33
03,001,01,001,0055,130,649,9,658,964,0,3,1,3,0,1,0,76.14,68.26 ,33.33
03,001,01,001,0055,131,785,12,797,1148,0,3,1,3,0,1,0,76.14,69.43 ,33.33
03,001,01,001,0055,132,808,19,827,1232,0,3,1,3,0,1,0,76.14,67.13 ,33.33
03,001,01,001,0056,133,727,11,738,1193,0,3,1,3,0,1,0,76.14,61.86 ,33.33
03,001,01,001,0056,134,648,12,660,1002,0,3,1,3,0,1,0,76.14,65.87 ,33.33
03,001,01,001,0057,135,672,11,683,969,0,3,1,3,0,1,0,76.14,70.49 ,33.33
03,001,01,001,0057,136,657,11,668,1001,0,3,1,3,0,1,0,76.14,66.73 ,33.33
03,001,01,001,0058,137,757,16,773,1055,0,3,1,3,0,1,0,76.14,73.27 ,33.33
03,001,01,001,0058,138,606,8,614,934,0,3,1,3,0,1,0,76.14,65.74 ,33.33
03,001,01,001,0058,139,599,6,605,895,0,3,1,3,0,1,0,76.14,67.60 ,33.33
03,001,01,001,0059,140,809,12,821,1281,0,3,1,3,0,1,0,76.14,64.09 ,33.33
03,001,01,001,0059,141,826,12,838,1308,0,3,1,3,0,1,0,76.14,64.07 ,33.33
03,001,01,001,0060,142,712,11,723,1165,0,3,1,3,0,1,0,76.14,62.06 ,33.33
03,001,01,001,0060,143,677,15,692,1045,0,3,1,3,0,1,0,76.14,66.22 ,33.33
03,001,01,001,0060,144,798,11,809,1283,0,3,1,3,0,1,0,76.14,63.06 ,33.33
03,001,01,001,0061,145,517,13,530,784,0,3,1,3,0,1,0,76.14,67.60 ,33.33
03,001,01,001,0061,146,659,6,665,976,0,3,1,3,0,1,0,76.14,68.14 ,33.33
03,001,01,001,0062,147,851,16,867,1198,0,3,1,3,0,1,0,76.14,72.37 ,33.33
03,001,01,001,0062,148,560,0,560,860,0,3,1,3,0,1,0,76.14,65.12 ,33.33
03,001,01,001,0062,149,787,9,796,1222,0,3,1,3,0,1,0,76.14,65.14 ,33.33
03,001,01,001,0062,150,546,9,555,867,0,3,1,3,0,1,0,76.14,64.01 ,33.33
03,001,01,001,0063,151,787,9,796,1160,0,3,1,3,0,1,0,76.14,68.62 ,33.33
03,001,01,001,0063,152,810,17,827,1132,0,3,1,3,0,1,0,76.14,73.06 ,33.33
03,001,01,001,0063,153,690,14,704,963,0,3,1,3,0,1,0,76.14,73.10 ,33.33
03,001,01,001,0064,154,721,19,740,1056,0,3,1,3,0,1,0,76.14,70.08 ,33.33
03,001,01,001,0064,155,678,11,689,1088,0,3,1,3,0,1,0,76.14,63.33 ,33.33
03,001,01,001,0064,156,607,7,614,897,0,3,1,3,0,1,0,76.14,68.45 ,33.33
03,001,01,001,0065,157,760,14,774,1152,0,3,1,3,0,1,0,76.14,67.19 ,33.33
03,001,01,001,0065,158,804,20,824,1242,0,3,1,3,0,1,0,76.14,66.34 ,33.33
03,001,01,001,0066,159,849,26,875,1275,0,3,1,3,0,1,0,76.14,68.63 ,33.33
03,001,01,001,0066,160,792,6,798,1216,0,3,1,3,0,1,0,76.14,65.63 ,33.33
03,001,01,001,0066,161,851,12,863,1291,0,3,1,3,0,1,0,76.14,66.85 ,33.33
03,001,01,001,0067,162,513,7,520,818,0,3,1,3,0,1,0,76.14,63.57 ,33.33
03,001,01,001,0067,163,519,4,523,758,0,3,1,3,0,1,0,76.14,69.00 ,33.33
03,001,01,001,0068,164,834,21,855,1204,0,3,1,3,0,1,0,76.14,71.01 ,33.33
03,001,01,001,0068,165,641,10,651,976,0,3,1,3,0,1,0,76.14,66.70 ,33.33
03,001,01,001,0069,166,671,13,684,1010,0,3,1,3,0,1,0,76.14,67.72 ,33.33
03,001,01,001,0069,167,692,7,699,995,0,3,1,3,0,1,0,76.14,70.25 ,33.33
03,001,01,001,0070,168,725,10,735,1045,0,3,1,3,0,1,0,76.14,70.33 ,33.33
03,001,01,001,0070,169,926,20,946,1294,0,3,1,3,0,1,0,76.14,73.11 ,33.33
03,001,01,001,0071,170,567,17,584,861,0,3,1,3,0,1,0,76.14,67.83 ,33.33
03,001,01,001,0071,171,549,4,553,759,0,3,1,3,0,1,0,76.14,72.86 ,33.33
03,001,01,001,0071,172,860,12,872,1207,0,3,1,3,0,1,0,76.14,72.25 ,33.33
03,001,01,001,0071,173,691,10,701,1054,0,3,1,3,0,1,0,76.14,66.51 ,33.33
03,001,01,001,0072,174,772,14,786,1231,0,3,1,3,0,1,0,76.14,63.85 ,33.33
03,001,01,001,0072,175,745,8,753,1109,0,3,1,3,0,1,0,76.14,67.90 ,33.33
03,001,01,001,0073,176,775,10,785,1078,0,3,1,3,0,1,0,76.14,72.82 ,33.33
03,001,01,001,0073,177,696,8,704,1046,0,3,1,3,0,1,0,76.14,67.30 ,33.33
03,001,01,001,0074,178,654,4,658,977,0,3,1,3,0,1,0,76.14,67.35 ,33.33
03,001,01,001,0074,179,823,14,837,1247,0,3,1,3,0,1,0,76.14,67.12 ,33.33
03,001,01,001,0074,180,759,13,772,1144,0,3,1,3,0,1,0,76.14,67.48 ,33.33
03,001,01,001,0075,181,842,6,848,1183,0,3,1,3,0,1,0,76.14,71.68 ,33.33
03,001,01,001,0075,182,791,9,800,1158,0,3,1,3,0,1,0,76.14,69.08 ,33.33
03,001,01,001,0076,183,881,11,892,1343,0,3,1,3,0,1,0,76.14,66.42 ,33.33
03,001,01,001,0076,184,845,12,857,1287,0,3,1,3,0,1,0,76.14,66.59 ,33.33
03,001,01,001,0077,185,440,4,444,651,0,3,1,3,0,1,0,76.14,68.20 ,33.33
03,001,01,001,0077,186,477,5,482,708,0,3,1,3,0,1,0,76.14,68.08 ,33.33
03,001,01,001,0078,187,728,4,732,1125,0,3,1,3,0,1,0,76.14,65.07 ,33.33
03,001,01,001,0078,188,597,13,610,955,0,3,1,3,0,1,0,76.14,63.87 ,33.33
03,001,01,001,0079,189,698,15,713,1224,0,3,1,3,0,1,0,76.14,58.25 ,33.33
03,001,01,001,0079,190,812,16,828,1265,0,3,1,3,0,1,0,76.14,65.45 ,33.33
03,001,01,001,0080,191,599,7,606,1005,0,3,1,3,0,1,0,76.14,60.30 ,33.33
03,001,01,001,0080,192,609,10,619,961,0,3,1,3,0,1,0,76.14,64.41 ,33.33
03,001,01,001,0080,193,612,9,621,921,0,3,1,3,0,1,0,76.14,67.43 ,33.33
03,001,01,001,0081,194,714,2,716,1067,0,3,1,3,0,1,0,76.14,67.10 ,33.33
03,001,01,001,0081,195,934,10,944,1316,0,3,1,3,0,1,0,76.14,71.73 ,33.33
03,001,01,001,0081,196,558,5,563,850,0,3,1,3,0,1,0,76.14,66.24 ,33.33
03,001,01,001,0081,197,478,1,479,682,0,3,1,3,0,1,0,76.14,70.23 ,33.33
03,001,01,001,0082,198,606,11,617,891,0,3,1,3,0,1,0,76.14,69.25 ,33.33
03,001,01,001,0082,199,599,8,607,839,0,3,1,3,0,1,0,76.14,72.35 ,33.33
03,001,01,001,0082,200,650,8,658,959,0,3,1,3,0,1,0,76.14,68.61 ,33.33
03,001,01,001,0083,201,775,12,787,1143,0,3,1,3,0,1,0,76.14,68.85 ,33.33
03,001,01,001,0083,202,493,3,496,749,0,3,1,3,0,1,0,76.14,66.22 ,33.33
03,001,01,001,0084,203,631,8,639,979,0,3,1,3,0,1,0,76.14,65.27 ,33.33
03,001,01,001,0084,204,779,13,792,1150,0,3,1,3,0,1,0,76.14,68.87 ,33.33
03,001,01,001,0084,205,710,13,723,1070,0,3,1,3,0,1,0,76.14,67.57 ,33.33
03,001,01,001,0085,206,393,7,400,656,0,3,1,3,0,1,0,76.14,60.98 ,33.33
03,001,01,001,0085,207,501,5,506,742,0,3,1,3,0,1,0,76.14,68.19 ,33.33
03,001,01,001,0086,208,765,7,772,1236,0,3,1,3,0,1,0,76.14,62.46 ,33.33
03,001,01,001,0086,209,838,16,854,1226,0,3,1,3,0,1,0,76.14,69.66 ,33.33
03,001,01,001,0087,210,622,12,634,922,0,3,1,3,0,1,0,76.14,68.76 ,33.33
03,001,01,001,0087,211,671,8,679,996,0,3,1,3,0,1,0,76.14,68.17 ,33.33
03,001,01,001,0088,212,533,4,537,809,0,3,1,3,0,1,0,76.14,66.38 ,33.33
03,001,01,001,0088,213,527,12,539,795,0,3,1,3,0,1,0,76.14,67.80 ,33.33
03,001,01,001,0089,214,659,14,673,1048,0,3,1,3,0,1,0,76.14,64.22 ,33.33
03,001,01,001,0089,215,921,15,936,1303,0,3,1,3,0,1,0,76.14,71.83 ,33.33
03,001,01,001,0090,216,745,6,751,1082,0,3,1,3,0,1,0,76.14,69.41 ,33.33
03,001,01,001,0090,217,767,5,772,1130,0,3,1,3,0,1,0,76.14,68.32 ,33.33
03,001,01,001,0090,218,646,8,654,962,0,3,1,3,0,1,0,76.14,67.98 ,33.33
03,001,01,001,0091,219,747,13,760,1147,0,3,1,3,0,1,0,76.14,66.26 ,33.33
03,001,01,001,0091,220,657,12,669,1028,0,3,1,3,0,1,0,76.14,65.08 ,33.33
03,001,01,001,0092,221,885,7,892,1281,0,3,1,3,0,1,0,76.14,69.63 ,33.33
03,001,01,001,0092,222,684,10,694,1073,0,3,1,3,0,1,0,76.14,64.68 ,33.33
03,001,01,001,0093,223,762,7,769,1175,0,3,1,3,0,1,0,76.14,65.45 ,33.33
03,001,01,001,0093,224,817,14,831,1187,0,3,1,3,0,1,0,76.14,70.01 ,33.33
03,001,01,001,0093,225,882,13,895,1264,0,3,1,3,0,1,0,76.14,70.81 ,33.33
03,001,01,001,0094,226,855,7,862,1186,0,3,1,3,0,1,0,76.14,72.68 ,33.33
03,001,01,001,0094,227,801,9,810,1236,0,3,1,3,0,1,0,76.14,65.53 ,33.33
03,001,01,001,0095,228,787,10,797,1159,0,3,1,3,0,1,0,76.14,68.77 ,33.33
03,001,01,001,0095,229,684,7,691,1035,0,3,1,3,0,1,0,76.14,66.76 ,33.33
03,001,01,001,0096,230,790,16,806,1062,0,3,1,3,0,1,0,76.14,75.89 ,33.33
03,001,01,001,0096,231,929,17,946,1311,0,3,1,3,0,1,0,76.14,72.16 ,33.33
03,001,01,001,0097,232,699,11,710,1059,0,3,1,3,0,1,0,76.14,67.04 ,33.33
03,001,01,001,0097,233,871,6,877,1276,0,3,1,3,0,1,0,76.14,68.73 ,33.33
03,001,01,001,0097,234,1066,9,1075,1516,0,3,1,3,0,1,0,76.14,70.91 ,33.33
03,001,01,001,0098,235,945,16,961,1437,0,3,1,3,0,1,0,76.14,66.88 ,33.33
03,001,01,001,0098,236,640,18,658,998,0,3,1,3,0,1,0,76.14,65.93 ,33.33
03,001,01,001,0098,237,737,9,746,1083,0,3,1,3,0,1,0,76.14,68.88 ,33.33
03,001,01,001,0099,238,650,6,656,996,0,3,1,3,0,1,0,76.14,65.86 ,33.33
03,001,01,001,0099,239,795,20,815,1130,0,3,1,3,0,1,0,76.14,72.12 ,33.33
03,001,01,001,0099,240,742,14,756,1118,0,3,1,3,0,1,0,76.14,67.62 ,33.33
03,001,01,001,0099,241,716,13,729,1045,0,3,1,3,0,1,0,76.14,69.76 ,33.33
03,001,01,001,0100,242,749,3,752,950,0,3,1,3,0,1,0,76.14,79.16 ,33.33
03,001,01,001,0100,243,586,7,593,870,0,3,1,3,0,1,0,76.14,68.16 ,33.33
03,001,01,001,0100,244,615,9,624,925,0,3,1,3,0,1,0,76.14,67.46 ,33.33
03,001,01,001,0101,245,596,12,608,880,0,3,1,3,0,1,0,76.14,69.09 ,33.33
03,001,01,001,0102,246,710,14,724,1027,0,3,1,3,0,1,0,76.14,70.50 ,33.33
03,001,01,001,0102,247,641,12,653,1059,0,3,1,3,0,1,0,76.14,61.66 ,33.33
03,001,01,001,0103,248,890,16,906,1322,0,3,1,3,0,1,0,76.14,68.53 ,33.33
03,001,01,001,0103,249,657,7,664,979,0,3,1,3,0,1,0,76.14,67.82 ,33.33
03,001,01,001,0103,250,773,4,777,1163,0,3,1,3,0,1,0,76.14,66.81 ,33.33
03,001,01,001,0104,251,674,8,682,1058,0,3,1,3,0,1,0,76.14,64.46 ,33.33
03,001,01,001,0104,252,752,9,761,1149,0,3,1,3,0,1,0,76.14,66.23 ,33.33
03,001,01,001,0105,253,744,9,753,1099,0,3,1,3,0,1,0,76.14,68.52 ,33.33
03,001,01,001,0105,254,809,5,814,1141,0,3,1,3,0,1,0,76.14,71.34 ,33.33
03,001,01,001,0106,255,571,8,579,817,0,3,1,3,0,1,0,76.14,70.87 ,33.33
03,001,01,001,0106,256,542,14,556,820,0,3,1,3,0,1,0,76.14,67.80 ,33.33
03,001,01,001,0107,257,904,22,926,1388,0,3,1,3,0,1,0,76.14,66.71 ,33.33
03,001,01,001,0107,258,639,6,645,1007,0,3,1,3,0,1,0,76.14,64.05 ,33.33
03,001,01,001,0107,259,823,9,832,1272,0,3,1,3,0,1,0,76.14,65.41 ,33.33
03,001,01,001,0108,260,488,7,495,688,0,3,1,3,0,1,0,76.14,71.95 ,33.33
03,001,01,001,0108,261,1055,12,1067,1476,0,3,1,3,0,1,0,76.14,72.29 ,33.33
03,001,01,001,0108,262,806,13,819,1172,0,3,1,3,0,1,0,76.14,69.88 ,33.33
03,001,01,001,0109,263,724,14,738,1045,0,3,1,3,0,1,0,76.14,70.62 ,33.33
03,001,01,001,0109,264,649,6,655,961,0,3,1,3,0,1,0,76.14,68.16 ,33.33
03,001,01,001,0109,265,793,20,813,1135,0,3,1,3,0,1,0,76.14,71.63 ,33.33
03,001,01,001,0110,266,746,8,754,1256,0,3,1,3,0,1,0,76.14,60.03 ,33.33
03,001,01,001,0110,267,724,14,738,1166,0,3,1,3,0,1,0,76.14,63.29 ,33.33
03,001,01,001,0110,268,516,7,523,1129,0,3,1,3,0,1,0,76.14,46.32 ,33.33
03,001,01,001,0111,269,794,15,809,1279,0,3,1,3,0,1,0,76.14,63.25 ,33.33
03,001,01,001,0111,270,643,10,653,1063,0,3,1,3,0,1,0,76.14,61.43 ,33.33
03,001,01,001,0111,271,782,17,799,1288,0,3,1,3,0,1,0,76.14,62.03 ,33.33
03,001,01,001,0112,272,768,8,776,1138,0,3,1,3,0,1,0,76.14,68.19 ,33.33
03,001,01,001,0112,273,511,10,521,727,0,3,1,3,0,1,0,76.14,71.66 ,33.33
03,001,01,001,0112,274,483,7,490,686,0,3,1,3,0,1,0,76.14,71.43 ,33.33
03,001,01,001,0113,275,766,15,781,1160,0,3,1,3,0,1,0,76.14,67.33 ,33.33
03,001,01,001,0113,276,827,15,842,1232,0,3,1,3,0,1,0,76.14,68.34 ,33.33
03,001,01,001,0114,277,731,13,744,1058,0,3,1,3,0,1,0,76.14,70.32 ,33.33
03,001,01,001,0115,278,620,13,633,1014,0,3,1,3,0,1,0,76.14,62.43 ,33.33
03,001,01,001,0115,279,568,9,577,923,0,3,1,3,0,1,0,76.14,62.51 ,33.33
03,001,01,001,0115,280,693,17,710,1076,0,3,1,3,0,1,0,76.14,65.99 ,33.33
03,001,01,001,0115,281,670,10,680,978,0,3,1,3,0,1,0,76.14,69.53 ,33.33
03,001,01,001,0116,282,720,19,739,949,0,3,1,3,0,1,0,76.14,77.87 ,33.33
03,001,01,001,0116,283,1149,41,1190,1636,0,3,1,3,0,1,0,76.14,72.74 ,33.33
03,001,01,001,0116,284,413,3,416,686,0,3,1,3,0,1,0,76.14,60.64 ,33.33
03,001,01,001,0117,285,743,13,756,1207,0,3,1,3,0,1,0,76.14,62.63 ,33.33
03,001,01,001,0117,286,843,11,854,1201,0,3,1,3,0,1,0,76.14,71.11 ,33.33
03,001,01,001,0117,287,571,7,578,887,0,3,1,3,0,1,0,76.14,65.16 ,33.33
03,001,01,001,0118,288,817,21,838,1263,0,3,1,3,0,1,0,76.14,66.35 ,33.33
03,001,01,001,0118,289,666,10,676,1073,0,3,1,3,0,1,0,76.14,63.00 ,33.33
03,001,01,001,0119,290,579,8,587,949,0,3,1,3,0,1,0,76.14,61.85 ,33.33
03,001,01,001,0119,291,615,11,626,946,0,3,1,3,0,1,0,76.14,66.17 ,33.33
03,001,01,001,0119,292,511,12,523,822,0,3,1,3,0,1,0,76.14,63.63 ,33.33
03,001,01,001,0119,293,605,9,614,968,0,3,1,3,0,1,0,76.14,63.43 ,33.33
03,001,01,001,0120,294,769,12,781,1123,0,3,1,3,0,1,0,76.14,69.55 ,33.33
03,001,01,001,0120,295,790,21,811,1284,0,3,1,3,0,1,0,76.14,63.16 ,33.33
03,001,01,001,0121,296,684,15,699,1005,0,3,1,3,0,1,0,76.14,69.55 ,33.33
03,001,01,001,0121,297,859,15,874,1372,0,3,1,3,0,1,0,76.14,63.70 ,33.33
03,001,01,001,0121,298,840,19,859,1288,0,3,1,3,0,1,0,76.14,66.69 ,33.33
03,001,01,001,0122,299,752,14,766,1263,0,3,1,3,0,1,0,76.14,60.65 ,33.33
03,001,01,001,0122,300,703,23,726,1072,0,3,1,3,0,1,0,76.14,67.72 ,33.33
03,001,01,001,0123,301,860,8,868,1272,0,3,1,3,0,1,0,76.14,68.24 ,33.33
03,001,01,001,0123,302,794,13,807,1256,0,3,1,3,0,1,0,76.14,64.25 ,33.33
03,001,01,001,0123,303,628,12,640,1066,0,3,1,3,0,1,0,76.14,60.04 ,33.33
03,001,01,001,0124,304,775,9,784,1199,0,3,1,3,0,1,0,76.14,65.39 ,33.33
03,001,01,001,0124,305,758,16,774,1188,0,3,1,3,0,1,0,76.14,65.15 ,33.33
03,001,01,001,0124,306,670,15,685,1034,0,3,1,3,0,1,0,76.14,66.25 ,33.33
03,001,01,001,0125,307,754,17,771,1146,0,3,1,3,0,1,0,76.14,67.28 ,33.33
03,001,01,001,0125,308,793,13,806,1160,0,3,1,3,0,1,0,76.14,69.48 ,33.33
03,001,01,001,0126,309,643,16,659,1084,0,3,1,3,0,1,0,76.14,60.79 ,33.33
03,001,01,001,0126,310,835,14,849,1227,0,3,1,3,0,1,0,76.14,69.19 ,33.33
03,001,01,002,0127,311,1095,16,1111,1651,0,3,1,3,0,1,0,76.14,67.29 ,33.33
03,001,01,002,0127,312,893,16,909,1320,0,3,1,3,0,1,0,76.14,68.86 ,33.33
03,001,01,002,0128,313,1026,11,1037,1504,0,3,1,3,0,1,0,76.14,68.95 ,33.33
03,001,01,002,0128,314,973,16,989,1429,0,3,1,3,0,1,0,76.14,69.21 ,33.33
03,001,01,002,0129,315,497,12,509,813,0,3,1,3,0,1,0,76.14,62.61 ,33.33
03,001,01,002,0129,316,607,10,617,941,0,3,1,3,0,1,0,76.14,65.57 ,33.33
03,001,01,002,0130,317,938,19,957,1456,0,3,1,3,0,1,0,76.14,65.73 ,33.33
03,001,01,002,0131,318,856,12,868,1233,0,3,1,3,0,1,0,76.14,70.40 ,33.33
03,001,01,002,0132,319,646,11,657,891,0,3,1,3,0,1,0,76.14,73.74 ,33.33
03,001,01,002,0132,320,677,10,687,994,0,3,1,3,0,1,0,76.14,69.11 ,33.33
03,001,01,002,0133,321,1113,24,1137,1743,0,3,1,3,0,1,0,76.14,65.23 ,33.33
03,001,01,002,0133,322,726,9,735,1010,0,3,1,3,0,1,0,76.14,72.77 ,33.33
03,001,01,002,0134,323,293,6,299,382,0,3,1,3,0,1,0,76.14,78.27 ,33.33
03,001,01,002,0135,324,734,9,743,1174,0,3,1,3,0,1,0,76.14,63.29 ,33.33
03,001,01,002,0135,325,734,14,748,1136,0,3,1,3,0,1,0,76.14,65.85 ,33.33
03,001,01,002,0136,326,949,7,956,1392,0,3,1,3,0,1,0,76.14,68.68 ,33.33
03,001,01,002,0136,327,837,12,849,1286,0,3,1,3,0,1,0,76.14,66.02 ,33.33
03,001,01,002,0137,328,807,13,820,1237,0,3,1,3,0,1,0,76.14,66.29 ,33.33
03,001,01,002,0137,329,756,7,763,1190,0,3,1,3,0,1,0,76.14,64.12 ,33.33
03,001,01,002,0138,330,798,8,806,1168,0,3,1,3,0,1,0,76.14,69.01 ,33.33
03,001,01,002,0138,331,881,6,887,1254,0,3,1,3,0,1,0,76.14,70.73 ,33.33
03,001,01,002,0139,332,992,20,1012,1591,0,3,1,3,0,1,0,76.14,63.61 ,33.33
03,001,01,002,0139,333,992,15,1007,1470,0,3,1,3,0,1,0,76.14,68.50 ,33.33
03,001,01,002,0140,334,553,8,561,857,0,3,1,3,0,1,0,76.14,65.46 ,33.33
03,001,01,002,0140,335,742,8,750,1042,0,3,1,3,0,1,0,76.14,71.98 ,33.33
03,001,01,002,0141,336,800,12,812,1198,0,3,1,3,0,1,0,76.14,67.78 ,33.33
03,001,01,002,0141,337,591,6,597,866,0,3,1,3,0,1,0,76.14,68.94 ,33.33
03,001,01,002,0142,338,885,9,894,1353,0,3,1,3,0,1,0,76.14,66.08 ,33.33
03,001,01,002,0142,339,1096,7,1103,1562,0,3,1,3,0,1,0,76.14,70.61 ,33.33
03,001,01,002,0143,340,1176,20,1196,1784,0,3,1,3,0,1,0,76.14,67.04 ,33.33
03,001,01,002,0143,341,1118,11,1129,1606,0,3,1,3,0,1,0,76.14,70.30 ,33.33
03,001,01,002,0144,342,734,6,740,1101,0,3,1,3,0,1,0,76.14,67.21 ,33.33
03,001,01,002,0144,343,743,5,748,1112,0,3,1,3,0,1,0,76.14,67.27 ,33.33
03,001,01,002,0144,344,807,10,817,1236,0,3,1,3,0,1,0,76.14,66.10 ,33.33
03,001,01,002,0145,345,776,11,787,1139,0,3,1,3,0,1,0,76.14,69.10 ,33.33
03,001,01,002,0145,346,735,8,743,1131,0,3,1,3,0,1,0,76.14,65.69 ,33.33
03,001,01,002,0146,347,868,9,877,1259,0,3,1,3,0,1,0,76.14,69.66 ,33.33
03,001,01,002,0146,348,886,11,897,1326,0,3,1,3,0,1,0,76.14,67.65 ,33.33
03,001,01,002,0146,349,861,10,871,1392,0,3,1,3,0,1,0,76.14,62.57 ,33.33
03,001,01,002,0147,350,789,13,802,1182,0,3,1,3,0,1,0,76.14,67.85 ,33.33
03,001,01,002,0147,351,705,12,717,1147,0,3,1,3,0,1,0,76.14,62.51 ,33.33
03,001,01,002,0147,352,871,11,882,1304,0,3,1,3,0,1,0,76.14,67.64 ,33.33
03,001,01,002,0148,353,742,10,752,1088,0,3,1,3,0,1,0,76.14,69.12 ,33.33
03,001,01,002,0148,354,574,8,582,850,0,3,1,3,0,1,0,76.14,68.47 ,33.33
03,001,01,002,0149,355,681,13,694,1064,0,3,1,3,0,1,0,76.14,65.23 ,33.33
03,001,01,002,0149,356,732,4,736,1151,0,3,1,3,0,1,0,76.14,63.94 ,33.33
03,001,01,002,0149,357,782,12,794,1310,0,3,1,3,0,1,0,76.14,60.61 ,33.33
03,001,01,002,0150,358,691,10,701,1151,0,3,1,3,0,1,0,76.14,60.90 ,33.33
03,001,01,002,0151,359,967,16,983,1570,0,3,1,3,0,1,0,76.14,62.61 ,33.33
03,001,01,002,0152,360,862,19,881,1429,0,3,1,3,0,1,0,76.14,61.65 ,33.33
03,001,01,002,0153,361,1174,17,1191,1735,0,3,1,3,0,1,0,76.14,68.65 ,33.33
03,001,01,002,0154,362,815,17,832,1188,0,3,1,3,0,1,0,76.14,70.03 ,33.33
03,001,01,002,0155,363,752,12,764,1105,0,3,1,3,0,1,0,76.14,69.14 ,33.33
03,001,01,002,0156,364,875,20,895,1380,0,3,1,3,0,1,0,76.14,64.86 ,33.33
03,001,01,002,0157,365,879,15,894,1368,0,3,1,3,0,1,0,76.14,65.35 ,33.33
03,001,01,002,0158,366,819,14,833,1232,0,3,1,3,0,1,0,76.14,67.61 ,33.33
03,001,01,002,0159,367,1049,18,1067,1545,0,3,1,3,0,1,0,76.14,69.06 ,33.33
03,001,01,002,0160,368,864,17,881,1385,0,3,1,3,0,1,0,76.14,63.61 ,33.33
03,001,01,002,0161,369,591,11,602,939,0,3,1,3,0,1,0,76.14,64.11 ,33.33
03,001,01,002,0161,370,726,9,735,1066,0,3,1,3,0,1,0,76.14,68.95 ,33.33
03,001,01,002,0162,371,1034,15,1049,1630,0,3,1,3,0,1,0,76.14,64.36 ,33.33
03,001,01,002,0163,372,745,14,759,1100,0,3,1,3,0,1,0,76.14,69.00 ,33.33
03,001,01,002,0164,373,658,11,669,1000,0,3,1,3,0,1,0,76.14,66.90 ,33.33
03,001,01,002,0165,374,660,7,667,923,0,3,1,3,0,1,0,76.14,72.26 ,33.33
03,001,01,002,0165,375,517,2,519,760,0,3,1,3,0,1,0,76.14,68.29 ,33.33
03,001,01,002,0166,376,642,9,651,896,0,3,1,3,0,1,0,76.14,72.66 ,33.33
03,001,01,002,0167,377,539,13,552,885,0,3,1,3,0,1,0,76.14,62.37 ,33.33
03,001,01,002,0168,378,1021,12,1033,1542,0,3,1,3,0,1,0,76.14,66.99 ,33.33
03,001,01,002,0169,379,485,7,492,737,0,3,1,3,0,1,0,76.14,66.76 ,33.33
03,001,01,002,0170,380,744,11,755,1066,0,3,1,3,0,1,0,76.14,70.83 ,33.33
03,001,01,002,0170,381,630,7,637,968,0,3,1,3,0,1,0,76.14,65.81 ,33.33
03,001,01,002,0171,382,724,5,729,1097,0,3,1,3,0,1,0,76.14,66.45 ,33.33
03,001,01,002,0171,383,599,8,607,950,0,3,1,3,0,1,0,76.14,63.89 ,33.33
03,001,01,002,0172,384,1033,10,1043,1575,0,3,1,3,0,1,0,76.14,66.22 ,33.33
03,001,01,002,0173,385,761,9,770,1199,0,3,1,3,0,1,0,76.14,64.22 ,33.33
03,001,01,002,0173,386,846,13,859,1289,0,3,1,3,0,1,0,76.14,66.64 ,33.33
03,001,01,002,0174,387,1205,8,1213,1760,0,3,1,3,0,1,0,76.14,68.92 ,33.33
03,001,01,002,0174,388,1155,11,1166,1663,0,3,1,3,0,1,0,76.14,70.11 ,33.33
03,001,01,002,0175,389,1017,10,1027,1442,0,3,1,3,0,1,0,76.14,71.22 ,33.33
03,001,01,002,0176,390,764,8,772,1105,0,3,1,3,0,1,0,76.14,69.86 ,33.33
03,001,01,002,0177,391,854,4,858,1231,0,3,1,3,0,1,0,76.14,69.70 ,33.33
03,001,01,002,0178,392,1072,12,1084,1618,0,3,1,3,0,1,0,76.14,67.00 ,33.33
03,001,01,002,0179,393,995,10,1005,1518,0,3,1,3,0,1,0,76.14,66.21 ,33.33
03,001,01,002,0180,394,834,10,844,1255,0,3,1,3,0,1,0,76.14,67.25 ,33.33
03,001,01,002,0180,395,745,8,753,1131,0,3,1,3,0,1,0,76.14,66.58 ,33.33
03,001,01,002,0181,396,909,14,923,1390,0,3,1,3,0,1,0,76.14,66.40 ,33.33
03,001,01,002,0182,397,674,15,689,1011,0,3,1,3,0,1,0,76.14,68.15 ,33.33
03,001,01,002,0183,398,1031,34,1065,1621,0,3,1,3,0,1,0,76.14,65.70 ,33.33
03,001,01,002,0184,399,591,4,595,868,0,3,1,3,0,1,0,76.14,68.55 ,33.33
03,001,01,002,0184,400,644,7,651,930,0,3,1,3,0,1,0,76.14,70.00 ,33.33
03,001,01,002,0185,401,570,8,578,906,0,3,1,3,0,1,0,76.14,63.80 ,33.33
03,001,01,002,0185,402,599,8,607,938,0,3,1,3,0,1,0,76.14,64.71 ,33.33
03,001,01,002,0186,403,1029,17,1046,1535,0,3,1,3,0,1,0,76.14,68.14 ,33.33
03,001,01,002,0187,404,445,4,449,694,0,3,1,3,0,1,0,76.14,64.70 ,33.33
03,001,01,002,0188,405,1039,16,1055,1552,0,3,1,3,0,1,0,76.14,67.98 ,33.33
03,001,01,002,0189,406,418,4,422,616,0,3,1,3,0,1,0,76.14,68.51 ,33.33
03,001,01,002,0190,407,612,11,623,905,0,3,1,3,0,1,0,76.14,68.84 ,33.33
03,001,01,002,0190,408,510,7,517,783,0,3,1,3,0,1,0,76.14,66.03 ,33.33
03,001,01,002,0191,409,1012,10,1022,1555,0,3,1,3,0,1,0,76.14,65.72 ,33.33
03,001,01,002,0192,410,687,11,698,963,0,3,1,3,0,1,0,76.14,72.48 ,33.33
03,001,01,002,0192,411,602,8,610,933,0,3,1,3,0,1,0,76.14,65.38 ,33.33
03,001,01,002,0193,412,998,14,1012,1451,0,3,1,3,0,1,0,76.14,69.75 ,33.33
03,001,01,002,0194,413,694,14,708,1060,0,3,1,3,0,1,0,76.14,66.79 ,33.33
03,001,01,002,0195,414,935,10,945,1398,0,3,1,3,0,1,0,76.14,67.60 ,33.33
03,001,01,002,0196,415,756,16,772,1212,0,3,1,3,0,1,0,76.14,63.70 ,33.33
03,001,01,002,0196,416,657,14,671,997,0,3,1,3,0,1,0,76.14,67.30 ,33.33
03,001,01,002,0197,417,877,17,894,1273,0,3,1,3,0,1,0,76.14,70.23 ,33.33
03,001,01,002,0197,418,598,10,608,1027,0,3,1,3,0,1,0,76.14,59.20 ,33.33
03,001,01,002,0198,419,982,14,996,1519,0,3,1,3,0,1,0,76.14,65.57 ,33.33
03,001,01,002,0199,420,821,8,829,1176,0,3,1,3,0,1,0,76.14,70.49 ,33.33
03,001,01,002,0200,421,993,11,1004,1448,0,3,1,3,0,1,0,76.14,69.34 ,33.33
03,001,01,002,0201,422,937,13,950,1411,0,3,1,3,0,1,0,76.14,67.33 ,33.33
03,001,01,002,0201,423,569,11,580,889,0,3,1,3,0,1,0,76.14,65.24 ,33.33
03,001,01,002,0202,424,770,13,783,1169,0,3,1,3,0,1,0,76.14,66.98 ,33.33
03,001,01,002,0202,425,696,12,708,1029,0,3,1,3,0,1,0,76.14,68.80 ,33.33
03,001,01,002,0203,426,774,14,788,1125,0,3,1,3,0,1,0,76.14,70.04 ,33.33
03,001,01,002,0204,427,556,11,567,813,0,3,1,3,0,1,0,76.14,69.74 ,33.33
03,001,01,002,0204,428,642,11,653,929,0,3,1,3,0,1,0,76.14,70.29 ,33.33
03,001,01,002,0205,429,859,11,870,1348,0,3,1,3,0,1,0,76.14,64.54 ,33.33
03,001,01,002,0205,430,747,16,763,1122,0,3,1,3,0,1,0,76.14,68.00 ,33.33
03,001,01,002,0205,431,731,10,741,1126,0,3,1,3,0,1,0,76.14,65.81 ,33.33
03,001,01,002,0206,432,1032,10,1042,1554,0,3,1,3,0,1,0,76.14,67.05 ,33.33
03,001,01,002,0206,433,937,11,948,1468,0,3,1,3,0,1,0,76.14,64.58 ,33.33
03,001,01,002,0207,434,834,14,848,1320,0,3,1,3,0,1,0,76.14,64.24 ,33.33
03,001,01,002,0207,435,791,7,798,1112,0,3,1,3,0,1,0,76.14,71.76 ,33.33
03,001,01,002,0207,436,771,12,783,1169,0,3,1,3,0,1,0,76.14,66.98 ,33.33
03,001,01,002,0208,437,756,7,763,1100,0,3,1,3,0,1,0,76.14,69.36 ,33.33
03,001,01,002,0208,438,626,5,631,934,0,3,1,3,0,1,0,76.14,67.56 ,33.33
03,001,01,002,0209,439,567,8,575,819,0,3,1,3,0,1,0,76.14,70.21 ,33.33
03,001,01,002,0209,440,593,7,600,866,0,3,1,3,0,1,0,76.14,69.28 ,33.33
03,001,01,002,0210,441,686,9,695,977,0,3,1,3,0,1,0,76.14,71.14 ,33.33
03,001,01,002,0210,442,763,13,776,1137,0,3,1,3,0,1,0,76.14,68.25 ,33.33
03,001,01,002,0211,443,744,11,755,1156,0,3,1,3,0,1,0,76.14,65.31 ,33.33
03,001,01,002,0211,444,733,11,744,1166,0,3,1,3,0,1,0,76.14,63.81 ,33.33
03,001,01,002,0211,445,722,10,732,1139,0,3,1,3,0,1,0,76.14,64.27 ,33.33
03,001,01,002,0212,446,773,9,782,1124,0,3,1,3,0,1,0,76.14,69.57 ,33.33
03,001,01,002,0212,447,779,11,790,1095,0,3,1,3,0,1,0,76.14,72.15 ,33.33
03,001,01,002,0213,448,675,13,688,1099,0,3,1,3,0,1,0,76.14,62.60 ,33.33
03,001,01,002,0213,449,735,11,746,1094,0,3,1,3,0,1,0,76.14,68.19 ,33.33
03,001,01,002,0214,450,930,15,945,1432,0,3,1,3,0,1,0,76.14,65.99 ,33.33
03,001,01,002,0214,451,838,17,855,1215,0,3,1,3,0,1,0,76.14,70.37 ,33.33
03,001,01,002,0215,452,575,5,580,884,0,3,1,3,0,1,0,76.14,65.61 ,33.33
03,001,01,002,0215,453,1072,12,1084,1594,0,3,1,3,0,1,0,76.14,68.01 ,33.33
03,001,01,002,0216,454,721,5,726,1098,0,3,1,3,0,1,0,76.14,66.12 ,33.33
03,001,01,002,0216,455,781,9,790,1197,0,3,1,3,0,1,0,76.14,66.00 ,33.33
03,001,01,002,0217,456,764,9,773,1116,0,3,1,3,0,1,0,76.14,69.27 ,33.33
03,001,01,002,0217,457,1145,14,1159,1704,0,3,1,3,0,1,0,76.14,68.02 ,33.33
03,001,01,002,0217,458,753,13,766,1103,0,3,1,3,0,1,0,76.14,69.45 ,33.33
03,001,01,002,0218,459,723,11,734,1068,0,3,1,3,0,1,0,76.14,68.73 ,33.33
03,001,01,002,0218,460,586,5,591,917,0,3,1,3,0,1,0,76.14,64.45 ,33.33
03,001,01,002,0219,461,930,14,944,1405,0,3,1,3,0,1,0,76.14,67.19 ,33.33
03,001,01,002,0219,462,904,15,919,1371,0,3,1,3,0,1,0,76.14,67.03 ,33.33
03,001,01,002,0220,463,795,8,803,1135,0,3,1,3,0,1,0,76.14,70.75 ,33.33
03,001,01,002,0220,464,940,16,956,1419,0,3,1,3,0,1,0,76.14,67.37 ,33.33
03,001,01,002,0221,465,728,10,738,1141,0,3,1,3,0,1,0,76.14,64.68 ,33.33
03,001,01,002,0221,466,584,7,591,906,0,3,1,3,0,1,0,76.14,65.23 ,33.33
03,001,01,002,0222,467,654,11,665,999,0,3,1,3,0,1,0,76.14,66.57 ,33.33
03,001,01,002,0222,468,651,8,659,973,0,3,1,3,0,1,0,76.14,67.73 ,33.33
03,001,01,002,0223,469,905,17,922,1424,0,3,1,3,0,1,0,76.14,64.75 ,33.33
03,001,01,002,0223,470,981,15,996,1560,0,3,1,3,0,1,0,76.14,63.85 ,33.33
03,001,01,002,0224,471,922,8,930,1441,0,3,1,3,0,1,0,76.14,64.54 ,33.33
03,001,01,002,0224,472,1148,24,1172,1850,0,3,1,3,0,1,0,76.14,63.35 ,33.33
03,001,01,002,0225,473,869,22,891,1374,0,3,1,3,0,1,0,76.14,64.85 ,33.33
03,001,01,002,0225,474,782,11,793,1269,0,3,1,3,0,1,0,76.14,62.49 ,33.33
03,001,01,002,0225,475,634,10,644,1085,0,3,1,3,0,1,0,76.14,59.35 ,33.33
03,001,01,002,0226,476,939,13,952,1462,0,3,1,3,0,1,0,76.14,65.12 ,33.33
03,001,01,002,0226,477,750,7,757,1200,0,3,1,3,0,1,0,76.14,63.08 ,33.33
03,001,01,002,0227,478,957,14,971,1437,0,3,1,3,0,1,0,76.14,67.57 ,33.33
03,001,01,002,0227,479,819,9,828,1224,0,3,1,3,0,1,0,76.14,67.65 ,33.33
03,001,01,002,0227,480,830,12,842,1306,0,3,1,3,0,1,0,76.14,64.47 ,33.33
03,001,01,002,0228,481,1167,6,1173,1876,0,3,1,3,0,1,0,76.14,62.53 ,33.33
03,001,01,002,0228,482,1134,13,1147,1720,0,3,1,3,0,1,0,76.14,66.69 ,33.33
03,001,01,002,0228,483,680,9,689,1053,0,3,1,3,0,1,0,76.14,65.43 ,33.33
03,001,01,002,0229,484,952,23,975,1512,0,3,1,3,0,1,0,76.14,64.48 ,33.33
03,001,01,002,0229,485,1051,14,1065,1554,0,3,1,3,0,1,0,76.14,68.53 ,33.33
03,001,01,002,0229,486,1135,13,1148,1720,0,3,1,3,0,1,0,76.14,66.74 ,33.33
03,001,01,002,0230,487,639,10,649,1013,0,3,1,3,0,1,0,76.14,64.07 ,33.33
03,001,01,002,0230,488,674,14,688,1113,0,3,1,3,0,1,0,76.14,61.81 ,33.33
03,001,01,002,0231,489,809,12,821,1310,0,3,1,3,0,1,0,76.14,62.67 ,33.33
03,001,01,002,0231,490,763,15,778,1201,0,3,1,3,0,1,0,76.14,64.78 ,33.33
03,001,01,002,0232,491,461,10,471,764,0,3,1,3,0,1,0,76.14,61.65 ,33.33
03,001,01,002,0232,492,783,15,798,1195,0,3,1,3,0,1,0,76.14,66.78 ,33.33
03,001,01,002,0233,493,849,11,860,1206,0,3,1,3,0,1,0,76.14,71.31 ,33.33
03,001,01,002,0233,494,555,11,566,886,0,3,1,3,0,1,0,76.14,63.88 ,33.33
03,001,01,002,0234,495,573,10,583,831,0,3,1,3,0,1,0,76.14,70.16 ,33.33
03,001,01,002,0234,496,669,10,679,961,0,3,1,3,0,1,0,76.14,70.66 ,33.33
03,001,01,002,0235,497,973,17,990,1419,0,3,1,3,0,1,0,76.14,69.77 ,33.33
03,001,01,002,0235,498,1031,17,1048,1491,0,3,1,3,0,1,0,76.14,70.29 ,33.33
03,001,01,002,0236,499,589,6,595,866,0,3,1,3,0,1,0,76.14,68.71 ,33.33
03,001,01,002,0236,500,672,22,694,987,0,3,1,3,0,1,0,76.14,70.31 ,33.33
03,001,01,002,0237,501,738,10,748,1131,0,3,1,3,0,1,0,76.14,66.14 ,33.33
03,001,01,002,0237,502,668,22,690,1071,0,3,1,3,0,1,0,76.14,64.43 ,33.33
03,001,01,002,0237,503,693,7,700,1009,0,3,1,3,0,1,0,76.14,69.38 ,33.33
03,001,01,002,0238,504,629,12,641,968,0,3,1,3,0,1,0,76.14,66.22 ,33.33
03,001,01,002,0238,505,725,11,736,1102,0,3,1,3,0,1,0,76.14,66.79 ,33.33
03,001,01,002,0239,506,755,24,779,1257,0,3,1,3,0,1,0,76.14,61.97 ,33.33
03,001,01,002,0239,507,644,8,652,922,0,3,1,3,0,1,0,76.14,70.72 ,33.33
03,001,01,002,0240,508,440,8,448,708,0,3,1,3,0,1,0,76.14,63.28 ,33.33
03,001,01,002,0240,509,603,9,612,946,0,3,1,3,0,1,0,76.14,64.69 ,33.33
03,001,01,002,0241,510,896,17,913,1325,0,3,1,3,0,1,0,76.14,68.91 ,33.33
03,001,01,002,0241,511,540,13,553,811,0,3,1,3,0,1,0,76.14,68.19 ,33.33
03,001,01,002,0242,512,709,17,726,1260,0,3,1,3,0,1,0,76.14,57.62 ,33.33
03,001,01,002,0242,513,967,15,982,1546,0,3,1,3,0,1,0,76.14,63.52 ,33.33
03,001,01,002,0242,514,828,9,837,1327,0,3,1,3,0,1,0,76.14,63.07 ,33.33
03,001,01,003,0243,515,1169,19,1188,1902,0,3,1,3,0,1,0,76.14,62.46 ,33.33
03,001,01,003,0243,516,434,6,440,660,0,3,1,3,0,1,0,76.14,66.67 ,33.33
03,001,01,003,0244,517,872,9,881,1335,0,3,1,3,0,1,0,76.14,65.99 ,33.33
03,001,01,003,0245,518,1100,16,1116,1657,0,3,1,3,0,1,0,76.14,67.35 ,33.33
03,001,01,003,0245,519,863,4,867,1144,0,3,1,3,0,1,0,76.14,75.79 ,33.33
03,001,01,003,0245,520,788,5,793,1163,0,3,1,3,0,1,0,76.14,68.19 ,33.33
03,001,01,003,0246,521,779,7,786,1149,0,3,1,3,0,1,0,76.14,68.41 ,33.33
03,001,01,003,0246,522,954,11,965,1469,0,3,1,3,0,1,0,76.14,65.69 ,33.33
03,001,01,003,0247,523,1260,18,1278,1853,0,3,1,3,0,1,0,76.14,68.97 ,33.33
03,001,01,003,0248,524,900,27,927,1392,0,3,1,3,0,1,0,76.14,66.59 ,33.33
03,001,01,003,0248,525,832,9,841,1209,0,3,1,3,0,1,0,76.14,69.56 ,33.33
03,001,01,003,0249,526,958,7,965,1404,0,3,1,3,0,1,0,76.14,68.73 ,33.33
03,001,01,003,0249,527,950,9,959,1410,0,3,1,3,0,1,0,76.14,68.01 ,33.33
03,001,01,003,0250,528,853,16,869,1232,0,3,1,3,0,1,0,76.14,70.54 ,33.33
03,001,01,003,0250,529,941,13,954,1391,0,3,1,3,0,1,0,76.14,68.58 ,33.33
03,001,01,003,0251,530,922,11,933,1300,0,3,1,3,0,1,0,76.14,71.77 ,33.33
03,001,01,003,0251,531,993,8,1001,1402,0,3,1,3,0,1,0,76.14,71.40 ,33.33
03,001,01,003,0251,532,600,8,608,907,0,3,1,3,0,1,0,76.14,67.03 ,33.33
03,001,01,003,0252,533,973,23,996,1519,0,3,1,3,0,1,0,76.14,65.57 ,33.33
03,001,01,003,0252,534,986,15,1001,1514,0,3,1,3,0,1,0,76.14,66.12 ,33.33
03,001,01,003,0253,535,1180,18,1198,1792,0,3,1,3,0,1,0,76.14,66.85 ,33.33
03,001,01,003,0253,536,850,9,859,1243,0,3,1,3,0,1,0,76.14,69.11 ,33.33
03,001,01,003,0254,537,1193,15,1208,1624,0,3,1,3,0,1,0,76.14,74.38 ,33.33
03,001,01,003,0254,538,722,10,732,1100,0,3,1,3,0,1,0,76.14,66.55 ,33.33
03,001,01,003,0254,539,738,19,757,1074,0,3,1,3,0,1,0,76.14,70.48 ,33.33
03,001,01,003,0255,540,935,23,958,1406,0,3,1,3,0,1,0,76.14,68.14 ,33.33
03,001,01,003,0255,541,1101,24,1125,1628,0,3,1,3,0,1,0,76.14,69.10 ,33.33
03,001,01,003,0256,542,617,18,635,962,0,3,1,3,0,1,0,76.14,66.01 ,33.33
03,001,01,003,0256,543,920,12,932,1366,0,3,1,3,0,1,0,76.14,68.23 ,33.33
03,001,01,003,0256,544,962,8,970,1411,0,3,1,3,0,1,0,76.14,68.75 ,33.33
03,001,01,003,0257,545,970,12,982,1414,0,3,1,3,0,1,0,76.14,69.45 ,33.33
03,001,01,003,0257,546,1107,16,1123,1587,0,3,1,3,0,1,0,76.14,70.76 ,33.33
03,001,01,003,0258,547,1227,25,1252,1867,0,3,1,3,0,1,0,76.14,67.06 ,33.33
03,001,01,003,0258,548,1240,14,1254,1786,0,3,1,3,0,1,0,76.14,70.21 ,33.33
03,001,01,003,0259,549,1154,13,1167,1796,0,3,1,3,0,1,0,76.14,64.98 ,33.33
03,001,01,003,0259,550,1087,13,1100,1597,0,3,1,3,0,1,0,76.14,68.88 ,33.33
03,001,01,003,0260,551,893,12,905,1248,0,3,1,3,0,1,0,76.14,72.52 ,33.33
03,001,01,003,0260,552,1192,11,1203,1696,0,3,1,3,0,1,0,76.14,70.93 ,33.33
03,001,01,003,0261,553,1031,10,1041,1571,0,3,1,3,0,1,0,76.14,66.26 ,33.33
03,001,01,003,0262,554,785,6,791,1114,0,3,1,3,0,1,0,76.14,71.01 ,33.33
03,001,01,003,0262,555,891,15,906,1259,0,3,1,3,0,1,0,76.14,71.96 ,33.33
03,001,01,003,0263,556,578,6,584,819,0,3,1,3,0,1,0,76.14,71.31 ,33.33
03,001,01,003,0263,557,751,11,762,1101,0,3,1,3,0,1,0,76.14,69.21 ,33.33
03,001,01,003,0264,558,850,13,863,1302,0,3,1,3,0,1,0,76.14,66.28 ,33.33
03,001,01,003,0264,559,979,11,990,1412,0,3,1,3,0,1,0,76.14,70.11 ,33.33
03,001,01,003,0265,560,844,8,852,1195,0,3,1,3,0,1,0,76.14,71.30 ,33.33
03,001,01,003,0265,561,792,10,802,1135,0,3,1,3,0,1,0,76.14,70.66 ,33.33
03,001,01,003,0265,562,1004,12,1016,1544,0,3,1,3,0,1,0,76.14,65.80 ,33.33
03,001,01,003,0266,563,965,13,978,1412,0,3,1,3,0,1,0,76.14,69.26 ,33.33
03,001,01,003,0266,564,827,3,830,1266,0,3,1,3,0,1,0,76.14,65.56 ,33.33
03,001,01,003,0267,565,695,13,708,1024,0,3,1,3,0,1,0,76.14,69.14 ,33.33
03,001,01,003,0267,566,656,11,667,976,0,3,1,3,0,1,0,76.14,68.34 ,33.33
03,001,01,003,0267,567,837,11,848,1247,0,3,1,3,0,1,0,76.14,68.00 ,33.33
03,001,01,003,0268,568,1128,9,1137,1596,0,3,1,3,0,1,0,76.14,71.24 ,33.33
03,001,01,003,0268,569,1047,16,1063,1607,0,3,1,3,0,1,0,76.14,66.15 ,33.33
03,001,01,003,0269,570,1026,20,1046,1517,0,3,1,3,0,1,0,76.14,68.95 ,33.33
03,001,01,003,0269,571,876,6,882,1290,0,3,1,3,0,1,0,76.14,68.37 ,33.33
03,001,01,003,0270,572,789,21,810,1198,0,3,1,3,0,1,0,76.14,67.61 ,33.33
03,001,01,003,0270,573,731,15,746,1027,0,3,1,3,0,1,0,76.14,72.64 ,33.33
03,001,01,003,0271,574,934,12,946,1386,0,3,1,3,0,1,0,76.14,68.25 ,33.33
03,001,01,003,0271,575,769,7,776,1127,0,3,1,3,0,1,0,76.14,68.86 ,33.33
03,001,01,003,0271,576,693,5,698,1022,0,3,1,3,0,1,0,76.14,68.30 ,33.33
03,001,01,003,0272,577,951,17,968,1475,0,3,1,3,0,1,0,76.14,65.63 ,33.33
03,001,01,003,0272,578,653,9,662,960,0,3,1,3,0,1,0,76.14,68.96 ,33.33
03,001,01,003,0272,579,781,12,793,1120,0,3,1,3,0,1,0,76.14,70.80 ,33.33
03,001,01,003,0273,580,905,9,914,1294,0,3,1,3,0,1,0,76.14,70.63 ,33.33
03,001,01,003,0273,581,1089,17,1106,1630,0,3,1,3,0,1,0,76.14,67.85 ,33.33
03,001,01,003,0274,582,742,4,746,1001,0,3,1,3,0,1,0,76.14,74.53 ,33.33
03,001,01,003,0274,583,683,9,692,1026,0,3,1,3,0,1,0,76.14,67.45 ,33.33
03,001,01,003,0275,584,726,12,738,1116,0,3,1,3,0,1,0,76.14,66.13 ,33.33
03,001,01,003,0275,585,713,8,721,1043,0,3,1,3,0,1,0,76.14,69.13 ,33.33
03,001,01,003,0276,586,853,12,865,1248,0,3,1,3,0,1,0,76.14,69.31 ,33.33
03,001,01,003,0276,587,651,6,657,985,0,3,1,3,0,1,0,76.14,66.70 ,33.33
03,001,01,003,0276,588,976,18,994,1443,0,3,1,3,0,1,0,76.14,68.88 ,33.33
03,001,01,003,0277,589,1070,10,1080,1535,0,3,1,3,0,1,0,76.14,70.36 ,33.33
03,001,01,003,0277,590,571,10,581,837,0,3,1,3,0,1,0,76.14,69.41 ,33.33
03,001,01,003,0278,591,963,20,983,1509,0,3,1,3,0,1,0,76.14,65.14 ,33.33
03,001,01,003,0278,592,1155,21,1176,1769,0,3,1,3,0,1,0,76.14,66.48 ,33.33
03,001,01,003,0279,593,1119,19,1138,1687,0,3,1,3,0,1,0,76.14,67.46 ,33.33
03,001,01,003,0279,594,484,4,488,715,0,3,1,3,0,1,0,76.14,68.25 ,33.33
03,001,01,003,0280,595,975,16,991,1527,0,3,1,3,0,1,0,76.14,64.90 ,33.33
03,001,01,003,0280,596,885,14,899,1368,0,3,1,3,0,1,0,76.14,65.72 ,33.33
03,001,01,003,0281,597,851,11,862,1132,0,3,1,3,0,1,0,76.14,76.15 ,33.33
03,001,01,003,0281,598,1047,19,1066,1623,0,3,1,3,0,1,0,76.14,65.68 ,33.33
03,001,01,003,0281,599,1052,10,1062,1487,0,3,1,3,0,1,0,76.14,71.42 ,33.33
03,001,01,003,0282,600,1021,26,1047,1505,0,3,1,3,0,1,0,76.14,69.57 ,33.33
03,001,01,003,0282,601,922,21,943,1393,0,3,1,3,0,1,0,76.14,67.70 ,33.33
03,001,01,003,0283,602,537,13,550,914,0,3,1,3,0,1,0,76.14,60.18 ,33.33
03,001,01,003,0283,603,627,6,633,955,0,3,1,3,0,1,0,76.14,66.28 ,33.33
03,001,01,003,0283,604,663,12,675,1001,0,3,1,3,0,1,0,76.14,67.43 ,33.33
03,001,01,003,0283,605,908,11,919,1429,0,3,1,3,0,1,0,76.14,64.31 ,33.33
03,001,01,003,0284,606,463,7,470,729,0,3,1,3,0,1,0,76.14,64.47 ,33.33
03,001,01,003,0284,607,870,5,875,1194,0,3,1,3,0,1,0,76.14,73.28 ,33.33
03,001,01,003,0285,608,1021,13,1034,1517,0,3,1,3,0,1,0,76.14,68.16 ,33.33
03,001,01,003,0285,609,1100,20,1120,1688,0,3,1,3,0,1,0,76.14,66.35 ,33.33
03,001,01,003,0286,610,894,12,906,1280,0,3,1,3,0,1,0,76.14,70.78 ,33.33
03,001,01,003,0286,611,991,10,1001,1491,0,3,1,3,0,1,0,76.14,67.14 ,33.33
03,001,01,003,0287,612,625,7,632,915,0,3,1,3,0,1,0,76.14,69.07 ,33.33
03,001,01,003,0287,613,725,6,731,1023,0,3,1,3,0,1,0,76.14,71.46 ,33.33
03,001,01,003,0288,614,167,1,168,232,0,3,1,3,0,1,0,76.14,72.41 ,33.33
03,001,01,003,0289,615,734,12,746,1099,0,3,1,3,0,1,0,76.14,67.88 ,33.33
03,001,01,003,0289,616,1119,20,1139,1659,0,3,1,3,0,1,0,76.14,68.66 ,33.33
03,001,01,003,0289,617,891,12,903,1382,0,3,1,3,0,1,0,76.14,65.34 ,33.33
03,001,01,003,0290,618,894,10,904,1289,0,3,1,3,0,1,0,76.14,70.13 ,33.33
03,001,01,003,0290,619,637,16,653,985,0,3,1,3,0,1,0,76.14,66.29 ,33.33
03,001,01,003,0291,620,998,18,1016,1619,0,3,1,3,0,1,0,76.14,62.75 ,33.33
03,001,01,003,0291,621,849,7,856,1264,0,3,1,3,0,1,0,76.14,67.72 ,33.33
03,001,01,003,0292,622,1226,17,1243,1816,0,3,1,3,0,1,0,76.14,68.45 ,33.33
03,001,01,003,0292,623,538,10,548,778,0,3,1,3,0,1,0,76.14,70.44 ,33.33
03,001,01,003,0293,624,709,8,717,1037,0,3,1,3,0,1,0,76.14,69.14 ,33.33
03,001,01,003,0293,625,1104,10,1114,1608,0,3,1,3,0,1,0,76.14,69.28 ,33.33
03,001,01,003,0294,626,612,8,620,956,0,3,1,3,0,1,0,76.14,64.85 ,33.33
03,001,01,003,0294,627,617,14,631,1002,0,3,1,3,0,1,0,76.14,62.97 ,33.33
03,001,01,003,0295,628,1142,17,1159,1673,0,3,1,3,0,1,0,76.14,69.28 ,33.33
03,001,01,003,0295,629,887,13,900,1352,0,3,1,3,0,1,0,76.14,66.57 ,33.33
03,001,01,003,0295,630,1031,13,1044,1523,0,3,1,3,0,1,0,76.14,68.55 ,33.33
03,001,01,003,0296,631,762,9,771,1120,0,3,1,3,0,1,0,76.14,68.84 ,33.33
03,001,01,003,0296,632,1131,27,1158,1692,0,3,1,3,0,1,0,76.14,68.44 ,33.33
03,001,01,003,0297,633,1139,12,1151,1730,0,3,1,3,0,1,0,76.14,66.53 ,33.33
03,001,01,003,0297,634,1014,14,1028,1606,0,3,1,3,0,1,0,76.14,64.01 ,33.33
03,001,01,003,0298,635,1076,16,1092,1736,0,3,1,3,0,1,0,76.14,62.90 ,33.33
03,001,01,003,0298,636,887,17,904,1352,0,3,1,3,0,1,0,76.14,66.86 ,33.33
03,001,01,003,0299,637,1064,19,1083,1600,0,3,1,3,0,1,0,76.14,67.69 ,33.33
03,001,01,003,0299,638,841,15,856,1267,0,3,1,3,0,1,0,76.14,67.56 ,33.33
03,001,01,003,0299,639,900,26,926,1439,0,3,1,3,0,1,0,76.14,64.35 ,33.33
03,001,01,003,0300,640,397,6,403,545,0,3,1,3,0,1,0,76.14,73.94 ,33.33
03,001,01,003,0300,641,579,10,589,814,0,3,1,3,0,1,0,76.14,72.36 ,33.33
03,001,01,003,0300,642,893,9,902,1362,0,3,1,3,0,1,0,76.14,66.23 ,33.33
03,001,01,003,0300,643,849,16,865,1253,0,3,1,3,0,1,0,76.14,69.03 ,33.33
03,001,01,003,0301,644,745,10,755,1087,0,3,1,3,0,1,0,76.14,69.46 ,33.33
03,001,01,003,0301,645,727,15,742,1105,0,3,1,3,0,1,0,76.14,67.15 ,33.33
03,001,01,003,0302,646,1095,19,1114,1668,0,3,1,3,0,1,0,76.14,66.79 ,33.33
03,001,01,003,0302,647,892,14,906,1352,0,3,1,3,0,1,0,76.14,67.01 ,33.33
03,001,01,003,0303,648,943,13,956,1375,0,3,1,3,0,1,0,76.14,69.53 ,33.33
03,001,01,003,0303,649,998,20,1018,1512,0,3,1,3,0,1,0,76.14,67.33 ,33.33
03,001,01,003,0304,650,1312,18,1330,2010,0,3,1,3,0,1,0,76.14,66.17 ,33.33
03,001,01,003,0304,651,1007,12,1019,1398,0,3,1,3,0,1,0,76.14,72.89 ,33.33
03,001,01,003,0305,652,897,16,913,1389,0,3,1,3,0,1,0,76.14,65.73 ,33.33
03,001,01,003,0305,653,1123,15,1138,1641,0,3,1,3,0,1,0,76.14,69.35 ,33.33
03,001,01,003,0306,654,1167,11,1178,1846,0,3,1,3,0,1,0,76.14,63.81 ,33.33
03,001,01,003,0307,655,1079,22,1101,1669,0,3,1,3,0,1,0,76.14,65.97 ,33.33
03,001,01,003,0307,656,1263,12,1275,1675,0,3,1,3,0,1,0,76.14,76.12 ,33.33
03,001,01,003,0308,657,600,2,602,925,0,3,1,3,0,1,0,76.14,65.08 ,33.33
03,001,01,003,0308,658,854,9,863,1253,0,3,1,3,0,1,0,76.14,68.87 ,33.33
03,001,01,003,0309,659,881,8,889,1253,0,3,1,3,0,1,0,76.14,70.95 ,33.33
03,001,01,003,0309,660,579,1,580,872,0,3,1,3,0,1,0,76.14,66.51 ,33.33
03,001,01,003,0310,661,744,12,756,1118,0,3,1,3,0,1,0,76.14,67.62 ,33.33
03,001,01,003,0310,662,1061,15,1076,1582,0,3,1,3,0,1,0,76.14,68.02 ,33.33
03,001,01,003,0311,663,997,11,1008,1441,0,3,1,3,0,1,0,76.14,69.95 ,33.33
03,001,01,003,0312,664,853,7,860,1313,0,3,1,3,0,1,0,76.14,65.50 ,33.33
03,001,01,003,0312,665,898,11,909,1343,0,3,1,3,0,1,0,76.14,67.68 ,33.33
03,001,01,003,0313,666,320,5,325,466,0,3,1,3,0,1,0,76.14,69.74 ,33.33
03,001,01,003,0314,667,903,15,918,1454,0,3,1,3,0,1,0,76.14,63.14 ,33.33
03,001,01,003,0314,668,421,7,428,652,0,3,1,3,0,1,0,76.14,65.64 ,33.33
03,001,01,003,0314,669,901,6,907,1310,0,3,1,3,0,1,0,76.14,69.24 ,33.33
03,001,01,003,0315,670,741,12,753,997,0,3,1,3,0,1,0,76.14,75.53 ,33.33
03,001,01,003,0315,671,751,6,757,999,0,3,1,3,0,1,0,76.14,75.78 ,33.33
03,001,01,003,0316,672,991,8,999,1409,0,3,1,3,0,1,0,76.14,70.90 ,33.33
03,001,01,003,0316,673,797,10,807,1152,0,3,1,3,0,1,0,76.14,70.05 ,33.33
03,001,01,003,0317,674,924,12,936,1327,0,3,1,3,0,1,0,76.14,70.54 ,33.33
03,001,01,003,0317,675,1009,16,1025,1534,0,3,1,3,0,1,0,76.14,66.82 ,33.33
03,001,01,003,0318,676,375,5,380,581,0,3,1,3,0,1,0,76.14,65.40 ,33.33
03,001,01,003,0318,677,869,15,884,1355,0,3,1,3,0,1,0,76.14,65.24 ,33.33
03,001,01,003,0319,678,771,12,783,1128,0,3,1,3,0,1,0,76.14,69.41 ,33.33
03,001,01,003,0319,679,628,8,636,990,0,3,1,3,0,1,0,76.14,64.24 ,33.33
03,001,01,003,0320,680,858,14,872,1394,0,3,1,3,0,1,0,76.14,62.55 ,33.33
03,001,01,003,0320,681,809,14,823,1331,0,3,1,3,0,1,0,76.14,61.83 ,33.33
03,001,01,003,0321,682,762,11,773,1223,0,3,1,3,0,1,0,76.14,63.21 ,33.33
03,001,01,003,0321,683,720,6,726,1031,0,3,1,3,0,1,0,76.14,70.42 ,33.33
03,001,01,003,0321,684,1193,16,1209,1779,0,3,1,3,0,1,0,76.14,67.96 ,33.33
03,001,01,003,0322,685,831,11,842,1282,0,3,1,3,0,1,0,76.14,65.68 ,33.33
03,001,01,003,0322,686,874,15,889,1341,0,3,1,3,0,1,0,76.14,66.29 ,33.33
03,001,01,003,0323,687,1236,20,1256,1893,0,3,1,3,0,1,0,76.14,66.35 ,33.33
03,001,01,003,0323,688,1048,11,1059,1602,0,3,1,3,0,1,0,76.14,66.10 ,33.33
03,001,01,003,0324,689,878,12,890,1335,0,3,1,3,0,1,0,76.14,66.67 ,33.33
03,001,01,003,0324,690,872,15,887,1421,0,3,1,3,0,1,0,76.14,62.42 ,33.33
03,001,01,003,0325,691,645,7,652,885,0,3,1,3,0,1,0,76.14,73.67 ,33.33
03,001,01,003,0325,692,666,5,671,931,0,3,1,3,0,1,0,76.14,72.07 ,33.33
03,001,01,003,0326,693,984,19,1003,1483,0,3,1,3,0,1,0,76.14,67.63 ,33.33
03,001,01,003,0326,694,885,12,897,1265,0,3,1,3,0,1,0,76.14,70.91 ,33.33
03,001,01,003,0327,695,976,22,998,1394,0,3,1,3,0,1,0,76.14,71.59 ,33.33
03,001,01,003,0327,696,1138,16,1154,1645,0,3,1,3,0,1,0,76.14,70.15 ,33.33
03,001,01,003,0328,697,1064,15,1079,1577,0,3,1,3,0,1,0,76.14,68.42 ,33.33
03,001,01,003,0328,698,533,10,543,757,0,3,1,3,0,1,0,76.14,71.73 ,33.33
03,001,01,003,0329,699,1106,17,1123,1638,0,3,1,3,0,1,0,76.14,68.56 ,33.33
03,001,01,003,0329,700,1188,22,1210,1748,0,3,1,3,0,1,0,76.14,69.22 ,33.33
03,001,01,003,0330,701,996,9,1005,1390,0,3,1,3,0,1,0,76.14,72.30 ,33.33
03,001,01,003,0330,702,797,15,812,1185,0,3,1,3,0,1,0,76.14,68.52 ,33.33
03,001,01,003,0330,703,946,13,959,1287,0,3,1,3,0,1,0,76.14,74.51 ,33.33
03,001,01,003,0331,704,778,12,790,1139,0,3,1,3,0,1,0,76.14,69.36 ,33.33
03,001,01,003,0331,705,916,10,926,1285,0,3,1,3,0,1,0,76.14,72.06 ,33.33
03,001,01,003,0332,706,755,11,766,1100,0,3,1,3,0,1,0,76.14,69.64 ,33.33
03,001,01,003,0332,707,900,7,907,1343,0,3,1,3,0,1,0,76.14,67.54 ,33.33
03,001,01,003,0333,708,655,5,660,944,0,3,1,3,0,1,0,76.14,69.92 ,33.33
03,001,01,003,0333,709,643,10,653,962,0,3,1,3,0,1,0,76.14,67.88 ,33.33
03,001,01,003,0334,710,1018,14,1032,1520,0,3,1,3,0,1,0,76.14,67.89 ,33.33
03,001,01,003,0335,711,963,18,981,1451,0,3,1,3,0,1,0,76.14,67.61 ,33.33
03,001,01,003,0335,712,1002,15,1017,1471,0,3,1,3,0,1,0,76.14,69.14 ,33.33
03,001,01,004,0336,713,1142,16,1158,1640,0,3,1,3,0,1,0,76.14,70.61 ,33.33
03,001,01,004,0337,714,752,11,763,1147,0,3,1,3,0,1,0,76.14,66.52 ,33.33
03,001,01,004,0338,715,641,8,649,1004,0,3,1,3,0,1,0,76.14,64.64 ,33.33
03,001,01,004,0338,716,749,6,755,1107,0,3,1,3,0,1,0,76.14,68.20 ,33.33
03,001,01,004,0339,717,1150,11,1161,1726,0,3,1,3,0,1,0,76.14,67.27 ,33.33
03,001,01,004,0339,718,1140,19,1159,1703,0,3,1,3,0,1,0,76.14,68.06 ,33.33
03,001,01,004,0340,719,1103,16,1119,1563,0,3,1,3,0,1,0,76.14,71.59 ,33.33
03,001,01,004,0340,720,892,17,909,1373,0,3,1,3,0,1,0,76.14,66.21 ,33.33
03,001,01,004,0341,721,1106,9,1115,1635,0,3,1,3,0,1,0,76.14,68.20 ,33.33
03,001,01,004,0341,722,1143,13,1156,1716,0,3,1,3,0,1,0,76.14,67.37 ,33.33
03,001,01,004,0342,723,1107,10,1117,1599,0,3,1,3,0,1,0,76.14,69.86 ,33.33
03,001,01,004,0342,724,1044,11,1055,1587,0,3,1,3,0,1,0,76.14,66.48 ,33.33
03,001,01,004,0343,725,871,15,886,1245,0,3,1,3,0,1,0,76.14,71.16 ,33.33
03,001,01,004,0344,726,1057,8,1065,1543,0,3,1,3,0,1,0,76.14,69.02 ,33.33
03,001,01,004,0344,727,903,14,917,1360,0,3,1,3,0,1,0,76.14,67.43 ,33.33
03,001,01,004,0345,728,1084,11,1095,1650,0,3,1,3,0,1,0,76.14,66.36 ,33.33
03,001,01,004,0345,729,1039,25,1064,1618,0,3,1,3,0,1,0,76.14,65.76 ,33.33
03,001,01,004,0346,730,724,10,734,1107,0,3,1,3,0,1,0,76.14,66.31 ,33.33
03,001,01,004,0346,731,594,5,599,887,0,3,1,3,0,1,0,76.14,67.53 ,33.33
03,001,01,004,0347,732,930,20,950,1505,0,3,1,3,0,1,0,76.14,63.12 ,33.33
03,001,01,004,0347,733,971,14,985,1449,0,3,1,3,0,1,0,76.14,67.98 ,33.33
03,001,01,004,0348,734,858,7,865,1247,0,3,1,3,0,1,0,76.14,69.37 ,33.33
03,001,01,004,0348,735,847,8,855,1288,0,3,1,3,0,1,0,76.14,66.38 ,33.33
03,001,01,004,0349,736,705,8,713,1103,0,3,1,3,0,1,0,76.14,64.64 ,33.33
03,001,01,004,0349,737,899,12,911,1354,0,3,1,3,0,1,0,76.14,67.28 ,33.33
03,001,01,004,0349,738,800,9,809,1165,0,3,1,3,0,1,0,76.14,69.44 ,33.33
03,001,01,004,0350,739,761,9,770,1084,0,3,1,3,0,1,0,76.14,71.03 ,33.33
03,001,01,004,0350,740,813,5,818,1174,0,3,1,3,0,1,0,76.14,69.68 ,33.33
03,001,01,004,0350,741,825,9,834,1131,0,3,1,3,0,1,0,76.14,73.74 ,33.33
03,001,01,004,0351,742,1093,6,1099,1608,0,3,1,3,0,1,0,76.14,68.35 ,33.33
03,001,01,004,0351,743,1070,13,1083,1510,0,3,1,3,0,1,0,76.14,71.72 ,33.33
03,001,01,004,0352,744,948,12,960,1351,0,3,1,3,0,1,0,76.14,71.06 ,33.33
03,001,01,004,0352,745,902,9,911,1271,0,3,1,3,0,1,0,76.14,71.68 ,33.33
03,001,01,004,0353,746,915,16,931,1332,0,3,1,3,0,1,0,76.14,69.89 ,33.33
03,001,01,004,0353,747,858,10,868,1278,0,3,1,3,0,1,0,76.14,67.92 ,33.33
03,001,01,004,0354,748,1129,16,1145,1645,0,3,1,3,0,1,0,76.14,69.60 ,33.33
03,001,01,004,0354,749,1162,9,1171,1732,0,3,1,3,0,1,0,76.14,67.61 ,33.33
03,001,01,004,0355,750,905,8,913,1261,0,3,1,3,0,1,0,76.14,72.40 ,33.33
03,001,01,004,0355,751,844,13,857,1237,0,3,1,3,0,1,0,76.14,69.28 ,33.33
03,001,01,004,0355,752,954,17,971,1377,0,3,1,3,0,1,0,76.14,70.52 ,33.33
03,001,01,004,0356,753,1111,9,1120,1563,0,3,1,3,0,1,0,76.14,71.66 ,33.33
03,001,01,004,0356,754,1040,13,1053,1452,0,3,1,3,0,1,0,76.14,72.52 ,33.33
03,001,01,004,0357,755,779,9,788,1180,0,3,1,3,0,1,0,76.14,66.78 ,33.33
03,001,01,004,0357,756,878,9,887,1236,0,3,1,3,0,1,0,76.14,71.76 ,33.33
03,001,01,004,0357,757,907,6,913,1219,0,3,1,3,0,1,0,76.14,74.90 ,33.33
03,001,01,004,0358,758,999,21,1020,1504,0,3,1,3,0,1,0,76.14,67.82 ,33.33
03,001,01,004,0358,759,1070,18,1088,1643,0,3,1,3,0,1,0,76.14,66.22 ,33.33
03,001,01,004,0359,760,730,9,739,1066,0,3,1,3,0,1,0,76.14,69.32 ,33.33
03,001,01,004,0359,761,916,11,927,1355,0,3,1,3,0,1,0,76.14,68.41 ,33.33
03,001,01,004,0360,762,1043,11,1054,1495,0,3,1,3,0,1,0,76.14,70.50 ,33.33
03,001,01,004,0360,763,963,10,973,1410,0,3,1,3,0,1,0,76.14,69.01 ,33.33
03,001,01,004,0361,764,1059,13,1072,1522,0,3,1,3,0,1,0,76.14,70.43 ,33.33
03,001,01,004,0361,765,1051,11,1062,1523,0,3,1,3,0,1,0,76.14,69.73 ,33.33
03,001,01,004,0361,766,1092,14,1106,1620,0,3,1,3,0,1,0,76.14,68.27 ,33.33
03,001,01,004,0362,767,806,7,813,1164,0,3,1,3,0,1,0,76.14,69.85 ,33.33
03,001,01,004,0362,768,961,7,968,1357,0,3,1,3,0,1,0,76.14,71.33 ,33.33
03,001,01,004,0362,769,720,11,731,1041,0,3,1,3,0,1,0,76.14,70.22 ,33.33
03,001,01,004,0363,770,1188,17,1205,1703,0,3,1,3,0,1,0,76.14,70.76 ,33.33
03,001,01,004,0363,771,1009,13,1022,1496,0,3,1,3,0,1,0,76.14,68.32 ,33.33
03,001,01,004,0363,772,932,14,946,1389,0,3,1,3,0,1,0,76.14,68.11 ,33.33
03,001,01,004,0364,773,1179,14,1193,1670,0,3,1,3,0,1,0,76.14,71.44 ,33.33
03,001,01,004,0364,774,1079,16,1095,1569,0,3,1,3,0,1,0,76.14,69.79 ,33.33
03,001,01,004,0365,775,837,12,849,1215,0,3,1,3,0,1,0,76.14,69.88 ,33.33
03,001,01,004,0365,776,765,15,780,1183,0,3,1,3,0,1,0,76.14,65.93 ,33.33
03,001,01,004,0366,777,1090,12,1102,1660,0,3,1,3,0,1,0,76.14,66.39 ,33.33
03,001,01,004,0366,778,1131,19,1150,1638,0,3,1,3,0,1,0,76.14,70.21 ,33.33
03,001,01,004,0367,779,614,12,626,958,0,3,1,3,0,1,0,76.14,65.34 ,33.33
03,001,01,004,0367,780,1029,8,1037,1507,0,3,1,3,0,1,0,76.14,68.81 ,33.33
03,001,01,004,0367,781,718,5,723,1096,0,3,1,3,0,1,0,76.14,65.97 ,33.33
03,001,01,004,0368,782,748,9,757,1100,0,3,1,3,0,1,0,76.14,68.82 ,33.33
03,001,01,004,0368,783,822,14,836,1200,0,3,1,3,0,1,0,76.14,69.67 ,33.33
03,001,01,004,0368,784,777,11,788,1193,0,3,1,3,0,1,0,76.14,66.05 ,33.33
03,001,01,004,0369,785,938,14,952,1440,0,3,1,3,0,1,0,76.14,66.11 ,33.33
03,001,01,004,0369,786,960,8,968,1437,0,3,1,3,0,1,0,76.14,67.36 ,33.33
03,001,01,004,0370,787,577,7,584,887,0,3,1,3,0,1,0,76.14,65.84 ,33.33
03,001,01,004,0370,788,624,2,626,974,0,3,1,3,0,1,0,76.14,64.27 ,33.33
03,001,01,004,0371,789,862,5,867,1229,0,3,1,3,0,1,0,76.14,70.55 ,33.33
03,001,01,004,0371,790,819,10,829,1194,0,3,1,3,0,1,0,76.14,69.43 ,33.33
03,001,01,004,0371,791,936,9,945,1424,0,3,1,3,0,1,0,76.14,66.36 ,33.33
03,001,01,004,0372,792,1242,15,1257,1809,0,3,1,3,0,1,0,76.14,69.49 ,33.33
03,001,01,004,0372,793,926,14,940,1339,0,3,1,3,0,1,0,76.14,70.20 ,33.33
03,001,01,004,0373,794,903,12,915,1395,0,3,1,3,0,1,0,76.14,65.59 ,33.33
03,001,01,004,0373,795,918,16,934,1368,0,3,1,3,0,1,0,76.14,68.27 ,33.33
03,001,01,004,0374,796,848,7,855,1308,0,3,1,3,0,1,0,76.14,65.37 ,33.33
03,001,01,004,0374,797,966,13,979,1321,0,3,1,3,0,1,0,76.14,74.11 ,33.33
03,001,01,004,0375,798,833,14,847,1261,0,3,1,3,0,1,0,76.14,67.17 ,33.33
03,001,01,004,0375,799,1043,16,1059,1492,0,3,1,3,0,1,0,76.14,70.98 ,33.33
03,001,01,004,0376,800,1203,16,1219,1727,0,3,1,3,0,1,0,76.14,70.58 ,33.33
03,001,01,004,0377,801,1101,14,1115,1662,0,3,1,3,0,1,0,76.14,67.09 ,33.33
03,001,01,004,0377,802,1109,13,1122,1663,0,3,1,3,0,1,0,76.14,67.47 ,33.33
03,001,01,004,0378,803,1098,12,1110,1573,0,3,1,3,0,1,0,76.14,70.57 ,33.33
03,001,01,004,0378,804,1232,6,1238,1745,0,3,1,3,0,1,0,76.14,70.95 ,33.33
03,001,01,004,0379,805,1137,10,1147,1637,0,3,1,3,0,1,0,76.14,70.07 ,33.33
03,001,01,004,0379,806,1110,17,1127,1687,0,3,1,3,0,1,0,76.14,66.80 ,33.33
03,001,01,004,0380,807,1173,13,1186,1768,0,3,1,3,0,1,0,76.14,67.08 ,33.33
03,001,01,004,0380,808,783,9,792,1153,0,3,1,3,0,1,0,76.14,68.69 ,33.33
03,001,01,004,0380,809,900,8,908,1378,0,3,1,3,0,1,0,76.14,65.89 ,33.33
03,001,01,004,0381,810,1031,15,1046,1493,0,3,1,3,0,1,0,76.14,70.06 ,33.33
03,001,01,004,0381,811,886,13,899,1348,0,3,1,3,0,1,0,76.14,66.69 ,33.33
03,001,01,004,0382,812,808,27,835,1055,0,3,1,3,0,1,0,76.14,79.15 ,33.33
03,001,01,004,0383,813,640,18,658,855,0,3,1,3,0,1,0,76.14,76.96 ,33.33
03,001,01,004,0384,814,750,18,768,1034,0,3,1,3,0,1,0,76.14,74.27 ,33.33
03,001,01,004,0385,815,586,9,595,789,0,3,1,3,0,1,0,76.14,75.41 ,33.33
03,001,01,004,0386,816,805,15,820,1161,0,3,1,3,0,1,0,76.14,70.63 ,33.33
03,001,01,004,0386,817,978,13,991,1384,0,3,1,3,0,1,0,76.14,71.60 ,33.33
03,001,01,004,0387,818,641,6,647,967,0,3,1,3,0,1,0,76.14,66.91 ,33.33
03,001,01,004,0387,819,736,12,748,1154,0,3,1,3,0,1,0,76.14,64.82 ,33.33
03,001,01,004,0388,820,647,8,655,983,0,3,1,3,0,1,0,76.14,66.63 ,33.33
03,001,01,004,0388,821,652,7,659,938,0,3,1,3,0,1,0,76.14,70.26 ,33.33
03,001,01,004,0389,822,1001,13,1014,1531,0,3,1,3,0,1,0,76.14,66.23 ,33.33
03,001,01,004,0390,823,524,22,546,812,0,3,1,3,0,1,0,76.14,67.24 ,33.33
03,001,01,004,0390,824,735,8,743,1083,0,3,1,3,0,1,0,76.14,68.61 ,33.33
03,001,01,004,0391,825,690,8,698,989,0,3,1,3,0,1,0,76.14,70.58 ,33.33
03,001,01,004,0391,826,804,7,811,1162,0,3,1,3,0,1,0,76.14,69.79 ,33.33
03,001,01,004,0392,827,612,9,621,866,0,3,1,3,0,1,0,76.14,71.71 ,33.33
03,001,01,004,0392,828,659,2,661,931,0,3,1,3,0,1,0,76.14,71.00 ,33.33
03,001,01,004,0393,829,695,8,703,1027,0,3,1,3,0,1,0,76.14,68.45 ,33.33
03,001,01,004,0393,830,903,12,915,1264,0,3,1,3,0,1,0,76.14,72.39 ,33.33
03,001,01,005,0394,831,741,5,746,1119,0,3,1,3,0,1,0,76.14,66.67 ,33.33
03,001,01,005,0394,832,955,12,967,1438,0,3,1,3,0,1,0,76.14,67.25 ,33.33
03,001,01,005,0394,833,1016,13,1029,1535,0,3,1,3,0,1,0,76.14,67.04 ,33.33
03,001,01,005,0395,834,1071,14,1085,1499,0,3,1,3,0,1,0,76.14,72.38 ,33.33
03,001,01,005,0395,835,942,10,952,1464,0,3,1,3,0,1,0,76.14,65.03 ,33.33
03,001,01,005,0396,836,760,6,766,1144,0,3,1,3,0,1,0,76.14,66.96 ,33.33
03,001,01,005,0396,837,788,8,796,1179,0,3,1,3,0,1,0,76.14,67.51 ,33.33
03,001,01,005,0396,838,788,9,797,1169,0,3,1,3,0,1,0,76.14,68.18 ,33.33
03,001,01,005,0397,839,1019,10,1029,1437,0,3,1,3,0,1,0,76.14,71.61 ,33.33
03,001,01,005,0398,840,1140,10,1150,1652,0,3,1,3,0,1,0,76.14,69.61 ,33.33
03,001,01,005,0398,841,942,9,951,1442,0,3,1,3,0,1,0,76.14,65.95 ,33.33
03,001,01,005,0399,842,675,6,681,966,0,3,1,3,0,1,0,76.14,70.50 ,33.33
03,001,01,005,0399,843,655,5,660,964,0,3,1,3,0,1,0,76.14,68.46 ,33.33
03,001,01,005,0399,844,615,12,627,911,0,3,1,3,0,1,0,76.14,68.83 ,33.33
03,001,01,005,0400,845,871,13,884,1314,0,3,1,3,0,1,0,76.14,67.28 ,33.33
03,001,01,005,0400,846,959,10,969,1354,0,3,1,3,0,1,0,76.14,71.57 ,33.33
03,001,01,005,0401,847,1007,12,1019,1448,0,3,1,3,0,1,0,76.14,70.37 ,33.33
03,001,01,005,0402,848,739,5,744,1083,0,3,1,3,0,1,0,76.14,68.70 ,33.33
03,001,01,005,0403,849,749,7,756,1151,0,3,1,3,0,1,0,76.14,65.68 ,33.33
03,001,01,005,0403,850,722,4,726,1072,0,3,1,3,0,1,0,76.14,67.72 ,33.33
03,001,01,005,0403,851,802,8,810,1181,0,3,1,3,0,1,0,76.14,68.59 ,33.33
03,001,01,005,0404,852,943,13,956,1373,0,3,1,3,0,1,0,76.14,69.63 ,33.33
03,001,01,005,0404,853,733,9,742,1156,0,3,1,3,0,1,0,76.14,64.19 ,33.33
03,001,01,005,0405,854,659,9,668,1067,0,3,1,3,0,1,0,76.14,62.61 ,33.33
03,001,01,005,0405,855,784,13,797,1232,0,3,1,3,0,1,0,76.14,64.69 ,33.33
03,001,01,005,0405,856,770,11,781,1181,0,3,1,3,0,1,0,76.14,66.13 ,33.33
03,001,01,005,0406,857,939,10,949,1381,0,3,1,3,0,1,0,76.14,68.72 ,33.33
03,001,01,005,0406,858,679,15,694,1078,0,3,1,3,0,1,0,76.14,64.38 ,33.33
03,001,01,005,0406,859,706,11,717,1098,0,3,1,3,0,1,0,76.14,65.30 ,33.33
03,001,01,005,0407,860,804,15,819,1191,0,3,1,3,0,1,0,76.14,68.77 ,33.33
03,001,01,005,0407,861,780,12,792,1204,0,3,1,3,0,1,0,76.14,65.78 ,33.33
03,001,01,005,0408,862,670,7,677,1117,0,3,1,3,0,1,0,76.14,60.61 ,33.33
03,001,01,005,0408,863,735,10,745,1136,0,3,1,3,0,1,0,76.14,65.58 ,33.33
03,001,01,005,0409,864,752,10,762,1216,0,3,1,3,0,1,0,76.14,62.66 ,33.33
03,001,01,005,0409,865,718,22,740,1177,0,3,1,3,0,1,0,76.14,62.87 ,33.33
03,001,01,005,0410,866,686,13,699,1109,0,3,1,3,0,1,0,76.14,63.03 ,33.33
03,001,01,005,0410,867,608,9,617,972,0,3,1,3,0,1,0,76.14,63.48 ,33.33
03,001,01,005,0410,868,643,10,653,1153,0,3,1,3,0,1,0,76.14,56.63 ,33.33
03,001,01,005,0411,869,653,6,659,1102,0,3,1,3,0,1,0,76.14,59.80 ,33.33
03,001,01,005,0411,870,739,14,753,1171,0,3,1,3,0,1,0,76.14,64.30 ,33.33
03,001,01,005,0411,871,677,14,691,1136,0,3,1,3,0,1,0,76.14,60.83 ,33.33
03,001,01,005,0412,872,800,14,814,1153,0,3,1,3,0,1,0,76.14,70.60 ,33.33
03,001,01,005,0412,873,1165,22,1187,1875,0,3,1,3,0,1,0,76.14,63.31 ,33.33
03,001,01,005,0413,874,360,6,366,561,0,3,1,3,0,1,0,76.14,65.24 ,33.33
03,001,01,005,0413,875,777,12,789,1317,0,3,1,3,0,1,0,76.14,59.91 ,33.33
03,001,01,005,0414,876,867,9,876,1448,0,3,1,3,0,1,0,76.14,60.50 ,33.33
03,001,01,005,0414,877,928,21,949,1472,0,3,1,3,0,1,0,76.14,64.47 ,33.33
03,001,01,005,0415,878,939,15,954,1478,0,3,1,3,0,1,0,76.14,64.55 ,33.33
03,001,01,005,0416,879,641,10,651,996,0,3,1,3,0,1,0,76.14,65.36 ,33.33
03,001,01,005,0416,880,687,10,697,1002,0,3,1,3,0,1,0,76.14,69.56 ,33.33
03,001,01,005,0417,881,957,14,971,1414,0,3,1,3,0,1,0,76.14,68.67 ,33.33
03,001,01,005,0417,882,992,21,1013,1529,0,3,1,3,0,1,0,76.14,66.25 ,33.33
03,001,01,005,0418,883,752,14,766,1087,0,3,1,3,0,1,0,76.14,70.47 ,33.33
03,001,01,005,0418,884,629,11,640,920,0,3,1,3,0,1,0,76.14,69.57 ,33.33
03,001,01,005,0418,885,895,22,917,1373,0,3,1,3,0,1,0,76.14,66.79 ,33.33
03,001,01,005,0419,886,693,7,700,1073,0,3,1,3,0,1,0,76.14,65.24 ,33.33
03,001,01,005,0419,887,768,7,775,1137,0,3,1,3,0,1,0,76.14,68.16 ,33.33
03,001,01,005,0419,888,739,9,748,1133,0,3,1,3,0,1,0,76.14,66.02 ,33.33
03,001,01,005,0420,889,1097,15,1112,1574,0,3,1,3,0,1,0,76.14,70.65 ,33.33
03,001,01,005,0421,890,826,9,835,1224,0,3,1,3,0,1,0,76.14,68.22 ,33.33
03,001,01,005,0421,891,849,12,861,1367,0,3,1,3,0,1,0,76.14,62.98 ,33.33
03,001,01,005,0421,892,903,9,912,1371,0,3,1,3,0,1,0,76.14,66.52 ,33.33
03,001,01,005,0422,893,731,12,743,1139,0,3,1,3,0,1,0,76.14,65.23 ,33.33
03,001,01,005,0423,894,959,15,974,1531,0,3,1,3,0,1,0,76.14,63.62 ,33.33
03,001,01,005,0424,895,489,10,499,709,0,3,1,3,0,1,0,76.14,70.38 ,33.33
03,001,01,005,0424,896,832,15,847,1270,0,3,1,3,0,1,0,76.14,66.69 ,33.33
03,001,01,005,0424,897,916,20,936,1499,0,3,1,3,0,1,0,76.14,62.44 ,33.33
03,001,01,005,0425,898,717,13,730,1131,0,3,1,3,0,1,0,76.14,64.54 ,33.33
03,001,01,005,0425,899,1049,7,1056,1656,0,3,1,3,0,1,0,76.14,63.77 ,33.33
03,001,01,005,0425,900,769,6,775,1206,0,3,1,3,0,1,0,76.14,64.26 ,33.33
03,001,01,005,0426,901,660,15,675,1119,0,3,1,3,0,1,0,76.14,60.32 ,33.33
03,001,01,005,0426,902,670,18,688,1138,0,3,1,3,0,1,0,76.14,60.46 ,33.33
03,001,01,005,0426,903,820,6,826,1339,0,3,1,3,0,1,0,76.14,61.69 ,33.33
03,001,01,005,0427,904,1009,21,1030,1626,0,3,1,3,0,1,0,76.14,63.35 ,33.33
03,001,01,005,0428,905,838,13,851,1260,0,3,1,3,0,1,0,76.14,67.54 ,33.33
03,001,01,005,0428,906,824,10,834,1323,0,3,1,3,0,1,0,76.14,63.04 ,33.33
03,001,01,005,0428,907,795,12,807,1257,0,3,1,3,0,1,0,76.14,64.20 ,33.33
03,001,01,005,0429,908,488,6,494,780,0,3,1,3,0,1,0,76.14,63.33 ,33.33
03,001,01,005,0429,909,607,9,616,968,0,3,1,3,0,1,0,76.14,63.64 ,33.33
03,001,01,005,0430,910,740,10,750,1193,0,3,1,3,0,1,0,76.14,62.87 ,33.33
03,001,01,005,0430,911,779,8,787,1259,0,3,1,3,0,1,0,76.14,62.51 ,33.33
03,001,01,005,0431,912,747,18,765,1188,0,3,1,3,0,1,0,76.14,64.39 ,33.33
03,001,01,005,0431,913,725,8,733,1099,0,3,1,3,0,1,0,76.14,66.70 ,33.33
03,001,01,005,0431,914,826,16,842,1219,0,3,1,3,0,1,0,76.14,69.07 ,33.33
03,001,01,005,0432,915,916,8,924,1393,0,3,1,3,0,1,0,76.14,66.33 ,33.33
03,001,01,005,0432,916,933,5,938,1466,0,3,1,3,0,1,0,76.14,63.98 ,33.33
03,001,01,005,0433,917,875,6,881,1421,0,3,1,3,0,1,0,76.14,62.00 ,33.33
03,001,01,005,0433,918,658,9,667,1032,0,3,1,3,0,1,0,76.14,64.63 ,33.33
03,001,01,005,0433,919,914,7,921,1377,0,3,1,3,0,1,0,76.14,66.88 ,33.33
03,001,01,005,0434,920,906,13,919,1480,0,3,1,3,0,1,0,76.14,62.09 ,33.33
03,001,01,005,0434,921,977,14,991,1537,0,3,1,3,0,1,0,76.14,64.48 ,33.33
03,001,01,005,0435,922,916,10,926,1372,0,3,1,3,0,1,0,76.14,67.49 ,33.33
03,001,01,005,0435,923,855,16,871,1294,0,3,1,3,0,1,0,76.14,67.31 ,33.33
03,001,01,005,0436,924,702,9,711,1045,0,3,1,3,0,1,0,76.14,68.04 ,33.33
03,001,01,005,0436,925,548,3,551,866,0,3,1,3,0,1,0,76.14,63.63 ,33.33
03,001,01,005,0437,926,682,5,687,1056,0,3,1,3,0,1,0,76.14,65.06 ,33.33
03,001,01,005,0437,927,940,12,952,1375,0,3,1,3,0,1,0,76.14,69.24 ,33.33
03,001,01,005,0437,928,568,10,578,926,0,3,1,3,0,1,0,76.14,62.42 ,33.33
03,001,01,005,0438,929,994,17,1011,1532,0,3,1,3,0,1,0,76.14,65.99 ,33.33
03,001,01,005,0438,930,755,18,773,1203,0,3,1,3,0,1,0,76.14,64.26 ,33.33
03,001,01,005,0438,931,814,14,828,1302,0,3,1,3,0,1,0,76.14,63.59 ,33.33
03,001,01,005,0439,932,1002,18,1020,1436,0,3,1,3,0,1,0,76.14,71.03 ,33.33
03,001,01,005,0440,933,581,9,590,1131,0,3,1,3,0,1,0,76.14,52.17 ,33.33
03,001,01,005,0440,934,652,8,660,1015,0,3,1,3,0,1,0,76.14,65.02 ,33.33
03,001,01,005,0441,935,662,9,671,959,0,3,1,3,0,1,0,76.14,69.97 ,33.33
03,001,01,005,0441,936,660,8,668,938,0,3,1,3,0,1,0,76.14,71.22 ,33.33
03,001,01,005,0442,937,643,8,651,1097,0,3,1,3,0,1,0,76.14,59.34 ,33.33
03,001,01,005,0442,938,741,9,750,1236,0,3,1,3,0,1,0,76.14,60.68 ,33.33
03,001,01,005,0442,939,825,13,838,1274,0,3,1,3,0,1,0,76.14,65.78 ,33.33
03,001,01,005,0443,940,776,12,788,1132,0,3,1,3,0,1,0,76.14,69.61 ,33.33
03,001,01,005,0443,941,689,15,704,1073,0,3,1,3,0,1,0,76.14,65.61 ,33.33
03,001,01,005,0443,942,745,11,756,1168,0,3,1,3,0,1,0,76.14,64.73 ,33.33
03,001,01,005,0443,943,636,5,641,926,0,3,1,3,0,1,0,76.14,69.22 ,33.33
03,001,01,005,0444,944,906,22,928,1477,0,3,1,3,0,1,0,76.14,62.83 ,33.33
03,001,01,005,0444,945,938,13,951,1535,0,3,1,3,0,1,0,76.14,61.95 ,33.33
03,001,01,005,0445,946,1029,14,1043,1609,0,3,1,3,0,1,0,76.14,64.82 ,33.33
03,001,01,005,0445,947,1047,18,1065,1615,0,3,1,3,0,1,0,76.14,65.94 ,33.33
03,001,01,005,0445,948,699,10,709,1134,0,3,1,3,0,1,0,76.14,62.52 ,33.33
03,001,01,005,0446,949,791,14,805,1258,0,3,1,3,0,1,0,76.14,63.99 ,33.33
03,001,01,005,0446,950,998,5,1003,1534,0,3,1,3,0,1,0,76.14,65.38 ,33.33
03,001,01,005,0447,951,201,0,201,222,0,3,1,3,0,1,0,76.14,90.54 ,33.33
03,001,01,005,0447,952,759,7,766,1242,0,3,1,3,0,1,0,76.14,61.67 ,33.33
03,001,01,005,0447,953,757,11,768,1237,0,3,1,3,0,1,0,76.14,62.09 ,33.33
03,001,01,005,0447,954,587,9,596,1039,0,3,1,3,0,1,0,76.14,57.36 ,33.33
03,001,01,005,0448,955,695,7,702,1173,0,3,1,3,0,1,0,76.14,59.85 ,33.33
03,001,01,005,0448,956,809,24,833,1372,0,3,1,3,0,1,0,76.14,60.71 ,33.33
03,001,01,005,0448,957,851,14,865,1295,0,3,1,3,0,1,0,76.14,66.80 ,33.33
03,001,01,005,0449,958,497,2,499,741,0,3,1,3,0,1,0,76.14,67.34 ,33.33
03,001,01,005,0449,959,521,5,526,825,0,3,1,3,0,1,0,76.14,63.76 ,33.33
03,001,01,005,0450,960,797,7,804,1268,0,3,1,3,0,1,0,76.14,63.41 ,33.33
03,001,01,005,0450,961,909,8,917,1462,0,3,1,3,0,1,0,76.14,62.72 ,33.33
03,001,01,005,0451,962,911,16,927,1582,0,3,1,3,0,1,0,76.14,58.60 ,33.33
03,001,01,005,0451,963,952,13,965,1576,0,3,1,3,0,1,0,76.14,61.23 ,33.33
03,001,01,005,0452,964,664,10,674,1117,0,3,1,3,0,1,0,76.14,60.34 ,33.33
03,001,01,005,0452,965,663,5,668,1056,0,3,1,3,0,1,0,76.14,63.26 ,33.33
03,001,01,005,0452,966,620,6,626,1106,0,3,1,3,0,1,0,76.14,56.60 ,33.33
03,001,01,005,0453,967,543,4,547,880,0,3,1,3,0,1,0,76.14,62.16 ,33.33
03,001,01,005,0453,968,574,5,579,889,0,3,1,3,0,1,0,76.14,65.13 ,33.33
03,001,01,005,0454,969,711,14,725,1182,0,3,1,3,0,1,0,76.14,61.34 ,33.33
03,001,01,005,0454,970,679,9,688,1102,0,3,1,3,0,1,0,76.14,62.43 ,33.33
03,001,01,005,0455,971,554,9,563,814,0,3,1,3,0,1,0,76.14,69.16 ,33.33
03,001,01,005,0455,972,561,2,563,885,0,3,1,3,0,1,0,76.14,63.62 ,33.33
03,001,01,005,0456,973,610,6,616,1014,0,3,1,3,0,1,0,76.14,60.75 ,33.33
03,001,01,005,0456,974,704,5,709,1110,0,3,1,3,0,1,0,76.14,63.87 ,33.33
03,001,01,005,0457,975,779,13,792,1313,0,3,1,3,0,1,0,76.14,60.32 ,33.33
03,001,01,005,0457,976,622,6,628,1003,0,3,1,3,0,1,0,76.14,62.61 ,33.33
03,001,01,005,0458,977,805,6,811,1313,0,3,1,3,0,1,0,76.14,61.77 ,33.33
03,001,01,005,0458,978,689,10,699,1135,0,3,1,3,0,1,0,76.14,61.59 ,33.33
03,001,01,005,0458,979,741,13,754,1293,0,3,1,3,0,1,0,76.14,58.31 ,33.33
03,001,01,005,0459,980,767,10,777,1210,0,3,1,3,0,1,0,76.14,64.21 ,33.33
03,001,01,005,0459,981,954,17,971,1563,0,3,1,3,0,1,0,76.14,62.12 ,33.33
03,001,01,005,0459,982,857,11,868,1342,0,3,1,3,0,1,0,76.14,64.68 ,33.33
03,001,01,005,0460,983,643,13,656,1033,0,3,1,3,0,1,0,76.14,63.50 ,33.33
03,001,01,005,0460,984,779,10,789,1277,0,3,1,3,0,1,0,76.14,61.79 ,33.33
03,001,01,005,0461,985,573,6,579,914,0,3,1,3,0,1,0,76.14,63.35 ,33.33
03,001,01,005,0461,986,634,11,645,1043,0,3,1,3,0,1,0,76.14,61.84 ,33.33
03,001,01,005,0462,987,836,10,846,1398,0,3,1,3,0,1,0,76.14,60.52 ,33.33
03,001,01,005,0462,988,851,12,863,1463,0,3,1,3,0,1,0,76.14,58.99 ,33.33
03,001,01,005,0463,989,819,9,828,1234,0,3,1,3,0,1,0,76.14,67.10 ,33.33
03,001,01,005,0463,990,732,6,738,1148,0,3,1,3,0,1,0,76.14,64.29 ,33.33
03,001,01,005,0463,991,768,18,786,1222,0,3,1,3,0,1,0,76.14,64.32 ,33.33
03,001,01,005,0463,992,745,8,753,1210,0,3,1,3,0,1,0,76.14,62.23 ,33.33
03,001,01,005,0464,993,669,7,676,1076,0,3,1,3,0,1,0,76.14,62.83 ,33.33
03,001,01,005,0464,994,804,10,814,1398,0,3,1,3,0,1,0,76.14,58.23 ,33.33
03,001,01,005,0464,995,627,6,633,951,0,3,1,3,0,1,0,76.14,66.56 ,33.33
03,001,01,006,0465,996,935,19,954,1339,0,3,1,3,0,1,0,76.14,71.25 ,33.33
03,001,01,006,0466,997,758,14,772,1095,0,3,1,3,0,1,0,76.14,70.50 ,33.33
03,001,01,006,0467,998,578,7,585,872,0,3,1,3,0,1,0,76.14,67.09 ,33.33
03,001,01,006,0467,999,679,10,689,1118,0,3,1,3,0,1,0,76.14,61.63 ,33.33
03,001,01,006,0468,1000,812,8,820,1259,0,3,1,3,0,1,0,76.14,65.13 ,33.33
03,001,01,006,0469,1001,587,11,598,882,0,3,1,3,0,1,0,76.14,67.80 ,33.33
03,001,01,006,0470,1002,820,7,827,1101,0,3,1,3,0,1,0,76.14,75.11 ,33.33
03,001,01,006,0470,1003,738,7,745,1057,0,3,1,3,0,1,0,76.14,70.48 ,33.33
03,001,01,006,0471,1004,954,7,961,1354,0,3,1,3,0,1,0,76.14,70.97 ,33.33
03,001,01,006,0471,1005,842,6,848,1250,0,3,1,3,0,1,0,76.14,67.84 ,33.33
03,001,01,006,0471,1006,849,10,859,1327,0,3,1,3,0,1,0,76.14,64.73 ,33.33
03,001,01,006,0472,1007,1079,20,1099,1567,0,3,1,3,0,1,0,76.14,70.13 ,33.33
03,001,01,006,0472,1008,988,10,998,1384,0,3,1,3,0,1,0,76.14,72.11 ,33.33
03,001,01,006,0472,1009,716,8,724,992,0,3,1,3,0,1,0,76.14,72.98 ,33.33
03,001,01,006,0473,1010,867,12,879,1259,0,3,1,3,0,1,0,76.14,69.82 ,33.33
03,001,01,006,0473,1011,856,12,868,1230,0,3,1,3,0,1,0,76.14,70.57 ,33.33
03,001,01,006,0474,1012,898,7,905,1340,0,3,1,3,0,1,0,76.14,67.54 ,33.33
03,001,01,006,0474,1013,861,13,874,1234,0,3,1,3,0,1,0,76.14,70.83 ,33.33
03,001,01,006,0474,1014,933,15,948,1443,0,3,1,3,0,1,0,76.14,65.70 ,33.33
03,001,01,006,0474,1015,869,13,882,1324,0,3,1,3,0,1,0,76.14,66.62 ,33.33
03,001,01,006,0475,1016,770,4,774,1068,0,3,1,3,0,1,0,76.14,72.47 ,33.33
03,001,01,006,0475,1017,941,5,946,1432,0,3,1,3,0,1,0,76.14,66.06 ,33.33
03,001,01,006,0475,1018,800,9,809,1251,0,3,1,3,0,1,0,76.14,64.67 ,33.33
03,001,01,006,0475,1019,843,6,849,1327,0,3,1,3,0,1,0,76.14,63.98 ,33.33
03,001,01,006,0475,1020,520,4,524,766,0,3,1,3,0,1,0,76.14,68.41 ,33.33
03,001,01,006,0476,1021,637,4,641,1000,0,3,1,3,0,1,0,76.14,64.10 ,33.33
03,001,01,006,0476,1022,707,7,714,1078,0,3,1,3,0,1,0,76.14,66.23 ,33.33
03,001,01,006,0476,1023,675,16,691,1007,0,3,1,3,0,1,0,76.14,68.62 ,33.33
03,001,01,006,0477,1024,686,4,690,1015,0,3,1,3,0,1,0,76.14,67.98 ,33.33
03,001,01,006,0477,1025,739,3,742,1098,0,3,1,3,0,1,0,76.14,67.58 ,33.33
03,001,01,006,0478,1026,923,11,934,1299,0,3,1,3,0,1,0,76.14,71.90 ,33.33
03,001,01,006,0478,1027,804,5,809,1184,0,3,1,3,0,1,0,76.14,68.33 ,33.33
03,001,01,006,0478,1028,1043,11,1054,1596,0,3,1,3,0,1,0,76.14,66.04 ,33.33
03,001,01,006,0478,1029,943,7,950,1372,0,3,1,3,0,1,0,76.14,69.24 ,33.33
03,001,01,006,0479,1030,828,8,836,1238,0,3,1,3,0,1,0,76.14,67.53 ,33.33
03,001,01,006,0479,1031,830,13,843,1253,0,3,1,3,0,1,0,76.14,67.28 ,33.33
03,001,01,006,0479,1032,696,9,705,1047,0,3,1,3,0,1,0,76.14,67.34 ,33.33
03,001,01,006,0480,1033,762,8,770,1183,0,3,1,3,0,1,0,76.14,65.09 ,33.33
03,001,01,006,0480,1034,684,12,696,1011,0,3,1,3,0,1,0,76.14,68.84 ,33.33
03,001,01,006,0480,1035,892,11,903,1324,0,3,1,3,0,1,0,76.14,68.20 ,33.33
03,001,01,006,0480,1036,1020,13,1033,1578,0,3,1,3,0,1,0,76.14,65.46 ,33.33
03,001,01,006,0481,1037,728,8,736,1057,0,3,1,3,0,1,0,76.14,69.63 ,33.33
03,001,01,006,0481,1038,789,6,795,1116,0,3,1,3,0,1,0,76.14,71.24 ,33.33
03,001,01,006,0481,1039,906,4,910,1386,0,3,1,3,0,1,0,76.14,65.66 ,33.33
03,001,01,006,0482,1040,765,9,774,1153,0,3,1,3,0,1,0,76.14,67.13 ,33.33
03,001,01,006,0482,1041,785,11,796,1235,0,3,1,3,0,1,0,76.14,64.45 ,33.33
03,001,01,006,0483,1042,957,15,972,1386,0,3,1,3,0,1,0,76.14,70.13 ,33.33
03,001,01,006,0483,1043,601,1,602,865,0,3,1,3,0,1,0,76.14,69.60 ,33.33
03,001,01,006,0483,1044,645,7,652,990,0,3,1,3,0,1,0,76.14,65.86 ,33.33
03,001,01,006,0484,1045,833,8,841,1197,0,3,1,3,0,1,0,76.14,70.26 ,33.33
03,001,01,006,0484,1046,895,11,906,1309,0,3,1,3,0,1,0,76.14,69.21 ,33.33
03,001,01,006,0485,1047,962,13,975,1373,0,3,1,3,0,1,0,76.14,71.01 ,33.33
03,001,01,006,0485,1048,920,9,929,1443,0,3,1,3,0,1,0,76.14,64.38 ,33.33
03,001,01,006,0486,1049,518,9,527,842,0,3,1,3,0,1,0,76.14,62.59 ,33.33
03,001,01,006,0486,1050,347,6,353,517,0,3,1,3,0,1,0,76.14,68.28 ,33.33
03,001,01,006,0487,1051,635,13,648,863,0,3,1,3,0,1,0,76.14,75.09 ,33.33
03,001,01,006,0488,1052,803,6,809,1220,0,3,1,3,0,1,0,76.14,66.31 ,33.33
03,001,01,006,0488,1053,837,8,845,1278,0,3,1,3,0,1,0,76.14,66.12 ,33.33
03,001,01,006,0489,1054,775,7,782,1139,0,3,1,3,0,1,0,76.14,68.66 ,33.33
03,001,01,006,0489,1055,695,9,704,1091,0,3,1,3,0,1,0,76.14,64.53 ,33.33
03,001,01,006,0489,1056,725,8,733,1084,0,3,1,3,0,1,0,76.14,67.62 ,33.33
03,001,01,006,0490,1057,729,8,737,1126,0,3,1,3,0,1,0,76.14,65.45 ,33.33
03,001,01,006,0490,1058,840,9,849,1217,0,3,1,3,0,1,0,76.14,69.76 ,33.33
03,001,01,006,0490,1059,692,4,696,1048,0,3,1,3,0,1,0,76.14,66.41 ,33.33
03,001,01,006,0491,1060,898,10,908,1332,0,3,1,3,0,1,0,76.14,68.17 ,33.33
03,001,01,006,0491,1061,1131,8,1139,1569,0,3,1,3,0,1,0,76.14,72.59 ,33.33
03,001,01,006,0492,1062,1157,9,1166,1605,0,3,1,3,0,1,0,76.14,72.65 ,33.33
03,001,01,006,0492,1063,1068,9,1077,1585,0,3,1,3,0,1,0,76.14,67.95 ,33.33
03,001,01,006,0493,1064,901,14,915,1410,0,3,1,3,0,1,0,76.14,64.89 ,33.33
03,001,01,006,0493,1065,1232,16,1248,1812,0,3,1,3,0,1,0,76.14,68.87 ,33.33
03,001,01,006,0493,1066,917,15,932,1388,0,3,1,3,0,1,0,76.14,67.15 ,33.33
03,001,01,006,0493,1067,743,19,762,1188,0,3,1,3,0,1,0,76.14,64.14 ,33.33
03,001,01,006,0494,1068,1106,15,1121,1674,0,3,1,3,0,1,0,76.14,66.97 ,33.33
03,001,01,006,0494,1069,1004,17,1021,1463,0,3,1,3,0,1,0,76.14,69.79 ,33.33
03,001,01,006,0495,1070,672,7,679,1055,0,3,1,3,0,1,0,76.14,64.36 ,33.33
03,001,01,006,0495,1071,1001,16,1017,1465,0,3,1,3,0,1,0,76.14,69.42 ,33.33
03,001,01,006,0495,1072,852,8,860,1228,0,3,1,3,0,1,0,76.14,70.03 ,33.33
03,001,01,006,0496,1073,985,12,997,1493,0,3,1,3,0,1,0,76.14,66.78 ,33.33
03,001,01,006,0496,1074,1052,11,1063,1530,0,3,1,3,0,1,0,76.14,69.48 ,33.33
03,001,01,006,0496,1075,837,6,843,1261,0,3,1,3,0,1,0,76.14,66.85 ,33.33
03,001,01,006,0497,1076,863,6,869,1302,0,3,1,3,0,1,0,76.14,66.74 ,33.33
03,001,01,006,0497,1077,991,12,1003,1513,0,3,1,3,0,1,0,76.14,66.29 ,33.33
03,001,01,006,0497,1078,978,19,997,1458,0,3,1,3,0,1,0,76.14,68.38 ,33.33
03,001,01,006,0498,1079,768,11,779,1144,0,3,1,3,0,1,0,76.14,68.09 ,33.33
03,001,01,006,0498,1080,603,7,610,850,0,3,1,3,0,1,0,76.14,71.76 ,33.33
03,001,01,006,0499,1081,319,6,325,524,0,3,1,3,0,1,0,76.14,62.02 ,33.33
03,001,01,006,0500,1082,1152,19,1171,1690,0,3,1,3,0,1,0,76.14,69.29 ,33.33
03,001,01,006,0500,1083,794,9,803,1132,0,3,1,3,0,1,0,76.14,70.94 ,33.33
03,001,01,006,0500,1084,808,7,815,1206,0,3,1,3,0,1,0,76.14,67.58 ,33.33
03,001,01,006,0501,1085,888,23,911,1484,0,3,1,3,0,1,0,76.14,61.39 ,33.33
03,001,01,006,0502,1086,1114,21,1135,1704,0,3,1,3,0,1,0,76.14,66.61 ,33.33
03,001,01,006,0503,1087,1157,27,1184,1722,0,3,1,3,0,1,0,76.14,68.76 ,33.33
03,001,01,006,0503,1088,996,16,1012,1531,0,3,1,3,0,1,0,76.14,66.10 ,33.33
03,001,01,006,0504,1089,684,15,699,996,0,3,1,3,0,1,0,76.14,70.18 ,33.33
03,001,01,006,0504,1090,774,8,782,1182,0,3,1,3,0,1,0,76.14,66.16 ,33.33
03,001,01,006,0504,1091,780,10,790,1235,0,3,1,3,0,1,0,76.14,63.97 ,33.33
03,001,01,006,0505,1092,1086,21,1107,1691,0,3,1,3,0,1,0,76.14,65.46 ,33.33
03,001,01,006,0505,1093,861,15,876,1271,0,3,1,3,0,1,0,76.14,68.92 ,33.33
03,001,01,006,0505,1094,599,14,613,974,0,3,1,3,0,1,0,76.14,62.94 ,33.33
03,001,01,006,0505,1095,1019,11,1030,1579,0,3,1,3,0,1,0,76.14,65.23 ,33.33
03,001,01,006,0505,1096,603,9,612,876,0,3,1,3,0,1,0,76.14,69.86 ,33.33
03,001,01,006,0505,1097,730,8,738,1148,0,3,1,3,0,1,0,76.14,64.29 ,33.33
03,001,01,006,0506,1098,755,15,770,1177,0,3,1,3,0,1,0,76.14,65.42 ,33.33
03,001,01,006,0506,1099,1028,11,1039,1490,0,3,1,3,0,1,0,76.14,69.73 ,33.33
03,001,01,006,0506,1100,1094,11,1105,1823,0,3,1,3,0,1,0,76.14,60.61 ,33.33
03,001,01,006,0506,1101,824,12,836,1270,0,3,1,3,0,1,0,76.14,65.83 ,33.33
03,001,01,006,0507,1102,827,15,842,1265,0,3,1,3,0,1,0,76.14,66.56 ,33.33
03,001,01,006,0507,1103,721,7,728,1012,0,3,1,3,0,1,0,76.14,71.94 ,33.33
03,001,01,006,0507,1104,809,18,827,1279,0,3,1,3,0,1,0,76.14,64.66 ,33.33
03,001,01,006,0508,1105,758,6,764,1084,0,3,1,3,0,1,0,76.14,70.48 ,33.33
03,001,01,006,0508,1106,1095,10,1105,1628,0,3,1,3,0,1,0,76.14,67.87 ,33.33
03,001,01,006,0508,1107,766,4,770,1131,0,3,1,3,0,1,0,76.14,68.08 ,33.33
03,001,01,006,0508,1108,574,5,579,834,0,3,1,3,0,1,0,76.14,69.42 ,33.33
03,001,01,006,0509,1109,598,5,603,902,0,3,1,3,0,1,0,76.14,66.85 ,33.33
03,001,01,006,0509,1110,567,8,575,804,0,3,1,3,0,1,0,76.14,71.52 ,33.33
03,001,01,006,0509,1111,801,15,816,1225,0,3,1,3,0,1,0,76.14,66.61 ,33.33
03,001,01,006,0509,1112,965,9,974,1517,0,3,1,3,0,1,0,76.14,64.21 ,33.33
03,001,01,006,0509,1113,636,10,646,1037,0,3,1,3,0,1,0,76.14,62.30 ,33.33
03,001,01,006,0510,1114,1006,17,1023,1498,0,3,1,3,0,1,0,76.14,68.29 ,33.33
03,001,01,006,0510,1115,735,13,748,1141,0,3,1,3,0,1,0,76.14,65.56 ,33.33
03,001,01,006,0510,1116,671,7,678,1028,0,3,1,3,0,1,0,76.14,65.95 ,33.33
03,001,01,006,0511,1117,931,8,939,1423,0,3,1,3,0,1,0,76.14,65.99 ,33.33
03,001,01,006,0511,1118,809,11,820,1174,0,3,1,3,0,1,0,76.14,69.85 ,33.33
03,001,01,006,0511,1119,728,4,732,1089,0,3,1,3,0,1,0,76.14,67.22 ,33.33
03,001,01,006,0512,1120,1141,9,1150,1738,0,3,1,3,0,1,0,76.14,66.17 ,33.33
03,001,01,006,0512,1121,925,5,930,1351,0,3,1,3,0,1,0,76.14,68.84 ,33.33
03,001,01,006,0513,1122,425,8,433,680,0,3,1,3,0,1,0,76.14,63.68 ,33.33
03,001,01,006,0513,1123,230,1,231,378,0,3,1,3,0,1,0,76.14,61.11 ,33.33
03,001,01,006,0514,1124,1090,16,1106,1660,0,3,1,3,0,1,0,76.14,66.63 ,33.33
03,001,01,006,0514,1125,710,10,720,1050,0,3,1,3,0,1,0,76.14,68.57 ,33.33
03,001,01,006,0515,1126,1278,21,1299,1802,0,3,1,3,0,1,0,76.14,72.09 ,33.33
03,001,01,006,0515,1127,786,14,800,1165,0,3,1,3,0,1,0,76.14,68.67 ,33.33
03,001,01,006,0516,1128,640,8,648,944,0,3,1,3,0,1,0,76.14,68.64 ,33.33
03,001,01,006,0516,1129,611,16,627,1017,0,3,1,3,0,1,0,76.14,61.65 ,33.33
03,001,01,006,0517,1130,485,5,490,790,0,3,1,3,0,1,0,76.14,62.03 ,33.33
03,001,01,006,0518,1131,253,6,259,342,0,3,1,3,0,1,0,76.14,75.73 ,33.33
03,001,01,006,0518,1132,1001,6,1007,1592,0,3,1,3,0,1,0,76.14,63.25 ,33.33
03,001,01,006,0519,1133,660,10,670,915,0,3,1,3,0,1,0,76.14,73.22 ,33.33
03,001,01,006,0519,1134,784,25,809,1164,0,3,1,3,0,1,0,76.14,69.50 ,33.33
03,001,01,006,0520,1135,913,23,936,1365,0,3,1,3,0,1,0,76.14,68.57 ,33.33
03,001,01,006,0521,1136,717,10,727,1043,0,3,1,3,0,1,0,76.14,69.70 ,33.33
03,001,01,006,0522,1137,382,10,392,598,0,3,1,3,0,1,0,76.14,65.55 ,33.33
03,001,01,007,0523,1138,702,12,714,1081,0,3,1,3,0,1,0,76.14,66.05 ,33.33
03,001,01,007,0524,1139,880,13,893,1178,0,3,1,3,0,1,0,76.14,75.81 ,33.33
03,001,01,007,0525,1140,895,15,910,1376,0,3,1,3,0,1,0,76.14,66.13 ,33.33
03,001,01,007,0525,1141,987,26,1013,1414,0,3,1,3,0,1,0,76.14,71.64 ,33.33
03,001,01,007,0526,1142,646,18,664,1000,0,3,1,3,0,1,0,76.14,66.40 ,33.33
03,001,01,007,0526,1143,769,12,781,1221,0,3,1,3,0,1,0,76.14,63.96 ,33.33
03,001,01,007,0527,1144,1239,38,1277,1942,0,3,1,3,0,1,0,76.14,65.76 ,33.33
03,001,01,007,0528,1145,1022,18,1040,1578,0,3,1,3,0,1,0,76.14,65.91 ,33.33
03,001,01,007,0528,1146,702,15,717,1106,0,3,1,3,0,1,0,76.14,64.83 ,33.33
03,001,01,007,0528,1147,722,10,732,1112,0,3,1,3,0,1,0,76.14,65.83 ,33.33
03,001,01,007,0529,1148,769,12,781,1207,0,3,1,3,0,1,0,76.14,64.71 ,33.33
03,001,01,007,0529,1149,880,14,894,1266,0,3,1,3,0,1,0,76.14,70.62 ,33.33
03,001,01,007,0530,1150,988,15,1003,1582,0,3,1,3,0,1,0,76.14,63.40 ,33.33
03,001,01,007,0530,1151,1018,17,1035,1668,0,3,1,3,0,1,0,76.14,62.05 ,33.33
03,001,01,007,0531,1152,1188,19,1207,1764,0,3,1,3,0,1,0,76.14,68.42 ,33.33
03,001,01,007,0532,1153,877,8,885,1311,0,3,1,3,0,1,0,76.14,67.51 ,33.33
03,001,01,007,0533,1154,602,6,608,805,0,3,1,3,0,1,0,76.14,75.53 ,33.33
03,001,01,007,0534,1155,751,12,763,1098,0,3,1,3,0,1,0,76.14,69.49 ,33.33
03,001,01,007,0534,1156,759,13,772,1249,0,3,1,3,0,1,0,76.14,61.81 ,33.33
03,001,01,007,0535,1157,1172,13,1185,1821,0,3,1,3,0,1,0,76.14,65.07 ,33.33
03,001,01,007,0535,1158,992,15,1007,1551,0,3,1,3,0,1,0,76.14,64.93 ,33.33
03,001,01,007,0536,1159,1132,12,1144,1716,0,3,1,3,0,1,0,76.14,66.67 ,33.33
03,001,01,007,0536,1160,1237,25,1262,1829,0,3,1,3,0,1,0,76.14,69.00 ,33.33
03,001,01,007,0537,1161,823,8,831,1169,0,3,1,3,0,1,0,76.14,71.09 ,33.33
03,001,01,007,0537,1162,921,22,943,1358,0,3,1,3,0,1,0,76.14,69.44 ,33.33
03,001,01,007,0537,1163,555,18,573,850,0,3,1,3,0,1,0,76.14,67.41 ,33.33
03,001,01,007,0538,1164,913,20,933,1369,0,3,1,3,0,1,0,76.14,68.15 ,33.33
03,001,01,007,0538,1165,1189,26,1215,1804,0,3,1,3,0,1,0,76.14,67.35 ,33.33
03,001,01,007,0539,1166,1054,19,1073,1552,0,3,1,3,0,1,0,76.14,69.14 ,33.33
03,001,01,007,0539,1167,1044,18,1062,1608,0,3,1,3,0,1,0,76.14,66.04 ,33.33
03,001,01,007,0540,1168,936,19,955,1453,0,3,1,3,0,1,0,76.14,65.73 ,33.33
03,001,01,007,0540,1169,805,11,816,1298,0,3,1,3,0,1,0,76.14,62.87 ,33.33
03,001,01,007,0541,1170,800,12,812,1147,0,3,1,3,0,1,0,76.14,70.79 ,33.33
03,001,01,007,0541,1171,649,10,659,944,0,3,1,3,0,1,0,76.14,69.81 ,33.33
03,001,01,007,0542,1172,770,10,780,1254,0,3,1,3,0,1,0,76.14,62.20 ,33.33
03,001,01,007,0542,1173,982,12,994,1470,0,3,1,3,0,1,0,76.14,67.62 ,33.33
03,001,01,007,0543,1174,813,12,825,1201,0,3,1,3,0,1,0,76.14,68.69 ,33.33
03,001,01,007,0543,1175,1084,18,1102,1655,0,3,1,3,0,1,0,76.14,66.59 ,33.33
03,001,01,007,0544,1176,681,9,690,1094,0,3,1,3,0,1,0,76.14,63.07 ,33.33
03,001,01,007,0544,1177,604,6,610,898,0,3,1,3,0,1,0,76.14,67.93 ,33.33
03,001,01,007,0545,1178,719,8,727,1126,0,3,1,3,0,1,0,76.14,64.56 ,33.33
03,001,01,007,0545,1179,1494,20,1514,2429,0,3,1,3,0,1,0,76.14,62.33 ,33.33
03,001,01,007,0545,1180,827,15,842,1268,0,3,1,3,0,1,0,76.14,66.40 ,33.33
03,001,01,007,0546,1181,1096,15,1111,1638,0,3,1,3,0,1,0,76.14,67.83 ,33.33
03,001,01,007,0546,1182,945,9,954,1470,0,3,1,3,0,1,0,76.14,64.90 ,33.33
03,001,01,007,0547,1183,692,12,704,1065,0,3,1,3,0,1,0,76.14,66.10 ,33.33
03,001,01,007,0547,1184,620,17,637,1015,0,3,1,3,0,1,0,76.14,62.76 ,33.33
03,001,01,007,0548,1185,1085,15,1100,1827,0,3,1,3,0,1,0,76.14,60.21 ,33.33
03,001,01,007,0548,1186,1165,22,1187,1925,0,3,1,3,0,1,0,76.14,61.66 ,33.33
03,001,01,007,0548,1187,886,10,896,1459,0,3,1,3,0,1,0,76.14,61.41 ,33.33
03,001,01,007,0549,1188,1100,16,1116,1557,0,3,1,3,0,1,0,76.14,71.68 ,33.33
03,001,01,007,0550,1189,760,9,769,1145,0,3,1,3,0,1,0,76.14,67.16 ,33.33
03,001,01,007,0550,1190,591,16,607,932,0,3,1,3,0,1,0,76.14,65.13 ,33.33
03,001,01,007,0550,1191,1035,24,1059,1622,0,3,1,3,0,1,0,76.14,65.29 ,33.33
03,001,01,007,0551,1192,658,8,666,984,0,3,1,3,0,1,0,76.14,67.68 ,33.33
03,001,01,007,0552,1193,1195,23,1218,1709,0,3,1,3,0,1,0,76.14,71.27 ,33.33
03,001,01,007,0552,1194,963,8,971,1564,0,3,1,3,0,1,0,76.14,62.08 ,33.33
03,001,01,007,0552,1195,399,7,406,612,0,3,1,3,0,1,0,76.14,66.34 ,33.33
03,001,01,007,0553,1196,1142,11,1153,1747,0,3,1,3,0,1,0,76.14,66.00 ,33.33
03,001,01,007,0553,1197,1109,14,1123,1816,0,3,1,3,0,1,0,76.14,61.84 ,33.33
03,001,01,007,0553,1198,604,13,617,946,0,3,1,3,0,1,0,76.14,65.22 ,33.33
03,001,01,007,0553,1199,736,11,747,1082,0,3,1,3,0,1,0,76.14,69.04 ,33.33
03,001,01,007,0554,1200,657,10,667,946,0,3,1,3,0,1,0,76.14,70.51 ,33.33
03,001,01,007,0554,1201,708,9,717,1004,0,3,1,3,0,1,0,76.14,71.41 ,33.33
03,001,01,007,0555,1202,868,15,883,1390,0,3,1,3,0,1,0,76.14,63.53 ,33.33
03,001,01,007,0555,1203,1026,20,1046,1595,0,3,1,3,0,1,0,76.14,65.58 ,33.33
03,001,01,007,0556,1204,1029,14,1043,1555,0,3,1,3,0,1,0,76.14,67.07 ,33.33
03,001,01,007,0556,1205,986,16,1002,1532,0,3,1,3,0,1,0,76.14,65.40 ,33.33
03,001,01,007,0557,1206,1237,21,1258,2069,0,3,1,3,0,1,0,76.14,60.80 ,33.33
03,001,01,007,0557,1207,625,5,630,910,0,3,1,3,0,1,0,76.14,69.23 ,33.33
03,001,01,007,0558,1208,1088,13,1101,1777,0,3,1,3,0,1,0,76.14,61.96 ,33.33
03,001,01,007,0558,1209,653,14,667,984,0,3,1,3,0,1,0,76.14,67.78 ,33.33
03,001,01,007,0558,1210,795,12,807,1287,0,3,1,3,0,1,0,76.14,62.70 ,33.33
03,001,01,007,0559,1211,888,18,906,1345,0,3,1,3,0,1,0,76.14,67.36 ,33.33
03,001,01,007,0559,1212,773,18,791,1221,0,3,1,3,0,1,0,76.14,64.78 ,33.33
03,001,01,007,0560,1213,731,10,741,1081,0,3,1,3,0,1,0,76.14,68.55 ,33.33
03,001,01,007,0560,1214,835,8,843,1364,0,3,1,3,0,1,0,76.14,61.80 ,33.33
03,001,01,007,0560,1215,1115,18,1133,1751,0,3,1,3,0,1,0,76.14,64.71 ,33.33
03,001,01,007,0561,1216,768,15,783,1114,0,3,1,3,0,1,0,76.14,70.29 ,33.33
03,001,01,007,0561,1217,1311,23,1334,2040,0,3,1,3,0,1,0,76.14,65.39 ,33.33
03,001,01,007,0561,1218,491,4,495,792,0,3,1,3,0,1,0,76.14,62.50 ,33.33
03,001,01,007,0562,1219,1016,22,1038,1545,0,3,1,3,0,1,0,76.14,67.18 ,33.33
03,001,01,007,0562,1220,539,11,550,833,0,3,1,3,0,1,0,76.14,66.03 ,33.33
03,001,01,008,0563,1221,1029,13,1042,1517,0,3,1,3,0,1,0,76.14,68.69 ,33.33
03,001,01,008,0563,1222,716,6,722,1047,0,3,1,3,0,1,0,76.14,68.96 ,33.33
03,001,01,008,0563,1223,835,13,848,1240,0,3,1,3,0,1,0,76.14,68.39 ,33.33
03,001,01,008,0564,1224,971,22,993,1554,0,3,1,3,0,1,0,76.14,63.90 ,33.33
03,001,01,008,0564,1225,652,4,656,931,0,3,1,3,0,1,0,76.14,70.46 ,33.33
03,001,01,008,0565,1226,876,16,892,1482,0,3,1,3,0,1,0,76.14,60.19 ,33.33
03,001,01,008,0565,1227,939,14,953,1608,0,3,1,3,0,1,0,76.14,59.27 ,33.33
03,001,01,008,0566,1228,502,10,512,811,0,3,1,3,0,1,0,76.14,63.13 ,33.33
03,001,01,008,0566,1229,790,6,796,1187,0,3,1,3,0,1,0,76.14,67.06 ,33.33
03,001,01,008,0566,1230,953,20,973,1553,0,3,1,3,0,1,0,76.14,62.65 ,33.33
03,001,01,008,0567,1231,956,16,972,1435,0,3,1,3,0,1,0,76.14,67.74 ,33.33
03,001,01,008,0567,1232,876,16,892,1354,0,3,1,3,0,1,0,76.14,65.88 ,33.33
03,001,01,008,0568,1233,593,15,608,1047,0,3,1,3,0,1,0,76.14,58.07 ,33.33
03,001,01,008,0568,1234,650,13,663,1092,0,3,1,3,0,1,0,76.14,60.71 ,33.33
03,001,01,008,0568,1235,738,9,747,1234,0,3,1,3,0,1,0,76.14,60.53 ,33.33
03,001,01,008,0569,1236,626,6,632,911,0,3,1,3,0,1,0,76.14,69.37 ,33.33
03,001,01,008,0569,1237,737,15,752,1253,0,3,1,3,0,1,0,76.14,60.02 ,33.33
03,001,01,008,0570,1238,554,6,560,868,0,3,1,3,0,1,0,76.14,64.52 ,33.33
03,001,01,008,0570,1239,573,10,583,954,0,3,1,3,0,1,0,76.14,61.11 ,33.33
03,001,01,008,0571,1240,645,11,656,950,0,3,1,3,0,1,0,76.14,69.05 ,33.33
03,001,01,008,0571,1241,554,16,570,860,0,3,1,3,0,1,0,76.14,66.28 ,33.33
03,001,01,008,0572,1242,930,9,939,1379,0,3,1,3,0,1,0,76.14,68.09 ,33.33
03,001,01,008,0572,1243,991,21,1012,1519,0,3,1,3,0,1,0,76.14,66.62 ,33.33
03,001,01,008,0573,1244,682,16,698,1014,0,3,1,3,0,1,0,76.14,68.84 ,33.33
03,001,01,008,0573,1245,558,3,561,924,0,3,1,3,0,1,0,76.14,60.71 ,33.33
03,001,01,008,0574,1246,639,7,646,878,0,3,1,3,0,1,0,76.14,73.58 ,33.33
03,001,01,008,0575,1247,752,16,768,1064,0,3,1,3,0,1,0,76.14,72.18 ,33.33
03,001,01,008,0576,1248,637,13,650,921,0,3,1,3,0,1,0,76.14,70.58 ,33.33
03,001,01,008,0576,1249,583,5,588,835,0,3,1,3,0,1,0,76.14,70.42 ,33.33
03,001,01,008,0577,1250,990,12,1002,1368,0,3,1,3,0,1,0,76.14,73.25 ,33.33
03,001,01,008,0577,1251,754,15,769,1145,0,3,1,3,0,1,0,76.14,67.16 ,33.33
03,001,01,008,0578,1252,692,9,701,971,0,3,1,3,0,1,0,76.14,72.19 ,33.33
03,001,01,008,0578,1253,988,11,999,1382,0,3,1,3,0,1,0,76.14,72.29 ,33.33
03,001,01,008,0578,1254,727,12,739,1035,0,3,1,3,0,1,0,76.14,71.40 ,33.33
03,001,01,008,0579,1255,648,7,655,964,0,3,1,3,0,1,0,76.14,67.95 ,33.33
03,001,01,008,0579,1256,710,10,720,986,0,3,1,3,0,1,0,76.14,73.02 ,33.33
03,001,01,008,0580,1257,949,11,960,1359,0,3,1,3,0,1,0,76.14,70.64 ,33.33
03,001,01,008,0580,1258,794,7,801,1131,0,3,1,3,0,1,0,76.14,70.82 ,33.33
03,001,01,008,0581,1259,694,20,714,1061,0,3,1,3,0,1,0,76.14,67.30 ,33.33
03,001,01,008,0581,1260,751,11,762,1100,0,3,1,3,0,1,0,76.14,69.27 ,33.33
03,001,01,008,0582,1261,960,10,970,1414,0,3,1,3,0,1,0,76.14,68.60 ,33.33
03,001,01,008,0582,1262,723,7,730,1083,0,3,1,3,0,1,0,76.14,67.41 ,33.33
03,001,01,008,0583,1263,745,9,754,1048,0,3,1,3,0,1,0,76.14,71.95 ,33.33
03,001,01,008,0584,1264,820,14,834,1395,0,3,1,3,0,1,0,76.14,59.78 ,33.33
03,001,01,008,0584,1265,706,8,714,1061,0,3,1,3,0,1,0,76.14,67.30 ,33.33
03,001,01,008,0584,1266,772,11,783,1247,0,3,1,3,0,1,0,76.14,62.79 ,33.33
03,001,01,008,0585,1267,891,16,907,1341,0,3,1,3,0,1,0,76.14,67.64 ,33.33
03,001,01,008,0585,1268,961,14,975,1359,0,3,1,3,0,1,0,76.14,71.74 ,33.33
03,001,01,008,0586,1269,975,25,1000,1606,0,3,1,3,0,1,0,76.14,62.27 ,33.33
03,001,01,008,0586,1270,831,16,847,1445,0,3,1,3,0,1,0,76.14,58.62 ,33.33
03,001,01,008,0587,1271,760,18,778,1258,0,3,1,3,0,1,0,76.14,61.84 ,33.33
03,001,01,008,0587,1272,603,8,611,976,0,3,1,3,0,1,0,76.14,62.60 ,33.33
03,001,01,008,0588,1273,751,16,767,1195,0,3,1,3,0,1,0,76.14,64.18 ,33.33
03,001,01,008,0588,1274,843,17,860,1210,0,3,1,3,0,1,0,76.14,71.07 ,33.33
03,001,01,008,0589,1275,991,16,1007,1540,0,3,1,3,0,1,0,76.14,65.39 ,33.33
03,001,01,008,0589,1276,512,5,517,749,0,3,1,3,0,1,0,76.14,69.03 ,33.33
03,001,01,008,0590,1277,826,10,836,1306,0,3,1,3,0,1,0,76.14,64.01 ,33.33
03,001,01,008,0590,1278,865,13,878,1321,0,3,1,3,0,1,0,76.14,66.46 ,33.33
03,001,01,008,0591,1279,1200,17,1217,1834,0,3,1,3,0,1,0,76.14,66.36 ,33.33
03,001,01,008,0592,1280,456,9,465,758,0,3,1,3,0,1,0,76.14,61.35 ,33.33
03,001,01,008,0592,1281,668,12,680,1039,0,3,1,3,0,1,0,76.14,65.45 ,33.33
03,001,01,008,0593,1282,747,16,763,1116,0,3,1,3,0,1,0,76.14,68.37 ,33.33
03,001,01,008,0593,1283,844,9,853,1265,0,3,1,3,0,1,0,76.14,67.43 ,33.33
03,001,01,008,0594,1284,717,13,730,1029,0,3,1,3,0,1,0,76.14,70.94 ,33.33
03,001,01,008,0595,1285,735,13,748,1045,0,3,1,3,0,1,0,76.14,71.58 ,33.33
03,001,01,008,0596,1286,738,9,747,1073,0,3,1,3,0,1,0,76.14,69.62 ,33.33
03,001,01,008,0597,1287,743,18,761,1083,0,3,1,3,0,1,0,76.14,70.27 ,33.33
03,001,01,008,0598,1288,539,4,543,740,0,3,1,3,0,1,0,76.14,73.38 ,33.33
03,001,01,008,0599,1289,715,16,731,1047,0,3,1,3,0,1,0,76.14,69.82 ,33.33
03,001,01,009,0600,1290,328,5,333,438,0,3,1,3,0,1,0,76.14,76.03 ,33.33
03,001,01,009,0601,1291,555,5,560,762,0,3,1,3,0,1,0,76.14,73.49 ,33.33
03,001,01,009,0602,1292,950,10,960,1254,0,3,1,3,0,1,0,76.14,76.56 ,33.33
03,001,01,009,0603,1293,424,9,433,562,0,3,1,3,0,1,0,76.14,77.05 ,33.33
03,001,01,009,0603,1294,767,12,779,1032,0,3,1,3,0,1,0,76.14,75.48 ,33.33
03,001,01,009,0604,1295,587,12,599,772,0,3,1,3,0,1,0,76.14,77.59 ,33.33
03,001,01,009,0605,1296,893,14,907,1245,0,3,1,3,0,1,0,76.14,72.85 ,33.33
03,001,01,009,0605,1297,737,12,749,1033,0,3,1,3,0,1,0,76.14,72.51 ,33.33
03,001,01,009,0605,1298,682,12,694,928,0,3,1,3,0,1,0,76.14,74.78 ,33.33
03,001,01,009,0606,1299,705,14,719,1021,0,3,1,3,0,1,0,76.14,70.42 ,33.33
03,001,01,009,0606,1300,1056,21,1077,1676,0,3,1,3,0,1,0,76.14,64.26 ,33.33
03,001,01,009,0607,1301,817,22,839,1106,0,3,1,3,0,1,0,76.14,75.86 ,33.33
03,001,01,009,0607,1302,838,14,852,1133,0,3,1,3,0,1,0,76.14,75.20 ,33.33
03,001,01,009,0608,1303,803,4,807,1116,0,3,1,3,0,1,0,76.14,72.31 ,33.33
03,001,01,009,0608,1304,1005,14,1019,1320,0,3,1,3,0,1,0,76.14,77.20 ,33.33
03,001,01,009,0609,1305,825,12,837,1101,0,3,1,3,0,1,0,76.14,76.02 ,33.33
03,001,01,009,0609,1306,910,18,928,1238,0,3,1,3,0,1,0,76.14,74.96 ,33.33
03,001,01,009,0609,1307,734,16,750,1010,0,3,1,3,0,1,0,76.14,74.26 ,33.33
03,001,01,009,0610,1308,542,12,554,688,0,3,1,3,0,1,0,76.14,80.52 ,33.33
03,001,01,009,0611,1309,743,8,751,1021,0,3,1,3,0,1,0,76.14,73.56 ,33.33
03,001,01,009,0612,1310,892,18,910,1353,0,3,1,3,0,1,0,76.14,67.26 ,33.33
03,001,01,009,0612,1311,942,10,952,1544,0,3,1,3,0,1,0,76.14,61.66 ,33.33
03,001,01,009,0612,1312,904,12,916,1287,0,3,1,3,0,1,0,76.14,71.17 ,33.33
03,001,01,009,0613,1313,719,22,741,1071,0,3,1,3,0,1,0,76.14,69.19 ,33.33
03,001,01,009,0613,1314,664,11,675,910,0,3,1,3,0,1,0,76.14,74.18 ,33.33
03,001,01,009,0613,1315,642,14,656,913,0,3,1,3,0,1,0,76.14,71.85 ,33.33
03,001,01,009,0614,1316,868,19,887,1349,0,3,1,3,0,1,0,76.14,65.75 ,33.33
03,001,01,009,0614,1317,877,16,893,1247,0,3,1,3,0,1,0,76.14,71.61 ,33.33
03,001,01,009,0615,1318,714,15,729,1070,0,3,1,3,0,1,0,76.14,68.13 ,33.33
03,001,01,009,0615,1319,552,10,562,818,0,3,1,3,0,1,0,76.14,68.70 ,33.33
03,001,01,009,0615,1320,523,14,537,1008,0,3,1,3,0,1,0,76.14,53.27 ,33.33
03,001,01,009,0616,1321,933,16,949,1372,0,3,1,3,0,1,0,76.14,69.17 ,33.33
03,001,01,009,0616,1322,875,20,895,1400,0,3,1,3,0,1,0,76.14,63.93 ,33.33
03,001,01,009,0617,1323,720,15,735,1154,0,3,1,3,0,1,0,76.14,63.69 ,33.33
03,001,01,009,0617,1324,864,6,870,1294,0,3,1,3,0,1,0,76.14,67.23 ,33.33
03,001,01,009,0617,1325,726,16,742,1108,0,3,1,3,0,1,0,76.14,66.97 ,33.33
03,001,01,009,0618,1326,774,13,787,1318,0,3,1,3,0,1,0,76.14,59.71 ,33.33
03,001,01,009,0618,1327,827,13,840,1225,0,3,1,3,0,1,0,76.14,68.57 ,33.33
03,001,01,009,0618,1328,753,22,775,1065,0,3,1,3,0,1,0,76.14,72.77 ,33.33
03,001,01,009,0619,1329,177,4,181,254,0,3,1,3,0,1,0,76.14,71.26 ,33.33
03,001,01,010,0620,1330,295,5,300,403,0,3,1,3,0,1,0,76.14,74.44 ,33.33
03,001,01,010,0621,1331,347,4,351,465,0,3,1,3,0,1,0,76.14,75.48 ,33.33
03,001,01,010,0622,1332,598,13,611,852,0,3,1,3,0,1,0,76.14,71.71 ,33.33
03,001,01,010,0622,1333,658,12,670,986,0,3,1,3,0,1,0,76.14,67.95 ,33.33
03,001,01,010,0623,1334,516,10,526,700,0,3,1,3,0,1,0,76.14,75.14 ,33.33
03,001,01,010,0624,1335,637,13,650,842,0,3,1,3,0,1,0,76.14,77.20 ,33.33
03,001,01,010,0625,1336,836,11,847,1216,0,3,1,3,0,1,0,76.14,69.65 ,33.33
03,001,01,010,0625,1337,639,12,651,916,0,3,1,3,0,1,0,76.14,71.07 ,33.33
03,001,01,010,0625,1338,879,9,888,1252,0,3,1,3,0,1,0,76.14,70.93 ,33.33
03,001,01,010,0626,1339,745,8,753,1178,0,3,1,3,0,1,0,76.14,63.92 ,33.33
03,001,01,010,0626,1340,702,19,721,1123,0,3,1,3,0,1,0,76.14,64.20 ,33.33
03,001,01,010,0627,1341,1077,13,1090,1529,0,3,1,3,0,1,0,76.14,71.29 ,33.33
03,001,01,010,0628,1342,744,11,755,1134,0,3,1,3,0,1,0,76.14,66.58 ,33.33
03,001,01,010,0628,1343,650,8,658,1010,0,3,1,3,0,1,0,76.14,65.15 ,33.33
03,001,01,010,0629,1344,904,20,924,1392,0,3,1,3,0,1,0,76.14,66.38 ,33.33
03,001,01,010,0629,1345,803,15,818,1203,0,3,1,3,0,1,0,76.14,68.00 ,33.33
03,001,01,010,0630,1346,1015,9,1024,1571,0,3,1,3,0,1,0,76.14,65.18 ,33.33
03,001,01,010,0630,1347,892,18,910,1386,0,3,1,3,0,1,0,76.14,65.66 ,33.33
03,001,01,010,0630,1348,920,18,938,1331,0,3,1,3,0,1,0,76.14,70.47 ,33.33
03,001,01,010,0631,1349,922,16,938,1364,0,3,1,3,0,1,0,76.14,68.77 ,33.33
03,001,01,010,0631,1350,994,16,1010,1571,0,3,1,3,0,1,0,76.14,64.29 ,33.33
03,001,01,010,0631,1351,879,30,909,1415,0,3,1,3,0,1,0,76.14,64.24 ,33.33
03,001,01,010,0632,1352,882,17,899,1347,0,3,1,3,0,1,0,76.14,66.74 ,33.33
03,001,01,010,0632,1353,953,18,971,1369,0,3,1,3,0,1,0,76.14,70.93 ,33.33
03,001,01,010,0632,1354,1175,23,1198,1859,0,3,1,3,0,1,0,76.14,64.44 ,33.33
03,001,01,010,0633,1355,1063,18,1081,1528,0,3,1,3,0,1,0,76.14,70.75 ,33.33
03,001,01,010,0633,1356,889,13,902,1200,0,3,1,3,0,1,0,76.14,75.17 ,33.33
03,001,01,010,0634,1357,593,13,606,819,0,3,1,3,0,1,0,76.14,73.99 ,33.33
03,001,01,010,0635,1358,696,14,710,954,0,3,1,3,0,1,0,76.14,74.42 ,33.33
03,001,01,010,0636,1359,331,6,337,464,0,3,1,3,0,1,0,76.14,72.63 ,33.33
03,001,01,010,0637,1360,577,12,589,872,0,3,1,3,0,1,0,76.14,67.55 ,33.33
03,001,01,010,0638,1361,544,9,553,837,0,3,1,3,0,1,0,76.14,66.07 ,33.33
03,001,01,010,0639,1362,824,13,837,1108,0,3,1,3,0,1,0,76.14,75.54 ,33.33
03,001,01,010,0640,1363,1210,17,1227,1714,0,3,1,3,0,1,0,76.14,71.59 ,33.33
03,001,01,010,0641,1364,710,15,725,975,0,3,1,3,0,1,0,76.14,74.36 ,33.33
03,001,01,010,0641,1365,858,17,875,1220,0,3,1,3,0,1,0,76.14,71.72 ,33.33
03,001,01,010,0642,1366,627,5,632,838,0,3,1,3,0,1,0,76.14,75.42 ,33.33
03,001,01,010,0643,1367,846,19,865,1296,0,3,1,3,0,1,0,76.14,66.74 ,33.33
03,001,01,010,0644,1368,1016,21,1037,1577,0,3,1,3,0,1,0,76.14,65.76 ,33.33
03,001,01,011,0645,1369,472,6,478,591,0,3,1,3,0,1,0,76.14,80.88 ,33.33
03,001,01,011,0646,1370,747,7,754,926,0,3,1,3,0,1,0,76.14,81.43 ,33.33
03,001,01,011,0647,1371,915,21,936,1211,0,3,1,3,0,1,0,76.14,77.29 ,33.33
03,001,01,011,0648,1372,967,16,983,1328,0,3,1,3,0,1,0,76.14,74.02 ,33.33
03,001,01,011,0649,1373,389,3,392,559,0,3,1,3,0,1,0,76.14,70.13 ,33.33
03,001,01,011,0650,1374,811,13,824,1159,0,3,1,3,0,1,0,76.14,71.10 ,33.33
03,001,01,011,0650,1375,729,16,745,1072,0,3,1,3,0,1,0,76.14,69.50 ,33.33
03,001,01,011,0651,1376,552,15,567,698,0,3,1,3,0,1,0,76.14,81.23 ,33.33
03,001,01,011,0652,1377,894,13,907,1236,0,3,1,3,0,1,0,76.14,73.38 ,33.33
03,001,01,011,0653,1378,832,9,841,1105,0,3,1,3,0,1,0,76.14,76.11 ,33.33
03,001,01,011,0654,1379,842,8,850,1183,0,3,1,3,0,1,0,76.14,71.85 ,33.33
03,001,01,011,0654,1380,880,15,895,1275,0,3,1,3,0,1,0,76.14,70.20 ,33.33
03,001,01,011,0654,1381,913,22,935,1374,0,3,1,3,0,1,0,76.14,68.05 ,33.33
03,001,01,011,0654,1382,1041,11,1052,1673,0,3,1,3,0,1,0,76.14,62.88 ,33.33
03,001,01,011,0654,1383,836,16,852,1266,0,3,1,3,0,1,0,76.14,67.30 ,33.33
03,001,01,011,0655,1384,975,25,1000,1323,0,3,1,3,0,1,0,76.14,75.59 ,33.33
03,001,01,011,0655,1385,1173,17,1190,1808,0,3,1,3,0,1,0,76.14,65.82 ,33.33
03,001,01,011,0655,1386,1170,14,1184,1659,0,3,1,3,0,1,0,76.14,71.37 ,33.33
03,001,01,011,0656,1387,910,13,923,1275,0,3,1,3,0,1,0,76.14,72.39 ,33.33
03,001,01,011,0657,1388,953,13,966,1447,0,3,1,3,0,1,0,76.14,66.76 ,33.33
03,001,01,011,0658,1389,652,14,666,880,0,3,1,3,0,1,0,76.14,75.68 ,33.33
03,001,01,011,0659,1390,443,11,454,665,0,3,1,3,0,1,0,76.14,68.27 ,33.33
03,001,01,011,0660,1391,537,9,546,765,0,3,1,3,0,1,0,76.14,71.37 ,33.33
03,001,01,011,0661,1392,1147,16,1163,1715,0,3,1,3,0,1,0,76.14,67.81 ,33.33
03,001,01,011,0661,1393,1076,7,1083,1639,0,3,1,3,0,1,0,76.14,66.08 ,33.33
03,001,01,011,0662,1394,756,11,767,1211,0,3,1,3,0,1,0,76.14,63.34 ,33.33
03,001,01,011,0662,1395,799,15,814,1171,0,3,1,3,0,1,0,76.14,69.51 ,33.33
03,001,01,011,0662,1396,799,11,810,1239,0,3,1,3,0,1,0,76.14,65.38 ,33.33
03,001,01,011,0663,1397,894,18,912,1329,0,3,1,3,0,1,0,76.14,68.62 ,33.33
03,001,01,011,0663,1398,1090,24,1114,1563,0,3,1,3,0,1,0,76.14,71.27 ,33.33
03,001,01,011,0664,1399,598,10,608,864,0,3,1,3,0,1,0,76.14,70.37 ,33.33
03,001,01,011,0665,1400,1061,16,1077,1780,0,3,1,3,0,1,0,76.14,60.51 ,33.33
03,001,01,011,0666,1401,1147,27,1174,1697,0,3,1,3,0,1,0,76.14,69.18 ,33.33
03,001,01,011,0666,1402,791,8,799,1149,0,3,1,3,0,1,0,76.14,69.54 ,33.33
03,001,01,011,0666,1403,1005,15,1020,1519,0,3,1,3,0,1,0,76.14,67.15 ,33.33
03,001,01,011,0666,1404,756,16,772,1230,0,3,1,3,0,1,0,76.14,62.76 ,33.33
03,001,01,011,0666,1405,1020,21,1041,1489,0,3,1,3,0,1,0,76.14,69.91 ,33.33
03,001,01,011,0667,1406,662,10,672,1154,0,3,1,3,0,1,0,76.14,58.23 ,33.33
03,001,01,011,0667,1407,883,14,897,1271,0,3,1,3,0,1,0,76.14,70.57 ,33.33
03,001,01,011,0667,1408,872,25,897,1239,0,3,1,3,0,1,0,76.14,72.40 ,33.33
03,001,01,011,0668,1409,1187,18,1205,1672,0,3,1,3,0,1,0,76.14,72.07 ,33.33
03,001,01,011,0669,1410,689,12,701,991,0,3,1,3,0,1,0,76.14,70.74 ,33.33
03,001,01,011,0670,1411,610,10,620,844,0,3,1,3,0,1,0,76.14,73.46 ,33.33
03,001,01,011,0671,1412,888,21,909,1361,0,3,1,3,0,1,0,76.14,66.79 ,33.33
03,001,01,011,0672,1413,538,7,545,741,0,3,1,3,0,1,0,76.14,73.55 ,33.33
03,001,01,011,0673,1414,558,7,565,775,0,3,1,3,0,1,0,76.14,72.90 ,33.33
03,001,01,011,0674,1415,427,6,433,600,0,3,1,3,0,1,0,76.14,72.17 ,33.33
03,001,01,011,0675,1416,753,11,764,1082,0,3,1,3,0,1,0,76.14,70.61 ,33.33
03,001,01,011,0676,1417,928,11,939,1297,0,3,1,3,0,1,0,76.14,72.40 ,33.33
03,001,01,011,0676,1418,934,18,952,1339,0,3,1,3,0,1,0,76.14,71.10 ,33.33
03,001,01,011,0677,1419,1090,25,1115,1618,0,3,1,3,0,1,0,76.14,68.91 ,33.33
03,001,01,011,0677,1420,1002,20,1022,1371,0,3,1,3,0,1,0,76.14,74.54 ,33.33
03,001,01,012,0678,1421,982,15,997,1253,0,3,1,3,0,1,0,76.14,79.57 ,33.33
03,001,01,012,0679,1422,883,4,887,1238,0,3,1,3,0,1,0,76.14,71.65 ,33.33
03,001,01,012,0680,1423,741,7,748,987,0,3,1,3,0,1,0,76.14,75.79 ,33.33
03,001,01,012,0681,1424,753,7,760,1090,0,3,1,3,0,1,0,76.14,69.72 ,33.33
03,001,01,012,0681,1425,968,7,975,1406,0,3,1,3,0,1,0,76.14,69.35 ,33.33
03,001,01,012,0682,1426,441,4,445,596,0,3,1,3,0,1,0,76.14,74.66 ,33.33
03,001,01,012,0683,1427,859,9,868,1107,0,3,1,3,0,1,0,76.14,78.41 ,33.33
03,001,01,012,0683,1428,824,8,832,1071,0,3,1,3,0,1,0,76.14,77.68 ,33.33
03,001,01,012,0683,1429,845,4,849,1032,0,3,1,3,0,1,0,76.14,82.27 ,33.33
03,001,01,012,0683,1430,868,15,883,1161,0,3,1,3,0,1,0,76.14,76.06 ,33.33
03,001,01,012,0684,1431,939,17,956,1258,0,3,1,3,0,1,0,76.14,75.99 ,33.33
03,001,01,012,0684,1432,983,10,993,1338,0,3,1,3,0,1,0,76.14,74.22 ,33.33
03,001,01,012,0684,1433,1296,7,1303,1652,0,3,1,3,0,1,0,76.14,78.87 ,33.33
03,001,01,012,0685,1434,667,9,676,842,0,3,1,3,0,1,0,76.14,80.29 ,33.33
03,001,01,012,0685,1435,867,4,871,1154,0,3,1,3,0,1,0,76.14,75.48 ,33.33
03,001,01,012,0686,1436,972,4,976,1271,0,3,1,3,0,1,0,76.14,76.79 ,33.33
03,001,01,012,0686,1437,811,11,822,1061,0,3,1,3,0,1,0,76.14,77.47 ,33.33
03,001,01,012,0687,1438,864,11,875,1207,0,3,1,3,0,1,0,76.14,72.49 ,33.33
03,001,01,012,0687,1439,699,13,712,954,0,3,1,3,0,1,0,76.14,74.63 ,33.33
03,001,01,012,0688,1440,1126,17,1143,1598,0,3,1,3,0,1,0,76.14,71.53 ,33.33
03,001,01,012,0689,1441,1174,17,1191,1535,0,3,1,3,0,1,0,76.14,77.59 ,33.33
03,001,01,012,0689,1442,1051,14,1065,1433,0,3,1,3,0,1,0,76.14,74.32 ,33.33
03,001,01,012,0689,1443,1063,6,1069,1505,0,3,1,3,0,1,0,76.14,71.03 ,33.33
03,001,01,012,0690,1444,1147,11,1158,1482,0,3,1,3,0,1,0,76.14,78.14 ,33.33
03,001,01,012,0690,1445,665,3,668,886,0,3,1,3,0,1,0,76.14,75.40 ,33.33
03,001,01,012,0691,1446,960,12,972,1314,0,3,1,3,0,1,0,76.14,73.97 ,33.33
03,001,01,012,0692,1447,859,6,865,1159,0,3,1,3,0,1,0,76.14,74.63 ,33.33
03,001,01,012,0693,1448,311,3,314,407,0,3,1,3,0,1,0,76.14,77.15 ,33.33
03,001,01,012,0694,1449,1235,22,1257,1642,0,3,1,3,0,1,0,76.14,76.55 ,33.33
03,001,01,012,0694,1450,464,3,467,584,0,3,1,3,0,1,0,76.14,79.97 ,33.33
03,001,01,012,0695,1451,1027,14,1041,1369,0,3,1,3,0,1,0,76.14,76.04 ,33.33
03,001,01,012,0696,1452,873,6,879,1144,0,3,1,3,0,1,0,76.14,76.84 ,33.33
03,001,01,012,0696,1453,787,8,795,1059,0,3,1,3,0,1,0,76.14,75.07 ,33.33
03,001,01,012,0696,1454,748,7,755,1051,0,3,1,3,0,1,0,76.14,71.84 ,33.33
03,001,01,012,0697,1455,767,9,776,1189,0,3,1,3,0,1,0,76.14,65.26 ,33.33
03,001,01,012,0697,1456,812,7,819,1186,0,3,1,3,0,1,0,76.14,69.06 ,33.33
03,001,01,012,0698,1457,744,9,753,1105,0,3,1,3,0,1,0,76.14,68.14 ,33.33
03,001,01,012,0699,1458,549,6,555,798,0,3,1,3,0,1,0,76.14,69.55 ,33.33
03,001,01,012,0699,1459,515,3,518,749,0,3,1,3,0,1,0,76.14,69.16 ,33.33
03,001,01,012,0700,1460,947,11,958,1352,0,3,1,3,0,1,0,76.14,70.86 ,33.33
03,001,01,012,0700,1461,933,10,943,1360,0,3,1,3,0,1,0,76.14,69.34 ,33.33
03,001,01,012,0700,1462,1068,13,1081,1596,0,3,1,3,0,1,0,76.14,67.73 ,33.33
03,001,01,012,0701,1463,1014,13,1027,1494,0,3,1,3,0,1,0,76.14,68.74 ,33.33
03,001,01,012,0702,1464,926,13,939,1320,0,3,1,3,0,1,0,76.14,71.14 ,33.33
03,001,01,012,0702,1465,995,16,1011,1416,0,3,1,3,0,1,0,76.14,71.40 ,33.33
03,001,01,012,0703,1466,531,6,537,805,0,3,1,3,0,1,0,76.14,66.71 ,33.33
03,001,01,012,0703,1467,586,11,597,834,0,3,1,3,0,1,0,76.14,71.58 ,33.33
03,001,01,012,0704,1468,1250,23,1273,1893,0,3,1,3,0,1,0,76.14,67.25 ,33.33
03,001,01,012,0704,1469,1002,11,1013,1434,0,3,1,3,0,1,0,76.14,70.64 ,33.33
03,001,01,012,0704,1470,689,10,699,1025,0,3,1,3,0,1,0,76.14,68.20 ,33.33
03,001,01,012,0704,1471,734,10,744,1027,0,3,1,3,0,1,0,76.14,72.44 ,33.33
03,001,01,012,0705,1472,739,8,747,1122,0,3,1,3,0,1,0,76.14,66.58 ,33.33
03,001,01,012,0705,1473,695,5,700,1024,0,3,1,3,0,1,0,76.14,68.36 ,33.33
03,001,01,012,0705,1474,771,6,777,1195,0,3,1,3,0,1,0,76.14,65.02 ,33.33
03,001,01,012,0706,1475,861,11,872,1395,0,3,1,3,0,1,0,76.14,62.51 ,33.33
03,001,01,012,0706,1476,958,13,971,1403,0,3,1,3,0,1,0,76.14,69.21 ,33.33
03,001,01,012,0706,1477,656,4,660,1007,0,3,1,3,0,1,0,76.14,65.54 ,33.33
03,001,01,012,0706,1478,678,7,685,1005,0,3,1,3,0,1,0,76.14,68.16 ,33.33
03,001,01,012,0706,1479,545,6,551,753,0,3,1,3,0,1,0,76.14,73.17 ,33.33
03,001,01,012,0707,1480,980,22,1002,1471,0,3,1,3,0,1,0,76.14,68.12 ,33.33
03,001,01,012,0707,1481,784,6,790,1146,0,3,1,3,0,1,0,76.14,68.94 ,33.33
03,001,01,012,0707,1482,827,14,841,1194,0,3,1,3,0,1,0,76.14,70.44 ,33.33
03,001,01,012,0708,1483,717,8,725,1009,0,3,1,3,0,1,0,76.14,71.85 ,33.33
03,001,01,012,0708,1484,668,6,674,1021,0,3,1,3,0,1,0,76.14,66.01 ,33.33
03,001,01,012,0709,1485,919,10,929,1345,0,3,1,3,0,1,0,76.14,69.07 ,33.33
03,001,01,012,0709,1486,1168,5,1173,1649,0,3,1,3,0,1,0,76.14,71.13 ,33.33
03,001,01,013,0710,1487,631,5,636,847,0,3,1,3,0,1,0,76.14,75.09 ,33.33
03,001,01,013,0711,1488,1167,9,1176,1643,0,3,1,3,0,1,0,76.14,71.58 ,33.33
03,001,01,013,0712,1489,1025,11,1036,1494,0,3,1,3,0,1,0,76.14,69.34 ,33.33
03,001,01,013,0713,1490,451,8,459,646,0,3,1,3,0,1,0,76.14,71.05 ,33.33
03,001,01,013,0714,1491,1093,21,1114,1606,0,3,1,3,0,1,0,76.14,69.36 ,33.33
03,001,01,013,0715,1492,906,15,921,1304,0,3,1,3,0,1,0,76.14,70.63 ,33.33
03,001,01,013,0716,1493,1002,12,1014,1448,0,3,1,3,0,1,0,76.14,70.03 ,33.33
03,001,01,013,0716,1494,748,6,754,1087,0,3,1,3,0,1,0,76.14,69.37 ,33.33
03,001,01,013,0716,1495,764,7,771,1103,0,3,1,3,0,1,0,76.14,69.90 ,33.33
03,001,01,013,0716,1496,488,3,491,731,0,3,1,3,0,1,0,76.14,67.17 ,33.33
03,001,01,013,0716,1497,980,16,996,1434,0,3,1,3,0,1,0,76.14,69.46 ,33.33
03,001,01,013,0717,1498,936,9,945,1322,0,3,1,3,0,1,0,76.14,71.48 ,33.33
03,001,01,013,0717,1499,603,7,610,877,0,3,1,3,0,1,0,76.14,69.56 ,33.33
03,001,01,013,0718,1500,888,14,902,1255,0,3,1,3,0,1,0,76.14,71.87 ,33.33
03,001,01,013,0719,1501,198,1,199,333,0,3,1,3,0,1,0,76.14,59.76 ,33.33
03,001,01,013,0720,1502,378,4,382,598,0,3,1,3,0,1,0,76.14,63.88 ,33.33
03,001,01,013,0721,1503,248,3,251,408,0,3,1,3,0,1,0,76.14,61.52 ,33.33
03,001,01,013,0722,1504,78,1,79,114,0,3,1,3,0,1,0,76.14,69.30 ,33.33
03,001,01,013,0723,1505,1194,21,1215,1755,0,3,1,3,0,1,0,76.14,69.23 ,33.33
03,001,01,013,0724,1506,1034,19,1053,1591,0,3,1,3,0,1,0,76.14,66.18 ,33.33
03,001,01,013,0724,1507,919,22,941,1440,0,3,1,3,0,1,0,76.14,65.35 ,33.33
03,001,01,013,0725,1508,482,9,491,711,0,3,1,3,0,1,0,76.14,69.06 ,33.33
03,001,01,013,0725,1509,485,9,494,689,0,3,1,3,0,1,0,76.14,71.70 ,33.33
03,001,01,013,0726,1510,691,11,702,1031,0,3,1,3,0,1,0,76.14,68.09 ,33.33
03,001,01,013,0726,1511,669,7,676,944,0,3,1,3,0,1,0,76.14,71.61 ,33.33
03,001,01,013,0727,1512,412,3,415,631,0,3,1,3,0,1,0,76.14,65.77 ,33.33
03,001,01,013,0728,1513,460,6,466,709,0,3,1,3,0,1,0,76.14,65.73 ,33.33
03,001,01,013,0729,1514,329,7,336,543,0,3,1,3,0,1,0,76.14,61.88 ,33.33
03,001,01,013,0730,1515,214,2,216,315,0,3,1,3,0,1,0,76.14,68.57 ,33.33
03,001,01,013,0731,1516,320,8,328,494,0,3,1,3,0,1,0,76.14,66.40 ,33.33
03,001,01,013,0732,1517,241,6,247,364,0,3,1,3,0,1,0,76.14,67.86 ,33.33
03,001,01,013,0733,1518,231,8,239,327,0,3,1,3,0,1,0,76.14,73.09 ,33.33
03,001,01,013,0734,1519,342,10,352,523,0,3,1,3,0,1,0,76.14,67.30 ,33.33
03,001,01,013,0735,1520,344,8,352,502,0,3,1,3,0,1,0,76.14,70.12 ,33.33
03,001,01,013,0736,1521,518,3,521,775,0,3,1,3,0,1,0,76.14,67.23 ,33.33
03,001,01,013,0737,1522,245,5,250,391,0,3,1,3,0,1,0,76.14,63.94 ,33.33
03,001,01,013,0738,1523,153,0,153,209,0,3,1,3,0,1,0,76.14,73.21 ,33.33
03,001,01,013,0739,1524,328,5,333,530,0,3,1,3,0,1,0,76.14,62.83 ,33.33
03,001,01,013,0740,1525,721,16,737,1051,0,3,1,3,0,1,0,76.14,70.12 ,33.33
03,001,01,013,0741,1526,549,9,558,847,0,3,1,3,0,1,0,76.14,65.88 ,33.33
03,001,01,013,0741,1527,595,7,602,876,0,3,1,3,0,1,0,76.14,68.72 ,33.33
03,001,01,013,0742,1528,683,13,696,1045,0,3,1,3,0,1,0,76.14,66.60 ,33.33
03,001,01,014,0743,1529,997,11,1008,1407,0,3,1,3,0,1,0,76.14,71.64 ,33.33
03,001,01,014,0743,1530,1116,22,1138,1673,0,3,1,3,0,1,0,76.14,68.02 ,33.33
03,001,01,014,0744,1531,882,14,896,1398,0,3,1,3,0,1,0,76.14,64.09 ,33.33
03,001,01,014,0744,1532,748,9,757,1159,0,3,1,3,0,1,0,76.14,65.31 ,33.33
03,001,01,014,0745,1533,820,11,831,1157,0,3,1,3,0,1,0,76.14,71.82 ,33.33
03,001,01,014,0745,1534,639,5,644,864,0,3,1,3,0,1,0,76.14,74.54 ,33.33
03,001,01,014,0746,1535,719,6,725,987,0,3,1,3,0,1,0,76.14,73.45 ,33.33
03,001,01,014,0746,1536,892,12,904,1259,0,3,1,3,0,1,0,76.14,71.80 ,33.33
03,001,01,014,0747,1537,941,10,951,1332,0,3,1,3,0,1,0,76.14,71.40 ,33.33
03,001,01,014,0748,1538,655,13,668,929,0,3,1,3,0,1,0,76.14,71.91 ,33.33
03,001,01,014,0748,1539,668,12,680,1028,0,3,1,3,0,1,0,76.14,66.15 ,33.33
03,001,01,014,0749,1540,720,14,734,1113,0,3,1,3,0,1,0,76.14,65.95 ,33.33
03,001,01,014,0749,1541,712,8,720,1087,0,3,1,3,0,1,0,76.14,66.24 ,33.33
03,001,01,014,0750,1542,894,9,903,1317,0,3,1,3,0,1,0,76.14,68.56 ,33.33
03,001,01,014,0751,1543,661,15,676,1055,0,3,1,3,0,1,0,76.14,64.08 ,33.33
03,001,01,014,0751,1544,789,6,795,1129,0,3,1,3,0,1,0,76.14,70.42 ,33.33
03,001,01,014,0752,1545,843,13,856,1361,0,3,1,3,0,1,0,76.14,62.89 ,33.33
03,001,01,014,0752,1546,988,12,1000,1573,0,3,1,3,0,1,0,76.14,63.57 ,33.33
03,001,01,014,0753,1547,1230,20,1250,2043,0,3,1,3,0,1,0,76.14,61.18 ,33.33
03,001,01,014,0753,1548,853,10,863,1348,0,3,1,3,0,1,0,76.14,64.02 ,33.33
03,001,01,014,0753,1549,940,12,952,1475,0,3,1,3,0,1,0,76.14,64.54 ,33.33
03,001,01,014,0754,1550,946,18,964,1504,0,3,1,3,0,1,0,76.14,64.10 ,33.33
03,001,01,014,0754,1551,863,9,872,1320,0,3,1,3,0,1,0,76.14,66.06 ,33.33
03,001,01,014,0754,1552,695,8,703,1057,0,3,1,3,0,1,0,76.14,66.51 ,33.33
03,001,01,014,0755,1553,444,3,447,615,0,3,1,3,0,1,0,76.14,72.68 ,33.33
03,001,01,014,0756,1554,745,12,757,1093,0,3,1,3,0,1,0,76.14,69.26 ,33.33
03,001,01,014,0756,1555,860,17,877,1360,0,3,1,3,0,1,0,76.14,64.49 ,33.33
03,001,01,014,0757,1556,826,16,842,1343,0,3,1,3,0,1,0,76.14,62.70 ,33.33
03,001,01,014,0757,1557,496,5,501,826,0,3,1,3,0,1,0,76.14,60.65 ,33.33
03,001,01,014,0758,1558,1053,15,1068,1612,0,3,1,3,0,1,0,76.14,66.25 ,33.33
03,001,01,014,0759,1559,1108,17,1125,1643,0,3,1,3,0,1,0,76.14,68.47 ,33.33
03,001,01,014,0760,1560,887,12,899,1265,0,3,1,3,0,1,0,76.14,71.07 ,33.33
03,001,01,014,0760,1561,953,17,970,1371,0,3,1,3,0,1,0,76.14,70.75 ,33.33
03,001,01,014,0761,1562,919,17,936,1367,0,3,1,3,0,1,0,76.14,68.47 ,33.33
03,001,01,014,0762,1563,800,7,807,1217,0,3,1,3,0,1,0,76.14,66.31 ,33.33
03,001,01,014,0762,1564,674,10,684,1123,0,3,1,3,0,1,0,76.14,60.91 ,33.33
03,001,01,014,0763,1565,1061,16,1077,1683,0,3,1,3,0,1,0,76.14,63.99 ,33.33
03,001,01,014,0763,1566,915,12,927,1399,0,3,1,3,0,1,0,76.14,66.26 ,33.33
03,001,01,014,0764,1567,789,10,799,1177,0,3,1,3,0,1,0,76.14,67.88 ,33.33
03,001,01,014,0764,1568,751,9,760,1079,0,3,1,3,0,1,0,76.14,70.44 ,33.33
03,001,01,014,0765,1569,718,11,729,1066,0,3,1,3,0,1,0,76.14,68.39 ,33.33
03,001,01,014,0765,1570,708,12,720,1058,0,3,1,3,0,1,0,76.14,68.05 ,33.33
03,001,01,014,0766,1571,1149,13,1162,1779,0,3,1,3,0,1,0,76.14,65.32 ,33.33
03,001,01,014,0767,1572,821,13,834,1163,0,3,1,3,0,1,0,76.14,71.71 ,33.33
03,001,01,014,0767,1573,554,11,565,796,0,3,1,3,0,1,0,76.14,70.98 ,33.33
03,001,01,014,0768,1574,960,18,978,1374,0,3,1,3,0,1,0,76.14,71.18 ,33.33
03,001,01,014,0768,1575,932,7,939,1301,0,3,1,3,0,1,0,76.14,72.18 ,33.33
03,001,01,014,0769,1576,1027,16,1043,1474,0,3,1,3,0,1,0,76.14,70.76 ,33.33
03,001,01,014,0770,1577,1114,14,1128,1665,0,3,1,3,0,1,0,76.14,67.75 ,33.33
03,001,01,014,0771,1578,994,14,1008,1545,0,3,1,3,0,1,0,76.14,65.24 ,33.33
03,001,01,014,0771,1579,1016,13,1029,1562,0,3,1,3,0,1,0,76.14,65.88 ,33.33
03,001,01,014,0772,1580,1020,11,1031,1668,0,3,1,3,0,1,0,76.14,61.81 ,33.33
03,001,01,014,0773,1581,952,33,985,1519,0,3,1,3,0,1,0,76.14,64.85 ,33.33
03,001,01,014,0773,1582,1032,13,1045,1568,0,3,1,3,0,1,0,76.14,66.65 ,33.33
03,001,01,014,0774,1583,981,20,1001,1574,0,3,1,3,0,1,0,76.14,63.60 ,33.33
03,001,01,014,0774,1584,1086,19,1105,1740,0,3,1,3,0,1,0,76.14,63.51 ,33.33
03,001,01,014,0775,1585,600,12,612,922,0,3,1,3,0,1,0,76.14,66.38 ,33.33
03,001,01,014,0775,1586,766,18,784,1102,0,3,1,3,0,1,0,76.14,71.14 ,33.33
03,001,01,014,0776,1587,811,17,828,1291,0,3,1,3,0,1,0,76.14,64.14 ,33.33
03,001,01,014,0777,1588,704,12,716,1108,0,3,1,3,0,1,0,76.14,64.62 ,33.33
03,001,01,014,0777,1589,881,14,895,1290,0,3,1,3,0,1,0,76.14,69.38 ,33.33
03,001,01,014,0778,1590,845,14,859,1286,0,3,1,3,0,1,0,76.14,66.80 ,33.33
03,001,01,014,0778,1591,795,9,804,1210,0,3,1,3,0,1,0,76.14,66.45 ,33.33
03,001,01,015,0779,1592,717,15,732,1084,0,3,1,3,0,1,0,76.14,67.53 ,33.33
03,001,01,015,0779,1593,672,10,682,960,0,3,1,3,0,1,0,76.14,71.04 ,33.33
03,001,01,015,0779,1594,810,10,820,1238,0,3,1,3,0,1,0,76.14,66.24 ,33.33
03,001,01,015,0780,1595,750,18,768,1073,0,3,1,3,0,1,0,76.14,71.58 ,33.33
03,001,01,015,0781,1596,469,7,476,726,0,3,1,3,0,1,0,76.14,65.56 ,33.33
03,001,01,015,0781,1597,492,9,501,781,0,3,1,3,0,1,0,76.14,64.15 ,33.33
03,001,01,015,0781,1598,521,8,529,887,0,3,1,3,0,1,0,76.14,59.64 ,33.33
03,001,01,015,0782,1599,767,13,780,1141,0,3,1,3,0,1,0,76.14,68.36 ,33.33
03,001,01,015,0783,1600,659,16,675,1035,0,3,1,3,0,1,0,76.14,65.22 ,33.33
03,001,01,015,0783,1601,709,11,720,1074,0,3,1,3,0,1,0,76.14,67.04 ,33.33
03,001,01,015,0784,1602,802,9,811,1165,0,3,1,3,0,1,0,76.14,69.61 ,33.33
03,001,01,015,0784,1603,625,10,635,980,0,3,1,3,0,1,0,76.14,64.80 ,33.33
03,001,01,015,0784,1604,655,9,664,1070,0,3,1,3,0,1,0,76.14,62.06 ,33.33
03,001,01,015,0785,1605,825,14,839,1450,0,3,1,3,0,1,0,76.14,57.86 ,33.33
03,001,01,015,0785,1606,710,11,721,1205,0,3,1,3,0,1,0,76.14,59.83 ,33.33
03,001,01,015,0785,1607,556,7,563,931,0,3,1,3,0,1,0,76.14,60.47 ,33.33
03,001,01,015,0786,1608,823,8,831,1277,0,3,1,3,0,1,0,76.14,65.07 ,33.33
03,001,01,015,0786,1609,967,16,983,1494,0,3,1,3,0,1,0,76.14,65.80 ,33.33
03,001,01,015,0786,1610,492,10,502,787,0,3,1,3,0,1,0,76.14,63.79 ,33.33
03,001,01,015,0787,1611,606,9,615,873,0,3,1,3,0,1,0,76.14,70.45 ,33.33
03,001,01,015,0788,1612,689,13,702,1004,0,3,1,3,0,1,0,76.14,69.92 ,33.33
03,001,01,015,0788,1613,742,5,747,1034,0,3,1,3,0,1,0,76.14,72.24 ,33.33
03,001,01,015,0788,1614,636,2,638,895,0,3,1,3,0,1,0,76.14,71.28 ,33.33
03,001,01,015,0788,1615,630,6,636,901,0,3,1,3,0,1,0,76.14,70.59 ,33.33
03,001,01,015,0789,1616,1002,9,1011,1489,0,3,1,3,0,1,0,76.14,67.90 ,33.33
03,001,01,015,0789,1617,614,8,622,944,0,3,1,3,0,1,0,76.14,65.89 ,33.33
03,001,01,015,0789,1618,742,14,756,1116,0,3,1,3,0,1,0,76.14,67.74 ,33.33
03,001,01,015,0789,1619,635,9,644,935,0,3,1,3,0,1,0,76.14,68.88 ,33.33
03,001,01,015,0790,1620,801,17,818,1250,0,3,1,3,0,1,0,76.14,65.44 ,33.33
03,001,01,015,0790,1621,682,8,690,978,0,3,1,3,0,1,0,76.14,70.55 ,33.33
03,001,01,015,0791,1622,841,13,854,1126,0,3,1,3,0,1,0,76.14,75.84 ,33.33
03,001,01,015,0791,1623,784,12,796,1075,0,3,1,3,0,1,0,76.14,74.05 ,33.33
03,001,01,015,0792,1624,883,10,893,1174,0,3,1,3,0,1,0,76.14,76.06 ,33.33
03,001,01,016,0793,1625,381,8,389,582,0,3,1,3,0,1,0,76.14,66.84 ,33.33
03,001,01,016,0793,1626,193,2,195,280,0,3,1,3,0,1,0,76.14,69.64 ,33.33
03,001,01,016,0794,1627,495,11,506,770,0,3,1,3,0,1,0,76.14,65.71 ,33.33
03,001,01,016,0794,1628,419,6,425,674,0,3,1,3,0,1,0,76.14,63.06 ,33.33
03,001,01,016,0794,1629,434,6,440,567,0,3,1,3,0,1,0,76.14,77.60 ,33.33
03,001,01,016,0795,1630,677,10,687,1056,0,3,1,3,0,1,0,76.14,65.06 ,33.33
03,001,01,016,0795,1631,677,18,695,1046,0,3,1,3,0,1,0,76.14,66.44 ,33.33
03,001,01,016,0795,1632,634,8,642,1051,0,3,1,3,0,1,0,76.14,61.08 ,33.33
03,001,01,016,0795,1633,543,6,549,792,0,3,1,3,0,1,0,76.14,69.32 ,33.33
03,001,01,016,0796,1634,693,5,698,1023,0,3,1,3,0,1,0,76.14,68.23 ,33.33
03,001,01,016,0796,1635,624,15,639,938,0,3,1,3,0,1,0,76.14,68.12 ,33.33
03,001,01,016,0796,1636,638,13,651,916,0,3,1,3,0,1,0,76.14,71.07 ,33.33
03,001,01,016,0796,1637,627,9,636,904,0,3,1,3,0,1,0,76.14,70.35 ,33.33
03,001,01,016,0797,1638,525,2,527,787,0,3,1,3,0,1,0,76.14,66.96 ,33.33
03,001,01,016,0797,1639,526,9,535,807,0,3,1,3,0,1,0,76.14,66.29 ,33.33
03,001,01,016,0797,1640,591,9,600,851,0,3,1,3,0,1,0,76.14,70.51 ,33.33
03,001,01,016,0798,1641,846,6,852,1229,0,3,1,3,0,1,0,76.14,69.32 ,33.33
03,001,01,016,0798,1642,787,11,798,1188,0,3,1,3,0,1,0,76.14,67.17 ,33.33
03,001,01,016,0799,1643,689,7,696,914,0,3,1,3,0,1,0,76.14,76.15 ,33.33
03,001,01,016,0799,1644,584,8,592,817,0,3,1,3,0,1,0,76.14,72.46 ,33.33
03,001,01,016,0800,1645,820,13,833,1192,0,3,1,3,0,1,0,76.14,69.88 ,33.33
03,001,01,016,0800,1646,729,7,736,1046,0,3,1,3,0,1,0,76.14,70.36 ,33.33
03,001,01,016,0801,1647,857,11,868,1286,0,3,1,3,0,1,0,76.14,67.50 ,33.33
03,001,01,016,0801,1648,923,6,929,1378,0,3,1,3,0,1,0,76.14,67.42 ,33.33
03,001,01,016,0802,1649,757,15,772,1201,0,3,1,3,0,1,0,76.14,64.28 ,33.33
03,001,01,016,0802,1650,819,12,831,1190,0,3,1,3,0,1,0,76.14,69.83 ,33.33
03,001,01,016,0803,1651,490,6,496,756,0,3,1,3,0,1,0,76.14,65.61 ,33.33
03,001,01,016,0803,1652,557,7,564,856,0,3,1,3,0,1,0,76.14,65.89 ,33.33
03,001,01,016,0804,1653,710,12,722,1058,0,3,1,3,0,1,0,76.14,68.24 ,33.33
03,001,01,016,0804,1654,726,13,739,1082,0,3,1,3,0,1,0,76.14,68.30 ,33.33
03,001,01,016,0805,1655,573,9,582,869,0,3,1,3,0,1,0,76.14,66.97 ,33.33
03,001,01,016,0805,1656,561,6,567,875,0,3,1,3,0,1,0,76.14,64.80 ,33.33
03,001,01,016,0805,1657,494,6,500,765,0,3,1,3,0,1,0,76.14,65.36 ,33.33
03,001,01,016,0806,1658,776,6,782,1069,0,3,1,3,0,1,0,76.14,73.15 ,33.33
03,001,01,016,0806,1659,880,20,900,1266,0,3,1,3,0,1,0,76.14,71.09 ,33.33
03,001,01,016,0807,1660,653,9,662,938,0,3,1,3,0,1,0,76.14,70.58 ,33.33
03,001,01,016,0807,1661,614,8,622,897,0,3,1,3,0,1,0,76.14,69.34 ,33.33
03,001,01,016,0807,1662,610,8,618,976,0,3,1,3,0,1,0,76.14,63.32 ,33.33
03,001,01,017,0808,1663,708,5,713,1056,0,3,1,3,0,1,0,76.14,67.52 ,33.33
03,001,01,017,0808,1664,577,3,580,870,0,3,1,3,0,1,0,76.14,66.67 ,33.33
03,001,01,017,0808,1665,761,9,770,1145,0,3,1,3,0,1,0,76.14,67.25 ,33.33
03,001,01,017,0809,1666,974,15,989,1671,0,3,1,3,0,1,0,76.14,59.19 ,33.33
03,001,01,017,0809,1667,979,11,990,1330,0,3,1,3,0,1,0,76.14,74.44 ,33.33
03,001,01,017,0810,1668,915,23,938,1360,0,3,1,3,0,1,0,76.14,68.97 ,33.33
03,001,01,017,0810,1669,927,10,937,1387,0,3,1,3,0,1,0,76.14,67.56 ,33.33
03,001,01,017,0811,1670,940,16,956,1294,0,3,1,3,0,1,0,76.14,73.88 ,33.33
03,001,01,017,0811,1671,918,23,941,1265,0,3,1,3,0,1,0,76.14,74.39 ,33.33
03,001,01,017,0812,1672,854,9,863,1198,0,3,1,3,0,1,0,76.14,72.04 ,33.33
03,001,01,017,0812,1673,825,9,834,1115,0,3,1,3,0,1,0,76.14,74.80 ,33.33
03,001,01,017,0813,1674,761,14,775,1049,0,3,1,3,0,1,0,76.14,73.88 ,33.33
03,001,01,017,0814,1675,953,22,975,1303,0,3,1,3,0,1,0,76.14,74.83 ,33.33
03,001,01,017,0815,1676,616,9,625,911,0,3,1,3,0,1,0,76.14,68.61 ,33.33
03,001,01,017,0815,1677,1239,17,1256,2067,0,3,1,3,0,1,0,76.14,60.76 ,33.33
03,001,01,017,0816,1678,954,13,967,1549,0,3,1,3,0,1,0,76.14,62.43 ,33.33
03,001,01,017,0816,1679,741,12,753,1114,0,3,1,3,0,1,0,76.14,67.59 ,33.33
03,001,01,017,0817,1680,669,7,676,895,0,3,1,3,0,1,0,76.14,75.53 ,33.33
03,001,01,017,0818,1681,686,9,695,904,0,3,1,3,0,1,0,76.14,76.88 ,33.33
03,001,01,017,0819,1682,467,8,475,608,0,3,1,3,0,1,0,76.14,78.13 ,33.33
03,001,01,017,0820,1683,345,8,353,472,0,3,1,3,0,1,0,76.14,74.79 ,33.33
03,001,01,017,0821,1684,499,5,504,783,0,3,1,3,0,1,0,76.14,64.37 ,33.33
03,001,01,018,0822,1685,887,9,896,1282,0,3,1,3,0,1,0,76.14,69.89 ,33.33
03,001,01,018,0822,1686,942,16,958,1444,0,3,1,3,0,1,0,76.14,66.34 ,33.33
03,001,01,018,0822,1687,988,9,997,1445,0,3,1,3,0,1,0,76.14,69.00 ,33.33
03,001,01,018,0823,1688,686,13,699,1004,0,3,1,3,0,1,0,76.14,69.62 ,33.33
03,001,01,018,0823,1689,706,13,719,1075,0,3,1,3,0,1,0,76.14,66.88 ,33.33
03,001,01,018,0823,1690,630,15,645,986,0,3,1,3,0,1,0,76.14,65.42 ,33.33
03,001,01,018,0824,1691,941,22,963,1418,0,3,1,3,0,1,0,76.14,67.91 ,33.33
03,001,01,018,0824,1692,814,8,822,1229,0,3,1,3,0,1,0,76.14,66.88 ,33.33
03,001,01,018,0825,1693,766,10,776,1157,0,3,1,3,0,1,0,76.14,67.07 ,33.33
03,001,01,018,0826,1694,311,3,314,432,0,3,1,3,0,1,0,76.14,72.69 ,33.33
03,001,01,019,0827,1695,294,2,296,395,0,3,1,3,0,1,0,76.14,74.94 ,33.33
03,001,01,019,0828,1696,417,6,423,622,0,3,1,3,0,1,0,76.14,68.01 ,33.33
03,001,01,019,0829,1697,399,10,409,569,0,3,1,3,0,1,0,76.14,71.88 ,33.33
03,001,01,019,0830,1698,173,0,173,256,0,3,1,3,0,1,0,76.14,67.58 ,33.33
03,001,01,019,0831,1699,245,5,250,366,0,3,1,3,0,1,0,76.14,68.31 ,33.33
03,001,01,019,0832,1700,488,16,504,709,0,3,1,3,0,1,0,76.14,71.09 ,33.33
03,001,01,019,0833,1701,175,1,176,254,0,3,1,3,0,1,0,76.14,69.29 ,33.33
03,001,01,019,0834,1702,544,14,558,756,0,3,1,3,0,1,0,76.14,73.81 ,33.33
03,001,01,019,0835,1703,374,4,378,530,0,3,1,3,0,1,0,76.14,71.32 ,33.33
03,001,01,019,0836,1704,137,1,138,203,0,3,1,3,0,1,0,76.14,67.98 ,33.33
03,001,01,019,0837,1705,268,3,271,399,0,3,1,3,0,1,0,76.14,67.92 ,33.33
03,001,01,019,0838,1706,400,6,406,572,0,3,1,3,0,1,0,76.14,70.98 ,33.33
03,001,01,019,0839,1707,214,4,218,379,0,3,1,3,0,1,0,76.14,57.52 ,33.33
03,001,01,020,0840,1708,676,3,679,944,0,3,1,3,0,1,0,76.14,71.93 ,33.33
03,001,01,020,0841,1709,301,0,301,468,0,3,1,3,0,1,0,76.14,64.32 ,33.33
03,001,01,020,0842,1710,498,5,503,878,0,3,1,3,0,1,0,76.14,57.29 ,33.33
03,001,01,020,0843,1711,219,2,221,369,0,3,1,3,0,1,0,76.14,59.89 ,33.33
03,001,01,020,0844,1712,287,9,296,460,0,3,1,3,0,1,0,76.14,64.35 ,33.33
03,001,01,020,0844,1713,113,1,114,194,0,3,1,3,0,1,0,76.14,58.76 ,33.33
03,001,01,020,0845,1714,223,3,226,332,0,3,1,3,0,1,0,76.14,68.07 ,33.33
03,001,01,020,0845,1715,221,1,222,370,0,3,1,3,0,1,0,76.14,60.00 ,33.33
03,001,01,020,0846,1716,174,4,178,306,0,3,1,3,0,1,0,76.14,58.17 ,33.33
03,001,01,020,0846,1717,193,2,195,296,0,3,1,3,0,1,0,76.14,65.88 ,33.33
03,001,01,021,0847,1718,228,3,231,312,0,3,1,3,0,1,0,76.14,74.04 ,33.33
03,001,01,021,0848,1719,960,29,989,1379,0,3,1,3,0,1,0,76.14,71.72 ,33.33
03,001,01,021,0848,1720,766,6,772,1091,0,3,1,3,0,1,0,76.14,70.76 ,33.33
03,001,01,021,0849,1721,532,8,540,733,0,3,1,3,0,1,0,76.14,73.67 ,33.33
03,001,01,021,0850,1722,535,11,546,783,0,3,1,3,0,1,0,76.14,69.73 ,33.33
03,001,01,021,0851,1723,1251,16,1267,1777,0,3,1,3,0,1,0,76.14,71.30 ,33.33
03,001,01,021,0851,1724,937,24,961,1356,0,3,1,3,0,1,0,76.14,70.87 ,33.33
03,001,01,021,0852,1725,234,3,237,359,0,3,1,3,0,1,0,76.14,66.02 ,33.33
03,001,01,021,0853,1726,406,1,407,549,0,3,1,3,0,1,0,76.14,74.13 ,33.33
03,001,01,021,0854,1727,527,8,535,784,0,3,1,3,0,1,0,76.14,68.24 ,33.33
03,001,01,021,0855,1728,805,12,817,1093,0,3,1,3,0,1,0,76.14,74.75 ,33.33
03,001,01,021,0856,1729,332,16,348,463,0,3,1,3,0,1,0,76.14,75.16 ,33.33
03,001,01,021,0857,1730,311,3,314,465,0,3,1,3,0,1,0,76.14,67.53 ,33.33
03,001,01,021,0858,1731,419,7,426,634,0,3,1,3,0,1,0,76.14,67.19 ,33.33
03,001,01,021,0859,1732,713,19,732,1051,0,3,1,3,0,1,0,76.14,69.65 ,33.33
03,001,01,022,0860,1733,505,7,512,692,0,3,1,3,0,1,0,76.14,73.99 ,33.33
03,001,01,022,0861,1734,681,11,692,940,0,3,1,3,0,1,0,76.14,73.62 ,33.33
03,001,01,022,0862,1735,989,27,1016,1453,0,3,1,3,0,1,0,76.14,69.92 ,33.33
03,001,01,022,0863,1736,384,5,389,579,0,3,1,3,0,1,0,76.14,67.18 ,33.33
03,001,01,022,0864,1737,710,9,719,1026,0,3,1,3,0,1,0,76.14,70.08 ,33.33
03,001,01,022,0865,1738,763,8,771,1074,0,3,1,3,0,1,0,76.14,71.79 ,33.33
03,001,01,022,0866,1739,135,1,136,212,0,3,1,3,0,1,0,76.14,64.15 ,33.33
03,001,01,022,0867,1740,327,2,329,427,0,3,1,3,0,1,0,76.14,77.05 ,33.33
03,001,01,022,0868,1741,411,6,417,618,0,3,1,3,0,1,0,76.14,67.48 ,33.33
03,001,01,023,0869,1742,1033,21,1054,1512,0,3,1,3,0,1,0,76.14,69.71 ,33.33
03,001,01,023,0869,1743,774,16,790,1128,0,3,1,3,0,1,0,76.14,70.04 ,33.33
03,001,01,023,0870,1744,1120,25,1145,1665,0,3,1,3,0,1,0,76.14,68.77 ,33.33
03,001,01,023,0871,1745,671,15,686,928,0,3,1,3,0,1,0,76.14,73.92 ,33.33
03,001,01,023,0872,1746,1023,27,1050,1561,0,3,1,3,0,1,0,76.14,67.26 ,33.33
03,001,01,023,0873,1747,563,15,578,780,0,3,1,3,0,1,0,76.14,74.10 ,33.33
03,001,01,023,0874,1748,721,10,731,1103,0,3,1,3,0,1,0,76.14,66.27 ,33.33
03,001,01,023,0874,1749,565,7,572,837,0,3,1,3,0,1,0,76.14,68.34 ,33.33
03,001,01,023,0875,1750,621,15,636,926,0,3,1,3,0,1,0,76.14,68.68 ,33.33
03,001,01,023,0875,1751,671,15,686,929,0,3,1,3,0,1,0,76.14,73.84 ,33.33
03,001,01,023,0876,1752,625,10,635,882,0,3,1,3,0,1,0,76.14,72.00 ,33.33
03,001,01,023,0877,1753,748,12,760,922,0,3,1,3,0,1,0,76.14,82.43 ,33.33
03,001,01,023,0878,1754,734,12,746,1005,0,3,1,3,0,1,0,76.14,74.23 ,33.33
03,001,01,024,0879,1755,336,3,339,457,0,3,1,3,0,1,0,76.14,74.18 ,33.33
03,001,01,024,0880,1756,239,1,240,315,0,3,1,3,0,1,0,76.14,76.19 ,33.33
03,001,01,024,0881,1757,266,8,274,352,0,3,1,3,0,1,0,76.14,77.84 ,33.33
03,001,01,024,0882,1758,381,4,385,564,0,3,1,3,0,1,0,76.14,68.26 ,33.33
03,001,01,024,0883,1759,238,2,240,326,0,3,1,3,0,1,0,76.14,73.62 ,33.33
03,001,01,024,0884,1760,536,1,537,717,0,3,1,3,0,1,0,76.14,74.90 ,33.33
03,001,01,024,0885,1761,239,5,244,350,0,3,1,3,0,1,0,76.14,69.71 ,33.33
03,001,01,024,0886,1762,813,7,820,1185,0,3,1,3,0,1,0,76.14,69.20 ,33.33
03,001,01,024,0887,1763,72,1,73,103,0,3,1,3,0,1,0,76.14,70.87 ,33.33
03,001,01,024,0888,1764,366,8,374,530,0,3,1,3,0,1,0,76.14,70.57 ,33.33
03,001,01,024,0889,1765,105,2,107,171,0,3,1,3,0,1,0,76.14,62.57 ,33.33
03,001,01,024,0890,1766,80,0,80,120,0,3,1,3,0,1,0,76.14,66.67 ,33.33
03,001,01,025,0891,1767,460,6,466,623,0,3,1,3,0,1,0,76.14,74.80 ,33.33
03,001,01,025,0892,1768,270,3,273,348,0,3,1,3,0,1,0,76.14,78.45 ,33.33
03,001,01,025,0892,1769,503,8,511,701,0,3,1,3,0,1,0,76.14,72.90 ,33.33
03,001,01,025,0893,1770,321,5,326,477,0,3,1,3,0,1,0,76.14,68.34 ,33.33
03,001,01,025,0894,1771,805,7,812,1139,0,3,1,3,0,1,0,76.14,71.29 ,33.33
03,001,01,025,0894,1772,629,6,635,820,0,3,1,3,0,1,0,76.14,77.44 ,33.33
03,001,01,025,0895,1773,223,4,227,325,0,3,1,3,0,1,0,76.14,69.85 ,33.33
03,001,01,025,0896,1774,454,2,456,598,0,3,1,3,0,1,0,76.14,76.25 ,33.33
03,001,01,025,0896,1775,210,1,211,294,0,3,1,3,0,1,0,76.14,71.77 ,33.33
03,001,01,025,0897,1776,540,6,546,763,0,3,1,3,0,1,0,76.14,71.56 ,33.33
03,001,01,025,0898,1777,308,2,310,526,0,3,1,3,0,1,0,76.14,58.94 ,33.33
03,001,01,025,0899,1778,292,1,293,395,0,3,1,3,0,1,0,76.14,74.18 ,33.33
03,001,01,025,0900,1779,382,4,386,517,0,3,1,3,0,1,0,76.14,74.66 ,33.33
03,001,01,025,0901,1780,214,4,218,316,0,3,1,3,0,1,0,76.14,68.99 ,33.33
03,001,01,025,0901,1781,213,0,213,298,0,3,1,3,0,1,0,76.14,71.48 ,33.33
03,001,01,025,0902,1782,127,0,127,209,0,3,1,3,0,1,0,76.14,60.77 ,33.33
03,001,01,025,0902,1783,75,0,75,94,0,3,1,3,0,1,0,76.14,79.79 ,33.33
03,001,01,026,0903,1784,701,10,711,968,0,3,1,3,0,1,0,76.14,73.45 ,33.33
03,001,01,026,0904,1785,276,7,283,422,0,3,1,3,0,1,0,76.14,67.06 ,33.33
03,001,01,026,0905,1786,259,4,263,414,0,3,1,3,0,1,0,76.14,63.53 ,33.33
03,001,01,026,0906,1787,314,3,317,451,0,3,1,3,0,1,0,76.14,70.29 ,33.33
03,001,01,026,0906,1788,243,6,249,356,0,3,1,3,0,1,0,76.14,69.94 ,33.33
03,001,01,026,0907,1789,588,13,601,841,0,3,1,3,0,1,0,76.14,71.46 ,33.33
03,001,01,026,0907,1790,497,10,507,686,0,3,1,3,0,1,0,76.14,73.91 ,33.33
03,001,01,026,0908,1791,455,7,462,730,0,3,1,3,0,1,0,76.14,63.29 ,33.33
03,001,01,026,0909,1792,435,5,440,652,0,3,1,3,0,1,0,76.14,67.48 ,33.33
03,001,01,026,0910,1793,1003,13,1016,1392,0,3,1,3,0,1,0,76.14,72.99 ,33.33
03,001,01,026,0911,1794,722,9,731,1044,0,3,1,3,0,1,0,76.14,70.02 ,33.33
03,001,01,026,0911,1795,501,9,510,765,0,3,1,3,0,1,0,76.14,66.67 ,33.33
03,001,01,026,0912,1796,273,2,275,407,0,3,1,3,0,1,0,76.14,67.57 ,33.33
03,001,01,026,0912,1797,258,2,260,412,0,3,1,3,0,1,0,76.14,63.11 ,33.33
03,001,01,026,0913,1798,294,5,299,473,0,3,1,3,0,1,0,76.14,63.21 ,33.33
03,001,01,026,0913,1799,264,3,267,443,0,3,1,3,0,1,0,76.14,60.27 ,33.33
03,001,01,027,0914,1800,289,5,294,425,0,3,1,3,0,1,0,76.14,69.18 ,33.33
03,001,01,027,0915,1801,493,7,500,674,0,3,1,3,0,1,0,76.14,74.18 ,33.33
03,001,01,027,0916,1802,292,3,295,441,0,3,1,3,0,1,0,76.14,66.89 ,33.33
03,001,01,027,0917,1803,861,6,867,1342,0,3,1,3,0,1,0,76.14,64.61 ,33.33
03,001,01,027,0918,1804,1027,12,1039,1406,0,3,1,3,0,1,0,76.14,73.90 ,33.33
03,001,01,027,0918,1805,1402,20,1422,2060,0,3,1,3,0,1,0,76.14,69.03 ,33.33
03,001,01,027,0918,1806,1121,15,1136,1651,0,3,1,3,0,1,0,76.14,68.81 ,33.33
03,001,01,027,0919,1807,917,19,936,1355,0,3,1,3,0,1,0,76.14,69.08 ,33.33
03,001,01,027,0920,1808,513,9,522,749,0,3,1,3,0,1,0,76.14,69.69 ,33.33
03,001,01,027,0921,1809,222,7,229,338,0,3,1,3,0,1,0,76.14,67.75 ,33.33
03,001,01,027,0922,1810,343,7,350,510,0,3,1,3,0,1,0,76.14,68.63 ,33.33
03,001,01,027,0923,1811,373,5,378,567,0,3,1,3,0,1,0,76.14,66.67 ,33.33
03,001,01,027,0924,1812,511,12,523,753,0,3,1,3,0,1,0,76.14,69.46 ,33.33
03,001,01,027,0925,1813,141,0,141,216,0,3,1,3,0,1,0,76.14,65.28 ,33.33
03,001,01,027,0926,1814,307,4,311,426,0,3,1,3,0,1,0,76.14,73.00 ,33.33
03,001,01,027,0927,1815,330,4,334,527,0,3,1,3,0,1,0,76.14,63.38 ,33.33
03,001,01,028,0928,1816,1012,17,1029,1443,0,3,1,3,0,1,0,76.14,71.31 ,33.33
03,001,01,028,0928,1817,1019,19,1038,1434,0,3,1,3,0,1,0,76.14,72.38 ,33.33
03,001,01,028,0929,1818,421,19,440,638,0,3,1,3,0,1,0,76.14,68.97 ,33.33
03,001,01,028,0929,1819,641,7,648,967,0,3,1,3,0,1,0,76.14,67.01 ,33.33
03,001,01,028,0930,1820,764,12,776,1066,0,3,1,3,0,1,0,76.14,72.80 ,33.33
03,001,01,028,0930,1821,793,12,805,1061,0,3,1,3,0,1,0,76.14,75.87 ,33.33
03,001,01,028,0931,1822,434,7,441,623,0,3,1,3,0,1,0,76.14,70.79 ,33.33
03,001,01,028,0931,1823,996,14,1010,1462,0,3,1,3,0,1,0,76.14,69.08 ,33.33
03,001,01,028,0932,1824,317,7,324,474,0,3,1,3,0,1,0,76.14,68.35 ,33.33
03,001,01,028,0933,1825,518,11,529,784,0,3,1,3,0,1,0,76.14,67.47 ,33.33
03,001,01,028,0934,1826,341,1,342,530,0,3,1,3,0,1,0,76.14,64.53 ,33.33
03,001,01,028,0935,1827,352,6,358,561,0,3,1,3,0,1,0,76.14,63.81 ,33.33
03,001,01,028,0936,1828,511,17,528,800,0,3,1,3,0,1,0,76.14,66.00 ,33.33
03,001,01,028,0937,1829,1180,22,1202,1842,0,3,1,3,0,1,0,76.14,65.26 ,33.33
03,001,01,029,0938,1830,250,2,252,366,0,3,1,3,0,1,0,76.14,68.85 ,33.33
03,001,01,029,0939,1831,519,7,526,773,0,3,1,3,0,1,0,76.14,68.05 ,33.33
03,001,01,029,0940,1832,47,0,47,64,0,3,1,3,0,1,0,76.14,73.44 ,33.33
03,001,01,029,0941,1833,95,1,96,148,0,3,1,3,0,1,0,76.14,64.86 ,33.33
03,001,01,029,0942,1834,36,0,36,54,0,3,1,3,0,1,0,76.14,66.67 ,33.33
03,002,01,001,0001,1,460,12,472,864,0,3,1,3,0,1,0,76.14,54.63 ,33.33
03,002,01,001,0002,2,579,8,587,913,0,3,1,3,0,1,0,76.14,64.29 ,33.33
03,002,01,001,0002,3,747,12,759,1257,0,3,1,3,0,1,0,76.14,60.38 ,33.33
03,002,01,001,0003,4,677,10,687,1172,0,3,1,3,0,1,0,76.14,58.62 ,33.33
03,002,01,001,0003,5,672,19,691,1158,0,3,1,3,0,1,0,76.14,59.67 ,33.33
03,002,01,001,0004,6,649,12,661,1150,0,3,1,3,0,1,0,76.14,57.48 ,33.33
03,002,01,001,0004,7,567,14,581,1063,0,3,1,3,0,1,0,76.14,54.66 ,33.33
03,002,01,001,0005,8,914,17,931,1542,0,3,1,3,0,1,0,76.14,60.38 ,33.33
03,002,01,001,0005,9,742,11,753,1320,0,3,1,3,0,1,0,76.14,57.05 ,33.33
03,002,01,001,0006,10,500,10,510,882,0,3,1,3,0,1,0,76.14,57.82 ,33.33
03,002,01,001,0006,11,959,21,980,1647,0,3,1,3,0,1,0,76.14,59.50 ,33.33
03,002,01,001,0007,12,689,8,697,1086,0,3,1,3,0,1,0,76.14,64.18 ,33.33
03,002,01,001,0007,13,728,23,751,1286,0,3,1,3,0,1,0,76.14,58.40 ,33.33
03,002,01,001,0008,14,471,5,476,794,0,3,1,3,0,1,0,76.14,59.95 ,33.33
03,002,01,001,0009,15,461,8,469,741,0,3,1,3,0,1,0,76.14,63.29 ,33.33
03,002,01,001,0009,16,373,6,379,689,0,3,1,3,0,1,0,76.14,55.01 ,33.33
03,002,01,001,0010,17,326,3,329,533,0,3,1,3,0,1,0,76.14,61.73 ,33.33
03,002,01,001,0011,18,457,6,463,747,0,3,1,3,0,1,0,76.14,61.98 ,33.33
03,002,01,001,0012,19,331,4,335,569,0,3,1,3,0,1,0,76.14,58.88 ,33.33
03,002,01,001,0013,20,357,5,362,648,0,3,1,3,0,1,0,76.14,55.86 ,33.33
03,002,01,001,0014,21,484,10,494,869,0,3,1,3,0,1,0,76.14,56.85 ,33.33
03,002,01,001,0014,22,583,14,597,1125,0,3,1,3,0,1,0,76.14,53.07 ,33.33
03,002,01,001,0015,23,958,14,972,1646,0,3,1,3,0,1,0,76.14,59.05 ,33.33
03,002,01,001,0015,24,396,7,403,624,0,3,1,3,0,1,0,76.14,64.58 ,33.33
03,002,01,001,0015,25,776,14,790,1313,0,3,1,3,0,1,0,76.14,60.17 ,33.33
03,002,01,001,0016,26,275,1,276,511,0,3,1,3,0,1,0,76.14,54.01 ,33.33
03,002,01,001,0017,27,519,7,526,1047,0,3,1,3,0,1,0,76.14,50.24 ,33.33
03,002,01,001,0018,28,406,7,413,763,0,3,1,3,0,1,0,76.14,54.13 ,33.33
03,002,01,001,0019,29,634,5,639,1169,0,3,1,3,0,1,0,76.14,54.66 ,33.33
03,002,01,001,0020,30,618,12,630,1098,0,3,1,3,0,1,0,76.14,57.38 ,33.33
03,002,01,001,0021,31,674,20,694,1212,0,3,1,3,0,1,0,76.14,57.26 ,33.33
03,002,01,001,0021,32,927,14,941,1643,0,3,1,3,0,1,0,76.14,57.27 ,33.33
03,002,01,001,0022,33,599,14,613,1027,0,3,1,3,0,1,0,76.14,59.69 ,33.33
03,002,01,001,0022,34,535,4,539,948,0,3,1,3,0,1,0,76.14,56.86 ,33.33
03,002,01,001,0022,35,506,11,517,975,0,3,1,3,0,1,0,76.14,53.03 ,33.33
03,002,01,001,0023,36,606,3,609,1007,0,3,1,3,0,1,0,76.14,60.48 ,33.33
03,002,01,001,0024,37,737,9,746,1404,0,3,1,3,0,1,0,76.14,53.13 ,33.33
03,002,01,001,0024,38,491,8,499,944,0,3,1,3,0,1,0,76.14,52.86 ,33.33
03,002,01,001,0024,39,648,15,663,1241,0,3,1,3,0,1,0,76.14,53.42 ,33.33
03,002,01,001,0025,40,409,7,416,669,0,3,1,3,0,1,0,76.14,62.18 ,33.33
03,002,01,001,0026,41,375,7,382,590,0,3,1,3,0,1,0,76.14,64.75 ,33.33
03,002,01,001,0027,42,456,5,461,703,0,3,1,3,0,1,0,76.14,65.58 ,33.33
03,002,01,001,0028,43,748,21,769,1330,0,3,1,3,0,1,0,76.14,57.82 ,33.33
03,002,01,001,0029,44,797,11,808,1346,0,3,1,3,0,1,0,76.14,60.03 ,33.33
03,002,01,001,0030,45,664,5,669,1152,0,3,1,3,0,1,0,76.14,58.07 ,33.33
03,002,01,001,0031,46,655,5,660,1215,0,3,1,3,0,1,0,76.14,54.32 ,33.33
03,002,01,001,0031,47,433,9,442,796,0,3,1,3,0,1,0,76.14,55.53 ,33.33
03,002,01,001,0032,48,763,9,772,1490,0,3,1,3,0,1,0,76.14,51.81 ,33.33
03,002,01,001,0033,49,691,12,703,1257,0,3,1,3,0,1,0,76.14,55.93 ,33.33
03,002,01,001,0034,50,745,10,755,1295,0,3,1,3,0,1,0,76.14,58.30 ,33.33
03,002,01,001,0034,51,550,8,558,977,0,3,1,3,0,1,0,76.14,57.11 ,33.33
03,002,01,001,0035,52,543,10,553,977,0,3,1,3,0,1,0,76.14,56.60 ,33.33
03,002,01,001,0036,53,521,15,536,818,0,3,1,3,0,1,0,76.14,65.53 ,33.33
03,002,01,001,0037,54,510,7,517,866,0,3,1,3,0,1,0,76.14,59.70 ,33.33
03,002,01,001,0038,55,768,10,778,1302,0,3,1,3,0,1,0,76.14,59.75 ,33.33
03,002,01,001,0039,56,520,5,525,891,0,3,1,3,0,1,0,76.14,58.92 ,33.33
03,002,01,001,0040,57,748,11,759,1369,0,3,1,3,0,1,0,76.14,55.44 ,33.33
03,002,01,002,0041,58,312,0,312,474,0,3,1,3,0,1,0,76.14,65.82 ,33.33
03,002,01,002,0042,59,385,6,391,594,0,3,1,3,0,1,0,76.14,65.82 ,33.33
03,002,01,002,0043,60,338,3,341,581,0,3,1,3,0,1,0,76.14,58.69 ,33.33
03,002,01,002,0044,61,657,6,663,1179,0,3,1,3,0,1,0,76.14,56.23 ,33.33
03,002,01,002,0045,62,847,14,861,1467,0,3,1,3,0,1,0,76.14,58.69 ,33.33
03,002,01,002,0046,63,582,4,586,935,0,3,1,3,0,1,0,76.14,62.67 ,33.33
03,002,01,002,0046,64,445,8,453,772,0,3,1,3,0,1,0,76.14,58.68 ,33.33
03,002,01,002,0047,65,586,6,592,1138,0,3,1,3,0,1,0,76.14,52.02 ,33.33
03,002,01,002,0048,66,665,12,677,1123,0,3,1,3,0,1,0,76.14,60.28 ,33.33
03,002,01,002,0048,67,572,14,586,981,0,3,1,3,0,1,0,76.14,59.73 ,33.33
03,002,01,002,0049,68,804,7,811,1395,0,3,1,3,0,1,0,76.14,58.14 ,33.33
03,002,01,002,0050,69,759,9,768,1228,0,3,1,3,0,1,0,76.14,62.54 ,33.33
03,002,01,002,0051,70,522,5,527,862,0,3,1,3,0,1,0,76.14,61.14 ,33.33
03,002,01,002,0052,71,424,4,428,709,0,3,1,3,0,1,0,76.14,60.37 ,33.33
03,002,01,002,0053,72,559,2,561,974,0,3,1,3,0,1,0,76.14,57.60 ,33.33
03,002,01,002,0054,73,425,5,430,707,0,3,1,3,0,1,0,76.14,60.82 ,33.33
03,002,01,002,0055,74,438,11,449,713,0,3,1,3,0,1,0,76.14,62.97 ,33.33
03,002,01,002,0056,75,629,7,636,1062,0,3,1,3,0,1,0,76.14,59.89 ,33.33
03,002,01,002,0056,76,690,9,699,1260,0,3,1,3,0,1,0,76.14,55.48 ,33.33
03,002,01,002,0056,77,601,8,609,1092,0,3,1,3,0,1,0,76.14,55.77 ,33.33
03,002,01,002,0057,78,480,6,486,839,0,3,1,3,0,1,0,76.14,57.93 ,33.33
03,002,01,002,0057,79,636,8,644,1089,0,3,1,3,0,1,0,76.14,59.14 ,33.33
03,002,01,002,0057,80,599,6,605,1018,0,3,1,3,0,1,0,76.14,59.43 ,33.33
03,002,01,002,0057,81,635,7,642,1162,0,3,1,3,0,1,0,76.14,55.25 ,33.33
03,002,01,002,0058,82,785,7,792,1359,0,3,1,3,0,1,0,76.14,58.28 ,33.33
03,002,01,002,0058,83,717,9,726,1227,0,3,1,3,0,1,0,76.14,59.17 ,33.33
03,002,01,002,0058,84,738,9,747,1283,0,3,1,3,0,1,0,76.14,58.22 ,33.33
03,002,01,002,0059,85,703,8,711,1305,0,3,1,3,0,1,0,76.14,54.48 ,33.33
03,002,01,002,0059,86,553,6,559,970,0,3,1,3,0,1,0,76.14,57.63 ,33.33
03,002,01,002,0059,87,606,6,612,1034,0,3,1,3,0,1,0,76.14,59.19 ,33.33
03,002,01,002,0060,88,491,6,497,891,0,3,1,3,0,1,0,76.14,55.78 ,33.33
03,002,01,002,0060,89,451,5,456,829,0,3,1,3,0,1,0,76.14,55.01 ,33.33
03,002,01,002,0061,90,571,8,579,1004,0,3,1,3,0,1,0,76.14,57.67 ,33.33
03,002,01,002,0062,91,754,9,763,1290,0,3,1,3,0,1,0,76.14,59.15 ,33.33
03,002,01,002,0062,92,696,14,710,1228,0,3,1,3,0,1,0,76.14,57.82 ,33.33
03,002,01,002,0063,93,811,9,820,1427,0,3,1,3,0,1,0,76.14,57.46 ,33.33
03,002,01,002,0063,94,771,8,779,1370,0,3,1,3,0,1,0,76.14,56.86 ,33.33
03,002,01,002,0064,95,789,15,804,1336,0,3,1,3,0,1,0,76.14,60.18 ,33.33
03,002,01,002,0064,96,663,11,674,1219,0,3,1,3,0,1,0,76.14,55.29 ,33.33
03,002,01,002,0065,97,621,7,628,1025,0,3,1,3,0,1,0,76.14,61.27 ,33.33
03,002,01,002,0065,98,563,7,570,1016,0,3,1,3,0,1,0,76.14,56.10 ,33.33
03,002,01,003,0066,99,664,7,671,1214,0,3,1,3,0,1,0,76.14,55.27 ,33.33
03,002,01,003,0066,100,848,10,858,1574,0,3,1,3,0,1,0,76.14,54.51 ,33.33
03,002,01,003,0067,101,392,4,396,688,0,3,1,3,0,1,0,76.14,57.56 ,33.33
03,002,01,003,0068,102,700,9,709,1269,0,3,1,3,0,1,0,76.14,55.87 ,33.33
03,002,01,003,0068,103,713,6,719,1247,0,3,1,3,0,1,0,76.14,57.66 ,33.33
03,002,01,003,0069,104,365,2,367,637,0,3,1,3,0,1,0,76.14,57.61 ,33.33
03,002,01,003,0069,105,242,2,244,449,0,3,1,3,0,1,0,76.14,54.34 ,33.33
03,002,01,003,0070,106,491,4,495,924,0,3,1,3,0,1,0,76.14,53.57 ,33.33
03,002,01,003,0070,107,276,2,278,449,0,3,1,3,0,1,0,76.14,61.92 ,33.33
03,002,01,003,0071,108,129,15,144,390,0,3,1,3,0,1,0,76.14,36.92 ,33.33
03,002,01,003,0072,109,565,6,571,976,0,3,1,3,0,1,0,76.14,58.50 ,33.33
03,002,01,003,0072,110,508,3,511,930,0,3,1,3,0,1,0,76.14,54.95 ,33.33
03,002,01,003,0073,111,529,7,536,1024,0,3,1,3,0,1,0,76.14,52.34 ,33.33
03,002,01,003,0074,112,715,13,728,1342,0,3,1,3,0,1,0,76.14,54.25 ,33.33
03,002,01,003,0074,113,832,14,846,1621,0,3,1,3,0,1,0,76.14,52.19 ,33.33
03,002,01,003,0074,114,757,5,762,1415,0,3,1,3,0,1,0,76.14,53.85 ,33.33
03,002,01,003,0075,115,676,5,681,1250,0,3,1,3,0,1,0,76.14,54.48 ,33.33
03,002,01,003,0075,116,524,8,532,936,0,3,1,3,0,1,0,76.14,56.84 ,33.33
03,002,01,003,0076,117,731,6,737,1315,0,3,1,3,0,1,0,76.14,56.05 ,33.33
03,002,01,003,0077,118,357,3,360,632,0,3,1,3,0,1,0,76.14,56.96 ,33.33
03,002,01,003,0078,119,293,7,300,607,0,3,1,3,0,1,0,76.14,49.42 ,33.33
03,002,01,003,0079,120,366,8,374,664,0,3,1,3,0,1,0,76.14,56.33 ,33.33
03,002,01,003,0080,121,415,6,421,678,0,3,1,3,0,1,0,76.14,62.09 ,33.33
03,002,01,003,0081,122,363,13,376,703,0,3,1,3,0,1,0,76.14,53.49 ,33.33
03,002,01,003,0082,123,352,5,357,568,0,3,1,3,0,1,0,76.14,62.85 ,33.33
03,002,01,003,0083,124,613,9,622,1209,0,3,1,3,0,1,0,76.14,51.45 ,33.33
03,002,01,003,0084,125,573,10,583,1185,0,3,1,3,0,1,0,76.14,49.20 ,33.33
03,002,01,003,0085,126,614,11,625,1344,0,3,1,3,0,1,0,76.14,46.50 ,33.33
03,002,01,003,0086,127,422,3,425,916,0,3,1,3,0,1,0,76.14,46.40 ,33.33
03,002,01,003,0086,128,328,3,331,804,0,3,1,3,0,1,0,76.14,41.17 ,33.33
03,002,01,003,0087,129,598,5,603,1259,0,3,1,3,0,1,0,76.14,47.90 ,33.33
03,002,01,003,0088,130,603,10,613,1353,0,3,1,3,0,1,0,76.14,45.31 ,33.33
03,002,01,003,0089,131,209,1,210,369,0,3,1,3,0,1,0,76.14,56.91 ,33.33
03,002,01,003,0090,132,466,5,471,883,0,3,1,3,0,1,0,76.14,53.34 ,33.33
03,002,01,003,0091,133,290,4,294,550,0,3,1,3,0,1,0,76.14,53.45 ,33.33
03,002,01,003,0091,134,153,1,154,286,0,3,1,3,0,1,0,76.14,53.85 ,33.33
03,002,01,004,0092,135,206,1,207,413,0,3,1,3,0,1,0,76.14,50.12 ,33.33
03,002,01,004,0093,136,239,5,244,696,0,3,1,3,0,1,0,76.14,35.06 ,33.33
03,002,01,004,0094,137,607,8,615,1532,0,3,1,3,0,1,0,76.14,40.14 ,33.33
03,002,01,004,0095,138,196,7,203,428,0,3,1,3,0,1,0,76.14,47.43 ,33.33
03,002,01,004,0096,139,645,6,651,1307,0,3,1,3,0,1,0,76.14,49.81 ,33.33
03,002,01,004,0097,140,438,6,444,880,0,3,1,3,0,1,0,76.14,50.45 ,33.33
03,002,01,004,0098,141,316,10,326,611,0,3,1,3,0,1,0,76.14,53.36 ,33.33
03,002,01,004,0099,142,686,6,692,1315,0,3,1,3,0,1,0,76.14,52.62 ,33.33
03,002,01,004,0100,143,612,9,621,1099,0,3,1,3,0,1,0,76.14,56.51 ,33.33
03,002,01,004,0101,144,433,3,436,761,0,3,1,3,0,1,0,76.14,57.29 ,33.33
03,002,01,004,0102,145,350,5,355,651,0,3,1,3,0,1,0,76.14,54.53 ,33.33
03,002,01,004,0103,146,407,4,411,712,0,3,1,3,0,1,0,76.14,57.72 ,33.33
03,002,01,004,0104,147,325,5,330,615,0,3,1,3,0,1,0,76.14,53.66 ,33.33
03,002,01,004,0105,148,439,6,445,906,0,3,1,3,0,1,0,76.14,49.12 ,33.33
03,002,01,004,0105,149,497,5,502,942,0,3,1,3,0,1,0,76.14,53.29 ,33.33
03,002,01,004,0106,150,909,19,928,1687,0,3,1,3,0,1,0,76.14,55.01 ,33.33
03,002,01,004,0107,151,646,7,653,1182,0,3,1,3,0,1,0,76.14,55.25 ,33.33
03,002,01,004,0108,152,509,6,515,980,0,3,1,3,0,1,0,76.14,52.55 ,33.33
03,002,01,004,0109,153,761,8,769,1576,0,3,1,3,0,1,0,76.14,48.79 ,33.33
03,002,01,004,0110,154,374,5,379,720,0,3,1,3,0,1,0,76.14,52.64 ,33.33
03,002,01,004,0111,155,660,7,667,1298,0,3,1,3,0,1,0,76.14,51.39 ,33.33
03,002,01,004,0112,156,489,3,492,945,0,3,1,3,0,1,0,76.14,52.06 ,33.33
03,002,01,004,0113,157,546,4,550,913,0,3,1,3,0,1,0,76.14,60.24 ,33.33
03,002,01,004,0114,158,562,8,570,1069,0,3,1,3,0,1,0,76.14,53.32 ,33.33
03,002,01,005,0115,159,758,8,766,1400,0,3,1,3,0,1,0,76.14,54.71 ,33.33
03,002,01,005,0116,160,904,12,916,1621,0,3,1,3,0,1,0,76.14,56.51 ,33.33
03,002,01,005,0117,161,902,12,914,1692,0,3,1,3,0,1,0,76.14,54.02 ,33.33
03,002,01,005,0117,162,868,20,888,1570,0,3,1,3,0,1,0,76.14,56.56 ,33.33
03,002,01,005,0118,163,636,11,647,1137,0,3,1,3,0,1,0,76.14,56.90 ,33.33
03,002,01,005,0118,164,489,1,490,760,0,3,1,3,0,1,0,76.14,64.47 ,33.33
03,002,01,005,0119,165,427,3,430,676,0,3,1,3,0,1,0,76.14,63.61 ,33.33
03,002,01,005,0120,166,789,7,796,1334,0,3,1,3,0,1,0,76.14,59.67 ,33.33
03,002,01,005,0121,167,594,8,602,1125,0,3,1,3,0,1,0,76.14,53.51 ,33.33
03,002,01,005,0122,168,606,4,610,1253,0,3,1,3,0,1,0,76.14,48.68 ,33.33
03,002,01,005,0123,169,438,7,445,802,0,3,1,3,0,1,0,76.14,55.49 ,33.33
03,002,01,005,0123,170,502,7,509,892,0,3,1,3,0,1,0,76.14,57.06 ,33.33
03,002,01,005,0124,171,743,20,763,1303,0,3,1,3,0,1,0,76.14,58.56 ,33.33
03,002,01,005,0124,172,474,7,481,863,0,3,1,3,0,1,0,76.14,55.74 ,33.33
03,002,01,005,0125,173,594,9,603,1039,0,3,1,3,0,1,0,76.14,58.04 ,33.33
03,002,01,005,0126,174,366,2,368,649,0,3,1,3,0,1,0,76.14,56.70 ,33.33
03,002,01,005,0127,175,474,8,482,877,0,3,1,3,0,1,0,76.14,54.96 ,33.33
03,002,01,005,0128,176,586,9,595,1056,0,3,1,3,0,1,0,76.14,56.34 ,33.33
03,002,01,005,0129,177,552,3,555,913,0,3,1,3,0,1,0,76.14,60.79 ,33.33
03,002,01,005,0129,178,652,6,658,1116,0,3,1,3,0,1,0,76.14,58.96 ,33.33
03,002,01,005,0130,179,724,11,735,1277,0,3,1,3,0,1,0,76.14,57.56 ,33.33
03,002,01,005,0130,180,685,6,691,1251,0,3,1,3,0,1,0,76.14,55.24 ,33.33
03,002,01,005,0131,181,482,10,492,882,0,3,1,3,0,1,0,76.14,55.78 ,33.33
03,002,01,005,0132,182,199,7,206,389,0,3,1,3,0,1,0,76.14,52.96 ,33.33
03,002,01,006,0133,183,648,12,660,1254,0,3,1,3,0,1,0,76.14,52.63 ,33.33
03,002,01,006,0133,184,622,9,631,1162,0,3,1,3,0,1,0,76.14,54.30 ,33.33
03,002,01,006,0134,185,742,10,752,1440,0,3,1,3,0,1,0,76.14,52.22 ,33.33
03,002,01,006,0135,186,425,5,430,827,0,3,1,3,0,1,0,76.14,52.00 ,33.33
03,002,01,006,0136,187,510,7,517,983,0,3,1,3,0,1,0,76.14,52.59 ,33.33
03,002,01,006,0137,188,793,11,804,1547,0,3,1,3,0,1,0,76.14,51.97 ,33.33
03,002,01,006,0138,189,719,4,723,1417,0,3,1,3,0,1,0,76.14,51.02 ,33.33
03,002,01,006,0139,190,375,4,379,820,0,3,1,3,0,1,0,76.14,46.22 ,33.33
03,002,01,006,0140,191,396,4,400,718,0,3,1,3,0,1,0,76.14,55.71 ,33.33
03,002,01,006,0140,192,602,7,609,1010,0,3,1,3,0,1,0,76.14,60.30 ,33.33
03,002,01,006,0141,193,603,12,615,1155,0,3,1,3,0,1,0,76.14,53.25 ,33.33
03,002,01,006,0142,194,540,6,546,936,0,3,1,3,0,1,0,76.14,58.33 ,33.33
03,002,01,006,0143,195,470,3,473,932,0,3,1,3,0,1,0,76.14,50.75 ,33.33
03,002,01,006,0143,196,454,1,455,799,0,3,1,3,0,1,0,76.14,56.95 ,33.33
03,002,01,006,0144,197,530,5,535,1079,0,3,1,3,0,1,0,76.14,49.58 ,33.33
03,002,01,006,0145,198,811,11,822,1487,0,3,1,3,0,1,0,76.14,55.28 ,33.33
03,002,01,007,0146,199,582,8,590,1043,0,3,1,3,0,1,0,76.14,56.57 ,33.33
03,002,01,007,0146,200,682,5,687,1259,0,3,1,3,0,1,0,76.14,54.57 ,33.33
03,002,01,007,0146,201,663,9,672,1256,0,3,1,3,0,1,0,76.14,53.50 ,33.33
03,002,01,007,0147,202,963,17,980,1729,0,3,1,3,0,1,0,76.14,56.68 ,33.33
03,002,01,007,0148,203,644,9,653,1110,0,3,1,3,0,1,0,76.14,58.83 ,33.33
03,002,01,007,0149,204,495,4,499,955,0,3,1,3,0,1,0,76.14,52.25 ,33.33
03,002,01,007,0150,205,709,9,718,1282,0,3,1,3,0,1,0,76.14,56.01 ,33.33
03,002,01,007,0151,206,581,9,590,1069,0,3,1,3,0,1,0,76.14,55.19 ,33.33
03,002,01,007,0152,207,552,8,560,944,0,3,1,3,0,1,0,76.14,59.32 ,33.33
03,002,01,007,0152,208,300,4,304,511,0,3,1,3,0,1,0,76.14,59.49 ,33.33
03,002,01,007,0153,209,206,2,208,454,0,3,1,3,0,1,0,76.14,45.81 ,33.33
03,002,01,007,0153,210,144,2,146,304,0,3,1,3,0,1,0,76.14,48.03 ,33.33
03,002,01,007,0154,211,804,14,818,1504,0,3,1,3,0,1,0,76.14,54.39 ,33.33
03,002,01,007,0155,212,606,8,614,1010,0,3,1,3,0,1,0,76.14,60.79 ,33.33
03,002,01,007,0156,213,888,10,898,1476,0,3,1,3,0,1,0,76.14,60.84 ,33.33
03,002,01,007,0156,214,280,4,284,528,0,3,1,3,0,1,0,76.14,53.79 ,33.33
03,002,01,007,0157,215,735,10,745,1258,0,3,1,3,0,1,0,76.14,59.22 ,33.33
03,002,01,007,0157,216,515,9,524,960,0,3,1,3,0,1,0,76.14,54.58 ,33.33
03,002,01,007,0158,217,439,6,445,835,0,3,1,3,0,1,0,76.14,53.29 ,33.33
03,002,01,007,0159,218,445,4,449,828,0,3,1,3,0,1,0,76.14,54.23 ,33.33
03,002,01,007,0160,219,514,6,520,978,0,3,1,3,0,1,0,76.14,53.17 ,33.33
03,002,01,007,0161,220,785,11,796,1560,0,3,1,3,0,1,0,76.14,51.03 ,33.33
03,002,01,008,0162,221,600,5,605,1046,0,3,1,3,0,1,0,76.14,57.84 ,33.33
03,002,01,008,0163,222,661,8,669,1093,0,3,1,3,0,1,0,76.14,61.21 ,33.33
03,002,01,008,0164,223,555,2,557,913,0,3,1,3,0,1,0,76.14,61.01 ,33.33
03,002,01,008,0165,224,454,9,463,779,0,3,1,3,0,1,0,76.14,59.44 ,33.33
03,002,01,008,0166,225,564,10,574,905,0,3,1,3,0,1,0,76.14,63.43 ,33.33
03,002,01,008,0167,226,628,8,636,1112,0,3,1,3,0,1,0,76.14,57.19 ,33.33
03,002,01,008,0168,227,532,7,539,859,0,3,1,3,0,1,0,76.14,62.75 ,33.33
03,002,01,008,0168,228,502,7,509,830,0,3,1,3,0,1,0,76.14,61.33 ,33.33
03,002,01,008,0169,229,494,3,497,835,0,3,1,3,0,1,0,76.14,59.52 ,33.33
03,002,01,008,0169,230,489,13,502,862,0,3,1,3,0,1,0,76.14,58.24 ,33.33
03,002,01,008,0170,231,539,7,546,855,0,3,1,3,0,1,0,76.14,63.86 ,33.33
03,002,01,008,0171,232,418,5,423,688,0,3,1,3,0,1,0,76.14,61.48 ,33.33
03,002,01,008,0172,233,758,10,768,1282,0,3,1,3,0,1,0,76.14,59.91 ,33.33
03,002,01,008,0173,234,473,6,479,798,0,3,1,3,0,1,0,76.14,60.03 ,33.33
03,002,01,008,0174,235,646,10,656,1187,0,3,1,3,0,1,0,76.14,55.27 ,33.33
03,002,01,008,0175,236,246,7,253,414,0,3,1,3,0,1,0,76.14,61.11 ,33.33
03,002,01,008,0176,237,705,8,713,1247,0,3,1,3,0,1,0,76.14,57.18 ,33.33
03,002,01,008,0176,238,738,8,746,1282,0,3,1,3,0,1,0,76.14,58.19 ,33.33
03,002,01,008,0176,239,673,5,678,1274,0,3,1,3,0,1,0,76.14,53.22 ,33.33
03,002,01,008,0177,240,550,6,556,952,0,3,1,3,0,1,0,76.14,58.40 ,33.33
03,002,01,008,0177,241,538,5,543,947,0,3,1,3,0,1,0,76.14,57.34 ,33.33
03,002,01,008,0178,242,637,11,648,1098,0,3,1,3,0,1,0,76.14,59.02 ,33.33
03,002,01,008,0178,243,589,12,601,1141,0,3,1,3,0,1,0,76.14,52.67 ,33.33
03,002,01,008,0178,244,635,9,644,1137,0,3,1,3,0,1,0,76.14,56.64 ,33.33
03,002,01,008,0178,245,660,9,669,1134,0,3,1,3,0,1,0,76.14,58.99 ,33.33
03,002,01,008,0179,246,710,9,719,1247,0,3,1,3,0,1,0,76.14,57.66 ,33.33
03,002,01,008,0179,247,772,8,780,1307,0,3,1,3,0,1,0,76.14,59.68 ,33.33
03,002,01,008,0180,248,554,4,558,936,0,3,1,3,0,1,0,76.14,59.62 ,33.33
03,002,01,008,0180,249,653,8,661,1140,0,3,1,3,0,1,0,76.14,57.98 ,33.33
03,002,01,008,0181,250,562,8,570,1029,0,3,1,3,0,1,0,76.14,55.39 ,33.33
03,002,01,008,0182,251,569,6,575,1019,0,3,1,3,0,1,0,76.14,56.43 ,33.33
03,002,01,008,0182,252,579,6,585,1030,0,3,1,3,0,1,0,76.14,56.80 ,33.33
03,002,01,008,0183,253,643,8,651,1070,0,3,1,3,0,1,0,76.14,60.84 ,33.33
03,002,01,008,0184,254,478,7,485,804,0,3,1,3,0,1,0,76.14,60.32 ,33.33
03,002,01,008,0185,255,443,6,449,766,0,3,1,3,0,1,0,76.14,58.62 ,33.33
03,002,01,009,0186,256,991,6,997,1592,0,3,1,3,0,1,0,76.14,62.63 ,33.33
03,002,01,009,0187,257,882,14,896,1396,0,3,1,3,0,1,0,76.14,64.18 ,33.33
03,002,01,009,0188,258,548,7,555,903,0,3,1,3,0,1,0,76.14,61.46 ,33.33
03,002,01,009,0188,259,576,5,581,922,0,3,1,3,0,1,0,76.14,63.02 ,33.33
03,002,01,009,0189,260,880,11,891,1438,0,3,1,3,0,1,0,76.14,61.96 ,33.33
03,002,01,009,0190,261,538,6,544,890,0,3,1,3,0,1,0,76.14,61.12 ,33.33
03,002,01,009,0191,262,589,10,599,989,0,3,1,3,0,1,0,76.14,60.57 ,33.33
03,002,01,009,0191,263,667,3,670,1109,0,3,1,3,0,1,0,76.14,60.41 ,33.33
03,002,01,009,0192,264,973,6,979,1533,0,3,1,3,0,1,0,76.14,63.86 ,33.33
03,002,01,009,0193,265,848,12,860,1356,0,3,1,3,0,1,0,76.14,63.42 ,33.33
03,002,01,009,0193,266,550,6,556,1013,0,3,1,3,0,1,0,76.14,54.89 ,33.33
03,002,01,009,0194,267,796,9,805,1366,0,3,1,3,0,1,0,76.14,58.93 ,33.33
03,002,01,009,0194,268,634,6,640,1070,0,3,1,3,0,1,0,76.14,59.81 ,33.33
03,002,01,009,0195,269,725,7,732,1212,0,3,1,3,0,1,0,76.14,60.40 ,33.33
03,002,01,009,0195,270,434,6,440,707,0,3,1,3,0,1,0,76.14,62.23 ,33.33
03,002,01,009,0196,271,742,5,747,1216,0,3,1,3,0,1,0,76.14,61.43 ,33.33
03,002,01,009,0197,272,810,4,814,1463,0,3,1,3,0,1,0,76.14,55.64 ,33.33
03,002,01,009,0198,273,639,7,646,1021,0,3,1,3,0,1,0,76.14,63.27 ,33.33
03,002,01,009,0198,274,581,12,593,1012,0,3,1,3,0,1,0,76.14,58.60 ,33.33
03,002,01,009,0199,275,885,12,897,1541,0,3,1,3,0,1,0,76.14,58.21 ,33.33
03,002,01,009,0199,276,371,3,374,700,0,3,1,3,0,1,0,76.14,53.43 ,33.33
03,002,01,009,0200,277,650,5,655,1147,0,3,1,3,0,1,0,76.14,57.11 ,33.33
03,002,01,009,0200,278,404,1,405,741,0,3,1,3,0,1,0,76.14,54.66 ,33.33
03,002,01,010,0201,279,138,1,139,243,0,3,1,3,0,1,0,76.14,57.20 ,33.33
03,002,01,010,0202,280,342,7,349,666,0,3,1,3,0,1,0,76.14,52.40 ,33.33
03,002,01,010,0203,281,446,4,450,861,0,3,1,3,0,1,0,76.14,52.26 ,33.33
03,002,01,010,0204,282,369,3,372,662,0,3,1,3,0,1,0,76.14,56.19 ,33.33
03,002,01,010,0205,283,295,3,298,485,0,3,1,3,0,1,0,76.14,61.44 ,33.33
03,002,01,010,0206,284,660,11,671,1180,0,3,1,3,0,1,0,76.14,56.86 ,33.33
03,002,01,010,0207,285,628,9,637,1095,0,3,1,3,0,1,0,76.14,58.17 ,33.33
03,002,01,010,0208,286,481,9,490,843,0,3,1,3,0,1,0,76.14,58.13 ,33.33
03,002,01,010,0209,287,557,3,560,1185,0,3,1,3,0,1,0,76.14,47.26 ,33.33
03,002,01,010,0210,288,729,8,737,1205,0,3,1,3,0,1,0,76.14,61.16 ,33.33
03,002,01,010,0210,289,797,13,810,1378,0,3,1,3,0,1,0,76.14,58.78 ,33.33
03,002,01,010,0211,290,360,5,365,660,0,3,1,3,0,1,0,76.14,55.30 ,33.33
03,002,01,010,0212,291,306,10,316,555,0,3,1,3,0,1,0,76.14,56.94 ,33.33
03,002,01,010,0213,292,248,1,249,468,0,3,1,3,0,1,0,76.14,53.21 ,33.33
03,002,01,010,0214,293,363,3,366,658,0,3,1,3,0,1,0,76.14,55.62 ,33.33
03,002,01,010,0215,294,644,12,656,1039,0,3,1,3,0,1,0,76.14,63.14 ,33.33
03,002,01,010,0216,295,461,4,465,790,0,3,1,3,0,1,0,76.14,58.86 ,33.33
03,002,01,010,0217,296,846,11,857,1232,0,3,1,3,0,1,0,76.14,69.56 ,33.33
03,002,01,010,0218,297,673,6,679,1075,0,3,1,3,0,1,0,76.14,63.16 ,33.33
03,002,01,011,0219,298,52,0,52,98,0,3,1,3,0,1,0,76.14,53.06 ,33.33
03,002,01,011,0220,299,46,0,46,101,0,3,1,3,0,1,0,76.14,45.54 ,33.33
03,002,01,011,0221,300,109,1,110,223,0,3,1,3,0,1,0,76.14,49.33 ,33.33
03,002,01,011,0222,301,118,2,120,222,0,3,1,3,0,1,0,76.14,54.05 ,33.33
03,002,01,011,0223,302,39,0,39,89,0,3,1,3,0,1,0,76.14,43.82 ,33.33
03,002,01,011,0224,303,27,2,29,73,0,3,1,3,0,1,0,76.14,39.73 ,33.33
03,002,01,011,0225,304,38,1,39,65,0,3,1,3,0,1,0,76.14,60.00 ,33.33
03,002,01,011,0226,305,11,0,11,14,0,3,1,3,0,1,0,76.14,78.57 ,33.33
03,002,01,011,0227,306,22,0,22,49,0,3,1,3,0,1,0,76.14,44.90 ,33.33
03,002,01,011,0228,307,27,0,27,60,0,3,1,3,0,1,0,76.14,45.00 ,33.33
03,002,01,012,0229,308,46,1,47,82,0,3,1,3,0,1,0,76.14,57.32 ,33.33
03,002,01,012,0230,309,144,3,147,299,0,3,1,3,0,1,0,76.14,49.16 ,33.33
03,002,01,012,0231,310,38,0,38,105,0,3,1,3,0,1,0,76.14,36.19 ,33.33
03,002,01,012,0232,311,32,1,33,57,0,3,1,3,0,1,0,76.14,57.89 ,33.33
03,002,01,012,0233,312,66,1,67,143,0,3,1,3,0,1,0,76.14,46.85 ,33.33
03,002,01,012,0234,313,21,0,21,41,0,3,1,3,0,1,0,76.14,51.22 ,33.33
03,002,01,012,0235,314,88,0,88,194,0,3,1,3,0,1,0,76.14,45.36 ,33.33
03,003,01,001,0001,1,955,9,964,1531,0,3,1,3,0,1,0,76.14,62.97 ,33.33
03,003,01,001,0002,2,955,11,966,1400,0,3,1,3,0,1,0,76.14,69.00 ,33.33
03,003,01,001,0003,3,600,6,606,927,0,3,1,3,0,1,0,76.14,65.37 ,33.33
03,003,01,001,0003,4,763,9,772,1234,0,3,1,3,0,1,0,76.14,62.56 ,33.33
03,003,01,001,0004,5,682,11,693,1010,0,3,1,3,0,1,0,76.14,68.61 ,33.33
03,003,01,001,0004,6,566,3,569,927,0,3,1,3,0,1,0,76.14,61.38 ,33.33
03,003,01,001,0005,7,665,12,677,1009,0,3,1,3,0,1,0,76.14,67.10 ,33.33
03,003,01,001,0006,8,844,7,851,1353,0,3,1,3,0,1,0,76.14,62.90 ,33.33
03,003,01,001,0006,9,961,12,973,1467,0,3,1,3,0,1,0,76.14,66.33 ,33.33
03,003,01,001,0007,10,821,12,833,1254,0,3,1,3,0,1,0,76.14,66.43 ,33.33
03,003,01,001,0007,11,776,6,782,1217,0,3,1,3,0,1,0,76.14,64.26 ,33.33
03,003,01,001,0007,12,667,11,678,1065,0,3,1,3,0,1,0,76.14,63.66 ,33.33
03,003,01,001,0008,13,798,7,805,1224,0,3,1,3,0,1,0,76.14,65.77 ,33.33
03,003,01,001,0008,14,680,13,693,1062,0,3,1,3,0,1,0,76.14,65.25 ,33.33
03,003,01,001,0008,15,924,16,940,1527,0,3,1,3,0,1,0,76.14,61.56 ,33.33
03,003,01,001,0009,16,940,18,958,1431,0,3,1,3,0,1,0,76.14,66.95 ,33.33
03,003,01,001,0009,17,937,16,953,1442,0,3,1,3,0,1,0,76.14,66.09 ,33.33
03,003,01,001,0009,18,1225,12,1237,1761,0,3,1,3,0,1,0,76.14,70.24 ,33.33
03,003,01,001,0010,19,903,12,915,1252,0,3,1,3,0,1,0,76.14,73.08 ,33.33
03,003,01,001,0010,20,996,16,1012,1471,0,3,1,3,0,1,0,76.14,68.80 ,33.33
03,003,01,001,0010,21,868,10,878,1335,0,3,1,3,0,1,0,76.14,65.77 ,33.33
03,003,01,001,0011,22,909,11,920,1364,0,3,1,3,0,1,0,76.14,67.45 ,33.33
03,003,01,001,0011,23,1031,8,1039,1482,0,3,1,3,0,1,0,76.14,70.11 ,33.33
03,003,01,001,0012,24,640,7,647,932,0,3,1,3,0,1,0,76.14,69.42 ,33.33
03,003,01,001,0012,25,1083,15,1098,1719,0,3,1,3,0,1,0,76.14,63.87 ,33.33
03,003,01,001,0012,26,979,17,996,1583,0,3,1,3,0,1,0,76.14,62.92 ,33.33
03,003,01,001,0013,27,567,7,574,861,0,3,1,3,0,1,0,76.14,66.67 ,33.33
03,003,01,001,0014,28,1020,7,1027,1504,0,3,1,3,0,1,0,76.14,68.28 ,33.33
03,003,01,001,0015,29,760,18,778,1154,0,3,1,3,0,1,0,76.14,67.42 ,33.33
03,003,01,001,0016,30,1179,21,1200,1843,0,3,1,3,0,1,0,76.14,65.11 ,33.33
03,003,01,001,0016,31,736,11,747,1124,0,3,1,3,0,1,0,76.14,66.46 ,33.33
03,003,01,001,0016,32,691,9,700,1075,0,3,1,3,0,1,0,76.14,65.12 ,33.33
03,003,01,001,0017,33,971,13,984,1495,0,3,1,3,0,1,0,76.14,65.82 ,33.33
03,003,01,001,0018,34,986,16,1002,1581,0,3,1,3,0,1,0,76.14,63.38 ,33.33
03,003,01,001,0018,35,1058,19,1077,1694,0,3,1,3,0,1,0,76.14,63.58 ,33.33
03,003,01,001,0018,36,830,12,842,1312,0,3,1,3,0,1,0,76.14,64.18 ,33.33
03,003,01,001,0019,37,1292,9,1301,1985,0,3,1,3,0,1,0,76.14,65.54 ,33.33
03,003,01,001,0019,38,1396,21,1417,2422,0,3,1,3,0,1,0,76.14,58.51 ,33.33
03,003,01,001,0019,39,1176,14,1190,1925,0,3,1,3,0,1,0,76.14,61.82 ,33.33
03,003,01,001,0020,40,1288,25,1313,1986,0,3,1,3,0,1,0,76.14,66.11 ,33.33
03,003,01,001,0020,41,788,7,795,1091,0,3,1,3,0,1,0,76.14,72.87 ,33.33
03,003,01,001,0021,42,766,13,779,1193,0,3,1,3,0,1,0,76.14,65.30 ,33.33
03,003,01,001,0021,43,957,19,976,1517,0,3,1,3,0,1,0,76.14,64.34 ,33.33
03,003,01,001,0021,44,898,10,908,1378,0,3,1,3,0,1,0,76.14,65.89 ,33.33
03,003,01,001,0022,45,884,13,897,1365,0,3,1,3,0,1,0,76.14,65.71 ,33.33
03,003,01,001,0022,46,827,11,838,1267,0,3,1,3,0,1,0,76.14,66.14 ,33.33
03,003,01,001,0023,47,825,8,833,1387,0,3,1,3,0,1,0,76.14,60.06 ,33.33
03,003,01,001,0023,48,847,9,856,1231,0,3,1,3,0,1,0,76.14,69.54 ,33.33
03,003,01,001,0024,49,825,10,835,1218,0,3,1,3,0,1,0,76.14,68.56 ,33.33
03,003,01,001,0024,50,815,13,828,1227,0,3,1,3,0,1,0,76.14,67.48 ,33.33
03,003,01,001,0024,51,842,15,857,1320,0,3,1,3,0,1,0,76.14,64.92 ,33.33
03,003,01,001,0025,52,582,7,589,813,0,3,1,3,0,1,0,76.14,72.45 ,33.33
03,003,01,001,0025,53,839,19,858,1256,0,3,1,3,0,1,0,76.14,68.31 ,33.33
03,003,01,001,0025,54,445,3,448,662,0,3,1,3,0,1,0,76.14,67.67 ,33.33
03,003,01,001,0026,55,968,11,979,1459,0,3,1,3,0,1,0,76.14,67.10 ,33.33
03,003,01,001,0026,56,964,10,974,1527,0,3,1,3,0,1,0,76.14,63.79 ,33.33
03,003,01,001,0026,57,886,11,897,1338,0,3,1,3,0,1,0,76.14,67.04 ,33.33
03,003,01,001,0027,58,968,16,984,1452,0,3,1,3,0,1,0,76.14,67.77 ,33.33
03,003,01,001,0027,59,968,10,978,1473,0,3,1,3,0,1,0,76.14,66.40 ,33.33
03,003,01,001,0027,60,941,11,952,1420,0,3,1,3,0,1,0,76.14,67.04 ,33.33
03,003,01,001,0028,61,840,17,857,1412,0,3,1,3,0,1,0,76.14,60.69 ,33.33
03,003,01,001,0028,62,979,15,994,1571,0,3,1,3,0,1,0,76.14,63.27 ,33.33
03,003,01,001,0028,63,774,8,782,1152,0,3,1,3,0,1,0,76.14,67.88 ,33.33
03,003,01,001,0028,64,845,10,855,1247,0,3,1,3,0,1,0,76.14,68.56 ,33.33
03,003,01,001,0029,65,617,6,623,928,0,3,1,3,0,1,0,76.14,67.13 ,33.33
03,003,01,001,0029,66,1253,20,1273,1870,0,3,1,3,0,1,0,76.14,68.07 ,33.33
03,003,01,001,0030,67,1104,28,1132,1749,0,3,1,3,0,1,0,76.14,64.72 ,33.33
03,003,01,001,0030,68,1061,23,1084,1518,0,3,1,3,0,1,0,76.14,71.41 ,33.33
03,003,01,001,0031,69,731,9,740,1131,0,3,1,3,0,1,0,76.14,65.43 ,33.33
03,003,01,001,0032,70,570,2,572,891,0,3,1,3,0,1,0,76.14,64.20 ,33.33
03,003,01,001,0032,71,655,3,658,977,0,3,1,3,0,1,0,76.14,67.35 ,33.33
03,003,01,001,0033,72,952,6,958,1520,0,3,1,3,0,1,0,76.14,63.03 ,33.33
03,003,01,001,0034,73,814,12,826,1208,0,3,1,3,0,1,0,76.14,68.38 ,33.33
03,003,01,001,0035,74,1085,25,1110,1854,0,3,1,3,0,1,0,76.14,59.87 ,33.33
03,003,01,001,0035,75,1094,9,1103,1722,0,3,1,3,0,1,0,76.14,64.05 ,33.33
03,003,01,001,0036,76,718,14,732,1213,0,3,1,3,0,1,0,76.14,60.35 ,33.33
03,003,01,001,0036,77,692,10,702,1091,0,3,1,3,0,1,0,76.14,64.34 ,33.33
03,003,01,001,0036,78,661,10,671,1096,0,3,1,3,0,1,0,76.14,61.22 ,33.33
03,003,01,001,0037,79,1116,14,1130,1744,0,3,1,3,0,1,0,76.14,64.79 ,33.33
03,003,01,001,0037,80,1193,23,1216,1896,0,3,1,3,0,1,0,76.14,64.14 ,33.33
03,003,01,001,0038,81,939,12,951,1559,0,3,1,3,0,1,0,76.14,61.00 ,33.33
03,003,01,001,0038,82,920,5,925,1421,0,3,1,3,0,1,0,76.14,65.10 ,33.33
03,003,01,001,0038,83,1125,19,1144,1772,0,3,1,3,0,1,0,76.14,64.56 ,33.33
03,003,01,001,0039,84,1301,17,1318,1876,0,3,1,3,0,1,0,76.14,70.26 ,33.33
03,003,01,001,0040,85,993,20,1013,1519,0,3,1,3,0,1,0,76.14,66.69 ,33.33
03,003,01,001,0040,86,1036,19,1055,1594,0,3,1,3,0,1,0,76.14,66.19 ,33.33
03,003,01,001,0040,87,1748,30,1778,2889,0,3,1,3,0,1,0,76.14,61.54 ,33.33
03,003,01,001,0041,88,982,13,995,1613,0,3,1,3,0,1,0,76.14,61.69 ,33.33
03,003,01,001,0041,89,796,10,806,1249,0,3,1,3,0,1,0,76.14,64.53 ,33.33
03,003,01,001,0042,90,752,9,761,1221,0,3,1,3,0,1,0,76.14,62.33 ,33.33
03,003,01,001,0042,91,1239,20,1259,1837,0,3,1,3,0,1,0,76.14,68.54 ,33.33
03,003,01,001,0043,92,754,21,775,1164,0,3,1,3,0,1,0,76.14,66.58 ,33.33
03,003,01,001,0043,93,876,33,909,1507,0,3,1,3,0,1,0,76.14,60.32 ,33.33
03,003,01,001,0044,94,943,21,964,1501,0,3,1,3,0,1,0,76.14,64.22 ,33.33
03,003,01,001,0044,95,1024,9,1033,1655,0,3,1,3,0,1,0,76.14,62.42 ,33.33
03,003,01,001,0045,96,656,13,669,1062,0,3,1,3,0,1,0,76.14,62.99 ,33.33
03,003,01,001,0045,97,799,15,814,1270,0,3,1,3,0,1,0,76.14,64.09 ,33.33
03,003,01,001,0045,98,762,14,776,1248,0,3,1,3,0,1,0,76.14,62.18 ,33.33
03,003,01,001,0046,99,1079,11,1090,1614,0,3,1,3,0,1,0,76.14,67.53 ,33.33
03,003,01,001,0047,100,1019,15,1034,1582,0,3,1,3,0,1,0,76.14,65.36 ,33.33
03,003,01,001,0048,101,842,18,860,1366,0,3,1,3,0,1,0,76.14,62.96 ,33.33
03,003,01,001,0048,102,709,12,721,1170,0,3,1,3,0,1,0,76.14,61.62 ,33.33
03,003,01,001,0048,103,951,10,961,1467,0,3,1,3,0,1,0,76.14,65.51 ,33.33
03,003,01,001,0049,104,1045,13,1058,1625,0,3,1,3,0,1,0,76.14,65.11 ,33.33
03,003,01,001,0050,105,1014,5,1019,1512,0,3,1,3,0,1,0,76.14,67.39 ,33.33
03,003,01,001,0050,106,860,10,870,1317,0,3,1,3,0,1,0,76.14,66.06 ,33.33
03,003,01,001,0051,107,1044,5,1049,1459,0,3,1,3,0,1,0,76.14,71.90 ,33.33
03,003,01,001,0051,108,822,14,836,1257,0,3,1,3,0,1,0,76.14,66.51 ,33.33
03,003,01,001,0052,109,739,12,751,1288,0,3,1,3,0,1,0,76.14,58.31 ,33.33
03,003,01,001,0052,110,843,14,857,1471,0,3,1,3,0,1,0,76.14,58.26 ,33.33
03,003,01,001,0052,111,820,9,829,1340,0,3,1,3,0,1,0,76.14,61.87 ,33.33
03,003,01,001,0053,112,589,10,599,1004,0,3,1,3,0,1,0,76.14,59.66 ,33.33
03,003,01,001,0053,113,882,19,901,1397,0,3,1,3,0,1,0,76.14,64.50 ,33.33
03,003,01,001,0053,114,753,12,765,1267,0,3,1,3,0,1,0,76.14,60.38 ,33.33
03,003,01,001,0054,115,772,14,786,1157,0,3,1,3,0,1,0,76.14,67.93 ,33.33
03,003,01,001,0054,116,790,19,809,1289,0,3,1,3,0,1,0,76.14,62.76 ,33.33
03,003,01,001,0055,117,887,17,904,1536,0,3,1,3,0,1,0,76.14,58.85 ,33.33
03,003,01,001,0055,118,678,17,695,1066,0,3,1,3,0,1,0,76.14,65.20 ,33.33
03,003,01,001,0056,119,881,11,892,1372,0,3,1,3,0,1,0,76.14,65.01 ,33.33
03,003,01,001,0056,120,890,15,905,1371,0,3,1,3,0,1,0,76.14,66.01 ,33.33
03,003,01,002,0057,121,723,9,732,1081,0,3,1,3,0,1,0,76.14,67.72 ,33.33
03,003,01,002,0057,122,902,11,913,1342,0,3,1,3,0,1,0,76.14,68.03 ,33.33
03,003,01,002,0057,123,1014,14,1028,1656,0,3,1,3,0,1,0,76.14,62.08 ,33.33
03,003,01,002,0058,124,984,19,1003,1392,0,3,1,3,0,1,0,76.14,72.05 ,33.33
03,003,01,002,0058,125,1164,18,1182,1772,0,3,1,3,0,1,0,76.14,66.70 ,33.33
03,003,01,002,0059,126,1208,19,1227,1727,0,3,1,3,0,1,0,76.14,71.05 ,33.33
03,003,01,002,0059,127,1258,13,1271,1949,0,3,1,3,0,1,0,76.14,65.21 ,33.33
03,003,01,002,0060,128,918,13,931,1455,0,3,1,3,0,1,0,76.14,63.99 ,33.33
03,003,01,002,0060,129,1107,18,1125,1734,0,3,1,3,0,1,0,76.14,64.88 ,33.33
03,003,01,002,0060,130,1139,24,1163,1776,0,3,1,3,0,1,0,76.14,65.48 ,33.33
03,003,01,002,0060,131,803,11,814,1280,0,3,1,3,0,1,0,76.14,63.59 ,33.33
03,003,01,002,0061,132,957,17,974,1228,0,3,1,3,0,1,0,76.14,79.32 ,33.33
03,003,01,002,0061,133,964,25,989,1312,0,3,1,3,0,1,0,76.14,75.38 ,33.33
03,003,01,002,0062,134,975,13,988,1319,0,3,1,3,0,1,0,76.14,74.91 ,33.33
03,003,01,002,0062,135,818,9,827,1067,0,3,1,3,0,1,0,76.14,77.51 ,33.33
03,003,01,002,0063,136,888,26,914,1423,0,3,1,3,0,1,0,76.14,64.23 ,33.33
03,003,01,002,0063,137,636,13,649,1140,0,3,1,3,0,1,0,76.14,56.93 ,33.33
03,003,01,002,0064,138,710,10,720,1255,0,3,1,3,0,1,0,76.14,57.37 ,33.33
03,003,01,002,0064,139,724,10,734,1272,0,3,1,3,0,1,0,76.14,57.70 ,33.33
03,003,01,002,0064,140,1019,18,1037,1908,0,3,1,3,0,1,0,76.14,54.35 ,33.33
03,003,01,002,0064,141,791,22,813,1442,0,3,1,3,0,1,0,76.14,56.38 ,33.33
03,003,01,002,0065,142,989,24,1013,1701,0,3,1,3,0,1,0,76.14,59.55 ,33.33
03,003,01,002,0065,143,762,24,786,1370,0,3,1,3,0,1,0,76.14,57.37 ,33.33
03,003,01,002,0065,144,777,16,793,1390,0,3,1,3,0,1,0,76.14,57.05 ,33.33
03,003,01,002,0066,145,1107,13,1120,1729,0,3,1,3,0,1,0,76.14,64.78 ,33.33
03,003,01,002,0067,146,988,11,999,1586,0,3,1,3,0,1,0,76.14,62.99 ,33.33
03,003,01,002,0067,147,922,22,944,1446,0,3,1,3,0,1,0,76.14,65.28 ,33.33
03,003,01,002,0067,148,959,25,984,1512,0,3,1,3,0,1,0,76.14,65.08 ,33.33
03,003,01,002,0068,149,1154,15,1169,1770,0,3,1,3,0,1,0,76.14,66.05 ,33.33
03,003,01,002,0068,150,827,9,836,3531,0,3,1,3,0,1,0,76.14,23.68 ,33.33
03,003,01,002,0069,151,757,9,766,1203,0,3,1,3,0,1,0,76.14,63.67 ,33.33
03,003,01,002,0069,152,786,15,801,1285,0,3,1,3,0,1,0,76.14,62.33 ,33.33
03,003,01,002,0069,153,721,16,737,1224,0,3,1,3,0,1,0,76.14,60.21 ,33.33
03,003,01,002,0069,154,725,11,736,1365,0,3,1,3,0,1,0,76.14,53.92 ,33.33
03,003,01,002,0069,155,741,16,757,1311,0,3,1,3,0,1,0,76.14,57.74 ,33.33
03,003,01,002,0070,156,1394,21,1415,2280,0,3,1,3,0,1,0,76.14,62.06 ,33.33
03,003,01,002,0070,157,1148,16,1164,1733,0,3,1,3,0,1,0,76.14,67.17 ,33.33
03,003,01,002,0071,158,1210,20,1230,2010,0,3,1,3,0,1,0,76.14,61.19 ,33.33
03,003,01,002,0072,159,1539,20,1559,2836,0,3,1,3,0,1,0,76.14,54.97 ,33.33
03,003,01,002,0073,160,665,12,677,1037,0,3,1,3,0,1,0,76.14,65.28 ,33.33
03,003,01,002,0074,161,1303,20,1323,2065,0,3,1,3,0,1,0,76.14,64.07 ,33.33
03,003,01,002,0075,162,1212,18,1230,1834,0,3,1,3,0,1,0,76.14,67.07 ,33.33
03,003,01,003,0076,163,811,15,826,1246,0,3,1,3,0,1,0,76.14,66.29 ,33.33
03,003,01,003,0076,164,680,12,692,1097,0,3,1,3,0,1,0,76.14,63.08 ,33.33
03,003,01,003,0077,165,835,14,849,1179,0,3,1,3,0,1,0,76.14,72.01 ,33.33
03,003,01,003,0077,166,738,33,771,1064,0,3,1,3,0,1,0,76.14,72.46 ,33.33
03,003,01,003,0078,167,1087,26,1113,1610,0,3,1,3,0,1,0,76.14,69.13 ,33.33
03,003,01,003,0078,168,890,12,902,1219,0,3,1,3,0,1,0,76.14,74.00 ,33.33
03,003,01,003,0079,169,857,13,870,1396,0,3,1,3,0,1,0,76.14,62.32 ,33.33
03,003,01,003,0079,170,801,11,812,1214,0,3,1,3,0,1,0,76.14,66.89 ,33.33
03,003,01,003,0080,171,999,18,1017,1412,0,3,1,3,0,1,0,76.14,72.03 ,33.33
03,003,01,003,0080,172,1136,15,1151,1613,0,3,1,3,0,1,0,76.14,71.36 ,33.33
03,003,01,003,0081,173,1074,17,1091,1527,0,3,1,3,0,1,0,76.14,71.45 ,33.33
03,003,01,003,0081,174,992,21,1013,1389,0,3,1,3,0,1,0,76.14,72.93 ,33.33
03,003,01,003,0082,175,1083,18,1101,1541,0,3,1,3,0,1,0,76.14,71.45 ,33.33
03,003,01,003,0082,176,838,10,848,1143,0,3,1,3,0,1,0,76.14,74.19 ,33.33
03,003,01,003,0083,177,1153,26,1179,1754,0,3,1,3,0,1,0,76.14,67.22 ,33.33
03,003,01,003,0083,178,1055,27,1082,1564,0,3,1,3,0,1,0,76.14,69.18 ,33.33
03,003,01,003,0084,179,1295,20,1315,1758,0,3,1,3,0,1,0,76.14,74.80 ,33.33
03,003,01,003,0084,180,519,11,530,759,0,3,1,3,0,1,0,76.14,69.83 ,33.33
03,003,01,003,0085,181,800,19,819,1184,0,3,1,3,0,1,0,76.14,69.17 ,33.33
03,003,01,003,0085,182,614,8,622,977,0,3,1,3,0,1,0,76.14,63.66 ,33.33
03,003,01,003,0086,183,1044,25,1069,1585,0,3,1,3,0,1,0,76.14,67.44 ,33.33
03,003,01,003,0086,184,833,20,853,1111,0,3,1,3,0,1,0,76.14,76.78 ,33.33
03,003,01,003,0086,185,636,15,651,928,0,3,1,3,0,1,0,76.14,70.15 ,33.33
03,003,01,003,0087,186,908,23,931,1437,0,3,1,3,0,1,0,76.14,64.79 ,33.33
03,003,01,003,0087,187,1007,20,1027,1479,0,3,1,3,0,1,0,76.14,69.44 ,33.33
03,003,01,003,0087,188,1114,23,1137,1781,0,3,1,3,0,1,0,76.14,63.84 ,33.33
03,003,01,003,0088,189,933,19,952,1387,0,3,1,3,0,1,0,76.14,68.64 ,33.33
03,003,01,003,0088,190,1033,25,1058,1677,0,3,1,3,0,1,0,76.14,63.09 ,33.33
03,003,01,003,0088,191,904,9,913,1293,0,3,1,3,0,1,0,76.14,70.61 ,33.33
03,003,01,003,0089,192,1278,33,1311,1826,0,3,1,3,0,1,0,76.14,71.80 ,33.33
03,003,01,003,0090,193,1223,20,1243,2016,0,3,1,3,0,1,0,76.14,61.66 ,33.33
03,003,01,003,0091,194,883,7,890,1267,0,3,1,3,0,1,0,76.14,70.24 ,33.33
03,003,01,003,0092,195,875,20,895,1414,0,3,1,3,0,1,0,76.14,63.30 ,33.33
03,003,01,003,0092,196,715,11,726,1088,0,3,1,3,0,1,0,76.14,66.73 ,33.33
03,003,01,003,0093,197,1094,19,1113,1832,0,3,1,3,0,1,0,76.14,60.75 ,33.33
03,003,01,003,0094,198,806,20,826,1173,0,3,1,3,0,1,0,76.14,70.42 ,33.33
03,003,01,003,0095,199,713,7,720,1059,0,3,1,3,0,1,0,76.14,67.99 ,33.33
03,003,01,003,0096,200,1034,19,1053,1645,0,3,1,3,0,1,0,76.14,64.01 ,33.33
03,003,01,003,0096,201,947,19,966,1437,0,3,1,3,0,1,0,76.14,67.22 ,33.33
03,003,01,003,0097,202,803,10,813,1171,0,3,1,3,0,1,0,76.14,69.43 ,33.33
03,003,01,003,0097,203,587,9,596,959,0,3,1,3,0,1,0,76.14,62.15 ,33.33
03,003,01,003,0097,204,909,18,927,1336,0,3,1,3,0,1,0,76.14,69.39 ,33.33
03,003,01,003,0098,205,613,7,620,1023,0,3,1,3,0,1,0,76.14,60.61 ,33.33
03,003,01,003,0098,206,770,12,782,1182,0,3,1,3,0,1,0,76.14,66.16 ,33.33
03,003,01,003,0098,207,741,12,753,1267,0,3,1,3,0,1,0,76.14,59.43 ,33.33
03,003,01,003,0098,208,768,22,790,1271,0,3,1,3,0,1,0,76.14,62.16 ,33.33
03,003,01,003,0098,209,781,25,806,1246,0,3,1,3,0,1,0,76.14,64.69 ,33.33
03,003,01,003,0099,210,609,7,616,922,0,3,1,3,0,1,0,76.14,66.81 ,33.33
03,003,01,003,0099,211,509,11,520,784,0,3,1,3,0,1,0,76.14,66.33 ,33.33
03,003,01,003,0100,212,584,14,598,860,0,3,1,3,0,1,0,76.14,69.53 ,33.33
03,003,01,003,0100,213,989,14,1003,1505,0,3,1,3,0,1,0,76.14,66.64 ,33.33
03,003,01,003,0101,214,438,9,447,566,0,3,1,3,0,1,0,76.14,78.98 ,33.33
03,003,01,003,0101,215,1045,16,1061,1507,0,3,1,3,0,1,0,76.14,70.40 ,33.33
03,003,01,003,0102,216,956,17,973,1456,0,3,1,3,0,1,0,76.14,66.83 ,33.33
03,003,01,003,0102,217,1097,19,1116,1610,0,3,1,3,0,1,0,76.14,69.32 ,33.33
03,003,01,003,0102,218,966,14,980,1451,0,3,1,3,0,1,0,76.14,67.54 ,33.33
03,003,01,003,0103,219,1085,13,1098,1563,0,3,1,3,0,1,0,76.14,70.25 ,33.33
03,003,01,003,0103,220,798,9,807,1277,0,3,1,3,0,1,0,76.14,63.19 ,33.33
03,003,01,003,0103,221,772,8,780,1161,0,3,1,3,0,1,0,76.14,67.18 ,33.33
03,003,01,003,0104,222,635,9,644,901,0,3,1,3,0,1,0,76.14,71.48 ,33.33
03,003,01,003,0104,223,614,10,624,896,0,3,1,3,0,1,0,76.14,69.64 ,33.33
03,003,01,003,0105,224,1334,18,1352,1903,0,3,1,3,0,1,0,76.14,71.05 ,33.33
03,003,01,003,0105,225,1104,15,1119,1629,0,3,1,3,0,1,0,76.14,68.69 ,33.33
03,003,01,003,0106,226,723,13,736,986,0,3,1,3,0,1,0,76.14,74.65 ,33.33
03,003,01,003,0106,227,850,15,865,1329,0,3,1,3,0,1,0,76.14,65.09 ,33.33
03,003,01,003,0107,228,1113,14,1127,1732,0,3,1,3,0,1,0,76.14,65.07 ,33.33
03,003,01,003,0107,229,535,10,545,810,0,3,1,3,0,1,0,76.14,67.28 ,33.33
03,003,01,003,0108,230,1316,22,1338,1934,0,3,1,3,0,1,0,76.14,69.18 ,33.33
03,003,01,003,0109,231,746,16,762,1158,0,3,1,3,0,1,0,76.14,65.80 ,33.33
03,003,01,003,0109,232,1085,15,1100,1580,0,3,1,3,0,1,0,76.14,69.62 ,33.33
03,003,01,004,0110,233,670,10,680,955,0,3,1,3,0,1,0,76.14,71.20 ,33.33
03,003,01,004,0110,234,897,15,912,1416,0,3,1,3,0,1,0,76.14,64.41 ,33.33
03,003,01,004,0111,235,1487,29,1516,2148,0,3,1,3,0,1,0,76.14,70.58 ,33.33
03,003,01,004,0112,236,918,14,932,1310,0,3,1,3,0,1,0,76.14,71.15 ,33.33
03,003,01,004,0112,237,692,14,706,985,0,3,1,3,0,1,0,76.14,71.68 ,33.33
03,003,01,004,0113,238,574,9,583,790,0,3,1,3,0,1,0,76.14,73.80 ,33.33
03,003,01,004,0114,239,1019,14,1033,1471,0,3,1,3,0,1,0,76.14,70.22 ,33.33
03,003,01,004,0115,240,1168,28,1196,1702,0,3,1,3,0,1,0,76.14,70.27 ,33.33
03,003,01,004,0116,241,1235,17,1252,1753,0,3,1,3,0,1,0,76.14,71.42 ,33.33
03,003,01,004,0117,242,175,2,177,221,0,3,1,3,0,1,0,76.14,80.09 ,33.33
03,003,01,004,0117,243,1293,23,1316,1640,0,3,1,3,0,1,0,76.14,80.24 ,33.33
03,003,01,004,0118,244,976,16,992,1345,0,3,1,3,0,1,0,76.14,73.75 ,33.33
03,003,01,004,0118,245,961,19,980,1321,0,3,1,3,0,1,0,76.14,74.19 ,33.33
03,003,01,004,0119,246,1215,23,1238,1816,0,3,1,3,0,1,0,76.14,68.17 ,33.33
03,003,01,004,0120,247,930,18,948,1464,0,3,1,3,0,1,0,76.14,64.75 ,33.33
03,003,01,004,0121,248,1222,29,1251,1875,0,3,1,3,0,1,0,76.14,66.72 ,33.33
03,003,01,004,0122,249,1210,25,1235,1900,0,3,1,3,0,1,0,76.14,65.00 ,33.33
03,003,01,004,0123,250,1042,22,1064,1551,0,3,1,3,0,1,0,76.14,68.60 ,33.33
03,003,01,004,0124,251,591,11,602,897,0,3,1,3,0,1,0,76.14,67.11 ,33.33
03,003,01,004,0125,252,1269,18,1287,2097,0,3,1,3,0,1,0,76.14,61.37 ,33.33
03,003,01,004,0125,253,1045,22,1067,1786,0,3,1,3,0,1,0,76.14,59.74 ,33.33
03,003,01,004,0126,254,1116,16,1132,1579,0,3,1,3,0,1,0,76.14,71.69 ,33.33
03,003,01,004,0127,255,769,12,781,1155,0,3,1,3,0,1,0,76.14,67.62 ,33.33
03,003,01,004,0128,256,1013,13,1026,1511,0,3,1,3,0,1,0,76.14,67.90 ,33.33
03,003,01,004,0129,257,822,12,834,1155,0,3,1,3,0,1,0,76.14,72.21 ,33.33
03,003,01,004,0130,258,861,17,878,1179,0,3,1,3,0,1,0,76.14,74.47 ,33.33
03,003,01,004,0130,259,1035,29,1064,1541,0,3,1,3,0,1,0,76.14,69.05 ,33.33
03,003,01,004,0131,260,1363,20,1383,1888,0,3,1,3,0,1,0,76.14,73.25 ,33.33
03,003,01,004,0132,261,878,17,895,1350,0,3,1,3,0,1,0,76.14,66.30 ,33.33
03,003,01,004,0132,262,843,14,857,1191,0,3,1,3,0,1,0,76.14,71.96 ,33.33
03,003,01,005,0133,263,1000,17,1017,1386,0,3,1,3,0,1,0,76.14,73.38 ,33.33
03,003,01,005,0133,264,1268,17,1285,1709,0,3,1,3,0,1,0,76.14,75.19 ,33.33
03,003,01,005,0133,265,1197,18,1215,1581,0,3,1,3,0,1,0,76.14,76.85 ,33.33
03,003,01,005,0134,266,1335,15,1350,1915,0,3,1,3,0,1,0,76.14,70.50 ,33.33
03,003,01,005,0134,267,1083,6,1089,1515,0,3,1,3,0,1,0,76.14,71.88 ,33.33
03,003,01,005,0135,268,692,13,705,1023,0,3,1,3,0,1,0,76.14,68.91 ,33.33
03,003,01,005,0135,269,748,13,761,1151,0,3,1,3,0,1,0,76.14,66.12 ,33.33
03,003,01,005,0136,270,968,8,976,1393,0,3,1,3,0,1,0,76.14,70.06 ,33.33
03,003,01,005,0137,271,1036,20,1056,1546,0,3,1,3,0,1,0,76.14,68.31 ,33.33
03,003,01,005,0137,272,872,12,884,1288,0,3,1,3,0,1,0,76.14,68.63 ,33.33
03,003,01,005,0137,273,952,7,959,1399,0,3,1,3,0,1,0,76.14,68.55 ,33.33
03,003,01,005,0138,274,1167,17,1184,1583,0,3,1,3,0,1,0,76.14,74.79 ,33.33
03,003,01,005,0138,275,903,18,921,1359,0,3,1,3,0,1,0,76.14,67.77 ,33.33
03,003,01,005,0139,276,807,9,816,1093,0,3,1,3,0,1,0,76.14,74.66 ,33.33
03,003,01,005,0139,277,704,11,715,1047,0,3,1,3,0,1,0,76.14,68.29 ,33.33
03,003,01,005,0139,278,1058,24,1082,1500,0,3,1,3,0,1,0,76.14,72.13 ,33.33
03,003,01,005,0140,279,877,13,890,1178,0,3,1,3,0,1,0,76.14,75.55 ,33.33
03,003,01,005,0141,280,779,12,791,984,0,3,1,3,0,1,0,76.14,80.39 ,33.33
03,003,01,005,0142,281,632,6,638,860,0,3,1,3,0,1,0,76.14,74.19 ,33.33
03,003,01,005,0142,282,1007,17,1024,1321,0,3,1,3,0,1,0,76.14,77.52 ,33.33
03,003,01,005,0143,283,1062,21,1083,1516,0,3,1,3,0,1,0,76.14,71.44 ,33.33
03,003,01,005,0143,284,1217,22,1239,1867,0,3,1,3,0,1,0,76.14,66.36 ,33.33
03,003,01,005,0144,285,629,4,633,867,0,3,1,3,0,1,0,76.14,73.01 ,33.33
03,003,01,005,0144,286,818,7,825,1201,0,3,1,3,0,1,0,76.14,68.69 ,33.33
03,003,01,005,0145,287,854,22,876,1261,0,3,1,3,0,1,0,76.14,69.47 ,33.33
03,003,01,005,0146,288,713,10,723,1032,0,3,1,3,0,1,0,76.14,70.06 ,33.33
03,003,01,005,0146,289,708,12,720,1115,0,3,1,3,0,1,0,76.14,64.57 ,33.33
03,003,01,005,0147,290,855,12,867,1244,0,3,1,3,0,1,0,76.14,69.69 ,33.33
03,003,01,005,0148,291,1160,17,1177,1683,0,3,1,3,0,1,0,76.14,69.93 ,33.33
03,003,01,005,0149,292,1125,13,1138,1609,0,3,1,3,0,1,0,76.14,70.73 ,33.33
03,003,01,005,0150,293,952,13,965,1393,0,3,1,3,0,1,0,76.14,69.27 ,33.33
03,003,01,005,0151,294,1017,9,1026,1593,0,3,1,3,0,1,0,76.14,64.41 ,33.33
03,003,01,006,0152,295,627,8,635,907,0,3,1,3,0,1,0,76.14,70.01 ,33.33
03,003,01,006,0152,296,553,4,557,803,0,3,1,3,0,1,0,76.14,69.36 ,33.33
03,003,01,006,0153,297,796,15,811,1148,0,3,1,3,0,1,0,76.14,70.64 ,33.33
03,003,01,006,0154,298,992,8,1000,1457,0,3,1,3,0,1,0,76.14,68.63 ,33.33
03,003,01,006,0154,299,830,20,850,1309,0,3,1,3,0,1,0,76.14,64.94 ,33.33
03,003,01,006,0154,300,872,18,890,1344,0,3,1,3,0,1,0,76.14,66.22 ,33.33
03,003,01,006,0154,301,909,11,920,1357,0,3,1,3,0,1,0,76.14,67.80 ,33.33
03,003,01,006,0155,302,744,13,757,1185,0,3,1,3,0,1,0,76.14,63.88 ,33.33
03,003,01,006,0155,303,732,13,745,1072,0,3,1,3,0,1,0,76.14,69.50 ,33.33
03,003,01,006,0155,304,629,6,635,1029,0,3,1,3,0,1,0,76.14,61.71 ,33.33
03,003,01,006,0156,305,644,15,659,964,0,3,1,3,0,1,0,76.14,68.36 ,33.33
03,003,01,006,0157,306,601,10,611,891,0,3,1,3,0,1,0,76.14,68.57 ,33.33
03,003,01,006,0158,307,690,11,701,993,0,3,1,3,0,1,0,76.14,70.59 ,33.33
03,003,01,006,0159,308,664,6,670,984,0,3,1,3,0,1,0,76.14,68.09 ,33.33
03,003,01,006,0159,309,403,7,410,598,0,3,1,3,0,1,0,76.14,68.56 ,33.33
03,003,01,006,0160,310,983,18,1001,1540,0,3,1,3,0,1,0,76.14,65.00 ,33.33
03,003,01,006,0160,311,383,9,392,638,0,3,1,3,0,1,0,76.14,61.44 ,33.33
03,003,01,006,0161,312,722,10,732,1121,0,3,1,3,0,1,0,76.14,65.30 ,33.33
03,003,01,006,0161,313,683,8,691,970,0,3,1,3,0,1,0,76.14,71.24 ,33.33
03,003,01,006,0162,314,586,16,602,950,0,3,1,3,0,1,0,76.14,63.37 ,33.33
03,003,01,006,0163,315,454,10,464,697,0,3,1,3,0,1,0,76.14,66.57 ,33.33
03,003,01,006,0163,316,191,1,192,306,0,3,1,3,0,1,0,76.14,62.75 ,33.33
03,003,01,006,0164,317,1038,24,1062,1544,0,3,1,3,0,1,0,76.14,68.78 ,33.33
03,003,01,006,0165,318,914,26,940,1360,0,3,1,3,0,1,0,76.14,69.12 ,33.33
03,003,01,006,0165,319,386,5,391,552,0,3,1,3,0,1,0,76.14,70.83 ,33.33
03,003,01,006,0166,320,869,18,887,1321,0,3,1,3,0,1,0,76.14,67.15 ,33.33
03,003,01,006,0166,321,605,12,617,878,0,3,1,3,0,1,0,76.14,70.27 ,33.33
03,003,01,006,0167,322,1107,13,1120,1446,0,3,1,3,0,1,0,76.14,77.46 ,33.33
03,003,01,006,0168,323,880,25,905,1257,0,3,1,3,0,1,0,76.14,72.00 ,33.33
03,003,01,006,0168,324,1005,28,1033,1434,0,3,1,3,0,1,0,76.14,72.04 ,33.33
03,003,01,006,0169,325,573,12,585,848,0,3,1,3,0,1,0,76.14,68.99 ,33.33
03,003,01,006,0169,326,692,24,716,1129,0,3,1,3,0,1,0,76.14,63.42 ,33.33
03,003,01,006,0169,327,913,8,921,1281,0,3,1,3,0,1,0,76.14,71.90 ,33.33
03,003,01,006,0170,328,757,9,766,1105,0,3,1,3,0,1,0,76.14,69.32 ,33.33
03,003,01,006,0170,329,1099,12,1111,1510,0,3,1,3,0,1,0,76.14,73.58 ,33.33
03,003,01,006,0170,330,891,21,912,1355,0,3,1,3,0,1,0,76.14,67.31 ,33.33
03,003,01,006,0170,331,885,13,898,1365,0,3,1,3,0,1,0,76.14,65.79 ,33.33
03,003,01,006,0171,332,765,16,781,1130,0,3,1,3,0,1,0,76.14,69.12 ,33.33
03,003,01,006,0171,333,821,12,833,1202,0,3,1,3,0,1,0,76.14,69.30 ,33.33
03,003,01,006,0171,334,720,22,742,1066,0,3,1,3,0,1,0,76.14,69.61 ,33.33
03,003,01,006,0172,335,897,14,911,1186,0,3,1,3,0,1,0,76.14,76.81 ,33.33
03,003,01,006,0172,336,881,9,890,1248,0,3,1,3,0,1,0,76.14,71.31 ,33.33
03,003,01,006,0172,337,808,10,818,1232,0,3,1,3,0,1,0,76.14,66.40 ,33.33
03,003,01,006,0172,338,1076,23,1099,1489,0,3,1,3,0,1,0,76.14,73.81 ,33.33
03,003,01,006,0173,339,792,11,803,1246,0,3,1,3,0,1,0,76.14,64.45 ,33.33
03,003,01,006,0173,340,815,11,826,1191,0,3,1,3,0,1,0,76.14,69.35 ,33.33
03,003,01,007,0174,341,711,12,723,1228,0,3,1,3,0,1,0,76.14,58.88 ,33.33
03,003,01,007,0175,342,411,2,413,604,0,3,1,3,0,1,0,76.14,68.38 ,33.33
03,003,01,007,0176,343,67,1,68,121,0,3,1,3,0,1,0,76.14,56.20 ,33.33
03,003,01,007,0177,344,23,0,23,41,0,3,1,3,0,1,0,76.14,56.10 ,33.33
03,003,01,007,0178,345,183,1,184,302,0,3,1,3,0,1,0,76.14,60.93 ,33.33
03,003,01,007,0179,346,23,0,23,40,0,3,1,3,0,1,0,76.14,57.50 ,33.33
03,003,01,007,0180,347,26,1,27,42,0,3,1,3,0,1,0,76.14,64.29 ,33.33
03,003,01,007,0181,348,25,1,26,53,0,3,1,3,0,1,0,76.14,49.06 ,33.33
03,003,01,007,0182,349,26,0,26,58,0,3,1,3,0,1,0,76.14,44.83 ,33.33
03,003,01,007,0183,350,89,0,89,231,0,3,1,3,0,1,0,76.14,38.53 ,33.33
03,003,01,008,0184,351,1155,21,1176,1797,0,3,1,3,0,1,0,76.14,65.44 ,33.33
03,003,01,008,0184,352,1237,25,1262,1911,0,3,1,3,0,1,0,76.14,66.04 ,33.33
03,003,01,008,0184,353,1014,7,1021,1486,0,3,1,3,0,1,0,76.14,68.71 ,33.33
03,003,01,008,0184,354,1150,13,1163,1733,0,3,1,3,0,1,0,76.14,67.11 ,33.33
03,003,01,008,0185,355,1045,20,1065,1516,0,3,1,3,0,1,0,76.14,70.25 ,33.33
03,003,01,008,0185,356,935,12,947,1394,0,3,1,3,0,1,0,76.14,67.93 ,33.33
03,003,01,008,0185,357,1027,10,1037,1442,0,3,1,3,0,1,0,76.14,71.91 ,33.33
03,003,01,008,0185,358,887,15,902,1320,0,3,1,3,0,1,0,76.14,68.33 ,33.33
03,003,01,008,0186,359,1177,16,1193,1667,0,3,1,3,0,1,0,76.14,71.57 ,33.33
03,003,01,008,0186,360,1185,29,1214,1669,0,3,1,3,0,1,0,76.14,72.74 ,33.33
03,003,01,008,0187,361,1420,21,1441,2007,0,3,1,3,0,1,0,76.14,71.80 ,33.33
03,003,01,008,0187,362,1369,25,1394,1875,0,3,1,3,0,1,0,76.14,74.35 ,33.33
03,003,01,008,0188,363,1341,27,1368,1983,0,3,1,3,0,1,0,76.14,68.99 ,33.33
03,003,01,008,0188,364,1183,25,1208,1622,0,3,1,3,0,1,0,76.14,74.48 ,33.33
03,003,01,008,0189,365,1364,28,1392,1885,0,3,1,3,0,1,0,76.14,73.85 ,33.33
03,003,01,008,0189,366,1294,28,1322,1819,0,3,1,3,0,1,0,76.14,72.68 ,33.33
03,003,01,008,0189,367,1197,15,1212,1671,0,3,1,3,0,1,0,76.14,72.53 ,33.33
03,003,01,008,0190,368,882,9,891,1260,0,3,1,3,0,1,0,76.14,70.71 ,33.33
03,003,01,008,0190,369,826,30,856,1249,0,3,1,3,0,1,0,76.14,68.53 ,33.33
03,003,01,008,0190,370,1121,20,1141,1693,0,3,1,3,0,1,0,76.14,67.40 ,33.33
03,003,01,008,0190,371,889,12,901,1229,0,3,1,3,0,1,0,76.14,73.31 ,33.33
03,003,01,008,0191,372,1006,18,1024,1522,0,3,1,3,0,1,0,76.14,67.28 ,33.33
03,003,01,008,0191,373,1003,24,1027,1523,0,3,1,3,0,1,0,76.14,67.43 ,33.33
03,003,01,008,0192,374,877,17,894,1223,0,3,1,3,0,1,0,76.14,73.10 ,33.33
03,003,01,008,0192,375,835,21,856,1299,0,3,1,3,0,1,0,76.14,65.90 ,33.33
03,003,01,008,0192,376,751,9,760,1142,0,3,1,3,0,1,0,76.14,66.55 ,33.33
03,003,01,008,0193,377,1087,15,1102,1664,0,3,1,3,0,1,0,76.14,66.23 ,33.33
03,003,01,008,0193,378,1145,21,1166,1710,0,3,1,3,0,1,0,76.14,68.19 ,33.33
03,003,01,008,0193,379,1162,22,1184,1678,0,3,1,3,0,1,0,76.14,70.56 ,33.33
03,003,01,008,0194,380,1226,21,1247,1641,0,3,1,3,0,1,0,76.14,75.99 ,33.33
03,003,01,008,0194,381,771,15,786,1059,0,3,1,3,0,1,0,76.14,74.22 ,33.33
03,003,01,008,0194,382,748,12,760,1050,0,3,1,3,0,1,0,76.14,72.38 ,33.33
03,003,01,008,0195,383,998,17,1015,1573,0,3,1,3,0,1,0,76.14,64.53 ,33.33
03,003,01,008,0195,384,1002,15,1017,1682,0,3,1,3,0,1,0,76.14,60.46 ,33.33
03,003,01,008,0195,385,760,17,777,1225,0,3,1,3,0,1,0,76.14,63.43 ,33.33
03,003,01,008,0195,386,898,12,910,1247,0,3,1,3,0,1,0,76.14,72.98 ,33.33
03,003,01,008,0195,387,818,3,821,1163,0,3,1,3,0,1,0,76.14,70.59 ,33.33
03,003,01,008,0196,388,839,11,850,1318,0,3,1,3,0,1,0,76.14,64.49 ,33.33
03,003,01,008,0196,389,713,13,726,1024,0,3,1,3,0,1,0,76.14,70.90 ,33.33
03,003,01,008,0197,390,873,14,887,1272,0,3,1,3,0,1,0,76.14,69.73 ,33.33
03,003,01,008,0197,391,949,14,963,1490,0,3,1,3,0,1,0,76.14,64.63 ,33.33
03,003,01,008,0197,392,996,16,1012,1415,0,3,1,3,0,1,0,76.14,71.52 ,33.33
03,003,01,008,0197,393,886,9,895,1329,0,3,1,3,0,1,0,76.14,67.34 ,33.33
03,003,01,008,0198,394,1290,11,1301,1961,0,3,1,3,0,1,0,76.14,66.34 ,33.33
03,003,01,008,0198,395,1450,13,1463,2248,0,3,1,3,0,1,0,76.14,65.08 ,33.33
03,003,01,008,0198,396,882,20,902,1326,0,3,1,3,0,1,0,76.14,68.02 ,33.33
03,003,01,008,0199,397,946,13,959,1447,0,3,1,3,0,1,0,76.14,66.28 ,33.33
03,003,01,008,0200,398,888,7,895,1234,0,3,1,3,0,1,0,76.14,72.53 ,33.33
03,003,01,008,0200,399,730,20,750,1136,0,3,1,3,0,1,0,76.14,66.02 ,33.33
03,003,01,008,0200,400,788,11,799,1167,0,3,1,3,0,1,0,76.14,68.47 ,33.33
03,003,01,008,0201,401,921,14,935,1303,0,3,1,3,0,1,0,76.14,71.76 ,33.33
03,003,01,008,0201,402,895,19,914,1395,0,3,1,3,0,1,0,76.14,65.52 ,33.33
03,003,01,008,0201,403,921,11,932,1404,0,3,1,3,0,1,0,76.14,66.38 ,33.33
03,003,01,008,0202,404,1089,22,1111,1514,0,3,1,3,0,1,0,76.14,73.38 ,33.33
03,003,01,008,0203,405,828,17,845,1186,0,3,1,3,0,1,0,76.14,71.25 ,33.33
03,003,01,008,0203,406,945,22,967,1344,0,3,1,3,0,1,0,76.14,71.95 ,33.33
03,003,01,008,0204,407,895,3,898,1240,0,3,1,3,0,1,0,76.14,72.42 ,33.33
03,003,01,008,0204,408,1411,21,1432,2083,0,3,1,3,0,1,0,76.14,68.75 ,33.33
03,003,01,008,0204,409,856,17,873,1275,0,3,1,3,0,1,0,76.14,68.47 ,33.33
03,003,01,008,0205,410,688,13,701,964,0,3,1,3,0,1,0,76.14,72.72 ,33.33
03,003,01,008,0205,411,878,8,886,1175,0,3,1,3,0,1,0,76.14,75.40 ,33.33
03,003,01,008,0205,412,763,13,776,1145,0,3,1,3,0,1,0,76.14,67.77 ,33.33
03,003,01,008,0205,413,1079,17,1096,1535,0,3,1,3,0,1,0,76.14,71.40 ,33.33
03,003,01,008,0206,414,1016,9,1025,1472,0,3,1,3,0,1,0,76.14,69.63 ,33.33
03,003,01,008,0206,415,962,10,972,1386,0,3,1,3,0,1,0,76.14,70.13 ,33.33
03,003,01,008,0206,416,867,14,881,1288,0,3,1,3,0,1,0,76.14,68.40 ,33.33
03,003,01,008,0206,417,989,21,1010,1463,0,3,1,3,0,1,0,76.14,69.04 ,33.33
03,003,01,008,0207,418,718,16,734,1066,0,3,1,3,0,1,0,76.14,68.86 ,33.33
03,003,01,008,0207,419,804,14,818,1207,0,3,1,3,0,1,0,76.14,67.77 ,33.33
03,003,01,008,0207,420,914,26,940,1366,0,3,1,3,0,1,0,76.14,68.81 ,33.33
03,003,01,008,0207,421,884,12,896,1361,0,3,1,3,0,1,0,76.14,65.83 ,33.33
03,003,01,008,0208,422,1054,11,1065,1366,0,3,1,3,0,1,0,76.14,77.96 ,33.33
03,003,01,008,0208,423,1088,12,1100,1465,0,3,1,3,0,1,0,76.14,75.09 ,33.33
03,003,01,008,0209,424,1153,12,1165,1539,0,3,1,3,0,1,0,76.14,75.70 ,33.33
03,003,01,008,0209,425,1045,17,1062,1398,0,3,1,3,0,1,0,76.14,75.97 ,33.33
03,003,01,008,0209,426,1052,6,1058,1462,0,3,1,3,0,1,0,76.14,72.37 ,33.33
03,003,01,008,0210,427,835,17,852,1099,0,3,1,3,0,1,0,76.14,77.53 ,33.33
03,003,01,008,0210,428,805,11,816,1199,0,3,1,3,0,1,0,76.14,68.06 ,33.33
03,003,01,008,0211,429,565,9,574,931,0,3,1,3,0,1,0,76.14,61.65 ,33.33
03,003,01,008,0211,430,648,15,663,1108,0,3,1,3,0,1,0,76.14,59.84 ,33.33
03,003,01,008,0212,431,819,15,834,1227,0,3,1,3,0,1,0,76.14,67.97 ,33.33
03,003,01,008,0212,432,667,8,675,1040,0,3,1,3,0,1,0,76.14,64.90 ,33.33
03,003,01,008,0212,433,817,8,825,1201,0,3,1,3,0,1,0,76.14,68.69 ,33.33
03,003,01,008,0213,434,856,16,872,1276,0,3,1,3,0,1,0,76.14,68.34 ,33.33
03,003,01,008,0213,435,1041,17,1058,1507,0,3,1,3,0,1,0,76.14,70.21 ,33.33
03,003,01,008,0213,436,850,8,858,1277,0,3,1,3,0,1,0,76.14,67.19 ,33.33
03,003,01,008,0214,437,599,7,606,853,0,3,1,3,0,1,0,76.14,71.04 ,33.33
03,003,01,008,0214,438,866,21,887,1279,0,3,1,3,0,1,0,76.14,69.35 ,33.33
03,003,01,008,0214,439,867,19,886,1236,0,3,1,3,0,1,0,76.14,71.68 ,33.33
03,003,01,008,0215,440,1023,14,1037,1522,0,3,1,3,0,1,0,76.14,68.13 ,33.33
03,003,01,008,0215,441,1064,11,1075,1610,0,3,1,3,0,1,0,76.14,66.77 ,33.33
03,003,01,008,0215,442,1051,12,1063,1566,0,3,1,3,0,1,0,76.14,67.88 ,33.33
03,003,01,008,0216,443,963,15,978,1410,0,3,1,3,0,1,0,76.14,69.36 ,33.33
03,003,01,008,0216,444,1225,10,1235,1902,0,3,1,3,0,1,0,76.14,64.93 ,33.33
03,003,01,008,0217,445,943,15,958,1441,0,3,1,3,0,1,0,76.14,66.48 ,33.33
03,003,01,008,0217,446,901,12,913,1512,0,3,1,3,0,1,0,76.14,60.38 ,33.33
03,003,01,008,0217,447,1051,10,1061,1753,0,3,1,3,0,1,0,76.14,60.52 ,33.33
03,003,01,008,0217,448,893,21,914,1529,0,3,1,3,0,1,0,76.14,59.78 ,33.33
03,003,01,008,0217,449,808,8,816,1201,0,3,1,3,0,1,0,76.14,67.94 ,33.33
03,003,01,008,0217,450,663,8,671,1042,0,3,1,3,0,1,0,76.14,64.40 ,33.33
03,003,01,008,0217,451,924,14,938,1265,0,3,1,3,0,1,0,76.14,74.15 ,33.33
03,003,01,008,0218,452,920,9,929,1283,0,3,1,3,0,1,0,76.14,72.41 ,33.33
03,003,01,008,0219,453,1189,15,1204,1762,0,3,1,3,0,1,0,76.14,68.33 ,33.33
03,003,01,008,0220,454,980,18,998,1493,0,3,1,3,0,1,0,76.14,66.85 ,33.33
03,003,01,008,0221,455,855,9,864,1359,0,3,1,3,0,1,0,76.14,63.58 ,33.33
03,003,01,008,0221,456,915,10,925,1357,0,3,1,3,0,1,0,76.14,68.17 ,33.33
03,003,01,008,0221,457,985,8,993,1482,0,3,1,3,0,1,0,76.14,67.00 ,33.33
03,003,01,008,0222,458,711,6,717,991,0,3,1,3,0,1,0,76.14,72.35 ,33.33
03,003,01,008,0222,459,872,21,893,1294,0,3,1,3,0,1,0,76.14,69.01 ,33.33
03,003,01,008,0223,460,689,14,703,1099,0,3,1,3,0,1,0,76.14,63.97 ,33.33
03,003,01,008,0224,461,644,11,655,979,0,3,1,3,0,1,0,76.14,66.91 ,33.33
03,003,01,008,0225,462,752,6,758,1190,0,3,1,3,0,1,0,76.14,63.70 ,33.33
03,003,01,008,0226,463,803,2,805,1145,0,3,1,3,0,1,0,76.14,70.31 ,33.33
03,003,01,008,0227,464,865,9,874,1249,0,3,1,3,0,1,0,76.14,69.98 ,33.33
03,003,01,008,0227,465,750,10,760,1027,0,3,1,3,0,1,0,76.14,74.00 ,33.33
03,003,01,008,0228,466,762,14,776,1131,0,3,1,3,0,1,0,76.14,68.61 ,33.33
03,003,01,008,0228,467,753,13,766,1126,0,3,1,3,0,1,0,76.14,68.03 ,33.33
03,003,01,008,0228,468,833,6,839,1271,0,3,1,3,0,1,0,76.14,66.01 ,33.33
03,003,01,008,0229,469,810,14,824,1254,0,3,1,3,0,1,0,76.14,65.71 ,33.33
03,003,01,008,0229,470,909,10,919,1329,0,3,1,3,0,1,0,76.14,69.15 ,33.33
03,003,01,008,0229,471,1024,11,1035,1564,0,3,1,3,0,1,0,76.14,66.18 ,33.33
03,003,01,008,0230,472,751,15,766,1108,0,3,1,3,0,1,0,76.14,69.13 ,33.33
03,003,01,008,0230,473,986,7,993,1508,0,3,1,3,0,1,0,76.14,65.85 ,33.33
03,003,01,008,0231,474,744,11,755,1101,0,3,1,3,0,1,0,76.14,68.57 ,33.33
03,003,01,008,0231,475,783,14,797,1208,0,3,1,3,0,1,0,76.14,65.98 ,33.33
03,003,01,008,0232,476,676,16,692,1077,0,3,1,3,0,1,0,76.14,64.25 ,33.33
03,003,01,008,0232,477,646,11,657,966,0,3,1,3,0,1,0,76.14,68.01 ,33.33
03,003,01,008,0232,478,1032,20,1052,1686,0,3,1,3,0,1,0,76.14,62.40 ,33.33
03,003,01,008,0232,479,952,18,970,1490,0,3,1,3,0,1,0,76.14,65.10 ,33.33
03,003,01,008,0232,480,1011,16,1027,1497,0,3,1,3,0,1,0,76.14,68.60 ,33.33
03,003,01,008,0233,481,1280,19,1299,1776,0,3,1,3,0,1,0,76.14,73.14 ,33.33
03,003,01,008,0234,482,905,28,933,1277,0,3,1,3,0,1,0,76.14,73.06 ,33.33
03,003,01,008,0235,483,1006,15,1021,1507,0,3,1,3,0,1,0,76.14,67.75 ,33.33
03,003,01,008,0235,484,848,12,860,1288,0,3,1,3,0,1,0,76.14,66.77 ,33.33
03,003,01,008,0236,485,740,9,749,1079,0,3,1,3,0,1,0,76.14,69.42 ,33.33
03,003,01,008,0236,486,934,11,945,1303,0,3,1,3,0,1,0,76.14,72.52 ,33.33
03,003,01,008,0237,487,912,21,933,1299,0,3,1,3,0,1,0,76.14,71.82 ,33.33
03,003,01,008,0237,488,732,14,746,1099,0,3,1,3,0,1,0,76.14,67.88 ,33.33
03,003,01,008,0238,489,744,7,751,1087,0,3,1,3,0,1,0,76.14,69.09 ,33.33
03,003,01,008,0238,490,701,9,710,1018,0,3,1,3,0,1,0,76.14,69.74 ,33.33
03,003,01,009,0239,491,1032,11,1043,1521,0,3,1,3,0,1,0,76.14,68.57 ,33.33
03,003,01,009,0239,492,1026,19,1045,1500,0,3,1,3,0,1,0,76.14,69.67 ,33.33
03,003,01,009,0240,493,896,23,919,1256,0,3,1,3,0,1,0,76.14,73.17 ,33.33
03,003,01,009,0240,494,996,16,1012,1457,0,3,1,3,0,1,0,76.14,69.46 ,33.33
03,003,01,009,0241,495,675,5,680,1005,0,3,1,3,0,1,0,76.14,67.66 ,33.33
03,003,01,009,0241,496,862,14,876,1395,0,3,1,3,0,1,0,76.14,62.80 ,33.33
03,003,01,009,0242,497,1187,21,1208,1728,0,3,1,3,0,1,0,76.14,69.91 ,33.33
03,003,01,009,0243,498,1106,16,1122,1581,0,3,1,3,0,1,0,76.14,70.97 ,33.33
03,003,01,009,0244,499,754,5,759,1076,0,3,1,3,0,1,0,76.14,70.54 ,33.33
03,003,01,009,0244,500,713,9,722,1008,0,3,1,3,0,1,0,76.14,71.63 ,33.33
03,003,01,009,0245,501,873,14,887,1333,0,3,1,3,0,1,0,76.14,66.54 ,33.33
03,003,01,009,0245,502,651,8,659,922,0,3,1,3,0,1,0,76.14,71.48 ,33.33
03,003,01,009,0246,503,1106,9,1115,1481,0,3,1,3,0,1,0,76.14,75.29 ,33.33
03,003,01,009,0247,504,1013,12,1025,1464,0,3,1,3,0,1,0,76.14,70.01 ,33.33
03,003,01,009,0247,505,948,20,968,1370,0,3,1,3,0,1,0,76.14,70.66 ,33.33
03,003,01,009,0248,506,808,7,815,1146,0,3,1,3,0,1,0,76.14,71.12 ,33.33
03,003,01,009,0248,507,936,14,950,1284,0,3,1,3,0,1,0,76.14,73.99 ,33.33
03,003,01,009,0249,508,1325,19,1344,1927,0,3,1,3,0,1,0,76.14,69.75 ,33.33
03,003,01,009,0250,509,878,25,903,1269,0,3,1,3,0,1,0,76.14,71.16 ,33.33
03,003,01,009,0250,510,782,23,805,1122,0,3,1,3,0,1,0,76.14,71.75 ,33.33
03,003,01,009,0251,511,1032,17,1049,1455,0,3,1,3,0,1,0,76.14,72.10 ,33.33
03,003,01,009,0251,512,967,18,985,1321,0,3,1,3,0,1,0,76.14,74.56 ,33.33
03,003,01,009,0252,513,750,20,770,1052,0,3,1,3,0,1,0,76.14,73.19 ,33.33
03,003,01,009,0252,514,763,19,782,1165,0,3,1,3,0,1,0,76.14,67.12 ,33.33
03,003,01,009,0253,515,963,26,989,1339,0,3,1,3,0,1,0,76.14,73.86 ,33.33
03,003,01,009,0254,516,903,12,915,1198,0,3,1,3,0,1,0,76.14,76.38 ,33.33
03,003,01,009,0255,517,1100,26,1126,1425,0,3,1,3,0,1,0,76.14,79.02 ,33.33
03,003,01,009,0255,518,737,15,752,992,0,3,1,3,0,1,0,76.14,75.81 ,33.33
03,003,01,009,0256,519,824,19,843,1237,0,3,1,3,0,1,0,76.14,68.15 ,33.33
03,003,01,009,0256,520,931,9,940,1322,0,3,1,3,0,1,0,76.14,71.10 ,33.33
03,003,01,009,0257,521,898,26,924,1305,0,3,1,3,0,1,0,76.14,70.80 ,33.33
03,003,01,009,0257,522,850,15,865,1200,0,3,1,3,0,1,0,76.14,72.08 ,33.33
03,003,01,009,0258,523,1335,25,1360,1917,0,3,1,3,0,1,0,76.14,70.94 ,33.33
03,003,01,009,0259,524,1510,35,1545,2217,0,3,1,3,0,1,0,76.14,69.69 ,33.33
03,003,01,009,0260,525,730,14,744,1017,0,3,1,3,0,1,0,76.14,73.16 ,33.33
03,003,01,009,0260,526,718,9,727,987,0,3,1,3,0,1,0,76.14,73.66 ,33.33
03,003,01,009,0260,527,598,11,609,994,0,3,1,3,0,1,0,76.14,61.27 ,33.33
03,003,01,009,0261,528,881,13,894,1256,0,3,1,3,0,1,0,76.14,71.18 ,33.33
03,003,01,009,0261,529,880,17,897,1266,0,3,1,3,0,1,0,76.14,70.85 ,33.33
03,003,01,009,0261,530,787,17,804,1237,0,3,1,3,0,1,0,76.14,65.00 ,33.33
03,003,01,009,0262,531,895,18,913,1273,0,3,1,3,0,1,0,76.14,71.72 ,33.33
03,003,01,009,0263,532,915,10,925,1275,0,3,1,3,0,1,0,76.14,72.55 ,33.33
03,003,01,009,0263,533,871,23,894,1229,0,3,1,3,0,1,0,76.14,72.74 ,33.33
03,003,01,009,0263,534,965,27,992,1412,0,3,1,3,0,1,0,76.14,70.25 ,33.33
03,003,01,009,0264,535,722,10,732,1100,0,3,1,3,0,1,0,76.14,66.55 ,33.33
03,003,01,009,0264,536,808,13,821,1229,0,3,1,3,0,1,0,76.14,66.80 ,33.33
03,003,01,009,0265,537,1028,18,1046,1499,0,3,1,3,0,1,0,76.14,69.78 ,33.33
03,003,01,009,0265,538,1041,14,1055,1525,0,3,1,3,0,1,0,76.14,69.18 ,33.33
03,003,01,009,0266,539,1068,9,1077,1565,0,3,1,3,0,1,0,76.14,68.82 ,33.33
03,003,01,009,0266,540,767,9,776,1135,0,3,1,3,0,1,0,76.14,68.37 ,33.33
03,003,01,009,0267,541,749,12,761,1220,0,3,1,3,0,1,0,76.14,62.38 ,33.33
03,003,01,009,0267,542,742,12,754,1094,0,3,1,3,0,1,0,76.14,68.92 ,33.33
03,003,01,009,0267,543,1016,22,1038,1593,0,3,1,3,0,1,0,76.14,65.16 ,33.33
03,003,01,009,0268,544,866,20,886,1279,0,3,1,3,0,1,0,76.14,69.27 ,33.33
03,003,01,009,0268,545,824,13,837,1281,0,3,1,3,0,1,0,76.14,65.34 ,33.33
03,003,01,009,0268,546,778,16,794,1135,0,3,1,3,0,1,0,76.14,69.96 ,33.33
03,003,01,009,0269,547,850,12,862,1286,0,3,1,3,0,1,0,76.14,67.03 ,33.33
03,003,01,009,0269,548,891,18,909,1396,0,3,1,3,0,1,0,76.14,65.11 ,33.33
03,003,01,009,0270,549,1000,15,1015,1545,0,3,1,3,0,1,0,76.14,65.70 ,33.33
03,003,01,009,0270,550,581,14,595,840,0,3,1,3,0,1,0,76.14,70.83 ,33.33
03,003,01,009,0271,551,657,13,670,997,0,3,1,3,0,1,0,76.14,67.20 ,33.33
03,003,01,009,0271,552,625,19,644,982,0,3,1,3,0,1,0,76.14,65.58 ,33.33
03,003,01,009,0271,553,589,8,597,1040,0,3,1,3,0,1,0,76.14,57.40 ,33.33
03,003,01,009,0272,554,978,23,1001,1439,0,3,1,3,0,1,0,76.14,69.56 ,33.33
03,003,01,009,0272,555,1111,17,1128,1645,0,3,1,3,0,1,0,76.14,68.57 ,33.33
03,003,01,009,0273,556,694,8,702,1056,0,3,1,3,0,1,0,76.14,66.48 ,33.33
03,003,01,009,0273,557,702,5,707,1063,0,3,1,3,0,1,0,76.14,66.51 ,33.33
03,003,01,009,0274,558,992,22,1014,1485,0,3,1,3,0,1,0,76.14,68.28 ,33.33
03,003,01,009,0274,559,999,24,1023,1417,0,3,1,3,0,1,0,76.14,72.19 ,33.33
03,003,01,009,0275,560,763,19,782,1114,0,3,1,3,0,1,0,76.14,70.20 ,33.33
03,003,01,009,0275,561,590,6,596,817,0,3,1,3,0,1,0,76.14,72.95 ,33.33
03,003,01,009,0276,562,962,17,979,1514,0,3,1,3,0,1,0,76.14,64.66 ,33.33
03,003,01,009,0276,563,798,17,815,1288,0,3,1,3,0,1,0,76.14,63.28 ,33.33
03,003,01,009,0276,564,812,19,831,1170,0,3,1,3,0,1,0,76.14,71.03 ,33.33
03,003,01,009,0276,565,913,11,924,1307,0,3,1,3,0,1,0,76.14,70.70 ,33.33
03,003,01,009,0277,566,904,9,913,1373,0,3,1,3,0,1,0,76.14,66.50 ,33.33
03,003,01,009,0277,567,954,13,967,1400,0,3,1,3,0,1,0,76.14,69.07 ,33.33
03,003,01,009,0278,568,528,7,535,734,0,3,1,3,0,1,0,76.14,72.89 ,33.33
03,003,01,009,0278,569,776,21,797,1062,0,3,1,3,0,1,0,76.14,75.05 ,33.33
03,003,01,009,0279,570,727,18,745,1133,0,3,1,3,0,1,0,76.14,65.75 ,33.33
03,003,01,009,0279,571,751,11,762,1049,0,3,1,3,0,1,0,76.14,72.64 ,33.33
03,003,01,010,0280,572,754,10,764,1154,0,3,1,3,0,1,0,76.14,66.20 ,33.33
03,003,01,010,0280,573,1059,13,1072,1474,0,3,1,3,0,1,0,76.14,72.73 ,33.33
03,003,01,010,0280,574,734,19,753,1041,0,3,1,3,0,1,0,76.14,72.33 ,33.33
03,003,01,010,0281,575,1125,19,1144,1580,0,3,1,3,0,1,0,76.14,72.41 ,33.33
03,003,01,010,0282,576,907,18,925,1244,0,3,1,3,0,1,0,76.14,74.36 ,33.33
03,003,01,010,0282,577,854,16,870,1241,0,3,1,3,0,1,0,76.14,70.10 ,33.33
03,003,01,010,0283,578,723,13,736,940,0,3,1,3,0,1,0,76.14,78.30 ,33.33
03,003,01,010,0283,579,524,11,535,721,0,3,1,3,0,1,0,76.14,74.20 ,33.33
03,003,01,010,0284,580,615,9,624,839,0,3,1,3,0,1,0,76.14,74.37 ,33.33
03,003,01,010,0284,581,652,7,659,883,0,3,1,3,0,1,0,76.14,74.63 ,33.33
03,003,01,010,0285,582,798,6,804,1303,0,3,1,3,0,1,0,76.14,61.70 ,33.33
03,003,01,010,0285,583,784,23,807,1288,0,3,1,3,0,1,0,76.14,62.66 ,33.33
03,003,01,010,0285,584,848,15,863,1257,0,3,1,3,0,1,0,76.14,68.66 ,33.33
03,003,01,010,0285,585,929,14,943,1421,0,3,1,3,0,1,0,76.14,66.36 ,33.33
03,003,01,010,0286,586,895,12,907,1352,0,3,1,3,0,1,0,76.14,67.09 ,33.33
03,003,01,010,0286,587,468,3,471,736,0,3,1,3,0,1,0,76.14,63.99 ,33.33
03,003,01,010,0286,588,686,9,695,1258,0,3,1,3,0,1,0,76.14,55.25 ,33.33
03,003,01,010,0286,589,1038,26,1064,1647,0,3,1,3,0,1,0,76.14,64.60 ,33.33
03,003,01,010,0287,590,849,16,865,1153,0,3,1,3,0,1,0,76.14,75.02 ,33.33
03,003,01,010,0287,591,822,15,837,1261,0,3,1,3,0,1,0,76.14,66.38 ,33.33
03,003,01,010,0287,592,918,10,928,1317,0,3,1,3,0,1,0,76.14,70.46 ,33.33
03,003,01,010,0288,593,1009,9,1018,1406,0,3,1,3,0,1,0,76.14,72.40 ,33.33
03,003,01,010,0288,594,941,13,954,1339,0,3,1,3,0,1,0,76.14,71.25 ,33.33
03,003,01,010,0289,595,794,7,801,1140,0,3,1,3,0,1,0,76.14,70.26 ,33.33
03,003,01,010,0290,596,1044,19,1063,1639,0,3,1,3,0,1,0,76.14,64.86 ,33.33
03,003,01,010,0291,597,628,11,639,961,0,3,1,3,0,1,0,76.14,66.49 ,33.33
03,003,01,010,0291,598,753,14,767,1086,0,3,1,3,0,1,0,76.14,70.63 ,33.33
03,003,01,010,0292,599,1028,16,1044,1462,0,3,1,3,0,1,0,76.14,71.41 ,33.33
03,003,01,010,0292,600,1009,18,1027,1442,0,3,1,3,0,1,0,76.14,71.22 ,33.33
03,003,01,010,0293,601,861,14,875,1250,0,3,1,3,0,1,0,76.14,70.00 ,33.33
03,003,01,010,0293,602,923,13,936,1321,0,3,1,3,0,1,0,76.14,70.86 ,33.33
03,003,01,010,0293,603,897,24,921,1289,0,3,1,3,0,1,0,76.14,71.45 ,33.33
03,003,01,010,0293,604,884,15,899,1383,0,3,1,3,0,1,0,76.14,65.00 ,33.33
03,003,01,010,0294,605,998,16,1014,1406,0,3,1,3,0,1,0,76.14,72.12 ,33.33
03,003,01,010,0295,606,942,19,961,1440,0,3,1,3,0,1,0,76.14,66.74 ,33.33
03,003,01,010,0295,607,868,12,880,1281,0,3,1,3,0,1,0,76.14,68.70 ,33.33
03,003,01,010,0296,608,890,13,903,1290,0,3,1,3,0,1,0,76.14,70.00 ,33.33
03,003,01,010,0296,609,858,13,871,1250,0,3,1,3,0,1,0,76.14,69.68 ,33.33
03,003,01,010,0296,610,821,18,839,1304,0,3,1,3,0,1,0,76.14,64.34 ,33.33
03,003,01,010,0297,611,956,21,977,1488,0,3,1,3,0,1,0,76.14,65.66 ,33.33
03,003,01,010,0298,612,1035,14,1049,1497,0,3,1,3,0,1,0,76.14,70.07 ,33.33
03,003,01,010,0299,613,741,24,765,1188,0,3,1,3,0,1,0,76.14,64.39 ,33.33
03,003,01,010,0299,614,724,14,738,1159,0,3,1,3,0,1,0,76.14,63.68 ,33.33
03,003,01,010,0300,615,667,13,680,1027,0,3,1,3,0,1,0,76.14,66.21 ,33.33
03,003,01,010,0300,616,525,9,534,815,0,3,1,3,0,1,0,76.14,65.52 ,33.33
03,003,01,010,0301,617,604,9,613,1001,0,3,1,3,0,1,0,76.14,61.24 ,33.33
03,003,01,010,0301,618,625,9,634,1049,0,3,1,3,0,1,0,76.14,60.44 ,33.33
03,003,01,010,0301,619,825,30,855,1299,0,3,1,3,0,1,0,76.14,65.82 ,33.33
03,003,01,010,0302,620,997,19,1016,1471,0,3,1,3,0,1,0,76.14,69.07 ,33.33
03,003,01,010,0302,621,542,14,556,981,0,3,1,3,0,1,0,76.14,56.68 ,33.33
03,003,01,010,0302,622,760,10,770,1110,0,3,1,3,0,1,0,76.14,69.37 ,33.33
03,003,01,010,0302,623,526,11,537,810,0,3,1,3,0,1,0,76.14,66.30 ,33.33
03,003,01,010,0303,624,931,18,949,1356,0,3,1,3,0,1,0,76.14,69.99 ,33.33
03,003,01,010,0303,625,882,15,897,1322,0,3,1,3,0,1,0,76.14,67.85 ,33.33
03,003,01,010,0304,626,854,18,872,1254,0,3,1,3,0,1,0,76.14,69.54 ,33.33
03,003,01,010,0304,627,772,18,790,1264,0,3,1,3,0,1,0,76.14,62.50 ,33.33
03,003,01,011,0305,628,1191,11,1202,1795,0,3,1,3,0,1,0,76.14,66.96 ,33.33
03,003,01,011,0305,629,998,24,1022,1531,0,3,1,3,0,1,0,76.14,66.75 ,33.33
03,003,01,011,0305,630,972,17,989,1446,0,3,1,3,0,1,0,76.14,68.40 ,33.33
03,003,01,011,0306,631,1244,9,1253,1680,0,3,1,3,0,1,0,76.14,74.58 ,33.33
03,003,01,011,0306,632,1013,15,1028,1435,0,3,1,3,0,1,0,76.14,71.64 ,33.33
03,003,01,011,0307,633,902,21,923,1353,0,3,1,3,0,1,0,76.14,68.22 ,33.33
03,003,01,011,0307,634,942,18,960,1398,0,3,1,3,0,1,0,76.14,68.67 ,33.33
03,003,01,011,0307,635,1029,18,1047,1496,0,3,1,3,0,1,0,76.14,69.99 ,33.33
03,003,01,011,0308,636,574,11,585,735,0,3,1,3,0,1,0,76.14,79.59 ,33.33
03,003,01,011,0309,637,1178,13,1191,1606,0,3,1,3,0,1,0,76.14,74.16 ,33.33
03,003,01,011,0309,638,1092,18,1110,1690,0,3,1,3,0,1,0,76.14,65.68 ,33.33
03,003,01,011,0309,639,949,11,960,1389,0,3,1,3,0,1,0,76.14,69.11 ,33.33
03,003,01,011,0310,640,713,12,725,1101,0,3,1,3,0,1,0,76.14,65.85 ,33.33
03,003,01,011,0310,641,575,13,588,929,0,3,1,3,0,1,0,76.14,63.29 ,33.33
03,003,01,011,0310,642,708,14,722,1111,0,3,1,3,0,1,0,76.14,64.99 ,33.33
03,003,01,011,0310,643,813,11,824,1179,0,3,1,3,0,1,0,76.14,69.89 ,33.33
03,003,01,011,0311,644,1329,30,1359,1979,0,3,1,3,0,1,0,76.14,68.67 ,33.33
03,003,01,011,0312,645,728,2,730,1004,0,3,1,3,0,1,0,76.14,72.71 ,33.33
03,003,01,011,0312,646,761,10,771,1018,0,3,1,3,0,1,0,76.14,75.74 ,33.33
03,003,01,011,0313,647,1172,15,1187,1550,0,3,1,3,0,1,0,76.14,76.58 ,33.33
03,003,01,011,0313,648,1471,29,1500,2211,0,3,1,3,0,1,0,76.14,67.84 ,33.33
03,003,01,011,0313,649,1057,21,1078,1522,0,3,1,3,0,1,0,76.14,70.83 ,33.33
03,003,01,011,0314,650,983,18,1001,1503,0,3,1,3,0,1,0,76.14,66.60 ,33.33
03,003,01,011,0314,651,1283,30,1313,1994,0,3,1,3,0,1,0,76.14,65.85 ,33.33
03,003,01,011,0315,652,871,10,881,1207,0,3,1,3,0,1,0,76.14,72.99 ,33.33
03,003,01,011,0315,653,1142,25,1167,1650,0,3,1,3,0,1,0,76.14,70.73 ,33.33
03,003,01,011,0315,654,1151,34,1185,1748,0,3,1,3,0,1,0,76.14,67.79 ,33.33
03,003,01,011,0315,655,1168,29,1197,1880,0,3,1,3,0,1,0,76.14,63.67 ,33.33
03,003,01,011,0316,656,1059,6,1065,1516,0,3,1,3,0,1,0,76.14,70.25 ,33.33
03,003,01,011,0316,657,914,12,926,1193,0,3,1,3,0,1,0,76.14,77.62 ,33.33
03,003,01,011,0317,658,840,14,854,1264,0,3,1,3,0,1,0,76.14,67.56 ,33.33
03,003,01,011,0318,659,488,7,495,759,0,3,1,3,0,1,0,76.14,65.22 ,33.33
03,003,01,011,0319,660,1115,9,1124,1537,0,3,1,3,0,1,0,76.14,73.13 ,33.33
03,003,01,011,0319,661,1093,11,1104,1498,0,3,1,3,0,1,0,76.14,73.70 ,33.33
03,003,01,011,0319,662,1140,13,1153,1555,0,3,1,3,0,1,0,76.14,74.15 ,33.33
03,003,01,011,0319,663,993,15,1008,1417,0,3,1,3,0,1,0,76.14,71.14 ,33.33
03,003,01,011,0320,664,1211,23,1234,1810,0,3,1,3,0,1,0,76.14,68.18 ,33.33
03,003,01,011,0321,665,1253,23,1276,1855,0,3,1,3,0,1,0,76.14,68.79 ,33.33
03,003,01,011,0322,666,579,13,592,818,0,3,1,3,0,1,0,76.14,72.37 ,33.33
03,003,01,011,0323,667,492,8,500,653,0,3,1,3,0,1,0,76.14,76.57 ,33.33
03,003,01,012,0324,668,898,11,909,1230,0,3,1,3,0,1,0,76.14,73.90 ,33.33
03,003,01,012,0324,669,728,6,734,1027,0,3,1,3,0,1,0,76.14,71.47 ,33.33
03,003,01,012,0325,670,878,10,888,1186,0,3,1,3,0,1,0,76.14,74.87 ,33.33
03,003,01,012,0325,671,1051,11,1062,1429,0,3,1,3,0,1,0,76.14,74.32 ,33.33
03,003,01,012,0326,672,757,10,767,1036,0,3,1,3,0,1,0,76.14,74.03 ,33.33
03,003,01,012,0327,673,926,16,942,1271,0,3,1,3,0,1,0,76.14,74.11 ,33.33
03,003,01,012,0327,674,791,8,799,1158,0,3,1,3,0,1,0,76.14,69.00 ,33.33
03,003,01,012,0328,675,1109,13,1122,1525,0,3,1,3,0,1,0,76.14,73.57 ,33.33
03,003,01,012,0329,676,742,10,752,1017,0,3,1,3,0,1,0,76.14,73.94 ,33.33
03,003,01,012,0330,677,972,12,984,1303,0,3,1,3,0,1,0,76.14,75.52 ,33.33
03,003,01,012,0331,678,1190,22,1212,1783,0,3,1,3,0,1,0,76.14,67.98 ,33.33
03,003,01,012,0332,679,1088,15,1103,1565,0,3,1,3,0,1,0,76.14,70.48 ,33.33
03,003,01,012,0333,680,1014,23,1037,1475,0,3,1,3,0,1,0,76.14,70.31 ,33.33
03,003,01,012,0333,681,690,11,701,1018,0,3,1,3,0,1,0,76.14,68.86 ,33.33
03,003,01,012,0334,682,953,9,962,1370,0,3,1,3,0,1,0,76.14,70.22 ,33.33
03,003,01,012,0335,683,1110,10,1120,1536,0,3,1,3,0,1,0,76.14,72.92 ,33.33
03,003,01,012,0336,684,749,16,765,1127,0,3,1,3,0,1,0,76.14,67.88 ,33.33
03,003,01,012,0337,685,527,11,538,796,0,3,1,3,0,1,0,76.14,67.59 ,33.33
03,003,01,012,0338,686,473,6,479,716,0,3,1,3,0,1,0,76.14,66.90 ,33.33
03,003,01,012,0339,687,725,2,727,1079,0,3,1,3,0,1,0,76.14,67.38 ,33.33
03,003,01,012,0340,688,771,18,789,1102,0,3,1,3,0,1,0,76.14,71.60 ,33.33
03,003,01,012,0341,689,602,4,606,862,0,3,1,3,0,1,0,76.14,70.30 ,33.33
03,003,01,012,0341,690,883,5,888,1201,0,3,1,3,0,1,0,76.14,73.94 ,33.33
03,003,01,012,0342,691,546,5,551,939,0,3,1,3,0,1,0,76.14,58.68 ,33.33
03,003,01,012,0343,692,501,10,511,737,0,3,1,3,0,1,0,76.14,69.34 ,33.33
03,003,01,012,0344,693,594,5,599,827,0,3,1,3,0,1,0,76.14,72.43 ,33.33
03,003,01,012,0345,694,1022,12,1034,1433,0,3,1,3,0,1,0,76.14,72.16 ,33.33
03,003,01,012,0346,695,728,16,744,1032,0,3,1,3,0,1,0,76.14,72.09 ,33.33
03,003,01,013,0347,696,732,12,744,1042,0,3,1,3,0,1,0,76.14,71.40 ,33.33
03,003,01,013,0347,697,771,12,783,1096,0,3,1,3,0,1,0,76.14,71.44 ,33.33
03,003,01,013,0348,698,819,11,830,1150,0,3,1,3,0,1,0,76.14,72.17 ,33.33
03,003,01,013,0349,699,844,15,859,1280,0,3,1,3,0,1,0,76.14,67.11 ,33.33
03,003,01,013,0350,700,763,12,775,1084,0,3,1,3,0,1,0,76.14,71.49 ,33.33
03,003,01,013,0351,701,1015,19,1034,1376,0,3,1,3,0,1,0,76.14,75.15 ,33.33
03,003,01,013,0352,702,477,8,485,688,0,3,1,3,0,1,0,76.14,70.49 ,33.33
03,003,01,013,0353,703,552,6,558,736,0,3,1,3,0,1,0,76.14,75.82 ,33.33
03,003,01,013,0354,704,470,9,479,675,0,3,1,3,0,1,0,76.14,70.96 ,33.33
03,003,01,013,0355,705,763,13,776,1032,0,3,1,3,0,1,0,76.14,75.19 ,33.33
03,003,01,013,0356,706,1003,18,1021,1508,0,3,1,3,0,1,0,76.14,67.71 ,33.33
03,003,01,013,0357,707,1080,15,1095,1540,0,3,1,3,0,1,0,76.14,71.10 ,33.33
03,003,01,013,0358,708,980,8,988,1465,0,3,1,3,0,1,0,76.14,67.44 ,33.33
03,003,01,013,0359,709,585,10,595,862,0,3,1,3,0,1,0,76.14,69.03 ,33.33
03,003,01,013,0360,710,969,13,982,1453,0,3,1,3,0,1,0,76.14,67.58 ,33.33
03,003,01,013,0360,711,1056,22,1078,1558,0,3,1,3,0,1,0,76.14,69.19 ,33.33
03,003,01,013,0361,712,955,13,968,1447,0,3,1,3,0,1,0,76.14,66.90 ,33.33
03,003,01,013,0362,713,890,9,899,1289,0,3,1,3,0,1,0,76.14,69.74 ,33.33
03,003,01,013,0363,714,808,6,814,1215,0,3,1,3,0,1,0,76.14,67.00 ,33.33
03,003,01,013,0363,715,793,8,801,1225,0,3,1,3,0,1,0,76.14,65.39 ,33.33
03,003,01,013,0364,716,1116,19,1135,1614,0,3,1,3,0,1,0,76.14,70.32 ,33.33
03,003,01,013,0365,717,701,10,711,971,0,3,1,3,0,1,0,76.14,73.22 ,33.33
03,003,01,013,0365,718,1008,13,1021,1483,0,3,1,3,0,1,0,76.14,68.85 ,33.33
03,003,01,013,0366,719,775,7,782,1107,0,3,1,3,0,1,0,76.14,70.64 ,33.33
03,003,01,013,0366,720,872,12,884,1385,0,3,1,3,0,1,0,76.14,63.83 ,33.33
03,003,01,013,0367,721,854,18,872,1370,0,3,1,3,0,1,0,76.14,63.65 ,33.33
03,003,01,013,0368,722,830,14,844,1206,0,3,1,3,0,1,0,76.14,69.98 ,33.33
03,004,01,001,0001,1,682,13,695,943,0,3,1,3,0,1,0,76.14,73.70 ,33.33
03,004,01,001,0002,2,343,6,349,433,0,3,1,3,0,1,0,76.14,80.60 ,33.33
03,004,01,001,0003,3,829,19,848,1184,0,3,1,3,0,1,0,76.14,71.62 ,33.33
03,004,01,001,0004,4,527,4,531,738,0,3,1,3,0,1,0,76.14,71.95 ,33.33
03,004,01,001,0005,5,718,7,725,1088,0,3,1,3,0,1,0,76.14,66.64 ,33.33
03,004,01,001,0005,6,708,9,717,1016,0,3,1,3,0,1,0,76.14,70.57 ,33.33
03,004,01,001,0006,7,875,18,893,1293,0,3,1,3,0,1,0,76.14,69.06 ,33.33
03,004,01,001,0006,8,726,19,745,1081,0,3,1,3,0,1,0,76.14,68.92 ,33.33
03,004,01,001,0006,9,659,7,666,1010,0,3,1,3,0,1,0,76.14,65.94 ,33.33
03,004,01,001,0007,10,695,11,706,1123,0,3,1,3,0,1,0,76.14,62.87 ,33.33
03,004,01,001,0007,11,816,20,836,1298,0,3,1,3,0,1,0,76.14,64.41 ,33.33
03,004,01,001,0007,12,785,14,799,1347,0,3,1,3,0,1,0,76.14,59.32 ,33.33
03,004,01,001,0007,13,462,12,474,782,0,3,1,3,0,1,0,76.14,60.61 ,33.33
03,004,01,001,0007,14,506,2,508,766,0,3,1,3,0,1,0,76.14,66.32 ,33.33
03,004,01,001,0008,15,894,15,909,1440,0,3,1,3,0,1,0,76.14,63.13 ,33.33
03,004,01,001,0008,16,567,8,575,941,0,3,1,3,0,1,0,76.14,61.11 ,33.33
03,004,01,001,0009,17,608,11,619,1044,0,3,1,3,0,1,0,76.14,59.29 ,33.33
03,004,01,001,0009,18,714,11,725,1184,0,3,1,3,0,1,0,76.14,61.23 ,33.33
03,004,01,001,0009,19,648,8,656,1151,0,3,1,3,0,1,0,76.14,56.99 ,33.33
03,004,01,001,0009,20,705,12,717,1133,0,3,1,3,0,1,0,76.14,63.28 ,33.33
03,004,01,001,0010,21,842,8,850,1247,0,3,1,3,0,1,0,76.14,68.16 ,33.33
03,004,01,001,0010,22,793,17,810,1304,0,3,1,3,0,1,0,76.14,62.12 ,33.33
03,004,01,001,0010,23,650,12,662,1132,0,3,1,3,0,1,0,76.14,58.48 ,33.33
03,004,01,001,0010,24,578,10,588,940,0,3,1,3,0,1,0,76.14,62.55 ,33.33
03,004,01,001,0010,25,604,9,613,1001,0,3,1,3,0,1,0,76.14,61.24 ,33.33
03,004,01,001,0011,26,726,10,736,1051,0,3,1,3,0,1,0,76.14,70.03 ,33.33
03,004,01,001,0011,27,912,6,918,1572,0,3,1,3,0,1,0,76.14,58.40 ,33.33
03,004,01,001,0012,28,754,13,767,1286,0,3,1,3,0,1,0,76.14,59.64 ,33.33
03,004,01,001,0012,29,596,11,607,1074,0,3,1,3,0,1,0,76.14,56.52 ,33.33
03,004,01,001,0012,30,690,18,708,1280,0,3,1,3,0,1,0,76.14,55.31 ,33.33
03,004,01,001,0013,31,726,12,738,1332,0,3,1,3,0,1,0,76.14,55.41 ,33.33
03,004,01,001,0013,32,758,16,774,1363,0,3,1,3,0,1,0,76.14,56.79 ,33.33
03,004,01,001,0014,33,802,20,822,1225,0,3,1,3,0,1,0,76.14,67.10 ,33.33
03,004,01,001,0014,34,623,13,636,1032,0,3,1,3,0,1,0,76.14,61.63 ,33.33
03,004,01,001,0015,35,667,18,685,991,0,3,1,3,0,1,0,76.14,69.12 ,33.33
03,004,01,001,0016,36,777,17,794,1400,0,3,1,3,0,1,0,76.14,56.71 ,33.33
03,004,01,001,0017,37,437,9,446,713,0,3,1,3,0,1,0,76.14,62.55 ,33.33
03,004,01,001,0018,38,771,22,793,1347,0,3,1,3,0,1,0,76.14,58.87 ,33.33
03,004,01,001,0019,39,538,12,550,962,0,3,1,3,0,1,0,76.14,57.17 ,33.33
03,004,01,001,0020,40,662,19,681,1194,0,3,1,3,0,1,0,76.14,57.04 ,33.33
03,004,01,001,0021,41,717,9,726,1188,0,3,1,3,0,1,0,76.14,61.11 ,33.33
03,004,01,001,0022,42,730,9,739,1241,0,3,1,3,0,1,0,76.14,59.55 ,33.33
03,004,01,001,0023,43,796,4,800,1324,0,3,1,3,0,1,0,76.14,60.42 ,33.33
03,004,01,002,0024,44,325,2,327,464,0,3,1,3,0,1,0,76.14,70.47 ,33.33
03,004,01,002,0025,45,235,3,238,359,0,3,1,3,0,1,0,76.14,66.30 ,33.33
03,004,01,002,0026,46,283,6,289,400,0,3,1,3,0,1,0,76.14,72.25 ,33.33
03,004,01,002,0027,47,489,10,499,725,0,3,1,3,0,1,0,76.14,68.83 ,33.33
03,004,01,002,0027,48,596,5,601,901,0,3,1,3,0,1,0,76.14,66.70 ,33.33
03,004,01,002,0028,49,696,11,707,1049,0,3,1,3,0,1,0,76.14,67.40 ,33.33
03,004,01,002,0028,50,643,13,656,966,0,3,1,3,0,1,0,76.14,67.91 ,33.33
03,004,01,002,0028,51,550,13,563,820,0,3,1,3,0,1,0,76.14,68.66 ,33.33
03,004,01,002,0028,52,593,7,600,920,0,3,1,3,0,1,0,76.14,65.22 ,33.33
03,004,01,002,0028,53,631,14,645,929,0,3,1,3,0,1,0,76.14,69.43 ,33.33
03,004,01,002,0029,54,522,6,528,817,0,3,1,3,0,1,0,76.14,64.63 ,33.33
03,004,01,002,0029,55,550,8,558,842,0,3,1,3,0,1,0,76.14,66.27 ,33.33
03,004,01,002,0029,56,629,8,637,891,0,3,1,3,0,1,0,76.14,71.49 ,33.33
03,004,01,002,0030,57,472,13,485,692,0,3,1,3,0,1,0,76.14,70.09 ,33.33
03,004,01,002,0030,58,542,6,548,748,0,3,1,3,0,1,0,76.14,73.26 ,33.33
03,004,01,002,0031,59,604,12,616,885,0,3,1,3,0,1,0,76.14,69.60 ,33.33
03,004,01,002,0031,60,655,9,664,960,0,3,1,3,0,1,0,76.14,69.17 ,33.33
03,004,01,002,0031,61,624,15,639,888,0,3,1,3,0,1,0,76.14,71.96 ,33.33
03,004,01,002,0032,62,684,5,689,961,0,3,1,3,0,1,0,76.14,71.70 ,33.33
03,004,01,002,0032,63,692,9,701,961,0,3,1,3,0,1,0,76.14,72.94 ,33.33
03,004,01,002,0033,64,867,12,879,1201,0,3,1,3,0,1,0,76.14,73.19 ,33.33
03,004,01,002,0034,65,572,7,579,822,0,3,1,3,0,1,0,76.14,70.44 ,33.33
03,004,01,002,0035,66,678,13,691,1021,0,3,1,3,0,1,0,76.14,67.68 ,33.33
03,004,01,002,0035,67,697,14,711,982,0,3,1,3,0,1,0,76.14,72.40 ,33.33
03,004,01,002,0036,68,626,12,638,939,0,3,1,3,0,1,0,76.14,67.94 ,33.33
03,004,01,002,0036,69,832,20,852,1236,0,3,1,3,0,1,0,76.14,68.93 ,33.33
03,004,01,002,0036,70,719,12,731,1032,0,3,1,3,0,1,0,76.14,70.83 ,33.33
03,004,01,002,0037,71,725,12,737,1113,0,3,1,3,0,1,0,76.14,66.22 ,33.33
03,004,01,002,0037,72,882,13,895,1278,0,3,1,3,0,1,0,76.14,70.03 ,33.33
03,004,01,002,0038,73,510,9,519,681,0,3,1,3,0,1,0,76.14,76.21 ,33.33
03,004,01,002,0038,74,612,5,617,845,0,3,1,3,0,1,0,76.14,73.02 ,33.33
03,004,01,002,0039,75,818,16,834,1246,0,3,1,3,0,1,0,76.14,66.93 ,33.33
03,004,01,002,0040,76,496,5,501,709,0,3,1,3,0,1,0,76.14,70.66 ,33.33
03,004,01,002,0040,77,501,7,508,726,0,3,1,3,0,1,0,76.14,69.97 ,33.33
03,004,01,002,0041,78,670,13,683,1003,0,3,1,3,0,1,0,76.14,68.10 ,33.33
03,004,01,002,0041,79,732,14,746,1048,0,3,1,3,0,1,0,76.14,71.18 ,33.33
03,004,01,002,0041,80,585,11,596,862,0,3,1,3,0,1,0,76.14,69.14 ,33.33
03,004,01,002,0041,81,685,11,696,1026,0,3,1,3,0,1,0,76.14,67.84 ,33.33
03,004,01,002,0041,82,592,10,602,932,0,3,1,3,0,1,0,76.14,64.59 ,33.33
03,004,01,002,0042,83,661,7,668,1055,0,3,1,3,0,1,0,76.14,63.32 ,33.33
03,004,01,002,0042,84,512,9,521,761,0,3,1,3,0,1,0,76.14,68.46 ,33.33
03,004,01,002,0042,85,574,9,583,865,0,3,1,3,0,1,0,76.14,67.40 ,33.33
03,004,01,002,0042,86,550,10,560,796,0,3,1,3,0,1,0,76.14,70.35 ,33.33
03,004,01,002,0043,87,308,3,311,439,0,3,1,3,0,1,0,76.14,70.84 ,33.33
03,004,01,002,0044,88,875,14,889,1386,0,3,1,3,0,1,0,76.14,64.14 ,33.33
03,004,01,002,0044,89,487,12,499,771,0,3,1,3,0,1,0,76.14,64.72 ,33.33
03,004,01,002,0044,90,460,6,466,649,0,3,1,3,0,1,0,76.14,71.80 ,33.33
03,004,01,002,0044,91,643,10,653,978,0,3,1,3,0,1,0,76.14,66.77 ,33.33
03,004,01,002,0045,92,828,15,843,1229,0,3,1,3,0,1,0,76.14,68.59 ,33.33
03,004,01,002,0045,93,762,11,773,1118,0,3,1,3,0,1,0,76.14,69.14 ,33.33
03,004,01,002,0045,94,845,10,855,1320,0,3,1,3,0,1,0,76.14,64.77 ,33.33
03,004,01,002,0045,95,818,22,840,1283,0,3,1,3,0,1,0,76.14,65.47 ,33.33
03,004,01,002,0046,96,683,9,692,1029,0,3,1,3,0,1,0,76.14,67.25 ,33.33
03,004,01,002,0046,97,581,9,590,865,0,3,1,3,0,1,0,76.14,68.21 ,33.33
03,004,01,002,0046,98,820,16,836,1166,0,3,1,3,0,1,0,76.14,71.70 ,33.33
03,004,01,002,0047,99,897,20,917,1286,0,3,1,3,0,1,0,76.14,71.31 ,33.33
03,004,01,002,0048,100,462,8,470,705,0,3,1,3,0,1,0,76.14,66.67 ,33.33
03,004,01,003,0049,101,702,7,709,976,0,3,1,3,0,1,0,76.14,72.64 ,33.33
03,004,01,003,0050,102,463,3,466,659,0,3,1,3,0,1,0,76.14,70.71 ,33.33
03,004,01,003,0051,103,681,12,693,1004,0,3,1,3,0,1,0,76.14,69.02 ,33.33
03,004,01,003,0052,104,1012,11,1023,1467,0,3,1,3,0,1,0,76.14,69.73 ,33.33
03,004,01,003,0052,105,520,6,526,745,0,3,1,3,0,1,0,76.14,70.60 ,33.33
03,004,01,003,0053,106,1182,24,1206,1581,0,3,1,3,0,1,0,76.14,76.28 ,33.33
03,004,01,003,0054,107,1082,24,1106,1572,0,3,1,3,0,1,0,76.14,70.36 ,33.33
03,004,01,003,0055,108,899,22,921,1327,0,3,1,3,0,1,0,76.14,69.40 ,33.33
03,004,01,003,0055,109,762,11,773,1143,0,3,1,3,0,1,0,76.14,67.63 ,33.33
03,004,01,003,0056,110,956,14,970,1393,0,3,1,3,0,1,0,76.14,69.63 ,33.33
03,004,01,003,0057,111,333,3,336,438,0,3,1,3,0,1,0,76.14,76.71 ,33.33
03,004,01,003,0058,112,467,7,474,712,0,3,1,3,0,1,0,76.14,66.57 ,33.33
03,004,01,003,0059,113,395,11,406,613,0,3,1,3,0,1,0,76.14,66.23 ,33.33
03,004,01,003,0060,114,736,19,755,1122,0,3,1,3,0,1,0,76.14,67.29 ,33.33
03,004,01,003,0061,115,739,15,754,1112,0,3,1,3,0,1,0,76.14,67.81 ,33.33
03,004,01,003,0062,116,479,8,487,697,0,3,1,3,0,1,0,76.14,69.87 ,33.33
03,004,01,003,0063,117,745,16,761,1198,0,3,1,3,0,1,0,76.14,63.52 ,33.33
03,004,01,003,0063,118,684,16,700,984,0,3,1,3,0,1,0,76.14,71.14 ,33.33
03,004,01,003,0063,119,655,5,660,1101,0,3,1,3,0,1,0,76.14,59.95 ,33.33
03,004,01,003,0064,120,997,20,1017,1479,0,3,1,3,0,1,0,76.14,68.76 ,33.33
03,004,01,003,0065,121,1100,17,1117,1603,0,3,1,3,0,1,0,76.14,69.68 ,33.33
03,004,01,003,0066,122,637,13,650,945,0,3,1,3,0,1,0,76.14,68.78 ,33.33
03,004,01,003,0067,123,475,4,479,647,0,3,1,3,0,1,0,76.14,74.03 ,33.33
03,004,01,004,0068,124,443,6,449,618,0,3,1,3,0,1,0,76.14,72.65 ,33.33
03,004,01,004,0069,125,1008,24,1032,1458,0,3,1,3,0,1,0,76.14,70.78 ,33.33
03,004,01,004,0070,126,503,8,511,737,0,3,1,3,0,1,0,76.14,69.34 ,33.33
03,004,01,004,0071,127,564,3,567,831,0,3,1,3,0,1,0,76.14,68.23 ,33.33
03,004,01,004,0071,128,756,6,762,1105,0,3,1,3,0,1,0,76.14,68.96 ,33.33
03,004,01,004,0071,129,908,16,924,1363,0,3,1,3,0,1,0,76.14,67.79 ,33.33
03,004,01,004,0072,130,533,8,541,764,0,3,1,3,0,1,0,76.14,70.81 ,33.33
03,004,01,004,0073,131,592,17,609,885,0,3,1,3,0,1,0,76.14,68.81 ,33.33
03,004,01,004,0074,132,688,7,695,1038,0,3,1,3,0,1,0,76.14,66.96 ,33.33
03,004,01,004,0075,133,776,15,791,1175,0,3,1,3,0,1,0,76.14,67.32 ,33.33
03,004,01,004,0075,134,762,18,780,1213,0,3,1,3,0,1,0,76.14,64.30 ,33.33
03,004,01,004,0076,135,495,11,506,728,0,3,1,3,0,1,0,76.14,69.51 ,33.33
03,004,01,004,0077,136,757,13,770,1109,0,3,1,3,0,1,0,76.14,69.43 ,33.33
03,004,01,004,0078,137,655,13,668,1010,0,3,1,3,0,1,0,76.14,66.14 ,33.33
03,004,01,004,0079,138,383,6,389,608,0,3,1,3,0,1,0,76.14,63.98 ,33.33
03,004,01,004,0080,139,340,4,344,546,0,3,1,3,0,1,0,76.14,63.00 ,33.33
03,004,01,004,0081,140,422,6,428,671,0,3,1,3,0,1,0,76.14,63.79 ,33.33
03,004,01,004,0082,141,594,17,611,936,0,3,1,3,0,1,0,76.14,65.28 ,33.33
03,004,01,004,0083,142,511,4,515,709,0,3,1,3,0,1,0,76.14,72.64 ,33.33
03,004,01,004,0084,143,617,9,626,902,0,3,1,3,0,1,0,76.14,69.40 ,33.33
03,004,01,004,0084,144,606,10,616,937,0,3,1,3,0,1,0,76.14,65.74 ,33.33
03,004,01,004,0085,145,639,18,657,991,0,3,1,3,0,1,0,76.14,66.30 ,33.33
03,004,01,004,0086,146,603,7,610,864,0,3,1,3,0,1,0,76.14,70.60 ,33.33
03,004,01,004,0087,147,412,7,419,601,0,3,1,3,0,1,0,76.14,69.72 ,33.33
03,004,01,004,0088,148,535,6,541,768,0,3,1,3,0,1,0,76.14,70.44 ,33.33
03,004,01,005,0089,149,882,15,897,1338,0,3,1,3,0,1,0,76.14,67.04 ,33.33
03,004,01,005,0089,150,821,16,837,1355,0,3,1,3,0,1,0,76.14,61.77 ,33.33
03,004,01,005,0089,151,966,13,979,1453,0,3,1,3,0,1,0,76.14,67.38 ,33.33
03,004,01,005,0090,152,917,17,934,1325,0,3,1,3,0,1,0,76.14,70.49 ,33.33
03,004,01,005,0090,153,884,13,897,1388,0,3,1,3,0,1,0,76.14,64.63 ,33.33
03,004,01,005,0091,154,792,9,801,1127,0,3,1,3,0,1,0,76.14,71.07 ,33.33
03,004,01,005,0091,155,819,20,839,1219,0,3,1,3,0,1,0,76.14,68.83 ,33.33
03,004,01,005,0091,156,684,18,702,1085,0,3,1,3,0,1,0,76.14,64.70 ,33.33
03,004,01,005,0092,157,519,10,529,812,0,3,1,3,0,1,0,76.14,65.15 ,33.33
03,004,01,005,0093,158,736,21,757,1066,0,3,1,3,0,1,0,76.14,71.01 ,33.33
03,004,01,005,0094,159,800,18,818,1264,0,3,1,3,0,1,0,76.14,64.72 ,33.33
03,004,01,005,0094,160,1089,16,1105,1571,0,3,1,3,0,1,0,76.14,70.34 ,33.33
03,004,01,005,0094,161,825,7,832,1190,0,3,1,3,0,1,0,76.14,69.92 ,33.33
03,004,01,005,0095,162,1090,24,1114,1582,0,3,1,3,0,1,0,76.14,70.42 ,33.33
03,004,01,005,0095,163,900,10,910,1362,0,3,1,3,0,1,0,76.14,66.81 ,33.33
03,004,01,005,0095,164,852,12,864,1334,0,3,1,3,0,1,0,76.14,64.77 ,33.33
03,004,01,005,0096,165,518,4,522,812,0,3,1,3,0,1,0,76.14,64.29 ,33.33
03,004,01,005,0097,166,633,18,651,909,0,3,1,3,0,1,0,76.14,71.62 ,33.33
03,004,01,005,0097,167,661,22,683,1105,0,3,1,3,0,1,0,76.14,61.81 ,33.33
03,004,01,005,0098,168,659,14,673,982,0,3,1,3,0,1,0,76.14,68.53 ,33.33
03,004,01,005,0099,169,857,21,878,1306,0,3,1,3,0,1,0,76.14,67.23 ,33.33
03,004,01,005,0099,170,426,4,430,642,0,3,1,3,0,1,0,76.14,66.98 ,33.33
03,004,01,005,0100,171,730,9,739,1117,0,3,1,3,0,1,0,76.14,66.16 ,33.33
03,004,01,005,0100,172,594,11,605,863,0,3,1,3,0,1,0,76.14,70.10 ,33.33
03,004,01,005,0101,173,755,14,769,1243,0,3,1,3,0,1,0,76.14,61.87 ,33.33
03,004,01,005,0102,174,1015,21,1036,1497,0,3,1,3,0,1,0,76.14,69.21 ,33.33
03,004,01,005,0102,175,954,26,980,1379,0,3,1,3,0,1,0,76.14,71.07 ,33.33
03,004,01,005,0103,176,605,8,613,968,0,3,1,3,0,1,0,76.14,63.33 ,33.33
03,004,01,005,0103,177,879,20,899,1458,0,3,1,3,0,1,0,76.14,61.66 ,33.33
03,004,01,005,0103,178,1109,26,1135,1734,0,3,1,3,0,1,0,76.14,65.46 ,33.33
03,004,01,005,0104,179,631,19,650,1136,0,3,1,3,0,1,0,76.14,57.22 ,33.33
03,004,01,005,0104,180,789,15,804,1216,0,3,1,3,0,1,0,76.14,66.12 ,33.33
03,004,01,006,0105,181,540,11,551,747,0,3,1,3,0,1,0,76.14,73.76 ,33.33
03,004,01,006,0106,182,1055,17,1072,1529,0,3,1,3,0,1,0,76.14,70.11 ,33.33
03,004,01,006,0107,183,902,24,926,1261,0,3,1,3,0,1,0,76.14,73.43 ,33.33
03,004,01,006,0108,184,637,10,647,1111,0,3,1,3,0,1,0,76.14,58.24 ,33.33
03,004,01,006,0108,185,444,1,445,798,0,3,1,3,0,1,0,76.14,55.76 ,33.33
03,004,01,006,0109,186,453,9,462,717,0,3,1,3,0,1,0,76.14,64.44 ,33.33
03,004,01,006,0110,187,620,12,632,1015,0,3,1,3,0,1,0,76.14,62.27 ,33.33
03,004,01,006,0110,188,579,6,585,949,0,3,1,3,0,1,0,76.14,61.64 ,33.33
03,004,01,006,0111,189,756,13,769,1080,0,3,1,3,0,1,0,76.14,71.20 ,33.33
03,004,01,006,0112,190,938,19,957,1467,0,3,1,3,0,1,0,76.14,65.24 ,33.33
03,004,01,006,0113,191,1135,17,1152,1902,0,3,1,3,0,1,0,76.14,60.57 ,33.33
03,004,01,006,0113,192,1098,20,1118,1779,0,3,1,3,0,1,0,76.14,62.84 ,33.33
03,004,01,006,0113,193,564,20,584,967,0,3,1,3,0,1,0,76.14,60.39 ,33.33
03,004,01,006,0114,194,692,8,700,1137,0,3,1,3,0,1,0,76.14,61.57 ,33.33
03,004,01,006,0115,195,614,20,634,899,0,3,1,3,0,1,0,76.14,70.52 ,33.33
03,004,01,006,0116,196,811,19,830,1283,0,3,1,3,0,1,0,76.14,64.69 ,33.33
03,004,01,006,0116,197,846,9,855,1229,0,3,1,3,0,1,0,76.14,69.57 ,33.33
03,004,01,006,0116,198,784,11,795,1231,0,3,1,3,0,1,0,76.14,64.58 ,33.33
03,004,01,006,0116,199,829,8,837,1301,0,3,1,3,0,1,0,76.14,64.34 ,33.33
03,004,01,006,0117,200,655,11,666,1027,0,3,1,3,0,1,0,76.14,64.85 ,33.33
03,004,01,006,0117,201,665,9,674,1201,0,3,1,3,0,1,0,76.14,56.12 ,33.33
03,004,01,006,0117,202,673,9,682,1207,0,3,1,3,0,1,0,76.14,56.50 ,33.33
03,004,01,007,0118,203,291,3,294,419,0,3,1,3,0,1,0,76.14,70.17 ,33.33
03,004,01,007,0119,204,367,8,375,495,0,3,1,3,0,1,0,76.14,75.76 ,33.33
03,004,01,007,0120,205,498,12,510,738,0,3,1,3,0,1,0,76.14,69.11 ,33.33
03,004,01,007,0121,206,296,6,302,400,0,3,1,3,0,1,0,76.14,75.50 ,33.33
03,004,01,007,0122,207,796,18,814,1206,0,3,1,3,0,1,0,76.14,67.50 ,33.33
03,004,01,007,0122,208,556,12,568,862,0,3,1,3,0,1,0,76.14,65.89 ,33.33
03,004,01,007,0123,209,982,19,1001,1443,0,3,1,3,0,1,0,76.14,69.37 ,33.33
03,004,01,007,0124,210,344,7,351,521,0,3,1,3,0,1,0,76.14,67.37 ,33.33
03,004,01,007,0125,211,399,13,412,597,0,3,1,3,0,1,0,76.14,69.01 ,33.33
03,004,01,007,0126,212,656,7,663,996,0,3,1,3,0,1,0,76.14,66.57 ,33.33
03,004,01,007,0126,213,535,11,546,774,0,3,1,3,0,1,0,76.14,70.54 ,33.33
03,004,01,007,0127,214,928,22,950,1357,0,3,1,3,0,1,0,76.14,70.01 ,33.33
03,004,01,007,0128,215,727,12,739,1098,0,3,1,3,0,1,0,76.14,67.30 ,33.33
03,004,01,007,0128,216,568,7,575,913,0,3,1,3,0,1,0,76.14,62.98 ,33.33
03,004,01,007,0129,217,695,12,707,983,0,3,1,3,0,1,0,76.14,71.92 ,33.33
03,004,01,008,0130,218,805,13,818,1135,0,3,1,3,0,1,0,76.14,72.07 ,33.33
03,004,01,008,0130,219,644,8,652,952,0,3,1,3,0,1,0,76.14,68.49 ,33.33
03,004,01,008,0130,220,728,17,745,1132,0,3,1,3,0,1,0,76.14,65.81 ,33.33
03,004,01,008,0131,221,584,6,590,821,0,3,1,3,0,1,0,76.14,71.86 ,33.33
03,004,01,008,0132,222,97,1,98,139,0,3,1,3,0,1,0,76.14,70.50 ,33.33
03,004,01,008,0133,223,96,0,96,128,0,3,1,3,0,1,0,76.14,75.00 ,33.33
03,004,01,008,0134,224,215,4,219,317,0,3,1,3,0,1,0,76.14,69.09 ,33.33
03,004,01,008,0135,225,796,16,812,1180,0,3,1,3,0,1,0,76.14,68.81 ,33.33
03,004,01,008,0136,226,388,12,400,595,0,3,1,3,0,1,0,76.14,67.23 ,33.33
03,004,01,008,0136,227,185,5,190,252,0,3,1,3,0,1,0,76.14,75.40 ,33.33
03,004,01,008,0137,228,337,2,339,480,0,3,1,3,0,1,0,76.14,70.63 ,33.33
03,004,01,008,0138,229,545,8,553,776,0,3,1,3,0,1,0,76.14,71.26 ,33.33
03,004,01,008,0138,230,264,4,268,373,0,3,1,3,0,1,0,76.14,71.85 ,33.33
03,004,01,008,0139,231,525,8,533,738,0,3,1,3,0,1,0,76.14,72.22 ,33.33
03,004,01,008,0139,232,589,8,597,795,0,3,1,3,0,1,0,76.14,75.09 ,33.33
03,004,01,008,0140,233,890,19,909,1289,0,3,1,3,0,1,0,76.14,70.52 ,33.33
03,004,01,009,0141,234,749,9,758,1125,0,3,1,3,0,1,0,76.14,67.38 ,33.33
03,004,01,009,0142,235,922,17,939,1321,0,3,1,3,0,1,0,76.14,71.08 ,33.33
03,004,01,009,0143,236,312,2,314,466,0,3,1,3,0,1,0,76.14,67.38 ,33.33
03,004,01,009,0144,237,640,12,652,908,0,3,1,3,0,1,0,76.14,71.81 ,33.33
03,004,01,009,0144,238,947,14,961,1436,0,3,1,3,0,1,0,76.14,66.92 ,33.33
03,004,01,009,0145,239,476,14,490,785,0,3,1,3,0,1,0,76.14,62.42 ,33.33
03,004,01,009,0146,240,257,5,262,337,0,3,1,3,0,1,0,76.14,77.74 ,33.33
03,004,01,009,0147,241,433,6,439,614,0,3,1,3,0,1,0,76.14,71.50 ,33.33
03,004,01,009,0148,242,229,3,232,341,0,3,1,3,0,1,0,76.14,68.04 ,33.33
03,004,01,009,0149,243,185,3,188,296,0,3,1,3,0,1,0,76.14,63.51 ,33.33
03,004,01,010,0150,244,634,11,645,990,0,3,1,3,0,1,0,76.14,65.15 ,33.33
03,004,01,010,0150,245,1061,10,1071,1662,0,3,1,3,0,1,0,76.14,64.44 ,33.33
03,004,01,010,0151,246,563,9,572,890,0,3,1,3,0,1,0,76.14,64.27 ,33.33
03,004,01,010,0152,247,484,12,496,728,0,3,1,3,0,1,0,76.14,68.13 ,33.33
03,004,01,010,0153,248,668,9,677,1076,0,3,1,3,0,1,0,76.14,62.92 ,33.33
03,004,01,010,0154,249,396,5,401,654,0,3,1,3,0,1,0,76.14,61.31 ,33.33
03,004,01,010,0155,250,422,6,428,693,0,3,1,3,0,1,0,76.14,61.76 ,33.33
03,004,01,010,0156,251,430,9,439,597,0,3,1,3,0,1,0,76.14,73.53 ,33.33
03,004,01,010,0157,252,379,8,387,557,0,3,1,3,0,1,0,76.14,69.48 ,33.33
03,004,01,010,0158,253,368,4,372,516,0,3,1,3,0,1,0,76.14,72.09 ,33.33
03,004,01,011,0159,254,615,7,622,874,0,3,1,3,0,1,0,76.14,71.17 ,33.33
03,004,01,011,0160,255,483,9,492,708,0,3,1,3,0,1,0,76.14,69.49 ,33.33
03,004,01,011,0161,256,424,5,429,618,0,3,1,3,0,1,0,76.14,69.42 ,33.33
03,004,01,011,0162,257,214,2,216,330,0,3,1,3,0,1,0,76.14,65.45 ,33.33
03,004,01,011,0162,258,218,4,222,310,0,3,1,3,0,1,0,76.14,71.61 ,33.33
03,004,01,011,0163,259,744,6,750,1208,0,3,1,3,0,1,0,76.14,62.09 ,33.33
03,004,01,011,0164,260,329,4,333,566,0,3,1,3,0,1,0,76.14,58.83 ,33.33
03,004,01,011,0164,261,256,5,261,412,0,3,1,3,0,1,0,76.14,63.35 ,33.33
03,004,01,012,0165,262,299,7,306,425,0,3,1,3,0,1,0,76.14,72.00 ,33.33
03,004,01,012,0166,263,14,2,16,31,0,3,1,3,0,1,0,76.14,51.61 ,33.33
03,004,01,012,0167,264,92,2,94,150,0,3,1,3,0,1,0,76.14,62.67 ,33.33
03,004,01,012,0168,265,96,0,96,178,0,3,1,3,0,1,0,76.14,53.93 ,33.33
03,004,01,012,0169,266,32,1,33,69,0,3,1,3,0,1,0,76.14,47.83 ,33.33
03,004,01,012,0169,267,43,1,44,79,0,3,1,3,0,1,0,76.14,55.70 ,33.33
03,004,01,012,0170,268,31,1,32,50,0,3,1,3,0,1,0,76.14,64.00 ,33.33
03,004,01,012,0171,269,12,1,13,23,0,3,1,3,0,1,0,76.14,56.52 ,33.33
03,004,01,012,0171,270,6,0,6,12,0,3,1,3,0,1,0,76.14,50.00 ,33.33
03,004,01,012,0172,271,8,0,8,16,0,3,1,3,0,1,0,76.14,50.00 ,33.33
03,004,01,012,0172,272,13,0,13,40,0,3,1,3,0,1,0,76.14,32.50 ,33.33
03,004,01,012,0172,273,9,0,9,14,0,3,1,3,0,1,0,76.14,64.29 ,33.33
03,004,01,013,0173,274,92,1,93,150,0,3,1,3,0,1,0,76.14,62.00 ,33.33
03,004,01,013,0173,275,13,0,13,43,0,3,1,3,0,1,0,76.14,30.23 ,33.33
03,004,01,013,0174,276,53,0,53,88,0,3,1,3,0,1,0,76.14,60.23 ,33.33
03,004,01,013,0175,277,7,0,7,14,0,3,1,3,0,1,0,76.14,50.00 ,33.33
03,004,01,013,0176,278,29,1,30,43,0,3,1,3,0,1,0,76.14,69.77 ,33.33
03,004,01,013,0176,279,20,2,22,70,0,3,1,3,0,1,0,76.14,31.43 ,33.33
03,005,01,001,0001,1,606,12,618,830,0,3,1,3,0,1,0,76.14,74.46 ,33.33
03,005,01,001,0002,2,766,6,772,1081,0,3,1,3,0,1,0,76.14,71.42 ,33.33
03,005,01,001,0003,3,967,13,980,1397,0,3,1,3,0,1,0,76.14,70.15 ,33.33
03,005,01,001,0003,4,1037,13,1050,1394,0,3,1,3,0,1,0,76.14,75.32 ,33.33
03,005,01,001,0004,5,930,8,938,1321,0,3,1,3,0,1,0,76.14,71.01 ,33.33
03,005,01,001,0004,6,802,15,817,1121,0,3,1,3,0,1,0,76.14,72.88 ,33.33
03,005,01,001,0004,7,789,9,798,1101,0,3,1,3,0,1,0,76.14,72.48 ,33.33
03,005,01,001,0005,8,727,9,736,1024,0,3,1,3,0,1,0,76.14,71.88 ,33.33
03,005,01,001,0005,9,774,12,786,1060,0,3,1,3,0,1,0,76.14,74.15 ,33.33
03,005,01,001,0006,10,1142,23,1165,1580,0,3,1,3,0,1,0,76.14,73.73 ,33.33
03,005,01,001,0006,11,1145,12,1157,1592,0,3,1,3,0,1,0,76.14,72.68 ,33.33
03,005,01,001,0007,12,633,9,642,895,0,3,1,3,0,1,0,76.14,71.73 ,33.33
03,005,01,001,0008,13,798,20,818,1166,0,3,1,3,0,1,0,76.14,70.15 ,33.33
03,005,01,001,0008,14,831,13,844,1247,0,3,1,3,0,1,0,76.14,67.68 ,33.33
03,005,01,001,0009,15,731,6,737,1000,0,3,1,3,0,1,0,76.14,73.70 ,33.33
03,005,01,001,0010,16,845,13,858,1200,0,3,1,3,0,1,0,76.14,71.50 ,33.33
03,005,01,001,0011,17,434,14,448,682,0,3,1,3,0,1,0,76.14,65.69 ,33.33
03,005,01,001,0012,18,1070,11,1081,1489,0,3,1,3,0,1,0,76.14,72.60 ,33.33
03,005,01,001,0013,19,946,11,957,1318,0,3,1,3,0,1,0,76.14,72.61 ,33.33
03,005,01,001,0013,20,691,8,699,884,0,3,1,3,0,1,0,76.14,79.07 ,33.33
03,005,01,001,0014,21,918,18,936,1319,0,3,1,3,0,1,0,76.14,70.96 ,33.33
03,005,01,001,0014,22,904,9,913,1220,0,3,1,3,0,1,0,76.14,74.84 ,33.33
03,005,01,001,0014,23,710,7,717,1006,0,3,1,3,0,1,0,76.14,71.27 ,33.33
03,005,01,001,0015,24,1205,13,1218,1604,0,3,1,3,0,1,0,76.14,75.94 ,33.33
03,005,01,001,0015,25,943,10,953,1262,0,3,1,3,0,1,0,76.14,75.52 ,33.33
03,005,01,001,0016,26,664,8,672,879,0,3,1,3,0,1,0,76.14,76.45 ,33.33
03,005,01,001,0016,27,646,9,655,904,0,3,1,3,0,1,0,76.14,72.46 ,33.33
03,005,01,001,0017,28,774,13,787,1118,0,3,1,3,0,1,0,76.14,70.39 ,33.33
03,005,01,001,0017,29,616,17,633,915,0,3,1,3,0,1,0,76.14,69.18 ,33.33
03,005,01,001,0017,30,991,11,1002,1431,0,3,1,3,0,1,0,76.14,70.02 ,33.33
03,005,01,001,0018,31,1063,12,1075,1514,0,3,1,3,0,1,0,76.14,71.00 ,33.33
03,005,01,001,0018,32,854,18,872,1150,0,3,1,3,0,1,0,76.14,75.83 ,33.33
03,005,01,001,0018,33,919,16,935,1263,0,3,1,3,0,1,0,76.14,74.03 ,33.33
03,005,01,001,0018,34,983,18,1001,1227,0,3,1,3,0,1,0,76.14,81.58 ,33.33
03,005,01,001,0019,35,1142,12,1154,1579,0,3,1,3,0,1,0,76.14,73.08 ,33.33
03,005,01,001,0019,36,1264,27,1291,1755,0,3,1,3,0,1,0,76.14,73.56 ,33.33
03,005,01,001,0019,37,1041,12,1053,1493,0,3,1,3,0,1,0,76.14,70.53 ,33.33
03,005,01,001,0020,38,686,3,689,917,0,3,1,3,0,1,0,76.14,75.14 ,33.33
03,005,01,001,0020,39,835,10,845,1149,0,3,1,3,0,1,0,76.14,73.54 ,33.33
03,005,01,001,0020,40,833,11,844,1153,0,3,1,3,0,1,0,76.14,73.20 ,33.33
03,005,01,001,0021,41,866,18,884,1247,0,3,1,3,0,1,0,76.14,70.89 ,33.33
03,005,01,001,0021,42,888,11,899,1313,0,3,1,3,0,1,0,76.14,68.47 ,33.33
03,005,01,001,0021,43,889,12,901,1299,0,3,1,3,0,1,0,76.14,69.36 ,33.33
03,005,01,001,0022,44,942,17,959,1271,0,3,1,3,0,1,0,76.14,75.45 ,33.33
03,005,01,001,0022,45,966,18,984,1333,0,3,1,3,0,1,0,76.14,73.82 ,33.33
03,005,01,001,0022,46,732,11,743,998,0,3,1,3,0,1,0,76.14,74.45 ,33.33
03,005,01,001,0023,47,775,13,788,1043,0,3,1,3,0,1,0,76.14,75.55 ,33.33
03,005,01,001,0024,48,1118,31,1149,1608,0,3,1,3,0,1,0,76.14,71.46 ,33.33
03,005,01,001,0024,49,778,11,789,1128,0,3,1,3,0,1,0,76.14,69.95 ,33.33
03,005,01,002,0025,50,535,6,541,723,0,3,1,3,0,1,0,76.14,74.83 ,33.33
03,005,01,002,0025,51,593,6,599,807,0,3,1,3,0,1,0,76.14,74.23 ,33.33
03,005,01,002,0026,52,625,7,632,890,0,3,1,3,0,1,0,76.14,71.01 ,33.33
03,005,01,002,0026,53,492,6,498,676,0,3,1,3,0,1,0,76.14,73.67 ,33.33
03,005,01,002,0027,54,701,6,707,931,0,3,1,3,0,1,0,76.14,75.94 ,33.33
03,005,01,002,0028,55,931,11,942,1270,0,3,1,3,0,1,0,76.14,74.17 ,33.33
03,005,01,002,0029,56,743,4,747,1048,0,3,1,3,0,1,0,76.14,71.28 ,33.33
03,005,01,002,0030,57,549,7,556,754,0,3,1,3,0,1,0,76.14,73.74 ,33.33
03,005,01,002,0030,58,523,5,528,690,0,3,1,3,0,1,0,76.14,76.52 ,33.33
03,005,01,002,0031,59,707,7,714,965,0,3,1,3,0,1,0,76.14,73.99 ,33.33
03,005,01,002,0032,60,661,10,671,903,0,3,1,3,0,1,0,76.14,74.31 ,33.33
03,005,01,002,0032,61,719,11,730,980,0,3,1,3,0,1,0,76.14,74.49 ,33.33
03,005,01,002,0033,62,1074,15,1089,1457,0,3,1,3,0,1,0,76.14,74.74 ,33.33
03,005,01,002,0033,63,925,8,933,1228,0,3,1,3,0,1,0,76.14,75.98 ,33.33
03,005,01,002,0034,64,664,7,671,904,0,3,1,3,0,1,0,76.14,74.23 ,33.33
03,005,01,002,0034,65,563,5,568,808,0,3,1,3,0,1,0,76.14,70.30 ,33.33
03,005,01,002,0035,66,653,14,667,991,0,3,1,3,0,1,0,76.14,67.31 ,33.33
03,005,01,002,0036,67,426,4,430,614,0,3,1,3,0,1,0,76.14,70.03 ,33.33
03,005,01,002,0037,68,773,15,788,1094,0,3,1,3,0,1,0,76.14,72.03 ,33.33
03,005,01,002,0038,69,554,10,564,831,0,3,1,3,0,1,0,76.14,67.87 ,33.33
03,005,01,002,0038,70,561,8,569,796,0,3,1,3,0,1,0,76.14,71.48 ,33.33
03,005,01,002,0039,71,1054,23,1077,1451,0,3,1,3,0,1,0,76.14,74.22 ,33.33
03,005,01,002,0040,72,909,19,928,1285,0,3,1,3,0,1,0,76.14,72.22 ,33.33
03,005,01,002,0041,73,500,8,508,638,0,3,1,3,0,1,0,76.14,79.62 ,33.33
03,005,01,002,0042,74,722,7,729,967,0,3,1,3,0,1,0,76.14,75.39 ,33.33
03,005,01,002,0043,75,545,9,554,757,0,3,1,3,0,1,0,76.14,73.18 ,33.33
03,005,01,002,0044,76,993,7,1000,1317,0,3,1,3,0,1,0,76.14,75.93 ,33.33
03,005,01,002,0045,77,1127,28,1155,1539,0,3,1,3,0,1,0,76.14,75.05 ,33.33
03,005,01,002,0046,78,918,13,931,1346,0,3,1,3,0,1,0,76.14,69.17 ,33.33
03,005,01,002,0047,79,681,11,692,931,0,3,1,3,0,1,0,76.14,74.33 ,33.33
03,005,01,002,0047,80,617,15,632,874,0,3,1,3,0,1,0,76.14,72.31 ,33.33
03,005,01,002,0048,81,728,3,731,1008,0,3,1,3,0,1,0,76.14,72.52 ,33.33
03,005,01,002,0049,82,834,10,844,1090,0,3,1,3,0,1,0,76.14,77.43 ,33.33
03,005,01,003,0050,83,926,11,937,1274,0,3,1,3,0,1,0,76.14,73.55 ,33.33
03,005,01,003,0051,84,917,10,927,1217,0,3,1,3,0,1,0,76.14,76.17 ,33.33
03,005,01,003,0051,85,703,9,712,919,0,3,1,3,0,1,0,76.14,77.48 ,33.33
03,005,01,003,0052,86,853,5,858,1173,0,3,1,3,0,1,0,76.14,73.15 ,33.33
03,005,01,003,0052,87,731,13,744,953,0,3,1,3,0,1,0,76.14,78.07 ,33.33
03,005,01,003,0052,88,692,6,698,986,0,3,1,3,0,1,0,76.14,70.79 ,33.33
03,005,01,003,0053,89,971,14,985,1255,0,3,1,3,0,1,0,76.14,78.49 ,33.33
03,005,01,003,0054,90,482,3,485,649,0,3,1,3,0,1,0,76.14,74.73 ,33.33
03,005,01,003,0054,91,537,9,546,728,0,3,1,3,0,1,0,76.14,75.00 ,33.33
03,005,01,003,0055,92,520,10,530,738,0,3,1,3,0,1,0,76.14,71.82 ,33.33
03,005,01,003,0055,93,507,7,514,644,0,3,1,3,0,1,0,76.14,79.81 ,33.33
03,005,01,003,0056,94,768,8,776,1086,0,3,1,3,0,1,0,76.14,71.45 ,33.33
03,005,01,003,0056,95,813,6,819,1143,0,3,1,3,0,1,0,76.14,71.65 ,33.33
03,005,01,003,0057,96,867,16,883,1230,0,3,1,3,0,1,0,76.14,71.79 ,33.33
03,005,01,003,0058,97,481,6,487,701,0,3,1,3,0,1,0,76.14,69.47 ,33.33
03,005,01,003,0059,98,642,6,648,853,0,3,1,3,0,1,0,76.14,75.97 ,33.33
03,005,01,003,0060,99,781,13,794,1069,0,3,1,3,0,1,0,76.14,74.28 ,33.33
03,005,01,003,0061,100,545,12,557,732,0,3,1,3,0,1,0,76.14,76.09 ,33.33
03,005,01,003,0062,101,609,6,615,783,0,3,1,3,0,1,0,76.14,78.54 ,33.33
03,005,01,003,0063,102,734,5,739,948,0,3,1,3,0,1,0,76.14,77.95 ,33.33
03,005,01,003,0063,103,555,4,559,731,0,3,1,3,0,1,0,76.14,76.47 ,33.33
03,005,01,003,0064,104,459,4,463,592,0,3,1,3,0,1,0,76.14,78.21 ,33.33
03,005,01,003,0065,105,750,8,758,976,0,3,1,3,0,1,0,76.14,77.66 ,33.33
03,005,01,003,0066,106,354,0,354,539,0,3,1,3,0,1,0,76.14,65.68 ,33.33
03,005,01,003,0067,107,480,7,487,640,0,3,1,3,0,1,0,76.14,76.09 ,33.33
03,005,01,003,0068,108,754,6,760,988,0,3,1,3,0,1,0,76.14,76.92 ,33.33
03,005,01,003,0068,109,756,7,763,1051,0,3,1,3,0,1,0,76.14,72.60 ,33.33
03,005,01,003,0069,110,884,12,896,1249,0,3,1,3,0,1,0,76.14,71.74 ,33.33
03,005,01,003,0070,111,564,8,572,768,0,3,1,3,0,1,0,76.14,74.48 ,33.33
03,005,01,003,0071,112,919,13,932,1348,0,3,1,3,0,1,0,76.14,69.14 ,33.33
03,005,01,003,0072,113,615,4,619,852,0,3,1,3,0,1,0,76.14,72.65 ,33.33
03,005,01,004,0073,114,561,8,569,728,0,3,1,3,0,1,0,76.14,78.16 ,33.33
03,005,01,004,0073,115,597,9,606,840,0,3,1,3,0,1,0,76.14,72.14 ,33.33
03,005,01,004,0074,116,905,13,918,1211,0,3,1,3,0,1,0,76.14,75.81 ,33.33
03,005,01,004,0074,117,795,9,804,1071,0,3,1,3,0,1,0,76.14,75.07 ,33.33
03,005,01,004,0075,118,728,9,737,964,0,3,1,3,0,1,0,76.14,76.45 ,33.33
03,005,01,004,0075,119,772,14,786,1026,0,3,1,3,0,1,0,76.14,76.61 ,33.33
03,005,01,004,0076,120,992,15,1007,1369,0,3,1,3,0,1,0,76.14,73.56 ,33.33
03,005,01,004,0076,121,803,18,821,1106,0,3,1,3,0,1,0,76.14,74.23 ,33.33
03,005,01,004,0077,122,918,16,934,1185,0,3,1,3,0,1,0,76.14,78.82 ,33.33
03,005,01,004,0077,123,685,12,697,969,0,3,1,3,0,1,0,76.14,71.93 ,33.33
03,005,01,004,0077,124,556,6,562,758,0,3,1,3,0,1,0,76.14,74.14 ,33.33
03,005,01,004,0078,125,706,8,714,1041,0,3,1,3,0,1,0,76.14,68.59 ,33.33
03,005,01,004,0078,126,808,6,814,1114,0,3,1,3,0,1,0,76.14,73.07 ,33.33
03,005,01,004,0079,127,701,13,714,941,0,3,1,3,0,1,0,76.14,75.88 ,33.33
03,005,01,004,0079,128,739,14,753,1010,0,3,1,3,0,1,0,76.14,74.55 ,33.33
03,005,01,004,0080,129,583,12,595,805,0,3,1,3,0,1,0,76.14,73.91 ,33.33
03,005,01,004,0080,130,562,8,570,815,0,3,1,3,0,1,0,76.14,69.94 ,33.33
03,005,01,004,0080,131,667,13,680,919,0,3,1,3,0,1,0,76.14,73.99 ,33.33
03,005,01,004,0081,132,831,11,842,1062,0,3,1,3,0,1,0,76.14,79.28 ,33.33
03,005,01,004,0081,133,796,34,830,1043,0,3,1,3,0,1,0,76.14,79.58 ,33.33
03,005,01,004,0081,134,778,14,792,993,0,3,1,3,0,1,0,76.14,79.76 ,33.33
03,005,01,004,0082,135,725,8,733,1007,0,3,1,3,0,1,0,76.14,72.79 ,33.33
03,005,01,004,0082,136,773,17,790,1149,0,3,1,3,0,1,0,76.14,68.76 ,33.33
03,005,01,004,0082,137,709,11,720,976,0,3,1,3,0,1,0,76.14,73.77 ,33.33
03,005,01,004,0082,138,733,14,747,1000,0,3,1,3,0,1,0,76.14,74.70 ,33.33
03,005,01,004,0083,139,700,10,710,933,0,3,1,3,0,1,0,76.14,76.10 ,33.33
03,005,01,004,0084,140,628,15,643,843,0,3,1,3,0,1,0,76.14,76.28 ,33.33
03,005,01,004,0084,141,677,12,689,881,0,3,1,3,0,1,0,76.14,78.21 ,33.33
03,005,01,004,0085,142,780,10,790,1051,0,3,1,3,0,1,0,76.14,75.17 ,33.33
03,005,01,004,0086,143,896,13,909,1151,0,3,1,3,0,1,0,76.14,78.97 ,33.33
03,005,01,004,0087,144,394,3,397,502,0,3,1,3,0,1,0,76.14,79.08 ,33.33
03,005,01,004,0088,145,604,13,617,827,0,3,1,3,0,1,0,76.14,74.61 ,33.33
03,005,01,004,0088,146,683,17,700,964,0,3,1,3,0,1,0,76.14,72.61 ,33.33
03,005,01,004,0089,147,922,3,925,1160,0,3,1,3,0,1,0,76.14,79.74 ,33.33
03,005,01,004,0090,148,748,14,762,983,0,3,1,3,0,1,0,76.14,77.52 ,33.33
03,005,01,004,0091,149,604,7,611,777,0,3,1,3,0,1,0,76.14,78.64 ,33.33
03,005,01,004,0091,150,806,17,823,1068,0,3,1,3,0,1,0,76.14,77.06 ,33.33
03,005,01,004,0091,151,680,14,694,891,0,3,1,3,0,1,0,76.14,77.89 ,33.33
03,005,01,004,0092,152,788,13,801,1053,0,3,1,3,0,1,0,76.14,76.07 ,33.33
03,005,01,004,0092,153,678,24,702,952,0,3,1,3,0,1,0,76.14,73.74 ,33.33
03,005,01,004,0093,154,905,16,921,1253,0,3,1,3,0,1,0,76.14,73.50 ,33.33
03,005,01,004,0093,155,540,6,546,716,0,3,1,3,0,1,0,76.14,76.26 ,33.33
03,005,01,004,0094,156,615,13,628,857,0,3,1,3,0,1,0,76.14,73.28 ,33.33
03,005,01,005,0095,157,556,5,561,740,0,3,1,3,0,1,0,76.14,75.81 ,33.33
03,005,01,005,0095,158,781,18,799,1118,0,3,1,3,0,1,0,76.14,71.47 ,33.33
03,005,01,005,0096,159,659,11,670,893,0,3,1,3,0,1,0,76.14,75.03 ,33.33
03,005,01,005,0096,160,692,9,701,975,0,3,1,3,0,1,0,76.14,71.90 ,33.33
03,005,01,005,0097,161,889,16,905,1191,0,3,1,3,0,1,0,76.14,75.99 ,33.33
03,005,01,005,0097,162,1097,22,1119,1499,0,3,1,3,0,1,0,76.14,74.65 ,33.33
03,005,01,005,0098,163,795,10,805,1009,0,3,1,3,0,1,0,76.14,79.78 ,33.33
03,005,01,005,0098,164,818,13,831,1138,0,3,1,3,0,1,0,76.14,73.02 ,33.33
03,005,01,005,0098,165,889,13,902,1249,0,3,1,3,0,1,0,76.14,72.22 ,33.33
03,005,01,005,0099,166,837,12,849,1229,0,3,1,3,0,1,0,76.14,69.08 ,33.33
03,005,01,005,0099,167,905,15,920,1344,0,3,1,3,0,1,0,76.14,68.45 ,33.33
03,005,01,005,0100,168,868,8,876,1141,0,3,1,3,0,1,0,76.14,76.77 ,33.33
03,005,01,005,0100,169,727,21,748,972,0,3,1,3,0,1,0,76.14,76.95 ,33.33
03,005,01,005,0101,170,599,14,613,850,0,3,1,3,0,1,0,76.14,72.12 ,33.33
03,005,01,005,0102,171,734,10,744,1022,0,3,1,3,0,1,0,76.14,72.80 ,33.33
03,005,01,005,0102,172,666,10,676,944,0,3,1,3,0,1,0,76.14,71.61 ,33.33
03,005,01,005,0103,173,701,2,703,1042,0,3,1,3,0,1,0,76.14,67.47 ,33.33
03,005,01,005,0103,174,924,22,946,1279,0,3,1,3,0,1,0,76.14,73.96 ,33.33
03,005,01,005,0103,175,963,13,976,1418,0,3,1,3,0,1,0,76.14,68.83 ,33.33
03,005,01,005,0104,176,558,4,562,754,0,3,1,3,0,1,0,76.14,74.54 ,33.33
03,005,01,005,0105,177,1093,20,1113,1442,0,3,1,3,0,1,0,76.14,77.18 ,33.33
03,005,01,005,0106,178,775,7,782,999,0,3,1,3,0,1,0,76.14,78.28 ,33.33
03,005,01,005,0107,179,632,8,640,852,0,3,1,3,0,1,0,76.14,75.12 ,33.33
03,005,01,005,0107,180,583,7,590,764,0,3,1,3,0,1,0,76.14,77.23 ,33.33
03,005,01,005,0108,181,678,2,680,933,0,3,1,3,0,1,0,76.14,72.88 ,33.33
03,005,01,005,0108,182,619,10,629,827,0,3,1,3,0,1,0,76.14,76.06 ,33.33
03,005,01,005,0109,183,1127,20,1147,1587,0,3,1,3,0,1,0,76.14,72.27 ,33.33
03,005,01,005,0109,184,1036,18,1054,1476,0,3,1,3,0,1,0,76.14,71.41 ,33.33
03,005,01,005,0110,185,971,19,990,1382,0,3,1,3,0,1,0,76.14,71.64 ,33.33
03,005,01,005,0110,186,961,22,983,1361,0,3,1,3,0,1,0,76.14,72.23 ,33.33
03,005,01,005,0110,187,981,17,998,1404,0,3,1,3,0,1,0,76.14,71.08 ,33.33
03,005,01,005,0110,188,861,13,874,1256,0,3,1,3,0,1,0,76.14,69.59 ,33.33
03,005,01,005,0111,189,724,6,730,1022,0,3,1,3,0,1,0,76.14,71.43 ,33.33
03,005,01,005,0111,190,729,9,738,1098,0,3,1,3,0,1,0,76.14,67.21 ,33.33
03,005,01,005,0112,191,828,4,832,1070,0,3,1,3,0,1,0,76.14,77.76 ,33.33
03,005,01,005,0113,192,634,7,641,910,0,3,1,3,0,1,0,76.14,70.44 ,33.33
03,005,01,005,0113,193,736,10,746,1100,0,3,1,3,0,1,0,76.14,67.82 ,33.33
03,005,01,005,0113,194,937,18,955,1322,0,3,1,3,0,1,0,76.14,72.24 ,33.33
03,005,01,005,0113,195,771,8,779,1114,0,3,1,3,0,1,0,76.14,69.93 ,33.33
03,005,01,005,0114,196,950,12,962,1293,0,3,1,3,0,1,0,76.14,74.40 ,33.33
03,005,01,005,0114,197,808,18,826,1205,0,3,1,3,0,1,0,76.14,68.55 ,33.33
03,005,01,005,0115,198,1059,14,1073,1337,0,3,1,3,0,1,0,76.14,80.25 ,33.33
03,005,01,005,0116,199,977,26,1003,1311,0,3,1,3,0,1,0,76.14,76.51 ,33.33
03,005,01,005,0117,200,605,7,612,799,0,3,1,3,0,1,0,76.14,76.60 ,33.33
03,005,01,005,0118,201,843,9,852,1141,0,3,1,3,0,1,0,76.14,74.67 ,33.33
03,005,01,005,0118,202,866,13,879,1220,0,3,1,3,0,1,0,76.14,72.05 ,33.33
03,005,01,005,0119,203,589,15,604,769,0,3,1,3,0,1,0,76.14,78.54 ,33.33
03,005,01,005,0119,204,603,10,613,829,0,3,1,3,0,1,0,76.14,73.94 ,33.33
03,005,01,006,0120,205,1011,16,1027,1489,0,3,1,3,0,1,0,76.14,68.97 ,33.33
03,005,01,006,0121,206,734,8,742,950,0,3,1,3,0,1,0,76.14,78.11 ,33.33
03,005,01,006,0122,207,1062,12,1074,1438,0,3,1,3,0,1,0,76.14,74.69 ,33.33
03,005,01,006,0123,208,962,12,974,1342,0,3,1,3,0,1,0,76.14,72.58 ,33.33
03,005,01,006,0123,209,1061,8,1069,1454,0,3,1,3,0,1,0,76.14,73.52 ,33.33
03,005,01,006,0124,210,676,7,683,963,0,3,1,3,0,1,0,76.14,70.92 ,33.33
03,005,01,006,0124,211,758,7,765,1046,0,3,1,3,0,1,0,76.14,73.14 ,33.33
03,005,01,006,0125,212,957,6,963,1265,0,3,1,3,0,1,0,76.14,76.13 ,33.33
03,005,01,006,0126,213,905,13,918,1164,0,3,1,3,0,1,0,76.14,78.87 ,33.33
03,005,01,006,0127,214,788,10,798,1022,0,3,1,3,0,1,0,76.14,78.08 ,33.33
03,005,01,006,0127,215,736,12,748,993,0,3,1,3,0,1,0,76.14,75.33 ,33.33
03,005,01,006,0128,216,1005,14,1019,1291,0,3,1,3,0,1,0,76.14,78.93 ,33.33
03,005,01,006,0129,217,505,6,511,656,0,3,1,3,0,1,0,76.14,77.90 ,33.33
03,005,01,006,0130,218,942,11,953,1311,0,3,1,3,0,1,0,76.14,72.69 ,33.33
03,005,01,006,0131,219,572,10,582,781,0,3,1,3,0,1,0,76.14,74.52 ,33.33
03,005,01,006,0131,220,587,7,594,850,0,3,1,3,0,1,0,76.14,69.88 ,33.33
03,005,01,006,0132,221,985,17,1002,1412,0,3,1,3,0,1,0,76.14,70.96 ,33.33
03,005,01,006,0133,222,752,7,759,1034,0,3,1,3,0,1,0,76.14,73.40 ,33.33
03,005,01,006,0134,223,832,11,843,1186,0,3,1,3,0,1,0,76.14,71.08 ,33.33
03,005,01,006,0135,224,759,10,769,1120,0,3,1,3,0,1,0,76.14,68.66 ,33.33
03,005,01,006,0136,225,599,5,604,809,0,3,1,3,0,1,0,76.14,74.66 ,33.33
03,005,01,006,0137,226,799,27,826,1123,0,3,1,3,0,1,0,76.14,73.55 ,33.33
03,005,01,006,0138,227,480,7,487,650,0,3,1,3,0,1,0,76.14,74.92 ,33.33
03,005,01,006,0139,228,863,17,880,1278,0,3,1,3,0,1,0,76.14,68.86 ,33.33
03,005,01,006,0140,229,597,5,602,859,0,3,1,3,0,1,0,76.14,70.08 ,33.33
03,005,01,006,0141,230,853,13,866,1341,0,3,1,3,0,1,0,76.14,64.58 ,33.33
03,005,01,006,0142,231,884,16,900,1339,0,3,1,3,0,1,0,76.14,67.21 ,33.33
03,005,01,007,0143,232,991,10,1001,1201,0,3,1,3,0,1,0,76.14,83.35 ,33.33
03,005,01,007,0143,233,700,9,709,878,0,3,1,3,0,1,0,76.14,80.75 ,33.33
03,005,01,007,0144,234,913,6,919,1153,0,3,1,3,0,1,0,76.14,79.71 ,33.33
03,005,01,007,0145,235,629,2,631,790,0,3,1,3,0,1,0,76.14,79.87 ,33.33
03,005,01,007,0146,236,1123,12,1135,1474,0,3,1,3,0,1,0,76.14,77.00 ,33.33
03,005,01,007,0147,237,807,7,814,1010,0,3,1,3,0,1,0,76.14,80.59 ,33.33
03,005,01,007,0148,238,449,11,460,579,0,3,1,3,0,1,0,76.14,79.45 ,33.33
03,005,01,007,0149,239,554,9,563,687,0,3,1,3,0,1,0,76.14,81.95 ,33.33
03,005,01,007,0150,240,1125,13,1138,1433,0,3,1,3,0,1,0,76.14,79.41 ,33.33
03,005,01,007,0150,241,349,1,350,437,0,3,1,3,0,1,0,76.14,80.09 ,33.33
03,005,01,007,0151,242,1138,20,1158,1417,0,3,1,3,0,1,0,76.14,81.72 ,33.33
03,005,01,007,0151,243,508,9,517,644,0,3,1,3,0,1,0,76.14,80.28 ,33.33
03,005,01,007,0152,244,748,20,768,991,0,3,1,3,0,1,0,76.14,77.50 ,33.33
03,005,01,007,0152,245,404,7,411,505,0,3,1,3,0,1,0,76.14,81.39 ,33.33
03,005,01,007,0153,246,525,8,533,743,0,3,1,3,0,1,0,76.14,71.74 ,33.33
03,005,01,008,0154,247,615,9,624,819,0,3,1,3,0,1,0,76.14,76.19 ,33.33
03,005,01,008,0154,248,639,10,649,926,0,3,1,3,0,1,0,76.14,70.09 ,33.33
03,005,01,008,0155,249,586,11,597,741,0,3,1,3,0,1,0,76.14,80.57 ,33.33
03,005,01,008,0156,250,660,7,667,873,0,3,1,3,0,1,0,76.14,76.40 ,33.33
03,005,01,008,0156,251,541,5,546,756,0,3,1,3,0,1,0,76.14,72.22 ,33.33
03,005,01,008,0157,252,1014,10,1024,1368,0,3,1,3,0,1,0,76.14,74.85 ,33.33
03,005,01,008,0158,253,486,8,494,733,0,3,1,3,0,1,0,76.14,67.39 ,33.33
03,005,01,008,0159,254,973,12,985,1302,0,3,1,3,0,1,0,76.14,75.65 ,33.33
03,005,01,008,0160,255,581,8,589,781,0,3,1,3,0,1,0,76.14,75.42 ,33.33
03,005,01,008,0161,256,1094,16,1110,1492,0,3,1,3,0,1,0,76.14,74.40 ,33.33
03,005,01,008,0162,257,580,14,594,786,0,3,1,3,0,1,0,76.14,75.57 ,33.33
03,005,01,008,0163,258,407,2,409,566,0,3,1,3,0,1,0,76.14,72.26 ,33.33
03,005,01,008,0164,259,722,10,732,988,0,3,1,3,0,1,0,76.14,74.09 ,33.33
03,005,01,008,0165,260,651,8,659,928,0,3,1,3,0,1,0,76.14,71.01 ,33.33
03,005,01,009,0166,261,619,8,627,818,0,3,1,3,0,1,0,76.14,76.65 ,33.33
03,005,01,009,0166,262,502,7,509,652,0,3,1,3,0,1,0,76.14,78.07 ,33.33
03,005,01,009,0167,263,780,7,787,1046,0,3,1,3,0,1,0,76.14,75.24 ,33.33
03,005,01,009,0167,264,814,11,825,1102,0,3,1,3,0,1,0,76.14,74.86 ,33.33
03,005,01,009,0168,265,852,12,864,1175,0,3,1,3,0,1,0,76.14,73.53 ,33.33
03,005,01,009,0168,266,818,11,829,1162,0,3,1,3,0,1,0,76.14,71.34 ,33.33
03,005,01,009,0169,267,652,17,669,893,0,3,1,3,0,1,0,76.14,74.92 ,33.33
03,005,01,009,0169,268,668,6,674,873,0,3,1,3,0,1,0,76.14,77.21 ,33.33
03,005,01,009,0170,269,539,5,544,746,0,3,1,3,0,1,0,76.14,72.92 ,33.33
03,005,01,009,0170,270,563,5,568,786,0,3,1,3,0,1,0,76.14,72.26 ,33.33
03,005,01,009,0171,271,637,15,652,930,0,3,1,3,0,1,0,76.14,70.11 ,33.33
03,005,01,009,0172,272,823,9,832,1070,0,3,1,3,0,1,0,76.14,77.76 ,33.33
03,005,01,009,0173,273,320,4,324,439,0,3,1,3,0,1,0,76.14,73.80 ,33.33
03,005,01,009,0174,274,974,11,985,1341,0,3,1,3,0,1,0,76.14,73.45 ,33.33
03,005,01,009,0175,275,554,11,565,697,0,3,1,3,0,1,0,76.14,81.06 ,33.33
03,005,01,009,0175,276,509,6,515,689,0,3,1,3,0,1,0,76.14,74.75 ,33.33
03,005,01,009,0176,277,289,2,291,356,0,3,1,3,0,1,0,76.14,81.74 ,33.33
03,005,01,009,0177,278,586,9,595,814,0,3,1,3,0,1,0,76.14,73.10 ,33.33
03,005,01,009,0177,279,588,4,592,822,0,3,1,3,0,1,0,76.14,72.02 ,33.33
03,005,01,009,0178,280,782,11,793,988,0,3,1,3,0,1,0,76.14,80.26 ,33.33
03,005,01,009,0179,281,1026,15,1041,1322,0,3,1,3,0,1,0,76.14,78.74 ,33.33
03,005,01,009,0180,282,1000,11,1011,1319,0,3,1,3,0,1,0,76.14,76.65 ,33.33
03,005,01,009,0181,283,1044,10,1054,1338,0,3,1,3,0,1,0,76.14,78.77 ,33.33
03,005,01,009,0182,284,925,12,937,1191,0,3,1,3,0,1,0,76.14,78.67 ,33.33
03,005,01,009,0183,285,160,3,163,217,0,3,1,3,0,1,0,76.14,75.12 ,33.33
03,005,01,009,0184,286,275,3,278,336,0,3,1,3,0,1,0,76.14,82.74 ,33.33
03,005,01,010,0185,287,806,11,817,1057,0,3,1,3,0,1,0,76.14,77.29 ,33.33
03,005,01,010,0186,288,1206,19,1225,1609,0,3,1,3,0,1,0,76.14,76.13 ,33.33
03,005,01,010,0187,289,766,13,779,1119,0,3,1,3,0,1,0,76.14,69.62 ,33.33
03,005,01,010,0188,290,1129,12,1141,1405,0,3,1,3,0,1,0,76.14,81.21 ,33.33
03,005,01,010,0188,291,1206,24,1230,1577,0,3,1,3,0,1,0,76.14,78.00 ,33.33
03,005,01,010,0188,292,572,7,579,834,0,3,1,3,0,1,0,76.14,69.42 ,33.33
03,005,01,010,0189,293,932,15,947,1234,0,3,1,3,0,1,0,76.14,76.74 ,33.33
03,005,01,010,0190,294,952,19,971,1315,0,3,1,3,0,1,0,76.14,73.84 ,33.33
03,005,01,010,0191,295,890,17,907,1186,0,3,1,3,0,1,0,76.14,76.48 ,33.33
03,005,01,010,0191,296,894,15,909,1205,0,3,1,3,0,1,0,76.14,75.44 ,33.33
03,005,01,010,0192,297,456,13,469,646,0,3,1,3,0,1,0,76.14,72.60 ,33.33
03,005,01,010,0193,298,400,4,404,585,0,3,1,3,0,1,0,76.14,69.06 ,33.33
03,005,01,010,0194,299,478,7,485,666,0,3,1,3,0,1,0,76.14,72.82 ,33.33
03,005,01,011,0195,300,519,8,527,685,0,3,1,3,0,1,0,76.14,76.93 ,33.33
03,005,01,011,0195,301,552,4,556,738,0,3,1,3,0,1,0,76.14,75.34 ,33.33
03,005,01,011,0196,302,521,4,525,712,0,3,1,3,0,1,0,76.14,73.74 ,33.33
03,005,01,011,0197,303,502,6,508,725,0,3,1,3,0,1,0,76.14,70.07 ,33.33
03,005,01,011,0197,304,300,4,304,452,0,3,1,3,0,1,0,76.14,67.26 ,33.33
03,005,01,011,0198,305,658,7,665,938,0,3,1,3,0,1,0,76.14,70.90 ,33.33
03,005,01,011,0199,306,463,9,472,686,0,3,1,3,0,1,0,76.14,68.80 ,33.33
03,005,01,011,0199,307,306,5,311,443,0,3,1,3,0,1,0,76.14,70.20 ,33.33
03,005,01,011,0200,308,804,14,818,1127,0,3,1,3,0,1,0,76.14,72.58 ,33.33
03,005,01,011,0201,309,730,6,736,1087,0,3,1,3,0,1,0,76.14,67.71 ,33.33
03,005,01,011,0202,310,316,4,320,477,0,3,1,3,0,1,0,76.14,67.09 ,33.33
03,005,01,011,0203,311,216,1,217,308,0,3,1,3,0,1,0,76.14,70.45 ,33.33
03,005,01,012,0204,312,895,13,908,1172,0,3,1,3,0,1,0,76.14,77.47 ,33.33
03,005,01,012,0204,313,846,14,860,1097,0,3,1,3,0,1,0,76.14,78.40 ,33.33
03,005,01,012,0205,314,638,11,649,847,0,3,1,3,0,1,0,76.14,76.62 ,33.33
03,005,01,012,0205,315,689,14,703,903,0,3,1,3,0,1,0,76.14,77.85 ,33.33
03,005,01,012,0206,316,434,7,441,569,0,3,1,3,0,1,0,76.14,77.50 ,33.33
03,005,01,012,0207,317,534,10,544,686,0,3,1,3,0,1,0,76.14,79.30 ,33.33
03,005,01,012,0207,318,612,9,621,764,0,3,1,3,0,1,0,76.14,81.28 ,33.33
03,005,01,012,0208,319,661,31,692,879,0,3,1,3,0,1,0,76.14,78.73 ,33.33
03,005,01,012,0209,320,269,5,274,359,0,3,1,3,0,1,0,76.14,76.32 ,33.33
03,005,01,012,0210,321,731,14,745,926,0,3,1,3,0,1,0,76.14,80.45 ,33.33
03,005,01,012,0210,322,180,4,184,229,0,3,1,3,0,1,0,76.14,80.35 ,33.33
03,005,01,012,0211,323,276,2,278,370,0,3,1,3,0,1,0,76.14,75.14 ,33.33
03,005,01,013,0212,324,805,14,819,1043,0,3,1,3,0,1,0,76.14,78.52 ,33.33
03,005,01,013,0212,325,749,15,764,986,0,3,1,3,0,1,0,76.14,77.48 ,33.33
03,005,01,013,0212,326,626,4,630,816,0,3,1,3,0,1,0,76.14,77.21 ,33.33
03,005,01,013,0212,327,832,10,842,1038,0,3,1,3,0,1,0,76.14,81.12 ,33.33
03,005,01,013,0213,328,933,13,946,1138,0,3,1,3,0,1,0,76.14,83.13 ,33.33
03,005,01,013,0213,329,929,10,939,1247,0,3,1,3,0,1,0,76.14,75.30 ,33.33
03,005,01,013,0214,330,705,10,715,908,0,3,1,3,0,1,0,76.14,78.74 ,33.33
03,005,01,013,0214,331,542,12,554,712,0,3,1,3,0,1,0,76.14,77.81 ,33.33
03,005,01,013,0215,332,587,7,594,725,0,3,1,3,0,1,0,76.14,81.93 ,33.33
03,005,01,013,0215,333,508,5,513,655,0,3,1,3,0,1,0,76.14,78.32 ,33.33
03,005,01,013,0216,334,990,13,1003,1257,0,3,1,3,0,1,0,76.14,79.79 ,33.33
03,005,01,013,0217,335,317,5,322,386,0,3,1,3,0,1,0,76.14,83.42 ,33.33
03,005,01,013,0218,336,883,6,889,1117,0,3,1,3,0,1,0,76.14,79.59 ,33.33
03,005,01,014,0219,337,488,7,495,654,0,3,1,3,0,1,0,76.14,75.69 ,33.33
03,005,01,014,0220,338,470,10,480,609,0,3,1,3,0,1,0,76.14,78.82 ,33.33
03,005,01,014,0221,339,701,15,716,972,0,3,1,3,0,1,0,76.14,73.66 ,33.33
03,005,01,014,0222,340,582,4,586,702,0,3,1,3,0,1,0,76.14,83.48 ,33.33
03,005,01,014,0223,341,767,5,772,1088,0,3,1,3,0,1,0,76.14,70.96 ,33.33
03,005,01,014,0224,342,425,5,430,554,0,3,1,3,0,1,0,76.14,77.62 ,33.33
03,005,01,014,0225,343,418,11,429,566,0,3,1,3,0,1,0,76.14,75.80 ,33.33
03,005,01,014,0226,344,783,47,830,1144,0,3,1,3,0,1,0,76.14,72.55 ,33.33
03,005,01,014,0227,345,507,9,516,714,0,3,1,3,0,1,0,76.14,72.27 ,33.33
03,005,01,015,0228,346,1215,12,1227,1556,0,3,1,3,0,1,0,76.14,78.86 ,33.33
03,005,01,015,0229,347,447,7,454,556,0,3,1,3,0,1,0,76.14,81.65 ,33.33
03,005,01,015,0230,348,738,5,743,946,0,3,1,3,0,1,0,76.14,78.54 ,33.33
03,005,01,015,0231,349,1238,7,1245,1492,0,3,1,3,0,1,0,76.14,83.45 ,33.33
03,005,01,015,0231,350,1036,15,1051,1292,0,3,1,3,0,1,0,76.14,81.35 ,33.33
03,005,01,015,0232,351,479,4,483,574,0,3,1,3,0,1,0,76.14,84.15 ,33.33
03,005,01,015,0233,352,454,7,461,546,0,3,1,3,0,1,0,76.14,84.43 ,33.33
03,005,01,015,0234,353,983,18,1001,1319,0,3,1,3,0,1,0,76.14,75.89 ,33.33
03,005,01,015,0235,354,571,8,579,721,0,3,1,3,0,1,0,76.14,80.31 ,33.33
03,005,01,015,0236,355,818,12,830,1053,0,3,1,3,0,1,0,76.14,78.82 ,33.33
03,005,01,016,0237,356,844,11,855,1101,0,3,1,3,0,1,0,76.14,77.66 ,33.33
03,005,01,016,0237,357,717,8,725,1015,0,3,1,3,0,1,0,76.14,71.43 ,33.33
03,005,01,016,0238,358,456,5,461,580,0,3,1,3,0,1,0,76.14,79.48 ,33.33
03,005,01,016,0239,359,650,8,658,877,0,3,1,3,0,1,0,76.14,75.03 ,33.33
03,005,01,016,0240,360,204,3,207,254,0,3,1,3,0,1,0,76.14,81.50 ,33.33
03,005,01,016,0241,361,437,4,441,608,0,3,1,3,0,1,0,76.14,72.53 ,33.33
03,005,01,016,0242,362,500,7,507,705,0,3,1,3,0,1,0,76.14,71.91 ,33.33
03,005,01,016,0243,363,401,5,406,508,0,3,1,3,0,1,0,76.14,79.92 ,33.33
03,005,01,016,0244,364,261,4,265,337,0,3,1,3,0,1,0,76.14,78.64 ,33.33
03,005,01,017,0245,365,216,0,216,302,0,3,1,3,0,1,0,76.14,71.52 ,33.33
03,005,01,017,0246,366,478,11,489,683,0,3,1,3,0,1,0,76.14,71.60 ,33.33
03,005,01,017,0247,367,692,11,703,1032,0,3,1,3,0,1,0,76.14,68.12 ,33.33
03,005,01,017,0248,368,417,9,426,632,0,3,1,3,0,1,0,76.14,67.41 ,33.33
03,005,01,017,0249,369,469,7,476,695,0,3,1,3,0,1,0,76.14,68.49 ,33.33
03,005,01,017,0250,370,295,0,295,391,0,3,1,3,0,1,0,76.14,75.45 ,33.33
03,005,01,017,0251,371,600,17,617,820,0,3,1,3,0,1,0,76.14,75.24 ,33.33
03,005,01,018,0252,372,98,1,99,126,0,3,1,3,0,1,0,76.14,78.57 ,33.33
03,005,01,018,0253,373,231,1,232,368,0,3,1,3,0,1,0,76.14,63.04 ,33.33
03,005,01,018,0254,374,227,3,230,318,0,3,1,3,0,1,0,76.14,72.33 ,33.33
03,005,01,018,0254,375,275,3,278,361,0,3,1,3,0,1,0,76.14,77.01 ,33.33
03,005,01,018,0255,376,81,1,82,107,0,3,1,3,0,1,0,76.14,76.64 ,33.33
03,005,01,018,0256,377,91,3,94,133,0,3,1,3,0,1,0,76.14,70.68 ,33.33
03,005,01,018,0257,378,17,0,17,25,0,3,1,3,0,1,0,76.14,68.00 ,33.33
03,005,01,018,0258,379,39,1,40,62,0,3,1,3,0,1,0,76.14,64.52 ,33.33
03,005,01,018,0259,380,16,0,16,34,0,3,1,3,0,1,0,76.14,47.06 ,33.33
03,006,01,001,0001,1,708,17,725,1013,0,3,1,3,0,1,0,76.14,71.57 ,33.33
03,006,01,001,0001,2,773,9,782,1039,0,3,1,3,0,1,0,76.14,75.26 ,33.33
03,006,01,001,0002,3,639,8,647,918,0,3,1,3,0,1,0,76.14,70.48 ,33.33
03,006,01,001,0003,4,556,4,560,789,0,3,1,3,0,1,0,76.14,70.98 ,33.33
03,006,01,001,0004,5,716,16,732,1011,0,3,1,3,0,1,0,76.14,72.40 ,33.33
03,006,01,001,0005,6,664,11,675,859,0,3,1,3,0,1,0,76.14,78.58 ,33.33
03,006,01,001,0006,7,970,8,978,1354,0,3,1,3,0,1,0,76.14,72.23 ,33.33
03,006,01,001,0006,8,975,18,993,1352,0,3,1,3,0,1,0,76.14,73.45 ,33.33
03,006,01,001,0006,9,1145,13,1158,1559,0,3,1,3,0,1,0,76.14,74.28 ,33.33
03,006,01,001,0007,10,729,11,740,1031,0,3,1,3,0,1,0,76.14,71.77 ,33.33
03,006,01,001,0007,11,763,11,774,994,0,3,1,3,0,1,0,76.14,77.87 ,33.33
03,006,01,001,0008,12,700,14,714,905,0,3,1,3,0,1,0,76.14,78.90 ,33.33
03,006,01,001,0008,13,804,16,820,1061,0,3,1,3,0,1,0,76.14,77.29 ,33.33
03,006,01,001,0009,14,1316,24,1340,1790,0,3,1,3,0,1,0,76.14,74.86 ,33.33
03,006,01,001,0009,15,1037,24,1061,1488,0,3,1,3,0,1,0,76.14,71.30 ,33.33
03,006,01,001,0010,16,1134,36,1170,1677,0,3,1,3,0,1,0,76.14,69.77 ,33.33
03,006,01,001,0010,17,1145,26,1171,1609,0,3,1,3,0,1,0,76.14,72.78 ,33.33
03,006,01,001,0010,18,1201,22,1223,1832,0,3,1,3,0,1,0,76.14,66.76 ,33.33
03,006,01,001,0011,19,1136,15,1151,1601,0,3,1,3,0,1,0,76.14,71.89 ,33.33
03,006,01,001,0012,20,903,8,911,1152,0,3,1,3,0,1,0,76.14,79.08 ,33.33
03,006,01,001,0013,21,866,9,875,1143,0,3,1,3,0,1,0,76.14,76.55 ,33.33
03,006,01,001,0013,22,962,22,984,1336,0,3,1,3,0,1,0,76.14,73.65 ,33.33
03,006,01,001,0014,23,693,9,702,911,0,3,1,3,0,1,0,76.14,77.06 ,33.33
03,006,01,001,0015,24,685,4,689,929,0,3,1,3,0,1,0,76.14,74.17 ,33.33
03,006,01,001,0016,25,1107,13,1120,1490,0,3,1,3,0,1,0,76.14,75.17 ,33.33
03,006,01,001,0016,26,1105,22,1127,1632,0,3,1,3,0,1,0,76.14,69.06 ,33.33
03,006,01,001,0016,27,1015,17,1032,1451,0,3,1,3,0,1,0,76.14,71.12 ,33.33
03,006,01,001,0017,28,741,13,754,1039,0,3,1,3,0,1,0,76.14,72.57 ,33.33
03,006,01,001,0017,29,785,9,794,1057,0,3,1,3,0,1,0,76.14,75.12 ,33.33
03,006,01,001,0018,30,962,9,971,1347,0,3,1,3,0,1,0,76.14,72.09 ,33.33
03,006,01,001,0018,31,1008,17,1025,1382,0,3,1,3,0,1,0,76.14,74.17 ,33.33
03,006,01,001,0019,32,1109,19,1128,1592,0,3,1,3,0,1,0,76.14,70.85 ,33.33
03,006,01,001,0019,33,1076,15,1091,1488,0,3,1,3,0,1,0,76.14,73.32 ,33.33
03,006,01,001,0019,34,944,15,959,1510,0,3,1,3,0,1,0,76.14,63.51 ,33.33
03,006,01,001,0019,35,1101,30,1131,1581,0,3,1,3,0,1,0,76.14,71.54 ,33.33
03,006,01,001,0020,36,1352,30,1382,1882,0,3,1,3,0,1,0,76.14,73.43 ,33.33
03,006,01,001,0020,37,1256,29,1285,1891,0,3,1,3,0,1,0,76.14,67.95 ,33.33
03,006,01,001,0021,38,1006,17,1023,1432,0,3,1,3,0,1,0,76.14,71.44 ,33.33
03,006,01,001,0022,39,776,9,785,1130,0,3,1,3,0,1,0,76.14,69.47 ,33.33
03,006,01,001,0023,40,918,23,941,1343,0,3,1,3,0,1,0,76.14,70.07 ,33.33
03,006,01,001,0023,41,986,14,1000,1433,0,3,1,3,0,1,0,76.14,69.78 ,33.33
03,006,01,001,0023,42,956,13,969,1318,0,3,1,3,0,1,0,76.14,73.52 ,33.33
03,006,01,001,0024,43,998,15,1013,1421,0,3,1,3,0,1,0,76.14,71.29 ,33.33
03,006,01,001,0024,44,1015,13,1028,1523,0,3,1,3,0,1,0,76.14,67.50 ,33.33
03,006,01,001,0024,45,1012,19,1031,1429,0,3,1,3,0,1,0,76.14,72.15 ,33.33
03,006,01,001,0024,46,1056,20,1076,1474,0,3,1,3,0,1,0,76.14,73.00 ,33.33
03,006,01,001,0024,47,961,17,978,1341,0,3,1,3,0,1,0,76.14,72.93 ,33.33
03,006,01,001,0025,48,1196,22,1218,1598,0,3,1,3,0,1,0,76.14,76.22 ,33.33
03,006,01,001,0025,49,1013,24,1037,1438,0,3,1,3,0,1,0,76.14,72.11 ,33.33
03,006,01,001,0026,50,940,16,956,1306,0,3,1,3,0,1,0,76.14,73.20 ,33.33
03,006,01,001,0026,51,708,12,720,1023,0,3,1,3,0,1,0,76.14,70.38 ,33.33
03,006,01,001,0027,52,1157,19,1176,1599,0,3,1,3,0,1,0,76.14,73.55 ,33.33
03,006,01,001,0027,53,1121,21,1142,1631,0,3,1,3,0,1,0,76.14,70.02 ,33.33
03,006,01,001,0027,54,1230,12,1242,1741,0,3,1,3,0,1,0,76.14,71.34 ,33.33
03,006,01,001,0028,55,1214,17,1231,1699,0,3,1,3,0,1,0,76.14,72.45 ,33.33
03,006,01,001,0028,56,1392,16,1408,1960,0,3,1,3,0,1,0,76.14,71.84 ,33.33
03,006,01,001,0028,57,1228,24,1252,1736,0,3,1,3,0,1,0,76.14,72.12 ,33.33
03,006,01,001,0028,58,1151,19,1170,1659,0,3,1,3,0,1,0,76.14,70.52 ,33.33
03,006,01,001,0028,59,1149,12,1161,1627,0,3,1,3,0,1,0,76.14,71.36 ,33.33
03,006,01,001,0029,60,1146,18,1164,1510,0,3,1,3,0,1,0,76.14,77.09 ,33.33
03,006,01,001,0030,61,1115,24,1139,1520,0,3,1,3,0,1,0,76.14,74.93 ,33.33
03,006,01,001,0030,62,1228,19,1247,1730,0,3,1,3,0,1,0,76.14,72.08 ,33.33
03,006,01,001,0031,63,1224,22,1246,1657,0,3,1,3,0,1,0,76.14,75.20 ,33.33
03,006,01,001,0031,64,938,14,952,1264,0,3,1,3,0,1,0,76.14,75.32 ,33.33
03,006,01,001,0032,65,977,20,997,1319,0,3,1,3,0,1,0,76.14,75.59 ,33.33
03,006,01,001,0032,66,931,8,939,1349,0,3,1,3,0,1,0,76.14,69.61 ,33.33
03,006,01,001,0033,67,993,25,1018,1355,0,3,1,3,0,1,0,76.14,75.13 ,33.33
03,006,01,001,0034,68,906,14,920,1228,0,3,1,3,0,1,0,76.14,74.92 ,33.33
03,006,01,001,0034,69,658,16,674,947,0,3,1,3,0,1,0,76.14,71.17 ,33.33
03,006,01,001,0035,70,1289,36,1325,1749,0,3,1,3,0,1,0,76.14,75.76 ,33.33
03,006,01,001,0036,71,1052,18,1070,1423,0,3,1,3,0,1,0,76.14,75.19 ,33.33
03,006,01,001,0036,72,818,16,834,1160,0,3,1,3,0,1,0,76.14,71.90 ,33.33
03,006,01,002,0037,73,808,7,815,1125,0,3,1,3,0,1,0,76.14,72.44 ,33.33
03,006,01,002,0038,74,674,8,682,898,0,3,1,3,0,1,0,76.14,75.95 ,33.33
03,006,01,002,0039,75,1143,14,1157,1562,0,3,1,3,0,1,0,76.14,74.07 ,33.33
03,006,01,002,0040,76,699,13,712,906,0,3,1,3,0,1,0,76.14,78.59 ,33.33
03,006,01,002,0040,77,771,17,788,1053,0,3,1,3,0,1,0,76.14,74.83 ,33.33
03,006,01,002,0041,78,825,10,835,1153,0,3,1,3,0,1,0,76.14,72.42 ,33.33
03,006,01,002,0041,79,797,13,810,1144,0,3,1,3,0,1,0,76.14,70.80 ,33.33
03,006,01,002,0042,80,786,5,791,1059,0,3,1,3,0,1,0,76.14,74.69 ,33.33
03,006,01,002,0043,81,1126,26,1152,1575,0,3,1,3,0,1,0,76.14,73.14 ,33.33
03,006,01,002,0044,82,1237,8,1245,1717,0,3,1,3,0,1,0,76.14,72.51 ,33.33
03,006,01,002,0044,83,1036,16,1052,1474,0,3,1,3,0,1,0,76.14,71.37 ,33.33
03,006,01,002,0045,84,1262,17,1279,1838,0,3,1,3,0,1,0,76.14,69.59 ,33.33
03,006,01,002,0046,85,678,11,689,944,0,3,1,3,0,1,0,76.14,72.99 ,33.33
03,006,01,002,0046,86,991,19,1010,1437,0,3,1,3,0,1,0,76.14,70.29 ,33.33
03,006,01,002,0047,87,1031,18,1049,1477,0,3,1,3,0,1,0,76.14,71.02 ,33.33
03,006,01,002,0048,88,880,20,900,1244,0,3,1,3,0,1,0,76.14,72.35 ,33.33
03,006,01,002,0048,89,1088,14,1102,1470,0,3,1,3,0,1,0,76.14,74.97 ,33.33
03,006,01,002,0048,90,1074,16,1090,1519,0,3,1,3,0,1,0,76.14,71.76 ,33.33
03,006,01,002,0049,91,1114,24,1138,1492,0,3,1,3,0,1,0,76.14,76.27 ,33.33
03,006,01,002,0050,92,735,8,743,998,0,3,1,3,0,1,0,76.14,74.45 ,33.33
03,006,01,002,0051,93,697,7,704,899,0,3,1,3,0,1,0,76.14,78.31 ,33.33
03,006,01,002,0052,94,789,7,796,1059,0,3,1,3,0,1,0,76.14,75.17 ,33.33
03,006,01,002,0052,95,673,4,677,892,0,3,1,3,0,1,0,76.14,75.90 ,33.33
03,006,01,002,0053,96,906,14,920,1393,0,3,1,3,0,1,0,76.14,66.04 ,33.33
03,006,01,002,0054,97,1211,24,1235,1705,0,3,1,3,0,1,0,76.14,72.43 ,33.33
03,006,01,002,0055,98,1373,22,1395,1834,0,3,1,3,0,1,0,76.14,76.06 ,33.33
03,006,01,002,0056,99,1106,18,1124,1492,0,3,1,3,0,1,0,76.14,75.34 ,33.33
03,006,01,002,0057,100,866,8,874,1221,0,3,1,3,0,1,0,76.14,71.58 ,33.33
03,006,01,002,0058,101,1045,18,1063,1543,0,3,1,3,0,1,0,76.14,68.89 ,33.33
03,006,01,002,0059,102,547,8,555,754,0,3,1,3,0,1,0,76.14,73.61 ,33.33
03,006,01,002,0060,103,532,7,539,674,0,3,1,3,0,1,0,76.14,79.97 ,33.33
03,006,01,002,0061,104,949,24,973,1350,0,3,1,3,0,1,0,76.14,72.07 ,33.33
03,006,01,003,0062,105,814,18,832,1155,0,3,1,3,0,1,0,76.14,72.03 ,33.33
03,006,01,003,0063,106,878,8,886,1209,0,3,1,3,0,1,0,76.14,73.28 ,33.33
03,006,01,003,0064,107,659,10,669,893,0,3,1,3,0,1,0,76.14,74.92 ,33.33
03,006,01,003,0064,108,632,7,639,880,0,3,1,3,0,1,0,76.14,72.61 ,33.33
03,006,01,003,0065,109,524,9,533,717,0,3,1,3,0,1,0,76.14,74.34 ,33.33
03,006,01,003,0066,110,669,7,676,888,0,3,1,3,0,1,0,76.14,76.13 ,33.33
03,006,01,003,0066,111,576,8,584,757,0,3,1,3,0,1,0,76.14,77.15 ,33.33
03,006,01,003,0067,112,576,9,585,853,0,3,1,3,0,1,0,76.14,68.58 ,33.33
03,006,01,003,0067,113,696,8,704,977,0,3,1,3,0,1,0,76.14,72.06 ,33.33
03,006,01,003,0068,114,683,16,699,963,0,3,1,3,0,1,0,76.14,72.59 ,33.33
03,006,01,003,0068,115,736,9,745,1017,0,3,1,3,0,1,0,76.14,73.25 ,33.33
03,006,01,003,0068,116,728,9,737,995,0,3,1,3,0,1,0,76.14,74.07 ,33.33
03,006,01,003,0069,117,1150,21,1171,1457,0,3,1,3,0,1,0,76.14,80.37 ,33.33
03,006,01,003,0070,118,625,12,637,872,0,3,1,3,0,1,0,76.14,73.05 ,33.33
03,006,01,003,0070,119,1274,18,1292,1777,0,3,1,3,0,1,0,76.14,72.71 ,33.33
03,006,01,003,0071,120,640,13,653,903,0,3,1,3,0,1,0,76.14,72.31 ,33.33
03,006,01,003,0072,121,663,4,667,908,0,3,1,3,0,1,0,76.14,73.46 ,33.33
03,006,01,003,0073,122,820,9,829,1077,0,3,1,3,0,1,0,76.14,76.97 ,33.33
03,006,01,003,0073,123,901,20,921,1217,0,3,1,3,0,1,0,76.14,75.68 ,33.33
03,006,01,003,0074,124,813,15,828,1001,0,3,1,3,0,1,0,76.14,82.72 ,33.33
03,006,01,003,0075,125,813,12,825,1038,0,3,1,3,0,1,0,76.14,79.48 ,33.33
03,006,01,003,0076,126,1024,18,1042,1295,0,3,1,3,0,1,0,76.14,80.46 ,33.33
03,006,01,003,0077,127,889,9,898,1186,0,3,1,3,0,1,0,76.14,75.72 ,33.33
03,006,01,003,0077,128,867,18,885,1169,0,3,1,3,0,1,0,76.14,75.71 ,33.33
03,006,01,003,0077,129,951,13,964,1307,0,3,1,3,0,1,0,76.14,73.76 ,33.33
03,006,01,003,0078,130,753,16,769,983,0,3,1,3,0,1,0,76.14,78.23 ,33.33
03,006,01,003,0079,131,1015,14,1029,1316,0,3,1,3,0,1,0,76.14,78.19 ,33.33
03,006,01,003,0080,132,634,8,642,805,0,3,1,3,0,1,0,76.14,79.75 ,33.33
03,006,01,003,0081,133,653,15,668,860,0,3,1,3,0,1,0,76.14,77.67 ,33.33
03,006,01,003,0081,134,764,11,775,961,0,3,1,3,0,1,0,76.14,80.65 ,33.33
03,006,01,003,0081,135,777,16,793,1031,0,3,1,3,0,1,0,76.14,76.92 ,33.33
03,006,01,003,0082,136,849,9,858,1136,0,3,1,3,0,1,0,76.14,75.53 ,33.33
03,006,01,003,0083,137,1125,22,1147,1477,0,3,1,3,0,1,0,76.14,77.66 ,33.33
03,006,01,003,0083,138,969,18,987,1284,0,3,1,3,0,1,0,76.14,76.87 ,33.33
03,006,01,003,0084,139,798,13,811,1097,0,3,1,3,0,1,0,76.14,73.93 ,33.33
03,006,01,003,0084,140,829,11,840,1142,0,3,1,3,0,1,0,76.14,73.56 ,33.33
03,006,01,003,0085,141,844,14,858,1239,0,3,1,3,0,1,0,76.14,69.25 ,33.33
03,006,01,003,0085,142,717,19,736,1104,0,3,1,3,0,1,0,76.14,66.67 ,33.33
03,006,01,003,0085,143,562,7,569,864,0,3,1,3,0,1,0,76.14,65.86 ,33.33
03,006,01,003,0086,144,994,11,1005,1254,0,3,1,3,0,1,0,76.14,80.14 ,33.33
03,006,01,003,0087,145,1068,19,1087,1457,0,3,1,3,0,1,0,76.14,74.61 ,33.33
03,006,01,003,0088,146,846,17,863,1128,0,3,1,3,0,1,0,76.14,76.51 ,33.33
03,006,01,003,0089,147,839,12,851,1033,0,3,1,3,0,1,0,76.14,82.38 ,33.33
03,006,01,003,0090,148,887,13,900,1172,0,3,1,3,0,1,0,76.14,76.79 ,33.33
03,006,01,004,0091,149,868,17,885,1250,0,3,1,3,0,1,0,76.14,70.80 ,33.33
03,006,01,004,0092,150,815,10,825,1069,0,3,1,3,0,1,0,76.14,77.17 ,33.33
03,006,01,004,0093,151,1424,21,1445,1994,0,3,1,3,0,1,0,76.14,72.47 ,33.33
03,006,01,004,0094,152,543,6,549,753,0,3,1,3,0,1,0,76.14,72.91 ,33.33
03,006,01,004,0095,153,703,11,714,987,0,3,1,3,0,1,0,76.14,72.34 ,33.33
03,006,01,004,0095,154,738,8,746,1016,0,3,1,3,0,1,0,76.14,73.43 ,33.33
03,006,01,004,0096,155,1032,16,1048,1345,0,3,1,3,0,1,0,76.14,77.92 ,33.33
03,006,01,004,0097,156,544,4,548,719,0,3,1,3,0,1,0,76.14,76.22 ,33.33
03,006,01,004,0098,157,335,6,341,495,0,3,1,3,0,1,0,76.14,68.89 ,33.33
03,006,01,004,0099,158,1011,12,1023,1387,0,3,1,3,0,1,0,76.14,73.76 ,33.33
03,006,01,004,0099,159,752,10,762,968,0,3,1,3,0,1,0,76.14,78.72 ,33.33
03,006,01,004,0100,160,1219,18,1237,1686,0,3,1,3,0,1,0,76.14,73.37 ,33.33
03,006,01,004,0100,161,1262,14,1276,1637,0,3,1,3,0,1,0,76.14,77.95 ,33.33
03,006,01,004,0101,162,736,12,748,967,0,3,1,3,0,1,0,76.14,77.35 ,33.33
03,006,01,004,0102,163,988,29,1017,1310,0,3,1,3,0,1,0,76.14,77.63 ,33.33
03,006,01,004,0103,164,979,17,996,1275,0,3,1,3,0,1,0,76.14,78.12 ,33.33
03,006,01,004,0103,165,1249,28,1277,1650,0,3,1,3,0,1,0,76.14,77.39 ,33.33
03,006,01,004,0104,166,993,18,1011,1277,0,3,1,3,0,1,0,76.14,79.17 ,33.33
03,006,01,004,0104,167,836,12,848,1094,0,3,1,3,0,1,0,76.14,77.51 ,33.33
03,006,01,004,0105,168,1346,18,1364,1665,0,3,1,3,0,1,0,76.14,81.92 ,33.33
03,006,01,004,0106,169,1154,17,1171,1483,0,3,1,3,0,1,0,76.14,78.96 ,33.33
03,006,01,004,0106,170,754,8,762,1082,0,3,1,3,0,1,0,76.14,70.43 ,33.33
03,006,01,004,0107,171,1517,16,1533,1989,0,3,1,3,0,1,0,76.14,77.07 ,33.33
03,006,01,004,0108,172,971,16,987,1243,0,3,1,3,0,1,0,76.14,79.40 ,33.33
03,006,01,004,0109,173,924,9,933,1213,0,3,1,3,0,1,0,76.14,76.92 ,33.33
03,006,01,004,0110,174,923,21,944,1230,0,3,1,3,0,1,0,76.14,76.75 ,33.33
03,006,01,004,0111,175,762,16,778,961,0,3,1,3,0,1,0,76.14,80.96 ,33.33
03,006,01,004,0112,176,962,8,970,1220,0,3,1,3,0,1,0,76.14,79.51 ,33.33
03,006,01,004,0113,177,1351,11,1362,1897,0,3,1,3,0,1,0,76.14,71.80 ,33.33
03,006,01,004,0114,178,1561,25,1586,2019,0,3,1,3,0,1,0,76.14,78.55 ,33.33
03,006,01,004,0115,179,1201,21,1222,1653,0,3,1,3,0,1,0,76.14,73.93 ,33.33
03,006,01,004,0116,180,1402,26,1428,1971,0,3,1,3,0,1,0,76.14,72.45 ,33.33
03,006,01,004,0117,181,966,22,988,1440,0,3,1,3,0,1,0,76.14,68.61 ,33.33
03,006,01,004,0117,182,1072,15,1087,1586,0,3,1,3,0,1,0,76.14,68.54 ,33.33
03,006,01,004,0117,183,1001,12,1013,1455,0,3,1,3,0,1,0,76.14,69.62 ,33.33
03,006,01,004,0118,184,847,9,856,1186,0,3,1,3,0,1,0,76.14,72.18 ,33.33
03,006,01,004,0118,185,1119,18,1137,1560,0,3,1,3,0,1,0,76.14,72.88 ,33.33
03,006,01,004,0119,186,863,15,878,1059,0,3,1,3,0,1,0,76.14,82.91 ,33.33
03,006,01,004,0120,187,797,6,803,1034,0,3,1,3,0,1,0,76.14,77.66 ,33.33
03,006,01,004,0121,188,718,15,733,949,0,3,1,3,0,1,0,76.14,77.24 ,33.33
03,006,01,004,0122,189,804,10,814,1050,0,3,1,3,0,1,0,76.14,77.52 ,33.33
03,006,01,005,0123,190,1003,14,1017,1296,0,3,1,3,0,1,0,76.14,78.47 ,33.33
03,006,01,005,0124,191,785,15,800,1045,0,3,1,3,0,1,0,76.14,76.56 ,33.33
03,006,01,005,0124,192,961,7,968,1184,0,3,1,3,0,1,0,76.14,81.76 ,33.33
03,006,01,005,0125,193,874,12,886,1167,0,3,1,3,0,1,0,76.14,75.92 ,33.33
03,006,01,005,0126,194,468,4,472,564,0,3,1,3,0,1,0,76.14,83.69 ,33.33
03,006,01,005,0127,195,918,17,935,1219,0,3,1,3,0,1,0,76.14,76.70 ,33.33
03,006,01,005,0127,196,675,6,681,980,0,3,1,3,0,1,0,76.14,69.49 ,33.33
03,006,01,005,0128,197,695,20,715,907,0,3,1,3,0,1,0,76.14,78.83 ,33.33
03,006,01,005,0128,198,1072,9,1081,1427,0,3,1,3,0,1,0,76.14,75.75 ,33.33
03,006,01,005,0129,199,1461,22,1483,2005,0,3,1,3,0,1,0,76.14,73.97 ,33.33
03,006,01,005,0129,200,761,10,771,985,0,3,1,3,0,1,0,76.14,78.27 ,33.33
03,006,01,005,0130,201,1316,18,1334,1728,0,3,1,3,0,1,0,76.14,77.20 ,33.33
03,006,01,005,0130,202,1204,22,1226,1570,0,3,1,3,0,1,0,76.14,78.09 ,33.33
03,006,01,005,0131,203,964,12,976,1302,0,3,1,3,0,1,0,76.14,74.96 ,33.33
03,006,01,005,0131,204,1268,13,1281,1631,0,3,1,3,0,1,0,76.14,78.54 ,33.33
03,006,01,005,0131,205,993,12,1005,1333,0,3,1,3,0,1,0,76.14,75.39 ,33.33
03,006,01,005,0132,206,1140,11,1151,1515,0,3,1,3,0,1,0,76.14,75.97 ,33.33
03,006,01,005,0132,207,1260,12,1272,1655,0,3,1,3,0,1,0,76.14,76.86 ,33.33
03,006,01,005,0132,208,891,18,909,1200,0,3,1,3,0,1,0,76.14,75.75 ,33.33
03,006,01,005,0133,209,670,10,680,838,0,3,1,3,0,1,0,76.14,81.15 ,33.33
03,006,01,005,0134,210,1359,16,1375,1791,0,3,1,3,0,1,0,76.14,76.77 ,33.33
03,006,01,005,0135,211,1012,11,1023,1332,0,3,1,3,0,1,0,76.14,76.80 ,33.33
03,006,01,005,0135,212,908,18,926,1227,0,3,1,3,0,1,0,76.14,75.47 ,33.33
03,006,01,005,0136,213,841,13,854,1095,0,3,1,3,0,1,0,76.14,77.99 ,33.33
03,006,01,005,0137,214,859,14,873,1222,0,3,1,3,0,1,0,76.14,71.44 ,33.33
03,006,01,005,0138,215,1079,22,1101,1423,0,3,1,3,0,1,0,76.14,77.37 ,33.33
03,006,01,005,0139,216,1119,13,1132,1460,0,3,1,3,0,1,0,76.14,77.53 ,33.33
03,006,01,005,0139,217,1168,17,1185,1536,0,3,1,3,0,1,0,76.14,77.15 ,33.33
03,006,01,005,0140,218,1198,19,1217,1590,0,3,1,3,0,1,0,76.14,76.54 ,33.33
03,006,01,005,0140,219,1201,16,1217,1644,0,3,1,3,0,1,0,76.14,74.03 ,33.33
03,006,01,005,0141,220,1111,20,1131,1373,0,3,1,3,0,1,0,76.14,82.37 ,33.33
03,006,01,005,0142,221,1419,24,1443,1889,0,3,1,3,0,1,0,76.14,76.39 ,33.33
03,006,01,006,0143,222,1263,17,1280,1817,0,3,1,3,0,1,0,76.14,70.45 ,33.33
03,006,01,006,0144,223,1516,24,1540,2043,0,3,1,3,0,1,0,76.14,75.38 ,33.33
03,006,01,006,0145,224,749,9,758,1025,0,3,1,3,0,1,0,76.14,73.95 ,33.33
03,006,01,006,0145,225,1169,22,1191,1848,0,3,1,3,0,1,0,76.14,64.45 ,33.33
03,006,01,006,0146,226,392,7,399,549,0,3,1,3,0,1,0,76.14,72.68 ,33.33
03,006,01,006,0147,227,828,17,845,1096,0,3,1,3,0,1,0,76.14,77.10 ,33.33
03,006,01,006,0148,228,561,8,569,748,0,3,1,3,0,1,0,76.14,76.07 ,33.33
03,006,01,006,0149,229,1391,31,1422,1872,0,3,1,3,0,1,0,76.14,75.96 ,33.33
03,006,01,006,0149,230,1349,22,1371,1786,0,3,1,3,0,1,0,76.14,76.76 ,33.33
03,006,01,006,0150,231,1258,21,1279,1678,0,3,1,3,0,1,0,76.14,76.22 ,33.33
03,006,01,006,0151,232,882,9,891,1166,0,3,1,3,0,1,0,76.14,76.42 ,33.33
03,006,01,006,0151,233,712,9,721,1019,0,3,1,3,0,1,0,76.14,70.76 ,33.33
03,006,01,006,0152,234,1122,21,1143,1626,0,3,1,3,0,1,0,76.14,70.30 ,33.33
03,006,01,006,0152,235,834,20,854,1154,0,3,1,3,0,1,0,76.14,74.00 ,33.33
03,006,01,006,0152,236,930,12,942,1311,0,3,1,3,0,1,0,76.14,71.85 ,33.33
03,006,01,006,0153,237,797,5,802,1076,0,3,1,3,0,1,0,76.14,74.54 ,33.33
03,006,01,006,0153,238,1159,13,1172,1617,0,3,1,3,0,1,0,76.14,72.48 ,33.33
03,006,01,006,0154,239,1125,13,1138,1585,0,3,1,3,0,1,0,76.14,71.80 ,33.33
03,006,01,006,0155,240,1392,35,1427,1867,0,3,1,3,0,1,0,76.14,76.43 ,33.33
03,006,01,006,0156,241,1384,21,1405,1837,0,3,1,3,0,1,0,76.14,76.48 ,33.33
03,006,01,007,0157,242,1353,28,1381,1844,0,3,1,3,0,1,0,76.14,74.89 ,33.33
03,006,01,007,0158,243,690,11,701,887,0,3,1,3,0,1,0,76.14,79.03 ,33.33
03,006,01,007,0158,244,1133,15,1148,1370,0,3,1,3,0,1,0,76.14,83.80 ,33.33
03,006,01,007,0159,245,763,19,782,1045,0,3,1,3,0,1,0,76.14,74.83 ,33.33
03,006,01,007,0159,246,1259,17,1276,1756,0,3,1,3,0,1,0,76.14,72.67 ,33.33
03,006,01,007,0159,247,1334,30,1364,1821,0,3,1,3,0,1,0,76.14,74.90 ,33.33
03,006,01,007,0160,248,1086,16,1102,1385,0,3,1,3,0,1,0,76.14,79.57 ,33.33
03,006,01,007,0160,249,1299,24,1323,1642,0,3,1,3,0,1,0,76.14,80.57 ,33.33
03,006,01,007,0161,250,1280,11,1291,1570,0,3,1,3,0,1,0,76.14,82.23 ,33.33
03,006,01,007,0162,251,1424,30,1454,1834,0,3,1,3,0,1,0,76.14,79.28 ,33.33
03,006,01,007,0162,252,1333,29,1362,1659,0,3,1,3,0,1,0,76.14,82.10 ,33.33
03,006,01,007,0163,253,1433,20,1453,1779,0,3,1,3,0,1,0,76.14,81.68 ,33.33
03,006,01,007,0164,254,1593,36,1629,2112,0,3,1,3,0,1,0,76.14,77.13 ,33.33
03,006,01,007,0165,255,964,13,977,1195,0,3,1,3,0,1,0,76.14,81.76 ,33.33
03,006,01,007,0165,256,1107,25,1132,1383,0,3,1,3,0,1,0,76.14,81.85 ,33.33
03,006,01,007,0166,257,1333,25,1358,1673,0,3,1,3,0,1,0,76.14,81.17 ,33.33
03,006,01,007,0167,258,861,18,879,1084,0,3,1,3,0,1,0,76.14,81.09 ,33.33
03,006,01,007,0168,259,1128,25,1153,1411,0,3,1,3,0,1,0,76.14,81.72 ,33.33
03,006,01,007,0169,260,1400,27,1427,1740,0,3,1,3,0,1,0,76.14,82.01 ,33.33
03,006,01,007,0170,261,1581,29,1610,2040,0,3,1,3,0,1,0,76.14,78.92 ,33.33
03,006,01,007,0171,262,265,6,271,330,0,3,1,3,0,1,0,76.14,82.12 ,33.33
03,006,01,007,0172,263,1104,17,1121,1394,0,3,1,3,0,1,0,76.14,80.42 ,33.33
03,006,01,007,0173,264,1251,20,1271,1655,0,3,1,3,0,1,0,76.14,76.80 ,33.33
03,006,01,007,0174,265,936,9,945,1215,0,3,1,3,0,1,0,76.14,77.78 ,33.33
03,006,01,008,0175,266,829,16,845,1115,0,3,1,3,0,1,0,76.14,75.78 ,33.33
03,006,01,008,0175,267,719,17,736,1001,0,3,1,3,0,1,0,76.14,73.53 ,33.33
03,006,01,008,0176,268,957,18,975,1238,0,3,1,3,0,1,0,76.14,78.76 ,33.33
03,006,01,008,0177,269,1456,23,1479,1897,0,3,1,3,0,1,0,76.14,77.97 ,33.33
03,006,01,008,0178,270,1367,26,1393,1741,0,3,1,3,0,1,0,76.14,80.01 ,33.33
03,006,01,008,0179,271,790,7,797,1007,0,3,1,3,0,1,0,76.14,79.15 ,33.33
03,006,01,008,0179,272,750,14,764,1011,0,3,1,3,0,1,0,76.14,75.57 ,33.33
03,006,01,008,0180,273,1470,31,1501,1898,0,3,1,3,0,1,0,76.14,79.08 ,33.33
03,006,01,008,0181,274,1185,16,1201,1511,0,3,1,3,0,1,0,76.14,79.48 ,33.33
03,006,01,008,0181,275,1146,30,1176,1551,0,3,1,3,0,1,0,76.14,75.82 ,33.33
03,006,01,008,0182,276,715,9,724,891,0,3,1,3,0,1,0,76.14,81.26 ,33.33
03,006,01,008,0183,277,1101,21,1122,1391,0,3,1,3,0,1,0,76.14,80.66 ,33.33
03,006,01,008,0183,278,1125,15,1140,1457,0,3,1,3,0,1,0,76.14,78.24 ,33.33
03,006,01,008,0183,279,902,19,921,1215,0,3,1,3,0,1,0,76.14,75.80 ,33.33
03,006,01,008,0184,280,1040,10,1050,1390,0,3,1,3,0,1,0,76.14,75.54 ,33.33
03,006,01,008,0184,281,1217,23,1240,1688,0,3,1,3,0,1,0,76.14,73.46 ,33.33
03,006,01,008,0185,282,1336,22,1358,1780,0,3,1,3,0,1,0,76.14,76.29 ,33.33
03,006,01,008,0186,283,1094,26,1120,1540,0,3,1,3,0,1,0,76.14,72.73 ,33.33
03,006,01,008,0187,284,726,11,737,1035,0,3,1,3,0,1,0,76.14,71.21 ,33.33
03,006,01,008,0187,285,768,12,780,1076,0,3,1,3,0,1,0,76.14,72.49 ,33.33
03,006,01,008,0188,286,1333,29,1362,1835,0,3,1,3,0,1,0,76.14,74.22 ,33.33
03,006,01,008,0188,287,1256,28,1284,1688,0,3,1,3,0,1,0,76.14,76.07 ,33.33
03,006,01,008,0188,288,1346,36,1382,1827,0,3,1,3,0,1,0,76.14,75.64 ,33.33
03,006,01,008,0189,289,743,12,755,969,0,3,1,3,0,1,0,76.14,77.92 ,33.33
03,006,01,008,0189,290,798,16,814,1017,0,3,1,3,0,1,0,76.14,80.04 ,33.33
03,006,01,008,0190,291,855,25,880,1085,0,3,1,3,0,1,0,76.14,81.11 ,33.33
03,006,01,008,0190,292,811,20,831,1086,0,3,1,3,0,1,0,76.14,76.52 ,33.33
03,006,01,009,0191,293,1081,12,1093,1484,0,3,1,3,0,1,0,76.14,73.65 ,33.33
03,006,01,009,0192,294,1324,17,1341,1854,0,3,1,3,0,1,0,76.14,72.33 ,33.33
03,006,01,009,0193,295,1061,20,1081,1522,0,3,1,3,0,1,0,76.14,71.02 ,33.33
03,006,01,009,0193,296,1270,22,1292,1843,0,3,1,3,0,1,0,76.14,70.10 ,33.33
03,006,01,009,0193,297,1159,7,1166,1763,0,3,1,3,0,1,0,76.14,66.14 ,33.33
03,006,01,009,0193,298,1087,19,1106,1563,0,3,1,3,0,1,0,76.14,70.76 ,33.33
03,006,01,009,0194,299,1174,20,1194,1598,0,3,1,3,0,1,0,76.14,74.72 ,33.33
03,006,01,009,0194,300,917,16,933,1371,0,3,1,3,0,1,0,76.14,68.05 ,33.33
03,006,01,009,0194,301,1350,22,1372,1923,0,3,1,3,0,1,0,76.14,71.35 ,33.33
03,006,01,009,0195,302,1371,19,1390,2412,0,3,1,3,0,1,0,76.14,57.63 ,33.33
03,006,01,009,0195,303,1196,27,1223,1751,0,3,1,3,0,1,0,76.14,69.85 ,33.33
03,006,01,009,0195,304,1201,20,1221,1755,0,3,1,3,0,1,0,76.14,69.57 ,33.33
03,006,01,009,0195,305,987,19,1006,1336,0,3,1,3,0,1,0,76.14,75.30 ,33.33
03,006,01,009,0195,306,1320,21,1341,1971,0,3,1,3,0,1,0,76.14,68.04 ,33.33
03,006,01,009,0196,307,937,13,950,1275,0,3,1,3,0,1,0,76.14,74.51 ,33.33
03,006,01,009,0196,308,1005,19,1024,1545,0,3,1,3,0,1,0,76.14,66.28 ,33.33
03,006,01,009,0197,309,693,13,706,913,0,3,1,3,0,1,0,76.14,77.33 ,33.33
03,006,01,009,0197,310,1260,45,1305,1822,0,3,1,3,0,1,0,76.14,71.62 ,33.33
03,006,01,009,0197,311,1075,14,1089,1477,0,3,1,3,0,1,0,76.14,73.73 ,33.33
03,006,01,009,0197,312,1015,11,1026,1388,0,3,1,3,0,1,0,76.14,73.92 ,33.33
03,006,01,009,0197,313,784,18,802,1037,0,3,1,3,0,1,0,76.14,77.34 ,33.33
03,006,01,009,0198,314,946,19,965,1140,0,3,1,3,0,1,0,76.14,84.65 ,33.33
03,006,01,009,0199,315,613,11,624,812,0,3,1,3,0,1,0,76.14,76.85 ,33.33
03,006,01,009,0199,316,901,18,919,1314,0,3,1,3,0,1,0,76.14,69.94 ,33.33
03,006,01,009,0200,317,1017,20,1037,1428,0,3,1,3,0,1,0,76.14,72.62 ,33.33
03,006,01,009,0200,318,899,11,910,1245,0,3,1,3,0,1,0,76.14,73.09 ,33.33
03,006,01,009,0200,319,745,13,758,1017,0,3,1,3,0,1,0,76.14,74.53 ,33.33
03,006,01,009,0201,320,1114,18,1132,1483,0,3,1,3,0,1,0,76.14,76.33 ,33.33
03,006,01,009,0201,321,1005,17,1022,1378,0,3,1,3,0,1,0,76.14,74.17 ,33.33
03,006,01,009,0202,322,1073,21,1094,1458,0,3,1,3,0,1,0,76.14,75.03 ,33.33
03,006,01,009,0203,323,994,15,1009,1302,0,3,1,3,0,1,0,76.14,77.50 ,33.33
03,006,01,009,0203,324,926,27,953,1316,0,3,1,3,0,1,0,76.14,72.42 ,33.33
03,006,01,010,0204,325,1291,17,1308,1815,0,3,1,3,0,1,0,76.14,72.07 ,33.33
03,006,01,010,0204,326,1348,21,1369,1897,0,3,1,3,0,1,0,76.14,72.17 ,33.33
03,006,01,010,0204,327,1181,23,1204,1683,0,3,1,3,0,1,0,76.14,71.54 ,33.33
03,006,01,010,0204,328,1357,30,1387,2017,0,3,1,3,0,1,0,76.14,68.77 ,33.33
03,006,01,010,0204,329,1410,20,1430,2035,0,3,1,3,0,1,0,76.14,70.27 ,33.33
03,006,01,010,0205,330,1611,32,1643,2439,0,3,1,3,0,1,0,76.14,67.36 ,33.33
03,006,01,010,0205,331,1154,27,1181,1642,0,3,1,3,0,1,0,76.14,71.92 ,33.33
03,006,01,010,0205,332,987,22,1009,1335,0,3,1,3,0,1,0,76.14,75.58 ,33.33
03,006,01,010,0205,333,947,19,966,1286,0,3,1,3,0,1,0,76.14,75.12 ,33.33
03,006,01,010,0206,334,1498,23,1521,2053,0,3,1,3,0,1,0,76.14,74.09 ,33.33
03,006,01,010,0207,335,1506,25,1531,2176,0,3,1,3,0,1,0,76.14,70.36 ,33.33
03,006,01,010,0207,336,1353,36,1389,2058,0,3,1,3,0,1,0,76.14,67.49 ,33.33
03,006,01,010,0207,337,716,13,729,954,0,3,1,3,0,1,0,76.14,76.42 ,33.33
03,006,01,010,0207,338,995,21,1016,1612,0,3,1,3,0,1,0,76.14,63.03 ,33.33
03,006,01,010,0208,339,1005,22,1027,1305,0,3,1,3,0,1,0,76.14,78.70 ,33.33
03,006,01,010,0208,340,964,26,990,1309,0,3,1,3,0,1,0,76.14,75.63 ,33.33
03,006,01,010,0208,341,1140,28,1168,1547,0,3,1,3,0,1,0,76.14,75.50 ,33.33
03,006,01,010,0209,342,1238,22,1260,1644,0,3,1,3,0,1,0,76.14,76.64 ,33.33
03,006,01,010,0209,343,1224,28,1252,1699,0,3,1,3,0,1,0,76.14,73.69 ,33.33
03,006,01,010,0209,344,970,23,993,1308,0,3,1,3,0,1,0,76.14,75.92 ,33.33
03,006,01,010,0210,345,1065,18,1083,1335,0,3,1,3,0,1,0,76.14,81.12 ,33.33
03,006,01,010,0210,346,740,14,754,975,0,3,1,3,0,1,0,76.14,77.33 ,33.33
03,006,01,010,0211,347,1095,27,1122,1412,0,3,1,3,0,1,0,76.14,79.46 ,33.33
03,006,01,010,0211,348,832,19,851,1114,0,3,1,3,0,1,0,76.14,76.39 ,33.33
03,006,01,010,0212,349,1040,23,1063,1353,0,3,1,3,0,1,0,76.14,78.57 ,33.33
03,006,01,010,0212,350,1218,30,1248,1759,0,3,1,3,0,1,0,76.14,70.95 ,33.33
03,006,01,011,0213,351,1819,31,1850,2393,0,3,1,3,0,1,0,76.14,77.31 ,33.33
03,006,01,011,0214,352,1302,22,1324,1666,0,3,1,3,0,1,0,76.14,79.47 ,33.33
03,006,01,011,0215,353,938,18,956,1179,0,3,1,3,0,1,0,76.14,81.09 ,33.33
03,006,01,011,0216,354,690,10,700,848,0,3,1,3,0,1,0,76.14,82.55 ,33.33
03,006,01,011,0217,355,939,17,956,1219,0,3,1,3,0,1,0,76.14,78.42 ,33.33
03,006,01,011,0218,356,1524,26,1550,1954,0,3,1,3,0,1,0,76.14,79.32 ,33.33
03,006,01,011,0219,357,1387,31,1418,1743,0,3,1,3,0,1,0,76.14,81.35 ,33.33
03,006,01,011,0219,358,493,10,503,637,0,3,1,3,0,1,0,76.14,78.96 ,33.33
03,006,01,011,0220,359,687,4,691,878,0,3,1,3,0,1,0,76.14,78.70 ,33.33
03,006,01,011,0221,360,864,13,877,1124,0,3,1,3,0,1,0,76.14,78.02 ,33.33
03,006,01,011,0221,361,996,17,1013,1290,0,3,1,3,0,1,0,76.14,78.53 ,33.33
03,006,01,011,0222,362,1011,14,1025,1264,0,3,1,3,0,1,0,76.14,81.09 ,33.33
03,006,01,011,0223,363,232,3,235,280,0,3,1,3,0,1,0,76.14,83.93 ,33.33
03,006,01,011,0223,364,478,8,486,628,0,3,1,3,0,1,0,76.14,77.39 ,33.33
03,006,01,011,0224,365,474,1,475,618,0,3,1,3,0,1,0,76.14,76.86 ,33.33
03,006,01,011,0225,366,814,13,827,1113,0,3,1,3,0,1,0,76.14,74.30 ,33.33
03,006,01,011,0225,367,212,0,212,278,0,3,1,3,0,1,0,76.14,76.26 ,33.33
03,006,01,012,0226,368,674,11,685,881,0,3,1,3,0,1,0,76.14,77.75 ,33.33
03,006,01,012,0227,369,817,16,833,1078,0,3,1,3,0,1,0,76.14,77.27 ,33.33
03,006,01,012,0228,370,711,12,723,932,0,3,1,3,0,1,0,76.14,77.58 ,33.33
03,006,01,012,0229,371,780,10,790,1051,0,3,1,3,0,1,0,76.14,75.17 ,33.33
03,006,01,012,0230,372,480,6,486,632,0,3,1,3,0,1,0,76.14,76.90 ,33.33
03,006,01,012,0231,373,945,23,968,1193,0,3,1,3,0,1,0,76.14,81.14 ,33.33
03,006,01,012,0232,374,1211,26,1237,1599,0,3,1,3,0,1,0,76.14,77.36 ,33.33
03,006,01,012,0233,375,751,12,763,966,0,3,1,3,0,1,0,76.14,78.99 ,33.33
03,006,01,012,0234,376,982,16,998,1264,0,3,1,3,0,1,0,76.14,78.96 ,33.33
03,006,01,012,0235,377,994,13,1007,1272,0,3,1,3,0,1,0,76.14,79.17 ,33.33
03,006,01,013,0236,378,775,10,785,930,0,3,1,3,0,1,0,76.14,84.41 ,33.33
03,006,01,013,0237,379,986,20,1006,1244,0,3,1,3,0,1,0,76.14,80.87 ,33.33
03,006,01,013,0238,380,1193,22,1215,1507,0,3,1,3,0,1,0,76.14,80.62 ,33.33
03,006,01,013,0239,381,1244,23,1267,1634,0,3,1,3,0,1,0,76.14,77.54 ,33.33
03,006,01,013,0239,382,1162,23,1185,1488,0,3,1,3,0,1,0,76.14,79.64 ,33.33
03,006,01,013,0240,383,1538,29,1567,2004,0,3,1,3,0,1,0,76.14,78.19 ,33.33
03,006,01,013,0241,384,1278,35,1313,1648,0,3,1,3,0,1,0,76.14,79.67 ,33.33
03,006,01,013,0241,385,1468,34,1502,1926,0,3,1,3,0,1,0,76.14,77.99 ,33.33
03,006,01,013,0242,386,1012,15,1027,1264,0,3,1,3,0,1,0,76.14,81.25 ,33.33
03,006,01,013,0243,387,725,8,733,865,0,3,1,3,0,1,0,76.14,84.74 ,33.33
03,006,01,013,0244,388,1473,23,1496,1848,0,3,1,3,0,1,0,76.14,80.95 ,33.33
03,006,01,013,0245,389,1159,23,1182,1425,0,3,1,3,0,1,0,76.14,82.95 ,33.33
03,006,01,013,0246,390,860,15,875,1080,0,3,1,3,0,1,0,76.14,81.02 ,33.33
03,006,01,014,0247,391,814,7,821,1009,0,3,1,3,0,1,0,76.14,81.37 ,33.33
03,006,01,014,0248,392,780,12,792,1036,0,3,1,3,0,1,0,76.14,76.45 ,33.33
03,006,01,014,0249,393,1492,18,1510,2093,0,3,1,3,0,1,0,76.14,72.15 ,33.33
03,006,01,014,0250,394,887,11,898,1116,0,3,1,3,0,1,0,76.14,80.47 ,33.33
03,006,01,014,0251,395,786,6,792,999,0,3,1,3,0,1,0,76.14,79.28 ,33.33
03,006,01,014,0252,396,1232,16,1248,1600,0,3,1,3,0,1,0,76.14,78.00 ,33.33
03,006,01,014,0253,397,616,4,620,802,0,3,1,3,0,1,0,76.14,77.31 ,33.33
03,006,01,014,0254,398,1074,17,1091,1443,0,3,1,3,0,1,0,76.14,75.61 ,33.33
03,006,01,014,0255,399,668,11,679,922,0,3,1,3,0,1,0,76.14,73.64 ,33.33
03,006,01,014,0256,400,1034,12,1046,1311,0,3,1,3,0,1,0,76.14,79.79 ,33.33
03,006,01,014,0257,401,828,12,840,1147,0,3,1,3,0,1,0,76.14,73.23 ,33.33
03,006,01,014,0258,402,501,5,506,630,0,3,1,3,0,1,0,76.14,80.32 ,33.33
03,006,01,015,0259,403,1575,28,1603,2195,0,3,1,3,0,1,0,76.14,73.03 ,33.33
03,006,01,015,0259,404,1684,20,1704,2357,0,3,1,3,0,1,0,76.14,72.30 ,33.33
03,006,01,015,0260,405,1527,30,1557,2278,0,3,1,3,0,1,0,76.14,68.35 ,33.33
03,006,01,015,0261,406,1460,37,1497,2090,0,3,1,3,0,1,0,76.14,71.63 ,33.33
03,006,01,015,0261,407,1137,28,1165,1541,0,3,1,3,0,1,0,76.14,75.60 ,33.33
03,006,01,015,0262,408,1143,13,1156,1427,0,3,1,3,0,1,0,76.14,81.01 ,33.33
03,006,01,015,0262,409,754,18,772,1074,0,3,1,3,0,1,0,76.14,71.88 ,33.33
03,006,01,015,0263,410,1504,26,1530,1944,0,3,1,3,0,1,0,76.14,78.70 ,33.33
03,006,01,015,0264,411,1594,23,1617,2348,0,3,1,3,0,1,0,76.14,68.87 ,33.33
03,006,01,015,0264,412,1416,27,1443,2027,0,3,1,3,0,1,0,76.14,71.19 ,33.33
03,006,01,015,0264,413,1568,18,1586,2246,0,3,1,3,0,1,0,76.14,70.61 ,33.33
03,006,01,015,0265,414,1512,30,1542,2117,0,3,1,3,0,1,0,76.14,72.84 ,33.33
03,006,01,015,0265,415,1160,10,1170,1674,0,3,1,3,0,1,0,76.14,69.89 ,33.33
03,006,01,015,0266,416,1396,21,1417,1907,0,3,1,3,0,1,0,76.14,74.31 ,33.33
03,006,01,015,0267,417,933,12,945,1198,0,3,1,3,0,1,0,76.14,78.88 ,33.33
03,006,01,015,0268,418,1315,25,1340,1830,0,3,1,3,0,1,0,76.14,73.22 ,33.33
03,006,01,015,0269,419,1051,10,1061,1343,0,3,1,3,0,1,0,76.14,79.00 ,33.33
03,006,01,015,0270,420,1183,19,1202,1467,0,3,1,3,0,1,0,76.14,81.94 ,33.33
03,006,01,015,0270,421,1041,22,1063,1353,0,3,1,3,0,1,0,76.14,78.57 ,33.33
03,006,01,015,0271,422,1049,17,1066,1347,0,3,1,3,0,1,0,76.14,79.14 ,33.33
03,006,01,015,0272,423,810,19,829,1127,0,3,1,3,0,1,0,76.14,73.56 ,33.33
03,006,01,015,0273,424,673,16,689,927,0,3,1,3,0,1,0,76.14,74.33 ,33.33
03,006,01,015,0274,425,603,10,613,807,0,3,1,3,0,1,0,76.14,75.96 ,33.33
03,006,01,016,0275,426,1132,13,1145,1496,0,3,1,3,0,1,0,76.14,76.54 ,33.33
03,006,01,016,0275,427,1122,19,1141,1539,0,3,1,3,0,1,0,76.14,74.14 ,33.33
03,006,01,016,0276,428,627,7,634,722,0,3,1,3,0,1,0,76.14,87.81 ,33.33
03,006,01,016,0277,429,983,18,1001,1308,0,3,1,3,0,1,0,76.14,76.53 ,33.33
03,006,01,016,0277,430,1094,11,1105,1443,0,3,1,3,0,1,0,76.14,76.58 ,33.33
03,006,01,016,0278,431,857,12,869,1053,0,3,1,3,0,1,0,76.14,82.53 ,33.33
03,006,01,016,0279,432,841,9,850,995,0,3,1,3,0,1,0,76.14,85.43 ,33.33
03,006,01,016,0279,433,750,16,766,949,0,3,1,3,0,1,0,76.14,80.72 ,33.33
03,006,01,016,0280,434,734,8,742,916,0,3,1,3,0,1,0,76.14,81.00 ,33.33
03,006,01,016,0280,435,552,8,560,904,0,3,1,3,0,1,0,76.14,61.95 ,33.33
03,006,01,016,0281,436,867,11,878,1099,0,3,1,3,0,1,0,76.14,79.89 ,33.33
03,006,01,016,0281,437,738,11,749,944,0,3,1,3,0,1,0,76.14,79.34 ,33.33
03,006,01,016,0282,438,692,5,697,879,0,3,1,3,0,1,0,76.14,79.29 ,33.33
03,006,01,016,0282,439,657,10,667,859,0,3,1,3,0,1,0,76.14,77.65 ,33.33
03,006,01,016,0283,440,644,11,655,800,0,3,1,3,0,1,0,76.14,81.88 ,33.33
03,006,01,016,0284,441,961,9,970,1171,0,3,1,3,0,1,0,76.14,82.84 ,33.33
03,006,01,016,0285,442,1120,13,1133,1445,0,3,1,3,0,1,0,76.14,78.41 ,33.33
03,006,01,016,0286,443,667,3,670,777,0,3,1,3,0,1,0,76.14,86.23 ,33.33
03,006,01,016,0287,444,1014,20,1034,1312,0,3,1,3,0,1,0,76.14,78.81 ,33.33
03,006,01,016,0288,445,1157,21,1178,1442,0,3,1,3,0,1,0,76.14,81.69 ,33.33
03,006,01,016,0288,446,846,11,857,1165,0,3,1,3,0,1,0,76.14,73.56 ,33.33
03,006,01,016,0289,447,1181,28,1209,1641,0,3,1,3,0,1,0,76.14,73.67 ,33.33
03,006,01,016,0289,448,1142,35,1177,1633,0,3,1,3,0,1,0,76.14,72.08 ,33.33
03,006,01,016,0290,449,1001,17,1018,1430,0,3,1,3,0,1,0,76.14,71.19 ,33.33
03,006,01,016,0290,450,909,20,929,1322,0,3,1,3,0,1,0,76.14,70.27 ,33.33
03,006,01,016,0290,451,753,13,766,1233,0,3,1,3,0,1,0,76.14,62.12 ,33.33
03,006,01,016,0290,452,1131,16,1147,1493,0,3,1,3,0,1,0,76.14,76.83 ,33.33
03,006,01,017,0291,453,1034,22,1056,1440,0,3,1,3,0,1,0,76.14,73.33 ,33.33
03,006,01,017,0292,454,1403,23,1426,1851,0,3,1,3,0,1,0,76.14,77.04 ,33.33
03,006,01,017,0293,455,1056,19,1075,1299,0,3,1,3,0,1,0,76.14,82.76 ,33.33
03,006,01,017,0294,456,793,11,804,1113,0,3,1,3,0,1,0,76.14,72.24 ,33.33
03,006,01,017,0294,457,626,14,640,881,0,3,1,3,0,1,0,76.14,72.64 ,33.33
03,006,01,017,0295,458,696,8,704,902,0,3,1,3,0,1,0,76.14,78.05 ,33.33
03,006,01,017,0296,459,1393,18,1411,1760,0,3,1,3,0,1,0,76.14,80.17 ,33.33
03,006,01,017,0297,460,1143,22,1165,1435,0,3,1,3,0,1,0,76.14,81.18 ,33.33
03,006,01,017,0297,461,1088,25,1113,1359,0,3,1,3,0,1,0,76.14,81.90 ,33.33
03,006,01,017,0297,462,520,9,529,743,0,3,1,3,0,1,0,76.14,71.20 ,33.33
03,006,01,017,0298,463,860,12,872,1104,0,3,1,3,0,1,0,76.14,78.99 ,33.33
03,006,01,017,0298,464,656,2,658,855,0,3,1,3,0,1,0,76.14,76.96 ,33.33
03,006,01,017,0299,465,1017,12,1029,1397,0,3,1,3,0,1,0,76.14,73.66 ,33.33
03,006,01,017,0299,466,1255,18,1273,1771,0,3,1,3,0,1,0,76.14,71.88 ,33.33
03,006,01,017,0300,467,791,15,806,1073,0,3,1,3,0,1,0,76.14,75.12 ,33.33
03,006,01,017,0300,468,919,13,932,1286,0,3,1,3,0,1,0,76.14,72.47 ,33.33
03,006,01,017,0301,469,1286,35,1321,1764,0,3,1,3,0,1,0,76.14,74.89 ,33.33
03,006,01,017,0301,470,1013,20,1033,1397,0,3,1,3,0,1,0,76.14,73.94 ,33.33
03,006,01,017,0302,471,1069,18,1087,1421,0,3,1,3,0,1,0,76.14,76.50 ,33.33
03,006,01,017,0303,472,1089,11,1100,1535,0,3,1,3,0,1,0,76.14,71.66 ,33.33
03,006,01,017,0303,473,1181,30,1211,1739,0,3,1,3,0,1,0,76.14,69.64 ,33.33
03,006,01,017,0304,474,862,11,873,1105,0,3,1,3,0,1,0,76.14,79.00 ,33.33
03,006,01,017,0305,475,1220,20,1240,1954,0,3,1,3,0,1,0,76.14,63.46 ,33.33
03,006,01,017,0305,476,985,11,996,1567,0,3,1,3,0,1,0,76.14,63.56 ,33.33
03,006,01,017,0305,477,825,18,843,1287,0,3,1,3,0,1,0,76.14,65.50 ,33.33
03,006,01,017,0305,478,791,11,802,1230,0,3,1,3,0,1,0,76.14,65.20 ,33.33
03,006,01,018,0306,479,803,15,818,1120,0,3,1,3,0,1,0,76.14,73.04 ,33.33
03,006,01,018,0307,480,1704,22,1726,2412,0,3,1,3,0,1,0,76.14,71.56 ,33.33
03,006,01,018,0307,481,1520,24,1544,2146,0,3,1,3,0,1,0,76.14,71.95 ,33.33
03,006,01,018,0307,482,966,12,978,1398,0,3,1,3,0,1,0,76.14,69.96 ,33.33
03,006,01,018,0308,483,1443,29,1472,2154,0,3,1,3,0,1,0,76.14,68.34 ,33.33
03,006,01,018,0308,484,1330,16,1346,1792,0,3,1,3,0,1,0,76.14,75.11 ,33.33
03,006,01,018,0309,485,1235,17,1252,1816,0,3,1,3,0,1,0,76.14,68.94 ,33.33
03,006,01,018,0310,486,1042,17,1059,1452,0,3,1,3,0,1,0,76.14,72.93 ,33.33
03,006,01,018,0311,487,616,14,630,816,0,3,1,3,0,1,0,76.14,77.21 ,33.33
03,006,01,018,0312,488,788,15,803,1135,0,3,1,3,0,1,0,76.14,70.75 ,33.33
03,006,01,018,0313,489,1150,11,1161,1620,0,3,1,3,0,1,0,76.14,71.67 ,33.33
03,006,01,018,0313,490,1034,19,1053,1478,0,3,1,3,0,1,0,76.14,71.24 ,33.33
03,006,01,018,0313,491,1116,15,1131,1576,0,3,1,3,0,1,0,76.14,71.76 ,33.33
03,006,01,018,0314,492,995,22,1017,1315,0,3,1,3,0,1,0,76.14,77.34 ,33.33
03,006,01,018,0314,493,869,28,897,1191,0,3,1,3,0,1,0,76.14,75.31 ,33.33
03,006,01,018,0315,494,1005,12,1017,1266,0,3,1,3,0,1,0,76.14,80.33 ,33.33
03,006,01,018,0316,495,1414,19,1433,1865,0,3,1,3,0,1,0,76.14,76.84 ,33.33
03,006,01,018,0317,496,1619,27,1646,2076,0,3,1,3,0,1,0,76.14,79.29 ,33.33
03,006,01,018,0318,497,1219,30,1249,1637,0,3,1,3,0,1,0,76.14,76.30 ,33.33
03,006,01,018,0319,498,1100,14,1114,1357,0,3,1,3,0,1,0,76.14,82.09 ,33.33
03,006,01,018,0320,499,741,11,752,966,0,3,1,3,0,1,0,76.14,77.85 ,33.33
03,006,01,018,0321,500,840,10,850,1126,0,3,1,3,0,1,0,76.14,75.49 ,33.33
03,006,01,018,0321,501,831,4,835,1235,0,3,1,3,0,1,0,76.14,67.61 ,33.33
03,006,01,018,0322,502,1440,15,1455,1913,0,3,1,3,0,1,0,76.14,76.06 ,33.33
03,006,01,018,0323,503,1570,23,1593,2101,0,3,1,3,0,1,0,76.14,75.82 ,33.33
03,006,01,018,0323,504,548,9,557,724,0,3,1,3,0,1,0,76.14,76.93 ,33.33
03,006,01,018,0324,505,817,12,829,1089,0,3,1,3,0,1,0,76.14,76.12 ,33.33
03,006,01,018,0325,506,1564,31,1595,2011,0,3,1,3,0,1,0,76.14,79.31 ,33.33
03,006,01,019,0326,507,1168,18,1186,1648,0,3,1,3,0,1,0,76.14,71.97 ,33.33
03,006,01,019,0326,508,1128,18,1146,1534,0,3,1,3,0,1,0,76.14,74.71 ,33.33
03,006,01,019,0326,509,973,17,990,1424,0,3,1,3,0,1,0,76.14,69.52 ,33.33
03,006,01,019,0327,510,989,25,1014,1493,0,3,1,3,0,1,0,76.14,67.92 ,33.33
03,006,01,019,0327,511,986,13,999,1429,0,3,1,3,0,1,0,76.14,69.91 ,33.33
03,006,01,019,0327,512,1454,39,1493,2245,0,3,1,3,0,1,0,76.14,66.50 ,33.33
03,006,01,019,0328,513,1255,23,1278,1859,0,3,1,3,0,1,0,76.14,68.75 ,33.33
03,006,01,019,0328,514,1218,27,1245,1713,0,3,1,3,0,1,0,76.14,72.68 ,33.33
03,006,01,019,0328,515,1053,25,1078,1636,0,3,1,3,0,1,0,76.14,65.89 ,33.33
03,006,01,019,0329,516,1155,17,1172,1643,0,3,1,3,0,1,0,76.14,71.33 ,33.33
03,006,01,019,0329,517,1146,23,1169,1647,0,3,1,3,0,1,0,76.14,70.98 ,33.33
03,006,01,019,0329,518,980,12,992,1340,0,3,1,3,0,1,0,76.14,74.03 ,33.33
03,006,01,019,0330,519,1346,16,1362,1867,0,3,1,3,0,1,0,76.14,72.95 ,33.33
03,006,01,019,0330,520,1062,30,1092,1504,0,3,1,3,0,1,0,76.14,72.61 ,33.33
03,006,01,019,0330,521,1160,25,1185,1718,0,3,1,3,0,1,0,76.14,68.98 ,33.33
03,006,01,019,0330,522,1157,21,1178,1581,0,3,1,3,0,1,0,76.14,74.51 ,33.33
03,006,01,019,0331,523,894,25,919,1392,0,3,1,3,0,1,0,76.14,66.02 ,33.33
03,006,01,019,0331,524,989,15,1004,1374,0,3,1,3,0,1,0,76.14,73.07 ,33.33
03,006,01,019,0331,525,912,19,931,1307,0,3,1,3,0,1,0,76.14,71.23 ,33.33
03,006,01,019,0332,526,1154,25,1179,1720,0,3,1,3,0,1,0,76.14,68.55 ,33.33
03,006,01,019,0332,527,1284,18,1302,1752,0,3,1,3,0,1,0,76.14,74.32 ,33.33
03,006,01,019,0332,528,1200,17,1217,1563,0,3,1,3,0,1,0,76.14,77.86 ,33.33
03,006,01,019,0332,529,1128,24,1152,1590,0,3,1,3,0,1,0,76.14,72.45 ,33.33
03,006,01,019,0333,530,1372,31,1403,1911,0,3,1,3,0,1,0,76.14,73.42 ,33.33
03,006,01,019,0333,531,1098,24,1122,1520,0,3,1,3,0,1,0,76.14,73.82 ,33.33
03,006,01,019,0333,532,806,16,822,1190,0,3,1,3,0,1,0,76.14,69.08 ,33.33
03,006,01,019,0333,533,1033,10,1043,1522,0,3,1,3,0,1,0,76.14,68.53 ,33.33
03,006,01,019,0334,534,1017,22,1039,1474,0,3,1,3,0,1,0,76.14,70.49 ,33.33
03,006,01,019,0334,535,851,18,869,1192,0,3,1,3,0,1,0,76.14,72.90 ,33.33
03,006,01,019,0334,536,972,10,982,1358,0,3,1,3,0,1,0,76.14,72.31 ,33.33
03,006,01,019,0334,537,1110,23,1133,1616,0,3,1,3,0,1,0,76.14,70.11 ,33.33
03,006,01,019,0335,538,1063,30,1093,1627,0,3,1,3,0,1,0,76.14,67.18 ,33.33
03,006,01,019,0335,539,1180,14,1194,1914,0,3,1,3,0,1,0,76.14,62.38 ,33.33
03,006,01,019,0335,540,1077,17,1094,1699,0,3,1,3,0,1,0,76.14,64.39 ,33.33
03,006,01,019,0335,541,1031,22,1053,1535,0,3,1,3,0,1,0,76.14,68.60 ,33.33
03,006,01,019,0335,542,1028,18,1046,1612,0,3,1,3,0,1,0,76.14,64.89 ,33.33
03,006,01,019,0335,543,856,11,867,1282,0,3,1,3,0,1,0,76.14,67.63 ,33.33
03,006,01,019,0336,544,1046,17,1063,1639,0,3,1,3,0,1,0,76.14,64.86 ,33.33
03,006,01,019,0336,545,1045,23,1068,1661,0,3,1,3,0,1,0,76.14,64.30 ,33.33
03,006,01,019,0336,546,1199,23,1222,2291,0,3,1,3,0,1,0,76.14,53.34 ,33.33
03,006,01,019,0336,547,1279,30,1309,1939,0,3,1,3,0,1,0,76.14,67.51 ,33.33
03,006,01,019,0337,548,913,23,936,1377,0,3,1,3,0,1,0,76.14,67.97 ,33.33
03,006,01,019,0337,549,1324,29,1353,1976,0,3,1,3,0,1,0,76.14,68.47 ,33.33
03,006,01,019,0337,550,826,11,837,1197,0,3,1,3,0,1,0,76.14,69.92 ,33.33
03,006,01,019,0337,551,1095,18,1113,1786,0,3,1,3,0,1,0,76.14,62.32 ,33.33
03,006,01,019,0338,552,1087,24,1111,1522,0,3,1,3,0,1,0,76.14,73.00 ,33.33
03,006,01,019,0338,553,889,19,908,1384,0,3,1,3,0,1,0,76.14,65.61 ,33.33
03,006,01,019,0339,554,781,12,793,1098,0,3,1,3,0,1,0,76.14,72.22 ,33.33
03,006,01,019,0339,555,897,13,910,1257,0,3,1,3,0,1,0,76.14,72.39 ,33.33
03,006,01,019,0339,556,793,15,808,1106,0,3,1,3,0,1,0,76.14,73.06 ,33.33
03,006,01,019,0340,557,916,21,937,1271,0,3,1,3,0,1,0,76.14,73.72 ,33.33
03,006,01,019,0341,558,1051,18,1069,1432,0,3,1,3,0,1,0,76.14,74.65 ,33.33
03,006,01,019,0341,559,1123,33,1156,1605,0,3,1,3,0,1,0,76.14,72.02 ,33.33
03,006,01,019,0341,560,1138,22,1160,1603,0,3,1,3,0,1,0,76.14,72.36 ,33.33
03,006,01,019,0342,561,719,7,726,921,0,3,1,3,0,1,0,76.14,78.83 ,33.33
03,006,01,019,0343,562,1026,26,1052,1430,0,3,1,3,0,1,0,76.14,73.57 ,33.33
03,006,01,019,0343,563,994,10,1004,1390,0,3,1,3,0,1,0,76.14,72.23 ,33.33
03,006,01,019,0343,564,874,17,891,1181,0,3,1,3,0,1,0,76.14,75.44 ,33.33
03,006,01,019,0344,565,976,15,991,1420,0,3,1,3,0,1,0,76.14,69.79 ,33.33
03,006,01,019,0344,566,928,15,943,1327,0,3,1,3,0,1,0,76.14,71.06 ,33.33
03,006,01,020,0345,567,997,15,1012,1318,0,3,1,3,0,1,0,76.14,76.78 ,33.33
03,006,01,020,0345,568,856,10,866,1102,0,3,1,3,0,1,0,76.14,78.58 ,33.33
03,006,01,020,0346,569,1076,11,1087,1501,0,3,1,3,0,1,0,76.14,72.42 ,33.33
03,006,01,020,0346,570,1051,12,1063,1558,0,3,1,3,0,1,0,76.14,68.23 ,33.33
03,006,01,020,0346,571,822,13,835,1122,0,3,1,3,0,1,0,76.14,74.42 ,33.33
03,006,01,020,0346,572,1167,26,1193,1708,0,3,1,3,0,1,0,76.14,69.85 ,33.33
03,006,01,020,0347,573,947,15,962,1219,0,3,1,3,0,1,0,76.14,78.92 ,33.33
03,006,01,020,0347,574,868,21,889,1205,0,3,1,3,0,1,0,76.14,73.78 ,33.33
03,006,01,020,0348,575,1263,15,1278,1967,0,3,1,3,0,1,0,76.14,64.97 ,33.33
03,006,01,020,0348,576,748,11,759,1222,0,3,1,3,0,1,0,76.14,62.11 ,33.33
03,006,01,020,0348,577,720,5,725,1134,0,3,1,3,0,1,0,76.14,63.93 ,33.33
03,006,01,020,0348,578,621,18,639,850,0,3,1,3,0,1,0,76.14,75.18 ,33.33
03,006,01,020,0349,579,1198,20,1218,1776,0,3,1,3,0,1,0,76.14,68.58 ,33.33
03,006,01,020,0349,580,1201,23,1224,1808,0,3,1,3,0,1,0,76.14,67.70 ,33.33
03,006,01,020,0349,581,970,12,982,1417,0,3,1,3,0,1,0,76.14,69.30 ,33.33
03,006,01,020,0349,582,1327,14,1341,2019,0,3,1,3,0,1,0,76.14,66.42 ,33.33
03,006,01,020,0350,583,904,22,926,1231,0,3,1,3,0,1,0,76.14,75.22 ,33.33
03,006,01,020,0350,584,904,8,912,1273,0,3,1,3,0,1,0,76.14,71.64 ,33.33
03,006,01,020,0351,585,1098,15,1113,1609,0,3,1,3,0,1,0,76.14,69.17 ,33.33
03,006,01,020,0351,586,794,9,803,1148,0,3,1,3,0,1,0,76.14,69.95 ,33.33
03,006,01,020,0352,587,983,22,1005,1292,0,3,1,3,0,1,0,76.14,77.79 ,33.33
03,006,01,020,0353,588,747,3,750,898,0,3,1,3,0,1,0,76.14,83.52 ,33.33
03,006,01,020,0354,589,1260,11,1271,1791,0,3,1,3,0,1,0,76.14,70.97 ,33.33
03,006,01,020,0354,590,1426,21,1447,2039,0,3,1,3,0,1,0,76.14,70.97 ,33.33
03,006,01,020,0354,591,1040,17,1057,1636,0,3,1,3,0,1,0,76.14,64.61 ,33.33
03,006,01,020,0354,592,1229,20,1249,1767,0,3,1,3,0,1,0,76.14,70.68 ,33.33
03,006,01,020,0355,593,547,12,559,726,0,3,1,3,0,1,0,76.14,77.00 ,33.33
03,006,01,020,0355,594,1373,22,1395,1859,0,3,1,3,0,1,0,76.14,75.04 ,33.33
03,006,01,020,0355,595,464,6,470,624,0,3,1,3,0,1,0,76.14,75.32 ,33.33
03,006,01,020,0356,596,1095,12,1107,1591,0,3,1,3,0,1,0,76.14,69.58 ,33.33
03,006,01,020,0356,597,1165,25,1190,1751,0,3,1,3,0,1,0,76.14,67.96 ,33.33
03,006,01,020,0356,598,1229,25,1254,1891,0,3,1,3,0,1,0,76.14,66.31 ,33.33
03,006,01,020,0357,599,1161,16,1177,1929,0,3,1,3,0,1,0,76.14,61.02 ,33.33
03,006,01,020,0357,600,1074,22,1096,1605,0,3,1,3,0,1,0,76.14,68.29 ,33.33
03,006,01,020,0357,601,1197,10,1207,1720,0,3,1,3,0,1,0,76.14,70.17 ,33.33
03,006,01,020,0358,602,445,15,460,644,0,3,1,3,0,1,0,76.14,71.43 ,33.33
03,006,01,020,0358,603,986,10,996,1560,0,3,1,3,0,1,0,76.14,63.85 ,33.33
03,006,01,020,0358,604,895,11,906,1283,0,3,1,3,0,1,0,76.14,70.62 ,33.33
03,006,01,020,0358,605,984,12,996,1452,0,3,1,3,0,1,0,76.14,68.60 ,33.33
03,006,01,020,0358,606,923,22,945,1394,0,3,1,3,0,1,0,76.14,67.79 ,33.33
03,006,01,020,0358,607,592,7,599,924,0,3,1,3,0,1,0,76.14,64.83 ,33.33
03,006,01,020,0359,608,936,23,959,1397,0,3,1,3,0,1,0,76.14,68.65 ,33.33
03,006,01,020,0359,609,1012,24,1036,1419,0,3,1,3,0,1,0,76.14,73.01 ,33.33
03,006,01,020,0360,610,1231,20,1251,1792,0,3,1,3,0,1,0,76.14,69.81 ,33.33
03,006,01,020,0360,611,1292,22,1314,1968,0,3,1,3,0,1,0,76.14,66.77 ,33.33
03,006,01,020,0360,612,1197,27,1224,1885,0,3,1,3,0,1,0,76.14,64.93 ,33.33
03,006,01,020,0360,613,1204,17,1221,1878,0,3,1,3,0,1,0,76.14,65.02 ,33.33
03,006,01,020,0360,614,1312,16,1328,1937,0,3,1,3,0,1,0,76.14,68.56 ,33.33
03,006,01,020,0361,615,1108,13,1121,1969,0,3,1,3,0,1,0,76.14,56.93 ,33.33
03,006,01,020,0361,616,1070,14,1084,1728,0,3,1,3,0,1,0,76.14,62.73 ,33.33
03,006,01,020,0361,617,1254,15,1269,1861,0,3,1,3,0,1,0,76.14,68.19 ,33.33
03,006,01,020,0361,618,1268,12,1280,1830,0,3,1,3,0,1,0,76.14,69.95 ,33.33
03,006,01,020,0362,619,1039,24,1063,1641,0,3,1,3,0,1,0,76.14,64.78 ,33.33
03,006,01,020,0362,620,1128,26,1154,1773,0,3,1,3,0,1,0,76.14,65.09 ,33.33
03,006,01,020,0362,621,818,5,823,1323,0,3,1,3,0,1,0,76.14,62.21 ,33.33
03,006,01,020,0362,622,945,17,962,1478,0,3,1,3,0,1,0,76.14,65.09 ,33.33
03,006,01,020,0363,623,1134,19,1153,1697,0,3,1,3,0,1,0,76.14,67.94 ,33.33
03,006,01,020,0363,624,1008,14,1022,1553,0,3,1,3,0,1,0,76.14,65.81 ,33.33
03,006,01,020,0363,625,970,15,985,1547,0,3,1,3,0,1,0,76.14,63.67 ,33.33
03,006,01,020,0364,626,1055,11,1066,1574,0,3,1,3,0,1,0,76.14,67.73 ,33.33
03,006,01,020,0364,627,1070,13,1083,1583,0,3,1,3,0,1,0,76.14,68.41 ,33.33
03,006,01,020,0364,628,1063,16,1079,1571,0,3,1,3,0,1,0,76.14,68.68 ,33.33
03,006,01,020,0364,629,1074,18,1092,1769,0,3,1,3,0,1,0,76.14,61.73 ,33.33
03,006,01,021,0365,630,101,0,101,144,0,3,1,3,0,1,0,76.14,70.14 ,33.33
03,006,01,021,0365,631,521,10,531,695,0,3,1,3,0,1,0,76.14,76.40 ,33.33
03,006,01,021,0365,632,401,4,405,530,0,3,1,3,0,1,0,76.14,76.42 ,33.33
03,006,01,021,0366,633,295,11,306,450,0,3,1,3,0,1,0,76.14,68.00 ,33.33
03,006,01,021,0367,634,427,10,437,612,0,3,1,3,0,1,0,76.14,71.41 ,33.33
03,006,01,021,0367,635,336,4,340,481,0,3,1,3,0,1,0,76.14,70.69 ,33.33
03,006,01,021,0368,636,56,0,56,84,0,3,1,3,0,1,0,76.14,66.67 ,33.33
03,006,01,021,0368,637,84,3,87,130,0,3,1,3,0,1,0,76.14,66.92 ,33.33
03,006,01,021,0368,638,206,2,208,270,0,3,1,3,0,1,0,76.14,77.04 ,33.33
03,006,01,021,0369,639,262,2,264,378,0,3,1,3,0,1,0,76.14,69.84 ,33.33
03,006,01,021,0369,640,57,2,59,94,0,3,1,3,0,1,0,76.14,62.77 ,33.33
03,006,01,021,0370,641,204,2,206,257,0,3,1,3,0,1,0,76.14,80.16 ,33.33
03,006,01,021,0371,642,122,2,124,212,0,3,1,3,0,1,0,76.14,58.49 ,33.33
03,006,01,021,0371,643,483,5,488,768,0,3,1,3,0,1,0,76.14,63.54 ,33.33
03,006,01,021,0371,644,155,3,158,260,0,3,1,3,0,1,0,76.14,60.77 ,33.33
03,006,01,021,0371,645,43,1,44,97,0,3,1,3,0,1,0,76.14,45.36 ,33.33
03,006,01,021,0372,646,149,2,151,230,0,3,1,3,0,1,0,76.14,65.65 ,33.33
03,006,01,021,0372,647,71,1,72,143,0,3,1,3,0,1,0,76.14,50.35 ,33.33
03,007,01,001,0001,1,1050,16,1066,1381,0,3,1,3,0,1,0,76.14,77.19 ,33.33
03,007,01,001,0001,2,889,12,901,1280,0,3,1,3,0,1,0,76.14,70.39 ,33.33
03,007,01,001,0002,3,814,10,824,1104,0,3,1,3,0,1,0,76.14,74.64 ,33.33
03,007,01,001,0002,4,753,18,771,1080,0,3,1,3,0,1,0,76.14,71.39 ,33.33
03,007,01,001,0003,5,1022,10,1032,1470,0,3,1,3,0,1,0,76.14,70.20 ,33.33
03,007,01,001,0004,6,1161,19,1180,1650,0,3,1,3,0,1,0,76.14,71.52 ,33.33
03,007,01,001,0005,7,768,13,781,1112,0,3,1,3,0,1,0,76.14,70.23 ,33.33
03,007,01,001,0005,8,778,19,797,1117,0,3,1,3,0,1,0,76.14,71.35 ,33.33
03,007,01,001,0006,9,813,9,822,1160,0,3,1,3,0,1,0,76.14,70.86 ,33.33
03,007,01,001,0006,10,828,19,847,1165,0,3,1,3,0,1,0,76.14,72.70 ,33.33
03,007,01,001,0007,11,897,10,907,1249,0,3,1,3,0,1,0,76.14,72.62 ,33.33
03,007,01,001,0008,12,874,15,889,1196,0,3,1,3,0,1,0,76.14,74.33 ,33.33
03,007,01,001,0008,13,492,4,496,705,0,3,1,3,0,1,0,76.14,70.35 ,33.33
03,007,01,001,0009,14,898,9,907,1320,0,3,1,3,0,1,0,76.14,68.71 ,33.33
03,007,01,001,0009,15,849,11,860,1285,0,3,1,3,0,1,0,76.14,66.93 ,33.33
03,007,01,001,0009,16,1052,13,1065,1536,0,3,1,3,0,1,0,76.14,69.34 ,33.33
03,007,01,001,0010,17,994,16,1010,1327,0,3,1,3,0,1,0,76.14,76.11 ,33.33
03,007,01,001,0010,18,1004,23,1027,1490,0,3,1,3,0,1,0,76.14,68.93 ,33.33
03,007,01,001,0011,19,1173,28,1201,1652,0,3,1,3,0,1,0,76.14,72.70 ,33.33
03,007,01,001,0011,20,1217,20,1237,1781,0,3,1,3,0,1,0,76.14,69.46 ,33.33
03,007,01,001,0012,21,1228,22,1250,1833,0,3,1,3,0,1,0,76.14,68.19 ,33.33
03,007,01,001,0012,22,941,17,958,1488,0,3,1,3,0,1,0,76.14,64.38 ,33.33
03,007,01,001,0012,23,1324,24,1348,2020,0,3,1,3,0,1,0,76.14,66.73 ,33.33
03,007,01,001,0013,24,989,17,1006,1437,0,3,1,3,0,1,0,76.14,70.01 ,33.33
03,007,01,001,0014,25,906,12,918,1243,0,3,1,3,0,1,0,76.14,73.85 ,33.33
03,007,01,001,0015,26,1083,16,1099,1535,0,3,1,3,0,1,0,76.14,71.60 ,33.33
03,007,01,001,0016,27,808,10,818,1102,0,3,1,3,0,1,0,76.14,74.23 ,33.33
03,007,01,001,0017,28,877,6,883,1277,0,3,1,3,0,1,0,76.14,69.15 ,33.33
03,007,01,001,0017,29,782,7,789,1179,0,3,1,3,0,1,0,76.14,66.92 ,33.33
03,007,01,001,0018,30,989,19,1008,1445,0,3,1,3,0,1,0,76.14,69.76 ,33.33
03,007,01,001,0018,31,1026,10,1036,1493,0,3,1,3,0,1,0,76.14,69.39 ,33.33
03,007,01,001,0019,32,699,9,708,985,0,3,1,3,0,1,0,76.14,71.88 ,33.33
03,007,01,001,0020,33,753,10,763,1091,0,3,1,3,0,1,0,76.14,69.94 ,33.33
03,007,01,001,0021,34,1023,11,1034,1347,0,3,1,3,0,1,0,76.14,76.76 ,33.33
03,007,01,001,0022,35,959,11,970,1367,0,3,1,3,0,1,0,76.14,70.96 ,33.33
03,007,01,001,0023,36,763,11,774,1090,0,3,1,3,0,1,0,76.14,71.01 ,33.33
03,007,01,001,0024,37,1285,21,1306,1851,0,3,1,3,0,1,0,76.14,70.56 ,33.33
03,007,01,001,0025,38,902,14,916,1310,0,3,1,3,0,1,0,76.14,69.92 ,33.33
03,007,01,001,0025,39,1278,21,1299,1862,0,3,1,3,0,1,0,76.14,69.76 ,33.33
03,007,01,001,0025,40,1037,18,1055,1502,0,3,1,3,0,1,0,76.14,70.24 ,33.33
03,007,01,001,0025,41,971,18,989,1449,0,3,1,3,0,1,0,76.14,68.25 ,33.33
03,007,01,001,0025,42,1039,17,1056,1636,0,3,1,3,0,1,0,76.14,64.55 ,33.33
03,007,01,001,0026,43,1393,27,1420,1911,0,3,1,3,0,1,0,76.14,74.31 ,33.33
03,007,01,001,0027,44,1060,15,1075,1362,0,3,1,3,0,1,0,76.14,78.93 ,33.33
03,007,01,001,0028,45,1093,27,1120,1475,0,3,1,3,0,1,0,76.14,75.93 ,33.33
03,007,01,001,0029,46,976,15,991,1276,0,3,1,3,0,1,0,76.14,77.66 ,33.33
03,007,01,001,0029,47,898,18,916,1171,0,3,1,3,0,1,0,76.14,78.22 ,33.33
03,007,01,001,0030,48,719,11,730,1078,0,3,1,3,0,1,0,76.14,67.72 ,33.33
03,007,01,001,0030,49,988,17,1005,1248,0,3,1,3,0,1,0,76.14,80.53 ,33.33
03,007,01,001,0031,50,709,14,723,1004,0,3,1,3,0,1,0,76.14,72.01 ,33.33
03,007,01,001,0031,51,725,13,738,1040,0,3,1,3,0,1,0,76.14,70.96 ,33.33
03,007,01,001,0032,52,1257,20,1277,1838,0,3,1,3,0,1,0,76.14,69.48 ,33.33
03,007,01,001,0033,53,800,36,836,1177,0,3,1,3,0,1,0,76.14,71.03 ,33.33
03,007,01,001,0034,54,754,7,761,1148,0,3,1,3,0,1,0,76.14,66.29 ,33.33
03,007,01,001,0034,55,882,7,889,1261,0,3,1,3,0,1,0,76.14,70.50 ,33.33
03,007,01,001,0035,56,1255,14,1269,1811,0,3,1,3,0,1,0,76.14,70.07 ,33.33
03,007,01,001,0035,57,1148,21,1169,1637,0,3,1,3,0,1,0,76.14,71.41 ,33.33
03,007,01,001,0036,58,680,10,690,958,0,3,1,3,0,1,0,76.14,72.03 ,33.33
03,007,01,001,0036,59,644,10,654,943,0,3,1,3,0,1,0,76.14,69.35 ,33.33
03,007,01,001,0037,60,956,12,968,1384,0,3,1,3,0,1,0,76.14,69.94 ,33.33
03,007,01,001,0038,61,726,13,739,1024,0,3,1,3,0,1,0,76.14,72.17 ,33.33
03,007,01,001,0039,62,992,12,1004,1387,0,3,1,3,0,1,0,76.14,72.39 ,33.33
03,007,01,001,0040,63,602,10,612,820,0,3,1,3,0,1,0,76.14,74.63 ,33.33
03,007,01,001,0041,64,768,15,783,1056,0,3,1,3,0,1,0,76.14,74.15 ,33.33
03,007,01,001,0042,65,676,8,684,947,0,3,1,3,0,1,0,76.14,72.23 ,33.33
03,007,01,001,0043,66,904,13,917,1230,0,3,1,3,0,1,0,76.14,74.55 ,33.33
03,007,01,001,0044,67,625,11,636,898,0,3,1,3,0,1,0,76.14,70.82 ,33.33
03,007,01,001,0045,68,716,8,724,1050,0,3,1,3,0,1,0,76.14,68.95 ,33.33
03,007,01,001,0045,69,791,15,806,1085,0,3,1,3,0,1,0,76.14,74.29 ,33.33
03,007,01,001,0046,70,995,19,1014,1429,0,3,1,3,0,1,0,76.14,70.96 ,33.33
03,007,01,001,0047,71,684,9,693,906,0,3,1,3,0,1,0,76.14,76.49 ,33.33
03,007,01,001,0047,72,732,9,741,1030,0,3,1,3,0,1,0,76.14,71.94 ,33.33
03,007,01,001,0048,73,1098,12,1110,1484,0,3,1,3,0,1,0,76.14,74.80 ,33.33
03,007,01,001,0048,74,1166,24,1190,1687,0,3,1,3,0,1,0,76.14,70.54 ,33.33
03,007,01,001,0049,75,1182,22,1204,1588,0,3,1,3,0,1,0,76.14,75.82 ,33.33
03,007,01,001,0049,76,1097,26,1123,1523,0,3,1,3,0,1,0,76.14,73.74 ,33.33
03,007,01,001,0050,77,574,15,589,750,0,3,1,3,0,1,0,76.14,78.53 ,33.33
03,007,01,001,0051,78,1211,20,1231,1676,0,3,1,3,0,1,0,76.14,73.45 ,33.33
03,007,01,001,0052,79,777,20,797,1013,0,3,1,3,0,1,0,76.14,78.68 ,33.33
03,007,01,001,0053,80,1370,24,1394,1816,0,3,1,3,0,1,0,76.14,76.76 ,33.33
03,007,01,001,0054,81,1128,30,1158,1464,0,3,1,3,0,1,0,76.14,79.10 ,33.33
03,007,01,001,0054,82,1157,32,1189,1523,0,3,1,3,0,1,0,76.14,78.07 ,33.33
03,007,01,001,0055,83,640,13,653,929,0,3,1,3,0,1,0,76.14,70.29 ,33.33
03,007,01,001,0055,84,805,8,813,1167,0,3,1,3,0,1,0,76.14,69.67 ,33.33
03,007,01,001,0056,85,1267,21,1288,1766,0,3,1,3,0,1,0,76.14,72.93 ,33.33
03,007,01,001,0056,86,1131,22,1153,1603,0,3,1,3,0,1,0,76.14,71.93 ,33.33
03,007,01,001,0057,87,641,15,656,978,0,3,1,3,0,1,0,76.14,67.08 ,33.33
03,007,01,001,0057,88,560,10,570,838,0,3,1,3,0,1,0,76.14,68.02 ,33.33
03,007,01,001,0058,89,575,12,587,755,0,3,1,3,0,1,0,76.14,77.75 ,33.33
03,007,01,001,0058,90,962,20,982,1302,0,3,1,3,0,1,0,76.14,75.42 ,33.33
03,007,01,001,0059,91,1136,21,1157,1595,0,3,1,3,0,1,0,76.14,72.54 ,33.33
03,007,01,001,0059,92,1045,14,1059,1532,0,3,1,3,0,1,0,76.14,69.13 ,33.33
03,007,01,001,0059,93,1163,28,1191,1732,0,3,1,3,0,1,0,76.14,68.76 ,33.33
03,007,01,001,0060,94,569,11,580,800,0,3,1,3,0,1,0,76.14,72.50 ,33.33
03,007,01,001,0061,95,1104,18,1122,1523,0,3,1,3,0,1,0,76.14,73.67 ,33.33
03,007,01,001,0062,96,733,7,740,928,0,3,1,3,0,1,0,76.14,79.74 ,33.33
03,007,01,001,0063,97,796,20,816,1067,0,3,1,3,0,1,0,76.14,76.48 ,33.33
03,007,01,001,0063,98,753,13,766,1086,0,3,1,3,0,1,0,76.14,70.53 ,33.33
03,007,01,001,0064,99,1471,24,1495,1907,0,3,1,3,0,1,0,76.14,78.40 ,33.33
03,007,01,001,0065,100,1035,20,1055,1379,0,3,1,3,0,1,0,76.14,76.50 ,33.33
03,007,01,001,0065,101,847,7,854,1142,0,3,1,3,0,1,0,76.14,74.78 ,33.33
03,007,01,001,0066,102,999,23,1022,1525,0,3,1,3,0,1,0,76.14,67.02 ,33.33
03,007,01,001,0066,103,670,23,693,1122,0,3,1,3,0,1,0,76.14,61.76 ,33.33
03,007,01,001,0067,104,592,8,600,749,0,3,1,3,0,1,0,76.14,80.11 ,33.33
03,007,01,001,0068,105,700,11,711,934,0,3,1,3,0,1,0,76.14,76.12 ,33.33
03,007,01,001,0069,106,561,7,568,711,0,3,1,3,0,1,0,76.14,79.89 ,33.33
03,007,01,001,0070,107,785,13,798,1039,0,3,1,3,0,1,0,76.14,76.80 ,33.33
03,007,01,001,0071,108,795,11,806,1048,0,3,1,3,0,1,0,76.14,76.91 ,33.33
03,007,01,002,0072,109,737,15,752,1050,0,3,1,3,0,1,0,76.14,71.62 ,33.33
03,007,01,002,0072,110,1175,13,1188,1573,0,3,1,3,0,1,0,76.14,75.52 ,33.33
03,007,01,002,0073,111,1144,12,1156,1470,0,3,1,3,0,1,0,76.14,78.64 ,33.33
03,007,01,002,0074,112,579,10,589,801,0,3,1,3,0,1,0,76.14,73.53 ,33.33
03,007,01,002,0074,113,863,16,879,1159,0,3,1,3,0,1,0,76.14,75.84 ,33.33
03,007,01,002,0075,114,825,12,837,984,0,3,1,3,0,1,0,76.14,85.06 ,33.33
03,007,01,002,0076,115,936,13,949,1195,0,3,1,3,0,1,0,76.14,79.41 ,33.33
03,007,01,002,0077,116,946,10,956,1285,0,3,1,3,0,1,0,76.14,74.40 ,33.33
03,007,01,002,0078,117,536,5,541,671,0,3,1,3,0,1,0,76.14,80.63 ,33.33
03,007,01,002,0079,118,1071,12,1083,1427,0,3,1,3,0,1,0,76.14,75.89 ,33.33
03,007,01,002,0080,119,852,16,868,1176,0,3,1,3,0,1,0,76.14,73.81 ,33.33
03,007,01,002,0080,120,1249,12,1261,1789,0,3,1,3,0,1,0,76.14,70.49 ,33.33
03,007,01,002,0081,121,708,16,724,956,0,3,1,3,0,1,0,76.14,75.73 ,33.33
03,007,01,002,0081,122,631,11,642,865,0,3,1,3,0,1,0,76.14,74.22 ,33.33
03,007,01,002,0082,123,969,19,988,1330,0,3,1,3,0,1,0,76.14,74.29 ,33.33
03,007,01,002,0082,124,898,18,916,1267,0,3,1,3,0,1,0,76.14,72.30 ,33.33
03,007,01,002,0083,125,885,14,899,1270,0,3,1,3,0,1,0,76.14,70.79 ,33.33
03,007,01,002,0084,126,1111,14,1125,1584,0,3,1,3,0,1,0,76.14,71.02 ,33.33
03,007,01,002,0084,127,733,11,744,985,0,3,1,3,0,1,0,76.14,75.53 ,33.33
03,007,01,002,0085,128,586,8,594,791,0,3,1,3,0,1,0,76.14,75.09 ,33.33
03,007,01,002,0086,129,688,9,697,948,0,3,1,3,0,1,0,76.14,73.52 ,33.33
03,007,01,002,0087,130,1073,9,1082,1420,0,3,1,3,0,1,0,76.14,76.20 ,33.33
03,007,01,002,0088,131,703,5,708,994,0,3,1,3,0,1,0,76.14,71.23 ,33.33
03,007,01,002,0089,132,868,10,878,1268,0,3,1,3,0,1,0,76.14,69.24 ,33.33
03,007,01,003,0090,133,1226,20,1246,1565,0,3,1,3,0,1,0,76.14,79.62 ,33.33
03,007,01,003,0091,134,992,12,1004,1298,0,3,1,3,0,1,0,76.14,77.35 ,33.33
03,007,01,003,0092,135,1165,23,1188,1466,0,3,1,3,0,1,0,76.14,81.04 ,33.33
03,007,01,003,0093,136,460,4,464,555,0,3,1,3,0,1,0,76.14,83.60 ,33.33
03,007,01,003,0094,137,606,5,611,768,0,3,1,3,0,1,0,76.14,79.56 ,33.33
03,007,01,003,0094,138,818,15,833,1131,0,3,1,3,0,1,0,76.14,73.65 ,33.33
03,007,01,003,0095,139,844,17,861,1168,0,3,1,3,0,1,0,76.14,73.72 ,33.33
03,007,01,003,0095,140,623,11,634,800,0,3,1,3,0,1,0,76.14,79.25 ,33.33
03,007,01,003,0096,141,1044,16,1060,1374,0,3,1,3,0,1,0,76.14,77.15 ,33.33
03,007,01,003,0097,142,652,12,664,839,0,3,1,3,0,1,0,76.14,79.14 ,33.33
03,007,01,003,0098,143,676,7,683,916,0,3,1,3,0,1,0,76.14,74.56 ,33.33
03,007,01,003,0099,144,751,10,761,957,0,3,1,3,0,1,0,76.14,79.52 ,33.33
03,007,01,003,0100,145,567,5,572,715,0,3,1,3,0,1,0,76.14,80.00 ,33.33
03,007,01,003,0101,146,1118,12,1130,1367,0,3,1,3,0,1,0,76.14,82.66 ,33.33
03,007,01,003,0102,147,910,8,918,1263,0,3,1,3,0,1,0,76.14,72.68 ,33.33
03,007,01,003,0103,148,694,12,706,999,0,3,1,3,0,1,0,76.14,70.67 ,33.33
03,007,01,003,0104,149,751,12,763,1032,0,3,1,3,0,1,0,76.14,73.93 ,33.33
03,007,01,004,0105,150,726,9,735,1168,0,3,1,3,0,1,0,76.14,62.93 ,33.33
03,007,01,004,0106,151,396,6,402,576,0,3,1,3,0,1,0,76.14,69.79 ,33.33
03,007,01,004,0107,152,729,4,733,1146,0,3,1,3,0,1,0,76.14,63.96 ,33.33
03,007,01,004,0108,153,677,14,691,996,0,3,1,3,0,1,0,76.14,69.38 ,33.33
03,007,01,004,0109,154,653,7,660,1059,0,3,1,3,0,1,0,76.14,62.32 ,33.33
03,007,01,004,0110,155,1082,21,1103,1752,0,3,1,3,0,1,0,76.14,62.96 ,33.33
03,007,01,004,0111,156,838,6,844,1238,0,3,1,3,0,1,0,76.14,68.17 ,33.33
03,007,01,004,0112,157,230,3,233,354,0,3,1,3,0,1,0,76.14,65.82 ,33.33
03,007,01,004,0113,158,483,8,491,759,0,3,1,3,0,1,0,76.14,64.69 ,33.33
03,007,01,004,0114,159,543,8,551,858,0,3,1,3,0,1,0,76.14,64.22 ,33.33
03,007,01,004,0115,160,822,10,832,1223,0,3,1,3,0,1,0,76.14,68.03 ,33.33
03,007,01,004,0116,161,428,10,438,595,0,3,1,3,0,1,0,76.14,73.61 ,33.33
03,007,01,004,0117,162,683,10,693,1013,0,3,1,3,0,1,0,76.14,68.41 ,33.33
03,007,01,004,0118,163,822,11,833,1320,0,3,1,3,0,1,0,76.14,63.11 ,33.33
03,007,01,004,0119,164,820,12,832,1269,0,3,1,3,0,1,0,76.14,65.56 ,33.33
03,007,01,004,0119,165,876,4,880,1286,0,3,1,3,0,1,0,76.14,68.43 ,33.33
03,007,01,004,0120,166,1289,16,1305,1928,0,3,1,3,0,1,0,76.14,67.69 ,33.33
03,007,01,004,0120,167,1185,18,1203,1859,0,3,1,3,0,1,0,76.14,64.71 ,33.33
03,007,01,004,0120,168,912,14,926,1513,0,3,1,3,0,1,0,76.14,61.20 ,33.33
03,007,01,004,0121,169,778,13,791,1162,0,3,1,3,0,1,0,76.14,68.07 ,33.33
03,007,01,004,0121,170,1133,20,1153,1654,0,3,1,3,0,1,0,76.14,69.71 ,33.33
03,007,01,004,0121,171,823,12,835,1138,0,3,1,3,0,1,0,76.14,73.37 ,33.33
03,007,01,004,0122,172,1231,14,1245,1696,0,3,1,3,0,1,0,76.14,73.41 ,33.33
03,007,01,004,0122,173,772,13,785,1182,0,3,1,3,0,1,0,76.14,66.41 ,33.33
03,007,01,004,0123,174,890,22,912,1214,0,3,1,3,0,1,0,76.14,75.12 ,33.33
03,007,01,004,0123,175,969,7,976,1354,0,3,1,3,0,1,0,76.14,72.08 ,33.33
03,007,01,004,0124,176,964,11,975,1429,0,3,1,3,0,1,0,76.14,68.23 ,33.33
03,007,01,004,0125,177,894,16,910,1351,0,3,1,3,0,1,0,76.14,67.36 ,33.33
03,007,01,004,0125,178,693,14,707,1008,0,3,1,3,0,1,0,76.14,70.14 ,33.33
03,007,01,004,0126,179,532,5,537,778,0,3,1,3,0,1,0,76.14,69.02 ,33.33
03,007,01,004,0126,180,920,11,931,1341,0,3,1,3,0,1,0,76.14,69.43 ,33.33
03,007,01,004,0127,181,872,11,883,1292,0,3,1,3,0,1,0,76.14,68.34 ,33.33
03,007,01,004,0127,182,1011,19,1030,1388,0,3,1,3,0,1,0,76.14,74.21 ,33.33
03,007,01,004,0128,183,615,9,624,855,0,3,1,3,0,1,0,76.14,72.98 ,33.33
03,007,01,004,0128,184,1199,17,1216,1691,0,3,1,3,0,1,0,76.14,71.91 ,33.33
03,007,01,004,0129,185,1153,20,1173,1584,0,3,1,3,0,1,0,76.14,74.05 ,33.33
03,007,01,004,0130,186,967,14,981,1224,0,3,1,3,0,1,0,76.14,80.15 ,33.33
03,007,01,004,0130,187,566,10,576,702,0,3,1,3,0,1,0,76.14,82.05 ,33.33
03,007,01,004,0131,188,857,17,874,1264,0,3,1,3,0,1,0,76.14,69.15 ,33.33
03,007,01,004,0131,189,1065,20,1085,1456,0,3,1,3,0,1,0,76.14,74.52 ,33.33
03,007,01,004,0132,190,811,10,821,1075,0,3,1,3,0,1,0,76.14,76.37 ,33.33
03,007,01,004,0132,191,674,19,693,1018,0,3,1,3,0,1,0,76.14,68.07 ,33.33
03,007,01,004,0132,192,538,11,549,698,0,3,1,3,0,1,0,76.14,78.65 ,33.33
03,007,01,005,0133,193,597,14,611,903,0,3,1,3,0,1,0,76.14,67.66 ,33.33
03,007,01,005,0133,194,572,10,582,845,0,3,1,3,0,1,0,76.14,68.88 ,33.33
03,007,01,005,0134,195,751,13,764,1067,0,3,1,3,0,1,0,76.14,71.60 ,33.33
03,007,01,005,0135,196,655,12,667,906,0,3,1,3,0,1,0,76.14,73.62 ,33.33
03,007,01,005,0136,197,847,5,852,1133,0,3,1,3,0,1,0,76.14,75.20 ,33.33
03,007,01,005,0137,198,449,5,454,615,0,3,1,3,0,1,0,76.14,73.82 ,33.33
03,007,01,005,0138,199,836,10,846,1103,0,3,1,3,0,1,0,76.14,76.70 ,33.33
03,007,01,005,0139,200,690,15,705,965,0,3,1,3,0,1,0,76.14,73.06 ,33.33
03,007,01,005,0140,201,605,12,617,846,0,3,1,3,0,1,0,76.14,72.93 ,33.33
03,007,01,005,0140,202,616,2,618,870,0,3,1,3,0,1,0,76.14,71.03 ,33.33
03,007,01,005,0141,203,739,17,756,1148,0,3,1,3,0,1,0,76.14,65.85 ,33.33
03,007,01,005,0142,204,820,19,839,1167,0,3,1,3,0,1,0,76.14,71.89 ,33.33
03,007,01,005,0143,205,667,10,677,898,0,3,1,3,0,1,0,76.14,75.39 ,33.33
03,007,01,005,0143,206,480,9,489,801,0,3,1,3,0,1,0,76.14,61.05 ,33.33
03,007,01,005,0144,207,529,14,543,793,0,3,1,3,0,1,0,76.14,68.47 ,33.33
03,007,01,005,0144,208,376,9,385,646,0,3,1,3,0,1,0,76.14,59.60 ,33.33
03,007,01,005,0145,209,489,9,498,737,0,3,1,3,0,1,0,76.14,67.57 ,33.33
03,007,01,005,0145,210,653,10,663,940,0,3,1,3,0,1,0,76.14,70.53 ,33.33
03,007,01,005,0146,211,684,14,698,1004,0,3,1,3,0,1,0,76.14,69.52 ,33.33
03,007,01,005,0147,212,676,3,679,1024,0,3,1,3,0,1,0,76.14,66.31 ,33.33
03,007,01,005,0148,213,636,8,644,934,0,3,1,3,0,1,0,76.14,68.95 ,33.33
03,007,01,005,0148,214,591,12,603,950,0,3,1,3,0,1,0,76.14,63.47 ,33.33
03,007,01,005,0149,215,558,8,566,739,0,3,1,3,0,1,0,76.14,76.59 ,33.33
03,007,01,005,0149,216,587,12,599,829,0,3,1,3,0,1,0,76.14,72.26 ,33.33
03,007,01,005,0150,217,632,14,646,832,0,3,1,3,0,1,0,76.14,77.64 ,33.33
03,007,01,005,0150,218,732,9,741,945,0,3,1,3,0,1,0,76.14,78.41 ,33.33
03,007,01,005,0151,219,703,18,721,1014,0,3,1,3,0,1,0,76.14,71.10 ,33.33
03,007,01,005,0152,220,798,14,812,1144,0,3,1,3,0,1,0,76.14,70.98 ,33.33
03,007,01,005,0153,221,916,26,942,1316,0,3,1,3,0,1,0,76.14,71.58 ,33.33
03,007,01,005,0153,222,691,11,702,1005,0,3,1,3,0,1,0,76.14,69.85 ,33.33
03,007,01,005,0154,223,578,4,582,880,0,3,1,3,0,1,0,76.14,66.14 ,33.33
03,007,01,005,0154,224,596,10,606,921,0,3,1,3,0,1,0,76.14,65.80 ,33.33
03,007,01,006,0155,225,633,10,643,860,0,3,1,3,0,1,0,76.14,74.77 ,33.33
03,007,01,006,0155,226,436,10,446,554,0,3,1,3,0,1,0,76.14,80.51 ,33.33
03,007,01,006,0156,227,929,20,949,1272,0,3,1,3,0,1,0,76.14,74.61 ,33.33
03,007,01,006,0157,228,1220,25,1245,1687,0,3,1,3,0,1,0,76.14,73.80 ,33.33
03,007,01,006,0158,229,824,13,837,1008,0,3,1,3,0,1,0,76.14,83.04 ,33.33
03,007,01,006,0159,230,572,9,581,723,0,3,1,3,0,1,0,76.14,80.36 ,33.33
03,007,01,006,0159,231,546,2,548,722,0,3,1,3,0,1,0,76.14,75.90 ,33.33
03,007,01,006,0160,232,807,6,813,1037,0,3,1,3,0,1,0,76.14,78.40 ,33.33
03,007,01,006,0160,233,532,15,547,708,0,3,1,3,0,1,0,76.14,77.26 ,33.33
03,007,01,006,0160,234,715,19,734,986,0,3,1,3,0,1,0,76.14,74.44 ,33.33
03,007,01,006,0161,235,952,12,964,1314,0,3,1,3,0,1,0,76.14,73.36 ,33.33
03,007,01,006,0161,236,689,11,700,918,0,3,1,3,0,1,0,76.14,76.25 ,33.33
03,007,01,006,0162,237,681,17,698,905,0,3,1,3,0,1,0,76.14,77.13 ,33.33
03,007,01,006,0162,238,551,9,560,719,0,3,1,3,0,1,0,76.14,77.89 ,33.33
03,007,01,006,0163,239,748,15,763,974,0,3,1,3,0,1,0,76.14,78.34 ,33.33
03,007,01,006,0164,240,915,18,933,1244,0,3,1,3,0,1,0,76.14,75.00 ,33.33
03,007,01,006,0164,241,1002,17,1019,1336,0,3,1,3,0,1,0,76.14,76.27 ,33.33
03,007,01,006,0165,242,383,6,389,521,0,3,1,3,0,1,0,76.14,74.66 ,33.33
03,007,01,006,0165,243,710,14,724,992,0,3,1,3,0,1,0,76.14,72.98 ,33.33
03,007,01,006,0166,244,896,18,914,1185,0,3,1,3,0,1,0,76.14,77.13 ,33.33
03,007,01,006,0167,245,962,14,976,1240,0,3,1,3,0,1,0,76.14,78.71 ,33.33
03,007,01,006,0168,246,870,11,881,1065,0,3,1,3,0,1,0,76.14,82.72 ,33.33
03,007,01,006,0168,247,492,4,496,640,0,3,1,3,0,1,0,76.14,77.50 ,33.33
03,007,01,007,0169,248,1010,19,1029,1383,0,3,1,3,0,1,0,76.14,74.40 ,33.33
03,007,01,007,0169,249,1136,16,1152,1512,0,3,1,3,0,1,0,76.14,76.19 ,33.33
03,007,01,007,0170,250,1124,25,1149,1506,0,3,1,3,0,1,0,76.14,76.29 ,33.33
03,007,01,007,0170,251,849,9,858,1270,0,3,1,3,0,1,0,76.14,67.56 ,33.33
03,007,01,007,0171,252,392,1,393,474,0,3,1,3,0,1,0,76.14,82.91 ,33.33
03,007,01,007,0172,253,917,21,938,1228,0,3,1,3,0,1,0,76.14,76.38 ,33.33
03,007,01,007,0173,254,831,10,841,1180,0,3,1,3,0,1,0,76.14,71.27 ,33.33
03,007,01,007,0173,255,1144,18,1162,1665,0,3,1,3,0,1,0,76.14,69.79 ,33.33
03,007,01,007,0174,256,563,11,574,801,0,3,1,3,0,1,0,76.14,71.66 ,33.33
03,007,01,007,0174,257,749,9,758,1078,0,3,1,3,0,1,0,76.14,70.32 ,33.33
03,007,01,007,0175,258,714,19,733,1006,0,3,1,3,0,1,0,76.14,72.86 ,33.33
03,007,01,007,0176,259,561,9,570,692,0,3,1,3,0,1,0,76.14,82.37 ,33.33
03,007,01,007,0177,260,376,5,381,459,0,3,1,3,0,1,0,76.14,83.01 ,33.33
03,007,01,007,0177,261,723,7,730,919,0,3,1,3,0,1,0,76.14,79.43 ,33.33
03,007,01,007,0178,262,751,17,768,1024,0,3,1,3,0,1,0,76.14,75.00 ,33.33
03,007,01,007,0178,263,707,10,717,955,0,3,1,3,0,1,0,76.14,75.08 ,33.33
03,007,01,007,0179,264,831,19,850,1060,0,3,1,3,0,1,0,76.14,80.19 ,33.33
03,007,01,007,0180,265,1060,29,1089,1397,0,3,1,3,0,1,0,76.14,77.95 ,33.33
03,007,01,007,0181,266,1014,25,1039,1311,0,3,1,3,0,1,0,76.14,79.25 ,33.33
03,007,01,007,0182,267,935,18,953,1148,0,3,1,3,0,1,0,76.14,83.01 ,33.33
03,007,01,007,0183,268,1328,15,1343,1784,0,3,1,3,0,1,0,76.14,75.28 ,33.33
03,007,01,007,0183,269,1398,19,1417,1986,0,3,1,3,0,1,0,76.14,71.35 ,33.33
03,007,01,007,0184,270,926,20,946,1296,0,3,1,3,0,1,0,76.14,72.99 ,33.33
03,007,01,007,0185,271,896,13,909,1226,0,3,1,3,0,1,0,76.14,74.14 ,33.33
03,007,01,007,0186,272,804,20,824,1062,0,3,1,3,0,1,0,76.14,77.59 ,33.33
03,007,01,007,0186,273,690,9,699,938,0,3,1,3,0,1,0,76.14,74.52 ,33.33
03,007,01,007,0187,274,903,23,926,1205,0,3,1,3,0,1,0,76.14,76.85 ,33.33
03,007,01,007,0187,275,893,11,904,1170,0,3,1,3,0,1,0,76.14,77.26 ,33.33
03,007,01,007,0188,276,554,7,561,674,0,3,1,3,0,1,0,76.14,83.23 ,33.33
03,007,01,007,0189,277,1425,42,1467,1927,0,3,1,3,0,1,0,76.14,76.13 ,33.33
03,007,01,007,0190,278,710,12,722,946,0,3,1,3,0,1,0,76.14,76.32 ,33.33
03,007,01,007,0190,279,741,13,754,941,0,3,1,3,0,1,0,76.14,80.13 ,33.33
03,007,01,007,0191,280,758,15,773,1050,0,3,1,3,0,1,0,76.14,73.62 ,33.33
03,007,01,007,0192,281,728,13,741,970,0,3,1,3,0,1,0,76.14,76.39 ,33.33
03,007,01,007,0192,282,863,21,884,1292,0,3,1,3,0,1,0,76.14,68.42 ,33.33
03,007,01,007,0193,283,827,19,846,1187,0,3,1,3,0,1,0,76.14,71.27 ,33.33
03,007,01,007,0194,284,1169,21,1190,1550,0,3,1,3,0,1,0,76.14,76.77 ,33.33
03,007,01,007,0195,285,655,7,662,852,0,3,1,3,0,1,0,76.14,77.70 ,33.33
03,007,01,007,0196,286,896,8,904,1150,0,3,1,3,0,1,0,76.14,78.61 ,33.33
03,007,01,007,0197,287,1182,23,1205,1589,0,3,1,3,0,1,0,76.14,75.83 ,33.33
03,007,01,007,0198,288,1055,20,1075,1466,0,3,1,3,0,1,0,76.14,73.33 ,33.33
03,007,01,007,0198,289,818,15,833,1146,0,3,1,3,0,1,0,76.14,72.69 ,33.33
03,007,01,007,0199,290,491,8,499,622,0,3,1,3,0,1,0,76.14,80.23 ,33.33
03,007,01,007,0199,291,718,9,727,889,0,3,1,3,0,1,0,76.14,81.78 ,33.33
03,007,01,008,0200,292,1286,15,1301,1698,0,3,1,3,0,1,0,76.14,76.62 ,33.33
03,007,01,008,0201,293,809,10,819,1055,0,3,1,3,0,1,0,76.14,77.63 ,33.33
03,007,01,008,0202,294,1139,12,1151,1593,0,3,1,3,0,1,0,76.14,72.25 ,33.33
03,007,01,008,0203,295,832,8,840,1098,0,3,1,3,0,1,0,76.14,76.50 ,33.33
03,007,01,008,0204,296,653,16,669,909,0,3,1,3,0,1,0,76.14,73.60 ,33.33
03,007,01,008,0205,297,1085,18,1103,1475,0,3,1,3,0,1,0,76.14,74.78 ,33.33
03,007,01,008,0206,298,1384,34,1418,1796,0,3,1,3,0,1,0,76.14,78.95 ,33.33
03,007,01,008,0207,299,731,16,747,887,0,3,1,3,0,1,0,76.14,84.22 ,33.33
03,007,01,009,0208,300,1088,17,1105,1538,0,3,1,3,0,1,0,76.14,71.85 ,33.33
03,007,01,009,0208,301,1275,22,1297,1856,0,3,1,3,0,1,0,76.14,69.88 ,33.33
03,007,01,009,0209,302,966,14,980,1339,0,3,1,3,0,1,0,76.14,73.19 ,33.33
03,007,01,009,0210,303,811,12,823,1045,0,3,1,3,0,1,0,76.14,78.76 ,33.33
03,007,01,009,0211,304,1070,17,1087,1405,0,3,1,3,0,1,0,76.14,77.37 ,33.33
03,007,01,009,0212,305,923,17,940,1217,0,3,1,3,0,1,0,76.14,77.24 ,33.33
03,007,01,009,0213,306,1061,13,1074,1359,0,3,1,3,0,1,0,76.14,79.03 ,33.33
03,007,01,009,0214,307,1214,30,1244,1737,0,3,1,3,0,1,0,76.14,71.62 ,33.33
03,007,01,009,0215,308,1008,12,1020,1325,0,3,1,3,0,1,0,76.14,76.98 ,33.33
03,007,01,009,0216,309,667,6,673,967,0,3,1,3,0,1,0,76.14,69.60 ,33.33
03,007,01,009,0217,310,1007,13,1020,1393,0,3,1,3,0,1,0,76.14,73.22 ,33.33
03,007,01,009,0218,311,790,14,804,1087,0,3,1,3,0,1,0,76.14,73.97 ,33.33
03,007,01,009,0219,312,460,4,464,619,0,3,1,3,0,1,0,76.14,74.96 ,33.33
03,007,01,009,0220,313,993,15,1008,1378,0,3,1,3,0,1,0,76.14,73.15 ,33.33
03,007,01,009,0221,314,1305,16,1321,1660,0,3,1,3,0,1,0,76.14,79.58 ,33.33
03,007,01,010,0222,315,836,12,848,1134,0,3,1,3,0,1,0,76.14,74.78 ,33.33
03,007,01,010,0223,316,699,9,708,1019,0,3,1,3,0,1,0,76.14,69.48 ,33.33
03,007,01,010,0223,317,1012,16,1028,1482,0,3,1,3,0,1,0,76.14,69.37 ,33.33
03,007,01,010,0224,318,1106,10,1116,1572,0,3,1,3,0,1,0,76.14,70.99 ,33.33
03,007,01,010,0225,319,784,8,792,1142,0,3,1,3,0,1,0,76.14,69.35 ,33.33
03,007,01,010,0225,320,1045,15,1060,1489,0,3,1,3,0,1,0,76.14,71.19 ,33.33
03,007,01,010,0226,321,588,15,603,815,0,3,1,3,0,1,0,76.14,73.99 ,33.33
03,007,01,010,0227,322,744,5,749,1081,0,3,1,3,0,1,0,76.14,69.29 ,33.33
03,007,01,010,0227,323,962,16,978,1394,0,3,1,3,0,1,0,76.14,70.16 ,33.33
03,007,01,010,0228,324,769,10,779,1012,0,3,1,3,0,1,0,76.14,76.98 ,33.33
03,007,01,010,0229,325,559,2,561,786,0,3,1,3,0,1,0,76.14,71.37 ,33.33
03,007,01,010,0230,326,605,8,613,871,0,3,1,3,0,1,0,76.14,70.38 ,33.33
03,007,01,010,0230,327,605,13,618,858,0,3,1,3,0,1,0,76.14,72.03 ,33.33
03,007,01,010,0231,328,771,10,781,1144,0,3,1,3,0,1,0,76.14,68.27 ,33.33
03,007,01,010,0231,329,779,12,791,1226,0,3,1,3,0,1,0,76.14,64.52 ,33.33
03,007,01,010,0231,330,799,23,822,1189,0,3,1,3,0,1,0,76.14,69.13 ,33.33
03,007,01,010,0232,331,689,6,695,1006,0,3,1,3,0,1,0,76.14,69.09 ,33.33
03,007,01,010,0232,332,758,12,770,1151,0,3,1,3,0,1,0,76.14,66.90 ,33.33
03,007,01,010,0233,333,690,18,708,968,0,3,1,3,0,1,0,76.14,73.14 ,33.33
03,007,01,010,0233,334,1072,18,1090,1505,0,3,1,3,0,1,0,76.14,72.43 ,33.33
03,007,01,010,0233,335,683,9,692,1007,0,3,1,3,0,1,0,76.14,68.72 ,33.33
03,007,01,010,0234,336,1035,23,1058,1534,0,3,1,3,0,1,0,76.14,68.97 ,33.33
03,007,01,010,0234,337,947,29,976,1348,0,3,1,3,0,1,0,76.14,72.40 ,33.33
03,007,01,010,0235,338,963,21,984,1387,0,3,1,3,0,1,0,76.14,70.94 ,33.33
03,007,01,010,0235,339,900,10,910,1259,0,3,1,3,0,1,0,76.14,72.28 ,33.33
03,007,01,010,0235,340,874,11,885,1244,0,3,1,3,0,1,0,76.14,71.14 ,33.33
03,007,01,010,0236,341,1107,16,1123,1470,0,3,1,3,0,1,0,76.14,76.39 ,33.33
03,007,01,010,0237,342,1008,19,1027,1298,0,3,1,3,0,1,0,76.14,79.12 ,33.33
03,007,01,010,0238,343,757,13,770,1087,0,3,1,3,0,1,0,76.14,70.84 ,33.33
03,007,01,010,0238,344,670,9,679,975,0,3,1,3,0,1,0,76.14,69.64 ,33.33
03,007,01,010,0238,345,846,17,863,1193,0,3,1,3,0,1,0,76.14,72.34 ,33.33
03,007,01,010,0238,346,916,11,927,1310,0,3,1,3,0,1,0,76.14,70.76 ,33.33
03,007,01,010,0239,347,869,6,875,1223,0,3,1,3,0,1,0,76.14,71.55 ,33.33
03,007,01,010,0239,348,938,18,956,1342,0,3,1,3,0,1,0,76.14,71.24 ,33.33
03,007,01,010,0239,349,1161,19,1180,1635,0,3,1,3,0,1,0,76.14,72.17 ,33.33
03,007,01,010,0240,350,794,9,803,1071,0,3,1,3,0,1,0,76.14,74.98 ,33.33
03,007,01,010,0240,351,754,13,767,1107,0,3,1,3,0,1,0,76.14,69.29 ,33.33
03,007,01,010,0241,352,609,5,614,878,0,3,1,3,0,1,0,76.14,69.93 ,33.33
03,007,01,010,0241,353,625,10,635,942,0,3,1,3,0,1,0,76.14,67.41 ,33.33
03,007,01,010,0242,354,654,6,660,906,0,3,1,3,0,1,0,76.14,72.85 ,33.33
03,007,01,010,0242,355,649,8,657,933,0,3,1,3,0,1,0,76.14,70.42 ,33.33
03,007,01,010,0243,356,688,4,692,1010,0,3,1,3,0,1,0,76.14,68.51 ,33.33
03,007,01,010,0243,357,443,6,449,665,0,3,1,3,0,1,0,76.14,67.52 ,33.33
03,007,01,010,0244,358,968,16,984,1287,0,3,1,3,0,1,0,76.14,76.46 ,33.33
03,007,01,010,0245,359,595,17,612,872,0,3,1,3,0,1,0,76.14,70.18 ,33.33
03,007,01,010,0245,360,651,14,665,927,0,3,1,3,0,1,0,76.14,71.74 ,33.33
03,007,01,010,0246,361,798,21,819,1082,0,3,1,3,0,1,0,76.14,75.69 ,33.33
03,007,01,010,0246,362,665,14,679,953,0,3,1,3,0,1,0,76.14,71.25 ,33.33
03,007,01,010,0247,363,1222,20,1242,1697,0,3,1,3,0,1,0,76.14,73.19 ,33.33
03,007,01,010,0248,364,1226,22,1248,1718,0,3,1,3,0,1,0,76.14,72.64 ,33.33
03,007,01,010,0248,365,647,12,659,934,0,3,1,3,0,1,0,76.14,70.56 ,33.33
03,007,01,010,0249,366,760,12,772,999,0,3,1,3,0,1,0,76.14,77.28 ,33.33
03,007,01,010,0249,367,744,7,751,1031,0,3,1,3,0,1,0,76.14,72.84 ,33.33
03,007,01,010,0250,368,516,7,523,729,0,3,1,3,0,1,0,76.14,71.74 ,33.33
03,007,01,010,0250,369,736,13,749,1035,0,3,1,3,0,1,0,76.14,72.37 ,33.33
03,007,01,010,0251,370,605,13,618,879,0,3,1,3,0,1,0,76.14,70.31 ,33.33
03,007,01,010,0251,371,734,16,750,1078,0,3,1,3,0,1,0,76.14,69.57 ,33.33
03,007,01,010,0252,372,1023,19,1042,1616,0,3,1,3,0,1,0,76.14,64.48 ,33.33
03,007,01,010,0253,373,911,13,924,1261,0,3,1,3,0,1,0,76.14,73.28 ,33.33
03,007,01,010,0254,374,480,10,490,739,0,3,1,3,0,1,0,76.14,66.31 ,33.33
03,007,01,010,0255,375,585,7,592,851,0,3,1,3,0,1,0,76.14,69.57 ,33.33
03,007,01,010,0255,376,594,13,607,840,0,3,1,3,0,1,0,76.14,72.26 ,33.33
03,007,01,010,0256,377,751,12,763,1021,0,3,1,3,0,1,0,76.14,74.73 ,33.33
03,007,01,010,0256,378,543,6,549,799,0,3,1,3,0,1,0,76.14,68.71 ,33.33
03,007,01,010,0257,379,984,18,1002,1384,0,3,1,3,0,1,0,76.14,72.40 ,33.33
03,007,01,010,0258,380,1015,19,1034,1542,0,3,1,3,0,1,0,76.14,67.06 ,33.33
03,007,01,010,0259,381,871,33,904,1262,0,3,1,3,0,1,0,76.14,71.63 ,33.33
03,007,01,010,0260,382,653,21,674,849,0,3,1,3,0,1,0,76.14,79.39 ,33.33
03,007,01,010,0260,383,684,11,695,868,0,3,1,3,0,1,0,76.14,80.07 ,33.33
03,007,01,011,0261,384,1181,25,1206,1588,0,3,1,3,0,1,0,76.14,75.94 ,33.33
03,007,01,011,0262,385,1150,26,1176,1498,0,3,1,3,0,1,0,76.14,78.50 ,33.33
03,007,01,011,0263,386,589,6,595,750,0,3,1,3,0,1,0,76.14,79.33 ,33.33
03,007,01,011,0264,387,854,12,866,1155,0,3,1,3,0,1,0,76.14,74.98 ,33.33
03,007,01,011,0265,388,826,10,836,1128,0,3,1,3,0,1,0,76.14,74.11 ,33.33
03,007,01,011,0266,389,1083,18,1101,1431,0,3,1,3,0,1,0,76.14,76.94 ,33.33
03,007,01,011,0267,390,750,12,762,1073,0,3,1,3,0,1,0,76.14,71.02 ,33.33
03,007,01,011,0268,391,755,12,767,983,0,3,1,3,0,1,0,76.14,78.03 ,33.33
03,007,01,011,0269,392,1328,21,1349,1823,0,3,1,3,0,1,0,76.14,74.00 ,33.33
03,007,01,011,0270,393,1022,8,1030,1332,0,3,1,3,0,1,0,76.14,77.33 ,33.33
03,007,01,011,0271,394,1208,29,1237,1684,0,3,1,3,0,1,0,76.14,73.46 ,33.33
03,007,01,011,0272,395,833,12,845,1063,0,3,1,3,0,1,0,76.14,79.49 ,33.33
03,007,01,011,0273,396,977,11,988,1266,0,3,1,3,0,1,0,76.14,78.04 ,33.33
03,007,01,011,0273,397,679,25,704,943,0,3,1,3,0,1,0,76.14,74.66 ,33.33
03,007,01,011,0274,398,1081,19,1100,1441,0,3,1,3,0,1,0,76.14,76.34 ,33.33
03,007,01,011,0275,399,1087,46,1133,1544,0,3,1,3,0,1,0,76.14,73.38 ,33.33
03,007,01,011,0276,400,1361,24,1385,1761,0,3,1,3,0,1,0,76.14,78.65 ,33.33
03,007,01,012,0277,401,585,10,595,779,0,3,1,3,0,1,0,76.14,76.38 ,33.33
03,007,01,012,0278,402,928,18,946,1334,0,3,1,3,0,1,0,76.14,70.91 ,33.33
03,007,01,012,0279,403,1217,29,1246,1692,0,3,1,3,0,1,0,76.14,73.64 ,33.33
03,007,01,012,0280,404,1071,20,1091,1496,0,3,1,3,0,1,0,76.14,72.93 ,33.33
03,007,01,012,0281,405,1066,28,1094,1539,0,3,1,3,0,1,0,76.14,71.09 ,33.33
03,007,01,012,0282,406,817,20,837,1198,0,3,1,3,0,1,0,76.14,69.87 ,33.33
03,007,01,012,0283,407,563,8,571,770,0,3,1,3,0,1,0,76.14,74.16 ,33.33
03,007,01,012,0284,408,561,7,568,764,0,3,1,3,0,1,0,76.14,74.35 ,33.33
03,007,01,012,0285,409,1268,25,1293,1755,0,3,1,3,0,1,0,76.14,73.68 ,33.33
03,007,01,012,0286,410,855,11,866,1170,0,3,1,3,0,1,0,76.14,74.02 ,33.33
03,007,01,012,0287,411,674,10,684,955,0,3,1,3,0,1,0,76.14,71.62 ,33.33
03,007,01,012,0288,412,904,18,922,1263,0,3,1,3,0,1,0,76.14,73.00 ,33.33
03,007,01,012,0289,413,1032,19,1051,1428,0,3,1,3,0,1,0,76.14,73.60 ,33.33
03,007,01,012,0290,414,1024,18,1042,1353,0,3,1,3,0,1,0,76.14,77.01 ,33.33
03,007,01,012,0291,415,746,16,762,1008,0,3,1,3,0,1,0,76.14,75.60 ,33.33
03,007,01,012,0292,416,608,15,623,844,0,3,1,3,0,1,0,76.14,73.82 ,33.33
03,007,01,012,0293,417,438,9,447,592,0,3,1,3,0,1,0,76.14,75.51 ,33.33
03,007,01,012,0294,418,505,21,526,680,0,3,1,3,0,1,0,76.14,77.35 ,33.33
03,007,01,012,0295,419,426,7,433,554,0,3,1,3,0,1,0,76.14,78.16 ,33.33
03,007,01,012,0296,420,690,12,702,905,0,3,1,3,0,1,0,76.14,77.57 ,33.33
03,007,01,012,0297,421,576,18,594,801,0,3,1,3,0,1,0,76.14,74.16 ,33.33
03,007,01,012,0298,422,504,9,513,688,0,3,1,3,0,1,0,76.14,74.56 ,33.33
03,007,01,012,0299,423,873,7,880,1121,0,3,1,3,0,1,0,76.14,78.50 ,33.33
03,007,01,012,0300,424,942,15,957,1333,0,3,1,3,0,1,0,76.14,71.79 ,33.33
03,007,01,013,0301,425,845,2,847,1177,0,3,1,3,0,1,0,76.14,71.96 ,33.33
03,007,01,013,0302,426,554,3,557,747,0,3,1,3,0,1,0,76.14,74.56 ,33.33
03,007,01,013,0303,427,816,12,828,1136,0,3,1,3,0,1,0,76.14,72.89 ,33.33
03,007,01,013,0304,428,407,3,410,556,0,3,1,3,0,1,0,76.14,73.74 ,33.33
03,007,01,013,0305,429,865,17,882,1242,0,3,1,3,0,1,0,76.14,71.01 ,33.33
03,007,01,013,0305,430,885,13,898,1225,0,3,1,3,0,1,0,76.14,73.31 ,33.33
03,007,01,013,0306,431,1152,16,1168,1563,0,3,1,3,0,1,0,76.14,74.73 ,33.33
03,007,01,013,0307,432,1204,25,1229,1671,0,3,1,3,0,1,0,76.14,73.55 ,33.33
03,007,01,013,0308,433,850,18,868,1191,0,3,1,3,0,1,0,76.14,72.88 ,33.33
03,007,01,013,0309,434,1073,14,1087,1553,0,3,1,3,0,1,0,76.14,69.99 ,33.33
03,007,01,013,0310,435,761,6,767,1057,0,3,1,3,0,1,0,76.14,72.56 ,33.33
03,007,01,013,0310,436,799,14,813,1098,0,3,1,3,0,1,0,76.14,74.04 ,33.33
03,007,01,013,0311,437,1117,14,1131,1577,0,3,1,3,0,1,0,76.14,71.72 ,33.33
03,007,01,013,0312,438,538,5,543,722,0,3,1,3,0,1,0,76.14,75.21 ,33.33
03,007,01,013,0313,439,1038,24,1062,1454,0,3,1,3,0,1,0,76.14,73.04 ,33.33
03,007,01,013,0314,440,854,13,867,1083,0,3,1,3,0,1,0,76.14,80.06 ,33.33
03,007,01,013,0314,441,694,3,697,1016,0,3,1,3,0,1,0,76.14,68.60 ,33.33
03,007,01,013,0315,442,496,9,505,675,0,3,1,3,0,1,0,76.14,74.81 ,33.33
03,007,01,013,0316,443,748,13,761,1157,0,3,1,3,0,1,0,76.14,65.77 ,33.33
03,007,01,013,0317,444,918,14,932,1285,0,3,1,3,0,1,0,76.14,72.53 ,33.33
03,007,01,013,0318,445,1184,16,1200,1735,0,3,1,3,0,1,0,76.14,69.16 ,33.33
03,007,01,013,0318,446,918,15,933,1286,0,3,1,3,0,1,0,76.14,72.55 ,33.33
03,007,01,013,0319,447,429,8,437,630,0,3,1,3,0,1,0,76.14,69.37 ,33.33
03,007,01,013,0320,448,879,9,888,1084,0,3,1,3,0,1,0,76.14,81.92 ,33.33
03,007,01,013,0321,449,559,7,566,690,0,3,1,3,0,1,0,76.14,82.03 ,33.33
03,007,01,013,0322,450,835,16,851,1081,0,3,1,3,0,1,0,76.14,78.72 ,33.33
03,007,01,013,0323,451,894,13,907,1289,0,3,1,3,0,1,0,76.14,70.36 ,33.33
03,007,01,013,0324,452,1133,11,1144,1600,0,3,1,3,0,1,0,76.14,71.50 ,33.33
03,007,01,013,0325,453,888,20,908,1397,0,3,1,3,0,1,0,76.14,65.00 ,33.33
03,007,01,014,0326,454,990,26,1016,1338,0,3,1,3,0,1,0,76.14,75.93 ,33.33
03,007,01,014,0327,455,963,12,975,1257,0,3,1,3,0,1,0,76.14,77.57 ,33.33
03,007,01,014,0328,456,799,17,816,1052,0,3,1,3,0,1,0,76.14,77.57 ,33.33
03,007,01,014,0329,457,556,13,569,708,0,3,1,3,0,1,0,76.14,80.37 ,33.33
03,007,01,014,0330,458,1184,24,1208,1474,0,3,1,3,0,1,0,76.14,81.95 ,33.33
03,007,01,014,0331,459,697,17,714,893,0,3,1,3,0,1,0,76.14,79.96 ,33.33
03,007,01,014,0332,460,853,15,868,1167,0,3,1,3,0,1,0,76.14,74.38 ,33.33
03,007,01,014,0333,461,735,12,747,957,0,3,1,3,0,1,0,76.14,78.06 ,33.33
03,007,01,014,0334,462,527,7,534,634,0,3,1,3,0,1,0,76.14,84.23 ,33.33
03,007,01,014,0335,463,747,9,756,966,0,3,1,3,0,1,0,76.14,78.26 ,33.33
03,007,01,014,0336,464,841,10,851,1087,0,3,1,3,0,1,0,76.14,78.29 ,33.33
03,007,01,014,0337,465,1369,21,1390,1837,0,3,1,3,0,1,0,76.14,75.67 ,33.33
03,007,01,014,0338,466,943,16,959,1189,0,3,1,3,0,1,0,76.14,80.66 ,33.33
03,007,01,014,0339,467,282,2,284,367,0,3,1,3,0,1,0,76.14,77.38 ,33.33
03,007,01,014,0340,468,698,10,708,957,0,3,1,3,0,1,0,76.14,73.98 ,33.33
03,007,01,014,0341,469,538,5,543,689,0,3,1,3,0,1,0,76.14,78.81 ,33.33
03,007,01,014,0342,470,930,10,940,1248,0,3,1,3,0,1,0,76.14,75.32 ,33.33
03,007,01,014,0343,471,632,12,644,816,0,3,1,3,0,1,0,76.14,78.92 ,33.33
03,007,01,014,0344,472,987,18,1005,1397,0,3,1,3,0,1,0,76.14,71.94 ,33.33
03,007,01,014,0345,473,892,11,903,1196,0,3,1,3,0,1,0,76.14,75.50 ,33.33
03,007,01,014,0346,474,939,11,950,1214,0,3,1,3,0,1,0,76.14,78.25 ,33.33
03,007,01,014,0347,475,906,10,916,1182,0,3,1,3,0,1,0,76.14,77.50 ,33.33
03,007,01,015,0348,476,813,16,829,1084,0,3,1,3,0,1,0,76.14,76.48 ,33.33
03,007,01,015,0348,477,815,7,822,1058,0,3,1,3,0,1,0,76.14,77.69 ,33.33
03,007,01,015,0349,478,810,14,824,1114,0,3,1,3,0,1,0,76.14,73.97 ,33.33
03,007,01,015,0350,479,964,19,983,1285,0,3,1,3,0,1,0,76.14,76.50 ,33.33
03,007,01,015,0351,480,751,14,765,964,0,3,1,3,0,1,0,76.14,79.36 ,33.33
03,007,01,015,0352,481,1087,12,1099,1405,0,3,1,3,0,1,0,76.14,78.22 ,33.33
03,007,01,015,0353,482,1136,18,1154,1448,0,3,1,3,0,1,0,76.14,79.70 ,33.33
03,007,01,015,0354,483,944,15,959,1204,0,3,1,3,0,1,0,76.14,79.65 ,33.33
03,007,01,015,0355,484,920,8,928,1238,0,3,1,3,0,1,0,76.14,74.96 ,33.33
03,007,01,015,0356,485,1085,25,1110,1497,0,3,1,3,0,1,0,76.14,74.15 ,33.33
03,007,01,015,0357,486,443,8,451,598,0,3,1,3,0,1,0,76.14,75.42 ,33.33
03,007,01,015,0358,487,638,12,650,894,0,3,1,3,0,1,0,76.14,72.71 ,33.33
03,007,01,015,0359,488,675,9,684,947,0,3,1,3,0,1,0,76.14,72.23 ,33.33
03,007,01,015,0360,489,456,9,465,687,0,3,1,3,0,1,0,76.14,67.69 ,33.33
03,007,01,015,0361,490,539,13,552,765,0,3,1,3,0,1,0,76.14,72.16 ,33.33
03,007,01,015,0362,491,1020,17,1037,1526,0,3,1,3,0,1,0,76.14,67.96 ,33.33
03,007,01,015,0363,492,889,14,903,1271,0,3,1,3,0,1,0,76.14,71.05 ,33.33
03,007,01,015,0364,493,667,5,672,851,0,3,1,3,0,1,0,76.14,78.97 ,33.33
03,007,01,015,0365,494,872,13,885,1102,0,3,1,3,0,1,0,76.14,80.31 ,33.33
03,007,01,015,0366,495,551,8,559,696,0,3,1,3,0,1,0,76.14,80.32 ,33.33
03,007,01,015,0367,496,652,8,660,833,0,3,1,3,0,1,0,76.14,79.23 ,33.33
03,007,01,016,0368,497,594,9,603,864,0,3,1,3,0,1,0,76.14,69.79 ,33.33
03,007,01,016,0369,498,669,30,699,1014,0,3,1,3,0,1,0,76.14,68.93 ,33.33
03,007,01,016,0369,499,716,23,739,997,0,3,1,3,0,1,0,76.14,74.12 ,33.33
03,007,01,016,0369,500,490,8,498,760,0,3,1,3,0,1,0,76.14,65.53 ,33.33
03,007,01,016,0370,501,411,6,417,651,0,3,1,3,0,1,0,76.14,64.06 ,33.33
03,007,01,016,0371,502,954,14,968,1368,0,3,1,3,0,1,0,76.14,70.76 ,33.33
03,007,01,016,0372,503,929,21,950,1433,0,3,1,3,0,1,0,76.14,66.29 ,33.33
03,007,01,016,0373,504,732,19,751,1043,0,3,1,3,0,1,0,76.14,72.00 ,33.33
03,007,01,016,0374,505,1063,14,1077,1561,0,3,1,3,0,1,0,76.14,68.99 ,33.33
03,007,01,016,0375,506,468,7,475,673,0,3,1,3,0,1,0,76.14,70.58 ,33.33
03,007,01,016,0376,507,994,15,1009,1488,0,3,1,3,0,1,0,76.14,67.81 ,33.33
03,007,01,016,0376,508,604,7,611,819,0,3,1,3,0,1,0,76.14,74.60 ,33.33
03,007,01,016,0377,509,629,7,636,890,0,3,1,3,0,1,0,76.14,71.46 ,33.33
03,007,01,016,0377,510,673,18,691,970,0,3,1,3,0,1,0,76.14,71.24 ,33.33
03,007,01,016,0378,511,786,13,799,1108,0,3,1,3,0,1,0,76.14,72.11 ,33.33
03,007,01,016,0379,512,916,11,927,1314,0,3,1,3,0,1,0,76.14,70.55 ,33.33
03,007,01,016,0380,513,599,6,605,930,0,3,1,3,0,1,0,76.14,65.05 ,33.33
03,007,01,016,0380,514,732,10,742,1063,0,3,1,3,0,1,0,76.14,69.80 ,33.33
03,007,01,016,0381,515,1114,28,1142,1663,0,3,1,3,0,1,0,76.14,68.67 ,33.33
03,007,01,016,0382,516,1067,33,1100,1559,0,3,1,3,0,1,0,76.14,70.56 ,33.33
03,007,01,016,0383,517,818,22,840,1165,0,3,1,3,0,1,0,76.14,72.10 ,33.33
03,007,01,016,0384,518,938,22,960,1422,0,3,1,3,0,1,0,76.14,67.51 ,33.33
03,007,01,016,0385,519,1056,23,1079,1495,0,3,1,3,0,1,0,76.14,72.17 ,33.33
03,007,01,016,0385,520,728,17,745,1155,0,3,1,3,0,1,0,76.14,64.50 ,33.33
03,007,01,016,0386,521,890,18,908,1285,0,3,1,3,0,1,0,76.14,70.66 ,33.33
03,007,01,016,0387,522,962,18,980,1353,0,3,1,3,0,1,0,76.14,72.43 ,33.33
03,007,01,016,0388,523,636,8,644,876,0,3,1,3,0,1,0,76.14,73.52 ,33.33
03,007,01,016,0389,524,499,9,508,729,0,3,1,3,0,1,0,76.14,69.68 ,33.33
03,007,01,017,0390,525,745,12,757,1106,0,3,1,3,0,1,0,76.14,68.44 ,33.33
03,007,01,017,0390,526,879,12,891,1270,0,3,1,3,0,1,0,76.14,70.16 ,33.33
03,007,01,017,0391,527,754,10,764,993,0,3,1,3,0,1,0,76.14,76.94 ,33.33
03,007,01,017,0391,528,724,20,744,999,0,3,1,3,0,1,0,76.14,74.47 ,33.33
03,007,01,017,0391,529,660,18,678,907,0,3,1,3,0,1,0,76.14,74.75 ,33.33
03,007,01,017,0392,530,654,10,664,908,0,3,1,3,0,1,0,76.14,73.13 ,33.33
03,007,01,017,0392,531,821,16,837,1244,0,3,1,3,0,1,0,76.14,67.28 ,33.33
03,007,01,017,0393,532,476,15,491,700,0,3,1,3,0,1,0,76.14,70.14 ,33.33
03,007,01,017,0394,533,691,11,702,927,0,3,1,3,0,1,0,76.14,75.73 ,33.33
03,007,01,017,0395,534,727,13,740,995,0,3,1,3,0,1,0,76.14,74.37 ,33.33
03,007,01,017,0396,535,881,11,892,1241,0,3,1,3,0,1,0,76.14,71.88 ,33.33
03,007,01,017,0397,536,607,14,621,806,0,3,1,3,0,1,0,76.14,77.05 ,33.33
03,007,01,017,0398,537,783,13,796,1116,0,3,1,3,0,1,0,76.14,71.33 ,33.33
03,007,01,017,0399,538,577,8,585,757,0,3,1,3,0,1,0,76.14,77.28 ,33.33
03,007,01,017,0400,539,1242,32,1274,1693,0,3,1,3,0,1,0,76.14,75.25 ,33.33
03,007,01,017,0401,540,982,18,1000,1270,0,3,1,3,0,1,0,76.14,78.74 ,33.33
03,007,01,017,0402,541,979,19,998,1322,0,3,1,3,0,1,0,76.14,75.49 ,33.33
03,007,01,017,0403,542,749,14,763,990,0,3,1,3,0,1,0,76.14,77.07 ,33.33
03,007,01,017,0404,543,767,12,779,945,0,3,1,3,0,1,0,76.14,82.43 ,33.33
03,007,01,017,0405,544,734,12,746,965,0,3,1,3,0,1,0,76.14,77.31 ,33.33
03,007,01,017,0406,545,665,11,676,863,0,3,1,3,0,1,0,76.14,78.33 ,33.33
03,007,01,017,0407,546,634,10,644,883,0,3,1,3,0,1,0,76.14,72.93 ,33.33
03,007,01,017,0408,547,459,14,473,605,0,3,1,3,0,1,0,76.14,78.18 ,33.33
03,007,01,017,0409,548,589,12,601,757,0,3,1,3,0,1,0,76.14,79.39 ,33.33
03,007,01,017,0410,549,592,15,607,774,0,3,1,3,0,1,0,76.14,78.42 ,33.33
03,007,01,017,0411,550,567,4,571,733,0,3,1,3,0,1,0,76.14,77.90 ,33.33
03,007,01,017,0412,551,912,15,927,1243,0,3,1,3,0,1,0,76.14,74.58 ,33.33
03,007,01,017,0413,552,1156,27,1183,1683,0,3,1,3,0,1,0,76.14,70.29 ,33.33
03,007,01,018,0414,553,742,15,757,1047,0,3,1,3,0,1,0,76.14,72.30 ,33.33
03,007,01,018,0415,554,471,7,478,710,0,3,1,3,0,1,0,76.14,67.32 ,33.33
03,007,01,018,0416,555,596,13,609,836,0,3,1,3,0,1,0,76.14,72.85 ,33.33
03,007,01,018,0417,556,717,13,730,1016,0,3,1,3,0,1,0,76.14,71.85 ,33.33
03,007,01,018,0418,557,496,9,505,682,0,3,1,3,0,1,0,76.14,74.05 ,33.33
03,007,01,018,0419,558,548,8,556,742,0,3,1,3,0,1,0,76.14,74.93 ,33.33
03,007,01,018,0420,559,677,18,695,932,0,3,1,3,0,1,0,76.14,74.57 ,33.33
03,007,01,018,0421,560,656,11,667,886,0,3,1,3,0,1,0,76.14,75.28 ,33.33
03,007,01,018,0422,561,612,9,621,843,0,3,1,3,0,1,0,76.14,73.67 ,33.33
03,007,01,018,0423,562,411,1,412,553,0,3,1,3,0,1,0,76.14,74.50 ,33.33
03,007,01,018,0424,563,635,9,644,878,0,3,1,3,0,1,0,76.14,73.35 ,33.33
03,007,01,018,0425,564,642,11,653,909,0,3,1,3,0,1,0,76.14,71.84 ,33.33
03,007,01,018,0426,565,512,11,523,681,0,3,1,3,0,1,0,76.14,76.80 ,33.33
03,007,01,018,0427,566,592,9,601,800,0,3,1,3,0,1,0,76.14,75.13 ,33.33
03,007,01,018,0428,567,594,7,601,856,0,3,1,3,0,1,0,76.14,70.21 ,33.33
03,007,01,018,0429,568,481,15,496,661,0,3,1,3,0,1,0,76.14,75.04 ,33.33
03,007,01,018,0430,569,483,11,494,653,0,3,1,3,0,1,0,76.14,75.65 ,33.33
03,007,01,019,0431,570,782,15,797,1100,0,3,1,3,0,1,0,76.14,72.45 ,33.33
03,007,01,019,0431,571,729,17,746,1036,0,3,1,3,0,1,0,76.14,72.01 ,33.33
03,007,01,019,0432,572,1121,15,1136,1537,0,3,1,3,0,1,0,76.14,73.91 ,33.33
03,007,01,019,0433,573,662,15,677,927,0,3,1,3,0,1,0,76.14,73.03 ,33.33
03,007,01,019,0433,574,760,5,765,1040,0,3,1,3,0,1,0,76.14,73.56 ,33.33
03,007,01,019,0433,575,864,16,880,1223,0,3,1,3,0,1,0,76.14,71.95 ,33.33
03,007,01,019,0434,576,1008,19,1027,1461,0,3,1,3,0,1,0,76.14,70.29 ,33.33
03,007,01,019,0435,577,808,18,826,1191,0,3,1,3,0,1,0,76.14,69.35 ,33.33
03,007,01,019,0436,578,602,4,606,820,0,3,1,3,0,1,0,76.14,73.90 ,33.33
03,007,01,019,0437,579,476,11,487,701,0,3,1,3,0,1,0,76.14,69.47 ,33.33
03,007,01,019,0438,580,581,6,587,802,0,3,1,3,0,1,0,76.14,73.19 ,33.33
03,007,01,019,0439,581,923,5,928,1317,0,3,1,3,0,1,0,76.14,70.46 ,33.33
03,007,01,019,0440,582,958,12,970,1315,0,3,1,3,0,1,0,76.14,73.76 ,33.33
03,007,01,019,0441,583,970,21,991,1392,0,3,1,3,0,1,0,76.14,71.19 ,33.33
03,007,01,019,0442,584,1196,30,1226,1722,0,3,1,3,0,1,0,76.14,71.20 ,33.33
03,007,01,019,0443,585,737,11,748,1007,0,3,1,3,0,1,0,76.14,74.28 ,33.33
03,007,01,019,0444,586,1076,28,1104,1520,0,3,1,3,0,1,0,76.14,72.63 ,33.33
03,007,01,019,0445,587,783,18,801,1217,0,3,1,3,0,1,0,76.14,65.82 ,33.33
03,007,01,020,0446,588,465,11,476,687,0,3,1,3,0,1,0,76.14,69.29 ,33.33
03,007,01,020,0446,589,627,41,668,1035,0,3,1,3,0,1,0,76.14,64.54 ,33.33
03,007,01,020,0447,590,414,9,423,626,0,3,1,3,0,1,0,76.14,67.57 ,33.33
03,007,01,020,0448,591,656,10,666,955,0,3,1,3,0,1,0,76.14,69.74 ,33.33
03,007,01,020,0449,592,567,3,570,747,0,3,1,3,0,1,0,76.14,76.31 ,33.33
03,007,01,020,0449,593,576,10,586,850,0,3,1,3,0,1,0,76.14,68.94 ,33.33
03,007,01,020,0450,594,840,14,854,1151,0,3,1,3,0,1,0,76.14,74.20 ,33.33
03,007,01,020,0451,595,556,8,564,815,0,3,1,3,0,1,0,76.14,69.20 ,33.33
03,007,01,020,0451,596,589,10,599,880,0,3,1,3,0,1,0,76.14,68.07 ,33.33
03,007,01,020,0452,597,833,8,841,1159,0,3,1,3,0,1,0,76.14,72.56 ,33.33
03,007,01,020,0453,598,891,8,899,1336,0,3,1,3,0,1,0,76.14,67.29 ,33.33
03,007,01,020,0454,599,691,14,705,1045,0,3,1,3,0,1,0,76.14,67.46 ,33.33
03,007,01,020,0454,600,569,12,581,887,0,3,1,3,0,1,0,76.14,65.50 ,33.33
03,007,01,020,0455,601,536,8,544,878,0,3,1,3,0,1,0,76.14,61.96 ,33.33
03,007,01,020,0455,602,531,8,539,820,0,3,1,3,0,1,0,76.14,65.73 ,33.33
03,007,01,020,0456,603,658,14,672,936,0,3,1,3,0,1,0,76.14,71.79 ,33.33
03,007,01,020,0456,604,590,10,600,943,0,3,1,3,0,1,0,76.14,63.63 ,33.33
03,007,01,020,0457,605,546,14,560,787,0,3,1,3,0,1,0,76.14,71.16 ,33.33
03,007,01,020,0458,606,727,14,741,1037,0,3,1,3,0,1,0,76.14,71.46 ,33.33
03,007,01,020,0459,607,582,14,596,951,0,3,1,3,0,1,0,76.14,62.67 ,33.33
03,007,01,020,0460,608,459,7,466,726,0,3,1,3,0,1,0,76.14,64.19 ,33.33
03,007,01,020,0461,609,570,8,578,863,0,3,1,3,0,1,0,76.14,66.98 ,33.33
03,007,01,020,0462,610,776,21,797,1160,0,3,1,3,0,1,0,76.14,68.71 ,33.33
03,007,01,020,0463,611,618,17,635,871,0,3,1,3,0,1,0,76.14,72.90 ,33.33
03,007,01,020,0464,612,787,32,819,1150,0,3,1,3,0,1,0,76.14,71.22 ,33.33
03,007,01,021,0465,613,786,14,800,1160,0,3,1,3,0,1,0,76.14,68.97 ,33.33
03,007,01,021,0466,614,414,3,417,582,0,3,1,3,0,1,0,76.14,71.65 ,33.33
03,007,01,021,0467,615,1168,22,1190,1557,0,3,1,3,0,1,0,76.14,76.43 ,33.33
03,007,01,021,0468,616,754,14,768,1026,0,3,1,3,0,1,0,76.14,74.85 ,33.33
03,007,01,021,0469,617,816,17,833,1089,0,3,1,3,0,1,0,76.14,76.49 ,33.33
03,007,01,021,0470,618,684,14,698,965,0,3,1,3,0,1,0,76.14,72.33 ,33.33
03,007,01,021,0471,619,786,9,795,1045,0,3,1,3,0,1,0,76.14,76.08 ,33.33
03,007,01,021,0472,620,561,6,567,769,0,3,1,3,0,1,0,76.14,73.73 ,33.33
03,007,01,021,0473,621,441,11,452,618,0,3,1,3,0,1,0,76.14,73.14 ,33.33
03,007,01,021,0474,622,608,15,623,850,0,3,1,3,0,1,0,76.14,73.29 ,33.33
03,007,01,021,0475,623,708,6,714,937,0,3,1,3,0,1,0,76.14,76.20 ,33.33
03,007,01,021,0476,624,843,12,855,1121,0,3,1,3,0,1,0,76.14,76.27 ,33.33
03,007,01,021,0477,625,1148,27,1175,1626,0,3,1,3,0,1,0,76.14,72.26 ,33.33
03,007,01,021,0478,626,574,11,585,755,0,3,1,3,0,1,0,76.14,77.48 ,33.33
03,007,01,021,0479,627,601,7,608,824,0,3,1,3,0,1,0,76.14,73.79 ,33.33
03,007,01,021,0480,628,1020,13,1033,1468,0,3,1,3,0,1,0,76.14,70.37 ,33.33
03,007,01,021,0481,629,1050,17,1067,1438,0,3,1,3,0,1,0,76.14,74.20 ,33.33
03,007,01,021,0482,630,226,4,230,324,0,3,1,3,0,1,0,76.14,70.99 ,33.33
03,007,01,021,0483,631,453,4,457,627,0,3,1,3,0,1,0,76.14,72.89 ,33.33
03,007,01,021,0484,632,436,5,441,602,0,3,1,3,0,1,0,76.14,73.26 ,33.33
03,007,01,022,0485,633,692,19,711,970,0,3,1,3,0,1,0,76.14,73.30 ,33.33
03,007,01,022,0485,634,764,22,786,1180,0,3,1,3,0,1,0,76.14,66.61 ,33.33
03,007,01,022,0486,635,970,16,986,1389,0,3,1,3,0,1,0,76.14,70.99 ,33.33
03,007,01,022,0487,636,1044,22,1066,1484,0,3,1,3,0,1,0,76.14,71.83 ,33.33
03,007,01,022,0488,637,647,14,661,938,0,3,1,3,0,1,0,76.14,70.47 ,33.33
03,007,01,022,0488,638,744,11,755,1017,0,3,1,3,0,1,0,76.14,74.24 ,33.33
03,007,01,022,0489,639,727,14,741,1087,0,3,1,3,0,1,0,76.14,68.17 ,33.33
03,007,01,022,0490,640,1006,32,1038,1442,0,3,1,3,0,1,0,76.14,71.98 ,33.33
03,007,01,022,0491,641,979,18,997,1321,0,3,1,3,0,1,0,76.14,75.47 ,33.33
03,007,01,022,0491,642,936,11,947,1339,0,3,1,3,0,1,0,76.14,70.72 ,33.33
03,007,01,022,0492,643,1088,22,1110,1514,0,3,1,3,0,1,0,76.14,73.32 ,33.33
03,007,01,022,0493,644,443,2,445,665,0,3,1,3,0,1,0,76.14,66.92 ,33.33
03,007,01,022,0494,645,411,6,417,606,0,3,1,3,0,1,0,76.14,68.81 ,33.33
03,007,01,022,0495,646,1052,25,1077,1566,0,3,1,3,0,1,0,76.14,68.77 ,33.33
03,007,01,022,0496,647,808,17,825,1222,0,3,1,3,0,1,0,76.14,67.51 ,33.33
03,007,01,022,0497,648,555,7,562,818,0,3,1,3,0,1,0,76.14,68.70 ,33.33
03,007,01,022,0498,649,507,17,524,751,0,3,1,3,0,1,0,76.14,69.77 ,33.33
03,007,01,022,0499,650,817,14,831,1211,0,3,1,3,0,1,0,76.14,68.62 ,33.33
03,007,01,022,0500,651,596,12,608,930,0,3,1,3,0,1,0,76.14,65.38 ,33.33
03,007,01,022,0501,652,650,12,662,976,0,3,1,3,0,1,0,76.14,67.83 ,33.33
03,007,01,023,0502,653,644,4,648,851,0,3,1,3,0,1,0,76.14,76.15 ,33.33
03,007,01,023,0502,654,870,11,881,1254,0,3,1,3,0,1,0,76.14,70.26 ,33.33
03,007,01,023,0503,655,846,15,861,1165,0,3,1,3,0,1,0,76.14,73.91 ,33.33
03,007,01,023,0503,656,946,13,959,1345,0,3,1,3,0,1,0,76.14,71.30 ,33.33
03,007,01,023,0504,657,987,11,998,1411,0,3,1,3,0,1,0,76.14,70.73 ,33.33
03,007,01,023,0505,658,658,11,669,898,0,3,1,3,0,1,0,76.14,74.50 ,33.33
03,007,01,023,0505,659,803,17,820,1192,0,3,1,3,0,1,0,76.14,68.79 ,33.33
03,007,01,023,0506,660,1089,20,1109,1556,0,3,1,3,0,1,0,76.14,71.27 ,33.33
03,007,01,023,0507,661,976,13,989,1482,0,3,1,3,0,1,0,76.14,66.73 ,33.33
03,007,01,023,0508,662,770,13,783,1195,0,3,1,3,0,1,0,76.14,65.52 ,33.33
03,007,01,023,0509,663,812,3,815,1097,0,3,1,3,0,1,0,76.14,74.29 ,33.33
03,007,01,023,0510,664,645,13,658,1040,0,3,1,3,0,1,0,76.14,63.27 ,33.33
03,007,01,023,0511,665,766,8,774,1123,0,3,1,3,0,1,0,76.14,68.92 ,33.33
03,007,01,023,0512,666,1265,19,1284,1954,0,3,1,3,0,1,0,76.14,65.71 ,33.33
03,007,01,023,0513,667,473,9,482,708,0,3,1,3,0,1,0,76.14,68.08 ,33.33
03,007,01,023,0513,668,870,10,880,1340,0,3,1,3,0,1,0,76.14,65.67 ,33.33
03,007,01,023,0514,669,853,13,866,1249,0,3,1,3,0,1,0,76.14,69.34 ,33.33
03,007,01,023,0515,670,1124,32,1156,1613,0,3,1,3,0,1,0,76.14,71.67 ,33.33
03,007,01,023,0516,671,908,11,919,1204,0,3,1,3,0,1,0,76.14,76.33 ,33.33
03,007,01,023,0517,672,569,8,577,758,0,3,1,3,0,1,0,76.14,76.12 ,33.33
03,007,01,023,0518,673,999,14,1013,1366,0,3,1,3,0,1,0,76.14,74.16 ,33.33
03,007,01,023,0519,674,793,13,806,1085,0,3,1,3,0,1,0,76.14,74.29 ,33.33
03,007,01,023,0520,675,801,16,817,1018,0,3,1,3,0,1,0,76.14,80.26 ,33.33
03,007,01,023,0521,676,808,20,828,1078,0,3,1,3,0,1,0,76.14,76.81 ,33.33
03,007,01,023,0521,677,764,14,778,997,0,3,1,3,0,1,0,76.14,78.03 ,33.33
03,007,01,023,0521,678,927,16,943,1201,0,3,1,3,0,1,0,76.14,78.52 ,33.33
03,007,01,023,0522,679,918,8,926,1303,0,3,1,3,0,1,0,76.14,71.07 ,33.33
03,007,01,023,0523,680,721,16,737,999,0,3,1,3,0,1,0,76.14,73.77 ,33.33
03,007,01,023,0524,681,608,6,614,869,0,3,1,3,0,1,0,76.14,70.66 ,33.33
03,007,01,023,0525,682,835,11,846,1174,0,3,1,3,0,1,0,76.14,72.06 ,33.33
03,007,01,023,0526,683,709,9,718,1013,0,3,1,3,0,1,0,76.14,70.88 ,33.33
03,007,01,023,0527,684,732,6,738,974,0,3,1,3,0,1,0,76.14,75.77 ,33.33
03,007,01,023,0528,685,540,8,548,764,0,3,1,3,0,1,0,76.14,71.73 ,33.33
03,007,01,024,0529,686,664,15,679,1113,0,3,1,3,0,1,0,76.14,61.01 ,33.33
03,007,01,024,0530,687,341,5,346,605,0,3,1,3,0,1,0,76.14,57.19 ,33.33
03,007,01,024,0531,688,604,8,612,968,0,3,1,3,0,1,0,76.14,63.22 ,33.33
03,007,01,024,0532,689,364,5,369,716,0,3,1,3,0,1,0,76.14,51.54 ,33.33
03,007,01,024,0533,690,568,8,576,881,0,3,1,3,0,1,0,76.14,65.38 ,33.33
03,007,01,024,0534,691,1119,25,1144,1595,0,3,1,3,0,1,0,76.14,71.72 ,33.33
03,007,01,024,0535,692,883,3,886,1458,0,3,1,3,0,1,0,76.14,60.77 ,33.33
03,007,01,024,0536,693,681,16,697,1143,0,3,1,3,0,1,0,76.14,60.98 ,33.33
03,007,01,024,0537,694,455,6,461,796,0,3,1,3,0,1,0,76.14,57.91 ,33.33
03,007,01,024,0538,695,535,8,543,787,0,3,1,3,0,1,0,76.14,69.00 ,33.33
03,007,01,024,0539,696,680,11,691,1008,0,3,1,3,0,1,0,76.14,68.55 ,33.33
03,007,01,024,0540,697,443,5,448,736,0,3,1,3,0,1,0,76.14,60.87 ,33.33
03,007,01,024,0541,698,434,7,441,701,0,3,1,3,0,1,0,76.14,62.91 ,33.33
03,007,01,024,0542,699,555,6,561,824,0,3,1,3,0,1,0,76.14,68.08 ,33.33
03,007,01,024,0543,700,486,2,488,832,0,3,1,3,0,1,0,76.14,58.65 ,33.33
03,007,01,024,0544,701,728,20,748,1330,0,3,1,3,0,1,0,76.14,56.24 ,33.33
03,007,01,024,0545,702,471,6,477,766,0,3,1,3,0,1,0,76.14,62.27 ,33.33
03,007,01,024,0546,703,873,8,881,1327,0,3,1,3,0,1,0,76.14,66.39 ,33.33
03,007,01,024,0547,704,329,8,337,638,0,3,1,3,0,1,0,76.14,52.82 ,33.33
03,007,01,024,0548,705,855,13,868,1304,0,3,1,3,0,1,0,76.14,66.56 ,33.33
03,007,01,024,0549,706,679,12,691,955,0,3,1,3,0,1,0,76.14,72.36 ,33.33
03,007,01,024,0549,707,681,9,690,971,0,3,1,3,0,1,0,76.14,71.06 ,33.33
03,007,01,024,0550,708,524,7,531,727,0,3,1,3,0,1,0,76.14,73.04 ,33.33
03,007,01,024,0551,709,672,10,682,980,0,3,1,3,0,1,0,76.14,69.59 ,33.33
03,007,01,024,0552,710,820,17,837,1310,0,3,1,3,0,1,0,76.14,63.89 ,33.33
03,007,01,024,0553,711,893,17,910,1345,0,3,1,3,0,1,0,76.14,67.66 ,33.33
03,007,01,024,0553,712,738,14,752,1179,0,3,1,3,0,1,0,76.14,63.78 ,33.33
03,007,01,024,0554,713,633,16,649,1059,0,3,1,3,0,1,0,76.14,61.28 ,33.33
03,007,01,024,0554,714,553,10,563,923,0,3,1,3,0,1,0,76.14,61.00 ,33.33
03,007,01,025,0555,715,882,24,906,1454,0,3,1,3,0,1,0,76.14,62.31 ,33.33
03,007,01,025,0556,716,804,22,826,1414,0,3,1,3,0,1,0,76.14,58.42 ,33.33
03,007,01,025,0557,717,515,8,523,851,0,3,1,3,0,1,0,76.14,61.46 ,33.33
03,007,01,025,0558,718,833,12,845,1244,0,3,1,3,0,1,0,76.14,67.93 ,33.33
03,007,01,025,0559,719,717,13,730,1052,0,3,1,3,0,1,0,76.14,69.39 ,33.33
03,007,01,025,0560,720,392,6,398,638,0,3,1,3,0,1,0,76.14,62.38 ,33.33
03,007,01,025,0560,721,350,4,354,513,0,3,1,3,0,1,0,76.14,69.01 ,33.33
03,007,01,025,0561,722,456,12,468,784,0,3,1,3,0,1,0,76.14,59.69 ,33.33
03,007,01,025,0562,723,291,2,293,474,0,3,1,3,0,1,0,76.14,61.81 ,33.33
03,007,01,025,0562,724,465,10,475,753,0,3,1,3,0,1,0,76.14,63.08 ,33.33
03,007,01,025,0563,725,525,4,529,860,0,3,1,3,0,1,0,76.14,61.51 ,33.33
03,007,01,025,0564,726,411,5,416,763,0,3,1,3,0,1,0,76.14,54.52 ,33.33
03,007,01,025,0565,727,739,17,756,1185,0,3,1,3,0,1,0,76.14,63.80 ,33.33
03,007,01,025,0566,728,732,12,744,1301,0,3,1,3,0,1,0,76.14,57.19 ,33.33
03,007,01,025,0567,729,629,8,637,1081,0,3,1,3,0,1,0,76.14,58.93 ,33.33
03,007,01,025,0568,730,477,4,481,859,0,3,1,3,0,1,0,76.14,56.00 ,33.33
03,007,01,025,0569,731,591,10,601,1040,0,3,1,3,0,1,0,76.14,57.79 ,33.33
03,007,01,026,0570,732,638,6,644,999,0,3,1,3,0,1,0,76.14,64.46 ,33.33
03,007,01,026,0571,733,1136,14,1150,1527,0,3,1,3,0,1,0,76.14,75.31 ,33.33
03,007,01,026,0572,734,562,4,566,836,0,3,1,3,0,1,0,76.14,67.70 ,33.33
03,007,01,026,0573,735,564,7,571,816,0,3,1,3,0,1,0,76.14,69.98 ,33.33
03,007,01,026,0574,736,953,18,971,1426,0,3,1,3,0,1,0,76.14,68.09 ,33.33
03,007,01,026,0575,737,410,7,417,631,0,3,1,3,0,1,0,76.14,66.09 ,33.33
03,007,01,026,0576,738,623,7,630,930,0,3,1,3,0,1,0,76.14,67.74 ,33.33
03,007,01,026,0577,739,854,10,864,1214,0,3,1,3,0,1,0,76.14,71.17 ,33.33
03,007,01,026,0578,740,426,5,431,583,0,3,1,3,0,1,0,76.14,73.93 ,33.33
03,007,01,026,0579,741,611,13,624,894,0,3,1,3,0,1,0,76.14,69.80 ,33.33
03,007,01,026,0580,742,517,9,526,754,0,3,1,3,0,1,0,76.14,69.76 ,33.33
03,007,01,026,0581,743,462,1,463,661,0,3,1,3,0,1,0,76.14,70.05 ,33.33
03,007,01,026,0582,744,531,5,536,787,0,3,1,3,0,1,0,76.14,68.11 ,33.33
03,007,01,026,0583,745,486,4,490,739,0,3,1,3,0,1,0,76.14,66.31 ,33.33
03,008,01,001,0001,1,648,4,652,986,0,3,1,3,0,1,0,76.14,66.13 ,33.33
03,008,01,001,0002,2,829,9,838,1297,0,3,1,3,0,1,0,76.14,64.61 ,33.33
03,008,01,001,0003,3,494,7,501,769,0,3,1,3,0,1,0,76.14,65.15 ,33.33
03,008,01,001,0004,4,417,2,419,578,0,3,1,3,0,1,0,76.14,72.49 ,33.33
03,008,01,001,0005,5,501,10,511,739,0,3,1,3,0,1,0,76.14,69.15 ,33.33
03,008,01,001,0006,6,277,6,283,439,0,3,1,3,0,1,0,76.14,64.46 ,33.33
03,008,01,001,0007,7,697,8,705,1069,0,3,1,3,0,1,0,76.14,65.95 ,33.33
03,008,01,001,0008,8,670,10,680,1143,0,3,1,3,0,1,0,76.14,59.49 ,33.33
03,008,01,001,0008,9,532,7,539,872,0,3,1,3,0,1,0,76.14,61.81 ,33.33
03,008,01,001,0008,10,996,15,1011,1581,0,3,1,3,0,1,0,76.14,63.95 ,33.33
03,008,01,001,0009,11,771,8,779,1279,0,3,1,3,0,1,0,76.14,60.91 ,33.33
03,008,01,001,0009,12,972,13,985,1478,0,3,1,3,0,1,0,76.14,66.64 ,33.33
03,008,01,001,0010,13,928,27,955,1527,0,3,1,3,0,1,0,76.14,62.54 ,33.33
03,008,01,001,0011,14,927,9,936,1418,0,3,1,3,0,1,0,76.14,66.01 ,33.33
03,008,01,001,0011,15,550,11,561,841,0,3,1,3,0,1,0,76.14,66.71 ,33.33
03,008,01,001,0012,16,1053,11,1064,1657,0,3,1,3,0,1,0,76.14,64.21 ,33.33
03,008,01,001,0012,17,1071,10,1081,1615,0,3,1,3,0,1,0,76.14,66.93 ,33.33
03,008,01,001,0012,18,954,6,960,1471,0,3,1,3,0,1,0,76.14,65.26 ,33.33
03,008,01,001,0013,19,330,10,340,534,0,3,1,3,0,1,0,76.14,63.67 ,33.33
03,008,01,001,0013,20,926,10,936,1432,0,3,1,3,0,1,0,76.14,65.36 ,33.33
03,008,01,001,0014,21,521,4,525,815,0,3,1,3,0,1,0,76.14,64.42 ,33.33
03,008,01,001,0015,22,1073,8,1081,1558,0,3,1,3,0,1,0,76.14,69.38 ,33.33
03,008,01,001,0015,23,896,18,914,1464,0,3,1,3,0,1,0,76.14,62.43 ,33.33
03,008,01,001,0015,24,259,3,262,312,0,3,1,3,0,1,0,76.14,83.97 ,33.33
03,008,01,001,0016,25,286,7,293,467,0,3,1,3,0,1,0,76.14,62.74 ,33.33
03,008,01,001,0017,26,642,12,654,995,0,3,1,3,0,1,0,76.14,65.73 ,33.33
03,008,01,001,0017,27,595,4,599,824,0,3,1,3,0,1,0,76.14,72.69 ,33.33
03,008,01,001,0018,28,1043,6,1049,1467,0,3,1,3,0,1,0,76.14,71.51 ,33.33
03,008,01,001,0018,29,945,6,951,1343,0,3,1,3,0,1,0,76.14,70.81 ,33.33
03,008,01,001,0018,30,916,14,930,1318,0,3,1,3,0,1,0,76.14,70.56 ,33.33
03,008,01,001,0019,31,1161,11,1172,1756,0,3,1,3,0,1,0,76.14,66.74 ,33.33
03,008,01,001,0019,32,1030,12,1042,1584,0,3,1,3,0,1,0,76.14,65.78 ,33.33
03,008,01,001,0019,33,343,7,350,481,0,3,1,3,0,1,0,76.14,72.77 ,33.33
03,008,01,001,0020,34,893,8,901,1250,0,3,1,3,0,1,0,76.14,72.08 ,33.33
03,008,01,001,0021,35,448,5,453,618,0,3,1,3,0,1,0,76.14,73.30 ,33.33
03,008,01,001,0022,36,602,16,618,894,0,3,1,3,0,1,0,76.14,69.13 ,33.33
03,008,01,001,0022,37,805,4,809,1185,0,3,1,3,0,1,0,76.14,68.27 ,33.33
03,008,01,001,0023,38,817,6,823,1123,0,3,1,3,0,1,0,76.14,73.29 ,33.33
03,008,01,001,0023,39,847,12,859,1192,0,3,1,3,0,1,0,76.14,72.06 ,33.33
03,008,01,001,0024,40,569,8,577,814,0,3,1,3,0,1,0,76.14,70.88 ,33.33
03,008,01,001,0024,41,704,8,712,924,0,3,1,3,0,1,0,76.14,77.06 ,33.33
03,008,01,001,0025,42,612,7,619,935,0,3,1,3,0,1,0,76.14,66.20 ,33.33
03,008,01,001,0025,43,737,6,743,1100,0,3,1,3,0,1,0,76.14,67.55 ,33.33
03,008,01,001,0026,44,668,10,678,1031,0,3,1,3,0,1,0,76.14,65.76 ,33.33
03,008,01,001,0026,45,710,7,717,1183,0,3,1,3,0,1,0,76.14,60.61 ,33.33
03,008,01,001,0026,46,830,9,839,1248,0,3,1,3,0,1,0,76.14,67.23 ,33.33
03,008,01,001,0026,47,939,15,954,1575,0,3,1,3,0,1,0,76.14,60.57 ,33.33
03,008,01,001,0027,48,836,12,848,1470,0,3,1,3,0,1,0,76.14,57.69 ,33.33
03,008,01,001,0027,49,1082,12,1094,1775,0,3,1,3,0,1,0,76.14,61.63 ,33.33
03,008,01,001,0028,50,621,8,629,952,0,3,1,3,0,1,0,76.14,66.07 ,33.33
03,008,01,001,0028,51,1018,13,1031,1578,0,3,1,3,0,1,0,76.14,65.34 ,33.33
03,008,01,001,0029,52,671,10,681,1116,0,3,1,3,0,1,0,76.14,61.02 ,33.33
03,008,01,001,0029,53,504,25,529,886,0,3,1,3,0,1,0,76.14,59.71 ,33.33
03,008,01,001,0030,54,649,18,667,1066,0,3,1,3,0,1,0,76.14,62.57 ,33.33
03,008,01,001,0030,55,743,6,749,1270,0,3,1,3,0,1,0,76.14,58.98 ,33.33
03,008,01,001,0031,56,716,11,727,1244,0,3,1,3,0,1,0,76.14,58.44 ,33.33
03,008,01,001,0032,57,491,7,498,736,0,3,1,3,0,1,0,76.14,67.66 ,33.33
03,008,01,001,0033,58,507,10,517,787,0,3,1,3,0,1,0,76.14,65.69 ,33.33
03,008,01,001,0034,59,998,16,1014,1511,0,3,1,3,0,1,0,76.14,67.11 ,33.33
03,008,01,002,0035,60,614,5,619,979,0,3,1,3,0,1,0,76.14,63.23 ,33.33
03,008,01,002,0035,61,730,4,734,1123,0,3,1,3,0,1,0,76.14,65.36 ,33.33
03,008,01,002,0035,62,613,12,625,966,0,3,1,3,0,1,0,76.14,64.70 ,33.33
03,008,01,002,0036,63,425,1,426,706,0,3,1,3,0,1,0,76.14,60.34 ,33.33
03,008,01,002,0036,64,682,10,692,1145,0,3,1,3,0,1,0,76.14,60.44 ,33.33
03,008,01,002,0036,65,818,2,820,1331,0,3,1,3,0,1,0,76.14,61.61 ,33.33
03,008,01,002,0037,66,668,1,669,983,0,3,1,3,0,1,0,76.14,68.06 ,33.33
03,008,01,002,0038,67,678,6,684,1067,0,3,1,3,0,1,0,76.14,64.10 ,33.33
03,008,01,002,0038,68,811,5,816,1344,0,3,1,3,0,1,0,76.14,60.71 ,33.33
03,008,01,002,0039,69,956,4,960,1474,0,3,1,3,0,1,0,76.14,65.13 ,33.33
03,008,01,002,0039,70,921,7,928,1412,0,3,1,3,0,1,0,76.14,65.72 ,33.33
03,008,01,002,0040,71,995,8,1003,1632,0,3,1,3,0,1,0,76.14,61.46 ,33.33
03,008,01,002,0041,72,552,3,555,836,0,3,1,3,0,1,0,76.14,66.39 ,33.33
03,008,01,002,0041,73,556,5,561,891,0,3,1,3,0,1,0,76.14,62.96 ,33.33
03,008,01,002,0042,74,712,19,731,1091,0,3,1,3,0,1,0,76.14,67.00 ,33.33
03,008,01,002,0042,75,676,15,691,1068,0,3,1,3,0,1,0,76.14,64.70 ,33.33
03,008,01,002,0043,76,662,6,668,1102,0,3,1,3,0,1,0,76.14,60.62 ,33.33
03,008,01,002,0043,77,653,10,663,1010,0,3,1,3,0,1,0,76.14,65.64 ,33.33
03,008,01,002,0043,78,810,8,818,1366,0,3,1,3,0,1,0,76.14,59.88 ,33.33
03,008,01,002,0044,79,933,13,946,1378,0,3,1,3,0,1,0,76.14,68.65 ,33.33
03,008,01,002,0045,80,803,9,812,1309,0,3,1,3,0,1,0,76.14,62.03 ,33.33
03,008,01,002,0045,81,773,14,787,1179,0,3,1,3,0,1,0,76.14,66.75 ,33.33
03,008,01,002,0045,82,746,8,754,1184,0,3,1,3,0,1,0,76.14,63.68 ,33.33
03,008,01,002,0045,83,823,10,833,1362,0,3,1,3,0,1,0,76.14,61.16 ,33.33
03,008,01,002,0046,84,534,1,535,746,0,3,1,3,0,1,0,76.14,71.72 ,33.33
03,008,01,002,0047,85,740,11,751,1016,0,3,1,3,0,1,0,76.14,73.92 ,33.33
03,008,01,002,0047,86,755,6,761,1038,0,3,1,3,0,1,0,76.14,73.31 ,33.33
03,008,01,002,0048,87,749,9,758,1190,0,3,1,3,0,1,0,76.14,63.70 ,33.33
03,008,01,002,0048,88,504,4,508,834,0,3,1,3,0,1,0,76.14,60.91 ,33.33
03,008,01,002,0048,89,825,11,836,1327,0,3,1,3,0,1,0,76.14,63.00 ,33.33
03,008,01,002,0048,90,801,7,808,1295,0,3,1,3,0,1,0,76.14,62.39 ,33.33
03,008,01,002,0049,91,900,16,916,1493,0,3,1,3,0,1,0,76.14,61.35 ,33.33
03,008,01,002,0049,92,632,5,637,1039,0,3,1,3,0,1,0,76.14,61.31 ,33.33
03,008,01,002,0050,93,593,8,601,916,0,3,1,3,0,1,0,76.14,65.61 ,33.33
03,008,01,002,0051,94,619,8,627,910,0,3,1,3,0,1,0,76.14,68.90 ,33.33
03,008,01,002,0052,95,454,6,460,707,0,3,1,3,0,1,0,76.14,65.06 ,33.33
03,008,01,002,0053,96,540,5,545,945,0,3,1,3,0,1,0,76.14,57.67 ,33.33
03,008,01,002,0054,97,202,1,203,371,0,3,1,3,0,1,0,76.14,54.72 ,33.33
03,008,01,002,0055,98,748,7,755,1197,0,3,1,3,0,1,0,76.14,63.07 ,33.33
03,008,01,002,0056,99,788,5,793,1200,0,3,1,3,0,1,0,76.14,66.08 ,33.33
03,008,01,002,0057,100,951,11,962,1469,0,3,1,3,0,1,0,76.14,65.49 ,33.33
03,008,01,002,0058,101,547,3,550,840,0,3,1,3,0,1,0,76.14,65.48 ,33.33
03,008,01,002,0058,102,197,2,199,319,0,3,1,3,0,1,0,76.14,62.38 ,33.33
03,008,01,002,0059,103,465,1,466,683,0,3,1,3,0,1,0,76.14,68.23 ,33.33
03,008,01,002,0060,104,487,4,491,805,0,3,1,3,0,1,0,76.14,60.99 ,33.33
03,008,01,002,0061,105,778,7,785,1229,0,3,1,3,0,1,0,76.14,63.87 ,33.33
03,008,01,002,0061,106,154,1,155,266,0,3,1,3,0,1,0,76.14,58.27 ,33.33
03,008,01,002,0062,107,667,7,674,1125,0,3,1,3,0,1,0,76.14,59.91 ,33.33
03,008,01,002,0063,108,402,0,402,640,0,3,1,3,0,1,0,76.14,62.81 ,33.33
03,008,01,002,0064,109,599,4,603,941,0,3,1,3,0,1,0,76.14,64.08 ,33.33
03,008,01,002,0065,110,696,3,699,1031,0,3,1,3,0,1,0,76.14,67.80 ,33.33
03,008,01,002,0065,111,880,10,890,1331,0,3,1,3,0,1,0,76.14,66.87 ,33.33
03,008,01,002,0066,112,678,10,688,1069,0,3,1,3,0,1,0,76.14,64.36 ,33.33
03,008,01,002,0067,113,598,8,606,920,0,3,1,3,0,1,0,76.14,65.87 ,33.33
03,008,01,002,0067,114,561,11,572,887,0,3,1,3,0,1,0,76.14,64.49 ,33.33
03,008,01,002,0067,115,364,2,366,623,0,3,1,3,0,1,0,76.14,58.75 ,33.33
03,008,01,003,0068,116,1165,12,1177,1686,0,3,1,3,0,1,0,76.14,69.81 ,33.33
03,008,01,003,0069,117,671,8,679,989,0,3,1,3,0,1,0,76.14,68.66 ,33.33
03,008,01,003,0069,118,710,10,720,1065,0,3,1,3,0,1,0,76.14,67.61 ,33.33
03,008,01,003,0069,119,656,4,660,976,0,3,1,3,0,1,0,76.14,67.62 ,33.33
03,008,01,003,0070,120,698,6,704,956,0,3,1,3,0,1,0,76.14,73.64 ,33.33
03,008,01,003,0070,121,677,4,681,946,0,3,1,3,0,1,0,76.14,71.99 ,33.33
03,008,01,003,0071,122,524,4,528,728,0,3,1,3,0,1,0,76.14,72.53 ,33.33
03,008,01,003,0072,123,1065,11,1076,1470,0,3,1,3,0,1,0,76.14,73.20 ,33.33
03,008,01,003,0073,124,675,7,682,983,0,3,1,3,0,1,0,76.14,69.38 ,33.33
03,008,01,003,0073,125,919,10,929,1306,0,3,1,3,0,1,0,76.14,71.13 ,33.33
03,008,01,003,0074,126,854,9,863,1217,0,3,1,3,0,1,0,76.14,70.91 ,33.33
03,008,01,003,0074,127,800,14,814,1197,0,3,1,3,0,1,0,76.14,68.00 ,33.33
03,008,01,003,0074,128,739,6,745,1108,0,3,1,3,0,1,0,76.14,67.24 ,33.33
03,008,01,003,0074,129,652,4,656,977,0,3,1,3,0,1,0,76.14,67.14 ,33.33
03,008,01,003,0075,130,962,18,980,1501,0,3,1,3,0,1,0,76.14,65.29 ,33.33
03,008,01,003,0075,131,1147,9,1156,1723,0,3,1,3,0,1,0,76.14,67.09 ,33.33
03,008,01,003,0075,132,1073,11,1084,1515,0,3,1,3,0,1,0,76.14,71.55 ,33.33
03,008,01,003,0076,133,948,7,955,1323,0,3,1,3,0,1,0,76.14,72.18 ,33.33
03,008,01,003,0076,134,886,7,893,1298,0,3,1,3,0,1,0,76.14,68.80 ,33.33
03,008,01,003,0077,135,807,7,814,1128,0,3,1,3,0,1,0,76.14,72.16 ,33.33
03,008,01,003,0077,136,611,3,614,895,0,3,1,3,0,1,0,76.14,68.60 ,33.33
03,008,01,003,0078,137,952,13,965,1448,0,3,1,3,0,1,0,76.14,66.64 ,33.33
03,008,01,003,0078,138,871,10,881,1358,0,3,1,3,0,1,0,76.14,64.87 ,33.33
03,008,01,003,0079,139,623,7,630,866,0,3,1,3,0,1,0,76.14,72.75 ,33.33
03,008,01,003,0079,140,383,6,389,586,0,3,1,3,0,1,0,76.14,66.38 ,33.33
03,008,01,003,0080,141,873,10,883,1301,0,3,1,3,0,1,0,76.14,67.87 ,33.33
03,008,01,003,0080,142,857,10,867,1336,0,3,1,3,0,1,0,76.14,64.90 ,33.33
03,008,01,003,0081,143,958,7,965,1349,0,3,1,3,0,1,0,76.14,71.53 ,33.33
03,008,01,003,0081,144,596,12,608,980,0,3,1,3,0,1,0,76.14,62.04 ,33.33
03,008,01,003,0081,145,505,4,509,790,0,3,1,3,0,1,0,76.14,64.43 ,33.33
03,008,01,003,0081,146,688,6,694,1056,0,3,1,3,0,1,0,76.14,65.72 ,33.33
03,008,01,003,0082,147,1006,8,1014,1457,0,3,1,3,0,1,0,76.14,69.60 ,33.33
03,008,01,003,0082,148,1046,11,1057,1587,0,3,1,3,0,1,0,76.14,66.60 ,33.33
03,008,01,003,0083,149,781,21,802,1227,0,3,1,3,0,1,0,76.14,65.36 ,33.33
03,008,01,003,0083,150,820,18,838,1216,0,3,1,3,0,1,0,76.14,68.91 ,33.33
03,008,01,003,0084,151,1105,13,1118,1706,0,3,1,3,0,1,0,76.14,65.53 ,33.33
03,008,01,003,0085,152,748,12,760,1052,0,3,1,3,0,1,0,76.14,72.24 ,33.33
03,008,01,003,0086,153,863,15,878,1201,0,3,1,3,0,1,0,76.14,73.11 ,33.33
03,008,01,003,0086,154,500,13,513,809,0,3,1,3,0,1,0,76.14,63.41 ,33.33
03,008,01,003,0087,155,742,6,748,1103,0,3,1,3,0,1,0,76.14,67.82 ,33.33
03,008,01,003,0087,156,826,8,834,1317,0,3,1,3,0,1,0,76.14,63.33 ,33.33
03,008,01,003,0087,157,374,2,376,511,0,3,1,3,0,1,0,76.14,73.58 ,33.33
03,008,01,003,0087,158,444,6,450,671,0,3,1,3,0,1,0,76.14,67.06 ,33.33
03,008,01,003,0088,159,880,8,888,1269,0,3,1,3,0,1,0,76.14,69.98 ,33.33
03,008,01,003,0088,160,342,2,344,524,0,3,1,3,0,1,0,76.14,65.65 ,33.33
03,008,01,003,0089,161,647,4,651,909,0,3,1,3,0,1,0,76.14,71.62 ,33.33
03,008,01,003,0089,162,516,7,523,775,0,3,1,3,0,1,0,76.14,67.48 ,33.33
03,008,01,003,0090,163,1101,10,1111,1642,0,3,1,3,0,1,0,76.14,67.66 ,33.33
03,008,01,003,0090,164,730,8,738,1107,0,3,1,3,0,1,0,76.14,66.67 ,33.33
03,008,01,003,0091,165,674,7,681,976,0,3,1,3,0,1,0,76.14,69.77 ,33.33
03,008,01,003,0092,166,954,16,970,1523,0,3,1,3,0,1,0,76.14,63.69 ,33.33
03,008,01,003,0093,167,635,5,640,935,0,3,1,3,0,1,0,76.14,68.45 ,33.33
03,008,01,003,0094,168,649,8,657,1086,0,3,1,3,0,1,0,76.14,60.50 ,33.33
03,008,01,003,0094,169,737,15,752,1183,0,3,1,3,0,1,0,76.14,63.57 ,33.33
03,008,01,004,0095,170,760,9,769,1258,0,3,1,3,0,1,0,76.14,61.13 ,33.33
03,008,01,004,0095,171,654,5,659,1051,0,3,1,3,0,1,0,76.14,62.70 ,33.33
03,008,01,004,0096,172,452,5,457,777,0,3,1,3,0,1,0,76.14,58.82 ,33.33
03,008,01,004,0097,173,701,9,710,1134,0,3,1,3,0,1,0,76.14,62.61 ,33.33
03,008,01,004,0097,174,832,8,840,1505,0,3,1,3,0,1,0,76.14,55.81 ,33.33
03,008,01,004,0097,175,851,13,864,1573,0,3,1,3,0,1,0,76.14,54.93 ,33.33
03,008,01,004,0098,176,924,5,929,1521,0,3,1,3,0,1,0,76.14,61.08 ,33.33
03,008,01,004,0098,177,867,13,880,1592,0,3,1,3,0,1,0,76.14,55.28 ,33.33
03,008,01,004,0099,178,419,8,427,769,0,3,1,3,0,1,0,76.14,55.53 ,33.33
03,008,01,004,0099,179,641,14,655,1181,0,3,1,3,0,1,0,76.14,55.46 ,33.33
03,008,01,004,0100,180,889,5,894,1584,0,3,1,3,0,1,0,76.14,56.44 ,33.33
03,008,01,004,0100,181,895,11,906,1587,0,3,1,3,0,1,0,76.14,57.09 ,33.33
03,008,01,004,0101,182,279,3,282,503,0,3,1,3,0,1,0,76.14,56.06 ,33.33
03,008,01,004,0101,183,207,3,210,377,0,3,1,3,0,1,0,76.14,55.70 ,33.33
03,008,01,004,0102,184,606,2,608,947,0,3,1,3,0,1,0,76.14,64.20 ,33.33
03,008,01,004,0103,185,705,5,710,1170,0,3,1,3,0,1,0,76.14,60.68 ,33.33
03,008,01,004,0104,186,189,2,191,323,0,3,1,3,0,1,0,76.14,59.13 ,33.33
03,008,01,004,0104,187,159,0,159,264,0,3,1,3,0,1,0,76.14,60.23 ,33.33
03,008,01,004,0104,188,168,1,169,271,0,3,1,3,0,1,0,76.14,62.36 ,33.33
03,008,01,004,0105,189,104,0,104,174,0,3,1,3,0,1,0,76.14,59.77 ,33.33
03,008,01,004,0106,190,665,8,673,1246,0,3,1,3,0,1,0,76.14,54.01 ,33.33
03,008,01,004,0106,191,662,9,671,1237,0,3,1,3,0,1,0,76.14,54.24 ,33.33
03,008,01,004,0106,192,671,7,678,1122,0,3,1,3,0,1,0,76.14,60.43 ,33.33
03,008,01,004,0107,193,858,18,876,1480,0,3,1,3,0,1,0,76.14,59.19 ,33.33
03,008,01,004,0107,194,738,10,748,1286,0,3,1,3,0,1,0,76.14,58.16 ,33.33
03,008,01,004,0108,195,361,9,370,645,0,3,1,3,0,1,0,76.14,57.36 ,33.33
03,008,01,004,0108,196,556,7,563,951,0,3,1,3,0,1,0,76.14,59.20 ,33.33
03,008,01,004,0109,197,623,8,631,1092,0,3,1,3,0,1,0,76.14,57.78 ,33.33
03,008,01,004,0109,198,601,7,608,916,0,3,1,3,0,1,0,76.14,66.38 ,33.33
03,008,01,004,0109,199,369,4,373,575,0,3,1,3,0,1,0,76.14,64.87 ,33.33
03,008,01,004,0110,200,340,1,341,668,0,3,1,3,0,1,0,76.14,51.05 ,33.33
03,008,01,004,0111,201,660,6,666,1211,0,3,1,3,0,1,0,76.14,55.00 ,33.33
03,008,01,004,0111,202,379,2,381,712,0,3,1,3,0,1,0,76.14,53.51 ,33.33
03,008,01,004,0112,203,517,5,522,862,0,3,1,3,0,1,0,76.14,60.56 ,33.33
03,008,01,004,0113,204,864,6,870,1500,0,3,1,3,0,1,0,76.14,58.00 ,33.33
03,008,01,004,0114,205,420,8,428,749,0,3,1,3,0,1,0,76.14,57.14 ,33.33
03,008,01,004,0115,206,232,2,234,468,0,3,1,3,0,1,0,76.14,50.00 ,33.33
03,008,01,004,0115,207,134,2,136,219,0,3,1,3,0,1,0,76.14,62.10 ,33.33
03,008,01,004,0116,208,649,11,660,1140,0,3,1,3,0,1,0,76.14,57.89 ,33.33
03,008,01,004,0117,209,251,3,254,400,0,3,1,3,0,1,0,76.14,63.50 ,33.33
03,008,01,004,0117,210,311,3,314,490,0,3,1,3,0,1,0,76.14,64.08 ,33.33
03,008,01,004,0118,211,134,1,135,204,0,3,1,3,0,1,0,76.14,66.18 ,33.33
03,008,01,004,0118,212,224,6,230,380,0,3,1,3,0,1,0,76.14,60.53 ,33.33
03,008,01,004,0119,213,318,5,323,597,0,3,1,3,0,1,0,76.14,54.10 ,33.33
03,008,01,004,0119,214,214,4,218,395,0,3,1,3,0,1,0,76.14,55.19 ,33.33
03,008,01,004,0120,215,321,6,327,611,0,3,1,3,0,1,0,76.14,53.52 ,33.33
03,008,01,004,0121,216,451,6,457,821,0,3,1,3,0,1,0,76.14,55.66 ,33.33
03,008,01,004,0122,217,296,7,303,623,0,3,1,3,0,1,0,76.14,48.64 ,33.33
03,008,01,004,0122,218,233,5,238,454,0,3,1,3,0,1,0,76.14,52.42 ,33.33
03,008,01,005,0123,219,572,7,579,882,0,3,1,3,0,1,0,76.14,65.65 ,33.33
03,008,01,005,0124,220,545,13,558,1008,0,3,1,3,0,1,0,76.14,55.36 ,33.33
03,008,01,005,0125,221,397,5,402,597,0,3,1,3,0,1,0,76.14,67.34 ,33.33
03,008,01,005,0126,222,695,12,707,1162,0,3,1,3,0,1,0,76.14,60.84 ,33.33
03,008,01,005,0127,223,354,1,355,546,0,3,1,3,0,1,0,76.14,65.02 ,33.33
03,008,01,005,0128,224,285,5,290,454,0,3,1,3,0,1,0,76.14,63.88 ,33.33
03,008,01,005,0129,225,589,7,596,929,0,3,1,3,0,1,0,76.14,64.16 ,33.33
03,008,01,005,0130,226,760,9,769,1261,0,3,1,3,0,1,0,76.14,60.98 ,33.33
03,008,01,005,0131,227,538,10,548,818,0,3,1,3,0,1,0,76.14,66.99 ,33.33
03,008,01,005,0132,228,315,4,319,541,0,3,1,3,0,1,0,76.14,58.96 ,33.33
03,008,01,005,0132,229,238,3,241,405,0,3,1,3,0,1,0,76.14,59.51 ,33.33
03,008,01,005,0133,230,249,2,251,433,0,3,1,3,0,1,0,76.14,57.97 ,33.33
03,008,01,006,0134,231,579,4,583,992,0,3,1,3,0,1,0,76.14,58.77 ,33.33
03,008,01,006,0135,232,731,11,742,1160,0,3,1,3,0,1,0,76.14,63.97 ,33.33
03,008,01,006,0135,233,816,13,829,1430,0,3,1,3,0,1,0,76.14,57.97 ,33.33
03,008,01,006,0136,234,398,4,402,688,0,3,1,3,0,1,0,76.14,58.43 ,33.33
03,008,01,006,0136,235,695,11,706,1100,0,3,1,3,0,1,0,76.14,64.18 ,33.33
03,008,01,006,0137,236,956,10,966,1522,0,3,1,3,0,1,0,76.14,63.47 ,33.33
03,008,01,006,0138,237,635,8,643,999,0,3,1,3,0,1,0,76.14,64.36 ,33.33
03,008,01,006,0139,238,606,5,611,980,0,3,1,3,0,1,0,76.14,62.35 ,33.33
03,008,01,006,0140,239,849,9,858,1303,0,3,1,3,0,1,0,76.14,65.85 ,33.33
03,008,01,006,0140,240,993,18,1011,1699,0,3,1,3,0,1,0,76.14,59.51 ,33.33
03,008,01,006,0141,241,471,14,485,777,0,3,1,3,0,1,0,76.14,62.42 ,33.33
03,008,01,006,0141,242,481,6,487,788,0,3,1,3,0,1,0,76.14,61.80 ,33.33
03,008,01,006,0142,243,535,3,538,755,0,3,1,3,0,1,0,76.14,71.26 ,33.33
03,008,01,006,0143,244,702,11,713,1052,0,3,1,3,0,1,0,76.14,67.78 ,33.33
03,008,01,006,0144,245,654,6,660,1034,0,3,1,3,0,1,0,76.14,63.83 ,33.33
03,008,01,006,0145,246,536,5,541,841,0,3,1,3,0,1,0,76.14,64.33 ,33.33
03,008,01,006,0146,247,676,8,684,1107,0,3,1,3,0,1,0,76.14,61.79 ,33.33
03,008,01,006,0146,248,494,6,500,797,0,3,1,3,0,1,0,76.14,62.74 ,33.33
03,008,01,006,0147,249,453,6,459,781,0,3,1,3,0,1,0,76.14,58.77 ,33.33
03,008,01,006,0148,250,439,6,445,688,0,3,1,3,0,1,0,76.14,64.68 ,33.33
03,008,01,006,0148,251,303,5,308,556,0,3,1,3,0,1,0,76.14,55.40 ,33.33
03,008,01,006,0149,252,559,4,563,881,0,3,1,3,0,1,0,76.14,63.90 ,33.33
03,008,01,006,0150,253,575,10,585,954,0,3,1,3,0,1,0,76.14,61.32 ,33.33
03,008,01,006,0150,254,304,3,307,479,0,3,1,3,0,1,0,76.14,64.09 ,33.33
03,008,01,006,0151,255,692,8,700,1299,0,3,1,3,0,1,0,76.14,53.89 ,33.33
03,008,01,006,0151,256,585,6,591,999,0,3,1,3,0,1,0,76.14,59.16 ,33.33
03,008,01,006,0152,257,454,8,462,741,0,3,1,3,0,1,0,76.14,62.35 ,33.33
03,008,01,006,0153,258,484,2,486,832,0,3,1,3,0,1,0,76.14,58.41 ,33.33
03,008,01,006,0154,259,540,2,542,847,0,3,1,3,0,1,0,76.14,63.99 ,33.33
03,008,01,006,0155,260,428,2,430,718,0,3,1,3,0,1,0,76.14,59.89 ,33.33
03,008,01,006,0155,261,481,8,489,784,0,3,1,3,0,1,0,76.14,62.37 ,33.33
03,008,01,007,0156,262,811,7,818,1492,0,3,1,3,0,1,0,76.14,54.83 ,33.33
03,008,01,007,0157,263,917,7,924,1567,0,3,1,3,0,1,0,76.14,58.97 ,33.33
03,008,01,007,0158,264,456,4,460,693,0,3,1,3,0,1,0,76.14,66.38 ,33.33
03,008,01,007,0158,265,207,6,213,378,0,3,1,3,0,1,0,76.14,56.35 ,33.33
03,008,01,007,0159,266,482,8,490,801,0,3,1,3,0,1,0,76.14,61.17 ,33.33
03,008,01,007,0159,267,557,8,565,961,0,3,1,3,0,1,0,76.14,58.79 ,33.33
03,008,01,007,0160,268,295,5,300,636,0,3,1,3,0,1,0,76.14,47.17 ,33.33
03,008,01,007,0160,269,301,2,303,471,0,3,1,3,0,1,0,76.14,64.33 ,33.33
03,008,01,007,0161,270,372,2,374,687,0,3,1,3,0,1,0,76.14,54.44 ,33.33
03,008,01,007,0162,271,826,3,829,1580,0,3,1,3,0,1,0,76.14,52.47 ,33.33
03,008,01,007,0163,272,537,3,540,910,0,3,1,3,0,1,0,76.14,59.34 ,33.33
03,008,01,007,0164,273,63,0,63,110,0,3,1,3,0,1,0,76.14,57.27 ,33.33
03,008,01,007,0164,274,773,8,781,1173,0,3,1,3,0,1,0,76.14,66.58 ,33.33
03,008,01,007,0165,275,742,5,747,1202,0,3,1,3,0,1,0,76.14,62.15 ,33.33
03,008,01,007,0165,276,234,2,236,468,0,3,1,3,0,1,0,76.14,50.43 ,33.33
03,008,01,007,0166,277,385,5,390,727,0,3,1,3,0,1,0,76.14,53.65 ,33.33
03,008,01,007,0167,278,426,2,428,800,0,3,1,3,0,1,0,76.14,53.50 ,33.33
03,008,01,007,0168,279,469,5,474,837,0,3,1,3,0,1,0,76.14,56.63 ,33.33
03,008,01,008,0169,280,551,7,558,930,0,3,1,3,0,1,0,76.14,60.00 ,33.33
03,008,01,008,0170,281,231,3,234,324,0,3,1,3,0,1,0,76.14,72.22 ,33.33
03,008,01,008,0170,282,152,0,152,237,0,3,1,3,0,1,0,76.14,64.14 ,33.33
03,008,01,008,0171,283,236,3,239,399,0,3,1,3,0,1,0,76.14,59.90 ,33.33
03,008,01,008,0171,284,245,2,247,402,0,3,1,3,0,1,0,76.14,61.44 ,33.33
03,008,01,008,0172,285,271,3,274,494,0,3,1,3,0,1,0,76.14,55.47 ,33.33
03,008,01,008,0172,286,196,6,202,411,0,3,1,3,0,1,0,76.14,49.15 ,33.33
03,008,01,008,0173,287,424,2,426,746,0,3,1,3,0,1,0,76.14,57.10 ,33.33
03,008,01,008,0174,288,178,1,179,298,0,3,1,3,0,1,0,76.14,60.07 ,33.33
03,008,01,008,0175,289,637,11,648,1044,0,3,1,3,0,1,0,76.14,62.07 ,33.33
03,008,01,008,0175,290,524,9,533,836,0,3,1,3,0,1,0,76.14,63.76 ,33.33
03,008,01,008,0176,291,429,6,435,728,0,3,1,3,0,1,0,76.14,59.75 ,33.33
03,008,01,008,0177,292,344,4,348,574,0,3,1,3,0,1,0,76.14,60.63 ,33.33
03,008,01,008,0178,293,242,2,244,384,0,3,1,3,0,1,0,76.14,63.54 ,33.33
03,008,01,008,0178,294,376,4,380,600,0,3,1,3,0,1,0,76.14,63.33 ,33.33
03,008,01,008,0179,295,301,4,305,468,0,3,1,3,0,1,0,76.14,65.17 ,33.33
03,008,01,008,0179,296,389,9,398,652,0,3,1,3,0,1,0,76.14,61.04 ,33.33
03,008,01,008,0180,297,564,9,573,966,0,3,1,3,0,1,0,76.14,59.32 ,33.33
03,008,01,008,0181,298,333,4,337,498,0,3,1,3,0,1,0,76.14,67.67 ,33.33
03,008,01,008,0182,299,519,5,524,764,0,3,1,3,0,1,0,76.14,68.59 ,33.33
03,008,01,008,0183,300,375,13,388,609,0,3,1,3,0,1,0,76.14,63.71 ,33.33
03,008,01,008,0184,301,455,7,462,715,0,3,1,3,0,1,0,76.14,64.62 ,33.33
03,008,01,008,0185,302,267,2,269,424,0,3,1,3,0,1,0,76.14,63.44 ,33.33
03,008,01,008,0186,303,391,2,393,599,0,3,1,3,0,1,0,76.14,65.61 ,33.33
03,008,01,009,0187,304,1030,7,1037,1777,0,3,1,3,0,1,0,76.14,58.36 ,33.33
03,008,01,009,0188,305,834,8,842,1518,0,3,1,3,0,1,0,76.14,55.47 ,33.33
03,008,01,009,0189,306,281,3,284,509,0,3,1,3,0,1,0,76.14,55.80 ,33.33
03,008,01,009,0189,307,315,1,316,529,0,3,1,3,0,1,0,76.14,59.74 ,33.33
03,008,01,009,0190,308,654,11,665,1193,0,3,1,3,0,1,0,76.14,55.74 ,33.33
03,008,01,009,0191,309,147,1,148,247,0,3,1,3,0,1,0,76.14,59.92 ,33.33
03,008,01,009,0192,310,287,2,289,539,0,3,1,3,0,1,0,76.14,53.62 ,33.33
03,008,01,009,0193,311,126,1,127,217,0,3,1,3,0,1,0,76.14,58.53 ,33.33
03,008,01,009,0194,312,418,2,420,683,0,3,1,3,0,1,0,76.14,61.49 ,33.33
03,008,01,009,0194,313,160,3,163,281,0,3,1,3,0,1,0,76.14,58.01 ,33.33
03,008,01,009,0194,314,142,0,142,266,0,3,1,3,0,1,0,76.14,53.38 ,33.33
03,008,01,009,0195,315,163,1,164,263,0,3,1,3,0,1,0,76.14,62.36 ,33.33
03,008,01,009,0195,316,235,0,235,359,0,3,1,3,0,1,0,76.14,65.46 ,33.33
03,008,01,009,0196,317,342,3,345,573,0,3,1,3,0,1,0,76.14,60.21 ,33.33
03,008,01,009,0196,318,91,0,91,171,0,3,1,3,0,1,0,76.14,53.22 ,33.33
03,008,01,009,0197,319,367,2,369,621,0,3,1,3,0,1,0,76.14,59.42 ,33.33
03,008,01,009,0197,320,195,2,197,354,0,3,1,3,0,1,0,76.14,55.65 ,33.33
03,008,01,009,0198,321,457,4,461,756,0,3,1,3,0,1,0,76.14,60.98 ,33.33
03,008,01,009,0199,322,323,2,325,539,0,3,1,3,0,1,0,76.14,60.30 ,33.33
03,008,01,009,0200,323,239,3,242,462,0,3,1,3,0,1,0,76.14,52.38 ,33.33
03,008,01,009,0200,324,269,3,272,603,0,3,1,3,0,1,0,76.14,45.11 ,33.33
03,008,01,009,0201,325,239,6,245,483,0,3,1,3,0,1,0,76.14,50.72 ,33.33
03,008,01,009,0201,326,199,3,202,336,0,3,1,3,0,1,0,76.14,60.12 ,33.33
03,008,01,010,0202,327,1062,8,1070,1735,0,3,1,3,0,1,0,76.14,61.67 ,33.33
03,008,01,010,0203,328,952,18,970,1546,0,3,1,3,0,1,0,76.14,62.74 ,33.33
03,008,01,010,0204,329,511,5,516,821,0,3,1,3,0,1,0,76.14,62.85 ,33.33
03,008,01,010,0205,330,918,13,931,1626,0,3,1,3,0,1,0,76.14,57.26 ,33.33
03,008,01,010,0206,331,476,5,481,783,0,3,1,3,0,1,0,76.14,61.43 ,33.33
03,008,01,010,0207,332,526,11,537,957,0,3,1,3,0,1,0,76.14,56.11 ,33.33
03,008,01,010,0208,333,676,11,687,1171,0,3,1,3,0,1,0,76.14,58.67 ,33.33
03,008,01,010,0208,334,550,5,555,977,0,3,1,3,0,1,0,76.14,56.81 ,33.33
03,008,01,010,0209,335,677,4,681,988,0,3,1,3,0,1,0,76.14,68.93 ,33.33
03,008,01,010,0209,336,688,13,701,1008,0,3,1,3,0,1,0,76.14,69.54 ,33.33
03,008,01,010,0210,337,599,3,602,922,0,3,1,3,0,1,0,76.14,65.29 ,33.33
03,008,01,010,0211,338,825,7,832,1246,0,3,1,3,0,1,0,76.14,66.77 ,33.33
03,008,01,010,0212,339,509,7,516,847,0,3,1,3,0,1,0,76.14,60.92 ,33.33
03,008,01,010,0213,340,759,12,771,1193,0,3,1,3,0,1,0,76.14,64.63 ,33.33
03,008,01,010,0213,341,345,2,347,502,0,3,1,3,0,1,0,76.14,69.12 ,33.33
03,008,01,010,0214,342,826,10,836,1469,0,3,1,3,0,1,0,76.14,56.91 ,33.33
03,008,01,010,0214,343,314,3,317,554,0,3,1,3,0,1,0,76.14,57.22 ,33.33
03,008,01,011,0215,344,470,10,480,924,0,3,1,3,0,1,0,76.14,51.95 ,33.33
03,008,01,011,0216,345,342,6,348,612,0,3,1,3,0,1,0,76.14,56.86 ,33.33
03,008,01,011,0216,346,627,14,641,1138,0,3,1,3,0,1,0,76.14,56.33 ,33.33
03,008,01,011,0217,347,442,7,449,740,0,3,1,3,0,1,0,76.14,60.68 ,33.33
03,008,01,011,0218,348,585,8,593,1030,0,3,1,3,0,1,0,76.14,57.57 ,33.33
03,008,01,011,0219,349,354,1,355,559,0,3,1,3,0,1,0,76.14,63.51 ,33.33
03,008,01,011,0220,350,642,9,651,1085,0,3,1,3,0,1,0,76.14,60.00 ,33.33
03,008,01,011,0221,351,720,8,728,1257,0,3,1,3,0,1,0,76.14,57.92 ,33.33
03,008,01,011,0222,352,701,10,711,1130,0,3,1,3,0,1,0,76.14,62.92 ,33.33
03,008,01,011,0223,353,828,14,842,1346,0,3,1,3,0,1,0,76.14,62.56 ,33.33
03,008,01,011,0224,354,619,4,623,1050,0,3,1,3,0,1,0,76.14,59.33 ,33.33
03,008,01,011,0225,355,609,9,618,1122,0,3,1,3,0,1,0,76.14,55.08 ,33.33
03,008,01,011,0226,356,240,3,243,417,0,3,1,3,0,1,0,76.14,58.27 ,33.33
03,008,01,011,0227,357,285,4,289,415,0,3,1,3,0,1,0,76.14,69.64 ,33.33
03,008,01,011,0228,358,676,7,683,1287,0,3,1,3,0,1,0,76.14,53.07 ,33.33
03,008,01,011,0229,359,219,2,221,366,0,3,1,3,0,1,0,76.14,60.38 ,33.33
03,008,01,011,0230,360,232,6,238,383,0,3,1,3,0,1,0,76.14,62.14 ,33.33
03,008,01,011,0231,361,582,8,590,923,0,3,1,3,0,1,0,76.14,63.92 ,33.33
03,008,01,011,0232,362,368,9,377,636,0,3,1,3,0,1,0,76.14,59.28 ,33.33
03,008,01,011,0233,363,371,3,374,692,0,3,1,3,0,1,0,76.14,54.05 ,33.33
03,008,01,012,0234,364,414,2,416,703,0,3,1,3,0,1,0,76.14,59.17 ,33.33
03,008,01,012,0234,365,260,0,260,443,0,3,1,3,0,1,0,76.14,58.69 ,33.33
03,008,01,012,0235,366,312,3,315,567,0,3,1,3,0,1,0,76.14,55.56 ,33.33
03,008,01,012,0236,367,240,6,246,422,0,3,1,3,0,1,0,76.14,58.29 ,33.33
03,008,01,012,0236,368,207,4,211,330,0,3,1,3,0,1,0,76.14,63.94 ,33.33
03,008,01,012,0237,369,207,1,208,330,0,3,1,3,0,1,0,76.14,63.03 ,33.33
03,008,01,012,0238,370,42,0,42,84,0,3,1,3,0,1,0,76.14,50.00 ,33.33
03,008,01,012,0239,371,110,2,112,224,0,3,1,3,0,1,0,76.14,50.00 ,33.33
03,008,01,012,0240,372,13,0,13,19,0,3,1,3,0,1,0,76.14,68.42 ,33.33
03,008,01,012,0240,373,131,1,132,268,0,3,1,3,0,1,0,76.14,49.25 ,33.33
03,008,01,012,0241,374,120,0,120,231,0,3,1,3,0,1,0,76.14,51.95 ,33.33
03,008,01,012,0242,375,278,6,284,505,0,3,1,3,0,1,0,76.14,56.24 ,33.33
03,008,01,012,0242,376,163,3,166,273,0,3,1,3,0,1,0,76.14,60.81 ,33.33
03,008,01,012,0243,377,580,3,583,940,0,3,1,3,0,1,0,76.14,62.02 ,33.33
03,008,01,012,0243,378,238,2,240,433,0,3,1,3,0,1,0,76.14,55.43 ,33.33
03,008,01,012,0244,379,25,3,28,68,0,3,1,3,0,1,0,76.14,41.18 ,33.33
03,008,01,012,0244,380,86,0,86,192,0,3,1,3,0,1,0,76.14,44.79 ,33.33
03,008,01,012,0245,381,12,0,12,18,0,3,1,3,0,1,0,76.14,66.67 ,33.33
03,008,01,012,0246,382,60,2,62,93,0,3,1,3,0,1,0,76.14,66.67 ,33.33
03,008,01,012,0247,383,25,0,25,41,0,3,1,3,0,1,0,76.14,60.98 ,33.33
03,008,01,013,0248,384,113,1,114,224,0,3,1,3,0,1,0,76.14,50.89 ,33.33
03,008,01,013,0248,385,186,1,187,312,0,3,1,3,0,1,0,76.14,59.94 ,33.33
03,008,01,013,0249,386,296,3,299,531,0,3,1,3,0,1,0,76.14,56.31 ,33.33
03,008,01,013,0249,387,193,6,199,329,0,3,1,3,0,1,0,76.14,60.49 ,33.33
03,008,01,013,0249,388,125,4,129,202,0,3,1,3,0,1,0,76.14,63.86 ,33.33
03,008,01,013,0250,389,63,0,63,89,0,3,1,3,0,1,0,76.14,70.79 ,33.33
03,008,01,013,0251,390,23,1,24,50,0,3,1,3,0,1,0,76.14,48.00 ,33.33
03,008,01,013,0252,391,74,1,75,121,0,3,1,3,0,1,0,76.14,61.98 ,33.33
03,008,01,013,0252,392,14,1,15,28,0,3,1,3,0,1,0,76.14,53.57 ,33.33
03,008,01,013,0253,393,15,1,16,27,0,3,1,3,0,1,0,76.14,59.26 ,33.33
03,008,01,013,0254,394,6,1,7,26,0,3,1,3,0,1,0,76.14,26.92 ,33.33
03,008,01,013,0254,395,2,1,3,15,0,3,1,3,0,1,0,76.14,20.00 ,33.33
03,008,01,013,0254,396,159,2,161,214,0,3,1,3,0,1,0,76.14,75.23 ,33.33
03,008,01,013,0255,397,8,0,8,13,0,3,1,3,0,1,0,76.14,61.54 ,33.33
03,008,01,013,0255,398,3,0,3,12,0,3,1,3,0,1,0,76.14,25.00 ,33.33
03,008,01,013,0255,399,12,0,12,29,0,3,1,3,0,1,0,76.14,41.38 ,33.33
03,008,01,013,0256,400,12,0,12,34,0,3,1,3,0,1,0,76.14,35.29 ,33.33
03,008,01,013,0256,401,2,1,3,3,0,3,1,3,0,1,0,76.14,100.00 ,33.33
03,008,01,013,0256,402,22,0,22,51,0,3,1,3,0,1,0,76.14,43.14 ,33.33
03,008,01,013,0257,403,32,0,32,65,0,3,1,3,0,1,0,76.14,49.23 ,33.33
03,008,01,013,0258,404,18,3,21,44,0,3,1,3,0,1,0,76.14,47.73 ,33.33
03,008,01,013,0259,405,44,1,45,85,0,3,1,3,0,1,0,76.14,52.94 ,33.33
03,008,01,013,0260,406,41,3,44,92,0,3,1,3,0,1,0,76.14,47.83 ,33.33
03,008,01,013,0260,407,9,2,11,28,0,3,1,3,0,1,0,76.14,39.29 ,33.33
03,008,01,013,0261,408,38,1,39,62,0,3,1,3,0,1,0,76.14,62.90 ,33.33
03,009,01,001,0001,1,708,2,710,978,0,3,1,3,0,1,0,76.14,72.60 ,33.33
03,009,01,001,0002,2,529,4,533,689,0,3,1,3,0,1,0,76.14,77.36 ,33.33
03,009,01,001,0003,3,564,8,572,775,0,3,1,3,0,1,0,76.14,73.81 ,33.33
03,009,01,001,0004,4,496,4,500,655,0,3,1,3,0,1,0,76.14,76.34 ,33.33
03,009,01,001,0005,5,690,13,703,1001,0,3,1,3,0,1,0,76.14,70.23 ,33.33
03,009,01,001,0006,6,717,13,730,1068,0,3,1,3,0,1,0,76.14,68.35 ,33.33
03,009,01,001,0006,7,831,14,845,1168,0,3,1,3,0,1,0,76.14,72.35 ,33.33
03,009,01,001,0007,8,706,12,718,950,0,3,1,3,0,1,0,76.14,75.58 ,33.33
03,009,01,001,0007,9,760,10,770,1045,0,3,1,3,0,1,0,76.14,73.68 ,33.33
03,009,01,001,0007,10,902,12,914,1230,0,3,1,3,0,1,0,76.14,74.31 ,33.33
03,009,01,001,0008,11,909,20,929,1297,0,3,1,3,0,1,0,76.14,71.63 ,33.33
03,009,01,001,0008,12,990,18,1008,1415,0,3,1,3,0,1,0,76.14,71.24 ,33.33
03,009,01,001,0009,13,999,27,1026,1480,0,3,1,3,0,1,0,76.14,69.32 ,33.33
03,009,01,001,0009,14,815,7,822,1176,0,3,1,3,0,1,0,76.14,69.90 ,33.33
03,009,01,001,0009,15,865,13,878,1256,0,3,1,3,0,1,0,76.14,69.90 ,33.33
03,009,01,001,0009,16,742,18,760,1060,0,3,1,3,0,1,0,76.14,71.70 ,33.33
03,009,01,001,0010,17,642,10,652,863,0,3,1,3,0,1,0,76.14,75.55 ,33.33
03,009,01,001,0010,18,526,7,533,740,0,3,1,3,0,1,0,76.14,72.03 ,33.33
03,009,01,001,0011,19,811,17,828,1157,0,3,1,3,0,1,0,76.14,71.56 ,33.33
03,009,01,001,0012,20,712,18,730,957,0,3,1,3,0,1,0,76.14,76.28 ,33.33
03,009,01,001,0012,21,775,20,795,1168,0,3,1,3,0,1,0,76.14,68.07 ,33.33
03,009,01,001,0013,22,1212,24,1236,1774,0,3,1,3,0,1,0,76.14,69.67 ,33.33
03,009,01,001,0014,23,620,14,634,871,0,3,1,3,0,1,0,76.14,72.79 ,33.33
03,009,01,001,0014,24,670,10,680,951,0,3,1,3,0,1,0,76.14,71.50 ,33.33
03,009,01,001,0015,25,909,13,922,1344,0,3,1,3,0,1,0,76.14,68.60 ,33.33
03,009,01,001,0015,26,767,13,780,1088,0,3,1,3,0,1,0,76.14,71.69 ,33.33
03,009,01,001,0015,27,881,18,899,1255,0,3,1,3,0,1,0,76.14,71.63 ,33.33
03,009,01,001,0015,28,901,14,915,1141,0,3,1,3,0,1,0,76.14,80.19 ,33.33
03,009,01,001,0016,29,942,12,954,1333,0,3,1,3,0,1,0,76.14,71.57 ,33.33
03,009,01,001,0016,30,1008,11,1019,1459,0,3,1,3,0,1,0,76.14,69.84 ,33.33
03,009,01,001,0017,31,639,11,650,900,0,3,1,3,0,1,0,76.14,72.22 ,33.33
03,009,01,001,0017,32,874,18,892,1172,0,3,1,3,0,1,0,76.14,76.11 ,33.33
03,009,01,001,0018,33,595,11,606,822,0,3,1,3,0,1,0,76.14,73.72 ,33.33
03,009,01,001,0019,34,463,4,467,579,0,3,1,3,0,1,0,76.14,80.66 ,33.33
03,009,01,001,0020,35,652,9,661,871,0,3,1,3,0,1,0,76.14,75.89 ,33.33
03,009,01,001,0020,36,505,11,516,668,0,3,1,3,0,1,0,76.14,77.25 ,33.33
03,009,01,001,0021,37,397,7,404,516,0,3,1,3,0,1,0,76.14,78.29 ,33.33
03,009,01,001,0022,38,742,15,757,1061,0,3,1,3,0,1,0,76.14,71.35 ,33.33
03,009,01,001,0023,39,457,12,469,633,0,3,1,3,0,1,0,76.14,74.09 ,33.33
03,009,01,001,0024,40,804,13,817,1050,0,3,1,3,0,1,0,76.14,77.81 ,33.33
03,009,01,001,0024,41,403,7,410,549,0,3,1,3,0,1,0,76.14,74.68 ,33.33
03,009,01,001,0025,42,746,15,761,1035,0,3,1,3,0,1,0,76.14,73.53 ,33.33
03,009,01,001,0025,43,1028,24,1052,1473,0,3,1,3,0,1,0,76.14,71.42 ,33.33
03,009,01,001,0025,44,885,17,902,1152,0,3,1,3,0,1,0,76.14,78.30 ,33.33
03,009,01,001,0026,45,1022,15,1037,1399,0,3,1,3,0,1,0,76.14,74.12 ,33.33
03,009,01,001,0026,46,848,20,868,1132,0,3,1,3,0,1,0,76.14,76.68 ,33.33
03,009,01,001,0027,47,1029,11,1040,1345,0,3,1,3,0,1,0,76.14,77.32 ,33.33
03,009,01,001,0028,48,1043,16,1059,1451,0,3,1,3,0,1,0,76.14,72.98 ,33.33
03,009,01,001,0028,49,1244,37,1281,1774,0,3,1,3,0,1,0,76.14,72.21 ,33.33
03,009,01,001,0029,50,590,12,602,809,0,3,1,3,0,1,0,76.14,74.41 ,33.33
03,009,01,001,0030,51,560,9,569,753,0,3,1,3,0,1,0,76.14,75.56 ,33.33
03,009,01,001,0031,52,621,22,643,839,0,3,1,3,0,1,0,76.14,76.64 ,33.33
03,009,01,001,0031,53,692,15,707,919,0,3,1,3,0,1,0,76.14,76.93 ,33.33
03,009,01,001,0032,54,879,22,901,1217,0,3,1,3,0,1,0,76.14,74.03 ,33.33
03,009,01,001,0033,55,710,21,731,945,0,3,1,3,0,1,0,76.14,77.35 ,33.33
03,009,01,001,0033,56,839,18,857,1133,0,3,1,3,0,1,0,76.14,75.64 ,33.33
03,009,01,001,0034,57,616,9,625,853,0,3,1,3,0,1,0,76.14,73.27 ,33.33
03,009,01,001,0034,58,694,26,720,1040,0,3,1,3,0,1,0,76.14,69.23 ,33.33
03,009,01,001,0035,59,797,15,812,1071,0,3,1,3,0,1,0,76.14,75.82 ,33.33
03,009,01,002,0036,60,810,19,829,1118,0,3,1,3,0,1,0,76.14,74.15 ,33.33
03,009,01,002,0037,61,890,9,899,1262,0,3,1,3,0,1,0,76.14,71.24 ,33.33
03,009,01,002,0037,62,737,17,754,1097,0,3,1,3,0,1,0,76.14,68.73 ,33.33
03,009,01,002,0037,63,705,14,719,1066,0,3,1,3,0,1,0,76.14,67.45 ,33.33
03,009,01,002,0038,64,706,17,723,1125,0,3,1,3,0,1,0,76.14,64.27 ,33.33
03,009,01,002,0038,65,539,5,544,761,0,3,1,3,0,1,0,76.14,71.48 ,33.33
03,009,01,002,0039,66,851,9,860,1198,0,3,1,3,0,1,0,76.14,71.79 ,33.33
03,009,01,002,0040,67,928,15,943,1334,0,3,1,3,0,1,0,76.14,70.69 ,33.33
03,009,01,002,0041,68,927,15,942,1412,0,3,1,3,0,1,0,76.14,66.71 ,33.33
03,009,01,002,0042,69,753,6,759,1053,0,3,1,3,0,1,0,76.14,72.08 ,33.33
03,009,01,002,0043,70,615,6,621,831,0,3,1,3,0,1,0,76.14,74.73 ,33.33
03,009,01,002,0044,71,654,12,666,903,0,3,1,3,0,1,0,76.14,73.75 ,33.33
03,009,01,002,0045,72,675,9,684,890,0,3,1,3,0,1,0,76.14,76.85 ,33.33
03,009,01,002,0046,73,502,5,507,714,0,3,1,3,0,1,0,76.14,71.01 ,33.33
03,009,01,002,0047,74,915,9,924,1180,0,3,1,3,0,1,0,76.14,78.31 ,33.33
03,009,01,002,0048,75,985,13,998,1320,0,3,1,3,0,1,0,76.14,75.61 ,33.33
03,009,01,002,0049,76,689,18,707,971,0,3,1,3,0,1,0,76.14,72.81 ,33.33
03,009,01,002,0050,77,665,13,678,911,0,3,1,3,0,1,0,76.14,74.42 ,33.33
03,009,01,002,0050,78,892,23,915,1256,0,3,1,3,0,1,0,76.14,72.85 ,33.33
03,009,01,002,0051,79,728,8,736,975,0,3,1,3,0,1,0,76.14,75.49 ,33.33
03,009,01,002,0051,80,681,21,702,953,0,3,1,3,0,1,0,76.14,73.66 ,33.33
03,009,01,002,0052,81,1085,23,1108,1510,0,3,1,3,0,1,0,76.14,73.38 ,33.33
03,009,01,002,0052,82,770,13,783,1097,0,3,1,3,0,1,0,76.14,71.38 ,33.33
03,009,01,002,0052,83,827,18,845,1246,0,3,1,3,0,1,0,76.14,67.82 ,33.33
03,009,01,002,0053,84,708,10,718,992,0,3,1,3,0,1,0,76.14,72.38 ,33.33
03,009,01,002,0054,85,622,7,629,889,0,3,1,3,0,1,0,76.14,70.75 ,33.33
03,009,01,002,0055,86,669,14,683,922,0,3,1,3,0,1,0,76.14,74.08 ,33.33
03,009,01,002,0056,87,553,7,560,790,0,3,1,3,0,1,0,76.14,70.89 ,33.33
03,009,01,002,0056,88,572,4,576,786,0,3,1,3,0,1,0,76.14,73.28 ,33.33
03,009,01,002,0057,89,1080,12,1092,1533,0,3,1,3,0,1,0,76.14,71.23 ,33.33
03,009,01,003,0058,90,768,11,779,1102,0,3,1,3,0,1,0,76.14,70.69 ,33.33
03,009,01,003,0058,91,818,14,832,1200,0,3,1,3,0,1,0,76.14,69.33 ,33.33
03,009,01,003,0059,92,512,9,521,718,0,3,1,3,0,1,0,76.14,72.56 ,33.33
03,009,01,003,0059,93,629,10,639,935,0,3,1,3,0,1,0,76.14,68.34 ,33.33
03,009,01,003,0060,94,739,12,751,1137,0,3,1,3,0,1,0,76.14,66.05 ,33.33
03,009,01,003,0060,95,930,9,939,1320,0,3,1,3,0,1,0,76.14,71.14 ,33.33
03,009,01,003,0061,96,671,8,679,1007,0,3,1,3,0,1,0,76.14,67.43 ,33.33
03,009,01,003,0061,97,937,13,950,1452,0,3,1,3,0,1,0,76.14,65.43 ,33.33
03,009,01,003,0062,98,779,11,790,1136,0,3,1,3,0,1,0,76.14,69.54 ,33.33
03,009,01,003,0063,99,860,9,869,1290,0,3,1,3,0,1,0,76.14,67.36 ,33.33
03,009,01,003,0063,100,1005,21,1026,1492,0,3,1,3,0,1,0,76.14,68.77 ,33.33
03,009,01,003,0064,101,948,17,965,1322,0,3,1,3,0,1,0,76.14,73.00 ,33.33
03,009,01,003,0064,102,1017,18,1035,1551,0,3,1,3,0,1,0,76.14,66.73 ,33.33
03,009,01,003,0065,103,911,11,922,1241,0,3,1,3,0,1,0,76.14,74.29 ,33.33
03,009,01,003,0066,104,697,9,706,1007,0,3,1,3,0,1,0,76.14,70.11 ,33.33
03,009,01,003,0067,105,800,8,808,1362,0,3,1,3,0,1,0,76.14,59.32 ,33.33
03,009,01,003,0068,106,1056,19,1075,1574,0,3,1,3,0,1,0,76.14,68.30 ,33.33
03,009,01,003,0069,107,1060,11,1071,1514,0,3,1,3,0,1,0,76.14,70.74 ,33.33
03,009,01,003,0070,108,541,12,553,750,0,3,1,3,0,1,0,76.14,73.73 ,33.33
03,009,01,003,0071,109,470,8,478,716,0,3,1,3,0,1,0,76.14,66.76 ,33.33
03,009,01,003,0072,110,686,10,696,993,0,3,1,3,0,1,0,76.14,70.09 ,33.33
03,009,01,003,0072,111,724,10,734,971,0,3,1,3,0,1,0,76.14,75.59 ,33.33
03,009,01,003,0073,112,561,9,570,726,0,3,1,3,0,1,0,76.14,78.51 ,33.33
03,009,01,003,0074,113,1048,15,1063,1448,0,3,1,3,0,1,0,76.14,73.41 ,33.33
03,009,01,003,0075,114,992,31,1023,1413,0,3,1,3,0,1,0,76.14,72.40 ,33.33
03,009,01,003,0076,115,810,13,823,1256,0,3,1,3,0,1,0,76.14,65.53 ,33.33
03,009,01,003,0076,116,894,15,909,1357,0,3,1,3,0,1,0,76.14,66.99 ,33.33
03,009,01,003,0077,117,725,8,733,1135,0,3,1,3,0,1,0,76.14,64.58 ,33.33
03,009,01,003,0077,118,643,10,653,985,0,3,1,3,0,1,0,76.14,66.29 ,33.33
03,009,01,003,0078,119,699,12,711,1026,0,3,1,3,0,1,0,76.14,69.30 ,33.33
03,009,01,003,0078,120,710,13,723,1064,0,3,1,3,0,1,0,76.14,67.95 ,33.33
03,009,01,003,0079,121,730,10,740,1139,0,3,1,3,0,1,0,76.14,64.97 ,33.33
03,009,01,003,0080,122,874,5,879,1192,0,3,1,3,0,1,0,76.14,73.74 ,33.33
03,009,01,003,0081,123,791,11,802,1044,0,3,1,3,0,1,0,76.14,76.82 ,33.33
03,009,01,003,0082,124,1057,11,1068,1400,0,3,1,3,0,1,0,76.14,76.29 ,33.33
03,009,01,003,0083,125,604,8,612,853,0,3,1,3,0,1,0,76.14,71.75 ,33.33
03,009,01,003,0084,126,654,12,666,926,0,3,1,3,0,1,0,76.14,71.92 ,33.33
03,009,01,003,0085,127,508,6,514,740,0,3,1,3,0,1,0,76.14,69.46 ,33.33
03,009,01,003,0086,128,629,6,635,977,0,3,1,3,0,1,0,76.14,64.99 ,33.33
03,009,01,004,0087,129,1047,10,1057,1485,0,3,1,3,0,1,0,76.14,71.18 ,33.33
03,009,01,004,0088,130,905,14,919,1225,0,3,1,3,0,1,0,76.14,75.02 ,33.33
03,009,01,004,0089,131,1136,14,1150,1545,0,3,1,3,0,1,0,76.14,74.43 ,33.33
03,009,01,004,0090,132,928,8,936,1388,0,3,1,3,0,1,0,76.14,67.44 ,33.33
03,009,01,004,0090,133,802,11,813,1139,0,3,1,3,0,1,0,76.14,71.38 ,33.33
03,009,01,004,0091,134,387,2,389,533,0,3,1,3,0,1,0,76.14,72.98 ,33.33
03,009,01,004,0092,135,556,4,560,811,0,3,1,3,0,1,0,76.14,69.05 ,33.33
03,009,01,004,0093,136,494,5,499,711,0,3,1,3,0,1,0,76.14,70.18 ,33.33
03,009,01,004,0094,137,721,7,728,1020,0,3,1,3,0,1,0,76.14,71.37 ,33.33
03,009,01,004,0095,138,798,9,807,1160,0,3,1,3,0,1,0,76.14,69.57 ,33.33
03,009,01,004,0095,139,603,3,606,873,0,3,1,3,0,1,0,76.14,69.42 ,33.33
03,009,01,004,0096,140,1023,11,1034,1480,0,3,1,3,0,1,0,76.14,69.86 ,33.33
03,009,01,004,0096,141,1011,10,1021,1429,0,3,1,3,0,1,0,76.14,71.45 ,33.33
03,009,01,004,0097,142,851,8,859,1172,0,3,1,3,0,1,0,76.14,73.29 ,33.33
03,009,01,004,0098,143,964,8,972,1334,0,3,1,3,0,1,0,76.14,72.86 ,33.33
03,009,01,004,0099,144,706,7,713,990,0,3,1,3,0,1,0,76.14,72.02 ,33.33
03,009,01,004,0099,145,499,8,507,748,0,3,1,3,0,1,0,76.14,67.78 ,33.33
03,009,01,004,0100,146,623,4,627,906,0,3,1,3,0,1,0,76.14,69.21 ,33.33
03,009,01,004,0101,147,810,14,824,1168,0,3,1,3,0,1,0,76.14,70.55 ,33.33
03,009,01,004,0102,148,993,16,1009,1414,0,3,1,3,0,1,0,76.14,71.36 ,33.33
03,009,01,004,0103,149,600,8,608,855,0,3,1,3,0,1,0,76.14,71.11 ,33.33
03,009,01,004,0104,150,714,7,721,1003,0,3,1,3,0,1,0,76.14,71.88 ,33.33
03,009,01,004,0105,151,905,7,912,1348,0,3,1,3,0,1,0,76.14,67.66 ,33.33
03,009,01,004,0106,152,490,5,495,709,0,3,1,3,0,1,0,76.14,69.82 ,33.33
03,009,01,004,0107,153,574,5,579,764,0,3,1,3,0,1,0,76.14,75.79 ,33.33
03,009,01,004,0108,154,677,10,687,1016,0,3,1,3,0,1,0,76.14,67.62 ,33.33
03,009,01,004,0109,155,947,9,956,1311,0,3,1,3,0,1,0,76.14,72.92 ,33.33
03,009,01,004,0110,156,636,6,642,951,0,3,1,3,0,1,0,76.14,67.51 ,33.33
03,009,01,004,0111,157,598,8,606,896,0,3,1,3,0,1,0,76.14,67.63 ,33.33
03,009,01,004,0112,158,577,6,583,884,0,3,1,3,0,1,0,76.14,65.95 ,33.33
03,009,01,004,0112,159,485,5,490,810,0,3,1,3,0,1,0,76.14,60.49 ,33.33
03,009,01,004,0113,160,986,10,996,1352,0,3,1,3,0,1,0,76.14,73.67 ,33.33
03,009,01,005,0114,161,662,6,668,921,0,3,1,3,0,1,0,76.14,72.53 ,33.33
03,009,01,005,0115,162,765,15,780,1055,0,3,1,3,0,1,0,76.14,73.93 ,33.33
03,009,01,005,0116,163,945,16,961,1327,0,3,1,3,0,1,0,76.14,72.42 ,33.33
03,009,01,005,0117,164,576,10,586,798,0,3,1,3,0,1,0,76.14,73.43 ,33.33
03,009,01,005,0118,165,486,2,488,699,0,3,1,3,0,1,0,76.14,69.81 ,33.33
03,009,01,005,0118,166,332,4,336,417,0,3,1,3,0,1,0,76.14,80.58 ,33.33
03,009,01,005,0119,167,881,26,907,1327,0,3,1,3,0,1,0,76.14,68.35 ,33.33
03,009,01,005,0120,168,398,5,403,566,0,3,1,3,0,1,0,76.14,71.20 ,33.33
03,009,01,005,0120,169,346,2,348,552,0,3,1,3,0,1,0,76.14,63.04 ,33.33
03,009,01,005,0121,170,460,5,465,845,0,3,1,3,0,1,0,76.14,55.03 ,33.33
03,009,01,005,0121,171,395,4,399,604,0,3,1,3,0,1,0,76.14,66.06 ,33.33
03,009,01,005,0122,172,561,7,568,918,0,3,1,3,0,1,0,76.14,61.87 ,33.33
03,009,01,005,0122,173,394,4,398,570,0,3,1,3,0,1,0,76.14,69.82 ,33.33
03,009,01,005,0123,174,808,16,824,1282,0,3,1,3,0,1,0,76.14,64.27 ,33.33
03,009,01,005,0123,175,679,4,683,967,0,3,1,3,0,1,0,76.14,70.63 ,33.33
03,009,01,005,0124,176,484,4,488,736,0,3,1,3,0,1,0,76.14,66.30 ,33.33
03,009,01,005,0124,177,422,8,430,674,0,3,1,3,0,1,0,76.14,63.80 ,33.33
03,009,01,005,0125,178,500,6,506,809,0,3,1,3,0,1,0,76.14,62.55 ,33.33
03,009,01,005,0126,179,574,8,582,957,0,3,1,3,0,1,0,76.14,60.82 ,33.33
03,009,01,005,0126,180,425,1,426,742,0,3,1,3,0,1,0,76.14,57.41 ,33.33
03,009,01,005,0127,181,597,4,601,930,0,3,1,3,0,1,0,76.14,64.62 ,33.33
03,009,01,005,0127,182,514,10,524,814,0,3,1,3,0,1,0,76.14,64.37 ,33.33
03,009,01,005,0128,183,573,14,587,940,0,3,1,3,0,1,0,76.14,62.45 ,33.33
03,009,01,005,0128,184,448,7,455,833,0,3,1,3,0,1,0,76.14,54.62 ,33.33
03,009,01,005,0129,185,639,3,642,986,0,3,1,3,0,1,0,76.14,65.11 ,33.33
03,009,01,005,0130,186,944,10,954,1399,0,3,1,3,0,1,0,76.14,68.19 ,33.33
03,009,01,006,0131,187,593,7,600,881,0,3,1,3,0,1,0,76.14,68.10 ,33.33
03,009,01,006,0132,188,564,9,573,801,0,3,1,3,0,1,0,76.14,71.54 ,33.33
03,009,01,006,0133,189,427,2,429,586,0,3,1,3,0,1,0,76.14,73.21 ,33.33
03,009,01,006,0134,190,723,13,736,1080,0,3,1,3,0,1,0,76.14,68.15 ,33.33
03,009,01,006,0135,191,317,4,321,460,0,3,1,3,0,1,0,76.14,69.78 ,33.33
03,009,01,006,0136,192,344,6,350,482,0,3,1,3,0,1,0,76.14,72.61 ,33.33
03,009,01,006,0137,193,377,7,384,559,0,3,1,3,0,1,0,76.14,68.69 ,33.33
03,009,01,006,0138,194,513,4,517,764,0,3,1,3,0,1,0,76.14,67.67 ,33.33
03,009,01,006,0139,195,422,4,426,595,0,3,1,3,0,1,0,76.14,71.60 ,33.33
03,009,01,006,0140,196,293,5,298,453,0,3,1,3,0,1,0,76.14,65.78 ,33.33
03,009,01,006,0141,197,484,14,498,704,0,3,1,3,0,1,0,76.14,70.74 ,33.33
03,009,01,006,0142,198,387,4,391,580,0,3,1,3,0,1,0,76.14,67.41 ,33.33
03,009,01,006,0142,199,503,6,509,803,0,3,1,3,0,1,0,76.14,63.39 ,33.33
03,009,01,006,0143,200,353,1,354,534,0,3,1,3,0,1,0,76.14,66.29 ,33.33
03,009,01,006,0144,201,722,7,729,1074,0,3,1,3,0,1,0,76.14,67.88 ,33.33
03,009,01,006,0144,202,903,16,919,1426,0,3,1,3,0,1,0,76.14,64.45 ,33.33
03,009,01,006,0144,203,671,12,683,987,0,3,1,3,0,1,0,76.14,69.20 ,33.33
03,009,01,006,0144,204,868,14,882,1348,0,3,1,3,0,1,0,76.14,65.43 ,33.33
03,009,01,006,0145,205,805,9,814,1208,0,3,1,3,0,1,0,76.14,67.38 ,33.33
03,009,01,006,0146,206,636,16,652,961,0,3,1,3,0,1,0,76.14,67.85 ,33.33
03,009,01,006,0146,207,1188,18,1206,1681,0,3,1,3,0,1,0,76.14,71.74 ,33.33
03,009,01,006,0146,208,1002,11,1013,1566,0,3,1,3,0,1,0,76.14,64.69 ,33.33
03,009,01,006,0147,209,703,14,717,1127,0,3,1,3,0,1,0,76.14,63.62 ,33.33
03,009,01,006,0148,210,372,5,377,642,0,3,1,3,0,1,0,76.14,58.72 ,33.33
03,009,01,006,0148,211,179,1,180,330,0,3,1,3,0,1,0,76.14,54.55 ,33.33
03,009,01,006,0149,212,265,2,267,403,0,3,1,3,0,1,0,76.14,66.25 ,33.33
03,009,01,006,0150,213,511,2,513,868,0,3,1,3,0,1,0,76.14,59.10 ,33.33
03,009,01,006,0151,214,879,20,899,1399,0,3,1,3,0,1,0,76.14,64.26 ,33.33
03,009,01,006,0152,215,696,11,707,1272,0,3,1,3,0,1,0,76.14,55.58 ,33.33
03,009,01,006,0153,216,684,12,696,1137,0,3,1,3,0,1,0,76.14,61.21 ,33.33
03,009,01,006,0154,217,380,7,387,711,0,3,1,3,0,1,0,76.14,54.43 ,33.33
03,009,01,006,0155,218,666,17,683,988,0,3,1,3,0,1,0,76.14,69.13 ,33.33
03,009,01,006,0155,219,414,8,422,614,0,3,1,3,0,1,0,76.14,68.73 ,33.33
03,009,01,006,0156,220,736,15,751,1265,0,3,1,3,0,1,0,76.14,59.37 ,33.33
03,009,01,006,0156,221,839,14,853,1302,0,3,1,3,0,1,0,76.14,65.51 ,33.33
03,009,01,006,0157,222,636,12,648,1090,0,3,1,3,0,1,0,76.14,59.45 ,33.33
03,009,01,006,0158,223,365,4,369,600,0,3,1,3,0,1,0,76.14,61.50 ,33.33
03,009,01,007,0159,224,793,12,805,1176,0,3,1,3,0,1,0,76.14,68.45 ,33.33
03,009,01,007,0159,225,627,9,636,899,0,3,1,3,0,1,0,76.14,70.75 ,33.33
03,009,01,007,0160,226,1019,14,1033,1564,0,3,1,3,0,1,0,76.14,66.05 ,33.33
03,009,01,007,0161,227,808,10,818,1130,0,3,1,3,0,1,0,76.14,72.39 ,33.33
03,009,01,007,0161,228,887,18,905,1300,0,3,1,3,0,1,0,76.14,69.62 ,33.33
03,009,01,007,0162,229,783,15,798,1102,0,3,1,3,0,1,0,76.14,72.41 ,33.33
03,009,01,007,0162,230,226,4,230,303,0,3,1,3,0,1,0,76.14,75.91 ,33.33
03,009,01,007,0163,231,827,13,840,1105,0,3,1,3,0,1,0,76.14,76.02 ,33.33
03,009,01,007,0164,232,935,12,947,1237,0,3,1,3,0,1,0,76.14,76.56 ,33.33
03,009,01,007,0165,233,639,9,648,848,0,3,1,3,0,1,0,76.14,76.42 ,33.33
03,009,01,007,0166,234,712,11,723,995,0,3,1,3,0,1,0,76.14,72.66 ,33.33
03,009,01,007,0166,235,722,9,731,975,0,3,1,3,0,1,0,76.14,74.97 ,33.33
03,009,01,007,0167,236,642,9,651,905,0,3,1,3,0,1,0,76.14,71.93 ,33.33
03,009,01,007,0167,237,653,9,662,917,0,3,1,3,0,1,0,76.14,72.19 ,33.33
03,009,01,007,0168,238,978,8,986,1387,0,3,1,3,0,1,0,76.14,71.09 ,33.33
03,009,01,007,0169,239,561,3,564,726,0,3,1,3,0,1,0,76.14,77.69 ,33.33
03,009,01,007,0170,240,751,5,756,995,0,3,1,3,0,1,0,76.14,75.98 ,33.33
03,009,01,007,0170,241,623,6,629,868,0,3,1,3,0,1,0,76.14,72.47 ,33.33
03,009,01,007,0171,242,713,12,725,993,0,3,1,3,0,1,0,76.14,73.01 ,33.33
03,009,01,007,0171,243,701,14,715,986,0,3,1,3,0,1,0,76.14,72.52 ,33.33
03,009,01,007,0172,244,517,5,522,662,0,3,1,3,0,1,0,76.14,78.85 ,33.33
03,009,01,007,0173,245,979,15,994,1340,0,3,1,3,0,1,0,76.14,74.18 ,33.33
03,009,01,007,0174,246,267,3,270,339,0,3,1,3,0,1,0,76.14,79.65 ,33.33
03,009,01,007,0175,247,674,8,682,1050,0,3,1,3,0,1,0,76.14,64.95 ,33.33
03,009,01,007,0176,248,635,6,641,960,0,3,1,3,0,1,0,76.14,66.77 ,33.33
03,009,01,007,0177,249,385,1,386,571,0,3,1,3,0,1,0,76.14,67.60 ,33.33
03,009,01,007,0178,250,520,3,523,715,0,3,1,3,0,1,0,76.14,73.15 ,33.33
03,009,01,008,0179,251,543,11,554,825,0,3,1,3,0,1,0,76.14,67.15 ,33.33
03,009,01,008,0180,252,995,16,1011,1408,0,3,1,3,0,1,0,76.14,71.80 ,33.33
03,009,01,008,0180,253,396,5,401,564,0,3,1,3,0,1,0,76.14,71.10 ,33.33
03,009,01,008,0181,254,739,14,753,1134,0,3,1,3,0,1,0,76.14,66.40 ,33.33
03,009,01,008,0182,255,745,8,753,1095,0,3,1,3,0,1,0,76.14,68.77 ,33.33
03,009,01,008,0183,256,802,12,814,1230,0,3,1,3,0,1,0,76.14,66.18 ,33.33
03,009,01,008,0183,257,332,3,335,524,0,3,1,3,0,1,0,76.14,63.93 ,33.33
03,009,01,008,0184,258,937,15,952,1284,0,3,1,3,0,1,0,76.14,74.14 ,33.33
03,009,01,008,0184,259,362,3,365,476,0,3,1,3,0,1,0,76.14,76.68 ,33.33
03,009,01,008,0185,260,719,15,734,1048,0,3,1,3,0,1,0,76.14,70.04 ,33.33
03,009,01,008,0186,261,862,11,873,1267,0,3,1,3,0,1,0,76.14,68.90 ,33.33
03,009,01,008,0187,262,523,7,530,834,0,3,1,3,0,1,0,76.14,63.55 ,33.33
03,009,01,008,0188,263,525,6,531,759,0,3,1,3,0,1,0,76.14,69.96 ,33.33
03,009,01,008,0189,264,846,17,863,1239,0,3,1,3,0,1,0,76.14,69.65 ,33.33
03,009,01,008,0190,265,598,3,601,844,0,3,1,3,0,1,0,76.14,71.21 ,33.33
03,009,01,008,0191,266,466,6,472,733,0,3,1,3,0,1,0,76.14,64.39 ,33.33
03,009,01,008,0192,267,556,8,564,870,0,3,1,3,0,1,0,76.14,64.83 ,33.33
03,009,01,008,0193,268,612,5,617,906,0,3,1,3,0,1,0,76.14,68.10 ,33.33
03,009,01,009,0194,269,998,13,1011,1409,0,3,1,3,0,1,0,76.14,71.75 ,33.33
03,009,01,009,0194,270,1133,23,1156,1544,0,3,1,3,0,1,0,76.14,74.87 ,33.33
03,009,01,009,0195,271,680,10,690,919,0,3,1,3,0,1,0,76.14,75.08 ,33.33
03,009,01,009,0196,272,1000,11,1011,1513,0,3,1,3,0,1,0,76.14,66.82 ,33.33
03,009,01,009,0197,273,384,8,392,585,0,3,1,3,0,1,0,76.14,67.01 ,33.33
03,009,01,009,0197,274,509,10,519,749,0,3,1,3,0,1,0,76.14,69.29 ,33.33
03,009,01,009,0198,275,772,11,783,1112,0,3,1,3,0,1,0,76.14,70.41 ,33.33
03,009,01,009,0199,276,1105,21,1126,1626,0,3,1,3,0,1,0,76.14,69.25 ,33.33
03,009,01,009,0200,277,793,10,803,1102,0,3,1,3,0,1,0,76.14,72.87 ,33.33
03,009,01,009,0200,278,657,12,669,926,0,3,1,3,0,1,0,76.14,72.25 ,33.33
03,009,01,009,0201,279,839,10,849,1119,0,3,1,3,0,1,0,76.14,75.87 ,33.33
03,009,01,009,0202,280,594,12,606,870,0,3,1,3,0,1,0,76.14,69.66 ,33.33
03,009,01,009,0202,281,630,11,641,904,0,3,1,3,0,1,0,76.14,70.91 ,33.33
03,009,01,009,0203,282,826,19,845,1124,0,3,1,3,0,1,0,76.14,75.18 ,33.33
03,009,01,009,0204,283,1070,20,1090,1622,0,3,1,3,0,1,0,76.14,67.20 ,33.33
03,009,01,009,0205,284,1032,14,1046,1502,0,3,1,3,0,1,0,76.14,69.64 ,33.33
03,009,01,009,0206,285,808,20,828,1260,0,3,1,3,0,1,0,76.14,65.71 ,33.33
03,009,01,009,0207,286,1066,13,1079,1565,0,3,1,3,0,1,0,76.14,68.95 ,33.33
03,009,01,010,0208,287,777,10,787,1012,0,3,1,3,0,1,0,76.14,77.77 ,33.33
03,009,01,010,0209,288,1022,18,1040,1406,0,3,1,3,0,1,0,76.14,73.97 ,33.33
03,009,01,010,0209,289,1162,24,1186,1551,0,3,1,3,0,1,0,76.14,76.47 ,33.33
03,009,01,010,0210,290,917,25,942,1323,0,3,1,3,0,1,0,76.14,71.20 ,33.33
03,009,01,010,0210,291,495,11,506,724,0,3,1,3,0,1,0,76.14,69.89 ,33.33
03,009,01,010,0211,292,506,4,510,657,0,3,1,3,0,1,0,76.14,77.63 ,33.33
03,009,01,010,0212,293,708,26,734,999,0,3,1,3,0,1,0,76.14,73.47 ,33.33
03,009,01,010,0213,294,755,18,773,1018,0,3,1,3,0,1,0,76.14,75.93 ,33.33
03,009,01,010,0213,295,972,22,994,1374,0,3,1,3,0,1,0,76.14,72.34 ,33.33
03,009,01,010,0214,296,407,13,420,609,0,3,1,3,0,1,0,76.14,68.97 ,33.33
03,009,01,010,0215,297,871,15,886,1102,0,3,1,3,0,1,0,76.14,80.40 ,33.33
03,009,01,010,0215,298,759,8,767,1093,0,3,1,3,0,1,0,76.14,70.17 ,33.33
03,009,01,010,0216,299,610,14,624,829,0,3,1,3,0,1,0,76.14,75.27 ,33.33
03,009,01,010,0216,300,545,11,556,799,0,3,1,3,0,1,0,76.14,69.59 ,33.33
03,009,01,011,0217,301,879,8,887,1335,0,3,1,3,0,1,0,76.14,66.44 ,33.33
03,009,01,011,0218,302,1001,10,1011,1520,0,3,1,3,0,1,0,76.14,66.51 ,33.33
03,009,01,011,0219,303,489,3,492,738,0,3,1,3,0,1,0,76.14,66.67 ,33.33
03,009,01,011,0219,304,705,7,712,1102,0,3,1,3,0,1,0,76.14,64.61 ,33.33
03,009,01,011,0220,305,326,4,330,516,0,3,1,3,0,1,0,76.14,63.95 ,33.33
03,009,01,011,0220,306,808,16,824,1246,0,3,1,3,0,1,0,76.14,66.13 ,33.33
03,009,01,011,0221,307,828,13,841,1221,0,3,1,3,0,1,0,76.14,68.88 ,33.33
03,009,01,011,0222,308,635,10,645,956,0,3,1,3,0,1,0,76.14,67.47 ,33.33
03,009,01,011,0222,309,666,5,671,947,0,3,1,3,0,1,0,76.14,70.86 ,33.33
03,009,01,011,0223,310,606,12,618,946,0,3,1,3,0,1,0,76.14,65.33 ,33.33
03,009,01,011,0224,311,863,10,873,1258,0,3,1,3,0,1,0,76.14,69.40 ,33.33
03,009,01,011,0225,312,634,5,639,949,0,3,1,3,0,1,0,76.14,67.33 ,33.33
03,009,01,011,0226,313,479,4,483,796,0,3,1,3,0,1,0,76.14,60.68 ,33.33
03,009,01,011,0227,314,998,9,1007,1449,0,3,1,3,0,1,0,76.14,69.50 ,33.33
03,009,01,011,0228,315,739,7,746,1243,0,3,1,3,0,1,0,76.14,60.02 ,33.33
03,009,01,011,0228,316,509,5,514,735,0,3,1,3,0,1,0,76.14,69.93 ,33.33
03,009,01,011,0229,317,571,9,580,907,0,3,1,3,0,1,0,76.14,63.95 ,33.33
03,009,01,011,0230,318,761,8,769,1076,0,3,1,3,0,1,0,76.14,71.47 ,33.33
03,009,01,011,0230,319,426,5,431,686,0,3,1,3,0,1,0,76.14,62.83 ,33.33
03,009,01,011,0231,320,897,14,911,1435,0,3,1,3,0,1,0,76.14,63.48 ,33.33
03,009,01,011,0232,321,602,5,607,1031,0,3,1,3,0,1,0,76.14,58.87 ,33.33
03,009,01,011,0233,322,571,8,579,810,0,3,1,3,0,1,0,76.14,71.48 ,33.33
03,009,01,011,0234,323,699,8,707,1015,0,3,1,3,0,1,0,76.14,69.66 ,33.33
03,009,01,012,0235,324,926,17,943,1286,0,3,1,3,0,1,0,76.14,73.33 ,33.33
03,009,01,012,0236,325,924,17,941,1235,0,3,1,3,0,1,0,76.14,76.19 ,33.33
03,009,01,012,0237,326,674,14,688,952,0,3,1,3,0,1,0,76.14,72.27 ,33.33
03,009,01,012,0237,327,871,5,876,1114,0,3,1,3,0,1,0,76.14,78.64 ,33.33
03,009,01,012,0238,328,651,9,660,944,0,3,1,3,0,1,0,76.14,69.92 ,33.33
03,009,01,012,0238,329,576,8,584,931,0,3,1,3,0,1,0,76.14,62.73 ,33.33
03,009,01,012,0239,330,558,5,563,870,0,3,1,3,0,1,0,76.14,64.71 ,33.33
03,009,01,012,0239,331,611,9,620,916,0,3,1,3,0,1,0,76.14,67.69 ,33.33
03,009,01,012,0240,332,834,11,845,1318,0,3,1,3,0,1,0,76.14,64.11 ,33.33
03,009,01,012,0241,333,631,10,641,980,0,3,1,3,0,1,0,76.14,65.41 ,33.33
03,009,01,012,0241,334,611,3,614,872,0,3,1,3,0,1,0,76.14,70.41 ,33.33
03,009,01,012,0242,335,554,3,557,876,0,3,1,3,0,1,0,76.14,63.58 ,33.33
03,009,01,012,0243,336,530,10,540,804,0,3,1,3,0,1,0,76.14,67.16 ,33.33
03,009,01,012,0243,337,601,11,612,926,0,3,1,3,0,1,0,76.14,66.09 ,33.33
03,009,01,012,0244,338,576,8,584,978,0,3,1,3,0,1,0,76.14,59.71 ,33.33
03,009,01,012,0244,339,602,12,614,1033,0,3,1,3,0,1,0,76.14,59.44 ,33.33
03,009,01,012,0245,340,949,20,969,1402,0,3,1,3,0,1,0,76.14,69.12 ,33.33
03,009,01,012,0246,341,767,12,779,1165,0,3,1,3,0,1,0,76.14,66.87 ,33.33
03,009,01,012,0247,342,809,12,821,1248,0,3,1,3,0,1,0,76.14,65.79 ,33.33
03,009,01,012,0248,343,633,7,640,898,0,3,1,3,0,1,0,76.14,71.27 ,33.33
03,009,01,013,0249,344,348,2,350,546,0,3,1,3,0,1,0,76.14,64.10 ,33.33
03,009,01,013,0249,345,811,13,824,1240,0,3,1,3,0,1,0,76.14,66.45 ,33.33
03,009,01,013,0249,346,627,6,633,947,0,3,1,3,0,1,0,76.14,66.84 ,33.33
03,009,01,013,0250,347,687,12,699,1099,0,3,1,3,0,1,0,76.14,63.60 ,33.33
03,009,01,013,0250,348,744,7,751,1179,0,3,1,3,0,1,0,76.14,63.70 ,33.33
03,009,01,013,0251,349,304,5,309,492,0,3,1,3,0,1,0,76.14,62.80 ,33.33
03,009,01,013,0251,350,471,3,474,816,0,3,1,3,0,1,0,76.14,58.09 ,33.33
03,009,01,013,0252,351,429,5,434,711,0,3,1,3,0,1,0,76.14,61.04 ,33.33
03,009,01,013,0252,352,646,2,648,1121,0,3,1,3,0,1,0,76.14,57.81 ,33.33
03,009,01,013,0253,353,506,4,510,778,0,3,1,3,0,1,0,76.14,65.55 ,33.33
03,009,01,013,0253,354,350,4,354,552,0,3,1,3,0,1,0,76.14,64.13 ,33.33
03,009,01,013,0254,355,581,7,588,903,0,3,1,3,0,1,0,76.14,65.12 ,33.33
03,009,01,013,0254,356,639,8,647,965,0,3,1,3,0,1,0,76.14,67.05 ,33.33
03,009,01,013,0255,357,481,8,489,816,0,3,1,3,0,1,0,76.14,59.93 ,33.33
03,009,01,013,0255,358,706,12,718,1137,0,3,1,3,0,1,0,76.14,63.15 ,33.33
03,009,01,013,0256,359,504,9,513,869,0,3,1,3,0,1,0,76.14,59.03 ,33.33
03,009,01,013,0256,360,554,16,570,931,0,3,1,3,0,1,0,76.14,61.22 ,33.33
03,009,01,013,0257,361,509,10,519,716,0,3,1,3,0,1,0,76.14,72.49 ,33.33
03,009,01,013,0257,362,1031,16,1047,1634,0,3,1,3,0,1,0,76.14,64.08 ,33.33
03,009,01,013,0258,363,460,7,467,757,0,3,1,3,0,1,0,76.14,61.69 ,33.33
03,009,01,013,0259,364,661,10,671,1054,0,3,1,3,0,1,0,76.14,63.66 ,33.33
03,009,01,013,0259,365,645,7,652,947,0,3,1,3,0,1,0,76.14,68.85 ,33.33
03,009,01,013,0260,366,774,23,797,1363,0,3,1,3,0,1,0,76.14,58.47 ,33.33
03,009,01,014,0261,367,712,13,725,1350,0,3,1,3,0,1,0,76.14,53.70 ,33.33
03,009,01,014,0262,368,292,2,294,456,0,3,1,3,0,1,0,76.14,64.47 ,33.33
03,009,01,014,0263,369,554,9,563,1007,0,3,1,3,0,1,0,76.14,55.91 ,33.33
03,009,01,014,0263,370,438,6,444,758,0,3,1,3,0,1,0,76.14,58.58 ,33.33
03,009,01,014,0264,371,864,11,875,1410,0,3,1,3,0,1,0,76.14,62.06 ,33.33
03,009,01,014,0265,372,698,4,702,1143,0,3,1,3,0,1,0,76.14,61.42 ,33.33
03,009,01,014,0266,373,563,7,570,963,0,3,1,3,0,1,0,76.14,59.19 ,33.33
03,009,01,014,0267,374,616,12,628,1028,0,3,1,3,0,1,0,76.14,61.09 ,33.33
03,009,01,014,0267,375,656,12,668,1057,0,3,1,3,0,1,0,76.14,63.20 ,33.33
03,009,01,014,0268,376,580,4,584,810,0,3,1,3,0,1,0,76.14,72.10 ,33.33
03,009,01,014,0268,377,292,4,296,451,0,3,1,3,0,1,0,76.14,65.63 ,33.33
03,009,01,014,0269,378,661,5,666,1212,0,3,1,3,0,1,0,76.14,54.95 ,33.33
03,009,01,014,0270,379,550,8,558,975,0,3,1,3,0,1,0,76.14,57.23 ,33.33
03,009,01,014,0271,380,581,4,585,1036,0,3,1,3,0,1,0,76.14,56.47 ,33.33
03,009,01,014,0272,381,352,6,358,579,0,3,1,3,0,1,0,76.14,61.83 ,33.33
03,009,01,015,0273,382,1197,14,1211,1688,0,3,1,3,0,1,0,76.14,71.74 ,33.33
03,009,01,015,0274,383,853,6,859,1275,0,3,1,3,0,1,0,76.14,67.37 ,33.33
03,009,01,015,0275,384,871,12,883,1274,0,3,1,3,0,1,0,76.14,69.31 ,33.33
03,009,01,015,0276,385,240,1,241,396,0,3,1,3,0,1,0,76.14,60.86 ,33.33
03,009,01,015,0276,386,594,10,604,919,0,3,1,3,0,1,0,76.14,65.72 ,33.33
03,009,01,015,0277,387,319,4,323,491,0,3,1,3,0,1,0,76.14,65.78 ,33.33
03,009,01,015,0277,388,492,8,500,761,0,3,1,3,0,1,0,76.14,65.70 ,33.33
03,009,01,015,0278,389,549,8,557,891,0,3,1,3,0,1,0,76.14,62.51 ,33.33
03,009,01,015,0279,390,572,13,585,858,0,3,1,3,0,1,0,76.14,68.18 ,33.33
03,009,01,015,0280,391,760,10,770,1241,0,3,1,3,0,1,0,76.14,62.05 ,33.33
03,009,01,015,0281,392,583,6,589,973,0,3,1,3,0,1,0,76.14,60.53 ,33.33
03,009,01,016,0282,393,969,12,981,1347,0,3,1,3,0,1,0,76.14,72.83 ,33.33
03,009,01,016,0283,394,655,11,666,985,0,3,1,3,0,1,0,76.14,67.61 ,33.33
03,009,01,016,0284,395,717,11,728,964,0,3,1,3,0,1,0,76.14,75.52 ,33.33
03,009,01,016,0285,396,755,11,766,983,0,3,1,3,0,1,0,76.14,77.92 ,33.33
03,009,01,016,0285,397,586,14,600,839,0,3,1,3,0,1,0,76.14,71.51 ,33.33
03,009,01,016,0286,398,673,9,682,968,0,3,1,3,0,1,0,76.14,70.45 ,33.33
03,009,01,016,0287,399,803,15,818,1557,0,3,1,3,0,1,0,76.14,52.54 ,33.33
03,009,01,016,0288,400,796,8,804,1394,0,3,1,3,0,1,0,76.14,57.68 ,33.33
03,009,01,016,0288,401,450,14,464,719,0,3,1,3,0,1,0,76.14,64.53 ,33.33
03,009,01,016,0289,402,394,7,401,621,0,3,1,3,0,1,0,76.14,64.57 ,33.33
03,009,01,016,0290,403,351,2,353,578,0,3,1,3,0,1,0,76.14,61.07 ,33.33
03,009,01,016,0291,404,516,14,530,696,0,3,1,3,0,1,0,76.14,76.15 ,33.33
03,009,01,016,0292,405,883,7,890,1170,0,3,1,3,0,1,0,76.14,76.07 ,33.33
03,009,01,016,0292,406,489,2,491,618,0,3,1,3,0,1,0,76.14,79.45 ,33.33
03,009,01,016,0293,407,715,10,725,1011,0,3,1,3,0,1,0,76.14,71.71 ,33.33
03,009,01,016,0293,408,418,2,420,528,0,3,1,3,0,1,0,76.14,79.55 ,33.33
03,009,01,016,0294,409,1039,16,1055,1390,0,3,1,3,0,1,0,76.14,75.90 ,33.33
03,009,01,016,0295,410,767,3,770,1050,0,3,1,3,0,1,0,76.14,73.33 ,33.33
03,009,01,016,0295,411,778,10,788,1022,0,3,1,3,0,1,0,76.14,77.10 ,33.33
03,009,01,016,0295,412,709,15,724,1157,0,3,1,3,0,1,0,76.14,62.58 ,33.33
03,009,01,016,0296,413,972,8,980,1220,0,3,1,3,0,1,0,76.14,80.33 ,33.33
03,009,01,016,0296,414,541,4,545,704,0,3,1,3,0,1,0,76.14,77.41 ,33.33
03,009,01,017,0297,415,1022,13,1035,1582,0,3,1,3,0,1,0,76.14,65.42 ,33.33
03,009,01,017,0297,416,772,6,778,1308,0,3,1,3,0,1,0,76.14,59.48 ,33.33
03,009,01,017,0298,417,489,6,495,816,0,3,1,3,0,1,0,76.14,60.66 ,33.33
03,009,01,017,0298,418,438,5,443,768,0,3,1,3,0,1,0,76.14,57.68 ,33.33
03,009,01,017,0299,419,831,6,837,1449,0,3,1,3,0,1,0,76.14,57.76 ,33.33
03,009,01,017,0300,420,482,4,486,765,0,3,1,3,0,1,0,76.14,63.53 ,33.33
03,009,01,017,0301,421,678,5,683,1032,0,3,1,3,0,1,0,76.14,66.18 ,33.33
03,009,01,017,0302,422,646,3,649,1165,0,3,1,3,0,1,0,76.14,55.71 ,33.33
03,009,01,017,0303,423,584,5,589,1059,0,3,1,3,0,1,0,76.14,55.62 ,33.33
03,009,01,017,0304,424,524,6,530,1005,0,3,1,3,0,1,0,76.14,52.74 ,33.33
03,009,01,017,0305,425,434,2,436,720,0,3,1,3,0,1,0,76.14,60.56 ,33.33
03,009,01,017,0306,426,456,3,459,832,0,3,1,3,0,1,0,76.14,55.17 ,33.33
03,009,01,017,0307,427,280,4,284,483,0,3,1,3,0,1,0,76.14,58.80 ,33.33
03,009,01,017,0308,428,688,7,695,1236,0,3,1,3,0,1,0,76.14,56.23 ,33.33
03,009,01,017,0309,429,801,7,808,1491,0,3,1,3,0,1,0,76.14,54.19 ,33.33
03,009,01,017,0310,430,664,5,669,1147,0,3,1,3,0,1,0,76.14,58.33 ,33.33
03,009,01,017,0311,431,519,10,529,931,0,3,1,3,0,1,0,76.14,56.82 ,33.33
03,009,01,017,0312,432,892,7,899,1381,0,3,1,3,0,1,0,76.14,65.10 ,33.33
03,009,01,017,0313,433,630,3,633,1067,0,3,1,3,0,1,0,76.14,59.33 ,33.33
03,009,01,017,0314,434,466,5,471,804,0,3,1,3,0,1,0,76.14,58.58 ,33.33
03,009,01,017,0314,435,574,8,582,910,0,3,1,3,0,1,0,76.14,63.96 ,33.33
03,009,01,017,0315,436,433,3,436,741,0,3,1,3,0,1,0,76.14,58.84 ,33.33
03,009,01,017,0316,437,586,11,597,994,0,3,1,3,0,1,0,76.14,60.06 ,33.33
03,009,01,017,0317,438,487,3,490,747,0,3,1,3,0,1,0,76.14,65.60 ,33.33
03,009,01,018,0318,439,937,9,946,1691,0,3,1,3,0,1,0,76.14,55.94 ,33.33
03,009,01,018,0319,440,894,11,905,1449,0,3,1,3,0,1,0,76.14,62.46 ,33.33
03,009,01,018,0319,441,338,6,344,643,0,3,1,3,0,1,0,76.14,53.50 ,33.33
03,009,01,018,0320,442,425,7,432,777,0,3,1,3,0,1,0,76.14,55.60 ,33.33
03,009,01,018,0321,443,706,10,716,1225,0,3,1,3,0,1,0,76.14,58.45 ,33.33
03,009,01,018,0322,444,572,5,577,1176,0,3,1,3,0,1,0,76.14,49.06 ,33.33
03,009,01,018,0323,445,562,4,566,1042,0,3,1,3,0,1,0,76.14,54.32 ,33.33
03,009,01,018,0324,446,418,6,424,917,0,3,1,3,0,1,0,76.14,46.24 ,33.33
03,009,01,018,0325,447,625,8,633,1330,0,3,1,3,0,1,0,76.14,47.59 ,33.33
03,009,01,018,0326,448,583,10,593,1148,0,3,1,3,0,1,0,76.14,51.66 ,33.33
03,009,01,018,0327,449,396,7,403,1009,0,3,1,3,0,1,0,76.14,39.94 ,33.33
03,009,01,018,0328,450,474,3,477,705,0,3,1,3,0,1,0,76.14,67.66 ,33.33
03,009,01,018,0329,451,848,12,860,1060,0,3,1,3,0,1,0,76.14,81.13 ,33.33
03,009,01,018,0330,452,222,5,227,421,0,3,1,3,0,1,0,76.14,53.92 ,33.33
03,009,01,018,0331,453,534,8,542,996,0,3,1,3,0,1,0,76.14,54.42 ,33.33
03,009,01,018,0331,454,425,7,432,800,0,3,1,3,0,1,0,76.14,54.00 ,33.33
03,009,01,018,0332,455,489,10,499,983,0,3,1,3,0,1,0,76.14,50.76 ,33.33
03,009,01,018,0333,456,454,6,460,784,0,3,1,3,0,1,0,76.14,58.67 ,33.33
03,009,01,018,0334,457,670,8,678,1050,0,3,1,3,0,1,0,76.14,64.57 ,33.33
03,009,01,018,0335,458,726,11,737,1177,0,3,1,3,0,1,0,76.14,62.62 ,33.33
03,009,01,018,0336,459,634,10,644,1347,0,3,1,3,0,1,0,76.14,47.81 ,33.33
03,009,01,018,0337,460,516,9,525,1129,0,3,1,3,0,1,0,76.14,46.50 ,33.33
03,009,01,018,0338,461,414,6,420,917,0,3,1,3,0,1,0,76.14,45.80 ,33.33
03,009,01,019,0339,462,602,4,606,942,0,3,1,3,0,1,0,76.14,64.33 ,33.33
03,009,01,019,0340,463,785,16,801,1252,0,3,1,3,0,1,0,76.14,63.98 ,33.33
03,009,01,019,0341,464,491,5,496,779,0,3,1,3,0,1,0,76.14,63.67 ,33.33
03,009,01,019,0342,465,408,2,410,651,0,3,1,3,0,1,0,76.14,62.98 ,33.33
03,009,01,019,0343,466,481,8,489,957,0,3,1,3,0,1,0,76.14,51.10 ,33.33
03,009,01,019,0344,467,562,8,570,939,0,3,1,3,0,1,0,76.14,60.70 ,33.33
03,009,01,019,0345,468,878,14,892,1419,0,3,1,3,0,1,0,76.14,62.86 ,33.33
03,009,01,019,0346,469,418,18,436,923,0,3,1,3,0,1,0,76.14,47.24 ,33.33
03,009,01,019,0346,470,570,2,572,1037,0,3,1,3,0,1,0,76.14,55.16 ,33.33
03,009,01,019,0347,471,479,12,491,882,0,3,1,3,0,1,0,76.14,55.67 ,33.33
03,009,01,019,0347,472,491,5,496,879,0,3,1,3,0,1,0,76.14,56.43 ,33.33
03,009,01,019,0348,473,861,11,872,1500,0,3,1,3,0,1,0,76.14,58.13 ,33.33
03,009,01,019,0349,474,338,1,339,556,0,3,1,3,0,1,0,76.14,60.97 ,33.33
03,009,01,019,0350,475,899,10,909,1344,0,3,1,3,0,1,0,76.14,67.63 ,33.33
03,009,01,019,0351,476,520,8,528,780,0,3,1,3,0,1,0,76.14,67.69 ,33.33
03,009,01,019,0352,477,206,2,208,347,0,3,1,3,0,1,0,76.14,59.94 ,33.33
03,009,01,019,0352,478,759,9,768,1145,0,3,1,3,0,1,0,76.14,67.07 ,33.33
03,009,01,019,0353,479,697,12,709,1042,0,3,1,3,0,1,0,76.14,68.04 ,33.33
03,009,01,019,0354,480,525,5,530,903,0,3,1,3,0,1,0,76.14,58.69 ,33.33
03,009,01,019,0354,481,556,7,563,932,0,3,1,3,0,1,0,76.14,60.41 ,33.33
03,009,01,019,0355,482,743,6,749,1344,0,3,1,3,0,1,0,76.14,55.73 ,33.33
03,009,01,019,0356,483,627,4,631,1058,0,3,1,3,0,1,0,76.14,59.64 ,33.33
03,009,01,019,0357,484,464,3,467,808,0,3,1,3,0,1,0,76.14,57.80 ,33.33
03,009,01,019,0358,485,560,8,568,993,0,3,1,3,0,1,0,76.14,57.20 ,33.33
03,009,01,019,0359,486,471,4,475,747,0,3,1,3,0,1,0,76.14,63.59 ,33.33
03,009,01,020,0360,487,803,15,818,1290,0,3,1,3,0,1,0,76.14,63.41 ,33.33
03,009,01,020,0360,488,585,14,599,858,0,3,1,3,0,1,0,76.14,69.81 ,33.33
03,009,01,020,0361,489,704,13,717,981,0,3,1,3,0,1,0,76.14,73.09 ,33.33
03,009,01,020,0361,490,516,9,525,789,0,3,1,3,0,1,0,76.14,66.54 ,33.33
03,009,01,020,0362,491,497,9,506,818,0,3,1,3,0,1,0,76.14,61.86 ,33.33
03,009,01,020,0363,492,460,6,466,728,0,3,1,3,0,1,0,76.14,64.01 ,33.33
03,009,01,020,0364,493,737,12,749,1109,0,3,1,3,0,1,0,76.14,67.54 ,33.33
03,009,01,020,0365,494,490,16,506,935,0,3,1,3,0,1,0,76.14,54.12 ,33.33
03,009,01,020,0366,495,802,8,810,1248,0,3,1,3,0,1,0,76.14,64.90 ,33.33
03,009,01,020,0367,496,519,15,534,851,0,3,1,3,0,1,0,76.14,62.75 ,33.33
03,009,01,020,0368,497,628,5,633,1130,0,3,1,3,0,1,0,76.14,56.02 ,33.33
03,009,01,020,0369,498,425,7,432,719,0,3,1,3,0,1,0,76.14,60.08 ,33.33
03,009,01,020,0370,499,409,6,415,722,0,3,1,3,0,1,0,76.14,57.48 ,33.33
03,009,01,020,0371,500,741,11,752,1310,0,3,1,3,0,1,0,76.14,57.40 ,33.33
03,009,01,020,0372,501,443,3,446,801,0,3,1,3,0,1,0,76.14,55.68 ,33.33
03,009,01,020,0373,502,627,8,635,1121,0,3,1,3,0,1,0,76.14,56.65 ,33.33
03,009,01,020,0374,503,598,5,603,1089,0,3,1,3,0,1,0,76.14,55.37 ,33.33
03,009,01,020,0375,504,555,11,566,918,0,3,1,3,0,1,0,76.14,61.66 ,33.33
03,009,01,020,0376,505,764,11,775,1256,0,3,1,3,0,1,0,76.14,61.70 ,33.33
03,009,01,020,0377,506,387,3,390,668,0,3,1,3,0,1,0,76.14,58.38 ,33.33
03,009,01,020,0378,507,500,12,512,915,0,3,1,3,0,1,0,76.14,55.96 ,33.33
03,009,01,020,0379,508,532,6,538,916,0,3,1,3,0,1,0,76.14,58.73 ,33.33
03,009,01,020,0380,509,494,7,501,834,0,3,1,3,0,1,0,76.14,60.07 ,33.33
03,009,01,020,0381,510,727,9,736,1118,0,3,1,3,0,1,0,76.14,65.83 ,33.33
03,009,01,020,0382,511,856,8,864,1300,0,3,1,3,0,1,0,76.14,66.46 ,33.33
03,009,01,020,0383,512,531,7,538,840,0,3,1,3,0,1,0,76.14,64.05 ,33.33
03,010,01,001,0001,1,898,15,913,1478,0,3,1,3,0,1,0,76.14,61.77 ,33.33
03,010,01,001,0002,2,287,3,290,438,0,3,1,3,0,1,0,76.14,66.21 ,33.33
03,010,01,001,0003,3,832,8,840,1354,0,3,1,3,0,1,0,76.14,62.04 ,33.33
03,010,01,001,0004,4,811,10,821,1362,0,3,1,3,0,1,0,76.14,60.28 ,33.33
03,010,01,001,0005,5,489,6,495,698,0,3,1,3,0,1,0,76.14,70.92 ,33.33
03,010,01,001,0005,6,251,6,257,360,0,3,1,3,0,1,0,76.14,71.39 ,33.33
03,010,01,001,0006,7,438,5,443,752,0,3,1,3,0,1,0,76.14,58.91 ,33.33
03,010,01,001,0007,8,523,10,533,772,0,3,1,3,0,1,0,76.14,69.04 ,33.33
03,010,01,001,0008,9,161,0,161,227,0,3,1,3,0,1,0,76.14,70.93 ,33.33
03,010,01,001,0008,10,277,3,280,442,0,3,1,3,0,1,0,76.14,63.35 ,33.33
03,010,01,001,0009,11,520,5,525,856,0,3,1,3,0,1,0,76.14,61.33 ,33.33
03,010,01,001,0010,12,658,14,672,1169,0,3,1,3,0,1,0,76.14,57.49 ,33.33
03,010,01,001,0011,13,478,5,483,904,0,3,1,3,0,1,0,76.14,53.43 ,33.33
03,010,01,001,0012,14,297,9,306,498,0,3,1,3,0,1,0,76.14,61.45 ,33.33
03,010,01,001,0012,15,152,2,154,231,0,3,1,3,0,1,0,76.14,66.67 ,33.33
03,010,01,001,0013,16,194,4,198,326,0,3,1,3,0,1,0,76.14,60.74 ,33.33
03,010,01,001,0013,17,170,3,173,258,0,3,1,3,0,1,0,76.14,67.05 ,33.33
03,010,01,001,0014,18,323,8,331,589,0,3,1,3,0,1,0,76.14,56.20 ,33.33
03,010,01,001,0014,19,548,4,552,943,0,3,1,3,0,1,0,76.14,58.54 ,33.33
03,010,01,001,0015,20,493,18,511,809,0,3,1,3,0,1,0,76.14,63.16 ,33.33
03,010,01,001,0015,21,693,12,705,1259,0,3,1,3,0,1,0,76.14,56.00 ,33.33
03,010,01,001,0016,22,852,13,865,1597,0,3,1,3,0,1,0,76.14,54.16 ,33.33
03,010,01,001,0017,23,1002,18,1020,1891,0,3,1,3,0,1,0,76.14,53.94 ,33.33
03,010,01,001,0018,24,404,9,413,724,0,3,1,3,0,1,0,76.14,57.04 ,33.33
03,010,01,002,0019,25,427,8,435,751,0,3,1,3,0,1,0,76.14,57.92 ,33.33
03,010,01,002,0019,26,632,5,637,1059,0,3,1,3,0,1,0,76.14,60.15 ,33.33
03,010,01,002,0020,27,1023,10,1033,1718,0,3,1,3,0,1,0,76.14,60.13 ,33.33
03,010,01,002,0021,28,726,6,732,1142,0,3,1,3,0,1,0,76.14,64.10 ,33.33
03,010,01,002,0022,29,353,1,354,562,0,3,1,3,0,1,0,76.14,62.99 ,33.33
03,010,01,002,0023,30,435,9,444,782,0,3,1,3,0,1,0,76.14,56.78 ,33.33
03,010,01,002,0024,31,490,5,495,746,0,3,1,3,0,1,0,76.14,66.35 ,33.33
03,010,01,002,0025,32,514,7,521,791,0,3,1,3,0,1,0,76.14,65.87 ,33.33
03,010,01,002,0026,33,544,2,546,916,0,3,1,3,0,1,0,76.14,59.61 ,33.33
03,010,01,002,0026,34,575,6,581,965,0,3,1,3,0,1,0,76.14,60.21 ,33.33
03,010,01,002,0027,35,576,10,586,913,0,3,1,3,0,1,0,76.14,64.18 ,33.33
03,010,01,002,0027,36,820,14,834,1341,0,3,1,3,0,1,0,76.14,62.19 ,33.33
03,010,01,002,0028,37,981,12,993,1610,0,3,1,3,0,1,0,76.14,61.68 ,33.33
03,010,01,002,0028,38,908,14,922,1489,0,3,1,3,0,1,0,76.14,61.92 ,33.33
03,010,01,002,0029,39,395,9,404,600,0,3,1,3,0,1,0,76.14,67.33 ,33.33
03,010,01,002,0030,40,498,1,499,776,0,3,1,3,0,1,0,76.14,64.30 ,33.33
03,010,01,002,0031,41,520,3,523,806,0,3,1,3,0,1,0,76.14,64.89 ,33.33
03,010,01,002,0032,42,621,5,626,955,0,3,1,3,0,1,0,76.14,65.55 ,33.33
03,010,01,002,0033,43,260,8,268,428,0,3,1,3,0,1,0,76.14,62.62 ,33.33
03,010,01,002,0034,44,764,18,782,1200,0,3,1,3,0,1,0,76.14,65.17 ,33.33
03,010,01,002,0034,45,774,14,788,1227,0,3,1,3,0,1,0,76.14,64.22 ,33.33
03,010,01,002,0035,46,944,24,968,1494,0,3,1,3,0,1,0,76.14,64.79 ,33.33
03,010,01,002,0036,47,359,5,364,559,0,3,1,3,0,1,0,76.14,65.12 ,33.33
03,010,01,002,0037,48,505,7,512,921,0,3,1,3,0,1,0,76.14,55.59 ,33.33
03,010,01,002,0038,49,586,8,594,1005,0,3,1,3,0,1,0,76.14,59.10 ,33.33
03,010,01,002,0039,50,516,10,526,911,0,3,1,3,0,1,0,76.14,57.74 ,33.33
03,010,01,002,0040,51,202,1,203,308,0,3,1,3,0,1,0,76.14,65.91 ,33.33
03,010,01,002,0041,52,462,9,471,811,0,3,1,3,0,1,0,76.14,58.08 ,33.33
03,010,01,002,0042,53,366,3,369,569,0,3,1,3,0,1,0,76.14,64.85 ,33.33
03,010,01,002,0043,54,715,9,724,1204,0,3,1,3,0,1,0,76.14,60.13 ,33.33
03,010,01,002,0044,55,830,12,842,1517,0,3,1,3,0,1,0,76.14,55.50 ,33.33
03,010,01,002,0045,56,345,4,349,581,0,3,1,3,0,1,0,76.14,60.07 ,33.33
03,010,01,003,0046,57,443,5,448,809,0,3,1,3,0,1,0,76.14,55.38 ,33.33
03,010,01,003,0047,58,261,5,266,449,0,3,1,3,0,1,0,76.14,59.24 ,33.33
03,010,01,003,0048,59,710,8,718,1170,0,3,1,3,0,1,0,76.14,61.37 ,33.33
03,010,01,003,0049,60,696,19,715,1225,0,3,1,3,0,1,0,76.14,58.37 ,33.33
03,010,01,003,0050,61,1078,16,1094,1805,0,3,1,3,0,1,0,76.14,60.61 ,33.33
03,010,01,003,0051,62,568,7,575,901,0,3,1,3,0,1,0,76.14,63.82 ,33.33
03,010,01,003,0052,63,457,12,469,791,0,3,1,3,0,1,0,76.14,59.29 ,33.33
03,010,01,003,0053,64,514,17,531,921,0,3,1,3,0,1,0,76.14,57.65 ,33.33
03,010,01,003,0054,65,841,7,848,1528,0,3,1,3,0,1,0,76.14,55.50 ,33.33
03,010,01,003,0055,66,865,12,877,1641,0,3,1,3,0,1,0,76.14,53.44 ,33.33
03,010,01,003,0056,67,929,8,937,1608,0,3,1,3,0,1,0,76.14,58.27 ,33.33
03,010,01,003,0057,68,211,1,212,312,0,3,1,3,0,1,0,76.14,67.95 ,33.33
03,010,01,003,0057,69,173,8,181,284,0,3,1,3,0,1,0,76.14,63.73 ,33.33
03,010,01,003,0058,70,270,2,272,471,0,3,1,3,0,1,0,76.14,57.75 ,33.33
03,010,01,003,0058,71,179,2,181,293,0,3,1,3,0,1,0,76.14,61.77 ,33.33
03,010,01,003,0059,72,747,13,760,1332,0,3,1,3,0,1,0,76.14,57.06 ,33.33
03,010,01,003,0060,73,582,13,595,939,0,3,1,3,0,1,0,76.14,63.37 ,33.33
03,010,01,003,0060,74,559,13,572,984,0,3,1,3,0,1,0,76.14,58.13 ,33.33
03,010,01,003,0061,75,228,5,233,399,0,3,1,3,0,1,0,76.14,58.40 ,33.33
03,010,01,003,0062,76,143,0,143,239,0,3,1,3,0,1,0,76.14,59.83 ,33.33
03,010,01,003,0062,77,146,5,151,244,0,3,1,3,0,1,0,76.14,61.89 ,33.33
03,010,01,003,0063,78,103,1,104,166,0,3,1,3,0,1,0,76.14,62.65 ,33.33
03,010,01,003,0063,79,148,0,148,228,0,3,1,3,0,1,0,76.14,64.91 ,33.33
03,010,01,003,0064,80,567,12,579,845,0,3,1,3,0,1,0,76.14,68.52 ,33.33
03,010,01,003,0065,81,648,6,654,994,0,3,1,3,0,1,0,76.14,65.79 ,33.33
03,010,01,003,0066,82,637,6,643,1178,0,3,1,3,0,1,0,76.14,54.58 ,33.33
03,010,01,003,0067,83,579,1,580,1064,0,3,1,3,0,1,0,76.14,54.51 ,33.33
03,010,01,003,0067,84,630,10,640,1211,0,3,1,3,0,1,0,76.14,52.85 ,33.33
03,010,01,003,0068,85,625,8,633,1044,0,3,1,3,0,1,0,76.14,60.63 ,33.33
03,010,01,004,0069,86,335,8,343,546,0,3,1,3,0,1,0,76.14,62.82 ,33.33
03,010,01,004,0070,87,1132,16,1148,1868,0,3,1,3,0,1,0,76.14,61.46 ,33.33
03,010,01,004,0071,88,606,5,611,1032,0,3,1,3,0,1,0,76.14,59.21 ,33.33
03,010,01,004,0072,89,1338,23,1361,2314,0,3,1,3,0,1,0,76.14,58.82 ,33.33
03,010,01,004,0072,90,887,18,905,1594,0,3,1,3,0,1,0,76.14,56.78 ,33.33
03,010,01,004,0073,91,745,10,755,1209,0,3,1,3,0,1,0,76.14,62.45 ,33.33
03,010,01,004,0074,92,763,2,765,1155,0,3,1,3,0,1,0,76.14,66.23 ,33.33
03,010,01,004,0075,93,438,1,439,714,0,3,1,3,0,1,0,76.14,61.48 ,33.33
03,010,01,004,0076,94,452,5,457,890,0,3,1,3,0,1,0,76.14,51.35 ,33.33
03,010,01,004,0077,95,493,11,504,717,0,3,1,3,0,1,0,76.14,70.29 ,33.33
03,010,01,004,0078,96,254,4,258,368,0,3,1,3,0,1,0,76.14,70.11 ,33.33
03,010,01,004,0079,97,1100,21,1121,1806,0,3,1,3,0,1,0,76.14,62.07 ,33.33
03,010,01,004,0080,98,949,19,968,1527,0,3,1,3,0,1,0,76.14,63.39 ,33.33
03,010,01,004,0081,99,804,18,822,1193,0,3,1,3,0,1,0,76.14,68.90 ,33.33
03,010,01,004,0081,100,239,3,242,480,0,3,1,3,0,1,0,76.14,50.42 ,33.33
03,010,01,004,0082,101,613,6,619,972,0,3,1,3,0,1,0,76.14,63.68 ,33.33
03,010,01,004,0083,102,895,12,907,1564,0,3,1,3,0,1,0,76.14,57.99 ,33.33
03,010,01,004,0084,103,1053,7,1060,1719,0,3,1,3,0,1,0,76.14,61.66 ,33.33
03,010,01,004,0085,104,639,13,652,1034,0,3,1,3,0,1,0,76.14,63.06 ,33.33
03,010,01,004,0086,105,434,6,440,701,0,3,1,3,0,1,0,76.14,62.77 ,33.33
03,010,01,004,0087,106,558,8,566,826,0,3,1,3,0,1,0,76.14,68.52 ,33.33
03,010,01,004,0088,107,770,15,785,1191,0,3,1,3,0,1,0,76.14,65.91 ,33.33
03,010,01,004,0089,108,432,7,439,705,0,3,1,3,0,1,0,76.14,62.27 ,33.33
03,010,01,005,0090,109,670,11,681,1101,0,3,1,3,0,1,0,76.14,61.85 ,33.33
03,010,01,005,0090,110,538,2,540,892,0,3,1,3,0,1,0,76.14,60.54 ,33.33
03,010,01,005,0091,111,876,13,889,1518,0,3,1,3,0,1,0,76.14,58.56 ,33.33
03,010,01,005,0092,112,770,7,777,1339,0,3,1,3,0,1,0,76.14,58.03 ,33.33
03,010,01,005,0092,113,782,7,789,1322,0,3,1,3,0,1,0,76.14,59.68 ,33.33
03,010,01,005,0093,114,1042,20,1062,1812,0,3,1,3,0,1,0,76.14,58.61 ,33.33
03,010,01,005,0094,115,652,9,661,1033,0,3,1,3,0,1,0,76.14,63.99 ,33.33
03,010,01,005,0095,116,1161,17,1178,1748,0,3,1,3,0,1,0,76.14,67.39 ,33.33
03,010,01,005,0096,117,772,12,784,1294,0,3,1,3,0,1,0,76.14,60.59 ,33.33
03,010,01,005,0097,118,854,19,873,1342,0,3,1,3,0,1,0,76.14,65.05 ,33.33
03,010,01,005,0097,119,281,2,283,399,0,3,1,3,0,1,0,76.14,70.93 ,33.33
03,010,01,005,0098,120,495,12,507,794,0,3,1,3,0,1,0,76.14,63.85 ,33.33
03,010,01,005,0099,121,331,0,331,626,0,3,1,3,0,1,0,76.14,52.88 ,33.33
03,010,01,005,0100,122,492,8,500,753,0,3,1,3,0,1,0,76.14,66.40 ,33.33
03,010,01,005,0101,123,953,14,967,1624,0,3,1,3,0,1,0,76.14,59.54 ,33.33
03,010,01,005,0102,124,426,11,437,674,0,3,1,3,0,1,0,76.14,64.84 ,33.33
03,010,01,005,0103,125,407,3,410,621,0,3,1,3,0,1,0,76.14,66.02 ,33.33
03,010,01,005,0104,126,411,4,415,695,0,3,1,3,0,1,0,76.14,59.71 ,33.33
03,010,01,005,0105,127,834,20,854,1467,0,3,1,3,0,1,0,76.14,58.21 ,33.33
03,010,01,005,0106,128,989,26,1015,1853,0,3,1,3,0,1,0,76.14,54.78 ,33.33
03,010,01,005,0107,129,1191,17,1208,2066,0,3,1,3,0,1,0,76.14,58.47 ,33.33
03,010,01,005,0108,130,883,23,906,1523,0,3,1,3,0,1,0,76.14,59.49 ,33.33
03,010,01,005,0109,131,1021,18,1039,1783,0,3,1,3,0,1,0,76.14,58.27 ,33.33
03,010,01,005,0110,132,1067,13,1080,1637,0,3,1,3,0,1,0,76.14,65.97 ,33.33
03,010,01,005,0110,133,802,12,814,1269,0,3,1,3,0,1,0,76.14,64.14 ,33.33
03,010,01,005,0111,134,751,4,755,1090,0,3,1,3,0,1,0,76.14,69.27 ,33.33
03,010,01,005,0112,135,1162,20,1182,2183,0,3,1,3,0,1,0,76.14,54.15 ,33.33
03,010,01,005,0112,136,279,5,284,435,0,3,1,3,0,1,0,76.14,65.29 ,33.33
03,010,01,005,0113,137,852,15,867,1376,0,3,1,3,0,1,0,76.14,63.01 ,33.33
03,010,01,005,0114,138,1395,29,1424,2577,0,3,1,3,0,1,0,76.14,55.26 ,33.33
03,010,01,005,0115,139,1055,25,1080,1743,0,3,1,3,0,1,0,76.14,61.96 ,33.33
03,010,01,005,0116,140,1025,17,1042,1758,0,3,1,3,0,1,0,76.14,59.27 ,33.33
03,010,01,005,0117,141,774,7,781,1505,0,3,1,3,0,1,0,76.14,51.89 ,33.33
03,010,01,006,0118,142,806,8,814,1352,0,3,1,3,0,1,0,76.14,60.21 ,33.33
03,010,01,006,0119,143,452,9,461,826,0,3,1,3,0,1,0,76.14,55.81 ,33.33
03,010,01,006,0120,144,245,1,246,414,0,3,1,3,0,1,0,76.14,59.42 ,33.33
03,010,01,006,0120,145,165,3,168,331,0,3,1,3,0,1,0,76.14,50.76 ,33.33
03,010,01,006,0121,146,463,3,466,875,0,3,1,3,0,1,0,76.14,53.26 ,33.33
03,010,01,006,0122,147,509,6,515,976,0,3,1,3,0,1,0,76.14,52.77 ,33.33
03,010,01,006,0123,148,671,11,682,1222,0,3,1,3,0,1,0,76.14,55.81 ,33.33
03,010,01,006,0124,149,528,11,539,1023,0,3,1,3,0,1,0,76.14,52.69 ,33.33
03,010,01,006,0125,150,370,7,377,579,0,3,1,3,0,1,0,76.14,65.11 ,33.33
03,010,01,006,0125,151,259,1,260,378,0,3,1,3,0,1,0,76.14,68.78 ,33.33
03,010,01,006,0126,152,622,10,632,1121,0,3,1,3,0,1,0,76.14,56.38 ,33.33
03,010,01,006,0127,153,409,7,416,802,0,3,1,3,0,1,0,76.14,51.87 ,33.33
03,010,01,006,0128,154,739,12,751,1242,0,3,1,3,0,1,0,76.14,60.47 ,33.33
03,010,01,006,0129,155,522,5,527,949,0,3,1,3,0,1,0,76.14,55.53 ,33.33
03,010,01,006,0130,156,430,3,433,764,0,3,1,3,0,1,0,76.14,56.68 ,33.33
03,010,01,006,0131,157,533,16,549,861,0,3,1,3,0,1,0,76.14,63.76 ,33.33
03,010,01,007,0132,158,908,8,916,1574,0,3,1,3,0,1,0,76.14,58.20 ,33.33
03,010,01,007,0133,159,904,16,920,1697,0,3,1,3,0,1,0,76.14,54.21 ,33.33
03,010,01,007,0134,160,819,11,830,1350,0,3,1,3,0,1,0,76.14,61.48 ,33.33
03,010,01,007,0135,161,749,12,761,1412,0,3,1,3,0,1,0,76.14,53.90 ,33.33
03,010,01,007,0136,162,648,6,654,1178,0,3,1,3,0,1,0,76.14,55.52 ,33.33
03,010,01,007,0137,163,869,9,878,1507,0,3,1,3,0,1,0,76.14,58.26 ,33.33
03,010,01,007,0138,164,906,19,925,1571,0,3,1,3,0,1,0,76.14,58.88 ,33.33
03,010,01,007,0139,165,489,7,496,920,0,3,1,3,0,1,0,76.14,53.91 ,33.33
03,010,01,007,0140,166,921,24,945,1605,0,3,1,3,0,1,0,76.14,58.88 ,33.33
03,010,01,007,0141,167,858,17,875,1434,0,3,1,3,0,1,0,76.14,61.02 ,33.33
03,010,01,007,0142,168,809,12,821,1397,0,3,1,3,0,1,0,76.14,58.77 ,33.33
03,010,01,007,0143,169,489,4,493,808,0,3,1,3,0,1,0,76.14,61.01 ,33.33
03,010,01,007,0144,170,71,8,79,957,0,3,1,3,0,1,0,76.14,8.25 ,33.33
03,010,01,007,0145,171,55,1,56,692,0,3,1,3,0,1,0,76.14,8.09 ,33.33
03,010,01,007,0146,172,674,15,689,1153,0,3,1,3,0,1,0,76.14,59.76 ,33.33
03,010,01,007,0147,173,599,10,609,1155,0,3,1,3,0,1,0,76.14,52.73 ,33.33
03,010,01,007,0148,174,541,27,568,1104,0,3,1,3,0,1,0,76.14,51.45 ,33.33
03,010,01,007,0149,175,380,6,386,666,0,3,1,3,0,1,0,76.14,57.96 ,33.33
03,010,01,007,0150,176,395,4,399,797,0,3,1,3,0,1,0,76.14,50.06 ,33.33
03,010,01,007,0151,177,317,6,323,599,0,3,1,3,0,1,0,76.14,53.92 ,33.33
03,010,01,007,0152,178,517,8,525,979,0,3,1,3,0,1,0,76.14,53.63 ,33.33
03,010,01,007,0153,179,329,2,331,646,0,3,1,3,0,1,0,76.14,51.24 ,33.33
03,010,01,007,0154,180,289,2,291,502,0,3,1,3,0,1,0,76.14,57.97 ,33.33
03,010,01,008,0155,181,784,13,797,1275,0,3,1,3,0,1,0,76.14,62.51 ,33.33
03,010,01,008,0156,182,509,4,513,964,0,3,1,3,0,1,0,76.14,53.22 ,33.33
03,010,01,008,0157,183,500,12,512,867,0,3,1,3,0,1,0,76.14,59.05 ,33.33
03,010,01,008,0158,184,286,14,300,403,0,3,1,3,0,1,0,76.14,74.44 ,33.33
03,010,01,008,0159,185,765,12,777,1251,0,3,1,3,0,1,0,76.14,62.11 ,33.33
03,010,01,008,0160,186,760,8,768,1382,0,3,1,3,0,1,0,76.14,55.57 ,33.33
03,010,01,008,0161,187,490,5,495,869,0,3,1,3,0,1,0,76.14,56.96 ,33.33
03,010,01,008,0162,188,488,4,492,760,0,3,1,3,0,1,0,76.14,64.74 ,33.33
03,010,01,008,0163,189,327,4,331,611,0,3,1,3,0,1,0,76.14,54.17 ,33.33
03,010,01,008,0163,190,115,2,117,202,0,3,1,3,0,1,0,76.14,57.92 ,33.33
03,010,01,008,0164,191,146,1,147,274,0,3,1,3,0,1,0,76.14,53.65 ,33.33
03,010,01,008,0164,192,183,1,184,310,0,3,1,3,0,1,0,76.14,59.35 ,33.33
03,010,01,008,0164,193,242,1,243,407,0,3,1,3,0,1,0,76.14,59.71 ,33.33
03,010,01,008,0164,194,241,5,246,409,0,3,1,3,0,1,0,76.14,60.15 ,33.33
03,010,01,008,0165,195,379,8,387,676,0,3,1,3,0,1,0,76.14,57.25 ,33.33
03,010,01,008,0166,196,445,9,454,805,0,3,1,3,0,1,0,76.14,56.40 ,33.33
03,010,01,008,0167,197,578,9,587,1132,0,3,1,3,0,1,0,76.14,51.86 ,33.33
03,010,01,008,0168,198,461,14,475,825,0,3,1,3,0,1,0,76.14,57.58 ,33.33
03,010,01,008,0169,199,555,7,562,1046,0,3,1,3,0,1,0,76.14,53.73 ,33.33
03,010,01,008,0170,200,753,7,760,1396,0,3,1,3,0,1,0,76.14,54.44 ,33.33
03,010,01,008,0171,201,390,5,395,752,0,3,1,3,0,1,0,76.14,52.53 ,33.33
03,010,01,008,0172,202,333,5,338,618,0,3,1,3,0,1,0,76.14,54.69 ,33.33
03,010,01,008,0173,203,455,3,458,870,0,3,1,3,0,1,0,76.14,52.64 ,33.33
03,010,01,008,0174,204,547,9,556,998,0,3,1,3,0,1,0,76.14,55.71 ,33.33
03,010,01,008,0175,205,539,7,546,975,0,3,1,3,0,1,0,76.14,56.00 ,33.33
03,010,01,008,0176,206,399,5,404,725,0,3,1,3,0,1,0,76.14,55.72 ,33.33
03,010,01,008,0177,207,459,6,465,835,0,3,1,3,0,1,0,76.14,55.69 ,33.33
03,010,01,008,0178,208,512,9,521,936,0,3,1,3,0,1,0,76.14,55.66 ,33.33
03,010,01,008,0179,209,231,2,233,417,0,3,1,3,0,1,0,76.14,55.88 ,33.33
03,010,01,008,0179,210,170,2,172,288,0,3,1,3,0,1,0,76.14,59.72 ,33.33
03,010,01,009,0180,211,893,14,907,1617,0,3,1,3,0,1,0,76.14,56.09 ,33.33
03,010,01,009,0181,212,540,6,546,1010,0,3,1,3,0,1,0,76.14,54.06 ,33.33
03,010,01,009,0182,213,825,15,840,1477,0,3,1,3,0,1,0,76.14,56.87 ,33.33
03,010,01,009,0183,214,869,13,882,1476,0,3,1,3,0,1,0,76.14,59.76 ,33.33
03,010,01,009,0184,215,672,5,677,1251,0,3,1,3,0,1,0,76.14,54.12 ,33.33
03,010,01,009,0185,216,405,4,409,715,0,3,1,3,0,1,0,76.14,57.20 ,33.33
03,010,01,009,0186,217,265,1,266,475,0,3,1,3,0,1,0,76.14,56.00 ,33.33
03,010,01,009,0187,218,602,5,607,1094,0,3,1,3,0,1,0,76.14,55.48 ,33.33
03,010,01,009,0188,219,771,12,783,1132,0,3,1,3,0,1,0,76.14,69.17 ,33.33
03,010,01,009,0189,220,506,9,515,937,0,3,1,3,0,1,0,76.14,54.96 ,33.33
03,010,01,009,0190,221,128,0,128,214,0,3,1,3,0,1,0,76.14,59.81 ,33.33
03,010,01,009,0190,222,118,0,118,266,0,3,1,3,0,1,0,76.14,44.36 ,33.33
03,010,01,009,0191,223,616,9,625,1136,0,3,1,3,0,1,0,76.14,55.02 ,33.33
03,010,01,009,0192,224,223,0,223,418,0,3,1,3,0,1,0,76.14,53.35 ,33.33
03,010,01,009,0193,225,649,13,662,1052,0,3,1,3,0,1,0,76.14,62.93 ,33.33
03,010,01,009,0193,226,185,0,185,332,0,3,1,3,0,1,0,76.14,55.72 ,33.33
03,010,01,009,0194,227,811,14,825,1298,0,3,1,3,0,1,0,76.14,63.56 ,33.33
03,010,01,009,0195,228,601,3,604,938,0,3,1,3,0,1,0,76.14,64.39 ,33.33
03,010,01,009,0196,229,433,11,444,830,0,3,1,3,0,1,0,76.14,53.49 ,33.33
03,010,01,009,0197,230,548,7,555,936,0,3,1,3,0,1,0,76.14,59.29 ,33.33
03,010,01,009,0198,231,242,4,246,428,0,3,1,3,0,1,0,76.14,57.48 ,33.33
03,010,01,009,0198,232,247,5,252,420,0,3,1,3,0,1,0,76.14,60.00 ,33.33
03,010,01,009,0199,233,600,13,613,991,0,3,1,3,0,1,0,76.14,61.86 ,33.33
03,010,01,009,0200,234,589,5,594,1022,0,3,1,3,0,1,0,76.14,58.12 ,33.33
03,010,01,009,0201,235,636,3,639,1211,0,3,1,3,0,1,0,76.14,52.77 ,33.33
03,010,01,009,0202,236,277,1,278,471,0,3,1,3,0,1,0,76.14,59.02 ,33.33
03,010,01,009,0202,237,231,3,234,354,0,3,1,3,0,1,0,76.14,66.10 ,33.33
03,010,01,010,0203,238,575,17,592,869,0,3,1,3,0,1,0,76.14,68.12 ,33.33
03,010,01,010,0204,239,993,18,1011,1597,0,3,1,3,0,1,0,76.14,63.31 ,33.33
03,010,01,010,0205,240,959,9,968,1382,0,3,1,3,0,1,0,76.14,70.04 ,33.33
03,010,01,010,0206,241,677,7,684,898,0,3,1,3,0,1,0,76.14,76.17 ,33.33
03,010,01,010,0207,242,429,8,437,695,0,3,1,3,0,1,0,76.14,62.88 ,33.33
03,010,01,010,0208,243,921,15,936,1316,0,3,1,3,0,1,0,76.14,71.12 ,33.33
03,010,01,010,0209,244,269,2,271,403,0,3,1,3,0,1,0,76.14,67.25 ,33.33
03,010,01,010,0210,245,257,2,259,396,0,3,1,3,0,1,0,76.14,65.40 ,33.33
03,010,01,010,0210,246,91,0,91,137,0,3,1,3,0,1,0,76.14,66.42 ,33.33
03,010,01,010,0211,247,570,9,579,819,0,3,1,3,0,1,0,76.14,70.70 ,33.33
03,010,01,010,0212,248,296,2,298,434,0,3,1,3,0,1,0,76.14,68.66 ,33.33
03,010,01,010,0213,249,376,6,382,546,0,3,1,3,0,1,0,76.14,69.96 ,33.33
03,010,01,010,0214,250,394,2,396,569,0,3,1,3,0,1,0,76.14,69.60 ,33.33
03,010,01,010,0215,251,964,7,971,1479,0,3,1,3,0,1,0,76.14,65.65 ,33.33
03,010,01,010,0216,252,538,8,546,871,0,3,1,3,0,1,0,76.14,62.69 ,33.33
03,010,01,010,0217,253,563,9,572,947,0,3,1,3,0,1,0,76.14,60.40 ,33.33
03,010,01,010,0218,254,552,6,558,835,0,3,1,3,0,1,0,76.14,66.83 ,33.33
03,010,01,010,0219,255,335,5,340,570,0,3,1,3,0,1,0,76.14,59.65 ,33.33
03,010,01,010,0220,256,415,7,422,546,0,3,1,3,0,1,0,76.14,77.29 ,33.33
03,010,01,010,0221,257,491,5,496,727,0,3,1,3,0,1,0,76.14,68.23 ,33.33
03,010,01,010,0221,258,115,3,118,186,0,3,1,3,0,1,0,76.14,63.44 ,33.33
03,010,01,010,0222,259,345,5,350,531,0,3,1,3,0,1,0,76.14,65.91 ,33.33
03,010,01,010,0223,260,479,4,483,773,0,3,1,3,0,1,0,76.14,62.48 ,33.33
03,010,01,010,0224,261,512,4,516,840,0,3,1,3,0,1,0,76.14,61.43 ,33.33
03,010,01,011,0225,262,294,4,298,493,0,3,1,3,0,1,0,76.14,60.45 ,33.33
03,010,01,011,0226,263,408,7,415,659,0,3,1,3,0,1,0,76.14,62.97 ,33.33
03,010,01,011,0227,264,795,10,805,1250,0,3,1,3,0,1,0,76.14,64.40 ,33.33
03,010,01,011,0228,265,689,15,704,1162,0,3,1,3,0,1,0,76.14,60.59 ,33.33
03,010,01,011,0229,266,178,2,180,286,0,3,1,3,0,1,0,76.14,62.94 ,33.33
03,010,01,011,0229,267,72,0,72,127,0,3,1,3,0,1,0,76.14,56.69 ,33.33
03,010,01,011,0230,268,739,10,749,1179,0,3,1,3,0,1,0,76.14,63.53 ,33.33
03,010,01,011,0231,269,326,8,334,561,0,3,1,3,0,1,0,76.14,59.54 ,33.33
03,010,01,011,0232,270,593,6,599,1017,0,3,1,3,0,1,0,76.14,58.90 ,33.33
03,010,01,011,0233,271,680,14,694,1173,0,3,1,3,0,1,0,76.14,59.16 ,33.33
03,010,01,011,0234,272,668,16,684,1149,0,3,1,3,0,1,0,76.14,59.53 ,33.33
03,010,01,011,0235,273,553,11,564,973,0,3,1,3,0,1,0,76.14,57.97 ,33.33
03,010,01,011,0236,274,409,5,414,700,0,3,1,3,0,1,0,76.14,59.14 ,33.33
03,010,01,011,0236,275,126,3,129,237,0,3,1,3,0,1,0,76.14,54.43 ,33.33
03,010,01,011,0237,276,663,11,674,1033,0,3,1,3,0,1,0,76.14,65.25 ,33.33
03,010,01,011,0237,277,196,4,200,317,0,3,1,3,0,1,0,76.14,63.09 ,33.33
03,010,01,011,0238,278,702,12,714,1169,0,3,1,3,0,1,0,76.14,61.08 ,33.33
03,010,01,011,0238,279,237,1,238,364,0,3,1,3,0,1,0,76.14,65.38 ,33.33
03,010,01,011,0239,280,191,2,193,300,0,3,1,3,0,1,0,76.14,64.33 ,33.33
03,010,01,011,0239,281,178,2,180,278,0,3,1,3,0,1,0,76.14,64.75 ,33.33
03,010,01,012,0240,282,767,13,780,1204,0,3,1,3,0,1,0,76.14,64.78 ,33.33
03,010,01,012,0240,283,817,18,835,1322,0,3,1,3,0,1,0,76.14,63.16 ,33.33
03,010,01,012,0241,284,799,14,813,1242,0,3,1,3,0,1,0,76.14,65.46 ,33.33
03,010,01,012,0241,285,326,4,330,492,0,3,1,3,0,1,0,76.14,67.07 ,33.33
03,010,01,012,0242,286,331,2,333,461,0,3,1,3,0,1,0,76.14,72.23 ,33.33
03,010,01,012,0242,287,311,8,319,490,0,3,1,3,0,1,0,76.14,65.10 ,33.33
03,010,01,012,0242,288,200,5,205,323,0,3,1,3,0,1,0,76.14,63.47 ,33.33
03,010,01,012,0243,289,1082,22,1104,1746,0,3,1,3,0,1,0,76.14,63.23 ,33.33
03,010,01,012,0244,290,471,5,476,765,0,3,1,3,0,1,0,76.14,62.22 ,33.33
03,010,01,012,0245,291,611,7,618,995,0,3,1,3,0,1,0,76.14,62.11 ,33.33
03,010,01,012,0245,292,256,2,258,369,0,3,1,3,0,1,0,76.14,69.92 ,33.33
03,010,01,012,0246,293,293,5,298,450,0,3,1,3,0,1,0,76.14,66.22 ,33.33
03,010,01,012,0246,294,668,16,684,1031,0,3,1,3,0,1,0,76.14,66.34 ,33.33
03,010,01,012,0247,295,760,18,778,1124,0,3,1,3,0,1,0,76.14,69.22 ,33.33
03,010,01,012,0247,296,308,3,311,453,0,3,1,3,0,1,0,76.14,68.65 ,33.33
03,010,01,012,0248,297,434,9,443,662,0,3,1,3,0,1,0,76.14,66.92 ,33.33
03,010,01,012,0249,298,438,13,451,691,0,3,1,3,0,1,0,76.14,65.27 ,33.33
03,010,01,012,0250,299,394,4,398,549,0,3,1,3,0,1,0,76.14,72.50 ,33.33
03,010,01,012,0251,300,523,9,532,783,0,3,1,3,0,1,0,76.14,67.94 ,33.33
03,010,01,012,0251,301,227,14,241,381,0,3,1,3,0,1,0,76.14,63.25 ,33.33
03,010,01,012,0252,302,1052,11,1063,1596,0,3,1,3,0,1,0,76.14,66.60 ,33.33
03,010,01,012,0253,303,646,7,653,998,0,3,1,3,0,1,0,76.14,65.43 ,33.33
03,010,01,012,0254,304,1292,40,1332,2004,0,3,1,3,0,1,0,76.14,66.47 ,33.33
03,010,01,012,0255,305,955,18,973,1645,0,3,1,3,0,1,0,76.14,59.15 ,33.33
03,010,01,012,0256,306,994,10,1004,1574,0,3,1,3,0,1,0,76.14,63.79 ,33.33
03,010,01,012,0257,307,567,11,578,888,0,3,1,3,0,1,0,76.14,65.09 ,33.33
03,010,01,012,0258,308,828,10,838,1336,0,3,1,3,0,1,0,76.14,62.72 ,33.33
03,010,01,012,0258,309,720,8,728,1298,0,3,1,3,0,1,0,76.14,56.09 ,33.33
03,010,01,012,0259,310,713,16,729,1207,0,3,1,3,0,1,0,76.14,60.40 ,33.33
03,010,01,012,0259,311,863,19,882,1415,0,3,1,3,0,1,0,76.14,62.33 ,33.33
03,010,01,012,0260,312,487,6,493,729,0,3,1,3,0,1,0,76.14,67.63 ,33.33
03,010,01,012,0261,313,1125,16,1141,1738,0,3,1,3,0,1,0,76.14,65.65 ,33.33
03,010,01,012,0262,314,1094,27,1121,1768,0,3,1,3,0,1,0,76.14,63.40 ,33.33
03,010,01,012,0263,315,475,4,479,830,0,3,1,3,0,1,0,76.14,57.71 ,33.33
03,010,01,012,0264,316,650,8,658,1017,0,3,1,3,0,1,0,76.14,64.70 ,33.33
03,010,01,012,0265,317,715,10,725,1263,0,3,1,3,0,1,0,76.14,57.40 ,33.33
03,010,01,013,0266,318,981,21,1002,1533,0,3,1,3,0,1,0,76.14,65.36 ,33.33
03,010,01,013,0267,319,430,6,436,746,0,3,1,3,0,1,0,76.14,58.45 ,33.33
03,010,01,013,0268,320,450,12,462,712,0,3,1,3,0,1,0,76.14,64.89 ,33.33
03,010,01,013,0269,321,455,14,469,818,0,3,1,3,0,1,0,76.14,57.33 ,33.33
03,010,01,013,0270,322,747,13,760,1278,0,3,1,3,0,1,0,76.14,59.47 ,33.33
03,010,01,013,0271,323,561,6,567,1004,0,3,1,3,0,1,0,76.14,56.47 ,33.33
03,010,01,013,0271,324,695,8,703,1147,0,3,1,3,0,1,0,76.14,61.29 ,33.33
03,010,01,013,0272,325,1121,15,1136,2105,0,3,1,3,0,1,0,76.14,53.97 ,33.33
03,010,01,013,0273,326,881,17,898,1544,0,3,1,3,0,1,0,76.14,58.16 ,33.33
03,010,01,013,0273,327,799,13,812,1519,0,3,1,3,0,1,0,76.14,53.46 ,33.33
03,010,01,013,0273,328,875,16,891,1618,0,3,1,3,0,1,0,76.14,55.07 ,33.33
03,010,01,013,0274,329,1038,13,1051,2036,0,3,1,3,0,1,0,76.14,51.62 ,33.33
03,010,01,013,0274,330,1123,23,1146,2241,0,3,1,3,0,1,0,76.14,51.14 ,33.33
03,010,01,013,0275,331,958,17,975,1588,0,3,1,3,0,1,0,76.14,61.40 ,33.33
03,010,01,013,0276,332,745,12,757,1208,0,3,1,3,0,1,0,76.14,62.67 ,33.33
03,010,01,013,0277,333,909,5,914,1513,0,3,1,3,0,1,0,76.14,60.41 ,33.33
03,010,01,013,0277,334,265,3,268,455,0,3,1,3,0,1,0,76.14,58.90 ,33.33
03,010,01,013,0278,335,721,7,728,1111,0,3,1,3,0,1,0,76.14,65.53 ,33.33
03,010,01,013,0279,336,586,7,593,835,0,3,1,3,0,1,0,76.14,71.02 ,33.33
03,010,01,013,0279,337,228,3,231,319,0,3,1,3,0,1,0,76.14,72.41 ,33.33
03,010,01,013,0280,338,570,7,577,907,0,3,1,3,0,1,0,76.14,63.62 ,33.33
03,010,01,013,0281,339,733,7,740,1175,0,3,1,3,0,1,0,76.14,62.98 ,33.33
03,010,01,013,0281,340,411,10,421,643,0,3,1,3,0,1,0,76.14,65.47 ,33.33
03,010,01,013,0282,341,521,6,527,726,0,3,1,3,0,1,0,76.14,72.59 ,33.33
03,010,01,013,0283,342,407,3,410,622,0,3,1,3,0,1,0,76.14,65.92 ,33.33
03,010,01,013,0284,343,475,2,477,703,0,3,1,3,0,1,0,76.14,67.85 ,33.33
03,010,01,013,0285,344,356,0,356,538,0,3,1,3,0,1,0,76.14,66.17 ,33.33
03,010,01,013,0285,345,382,6,388,574,0,3,1,3,0,1,0,76.14,67.60 ,33.33
03,010,01,013,0286,346,200,2,202,317,0,3,1,3,0,1,0,76.14,63.72 ,33.33
03,010,01,013,0287,347,217,2,219,331,0,3,1,3,0,1,0,76.14,66.16 ,33.33
03,010,01,014,0288,348,656,17,673,1059,0,3,1,3,0,1,0,76.14,63.55 ,33.33
03,010,01,014,0288,349,591,15,606,979,0,3,1,3,0,1,0,76.14,61.90 ,33.33
03,010,01,014,0289,350,1085,15,1100,1686,0,3,1,3,0,1,0,76.14,65.24 ,33.33
03,010,01,014,0290,351,414,2,416,737,0,3,1,3,0,1,0,76.14,56.45 ,33.33
03,010,01,014,0291,352,543,12,555,840,0,3,1,3,0,1,0,76.14,66.07 ,33.33
03,010,01,014,0292,353,731,5,736,1256,0,3,1,3,0,1,0,76.14,58.60 ,33.33
03,010,01,014,0293,354,366,3,369,542,0,3,1,3,0,1,0,76.14,68.08 ,33.33
03,010,01,014,0294,355,642,6,648,1027,0,3,1,3,0,1,0,76.14,63.10 ,33.33
03,010,01,014,0295,356,665,5,670,1074,0,3,1,3,0,1,0,76.14,62.38 ,33.33
03,010,01,014,0295,357,1006,8,1014,1569,0,3,1,3,0,1,0,76.14,64.63 ,33.33
03,010,01,014,0295,358,833,8,841,1506,0,3,1,3,0,1,0,76.14,55.84 ,33.33
03,010,01,014,0296,359,754,13,767,1256,0,3,1,3,0,1,0,76.14,61.07 ,33.33
03,010,01,014,0297,360,845,5,850,1292,0,3,1,3,0,1,0,76.14,65.79 ,33.33
03,010,01,014,0298,361,1010,10,1020,1560,0,3,1,3,0,1,0,76.14,65.38 ,33.33
03,010,01,014,0299,362,476,3,479,677,0,3,1,3,0,1,0,76.14,70.75 ,33.33
03,010,01,014,0299,363,652,18,670,994,0,3,1,3,0,1,0,76.14,67.40 ,33.33
03,010,01,014,0300,364,478,4,482,737,0,3,1,3,0,1,0,76.14,65.40 ,33.33
03,010,01,014,0300,365,245,0,245,371,0,3,1,3,0,1,0,76.14,66.04 ,33.33
03,010,01,014,0301,366,481,5,486,737,0,3,1,3,0,1,0,76.14,65.94 ,33.33
03,010,01,014,0302,367,323,5,328,490,0,3,1,3,0,1,0,76.14,66.94 ,33.33
03,010,01,014,0302,368,259,1,260,403,0,3,1,3,0,1,0,76.14,64.52 ,33.33
03,010,01,014,0303,369,343,3,346,535,0,3,1,3,0,1,0,76.14,64.67 ,33.33
03,010,01,014,0304,370,145,0,145,234,0,3,1,3,0,1,0,76.14,61.97 ,33.33
03,010,01,014,0305,371,828,15,843,1358,0,3,1,3,0,1,0,76.14,62.08 ,33.33
03,010,01,014,0306,372,485,10,495,844,0,3,1,3,0,1,0,76.14,58.65 ,33.33
03,010,01,014,0307,373,288,4,292,524,0,3,1,3,0,1,0,76.14,55.73 ,33.33
03,010,01,014,0307,374,1050,11,1061,1770,0,3,1,3,0,1,0,76.14,59.94 ,33.33
03,010,01,014,0308,375,490,11,501,973,0,3,1,3,0,1,0,76.14,51.49 ,33.33
03,010,01,014,0308,376,82,1,83,152,0,3,1,3,0,1,0,76.14,54.61 ,33.33
03,010,01,014,0309,377,167,1,168,349,0,3,1,3,0,1,0,76.14,48.14 ,33.33
03,010,01,014,0310,378,232,3,235,423,0,3,1,3,0,1,0,76.14,55.56 ,33.33
03,010,01,014,0310,379,274,1,275,386,0,3,1,3,0,1,0,76.14,71.24 ,33.33
03,010,01,014,0311,380,294,3,297,428,0,3,1,3,0,1,0,76.14,69.39 ,33.33
03,010,01,014,0311,381,168,1,169,331,0,3,1,3,0,1,0,76.14,51.06 ,33.33
03,010,01,015,0312,382,576,14,590,972,0,3,1,3,0,1,0,76.14,60.70 ,33.33
03,010,01,015,0312,383,845,14,859,1527,0,3,1,3,0,1,0,76.14,56.25 ,33.33
03,010,01,015,0313,384,654,14,668,1010,0,3,1,3,0,1,0,76.14,66.14 ,33.33
03,010,01,015,0314,385,774,8,782,1345,0,3,1,3,0,1,0,76.14,58.14 ,33.33
03,010,01,015,0314,386,1197,18,1215,2079,0,3,1,3,0,1,0,76.14,58.44 ,33.33
03,010,01,015,0315,387,394,6,400,597,0,3,1,3,0,1,0,76.14,67.00 ,33.33
03,010,01,015,0316,388,334,4,338,547,0,3,1,3,0,1,0,76.14,61.79 ,33.33
03,010,01,015,0317,389,438,3,441,720,0,3,1,3,0,1,0,76.14,61.25 ,33.33
03,010,01,015,0318,390,410,4,414,589,0,3,1,3,0,1,0,76.14,70.29 ,33.33
03,010,01,015,0319,391,999,16,1015,1701,0,3,1,3,0,1,0,76.14,59.67 ,33.33
03,010,01,015,0320,392,552,9,561,972,0,3,1,3,0,1,0,76.14,57.72 ,33.33
03,010,01,015,0321,393,276,2,278,535,0,3,1,3,0,1,0,76.14,51.96 ,33.33
03,010,01,015,0322,394,296,4,300,489,0,3,1,3,0,1,0,76.14,61.35 ,33.33
03,010,01,015,0323,395,331,10,341,532,0,3,1,3,0,1,0,76.14,64.10 ,33.33
03,010,01,015,0324,396,280,1,281,413,0,3,1,3,0,1,0,76.14,68.04 ,33.33
03,010,01,015,0325,397,319,7,326,489,0,3,1,3,0,1,0,76.14,66.67 ,33.33
03,010,01,015,0326,398,198,3,201,353,0,3,1,3,0,1,0,76.14,56.94 ,33.33
03,010,01,015,0327,399,457,4,461,717,0,3,1,3,0,1,0,76.14,64.30 ,33.33
03,010,01,015,0328,400,478,20,498,730,0,3,1,3,0,1,0,76.14,68.22 ,33.33
03,010,01,015,0329,401,353,5,358,559,0,3,1,3,0,1,0,76.14,64.04 ,33.33
03,010,01,015,0329,402,297,8,305,468,0,3,1,3,0,1,0,76.14,65.17 ,33.33
03,010,01,016,0330,403,573,8,581,878,0,3,1,3,0,1,0,76.14,66.17 ,33.33
03,010,01,016,0331,404,213,2,215,352,0,3,1,3,0,1,0,76.14,61.08 ,33.33
03,010,01,016,0332,405,510,3,513,743,0,3,1,3,0,1,0,76.14,69.04 ,33.33
03,010,01,016,0333,406,925,10,935,1450,0,3,1,3,0,1,0,76.14,64.48 ,33.33
03,010,01,016,0334,407,529,8,537,794,0,3,1,3,0,1,0,76.14,67.63 ,33.33
03,010,01,016,0335,408,503,9,512,783,0,3,1,3,0,1,0,76.14,65.39 ,33.33
03,010,01,016,0336,409,597,8,605,865,0,3,1,3,0,1,0,76.14,69.94 ,33.33
03,010,01,016,0337,410,486,1,487,884,0,3,1,3,0,1,0,76.14,55.09 ,33.33
03,010,01,016,0338,411,239,1,240,416,0,3,1,3,0,1,0,76.14,57.69 ,33.33
03,010,01,016,0338,412,266,7,273,467,0,3,1,3,0,1,0,76.14,58.46 ,33.33
03,010,01,016,0339,413,310,4,314,575,0,3,1,3,0,1,0,76.14,54.61 ,33.33
03,010,01,016,0340,414,108,0,108,142,0,3,1,3,0,1,0,76.14,76.06 ,33.33
03,010,01,016,0340,415,141,0,141,208,0,3,1,3,0,1,0,76.14,67.79 ,33.33
03,010,01,017,0341,416,454,64,518,981,0,3,1,3,0,1,0,76.14,52.80 ,33.33
03,010,01,017,0342,417,129,7,136,248,0,3,1,3,0,1,0,76.14,54.84 ,33.33
03,010,01,017,0342,418,98,30,128,242,0,3,1,3,0,1,0,76.14,52.89 ,33.33
03,010,01,017,0343,419,77,11,88,152,0,3,1,3,0,1,0,76.14,57.89 ,33.33
03,010,01,017,0343,420,93,2,95,153,0,3,1,3,0,1,0,76.14,62.09 ,33.33
03,010,01,017,0344,421,167,8,175,342,0,3,1,3,0,1,0,76.14,51.17 ,33.33
03,010,01,017,0344,422,79,3,82,144,0,3,1,3,0,1,0,76.14,56.94 ,33.33
03,010,01,017,0344,423,86,6,92,214,0,3,1,3,0,1,0,76.14,42.99 ,33.33
03,010,01,017,0345,424,202,5,207,358,0,3,1,3,0,1,0,76.14,57.82 ,33.33
03,010,01,018,0346,425,213,2,215,374,0,3,1,3,0,1,0,76.14,57.49 ,33.33
03,010,01,018,0347,426,104,2,106,206,0,3,1,3,0,1,0,76.14,51.46 ,33.33
03,010,01,018,0348,427,121,2,123,238,0,3,1,3,0,1,0,76.14,51.68 ,33.33
03,010,01,018,0349,428,115,2,117,238,0,3,1,3,0,1,0,76.14,49.16 ,33.33
03,010,01,018,0350,429,58,0,58,149,0,3,1,3,0,1,0,76.14,38.93 ,33.33
03,010,01,018,0351,430,129,0,129,234,0,3,1,3,0,1,0,76.14,55.13 ,33.33
03,010,01,018,0352,431,14,0,14,99,0,3,1,3,0,1,0,76.14,14.14 ,33.33
03,010,01,018,0353,432,162,1,163,264,0,3,1,3,0,1,0,76.14,61.74 ,33.33
03,010,01,018,0354,433,8,0,8,27,0,3,1,3,0,1,0,76.14,29.63 ,33.33
03,010,01,018,0355,434,12,1,13,24,0,3,1,3,0,1,0,76.14,54.17 ,33.33
03,010,01,018,0356,435,8,0,8,20,0,3,1,3,0,1,0,76.14,40.00 ,33.33
03,010,01,018,0357,436,55,0,55,100,0,3,1,3,0,1,0,76.14,55.00 ,33.33
03,011,01,001,0001,1,676,9,685,1071,0,3,1,3,0,1,0,76.14,63.96 ,33.33
03,011,01,001,0001,2,754,12,766,1187,0,3,1,3,0,1,0,76.14,64.53 ,33.33
03,011,01,001,0001,3,780,5,785,1204,0,3,1,3,0,1,0,76.14,65.20 ,33.33
03,011,01,001,0001,4,868,8,876,1354,0,3,1,3,0,1,0,76.14,64.70 ,33.33
03,011,01,001,0002,5,886,9,895,1379,0,3,1,3,0,1,0,76.14,64.90 ,33.33
03,011,01,001,0003,6,745,6,751,1224,0,3,1,3,0,1,0,76.14,61.36 ,33.33
03,011,01,001,0003,7,754,12,766,1270,0,3,1,3,0,1,0,76.14,60.31 ,33.33
03,011,01,001,0004,8,527,10,537,952,0,3,1,3,0,1,0,76.14,56.41 ,33.33
03,011,01,001,0005,9,790,15,805,1382,0,3,1,3,0,1,0,76.14,58.25 ,33.33
03,011,01,001,0006,10,732,4,736,1051,0,3,1,3,0,1,0,76.14,70.03 ,33.33
03,011,01,001,0007,11,577,8,585,910,0,3,1,3,0,1,0,76.14,64.29 ,33.33
03,011,01,001,0007,12,588,7,595,973,0,3,1,3,0,1,0,76.14,61.15 ,33.33
03,011,01,001,0007,13,711,8,719,1212,0,3,1,3,0,1,0,76.14,59.32 ,33.33
03,011,01,001,0008,14,852,7,859,1427,0,3,1,3,0,1,0,76.14,60.20 ,33.33
03,011,01,001,0008,15,828,11,839,1342,0,3,1,3,0,1,0,76.14,62.52 ,33.33
03,011,01,001,0008,16,916,12,928,1494,0,3,1,3,0,1,0,76.14,62.12 ,33.33
03,011,01,001,0009,17,520,5,525,855,0,3,1,3,0,1,0,76.14,61.40 ,33.33
03,011,01,001,0009,18,488,15,503,791,0,3,1,3,0,1,0,76.14,63.59 ,33.33
03,011,01,001,0010,19,979,13,992,1465,0,3,1,3,0,1,0,76.14,67.71 ,33.33
03,011,01,001,0011,20,81,1,82,121,0,3,1,3,0,1,0,76.14,67.77 ,33.33
03,011,01,001,0012,21,734,13,747,1145,0,3,1,3,0,1,0,76.14,65.24 ,33.33
03,011,01,001,0012,22,829,10,839,1337,0,3,1,3,0,1,0,76.14,62.75 ,33.33
03,011,01,001,0013,23,790,16,806,1153,0,3,1,3,0,1,0,76.14,69.90 ,33.33
03,011,01,001,0014,24,716,8,724,1199,0,3,1,3,0,1,0,76.14,60.38 ,33.33
03,011,01,001,0014,25,706,6,712,1262,0,3,1,3,0,1,0,76.14,56.42 ,33.33
03,011,01,001,0014,26,742,6,748,1274,0,3,1,3,0,1,0,76.14,58.71 ,33.33
03,011,01,001,0014,27,691,11,702,1266,0,3,1,3,0,1,0,76.14,55.45 ,33.33
03,011,01,001,0014,28,711,12,723,1174,0,3,1,3,0,1,0,76.14,61.58 ,33.33
03,011,01,001,0014,29,770,11,781,1208,0,3,1,3,0,1,0,76.14,64.65 ,33.33
03,011,01,001,0015,30,575,9,584,919,0,3,1,3,0,1,0,76.14,63.55 ,33.33
03,011,01,001,0015,31,671,7,678,1160,0,3,1,3,0,1,0,76.14,58.45 ,33.33
03,011,01,001,0015,32,791,9,800,1328,0,3,1,3,0,1,0,76.14,60.24 ,33.33
03,011,01,001,0016,33,748,7,755,1153,0,3,1,3,0,1,0,76.14,65.48 ,33.33
03,011,01,001,0016,34,635,10,645,854,0,3,1,3,0,1,0,76.14,75.53 ,33.33
03,011,01,001,0017,35,732,9,741,1161,0,3,1,3,0,1,0,76.14,63.82 ,33.33
03,011,01,001,0018,36,882,15,897,1336,0,3,1,3,0,1,0,76.14,67.14 ,33.33
03,011,01,001,0019,37,912,9,921,1405,0,3,1,3,0,1,0,76.14,65.55 ,33.33
03,011,01,001,0020,38,541,9,550,830,0,3,1,3,0,1,0,76.14,66.27 ,33.33
03,011,01,001,0020,39,737,14,751,1178,0,3,1,3,0,1,0,76.14,63.75 ,33.33
03,011,01,001,0021,40,813,18,831,1336,0,3,1,3,0,1,0,76.14,62.20 ,33.33
03,011,01,001,0022,41,271,0,271,391,0,3,1,3,0,1,0,76.14,69.31 ,33.33
03,011,01,001,0023,42,346,1,347,462,0,3,1,3,0,1,0,76.14,75.11 ,33.33
03,011,01,001,0024,43,499,6,505,783,0,3,1,3,0,1,0,76.14,64.50 ,33.33
03,011,01,001,0025,44,626,10,636,986,0,3,1,3,0,1,0,76.14,64.50 ,33.33
03,011,01,001,0026,45,424,3,427,608,0,3,1,3,0,1,0,76.14,70.23 ,33.33
03,011,01,002,0027,46,512,8,520,818,0,3,1,3,0,1,0,76.14,63.57 ,33.33
03,011,01,002,0027,47,334,2,336,522,0,3,1,3,0,1,0,76.14,64.37 ,33.33
03,011,01,002,0028,48,366,4,370,549,0,3,1,3,0,1,0,76.14,67.40 ,33.33
03,011,01,002,0029,49,248,4,252,372,0,3,1,3,0,1,0,76.14,67.74 ,33.33
03,011,01,002,0030,50,394,6,400,604,0,3,1,3,0,1,0,76.14,66.23 ,33.33
03,011,01,002,0031,51,356,30,386,581,0,3,1,3,0,1,0,76.14,66.44 ,33.33
03,011,01,002,0032,52,274,2,276,433,0,3,1,3,0,1,0,76.14,63.74 ,33.33
03,011,01,002,0033,53,516,5,521,764,0,3,1,3,0,1,0,76.14,68.19 ,33.33
03,011,01,002,0034,54,911,13,924,1506,0,3,1,3,0,1,0,76.14,61.35 ,33.33
03,011,01,002,0034,55,690,5,695,1105,0,3,1,3,0,1,0,76.14,62.90 ,33.33
03,011,01,002,0035,56,462,7,469,687,0,3,1,3,0,1,0,76.14,68.27 ,33.33
03,011,01,002,0036,57,628,13,641,1083,0,3,1,3,0,1,0,76.14,59.19 ,33.33
03,011,01,002,0037,58,1035,18,1053,1652,0,3,1,3,0,1,0,76.14,63.74 ,33.33
03,011,01,002,0037,59,769,9,778,1269,0,3,1,3,0,1,0,76.14,61.31 ,33.33
03,011,01,002,0038,60,405,5,410,589,0,3,1,3,0,1,0,76.14,69.61 ,33.33
03,011,01,002,0039,61,496,9,505,781,0,3,1,3,0,1,0,76.14,64.66 ,33.33
03,011,01,002,0040,62,434,7,441,727,0,3,1,3,0,1,0,76.14,60.66 ,33.33
03,011,01,002,0040,63,414,3,417,767,0,3,1,3,0,1,0,76.14,54.37 ,33.33
03,011,01,002,0041,64,346,1,347,569,0,3,1,3,0,1,0,76.14,60.98 ,33.33
03,011,01,002,0042,65,189,1,190,297,0,3,1,3,0,1,0,76.14,63.97 ,33.33
03,011,01,002,0043,66,465,8,473,686,0,3,1,3,0,1,0,76.14,68.95 ,33.33
03,011,01,002,0044,67,333,4,337,521,0,3,1,3,0,1,0,76.14,64.68 ,33.33
03,011,01,002,0045,68,617,10,627,876,0,3,1,3,0,1,0,76.14,71.58 ,33.33
03,011,01,002,0046,69,261,3,264,439,0,3,1,3,0,1,0,76.14,60.14 ,33.33
03,011,01,002,0047,70,207,5,212,290,0,3,1,3,0,1,0,76.14,73.10 ,33.33
03,011,01,002,0048,71,255,1,256,383,0,3,1,3,0,1,0,76.14,66.84 ,33.33
03,011,01,002,0049,72,286,1,287,427,0,3,1,3,0,1,0,76.14,67.21 ,33.33
03,011,01,002,0050,73,405,4,409,641,0,3,1,3,0,1,0,76.14,63.81 ,33.33
03,011,01,002,0051,74,672,14,686,951,0,3,1,3,0,1,0,76.14,72.13 ,33.33
03,011,01,003,0052,75,815,6,821,1285,0,3,1,3,0,1,0,76.14,63.89 ,33.33
03,011,01,003,0052,76,427,10,437,659,0,3,1,3,0,1,0,76.14,66.31 ,33.33
03,011,01,003,0053,77,875,7,882,1442,0,3,1,3,0,1,0,76.14,61.17 ,33.33
03,011,01,003,0053,78,743,3,746,1112,0,3,1,3,0,1,0,76.14,67.09 ,33.33
03,011,01,003,0054,79,909,17,926,1458,0,3,1,3,0,1,0,76.14,63.51 ,33.33
03,011,01,003,0055,80,914,16,930,1489,0,3,1,3,0,1,0,76.14,62.46 ,33.33
03,011,01,003,0056,81,528,8,536,811,0,3,1,3,0,1,0,76.14,66.09 ,33.33
03,011,01,003,0057,82,838,8,846,1388,0,3,1,3,0,1,0,76.14,60.95 ,33.33
03,011,01,003,0058,83,301,5,306,493,0,3,1,3,0,1,0,76.14,62.07 ,33.33
03,011,01,003,0059,84,369,5,374,637,0,3,1,3,0,1,0,76.14,58.71 ,33.33
03,011,01,003,0060,85,340,2,342,495,0,3,1,3,0,1,0,76.14,69.09 ,33.33
03,011,01,003,0061,86,366,4,370,658,0,3,1,3,0,1,0,76.14,56.23 ,33.33
03,011,01,003,0062,87,796,10,806,1325,0,3,1,3,0,1,0,76.14,60.83 ,33.33
03,011,01,003,0063,88,499,4,503,830,0,3,1,3,0,1,0,76.14,60.60 ,33.33
03,011,01,003,0063,89,348,10,358,613,0,3,1,3,0,1,0,76.14,58.40 ,33.33
03,011,01,003,0063,90,452,13,465,592,0,3,1,3,0,1,0,76.14,78.55 ,33.33
03,011,01,003,0063,91,410,10,420,563,0,3,1,3,0,1,0,76.14,74.60 ,33.33
03,011,01,003,0064,92,765,8,773,1174,0,3,1,3,0,1,0,76.14,65.84 ,33.33
03,011,01,003,0065,93,881,4,885,1349,0,3,1,3,0,1,0,76.14,65.60 ,33.33
03,011,01,003,0066,94,617,11,628,898,0,3,1,3,0,1,0,76.14,69.93 ,33.33
03,011,01,003,0067,95,442,9,451,691,0,3,1,3,0,1,0,76.14,65.27 ,33.33
03,011,01,003,0068,96,658,8,666,938,0,3,1,3,0,1,0,76.14,71.00 ,33.33
03,011,01,003,0069,97,686,6,692,982,0,3,1,3,0,1,0,76.14,70.47 ,33.33
03,011,01,003,0070,98,529,9,538,872,0,3,1,3,0,1,0,76.14,61.70 ,33.33
03,011,01,003,0071,99,778,14,792,1257,0,3,1,3,0,1,0,76.14,63.01 ,33.33
03,011,01,003,0072,100,509,10,519,814,0,3,1,3,0,1,0,76.14,63.76 ,33.33
03,011,01,003,0073,101,586,8,594,815,0,3,1,3,0,1,0,76.14,72.88 ,33.33
03,011,01,003,0074,102,632,7,639,960,0,3,1,3,0,1,0,76.14,66.56 ,33.33
03,011,01,003,0075,103,458,10,468,763,0,3,1,3,0,1,0,76.14,61.34 ,33.33
03,011,01,004,0076,104,828,9,837,1267,0,3,1,3,0,1,0,76.14,66.06 ,33.33
03,011,01,004,0077,105,554,13,567,825,0,3,1,3,0,1,0,76.14,68.73 ,33.33
03,011,01,004,0077,106,603,11,614,913,0,3,1,3,0,1,0,76.14,67.25 ,33.33
03,011,01,004,0078,107,488,4,492,693,0,3,1,3,0,1,0,76.14,71.00 ,33.33
03,011,01,004,0079,108,749,5,754,1069,0,3,1,3,0,1,0,76.14,70.53 ,33.33
03,011,01,004,0079,109,833,12,845,1195,0,3,1,3,0,1,0,76.14,70.71 ,33.33
03,011,01,004,0080,110,780,11,791,1191,0,3,1,3,0,1,0,76.14,66.41 ,33.33
03,011,01,004,0081,111,298,2,300,481,0,3,1,3,0,1,0,76.14,62.37 ,33.33
03,011,01,004,0081,112,229,1,230,311,0,3,1,3,0,1,0,76.14,73.95 ,33.33
03,011,01,004,0082,113,1052,12,1064,1489,0,3,1,3,0,1,0,76.14,71.46 ,33.33
03,011,01,004,0083,114,880,7,887,1422,0,3,1,3,0,1,0,76.14,62.38 ,33.33
03,011,01,004,0083,115,212,1,213,312,0,3,1,3,0,1,0,76.14,68.27 ,33.33
03,011,01,004,0084,116,862,14,876,1390,0,3,1,3,0,1,0,76.14,63.02 ,33.33
03,011,01,004,0085,117,457,7,464,652,0,3,1,3,0,1,0,76.14,71.17 ,33.33
03,011,01,004,0086,118,742,9,751,1188,0,3,1,3,0,1,0,76.14,63.22 ,33.33
03,011,01,004,0086,119,147,3,150,232,0,3,1,3,0,1,0,76.14,64.66 ,33.33
03,011,01,004,0087,120,823,14,837,1260,0,3,1,3,0,1,0,76.14,66.43 ,33.33
03,011,01,004,0088,121,668,9,677,1017,0,3,1,3,0,1,0,76.14,66.57 ,33.33
03,011,01,004,0088,122,352,3,355,486,0,3,1,3,0,1,0,76.14,73.05 ,33.33
03,011,01,004,0088,123,150,4,154,205,0,3,1,3,0,1,0,76.14,75.12 ,33.33
03,011,01,005,0089,124,419,3,422,686,0,3,1,3,0,1,0,76.14,61.52 ,33.33
03,011,01,005,0089,125,508,9,517,748,0,3,1,3,0,1,0,76.14,69.12 ,33.33
03,011,01,005,0090,126,841,7,848,1202,0,3,1,3,0,1,0,76.14,70.55 ,33.33
03,011,01,005,0091,127,695,2,697,1057,0,3,1,3,0,1,0,76.14,65.94 ,33.33
03,011,01,005,0091,128,152,6,158,252,0,3,1,3,0,1,0,76.14,62.70 ,33.33
03,011,01,005,0092,129,915,18,933,1300,0,3,1,3,0,1,0,76.14,71.77 ,33.33
03,011,01,005,0093,130,732,6,738,1176,0,3,1,3,0,1,0,76.14,62.76 ,33.33
03,011,01,005,0094,131,805,17,822,1229,0,3,1,3,0,1,0,76.14,66.88 ,33.33
03,011,01,005,0095,132,581,5,586,832,0,3,1,3,0,1,0,76.14,70.43 ,33.33
03,011,01,005,0096,133,396,4,400,566,0,3,1,3,0,1,0,76.14,70.67 ,33.33
03,011,01,005,0097,134,365,24,389,654,0,3,1,3,0,1,0,76.14,59.48 ,33.33
03,011,01,005,0098,135,584,9,593,862,0,3,1,3,0,1,0,76.14,68.79 ,33.33
03,011,01,005,0099,136,357,3,360,501,0,3,1,3,0,1,0,76.14,71.86 ,33.33
03,011,01,005,0100,137,769,9,778,1227,0,3,1,3,0,1,0,76.14,63.41 ,33.33
03,011,01,005,0101,138,392,1,393,537,0,3,1,3,0,1,0,76.14,73.18 ,33.33
03,011,01,005,0102,139,765,10,775,1071,0,3,1,3,0,1,0,76.14,72.36 ,33.33
03,011,01,005,0103,140,389,1,390,584,0,3,1,3,0,1,0,76.14,66.78 ,33.33
03,011,01,005,0104,141,729,10,739,1045,0,3,1,3,0,1,0,76.14,70.72 ,33.33
03,011,01,005,0104,142,278,3,281,401,0,3,1,3,0,1,0,76.14,70.07 ,33.33
03,011,01,005,0105,143,892,15,907,1406,0,3,1,3,0,1,0,76.14,64.51 ,33.33
03,011,01,005,0106,144,743,12,755,1086,0,3,1,3,0,1,0,76.14,69.52 ,33.33
03,011,01,005,0107,145,506,3,509,743,0,3,1,3,0,1,0,76.14,68.51 ,33.33
03,011,01,005,0107,146,442,6,448,668,0,3,1,3,0,1,0,76.14,67.07 ,33.33
03,011,01,005,0108,147,728,4,732,1065,0,3,1,3,0,1,0,76.14,68.73 ,33.33
03,011,01,005,0109,148,443,5,448,743,0,3,1,3,0,1,0,76.14,60.30 ,33.33
03,011,01,005,0110,149,137,4,141,209,0,3,1,3,0,1,0,76.14,67.46 ,33.33
03,011,01,006,0111,150,826,6,832,1442,0,3,1,3,0,1,0,76.14,57.70 ,33.33
03,011,01,006,0112,151,770,3,773,1154,0,3,1,3,0,1,0,76.14,66.98 ,33.33
03,011,01,006,0112,152,666,6,672,1104,0,3,1,3,0,1,0,76.14,60.87 ,33.33
03,011,01,006,0113,153,924,11,935,1605,0,3,1,3,0,1,0,76.14,58.26 ,33.33
03,011,01,006,0114,154,606,2,608,1005,0,3,1,3,0,1,0,76.14,60.50 ,33.33
03,011,01,006,0115,155,707,12,719,1204,0,3,1,3,0,1,0,76.14,59.72 ,33.33
03,011,01,006,0116,156,526,12,538,825,0,3,1,3,0,1,0,76.14,65.21 ,33.33
03,011,01,006,0116,157,419,3,422,641,0,3,1,3,0,1,0,76.14,65.83 ,33.33
03,011,01,006,0117,158,543,7,550,957,0,3,1,3,0,1,0,76.14,57.47 ,33.33
03,011,01,006,0118,159,524,7,531,836,0,3,1,3,0,1,0,76.14,63.52 ,33.33
03,011,01,006,0118,160,648,7,655,1009,0,3,1,3,0,1,0,76.14,64.92 ,33.33
03,011,01,006,0119,161,370,4,374,582,0,3,1,3,0,1,0,76.14,64.26 ,33.33
03,011,01,006,0120,162,296,4,300,563,0,3,1,3,0,1,0,76.14,53.29 ,33.33
03,011,01,006,0121,163,237,2,239,406,0,3,1,3,0,1,0,76.14,58.87 ,33.33
03,011,01,006,0122,164,593,7,600,1036,0,3,1,3,0,1,0,76.14,57.92 ,33.33
03,011,01,006,0122,165,692,11,703,1273,0,3,1,3,0,1,0,76.14,55.22 ,33.33
03,011,01,006,0123,166,392,4,396,796,0,3,1,3,0,1,0,76.14,49.75 ,33.33
03,011,01,006,0124,167,665,8,673,1151,0,3,1,3,0,1,0,76.14,58.47 ,33.33
03,011,01,006,0125,168,636,5,641,1156,0,3,1,3,0,1,0,76.14,55.45 ,33.33
03,011,01,006,0126,169,504,7,511,1022,0,3,1,3,0,1,0,76.14,50.00 ,33.33
03,011,01,007,0127,170,499,4,503,664,0,3,1,3,0,1,0,76.14,75.75 ,33.33
03,011,01,007,0128,171,436,2,438,599,0,3,1,3,0,1,0,76.14,73.12 ,33.33
03,011,01,007,0129,172,672,9,681,921,0,3,1,3,0,1,0,76.14,73.94 ,33.33
03,011,01,007,0129,173,540,6,546,774,0,3,1,3,0,1,0,76.14,70.54 ,33.33
03,011,01,007,0130,174,805,4,809,1114,0,3,1,3,0,1,0,76.14,72.62 ,33.33
03,011,01,007,0130,175,735,7,742,1134,0,3,1,3,0,1,0,76.14,65.43 ,33.33
03,011,01,007,0131,176,966,10,976,1301,0,3,1,3,0,1,0,76.14,75.02 ,33.33
03,011,01,007,0132,177,628,3,631,870,0,3,1,3,0,1,0,76.14,72.53 ,33.33
03,011,01,007,0132,178,588,6,594,811,0,3,1,3,0,1,0,76.14,73.24 ,33.33
03,011,01,007,0133,179,823,13,836,1133,0,3,1,3,0,1,0,76.14,73.79 ,33.33
03,011,01,007,0134,180,671,7,678,903,0,3,1,3,0,1,0,76.14,75.08 ,33.33
03,011,01,007,0135,181,819,10,829,1258,0,3,1,3,0,1,0,76.14,65.90 ,33.33
03,011,01,007,0135,182,967,4,971,1392,0,3,1,3,0,1,0,76.14,69.76 ,33.33
03,011,01,007,0136,183,822,14,836,1185,0,3,1,3,0,1,0,76.14,70.55 ,33.33
03,011,01,007,0137,184,843,9,852,1224,0,3,1,3,0,1,0,76.14,69.61 ,33.33
03,011,01,007,0137,185,746,8,754,1082,0,3,1,3,0,1,0,76.14,69.69 ,33.33
03,011,01,007,0138,186,459,6,465,624,0,3,1,3,0,1,0,76.14,74.52 ,33.33
03,011,01,007,0139,187,537,8,545,702,0,3,1,3,0,1,0,76.14,77.64 ,33.33
03,011,01,007,0140,188,638,6,644,887,0,3,1,3,0,1,0,76.14,72.60 ,33.33
03,011,01,007,0140,189,935,15,950,1331,0,3,1,3,0,1,0,76.14,71.37 ,33.33
03,011,01,007,0141,190,978,8,986,1351,0,3,1,3,0,1,0,76.14,72.98 ,33.33
03,011,01,007,0142,191,527,6,533,706,0,3,1,3,0,1,0,76.14,75.50 ,33.33
03,011,01,007,0143,192,944,10,954,1270,0,3,1,3,0,1,0,76.14,75.12 ,33.33
03,011,01,007,0144,193,420,3,423,518,0,3,1,3,0,1,0,76.14,81.66 ,33.33
03,011,01,007,0145,194,752,9,761,1013,0,3,1,3,0,1,0,76.14,75.12 ,33.33
03,011,01,007,0146,195,415,5,420,563,0,3,1,3,0,1,0,76.14,74.60 ,33.33
03,011,01,007,0147,196,822,14,836,1168,0,3,1,3,0,1,0,76.14,71.58 ,33.33
03,011,01,007,0148,197,692,12,704,962,0,3,1,3,0,1,0,76.14,73.18 ,33.33
03,011,01,007,0149,198,449,7,456,584,0,3,1,3,0,1,0,76.14,78.08 ,33.33
03,011,01,007,0150,199,483,13,496,658,0,3,1,3,0,1,0,76.14,75.38 ,33.33
03,011,01,007,0151,200,471,4,475,622,0,3,1,3,0,1,0,76.14,76.37 ,33.33
03,011,01,007,0152,201,678,5,683,827,0,3,1,3,0,1,0,76.14,82.59 ,33.33
03,011,01,007,0153,202,628,5,633,795,0,3,1,3,0,1,0,76.14,79.62 ,33.33
03,011,01,007,0154,203,555,7,562,763,0,3,1,3,0,1,0,76.14,73.66 ,33.33
03,011,01,007,0155,204,871,8,879,1152,0,3,1,3,0,1,0,76.14,76.30 ,33.33
03,011,01,008,0156,205,736,14,750,1079,0,3,1,3,0,1,0,76.14,69.51 ,33.33
03,011,01,008,0157,206,819,10,829,1223,0,3,1,3,0,1,0,76.14,67.78 ,33.33
03,011,01,008,0157,207,793,11,804,1187,0,3,1,3,0,1,0,76.14,67.73 ,33.33
03,011,01,008,0158,208,815,5,820,1164,0,3,1,3,0,1,0,76.14,70.45 ,33.33
03,011,01,008,0159,209,1061,15,1076,1494,0,3,1,3,0,1,0,76.14,72.02 ,33.33
03,011,01,008,0160,210,838,8,846,1190,0,3,1,3,0,1,0,76.14,71.09 ,33.33
03,011,01,008,0160,211,519,3,522,755,0,3,1,3,0,1,0,76.14,69.14 ,33.33
03,011,01,008,0161,212,653,8,661,957,0,3,1,3,0,1,0,76.14,69.07 ,33.33
03,011,01,008,0161,213,700,11,711,1045,0,3,1,3,0,1,0,76.14,68.04 ,33.33
03,011,01,008,0162,214,582,10,592,806,0,3,1,3,0,1,0,76.14,73.45 ,33.33
03,011,01,008,0163,215,593,3,596,805,0,3,1,3,0,1,0,76.14,74.04 ,33.33
03,011,01,008,0164,216,801,13,814,1166,0,3,1,3,0,1,0,76.14,69.81 ,33.33
03,011,01,008,0165,217,732,6,738,1048,0,3,1,3,0,1,0,76.14,70.42 ,33.33
03,011,01,008,0166,218,1096,15,1111,1687,0,3,1,3,0,1,0,76.14,65.86 ,33.33
03,011,01,008,0167,219,637,11,648,884,0,3,1,3,0,1,0,76.14,73.30 ,33.33
03,011,01,008,0168,220,857,9,866,1269,0,3,1,3,0,1,0,76.14,68.24 ,33.33
03,011,01,008,0169,221,825,5,830,1210,0,3,1,3,0,1,0,76.14,68.60 ,33.33
03,011,01,008,0170,222,904,14,918,1245,0,3,1,3,0,1,0,76.14,73.73 ,33.33
03,011,01,009,0171,223,959,18,977,1391,0,3,1,3,0,1,0,76.14,70.24 ,33.33
03,011,01,009,0171,224,808,23,831,1179,0,3,1,3,0,1,0,76.14,70.48 ,33.33
03,011,01,009,0172,225,856,6,862,1247,0,3,1,3,0,1,0,76.14,69.13 ,33.33
03,011,01,009,0172,226,783,15,798,1164,0,3,1,3,0,1,0,76.14,68.56 ,33.33
03,011,01,009,0173,227,888,10,898,1280,0,3,1,3,0,1,0,76.14,70.16 ,33.33
03,011,01,009,0174,228,712,7,719,1031,0,3,1,3,0,1,0,76.14,69.74 ,33.33
03,011,01,009,0175,229,592,4,596,846,0,3,1,3,0,1,0,76.14,70.45 ,33.33
03,011,01,009,0176,230,810,8,818,1221,0,3,1,3,0,1,0,76.14,66.99 ,33.33
03,011,01,009,0176,231,893,11,904,1327,0,3,1,3,0,1,0,76.14,68.12 ,33.33
03,011,01,009,0177,232,625,5,630,904,0,3,1,3,0,1,0,76.14,69.69 ,33.33
03,011,01,009,0177,233,579,12,591,804,0,3,1,3,0,1,0,76.14,73.51 ,33.33
03,011,01,009,0178,234,1071,17,1088,1491,0,3,1,3,0,1,0,76.14,72.97 ,33.33
03,011,01,009,0179,235,712,7,719,1017,0,3,1,3,0,1,0,76.14,70.70 ,33.33
03,011,01,009,0180,236,390,3,393,542,0,3,1,3,0,1,0,76.14,72.51 ,33.33
03,011,01,009,0181,237,573,8,581,958,0,3,1,3,0,1,0,76.14,60.65 ,33.33
03,011,01,009,0182,238,482,6,488,826,0,3,1,3,0,1,0,76.14,59.08 ,33.33
03,011,01,010,0183,239,842,11,853,1162,0,3,1,3,0,1,0,76.14,73.41 ,33.33
03,011,01,010,0183,240,540,5,545,787,0,3,1,3,0,1,0,76.14,69.25 ,33.33
03,011,01,010,0184,241,739,5,744,1058,0,3,1,3,0,1,0,76.14,70.32 ,33.33
03,011,01,010,0184,242,674,3,677,941,0,3,1,3,0,1,0,76.14,71.94 ,33.33
03,011,01,010,0185,243,726,12,738,1040,0,3,1,3,0,1,0,76.14,70.96 ,33.33
03,011,01,010,0186,244,527,7,534,686,0,3,1,3,0,1,0,76.14,77.84 ,33.33
03,011,01,010,0187,245,344,1,345,499,0,3,1,3,0,1,0,76.14,69.14 ,33.33
03,011,01,010,0188,246,671,12,683,943,0,3,1,3,0,1,0,76.14,72.43 ,33.33
03,011,01,010,0188,247,610,6,616,852,0,3,1,3,0,1,0,76.14,72.30 ,33.33
03,011,01,010,0189,248,532,10,542,785,0,3,1,3,0,1,0,76.14,69.04 ,33.33
03,011,01,010,0189,249,628,8,636,884,0,3,1,3,0,1,0,76.14,71.95 ,33.33
03,011,01,010,0189,250,623,7,630,852,0,3,1,3,0,1,0,76.14,73.94 ,33.33
03,011,01,010,0190,251,654,15,669,958,0,3,1,3,0,1,0,76.14,69.83 ,33.33
03,011,01,010,0191,252,955,11,966,1389,0,3,1,3,0,1,0,76.14,69.55 ,33.33
03,011,01,010,0192,253,480,5,485,692,0,3,1,3,0,1,0,76.14,70.09 ,33.33
03,011,01,010,0193,254,466,5,471,627,0,3,1,3,0,1,0,76.14,75.12 ,33.33
03,011,01,010,0194,255,603,7,610,884,0,3,1,3,0,1,0,76.14,69.00 ,33.33
03,011,01,010,0194,256,608,9,617,864,0,3,1,3,0,1,0,76.14,71.41 ,33.33
03,011,01,010,0194,257,375,8,383,573,0,3,1,3,0,1,0,76.14,66.84 ,33.33
03,011,01,010,0195,258,657,10,667,913,0,3,1,3,0,1,0,76.14,73.06 ,33.33
03,011,01,011,0196,259,816,4,820,1207,0,3,1,3,0,1,0,76.14,67.94 ,33.33
03,011,01,011,0197,260,594,6,600,817,0,3,1,3,0,1,0,76.14,73.44 ,33.33
03,011,01,011,0198,261,975,7,982,1392,0,3,1,3,0,1,0,76.14,70.55 ,33.33
03,011,01,011,0199,262,780,9,789,1069,0,3,1,3,0,1,0,76.14,73.81 ,33.33
03,011,01,011,0200,263,620,6,626,842,0,3,1,3,0,1,0,76.14,74.35 ,33.33
03,011,01,011,0201,264,449,8,457,668,0,3,1,3,0,1,0,76.14,68.41 ,33.33
03,011,01,011,0202,265,699,7,706,1059,0,3,1,3,0,1,0,76.14,66.67 ,33.33
03,011,01,011,0203,266,584,11,595,920,0,3,1,3,0,1,0,76.14,64.67 ,33.33
03,011,01,011,0204,267,663,6,669,953,0,3,1,3,0,1,0,76.14,70.20 ,33.33
03,011,01,011,0205,268,472,8,480,682,0,3,1,3,0,1,0,76.14,70.38 ,33.33
03,011,01,012,0206,269,585,12,597,867,0,3,1,3,0,1,0,76.14,68.86 ,33.33
03,011,01,012,0206,270,565,5,570,826,0,3,1,3,0,1,0,76.14,69.01 ,33.33
03,011,01,012,0207,271,764,9,773,1176,0,3,1,3,0,1,0,76.14,65.73 ,33.33
03,011,01,012,0207,272,846,9,855,1243,0,3,1,3,0,1,0,76.14,68.79 ,33.33
03,011,01,012,0208,273,650,3,653,949,0,3,1,3,0,1,0,76.14,68.81 ,33.33
03,011,01,012,0208,274,625,0,625,961,0,3,1,3,0,1,0,76.14,65.04 ,33.33
03,011,01,012,0208,275,624,8,632,945,0,3,1,3,0,1,0,76.14,66.88 ,33.33
03,011,01,012,0208,276,680,6,686,1043,0,3,1,3,0,1,0,76.14,65.77 ,33.33
03,011,01,012,0209,277,829,6,835,1210,0,3,1,3,0,1,0,76.14,69.01 ,33.33
03,011,01,012,0209,278,837,5,842,1225,0,3,1,3,0,1,0,76.14,68.73 ,33.33
03,011,01,012,0209,279,663,6,669,1055,0,3,1,3,0,1,0,76.14,63.41 ,33.33
03,011,01,012,0209,280,840,5,845,1328,0,3,1,3,0,1,0,76.14,63.63 ,33.33
03,011,01,012,0210,281,811,6,817,1217,0,3,1,3,0,1,0,76.14,67.13 ,33.33
03,011,01,012,0210,282,766,6,772,1140,0,3,1,3,0,1,0,76.14,67.72 ,33.33
03,011,01,012,0210,283,744,4,748,1108,0,3,1,3,0,1,0,76.14,67.51 ,33.33
03,011,01,012,0210,284,867,8,875,1174,0,3,1,3,0,1,0,76.14,74.53 ,33.33
03,011,01,012,0210,285,682,9,691,1007,0,3,1,3,0,1,0,76.14,68.62 ,33.33
03,011,01,012,0210,286,751,7,758,1114,0,3,1,3,0,1,0,76.14,68.04 ,33.33
03,011,01,012,0211,287,630,8,638,914,0,3,1,3,0,1,0,76.14,69.80 ,33.33
03,011,01,012,0211,288,631,6,637,995,0,3,1,3,0,1,0,76.14,64.02 ,33.33
03,011,01,012,0211,289,614,8,622,910,0,3,1,3,0,1,0,76.14,68.35 ,33.33
03,011,01,012,0212,290,629,9,638,959,0,3,1,3,0,1,0,76.14,66.53 ,33.33
03,011,01,012,0212,291,561,7,568,782,0,3,1,3,0,1,0,76.14,72.63 ,33.33
03,011,01,012,0213,292,621,6,627,839,0,3,1,3,0,1,0,76.14,74.73 ,33.33
03,011,01,012,0214,293,938,6,944,1351,0,3,1,3,0,1,0,76.14,69.87 ,33.33
03,011,01,012,0215,294,457,3,460,654,0,3,1,3,0,1,0,76.14,70.34 ,33.33
03,011,01,012,0216,295,282,3,285,381,0,3,1,3,0,1,0,76.14,74.80 ,33.33
03,011,01,012,0217,296,691,14,705,1062,0,3,1,3,0,1,0,76.14,66.38 ,33.33
03,011,01,012,0218,297,405,5,410,572,0,3,1,3,0,1,0,76.14,71.68 ,33.33
03,011,01,012,0219,298,457,5,462,670,0,3,1,3,0,1,0,76.14,68.96 ,33.33
03,011,01,012,0220,299,679,7,686,962,0,3,1,3,0,1,0,76.14,71.31 ,33.33
03,011,01,012,0221,300,762,2,764,1065,0,3,1,3,0,1,0,76.14,71.74 ,33.33
03,011,01,012,0222,301,591,6,597,835,0,3,1,3,0,1,0,76.14,71.50 ,33.33
03,011,01,012,0223,302,706,9,715,962,0,3,1,3,0,1,0,76.14,74.32 ,33.33
03,011,01,012,0224,303,798,14,812,1180,0,3,1,3,0,1,0,76.14,68.81 ,33.33
03,011,01,012,0225,304,989,13,1002,1440,0,3,1,3,0,1,0,76.14,69.58 ,33.33
03,011,01,012,0226,305,574,7,581,807,0,3,1,3,0,1,0,76.14,72.00 ,33.33
03,011,01,013,0227,306,394,9,403,624,0,3,1,3,0,1,0,76.14,64.58 ,33.33
03,011,01,013,0227,307,280,0,280,404,0,3,1,3,0,1,0,76.14,69.31 ,33.33
03,011,01,013,0228,308,728,10,738,1164,0,3,1,3,0,1,0,76.14,63.40 ,33.33
03,011,01,013,0229,309,355,2,357,545,0,3,1,3,0,1,0,76.14,65.50 ,33.33
03,011,01,013,0230,310,540,4,544,849,0,3,1,3,0,1,0,76.14,64.08 ,33.33
03,011,01,013,0231,311,420,5,425,610,0,3,1,3,0,1,0,76.14,69.67 ,33.33
03,011,01,013,0232,312,655,5,660,1043,0,3,1,3,0,1,0,76.14,63.28 ,33.33
03,011,01,013,0232,313,549,4,553,892,0,3,1,3,0,1,0,76.14,62.00 ,33.33
03,011,01,013,0232,314,786,7,793,1233,0,3,1,3,0,1,0,76.14,64.31 ,33.33
03,011,01,013,0233,315,910,9,919,1374,0,3,1,3,0,1,0,76.14,66.89 ,33.33
03,011,01,013,0234,316,353,2,355,545,0,3,1,3,0,1,0,76.14,65.14 ,33.33
03,011,01,013,0234,317,494,2,496,703,0,3,1,3,0,1,0,76.14,70.55 ,33.33
03,011,01,013,0235,318,777,7,784,1148,0,3,1,3,0,1,0,76.14,68.29 ,33.33
03,011,01,013,0236,319,349,4,353,492,0,3,1,3,0,1,0,76.14,71.75 ,33.33
03,011,01,013,0237,320,349,3,352,517,0,3,1,3,0,1,0,76.14,68.09 ,33.33
03,011,01,013,0238,321,530,7,537,811,0,3,1,3,0,1,0,76.14,66.21 ,33.33
03,011,01,013,0239,322,240,4,244,361,0,3,1,3,0,1,0,76.14,67.59 ,33.33
03,011,01,013,0240,323,508,8,516,710,0,3,1,3,0,1,0,76.14,72.68 ,33.33
03,011,01,013,0241,324,218,3,221,369,0,3,1,3,0,1,0,76.14,59.89 ,33.33
03,011,01,013,0242,325,276,6,282,450,0,3,1,3,0,1,0,76.14,62.67 ,33.33
03,011,01,013,0243,326,330,4,334,546,0,3,1,3,0,1,0,76.14,61.17 ,33.33
03,011,01,013,0244,327,244,3,247,347,0,3,1,3,0,1,0,76.14,71.18 ,33.33
03,011,01,013,0245,328,298,5,303,454,0,3,1,3,0,1,0,76.14,66.74 ,33.33
03,011,01,013,0245,329,227,2,229,283,0,3,1,3,0,1,0,76.14,80.92 ,33.33
03,011,01,013,0246,330,382,1,383,596,0,3,1,3,0,1,0,76.14,64.26 ,33.33
03,011,01,013,0247,331,439,7,446,730,0,3,1,3,0,1,0,76.14,61.10 ,33.33
03,011,01,013,0247,332,324,4,328,503,0,3,1,3,0,1,0,76.14,65.21 ,33.33
03,011,01,013,0248,333,350,2,352,558,0,3,1,3,0,1,0,76.14,63.08 ,33.33
03,011,01,013,0249,334,443,2,445,777,0,3,1,3,0,1,0,76.14,57.27 ,33.33
03,011,01,013,0250,335,475,4,479,667,0,3,1,3,0,1,0,76.14,71.81 ,33.33
03,011,01,013,0251,336,323,0,323,542,0,3,1,3,0,1,0,76.14,59.59 ,33.33
03,011,01,013,0252,337,315,4,319,499,0,3,1,3,0,1,0,76.14,63.93 ,33.33
03,011,01,014,0253,338,864,4,868,1238,0,3,1,3,0,1,0,76.14,70.11 ,33.33
03,011,01,014,0253,339,745,7,752,1036,0,3,1,3,0,1,0,76.14,72.59 ,33.33
03,011,01,014,0254,340,653,6,659,977,0,3,1,3,0,1,0,76.14,67.45 ,33.33
03,011,01,014,0254,341,669,11,680,919,0,3,1,3,0,1,0,76.14,73.99 ,33.33
03,011,01,014,0254,342,614,9,623,878,0,3,1,3,0,1,0,76.14,70.96 ,33.33
03,011,01,014,0255,343,832,13,845,1159,0,3,1,3,0,1,0,76.14,72.91 ,33.33
03,011,01,014,0255,344,440,7,447,602,0,3,1,3,0,1,0,76.14,74.25 ,33.33
03,011,01,014,0256,345,601,7,608,821,0,3,1,3,0,1,0,76.14,74.06 ,33.33
03,011,01,014,0256,346,271,2,273,405,0,3,1,3,0,1,0,76.14,67.41 ,33.33
03,011,01,014,0257,347,538,6,544,741,0,3,1,3,0,1,0,76.14,73.41 ,33.33
03,011,01,014,0257,348,554,5,559,805,0,3,1,3,0,1,0,76.14,69.44 ,33.33
03,011,01,014,0258,349,865,7,872,1244,0,3,1,3,0,1,0,76.14,70.10 ,33.33
03,011,01,014,0259,350,850,10,860,1203,0,3,1,3,0,1,0,76.14,71.49 ,33.33
03,011,01,014,0260,351,300,5,305,418,0,3,1,3,0,1,0,76.14,72.97 ,33.33
03,011,01,014,0260,352,303,0,303,410,0,3,1,3,0,1,0,76.14,73.90 ,33.33
03,011,01,014,0261,353,775,21,796,1114,0,3,1,3,0,1,0,76.14,71.45 ,33.33
03,011,01,014,0262,354,816,6,822,1141,0,3,1,3,0,1,0,76.14,72.04 ,33.33
03,011,01,014,0263,355,636,7,643,843,0,3,1,3,0,1,0,76.14,76.28 ,33.33
03,011,01,014,0264,356,315,2,317,421,0,3,1,3,0,1,0,76.14,75.30 ,33.33
03,011,01,014,0265,357,450,4,454,650,0,3,1,3,0,1,0,76.14,69.85 ,33.33
03,011,01,015,0266,358,428,4,432,577,0,3,1,3,0,1,0,76.14,74.87 ,33.33
03,011,01,015,0267,359,509,3,512,786,0,3,1,3,0,1,0,76.14,65.14 ,33.33
03,011,01,015,0268,360,388,4,392,499,0,3,1,3,0,1,0,76.14,78.56 ,33.33
03,011,01,015,0269,361,595,5,600,851,0,3,1,3,0,1,0,76.14,70.51 ,33.33
03,011,01,015,0270,362,694,7,701,984,0,3,1,3,0,1,0,76.14,71.24 ,33.33
03,011,01,015,0271,363,384,1,385,555,0,3,1,3,0,1,0,76.14,69.37 ,33.33
03,011,01,015,0272,364,337,3,340,470,0,3,1,3,0,1,0,76.14,72.34 ,33.33
03,011,01,015,0273,365,592,3,595,762,0,3,1,3,0,1,0,76.14,78.08 ,33.33
03,011,01,015,0274,366,505,6,511,771,0,3,1,3,0,1,0,76.14,66.28 ,33.33
03,011,01,015,0274,367,597,5,602,855,0,3,1,3,0,1,0,76.14,70.41 ,33.33
03,011,01,015,0275,368,262,2,264,349,0,3,1,3,0,1,0,76.14,75.64 ,33.33
03,011,01,015,0276,369,538,7,545,839,0,3,1,3,0,1,0,76.14,64.96 ,33.33
03,011,01,015,0277,370,514,3,517,778,0,3,1,3,0,1,0,76.14,66.45 ,33.33
03,011,01,015,0278,371,774,11,785,1236,0,3,1,3,0,1,0,76.14,63.51 ,33.33
03,011,01,015,0279,372,661,6,667,987,0,3,1,3,0,1,0,76.14,67.58 ,33.33
03,011,01,015,0280,373,403,3,406,560,0,3,1,3,0,1,0,76.14,72.50 ,33.33
03,011,01,015,0281,374,699,3,702,919,0,3,1,3,0,1,0,76.14,76.39 ,33.33
03,011,01,015,0282,375,417,5,422,552,0,3,1,3,0,1,0,76.14,76.45 ,33.33
03,011,01,015,0282,376,550,2,552,760,0,3,1,3,0,1,0,76.14,72.63 ,33.33
03,011,01,015,0283,377,596,5,601,812,0,3,1,3,0,1,0,76.14,74.01 ,33.33
03,011,01,015,0284,378,468,2,470,634,0,3,1,3,0,1,0,76.14,74.13 ,33.33
03,011,01,015,0285,379,555,2,557,772,0,3,1,3,0,1,0,76.14,72.15 ,33.33
03,011,01,015,0286,380,771,11,782,1104,0,3,1,3,0,1,0,76.14,70.83 ,33.33
03,011,01,015,0286,381,860,11,871,1095,0,3,1,3,0,1,0,76.14,79.54 ,33.33
03,011,01,015,0287,382,895,12,907,1267,0,3,1,3,0,1,0,76.14,71.59 ,33.33
03,011,01,016,0288,383,594,4,598,809,0,3,1,3,0,1,0,76.14,73.92 ,33.33
03,011,01,016,0289,384,808,5,813,1187,0,3,1,3,0,1,0,76.14,68.49 ,33.33
03,011,01,016,0290,385,763,11,774,1101,0,3,1,3,0,1,0,76.14,70.30 ,33.33
03,011,01,016,0291,386,1041,3,1044,1461,0,3,1,3,0,1,0,76.14,71.46 ,33.33
03,011,01,016,0292,387,254,2,256,357,0,3,1,3,0,1,0,76.14,71.71 ,33.33
03,011,01,016,0292,388,425,6,431,568,0,3,1,3,0,1,0,76.14,75.88 ,33.33
03,011,01,016,0293,389,337,2,339,464,0,3,1,3,0,1,0,76.14,73.06 ,33.33
03,011,01,016,0293,390,417,5,422,590,0,3,1,3,0,1,0,76.14,71.53 ,33.33
03,011,01,016,0294,391,432,4,436,635,0,3,1,3,0,1,0,76.14,68.66 ,33.33
03,011,01,016,0294,392,220,1,221,330,0,3,1,3,0,1,0,76.14,66.97 ,33.33
03,011,01,016,0295,393,526,2,528,846,0,3,1,3,0,1,0,76.14,62.41 ,33.33
03,011,01,016,0296,394,447,4,451,663,0,3,1,3,0,1,0,76.14,68.02 ,33.33
03,011,01,016,0297,395,501,5,506,746,0,3,1,3,0,1,0,76.14,67.83 ,33.33
03,011,01,016,0298,396,482,1,483,650,0,3,1,3,0,1,0,76.14,74.31 ,33.33
03,011,01,016,0299,397,294,2,296,438,0,3,1,3,0,1,0,76.14,67.58 ,33.33
03,011,01,016,0300,398,642,4,646,925,0,3,1,3,0,1,0,76.14,69.84 ,33.33
03,011,01,016,0301,399,510,6,516,790,0,3,1,3,0,1,0,76.14,65.32 ,33.33
03,011,01,016,0302,400,970,8,978,1374,0,3,1,3,0,1,0,76.14,71.18 ,33.33
03,011,01,016,0303,401,817,10,827,1177,0,3,1,3,0,1,0,76.14,70.26 ,33.33
03,011,01,016,0304,402,683,9,692,975,0,3,1,3,0,1,0,76.14,70.97 ,33.33
03,011,01,016,0304,403,519,4,523,770,0,3,1,3,0,1,0,76.14,67.92 ,33.33
03,011,01,016,0305,404,574,7,581,944,0,3,1,3,0,1,0,76.14,61.55 ,33.33
03,011,01,017,0306,405,359,3,362,528,0,3,1,3,0,1,0,76.14,68.56 ,33.33
03,011,01,017,0306,406,283,5,288,415,0,3,1,3,0,1,0,76.14,69.40 ,33.33
03,011,01,017,0307,407,341,7,348,521,0,3,1,3,0,1,0,76.14,66.79 ,33.33
03,011,01,017,0308,408,254,2,256,379,0,3,1,3,0,1,0,76.14,67.55 ,33.33
03,011,01,017,0309,409,345,2,347,516,0,3,1,3,0,1,0,76.14,67.25 ,33.33
03,011,01,017,0309,410,235,0,235,339,0,3,1,3,0,1,0,76.14,69.32 ,33.33
03,011,01,017,0310,411,525,2,527,780,0,3,1,3,0,1,0,76.14,67.56 ,33.33
03,011,01,017,0310,412,355,4,359,491,0,3,1,3,0,1,0,76.14,73.12 ,33.33
03,011,01,017,0311,413,460,5,465,689,0,3,1,3,0,1,0,76.14,67.49 ,33.33
03,011,01,017,0312,414,277,2,279,429,0,3,1,3,0,1,0,76.14,65.03 ,33.33
03,011,01,017,0312,415,221,0,221,334,0,3,1,3,0,1,0,76.14,66.17 ,33.33
03,011,01,017,0313,416,353,0,353,579,0,3,1,3,0,1,0,76.14,60.97 ,33.33
03,011,01,017,0314,417,651,8,659,1112,0,3,1,3,0,1,0,76.14,59.26 ,33.33
03,011,01,017,0315,418,413,2,415,661,0,3,1,3,0,1,0,76.14,62.78 ,33.33
03,011,01,017,0316,419,417,10,427,685,0,3,1,3,0,1,0,76.14,62.34 ,33.33
03,011,01,017,0316,420,329,0,329,450,0,3,1,3,0,1,0,76.14,73.11 ,33.33
03,011,01,017,0317,421,488,3,491,766,0,3,1,3,0,1,0,76.14,64.10 ,33.33
03,011,01,017,0318,422,501,5,506,749,0,3,1,3,0,1,0,76.14,67.56 ,33.33
03,011,01,018,0319,423,511,5,516,712,0,3,1,3,0,1,0,76.14,72.47 ,33.33
03,011,01,018,0319,424,524,7,531,791,0,3,1,3,0,1,0,76.14,67.13 ,33.33
03,011,01,018,0320,425,816,9,825,1255,0,3,1,3,0,1,0,76.14,65.74 ,33.33
03,011,01,018,0320,426,826,11,837,1163,0,3,1,3,0,1,0,76.14,71.97 ,33.33
03,011,01,018,0320,427,697,14,711,1035,0,3,1,3,0,1,0,76.14,68.70 ,33.33
03,011,01,018,0321,428,552,15,567,777,0,3,1,3,0,1,0,76.14,72.97 ,33.33
03,011,01,018,0321,429,330,6,336,749,0,3,1,3,0,1,0,76.14,44.86 ,33.33
03,011,01,018,0322,430,627,11,638,849,0,3,1,3,0,1,0,76.14,75.15 ,33.33
03,011,01,018,0322,431,540,11,551,766,0,3,1,3,0,1,0,76.14,71.93 ,33.33
03,011,01,018,0322,432,544,4,548,757,0,3,1,3,0,1,0,76.14,72.39 ,33.33
03,011,01,018,0322,433,588,10,598,798,0,3,1,3,0,1,0,76.14,74.94 ,33.33
03,011,01,018,0323,434,357,5,362,500,0,3,1,3,0,1,0,76.14,72.40 ,33.33
03,011,01,018,0324,435,440,7,447,634,0,3,1,3,0,1,0,76.14,70.50 ,33.33
03,011,01,018,0325,436,345,4,349,473,0,3,1,3,0,1,0,76.14,73.78 ,33.33
03,011,01,018,0326,437,653,6,659,924,0,3,1,3,0,1,0,76.14,71.32 ,33.33
03,011,01,018,0327,438,545,7,552,783,0,3,1,3,0,1,0,76.14,70.50 ,33.33
03,011,01,018,0327,439,657,4,661,939,0,3,1,3,0,1,0,76.14,70.39 ,33.33
03,011,01,018,0327,440,572,12,584,853,0,3,1,3,0,1,0,76.14,68.46 ,33.33
03,011,01,018,0328,441,879,13,892,1239,0,3,1,3,0,1,0,76.14,71.99 ,33.33
03,011,01,018,0329,442,598,6,604,784,0,3,1,3,0,1,0,76.14,77.04 ,33.33
03,011,01,018,0330,443,642,6,648,930,0,3,1,3,0,1,0,76.14,69.68 ,33.33
03,011,01,018,0330,444,739,9,748,959,0,3,1,3,0,1,0,76.14,78.00 ,33.33
03,011,01,018,0331,445,972,15,987,1360,0,3,1,3,0,1,0,76.14,72.57 ,33.33
03,011,01,018,0332,446,656,9,665,899,0,3,1,3,0,1,0,76.14,73.97 ,33.33
03,011,01,018,0332,447,564,7,571,750,0,3,1,3,0,1,0,76.14,76.13 ,33.33
03,011,01,018,0333,448,741,14,755,963,0,3,1,3,0,1,0,76.14,78.40 ,33.33
03,011,01,018,0333,449,698,24,722,1105,0,3,1,3,0,1,0,76.14,65.34 ,33.33
03,011,01,018,0334,450,884,17,901,1149,0,3,1,3,0,1,0,76.14,78.42 ,33.33
03,011,01,018,0335,451,367,6,373,529,0,3,1,3,0,1,0,76.14,70.51 ,33.33
03,011,01,018,0336,452,669,15,684,979,0,3,1,3,0,1,0,76.14,69.87 ,33.33
03,011,01,018,0336,453,697,10,707,1002,0,3,1,3,0,1,0,76.14,70.56 ,33.33
03,011,01,018,0337,454,559,9,568,858,0,3,1,3,0,1,0,76.14,66.20 ,33.33
03,011,01,018,0338,455,732,7,739,1096,0,3,1,3,0,1,0,76.14,67.43 ,33.33
03,011,01,019,0339,456,704,8,712,1035,0,3,1,3,0,1,0,76.14,68.79 ,33.33
03,011,01,019,0340,457,701,8,709,987,0,3,1,3,0,1,0,76.14,71.83 ,33.33
03,011,01,019,0340,458,967,11,978,1356,0,3,1,3,0,1,0,76.14,72.12 ,33.33
03,011,01,019,0341,459,717,16,733,1015,0,3,1,3,0,1,0,76.14,72.22 ,33.33
03,011,01,019,0341,460,871,11,882,1229,0,3,1,3,0,1,0,76.14,71.77 ,33.33
03,011,01,019,0341,461,943,14,957,1301,0,3,1,3,0,1,0,76.14,73.56 ,33.33
03,011,01,019,0342,462,595,5,600,875,0,3,1,3,0,1,0,76.14,68.57 ,33.33
03,011,01,019,0342,463,674,10,684,979,0,3,1,3,0,1,0,76.14,69.87 ,33.33
03,011,01,019,0343,464,817,15,832,1193,0,3,1,3,0,1,0,76.14,69.74 ,33.33
03,011,01,019,0344,465,498,3,501,691,0,3,1,3,0,1,0,76.14,72.50 ,33.33
03,011,01,019,0345,466,343,3,346,495,0,3,1,3,0,1,0,76.14,69.90 ,33.33
03,011,01,019,0346,467,702,9,711,988,0,3,1,3,0,1,0,76.14,71.96 ,33.33
03,011,01,019,0347,468,910,4,914,1254,0,3,1,3,0,1,0,76.14,72.89 ,33.33
03,011,01,019,0348,469,889,16,905,1191,0,3,1,3,0,1,0,76.14,75.99 ,33.33
03,011,01,019,0348,470,507,18,525,743,0,3,1,3,0,1,0,76.14,70.66 ,33.33
03,011,01,019,0349,471,564,10,574,794,0,3,1,3,0,1,0,76.14,72.29 ,33.33
03,011,01,019,0350,472,595,14,609,836,0,3,1,3,0,1,0,76.14,72.85 ,33.33
03,011,01,019,0350,473,531,5,536,750,0,3,1,3,0,1,0,76.14,71.47 ,33.33
03,011,01,019,0351,474,462,7,469,677,0,3,1,3,0,1,0,76.14,69.28 ,33.33
03,011,01,019,0352,475,727,9,736,1039,0,3,1,3,0,1,0,76.14,70.84 ,33.33
03,011,01,019,0353,476,488,4,492,712,0,3,1,3,0,1,0,76.14,69.10 ,33.33
03,011,01,019,0353,477,636,5,641,956,0,3,1,3,0,1,0,76.14,67.05 ,33.33
03,011,01,019,0354,478,531,11,542,778,0,3,1,3,0,1,0,76.14,69.67 ,33.33
03,011,01,019,0355,479,632,10,642,957,0,3,1,3,0,1,0,76.14,67.08 ,33.33
03,011,01,019,0356,480,952,12,964,1375,0,3,1,3,0,1,0,76.14,70.11 ,33.33
03,011,01,019,0357,481,950,13,963,1337,0,3,1,3,0,1,0,76.14,72.03 ,33.33
03,011,01,019,0358,482,701,6,707,971,0,3,1,3,0,1,0,76.14,72.81 ,33.33
03,011,01,019,0359,483,751,12,763,1052,0,3,1,3,0,1,0,76.14,72.53 ,33.33
03,011,01,019,0359,484,801,11,812,1114,0,3,1,3,0,1,0,76.14,72.89 ,33.33
03,011,01,020,0360,485,616,8,624,885,0,3,1,3,0,1,0,76.14,70.51 ,33.33
03,011,01,020,0360,486,687,11,698,1060,0,3,1,3,0,1,0,76.14,65.85 ,33.33
03,011,01,020,0361,487,952,21,973,1409,0,3,1,3,0,1,0,76.14,69.06 ,33.33
03,011,01,020,0361,488,466,5,471,657,0,3,1,3,0,1,0,76.14,71.69 ,33.33
03,011,01,020,0361,489,804,10,814,1176,0,3,1,3,0,1,0,76.14,69.22 ,33.33
03,011,01,020,0361,490,805,6,811,1200,0,3,1,3,0,1,0,76.14,67.58 ,33.33
03,011,01,020,0362,491,567,7,574,779,0,3,1,3,0,1,0,76.14,73.68 ,33.33
03,011,01,020,0362,492,624,6,630,864,0,3,1,3,0,1,0,76.14,72.92 ,33.33
03,011,01,020,0363,493,467,2,469,610,0,3,1,3,0,1,0,76.14,76.89 ,33.33
03,011,01,020,0364,494,532,7,539,816,0,3,1,3,0,1,0,76.14,66.05 ,33.33
03,011,01,020,0365,495,620,9,629,881,0,3,1,3,0,1,0,76.14,71.40 ,33.33
03,011,01,020,0366,496,586,4,590,797,0,3,1,3,0,1,0,76.14,74.03 ,33.33
03,011,01,020,0366,497,430,5,435,583,0,3,1,3,0,1,0,76.14,74.61 ,33.33
03,011,01,020,0366,498,406,7,413,549,0,3,1,3,0,1,0,76.14,75.23 ,33.33
03,011,01,020,0367,499,847,13,860,1327,0,3,1,3,0,1,0,76.14,64.81 ,33.33
03,011,01,020,0367,500,918,13,931,1346,0,3,1,3,0,1,0,76.14,69.17 ,33.33
03,011,01,020,0368,501,911,18,929,1338,0,3,1,3,0,1,0,76.14,69.43 ,33.33
03,011,01,020,0369,502,467,9,476,682,0,3,1,3,0,1,0,76.14,69.79 ,33.33
03,011,01,020,0369,503,573,8,581,834,0,3,1,3,0,1,0,76.14,69.66 ,33.33
03,011,01,020,0369,504,626,11,637,916,0,3,1,3,0,1,0,76.14,69.54 ,33.33
03,011,01,020,0370,505,340,9,349,445,0,3,1,3,0,1,0,76.14,78.43 ,33.33
03,011,01,020,0370,506,553,6,559,750,0,3,1,3,0,1,0,76.14,74.53 ,33.33
03,011,01,021,0371,507,816,4,820,1086,0,3,1,3,0,1,0,76.14,75.51 ,33.33
03,011,01,021,0371,508,658,8,666,897,0,3,1,3,0,1,0,76.14,74.25 ,33.33
03,011,01,021,0372,509,608,10,618,877,0,3,1,3,0,1,0,76.14,70.47 ,33.33
03,011,01,021,0372,510,561,8,569,761,0,3,1,3,0,1,0,76.14,74.77 ,33.33
03,011,01,021,0373,511,928,11,939,1275,0,3,1,3,0,1,0,76.14,73.65 ,33.33
03,011,01,021,0374,512,835,8,843,1121,0,3,1,3,0,1,0,76.14,75.20 ,33.33
03,011,01,021,0375,513,516,6,522,687,0,3,1,3,0,1,0,76.14,75.98 ,33.33
03,011,01,021,0376,514,971,11,982,1329,0,3,1,3,0,1,0,76.14,73.89 ,33.33
03,011,01,021,0377,515,728,11,739,968,0,3,1,3,0,1,0,76.14,76.34 ,33.33
03,011,01,021,0378,516,648,4,652,929,0,3,1,3,0,1,0,76.14,70.18 ,33.33
03,011,01,021,0378,517,679,13,692,926,0,3,1,3,0,1,0,76.14,74.73 ,33.33
03,011,01,021,0379,518,772,6,778,1065,0,3,1,3,0,1,0,76.14,73.05 ,33.33
03,011,01,021,0379,519,630,11,641,876,0,3,1,3,0,1,0,76.14,73.17 ,33.33
03,011,01,021,0380,520,439,9,448,585,0,3,1,3,0,1,0,76.14,76.58 ,33.33
03,011,01,021,0381,521,905,12,917,1247,0,3,1,3,0,1,0,76.14,73.54 ,33.33
03,011,01,021,0382,522,507,2,509,689,0,3,1,3,0,1,0,76.14,73.88 ,33.33
03,011,01,021,0383,523,1103,10,1113,1466,0,3,1,3,0,1,0,76.14,75.92 ,33.33
03,011,01,021,0384,524,736,8,744,945,0,3,1,3,0,1,0,76.14,78.73 ,33.33
03,011,01,021,0384,525,722,9,731,981,0,3,1,3,0,1,0,76.14,74.52 ,33.33
03,011,01,021,0385,526,646,9,655,887,0,3,1,3,0,1,0,76.14,73.84 ,33.33
03,011,01,021,0386,527,349,4,353,437,0,3,1,3,0,1,0,76.14,80.78 ,33.33
03,011,01,022,0387,528,626,5,631,847,0,3,1,3,0,1,0,76.14,74.50 ,33.33
03,011,01,022,0387,529,525,4,529,784,0,3,1,3,0,1,0,76.14,67.47 ,33.33
03,011,01,022,0388,530,503,6,509,709,0,3,1,3,0,1,0,76.14,71.79 ,33.33
03,011,01,022,0388,531,534,5,539,751,0,3,1,3,0,1,0,76.14,71.77 ,33.33
03,011,01,022,0389,532,605,14,619,860,0,3,1,3,0,1,0,76.14,71.98 ,33.33
03,011,01,022,0390,533,450,3,453,661,0,3,1,3,0,1,0,76.14,68.53 ,33.33
03,011,01,022,0391,534,413,4,417,567,0,3,1,3,0,1,0,76.14,73.54 ,33.33
03,011,01,022,0392,535,292,2,294,369,0,3,1,3,0,1,0,76.14,79.67 ,33.33
03,011,01,022,0393,536,224,3,227,307,0,3,1,3,0,1,0,76.14,73.94 ,33.33
03,011,01,023,0394,537,732,6,738,1054,0,3,1,3,0,1,0,76.14,70.02 ,33.33
03,011,01,023,0395,538,1369,11,1380,2068,0,3,1,3,0,1,0,76.14,66.73 ,33.33
03,011,01,023,0395,539,1338,12,1350,1918,0,3,1,3,0,1,0,76.14,70.39 ,33.33
03,011,01,023,0396,540,882,9,891,1282,0,3,1,3,0,1,0,76.14,69.50 ,33.33
03,011,01,023,0397,541,833,7,840,1260,0,3,1,3,0,1,0,76.14,66.67 ,33.33
03,011,01,023,0398,542,339,5,344,496,0,3,1,3,0,1,0,76.14,69.35 ,33.33
03,011,01,023,0399,543,308,2,310,501,0,3,1,3,0,1,0,76.14,61.88 ,33.33
03,011,01,023,0400,544,556,5,561,772,0,3,1,3,0,1,0,76.14,72.67 ,33.33
03,011,01,023,0401,545,1025,10,1035,1523,0,3,1,3,0,1,0,76.14,67.96 ,33.33
03,011,01,023,0402,546,514,2,516,710,0,3,1,3,0,1,0,76.14,72.68 ,33.33
03,011,01,023,0403,547,737,6,743,1073,0,3,1,3,0,1,0,76.14,69.25 ,33.33
03,011,01,024,0404,548,648,6,654,1018,0,3,1,3,0,1,0,76.14,64.24 ,33.33
03,011,01,024,0404,549,563,4,567,854,0,3,1,3,0,1,0,76.14,66.39 ,33.33
03,011,01,024,0405,550,814,12,826,1305,0,3,1,3,0,1,0,76.14,63.30 ,33.33
03,011,01,024,0406,551,583,11,594,903,0,3,1,3,0,1,0,76.14,65.78 ,33.33
03,011,01,024,0407,552,664,3,667,1102,0,3,1,3,0,1,0,76.14,60.53 ,33.33
03,011,01,024,0408,553,743,11,754,1108,0,3,1,3,0,1,0,76.14,68.05 ,33.33
03,011,01,024,0409,554,466,4,470,689,0,3,1,3,0,1,0,76.14,68.21 ,33.33
03,011,01,024,0410,555,718,8,726,1043,0,3,1,3,0,1,0,76.14,69.61 ,33.33
03,011,01,024,0410,556,763,9,772,1193,0,3,1,3,0,1,0,76.14,64.71 ,33.33
03,011,01,025,0411,557,932,13,945,1404,0,3,1,3,0,1,0,76.14,67.31 ,33.33
03,011,01,025,0412,558,548,5,553,789,0,3,1,3,0,1,0,76.14,70.09 ,33.33
03,011,01,025,0413,559,360,5,365,493,0,3,1,3,0,1,0,76.14,74.04 ,33.33
03,011,01,025,0414,560,385,3,388,550,0,3,1,3,0,1,0,76.14,70.55 ,33.33
03,011,01,025,0415,561,397,10,407,670,0,3,1,3,0,1,0,76.14,60.75 ,33.33
03,011,01,025,0416,562,571,8,579,846,0,3,1,3,0,1,0,76.14,68.44 ,33.33
03,011,01,025,0417,563,815,6,821,1184,0,3,1,3,0,1,0,76.14,69.34 ,33.33
03,011,01,025,0418,564,668,3,671,921,0,3,1,3,0,1,0,76.14,72.86 ,33.33
03,011,01,025,0419,565,260,5,265,518,0,3,1,3,0,1,0,76.14,51.16 ,33.33
03,011,01,026,0420,566,319,9,328,489,0,3,1,3,0,1,0,76.14,67.08 ,33.33
03,011,01,026,0421,567,488,7,495,747,0,3,1,3,0,1,0,76.14,66.27 ,33.33
03,011,01,026,0422,568,382,7,389,549,0,3,1,3,0,1,0,76.14,70.86 ,33.33
03,011,01,026,0423,569,681,5,686,916,0,3,1,3,0,1,0,76.14,74.89 ,33.33
03,011,01,026,0424,570,258,1,259,333,0,3,1,3,0,1,0,76.14,77.78 ,33.33
03,011,01,026,0425,571,331,6,337,481,0,3,1,3,0,1,0,76.14,70.06 ,33.33
03,011,01,026,0426,572,290,6,296,431,0,3,1,3,0,1,0,76.14,68.68 ,33.33
03,011,01,026,0427,573,220,2,222,303,0,3,1,3,0,1,0,76.14,73.27 ,33.33
03,011,01,026,0428,574,156,2,158,217,0,3,1,3,0,1,0,76.14,72.81 ,33.33
03,011,01,026,0429,575,381,6,387,606,0,3,1,3,0,1,0,76.14,63.86 ,33.33
03,011,01,027,0430,576,965,7,972,1383,0,3,1,3,0,1,0,76.14,70.28 ,33.33
03,011,01,027,0430,577,799,11,810,1107,0,3,1,3,0,1,0,76.14,73.17 ,33.33
03,011,01,027,0430,578,736,9,745,1130,0,3,1,3,0,1,0,76.14,65.93 ,33.33
03,011,01,027,0431,579,680,4,684,962,0,3,1,3,0,1,0,76.14,71.10 ,33.33
03,011,01,027,0431,580,751,7,758,1087,0,3,1,3,0,1,0,76.14,69.73 ,33.33
03,011,01,027,0432,581,493,7,500,702,0,3,1,3,0,1,0,76.14,71.23 ,33.33
03,011,01,027,0432,582,513,6,519,817,0,3,1,3,0,1,0,76.14,63.53 ,33.33
03,011,01,027,0433,583,779,14,793,1131,0,3,1,3,0,1,0,76.14,70.11 ,33.33
03,011,01,027,0433,584,602,8,610,954,0,3,1,3,0,1,0,76.14,63.94 ,33.33
03,011,01,027,0433,585,716,4,720,1117,0,3,1,3,0,1,0,76.14,64.46 ,33.33
03,011,01,027,0434,586,785,9,794,1056,0,3,1,3,0,1,0,76.14,75.19 ,33.33
03,011,01,027,0434,587,743,9,752,1033,0,3,1,3,0,1,0,76.14,72.80 ,33.33
03,011,01,027,0434,588,813,8,821,1332,0,3,1,3,0,1,0,76.14,61.64 ,33.33
03,011,01,027,0434,589,497,6,503,736,0,3,1,3,0,1,0,76.14,68.34 ,33.33
03,011,01,027,0434,590,737,17,754,1089,0,3,1,3,0,1,0,76.14,69.24 ,33.33
03,011,01,027,0435,591,870,11,881,1331,0,3,1,3,0,1,0,76.14,66.19 ,33.33
03,011,01,027,0435,592,495,7,502,737,0,3,1,3,0,1,0,76.14,68.11 ,33.33
03,011,01,027,0436,593,639,9,648,1056,0,3,1,3,0,1,0,76.14,61.36 ,33.33
03,011,01,027,0436,594,792,13,805,1173,0,3,1,3,0,1,0,76.14,68.63 ,33.33
03,011,01,027,0436,595,760,14,774,1160,0,3,1,3,0,1,0,76.14,66.72 ,33.33
03,011,01,027,0436,596,746,16,762,1335,0,3,1,3,0,1,0,76.14,57.08 ,33.33
03,011,01,027,0437,597,729,16,745,1216,0,3,1,3,0,1,0,76.14,61.27 ,33.33
03,011,01,027,0437,598,889,9,898,1368,0,3,1,3,0,1,0,76.14,65.64 ,33.33
03,011,01,027,0437,599,447,12,459,646,0,3,1,3,0,1,0,76.14,71.05 ,33.33
03,011,01,027,0438,600,855,15,870,1162,0,3,1,3,0,1,0,76.14,74.87 ,33.33
03,011,01,027,0439,601,451,5,456,625,0,3,1,3,0,1,0,76.14,72.96 ,33.33
03,011,01,027,0440,602,473,5,478,728,0,3,1,3,0,1,0,76.14,65.66 ,33.33
03,011,01,027,0440,603,777,7,784,1221,0,3,1,3,0,1,0,76.14,64.21 ,33.33
03,011,01,027,0441,604,742,14,756,1132,0,3,1,3,0,1,0,76.14,66.78 ,33.33
03,011,01,027,0441,605,621,10,631,936,0,3,1,3,0,1,0,76.14,67.41 ,33.33
03,011,01,027,0441,606,705,11,716,1057,0,3,1,3,0,1,0,76.14,67.74 ,33.33
03,011,01,027,0441,607,207,7,214,343,0,3,1,3,0,1,0,76.14,62.39 ,33.33
03,011,01,027,0442,608,868,20,888,1249,0,3,1,3,0,1,0,76.14,71.10 ,33.33
03,011,01,027,0443,609,697,9,706,1001,0,3,1,3,0,1,0,76.14,70.53 ,33.33
03,011,01,027,0443,610,654,9,663,963,0,3,1,3,0,1,0,76.14,68.85 ,33.33
03,011,01,027,0444,611,702,17,719,1097,0,3,1,3,0,1,0,76.14,65.54 ,33.33
03,011,01,027,0444,612,549,11,560,800,0,3,1,3,0,1,0,76.14,70.00 ,33.33
03,011,01,027,0445,613,556,12,568,772,0,3,1,3,0,1,0,76.14,73.58 ,33.33
03,011,01,027,0445,614,684,9,693,991,0,3,1,3,0,1,0,76.14,69.93 ,33.33
03,011,01,027,0446,615,727,6,733,1219,0,3,1,3,0,1,0,76.14,60.13 ,33.33
03,011,01,027,0447,616,827,14,841,1307,0,3,1,3,0,1,0,76.14,64.35 ,33.33
03,011,01,028,0448,617,900,15,915,1282,0,3,1,3,0,1,0,76.14,71.37 ,33.33
03,011,01,028,0448,618,775,11,786,1163,0,3,1,3,0,1,0,76.14,67.58 ,33.33
03,011,01,028,0448,619,885,13,898,1222,0,3,1,3,0,1,0,76.14,73.49 ,33.33
03,011,01,028,0449,620,756,11,767,1143,0,3,1,3,0,1,0,76.14,67.10 ,33.33
03,011,01,028,0449,621,677,8,685,998,0,3,1,3,0,1,0,76.14,68.64 ,33.33
03,011,01,028,0450,622,692,6,698,1004,0,3,1,3,0,1,0,76.14,69.52 ,33.33
03,011,01,028,0450,623,669,7,676,1028,0,3,1,3,0,1,0,76.14,65.76 ,33.33
03,011,01,028,0450,624,722,9,731,1035,0,3,1,3,0,1,0,76.14,70.63 ,33.33
03,011,01,028,0450,625,844,15,859,1277,0,3,1,3,0,1,0,76.14,67.27 ,33.33
03,011,01,028,0451,626,786,4,790,1098,0,3,1,3,0,1,0,76.14,71.95 ,33.33
03,011,01,028,0451,627,719,6,725,1019,0,3,1,3,0,1,0,76.14,71.15 ,33.33
03,011,01,028,0451,628,666,8,674,1015,0,3,1,3,0,1,0,76.14,66.40 ,33.33
03,011,01,028,0451,629,764,6,770,1126,0,3,1,3,0,1,0,76.14,68.38 ,33.33
03,011,01,028,0452,630,957,12,969,1395,0,3,1,3,0,1,0,76.14,69.46 ,33.33
03,011,01,028,0452,631,858,10,868,1344,0,3,1,3,0,1,0,76.14,64.58 ,33.33
03,011,01,028,0452,632,811,9,820,1178,0,3,1,3,0,1,0,76.14,69.61 ,33.33
03,011,01,028,0453,633,997,10,1007,1423,0,3,1,3,0,1,0,76.14,70.77 ,33.33
03,011,01,028,0453,634,719,2,721,958,0,3,1,3,0,1,0,76.14,75.26 ,33.33
03,011,01,028,0454,635,859,9,868,1200,0,3,1,3,0,1,0,76.14,72.33 ,33.33
03,011,01,028,0455,636,857,17,874,1194,0,3,1,3,0,1,0,76.14,73.20 ,33.33
03,011,01,028,0456,637,584,4,588,773,0,3,1,3,0,1,0,76.14,76.07 ,33.33
03,011,01,028,0456,638,652,5,657,851,0,3,1,3,0,1,0,76.14,77.20 ,33.33
03,011,01,028,0457,639,334,4,338,484,0,3,1,3,0,1,0,76.14,69.83 ,33.33
03,011,01,028,0458,640,602,8,610,835,0,3,1,3,0,1,0,76.14,73.05 ,33.33
03,011,01,028,0458,641,489,3,492,710,0,3,1,3,0,1,0,76.14,69.30 ,33.33
03,011,01,028,0459,642,746,17,763,1348,0,3,1,3,0,1,0,76.14,56.60 ,33.33
03,011,01,028,0460,643,554,10,564,844,0,3,1,3,0,1,0,76.14,66.82 ,33.33
03,011,01,028,0460,644,538,2,540,760,0,3,1,3,0,1,0,76.14,71.05 ,33.33
03,011,01,028,0461,645,742,1,743,1045,0,3,1,3,0,1,0,76.14,71.10 ,33.33
03,011,01,028,0461,646,459,8,467,652,0,3,1,3,0,1,0,76.14,71.63 ,33.33
03,011,01,028,0462,647,960,8,968,1397,0,3,1,3,0,1,0,76.14,69.29 ,33.33
03,011,01,028,0463,648,624,6,630,888,0,3,1,3,0,1,0,76.14,70.95 ,33.33
03,011,01,028,0463,649,523,11,534,764,0,3,1,3,0,1,0,76.14,69.90 ,33.33
03,011,01,028,0464,650,500,9,509,659,0,3,1,3,0,1,0,76.14,77.24 ,33.33
03,011,01,028,0464,651,387,6,393,567,0,3,1,3,0,1,0,76.14,69.31 ,33.33
03,011,01,028,0465,652,776,16,792,1150,0,3,1,3,0,1,0,76.14,68.87 ,33.33
03,011,01,028,0465,653,566,13,579,767,0,3,1,3,0,1,0,76.14,75.49 ,33.33
03,011,01,029,0466,654,563,3,566,806,0,3,1,3,0,1,0,76.14,70.22 ,33.33
03,011,01,029,0466,655,683,7,690,937,0,3,1,3,0,1,0,76.14,73.64 ,33.33
03,011,01,029,0467,656,586,5,591,835,0,3,1,3,0,1,0,76.14,70.78 ,33.33
03,011,01,029,0467,657,609,5,614,850,0,3,1,3,0,1,0,76.14,72.24 ,33.33
03,011,01,029,0468,658,725,5,730,1038,0,3,1,3,0,1,0,76.14,70.33 ,33.33
03,011,01,029,0468,659,761,4,765,1144,0,3,1,3,0,1,0,76.14,66.87 ,33.33
03,011,01,029,0468,660,838,14,852,1237,0,3,1,3,0,1,0,76.14,68.88 ,33.33
03,011,01,029,0469,661,855,12,867,1272,0,3,1,3,0,1,0,76.14,68.16 ,33.33
03,011,01,029,0469,662,794,8,802,1192,0,3,1,3,0,1,0,76.14,67.28 ,33.33
03,011,01,029,0470,663,538,4,542,758,0,3,1,3,0,1,0,76.14,71.50 ,33.33
03,011,01,029,0471,664,531,7,538,794,0,3,1,3,0,1,0,76.14,67.76 ,33.33
03,011,01,029,0472,665,882,14,896,1254,0,3,1,3,0,1,0,76.14,71.45 ,33.33
03,011,01,029,0472,666,732,8,740,1001,0,3,1,3,0,1,0,76.14,73.93 ,33.33
03,011,01,029,0473,667,922,7,929,1354,0,3,1,3,0,1,0,76.14,68.61 ,33.33
03,011,01,029,0473,668,832,6,838,1208,0,3,1,3,0,1,0,76.14,69.37 ,33.33
03,011,01,029,0474,669,571,7,578,855,0,3,1,3,0,1,0,76.14,67.60 ,33.33
03,011,01,029,0474,670,730,6,736,1030,0,3,1,3,0,1,0,76.14,71.46 ,33.33
03,011,01,029,0475,671,878,11,889,1278,0,3,1,3,0,1,0,76.14,69.56 ,33.33
03,011,01,029,0476,672,649,8,657,905,0,3,1,3,0,1,0,76.14,72.60 ,33.33
03,011,01,029,0476,673,801,7,808,1170,0,3,1,3,0,1,0,76.14,69.06 ,33.33
03,011,01,029,0477,674,1049,9,1058,1412,0,3,1,3,0,1,0,76.14,74.93 ,33.33
03,011,01,029,0478,675,768,10,778,1170,0,3,1,3,0,1,0,76.14,66.50 ,33.33
03,011,01,029,0479,676,513,5,518,774,0,3,1,3,0,1,0,76.14,66.93 ,33.33
03,011,01,029,0480,677,526,5,531,719,0,3,1,3,0,1,0,76.14,73.85 ,33.33
03,011,01,029,0481,678,924,7,931,1335,0,3,1,3,0,1,0,76.14,69.74 ,33.33
03,011,01,029,0482,679,299,6,305,396,0,3,1,3,0,1,0,76.14,77.02 ,33.33
03,011,01,030,0483,680,811,8,819,1200,0,3,1,3,0,1,0,76.14,68.25 ,33.33
03,011,01,030,0484,681,501,6,507,693,0,3,1,3,0,1,0,76.14,73.16 ,33.33
03,011,01,030,0485,682,111,1,112,202,0,3,1,3,0,1,0,76.14,55.45 ,33.33
03,011,01,030,0486,683,224,4,228,306,0,3,1,3,0,1,0,76.14,74.51 ,33.33
03,011,01,030,0487,684,213,2,215,285,0,3,1,3,0,1,0,76.14,75.44 ,33.33
03,011,01,030,0488,685,230,0,230,325,0,3,1,3,0,1,0,76.14,70.77 ,33.33
03,011,01,030,0489,686,322,2,324,437,0,3,1,3,0,1,0,76.14,74.14 ,33.33
03,011,01,030,0490,687,253,3,256,393,0,3,1,3,0,1,0,76.14,65.14 ,33.33
03,011,01,031,0491,688,768,9,777,1270,0,3,1,3,0,1,0,76.14,61.18 ,33.33
03,011,01,031,0491,689,623,7,630,1031,0,3,1,3,0,1,0,76.14,61.11 ,33.33
03,011,01,031,0491,690,672,6,678,1126,0,3,1,3,0,1,0,76.14,60.21 ,33.33
03,011,01,031,0492,691,733,16,749,1183,0,3,1,3,0,1,0,76.14,63.31 ,33.33
03,011,01,031,0492,692,635,13,648,1046,0,3,1,3,0,1,0,76.14,61.95 ,33.33
03,011,01,031,0493,693,731,12,743,1118,0,3,1,3,0,1,0,76.14,66.46 ,33.33
03,011,01,031,0493,694,386,6,392,661,0,3,1,3,0,1,0,76.14,59.30 ,33.33
03,011,01,031,0494,695,995,16,1011,1672,0,3,1,3,0,1,0,76.14,60.47 ,33.33
03,011,01,031,0494,696,759,7,766,1200,0,3,1,3,0,1,0,76.14,63.83 ,33.33
03,011,01,031,0495,697,658,6,664,990,0,3,1,3,0,1,0,76.14,67.07 ,33.33
03,011,01,031,0495,698,764,7,771,1244,0,3,1,3,0,1,0,76.14,61.98 ,33.33
03,011,01,031,0495,699,587,5,592,917,0,3,1,3,0,1,0,76.14,64.56 ,33.33
03,011,01,031,0495,700,703,10,713,1188,0,3,1,3,0,1,0,76.14,60.02 ,33.33
03,011,01,031,0496,701,717,10,727,1082,0,3,1,3,0,1,0,76.14,67.19 ,33.33
03,011,01,031,0496,702,878,8,886,1247,0,3,1,3,0,1,0,76.14,71.05 ,33.33
03,011,01,031,0496,703,838,4,842,1245,0,3,1,3,0,1,0,76.14,67.63 ,33.33
03,011,01,031,0496,704,600,7,607,1037,0,3,1,3,0,1,0,76.14,58.53 ,33.33
03,011,01,031,0497,705,730,13,743,1027,0,3,1,3,0,1,0,76.14,72.35 ,33.33
03,011,01,031,0497,706,751,11,762,1103,0,3,1,3,0,1,0,76.14,69.08 ,33.33
03,011,01,031,0497,707,865,17,882,1289,0,3,1,3,0,1,0,76.14,68.43 ,33.33
03,011,01,031,0498,708,737,6,743,1083,0,3,1,3,0,1,0,76.14,68.61 ,33.33
03,011,01,031,0498,709,674,6,680,1012,0,3,1,3,0,1,0,76.14,67.19 ,33.33
03,011,01,031,0498,710,859,11,870,1394,0,3,1,3,0,1,0,76.14,62.41 ,33.33
03,011,01,031,0498,711,700,9,709,1048,0,3,1,3,0,1,0,76.14,67.65 ,33.33
03,011,01,031,0499,712,890,19,909,1531,0,3,1,3,0,1,0,76.14,59.37 ,33.33
03,011,01,031,0499,713,700,8,708,1090,0,3,1,3,0,1,0,76.14,64.95 ,33.33
03,011,01,031,0499,714,591,3,594,943,0,3,1,3,0,1,0,76.14,62.99 ,33.33
03,011,01,031,0500,715,433,8,441,697,0,3,1,3,0,1,0,76.14,63.27 ,33.33
03,011,01,031,0500,716,492,3,495,776,0,3,1,3,0,1,0,76.14,63.79 ,33.33
03,011,01,031,0500,717,473,8,481,709,0,3,1,3,0,1,0,76.14,67.84 ,33.33
03,011,01,031,0501,718,629,19,648,1085,0,3,1,3,0,1,0,76.14,59.72 ,33.33
03,011,01,031,0501,719,640,6,646,1025,0,3,1,3,0,1,0,76.14,63.02 ,33.33
03,011,01,031,0502,720,587,7,594,1015,0,3,1,3,0,1,0,76.14,58.52 ,33.33
03,011,01,031,0502,721,642,15,657,1068,0,3,1,3,0,1,0,76.14,61.52 ,33.33
03,011,01,031,0503,722,822,11,833,1171,0,3,1,3,0,1,0,76.14,71.14 ,33.33
03,011,01,031,0504,723,729,9,738,1010,0,3,1,3,0,1,0,76.14,73.07 ,33.33
03,011,01,031,0505,724,732,15,747,988,0,3,1,3,0,1,0,76.14,75.61 ,33.33
03,011,01,031,0505,725,681,9,690,1015,0,3,1,3,0,1,0,76.14,67.98 ,33.33
03,011,01,031,0505,726,660,8,668,1030,0,3,1,3,0,1,0,76.14,64.85 ,33.33
03,011,01,031,0505,727,583,8,591,993,0,3,1,3,0,1,0,76.14,59.52 ,33.33
03,011,01,031,0505,728,606,8,614,895,0,3,1,3,0,1,0,76.14,68.60 ,33.33
03,011,01,031,0506,729,841,15,856,1245,0,3,1,3,0,1,0,76.14,68.76 ,33.33
03,011,01,031,0506,730,735,15,750,1090,0,3,1,3,0,1,0,76.14,68.81 ,33.33
03,011,01,031,0506,731,620,7,627,910,0,3,1,3,0,1,0,76.14,68.90 ,33.33
03,011,01,031,0507,732,521,5,526,698,0,3,1,3,0,1,0,76.14,75.36 ,33.33
03,011,01,031,0507,733,481,1,482,790,0,3,1,3,0,1,0,76.14,61.01 ,33.33
03,011,01,031,0507,734,499,5,504,740,0,3,1,3,0,1,0,76.14,68.11 ,33.33
03,011,01,031,0508,735,631,5,636,913,0,3,1,3,0,1,0,76.14,69.66 ,33.33
03,011,01,031,0508,736,580,6,586,952,0,3,1,3,0,1,0,76.14,61.55 ,33.33
03,011,01,031,0508,737,523,8,531,790,0,3,1,3,0,1,0,76.14,67.22 ,33.33
03,011,01,031,0509,738,814,13,827,1189,0,3,1,3,0,1,0,76.14,69.55 ,33.33
03,011,01,031,0509,739,674,10,684,1036,0,3,1,3,0,1,0,76.14,66.02 ,33.33
03,011,01,031,0509,740,697,9,706,1066,0,3,1,3,0,1,0,76.14,66.23 ,33.33
03,011,01,031,0509,741,624,10,634,1114,0,3,1,3,0,1,0,76.14,56.91 ,33.33
03,011,01,031,0510,742,689,10,699,1041,0,3,1,3,0,1,0,76.14,67.15 ,33.33
03,011,01,031,0510,743,340,2,342,465,0,3,1,3,0,1,0,76.14,73.55 ,33.33
03,011,01,031,0511,744,789,6,795,1162,0,3,1,3,0,1,0,76.14,68.42 ,33.33
03,011,01,031,0512,745,769,12,781,1092,0,3,1,3,0,1,0,76.14,71.52 ,33.33
03,011,01,031,0512,746,646,6,652,970,0,3,1,3,0,1,0,76.14,67.22 ,33.33
03,011,01,031,0512,747,679,20,699,1020,0,3,1,3,0,1,0,76.14,68.53 ,33.33
03,011,01,031,0513,748,769,11,780,1133,0,3,1,3,0,1,0,76.14,68.84 ,33.33
03,011,01,031,0514,749,735,9,744,997,0,3,1,3,0,1,0,76.14,74.62 ,33.33
03,011,01,031,0514,750,528,7,535,733,0,3,1,3,0,1,0,76.14,72.99 ,33.33
03,011,01,031,0514,751,687,9,696,964,0,3,1,3,0,1,0,76.14,72.20 ,33.33
03,011,01,031,0515,752,616,7,623,870,0,3,1,3,0,1,0,76.14,71.61 ,33.33
03,011,01,031,0515,753,574,10,584,850,0,3,1,3,0,1,0,76.14,68.71 ,33.33
03,011,01,031,0515,754,683,3,686,1022,0,3,1,3,0,1,0,76.14,67.12 ,33.33
03,011,01,031,0516,755,849,12,861,1213,0,3,1,3,0,1,0,76.14,70.98 ,33.33
03,011,01,031,0516,756,825,14,839,1296,0,3,1,3,0,1,0,76.14,64.74 ,33.33
03,011,01,031,0516,757,861,17,878,1280,0,3,1,3,0,1,0,76.14,68.59 ,33.33
03,011,01,031,0517,758,620,6,626,853,0,3,1,3,0,1,0,76.14,73.39 ,33.33
03,011,01,031,0517,759,766,6,772,1063,0,3,1,3,0,1,0,76.14,72.62 ,33.33
03,011,01,031,0517,760,872,7,879,1236,0,3,1,3,0,1,0,76.14,71.12 ,33.33
03,011,01,031,0518,761,690,13,703,1100,0,3,1,3,0,1,0,76.14,63.91 ,33.33
03,011,01,031,0518,762,699,14,713,1015,0,3,1,3,0,1,0,76.14,70.25 ,33.33
03,011,01,031,0518,763,754,12,766,1177,0,3,1,3,0,1,0,76.14,65.08 ,33.33
03,011,01,031,0518,764,670,7,677,1033,0,3,1,3,0,1,0,76.14,65.54 ,33.33
03,011,01,031,0519,765,840,13,853,1161,0,3,1,3,0,1,0,76.14,73.47 ,33.33
03,011,01,031,0519,766,842,11,853,1284,0,3,1,3,0,1,0,76.14,66.43 ,33.33
03,011,01,031,0519,767,965,12,977,1554,0,3,1,3,0,1,0,76.14,62.87 ,33.33
03,011,01,031,0520,768,604,17,621,891,0,3,1,3,0,1,0,76.14,69.70 ,33.33
03,011,01,031,0520,769,727,15,742,1056,0,3,1,3,0,1,0,76.14,70.27 ,33.33
03,011,01,031,0521,770,858,14,872,1220,0,3,1,3,0,1,0,76.14,71.48 ,33.33
03,011,01,031,0521,771,672,12,684,878,0,3,1,3,0,1,0,76.14,77.90 ,33.33
03,011,01,031,0522,772,714,5,719,1034,0,3,1,3,0,1,0,76.14,69.54 ,33.33
03,011,01,031,0522,773,558,6,564,860,0,3,1,3,0,1,0,76.14,65.58 ,33.33
03,011,01,031,0523,774,1264,16,1280,2111,0,3,1,3,0,1,0,76.14,60.63 ,33.33
03,011,01,031,0523,775,705,14,719,1248,0,3,1,3,0,1,0,76.14,57.61 ,33.33
03,011,01,031,0523,776,768,12,780,1166,0,3,1,3,0,1,0,76.14,66.90 ,33.33
03,011,01,031,0523,777,806,9,815,1404,0,3,1,3,0,1,0,76.14,58.05 ,33.33
03,011,01,031,0524,778,904,15,919,1259,0,3,1,3,0,1,0,76.14,72.99 ,33.33
03,011,01,031,0525,779,717,7,724,963,0,3,1,3,0,1,0,76.14,75.18 ,33.33
03,011,01,031,0525,780,553,8,561,863,0,3,1,3,0,1,0,76.14,65.01 ,33.33
03,011,01,031,0526,781,800,11,811,1106,0,3,1,3,0,1,0,76.14,73.33 ,33.33
03,011,01,031,0526,782,819,14,833,1254,0,3,1,3,0,1,0,76.14,66.43 ,33.33
03,011,01,031,0527,783,490,4,494,797,0,3,1,3,0,1,0,76.14,61.98 ,33.33
03,011,01,031,0527,784,496,1,497,800,0,3,1,3,0,1,0,76.14,62.13 ,33.33
03,011,01,031,0528,785,804,14,818,1268,0,3,1,3,0,1,0,76.14,64.51 ,33.33
03,011,01,031,0528,786,923,16,939,1458,0,3,1,3,0,1,0,76.14,64.40 ,33.33
03,011,01,031,0529,787,631,10,641,973,0,3,1,3,0,1,0,76.14,65.88 ,33.33
03,011,01,031,0529,788,643,6,649,1081,0,3,1,3,0,1,0,76.14,60.04 ,33.33
03,011,01,031,0529,789,577,3,580,942,0,3,1,3,0,1,0,76.14,61.57 ,33.33
03,011,01,031,0529,790,590,12,602,1001,0,3,1,3,0,1,0,76.14,60.14 ,33.33
03,012,01,001,0001,1,469,5,474,690,0,3,1,3,0,1,0,76.14,68.70 ,33.33
03,012,01,001,0001,2,511,6,517,754,0,3,1,3,0,1,0,76.14,68.57 ,33.33
03,012,01,001,0002,3,584,6,590,924,0,3,1,3,0,1,0,76.14,63.85 ,33.33
03,012,01,001,0003,4,802,8,810,1184,0,3,1,3,0,1,0,76.14,68.41 ,33.33
03,012,01,001,0003,5,734,8,742,1121,0,3,1,3,0,1,0,76.14,66.19 ,33.33
03,012,01,001,0004,6,925,14,939,1428,0,3,1,3,0,1,0,76.14,65.76 ,33.33
03,012,01,001,0004,7,806,14,820,1267,0,3,1,3,0,1,0,76.14,64.72 ,33.33
03,012,01,001,0004,8,777,1,778,1111,0,3,1,3,0,1,0,76.14,70.03 ,33.33
03,012,01,001,0004,9,851,5,856,1357,0,3,1,3,0,1,0,76.14,63.08 ,33.33
03,012,01,001,0005,10,696,11,707,1053,0,3,1,3,0,1,0,76.14,67.14 ,33.33
03,012,01,001,0005,11,667,13,680,993,0,3,1,3,0,1,0,76.14,68.48 ,33.33
03,012,01,001,0005,12,668,13,681,1043,0,3,1,3,0,1,0,76.14,65.29 ,33.33
03,012,01,001,0005,13,696,6,702,1072,0,3,1,3,0,1,0,76.14,65.49 ,33.33
03,012,01,001,0006,14,953,3,956,1557,0,3,1,3,0,1,0,76.14,61.40 ,33.33
03,012,01,001,0006,15,827,15,842,1312,0,3,1,3,0,1,0,76.14,64.18 ,33.33
03,012,01,001,0006,16,700,7,707,1154,0,3,1,3,0,1,0,76.14,61.27 ,33.33
03,012,01,001,0006,17,1069,13,1082,1686,0,3,1,3,0,1,0,76.14,64.18 ,33.33
03,012,01,001,0007,18,783,11,794,1153,0,3,1,3,0,1,0,76.14,68.86 ,33.33
03,012,01,001,0007,19,723,5,728,1127,0,3,1,3,0,1,0,76.14,64.60 ,33.33
03,012,01,001,0008,20,628,3,631,918,0,3,1,3,0,1,0,76.14,68.74 ,33.33
03,012,01,001,0008,21,725,10,735,1167,0,3,1,3,0,1,0,76.14,62.98 ,33.33
03,012,01,001,0009,22,697,7,704,1018,0,3,1,3,0,1,0,76.14,69.16 ,33.33
03,012,01,001,0009,23,651,8,659,991,0,3,1,3,0,1,0,76.14,66.50 ,33.33
03,012,01,001,0009,24,789,3,792,1218,0,3,1,3,0,1,0,76.14,65.02 ,33.33
03,012,01,001,0009,25,646,4,650,992,0,3,1,3,0,1,0,76.14,65.52 ,33.33
03,012,01,001,0010,26,542,4,546,813,0,3,1,3,0,1,0,76.14,67.16 ,33.33
03,012,01,001,0010,27,762,9,771,1145,0,3,1,3,0,1,0,76.14,67.34 ,33.33
03,012,01,001,0010,28,622,6,628,895,0,3,1,3,0,1,0,76.14,70.17 ,33.33
03,012,01,001,0010,29,799,9,808,1309,0,3,1,3,0,1,0,76.14,61.73 ,33.33
03,012,01,001,0011,30,601,5,606,1022,0,3,1,3,0,1,0,76.14,59.30 ,33.33
03,012,01,001,0011,31,808,16,824,1188,0,3,1,3,0,1,0,76.14,69.36 ,33.33
03,012,01,001,0011,32,628,4,632,1055,0,3,1,3,0,1,0,76.14,59.91 ,33.33
03,012,01,001,0011,33,574,5,579,946,0,3,1,3,0,1,0,76.14,61.21 ,33.33
03,012,01,001,0011,34,601,4,605,992,0,3,1,3,0,1,0,76.14,60.99 ,33.33
03,012,01,001,0011,35,558,5,563,948,0,3,1,3,0,1,0,76.14,59.39 ,33.33
03,012,01,001,0011,36,493,3,496,910,0,3,1,3,0,1,0,76.14,54.51 ,33.33
03,012,01,001,0011,37,573,9,582,969,0,3,1,3,0,1,0,76.14,60.06 ,33.33
03,012,01,001,0012,38,681,10,691,949,0,3,1,3,0,1,0,76.14,72.81 ,33.33
03,012,01,001,0013,39,387,3,390,549,0,3,1,3,0,1,0,76.14,71.04 ,33.33
03,012,01,001,0014,40,421,10,431,638,0,3,1,3,0,1,0,76.14,67.55 ,33.33
03,012,01,001,0014,41,595,8,603,854,0,3,1,3,0,1,0,76.14,70.61 ,33.33
03,012,01,001,0015,42,619,7,626,901,0,3,1,3,0,1,0,76.14,69.48 ,33.33
03,012,01,001,0015,43,494,5,499,741,0,3,1,3,0,1,0,76.14,67.34 ,33.33
03,012,01,001,0016,44,744,5,749,1066,0,3,1,3,0,1,0,76.14,70.26 ,33.33
03,012,01,001,0016,45,827,7,834,1224,0,3,1,3,0,1,0,76.14,68.14 ,33.33
03,012,01,001,0016,46,735,2,737,1141,0,3,1,3,0,1,0,76.14,64.59 ,33.33
03,012,01,001,0016,47,812,10,822,1213,0,3,1,3,0,1,0,76.14,67.77 ,33.33
03,012,01,001,0017,48,714,11,725,1064,0,3,1,3,0,1,0,76.14,68.14 ,33.33
03,012,01,001,0018,49,784,13,797,1181,0,3,1,3,0,1,0,76.14,67.49 ,33.33
03,012,01,001,0019,50,799,9,808,1128,0,3,1,3,0,1,0,76.14,71.63 ,33.33
03,012,01,001,0020,51,747,4,751,1091,0,3,1,3,0,1,0,76.14,68.84 ,33.33
03,012,01,001,0020,52,447,4,451,689,0,3,1,3,0,1,0,76.14,65.46 ,33.33
03,012,01,001,0020,53,688,4,692,1027,0,3,1,3,0,1,0,76.14,67.38 ,33.33
03,012,01,001,0020,54,684,8,692,1009,0,3,1,3,0,1,0,76.14,68.58 ,33.33
03,012,01,001,0021,55,559,8,567,831,0,3,1,3,0,1,0,76.14,68.23 ,33.33
03,012,01,001,0022,56,781,21,802,1284,0,3,1,3,0,1,0,76.14,62.46 ,33.33
03,012,01,001,0022,57,825,13,838,1234,0,3,1,3,0,1,0,76.14,67.91 ,33.33
03,012,01,001,0022,58,835,7,842,1100,0,3,1,3,0,1,0,76.14,76.55 ,33.33
03,012,01,001,0023,59,573,7,580,875,0,3,1,3,0,1,0,76.14,66.29 ,33.33
03,012,01,001,0023,60,691,6,697,1084,0,3,1,3,0,1,0,76.14,64.30 ,33.33
03,012,01,001,0023,61,758,8,766,1171,0,3,1,3,0,1,0,76.14,65.41 ,33.33
03,012,01,001,0024,62,717,7,724,1165,0,3,1,3,0,1,0,76.14,62.15 ,33.33
03,012,01,001,0024,63,859,14,873,1250,0,3,1,3,0,1,0,76.14,69.84 ,33.33
03,012,01,001,0024,64,699,9,708,1066,0,3,1,3,0,1,0,76.14,66.42 ,33.33
03,012,01,001,0024,65,602,5,607,956,0,3,1,3,0,1,0,76.14,63.49 ,33.33
03,012,01,001,0025,66,761,9,770,1109,0,3,1,3,0,1,0,76.14,69.43 ,33.33
03,012,01,001,0025,67,753,7,760,1097,0,3,1,3,0,1,0,76.14,69.28 ,33.33
03,012,01,001,0025,68,740,4,744,1022,0,3,1,3,0,1,0,76.14,72.80 ,33.33
03,012,01,001,0026,69,467,2,469,602,0,3,1,3,0,1,0,76.14,77.91 ,33.33
03,012,01,001,0026,70,426,5,431,555,0,3,1,3,0,1,0,76.14,77.66 ,33.33
03,012,01,001,0027,71,479,2,481,649,0,3,1,3,0,1,0,76.14,74.11 ,33.33
03,012,01,001,0028,72,1053,17,1070,1454,0,3,1,3,0,1,0,76.14,73.59 ,33.33
03,012,01,001,0029,73,738,6,744,1184,0,3,1,3,0,1,0,76.14,62.84 ,33.33
03,012,01,001,0029,74,703,7,710,1099,0,3,1,3,0,1,0,76.14,64.60 ,33.33
03,012,01,001,0030,75,752,10,762,1088,0,3,1,3,0,1,0,76.14,70.04 ,33.33
03,012,01,001,0030,76,870,16,886,1266,0,3,1,3,0,1,0,76.14,69.98 ,33.33
03,012,01,001,0030,77,858,16,874,1325,0,3,1,3,0,1,0,76.14,65.96 ,33.33
03,012,01,001,0030,78,694,9,703,1064,0,3,1,3,0,1,0,76.14,66.07 ,33.33
03,012,01,001,0031,79,784,11,795,1210,0,3,1,3,0,1,0,76.14,65.70 ,33.33
03,012,01,001,0031,80,728,7,735,1106,0,3,1,3,0,1,0,76.14,66.46 ,33.33
03,012,01,001,0032,81,728,9,737,1151,0,3,1,3,0,1,0,76.14,64.03 ,33.33
03,012,01,001,0032,82,829,12,841,1177,0,3,1,3,0,1,0,76.14,71.45 ,33.33
03,012,01,001,0032,83,705,4,709,1048,0,3,1,3,0,1,0,76.14,67.65 ,33.33
03,012,01,001,0033,84,886,3,889,1240,0,3,1,3,0,1,0,76.14,71.69 ,33.33
03,012,01,001,0033,85,986,7,993,1532,0,3,1,3,0,1,0,76.14,64.82 ,33.33
03,012,01,001,0033,86,1203,17,1220,1926,0,3,1,3,0,1,0,76.14,63.34 ,33.33
03,012,01,001,0034,87,768,10,778,1120,0,3,1,3,0,1,0,76.14,69.46 ,33.33
03,012,01,001,0034,88,768,16,784,1173,0,3,1,3,0,1,0,76.14,66.84 ,33.33
03,012,01,001,0034,89,856,10,866,1335,0,3,1,3,0,1,0,76.14,64.87 ,33.33
03,012,01,001,0035,90,798,10,808,1118,0,3,1,3,0,1,0,76.14,72.27 ,33.33
03,012,01,001,0035,91,576,11,587,844,0,3,1,3,0,1,0,76.14,69.55 ,33.33
03,012,01,001,0035,92,588,3,591,923,0,3,1,3,0,1,0,76.14,64.03 ,33.33
03,012,01,001,0035,93,879,12,891,1330,0,3,1,3,0,1,0,76.14,66.99 ,33.33
03,012,01,001,0036,94,753,11,764,989,0,3,1,3,0,1,0,76.14,77.25 ,33.33
03,012,01,001,0037,95,785,12,797,1052,0,3,1,3,0,1,0,76.14,75.76 ,33.33
03,012,01,001,0037,96,765,7,772,1114,0,3,1,3,0,1,0,76.14,69.30 ,33.33
03,012,01,001,0038,97,742,15,757,1014,0,3,1,3,0,1,0,76.14,74.65 ,33.33
03,012,01,001,0038,98,638,4,642,885,0,3,1,3,0,1,0,76.14,72.54 ,33.33
03,012,01,001,0038,99,707,9,716,1073,0,3,1,3,0,1,0,76.14,66.73 ,33.33
03,012,01,001,0038,100,752,13,765,1140,0,3,1,3,0,1,0,76.14,67.11 ,33.33
03,012,01,001,0039,101,627,5,632,830,0,3,1,3,0,1,0,76.14,76.14 ,33.33
03,012,01,001,0039,102,708,4,712,901,0,3,1,3,0,1,0,76.14,79.02 ,33.33
03,012,01,001,0039,103,731,6,737,947,0,3,1,3,0,1,0,76.14,77.82 ,33.33
03,012,01,001,0040,104,612,4,616,924,0,3,1,3,0,1,0,76.14,66.67 ,33.33
03,012,01,001,0040,105,535,8,543,785,0,3,1,3,0,1,0,76.14,69.17 ,33.33
03,012,01,001,0040,106,603,8,611,871,0,3,1,3,0,1,0,76.14,70.15 ,33.33
03,012,01,001,0040,107,639,10,649,1014,0,3,1,3,0,1,0,76.14,64.00 ,33.33
03,012,01,001,0041,108,664,8,672,1029,0,3,1,3,0,1,0,76.14,65.31 ,33.33
03,012,01,001,0041,109,605,5,610,1037,0,3,1,3,0,1,0,76.14,58.82 ,33.33
03,012,01,001,0041,110,666,4,670,985,0,3,1,3,0,1,0,76.14,68.02 ,33.33
03,012,01,001,0041,111,686,7,693,993,0,3,1,3,0,1,0,76.14,69.79 ,33.33
03,012,01,001,0042,112,576,7,583,955,0,3,1,3,0,1,0,76.14,61.05 ,33.33
03,012,01,001,0042,113,498,4,502,870,0,3,1,3,0,1,0,76.14,57.70 ,33.33
03,012,01,001,0042,114,464,9,473,787,0,3,1,3,0,1,0,76.14,60.10 ,33.33
03,012,01,001,0042,115,327,6,333,545,0,3,1,3,0,1,0,76.14,61.10 ,33.33
03,012,01,001,0043,116,657,11,668,1091,0,3,1,3,0,1,0,76.14,61.23 ,33.33
03,012,01,001,0043,117,669,11,680,1111,0,3,1,3,0,1,0,76.14,61.21 ,33.33
03,012,01,001,0043,118,615,12,627,1032,0,3,1,3,0,1,0,76.14,60.76 ,33.33
03,012,01,001,0043,119,683,4,687,1062,0,3,1,3,0,1,0,76.14,64.69 ,33.33
03,012,01,001,0043,120,570,8,578,953,0,3,1,3,0,1,0,76.14,60.65 ,33.33
03,012,01,001,0044,121,587,19,606,953,0,3,1,3,0,1,0,76.14,63.59 ,33.33
03,012,01,001,0044,122,488,4,492,852,0,3,1,3,0,1,0,76.14,57.75 ,33.33
03,012,01,001,0044,123,492,7,499,830,0,3,1,3,0,1,0,76.14,60.12 ,33.33
03,012,01,001,0044,124,602,7,609,1061,0,3,1,3,0,1,0,76.14,57.40 ,33.33
03,012,01,001,0044,125,595,6,601,1077,0,3,1,3,0,1,0,76.14,55.80 ,33.33
03,012,01,001,0044,126,654,15,669,1179,0,3,1,3,0,1,0,76.14,56.74 ,33.33
03,012,01,001,0044,127,633,3,636,1158,0,3,1,3,0,1,0,76.14,54.92 ,33.33
03,012,01,001,0045,128,671,11,682,1016,0,3,1,3,0,1,0,76.14,67.13 ,33.33
03,012,01,001,0045,129,702,6,708,1048,0,3,1,3,0,1,0,76.14,67.56 ,33.33
03,012,01,001,0045,130,616,8,624,927,0,3,1,3,0,1,0,76.14,67.31 ,33.33
03,012,01,001,0046,131,671,9,680,1132,0,3,1,3,0,1,0,76.14,60.07 ,33.33
03,012,01,001,0046,132,604,7,611,1051,0,3,1,3,0,1,0,76.14,58.14 ,33.33
03,012,01,001,0046,133,567,12,579,981,0,3,1,3,0,1,0,76.14,59.02 ,33.33
03,012,01,001,0046,134,618,8,626,1076,0,3,1,3,0,1,0,76.14,58.18 ,33.33
03,012,01,001,0046,135,609,10,619,1048,0,3,1,3,0,1,0,76.14,59.06 ,33.33
03,012,01,001,0047,136,660,9,669,1104,0,3,1,3,0,1,0,76.14,60.60 ,33.33
03,012,01,001,0047,137,690,11,701,1066,0,3,1,3,0,1,0,76.14,65.76 ,33.33
03,012,01,001,0047,138,913,14,927,1525,0,3,1,3,0,1,0,76.14,60.79 ,33.33
03,012,01,001,0047,139,898,10,908,1432,0,3,1,3,0,1,0,76.14,63.41 ,33.33
03,012,01,001,0047,140,475,11,486,765,0,3,1,3,0,1,0,76.14,63.53 ,33.33
03,012,01,001,0048,141,796,19,815,1243,0,3,1,3,0,1,0,76.14,65.57 ,33.33
03,012,01,001,0048,142,565,7,572,873,0,3,1,3,0,1,0,76.14,65.52 ,33.33
03,012,01,001,0049,143,588,16,604,927,0,3,1,3,0,1,0,76.14,65.16 ,33.33
03,012,01,001,0049,144,680,11,691,1028,0,3,1,3,0,1,0,76.14,67.22 ,33.33
03,012,01,001,0049,145,681,6,687,1045,0,3,1,3,0,1,0,76.14,65.74 ,33.33
03,012,01,001,0049,146,624,8,632,1078,0,3,1,3,0,1,0,76.14,58.63 ,33.33
03,012,01,001,0049,147,660,13,673,1050,0,3,1,3,0,1,0,76.14,64.10 ,33.33
03,012,01,001,0050,148,745,9,754,1203,0,3,1,3,0,1,0,76.14,62.68 ,33.33
03,012,01,001,0050,149,701,12,713,1150,0,3,1,3,0,1,0,76.14,62.00 ,33.33
03,012,01,001,0050,150,806,12,818,1256,0,3,1,3,0,1,0,76.14,65.13 ,33.33
03,012,01,001,0050,151,638,8,646,995,0,3,1,3,0,1,0,76.14,64.92 ,33.33
03,012,01,001,0050,152,672,10,682,1052,0,3,1,3,0,1,0,76.14,64.83 ,33.33
03,012,01,001,0051,153,608,5,613,926,0,3,1,3,0,1,0,76.14,66.20 ,33.33
03,012,01,001,0051,154,522,7,529,817,0,3,1,3,0,1,0,76.14,64.75 ,33.33
03,012,01,001,0051,155,823,16,839,1273,0,3,1,3,0,1,0,76.14,65.91 ,33.33
03,012,01,001,0051,156,619,5,624,977,0,3,1,3,0,1,0,76.14,63.87 ,33.33
03,012,01,001,0051,157,550,6,556,824,0,3,1,3,0,1,0,76.14,67.48 ,33.33
03,012,01,001,0051,158,554,5,559,849,0,3,1,3,0,1,0,76.14,65.84 ,33.33
03,012,01,001,0052,159,593,9,602,910,0,3,1,3,0,1,0,76.14,66.15 ,33.33
03,012,01,001,0052,160,598,9,607,920,0,3,1,3,0,1,0,76.14,65.98 ,33.33
03,012,01,001,0052,161,441,8,449,676,0,3,1,3,0,1,0,76.14,66.42 ,33.33
03,012,01,001,0052,162,424,4,428,702,0,3,1,3,0,1,0,76.14,60.97 ,33.33
03,012,01,001,0052,163,554,6,560,966,0,3,1,3,0,1,0,76.14,57.97 ,33.33
03,012,01,001,0052,164,523,7,530,911,0,3,1,3,0,1,0,76.14,58.18 ,33.33
03,012,01,001,0052,165,542,12,554,850,0,3,1,3,0,1,0,76.14,65.18 ,33.33
03,012,01,001,0052,166,508,7,515,826,0,3,1,3,0,1,0,76.14,62.35 ,33.33
03,012,01,001,0053,167,623,5,628,960,0,3,1,3,0,1,0,76.14,65.42 ,33.33
03,012,01,001,0053,168,623,13,636,956,0,3,1,3,0,1,0,76.14,66.53 ,33.33
03,012,01,001,0053,169,623,7,630,895,0,3,1,3,0,1,0,76.14,70.39 ,33.33
03,012,01,001,0053,170,564,6,570,944,0,3,1,3,0,1,0,76.14,60.38 ,33.33
03,012,01,001,0053,171,420,2,422,660,0,3,1,3,0,1,0,76.14,63.94 ,33.33
03,012,01,001,0053,172,710,16,726,1099,0,3,1,3,0,1,0,76.14,66.06 ,33.33
03,012,01,001,0054,173,802,8,810,1231,0,3,1,3,0,1,0,76.14,65.80 ,33.33
03,012,01,001,0054,174,701,6,707,1058,0,3,1,3,0,1,0,76.14,66.82 ,33.33
03,012,01,001,0054,175,776,9,785,1203,0,3,1,3,0,1,0,76.14,65.25 ,33.33
03,012,01,001,0055,176,830,13,843,1377,0,3,1,3,0,1,0,76.14,61.22 ,33.33
03,012,01,001,0055,177,947,12,959,1502,0,3,1,3,0,1,0,76.14,63.85 ,33.33
03,012,01,001,0056,178,708,8,716,1065,0,3,1,3,0,1,0,76.14,67.23 ,33.33
03,012,01,001,0056,179,711,13,724,1049,0,3,1,3,0,1,0,76.14,69.02 ,33.33
03,012,01,001,0056,180,742,9,751,1131,0,3,1,3,0,1,0,76.14,66.40 ,33.33
03,012,01,001,0057,181,723,12,735,1110,0,3,1,3,0,1,0,76.14,66.22 ,33.33
03,012,01,001,0057,182,682,4,686,1026,0,3,1,3,0,1,0,76.14,66.86 ,33.33
03,012,01,001,0057,183,732,10,742,1170,0,3,1,3,0,1,0,76.14,63.42 ,33.33
03,012,01,001,0057,184,678,10,688,1015,0,3,1,3,0,1,0,76.14,67.78 ,33.33
03,012,01,001,0057,185,622,9,631,949,0,3,1,3,0,1,0,76.14,66.49 ,33.33
03,012,01,001,0058,186,638,4,642,1089,0,3,1,3,0,1,0,76.14,58.95 ,33.33
03,012,01,001,0058,187,571,8,579,914,0,3,1,3,0,1,0,76.14,63.35 ,33.33
03,012,01,001,0058,188,579,7,586,929,0,3,1,3,0,1,0,76.14,63.08 ,33.33
03,012,01,001,0058,189,735,10,745,1220,0,3,1,3,0,1,0,76.14,61.07 ,33.33
03,012,01,002,0059,190,878,10,888,1271,0,3,1,3,0,1,0,76.14,69.87 ,33.33
03,012,01,002,0059,191,775,10,785,1136,0,3,1,3,0,1,0,76.14,69.10 ,33.33
03,012,01,002,0059,192,955,17,972,1337,0,3,1,3,0,1,0,76.14,72.70 ,33.33
03,012,01,002,0059,193,658,6,664,980,0,3,1,3,0,1,0,76.14,67.76 ,33.33
03,012,01,002,0060,194,871,5,876,1347,0,3,1,3,0,1,0,76.14,65.03 ,33.33
03,012,01,002,0060,195,927,17,944,1499,0,3,1,3,0,1,0,76.14,62.98 ,33.33
03,012,01,002,0060,196,817,3,820,1180,0,3,1,3,0,1,0,76.14,69.49 ,33.33
03,012,01,002,0061,197,881,11,892,1261,0,3,1,3,0,1,0,76.14,70.74 ,33.33
03,012,01,002,0061,198,1060,20,1080,1557,0,3,1,3,0,1,0,76.14,69.36 ,33.33
03,012,01,002,0061,199,902,21,923,1498,0,3,1,3,0,1,0,76.14,61.62 ,33.33
03,012,01,002,0062,200,834,8,842,1150,0,3,1,3,0,1,0,76.14,73.22 ,33.33
03,012,01,002,0062,201,681,8,689,960,0,3,1,3,0,1,0,76.14,71.77 ,33.33
03,012,01,002,0063,202,888,17,905,1264,0,3,1,3,0,1,0,76.14,71.60 ,33.33
03,012,01,002,0063,203,859,20,879,1180,0,3,1,3,0,1,0,76.14,74.49 ,33.33
03,012,01,002,0064,204,598,10,608,878,0,3,1,3,0,1,0,76.14,69.25 ,33.33
03,012,01,002,0064,205,618,8,626,812,0,3,1,3,0,1,0,76.14,77.09 ,33.33
03,012,01,002,0065,206,1003,11,1014,1490,0,3,1,3,0,1,0,76.14,68.05 ,33.33
03,012,01,002,0065,207,938,33,971,1308,0,3,1,3,0,1,0,76.14,74.24 ,33.33
03,012,01,002,0065,208,676,9,685,928,0,3,1,3,0,1,0,76.14,73.81 ,33.33
03,012,01,002,0065,209,604,6,610,834,0,3,1,3,0,1,0,76.14,73.14 ,33.33
03,012,01,002,0066,210,1004,13,1017,1279,0,3,1,3,0,1,0,76.14,79.52 ,33.33
03,012,01,002,0067,211,990,15,1005,1411,0,3,1,3,0,1,0,76.14,71.23 ,33.33
03,012,01,002,0068,212,613,16,629,807,0,3,1,3,0,1,0,76.14,77.94 ,33.33
03,012,01,002,0068,213,707,13,720,969,0,3,1,3,0,1,0,76.14,74.30 ,33.33
03,012,01,002,0069,214,1132,20,1152,1554,0,3,1,3,0,1,0,76.14,74.13 ,33.33
03,012,01,002,0069,215,752,8,760,1132,0,3,1,3,0,1,0,76.14,67.14 ,33.33
03,012,01,002,0070,216,1084,12,1096,1494,0,3,1,3,0,1,0,76.14,73.36 ,33.33
03,012,01,002,0071,217,821,11,832,1124,0,3,1,3,0,1,0,76.14,74.02 ,33.33
03,012,01,002,0072,218,856,9,865,1205,0,3,1,3,0,1,0,76.14,71.78 ,33.33
03,012,01,002,0072,219,811,12,823,1113,0,3,1,3,0,1,0,76.14,73.94 ,33.33
03,012,01,002,0073,220,639,4,643,888,0,3,1,3,0,1,0,76.14,72.41 ,33.33
03,012,01,002,0073,221,536,7,543,757,0,3,1,3,0,1,0,76.14,71.73 ,33.33
03,012,01,002,0074,222,1128,14,1142,1540,0,3,1,3,0,1,0,76.14,74.16 ,33.33
03,012,01,002,0075,223,641,12,653,897,0,3,1,3,0,1,0,76.14,72.80 ,33.33
03,012,01,002,0076,224,533,3,536,820,0,3,1,3,0,1,0,76.14,65.37 ,33.33
03,012,01,002,0077,225,596,7,603,969,0,3,1,3,0,1,0,76.14,62.23 ,33.33
03,012,01,002,0077,226,433,1,434,705,0,3,1,3,0,1,0,76.14,61.56 ,33.33
03,012,01,002,0077,227,624,12,636,994,0,3,1,3,0,1,0,76.14,63.98 ,33.33
03,012,01,002,0077,228,651,13,664,983,0,3,1,3,0,1,0,76.14,67.55 ,33.33
03,012,01,003,0078,229,685,7,692,900,0,3,1,3,0,1,0,76.14,76.89 ,33.33
03,012,01,003,0078,230,637,11,648,947,0,3,1,3,0,1,0,76.14,68.43 ,33.33
03,012,01,003,0079,231,843,8,851,1227,0,3,1,3,0,1,0,76.14,69.36 ,33.33
03,012,01,003,0080,232,945,13,958,1386,0,3,1,3,0,1,0,76.14,69.12 ,33.33
03,012,01,003,0081,233,668,7,675,1020,0,3,1,3,0,1,0,76.14,66.18 ,33.33
03,012,01,003,0081,234,588,14,602,828,0,3,1,3,0,1,0,76.14,72.71 ,33.33
03,012,01,003,0081,235,628,8,636,937,0,3,1,3,0,1,0,76.14,67.88 ,33.33
03,012,01,003,0081,236,690,7,697,1090,0,3,1,3,0,1,0,76.14,63.94 ,33.33
03,012,01,003,0081,237,531,8,539,864,0,3,1,3,0,1,0,76.14,62.38 ,33.33
03,012,01,003,0081,238,547,7,554,885,0,3,1,3,0,1,0,76.14,62.60 ,33.33
03,012,01,003,0081,239,622,9,631,913,0,3,1,3,0,1,0,76.14,69.11 ,33.33
03,012,01,003,0081,240,501,6,507,771,0,3,1,3,0,1,0,76.14,65.76 ,33.33
03,012,01,003,0082,241,711,8,719,1148,0,3,1,3,0,1,0,76.14,62.63 ,33.33
03,012,01,003,0082,242,1024,15,1039,1587,0,3,1,3,0,1,0,76.14,65.47 ,33.33
03,012,01,003,0082,243,779,11,790,1284,0,3,1,3,0,1,0,76.14,61.53 ,33.33
03,012,01,003,0083,244,597,9,606,816,0,3,1,3,0,1,0,76.14,74.26 ,33.33
03,012,01,003,0083,245,632,12,644,940,0,3,1,3,0,1,0,76.14,68.51 ,33.33
03,012,01,003,0084,246,799,5,804,1004,0,3,1,3,0,1,0,76.14,80.08 ,33.33
03,012,01,003,0084,247,628,7,635,823,0,3,1,3,0,1,0,76.14,77.16 ,33.33
03,012,01,003,0085,248,1099,10,1109,1630,0,3,1,3,0,1,0,76.14,68.04 ,33.33
03,012,01,003,0085,249,772,11,783,1073,0,3,1,3,0,1,0,76.14,72.97 ,33.33
03,012,01,003,0086,250,1106,10,1116,1570,0,3,1,3,0,1,0,76.14,71.08 ,33.33
03,012,01,003,0086,251,828,10,838,1227,0,3,1,3,0,1,0,76.14,68.30 ,33.33
03,012,01,003,0086,252,914,11,925,1312,0,3,1,3,0,1,0,76.14,70.50 ,33.33
03,012,01,003,0086,253,915,18,933,1364,0,3,1,3,0,1,0,76.14,68.40 ,33.33
03,012,01,003,0087,254,1022,12,1034,1417,0,3,1,3,0,1,0,76.14,72.97 ,33.33
03,012,01,003,0087,255,913,9,922,1245,0,3,1,3,0,1,0,76.14,74.06 ,33.33
03,012,01,003,0088,256,870,6,876,1151,0,3,1,3,0,1,0,76.14,76.11 ,33.33
03,012,01,003,0088,257,893,6,899,1135,0,3,1,3,0,1,0,76.14,79.21 ,33.33
03,012,01,003,0089,258,691,8,699,899,0,3,1,3,0,1,0,76.14,77.75 ,33.33
03,012,01,003,0089,259,801,15,816,1020,0,3,1,3,0,1,0,76.14,80.00 ,33.33
03,012,01,003,0089,260,909,9,918,1173,0,3,1,3,0,1,0,76.14,78.26 ,33.33
03,012,01,003,0089,261,808,13,821,1030,0,3,1,3,0,1,0,76.14,79.71 ,33.33
03,012,01,003,0090,262,779,10,789,1241,0,3,1,3,0,1,0,76.14,63.58 ,33.33
03,012,01,003,0090,263,494,7,501,722,0,3,1,3,0,1,0,76.14,69.39 ,33.33
03,012,01,003,0090,264,912,9,921,1352,0,3,1,3,0,1,0,76.14,68.12 ,33.33
03,012,01,003,0090,265,879,11,890,1270,0,3,1,3,0,1,0,76.14,70.08 ,33.33
03,012,01,003,0091,266,965,13,978,1435,0,3,1,3,0,1,0,76.14,68.15 ,33.33
03,012,01,003,0091,267,827,20,847,1273,0,3,1,3,0,1,0,76.14,66.54 ,33.33
03,012,01,003,0091,268,1065,8,1073,1689,0,3,1,3,0,1,0,76.14,63.53 ,33.33
03,012,01,003,0092,269,700,10,710,971,0,3,1,3,0,1,0,76.14,73.12 ,33.33
03,012,01,003,0092,270,660,9,669,937,0,3,1,3,0,1,0,76.14,71.40 ,33.33
03,012,01,003,0092,271,793,11,804,1248,0,3,1,3,0,1,0,76.14,64.42 ,33.33
03,012,01,003,0092,272,650,9,659,964,0,3,1,3,0,1,0,76.14,68.36 ,33.33
03,012,01,003,0093,273,810,8,818,1186,0,3,1,3,0,1,0,76.14,68.97 ,33.33
03,012,01,003,0093,274,805,12,817,1174,0,3,1,3,0,1,0,76.14,69.59 ,33.33
03,012,01,003,0093,275,750,10,760,1114,0,3,1,3,0,1,0,76.14,68.22 ,33.33
03,012,01,003,0094,276,649,8,657,965,0,3,1,3,0,1,0,76.14,68.08 ,33.33
03,012,01,003,0094,277,580,3,583,813,0,3,1,3,0,1,0,76.14,71.71 ,33.33
03,012,01,003,0095,278,648,7,655,1121,0,3,1,3,0,1,0,76.14,58.43 ,33.33
03,012,01,003,0095,279,732,16,748,1248,0,3,1,3,0,1,0,76.14,59.94 ,33.33
03,012,01,003,0095,280,674,10,684,1040,0,3,1,3,0,1,0,76.14,65.77 ,33.33
03,012,01,003,0095,281,606,15,621,1032,0,3,1,3,0,1,0,76.14,60.17 ,33.33
03,012,01,003,0096,282,756,8,764,1056,0,3,1,3,0,1,0,76.14,72.35 ,33.33
03,012,01,003,0097,283,519,4,523,1023,0,3,1,3,0,1,0,76.14,51.12 ,33.33
03,012,01,003,0097,284,615,5,620,941,0,3,1,3,0,1,0,76.14,65.89 ,33.33
03,012,01,003,0097,285,318,7,325,441,0,3,1,3,0,1,0,76.14,73.70 ,33.33
03,012,01,003,0098,286,786,11,797,1211,0,3,1,3,0,1,0,76.14,65.81 ,33.33
03,012,01,003,0099,287,898,11,909,1284,0,3,1,3,0,1,0,76.14,70.79 ,33.33
03,012,01,003,0100,288,874,14,888,1239,0,3,1,3,0,1,0,76.14,71.67 ,33.33
03,012,01,003,0100,289,876,12,888,1223,0,3,1,3,0,1,0,76.14,72.61 ,33.33
03,012,01,003,0101,290,886,16,902,1158,0,3,1,3,0,1,0,76.14,77.89 ,33.33
03,012,01,003,0102,291,921,18,939,1407,0,3,1,3,0,1,0,76.14,66.74 ,33.33
03,012,01,003,0102,292,831,12,843,1224,0,3,1,3,0,1,0,76.14,68.87 ,33.33
03,012,01,003,0103,293,594,5,599,924,0,3,1,3,0,1,0,76.14,64.83 ,33.33
03,012,01,003,0103,294,550,11,561,788,0,3,1,3,0,1,0,76.14,71.19 ,33.33
03,012,01,004,0104,295,796,8,804,1116,0,3,1,3,0,1,0,76.14,72.04 ,33.33
03,012,01,004,0104,296,567,11,578,767,0,3,1,3,0,1,0,76.14,75.36 ,33.33
03,012,01,004,0105,297,1155,10,1165,1570,0,3,1,3,0,1,0,76.14,74.20 ,33.33
03,012,01,004,0105,298,966,9,975,1327,0,3,1,3,0,1,0,76.14,73.47 ,33.33
03,012,01,004,0106,299,1017,8,1025,1406,0,3,1,3,0,1,0,76.14,72.90 ,33.33
03,012,01,004,0106,300,901,5,906,1127,0,3,1,3,0,1,0,76.14,80.39 ,33.33
03,012,01,004,0106,301,1027,21,1048,1366,0,3,1,3,0,1,0,76.14,76.72 ,33.33
03,012,01,004,0107,302,734,8,742,1029,0,3,1,3,0,1,0,76.14,72.11 ,33.33
03,012,01,004,0107,303,731,6,737,1054,0,3,1,3,0,1,0,76.14,69.92 ,33.33
03,012,01,004,0108,304,890,3,893,1193,0,3,1,3,0,1,0,76.14,74.85 ,33.33
03,012,01,004,0108,305,775,7,782,1048,0,3,1,3,0,1,0,76.14,74.62 ,33.33
03,012,01,004,0109,306,1163,17,1180,1514,0,3,1,3,0,1,0,76.14,77.94 ,33.33
03,012,01,004,0110,307,856,15,871,1132,0,3,1,3,0,1,0,76.14,76.94 ,33.33
03,012,01,004,0111,308,1160,15,1175,1519,0,3,1,3,0,1,0,76.14,77.35 ,33.33
03,012,01,004,0112,309,780,11,791,1173,0,3,1,3,0,1,0,76.14,67.43 ,33.33
03,012,01,004,0112,310,713,9,722,1016,0,3,1,3,0,1,0,76.14,71.06 ,33.33
03,012,01,004,0113,311,1152,15,1167,1623,0,3,1,3,0,1,0,76.14,71.90 ,33.33
03,012,01,004,0113,312,913,6,919,1310,0,3,1,3,0,1,0,76.14,70.15 ,33.33
03,012,01,004,0114,313,730,3,733,1032,0,3,1,3,0,1,0,76.14,71.03 ,33.33
03,012,01,004,0115,314,674,9,683,959,0,3,1,3,0,1,0,76.14,71.22 ,33.33
03,012,01,004,0116,315,726,10,736,1001,0,3,1,3,0,1,0,76.14,73.53 ,33.33
03,012,01,004,0117,316,639,5,644,917,0,3,1,3,0,1,0,76.14,70.23 ,33.33
03,012,01,004,0118,317,824,6,830,1194,0,3,1,3,0,1,0,76.14,69.51 ,33.33
03,012,01,004,0119,318,651,4,655,815,0,3,1,3,0,1,0,76.14,80.37 ,33.33
03,012,01,004,0119,319,757,7,764,1039,0,3,1,3,0,1,0,76.14,73.53 ,33.33
03,012,01,004,0120,320,649,16,665,947,0,3,1,3,0,1,0,76.14,70.22 ,33.33
03,012,01,004,0120,321,560,4,564,780,0,3,1,3,0,1,0,76.14,72.31 ,33.33
03,012,01,004,0121,322,507,6,513,694,0,3,1,3,0,1,0,76.14,73.92 ,33.33
03,012,01,005,0122,323,760,19,779,1115,0,3,1,3,0,1,0,76.14,69.87 ,33.33
03,012,01,005,0122,324,730,10,740,1080,0,3,1,3,0,1,0,76.14,68.52 ,33.33
03,012,01,005,0122,325,959,21,980,1337,0,3,1,3,0,1,0,76.14,73.30 ,33.33
03,012,01,005,0123,326,537,8,545,770,0,3,1,3,0,1,0,76.14,70.78 ,33.33
03,012,01,005,0123,327,636,11,647,972,0,3,1,3,0,1,0,76.14,66.56 ,33.33
03,012,01,005,0123,328,626,6,632,815,0,3,1,3,0,1,0,76.14,77.55 ,33.33
03,012,01,005,0124,329,621,21,642,930,0,3,1,3,0,1,0,76.14,69.03 ,33.33
03,012,01,005,0124,330,451,11,462,754,0,3,1,3,0,1,0,76.14,61.27 ,33.33
03,012,01,005,0125,331,666,9,675,939,0,3,1,3,0,1,0,76.14,71.88 ,33.33
03,012,01,005,0125,332,667,9,676,1078,0,3,1,3,0,1,0,76.14,62.71 ,33.33
03,012,01,005,0125,333,806,23,829,1202,0,3,1,3,0,1,0,76.14,68.97 ,33.33
03,012,01,005,0126,334,749,8,757,1199,0,3,1,3,0,1,0,76.14,63.14 ,33.33
03,012,01,005,0126,335,539,6,545,912,0,3,1,3,0,1,0,76.14,59.76 ,33.33
03,012,01,005,0126,336,658,11,669,1120,0,3,1,3,0,1,0,76.14,59.73 ,33.33
03,012,01,005,0126,337,537,7,544,801,0,3,1,3,0,1,0,76.14,67.92 ,33.33
03,012,01,005,0127,338,561,15,576,792,0,3,1,3,0,1,0,76.14,72.73 ,33.33
03,012,01,005,0127,339,621,7,628,795,0,3,1,3,0,1,0,76.14,78.99 ,33.33
03,012,01,005,0128,340,769,6,775,1167,0,3,1,3,0,1,0,76.14,66.41 ,33.33
03,012,01,005,0129,341,709,9,718,1114,0,3,1,3,0,1,0,76.14,64.45 ,33.33
03,012,01,005,0129,342,715,15,730,1197,0,3,1,3,0,1,0,76.14,60.99 ,33.33
03,012,01,005,0129,343,783,5,788,1191,0,3,1,3,0,1,0,76.14,66.16 ,33.33
03,012,01,005,0129,344,655,10,665,1021,0,3,1,3,0,1,0,76.14,65.13 ,33.33
03,012,01,005,0130,345,527,6,533,863,0,3,1,3,0,1,0,76.14,61.76 ,33.33
03,012,01,005,0130,346,833,16,849,1239,0,3,1,3,0,1,0,76.14,68.52 ,33.33
03,012,01,005,0130,347,742,5,747,1138,0,3,1,3,0,1,0,76.14,65.64 ,33.33
03,012,01,005,0131,348,996,18,1014,1361,0,3,1,3,0,1,0,76.14,74.50 ,33.33
03,012,01,005,0131,349,608,8,616,905,0,3,1,3,0,1,0,76.14,68.07 ,33.33
03,012,01,005,0132,350,329,2,331,465,0,3,1,3,0,1,0,76.14,71.18 ,33.33
03,012,01,006,0133,351,590,8,598,861,0,3,1,3,0,1,0,76.14,69.45 ,33.33
03,012,01,006,0134,352,1018,10,1028,1369,0,3,1,3,0,1,0,76.14,75.09 ,33.33
03,012,01,006,0135,353,835,11,846,1374,0,3,1,3,0,1,0,76.14,61.57 ,33.33
03,012,01,006,0135,354,739,17,756,1133,0,3,1,3,0,1,0,76.14,66.73 ,33.33
03,012,01,006,0135,355,999,7,1006,1586,0,3,1,3,0,1,0,76.14,63.43 ,33.33
03,012,01,006,0135,356,1026,9,1035,1608,0,3,1,3,0,1,0,76.14,64.37 ,33.33
03,012,01,006,0136,357,952,25,977,1375,0,3,1,3,0,1,0,76.14,71.05 ,33.33
03,012,01,006,0136,358,727,7,734,990,0,3,1,3,0,1,0,76.14,74.14 ,33.33
03,012,01,006,0137,359,726,8,734,976,0,3,1,3,0,1,0,76.14,75.20 ,33.33
03,012,01,006,0137,360,957,15,972,1452,0,3,1,3,0,1,0,76.14,66.94 ,33.33
03,012,01,006,0137,361,1016,12,1028,1579,0,3,1,3,0,1,0,76.14,65.10 ,33.33
03,012,01,006,0138,362,805,9,814,1162,0,3,1,3,0,1,0,76.14,70.05 ,33.33
03,012,01,006,0138,363,959,20,979,1509,0,3,1,3,0,1,0,76.14,64.88 ,33.33
03,012,01,006,0139,364,891,18,909,1281,0,3,1,3,0,1,0,76.14,70.96 ,33.33
03,012,01,006,0139,365,688,8,696,980,0,3,1,3,0,1,0,76.14,71.02 ,33.33
03,012,01,006,0140,366,922,12,934,1258,0,3,1,3,0,1,0,76.14,74.24 ,33.33
03,012,01,007,0141,367,756,0,756,1186,0,3,1,3,0,1,0,76.14,63.74 ,33.33
03,012,01,007,0141,368,715,9,724,1101,0,3,1,3,0,1,0,76.14,65.76 ,33.33
03,012,01,007,0141,369,1000,10,1010,1580,0,3,1,3,0,1,0,76.14,63.92 ,33.33
03,012,01,007,0141,370,870,12,882,1252,0,3,1,3,0,1,0,76.14,70.45 ,33.33
03,012,01,007,0142,371,1095,16,1111,1527,0,3,1,3,0,1,0,76.14,72.76 ,33.33
03,012,01,007,0143,372,716,12,728,1027,0,3,1,3,0,1,0,76.14,70.89 ,33.33
03,012,01,007,0143,373,1009,16,1025,1563,0,3,1,3,0,1,0,76.14,65.58 ,33.33
03,012,01,007,0143,374,975,9,984,1538,0,3,1,3,0,1,0,76.14,63.98 ,33.33
03,012,01,007,0143,375,742,5,747,1200,0,3,1,3,0,1,0,76.14,62.25 ,33.33
03,012,01,007,0144,376,796,5,801,1061,0,3,1,3,0,1,0,76.14,75.49 ,33.33
03,012,01,007,0144,377,761,8,769,1099,0,3,1,3,0,1,0,76.14,69.97 ,33.33
03,012,01,007,0145,378,1029,15,1044,1562,0,3,1,3,0,1,0,76.14,66.84 ,33.33
03,012,01,007,0145,379,1000,10,1010,1430,0,3,1,3,0,1,0,76.14,70.63 ,33.33
03,012,01,007,0145,380,1092,15,1107,1774,0,3,1,3,0,1,0,76.14,62.40 ,33.33
03,012,01,007,0146,381,803,16,819,1214,0,3,1,3,0,1,0,76.14,67.46 ,33.33
03,012,01,007,0146,382,1000,16,1016,1475,0,3,1,3,0,1,0,76.14,68.88 ,33.33
03,012,01,007,0147,383,382,16,398,541,0,3,1,3,0,1,0,76.14,73.57 ,33.33
03,012,01,008,0148,384,791,6,797,1139,0,3,1,3,0,1,0,76.14,69.97 ,33.33
03,012,01,008,0148,385,669,10,679,1023,0,3,1,3,0,1,0,76.14,66.37 ,33.33
03,012,01,008,0148,386,596,6,602,899,0,3,1,3,0,1,0,76.14,66.96 ,33.33
03,012,01,008,0149,387,959,15,974,1354,0,3,1,3,0,1,0,76.14,71.94 ,33.33
03,012,01,008,0150,388,709,14,723,1054,0,3,1,3,0,1,0,76.14,68.60 ,33.33
03,012,01,008,0150,389,659,12,671,974,0,3,1,3,0,1,0,76.14,68.89 ,33.33
03,012,01,008,0150,390,491,9,500,740,0,3,1,3,0,1,0,76.14,67.57 ,33.33
03,012,01,008,0151,391,476,6,482,710,0,3,1,3,0,1,0,76.14,67.89 ,33.33
03,012,01,008,0151,392,485,11,496,710,0,3,1,3,0,1,0,76.14,69.86 ,33.33
03,012,01,008,0152,393,818,9,827,1115,0,3,1,3,0,1,0,76.14,74.17 ,33.33
03,012,01,008,0153,394,840,1,841,1122,0,3,1,3,0,1,0,76.14,74.96 ,33.33
03,012,01,008,0154,395,613,9,622,885,0,3,1,3,0,1,0,76.14,70.28 ,33.33
03,012,01,008,0154,396,619,11,630,893,0,3,1,3,0,1,0,76.14,70.55 ,33.33
03,012,01,008,0155,397,929,11,940,1323,0,3,1,3,0,1,0,76.14,71.05 ,33.33
03,012,01,008,0155,398,812,13,825,1186,0,3,1,3,0,1,0,76.14,69.56 ,33.33
03,012,01,008,0156,399,1065,12,1077,1557,0,3,1,3,0,1,0,76.14,69.17 ,33.33
03,012,01,008,0156,400,573,10,583,887,0,3,1,3,0,1,0,76.14,65.73 ,33.33
03,012,01,008,0157,401,814,10,824,1251,0,3,1,3,0,1,0,76.14,65.87 ,33.33
03,012,01,008,0157,402,957,10,967,1378,0,3,1,3,0,1,0,76.14,70.17 ,33.33
03,012,01,008,0158,403,863,13,876,1259,0,3,1,3,0,1,0,76.14,69.58 ,33.33
03,012,01,008,0158,404,858,9,867,1242,0,3,1,3,0,1,0,76.14,69.81 ,33.33
03,012,01,008,0159,405,438,4,442,547,0,3,1,3,0,1,0,76.14,80.80 ,33.33
03,012,01,008,0160,406,699,4,703,1011,0,3,1,3,0,1,0,76.14,69.54 ,33.33
03,012,01,008,0160,407,938,15,953,1440,0,3,1,3,0,1,0,76.14,66.18 ,33.33
03,012,01,008,0161,408,1044,11,1055,1448,0,3,1,3,0,1,0,76.14,72.86 ,33.33
03,012,01,008,0162,409,689,3,692,987,0,3,1,3,0,1,0,76.14,70.11 ,33.33
03,012,01,008,0162,410,743,9,752,1056,0,3,1,3,0,1,0,76.14,71.21 ,33.33
03,012,01,008,0162,411,783,11,794,1153,0,3,1,3,0,1,0,76.14,68.86 ,33.33
03,012,01,008,0163,412,803,12,815,1188,0,3,1,3,0,1,0,76.14,68.60 ,33.33
03,012,01,008,0163,413,838,8,846,1179,0,3,1,3,0,1,0,76.14,71.76 ,33.33
03,012,01,008,0163,414,412,5,417,548,0,3,1,3,0,1,0,76.14,76.09 ,33.33
03,012,01,008,0164,415,853,5,858,1156,0,3,1,3,0,1,0,76.14,74.22 ,33.33
03,012,01,008,0165,416,795,9,804,1149,0,3,1,3,0,1,0,76.14,69.97 ,33.33
03,012,01,008,0165,417,873,13,886,1268,0,3,1,3,0,1,0,76.14,69.87 ,33.33
03,012,01,008,0165,418,882,10,892,1281,0,3,1,3,0,1,0,76.14,69.63 ,33.33
03,012,01,008,0166,419,706,9,715,1012,0,3,1,3,0,1,0,76.14,70.65 ,33.33
03,012,01,008,0166,420,534,6,540,758,0,3,1,3,0,1,0,76.14,71.24 ,33.33
03,012,01,008,0167,421,845,10,855,1201,0,3,1,3,0,1,0,76.14,71.19 ,33.33
03,012,01,008,0168,422,496,4,500,673,0,3,1,3,0,1,0,76.14,74.29 ,33.33
03,012,01,008,0169,423,852,13,865,1187,0,3,1,3,0,1,0,76.14,72.87 ,33.33
03,012,01,008,0170,424,661,7,668,970,0,3,1,3,0,1,0,76.14,68.87 ,33.33
03,012,01,008,0171,425,906,16,922,1346,0,3,1,3,0,1,0,76.14,68.50 ,33.33
03,012,01,008,0171,426,1073,18,1091,1603,0,3,1,3,0,1,0,76.14,68.06 ,33.33
03,012,01,008,0172,427,885,12,897,1142,0,3,1,3,0,1,0,76.14,78.55 ,33.33
03,012,01,008,0172,428,236,7,243,303,0,3,1,3,0,1,0,76.14,80.20 ,33.33
03,012,01,008,0173,429,540,10,550,722,0,3,1,3,0,1,0,76.14,76.18 ,33.33
03,012,01,008,0174,430,950,10,960,1253,0,3,1,3,0,1,0,76.14,76.62 ,33.33
03,012,01,008,0175,431,510,5,515,694,0,3,1,3,0,1,0,76.14,74.21 ,33.33
03,012,01,008,0176,432,599,9,608,838,0,3,1,3,0,1,0,76.14,72.55 ,33.33
03,012,01,008,0177,433,730,7,737,984,0,3,1,3,0,1,0,76.14,74.90 ,33.33
03,012,01,008,0178,434,686,13,699,919,0,3,1,3,0,1,0,76.14,76.06 ,33.33
03,012,01,008,0179,435,671,2,673,880,0,3,1,3,0,1,0,76.14,76.48 ,33.33
03,012,01,008,0179,436,906,8,914,1271,0,3,1,3,0,1,0,76.14,71.91 ,33.33
03,012,01,008,0180,437,1088,10,1098,1421,0,3,1,3,0,1,0,76.14,77.27 ,33.33
03,012,01,008,0181,438,1120,12,1132,1446,0,3,1,3,0,1,0,76.14,78.28 ,33.33
03,012,01,008,0182,439,357,2,359,468,0,3,1,3,0,1,0,76.14,76.71 ,33.33
03,012,01,009,0183,440,663,14,677,938,0,3,1,3,0,1,0,76.14,72.17 ,33.33
03,012,01,009,0183,441,418,1,419,555,0,3,1,3,0,1,0,76.14,75.50 ,33.33
03,012,01,009,0184,442,712,4,716,919,0,3,1,3,0,1,0,76.14,77.91 ,33.33
03,012,01,009,0185,443,261,3,264,357,0,3,1,3,0,1,0,76.14,73.95 ,33.33
03,012,01,009,0186,444,752,8,760,1008,0,3,1,3,0,1,0,76.14,75.40 ,33.33
03,012,01,009,0186,445,838,9,847,1201,0,3,1,3,0,1,0,76.14,70.52 ,33.33
03,012,01,009,0187,446,659,9,668,929,0,3,1,3,0,1,0,76.14,71.91 ,33.33
03,012,01,009,0187,447,724,8,732,968,0,3,1,3,0,1,0,76.14,75.62 ,33.33
03,012,01,009,0188,448,856,10,866,1162,0,3,1,3,0,1,0,76.14,74.53 ,33.33
03,012,01,009,0188,449,1036,10,1046,1444,0,3,1,3,0,1,0,76.14,72.44 ,33.33
03,012,01,009,0189,450,543,4,547,728,0,3,1,3,0,1,0,76.14,75.14 ,33.33
03,012,01,009,0189,451,239,3,242,301,0,3,1,3,0,1,0,76.14,80.40 ,33.33
03,012,01,009,0189,452,148,0,148,195,0,3,1,3,0,1,0,76.14,75.90 ,33.33
03,012,01,009,0190,453,786,13,799,1068,0,3,1,3,0,1,0,76.14,74.81 ,33.33
03,012,01,009,0190,454,558,10,568,801,0,3,1,3,0,1,0,76.14,70.91 ,33.33
03,012,01,009,0191,455,684,10,694,1033,0,3,1,3,0,1,0,76.14,67.18 ,33.33
03,012,01,009,0191,456,729,10,739,962,0,3,1,3,0,1,0,76.14,76.82 ,33.33
03,012,01,009,0192,457,595,15,610,874,0,3,1,3,0,1,0,76.14,69.79 ,33.33
03,012,01,009,0193,458,700,11,711,939,0,3,1,3,0,1,0,76.14,75.72 ,33.33
03,012,01,009,0193,459,607,5,612,832,0,3,1,3,0,1,0,76.14,73.56 ,33.33
03,012,01,009,0193,460,388,5,393,449,0,3,1,3,0,1,0,76.14,87.53 ,33.33
03,012,01,009,0194,461,788,6,794,1057,0,3,1,3,0,1,0,76.14,75.12 ,33.33
03,012,01,009,0194,462,505,6,511,659,0,3,1,3,0,1,0,76.14,77.54 ,33.33
03,012,01,009,0195,463,520,12,532,722,0,3,1,3,0,1,0,76.14,73.68 ,33.33
03,012,01,009,0195,464,548,9,557,742,0,3,1,3,0,1,0,76.14,75.07 ,33.33
03,012,01,009,0196,465,738,11,749,995,0,3,1,3,0,1,0,76.14,75.28 ,33.33
03,012,01,009,0196,466,682,6,688,927,0,3,1,3,0,1,0,76.14,74.22 ,33.33
03,012,01,009,0197,467,626,5,631,854,0,3,1,3,0,1,0,76.14,73.89 ,33.33
03,012,01,009,0198,468,346,3,349,458,0,3,1,3,0,1,0,76.14,76.20 ,33.33
03,012,01,009,0198,469,627,11,638,832,0,3,1,3,0,1,0,76.14,76.68 ,33.33
03,012,01,009,0199,470,465,0,465,610,0,3,1,3,0,1,0,76.14,76.23 ,33.33
03,012,01,010,0200,471,358,1,359,441,0,3,1,3,0,1,0,76.14,81.41 ,33.33
03,012,01,010,0201,472,733,17,750,1018,0,3,1,3,0,1,0,76.14,73.67 ,33.33
03,012,01,010,0202,473,907,9,916,1220,0,3,1,3,0,1,0,76.14,75.08 ,33.33
03,012,01,010,0202,474,606,5,611,816,0,3,1,3,0,1,0,76.14,74.88 ,33.33
03,012,01,010,0203,475,718,8,726,969,0,3,1,3,0,1,0,76.14,74.92 ,33.33
03,012,01,010,0203,476,632,5,637,851,0,3,1,3,0,1,0,76.14,74.85 ,33.33
03,012,01,010,0203,477,664,20,684,968,0,3,1,3,0,1,0,76.14,70.66 ,33.33
03,012,01,010,0204,478,926,19,945,1249,0,3,1,3,0,1,0,76.14,75.66 ,33.33
03,012,01,010,0204,479,876,11,887,1206,0,3,1,3,0,1,0,76.14,73.55 ,33.33
03,012,01,010,0205,480,1089,16,1105,1476,0,3,1,3,0,1,0,76.14,74.86 ,33.33
03,012,01,010,0206,481,799,13,812,1039,0,3,1,3,0,1,0,76.14,78.15 ,33.33
03,012,01,010,0206,482,998,8,1006,1299,0,3,1,3,0,1,0,76.14,77.44 ,33.33
03,012,01,010,0206,483,352,4,356,506,0,3,1,3,0,1,0,76.14,70.36 ,33.33
03,012,01,010,0206,484,470,7,477,616,0,3,1,3,0,1,0,76.14,77.44 ,33.33
03,012,01,010,0206,485,569,11,580,820,0,3,1,3,0,1,0,76.14,70.73 ,33.33
03,012,01,010,0207,486,581,9,590,756,0,3,1,3,0,1,0,76.14,78.04 ,33.33
03,012,01,010,0207,487,386,26,412,569,0,3,1,3,0,1,0,76.14,72.41 ,33.33
03,012,01,010,0207,488,465,4,469,701,0,3,1,3,0,1,0,76.14,66.90 ,33.33
03,012,01,010,0208,489,740,15,755,1005,0,3,1,3,0,1,0,76.14,75.12 ,33.33
03,012,01,010,0208,490,912,20,932,1172,0,3,1,3,0,1,0,76.14,79.52 ,33.33
03,012,01,010,0209,491,616,9,625,903,0,3,1,3,0,1,0,76.14,69.21 ,33.33
03,012,01,010,0209,492,588,7,595,844,0,3,1,3,0,1,0,76.14,70.50 ,33.33
03,012,01,010,0210,493,760,10,770,1169,0,3,1,3,0,1,0,76.14,65.87 ,33.33
03,012,01,010,0210,494,865,20,885,1351,0,3,1,3,0,1,0,76.14,65.51 ,33.33
03,012,01,011,0211,495,266,1,267,382,0,3,1,3,0,1,0,76.14,69.90 ,33.33
03,012,01,011,0212,496,426,9,435,696,0,3,1,3,0,1,0,76.14,62.50 ,33.33
03,012,01,011,0213,497,746,7,753,1017,0,3,1,3,0,1,0,76.14,74.04 ,33.33
03,012,01,011,0214,498,286,4,290,426,0,3,1,3,0,1,0,76.14,68.08 ,33.33
03,012,01,011,0215,499,628,21,649,975,0,3,1,3,0,1,0,76.14,66.56 ,33.33
03,012,01,011,0216,500,557,13,570,822,0,3,1,3,0,1,0,76.14,69.34 ,33.33
03,012,01,011,0216,501,387,3,390,590,0,3,1,3,0,1,0,76.14,66.10 ,33.33
03,012,01,011,0217,502,292,6,298,434,0,3,1,3,0,1,0,76.14,68.66 ,33.33
03,012,01,011,0218,503,283,7,290,444,0,3,1,3,0,1,0,76.14,65.32 ,33.33
03,012,01,011,0219,504,460,12,472,695,0,3,1,3,0,1,0,76.14,67.91 ,33.33
03,012,01,011,0220,505,913,8,921,1289,0,3,1,3,0,1,0,76.14,71.45 ,33.33
03,012,01,012,0221,506,925,9,934,1454,0,3,1,3,0,1,0,76.14,64.24 ,33.33
03,012,01,012,0221,507,600,18,618,927,0,3,1,3,0,1,0,76.14,66.67 ,33.33
03,012,01,012,0221,508,767,12,779,1249,0,3,1,3,0,1,0,76.14,62.37 ,33.33
03,012,01,012,0222,509,882,15,897,1355,0,3,1,3,0,1,0,76.14,66.20 ,33.33
03,012,01,012,0222,510,781,9,790,1123,0,3,1,3,0,1,0,76.14,70.35 ,33.33
03,012,01,012,0223,511,865,9,874,1206,0,3,1,3,0,1,0,76.14,72.47 ,33.33
03,012,01,012,0223,512,700,11,711,980,0,3,1,3,0,1,0,76.14,72.55 ,33.33
03,012,01,012,0224,513,547,8,555,776,0,3,1,3,0,1,0,76.14,71.52 ,33.33
03,012,01,012,0224,514,666,7,673,1023,0,3,1,3,0,1,0,76.14,65.79 ,33.33
03,012,01,012,0225,515,845,11,856,1276,0,3,1,3,0,1,0,76.14,67.08 ,33.33
03,012,01,012,0226,516,865,16,881,1213,0,3,1,3,0,1,0,76.14,72.63 ,33.33
03,012,01,012,0227,517,674,9,683,941,0,3,1,3,0,1,0,76.14,72.58 ,33.33
03,012,01,012,0227,518,610,7,617,848,0,3,1,3,0,1,0,76.14,72.76 ,33.33
03,012,01,012,0228,519,798,14,812,1070,0,3,1,3,0,1,0,76.14,75.89 ,33.33
03,012,01,012,0229,520,815,16,831,1074,0,3,1,3,0,1,0,76.14,77.37 ,33.33
03,012,01,012,0229,521,337,5,342,449,0,3,1,3,0,1,0,76.14,76.17 ,33.33
03,012,01,012,0230,522,479,12,491,656,0,3,1,3,0,1,0,76.14,74.85 ,33.33
03,012,01,012,0231,523,1026,20,1046,1434,0,3,1,3,0,1,0,76.14,72.94 ,33.33
03,012,01,012,0232,524,673,9,682,904,0,3,1,3,0,1,0,76.14,75.44 ,33.33
03,012,01,013,0233,525,668,1,669,838,0,3,1,3,0,1,0,76.14,79.83 ,33.33
03,012,01,013,0233,526,614,11,625,792,0,3,1,3,0,1,0,76.14,78.91 ,33.33
03,012,01,013,0234,527,1021,17,1038,1227,0,3,1,3,0,1,0,76.14,84.60 ,33.33
03,012,01,013,0234,528,962,16,978,1166,0,3,1,3,0,1,0,76.14,83.88 ,33.33
03,012,01,013,0235,529,1128,13,1141,1388,0,3,1,3,0,1,0,76.14,82.20 ,33.33
03,012,01,013,0235,530,840,8,848,1249,0,3,1,3,0,1,0,76.14,67.89 ,33.33
03,012,01,013,0236,531,724,6,730,899,0,3,1,3,0,1,0,76.14,81.20 ,33.33
03,012,01,013,0236,532,706,2,708,861,0,3,1,3,0,1,0,76.14,82.23 ,33.33
03,012,01,013,0237,533,1122,11,1133,1456,0,3,1,3,0,1,0,76.14,77.82 ,33.33
03,012,01,013,0238,534,744,7,751,973,0,3,1,3,0,1,0,76.14,77.18 ,33.33
03,012,01,013,0239,535,779,13,792,1021,0,3,1,3,0,1,0,76.14,77.57 ,33.33
03,012,01,013,0239,536,786,18,804,1096,0,3,1,3,0,1,0,76.14,73.36 ,33.33
03,012,01,013,0240,537,1106,13,1119,1457,0,3,1,3,0,1,0,76.14,76.80 ,33.33
03,012,01,013,0240,538,1014,10,1024,1420,0,3,1,3,0,1,0,76.14,72.11 ,33.33
03,012,01,013,0241,539,895,15,910,1207,0,3,1,3,0,1,0,76.14,75.39 ,33.33
03,012,01,013,0241,540,849,5,854,1140,0,3,1,3,0,1,0,76.14,74.91 ,33.33
03,012,01,013,0242,541,947,9,956,1363,0,3,1,3,0,1,0,76.14,70.14 ,33.33
03,012,01,013,0242,542,823,14,837,1162,0,3,1,3,0,1,0,76.14,72.03 ,33.33
03,012,01,013,0243,543,735,8,743,918,0,3,1,3,0,1,0,76.14,80.94 ,33.33
03,012,01,013,0243,544,779,6,785,1041,0,3,1,3,0,1,0,76.14,75.41 ,33.33
03,012,01,013,0244,545,688,3,691,906,0,3,1,3,0,1,0,76.14,76.27 ,33.33
03,012,01,013,0244,546,678,7,685,910,0,3,1,3,0,1,0,76.14,75.27 ,33.33
03,012,01,013,0245,547,934,5,939,1118,0,3,1,3,0,1,0,76.14,83.99 ,33.33
03,012,01,013,0245,548,875,12,887,1128,0,3,1,3,0,1,0,76.14,78.63 ,33.33
03,012,01,013,0246,549,638,12,650,856,0,3,1,3,0,1,0,76.14,75.93 ,33.33
03,012,01,013,0246,550,773,10,783,1029,0,3,1,3,0,1,0,76.14,76.09 ,33.33
03,012,01,013,0247,551,831,2,833,1137,0,3,1,3,0,1,0,76.14,73.26 ,33.33
03,012,01,013,0248,552,849,10,859,1121,0,3,1,3,0,1,0,76.14,76.63 ,33.33
03,012,01,013,0249,553,645,9,654,833,0,3,1,3,0,1,0,76.14,78.51 ,33.33
03,012,01,013,0250,554,789,11,800,969,0,3,1,3,0,1,0,76.14,82.56 ,33.33
03,012,01,013,0251,555,647,9,656,805,0,3,1,3,0,1,0,76.14,81.49 ,33.33
03,012,01,013,0252,556,946,11,957,1213,0,3,1,3,0,1,0,76.14,78.90 ,33.33
03,012,01,014,0253,557,954,11,965,1273,0,3,1,3,0,1,0,76.14,75.81 ,33.33
03,012,01,014,0253,558,609,5,614,808,0,3,1,3,0,1,0,76.14,75.99 ,33.33
03,012,01,014,0254,559,727,12,739,1008,0,3,1,3,0,1,0,76.14,73.31 ,33.33
03,012,01,014,0255,560,630,12,642,867,0,3,1,3,0,1,0,76.14,74.05 ,33.33
03,012,01,014,0255,561,443,5,448,656,0,3,1,3,0,1,0,76.14,68.29 ,33.33
03,012,01,014,0255,562,424,5,429,602,0,3,1,3,0,1,0,76.14,71.26 ,33.33
03,012,01,014,0255,563,603,13,616,947,0,3,1,3,0,1,0,76.14,65.05 ,33.33
03,012,01,014,0256,564,524,4,528,754,0,3,1,3,0,1,0,76.14,70.03 ,33.33
03,012,01,014,0256,565,530,12,542,864,0,3,1,3,0,1,0,76.14,62.73 ,33.33
03,012,01,014,0257,566,833,12,845,1150,0,3,1,3,0,1,0,76.14,73.48 ,33.33
03,012,01,014,0258,567,748,18,766,1107,0,3,1,3,0,1,0,76.14,69.20 ,33.33
03,012,01,014,0259,568,587,5,592,801,0,3,1,3,0,1,0,76.14,73.91 ,33.33
03,012,01,014,0260,569,979,10,989,1340,0,3,1,3,0,1,0,76.14,73.81 ,33.33
03,012,01,014,0261,570,528,5,533,733,0,3,1,3,0,1,0,76.14,72.71 ,33.33
03,012,01,014,0261,571,556,7,563,799,0,3,1,3,0,1,0,76.14,70.46 ,33.33
03,012,01,014,0262,572,754,19,773,1099,0,3,1,3,0,1,0,76.14,70.34 ,33.33
03,012,01,014,0263,573,608,5,613,869,0,3,1,3,0,1,0,76.14,70.54 ,33.33
03,012,01,014,0263,574,678,8,686,976,0,3,1,3,0,1,0,76.14,70.29 ,33.33
03,012,01,014,0264,575,573,10,583,834,0,3,1,3,0,1,0,76.14,69.90 ,33.33
03,012,01,014,0265,576,546,6,552,724,0,3,1,3,0,1,0,76.14,76.24 ,33.33
03,012,01,015,0266,577,690,4,694,1036,0,3,1,3,0,1,0,76.14,66.99 ,33.33
03,012,01,015,0267,578,553,6,559,847,0,3,1,3,0,1,0,76.14,66.00 ,33.33
03,012,01,015,0268,579,1061,15,1076,1537,0,3,1,3,0,1,0,76.14,70.01 ,33.33
03,012,01,015,0269,580,750,3,753,1169,0,3,1,3,0,1,0,76.14,64.41 ,33.33
03,012,01,015,0269,581,767,12,779,1190,0,3,1,3,0,1,0,76.14,65.46 ,33.33
03,012,01,015,0270,582,875,8,883,1266,0,3,1,3,0,1,0,76.14,69.75 ,33.33
03,012,01,015,0271,583,1254,15,1269,1785,0,3,1,3,0,1,0,76.14,71.09 ,33.33
03,012,01,015,0272,584,827,12,839,1278,0,3,1,3,0,1,0,76.14,65.65 ,33.33
03,012,01,015,0273,585,725,7,732,1090,0,3,1,3,0,1,0,76.14,67.16 ,33.33
03,012,01,015,0274,586,760,9,769,1197,0,3,1,3,0,1,0,76.14,64.24 ,33.33
03,012,01,015,0275,587,895,7,902,1307,0,3,1,3,0,1,0,76.14,69.01 ,33.33
03,012,01,015,0276,588,669,9,678,1079,0,3,1,3,0,1,0,76.14,62.84 ,33.33
03,012,01,015,0276,589,988,7,995,1614,0,3,1,3,0,1,0,76.14,61.65 ,33.33
03,012,01,015,0277,590,742,10,752,1158,0,3,1,3,0,1,0,76.14,64.94 ,33.33
03,012,01,015,0278,591,678,10,688,1027,0,3,1,3,0,1,0,76.14,66.99 ,33.33
03,012,01,015,0279,592,758,8,766,1110,0,3,1,3,0,1,0,76.14,69.01 ,33.33
03,012,01,015,0280,593,903,12,915,1182,0,3,1,3,0,1,0,76.14,77.41 ,33.33
03,012,01,015,0280,594,933,19,952,1468,0,3,1,3,0,1,0,76.14,64.85 ,33.33
03,012,01,016,0281,595,1045,10,1055,1340,0,3,1,3,0,1,0,76.14,78.73 ,33.33
03,012,01,016,0282,596,1241,17,1258,1698,0,3,1,3,0,1,0,76.14,74.09 ,33.33
03,012,01,016,0283,597,1295,20,1315,1734,0,3,1,3,0,1,0,76.14,75.84 ,33.33
03,012,01,016,0284,598,700,16,716,860,0,3,1,3,0,1,0,76.14,83.26 ,33.33
03,012,01,016,0285,599,735,8,743,993,0,3,1,3,0,1,0,76.14,74.82 ,33.33
03,012,01,016,0286,600,1265,11,1276,1682,0,3,1,3,0,1,0,76.14,75.86 ,33.33
03,012,01,016,0287,601,440,3,443,575,0,3,1,3,0,1,0,76.14,77.04 ,33.33
03,012,01,016,0288,602,544,7,551,724,0,3,1,3,0,1,0,76.14,76.10 ,33.33
03,012,01,016,0289,603,1052,23,1075,1403,0,3,1,3,0,1,0,76.14,76.62 ,33.33
03,012,01,016,0290,604,611,13,624,802,0,3,1,3,0,1,0,76.14,77.81 ,33.33
03,012,01,016,0291,605,745,5,750,901,0,3,1,3,0,1,0,76.14,83.24 ,33.33
03,012,01,016,0292,606,1346,11,1357,1821,0,3,1,3,0,1,0,76.14,74.52 ,33.33
03,012,01,017,0293,607,980,6,986,1333,0,3,1,3,0,1,0,76.14,73.97 ,33.33
03,012,01,017,0294,608,1124,15,1139,1513,0,3,1,3,0,1,0,76.14,75.28 ,33.33
03,012,01,017,0295,609,1059,5,1064,1412,0,3,1,3,0,1,0,76.14,75.35 ,33.33
03,012,01,017,0295,610,451,6,457,678,0,3,1,3,0,1,0,76.14,67.40 ,33.33
03,012,01,017,0296,611,287,2,289,429,0,3,1,3,0,1,0,76.14,67.37 ,33.33
03,012,01,017,0297,612,1177,15,1192,1520,0,3,1,3,0,1,0,76.14,78.42 ,33.33
03,012,01,017,0298,613,622,6,628,808,0,3,1,3,0,1,0,76.14,77.72 ,33.33
03,012,01,017,0298,614,892,3,895,1216,0,3,1,3,0,1,0,76.14,73.60 ,33.33
03,012,01,018,0299,615,1180,25,1205,1714,0,3,1,3,0,1,0,76.14,70.30 ,33.33
03,012,01,018,0300,616,623,8,631,916,0,3,1,3,0,1,0,76.14,68.89 ,33.33
03,012,01,018,0300,617,725,11,736,1004,0,3,1,3,0,1,0,76.14,73.31 ,33.33
03,012,01,018,0301,618,880,15,895,1247,0,3,1,3,0,1,0,76.14,71.77 ,33.33
03,012,01,018,0301,619,590,8,598,846,0,3,1,3,0,1,0,76.14,70.69 ,33.33
03,012,01,018,0302,620,743,7,750,996,0,3,1,3,0,1,0,76.14,75.30 ,33.33
03,012,01,018,0303,621,619,10,629,861,0,3,1,3,0,1,0,76.14,73.05 ,33.33
03,012,01,018,0304,622,601,5,606,784,0,3,1,3,0,1,0,76.14,77.30 ,33.33
03,012,01,018,0305,623,916,17,933,1285,0,3,1,3,0,1,0,76.14,72.61 ,33.33
03,012,01,018,0305,624,1285,18,1303,1842,0,3,1,3,0,1,0,76.14,70.74 ,33.33
03,012,01,018,0306,625,816,15,831,1121,0,3,1,3,0,1,0,76.14,74.13 ,33.33
03,012,01,018,0306,626,540,11,551,769,0,3,1,3,0,1,0,76.14,71.65 ,33.33
03,012,01,018,0307,627,988,14,1002,1352,0,3,1,3,0,1,0,76.14,74.11 ,33.33
03,012,01,018,0307,628,768,12,780,1039,0,3,1,3,0,1,0,76.14,75.07 ,33.33
03,012,01,018,0308,629,444,4,448,639,0,3,1,3,0,1,0,76.14,70.11 ,33.33
03,012,01,018,0309,630,738,12,750,1090,0,3,1,3,0,1,0,76.14,68.81 ,33.33
03,012,01,018,0309,631,821,7,828,1146,0,3,1,3,0,1,0,76.14,72.25 ,33.33
03,012,01,018,0310,632,569,9,578,852,0,3,1,3,0,1,0,76.14,67.84 ,33.33
03,012,01,018,0310,633,744,12,756,1040,0,3,1,3,0,1,0,76.14,72.69 ,33.33
03,012,01,018,0311,634,781,5,786,1157,0,3,1,3,0,1,0,76.14,67.93 ,33.33
03,012,01,018,0312,635,871,13,884,1155,0,3,1,3,0,1,0,76.14,76.54 ,33.33
03,012,01,018,0312,636,663,4,667,949,0,3,1,3,0,1,0,76.14,70.28 ,33.33
03,012,01,018,0313,637,809,10,819,1020,0,3,1,3,0,1,0,76.14,80.29 ,33.33
03,012,01,018,0313,638,609,7,616,837,0,3,1,3,0,1,0,76.14,73.60 ,33.33
03,012,01,019,0314,639,723,3,726,1055,0,3,1,3,0,1,0,76.14,68.82 ,33.33
03,012,01,019,0314,640,823,15,838,1231,0,3,1,3,0,1,0,76.14,68.07 ,33.33
03,012,01,019,0315,641,972,12,984,1327,0,3,1,3,0,1,0,76.14,74.15 ,33.33
03,012,01,019,0315,642,769,3,772,1099,0,3,1,3,0,1,0,76.14,70.25 ,33.33
03,012,01,019,0316,643,642,5,647,896,0,3,1,3,0,1,0,76.14,72.21 ,33.33
03,012,01,019,0317,644,482,7,489,635,0,3,1,3,0,1,0,76.14,77.01 ,33.33
03,012,01,019,0318,645,672,3,675,915,0,3,1,3,0,1,0,76.14,73.77 ,33.33
03,012,01,019,0319,646,466,8,474,671,0,3,1,3,0,1,0,76.14,70.64 ,33.33
03,012,01,019,0320,647,365,5,370,495,0,3,1,3,0,1,0,76.14,74.75 ,33.33
03,012,01,019,0321,648,626,4,630,907,0,3,1,3,0,1,0,76.14,69.46 ,33.33
03,012,01,019,0321,649,645,5,650,962,0,3,1,3,0,1,0,76.14,67.57 ,33.33
03,012,01,019,0322,650,981,9,990,1435,0,3,1,3,0,1,0,76.14,68.99 ,33.33
03,012,01,019,0322,651,978,19,997,1377,0,3,1,3,0,1,0,76.14,72.40 ,33.33
03,012,01,019,0323,652,1009,14,1023,1472,0,3,1,3,0,1,0,76.14,69.50 ,33.33
03,012,01,019,0323,653,9,0,9,298,0,3,1,3,0,1,0,76.14,3.02 ,33.33
03,012,01,019,0324,654,724,22,746,1059,0,3,1,3,0,1,0,76.14,70.44 ,33.33
03,012,01,019,0324,655,560,10,570,826,0,3,1,3,0,1,0,76.14,69.01 ,33.33
03,012,01,019,0325,656,1044,22,1066,1521,0,3,1,3,0,1,0,76.14,70.09 ,33.33
03,012,01,019,0326,657,770,11,781,1097,0,3,1,3,0,1,0,76.14,71.19 ,33.33
03,012,01,019,0326,658,427,4,431,581,0,3,1,3,0,1,0,76.14,74.18 ,33.33
03,012,01,019,0327,659,721,9,730,954,0,3,1,3,0,1,0,76.14,76.52 ,33.33
03,012,01,019,0328,660,767,7,774,986,0,3,1,3,0,1,0,76.14,78.50 ,33.33
03,012,01,019,0329,661,1061,14,1075,1402,0,3,1,3,0,1,0,76.14,76.68 ,33.33
03,012,01,019,0330,662,825,14,839,1103,0,3,1,3,0,1,0,76.14,76.07 ,33.33
03,012,01,019,0331,663,1124,10,1134,1452,0,3,1,3,0,1,0,76.14,78.10 ,33.33
03,012,01,019,0332,664,762,3,765,988,0,3,1,3,0,1,0,76.14,77.43 ,33.33
03,012,01,019,0333,665,935,10,945,1220,0,3,1,3,0,1,0,76.14,77.46 ,33.33
03,012,01,019,0333,666,909,15,924,1186,0,3,1,3,0,1,0,76.14,77.91 ,33.33
03,012,01,019,0334,667,683,6,689,932,0,3,1,3,0,1,0,76.14,73.93 ,33.33
03,012,01,019,0334,668,640,8,648,917,0,3,1,3,0,1,0,76.14,70.67 ,33.33
03,012,01,019,0335,669,492,8,500,709,0,3,1,3,0,1,0,76.14,70.52 ,33.33
03,012,01,019,0336,670,283,3,286,387,0,3,1,3,0,1,0,76.14,73.90 ,33.33
03,012,01,019,0337,671,457,3,460,612,0,3,1,3,0,1,0,76.14,75.16 ,33.33
03,012,01,019,0338,672,139,0,139,201,0,3,1,3,0,1,0,76.14,69.15 ,33.33
03,012,01,020,0339,673,1177,13,1190,1610,0,3,1,3,0,1,0,76.14,73.91 ,33.33
03,012,01,020,0340,674,1109,14,1123,1575,0,3,1,3,0,1,0,76.14,71.30 ,33.33
03,012,01,020,0341,675,993,8,1001,1422,0,3,1,3,0,1,0,76.14,70.39 ,33.33
03,012,01,020,0342,676,744,13,757,1022,0,3,1,3,0,1,0,76.14,74.07 ,33.33
03,012,01,020,0342,677,810,12,822,1208,0,3,1,3,0,1,0,76.14,68.05 ,33.33
03,012,01,020,0343,678,861,8,869,1241,0,3,1,3,0,1,0,76.14,70.02 ,33.33
03,012,01,020,0343,679,653,10,663,975,0,3,1,3,0,1,0,76.14,68.00 ,33.33
03,012,01,020,0344,680,849,7,856,1195,0,3,1,3,0,1,0,76.14,71.63 ,33.33
03,012,01,020,0344,681,906,13,919,1352,0,3,1,3,0,1,0,76.14,67.97 ,33.33
03,012,01,020,0345,682,887,12,899,1262,0,3,1,3,0,1,0,76.14,71.24 ,33.33
03,012,01,020,0345,683,836,10,846,1196,0,3,1,3,0,1,0,76.14,70.74 ,33.33
03,012,01,020,0346,684,684,2,686,907,0,3,1,3,0,1,0,76.14,75.63 ,33.33
03,012,01,020,0346,685,804,11,815,1190,0,3,1,3,0,1,0,76.14,68.49 ,33.33
03,012,01,020,0347,686,1088,9,1097,1532,0,3,1,3,0,1,0,76.14,71.61 ,33.33
03,012,01,020,0348,687,687,13,700,1012,0,3,1,3,0,1,0,76.14,69.17 ,33.33
03,012,01,020,0348,688,501,4,505,732,0,3,1,3,0,1,0,76.14,68.99 ,33.33
03,012,01,020,0349,689,1070,12,1082,1459,0,3,1,3,0,1,0,76.14,74.16 ,33.33
03,012,01,020,0350,690,737,9,746,1072,0,3,1,3,0,1,0,76.14,69.59 ,33.33
03,012,01,020,0350,691,704,7,711,1054,0,3,1,3,0,1,0,76.14,67.46 ,33.33
03,012,01,020,0351,692,1185,16,1201,1638,0,3,1,3,0,1,0,76.14,73.32 ,33.33
03,012,01,020,0352,693,835,13,848,1207,0,3,1,3,0,1,0,76.14,70.26 ,33.33
03,012,01,020,0352,694,732,19,751,1099,0,3,1,3,0,1,0,76.14,68.33 ,33.33
03,012,01,020,0353,695,926,50,976,1379,0,3,1,3,0,1,0,76.14,70.78 ,33.33
03,012,01,020,0353,696,747,9,756,1005,0,3,1,3,0,1,0,76.14,75.22 ,33.33
03,012,01,020,0354,697,523,7,530,775,0,3,1,3,0,1,0,76.14,68.39 ,33.33
03,012,01,020,0354,698,619,10,629,919,0,3,1,3,0,1,0,76.14,68.44 ,33.33
03,012,01,020,0355,699,1035,18,1053,1477,0,3,1,3,0,1,0,76.14,71.29 ,33.33
03,012,01,020,0356,700,899,5,904,1232,0,3,1,3,0,1,0,76.14,73.38 ,33.33
03,012,01,020,0357,701,623,12,635,934,0,3,1,3,0,1,0,76.14,67.99 ,33.33
03,012,01,020,0357,702,539,5,544,835,0,3,1,3,0,1,0,76.14,65.15 ,33.33
03,012,01,021,0358,703,672,13,685,1146,0,3,1,3,0,1,0,76.14,59.77 ,33.33
03,012,01,021,0359,704,845,8,853,1191,0,3,1,3,0,1,0,76.14,71.62 ,33.33
03,012,01,021,0360,705,1031,24,1055,1670,0,3,1,3,0,1,0,76.14,63.17 ,33.33
03,012,01,021,0361,706,889,20,909,1416,0,3,1,3,0,1,0,76.14,64.19 ,33.33
03,012,01,021,0362,707,634,12,646,1000,0,3,1,3,0,1,0,76.14,64.60 ,33.33
03,012,01,021,0363,708,591,9,600,871,0,3,1,3,0,1,0,76.14,68.89 ,33.33
03,012,01,021,0364,709,549,4,553,809,0,3,1,3,0,1,0,76.14,68.36 ,33.33
03,012,01,021,0365,710,499,7,506,651,0,3,1,3,0,1,0,76.14,77.73 ,33.33
03,012,01,021,0366,711,276,5,281,382,0,3,1,3,0,1,0,76.14,73.56 ,33.33
03,012,01,021,0367,712,853,8,861,1510,0,3,1,3,0,1,0,76.14,57.02 ,33.33
03,012,01,021,0368,713,977,32,1009,1570,0,3,1,3,0,1,0,76.14,64.27 ,33.33
03,012,01,021,0369,714,676,15,691,1024,0,3,1,3,0,1,0,76.14,67.48 ,33.33
03,012,01,022,0370,715,435,6,441,630,0,3,1,3,0,1,0,76.14,70.00 ,33.33
03,012,01,022,0371,716,813,5,818,1057,0,3,1,3,0,1,0,76.14,77.39 ,33.33
03,012,01,022,0372,717,559,6,565,764,0,3,1,3,0,1,0,76.14,73.95 ,33.33
03,012,01,022,0373,718,1064,11,1075,1472,0,3,1,3,0,1,0,76.14,73.03 ,33.33
03,012,01,022,0374,719,494,5,499,712,0,3,1,3,0,1,0,76.14,70.08 ,33.33
03,012,01,022,0375,720,494,4,498,693,0,3,1,3,0,1,0,76.14,71.86 ,33.33
03,012,01,022,0376,721,734,8,742,1163,0,3,1,3,0,1,0,76.14,63.80 ,33.33
03,012,01,023,0377,722,583,5,588,878,0,3,1,3,0,1,0,76.14,66.97 ,33.33
03,012,01,023,0378,723,483,4,487,812,0,3,1,3,0,1,0,76.14,59.98 ,33.33
03,012,01,023,0379,724,638,19,657,1139,0,3,1,3,0,1,0,76.14,57.68 ,33.33
03,012,01,023,0379,725,451,7,458,763,0,3,1,3,0,1,0,76.14,60.03 ,33.33
03,012,01,023,0380,726,1188,19,1207,1852,0,3,1,3,0,1,0,76.14,65.17 ,33.33
03,012,01,023,0381,727,1124,17,1141,1638,0,3,1,3,0,1,0,76.14,69.66 ,33.33
03,012,01,023,0382,728,1205,22,1227,1836,0,3,1,3,0,1,0,76.14,66.83 ,33.33
03,012,01,023,0383,729,938,13,951,1411,0,3,1,3,0,1,0,76.14,67.40 ,33.33
03,012,01,024,0384,730,573,14,587,778,0,3,1,3,0,1,0,76.14,75.45 ,33.33
03,012,01,024,0385,731,722,10,732,1055,0,3,1,3,0,1,0,76.14,69.38 ,33.33
03,012,01,024,0386,732,344,4,348,510,0,3,1,3,0,1,0,76.14,68.24 ,33.33
03,012,01,024,0387,733,373,7,380,483,0,3,1,3,0,1,0,76.14,78.67 ,33.33
03,012,01,024,0388,734,752,16,768,1001,0,3,1,3,0,1,0,76.14,76.72 ,33.33
03,012,01,024,0389,735,487,5,492,670,0,3,1,3,0,1,0,76.14,73.43 ,33.33
03,012,01,024,0389,736,788,22,810,1077,0,3,1,3,0,1,0,76.14,75.21 ,33.33
03,012,01,024,0390,737,477,5,482,623,0,3,1,3,0,1,0,76.14,77.37 ,33.33
03,012,01,024,0391,738,291,3,294,386,0,3,1,3,0,1,0,76.14,76.17 ,33.33
03,012,01,024,0392,739,281,3,284,364,0,3,1,3,0,1,0,76.14,78.02 ,33.33
03,012,01,024,0393,740,665,6,671,844,0,3,1,3,0,1,0,76.14,79.50 ,33.33
03,012,01,024,0394,741,507,7,514,656,0,3,1,3,0,1,0,76.14,78.35 ,33.33
03,012,01,024,0395,742,344,3,347,476,0,3,1,3,0,1,0,76.14,72.90 ,33.33
03,012,01,024,0396,743,885,3,888,1130,0,3,1,3,0,1,0,76.14,78.58 ,33.33
03,012,01,024,0397,744,759,5,764,928,0,3,1,3,0,1,0,76.14,82.33 ,33.33
03,012,01,024,0398,745,379,9,388,508,0,3,1,3,0,1,0,76.14,76.38 ,33.33
03,012,01,024,0399,746,502,7,509,675,0,3,1,3,0,1,0,76.14,75.41 ,33.33
03,012,01,024,0400,747,469,8,477,685,0,3,1,3,0,1,0,76.14,69.64 ,33.33
03,012,01,024,0401,748,447,3,450,619,0,3,1,3,0,1,0,76.14,72.70 ,33.33
03,012,01,025,0402,749,29,1,30,59,0,3,1,3,0,1,0,76.14,50.85 ,33.33
03,012,01,025,0403,750,12,0,12,18,0,3,1,3,0,1,0,76.14,66.67 ,33.33
03,012,01,025,0404,751,7,0,7,17,0,3,1,3,0,1,0,76.14,41.18 ,33.33
03,012,01,026,0405,752,3,1,4,8,0,3,1,3,0,1,0,76.14,50.00 ,33.33
03,012,01,026,0405,753,9,1,10,21,0,3,1,3,0,1,0,76.14,47.62 ,33.33
03,012,01,026,0406,754,27,1,28,42,0,3,1,3,0,1,0,76.14,66.67 ,33.33
03,012,01,026,0407,755,46,0,46,72,0,3,1,3,0,1,0,76.14,63.89 ,33.33
03,012,01,026,0408,756,87,0,87,130,0,3,1,3,0,1,0,76.14,66.92 ,33.33
03,012,01,026,0409,757,7,0,7,17,0,3,1,3,0,1,0,76.14,41.18 ,33.33
03,012,01,026,0410,758,9,0,9,19,0,3,1,3,0,1,0,76.14,47.37 ,33.33
03,012,01,026,0411,759,7,0,7,13,0,3,1,3,0,1,0,76.14,53.85 ,33.33
03,012,01,026,0412,760,8,0,8,18,0,3,1,3,0,1,0,76.14,44.44 ,33.33
03,012,01,027,0413,761,53,0,53,133,0,3,1,3,0,1,0,76.14,39.85 ,33.33
03,012,01,027,0414,762,15,0,15,31,0,3,1,3,0,1,0,76.14,48.39 ,33.33
03,012,01,027,0415,763,49,0,49,79,0,3,1,3,0,1,0,76.14,62.03 ,33.33
03,013,01,001,0001,1,922,4,926,1348,0,3,1,3,0,1,0,76.14,68.69 ,33.33
03,013,01,001,0002,2,1092,7,1099,1561,0,3,1,3,0,1,0,76.14,70.40 ,33.33
03,013,01,001,0003,3,622,2,624,882,0,3,1,3,0,1,0,76.14,70.75 ,33.33
03,013,01,001,0004,4,913,3,916,1412,0,3,1,3,0,1,0,76.14,64.87 ,33.33
03,013,01,001,0005,5,1054,9,1063,1576,0,3,1,3,0,1,0,76.14,67.45 ,33.33
03,013,01,001,0005,6,920,5,925,1409,0,3,1,3,0,1,0,76.14,65.65 ,33.33
03,013,01,001,0006,7,988,10,998,1521,0,3,1,3,0,1,0,76.14,65.61 ,33.33
03,013,01,001,0007,8,674,4,678,972,0,3,1,3,0,1,0,76.14,69.75 ,33.33
03,013,01,001,0008,9,629,4,633,968,0,3,1,3,0,1,0,76.14,65.39 ,33.33
03,013,01,001,0009,10,883,4,887,1355,0,3,1,3,0,1,0,76.14,65.46 ,33.33
03,013,01,001,0010,11,688,2,690,1007,0,3,1,3,0,1,0,76.14,68.52 ,33.33
03,013,01,001,0011,12,780,5,785,1128,0,3,1,3,0,1,0,76.14,69.59 ,33.33
03,013,01,001,0012,13,915,7,922,1640,0,3,1,3,0,1,0,76.14,56.22 ,33.33
03,013,01,001,0013,14,729,6,735,1128,0,3,1,3,0,1,0,76.14,65.16 ,33.33
03,013,01,001,0014,15,696,4,700,1043,0,3,1,3,0,1,0,76.14,67.11 ,33.33
03,013,01,001,0014,16,603,8,611,1001,0,3,1,3,0,1,0,76.14,61.04 ,33.33
03,013,01,001,0015,17,757,2,759,1149,0,3,1,3,0,1,0,76.14,66.06 ,33.33
03,013,01,001,0015,18,805,4,809,1166,0,3,1,3,0,1,0,76.14,69.38 ,33.33
03,013,01,001,0016,19,693,3,696,1075,0,3,1,3,0,1,0,76.14,64.74 ,33.33
03,013,01,001,0016,20,807,2,809,1261,0,3,1,3,0,1,0,76.14,64.16 ,33.33
03,013,01,001,0016,21,910,8,918,1416,0,3,1,3,0,1,0,76.14,64.83 ,33.33
03,013,01,001,0017,22,1233,4,1237,1902,0,3,1,3,0,1,0,76.14,65.04 ,33.33
03,013,01,001,0017,23,1005,17,1022,1535,0,3,1,3,0,1,0,76.14,66.58 ,33.33
03,013,01,001,0017,24,1094,8,1102,1700,0,3,1,3,0,1,0,76.14,64.82 ,33.33
03,013,01,001,0017,25,1230,9,1239,1864,0,3,1,3,0,1,0,76.14,66.47 ,33.33
03,013,01,001,0018,26,1118,10,1128,1768,0,3,1,3,0,1,0,76.14,63.80 ,33.33
03,013,01,001,0018,27,1037,10,1047,1609,0,3,1,3,0,1,0,76.14,65.07 ,33.33
03,013,01,001,0019,28,613,7,620,881,0,3,1,3,0,1,0,76.14,70.37 ,33.33
03,013,01,001,0020,29,862,5,867,1251,0,3,1,3,0,1,0,76.14,69.30 ,33.33
03,013,01,001,0021,30,713,8,721,1034,0,3,1,3,0,1,0,76.14,69.73 ,33.33
03,013,01,001,0022,31,1114,7,1121,1741,0,3,1,3,0,1,0,76.14,64.39 ,33.33
03,013,01,001,0022,32,1238,13,1251,1924,0,3,1,3,0,1,0,76.14,65.02 ,33.33
03,013,01,001,0022,33,1211,25,1236,1848,0,3,1,3,0,1,0,76.14,66.88 ,33.33
03,013,01,001,0023,34,940,12,952,1380,0,3,1,3,0,1,0,76.14,68.99 ,33.33
03,013,01,001,0024,35,902,7,909,1488,0,3,1,3,0,1,0,76.14,61.09 ,33.33
03,013,01,001,0025,36,485,5,490,774,0,3,1,3,0,1,0,76.14,63.31 ,33.33
03,013,01,001,0026,37,534,5,539,838,0,3,1,3,0,1,0,76.14,64.32 ,33.33
03,013,01,001,0027,38,866,10,876,1471,0,3,1,3,0,1,0,76.14,59.55 ,33.33
03,013,01,001,0027,39,912,7,919,1473,0,3,1,3,0,1,0,76.14,62.39 ,33.33
03,013,01,001,0028,40,851,5,856,1427,0,3,1,3,0,1,0,76.14,59.99 ,33.33
03,013,01,001,0028,41,934,8,942,1576,0,3,1,3,0,1,0,76.14,59.77 ,33.33
03,013,01,001,0028,42,792,3,795,1323,0,3,1,3,0,1,0,76.14,60.09 ,33.33
03,013,01,001,0028,43,885,10,895,1464,0,3,1,3,0,1,0,76.14,61.13 ,33.33
03,013,01,001,0029,44,662,8,670,978,0,3,1,3,0,1,0,76.14,68.51 ,33.33
03,013,01,001,0029,45,980,11,991,1531,0,3,1,3,0,1,0,76.14,64.73 ,33.33
03,013,01,001,0029,46,764,10,774,1143,0,3,1,3,0,1,0,76.14,67.72 ,33.33
03,013,01,001,0030,47,363,5,368,544,0,3,1,3,0,1,0,76.14,67.65 ,33.33
03,013,01,001,0031,48,653,6,659,907,0,3,1,3,0,1,0,76.14,72.66 ,33.33
03,013,01,001,0032,49,867,6,873,1209,0,3,1,3,0,1,0,76.14,72.21 ,33.33
03,013,01,001,0032,50,711,7,718,1021,0,3,1,3,0,1,0,76.14,70.32 ,33.33
03,013,01,001,0033,51,899,9,908,1278,0,3,1,3,0,1,0,76.14,71.05 ,33.33
03,013,01,001,0034,52,1372,7,1379,1956,0,3,1,3,0,1,0,76.14,70.50 ,33.33
03,013,01,001,0035,53,1024,9,1033,1435,0,3,1,3,0,1,0,76.14,71.99 ,33.33
03,013,01,001,0036,54,815,7,822,1161,0,3,1,3,0,1,0,76.14,70.80 ,33.33
03,013,01,001,0037,55,763,14,777,1129,0,3,1,3,0,1,0,76.14,68.82 ,33.33
03,013,01,001,0038,56,1249,10,1259,1879,0,3,1,3,0,1,0,76.14,67.00 ,33.33
03,013,01,001,0039,57,856,11,867,1293,0,3,1,3,0,1,0,76.14,67.05 ,33.33
03,013,01,001,0040,58,754,9,763,1152,0,3,1,3,0,1,0,76.14,66.23 ,33.33
03,013,01,001,0040,59,515,13,528,807,0,3,1,3,0,1,0,76.14,65.43 ,33.33
03,013,01,001,0041,60,826,7,833,1169,0,3,1,3,0,1,0,76.14,71.26 ,33.33
03,013,01,001,0042,61,1283,17,1300,1953,0,3,1,3,0,1,0,76.14,66.56 ,33.33
03,013,01,001,0042,62,1244,15,1259,1974,0,3,1,3,0,1,0,76.14,63.78 ,33.33
03,013,01,001,0042,63,1020,12,1032,1560,0,3,1,3,0,1,0,76.14,66.15 ,33.33
03,013,01,001,0043,64,960,8,968,1448,0,3,1,3,0,1,0,76.14,66.85 ,33.33
03,013,01,001,0043,65,1253,13,1266,2005,0,3,1,3,0,1,0,76.14,63.14 ,33.33
03,013,01,001,0044,66,747,4,751,1092,0,3,1,3,0,1,0,76.14,68.77 ,33.33
03,013,01,001,0045,67,644,5,649,891,0,3,1,3,0,1,0,76.14,72.84 ,33.33
03,013,01,001,0046,68,1074,6,1080,1528,0,3,1,3,0,1,0,76.14,70.68 ,33.33
03,013,01,001,0047,69,1058,13,1071,1446,0,3,1,3,0,1,0,76.14,74.07 ,33.33
03,013,01,001,0048,70,734,7,741,1108,0,3,1,3,0,1,0,76.14,66.88 ,33.33
03,013,01,001,0049,71,590,5,595,863,0,3,1,3,0,1,0,76.14,68.95 ,33.33
03,013,01,001,0049,72,670,9,679,1000,0,3,1,3,0,1,0,76.14,67.90 ,33.33
03,013,01,001,0050,73,662,8,670,995,0,3,1,3,0,1,0,76.14,67.34 ,33.33
03,013,01,001,0051,74,821,4,825,1211,0,3,1,3,0,1,0,76.14,68.13 ,33.33
03,013,01,001,0051,75,898,11,909,1311,0,3,1,3,0,1,0,76.14,69.34 ,33.33
03,013,01,001,0051,76,885,6,891,1359,0,3,1,3,0,1,0,76.14,65.56 ,33.33
03,013,01,001,0052,77,783,1,784,1247,0,3,1,3,0,1,0,76.14,62.87 ,33.33
03,013,01,001,0052,78,859,4,863,1296,0,3,1,3,0,1,0,76.14,66.59 ,33.33
03,013,01,001,0053,79,966,7,973,1465,0,3,1,3,0,1,0,76.14,66.42 ,33.33
03,013,01,001,0053,80,714,9,723,1192,0,3,1,3,0,1,0,76.14,60.65 ,33.33
03,013,01,001,0054,81,571,5,576,950,0,3,1,3,0,1,0,76.14,60.63 ,33.33
03,013,01,001,0054,82,603,3,606,1037,0,3,1,3,0,1,0,76.14,58.44 ,33.33
03,013,01,001,0055,83,957,10,967,1417,0,3,1,3,0,1,0,76.14,68.24 ,33.33
03,013,01,001,0055,84,1068,11,1079,1762,0,3,1,3,0,1,0,76.14,61.24 ,33.33
03,013,01,001,0055,85,902,7,909,1415,0,3,1,3,0,1,0,76.14,64.24 ,33.33
03,013,01,001,0056,86,708,4,712,1061,0,3,1,3,0,1,0,76.14,67.11 ,33.33
03,013,01,001,0056,87,768,8,776,1092,0,3,1,3,0,1,0,76.14,71.06 ,33.33
03,013,01,001,0057,88,587,4,591,930,0,3,1,3,0,1,0,76.14,63.55 ,33.33
03,013,01,001,0057,89,774,12,786,1256,0,3,1,3,0,1,0,76.14,62.58 ,33.33
03,013,01,001,0057,90,1028,9,1037,1597,0,3,1,3,0,1,0,76.14,64.93 ,33.33
03,013,01,001,0058,91,720,3,723,1058,0,3,1,3,0,1,0,76.14,68.34 ,33.33
03,013,01,001,0058,92,816,12,828,1376,0,3,1,3,0,1,0,76.14,60.17 ,33.33
03,013,01,001,0059,93,868,4,872,1347,0,3,1,3,0,1,0,76.14,64.74 ,33.33
03,013,01,001,0059,94,944,5,949,1433,0,3,1,3,0,1,0,76.14,66.22 ,33.33
03,013,01,001,0059,95,749,4,753,1162,0,3,1,3,0,1,0,76.14,64.80 ,33.33
03,013,01,001,0059,96,710,7,717,1066,0,3,1,3,0,1,0,76.14,67.26 ,33.33
03,013,01,001,0060,97,1245,18,1263,1700,0,3,1,3,0,1,0,76.14,74.29 ,33.33
03,013,01,001,0061,98,1025,9,1034,1538,0,3,1,3,0,1,0,76.14,67.23 ,33.33
03,013,01,001,0062,99,543,8,551,786,0,3,1,3,0,1,0,76.14,70.10 ,33.33
03,013,01,001,0063,100,919,7,926,1479,0,3,1,3,0,1,0,76.14,62.61 ,33.33
03,013,01,001,0063,101,842,6,848,1318,0,3,1,3,0,1,0,76.14,64.34 ,33.33
03,013,01,001,0063,102,862,4,866,1333,0,3,1,3,0,1,0,76.14,64.97 ,33.33
03,013,01,001,0063,103,952,6,958,1537,0,3,1,3,0,1,0,76.14,62.33 ,33.33
03,013,01,001,0064,104,822,16,838,1188,0,3,1,3,0,1,0,76.14,70.54 ,33.33
03,013,01,001,0065,105,565,1,566,817,0,3,1,3,0,1,0,76.14,69.28 ,33.33
03,013,01,001,0066,106,695,7,702,947,0,3,1,3,0,1,0,76.14,74.13 ,33.33
03,013,01,001,0067,107,936,6,942,1360,0,3,1,3,0,1,0,76.14,69.26 ,33.33
03,013,01,001,0068,108,640,5,645,943,0,3,1,3,0,1,0,76.14,68.40 ,33.33
03,013,01,002,0069,109,447,0,447,696,0,3,1,3,0,1,0,76.14,64.22 ,33.33
03,013,01,002,0070,110,1029,6,1035,1642,0,3,1,3,0,1,0,76.14,63.03 ,33.33
03,013,01,002,0070,111,997,9,1006,1673,0,3,1,3,0,1,0,76.14,60.13 ,33.33
03,013,01,002,0071,112,550,2,552,806,0,3,1,3,0,1,0,76.14,68.49 ,33.33
03,013,01,002,0072,113,841,5,846,1320,0,3,1,3,0,1,0,76.14,64.09 ,33.33
03,013,01,002,0073,114,922,5,927,1459,0,3,1,3,0,1,0,76.14,63.54 ,33.33
03,013,01,002,0074,115,559,0,559,781,0,3,1,3,0,1,0,76.14,71.57 ,33.33
03,013,01,002,0075,116,1026,5,1031,1672,0,3,1,3,0,1,0,76.14,61.66 ,33.33
03,013,01,002,0075,117,1185,8,1193,1890,0,3,1,3,0,1,0,76.14,63.12 ,33.33
03,013,01,002,0076,118,996,4,1000,1559,0,3,1,3,0,1,0,76.14,64.14 ,33.33
03,013,01,002,0076,119,972,11,983,1644,0,3,1,3,0,1,0,76.14,59.79 ,33.33
03,013,01,002,0076,120,965,7,972,1591,0,3,1,3,0,1,0,76.14,61.09 ,33.33
03,013,01,002,0077,121,1011,7,1018,1606,0,3,1,3,0,1,0,76.14,63.39 ,33.33
03,013,01,002,0078,122,617,6,623,932,0,3,1,3,0,1,0,76.14,66.85 ,33.33
03,013,01,002,0079,123,1156,15,1171,1747,0,3,1,3,0,1,0,76.14,67.03 ,33.33
03,013,01,002,0080,124,1209,9,1218,1830,0,3,1,3,0,1,0,76.14,66.56 ,33.33
03,013,01,002,0081,125,594,4,598,980,0,3,1,3,0,1,0,76.14,61.02 ,33.33
03,013,01,002,0081,126,712,4,716,1193,0,3,1,3,0,1,0,76.14,60.02 ,33.33
03,013,01,002,0081,127,1211,6,1217,1954,0,3,1,3,0,1,0,76.14,62.28 ,33.33
03,013,01,002,0082,128,905,8,913,1414,0,3,1,3,0,1,0,76.14,64.57 ,33.33
03,013,01,002,0083,129,819,12,831,1254,0,3,1,3,0,1,0,76.14,66.27 ,33.33
03,013,01,002,0084,130,470,5,475,746,0,3,1,3,0,1,0,76.14,63.67 ,33.33
03,013,01,002,0085,131,385,2,387,612,0,3,1,3,0,1,0,76.14,63.24 ,33.33
03,013,01,002,0086,132,956,15,971,1557,0,3,1,3,0,1,0,76.14,62.36 ,33.33
03,013,01,002,0087,133,925,10,935,1420,0,3,1,3,0,1,0,76.14,65.85 ,33.33
03,013,01,002,0088,134,1227,17,1244,1859,0,3,1,3,0,1,0,76.14,66.92 ,33.33
03,013,01,002,0089,135,961,15,976,1545,0,3,1,3,0,1,0,76.14,63.17 ,33.33
03,013,01,003,0090,136,826,8,834,1146,0,3,1,3,0,1,0,76.14,72.77 ,33.33
03,013,01,003,0090,137,911,5,916,1229,0,3,1,3,0,1,0,76.14,74.53 ,33.33
03,013,01,003,0091,138,393,4,397,559,0,3,1,3,0,1,0,76.14,71.02 ,33.33
03,013,01,003,0092,139,367,3,370,488,0,3,1,3,0,1,0,76.14,75.82 ,33.33
03,013,01,003,0093,140,491,2,493,776,0,3,1,3,0,1,0,76.14,63.53 ,33.33
03,013,01,003,0094,141,460,5,465,651,0,3,1,3,0,1,0,76.14,71.43 ,33.33
03,013,01,003,0095,142,907,9,916,1348,0,3,1,3,0,1,0,76.14,67.95 ,33.33
03,013,01,003,0095,143,981,14,995,1603,0,3,1,3,0,1,0,76.14,62.07 ,33.33
03,013,01,003,0095,144,899,12,911,1312,0,3,1,3,0,1,0,76.14,69.44 ,33.33
03,013,01,003,0096,145,508,8,516,700,0,3,1,3,0,1,0,76.14,73.71 ,33.33
03,013,01,003,0097,146,447,3,450,615,0,3,1,3,0,1,0,76.14,73.17 ,33.33
03,013,01,003,0098,147,815,7,822,1276,0,3,1,3,0,1,0,76.14,64.42 ,33.33
03,013,01,003,0098,148,438,3,441,652,0,3,1,3,0,1,0,76.14,67.64 ,33.33
03,013,01,003,0099,149,587,10,597,925,0,3,1,3,0,1,0,76.14,64.54 ,33.33
03,013,01,003,0100,150,982,8,990,1384,0,3,1,3,0,1,0,76.14,71.53 ,33.33
03,013,01,003,0101,151,507,2,509,735,0,3,1,3,0,1,0,76.14,69.25 ,33.33
03,013,01,003,0102,152,728,10,738,1184,0,3,1,3,0,1,0,76.14,62.33 ,33.33
03,013,01,003,0103,153,1187,15,1202,1824,0,3,1,3,0,1,0,76.14,65.90 ,33.33
03,013,01,003,0104,154,1478,19,1497,2287,0,3,1,3,0,1,0,76.14,65.46 ,33.33
03,013,01,003,0105,155,814,7,821,1266,0,3,1,3,0,1,0,76.14,64.85 ,33.33
03,013,01,003,0106,156,301,3,304,425,0,3,1,3,0,1,0,76.14,71.53 ,33.33
03,013,01,003,0106,157,655,6,661,1027,0,3,1,3,0,1,0,76.14,64.36 ,33.33
03,013,01,003,0107,158,1276,11,1287,1829,0,3,1,3,0,1,0,76.14,70.37 ,33.33
03,013,01,003,0107,159,489,5,494,802,0,3,1,3,0,1,0,76.14,61.60 ,33.33
03,013,01,003,0108,160,1151,6,1157,1718,0,3,1,3,0,1,0,76.14,67.35 ,33.33
03,013,01,003,0109,161,1055,7,1062,1542,0,3,1,3,0,1,0,76.14,68.87 ,33.33
03,013,01,003,0110,162,574,12,586,817,0,3,1,3,0,1,0,76.14,71.73 ,33.33
03,013,01,003,0111,163,529,8,537,771,0,3,1,3,0,1,0,76.14,69.65 ,33.33
03,013,01,003,0112,164,256,2,258,382,0,3,1,3,0,1,0,76.14,67.54 ,33.33
03,013,01,004,0113,165,652,8,660,1033,0,3,1,3,0,1,0,76.14,63.89 ,33.33
03,013,01,004,0114,166,1050,17,1067,1845,0,3,1,3,0,1,0,76.14,57.83 ,33.33
03,013,01,004,0115,167,710,7,717,1127,0,3,1,3,0,1,0,76.14,63.62 ,33.33
03,013,01,004,0116,168,970,20,990,1807,0,3,1,3,0,1,0,76.14,54.79 ,33.33
03,013,01,004,0116,169,772,7,779,1360,0,3,1,3,0,1,0,76.14,57.28 ,33.33
03,013,01,004,0117,170,667,7,674,1257,0,3,1,3,0,1,0,76.14,53.62 ,33.33
03,013,01,004,0117,171,617,6,623,1162,0,3,1,3,0,1,0,76.14,53.61 ,33.33
03,013,01,004,0118,172,433,9,442,786,0,3,1,3,0,1,0,76.14,56.23 ,33.33
03,013,01,004,0119,173,280,10,290,516,0,3,1,3,0,1,0,76.14,56.20 ,33.33
03,013,01,004,0120,174,237,3,240,504,0,3,1,3,0,1,0,76.14,47.62 ,33.33
03,013,01,004,0121,175,502,5,507,916,0,3,1,3,0,1,0,76.14,55.35 ,33.33
03,013,01,004,0122,176,315,8,323,534,0,3,1,3,0,1,0,76.14,60.49 ,33.33
03,013,01,004,0123,177,514,9,523,922,0,3,1,3,0,1,0,76.14,56.72 ,33.33
03,013,01,004,0124,178,854,8,862,1475,0,3,1,3,0,1,0,76.14,58.44 ,33.33
03,013,01,004,0125,179,991,10,1001,1728,0,3,1,3,0,1,0,76.14,57.93 ,33.33
03,013,01,004,0126,180,709,10,719,1474,0,3,1,3,0,1,0,76.14,48.78 ,33.33
03,013,01,004,0127,181,727,10,737,1347,0,3,1,3,0,1,0,76.14,54.71 ,33.33
03,013,01,004,0128,182,706,4,710,1134,0,3,1,3,0,1,0,76.14,62.61 ,33.33
03,013,01,004,0129,183,600,6,606,1044,0,3,1,3,0,1,0,76.14,58.05 ,33.33
03,013,01,005,0130,184,776,14,790,1138,0,3,1,3,0,1,0,76.14,69.42 ,33.33
03,013,01,005,0131,185,857,6,863,1238,0,3,1,3,0,1,0,76.14,69.71 ,33.33
03,013,01,005,0132,186,1085,13,1098,1625,0,3,1,3,0,1,0,76.14,67.57 ,33.33
03,013,01,005,0133,187,611,12,623,786,0,3,1,3,0,1,0,76.14,79.26 ,33.33
03,013,01,005,0134,188,748,8,756,1029,0,3,1,3,0,1,0,76.14,73.47 ,33.33
03,013,01,005,0135,189,774,7,781,1004,0,3,1,3,0,1,0,76.14,77.79 ,33.33
03,013,01,005,0136,190,449,5,454,582,0,3,1,3,0,1,0,76.14,78.01 ,33.33
03,013,01,005,0137,191,1003,9,1012,1506,0,3,1,3,0,1,0,76.14,67.20 ,33.33
03,013,01,005,0138,192,885,7,892,1271,0,3,1,3,0,1,0,76.14,70.18 ,33.33
03,013,01,005,0139,193,888,10,898,1217,0,3,1,3,0,1,0,76.14,73.79 ,33.33
03,013,01,005,0140,194,573,4,577,708,0,3,1,3,0,1,0,76.14,81.50 ,33.33
03,013,01,005,0141,195,805,5,810,956,0,3,1,3,0,1,0,76.14,84.73 ,33.33
03,013,01,005,0142,196,853,5,858,1106,0,3,1,3,0,1,0,76.14,77.58 ,33.33
03,013,01,005,0143,197,960,10,970,1360,0,3,1,3,0,1,0,76.14,71.32 ,33.33
03,013,01,005,0144,198,1269,14,1283,1711,0,3,1,3,0,1,0,76.14,74.99 ,33.33
03,013,01,005,0145,199,1292,13,1305,1694,0,3,1,3,0,1,0,76.14,77.04 ,33.33
03,013,01,005,0146,200,369,3,372,481,0,3,1,3,0,1,0,76.14,77.34 ,33.33
03,013,01,005,0147,201,595,5,600,756,0,3,1,3,0,1,0,76.14,79.37 ,33.33
03,013,01,005,0148,202,807,4,811,1063,0,3,1,3,0,1,0,76.14,76.29 ,33.33
03,013,01,005,0149,203,245,1,246,351,0,3,1,3,0,1,0,76.14,70.09 ,33.33
03,013,01,005,0150,204,907,8,915,1270,0,3,1,3,0,1,0,76.14,72.05 ,33.33
03,013,01,005,0151,205,948,11,959,1368,0,3,1,3,0,1,0,76.14,70.10 ,33.33
03,013,01,005,0152,206,1165,9,1174,1612,0,3,1,3,0,1,0,76.14,72.83 ,33.33
03,013,01,005,0153,207,1096,3,1099,1496,0,3,1,3,0,1,0,76.14,73.46 ,33.33
03,013,01,005,0154,208,1297,16,1313,1807,0,3,1,3,0,1,0,76.14,72.66 ,33.33
03,013,01,005,0155,209,880,8,888,1194,0,3,1,3,0,1,0,76.14,74.37 ,33.33
03,013,01,005,0156,210,567,3,570,697,0,3,1,3,0,1,0,76.14,81.78 ,33.33
03,013,01,005,0157,211,338,1,339,468,0,3,1,3,0,1,0,76.14,72.44 ,33.33
03,013,01,005,0158,212,315,2,317,413,0,3,1,3,0,1,0,76.14,76.76 ,33.33
03,013,01,005,0159,213,1150,12,1162,1612,0,3,1,3,0,1,0,76.14,72.08 ,33.33
03,013,01,005,0159,214,1046,7,1053,1445,0,3,1,3,0,1,0,76.14,72.87 ,33.33
03,013,01,006,0160,215,1216,15,1231,1822,0,3,1,3,0,1,0,76.14,67.56 ,33.33
03,013,01,006,0161,216,650,3,653,971,0,3,1,3,0,1,0,76.14,67.25 ,33.33
03,013,01,006,0161,217,772,10,782,1202,0,3,1,3,0,1,0,76.14,65.06 ,33.33
03,013,01,006,0162,218,995,4,999,1399,0,3,1,3,0,1,0,76.14,71.41 ,33.33
03,013,01,006,0163,219,885,8,893,1300,0,3,1,3,0,1,0,76.14,68.69 ,33.33
03,013,01,006,0164,220,602,6,608,903,0,3,1,3,0,1,0,76.14,67.33 ,33.33
03,013,01,006,0165,221,983,5,988,1345,0,3,1,3,0,1,0,76.14,73.46 ,33.33
03,013,01,006,0166,222,696,3,699,971,0,3,1,3,0,1,0,76.14,71.99 ,33.33
03,013,01,006,0167,223,551,8,559,743,0,3,1,3,0,1,0,76.14,75.24 ,33.33
03,013,01,006,0168,224,930,14,944,1323,0,3,1,3,0,1,0,76.14,71.35 ,33.33
03,013,01,006,0169,225,589,3,592,818,0,3,1,3,0,1,0,76.14,72.37 ,33.33
03,013,01,006,0170,226,698,8,706,1015,0,3,1,3,0,1,0,76.14,69.56 ,33.33
03,013,01,006,0171,227,836,7,843,1204,0,3,1,3,0,1,0,76.14,70.02 ,33.33
03,013,01,006,0172,228,1103,11,1114,1535,0,3,1,3,0,1,0,76.14,72.57 ,33.33
03,013,01,006,0173,229,672,6,678,942,0,3,1,3,0,1,0,76.14,71.97 ,33.33
03,013,01,006,0174,230,800,10,810,1101,0,3,1,3,0,1,0,76.14,73.57 ,33.33
03,013,01,006,0174,231,626,10,636,915,0,3,1,3,0,1,0,76.14,69.51 ,33.33
03,013,01,006,0175,232,361,5,366,498,0,3,1,3,0,1,0,76.14,73.49 ,33.33
03,013,01,007,0176,233,1142,7,1149,1585,0,3,1,3,0,1,0,76.14,72.49 ,33.33
03,013,01,007,0177,234,549,3,552,730,0,3,1,3,0,1,0,76.14,75.62 ,33.33
03,013,01,007,0178,235,1030,9,1039,1417,0,3,1,3,0,1,0,76.14,73.32 ,33.33
03,013,01,007,0179,236,781,11,792,1054,0,3,1,3,0,1,0,76.14,75.14 ,33.33
03,013,01,007,0179,237,672,10,682,971,0,3,1,3,0,1,0,76.14,70.24 ,33.33
03,013,01,007,0180,238,745,4,749,975,0,3,1,3,0,1,0,76.14,76.82 ,33.33
03,013,01,007,0181,239,521,5,526,689,0,3,1,3,0,1,0,76.14,76.34 ,33.33
03,013,01,007,0182,240,515,5,520,684,0,3,1,3,0,1,0,76.14,76.02 ,33.33
03,013,01,008,0183,241,1050,8,1058,1472,0,3,1,3,0,1,0,76.14,71.88 ,33.33
03,013,01,008,0184,242,863,7,870,1174,0,3,1,3,0,1,0,76.14,74.11 ,33.33
03,013,01,008,0185,243,932,16,948,1304,0,3,1,3,0,1,0,76.14,72.70 ,33.33
03,013,01,008,0186,244,857,10,867,1161,0,3,1,3,0,1,0,76.14,74.68 ,33.33
03,013,01,008,0187,245,924,16,940,1320,0,3,1,3,0,1,0,76.14,71.21 ,33.33
03,013,01,008,0188,246,476,4,480,608,0,3,1,3,0,1,0,76.14,78.95 ,33.33
03,013,01,008,0188,247,1044,17,1061,1490,0,3,1,3,0,1,0,76.14,71.21 ,33.33
03,013,01,008,0188,248,532,6,538,806,0,3,1,3,0,1,0,76.14,66.75 ,33.33
03,013,01,008,0189,249,667,4,671,893,0,3,1,3,0,1,0,76.14,75.14 ,33.33
03,013,01,008,0190,250,780,12,792,1121,0,3,1,3,0,1,0,76.14,70.65 ,33.33
03,013,01,008,0191,251,1114,7,1121,1504,0,3,1,3,0,1,0,76.14,74.53 ,33.33
03,013,01,008,0192,252,801,10,811,1060,0,3,1,3,0,1,0,76.14,76.51 ,33.33
03,013,01,008,0193,253,854,6,860,1197,0,3,1,3,0,1,0,76.14,71.85 ,33.33
03,013,01,009,0194,254,1150,14,1164,1677,0,3,1,3,0,1,0,76.14,69.41 ,33.33
03,013,01,009,0195,255,834,3,837,1120,0,3,1,3,0,1,0,76.14,74.73 ,33.33
03,013,01,009,0196,256,580,4,584,806,0,3,1,3,0,1,0,76.14,72.46 ,33.33
03,013,01,009,0197,257,763,3,766,1115,0,3,1,3,0,1,0,76.14,68.70 ,33.33
03,013,01,009,0198,258,994,7,1001,1494,0,3,1,3,0,1,0,76.14,67.00 ,33.33
03,013,01,009,0199,259,746,8,754,1058,0,3,1,3,0,1,0,76.14,71.27 ,33.33
03,013,01,009,0200,260,877,7,884,1259,0,3,1,3,0,1,0,76.14,70.21 ,33.33
03,013,01,009,0201,261,843,12,855,1233,0,3,1,3,0,1,0,76.14,69.34 ,33.33
03,013,01,009,0202,262,296,5,301,410,0,3,1,3,0,1,0,76.14,73.41 ,33.33
03,013,01,009,0202,263,840,5,845,1153,0,3,1,3,0,1,0,76.14,73.29 ,33.33
03,013,01,009,0203,264,712,6,718,961,0,3,1,3,0,1,0,76.14,74.71 ,33.33
03,013,01,009,0203,265,864,7,871,1240,0,3,1,3,0,1,0,76.14,70.24 ,33.33
03,013,01,009,0204,266,1066,17,1083,1494,0,3,1,3,0,1,0,76.14,72.49 ,33.33
03,013,01,009,0204,267,419,7,426,590,0,3,1,3,0,1,0,76.14,72.20 ,33.33
03,013,01,009,0205,268,598,3,601,857,0,3,1,3,0,1,0,76.14,70.13 ,33.33
03,013,01,009,0205,269,568,8,576,861,0,3,1,3,0,1,0,76.14,66.90 ,33.33
03,013,01,009,0206,270,523,5,528,763,0,3,1,3,0,1,0,76.14,69.20 ,33.33
03,013,01,009,0207,271,368,5,373,499,0,3,1,3,0,1,0,76.14,74.75 ,33.33
03,013,01,010,0208,272,1163,10,1173,1536,0,3,1,3,0,1,0,76.14,76.37 ,33.33
03,013,01,010,0209,273,1605,22,1627,2154,0,3,1,3,0,1,0,76.14,75.53 ,33.33
03,013,01,010,0210,274,1086,8,1094,1445,0,3,1,3,0,1,0,76.14,75.71 ,33.33
03,013,01,010,0211,275,747,5,752,865,0,3,1,3,0,1,0,76.14,86.94 ,33.33
03,013,01,010,0212,276,1860,20,1880,2464,0,3,1,3,0,1,0,76.14,76.30 ,33.33
03,013,01,010,0213,277,1311,34,1345,1864,0,3,1,3,0,1,0,76.14,72.16 ,33.33
03,013,01,010,0214,278,632,7,639,810,0,3,1,3,0,1,0,76.14,78.89 ,33.33
03,013,01,010,0215,279,1972,31,2003,2619,0,3,1,3,0,1,0,76.14,76.48 ,33.33
03,013,01,010,0216,280,1996,28,2024,2778,0,3,1,3,0,1,0,76.14,72.86 ,33.33
03,013,01,010,0217,281,706,2,708,897,0,3,1,3,0,1,0,76.14,78.93 ,33.33
03,013,01,010,0218,282,1025,17,1042,1321,0,3,1,3,0,1,0,76.14,78.88 ,33.33
03,013,01,010,0219,283,436,11,447,591,0,3,1,3,0,1,0,76.14,75.63 ,33.33
03,013,01,011,0220,284,760,5,765,1188,0,3,1,3,0,1,0,76.14,64.39 ,33.33
03,013,01,011,0220,285,631,2,633,972,0,3,1,3,0,1,0,76.14,65.12 ,33.33
03,013,01,011,0221,286,862,3,865,1336,0,3,1,3,0,1,0,76.14,64.75 ,33.33
03,013,01,011,0222,287,560,2,562,864,0,3,1,3,0,1,0,76.14,65.05 ,33.33
03,013,01,011,0223,288,414,4,418,686,0,3,1,3,0,1,0,76.14,60.93 ,33.33
03,013,01,011,0224,289,641,4,645,950,0,3,1,3,0,1,0,76.14,67.89 ,33.33
03,013,01,011,0225,290,730,4,734,1224,0,3,1,3,0,1,0,76.14,59.97 ,33.33
03,013,01,011,0226,291,463,8,471,749,0,3,1,3,0,1,0,76.14,62.88 ,33.33
03,013,01,011,0227,292,560,6,566,904,0,3,1,3,0,1,0,76.14,62.61 ,33.33
03,013,01,011,0228,293,494,6,500,747,0,3,1,3,0,1,0,76.14,66.93 ,33.33
03,013,01,011,0229,294,898,6,904,1366,0,3,1,3,0,1,0,76.14,66.18 ,33.33
03,013,01,011,0230,295,905,15,920,1550,0,3,1,3,0,1,0,76.14,59.35 ,33.33
03,013,01,011,0231,296,1203,16,1219,1997,0,3,1,3,0,1,0,76.14,61.04 ,33.33
03,013,01,011,0232,297,815,8,823,1228,0,3,1,3,0,1,0,76.14,67.02 ,33.33
03,013,01,011,0233,298,612,3,615,995,0,3,1,3,0,1,0,76.14,61.81 ,33.33
03,013,01,011,0234,299,709,11,720,1032,0,3,1,3,0,1,0,76.14,69.77 ,33.33
03,013,01,011,0235,300,696,9,705,1027,0,3,1,3,0,1,0,76.14,68.65 ,33.33
03,013,01,011,0236,301,827,7,834,1144,0,3,1,3,0,1,0,76.14,72.90 ,33.33
03,013,01,011,0237,302,469,8,477,722,0,3,1,3,0,1,0,76.14,66.07 ,33.33
03,013,01,011,0237,303,430,6,436,675,0,3,1,3,0,1,0,76.14,64.59 ,33.33
03,013,01,011,0238,304,947,6,953,1402,0,3,1,3,0,1,0,76.14,67.97 ,33.33
03,013,01,012,0239,305,864,3,867,1226,0,3,1,3,0,1,0,76.14,70.72 ,33.33
03,013,01,012,0240,306,572,4,576,817,0,3,1,3,0,1,0,76.14,70.50 ,33.33
03,013,01,012,0241,307,878,10,888,1365,0,3,1,3,0,1,0,76.14,65.05 ,33.33
03,013,01,012,0242,308,682,8,690,929,0,3,1,3,0,1,0,76.14,74.27 ,33.33
03,013,01,012,0243,309,395,1,396,532,0,3,1,3,0,1,0,76.14,74.44 ,33.33
03,013,01,012,0244,310,903,10,913,1305,0,3,1,3,0,1,0,76.14,69.96 ,33.33
03,013,01,012,0245,311,903,6,909,1162,0,3,1,3,0,1,0,76.14,78.23 ,33.33
03,013,01,012,0246,312,901,12,913,1371,0,3,1,3,0,1,0,76.14,66.59 ,33.33
03,013,01,012,0247,313,934,20,954,1645,0,3,1,3,0,1,0,76.14,57.99 ,33.33
03,013,01,012,0248,314,1210,20,1230,1873,0,3,1,3,0,1,0,76.14,65.67 ,33.33
03,013,01,012,0249,315,988,12,1000,1510,0,3,1,3,0,1,0,76.14,66.23 ,33.33
03,013,01,012,0250,316,1036,6,1042,1461,0,3,1,3,0,1,0,76.14,71.32 ,33.33
03,013,01,012,0251,317,668,8,676,1052,0,3,1,3,0,1,0,76.14,64.26 ,33.33
03,013,01,012,0252,318,344,3,347,611,0,3,1,3,0,1,0,76.14,56.79 ,33.33
03,013,01,012,0252,319,329,1,330,608,0,3,1,3,0,1,0,76.14,54.28 ,33.33
03,013,01,013,0253,320,852,6,858,1304,0,3,1,3,0,1,0,76.14,65.80 ,33.33
03,013,01,013,0253,321,1045,11,1056,1627,0,3,1,3,0,1,0,76.14,64.90 ,33.33
03,013,01,013,0254,322,774,4,778,1287,0,3,1,3,0,1,0,76.14,60.45 ,33.33
03,013,01,013,0254,323,825,11,836,1342,0,3,1,3,0,1,0,76.14,62.30 ,33.33
03,013,01,013,0255,324,981,5,986,1343,0,3,1,3,0,1,0,76.14,73.42 ,33.33
03,013,01,013,0256,325,380,5,385,568,0,3,1,3,0,1,0,76.14,67.78 ,33.33
03,013,01,013,0257,326,641,5,646,949,0,3,1,3,0,1,0,76.14,68.07 ,33.33
03,013,01,013,0257,327,645,7,652,924,0,3,1,3,0,1,0,76.14,70.56 ,33.33
03,013,01,013,0258,328,1101,10,1111,1613,0,3,1,3,0,1,0,76.14,68.88 ,33.33
03,013,01,013,0259,329,663,3,666,966,0,3,1,3,0,1,0,76.14,68.94 ,33.33
03,013,01,013,0259,330,777,5,782,1220,0,3,1,3,0,1,0,76.14,64.10 ,33.33
03,013,01,013,0259,331,931,6,937,1445,0,3,1,3,0,1,0,76.14,64.84 ,33.33
03,013,01,013,0260,332,868,11,879,1445,0,3,1,3,0,1,0,76.14,60.83 ,33.33
03,013,01,013,0260,333,470,7,477,763,0,3,1,3,0,1,0,76.14,62.52 ,33.33
03,013,01,013,0261,334,1142,12,1154,1673,0,3,1,3,0,1,0,76.14,68.98 ,33.33
03,013,01,013,0262,335,582,2,584,886,0,3,1,3,0,1,0,76.14,65.91 ,33.33
03,013,01,013,0262,336,699,6,705,1027,0,3,1,3,0,1,0,76.14,68.65 ,33.33
03,013,01,013,0263,337,800,11,811,1344,0,3,1,3,0,1,0,76.14,60.34 ,33.33
03,013,01,013,0264,338,857,8,865,1220,0,3,1,3,0,1,0,76.14,70.90 ,33.33
03,013,01,013,0264,339,1148,14,1162,1690,0,3,1,3,0,1,0,76.14,68.76 ,33.33
03,013,01,013,0265,340,631,4,635,883,0,3,1,3,0,1,0,76.14,71.91 ,33.33
03,013,01,013,0266,341,672,8,680,970,0,3,1,3,0,1,0,76.14,70.10 ,33.33
03,013,01,013,0267,342,607,3,610,1098,0,3,1,3,0,1,0,76.14,55.56 ,33.33
03,013,01,013,0267,343,666,8,674,1177,0,3,1,3,0,1,0,76.14,57.26 ,33.33
03,013,01,013,0268,344,839,11,850,1331,0,3,1,3,0,1,0,76.14,63.86 ,33.33
03,013,01,013,0269,345,889,14,903,1317,0,3,1,3,0,1,0,76.14,68.56 ,33.33
03,013,01,013,0269,346,743,10,753,1175,0,3,1,3,0,1,0,76.14,64.09 ,33.33
03,013,01,013,0270,347,171,4,175,242,0,3,1,3,0,1,0,76.14,72.31 ,33.33
03,013,01,013,0270,348,896,11,907,1371,0,3,1,3,0,1,0,76.14,66.16 ,33.33
03,013,01,013,0270,349,629,7,636,952,0,3,1,3,0,1,0,76.14,66.81 ,33.33
03,013,01,013,0271,350,443,7,450,664,0,3,1,3,0,1,0,76.14,67.77 ,33.33
03,013,01,013,0271,351,387,5,392,540,0,3,1,3,0,1,0,76.14,72.59 ,33.33
03,013,01,013,0271,352,817,15,832,1124,0,3,1,3,0,1,0,76.14,74.02 ,33.33
03,013,01,013,0272,353,1137,16,1153,1689,0,3,1,3,0,1,0,76.14,68.27 ,33.33
03,013,01,013,0273,354,738,7,745,1091,0,3,1,3,0,1,0,76.14,68.29 ,33.33
03,013,01,013,0273,355,714,12,726,1015,0,3,1,3,0,1,0,76.14,71.53 ,33.33
03,013,01,013,0274,356,713,9,722,1191,0,3,1,3,0,1,0,76.14,60.62 ,33.33
03,013,01,013,0275,357,484,4,488,784,0,3,1,3,0,1,0,76.14,62.24 ,33.33
03,013,01,014,0276,358,942,10,952,1402,0,3,1,3,0,1,0,76.14,67.90 ,33.33
03,013,01,014,0277,359,578,8,586,856,0,3,1,3,0,1,0,76.14,68.46 ,33.33
03,013,01,014,0278,360,488,1,489,656,0,3,1,3,0,1,0,76.14,74.54 ,33.33
03,013,01,014,0279,361,431,6,437,580,0,3,1,3,0,1,0,76.14,75.34 ,33.33
03,013,01,014,0280,362,901,10,911,1294,0,3,1,3,0,1,0,76.14,70.40 ,33.33
03,013,01,014,0281,363,652,1,653,965,0,3,1,3,0,1,0,76.14,67.67 ,33.33
03,013,01,014,0282,364,422,4,426,626,0,3,1,3,0,1,0,76.14,68.05 ,33.33
03,013,01,014,0283,365,339,2,341,461,0,3,1,3,0,1,0,76.14,73.97 ,33.33
03,013,01,014,0284,366,950,12,962,1342,0,3,1,3,0,1,0,76.14,71.68 ,33.33
03,013,01,014,0284,367,880,4,884,1238,0,3,1,3,0,1,0,76.14,71.41 ,33.33
03,013,01,014,0285,368,324,1,325,426,0,3,1,3,0,1,0,76.14,76.29 ,33.33
03,013,01,014,0286,369,377,3,380,526,0,3,1,3,0,1,0,76.14,72.24 ,33.33
03,013,01,014,0287,370,455,8,463,641,0,3,1,3,0,1,0,76.14,72.23 ,33.33
03,013,01,014,0288,371,734,11,745,1145,0,3,1,3,0,1,0,76.14,65.07 ,33.33
03,013,01,014,0289,372,723,6,729,1066,0,3,1,3,0,1,0,76.14,68.39 ,33.33
03,013,01,014,0290,373,691,9,700,933,0,3,1,3,0,1,0,76.14,75.03 ,33.33
03,013,01,015,0291,374,1252,9,1261,1916,0,3,1,3,0,1,0,76.14,65.81 ,33.33
03,013,01,015,0292,375,829,3,832,1253,0,3,1,3,0,1,0,76.14,66.40 ,33.33
03,013,01,015,0293,376,710,5,715,1086,0,3,1,3,0,1,0,76.14,65.84 ,33.33
03,013,01,015,0294,377,516,5,521,793,0,3,1,3,0,1,0,76.14,65.70 ,33.33
03,013,01,015,0295,378,599,11,610,1031,0,3,1,3,0,1,0,76.14,59.17 ,33.33
03,013,01,015,0295,379,465,4,469,645,0,3,1,3,0,1,0,76.14,72.71 ,33.33
03,013,01,015,0296,380,773,8,781,1306,0,3,1,3,0,1,0,76.14,59.80 ,33.33
03,013,01,015,0297,381,331,4,335,528,0,3,1,3,0,1,0,76.14,63.45 ,33.33
03,013,01,015,0297,382,337,9,346,525,0,3,1,3,0,1,0,76.14,65.90 ,33.33
03,013,01,016,0298,383,916,6,922,1415,0,3,1,3,0,1,0,76.14,65.16 ,33.33
03,013,01,016,0299,384,550,5,555,816,0,3,1,3,0,1,0,76.14,68.01 ,33.33
03,013,01,016,0300,385,685,6,691,1011,0,3,1,3,0,1,0,76.14,68.35 ,33.33
03,013,01,016,0301,386,473,3,476,752,0,3,1,3,0,1,0,76.14,63.30 ,33.33
03,013,01,016,0302,387,1166,16,1182,1832,0,3,1,3,0,1,0,76.14,64.52 ,33.33
03,013,01,016,0303,388,1180,8,1188,1898,0,3,1,3,0,1,0,76.14,62.59 ,33.33
03,013,01,016,0303,389,809,6,815,1396,0,3,1,3,0,1,0,76.14,58.38 ,33.33
03,013,01,016,0304,390,1301,8,1309,1908,0,3,1,3,0,1,0,76.14,68.61 ,33.33
03,013,01,016,0305,391,1101,9,1110,1712,0,3,1,3,0,1,0,76.14,64.84 ,33.33
03,013,01,016,0306,392,701,7,708,1093,0,3,1,3,0,1,0,76.14,64.78 ,33.33
03,013,01,016,0306,393,702,3,705,1117,0,3,1,3,0,1,0,76.14,63.12 ,33.33
03,013,01,016,0307,394,428,1,429,804,0,3,1,3,0,1,0,76.14,53.36 ,33.33
03,013,01,016,0308,395,543,3,546,1044,0,3,1,3,0,1,0,76.14,52.30 ,33.33
03,013,01,016,0309,396,723,11,734,1106,0,3,1,3,0,1,0,76.14,66.37 ,33.33
03,013,01,016,0309,397,958,9,967,1484,0,3,1,3,0,1,0,76.14,65.16 ,33.33
03,013,01,016,0310,398,389,0,389,555,0,3,1,3,0,1,0,76.14,70.09 ,33.33
03,013,01,016,0311,399,533,8,541,925,0,3,1,3,0,1,0,76.14,58.49 ,33.33
03,013,01,016,0312,400,255,4,259,436,0,3,1,3,0,1,0,76.14,59.40 ,33.33
03,013,01,017,0313,401,1071,5,1076,1505,0,3,1,3,0,1,0,76.14,71.50 ,33.33
03,013,01,017,0314,402,662,7,669,968,0,3,1,3,0,1,0,76.14,69.11 ,33.33
03,013,01,017,0314,403,809,5,814,1173,0,3,1,3,0,1,0,76.14,69.39 ,33.33
03,013,01,017,0315,404,1293,12,1305,1858,0,3,1,3,0,1,0,76.14,70.24 ,33.33
03,013,01,017,0316,405,467,6,473,648,0,3,1,3,0,1,0,76.14,72.99 ,33.33
03,013,01,017,0317,406,588,3,591,752,0,3,1,3,0,1,0,76.14,78.59 ,33.33
03,013,01,017,0318,407,831,13,844,1191,0,3,1,3,0,1,0,76.14,70.86 ,33.33
03,013,01,017,0318,408,708,3,711,951,0,3,1,3,0,1,0,76.14,74.76 ,33.33
03,013,01,017,0319,409,1380,11,1391,1909,0,3,1,3,0,1,0,76.14,72.87 ,33.33
03,013,01,017,0320,410,832,9,841,1056,0,3,1,3,0,1,0,76.14,79.64 ,33.33
03,013,01,017,0320,411,793,6,799,1048,0,3,1,3,0,1,0,76.14,76.24 ,33.33
03,013,01,017,0321,412,1145,9,1154,1669,0,3,1,3,0,1,0,76.14,69.14 ,33.33
03,013,01,017,0321,413,681,8,689,1054,0,3,1,3,0,1,0,76.14,65.37 ,33.33
03,013,01,017,0322,414,882,9,891,1211,0,3,1,3,0,1,0,76.14,73.58 ,33.33
03,013,01,017,0323,415,1348,10,1358,1967,0,3,1,3,0,1,0,76.14,69.04 ,33.33
03,013,01,017,0324,416,1054,8,1062,1602,0,3,1,3,0,1,0,76.14,66.29 ,33.33
03,013,01,017,0325,417,916,9,925,1308,0,3,1,3,0,1,0,76.14,70.72 ,33.33
03,013,01,017,0326,418,1176,9,1185,1906,0,3,1,3,0,1,0,76.14,62.17 ,33.33
03,013,01,017,0326,419,956,8,964,1620,0,3,1,3,0,1,0,76.14,59.51 ,33.33
03,013,01,017,0327,420,646,4,650,1029,0,3,1,3,0,1,0,76.14,63.17 ,33.33
03,013,01,017,0327,421,648,8,656,1091,0,3,1,3,0,1,0,76.14,60.13 ,33.33
03,013,01,018,0328,422,1213,12,1225,1722,0,3,1,3,0,1,0,76.14,71.14 ,33.33
03,013,01,018,0329,423,909,9,918,1385,0,3,1,3,0,1,0,76.14,66.28 ,33.33
03,013,01,018,0330,424,675,7,682,969,0,3,1,3,0,1,0,76.14,70.38 ,33.33
03,013,01,018,0331,425,783,5,788,1011,0,3,1,3,0,1,0,76.14,77.94 ,33.33
03,013,01,018,0332,426,591,7,598,798,0,3,1,3,0,1,0,76.14,74.94 ,33.33
03,013,01,018,0333,427,983,12,995,1407,0,3,1,3,0,1,0,76.14,70.72 ,33.33
03,013,01,018,0334,428,467,9,476,655,0,3,1,3,0,1,0,76.14,72.67 ,33.33
03,013,01,018,0335,429,1104,11,1115,1624,0,3,1,3,0,1,0,76.14,68.66 ,33.33
03,013,01,019,0336,430,996,10,1006,1380,0,3,1,3,0,1,0,76.14,72.90 ,33.33
03,013,01,019,0337,431,1120,7,1127,1617,0,3,1,3,0,1,0,76.14,69.70 ,33.33
03,013,01,019,0338,432,665,6,671,897,0,3,1,3,0,1,0,76.14,74.80 ,33.33
03,013,01,019,0339,433,1063,7,1070,1473,0,3,1,3,0,1,0,76.14,72.64 ,33.33
03,013,01,019,0340,434,1031,12,1043,1412,0,3,1,3,0,1,0,76.14,73.87 ,33.33
03,013,01,019,0340,435,1097,9,1106,1549,0,3,1,3,0,1,0,76.14,71.40 ,33.33
03,013,01,019,0341,436,628,4,632,889,0,3,1,3,0,1,0,76.14,71.09 ,33.33
03,013,01,019,0342,437,825,5,830,1266,0,3,1,3,0,1,0,76.14,65.56 ,33.33
03,013,01,019,0343,438,1131,14,1145,1737,0,3,1,3,0,1,0,76.14,65.92 ,33.33
03,013,01,019,0344,439,1088,9,1097,1542,0,3,1,3,0,1,0,76.14,71.14 ,33.33
03,013,01,019,0344,440,915,8,923,1300,0,3,1,3,0,1,0,76.14,71.00 ,33.33
03,013,01,019,0345,441,807,5,812,1155,0,3,1,3,0,1,0,76.14,70.30 ,33.33
03,013,01,020,0346,442,1228,14,1242,1724,0,3,1,3,0,1,0,76.14,72.04 ,33.33
03,013,01,020,0347,443,703,7,710,992,0,3,1,3,0,1,0,76.14,71.57 ,33.33
03,013,01,020,0348,444,423,3,426,607,0,3,1,3,0,1,0,76.14,70.18 ,33.33
03,013,01,020,0349,445,554,5,559,756,0,3,1,3,0,1,0,76.14,73.94 ,33.33
03,013,01,020,0350,446,679,4,683,1042,0,3,1,3,0,1,0,76.14,65.55 ,33.33
03,013,01,020,0351,447,707,8,715,998,0,3,1,3,0,1,0,76.14,71.64 ,33.33
03,013,01,020,0352,448,746,7,753,1068,0,3,1,3,0,1,0,76.14,70.51 ,33.33
03,013,01,020,0353,449,758,7,765,1085,0,3,1,3,0,1,0,76.14,70.51 ,33.33
03,013,01,020,0354,450,589,5,594,873,0,3,1,3,0,1,0,76.14,68.04 ,33.33
03,013,01,020,0355,451,408,5,413,608,0,3,1,3,0,1,0,76.14,67.93 ,33.33
03,013,01,021,0356,452,1049,10,1059,1508,0,3,1,3,0,1,0,76.14,70.23 ,33.33
03,013,01,021,0357,453,1270,14,1284,1789,0,3,1,3,0,1,0,76.14,71.77 ,33.33
03,013,01,021,0358,454,678,9,687,1001,0,3,1,3,0,1,0,76.14,68.63 ,33.33
03,013,01,021,0359,455,1060,9,1069,1687,0,3,1,3,0,1,0,76.14,63.37 ,33.33
03,013,01,021,0360,456,1210,13,1223,1827,0,3,1,3,0,1,0,76.14,66.94 ,33.33
03,013,01,021,0361,457,1408,15,1423,2211,0,3,1,3,0,1,0,76.14,64.36 ,33.33
03,013,01,021,0362,458,799,4,803,1173,0,3,1,3,0,1,0,76.14,68.46 ,33.33
03,013,01,021,0363,459,582,8,590,895,0,3,1,3,0,1,0,76.14,65.92 ,33.33
03,013,01,021,0364,460,880,3,883,1204,0,3,1,3,0,1,0,76.14,73.34 ,33.33
03,013,01,021,0365,461,692,4,696,943,0,3,1,3,0,1,0,76.14,73.81 ,33.33
03,013,01,021,0366,462,749,13,762,1089,0,3,1,3,0,1,0,76.14,69.97 ,33.33
03,013,01,021,0367,463,1408,17,1425,2090,0,3,1,3,0,1,0,76.14,68.18 ,33.33
03,013,01,022,0368,464,885,10,895,1629,0,3,1,3,0,1,0,76.14,54.94 ,33.33
03,013,01,022,0369,465,543,11,554,949,0,3,1,3,0,1,0,76.14,58.38 ,33.33
03,013,01,022,0370,466,425,6,431,762,0,3,1,3,0,1,0,76.14,56.56 ,33.33
03,013,01,022,0371,467,662,3,665,1332,0,3,1,3,0,1,0,76.14,49.92 ,33.33
03,013,01,022,0372,468,472,6,478,1023,0,3,1,3,0,1,0,76.14,46.73 ,33.33
03,013,01,022,0373,469,453,6,459,942,0,3,1,3,0,1,0,76.14,48.73 ,33.33
03,013,01,022,0374,470,610,7,617,1197,0,3,1,3,0,1,0,76.14,51.55 ,33.33
03,013,01,022,0375,471,330,4,334,675,0,3,1,3,0,1,0,76.14,49.48 ,33.33
03,013,01,023,0376,472,861,11,872,1369,0,3,1,3,0,1,0,76.14,63.70 ,33.33
03,013,01,023,0377,473,363,0,363,576,0,3,1,3,0,1,0,76.14,63.02 ,33.33
03,013,01,023,0378,474,426,2,428,798,0,3,1,3,0,1,0,76.14,53.63 ,33.33
03,013,01,023,0379,475,472,4,476,849,0,3,1,3,0,1,0,76.14,56.07 ,33.33
03,013,01,023,0380,476,253,3,256,450,0,3,1,3,0,1,0,76.14,56.89 ,33.33
03,013,01,023,0381,477,589,13,602,1078,0,3,1,3,0,1,0,76.14,55.84 ,33.33
03,013,01,023,0382,478,775,7,782,1484,0,3,1,3,0,1,0,76.14,52.70 ,33.33
03,013,01,023,0383,479,276,4,280,438,0,3,1,3,0,1,0,76.14,63.93 ,33.33
03,013,01,023,0384,480,257,4,261,448,0,3,1,3,0,1,0,76.14,58.26 ,33.33
03,013,01,023,0385,481,307,3,310,534,0,3,1,3,0,1,0,76.14,58.05 ,33.33
03,013,01,023,0386,482,292,7,299,538,0,3,1,3,0,1,0,76.14,55.58 ,33.33
03,013,01,024,0387,483,793,9,802,1391,0,3,1,3,0,1,0,76.14,57.66 ,33.33
03,013,01,024,0388,484,126,2,128,260,0,3,1,3,0,1,0,76.14,49.23 ,33.33
03,013,01,024,0389,485,608,4,612,1123,0,3,1,3,0,1,0,76.14,54.50 ,33.33
03,013,01,024,0390,486,597,6,603,1043,0,3,1,3,0,1,0,76.14,57.81 ,33.33
03,013,01,024,0391,487,240,1,241,452,0,3,1,3,0,1,0,76.14,53.32 ,33.33
03,013,01,024,0392,488,340,9,349,683,0,3,1,3,0,1,0,76.14,51.10 ,33.33
03,013,01,024,0393,489,127,1,128,239,0,3,1,3,0,1,0,76.14,53.56 ,33.33
03,013,01,024,0394,490,176,3,179,296,0,3,1,3,0,1,0,76.14,60.47 ,33.33
03,013,01,025,0395,491,643,6,649,1042,0,3,1,3,0,1,0,76.14,62.28 ,33.33
03,013,01,025,0396,492,555,5,560,838,0,3,1,3,0,1,0,76.14,66.83 ,33.33
03,013,01,025,0396,493,606,7,613,931,0,3,1,3,0,1,0,76.14,65.84 ,33.33
03,013,01,025,0397,494,593,7,600,1164,0,3,1,3,0,1,0,76.14,51.55 ,33.33
03,013,01,025,0398,495,493,7,500,1030,0,3,1,3,0,1,0,76.14,48.54 ,33.33
03,013,01,026,0399,496,70,1,71,112,0,3,1,3,0,1,0,76.14,63.39 ,33.33
03,013,01,026,0400,497,19,1,20,37,0,3,1,3,0,1,0,76.14,54.05 ,33.33
03,013,01,026,0401,498,28,0,28,48,0,3,1,3,0,1,0,76.14,58.33 ,33.33
03,013,01,026,0402,499,2,0,2,5,0,3,1,3,0,1,0,76.14,40.00 ,33.33
03,013,01,026,0403,500,21,0,21,38,0,3,1,3,0,1,0,76.14,55.26 ,33.33
03,013,01,026,0404,501,28,1,29,46,0,3,1,3,0,1,0,76.14,63.04 ,33.33
03,013,01,026,0405,502,21,0,21,39,0,3,1,3,0,1,0,76.14,53.85 ,33.33
03,013,01,026,0406,503,8,0,8,14,0,3,1,3,0,1,0,76.14,57.14 ,33.33
03,013,01,026,0407,504,6,0,6,11,0,3,1,3,0,1,0,76.14,54.55 ,33.33
03,013,01,026,0408,505,5,0,5,22,0,3,1,3,0,1,0,76.14,22.73 ,33.33
03,013,01,027,0409,506,7,0,7,16,0,3,1,3,0,1,0,76.14,43.75 ,33.33
03,013,01,027,0409,507,5,0,5,7,0,3,1,3,0,1,0,76.14,71.43 ,33.33
03,013,01,027,0409,508,2,0,2,2,0,3,1,3,0,1,0,76.14,100.00 ,33.33
03,013,01,027,0410,509,4,0,4,5,0,3,1,3,0,1,0,76.14,80.00 ,33.33
03,013,01,027,0411,510,2,0,2,4,0,3,1,3,0,1,0,76.14,50.00 ,33.33
03,013,01,027,0412,511,2,0,2,5,0,3,1,3,0,1,0,76.14,40.00 ,33.33
03,013,01,027,0413,512,4,0,4,8,0,3,1,3,0,1,0,76.14,50.00 ,33.33
03,013,01,027,0414,513,2,0,2,4,0,3,1,3,0,1,0,76.14,50.00 ,33.33
03,013,01,028,0415,514,5,1,6,12,0,3,1,3,0,1,0,76.14,50.00 ,33.33
03,013,01,028,0416,515,57,0,57,87,0,3,1,3,0,1,0,76.14,65.52 ,33.33
03,013,01,028,0417,516,33,1,34,46,0,3,1,3,0,1,0,76.14,73.91 ,33.33
03,013,01,028,0418,517,31,1,32,51,0,3,1,3,0,1,0,76.14,62.75 ,33.33
03,013,01,028,0419,518,8,0,8,17,0,3,1,3,0,1,0,76.14,47.06 ,33.33
03,013,01,028,0420,519,27,0,27,44,0,3,1,3,0,1,0,76.14,61.36 ,33.33
03,013,01,028,0420,520,31,0,31,48,0,3,1,3,0,1,0,76.14,64.58 ,33.33
03,013,01,028,0420,521,29,1,30,57,0,3,1,3,0,1,0,76.14,52.63 ,33.33
03,013,01,029,0421,522,19,0,19,34,0,3,1,3,0,1,0,76.14,55.88 ,33.33
03,013,01,029,0421,523,6,0,6,13,0,3,1,3,0,1,0,76.14,46.15 ,33.33
03,013,01,029,0422,524,16,0,16,36,0,3,1,3,0,1,0,76.14,44.44 ,33.33
03,013,01,029,0423,525,17,0,17,33,0,3,1,3,0,1,0,76.14,51.52 ,33.33
03,013,01,029,0424,526,6,0,6,14,0,3,1,3,0,1,0,76.14,42.86 ,33.33
03,013,01,029,0425,527,1,0,1,6,0,3,1,3,0,1,0,76.14,16.67 ,33.33
03,013,01,029,0426,528,18,0,18,33,0,3,1,3,0,1,0,76.14,54.55 ,33.33
03,013,01,030,0427,529,17,3,20,39,0,3,1,3,0,1,0,76.14,51.28 ,33.33
03,013,01,030,0428,530,15,0,15,27,0,3,1,3,0,1,0,76.14,55.56 ,33.33
03,013,01,030,0428,531,8,0,8,12,0,3,1,3,0,1,0,76.14,66.67 ,33.33
03,013,01,030,0429,532,16,0,16,25,0,3,1,3,0,1,0,76.14,64.00 ,33.33
03,013,01,030,0429,533,32,1,33,49,0,3,1,3,0,1,0,76.14,67.35 ,33.33
03,013,01,030,0430,534,53,0,53,106,0,3,1,3,0,1,0,76.14,50.00 ,33.33
03,013,01,030,0431,535,30,1,31,46,0,3,1,3,0,1,0,76.14,67.39 ,33.33
03,013,01,030,0432,536,44,1,45,57,0,3,1,3,0,1,0,76.14,78.95 ,33.33
03,013,01,030,0433,537,35,1,36,70,0,3,1,3,0,1,0,76.14,51.43 ,33.33
03,013,01,031,0434,538,36,0,36,68,0,3,1,3,0,1,0,76.14,52.94 ,33.33
03,013,01,031,0435,539,32,1,33,59,0,3,1,3,0,1,0,76.14,55.93 ,33.33
03,013,01,031,0436,540,6,0,6,9,0,3,1,3,0,1,0,76.14,66.67 ,33.33
03,013,01,031,0437,541,95,0,95,153,0,3,1,3,0,1,0,76.14,62.09 ,33.33
03,013,01,031,0438,542,76,2,78,124,0,3,1,3,0,1,0,76.14,62.90 ,33.33
03,013,01,031,0439,543,14,0,14,20,0,3,1,3,0,1,0,76.14,70.00 ,33.33
03,013,01,032,0440,544,9,0,9,14,0,3,1,3,0,1,0,76.14,64.29 ,33.33
03,013,01,032,0441,545,22,0,22,38,0,3,1,3,0,1,0,76.14,57.89 ,33.33
03,013,01,032,0442,546,9,0,9,14,0,3,1,3,0,1,0,76.14,64.29 ,33.33
03,013,01,032,0443,547,18,0,18,29,0,3,1,3,0,1,0,76.14,62.07 ,33.33
03,013,01,032,0444,548,30,0,30,45,0,3,1,3,0,1,0,76.14,66.67 ,33.33
03,013,01,032,0445,549,32,0,32,72,0,3,1,3,0,1,0,76.14,44.44 ,33.33
03,013,01,032,0446,550,34,0,34,58,0,3,1,3,0,1,0,76.14,58.62 ,33.33
03,013,01,032,0447,551,11,0,11,22,0,3,1,3,0,1,0,76.14,50.00 ,33.33
03,013,01,033,0448,552,112,2,114,176,0,3,1,3,0,1,0,76.14,64.77 ,33.33
03,013,01,033,0449,553,36,0,36,64,0,3,1,3,0,1,0,76.14,56.25 ,33.33
03,013,01,033,0450,554,8,0,8,19,0,3,1,3,0,1,0,76.14,42.11 ,33.33
03,013,01,033,0451,555,48,1,49,91,0,3,1,3,0,1,0,76.14,53.85 ,33.33
03,013,01,033,0452,556,15,0,15,24,0,3,1,3,0,1,0,76.14,62.50 ,33.33
03,013,01,033,0453,557,16,1,17,27,0,3,1,3,0,1,0,76.14,62.96 ,33.33
03,014,01,001,0001,1,854,15,869,1397,0,3,1,3,0,1,0,76.14,62.20 ,33.33
03,014,01,001,0002,2,616,5,621,933,0,3,1,3,0,1,0,76.14,66.56 ,33.33
03,014,01,001,0002,3,628,10,638,967,0,3,1,3,0,1,0,76.14,65.98 ,33.33
03,014,01,001,0003,4,946,10,956,1480,0,3,1,3,0,1,0,76.14,64.59 ,33.33
03,014,01,001,0003,5,1012,5,1017,1623,0,3,1,3,0,1,0,76.14,62.66 ,33.33
03,014,01,001,0004,6,784,18,802,1359,0,3,1,3,0,1,0,76.14,59.01 ,33.33
03,014,01,001,0004,7,719,4,723,1179,0,3,1,3,0,1,0,76.14,61.32 ,33.33
03,014,01,001,0005,8,432,7,439,717,0,3,1,3,0,1,0,76.14,61.23 ,33.33
03,014,01,001,0006,9,681,5,686,1117,0,3,1,3,0,1,0,76.14,61.41 ,33.33
03,014,01,001,0007,10,248,1,249,444,0,3,1,3,0,1,0,76.14,56.08 ,33.33
03,014,01,001,0008,11,597,7,604,945,0,3,1,3,0,1,0,76.14,63.92 ,33.33
03,014,01,001,0008,12,460,1,461,805,0,3,1,3,0,1,0,76.14,57.27 ,33.33
03,014,01,001,0009,13,484,9,493,797,0,3,1,3,0,1,0,76.14,61.86 ,33.33
03,014,01,001,0010,14,422,2,424,677,0,3,1,3,0,1,0,76.14,62.63 ,33.33
03,014,01,001,0011,15,458,11,469,770,0,3,1,3,0,1,0,76.14,60.91 ,33.33
03,014,01,001,0012,16,563,9,572,991,0,3,1,3,0,1,0,76.14,57.72 ,33.33
03,014,01,001,0013,17,885,17,902,1514,0,3,1,3,0,1,0,76.14,59.58 ,33.33
03,014,01,001,0014,18,544,3,547,889,0,3,1,3,0,1,0,76.14,61.53 ,33.33
03,014,01,001,0015,19,702,7,709,1116,0,3,1,3,0,1,0,76.14,63.53 ,33.33
03,014,01,001,0016,20,523,3,526,823,0,3,1,3,0,1,0,76.14,63.91 ,33.33
03,014,01,001,0017,21,283,1,284,489,0,3,1,3,0,1,0,76.14,58.08 ,33.33
03,014,01,001,0018,22,479,2,481,815,0,3,1,3,0,1,0,76.14,59.02 ,33.33
03,014,01,001,0018,23,758,18,776,1247,0,3,1,3,0,1,0,76.14,62.23 ,33.33
03,014,01,001,0019,24,453,13,466,790,0,3,1,3,0,1,0,76.14,58.99 ,33.33
03,014,01,001,0020,25,311,4,315,585,0,3,1,3,0,1,0,76.14,53.85 ,33.33
03,014,01,001,0021,26,737,13,750,1247,0,3,1,3,0,1,0,76.14,60.14 ,33.33
03,014,01,001,0022,27,585,5,590,979,0,3,1,3,0,1,0,76.14,60.27 ,33.33
03,014,01,001,0022,28,830,7,837,1365,0,3,1,3,0,1,0,76.14,61.32 ,33.33
03,014,01,001,0022,29,728,15,743,1284,0,3,1,3,0,1,0,76.14,57.87 ,33.33
03,014,01,001,0023,30,529,9,538,848,0,3,1,3,0,1,0,76.14,63.44 ,33.33
03,014,01,001,0023,31,625,12,637,1052,0,3,1,3,0,1,0,76.14,60.55 ,33.33
03,014,01,001,0024,32,681,2,683,1114,0,3,1,3,0,1,0,76.14,61.31 ,33.33
03,014,01,001,0024,33,723,6,729,1099,0,3,1,3,0,1,0,76.14,66.33 ,33.33
03,014,01,001,0024,34,680,10,690,1100,0,3,1,3,0,1,0,76.14,62.73 ,33.33
03,014,01,001,0025,35,446,6,452,788,0,3,1,3,0,1,0,76.14,57.36 ,33.33
03,014,01,001,0026,36,284,6,290,471,0,3,1,3,0,1,0,76.14,61.57 ,33.33
03,014,01,001,0026,37,616,12,628,1120,0,3,1,3,0,1,0,76.14,56.07 ,33.33
03,014,01,001,0027,38,453,12,465,782,0,3,1,3,0,1,0,76.14,59.46 ,33.33
03,014,01,001,0028,39,506,13,519,786,0,3,1,3,0,1,0,76.14,66.03 ,33.33
03,014,01,001,0029,40,551,9,560,941,0,3,1,3,0,1,0,76.14,59.51 ,33.33
03,014,01,001,0030,41,840,10,850,1477,0,3,1,3,0,1,0,76.14,57.55 ,33.33
03,014,01,001,0030,42,834,10,844,1533,0,3,1,3,0,1,0,76.14,55.06 ,33.33
03,014,01,001,0030,43,869,15,884,1533,0,3,1,3,0,1,0,76.14,57.66 ,33.33
03,014,01,001,0030,44,565,8,573,1072,0,3,1,3,0,1,0,76.14,53.45 ,33.33
03,014,01,001,0031,45,941,14,955,1623,0,3,1,3,0,1,0,76.14,58.84 ,33.33
03,014,01,001,0032,46,823,10,833,1376,0,3,1,3,0,1,0,76.14,60.54 ,33.33
03,014,01,001,0033,47,561,13,574,973,0,3,1,3,0,1,0,76.14,58.99 ,33.33
03,014,01,001,0034,48,635,11,646,1101,0,3,1,3,0,1,0,76.14,58.67 ,33.33
03,014,01,001,0035,49,248,5,253,478,0,3,1,3,0,1,0,76.14,52.93 ,33.33
03,014,01,001,0036,50,726,38,764,1081,0,3,1,3,0,1,0,76.14,70.68 ,33.33
03,014,01,001,0036,51,282,7,289,464,0,3,1,3,0,1,0,76.14,62.28 ,33.33
03,014,01,001,0036,52,136,0,136,240,0,3,1,3,0,1,0,76.14,56.67 ,33.33
03,014,01,001,0037,53,523,6,529,1061,0,3,1,3,0,1,0,76.14,49.86 ,33.33
03,014,01,001,0038,54,949,10,959,1390,0,3,1,3,0,1,0,76.14,68.99 ,33.33
03,014,01,001,0039,55,468,5,473,786,0,3,1,3,0,1,0,76.14,60.18 ,33.33
03,014,01,001,0039,56,302,2,304,554,0,3,1,3,0,1,0,76.14,54.87 ,33.33
03,014,01,001,0040,57,527,4,531,904,0,3,1,3,0,1,0,76.14,58.74 ,33.33
03,014,01,001,0040,58,510,8,518,834,0,3,1,3,0,1,0,76.14,62.11 ,33.33
03,014,01,001,0041,59,662,4,666,1063,0,3,1,3,0,1,0,76.14,62.65 ,33.33
03,014,01,001,0042,60,516,7,523,973,0,3,1,3,0,1,0,76.14,53.75 ,33.33
03,014,01,001,0043,61,468,4,472,832,0,3,1,3,0,1,0,76.14,56.73 ,33.33
03,014,01,001,0044,62,496,3,499,899,0,3,1,3,0,1,0,76.14,55.51 ,33.33
03,014,01,001,0045,63,458,5,463,844,0,3,1,3,0,1,0,76.14,54.86 ,33.33
03,014,01,001,0046,64,640,24,664,1155,0,3,1,3,0,1,0,76.14,57.49 ,33.33
03,014,01,002,0047,65,132,1,133,230,0,3,1,3,0,1,0,76.14,57.83 ,33.33
03,014,01,002,0047,66,104,2,106,193,0,3,1,3,0,1,0,76.14,54.92 ,33.33
03,014,01,002,0047,67,51,0,51,91,0,3,1,3,0,1,0,76.14,56.04 ,33.33
03,014,01,002,0048,68,110,1,111,204,0,3,1,3,0,1,0,76.14,54.41 ,33.33
03,014,01,002,0049,69,40,1,41,105,0,3,1,3,0,1,0,76.14,39.05 ,33.33
03,014,01,002,0049,70,563,4,567,1044,0,3,1,3,0,1,0,76.14,54.31 ,33.33
03,014,01,002,0049,71,689,13,702,1245,0,3,1,3,0,1,0,76.14,56.39 ,33.33
03,014,01,002,0050,72,643,2,645,1129,0,3,1,3,0,1,0,76.14,57.13 ,33.33
03,014,01,002,0051,73,190,1,191,390,0,3,1,3,0,1,0,76.14,48.97 ,33.33
03,014,01,002,0051,74,309,5,314,602,0,3,1,3,0,1,0,76.14,52.16 ,33.33
03,014,01,002,0052,75,99,2,101,167,0,3,1,3,0,1,0,76.14,60.48 ,33.33
03,014,01,002,0052,76,199,4,203,407,0,3,1,3,0,1,0,76.14,49.88 ,33.33
03,014,01,002,0053,77,146,4,150,294,0,3,1,3,0,1,0,76.14,51.02 ,33.33
03,014,01,002,0053,78,145,4,149,281,0,3,1,3,0,1,0,76.14,53.02 ,33.33
03,014,01,002,0054,79,35,0,35,68,0,3,1,3,0,1,0,76.14,51.47 ,33.33
03,014,01,002,0054,80,38,0,38,71,0,3,1,3,0,1,0,76.14,53.52 ,33.33
03,014,01,003,0055,81,572,4,576,984,0,3,1,3,0,1,0,76.14,58.54 ,33.33
03,014,01,003,0055,82,369,11,380,736,0,3,1,3,0,1,0,76.14,51.63 ,33.33
03,014,01,003,0056,83,538,10,548,876,0,3,1,3,0,1,0,76.14,62.56 ,33.33
03,014,01,003,0057,84,375,12,387,652,0,3,1,3,0,1,0,76.14,59.36 ,33.33
03,014,01,003,0058,85,498,5,503,922,0,3,1,3,0,1,0,76.14,54.56 ,33.33
03,014,01,003,0059,86,363,4,367,737,0,3,1,3,0,1,0,76.14,49.80 ,33.33
03,014,01,003,0060,87,242,3,245,516,0,3,1,3,0,1,0,76.14,47.48 ,33.33
03,014,01,003,0060,88,421,3,424,827,0,3,1,3,0,1,0,76.14,51.27 ,33.33
03,014,01,003,0061,89,119,0,119,257,0,3,1,3,0,1,0,76.14,46.30 ,33.33
03,014,01,004,0062,90,532,6,538,845,0,3,1,3,0,1,0,76.14,63.67 ,33.33
03,014,01,004,0062,91,501,6,507,854,0,3,1,3,0,1,0,76.14,59.37 ,33.33
03,014,01,004,0063,92,165,1,166,257,0,3,1,3,0,1,0,76.14,64.59 ,33.33
03,014,01,004,0063,93,267,1,268,433,0,3,1,3,0,1,0,76.14,61.89 ,33.33
03,014,01,004,0063,94,157,3,160,323,0,3,1,3,0,1,0,76.14,49.54 ,33.33
03,014,01,004,0064,95,347,6,353,592,0,3,1,3,0,1,0,76.14,59.63 ,33.33
03,014,01,004,0064,96,297,4,301,474,0,3,1,3,0,1,0,76.14,63.50 ,33.33
03,014,01,004,0065,97,401,5,406,732,0,3,1,3,0,1,0,76.14,55.46 ,33.33
03,014,01,004,0065,98,175,5,180,330,0,3,1,3,0,1,0,76.14,54.55 ,33.33
03,014,01,004,0066,99,108,3,111,201,0,3,1,3,0,1,0,76.14,55.22 ,33.33
03,014,01,004,0066,100,22,0,22,40,0,3,1,3,0,1,0,76.14,55.00 ,33.33
03,014,01,004,0067,101,741,11,752,1144,0,3,1,3,0,1,0,76.14,65.73 ,33.33
03,014,01,004,0067,102,832,15,847,1158,0,3,1,3,0,1,0,76.14,73.14 ,33.33
03,014,01,004,0067,103,399,8,407,694,0,3,1,3,0,1,0,76.14,58.65 ,33.33
03,014,01,004,0068,104,438,11,449,741,0,3,1,3,0,1,0,76.14,60.59 ,33.33
03,014,01,004,0069,105,221,1,222,418,0,3,1,3,0,1,0,76.14,53.11 ,33.33
03,014,01,004,0070,106,172,1,173,306,0,3,1,3,0,1,0,76.14,56.54 ,33.33
03,014,01,004,0071,107,491,4,495,862,0,3,1,3,0,1,0,76.14,57.42 ,33.33
03,014,01,004,0071,108,89,3,92,203,0,3,1,3,0,1,0,76.14,45.32 ,33.33
03,014,01,004,0072,109,241,5,246,473,0,3,1,3,0,1,0,76.14,52.01 ,33.33
03,014,01,004,0073,110,197,2,199,374,0,3,1,3,0,1,0,76.14,53.21 ,33.33
03,014,01,004,0074,111,143,2,145,269,0,3,1,3,0,1,0,76.14,53.90 ,33.33
03,014,01,005,0075,112,78,1,79,207,0,3,1,3,0,1,0,76.14,38.16 ,33.33
03,014,01,005,0075,113,342,9,351,620,0,3,1,3,0,1,0,76.14,56.61 ,33.33
03,014,01,005,0076,114,563,6,569,1088,0,3,1,3,0,1,0,76.14,52.30 ,33.33
03,014,01,005,0077,115,364,7,371,771,0,3,1,3,0,1,0,76.14,48.12 ,33.33
03,014,01,005,0077,116,171,3,174,306,0,3,1,3,0,1,0,76.14,56.86 ,33.33
03,014,01,005,0078,117,449,6,455,852,0,3,1,3,0,1,0,76.14,53.40 ,33.33
03,014,01,005,0079,118,348,4,352,677,0,3,1,3,0,1,0,76.14,51.99 ,33.33
03,014,01,005,0080,119,222,6,228,409,0,3,1,3,0,1,0,76.14,55.75 ,33.33
03,014,01,005,0081,120,253,2,255,458,0,3,1,3,0,1,0,76.14,55.68 ,33.33
03,014,01,005,0081,121,303,2,305,573,0,3,1,3,0,1,0,76.14,53.23 ,33.33
03,014,01,006,0082,122,565,10,575,960,0,3,1,3,0,1,0,76.14,59.90 ,33.33
03,014,01,006,0082,123,490,1,491,860,0,3,1,3,0,1,0,76.14,57.09 ,33.33
03,014,01,006,0083,124,327,7,334,645,0,3,1,3,0,1,0,76.14,51.78 ,33.33
03,014,01,006,0083,125,387,9,396,781,0,3,1,3,0,1,0,76.14,50.70 ,33.33
03,014,01,006,0084,126,357,6,363,703,0,3,1,3,0,1,0,76.14,51.64 ,33.33
03,014,01,006,0085,127,56,1,57,128,0,3,1,3,0,1,0,76.14,44.53 ,33.33
03,014,01,006,0086,128,249,3,252,412,0,3,1,3,0,1,0,76.14,61.17 ,33.33
03,014,01,006,0087,129,484,8,492,882,0,3,1,3,0,1,0,76.14,55.78 ,33.33
03,014,01,006,0088,130,256,4,260,487,0,3,1,3,0,1,0,76.14,53.39 ,33.33
03,014,01,006,0089,131,207,3,210,406,0,3,1,3,0,1,0,76.14,51.72 ,33.33
03,014,01,006,0090,132,219,4,223,405,0,3,1,3,0,1,0,76.14,55.06 ,33.33
03,014,01,006,0091,133,91,1,92,192,0,3,1,3,0,1,0,76.14,47.92 ,33.33
03,014,01,007,0092,134,136,1,137,315,0,3,1,3,0,1,0,76.14,43.49 ,33.33
03,014,01,007,0092,135,213,3,216,425,0,3,1,3,0,1,0,76.14,50.82 ,33.33
03,014,01,007,0092,136,290,1,291,566,0,3,1,3,0,1,0,76.14,51.41 ,33.33
03,014,01,007,0093,137,220,1,221,455,0,3,1,3,0,1,0,76.14,48.57 ,33.33
03,014,01,007,0093,138,133,1,134,253,0,3,1,3,0,1,0,76.14,52.96 ,33.33
03,014,01,007,0094,139,99,2,101,212,0,3,1,3,0,1,0,76.14,47.64 ,33.33
03,014,01,007,0095,140,173,4,177,369,0,3,1,3,0,1,0,76.14,47.97 ,33.33
03,014,01,007,0096,141,421,3,424,720,0,3,1,3,0,1,0,76.14,58.89 ,33.33
03,014,01,007,0097,142,197,3,200,968,0,3,1,3,0,1,0,76.14,20.66 ,33.33
03,014,01,007,0097,143,111,0,111,228,0,3,1,3,0,1,0,76.14,48.68 ,33.33
03,014,01,007,0097,144,177,4,181,372,0,3,1,3,0,1,0,76.14,48.66 ,33.33
03,014,01,007,0098,145,79,2,81,161,0,3,1,3,0,1,0,76.14,50.31 ,33.33
03,014,01,007,0098,146,29,0,29,63,0,3,1,3,0,1,0,76.14,46.03 ,33.33
03,014,01,008,0099,147,58,1,59,144,0,3,1,3,0,1,0,76.14,40.97 ,33.33
03,014,01,008,0099,148,135,2,137,324,0,3,1,3,0,1,0,76.14,42.28 ,33.33
03,014,01,008,0100,149,205,4,209,443,0,3,1,3,0,1,0,76.14,47.18 ,33.33
03,014,01,008,0101,150,675,10,685,1218,0,3,1,3,0,1,0,76.14,56.24 ,33.33
03,014,01,008,0102,151,244,5,249,567,0,3,1,3,0,1,0,76.14,43.92 ,33.33
03,014,01,008,0103,152,105,1,106,238,0,3,1,3,0,1,0,76.14,44.54 ,33.33
03,014,01,008,0104,153,95,1,96,241,0,3,1,3,0,1,0,76.14,39.83 ,33.33
03,014,01,008,0104,154,84,0,84,156,0,3,1,3,0,1,0,76.14,53.85 ,33.33
03,014,01,008,0104,155,72,1,73,150,0,3,1,3,0,1,0,76.14,48.67 ,33.33
03,014,01,008,0105,156,169,3,172,328,0,3,1,3,0,1,0,76.14,52.44 ,33.33
03,014,01,009,0106,157,531,3,534,912,0,3,1,3,0,1,0,76.14,58.55 ,33.33
03,014,01,009,0106,158,261,3,264,437,0,3,1,3,0,1,0,76.14,60.41 ,33.33
03,014,01,009,0107,159,81,0,81,160,0,3,1,3,0,1,0,76.14,50.63 ,33.33
03,014,01,009,0108,160,335,5,340,626,0,3,1,3,0,1,0,76.14,54.31 ,33.33
03,014,01,009,0108,161,57,1,58,123,0,3,1,3,0,1,0,76.14,47.15 ,33.33
03,014,01,009,0109,162,209,1,210,389,0,3,1,3,0,1,0,76.14,53.98 ,33.33
03,014,01,009,0110,163,531,11,542,1092,0,3,1,3,0,1,0,76.14,49.63 ,33.33
03,014,01,009,0110,164,50,0,50,93,0,3,1,3,0,1,0,76.14,53.76 ,33.33
03,014,01,009,0111,165,735,6,741,1341,0,3,1,3,0,1,0,76.14,55.26 ,33.33
03,014,01,009,0112,166,214,2,216,432,0,3,1,3,0,1,0,76.14,50.00 ,33.33
03,014,01,009,0112,167,87,1,88,158,0,3,1,3,0,1,0,76.14,55.70 ,33.33
03,014,01,009,0113,168,275,5,280,550,0,3,1,3,0,1,0,76.14,50.91 ,33.33
03,014,01,009,0113,169,42,0,42,88,0,3,1,3,0,1,0,76.14,47.73 ,33.33
03,014,01,009,0114,170,12,0,12,31,0,3,1,3,0,1,0,76.14,38.71 ,33.33
03,014,01,009,0114,171,129,0,129,223,0,3,1,3,0,1,0,76.14,57.85 ,33.33
03,014,01,010,0115,172,157,0,157,272,0,3,1,3,0,1,0,76.14,57.72 ,33.33
03,014,01,010,0116,173,622,4,626,1148,0,3,1,3,0,1,0,76.14,54.53 ,33.33
03,014,01,010,0117,174,493,10,503,904,0,3,1,3,0,1,0,76.14,55.64 ,33.33
03,014,01,010,0118,175,54,2,56,137,0,3,1,3,0,1,0,76.14,40.88 ,33.33
03,014,01,010,0119,176,24,0,24,47,0,3,1,3,0,1,0,76.14,51.06 ,33.33
03,014,01,010,0119,177,18,1,19,43,0,3,1,3,0,1,0,76.14,44.19 ,33.33
03,014,01,011,0120,178,297,7,304,596,0,3,1,3,0,1,0,76.14,51.01 ,33.33
03,014,01,011,0121,179,336,2,338,630,0,3,1,3,0,1,0,76.14,53.65 ,33.33
03,014,01,011,0122,180,194,2,196,377,0,3,1,3,0,1,0,76.14,51.99 ,33.33
03,014,01,011,0122,181,72,2,74,115,0,3,1,3,0,1,0,76.14,64.35 ,33.33
03,014,01,012,0123,182,11,0,11,20,0,3,1,3,0,1,0,76.14,55.00 ,33.33
03,014,01,012,0124,183,30,2,32,46,0,3,1,3,0,1,0,76.14,69.57 ,33.33
03,014,01,012,0125,184,56,0,56,130,0,3,1,3,0,1,0,76.14,43.08 ,33.33
03,014,01,012,0126,185,60,1,61,90,0,3,1,3,0,1,0,76.14,67.78 ,33.33
03,014,01,012,0127,186,18,1,19,30,0,3,1,3,0,1,0,76.14,63.33 ,33.33
03,014,01,012,0128,187,19,2,21,33,0,3,1,3,0,1,0,76.14,63.64 ,33.33
03,014,01,013,0129,188,58,0,58,108,0,3,1,3,0,1,0,76.14,53.70 ,33.33
03,014,01,013,0130,189,18,0,18,27,0,3,1,3,0,1,0,76.14,66.67 ,33.33
03,014,01,013,0131,190,16,1,17,21,0,3,1,3,0,1,0,76.14,80.95 ,33.33
03,014,01,013,0132,191,19,0,19,33,0,3,1,3,0,1,0,76.14,57.58 ,33.33
03,014,01,013,0133,192,17,0,17,32,0,3,1,3,0,1,0,76.14,53.13 ,33.33
03,014,01,013,0133,193,46,1,47,76,0,3,1,3,0,1,0,76.14,61.84 ,33.33
03,014,01,014,0134,194,52,0,52,109,0,3,1,3,0,1,0,76.14,47.71 ,33.33
03,014,01,014,0135,195,18,0,18,46,0,3,1,3,0,1,0,76.14,39.13 ,33.33
03,014,01,014,0136,196,22,0,22,35,0,3,1,3,0,1,0,76.14,62.86 ,33.33
03,014,01,014,0137,197,11,0,11,20,0,3,1,3,0,1,0,76.14,55.00 ,33.33
03,014,01,014,0138,198,6,0,6,21,0,3,1,3,0,1,0,76.14,28.57 ,33.33
03,014,01,015,0139,199,78,0,78,135,0,3,1,3,0,1,0,76.14,57.78 ,33.33
03,014,01,015,0139,200,27,0,27,49,0,3,1,3,0,1,0,76.14,55.10 ,33.33
03,014,01,015,0140,201,16,0,16,37,0,3,1,3,0,1,0,76.14,43.24 ,33.33
03,014,01,015,0141,202,26,1,27,67,0,3,1,3,0,1,0,76.14,40.30 ,33.33
03,014,01,015,0142,203,2,0,2,15,0,3,1,3,0,1,0,76.14,13.33 ,33.33
03,014,01,015,0143,204,6,0,6,30,0,3,1,3,0,1,0,76.14,20.00 ,33.33
03,014,01,015,0144,205,5,0,5,11,0,3,1,3,0,1,0,76.14,45.45 ,33.33
03,014,01,016,0145,206,25,0,25,62,0,3,1,3,0,1,0,76.14,40.32 ,33.33
03,014,01,016,0146,207,31,1,32,66,0,3,1,3,0,1,0,76.14,48.48 ,33.33
03,014,01,016,0147,208,1,0,1,10,0,3,1,3,0,1,0,76.14,10.00 ,33.33
03,014,01,016,0148,209,5,0,5,14,0,3,1,3,0,1,0,76.14,35.71 ,33.33
03,015,01,001,0001,1,955,6,961,1494,0,3,1,3,0,1,0,76.14,64.32 ,33.33
03,015,01,001,0002,2,1093,18,1111,1729,0,3,1,3,0,1,0,76.14,64.26 ,33.33
03,015,01,001,0002,3,1042,8,1050,1621,0,3,1,3,0,1,0,76.14,64.77 ,33.33
03,015,01,001,0003,4,403,2,405,659,0,3,1,3,0,1,0,76.14,61.46 ,33.33
03,015,01,001,0003,5,806,29,835,1282,0,3,1,3,0,1,0,76.14,65.13 ,33.33
03,015,01,001,0003,6,773,12,785,1237,0,3,1,3,0,1,0,76.14,63.46 ,33.33
03,015,01,001,0004,7,386,8,394,657,0,3,1,3,0,1,0,76.14,59.97 ,33.33
03,015,01,001,0005,8,837,9,846,1370,0,3,1,3,0,1,0,76.14,61.75 ,33.33
03,015,01,001,0005,9,674,8,682,1226,0,3,1,3,0,1,0,76.14,55.63 ,33.33
03,015,01,001,0006,10,590,7,597,942,0,3,1,3,0,1,0,76.14,63.38 ,33.33
03,015,01,001,0006,11,467,15,482,768,0,3,1,3,0,1,0,76.14,62.76 ,33.33
03,015,01,001,0007,12,705,14,719,1137,0,3,1,3,0,1,0,76.14,63.24 ,33.33
03,015,01,001,0007,13,775,14,789,1264,0,3,1,3,0,1,0,76.14,62.42 ,33.33
03,015,01,001,0008,14,994,17,1011,1483,0,3,1,3,0,1,0,76.14,68.17 ,33.33
03,015,01,001,0009,15,213,0,213,344,0,3,1,3,0,1,0,76.14,61.92 ,33.33
03,015,01,001,0010,16,421,4,425,655,0,3,1,3,0,1,0,76.14,64.89 ,33.33
03,015,01,001,0011,17,400,7,407,687,0,3,1,3,0,1,0,76.14,59.24 ,33.33
03,015,01,001,0012,18,337,6,343,535,0,3,1,3,0,1,0,76.14,64.11 ,33.33
03,015,01,001,0013,19,403,0,403,646,0,3,1,3,0,1,0,76.14,62.38 ,33.33
03,015,01,001,0014,20,910,13,923,1411,0,3,1,3,0,1,0,76.14,65.41 ,33.33
03,015,01,001,0015,21,339,6,345,550,0,3,1,3,0,1,0,76.14,62.73 ,33.33
03,015,01,001,0016,22,573,9,582,833,0,3,1,3,0,1,0,76.14,69.87 ,33.33
03,015,01,001,0017,23,678,8,686,1094,0,3,1,3,0,1,0,76.14,62.71 ,33.33
03,015,01,001,0018,24,499,6,505,724,0,3,1,3,0,1,0,76.14,69.75 ,33.33
03,015,01,001,0019,25,497,7,504,776,0,3,1,3,0,1,0,76.14,64.95 ,33.33
03,015,01,001,0020,26,619,7,626,1004,0,3,1,3,0,1,0,76.14,62.35 ,33.33
03,015,01,001,0021,27,466,7,473,796,0,3,1,3,0,1,0,76.14,59.42 ,33.33
03,015,01,001,0022,28,770,16,786,1241,0,3,1,3,0,1,0,76.14,63.34 ,33.33
03,015,01,001,0022,29,921,7,928,1505,0,3,1,3,0,1,0,76.14,61.66 ,33.33
03,015,01,001,0023,30,1025,8,1033,1572,0,3,1,3,0,1,0,76.14,65.71 ,33.33
03,015,01,001,0024,31,924,13,937,1408,0,3,1,3,0,1,0,76.14,66.55 ,33.33
03,015,01,001,0024,32,597,4,601,968,0,3,1,3,0,1,0,76.14,62.09 ,33.33
03,015,01,001,0024,33,598,6,604,945,0,3,1,3,0,1,0,76.14,63.92 ,33.33
03,015,01,001,0024,34,824,10,834,1321,0,3,1,3,0,1,0,76.14,63.13 ,33.33
03,015,01,001,0025,35,591,8,599,1003,0,3,1,3,0,1,0,76.14,59.72 ,33.33
03,015,01,001,0025,36,536,3,539,881,0,3,1,3,0,1,0,76.14,61.18 ,33.33
03,015,01,001,0025,37,767,7,774,1250,0,3,1,3,0,1,0,76.14,61.92 ,33.33
03,015,01,001,0026,38,762,11,773,1183,0,3,1,3,0,1,0,76.14,65.34 ,33.33
03,015,01,001,0026,39,677,7,684,1039,0,3,1,3,0,1,0,76.14,65.83 ,33.33
03,015,01,001,0027,40,1058,7,1065,1734,0,3,1,3,0,1,0,76.14,61.42 ,33.33
03,015,01,001,0027,41,799,13,812,1306,0,3,1,3,0,1,0,76.14,62.17 ,33.33
03,015,01,001,0028,42,1011,8,1019,1530,0,3,1,3,0,1,0,76.14,66.60 ,33.33
03,015,01,001,0029,43,709,11,720,1087,0,3,1,3,0,1,0,76.14,66.24 ,33.33
03,015,01,001,0030,44,297,3,300,460,0,3,1,3,0,1,0,76.14,65.22 ,33.33
03,015,01,001,0031,45,930,24,954,1456,0,3,1,3,0,1,0,76.14,65.52 ,33.33
03,015,01,001,0032,46,491,3,494,780,0,3,1,3,0,1,0,76.14,63.33 ,33.33
03,015,01,001,0033,47,793,8,801,1244,0,3,1,3,0,1,0,76.14,64.39 ,33.33
03,015,01,001,0033,48,602,7,609,919,0,3,1,3,0,1,0,76.14,66.27 ,33.33
03,015,01,001,0034,49,590,9,599,900,0,3,1,3,0,1,0,76.14,66.56 ,33.33
03,015,01,001,0034,50,508,4,512,848,0,3,1,3,0,1,0,76.14,60.38 ,33.33
03,015,01,001,0035,51,1006,15,1021,1613,0,3,1,3,0,1,0,76.14,63.30 ,33.33
03,015,01,001,0035,52,1170,11,1181,2091,0,3,1,3,0,1,0,76.14,56.48 ,33.33
03,015,01,001,0036,53,489,3,492,809,0,3,1,3,0,1,0,76.14,60.82 ,33.33
03,015,01,001,0037,54,802,11,813,1225,0,3,1,3,0,1,0,76.14,66.37 ,33.33
03,015,01,001,0037,55,866,9,875,1350,0,3,1,3,0,1,0,76.14,64.81 ,33.33
03,015,01,001,0037,56,749,11,760,1176,0,3,1,3,0,1,0,76.14,64.63 ,33.33
03,015,01,001,0038,57,779,9,788,1220,0,3,1,3,0,1,0,76.14,64.59 ,33.33
03,015,01,001,0038,58,738,8,746,1235,0,3,1,3,0,1,0,76.14,60.40 ,33.33
03,015,01,001,0039,59,539,5,544,898,0,3,1,3,0,1,0,76.14,60.58 ,33.33
03,015,01,001,0039,60,1091,11,1102,1852,0,3,1,3,0,1,0,76.14,59.50 ,33.33
03,015,01,001,0040,61,384,7,391,733,0,3,1,3,0,1,0,76.14,53.34 ,33.33
03,015,01,002,0041,62,204,1,205,349,0,3,1,3,0,1,0,76.14,58.74 ,33.33
03,015,01,002,0041,63,622,11,633,945,0,3,1,3,0,1,0,76.14,66.98 ,33.33
03,015,01,002,0042,64,296,3,299,576,0,3,1,3,0,1,0,76.14,51.91 ,33.33
03,015,01,002,0042,65,175,0,175,264,0,3,1,3,0,1,0,76.14,66.29 ,33.33
03,015,01,002,0043,66,225,1,226,330,0,3,1,3,0,1,0,76.14,68.48 ,33.33
03,015,01,002,0043,67,1016,13,1029,1644,0,3,1,3,0,1,0,76.14,62.59 ,33.33
03,015,01,002,0044,68,816,15,831,1465,0,3,1,3,0,1,0,76.14,56.72 ,33.33
03,015,01,002,0044,69,1059,17,1076,1809,0,3,1,3,0,1,0,76.14,59.48 ,33.33
03,015,01,002,0044,70,275,4,279,398,0,3,1,3,0,1,0,76.14,70.10 ,33.33
03,015,01,002,0045,71,317,4,321,541,0,3,1,3,0,1,0,76.14,59.33 ,33.33
03,015,01,002,0046,72,805,17,822,1268,0,3,1,3,0,1,0,76.14,64.83 ,33.33
03,015,01,002,0046,73,774,21,795,1195,0,3,1,3,0,1,0,76.14,66.53 ,33.33
03,015,01,002,0047,74,562,12,574,795,0,3,1,3,0,1,0,76.14,72.20 ,33.33
03,015,01,002,0047,75,130,6,136,258,0,3,1,3,0,1,0,76.14,52.71 ,33.33
03,015,01,003,0048,76,161,6,167,329,0,3,1,3,0,1,0,76.14,50.76 ,33.33
03,015,01,003,0048,77,66,0,66,115,0,3,1,3,0,1,0,76.14,57.39 ,33.33
03,015,01,003,0049,78,186,3,189,334,0,3,1,3,0,1,0,76.14,56.59 ,33.33
03,015,01,003,0050,79,124,2,126,251,0,3,1,3,0,1,0,76.14,50.20 ,33.33
03,015,01,003,0050,80,115,5,120,245,0,3,1,3,0,1,0,76.14,48.98 ,33.33
03,015,01,003,0051,81,59,3,62,124,0,3,1,3,0,1,0,76.14,50.00 ,33.33
03,015,01,003,0052,82,39,0,39,82,0,3,1,3,0,1,0,76.14,47.56 ,33.33
03,015,01,003,0052,83,39,1,40,86,0,3,1,3,0,1,0,76.14,46.51 ,33.33
03,015,01,003,0053,84,76,0,76,124,0,3,1,3,0,1,0,76.14,61.29 ,33.33
03,015,01,003,0054,85,79,1,80,114,0,3,1,3,0,1,0,76.14,70.18 ,33.33
03,015,01,003,0055,86,78,1,79,122,0,3,1,3,0,1,0,76.14,64.75 ,33.33
03,015,01,003,0056,87,41,0,41,75,0,3,1,3,0,1,0,76.14,54.67 ,33.33
03,015,01,003,0056,88,6,0,6,17,0,3,1,3,0,1,0,76.14,35.29 ,33.33
03,015,01,004,0057,89,760,12,772,1233,0,3,1,3,0,1,0,76.14,62.61 ,33.33
03,015,01,004,0057,90,805,13,818,1373,0,3,1,3,0,1,0,76.14,59.58 ,33.33
03,015,01,004,0058,91,612,3,615,1031,0,3,1,3,0,1,0,76.14,59.65 ,33.33
03,015,01,004,0058,92,624,13,637,1036,0,3,1,3,0,1,0,76.14,61.49 ,33.33
03,015,01,004,0059,93,902,16,918,1583,0,3,1,3,0,1,0,76.14,57.99 ,33.33
03,015,01,004,0059,94,1108,23,1131,1758,0,3,1,3,0,1,0,76.14,64.33 ,33.33
03,015,01,004,0060,95,516,2,518,850,0,3,1,3,0,1,0,76.14,60.94 ,33.33
03,015,01,004,0060,96,852,11,863,1404,0,3,1,3,0,1,0,76.14,61.47 ,33.33
03,015,01,004,0061,97,1001,8,1009,1652,0,3,1,3,0,1,0,76.14,61.08 ,33.33
03,015,01,004,0062,98,710,9,719,1133,0,3,1,3,0,1,0,76.14,63.46 ,33.33
03,015,01,004,0063,99,517,17,534,1034,0,3,1,3,0,1,0,76.14,51.64 ,33.33
03,015,01,004,0064,100,884,13,897,1425,0,3,1,3,0,1,0,76.14,62.95 ,33.33
03,015,01,004,0065,101,1252,25,1277,1984,0,3,1,3,0,1,0,76.14,64.36 ,33.33
03,015,01,004,0066,102,899,24,923,1599,0,3,1,3,0,1,0,76.14,57.72 ,33.33
03,015,01,004,0067,103,738,7,745,1178,0,3,1,3,0,1,0,76.14,63.24 ,33.33
03,015,01,004,0067,104,708,8,716,1136,0,3,1,3,0,1,0,76.14,63.03 ,33.33
03,015,01,004,0068,105,1132,11,1143,1768,0,3,1,3,0,1,0,76.14,64.65 ,33.33
03,015,01,004,0068,106,644,9,653,1029,0,3,1,3,0,1,0,76.14,63.46 ,33.33
03,015,01,004,0068,107,1383,16,1399,2149,0,3,1,3,0,1,0,76.14,65.10 ,33.33
03,015,01,004,0069,108,766,11,777,1240,0,3,1,3,0,1,0,76.14,62.66 ,33.33
03,015,01,004,0069,109,896,8,904,1433,0,3,1,3,0,1,0,76.14,63.08 ,33.33
03,015,01,004,0070,110,739,11,750,1257,0,3,1,3,0,1,0,76.14,59.67 ,33.33
03,015,01,004,0070,111,829,6,835,1389,0,3,1,3,0,1,0,76.14,60.12 ,33.33
03,015,01,004,0070,112,853,14,867,1388,0,3,1,3,0,1,0,76.14,62.46 ,33.33
03,015,01,004,0071,113,746,9,755,1227,0,3,1,3,0,1,0,76.14,61.53 ,33.33
03,015,01,004,0071,114,715,9,724,1242,0,3,1,3,0,1,0,76.14,58.29 ,33.33
03,015,01,004,0072,115,703,10,713,1301,0,3,1,3,0,1,0,76.14,54.80 ,33.33
03,015,01,004,0073,116,1141,18,1159,1873,0,3,1,3,0,1,0,76.14,61.88 ,33.33
03,015,01,004,0073,117,499,11,510,873,0,3,1,3,0,1,0,76.14,58.42 ,33.33
03,015,01,004,0074,118,499,21,520,856,0,3,1,3,0,1,0,76.14,60.75 ,33.33
03,015,01,005,0075,119,453,9,462,769,0,3,1,3,0,1,0,76.14,60.08 ,33.33
03,015,01,005,0076,120,177,1,178,326,0,3,1,3,0,1,0,76.14,54.60 ,33.33
03,015,01,005,0077,121,1064,17,1081,1843,0,3,1,3,0,1,0,76.14,58.65 ,33.33
03,015,01,005,0078,122,679,11,690,1163,0,3,1,3,0,1,0,76.14,59.33 ,33.33
03,015,01,005,0079,123,410,3,413,666,0,3,1,3,0,1,0,76.14,62.01 ,33.33
03,015,01,005,0080,124,627,10,637,1088,0,3,1,3,0,1,0,76.14,58.55 ,33.33
03,015,01,005,0081,125,380,5,385,604,0,3,1,3,0,1,0,76.14,63.74 ,33.33
03,015,01,005,0082,126,87,2,89,156,0,3,1,3,0,1,0,76.14,57.05 ,33.33
03,015,01,005,0083,127,328,5,333,561,0,3,1,3,0,1,0,76.14,59.36 ,33.33
03,015,01,005,0084,128,452,9,461,789,0,3,1,3,0,1,0,76.14,58.43 ,33.33
03,015,01,005,0084,129,182,5,187,324,0,3,1,3,0,1,0,76.14,57.72 ,33.33
03,015,01,005,0085,130,937,23,960,1657,0,3,1,3,0,1,0,76.14,57.94 ,33.33
03,015,01,005,0085,131,233,8,241,389,0,3,1,3,0,1,0,76.14,61.95 ,33.33
03,015,01,005,0086,132,71,1,72,97,0,3,1,3,0,1,0,76.14,74.23 ,33.33
03,015,01,005,0086,133,21,2,23,45,0,3,1,3,0,1,0,76.14,51.11 ,33.33
03,015,01,005,0087,134,108,1,109,270,0,3,1,3,0,1,0,76.14,40.37 ,33.33
03,015,01,005,0088,135,173,6,179,388,0,3,1,3,0,1,0,76.14,46.13 ,33.33
03,015,01,005,0089,136,232,3,235,441,0,3,1,3,0,1,0,76.14,53.29 ,33.33
03,015,01,005,0089,137,34,1,35,58,0,3,1,3,0,1,0,76.14,60.34 ,33.33
03,015,01,006,0090,138,705,6,711,1124,0,3,1,3,0,1,0,76.14,63.26 ,33.33
03,015,01,006,0091,139,417,6,423,722,0,3,1,3,0,1,0,76.14,58.59 ,33.33
03,015,01,006,0092,140,493,4,497,739,0,3,1,3,0,1,0,76.14,67.25 ,33.33
03,015,01,006,0093,141,804,9,813,1244,0,3,1,3,0,1,0,76.14,65.35 ,33.33
03,015,01,006,0094,142,442,1,443,699,0,3,1,3,0,1,0,76.14,63.38 ,33.33
03,015,01,006,0094,143,155,0,155,236,0,3,1,3,0,1,0,76.14,65.68 ,33.33
03,015,01,006,0095,144,109,3,112,196,0,3,1,3,0,1,0,76.14,57.14 ,33.33
03,015,01,006,0095,145,55,0,55,99,0,3,1,3,0,1,0,76.14,55.56 ,33.33
03,015,01,006,0096,146,371,6,377,714,0,3,1,3,0,1,0,76.14,52.80 ,33.33
03,015,01,006,0096,147,353,7,360,606,0,3,1,3,0,1,0,76.14,59.41 ,33.33
03,015,01,006,0097,148,437,9,446,684,0,3,1,3,0,1,0,76.14,65.20 ,33.33
03,015,01,006,0098,149,441,1,442,739,0,3,1,3,0,1,0,76.14,59.81 ,33.33
03,015,01,006,0099,150,602,10,612,905,0,3,1,3,0,1,0,76.14,67.62 ,33.33
03,015,01,006,0100,151,635,16,651,1087,0,3,1,3,0,1,0,76.14,59.89 ,33.33
03,015,01,006,0101,152,108,2,110,196,0,3,1,3,0,1,0,76.14,56.12 ,33.33
03,015,01,007,0102,153,535,8,543,931,0,3,1,3,0,1,0,76.14,58.32 ,33.33
03,015,01,007,0103,154,540,2,542,912,0,3,1,3,0,1,0,76.14,59.43 ,33.33
03,015,01,007,0104,155,250,4,254,456,0,3,1,3,0,1,0,76.14,55.70 ,33.33
03,015,01,007,0105,156,139,3,142,324,0,3,1,3,0,1,0,76.14,43.83 ,33.33
03,015,01,007,0106,157,405,7,412,735,0,3,1,3,0,1,0,76.14,56.05 ,33.33
03,015,01,007,0107,158,46,1,47,92,0,3,1,3,0,1,0,76.14,51.09 ,33.33
03,015,01,007,0107,159,70,1,71,174,0,3,1,3,0,1,0,76.14,40.80 ,33.33
03,015,01,007,0108,160,67,0,67,134,0,3,1,3,0,1,0,76.14,50.00 ,33.33
03,015,01,007,0109,161,55,1,56,127,0,3,1,3,0,1,0,76.14,44.09 ,33.33
03,015,01,007,0110,162,89,1,90,237,0,3,1,3,0,1,0,76.14,37.97 ,33.33
03,015,01,007,0111,163,129,2,131,258,0,3,1,3,0,1,0,76.14,50.78 ,33.33
03,015,01,007,0112,164,366,3,369,566,0,3,1,3,0,1,0,76.14,65.19 ,33.33
03,015,01,007,0113,165,308,4,312,556,0,3,1,3,0,1,0,76.14,56.12 ,33.33
03,015,01,007,0113,166,77,2,79,166,0,3,1,3,0,1,0,76.14,47.59 ,33.33
03,015,01,007,0114,167,211,1,212,386,0,3,1,3,0,1,0,76.14,54.92 ,33.33
03,015,01,007,0115,168,232,5,237,427,0,3,1,3,0,1,0,76.14,55.50 ,33.33
03,015,01,007,0116,169,345,8,353,642,0,3,1,3,0,1,0,76.14,54.98 ,33.33
03,015,01,008,0117,170,54,0,54,148,0,3,1,3,0,1,0,76.14,36.49 ,33.33
03,015,01,008,0118,171,68,2,70,160,0,3,1,3,0,1,0,76.14,43.75 ,33.33
03,015,01,008,0119,172,58,1,59,95,0,3,1,3,0,1,0,76.14,62.11 ,33.33
03,015,01,008,0119,173,337,4,341,619,0,3,1,3,0,1,0,76.14,55.09 ,33.33
03,015,01,008,0119,174,45,2,47,93,0,3,1,3,0,1,0,76.14,50.54 ,33.33
03,015,01,008,0120,175,57,1,58,145,0,3,1,3,0,1,0,76.14,40.00 ,33.33
03,015,01,008,0121,176,73,0,73,116,0,3,1,3,0,1,0,76.14,62.93 ,33.33
03,015,01,009,0122,177,29,2,31,63,0,3,1,3,0,1,0,76.14,49.21 ,33.33
03,015,01,009,0123,178,15,0,15,29,0,3,1,3,0,1,0,76.14,51.72 ,33.33
03,015,01,009,0124,179,30,1,31,47,0,3,1,3,0,1,0,76.14,65.96 ,33.33
03,015,01,009,0125,180,34,0,34,64,0,3,1,3,0,1,0,76.14,53.13 ,33.33
03,015,01,009,0126,181,6,0,6,12,0,3,1,3,0,1,0,76.14,50.00 ,33.33
03,015,01,009,0126,182,6,0,6,15,0,3,1,3,0,1,0,76.14,40.00 ,33.33
03,015,01,009,0127,183,56,1,57,118,0,3,1,3,0,1,0,76.14,48.31 ,33.33
03,015,01,010,0128,184,415,6,421,684,0,3,1,3,0,1,0,76.14,61.55 ,33.33
03,015,01,010,0128,185,711,6,717,1270,0,3,1,3,0,1,0,76.14,56.46 ,33.33
03,015,01,010,0129,186,482,7,489,803,0,3,1,3,0,1,0,76.14,60.90 ,33.33
03,015,01,010,0129,187,466,2,468,788,0,3,1,3,0,1,0,76.14,59.39 ,33.33
03,015,01,010,0130,188,281,2,283,442,0,3,1,3,0,1,0,76.14,64.03 ,33.33
03,015,01,010,0131,189,472,8,480,844,0,3,1,3,0,1,0,76.14,56.87 ,33.33
03,015,01,010,0132,190,240,2,242,452,0,3,1,3,0,1,0,76.14,53.54 ,33.33
03,015,01,010,0133,191,262,9,271,504,0,3,1,3,0,1,0,76.14,53.77 ,33.33
03,015,01,010,0134,192,159,2,161,364,0,3,1,3,0,1,0,76.14,44.23 ,33.33
03,015,01,010,0135,193,19,0,19,52,0,3,1,3,0,1,0,76.14,36.54 ,33.33
03,015,01,010,0136,194,426,7,433,716,0,3,1,3,0,1,0,76.14,60.47 ,33.33
03,015,01,010,0137,195,273,3,276,538,0,3,1,3,0,1,0,76.14,51.30 ,33.33
03,015,01,010,0138,196,134,6,140,311,0,3,1,3,0,1,0,76.14,45.02 ,33.33
03,015,01,011,0139,197,838,17,855,1478,0,3,1,3,0,1,0,76.14,57.85 ,33.33
03,015,01,011,0139,198,719,16,735,1316,0,3,1,3,0,1,0,76.14,55.85 ,33.33
03,015,01,011,0139,199,669,9,678,1157,0,3,1,3,0,1,0,76.14,58.60 ,33.33
03,015,01,011,0140,200,833,5,838,1422,0,3,1,3,0,1,0,76.14,58.93 ,33.33
03,015,01,011,0141,201,473,9,482,904,0,3,1,3,0,1,0,76.14,53.32 ,33.33
03,015,01,011,0141,202,578,7,585,1007,0,3,1,3,0,1,0,76.14,58.09 ,33.33
03,015,01,011,0142,203,726,14,740,1210,0,3,1,3,0,1,0,76.14,61.16 ,33.33
03,015,01,011,0142,204,175,39,214,689,0,3,1,3,0,1,0,76.14,31.06 ,33.33
03,015,01,011,0142,205,193,37,230,597,0,3,1,3,0,1,0,76.14,38.53 ,33.33
03,015,01,011,0142,206,310,57,367,595,0,3,1,3,0,1,0,76.14,61.68 ,33.33
03,015,01,011,0143,207,624,15,639,1127,0,3,1,3,0,1,0,76.14,56.70 ,33.33
03,015,01,011,0144,208,583,9,592,1150,0,3,1,3,0,1,0,76.14,51.48 ,33.33
03,015,01,011,0145,209,350,46,396,769,0,3,1,3,0,1,0,76.14,51.50 ,33.33
03,015,01,011,0146,210,185,4,189,406,0,3,1,3,0,1,0,76.14,46.55 ,33.33
03,015,01,011,0147,211,193,2,195,379,0,3,1,3,0,1,0,76.14,51.45 ,33.33
03,015,01,011,0148,212,313,12,325,746,0,3,1,3,0,1,0,76.14,43.57 ,33.33
03,015,01,011,0148,213,176,5,181,360,0,3,1,3,0,1,0,76.14,50.28 ,33.33
03,015,01,011,0149,214,53,5,58,133,0,3,1,3,0,1,0,76.14,43.61 ,33.33
03,015,01,011,0149,215,196,2,198,467,0,3,1,3,0,1,0,76.14,42.40 ,33.33
03,015,01,011,0150,216,247,3,250,531,0,3,1,3,0,1,0,76.14,47.08 ,33.33
03,015,01,011,0151,217,43,1,44,97,0,3,1,3,0,1,0,76.14,45.36 ,33.33
03,015,01,011,0152,218,520,8,528,1030,0,3,1,3,0,1,0,76.14,51.26 ,33.33
03,015,01,011,0153,219,587,7,594,1119,0,3,1,3,0,1,0,76.14,53.08 ,33.33
03,015,01,012,0154,220,244,4,248,508,0,3,1,3,0,1,0,76.14,48.82 ,33.33
03,015,01,012,0155,221,633,20,653,1308,0,3,1,3,0,1,0,76.14,49.92 ,33.33
03,015,01,012,0156,222,619,43,662,1134,0,3,1,3,0,1,0,76.14,58.38 ,33.33
03,015,01,012,0157,223,324,6,330,674,0,3,1,3,0,1,0,76.14,48.96 ,33.33
03,015,01,012,0158,224,630,11,641,1133,0,3,1,3,0,1,0,76.14,56.58 ,33.33
03,015,01,012,0159,225,224,0,224,482,0,3,1,3,0,1,0,76.14,46.47 ,33.33
03,015,01,012,0160,226,517,4,521,931,0,3,1,3,0,1,0,76.14,55.96 ,33.33
03,015,01,012,0161,227,255,3,258,440,0,3,1,3,0,1,0,76.14,58.64 ,33.33
03,015,01,012,0162,228,922,13,935,1744,0,3,1,3,0,1,0,76.14,53.61 ,33.33
03,015,01,012,0163,229,302,1,303,589,0,3,1,3,0,1,0,76.14,51.44 ,33.33
03,015,01,012,0164,230,212,5,217,397,0,3,1,3,0,1,0,76.14,54.66 ,33.33
03,015,01,012,0165,231,281,8,289,555,0,3,1,3,0,1,0,76.14,52.07 ,33.33
03,015,01,012,0166,232,332,4,336,583,0,3,1,3,0,1,0,76.14,57.63 ,33.33
03,015,01,013,0167,233,14,0,14,34,0,3,1,3,0,1,0,76.14,41.18 ,33.33
03,015,01,013,0168,234,10,1,11,24,0,3,1,3,0,1,0,76.14,45.83 ,33.33
03,015,01,013,0168,235,8,1,9,25,0,3,1,3,0,1,0,76.14,36.00 ,33.33
03,015,01,013,0169,236,7,0,7,14,0,3,1,3,0,1,0,76.14,50.00 ,33.33
03,015,01,013,0169,237,11,1,12,22,0,3,1,3,0,1,0,76.14,54.55 ,33.33
03,015,01,013,0170,238,41,1,42,81,0,3,1,3,0,1,0,76.14,51.85 ,33.33
03,015,01,013,0171,239,39,2,41,75,0,3,1,3,0,1,0,76.14,54.67 ,33.33
03,015,01,013,0171,240,19,2,21,32,0,3,1,3,0,1,0,76.14,65.63 ,33.33
03,015,01,013,0172,241,19,0,19,41,0,3,1,3,0,1,0,76.14,46.34 ,33.33
03,015,01,013,0172,242,17,0,17,33,0,3,1,3,0,1,0,76.14,51.52 ,33.33
03,015,01,013,0172,243,12,0,12,23,0,3,1,3,0,1,0,76.14,52.17 ,33.33
03,016,01,001,0001,1,259,3,262,405,0,3,1,3,0,1,0,76.14,64.69 ,33.33
03,016,01,001,0002,2,266,5,271,353,0,3,1,3,0,1,0,76.14,76.77 ,33.33
03,016,01,001,0003,3,418,6,424,644,0,3,1,3,0,1,0,76.14,65.84 ,33.33
03,016,01,001,0004,4,392,5,397,553,0,3,1,3,0,1,0,76.14,71.79 ,33.33
03,016,01,001,0005,5,645,4,649,944,0,3,1,3,0,1,0,76.14,68.75 ,33.33
03,016,01,001,0006,6,808,4,812,1154,0,3,1,3,0,1,0,76.14,70.36 ,33.33
03,016,01,001,0007,7,557,5,562,789,0,3,1,3,0,1,0,76.14,71.23 ,33.33
03,016,01,001,0008,8,621,8,629,937,0,3,1,3,0,1,0,76.14,67.13 ,33.33
03,016,01,001,0008,9,621,5,626,877,0,3,1,3,0,1,0,76.14,71.38 ,33.33
03,016,01,001,0009,10,538,7,545,778,0,3,1,3,0,1,0,76.14,70.05 ,33.33
03,016,01,001,0009,11,413,9,422,646,0,3,1,3,0,1,0,76.14,65.33 ,33.33
03,016,01,001,0010,12,607,10,617,925,0,3,1,3,0,1,0,76.14,66.70 ,33.33
03,016,01,001,0010,13,840,8,848,1244,0,3,1,3,0,1,0,76.14,68.17 ,33.33
03,016,01,001,0011,14,869,7,876,1308,0,3,1,3,0,1,0,76.14,66.97 ,33.33
03,016,01,001,0011,15,767,9,776,1177,0,3,1,3,0,1,0,76.14,65.93 ,33.33
03,016,01,001,0011,16,992,12,1004,1447,0,3,1,3,0,1,0,76.14,69.38 ,33.33
03,016,01,001,0012,17,724,14,738,1135,0,3,1,3,0,1,0,76.14,65.02 ,33.33
03,016,01,001,0012,18,728,9,737,1141,0,3,1,3,0,1,0,76.14,64.59 ,33.33
03,016,01,001,0013,19,563,9,572,810,0,3,1,3,0,1,0,76.14,70.62 ,33.33
03,016,01,001,0014,20,781,7,788,1154,0,3,1,3,0,1,0,76.14,68.28 ,33.33
03,016,01,001,0014,21,640,9,649,953,0,3,1,3,0,1,0,76.14,68.10 ,33.33
03,016,01,001,0015,22,633,6,639,899,0,3,1,3,0,1,0,76.14,71.08 ,33.33
03,016,01,001,0015,23,534,3,537,829,0,3,1,3,0,1,0,76.14,64.78 ,33.33
03,016,01,001,0016,24,934,11,945,1369,0,3,1,3,0,1,0,76.14,69.03 ,33.33
03,016,01,001,0017,25,808,14,822,1125,0,3,1,3,0,1,0,76.14,73.07 ,33.33
03,016,01,001,0018,26,321,2,323,509,0,3,1,3,0,1,0,76.14,63.46 ,33.33
03,016,01,001,0019,27,342,3,345,467,0,3,1,3,0,1,0,76.14,73.88 ,33.33
03,016,01,001,0020,28,694,8,702,1026,0,3,1,3,0,1,0,76.14,68.42 ,33.33
03,016,01,001,0021,29,247,0,247,330,0,3,1,3,0,1,0,76.14,74.85 ,33.33
03,016,01,001,0022,30,768,12,780,1119,0,3,1,3,0,1,0,76.14,69.71 ,33.33
03,016,01,001,0023,31,305,5,310,434,0,3,1,3,0,1,0,76.14,71.43 ,33.33
03,016,01,001,0024,32,348,7,355,533,0,3,1,3,0,1,0,76.14,66.60 ,33.33
03,016,01,001,0025,33,484,3,487,770,0,3,1,3,0,1,0,76.14,63.25 ,33.33
03,016,01,001,0026,34,242,1,243,323,0,3,1,3,0,1,0,76.14,75.23 ,33.33
03,016,01,001,0027,35,559,8,567,895,0,3,1,3,0,1,0,76.14,63.35 ,33.33
03,016,01,001,0027,36,575,8,583,964,0,3,1,3,0,1,0,76.14,60.48 ,33.33
03,016,01,001,0028,37,821,6,827,1248,0,3,1,3,0,1,0,76.14,66.27 ,33.33
03,016,01,001,0029,38,113,2,115,171,0,3,1,3,0,1,0,76.14,67.25 ,33.33
03,016,01,001,0030,39,215,3,218,321,0,3,1,3,0,1,0,76.14,67.91 ,33.33
03,016,01,001,0031,40,799,5,804,967,0,3,1,3,0,1,0,76.14,83.14 ,33.33
03,016,01,001,0032,41,731,17,748,1080,0,3,1,3,0,1,0,76.14,69.26 ,33.33
03,016,01,001,0033,42,203,1,204,550,0,3,1,3,0,1,0,76.14,37.09 ,33.33
03,016,01,001,0034,43,54,0,54,147,0,3,1,3,0,1,0,76.14,36.73 ,33.33
03,016,01,002,0035,44,526,13,539,797,0,3,1,3,0,1,0,76.14,67.63 ,33.33
03,016,01,002,0036,45,168,4,172,262,0,3,1,3,0,1,0,76.14,65.65 ,33.33
03,016,01,002,0037,46,130,1,131,210,0,3,1,3,0,1,0,76.14,62.38 ,33.33
03,016,01,002,0038,47,153,5,158,244,0,3,1,3,0,1,0,76.14,64.75 ,33.33
03,016,01,002,0039,48,344,3,347,596,0,3,1,3,0,1,0,76.14,58.22 ,33.33
03,016,01,002,0040,49,179,0,179,264,0,3,1,3,0,1,0,76.14,67.80 ,33.33
03,016,01,002,0041,50,339,3,342,507,0,3,1,3,0,1,0,76.14,67.46 ,33.33
03,016,01,002,0042,51,239,7,246,404,0,3,1,3,0,1,0,76.14,60.89 ,33.33
03,016,01,002,0043,52,263,2,265,384,0,3,1,3,0,1,0,76.14,69.01 ,33.33
03,016,01,002,0044,53,72,1,73,108,0,3,1,3,0,1,0,76.14,67.59 ,33.33
03,016,01,002,0045,54,454,4,458,733,0,3,1,3,0,1,0,76.14,62.48 ,33.33
03,016,01,002,0046,55,101,1,102,160,0,3,1,3,0,1,0,76.14,63.75 ,33.33
03,016,01,002,0047,56,210,3,213,449,0,3,1,3,0,1,0,76.14,47.44 ,33.33
03,016,01,002,0048,57,176,3,179,230,0,3,1,3,0,1,0,76.14,77.83 ,33.33
03,016,01,002,0049,58,115,4,119,186,0,3,1,3,0,1,0,76.14,63.98 ,33.33
03,016,01,002,0050,59,127,1,128,192,0,3,1,3,0,1,0,76.14,66.67 ,33.33
03,016,01,002,0051,60,56,0,56,77,0,3,1,3,0,1,0,76.14,72.73 ,33.33
03,016,01,002,0052,61,401,4,405,617,0,3,1,3,0,1,0,76.14,65.64 ,33.33
03,016,01,002,0053,62,518,8,526,786,0,3,1,3,0,1,0,76.14,66.92 ,33.33
03,016,01,002,0054,63,286,4,290,461,0,3,1,3,0,1,0,76.14,62.91 ,33.33
03,016,01,002,0054,64,397,5,402,744,0,3,1,3,0,1,0,76.14,54.03 ,33.33
03,016,01,002,0055,65,379,4,383,746,0,3,1,3,0,1,0,76.14,51.34 ,33.33
03,016,01,002,0056,66,354,6,360,608,0,3,1,3,0,1,0,76.14,59.21 ,33.33
03,016,01,003,0057,67,270,4,274,408,0,3,1,3,0,1,0,76.14,67.16 ,33.33
03,016,01,003,0058,68,337,4,341,485,0,3,1,3,0,1,0,76.14,70.31 ,33.33
03,016,01,003,0059,69,63,0,63,87,0,3,1,3,0,1,0,76.14,72.41 ,33.33
03,016,01,003,0060,70,72,0,72,103,0,3,1,3,0,1,0,76.14,69.90 ,33.33
03,016,01,003,0061,71,170,3,173,264,0,3,1,3,0,1,0,76.14,65.53 ,33.33
03,016,01,003,0062,72,115,2,117,179,0,3,1,3,0,1,0,76.14,65.36 ,33.33
03,016,01,003,0063,73,106,2,108,160,0,3,1,3,0,1,0,76.14,67.50 ,33.33
03,016,01,003,0064,74,818,9,827,1235,0,3,1,3,0,1,0,76.14,66.96 ,33.33
03,016,01,003,0065,75,178,1,179,276,0,3,1,3,0,1,0,76.14,64.86 ,33.33
03,016,01,003,0066,76,362,2,364,640,0,3,1,3,0,1,0,76.14,56.88 ,33.33
03,016,01,003,0067,77,429,3,432,705,0,3,1,3,0,1,0,76.14,61.28 ,33.33
03,016,01,003,0068,78,443,5,448,1149,0,3,1,3,0,1,0,76.14,38.99 ,33.33
03,016,01,003,0069,79,379,2,381,828,0,3,1,3,0,1,0,76.14,46.01 ,33.33
03,016,01,003,0070,80,85,0,85,180,0,3,1,3,0,1,0,76.14,47.22 ,33.33
03,016,01,003,0071,81,86,0,86,158,0,3,1,3,0,1,0,76.14,54.43 ,33.33
03,016,01,004,0072,82,122,3,125,230,0,3,1,3,0,1,0,76.14,54.35 ,33.33
03,016,01,004,0073,83,230,2,232,422,0,3,1,3,0,1,0,76.14,54.98 ,33.33
03,016,01,004,0074,84,438,8,446,793,0,3,1,3,0,1,0,76.14,56.24 ,33.33
03,016,01,004,0075,85,151,0,151,242,0,3,1,3,0,1,0,76.14,62.40 ,33.33
03,016,01,004,0076,86,326,6,332,604,0,3,1,3,0,1,0,76.14,54.97 ,33.33
03,016,01,004,0077,87,51,1,52,104,0,3,1,3,0,1,0,76.14,50.00 ,33.33
03,016,01,004,0078,88,310,3,313,498,0,3,1,3,0,1,0,76.14,62.85 ,33.33
03,016,01,004,0079,89,111,1,112,202,0,3,1,3,0,1,0,76.14,55.45 ,33.33
03,016,01,004,0080,90,315,3,318,618,0,3,1,3,0,1,0,76.14,51.46 ,33.33
03,016,01,004,0081,91,669,6,675,1179,0,3,1,3,0,1,0,76.14,57.25 ,33.33
03,016,01,004,0082,92,391,4,395,762,0,3,1,3,0,1,0,76.14,51.84 ,33.33
03,016,01,004,0082,93,457,3,460,888,0,3,1,3,0,1,0,76.14,51.80 ,33.33
03,016,01,005,0083,94,168,7,175,371,0,3,1,3,0,1,0,76.14,47.17 ,33.33
03,016,01,005,0084,95,162,4,166,326,0,3,1,3,0,1,0,76.14,50.92 ,33.33
03,016,01,005,0085,96,87,2,89,198,0,3,1,3,0,1,0,76.14,44.95 ,33.33
03,016,01,005,0086,97,95,2,97,228,0,3,1,3,0,1,0,76.14,42.54 ,33.33
03,016,01,005,0087,98,470,6,476,1049,0,3,1,3,0,1,0,76.14,45.38 ,33.33
03,016,01,005,0088,99,16,0,16,66,0,3,1,3,0,1,0,76.14,24.24 ,33.33
03,016,01,005,0089,100,63,1,64,172,0,3,1,3,0,1,0,76.14,37.21 ,33.33
03,016,01,005,0090,101,41,0,41,104,0,3,1,3,0,1,0,76.14,39.42 ,33.33
03,016,01,005,0091,102,120,1,121,233,0,3,1,3,0,1,0,76.14,51.93 ,33.33
03,016,01,006,0092,103,110,3,113,230,0,3,1,3,0,1,0,76.14,49.13 ,33.33
03,016,01,006,0093,104,178,1,179,373,0,3,1,3,0,1,0,76.14,47.99 ,33.33
03,016,01,006,0094,105,207,2,209,422,0,3,1,3,0,1,0,76.14,49.53 ,33.33
03,016,01,006,0095,106,95,2,97,220,0,3,1,3,0,1,0,76.14,44.09 ,33.33
03,016,01,006,0096,107,91,0,91,238,0,3,1,3,0,1,0,76.14,38.24 ,33.33
03,016,01,006,0097,108,413,8,421,761,0,3,1,3,0,1,0,76.14,55.32 ,33.33
03,017,01,001,0001,1,505,11,516,754,0,3,1,3,0,1,0,76.14,68.44 ,33.33
03,017,01,001,0002,2,823,7,830,1373,0,3,1,3,0,1,0,76.14,60.45 ,33.33
03,017,01,001,0002,3,329,8,337,602,0,3,1,3,0,1,0,76.14,55.98 ,33.33
03,017,01,001,0003,4,1054,16,1070,1658,0,3,1,3,0,1,0,76.14,64.54 ,33.33
03,017,01,001,0004,5,729,17,746,1274,0,3,1,3,0,1,0,76.14,58.56 ,33.33
03,017,01,001,0004,6,389,6,395,894,0,3,1,3,0,1,0,76.14,44.18 ,33.33
03,017,01,001,0004,7,550,9,559,1052,0,3,1,3,0,1,0,76.14,53.14 ,33.33
03,017,01,001,0005,8,1073,15,1088,1667,0,3,1,3,0,1,0,76.14,65.27 ,33.33
03,017,01,001,0006,9,756,8,764,1183,0,3,1,3,0,1,0,76.14,64.58 ,33.33
03,017,01,001,0006,10,628,10,638,1004,0,3,1,3,0,1,0,76.14,63.55 ,33.33
03,017,01,001,0007,11,663,7,670,1033,0,3,1,3,0,1,0,76.14,64.86 ,33.33
03,017,01,001,0008,12,671,18,689,1088,0,3,1,3,0,1,0,76.14,63.33 ,33.33
03,017,01,001,0009,13,925,15,940,1466,0,3,1,3,0,1,0,76.14,64.12 ,33.33
03,017,01,001,0010,14,625,9,634,1038,0,3,1,3,0,1,0,76.14,61.08 ,33.33
03,017,01,001,0010,15,700,12,712,1116,0,3,1,3,0,1,0,76.14,63.80 ,33.33
03,017,01,001,0011,16,1013,7,1020,1638,0,3,1,3,0,1,0,76.14,62.27 ,33.33
03,017,01,001,0012,17,728,8,736,1141,0,3,1,3,0,1,0,76.14,64.50 ,33.33
03,017,01,001,0012,18,798,10,808,1144,0,3,1,3,0,1,0,76.14,70.63 ,33.33
03,017,01,001,0013,19,718,6,724,1165,0,3,1,3,0,1,0,76.14,62.15 ,33.33
03,017,01,001,0013,20,645,14,659,1044,0,3,1,3,0,1,0,76.14,63.12 ,33.33
03,017,01,001,0014,21,1004,13,1017,1578,0,3,1,3,0,1,0,76.14,64.45 ,33.33
03,017,01,001,0015,22,721,5,726,1087,0,3,1,3,0,1,0,76.14,66.79 ,33.33
03,017,01,001,0015,23,870,7,877,1385,0,3,1,3,0,1,0,76.14,63.32 ,33.33
03,017,01,001,0016,24,1046,11,1057,1584,0,3,1,3,0,1,0,76.14,66.73 ,33.33
03,017,01,001,0017,25,958,15,973,1529,0,3,1,3,0,1,0,76.14,63.64 ,33.33
03,017,01,001,0018,26,1040,11,1051,1667,0,3,1,3,0,1,0,76.14,63.05 ,33.33
03,017,01,001,0019,27,999,12,1011,1615,0,3,1,3,0,1,0,76.14,62.60 ,33.33
03,017,01,001,0020,28,915,14,929,1412,0,3,1,3,0,1,0,76.14,65.79 ,33.33
03,017,01,001,0021,29,829,11,840,1299,0,3,1,3,0,1,0,76.14,64.67 ,33.33
03,017,01,001,0022,30,788,12,800,1222,0,3,1,3,0,1,0,76.14,65.47 ,33.33
03,017,01,001,0023,31,974,10,984,1517,0,3,1,3,0,1,0,76.14,64.86 ,33.33
03,017,01,001,0024,32,618,5,623,912,0,3,1,3,0,1,0,76.14,68.31 ,33.33
03,017,01,002,0025,33,1017,22,1039,1649,0,3,1,3,0,1,0,76.14,63.01 ,33.33
03,017,01,002,0025,34,1428,17,1445,2261,0,3,1,3,0,1,0,76.14,63.91 ,33.33
03,017,01,002,0026,35,776,20,796,1195,0,3,1,3,0,1,0,76.14,66.61 ,33.33
03,017,01,002,0026,36,572,6,578,856,0,3,1,3,0,1,0,76.14,67.52 ,33.33
03,017,01,002,0027,37,905,14,919,1454,0,3,1,3,0,1,0,76.14,63.20 ,33.33
03,017,01,002,0027,38,596,13,609,842,0,3,1,3,0,1,0,76.14,72.33 ,33.33
03,017,01,002,0028,39,1223,13,1236,1869,0,3,1,3,0,1,0,76.14,66.13 ,33.33
03,017,01,002,0028,40,1180,20,1200,1771,0,3,1,3,0,1,0,76.14,67.76 ,33.33
03,017,01,002,0029,41,743,5,748,1158,0,3,1,3,0,1,0,76.14,64.59 ,33.33
03,017,01,002,0029,42,723,10,733,1093,0,3,1,3,0,1,0,76.14,67.06 ,33.33
03,017,01,002,0030,43,872,12,884,1309,0,3,1,3,0,1,0,76.14,67.53 ,33.33
03,017,01,002,0030,44,638,13,651,967,0,3,1,3,0,1,0,76.14,67.32 ,33.33
03,017,01,002,0031,45,157,4,161,274,0,3,1,3,0,1,0,76.14,58.76 ,33.33
03,017,01,002,0031,46,774,6,780,1268,0,3,1,3,0,1,0,76.14,61.51 ,33.33
03,017,01,002,0032,47,499,6,505,873,0,3,1,3,0,1,0,76.14,57.85 ,33.33
03,017,01,002,0033,48,737,10,747,1183,0,3,1,3,0,1,0,76.14,63.14 ,33.33
03,017,01,002,0033,49,677,11,688,1087,0,3,1,3,0,1,0,76.14,63.29 ,33.33
03,017,01,002,0034,50,650,11,661,1068,0,3,1,3,0,1,0,76.14,61.89 ,33.33
03,017,01,002,0035,51,770,5,775,1281,0,3,1,3,0,1,0,76.14,60.50 ,33.33
03,017,01,002,0035,52,803,8,811,1398,0,3,1,3,0,1,0,76.14,58.01 ,33.33
03,017,01,002,0036,53,682,14,696,1147,0,3,1,3,0,1,0,76.14,60.68 ,33.33
03,017,01,002,0036,54,773,21,794,1295,0,3,1,3,0,1,0,76.14,61.31 ,33.33
03,017,01,002,0037,55,1075,14,1089,1744,0,3,1,3,0,1,0,76.14,62.44 ,33.33
03,017,01,002,0037,56,931,17,948,1638,0,3,1,3,0,1,0,76.14,57.88 ,33.33
03,017,01,002,0038,57,873,15,888,1485,0,3,1,3,0,1,0,76.14,59.80 ,33.33
03,017,01,002,0038,58,990,13,1003,1679,0,3,1,3,0,1,0,76.14,59.74 ,33.33
03,017,01,002,0039,59,285,3,288,432,0,3,1,3,0,1,0,76.14,66.67 ,33.33
03,017,01,002,0040,60,208,4,212,344,0,3,1,3,0,1,0,76.14,61.63 ,33.33
03,017,01,002,0041,61,277,2,279,396,0,3,1,3,0,1,0,76.14,70.45 ,33.33
03,017,01,002,0042,62,563,5,568,884,0,3,1,3,0,1,0,76.14,64.25 ,33.33
03,017,01,002,0043,63,290,0,290,440,0,3,1,3,0,1,0,76.14,65.91 ,33.33
03,017,01,003,0044,64,789,20,809,1267,0,3,1,3,0,1,0,76.14,63.85 ,33.33
03,017,01,003,0045,65,433,13,446,691,0,3,1,3,0,1,0,76.14,64.54 ,33.33
03,017,01,003,0046,66,622,9,631,943,0,3,1,3,0,1,0,76.14,66.91 ,33.33
03,017,01,003,0047,67,356,4,360,573,0,3,1,3,0,1,0,76.14,62.83 ,33.33
03,017,01,003,0048,68,927,18,945,1466,0,3,1,3,0,1,0,76.14,64.46 ,33.33
03,017,01,003,0048,69,846,12,858,1250,0,3,1,3,0,1,0,76.14,68.64 ,33.33
03,017,01,003,0049,70,632,9,641,972,0,3,1,3,0,1,0,76.14,65.95 ,33.33
03,017,01,003,0049,71,611,5,616,933,0,3,1,3,0,1,0,76.14,66.02 ,33.33
03,017,01,003,0050,72,1079,17,1096,1664,0,3,1,3,0,1,0,76.14,65.87 ,33.33
03,017,01,003,0051,73,272,3,275,396,0,3,1,3,0,1,0,76.14,69.44 ,33.33
03,017,01,003,0052,74,1096,23,1119,1745,0,3,1,3,0,1,0,76.14,64.13 ,33.33
03,017,01,003,0052,75,783,14,797,1295,0,3,1,3,0,1,0,76.14,61.54 ,33.33
03,017,01,003,0053,76,582,9,591,863,0,3,1,3,0,1,0,76.14,68.48 ,33.33
03,017,01,003,0053,77,706,18,724,1101,0,3,1,3,0,1,0,76.14,65.76 ,33.33
03,017,01,003,0054,78,1693,21,1714,2619,0,3,1,3,0,1,0,76.14,65.44 ,33.33
03,017,01,003,0055,79,910,11,921,1393,0,3,1,3,0,1,0,76.14,66.12 ,33.33
03,017,01,003,0055,80,1018,14,1032,1459,0,3,1,3,0,1,0,76.14,70.73 ,33.33
03,017,01,004,0056,81,561,7,568,904,0,3,1,3,0,1,0,76.14,62.83 ,33.33
03,017,01,004,0056,82,701,11,712,1084,0,3,1,3,0,1,0,76.14,65.68 ,33.33
03,017,01,004,0057,83,762,12,774,1049,0,3,1,3,0,1,0,76.14,73.78 ,33.33
03,017,01,004,0058,84,1154,17,1171,1717,0,3,1,3,0,1,0,76.14,68.20 ,33.33
03,017,01,004,0059,85,1272,21,1293,1934,0,3,1,3,0,1,0,76.14,66.86 ,33.33
03,017,01,004,0060,86,900,9,909,1345,0,3,1,3,0,1,0,76.14,67.58 ,33.33
03,017,01,004,0060,87,814,9,823,1211,0,3,1,3,0,1,0,76.14,67.96 ,33.33
03,017,01,004,0061,88,882,11,893,1350,0,3,1,3,0,1,0,76.14,66.15 ,33.33
03,017,01,004,0062,89,772,10,782,1213,0,3,1,3,0,1,0,76.14,64.47 ,33.33
03,017,01,004,0063,90,880,7,887,1273,0,3,1,3,0,1,0,76.14,69.68 ,33.33
03,017,01,004,0064,91,793,7,800,1168,0,3,1,3,0,1,0,76.14,68.49 ,33.33
03,017,01,004,0065,92,850,10,860,1234,0,3,1,3,0,1,0,76.14,69.69 ,33.33
03,017,01,004,0065,93,415,8,423,576,0,3,1,3,0,1,0,76.14,73.44 ,33.33
03,017,01,004,0066,94,632,4,636,976,0,3,1,3,0,1,0,76.14,65.16 ,33.33
03,017,01,004,0067,95,727,19,746,1134,0,3,1,3,0,1,0,76.14,65.78 ,33.33
03,017,01,004,0068,96,1102,10,1112,1633,0,3,1,3,0,1,0,76.14,68.10 ,33.33
03,017,01,004,0068,97,1102,23,1125,1725,0,3,1,3,0,1,0,76.14,65.22 ,33.33
03,017,01,004,0069,98,591,5,596,922,0,3,1,3,0,1,0,76.14,64.64 ,33.33
03,017,01,004,0070,99,566,2,568,866,0,3,1,3,0,1,0,76.14,65.59 ,33.33
03,017,01,004,0070,100,506,10,516,806,0,3,1,3,0,1,0,76.14,64.02 ,33.33
03,017,01,004,0071,101,595,14,609,963,0,3,1,3,0,1,0,76.14,63.24 ,33.33
03,017,01,004,0072,102,913,14,927,1335,0,3,1,3,0,1,0,76.14,69.44 ,33.33
03,017,01,004,0073,103,735,4,739,1055,0,3,1,3,0,1,0,76.14,70.05 ,33.33
03,017,01,004,0074,104,653,8,661,1001,0,3,1,3,0,1,0,76.14,66.03 ,33.33
03,017,01,004,0075,105,865,10,875,1288,0,3,1,3,0,1,0,76.14,67.93 ,33.33
03,017,01,004,0076,106,524,11,535,792,0,3,1,3,0,1,0,76.14,67.55 ,33.33
03,017,01,004,0077,107,910,8,918,1343,0,3,1,3,0,1,0,76.14,68.35 ,33.33
03,017,01,004,0078,108,913,10,923,1296,0,3,1,3,0,1,0,76.14,71.22 ,33.33
03,017,01,004,0079,109,576,8,584,874,0,3,1,3,0,1,0,76.14,66.82 ,33.33
03,017,01,004,0079,110,615,19,634,996,0,3,1,3,0,1,0,76.14,63.65 ,33.33
03,017,01,004,0080,111,582,3,585,865,0,3,1,3,0,1,0,76.14,67.63 ,33.33
03,017,01,004,0080,112,821,11,832,1196,0,3,1,3,0,1,0,76.14,69.57 ,33.33
03,017,01,004,0081,113,584,9,593,840,0,3,1,3,0,1,0,76.14,70.60 ,33.33
03,017,01,004,0082,114,545,7,552,783,0,3,1,3,0,1,0,76.14,70.50 ,33.33
03,017,01,004,0083,115,665,6,671,953,0,3,1,3,0,1,0,76.14,70.41 ,33.33
03,017,01,004,0084,116,605,14,619,902,0,3,1,3,0,1,0,76.14,68.63 ,33.33
03,017,01,005,0085,117,647,5,652,937,0,3,1,3,0,1,0,76.14,69.58 ,33.33
03,017,01,005,0086,118,840,8,848,1255,0,3,1,3,0,1,0,76.14,67.57 ,33.33
03,017,01,005,0087,119,697,19,716,1046,0,3,1,3,0,1,0,76.14,68.45 ,33.33
03,017,01,005,0088,120,862,10,872,1276,0,3,1,3,0,1,0,76.14,68.34 ,33.33
03,017,01,005,0089,121,773,12,785,1202,0,3,1,3,0,1,0,76.14,65.31 ,33.33
03,017,01,005,0090,122,1047,12,1059,1559,0,3,1,3,0,1,0,76.14,67.93 ,33.33
03,017,01,005,0091,123,607,11,618,915,0,3,1,3,0,1,0,76.14,67.54 ,33.33
03,017,01,005,0092,124,1202,21,1223,1811,0,3,1,3,0,1,0,76.14,67.53 ,33.33
03,017,01,005,0093,125,938,15,953,1419,0,3,1,3,0,1,0,76.14,67.16 ,33.33
03,017,01,005,0094,126,643,6,649,968,0,3,1,3,0,1,0,76.14,67.05 ,33.33
03,017,01,005,0094,127,618,7,625,1038,0,3,1,3,0,1,0,76.14,60.21 ,33.33
03,017,01,005,0095,128,969,15,984,1412,0,3,1,3,0,1,0,76.14,69.69 ,33.33
03,017,01,005,0095,129,558,17,575,814,0,3,1,3,0,1,0,76.14,70.64 ,33.33
03,017,01,005,0096,130,593,5,598,880,0,3,1,3,0,1,0,76.14,67.95 ,33.33
03,017,01,005,0097,131,542,8,550,897,0,3,1,3,0,1,0,76.14,61.32 ,33.33
03,017,01,005,0098,132,744,15,759,1108,0,3,1,3,0,1,0,76.14,68.50 ,33.33
03,017,01,005,0099,133,450,3,453,654,0,3,1,3,0,1,0,76.14,69.27 ,33.33
03,017,01,005,0099,134,712,16,728,1068,0,3,1,3,0,1,0,76.14,68.16 ,33.33
03,017,01,005,0100,135,784,16,800,1173,0,3,1,3,0,1,0,76.14,68.20 ,33.33
03,017,01,005,0101,136,1409,24,1433,2212,0,3,1,3,0,1,0,76.14,64.78 ,33.33
03,017,01,005,0102,137,1283,18,1301,1913,0,3,1,3,0,1,0,76.14,68.01 ,33.33
03,017,01,005,0102,138,884,15,899,1247,0,3,1,3,0,1,0,76.14,72.09 ,33.33
03,017,01,005,0103,139,927,18,945,1456,0,3,1,3,0,1,0,76.14,64.90 ,33.33
03,017,01,005,0103,140,697,15,712,1194,0,3,1,3,0,1,0,76.14,59.63 ,33.33
03,017,01,005,0104,141,1272,26,1298,2007,0,3,1,3,0,1,0,76.14,64.67 ,33.33
03,017,01,005,0105,142,760,7,767,1154,0,3,1,3,0,1,0,76.14,66.46 ,33.33
03,017,01,005,0106,143,802,8,810,1199,0,3,1,3,0,1,0,76.14,67.56 ,33.33
03,017,01,005,0107,144,645,8,653,957,0,3,1,3,0,1,0,76.14,68.23 ,33.33
03,017,01,006,0108,145,1151,11,1162,1824,0,3,1,3,0,1,0,76.14,63.71 ,33.33
03,017,01,006,0109,146,1010,15,1025,1571,0,3,1,3,0,1,0,76.14,65.25 ,33.33
03,017,01,006,0110,147,893,13,906,1412,0,3,1,3,0,1,0,76.14,64.16 ,33.33
03,017,01,006,0111,148,965,23,988,1511,0,3,1,3,0,1,0,76.14,65.39 ,33.33
03,017,01,006,0112,149,1149,12,1161,1746,0,3,1,3,0,1,0,76.14,66.49 ,33.33
03,017,01,006,0112,150,642,12,654,926,0,3,1,3,0,1,0,76.14,70.63 ,33.33
03,017,01,006,0113,151,964,19,983,1588,0,3,1,3,0,1,0,76.14,61.90 ,33.33
03,017,01,006,0113,152,363,4,367,546,0,3,1,3,0,1,0,76.14,67.22 ,33.33
03,017,01,006,0114,153,713,14,727,1168,0,3,1,3,0,1,0,76.14,62.24 ,33.33
03,017,01,006,0115,154,639,8,647,950,0,3,1,3,0,1,0,76.14,68.11 ,33.33
03,017,01,006,0116,155,608,19,627,853,0,3,1,3,0,1,0,76.14,73.51 ,33.33
03,017,01,006,0117,156,1120,15,1135,1763,0,3,1,3,0,1,0,76.14,64.38 ,33.33
03,017,01,006,0117,157,1063,15,1078,1682,0,3,1,3,0,1,0,76.14,64.09 ,33.33
03,017,01,006,0118,158,927,7,934,1321,0,3,1,3,0,1,0,76.14,70.70 ,33.33
03,017,01,006,0118,159,779,7,786,1253,0,3,1,3,0,1,0,76.14,62.73 ,33.33
03,017,01,006,0119,160,1063,13,1076,1592,0,3,1,3,0,1,0,76.14,67.59 ,33.33
03,017,01,006,0119,161,930,13,943,1463,0,3,1,3,0,1,0,76.14,64.46 ,33.33
03,017,01,006,0120,162,1198,22,1220,1759,0,3,1,3,0,1,0,76.14,69.36 ,33.33
03,017,01,006,0120,163,1132,13,1145,1716,0,3,1,3,0,1,0,76.14,66.72 ,33.33
03,017,01,006,0121,164,1024,17,1041,1514,0,3,1,3,0,1,0,76.14,68.76 ,33.33
03,017,01,006,0122,165,1098,20,1118,1646,0,3,1,3,0,1,0,76.14,67.92 ,33.33
03,017,01,006,0122,166,1270,31,1301,1872,0,3,1,3,0,1,0,76.14,69.50 ,33.33
03,017,01,006,0123,167,1118,7,1125,1720,0,3,1,3,0,1,0,76.14,65.41 ,33.33
03,017,01,006,0123,168,1206,17,1223,1803,0,3,1,3,0,1,0,76.14,67.83 ,33.33
03,017,01,006,0124,169,977,22,999,1597,0,3,1,3,0,1,0,76.14,62.55 ,33.33
03,017,01,006,0124,170,665,7,672,1177,0,3,1,3,0,1,0,76.14,57.09 ,33.33
03,017,01,006,0125,171,1409,24,1433,2369,0,3,1,3,0,1,0,76.14,60.49 ,33.33
03,017,01,006,0125,172,292,4,296,503,0,3,1,3,0,1,0,76.14,58.85 ,33.33
03,017,01,006,0126,173,631,10,641,1081,0,3,1,3,0,1,0,76.14,59.30 ,33.33
03,017,01,006,0127,174,564,8,572,917,0,3,1,3,0,1,0,76.14,62.38 ,33.33
03,017,01,006,0127,175,752,10,762,1276,0,3,1,3,0,1,0,76.14,59.72 ,33.33
03,017,01,007,0128,176,853,11,864,1264,0,3,1,3,0,1,0,76.14,68.35 ,33.33
03,017,01,007,0129,177,978,13,991,1333,0,3,1,3,0,1,0,76.14,74.34 ,33.33
03,017,01,007,0130,178,839,5,844,1222,0,3,1,3,0,1,0,76.14,69.07 ,33.33
03,017,01,007,0131,179,963,12,975,1339,0,3,1,3,0,1,0,76.14,72.82 ,33.33
03,017,01,007,0131,180,871,14,885,1217,0,3,1,3,0,1,0,76.14,72.72 ,33.33
03,017,01,007,0132,181,620,7,627,896,0,3,1,3,0,1,0,76.14,69.98 ,33.33
03,017,01,007,0133,182,1012,14,1026,1495,0,3,1,3,0,1,0,76.14,68.63 ,33.33
03,017,01,007,0134,183,585,7,592,826,0,3,1,3,0,1,0,76.14,71.67 ,33.33
03,017,01,007,0135,184,531,8,539,790,0,3,1,3,0,1,0,76.14,68.23 ,33.33
03,017,01,007,0135,185,790,9,799,1119,0,3,1,3,0,1,0,76.14,71.40 ,33.33
03,017,01,007,0136,186,1079,14,1093,1592,0,3,1,3,0,1,0,76.14,68.66 ,33.33
03,017,01,007,0137,187,1139,12,1151,1694,0,3,1,3,0,1,0,76.14,67.95 ,33.33
03,017,01,007,0138,188,1190,8,1198,1709,0,3,1,3,0,1,0,76.14,70.10 ,33.33
03,017,01,007,0138,189,461,9,470,703,0,3,1,3,0,1,0,76.14,66.86 ,33.33
03,017,01,007,0139,190,681,7,688,1020,0,3,1,3,0,1,0,76.14,67.45 ,33.33
03,017,01,007,0139,191,733,9,742,1152,0,3,1,3,0,1,0,76.14,64.41 ,33.33
03,017,01,007,0140,192,1142,13,1155,1660,0,3,1,3,0,1,0,76.14,69.58 ,33.33
03,017,01,007,0141,193,975,18,993,1453,0,3,1,3,0,1,0,76.14,68.34 ,33.33
03,017,01,007,0141,194,733,14,747,1307,0,3,1,3,0,1,0,76.14,57.15 ,33.33
03,017,01,007,0142,195,940,14,954,1397,0,3,1,3,0,1,0,76.14,68.29 ,33.33
03,017,01,007,0142,196,947,16,963,1369,0,3,1,3,0,1,0,76.14,70.34 ,33.33
03,017,01,007,0143,197,1318,11,1329,1989,0,3,1,3,0,1,0,76.14,66.82 ,33.33
03,017,01,007,0143,198,1147,22,1169,1832,0,3,1,3,0,1,0,76.14,63.81 ,33.33
03,017,01,007,0144,199,456,4,460,748,0,3,1,3,0,1,0,76.14,61.50 ,33.33
03,018,01,001,0001,1,661,4,665,1121,0,3,1,3,0,1,0,76.14,59.32 ,33.33
03,018,01,001,0002,2,562,8,570,952,0,3,1,3,0,1,0,76.14,59.87 ,33.33
03,018,01,001,0002,3,610,3,613,962,0,3,1,3,0,1,0,76.14,63.72 ,33.33
03,018,01,001,0003,4,528,5,533,884,0,3,1,3,0,1,0,76.14,60.29 ,33.33
03,018,01,001,0004,5,491,4,495,873,0,3,1,3,0,1,0,76.14,56.70 ,33.33
03,018,01,001,0005,6,329,3,332,584,0,3,1,3,0,1,0,76.14,56.85 ,33.33
03,018,01,001,0006,7,350,2,352,630,0,3,1,3,0,1,0,76.14,55.87 ,33.33
03,018,01,001,0007,8,807,12,819,1281,0,3,1,3,0,1,0,76.14,63.93 ,33.33
03,018,01,001,0007,9,401,3,404,589,0,3,1,3,0,1,0,76.14,68.59 ,33.33
03,018,01,001,0008,10,625,5,630,1002,0,3,1,3,0,1,0,76.14,62.87 ,33.33
03,018,01,001,0008,11,589,14,603,919,0,3,1,3,0,1,0,76.14,65.61 ,33.33
03,018,01,001,0008,12,551,6,557,962,0,3,1,3,0,1,0,76.14,57.90 ,33.33
03,018,01,001,0009,13,907,9,916,1529,0,3,1,3,0,1,0,76.14,59.91 ,33.33
03,018,01,001,0009,14,934,10,944,1567,0,3,1,3,0,1,0,76.14,60.24 ,33.33
03,018,01,001,0010,15,597,8,605,1085,0,3,1,3,0,1,0,76.14,55.76 ,33.33
03,018,01,001,0010,16,794,12,806,1303,0,3,1,3,0,1,0,76.14,61.86 ,33.33
03,018,01,001,0011,17,682,9,691,1146,0,3,1,3,0,1,0,76.14,60.30 ,33.33
03,018,01,001,0011,18,846,7,853,1332,0,3,1,3,0,1,0,76.14,64.04 ,33.33
03,018,01,001,0011,19,644,8,652,1082,0,3,1,3,0,1,0,76.14,60.26 ,33.33
03,018,01,001,0012,20,483,7,490,799,0,3,1,3,0,1,0,76.14,61.33 ,33.33
03,018,01,001,0012,21,661,3,664,1070,0,3,1,3,0,1,0,76.14,62.06 ,33.33
03,018,01,001,0013,22,510,2,512,888,0,3,1,3,0,1,0,76.14,57.66 ,33.33
03,018,01,001,0013,23,558,6,564,917,0,3,1,3,0,1,0,76.14,61.50 ,33.33
03,018,01,001,0014,24,700,8,708,1204,0,3,1,3,0,1,0,76.14,58.80 ,33.33
03,018,01,001,0014,25,540,3,543,904,0,3,1,3,0,1,0,76.14,60.07 ,33.33
03,018,01,001,0015,26,1023,11,1034,1677,0,3,1,3,0,1,0,76.14,61.66 ,33.33
03,018,01,001,0015,27,655,5,660,1092,0,3,1,3,0,1,0,76.14,60.44 ,33.33
03,018,01,001,0016,28,765,9,774,1222,0,3,1,3,0,1,0,76.14,63.34 ,33.33
03,018,01,001,0016,29,926,11,937,1541,0,3,1,3,0,1,0,76.14,60.80 ,33.33
03,018,01,001,0016,30,713,6,719,1081,0,3,1,3,0,1,0,76.14,66.51 ,33.33
03,018,01,001,0017,31,901,12,913,1620,0,3,1,3,0,1,0,76.14,56.36 ,33.33
03,018,01,001,0018,32,584,6,590,984,0,3,1,3,0,1,0,76.14,59.96 ,33.33
03,018,01,001,0019,33,689,21,710,1383,0,3,1,3,0,1,0,76.14,51.34 ,33.33
03,018,01,001,0019,34,464,14,478,821,0,3,1,3,0,1,0,76.14,58.22 ,33.33
03,018,01,001,0020,35,802,18,820,1373,0,3,1,3,0,1,0,76.14,59.72 ,33.33
03,018,01,001,0020,36,858,11,869,1430,0,3,1,3,0,1,0,76.14,60.77 ,33.33
03,018,01,001,0021,37,867,26,893,1394,0,3,1,3,0,1,0,76.14,64.06 ,33.33
03,018,01,001,0022,38,928,11,939,1491,0,3,1,3,0,1,0,76.14,62.98 ,33.33
03,018,01,001,0022,39,815,11,826,1222,0,3,1,3,0,1,0,76.14,67.59 ,33.33
03,018,01,001,0023,40,519,4,523,785,0,3,1,3,0,1,0,76.14,66.62 ,33.33
03,018,01,001,0024,41,320,6,326,539,0,3,1,3,0,1,0,76.14,60.48 ,33.33
03,018,01,001,0025,42,952,14,966,1385,0,3,1,3,0,1,0,76.14,69.75 ,33.33
03,018,01,001,0025,43,1020,9,1029,1562,0,3,1,3,0,1,0,76.14,65.88 ,33.33
03,018,01,001,0026,44,833,14,847,1249,0,3,1,3,0,1,0,76.14,67.81 ,33.33
03,018,01,001,0027,45,1101,15,1116,1580,0,3,1,3,0,1,0,76.14,70.63 ,33.33
03,018,01,001,0027,46,532,2,534,764,0,3,1,3,0,1,0,76.14,69.90 ,33.33
03,018,01,001,0028,47,671,5,676,1071,0,3,1,3,0,1,0,76.14,63.12 ,33.33
03,018,01,001,0028,48,431,1,432,659,0,3,1,3,0,1,0,76.14,65.55 ,33.33
03,018,01,001,0028,49,474,4,478,761,0,3,1,3,0,1,0,76.14,62.81 ,33.33
03,018,01,001,0029,50,744,7,751,1203,0,3,1,3,0,1,0,76.14,62.43 ,33.33
03,018,01,001,0029,51,515,7,522,794,0,3,1,3,0,1,0,76.14,65.74 ,33.33
03,018,01,001,0030,52,954,6,960,1465,0,3,1,3,0,1,0,76.14,65.53 ,33.33
03,018,01,001,0030,53,984,10,994,1509,0,3,1,3,0,1,0,76.14,65.87 ,33.33
03,018,01,001,0030,54,851,11,862,1250,0,3,1,3,0,1,0,76.14,68.96 ,33.33
03,018,01,001,0031,55,985,23,1008,1730,0,3,1,3,0,1,0,76.14,58.27 ,33.33
03,018,01,001,0032,56,1015,11,1026,1761,0,3,1,3,0,1,0,76.14,58.26 ,33.33
03,018,01,001,0032,57,1189,22,1211,1900,0,3,1,3,0,1,0,76.14,63.74 ,33.33
03,018,01,001,0033,58,1026,17,1043,1725,0,3,1,3,0,1,0,76.14,60.46 ,33.33
03,018,01,001,0033,59,841,10,851,1404,0,3,1,3,0,1,0,76.14,60.61 ,33.33
03,018,01,001,0034,60,382,1,383,681,0,3,1,3,0,1,0,76.14,56.24 ,33.33
03,018,01,001,0034,61,480,5,485,740,0,3,1,3,0,1,0,76.14,65.54 ,33.33
03,018,01,001,0034,62,616,8,624,906,0,3,1,3,0,1,0,76.14,68.87 ,33.33
03,018,01,001,0035,63,685,7,692,1148,0,3,1,3,0,1,0,76.14,60.28 ,33.33
03,018,01,001,0035,64,711,6,717,1131,0,3,1,3,0,1,0,76.14,63.40 ,33.33
03,018,01,001,0036,65,297,5,302,532,0,3,1,3,0,1,0,76.14,56.77 ,33.33
03,018,01,001,0037,66,365,6,371,668,0,3,1,3,0,1,0,76.14,55.54 ,33.33
03,018,01,001,0038,67,410,5,415,690,0,3,1,3,0,1,0,76.14,60.14 ,33.33
03,018,01,001,0039,68,569,11,580,981,0,3,1,3,0,1,0,76.14,59.12 ,33.33
03,018,01,001,0040,69,733,12,745,1248,0,3,1,3,0,1,0,76.14,59.70 ,33.33
03,018,01,001,0041,70,651,8,659,1134,0,3,1,3,0,1,0,76.14,58.11 ,33.33
03,018,01,001,0041,71,760,9,769,1345,0,3,1,3,0,1,0,76.14,57.17 ,33.33
03,018,01,001,0041,72,535,8,543,1009,0,3,1,3,0,1,0,76.14,53.82 ,33.33
03,018,01,001,0042,73,941,18,959,1575,0,3,1,3,0,1,0,76.14,60.89 ,33.33
03,018,01,001,0042,74,857,13,870,1551,0,3,1,3,0,1,0,76.14,56.09 ,33.33
03,018,01,001,0043,75,466,6,472,862,0,3,1,3,0,1,0,76.14,54.76 ,33.33
03,018,01,001,0044,76,530,5,535,896,0,3,1,3,0,1,0,76.14,59.71 ,33.33
03,018,01,001,0045,77,809,14,823,1305,0,3,1,3,0,1,0,76.14,63.07 ,33.33
03,018,01,001,0046,78,875,9,884,1547,0,3,1,3,0,1,0,76.14,57.14 ,33.33
03,018,01,001,0046,79,891,7,898,1566,0,3,1,3,0,1,0,76.14,57.34 ,33.33
03,018,01,001,0047,80,354,5,359,719,0,3,1,3,0,1,0,76.14,49.93 ,33.33
03,018,01,001,0047,81,526,9,535,960,0,3,1,3,0,1,0,76.14,55.73 ,33.33
03,018,01,001,0048,82,721,12,733,1338,0,3,1,3,0,1,0,76.14,54.78 ,33.33
03,018,01,001,0048,83,632,7,639,1021,0,3,1,3,0,1,0,76.14,62.59 ,33.33
03,018,01,001,0049,84,728,13,741,1285,0,3,1,3,0,1,0,76.14,57.67 ,33.33
03,018,01,001,0049,85,771,12,783,1336,0,3,1,3,0,1,0,76.14,58.61 ,33.33
03,018,01,001,0050,86,1079,12,1091,1801,0,3,1,3,0,1,0,76.14,60.58 ,33.33
03,018,01,001,0050,87,577,8,585,1073,0,3,1,3,0,1,0,76.14,54.52 ,33.33
03,018,01,001,0050,88,643,8,651,1197,0,3,1,3,0,1,0,76.14,54.39 ,33.33
03,018,01,001,0051,89,721,6,727,1391,0,3,1,3,0,1,0,76.14,52.26 ,33.33
03,018,01,001,0051,90,599,6,605,1022,0,3,1,3,0,1,0,76.14,59.20 ,33.33
03,018,01,001,0051,91,715,7,722,1192,0,3,1,3,0,1,0,76.14,60.57 ,33.33
03,018,01,001,0051,92,838,14,852,1575,0,3,1,3,0,1,0,76.14,54.10 ,33.33
03,018,01,002,0052,93,314,3,317,558,0,3,1,3,0,1,0,76.14,56.81 ,33.33
03,018,01,002,0053,94,446,2,448,771,0,3,1,3,0,1,0,76.14,58.11 ,33.33
03,018,01,002,0054,95,359,2,361,601,0,3,1,3,0,1,0,76.14,60.07 ,33.33
03,018,01,002,0055,96,298,4,302,499,0,3,1,3,0,1,0,76.14,60.52 ,33.33
03,018,01,002,0056,97,524,11,535,938,0,3,1,3,0,1,0,76.14,57.04 ,33.33
03,018,01,002,0057,98,699,7,706,1112,0,3,1,3,0,1,0,76.14,63.49 ,33.33
03,018,01,002,0058,99,809,8,817,1374,0,3,1,3,0,1,0,76.14,59.46 ,33.33
03,018,01,002,0059,100,413,5,418,708,0,3,1,3,0,1,0,76.14,59.04 ,33.33
03,018,01,002,0059,101,897,12,909,1538,0,3,1,3,0,1,0,76.14,59.10 ,33.33
03,018,01,002,0059,102,850,14,864,1535,0,3,1,3,0,1,0,76.14,56.29 ,33.33
03,018,01,002,0060,103,510,6,516,892,0,3,1,3,0,1,0,76.14,57.85 ,33.33
03,018,01,002,0060,104,1122,22,1144,1845,0,3,1,3,0,1,0,76.14,62.01 ,33.33
03,018,01,002,0060,105,465,17,482,593,0,3,1,3,0,1,0,76.14,81.28 ,33.33
03,018,01,002,0060,106,572,10,582,797,0,3,1,3,0,1,0,76.14,73.02 ,33.33
03,018,01,002,0060,107,681,8,689,1216,0,3,1,3,0,1,0,76.14,56.66 ,33.33
03,018,01,002,0061,108,649,9,658,1161,0,3,1,3,0,1,0,76.14,56.68 ,33.33
03,018,01,002,0061,109,720,8,728,1289,0,3,1,3,0,1,0,76.14,56.48 ,33.33
03,018,01,002,0062,110,595,5,600,925,0,3,1,3,0,1,0,76.14,64.86 ,33.33
03,018,01,002,0062,111,753,2,755,1088,0,3,1,3,0,1,0,76.14,69.39 ,33.33
03,018,01,002,0062,112,631,13,644,1181,0,3,1,3,0,1,0,76.14,54.53 ,33.33
03,018,01,002,0063,113,537,8,545,886,0,3,1,3,0,1,0,76.14,61.51 ,33.33
03,018,01,002,0063,114,764,13,777,1263,0,3,1,3,0,1,0,76.14,61.52 ,33.33
03,018,01,002,0063,115,557,7,564,946,0,3,1,3,0,1,0,76.14,59.62 ,33.33
03,018,01,002,0064,116,699,14,713,947,0,3,1,3,0,1,0,76.14,75.29 ,33.33
03,018,01,002,0064,117,579,2,581,744,0,3,1,3,0,1,0,76.14,78.09 ,33.33
03,018,01,002,0065,118,511,4,515,862,0,3,1,3,0,1,0,76.14,59.74 ,33.33
03,018,01,002,0066,119,423,3,426,696,0,3,1,3,0,1,0,76.14,61.21 ,33.33
03,018,01,002,0067,120,335,6,341,625,0,3,1,3,0,1,0,76.14,54.56 ,33.33
03,018,01,002,0068,121,731,14,745,1299,0,3,1,3,0,1,0,76.14,57.35 ,33.33
03,018,01,002,0069,122,582,10,592,960,0,3,1,3,0,1,0,76.14,61.67 ,33.33
03,018,01,002,0070,123,578,5,583,995,0,3,1,3,0,1,0,76.14,58.59 ,33.33
03,018,01,002,0071,124,643,7,650,1156,0,3,1,3,0,1,0,76.14,56.23 ,33.33
03,018,01,002,0071,125,746,9,755,1346,0,3,1,3,0,1,0,76.14,56.09 ,33.33
03,018,01,002,0071,126,700,7,707,1463,0,3,1,3,0,1,0,76.14,48.33 ,33.33
03,018,01,002,0072,127,828,9,837,1525,0,3,1,3,0,1,0,76.14,54.89 ,33.33
03,018,01,002,0072,128,874,14,888,1550,0,3,1,3,0,1,0,76.14,57.29 ,33.33
03,018,01,002,0073,129,772,15,787,1293,0,3,1,3,0,1,0,76.14,60.87 ,33.33
03,018,01,002,0073,130,694,9,703,1181,0,3,1,3,0,1,0,76.14,59.53 ,33.33
03,018,01,002,0073,131,431,3,434,803,0,3,1,3,0,1,0,76.14,54.05 ,33.33
03,018,01,002,0074,132,799,10,809,1336,0,3,1,3,0,1,0,76.14,60.55 ,33.33
03,018,01,002,0074,133,867,12,879,1381,0,3,1,3,0,1,0,76.14,63.65 ,33.33
03,018,01,002,0075,134,662,8,670,1077,0,3,1,3,0,1,0,76.14,62.21 ,33.33
03,018,01,002,0075,135,666,4,670,1178,0,3,1,3,0,1,0,76.14,56.88 ,33.33
03,018,01,002,0076,136,576,11,587,1009,0,3,1,3,0,1,0,76.14,58.18 ,33.33
03,018,01,002,0076,137,637,13,650,1042,0,3,1,3,0,1,0,76.14,62.38 ,33.33
03,018,01,002,0077,138,738,8,746,1378,0,3,1,3,0,1,0,76.14,54.14 ,33.33
03,018,01,002,0077,139,543,7,550,944,0,3,1,3,0,1,0,76.14,58.26 ,33.33
03,018,01,002,0078,140,715,3,718,1352,0,3,1,3,0,1,0,76.14,53.11 ,33.33
03,018,01,002,0078,141,758,13,771,1259,0,3,1,3,0,1,0,76.14,61.24 ,33.33
03,018,01,002,0079,142,770,10,780,1306,0,3,1,3,0,1,0,76.14,59.72 ,33.33
03,018,01,002,0079,143,864,16,880,1510,0,3,1,3,0,1,0,76.14,58.28 ,33.33
03,018,01,002,0079,144,665,11,676,1201,0,3,1,3,0,1,0,76.14,56.29 ,33.33
03,018,01,002,0080,145,908,15,923,1588,0,3,1,3,0,1,0,76.14,58.12 ,33.33
03,018,01,002,0080,146,862,12,874,1373,0,3,1,3,0,1,0,76.14,63.66 ,33.33
03,018,01,002,0081,147,869,8,877,1486,0,3,1,3,0,1,0,76.14,59.02 ,33.33
03,018,01,002,0081,148,819,11,830,1379,0,3,1,3,0,1,0,76.14,60.19 ,33.33
03,018,01,002,0082,149,697,5,702,981,0,3,1,3,0,1,0,76.14,71.56 ,33.33
03,018,01,002,0082,150,85,1,86,166,0,3,1,3,0,1,0,76.14,51.81 ,33.33
03,018,01,002,0083,151,710,8,718,1129,0,3,1,3,0,1,0,76.14,63.60 ,33.33
03,018,01,002,0083,152,863,21,884,1474,0,3,1,3,0,1,0,76.14,59.97 ,33.33
03,018,01,002,0084,153,821,15,836,1525,0,3,1,3,0,1,0,76.14,54.82 ,33.33
03,018,01,002,0084,154,832,13,845,1368,0,3,1,3,0,1,0,76.14,61.77 ,33.33
03,018,01,002,0085,155,681,5,686,1149,0,3,1,3,0,1,0,76.14,59.70 ,33.33
03,018,01,002,0085,156,630,4,634,883,0,3,1,3,0,1,0,76.14,71.80 ,33.33
03,018,01,002,0085,157,626,6,632,895,0,3,1,3,0,1,0,76.14,70.61 ,33.33
03,018,01,002,0086,158,430,12,442,757,0,3,1,3,0,1,0,76.14,58.39 ,33.33
03,018,01,002,0087,159,842,15,857,1615,0,3,1,3,0,1,0,76.14,53.07 ,33.33
03,018,01,002,0087,160,720,7,727,1517,0,3,1,3,0,1,0,76.14,47.92 ,33.33
03,018,01,002,0088,161,739,8,747,1240,0,3,1,3,0,1,0,76.14,60.24 ,33.33
03,018,01,002,0089,162,503,9,512,847,0,3,1,3,0,1,0,76.14,60.45 ,33.33
03,018,01,002,0090,163,628,10,638,1185,0,3,1,3,0,1,0,76.14,53.84 ,33.33
03,018,01,002,0091,164,567,7,574,1014,0,3,1,3,0,1,0,76.14,56.61 ,33.33
03,018,01,002,0092,165,314,4,318,516,0,3,1,3,0,1,0,76.14,61.63 ,33.33
03,018,01,003,0093,166,719,3,722,1325,0,3,1,3,0,1,0,76.14,54.49 ,33.33
03,018,01,003,0093,167,747,14,761,1282,0,3,1,3,0,1,0,76.14,59.36 ,33.33
03,018,01,003,0093,168,940,16,956,1569,0,3,1,3,0,1,0,76.14,60.93 ,33.33
03,018,01,003,0094,169,496,8,504,852,0,3,1,3,0,1,0,76.14,59.15 ,33.33
03,018,01,003,0094,170,568,8,576,972,0,3,1,3,0,1,0,76.14,59.26 ,33.33
03,018,01,003,0095,171,742,10,752,1350,0,3,1,3,0,1,0,76.14,55.70 ,33.33
03,018,01,003,0096,172,551,2,553,999,0,3,1,3,0,1,0,76.14,55.36 ,33.33
03,018,01,003,0096,173,574,8,582,1005,0,3,1,3,0,1,0,76.14,57.91 ,33.33
03,018,01,003,0097,174,427,4,431,759,0,3,1,3,0,1,0,76.14,56.79 ,33.33
03,018,01,003,0097,175,479,6,485,815,0,3,1,3,0,1,0,76.14,59.51 ,33.33
03,018,01,003,0098,176,719,15,734,1293,0,3,1,3,0,1,0,76.14,56.77 ,33.33
03,018,01,003,0099,177,845,10,855,1445,0,3,1,3,0,1,0,76.14,59.17 ,33.33
03,018,01,003,0100,178,571,10,581,1064,0,3,1,3,0,1,0,76.14,54.61 ,33.33
03,018,01,003,0100,179,551,6,557,1098,0,3,1,3,0,1,0,76.14,50.73 ,33.33
03,018,01,003,0100,180,745,11,756,1493,0,3,1,3,0,1,0,76.14,50.64 ,33.33
03,018,01,003,0101,181,486,4,490,847,0,3,1,3,0,1,0,76.14,57.85 ,33.33
03,018,01,003,0101,182,401,8,409,713,0,3,1,3,0,1,0,76.14,57.36 ,33.33
03,018,01,003,0102,183,528,4,532,1044,0,3,1,3,0,1,0,76.14,50.96 ,33.33
03,018,01,003,0103,184,764,14,778,1484,0,3,1,3,0,1,0,76.14,52.43 ,33.33
03,018,01,003,0104,185,594,6,600,1054,0,3,1,3,0,1,0,76.14,56.93 ,33.33
03,018,01,003,0104,186,678,9,687,1204,0,3,1,3,0,1,0,76.14,57.06 ,33.33
03,018,01,003,0105,187,890,10,900,1549,0,3,1,3,0,1,0,76.14,58.10 ,33.33
03,018,01,003,0106,188,475,3,478,884,0,3,1,3,0,1,0,76.14,54.07 ,33.33
03,018,01,003,0107,189,798,11,809,1427,0,3,1,3,0,1,0,76.14,56.69 ,33.33
03,018,01,003,0108,190,722,20,742,1293,0,3,1,3,0,1,0,76.14,57.39 ,33.33
03,018,01,003,0109,191,555,4,559,935,0,3,1,3,0,1,0,76.14,59.79 ,33.33
03,018,01,003,0110,192,708,11,719,1253,0,3,1,3,0,1,0,76.14,57.38 ,33.33
03,018,01,003,0110,193,672,11,683,1348,0,3,1,3,0,1,0,76.14,50.67 ,33.33
03,018,01,003,0111,194,421,4,425,677,0,3,1,3,0,1,0,76.14,62.78 ,33.33
03,018,01,003,0112,195,604,14,618,1053,0,3,1,3,0,1,0,76.14,58.69 ,33.33
03,018,01,003,0113,196,347,5,352,577,0,3,1,3,0,1,0,76.14,61.01 ,33.33
03,018,01,003,0114,197,384,10,394,643,0,3,1,3,0,1,0,76.14,61.28 ,33.33
03,018,01,003,0115,198,330,8,338,654,0,3,1,3,0,1,0,76.14,51.68 ,33.33
03,019,01,001,0001,1,602,7,609,966,0,3,1,3,0,1,0,76.14,63.04 ,33.33
03,019,01,001,0002,2,678,3,681,1083,0,3,1,3,0,1,0,76.14,62.88 ,33.33
03,019,01,001,0003,3,784,4,788,1296,0,3,1,3,0,1,0,76.14,60.80 ,33.33
03,019,01,001,0004,4,950,10,960,1584,0,3,1,3,0,1,0,76.14,60.61 ,33.33
03,019,01,001,0005,5,647,6,653,993,0,3,1,3,0,1,0,76.14,65.76 ,33.33
03,019,01,001,0006,6,945,10,955,1390,0,3,1,3,0,1,0,76.14,68.71 ,33.33
03,019,01,001,0007,7,835,1,836,1310,0,3,1,3,0,1,0,76.14,63.82 ,33.33
03,019,01,001,0008,8,944,7,951,1442,0,3,1,3,0,1,0,76.14,65.95 ,33.33
03,019,01,001,0009,9,765,15,780,1238,0,3,1,3,0,1,0,76.14,63.00 ,33.33
03,019,01,001,0010,10,745,10,755,1114,0,3,1,3,0,1,0,76.14,67.77 ,33.33
03,019,01,001,0011,11,733,10,743,1125,0,3,1,3,0,1,0,76.14,66.04 ,33.33
03,019,01,001,0012,12,807,12,819,1307,0,3,1,3,0,1,0,76.14,62.66 ,33.33
03,019,01,001,0013,13,903,7,910,1301,0,3,1,3,0,1,0,76.14,69.95 ,33.33
03,019,01,001,0014,14,754,17,771,1267,0,3,1,3,0,1,0,76.14,60.85 ,33.33
03,019,01,002,0015,15,734,7,741,1123,0,3,1,3,0,1,0,76.14,65.98 ,33.33
03,019,01,002,0016,16,428,6,434,624,0,3,1,3,0,1,0,76.14,69.55 ,33.33
03,019,01,002,0017,17,646,6,652,998,0,3,1,3,0,1,0,76.14,65.33 ,33.33
03,019,01,002,0018,18,669,6,675,1044,0,3,1,3,0,1,0,76.14,64.66 ,33.33
03,019,01,002,0019,19,783,10,793,1283,0,3,1,3,0,1,0,76.14,61.81 ,33.33
03,019,01,002,0020,20,762,7,769,1178,0,3,1,3,0,1,0,76.14,65.28 ,33.33
03,019,01,002,0021,21,878,6,884,1298,0,3,1,3,0,1,0,76.14,68.10 ,33.33
03,019,01,002,0022,22,663,7,670,992,0,3,1,3,0,1,0,76.14,67.54 ,33.33
03,019,01,002,0023,23,742,7,749,1165,0,3,1,3,0,1,0,76.14,64.29 ,33.33
03,019,01,002,0023,24,706,12,718,1113,0,3,1,3,0,1,0,76.14,64.51 ,33.33
03,019,01,002,0023,25,776,7,783,1271,0,3,1,3,0,1,0,76.14,61.61 ,33.33
03,019,01,002,0024,26,650,7,657,908,0,3,1,3,0,1,0,76.14,72.36 ,33.33
03,019,01,002,0024,27,643,12,655,1023,0,3,1,3,0,1,0,76.14,64.03 ,33.33
03,019,01,002,0025,28,689,14,703,1014,0,3,1,3,0,1,0,76.14,69.33 ,33.33
03,019,01,002,0026,29,634,7,641,916,0,3,1,3,0,1,0,76.14,69.98 ,33.33
03,019,01,002,0027,30,767,9,776,1213,0,3,1,3,0,1,0,76.14,63.97 ,33.33
03,019,01,002,0028,31,540,5,545,842,0,3,1,3,0,1,0,76.14,64.73 ,33.33
03,019,01,002,0029,32,709,8,717,1070,0,3,1,3,0,1,0,76.14,67.01 ,33.33
03,019,01,002,0030,33,950,14,964,1384,0,3,1,3,0,1,0,76.14,69.65 ,33.33
03,019,01,002,0031,34,915,9,924,1337,0,3,1,3,0,1,0,76.14,69.11 ,33.33
03,019,01,002,0031,35,510,8,518,793,0,3,1,3,0,1,0,76.14,65.32 ,33.33
03,019,01,002,0031,36,1025,15,1040,1527,0,3,1,3,0,1,0,76.14,68.11 ,33.33
03,019,01,002,0032,37,1039,21,1060,1593,0,3,1,3,0,1,0,76.14,66.54 ,33.33
03,019,01,002,0032,38,1200,11,1211,1961,0,3,1,3,0,1,0,76.14,61.75 ,33.33
03,019,01,002,0032,39,1124,14,1138,1768,0,3,1,3,0,1,0,76.14,64.37 ,33.33
03,019,01,002,0033,40,1022,15,1037,1631,0,3,1,3,0,1,0,76.14,63.58 ,33.33
03,019,01,002,0033,41,1008,7,1015,1477,0,3,1,3,0,1,0,76.14,68.72 ,33.33
03,019,01,002,0034,42,538,5,543,828,0,3,1,3,0,1,0,76.14,65.58 ,33.33
03,019,01,002,0034,43,507,5,512,843,0,3,1,3,0,1,0,76.14,60.74 ,33.33
03,019,01,002,0035,44,540,5,545,884,0,3,1,3,0,1,0,76.14,61.65 ,33.33
03,019,01,002,0036,45,572,9,581,919,0,3,1,3,0,1,0,76.14,63.22 ,33.33
03,019,01,002,0036,46,1045,16,1061,1614,0,3,1,3,0,1,0,76.14,65.74 ,33.33
03,019,01,002,0037,47,586,5,591,921,0,3,1,3,0,1,0,76.14,64.17 ,33.33
03,019,01,002,0038,48,966,15,981,1476,0,3,1,3,0,1,0,76.14,66.46 ,33.33
03,019,01,002,0038,49,1046,21,1067,1540,0,3,1,3,0,1,0,76.14,69.29 ,33.33
03,019,01,002,0039,50,672,9,681,967,0,3,1,3,0,1,0,76.14,70.42 ,33.33
03,019,01,002,0040,51,439,4,443,756,0,3,1,3,0,1,0,76.14,58.60 ,33.33
03,019,01,002,0041,52,521,11,532,872,0,3,1,3,0,1,0,76.14,61.01 ,33.33
03,019,01,002,0041,53,1004,17,1021,1578,0,3,1,3,0,1,0,76.14,64.70 ,33.33
03,019,01,002,0042,54,970,10,980,1483,0,3,1,3,0,1,0,76.14,66.08 ,33.33
03,019,01,003,0043,55,1053,11,1064,1538,0,3,1,3,0,1,0,76.14,69.18 ,33.33
03,019,01,003,0044,56,727,6,733,1107,0,3,1,3,0,1,0,76.14,66.21 ,33.33
03,019,01,003,0045,57,646,7,653,1024,0,3,1,3,0,1,0,76.14,63.77 ,33.33
03,019,01,003,0045,58,710,2,712,1372,0,3,1,3,0,1,0,76.14,51.90 ,33.33
03,019,01,003,0046,59,993,4,997,1522,0,3,1,3,0,1,0,76.14,65.51 ,33.33
03,019,01,003,0047,60,760,6,766,1196,0,3,1,3,0,1,0,76.14,64.05 ,33.33
03,019,01,003,0047,61,765,7,772,1172,0,3,1,3,0,1,0,76.14,65.87 ,33.33
03,019,01,003,0047,62,760,3,763,1209,0,3,1,3,0,1,0,76.14,63.11 ,33.33
03,019,01,003,0048,63,1089,8,1097,1550,0,3,1,3,0,1,0,76.14,70.77 ,33.33
03,019,01,003,0049,64,625,8,633,942,0,3,1,3,0,1,0,76.14,67.20 ,33.33
03,019,01,003,0049,65,930,11,941,1336,0,3,1,3,0,1,0,76.14,70.43 ,33.33
03,019,01,003,0050,66,802,7,809,1186,0,3,1,3,0,1,0,76.14,68.21 ,33.33
03,019,01,003,0050,67,764,19,783,1060,0,3,1,3,0,1,0,76.14,73.87 ,33.33
03,019,01,003,0050,68,1021,16,1037,1548,0,3,1,3,0,1,0,76.14,66.99 ,33.33
03,019,01,003,0051,69,554,6,560,856,0,3,1,3,0,1,0,76.14,65.42 ,33.33
03,019,01,003,0052,70,963,12,975,1571,0,3,1,3,0,1,0,76.14,62.06 ,33.33
03,019,01,003,0053,71,742,3,745,1205,0,3,1,3,0,1,0,76.14,61.83 ,33.33
03,019,01,003,0053,72,889,8,897,1317,0,3,1,3,0,1,0,76.14,68.11 ,33.33
03,019,01,003,0054,73,551,2,553,847,0,3,1,3,0,1,0,76.14,65.29 ,33.33
03,019,01,003,0054,74,544,5,549,834,0,3,1,3,0,1,0,76.14,65.83 ,33.33
03,019,01,003,0055,75,953,6,959,1444,0,3,1,3,0,1,0,76.14,66.41 ,33.33
03,019,01,003,0056,76,631,5,636,959,0,3,1,3,0,1,0,76.14,66.32 ,33.33
03,019,01,003,0056,77,514,5,519,832,0,3,1,3,0,1,0,76.14,62.38 ,33.33
03,019,01,003,0057,78,909,4,913,1381,0,3,1,3,0,1,0,76.14,66.11 ,33.33
03,019,01,003,0058,79,601,6,607,962,0,3,1,3,0,1,0,76.14,63.10 ,33.33
03,019,01,003,0058,80,521,2,523,851,0,3,1,3,0,1,0,76.14,61.46 ,33.33
03,019,01,003,0059,81,613,3,616,1007,0,3,1,3,0,1,0,76.14,61.17 ,33.33
03,019,01,003,0059,82,646,7,653,967,0,3,1,3,0,1,0,76.14,67.53 ,33.33
03,019,01,003,0060,83,648,7,655,891,0,3,1,3,0,1,0,76.14,73.51 ,33.33
03,019,01,003,0061,84,707,4,711,1108,0,3,1,3,0,1,0,76.14,64.17 ,33.33
03,019,01,003,0061,85,595,10,605,942,0,3,1,3,0,1,0,76.14,64.23 ,33.33
03,019,01,003,0062,86,749,6,755,1129,0,3,1,3,0,1,0,76.14,66.87 ,33.33
03,019,01,003,0062,87,1020,14,1034,1583,0,3,1,3,0,1,0,76.14,65.32 ,33.33
03,019,01,003,0062,88,985,10,995,1567,0,3,1,3,0,1,0,76.14,63.50 ,33.33
03,019,01,003,0063,89,825,2,827,1197,0,3,1,3,0,1,0,76.14,69.09 ,33.33
03,019,01,003,0063,90,699,7,706,1105,0,3,1,3,0,1,0,76.14,63.89 ,33.33
03,019,01,003,0063,91,588,9,597,1029,0,3,1,3,0,1,0,76.14,58.02 ,33.33
03,019,01,003,0064,92,756,6,762,1184,0,3,1,3,0,1,0,76.14,64.36 ,33.33
03,019,01,003,0064,93,835,16,851,1352,0,3,1,3,0,1,0,76.14,62.94 ,33.33
03,019,01,003,0064,94,897,8,905,1442,0,3,1,3,0,1,0,76.14,62.76 ,33.33
03,019,01,003,0065,95,754,6,760,1203,0,3,1,3,0,1,0,76.14,63.18 ,33.33
03,019,01,003,0065,96,695,2,697,1125,0,3,1,3,0,1,0,76.14,61.96 ,33.33
03,019,01,003,0065,97,922,7,929,1378,0,3,1,3,0,1,0,76.14,67.42 ,33.33
03,019,01,003,0065,98,622,3,625,953,0,3,1,3,0,1,0,76.14,65.58 ,33.33
03,019,01,003,0066,99,898,14,912,1422,0,3,1,3,0,1,0,76.14,64.14 ,33.33
03,019,01,003,0066,100,839,10,849,1243,0,3,1,3,0,1,0,76.14,68.30 ,33.33
03,019,01,003,0066,101,696,11,707,1156,0,3,1,3,0,1,0,76.14,61.16 ,33.33
03,019,01,003,0066,102,702,9,711,1158,0,3,1,3,0,1,0,76.14,61.40 ,33.33
03,019,01,003,0066,103,1013,11,1024,1630,0,3,1,3,0,1,0,76.14,62.82 ,33.33
03,019,01,003,0066,104,697,8,705,1071,0,3,1,3,0,1,0,76.14,65.83 ,33.33
03,019,01,003,0067,105,852,11,863,1271,0,3,1,3,0,1,0,76.14,67.90 ,33.33
03,019,01,003,0067,106,847,17,864,1234,0,3,1,3,0,1,0,76.14,70.02 ,33.33
03,019,01,003,0068,107,536,6,542,797,0,3,1,3,0,1,0,76.14,68.01 ,33.33
03,019,01,003,0068,108,645,6,651,974,0,3,1,3,0,1,0,76.14,66.84 ,33.33
03,019,01,003,0068,109,706,7,713,1043,0,3,1,3,0,1,0,76.14,68.36 ,33.33
03,019,01,003,0069,110,1203,21,1224,1805,0,3,1,3,0,1,0,76.14,67.81 ,33.33
03,019,01,003,0069,111,774,4,778,1194,0,3,1,3,0,1,0,76.14,65.16 ,33.33
03,019,01,003,0069,112,1030,8,1038,1640,0,3,1,3,0,1,0,76.14,63.29 ,33.33
03,019,01,003,0069,113,700,7,707,1082,0,3,1,3,0,1,0,76.14,65.34 ,33.33
03,019,01,004,0070,114,488,4,492,750,0,3,1,3,0,1,0,76.14,65.60 ,33.33
03,019,01,004,0071,115,543,8,551,865,0,3,1,3,0,1,0,76.14,63.70 ,33.33
03,019,01,004,0072,116,650,5,655,995,0,3,1,3,0,1,0,76.14,65.83 ,33.33
03,019,01,004,0073,117,1074,11,1085,1579,0,3,1,3,0,1,0,76.14,68.71 ,33.33
03,019,01,004,0074,118,772,11,783,1159,0,3,1,3,0,1,0,76.14,67.56 ,33.33
03,019,01,004,0075,119,698,9,707,1059,0,3,1,3,0,1,0,76.14,66.76 ,33.33
03,019,01,004,0076,120,939,5,944,1488,0,3,1,3,0,1,0,76.14,63.44 ,33.33
03,019,01,004,0077,121,744,3,747,1147,0,3,1,3,0,1,0,76.14,65.13 ,33.33
03,019,01,004,0078,122,997,11,1008,1600,0,3,1,3,0,1,0,76.14,63.00 ,33.33
03,019,01,004,0078,123,1021,11,1032,1581,0,3,1,3,0,1,0,76.14,65.28 ,33.33
03,019,01,004,0079,124,899,6,905,1434,0,3,1,3,0,1,0,76.14,63.11 ,33.33
03,019,01,004,0079,125,1020,11,1031,1586,0,3,1,3,0,1,0,76.14,65.01 ,33.33
03,019,01,004,0080,126,619,7,626,920,0,3,1,3,0,1,0,76.14,68.04 ,33.33
03,019,01,004,0080,127,775,9,784,1131,0,3,1,3,0,1,0,76.14,69.32 ,33.33
03,019,01,004,0081,128,652,6,658,1158,0,3,1,3,0,1,0,76.14,56.82 ,33.33
03,019,01,004,0081,129,946,24,970,1517,0,3,1,3,0,1,0,76.14,63.94 ,33.33
03,019,01,004,0082,130,1159,12,1171,1720,0,3,1,3,0,1,0,76.14,68.08 ,33.33
03,019,01,004,0083,131,808,5,813,1270,0,3,1,3,0,1,0,76.14,64.02 ,33.33
03,019,01,004,0084,132,715,6,721,1070,0,3,1,3,0,1,0,76.14,67.38 ,33.33
03,019,01,004,0084,133,758,7,765,1149,0,3,1,3,0,1,0,76.14,66.58 ,33.33
03,019,01,004,0085,134,834,8,842,1291,0,3,1,3,0,1,0,76.14,65.22 ,33.33
03,019,01,004,0085,135,1012,11,1023,1644,0,3,1,3,0,1,0,76.14,62.23 ,33.33
03,019,01,004,0085,136,961,18,979,1528,0,3,1,3,0,1,0,76.14,64.07 ,33.33
03,019,01,004,0085,137,764,5,769,1233,0,3,1,3,0,1,0,76.14,62.37 ,33.33
03,019,01,004,0086,138,946,9,955,1546,0,3,1,3,0,1,0,76.14,61.77 ,33.33
03,019,01,004,0086,139,930,14,944,1502,0,3,1,3,0,1,0,76.14,62.85 ,33.33
03,019,01,004,0086,140,1234,21,1255,1854,0,3,1,3,0,1,0,76.14,67.69 ,33.33
03,019,01,004,0087,141,1004,7,1011,1768,0,3,1,3,0,1,0,76.14,57.18 ,33.33
03,019,01,004,0087,142,802,9,811,1286,0,3,1,3,0,1,0,76.14,63.06 ,33.33
03,019,01,004,0087,143,711,9,720,1154,0,3,1,3,0,1,0,76.14,62.39 ,33.33
03,019,01,004,0088,144,960,15,975,1528,0,3,1,3,0,1,0,76.14,63.81 ,33.33
03,019,01,004,0088,145,993,10,1003,1534,0,3,1,3,0,1,0,76.14,65.38 ,33.33
03,019,01,004,0088,146,949,11,960,1621,0,3,1,3,0,1,0,76.14,59.22 ,33.33
03,019,01,004,0089,147,1188,14,1202,1892,0,3,1,3,0,1,0,76.14,63.53 ,33.33
03,019,01,004,0090,148,1061,17,1078,1670,0,3,1,3,0,1,0,76.14,64.55 ,33.33
03,019,01,004,0090,149,933,10,943,1474,0,3,1,3,0,1,0,76.14,63.98 ,33.33
03,019,01,004,0090,150,956,14,970,1461,0,3,1,3,0,1,0,76.14,66.39 ,33.33
03,019,01,005,0091,151,1038,10,1048,1496,0,3,1,3,0,1,0,76.14,70.05 ,33.33
03,019,01,005,0092,152,579,7,586,882,0,3,1,3,0,1,0,76.14,66.44 ,33.33
03,019,01,005,0093,153,710,8,718,1075,0,3,1,3,0,1,0,76.14,66.79 ,33.33
03,019,01,005,0094,154,504,9,513,893,0,3,1,3,0,1,0,76.14,57.45 ,33.33
03,019,01,005,0095,155,720,10,730,1095,0,3,1,3,0,1,0,76.14,66.67 ,33.33
03,019,01,005,0095,156,507,7,514,839,0,3,1,3,0,1,0,76.14,61.26 ,33.33
03,019,01,005,0096,157,663,12,675,1045,0,3,1,3,0,1,0,76.14,64.59 ,33.33
03,019,01,005,0096,158,579,4,583,949,0,3,1,3,0,1,0,76.14,61.43 ,33.33
03,019,01,005,0097,159,658,11,669,1082,0,3,1,3,0,1,0,76.14,61.83 ,33.33
03,019,01,005,0098,160,487,7,494,709,0,3,1,3,0,1,0,76.14,69.68 ,33.33
03,019,01,005,0099,161,615,3,618,980,0,3,1,3,0,1,0,76.14,63.06 ,33.33
03,019,01,005,0100,162,951,13,964,1563,0,3,1,3,0,1,0,76.14,61.68 ,33.33
03,019,01,005,0101,163,556,8,564,837,0,3,1,3,0,1,0,76.14,67.38 ,33.33
03,019,01,005,0102,164,673,11,684,1030,0,3,1,3,0,1,0,76.14,66.41 ,33.33
03,019,01,005,0103,165,775,6,781,1251,0,3,1,3,0,1,0,76.14,62.43 ,33.33
03,019,01,005,0104,166,611,5,616,1000,0,3,1,3,0,1,0,76.14,61.60 ,33.33
03,019,01,005,0105,167,901,12,913,1383,0,3,1,3,0,1,0,76.14,66.02 ,33.33
03,019,01,005,0105,168,642,7,649,1039,0,3,1,3,0,1,0,76.14,62.46 ,33.33
03,019,01,005,0106,169,767,4,771,1112,0,3,1,3,0,1,0,76.14,69.33 ,33.33
03,019,01,005,0106,170,868,6,874,1239,0,3,1,3,0,1,0,76.14,70.54 ,33.33
03,019,01,005,0106,171,606,8,614,965,0,3,1,3,0,1,0,76.14,63.63 ,33.33
03,019,01,005,0107,172,623,3,626,927,0,3,1,3,0,1,0,76.14,67.53 ,33.33
03,019,01,005,0107,173,663,7,670,978,0,3,1,3,0,1,0,76.14,68.51 ,33.33
03,019,01,005,0107,174,735,2,737,1154,0,3,1,3,0,1,0,76.14,63.86 ,33.33
03,019,01,005,0108,175,765,7,772,1197,0,3,1,3,0,1,0,76.14,64.49 ,33.33
03,019,01,005,0108,176,719,13,732,1102,0,3,1,3,0,1,0,76.14,66.42 ,33.33
03,019,01,005,0108,177,718,10,728,1045,0,3,1,3,0,1,0,76.14,69.67 ,33.33
03,019,01,005,0108,178,839,6,845,1361,0,3,1,3,0,1,0,76.14,62.09 ,33.33
03,019,01,005,0108,179,848,15,863,1502,0,3,1,3,0,1,0,76.14,57.46 ,33.33
03,019,01,005,0109,180,1006,7,1013,1492,0,3,1,3,0,1,0,76.14,67.90 ,33.33
03,019,01,005,0109,181,845,6,851,1348,0,3,1,3,0,1,0,76.14,63.13 ,33.33
03,019,01,005,0110,182,910,6,916,1585,0,3,1,3,0,1,0,76.14,57.79 ,33.33
03,019,01,005,0110,183,847,6,853,1398,0,3,1,3,0,1,0,76.14,61.02 ,33.33
03,019,01,005,0111,184,1017,8,1025,1553,0,3,1,3,0,1,0,76.14,66.00 ,33.33
03,019,01,005,0112,185,872,7,879,1371,0,3,1,3,0,1,0,76.14,64.11 ,33.33
03,019,01,005,0112,186,872,8,880,1416,0,3,1,3,0,1,0,76.14,62.15 ,33.33
03,019,01,005,0112,187,937,7,944,1412,0,3,1,3,0,1,0,76.14,66.86 ,33.33
03,019,01,005,0113,188,723,2,725,1173,0,3,1,3,0,1,0,76.14,61.81 ,33.33
03,019,01,005,0113,189,590,5,595,1062,0,3,1,3,0,1,0,76.14,56.03 ,33.33
03,019,01,005,0114,190,1005,13,1018,1628,0,3,1,3,0,1,0,76.14,62.53 ,33.33
03,019,01,005,0114,191,917,7,924,1420,0,3,1,3,0,1,0,76.14,65.07 ,33.33
03,019,01,005,0114,192,912,8,920,1485,0,3,1,3,0,1,0,76.14,61.95 ,33.33
03,019,01,005,0115,193,688,12,700,1052,0,3,1,3,0,1,0,76.14,66.54 ,33.33
03,019,01,005,0115,194,803,7,810,1264,0,3,1,3,0,1,0,76.14,64.08 ,33.33
03,019,01,005,0115,195,681,3,684,1055,0,3,1,3,0,1,0,76.14,64.83 ,33.33
03,019,01,005,0115,196,792,6,798,1340,0,3,1,3,0,1,0,76.14,59.55 ,33.33
03,019,01,005,0116,197,1140,10,1150,1687,0,3,1,3,0,1,0,76.14,68.17 ,33.33
03,019,01,005,0116,198,1015,10,1025,1577,0,3,1,3,0,1,0,76.14,65.00 ,33.33
03,019,01,005,0117,199,758,9,767,1234,0,3,1,3,0,1,0,76.14,62.16 ,33.33
03,019,01,005,0117,200,804,2,806,1247,0,3,1,3,0,1,0,76.14,64.64 ,33.33
03,019,01,005,0117,201,731,12,743,1182,0,3,1,3,0,1,0,76.14,62.86 ,33.33
03,019,01,005,0118,202,645,10,655,1153,0,3,1,3,0,1,0,76.14,56.81 ,33.33
03,019,01,005,0118,203,715,8,723,1185,0,3,1,3,0,1,0,76.14,61.01 ,33.33
03,019,01,005,0118,204,697,8,705,1104,0,3,1,3,0,1,0,76.14,63.86 ,33.33
03,019,01,005,0118,205,718,8,726,1207,0,3,1,3,0,1,0,76.14,60.15 ,33.33
03,019,01,005,0119,206,644,14,658,1034,0,3,1,3,0,1,0,76.14,63.64 ,33.33
03,019,01,005,0119,207,656,10,666,1103,0,3,1,3,0,1,0,76.14,60.38 ,33.33
03,019,01,005,0119,208,746,6,752,1160,0,3,1,3,0,1,0,76.14,64.83 ,33.33
03,019,01,005,0120,209,864,7,871,1388,0,3,1,3,0,1,0,76.14,62.75 ,33.33
03,019,01,005,0120,210,869,13,882,1404,0,3,1,3,0,1,0,76.14,62.82 ,33.33
03,019,01,005,0121,211,548,7,555,913,0,3,1,3,0,1,0,76.14,60.79 ,33.33
03,019,01,005,0121,212,622,7,629,1018,0,3,1,3,0,1,0,76.14,61.79 ,33.33
03,019,01,005,0121,213,789,7,796,1212,0,3,1,3,0,1,0,76.14,65.68 ,33.33
03,019,01,005,0122,214,755,3,758,1139,0,3,1,3,0,1,0,76.14,66.55 ,33.33
03,019,01,005,0122,215,836,8,844,1275,0,3,1,3,0,1,0,76.14,66.20 ,33.33
03,019,01,005,0122,216,856,14,870,1349,0,3,1,3,0,1,0,76.14,64.49 ,33.33
03,019,01,005,0122,217,800,7,807,1273,0,3,1,3,0,1,0,76.14,63.39 ,33.33
03,019,01,005,0123,218,996,9,1005,1566,0,3,1,3,0,1,0,76.14,64.18 ,33.33
03,019,01,005,0123,219,1058,10,1068,1743,0,3,1,3,0,1,0,76.14,61.27 ,33.33
03,019,01,005,0123,220,818,6,824,1272,0,3,1,3,0,1,0,76.14,64.78 ,33.33
03,019,01,005,0123,221,661,9,670,1048,0,3,1,3,0,1,0,76.14,63.93 ,33.33
03,019,01,005,0124,222,1029,7,1036,1722,0,3,1,3,0,1,0,76.14,60.16 ,33.33
03,019,01,005,0124,223,990,10,1000,1641,0,3,1,3,0,1,0,76.14,60.94 ,33.33
03,019,01,005,0124,224,926,10,936,1549,0,3,1,3,0,1,0,76.14,60.43 ,33.33
03,019,01,005,0124,225,863,4,867,1413,0,3,1,3,0,1,0,76.14,61.36 ,33.33
03,019,01,005,0125,226,770,8,778,1286,0,3,1,3,0,1,0,76.14,60.50 ,33.33
03,019,01,005,0125,227,880,5,885,1377,0,3,1,3,0,1,0,76.14,64.27 ,33.33
03,019,01,006,0126,228,1044,8,1052,1465,0,3,1,3,0,1,0,76.14,71.81 ,33.33
03,019,01,006,0126,229,1024,9,1033,1546,0,3,1,3,0,1,0,76.14,66.82 ,33.33
03,019,01,006,0126,230,927,9,936,1395,0,3,1,3,0,1,0,76.14,67.10 ,33.33
03,019,01,006,0127,231,702,14,716,1108,0,3,1,3,0,1,0,76.14,64.62 ,33.33
03,019,01,006,0127,232,774,11,785,1233,0,3,1,3,0,1,0,76.14,63.67 ,33.33
03,019,01,006,0127,233,883,10,893,1182,0,3,1,3,0,1,0,76.14,75.55 ,33.33
03,019,01,006,0128,234,1141,15,1156,1613,0,3,1,3,0,1,0,76.14,71.67 ,33.33
03,019,01,006,0128,235,1096,10,1106,1580,0,3,1,3,0,1,0,76.14,70.00 ,33.33
03,019,01,006,0129,236,741,10,751,1052,0,3,1,3,0,1,0,76.14,71.39 ,33.33
03,019,01,006,0130,237,676,10,686,883,0,3,1,3,0,1,0,76.14,77.69 ,33.33
03,019,01,006,0131,238,1058,9,1067,1518,0,3,1,3,0,1,0,76.14,70.29 ,33.33
03,019,01,006,0131,239,1000,18,1018,1456,0,3,1,3,0,1,0,76.14,69.92 ,33.33
03,019,01,006,0132,240,872,9,881,1294,0,3,1,3,0,1,0,76.14,68.08 ,33.33
03,019,01,006,0132,241,1103,10,1113,1742,0,3,1,3,0,1,0,76.14,63.89 ,33.33
03,019,01,006,0132,242,1005,13,1018,1564,0,3,1,3,0,1,0,76.14,65.09 ,33.33
03,019,01,006,0133,243,970,15,985,1543,0,3,1,3,0,1,0,76.14,63.84 ,33.33
03,019,01,006,0133,244,847,9,856,1243,0,3,1,3,0,1,0,76.14,68.87 ,33.33
03,019,01,006,0133,245,805,10,815,1193,0,3,1,3,0,1,0,76.14,68.32 ,33.33
03,019,01,006,0133,246,894,5,899,1284,0,3,1,3,0,1,0,76.14,70.02 ,33.33
03,019,01,006,0134,247,754,11,765,989,0,3,1,3,0,1,0,76.14,77.35 ,33.33
03,019,01,006,0134,248,735,9,744,955,0,3,1,3,0,1,0,76.14,77.91 ,33.33
03,019,01,006,0135,249,1010,6,1016,1596,0,3,1,3,0,1,0,76.14,63.66 ,33.33
03,019,01,006,0135,250,1035,8,1043,1587,0,3,1,3,0,1,0,76.14,65.72 ,33.33
03,019,01,006,0135,251,811,10,821,1372,0,3,1,3,0,1,0,76.14,59.84 ,33.33
03,019,01,006,0136,252,1112,12,1124,1619,0,3,1,3,0,1,0,76.14,69.43 ,33.33
03,019,01,006,0136,253,960,13,973,1476,0,3,1,3,0,1,0,76.14,65.92 ,33.33
03,019,01,006,0136,254,801,11,812,1250,0,3,1,3,0,1,0,76.14,64.96 ,33.33
03,019,01,006,0137,255,708,9,717,1046,0,3,1,3,0,1,0,76.14,68.55 ,33.33
03,019,01,006,0137,256,767,2,769,1147,0,3,1,3,0,1,0,76.14,67.04 ,33.33
03,019,01,006,0137,257,735,10,745,1103,0,3,1,3,0,1,0,76.14,67.54 ,33.33
03,019,01,006,0138,258,734,12,746,1168,0,3,1,3,0,1,0,76.14,63.87 ,33.33
03,019,01,006,0138,259,897,7,904,1319,0,3,1,3,0,1,0,76.14,68.54 ,33.33
03,019,01,006,0138,260,773,4,777,1246,0,3,1,3,0,1,0,76.14,62.36 ,33.33
03,019,01,006,0139,261,907,3,910,1338,0,3,1,3,0,1,0,76.14,68.01 ,33.33
03,019,01,006,0139,262,973,13,986,1514,0,3,1,3,0,1,0,76.14,65.13 ,33.33
03,019,01,006,0139,263,887,5,892,1399,0,3,1,3,0,1,0,76.14,63.76 ,33.33
03,019,01,006,0140,264,624,4,628,999,0,3,1,3,0,1,0,76.14,62.86 ,33.33
03,019,01,006,0140,265,781,9,790,1234,0,3,1,3,0,1,0,76.14,64.02 ,33.33
03,019,01,006,0140,266,892,11,903,1385,0,3,1,3,0,1,0,76.14,65.20 ,33.33
03,019,01,006,0141,267,1053,15,1068,1538,0,3,1,3,0,1,0,76.14,69.44 ,33.33
03,019,01,006,0141,268,1051,14,1065,1543,0,3,1,3,0,1,0,76.14,69.02 ,33.33
03,019,01,006,0142,269,782,8,790,1019,0,3,1,3,0,1,0,76.14,77.53 ,33.33
03,019,01,006,0143,270,948,22,970,1355,0,3,1,3,0,1,0,76.14,71.59 ,33.33
03,019,01,006,0143,271,947,8,955,1317,0,3,1,3,0,1,0,76.14,72.51 ,33.33
03,019,01,006,0144,272,890,6,896,1307,0,3,1,3,0,1,0,76.14,68.55 ,33.33
03,019,01,006,0144,273,773,6,779,1193,0,3,1,3,0,1,0,76.14,65.30 ,33.33
03,019,01,006,0144,274,776,8,784,1204,0,3,1,3,0,1,0,76.14,65.12 ,33.33
03,019,01,006,0145,275,686,6,692,838,0,3,1,3,0,1,0,76.14,82.58 ,33.33
03,019,01,006,0145,276,1019,13,1032,1494,0,3,1,3,0,1,0,76.14,69.08 ,33.33
03,019,01,006,0145,277,1173,18,1191,1629,0,3,1,3,0,1,0,76.14,73.11 ,33.33
03,019,01,006,0146,278,660,13,673,931,0,3,1,3,0,1,0,76.14,72.29 ,33.33
03,019,01,006,0146,279,595,9,604,842,0,3,1,3,0,1,0,76.14,71.73 ,33.33
03,019,01,006,0147,280,690,17,707,1015,0,3,1,3,0,1,0,76.14,69.66 ,33.33
03,019,01,006,0147,281,689,10,699,1004,0,3,1,3,0,1,0,76.14,69.62 ,33.33
03,019,01,006,0148,282,946,9,955,1431,0,3,1,3,0,1,0,76.14,66.74 ,33.33
03,019,01,006,0148,283,1019,10,1029,1580,0,3,1,3,0,1,0,76.14,65.13 ,33.33
03,019,01,006,0149,284,669,8,677,1090,0,3,1,3,0,1,0,76.14,62.11 ,33.33
03,019,01,006,0149,285,704,12,716,1087,0,3,1,3,0,1,0,76.14,65.87 ,33.33
03,019,01,006,0149,286,730,7,737,1224,0,3,1,3,0,1,0,76.14,60.21 ,33.33
03,019,01,006,0149,287,723,7,730,1106,0,3,1,3,0,1,0,76.14,66.00 ,33.33
03,019,01,006,0149,288,853,5,858,1324,0,3,1,3,0,1,0,76.14,64.80 ,33.33
03,019,01,006,0149,289,980,8,988,1508,0,3,1,3,0,1,0,76.14,65.52 ,33.33
03,019,01,006,0149,290,748,13,761,1185,0,3,1,3,0,1,0,76.14,64.22 ,33.33
03,019,01,006,0149,291,968,8,976,1636,0,3,1,3,0,1,0,76.14,59.66 ,33.33
03,019,01,006,0149,292,751,5,756,1437,0,3,1,3,0,1,0,76.14,52.61 ,33.33
03,019,01,006,0149,293,660,3,663,988,0,3,1,3,0,1,0,76.14,67.11 ,33.33
03,019,01,006,0150,294,705,9,714,1035,0,3,1,3,0,1,0,76.14,68.99 ,33.33
03,019,01,006,0150,295,835,15,850,1320,0,3,1,3,0,1,0,76.14,64.39 ,33.33
03,019,01,007,0151,296,1222,23,1245,1704,0,3,1,3,0,1,0,76.14,73.06 ,33.33
03,019,01,007,0151,297,1159,20,1179,1696,0,3,1,3,0,1,0,76.14,69.52 ,33.33
03,019,01,007,0152,298,1034,13,1047,1514,0,3,1,3,0,1,0,76.14,69.15 ,33.33
03,019,01,007,0152,299,902,12,914,1368,0,3,1,3,0,1,0,76.14,66.81 ,33.33
03,019,01,007,0153,300,1139,16,1155,1591,0,3,1,3,0,1,0,76.14,72.60 ,33.33
03,019,01,007,0153,301,1035,13,1048,1594,0,3,1,3,0,1,0,76.14,65.75 ,33.33
03,019,01,007,0154,302,1056,7,1063,1512,0,3,1,3,0,1,0,76.14,70.30 ,33.33
03,019,01,007,0154,303,1147,24,1171,1622,0,3,1,3,0,1,0,76.14,72.19 ,33.33
03,019,01,007,0155,304,662,13,675,898,0,3,1,3,0,1,0,76.14,75.17 ,33.33
03,019,01,007,0155,305,428,4,432,600,0,3,1,3,0,1,0,76.14,72.00 ,33.33
03,019,01,007,0156,306,672,9,681,1137,0,3,1,3,0,1,0,76.14,59.89 ,33.33
03,019,01,007,0156,307,821,6,827,1167,0,3,1,3,0,1,0,76.14,70.87 ,33.33
03,019,01,007,0157,308,721,11,732,1162,0,3,1,3,0,1,0,76.14,62.99 ,33.33
03,019,01,007,0157,309,797,10,807,1186,0,3,1,3,0,1,0,76.14,68.04 ,33.33
03,019,01,007,0157,310,617,9,626,883,0,3,1,3,0,1,0,76.14,70.89 ,33.33
03,019,01,007,0157,311,425,5,430,1768,0,3,1,3,0,1,0,76.14,24.32 ,33.33
03,019,01,007,0158,312,839,12,851,1102,0,3,1,3,0,1,0,76.14,77.22 ,33.33
03,019,01,007,0158,313,854,10,864,1099,0,3,1,3,0,1,0,76.14,78.62 ,33.33
03,019,01,007,0159,314,872,11,883,1324,0,3,1,3,0,1,0,76.14,66.69 ,33.33
03,019,01,007,0159,315,1272,20,1292,1999,0,3,1,3,0,1,0,76.14,64.63 ,33.33
03,019,01,007,0159,316,741,5,746,1101,0,3,1,3,0,1,0,76.14,67.76 ,33.33
03,019,01,007,0160,317,896,15,911,1219,0,3,1,3,0,1,0,76.14,74.73 ,33.33
03,019,01,007,0161,318,897,9,906,1341,0,3,1,3,0,1,0,76.14,67.56 ,33.33
03,019,01,007,0161,319,692,3,695,1108,0,3,1,3,0,1,0,76.14,62.73 ,33.33
03,019,01,007,0161,320,541,3,544,783,0,3,1,3,0,1,0,76.14,69.48 ,33.33
03,019,01,007,0162,321,1000,7,1007,1345,0,3,1,3,0,1,0,76.14,74.87 ,33.33
03,019,01,007,0163,322,843,6,849,1152,0,3,1,3,0,1,0,76.14,73.70 ,33.33
03,019,01,007,0163,323,788,6,794,1214,0,3,1,3,0,1,0,76.14,65.40 ,33.33
03,019,01,007,0164,324,927,7,934,1427,0,3,1,3,0,1,0,76.14,65.45 ,33.33
03,019,01,007,0164,325,917,7,924,1275,0,3,1,3,0,1,0,76.14,72.47 ,33.33
03,019,01,007,0164,326,941,17,958,1436,0,3,1,3,0,1,0,76.14,66.71 ,33.33
03,019,01,007,0164,327,864,6,870,1396,0,3,1,3,0,1,0,76.14,62.32 ,33.33
03,019,01,007,0164,328,1173,10,1183,1775,0,3,1,3,0,1,0,76.14,66.65 ,33.33
03,019,01,007,0165,329,926,6,932,1449,0,3,1,3,0,1,0,76.14,64.32 ,33.33
03,019,01,007,0165,330,879,12,891,1307,0,3,1,3,0,1,0,76.14,68.17 ,33.33
03,019,01,007,0165,331,951,14,965,1462,0,3,1,3,0,1,0,76.14,66.01 ,33.33
03,019,01,007,0165,332,1015,15,1030,1625,0,3,1,3,0,1,0,76.14,63.38 ,33.33
03,019,01,007,0166,333,1002,7,1009,1444,0,3,1,3,0,1,0,76.14,69.88 ,33.33
03,019,01,007,0166,334,1077,10,1087,1695,0,3,1,3,0,1,0,76.14,64.13 ,33.33
03,019,01,007,0166,335,1049,4,1053,1554,0,3,1,3,0,1,0,76.14,67.76 ,33.33
03,019,01,007,0166,336,1009,4,1013,1579,0,3,1,3,0,1,0,76.14,64.15 ,33.33
03,019,01,008,0167,337,682,9,691,1077,0,3,1,3,0,1,0,76.14,64.16 ,33.33
03,019,01,008,0167,338,820,5,825,1215,0,3,1,3,0,1,0,76.14,67.90 ,33.33
03,019,01,008,0167,339,848,8,856,1281,0,3,1,3,0,1,0,76.14,66.82 ,33.33
03,019,01,008,0167,340,794,7,801,1243,0,3,1,3,0,1,0,76.14,64.44 ,33.33
03,019,01,008,0168,341,1003,7,1010,1440,0,3,1,3,0,1,0,76.14,70.14 ,33.33
03,019,01,008,0168,342,1070,12,1082,1557,0,3,1,3,0,1,0,76.14,69.49 ,33.33
03,019,01,008,0169,343,1037,16,1053,1683,0,3,1,3,0,1,0,76.14,62.57 ,33.33
03,019,01,008,0169,344,847,11,858,1372,0,3,1,3,0,1,0,76.14,62.54 ,33.33
03,019,01,008,0169,345,1142,15,1157,1906,0,3,1,3,0,1,0,76.14,60.70 ,33.33
03,019,01,008,0169,346,1046,17,1063,1650,0,3,1,3,0,1,0,76.14,64.42 ,33.33
03,019,01,008,0169,347,740,6,746,1041,0,3,1,3,0,1,0,76.14,71.66 ,33.33
03,019,01,008,0170,348,555,7,562,880,0,3,1,3,0,1,0,76.14,63.86 ,33.33
03,019,01,008,0170,349,1169,12,1181,1994,0,3,1,3,0,1,0,76.14,59.23 ,33.33
03,019,01,008,0170,350,1042,7,1049,1695,0,3,1,3,0,1,0,76.14,61.89 ,33.33
03,019,01,008,0170,351,780,7,787,1206,0,3,1,3,0,1,0,76.14,65.26 ,33.33
03,019,01,008,0170,352,882,7,889,1297,0,3,1,3,0,1,0,76.14,68.54 ,33.33
03,019,01,008,0171,353,1010,3,1013,1670,0,3,1,3,0,1,0,76.14,60.66 ,33.33
03,019,01,008,0171,354,859,14,873,1407,0,3,1,3,0,1,0,76.14,62.05 ,33.33
03,019,01,008,0171,355,1070,8,1078,1709,0,3,1,3,0,1,0,76.14,63.08 ,33.33
03,019,01,008,0172,356,720,8,728,1142,0,3,1,3,0,1,0,76.14,63.75 ,33.33
03,019,01,008,0172,357,779,10,789,1261,0,3,1,3,0,1,0,76.14,62.57 ,33.33
03,019,01,008,0172,358,751,13,764,1137,0,3,1,3,0,1,0,76.14,67.19 ,33.33
03,019,01,008,0173,359,991,16,1007,1513,0,3,1,3,0,1,0,76.14,66.56 ,33.33
03,019,01,008,0173,360,1124,16,1140,1858,0,3,1,3,0,1,0,76.14,61.36 ,33.33
03,019,01,008,0173,361,1063,12,1075,1646,0,3,1,3,0,1,0,76.14,65.31 ,33.33
03,019,01,008,0174,362,1025,8,1033,1620,0,3,1,3,0,1,0,76.14,63.77 ,33.33
03,019,01,008,0174,363,1018,18,1036,1587,0,3,1,3,0,1,0,76.14,65.28 ,33.33
03,019,01,008,0175,364,815,9,824,1277,0,3,1,3,0,1,0,76.14,64.53 ,33.33
03,019,01,008,0175,365,942,7,949,1444,0,3,1,3,0,1,0,76.14,65.72 ,33.33
03,019,01,008,0176,366,879,11,890,1334,0,3,1,3,0,1,0,76.14,66.72 ,33.33
03,019,01,008,0176,367,1006,16,1022,1642,0,3,1,3,0,1,0,76.14,62.24 ,33.33
03,019,01,008,0176,368,594,7,601,981,0,3,1,3,0,1,0,76.14,61.26 ,33.33
03,019,01,008,0177,369,854,13,867,1346,0,3,1,3,0,1,0,76.14,64.41 ,33.33
03,019,01,008,0177,370,1015,13,1028,1634,0,3,1,3,0,1,0,76.14,62.91 ,33.33
03,019,01,008,0177,371,1106,16,1122,1655,0,3,1,3,0,1,0,76.14,67.79 ,33.33
03,019,01,008,0178,372,952,7,959,1436,0,3,1,3,0,1,0,76.14,66.78 ,33.33
03,019,01,008,0178,373,889,16,905,1366,0,3,1,3,0,1,0,76.14,66.25 ,33.33
03,019,01,008,0178,374,821,21,842,1337,0,3,1,3,0,1,0,76.14,62.98 ,33.33
03,019,01,008,0178,375,801,6,807,1259,0,3,1,3,0,1,0,76.14,64.10 ,33.33
03,019,01,008,0179,376,1082,18,1100,1609,0,3,1,3,0,1,0,76.14,68.37 ,33.33
03,019,01,008,0179,377,1049,8,1057,1517,0,3,1,3,0,1,0,76.14,69.68 ,33.33
03,019,01,008,0179,378,494,5,499,701,0,3,1,3,0,1,0,76.14,71.18 ,33.33
03,019,01,008,0180,379,942,11,953,1401,0,3,1,3,0,1,0,76.14,68.02 ,33.33
03,019,01,008,0181,380,536,4,540,859,0,3,1,3,0,1,0,76.14,62.86 ,33.33
03,019,01,008,0182,381,551,10,561,894,0,3,1,3,0,1,0,76.14,62.75 ,33.33
03,019,01,008,0182,382,645,22,667,931,0,3,1,3,0,1,0,76.14,71.64 ,33.33
03,019,01,008,0183,383,840,8,848,1255,0,3,1,3,0,1,0,76.14,67.57 ,33.33
03,019,01,008,0184,384,464,7,471,693,0,3,1,3,0,1,0,76.14,67.97 ,33.33
03,019,01,008,0185,385,1068,10,1078,1697,0,3,1,3,0,1,0,76.14,63.52 ,33.33
03,019,01,008,0185,386,1110,17,1127,1697,0,3,1,3,0,1,0,76.14,66.41 ,33.33
03,019,01,008,0186,387,1123,8,1131,1840,0,3,1,3,0,1,0,76.14,61.47 ,33.33
03,019,01,008,0186,388,1045,12,1057,1730,0,3,1,3,0,1,0,76.14,61.10 ,33.33
03,019,01,008,0186,389,773,6,779,1207,0,3,1,3,0,1,0,76.14,64.54 ,33.33
03,019,01,008,0186,390,788,10,798,1261,0,3,1,3,0,1,0,76.14,63.28 ,33.33
03,019,01,008,0187,391,950,11,961,1460,0,3,1,3,0,1,0,76.14,65.82 ,33.33
03,019,01,008,0187,392,1000,10,1010,1563,0,3,1,3,0,1,0,76.14,64.62 ,33.33
03,019,01,008,0187,393,859,6,865,1287,0,3,1,3,0,1,0,76.14,67.21 ,33.33
03,019,01,008,0187,394,668,11,679,1157,0,3,1,3,0,1,0,76.14,58.69 ,33.33
03,019,01,008,0187,395,873,10,883,1306,0,3,1,3,0,1,0,76.14,67.61 ,33.33
03,019,01,008,0188,396,993,3,996,1341,0,3,1,3,0,1,0,76.14,74.27 ,33.33
03,019,01,008,0188,397,992,10,1002,1517,0,3,1,3,0,1,0,76.14,66.05 ,33.33
03,019,01,008,0188,398,1012,9,1021,1496,0,3,1,3,0,1,0,76.14,68.25 ,33.33
03,019,01,008,0188,399,835,7,842,1229,0,3,1,3,0,1,0,76.14,68.51 ,33.33
03,019,01,008,0189,400,1021,11,1032,1495,0,3,1,3,0,1,0,76.14,69.03 ,33.33
03,019,01,008,0189,401,1242,15,1257,1686,0,3,1,3,0,1,0,76.14,74.56 ,33.33
03,019,01,008,0189,402,1113,14,1127,1553,0,3,1,3,0,1,0,76.14,72.57 ,33.33
03,019,01,008,0190,403,723,10,733,1021,0,3,1,3,0,1,0,76.14,71.79 ,33.33
03,019,01,008,0191,404,992,8,1000,1444,0,3,1,3,0,1,0,76.14,69.25 ,33.33
03,019,01,008,0191,405,1017,10,1027,1580,0,3,1,3,0,1,0,76.14,65.00 ,33.33
03,019,01,008,0191,406,972,11,983,1362,0,3,1,3,0,1,0,76.14,72.17 ,33.33
03,019,01,008,0192,407,1108,10,1118,1624,0,3,1,3,0,1,0,76.14,68.84 ,33.33
03,019,01,008,0192,408,986,13,999,1432,0,3,1,3,0,1,0,76.14,69.76 ,33.33
03,019,01,008,0192,409,542,8,550,812,0,3,1,3,0,1,0,76.14,67.73 ,33.33
03,019,01,008,0193,410,1211,13,1224,1950,0,3,1,3,0,1,0,76.14,62.77 ,33.33
03,019,01,008,0193,411,1127,9,1136,1759,0,3,1,3,0,1,0,76.14,64.58 ,33.33
03,019,01,008,0193,412,928,10,938,1465,0,3,1,3,0,1,0,76.14,64.03 ,33.33
03,019,01,008,0194,413,958,6,964,1444,0,3,1,3,0,1,0,76.14,66.76 ,33.33
03,019,01,008,0194,414,1392,15,1407,2015,0,3,1,3,0,1,0,76.14,69.83 ,33.33
03,019,01,008,0195,415,904,17,921,1442,0,3,1,3,0,1,0,76.14,63.87 ,33.33
03,019,01,008,0195,416,1018,11,1029,1431,0,3,1,3,0,1,0,76.14,71.91 ,33.33
03,019,01,008,0195,417,863,12,875,1248,0,3,1,3,0,1,0,76.14,70.11 ,33.33
03,019,01,008,0196,418,620,4,624,857,0,3,1,3,0,1,0,76.14,72.81 ,33.33
03,019,01,008,0197,419,910,10,920,1362,0,3,1,3,0,1,0,76.14,67.55 ,33.33
03,019,01,008,0197,420,766,12,778,1212,0,3,1,3,0,1,0,76.14,64.19 ,33.33
03,019,01,008,0197,421,836,8,844,1273,0,3,1,3,0,1,0,76.14,66.30 ,33.33
03,019,01,008,0197,422,779,11,790,1179,0,3,1,3,0,1,0,76.14,67.01 ,33.33
03,020,01,001,0001,1,877,7,884,1234,0,3,1,3,0,1,0,76.14,71.64 ,33.33
03,020,01,001,0001,2,595,3,598,827,0,3,1,3,0,1,0,76.14,72.31 ,33.33
03,020,01,001,0001,3,873,4,877,1183,0,3,1,3,0,1,0,76.14,74.13 ,33.33
03,020,01,001,0002,4,1101,6,1107,1472,0,3,1,3,0,1,0,76.14,75.20 ,33.33
03,020,01,001,0002,5,677,4,681,965,0,3,1,3,0,1,0,76.14,70.57 ,33.33
03,020,01,001,0003,6,428,3,431,590,0,3,1,3,0,1,0,76.14,73.05 ,33.33
03,020,01,001,0004,7,655,10,665,939,0,3,1,3,0,1,0,76.14,70.82 ,33.33
03,020,01,001,0004,8,654,6,660,888,0,3,1,3,0,1,0,76.14,74.32 ,33.33
03,020,01,001,0005,9,731,8,739,958,0,3,1,3,0,1,0,76.14,77.14 ,33.33
03,020,01,001,0006,10,1043,8,1051,1376,0,3,1,3,0,1,0,76.14,76.38 ,33.33
03,020,01,001,0006,11,527,5,532,755,0,3,1,3,0,1,0,76.14,70.46 ,33.33
03,020,01,001,0006,12,672,4,676,894,0,3,1,3,0,1,0,76.14,75.62 ,33.33
03,020,01,001,0007,13,766,3,769,998,0,3,1,3,0,1,0,76.14,77.05 ,33.33
03,020,01,001,0007,14,812,7,819,1049,0,3,1,3,0,1,0,76.14,78.07 ,33.33
03,020,01,001,0008,15,708,3,711,923,0,3,1,3,0,1,0,76.14,77.03 ,33.33
03,020,01,001,0008,16,732,2,734,969,0,3,1,3,0,1,0,76.14,75.75 ,33.33
03,020,01,001,0009,17,896,7,903,1193,0,3,1,3,0,1,0,76.14,75.69 ,33.33
03,020,01,001,0009,18,719,4,723,895,0,3,1,3,0,1,0,76.14,80.78 ,33.33
03,020,01,001,0009,19,531,3,534,690,0,3,1,3,0,1,0,76.14,77.39 ,33.33
03,020,01,001,0010,20,899,2,901,1154,0,3,1,3,0,1,0,76.14,78.08 ,33.33
03,020,01,001,0010,21,693,4,697,946,0,3,1,3,0,1,0,76.14,73.68 ,33.33
03,020,01,001,0010,22,624,7,631,852,0,3,1,3,0,1,0,76.14,74.06 ,33.33
03,020,01,001,0011,23,899,9,908,1245,0,3,1,3,0,1,0,76.14,72.93 ,33.33
03,020,01,001,0011,24,766,5,771,1019,0,3,1,3,0,1,0,76.14,75.66 ,33.33
03,020,01,001,0011,25,1055,4,1059,1392,0,3,1,3,0,1,0,76.14,76.08 ,33.33
03,020,01,001,0012,26,970,3,973,1340,0,3,1,3,0,1,0,76.14,72.61 ,33.33
03,020,01,001,0013,27,261,2,263,351,0,3,1,3,0,1,0,76.14,74.93 ,33.33
03,020,01,001,0014,28,391,6,397,518,0,3,1,3,0,1,0,76.14,76.64 ,33.33
03,020,01,001,0015,29,461,4,465,601,0,3,1,3,0,1,0,76.14,77.37 ,33.33
03,020,01,001,0016,30,436,3,439,564,0,3,1,3,0,1,0,76.14,77.84 ,33.33
03,020,01,001,0017,31,499,4,503,642,0,3,1,3,0,1,0,76.14,78.35 ,33.33
03,020,01,001,0018,32,447,4,451,603,0,3,1,3,0,1,0,76.14,74.79 ,33.33
03,020,01,001,0019,33,390,2,392,524,0,3,1,3,0,1,0,76.14,74.81 ,33.33
03,020,01,001,0020,34,508,2,510,684,0,3,1,3,0,1,0,76.14,74.56 ,33.33
03,020,01,001,0020,35,528,1,529,693,0,3,1,3,0,1,0,76.14,76.33 ,33.33
03,020,01,001,0021,36,498,1,499,675,0,3,1,3,0,1,0,76.14,73.93 ,33.33
03,020,01,001,0022,37,787,1,788,1023,0,3,1,3,0,1,0,76.14,77.03 ,33.33
03,020,01,001,0023,38,297,3,300,411,0,3,1,3,0,1,0,76.14,72.99 ,33.33
03,020,01,001,0024,39,842,3,845,1126,0,3,1,3,0,1,0,76.14,75.04 ,33.33
03,020,01,001,0025,40,509,3,512,681,0,3,1,3,0,1,0,76.14,75.18 ,33.33
03,020,01,001,0026,41,594,1,595,784,0,3,1,3,0,1,0,76.14,75.89 ,33.33
03,020,01,001,0027,42,617,3,620,828,0,3,1,3,0,1,0,76.14,74.88 ,33.33
03,020,01,001,0028,43,585,2,587,754,0,3,1,3,0,1,0,76.14,77.85 ,33.33
03,020,01,001,0029,44,969,9,978,1272,0,3,1,3,0,1,0,76.14,76.89 ,33.33
03,020,01,001,0029,45,505,4,509,667,0,3,1,3,0,1,0,76.14,76.31 ,33.33
03,020,01,001,0030,46,882,10,892,1231,0,3,1,3,0,1,0,76.14,72.46 ,33.33
03,020,01,001,0031,47,951,7,958,1262,0,3,1,3,0,1,0,76.14,75.91 ,33.33
03,020,01,001,0032,48,692,10,702,931,0,3,1,3,0,1,0,76.14,75.40 ,33.33
03,020,01,001,0033,49,558,2,560,716,0,3,1,3,0,1,0,76.14,78.21 ,33.33
03,020,01,001,0033,50,484,4,488,649,0,3,1,3,0,1,0,76.14,75.19 ,33.33
03,020,01,001,0033,51,781,8,789,1104,0,3,1,3,0,1,0,76.14,71.47 ,33.33
03,020,01,001,0034,52,716,7,723,1010,0,3,1,3,0,1,0,76.14,71.58 ,33.33
03,020,01,001,0034,53,484,2,486,663,0,3,1,3,0,1,0,76.14,73.30 ,33.33
03,020,01,001,0035,54,592,1,593,781,0,3,1,3,0,1,0,76.14,75.93 ,33.33
03,020,01,001,0036,55,546,6,552,752,0,3,1,3,0,1,0,76.14,73.40 ,33.33
03,020,01,001,0036,56,682,3,685,922,0,3,1,3,0,1,0,76.14,74.30 ,33.33
03,020,01,001,0037,57,812,6,818,1125,0,3,1,3,0,1,0,76.14,72.71 ,33.33
03,020,01,001,0037,58,714,3,717,912,0,3,1,3,0,1,0,76.14,78.62 ,33.33
03,020,01,001,0037,59,663,10,673,960,0,3,1,3,0,1,0,76.14,70.10 ,33.33
03,020,01,001,0038,60,946,3,949,1253,0,3,1,3,0,1,0,76.14,75.74 ,33.33
03,020,01,001,0038,61,628,6,634,839,0,3,1,3,0,1,0,76.14,75.57 ,33.33
03,020,01,001,0039,62,753,4,757,986,0,3,1,3,0,1,0,76.14,76.77 ,33.33
03,020,01,001,0039,63,637,4,641,834,0,3,1,3,0,1,0,76.14,76.86 ,33.33
03,020,01,001,0040,64,574,6,580,786,0,3,1,3,0,1,0,76.14,73.79 ,33.33
03,020,01,001,0040,65,727,5,732,1030,0,3,1,3,0,1,0,76.14,71.07 ,33.33
03,020,01,001,0040,66,884,5,889,1184,0,3,1,3,0,1,0,76.14,75.08 ,33.33
03,020,01,001,0040,67,1009,7,1016,1310,0,3,1,3,0,1,0,76.14,77.56 ,33.33
03,020,01,001,0041,68,896,4,900,1172,0,3,1,3,0,1,0,76.14,76.79 ,33.33
03,020,01,001,0041,69,876,6,882,1269,0,3,1,3,0,1,0,76.14,69.50 ,33.33
03,020,01,001,0042,70,768,6,774,1106,0,3,1,3,0,1,0,76.14,69.98 ,33.33
03,020,01,001,0042,71,621,8,629,875,0,3,1,3,0,1,0,76.14,71.89 ,33.33
03,020,01,001,0043,72,1018,15,1033,1405,0,3,1,3,0,1,0,76.14,73.52 ,33.33
03,020,01,001,0043,73,822,5,827,1077,0,3,1,3,0,1,0,76.14,76.79 ,33.33
03,020,01,001,0044,74,642,8,650,853,0,3,1,3,0,1,0,76.14,76.20 ,33.33
03,020,01,001,0045,75,529,5,534,710,0,3,1,3,0,1,0,76.14,75.21 ,33.33
03,020,01,001,0046,76,863,2,865,1179,0,3,1,3,0,1,0,76.14,73.37 ,33.33
03,020,01,001,0047,77,709,3,712,954,0,3,1,3,0,1,0,76.14,74.63 ,33.33
03,020,01,001,0047,78,436,0,436,569,0,3,1,3,0,1,0,76.14,76.63 ,33.33
03,020,01,001,0048,79,739,4,743,954,0,3,1,3,0,1,0,76.14,77.88 ,33.33
03,020,01,001,0049,80,398,5,403,496,0,3,1,3,0,1,0,76.14,81.25 ,33.33
03,020,01,001,0050,81,843,6,849,1150,0,3,1,3,0,1,0,76.14,73.83 ,33.33
03,020,01,001,0050,82,964,9,973,1336,0,3,1,3,0,1,0,76.14,72.83 ,33.33
03,020,01,001,0051,83,841,8,849,1089,0,3,1,3,0,1,0,76.14,77.96 ,33.33
03,020,01,001,0051,84,622,4,626,852,0,3,1,3,0,1,0,76.14,73.47 ,33.33
03,020,01,001,0052,85,986,5,991,1338,0,3,1,3,0,1,0,76.14,74.07 ,33.33
03,020,01,001,0052,86,907,6,913,1200,0,3,1,3,0,1,0,76.14,76.08 ,33.33
03,020,01,001,0053,87,463,2,465,631,0,3,1,3,0,1,0,76.14,73.69 ,33.33
03,020,01,001,0053,88,720,2,722,933,0,3,1,3,0,1,0,76.14,77.38 ,33.33
03,020,01,001,0054,89,823,5,828,1128,0,3,1,3,0,1,0,76.14,73.40 ,33.33
03,020,01,001,0054,90,1074,9,1083,1461,0,3,1,3,0,1,0,76.14,74.13 ,33.33
03,020,01,001,0054,91,1001,4,1005,1295,0,3,1,3,0,1,0,76.14,77.61 ,33.33
03,020,01,002,0055,92,840,3,843,1096,0,3,1,3,0,1,0,76.14,76.92 ,33.33
03,020,01,002,0056,93,553,1,554,722,0,3,1,3,0,1,0,76.14,76.73 ,33.33
03,020,01,002,0057,94,397,3,400,519,0,3,1,3,0,1,0,76.14,77.07 ,33.33
03,020,01,002,0058,95,488,5,493,661,0,3,1,3,0,1,0,76.14,74.58 ,33.33
03,020,01,002,0059,96,461,4,465,603,0,3,1,3,0,1,0,76.14,77.11 ,33.33
03,020,01,002,0060,97,696,5,701,873,0,3,1,3,0,1,0,76.14,80.30 ,33.33
03,020,01,002,0061,98,464,1,465,581,0,3,1,3,0,1,0,76.14,80.03 ,33.33
03,020,01,002,0062,99,769,12,781,1022,0,3,1,3,0,1,0,76.14,76.42 ,33.33
03,020,01,002,0063,100,758,1,759,1006,0,3,1,3,0,1,0,76.14,75.45 ,33.33
03,020,01,002,0064,101,637,2,639,853,0,3,1,3,0,1,0,76.14,74.91 ,33.33
03,020,01,002,0065,102,443,5,448,548,0,3,1,3,0,1,0,76.14,81.75 ,33.33
03,020,01,002,0066,103,613,3,616,821,0,3,1,3,0,1,0,76.14,75.03 ,33.33
03,020,01,002,0067,104,423,1,424,574,0,3,1,3,0,1,0,76.14,73.87 ,33.33
03,020,01,002,0068,105,432,7,439,573,0,3,1,3,0,1,0,76.14,76.61 ,33.33
03,020,01,002,0069,106,355,3,358,475,0,3,1,3,0,1,0,76.14,75.37 ,33.33
03,020,01,002,0070,107,360,4,364,483,0,3,1,3,0,1,0,76.14,75.36 ,33.33
03,020,01,002,0071,108,481,4,485,659,0,3,1,3,0,1,0,76.14,73.60 ,33.33
03,020,01,002,0072,109,606,4,610,749,0,3,1,3,0,1,0,76.14,81.44 ,33.33
03,020,01,002,0073,110,531,2,533,689,0,3,1,3,0,1,0,76.14,77.36 ,33.33
03,020,01,002,0074,111,904,4,908,1211,0,3,1,3,0,1,0,76.14,74.98 ,33.33
03,020,01,002,0074,112,707,6,713,1030,0,3,1,3,0,1,0,76.14,69.22 ,33.33
03,020,01,002,0074,113,565,3,568,753,0,3,1,3,0,1,0,76.14,75.43 ,33.33
03,020,01,002,0074,114,984,14,998,1323,0,3,1,3,0,1,0,76.14,75.43 ,33.33
03,020,01,002,0075,115,734,10,744,979,0,3,1,3,0,1,0,76.14,76.00 ,33.33
03,020,01,002,0076,116,1047,7,1054,1437,0,3,1,3,0,1,0,76.14,73.35 ,33.33
03,020,01,002,0076,117,938,12,950,1268,0,3,1,3,0,1,0,76.14,74.92 ,33.33
03,020,01,002,0077,118,913,10,923,1180,0,3,1,3,0,1,0,76.14,78.22 ,33.33
03,020,01,002,0078,119,768,8,776,976,0,3,1,3,0,1,0,76.14,79.51 ,33.33
03,020,01,002,0079,120,951,4,955,1231,0,3,1,3,0,1,0,76.14,77.58 ,33.33
03,020,01,002,0080,121,646,1,647,877,0,3,1,3,0,1,0,76.14,73.77 ,33.33
03,020,01,002,0080,122,591,1,592,744,0,3,1,3,0,1,0,76.14,79.57 ,33.33
03,020,01,002,0081,123,732,6,738,959,0,3,1,3,0,1,0,76.14,76.96 ,33.33
03,020,01,002,0081,124,1094,7,1101,1466,0,3,1,3,0,1,0,76.14,75.10 ,33.33
03,020,01,002,0082,125,745,7,752,1030,0,3,1,3,0,1,0,76.14,73.01 ,33.33
03,020,01,002,0082,126,858,3,861,1131,0,3,1,3,0,1,0,76.14,76.13 ,33.33
03,020,01,002,0083,127,621,4,625,816,0,3,1,3,0,1,0,76.14,76.59 ,33.33
03,020,01,002,0084,128,415,2,417,568,0,3,1,3,0,1,0,76.14,73.42 ,33.33
03,020,01,002,0084,129,569,4,573,788,0,3,1,3,0,1,0,76.14,72.72 ,33.33
03,020,01,002,0085,130,818,5,823,1096,0,3,1,3,0,1,0,76.14,75.09 ,33.33
03,020,01,002,0086,131,679,3,682,943,0,3,1,3,0,1,0,76.14,72.32 ,33.33
03,020,01,002,0086,132,800,7,807,1107,0,3,1,3,0,1,0,76.14,72.90 ,33.33
03,020,01,002,0087,133,768,5,773,1046,0,3,1,3,0,1,0,76.14,73.90 ,33.33
03,020,01,002,0087,134,786,11,797,1050,0,3,1,3,0,1,0,76.14,75.90 ,33.33
03,020,01,002,0087,135,945,7,952,1268,0,3,1,3,0,1,0,76.14,75.08 ,33.33
03,020,01,002,0088,136,1032,5,1037,1318,0,3,1,3,0,1,0,76.14,78.68 ,33.33
03,020,01,002,0088,137,1201,5,1206,1559,0,3,1,3,0,1,0,76.14,77.36 ,33.33
03,020,01,002,0089,138,876,10,886,1168,0,3,1,3,0,1,0,76.14,75.86 ,33.33
03,020,01,002,0089,139,1119,10,1129,1536,0,3,1,3,0,1,0,76.14,73.50 ,33.33
03,020,01,002,0089,140,969,5,974,1320,0,3,1,3,0,1,0,76.14,73.79 ,33.33
03,020,01,002,0089,141,696,7,703,987,0,3,1,3,0,1,0,76.14,71.23 ,33.33
03,020,01,002,0090,142,1225,11,1236,1619,0,3,1,3,0,1,0,76.14,76.34 ,33.33
03,020,01,002,0090,143,1058,10,1068,1434,0,3,1,3,0,1,0,76.14,74.48 ,33.33
03,020,01,002,0091,144,832,2,834,1094,0,3,1,3,0,1,0,76.14,76.23 ,33.33
03,020,01,002,0091,145,964,7,971,1269,0,3,1,3,0,1,0,76.14,76.52 ,33.33
03,020,01,002,0091,146,939,8,947,1263,0,3,1,3,0,1,0,76.14,74.98 ,33.33
03,020,01,002,0092,147,931,5,936,1253,0,3,1,3,0,1,0,76.14,74.70 ,33.33
03,020,01,002,0092,148,853,3,856,1132,0,3,1,3,0,1,0,76.14,75.62 ,33.33
03,020,01,002,0093,149,511,3,514,671,0,3,1,3,0,1,0,76.14,76.60 ,33.33
03,020,01,002,0094,150,398,4,402,522,0,3,1,3,0,1,0,76.14,77.01 ,33.33
03,020,01,002,0095,151,684,4,688,890,0,3,1,3,0,1,0,76.14,77.30 ,33.33
03,020,01,002,0095,152,645,5,650,900,0,3,1,3,0,1,0,76.14,72.22 ,33.33
03,020,01,002,0096,153,1002,6,1008,1324,0,3,1,3,0,1,0,76.14,76.13 ,33.33
03,020,01,002,0097,154,665,3,668,935,0,3,1,3,0,1,0,76.14,71.44 ,33.33
03,020,01,002,0097,155,570,4,574,775,0,3,1,3,0,1,0,76.14,74.06 ,33.33
03,020,01,002,0098,156,796,9,805,1132,0,3,1,3,0,1,0,76.14,71.11 ,33.33
03,020,01,002,0098,157,735,9,744,984,0,3,1,3,0,1,0,76.14,75.61 ,33.33
03,020,01,002,0099,158,472,3,475,612,0,3,1,3,0,1,0,76.14,77.61 ,33.33
03,020,01,002,0100,159,519,6,525,728,0,3,1,3,0,1,0,76.14,72.12 ,33.33
03,020,01,002,0101,160,601,6,607,847,0,3,1,3,0,1,0,76.14,71.66 ,33.33
03,020,01,002,0101,161,509,1,510,669,0,3,1,3,0,1,0,76.14,76.23 ,33.33
03,020,01,002,0102,162,938,10,948,1293,0,3,1,3,0,1,0,76.14,73.32 ,33.33
03,020,01,002,0103,163,643,5,648,839,0,3,1,3,0,1,0,76.14,77.23 ,33.33
03,020,01,002,0103,164,664,1,665,891,0,3,1,3,0,1,0,76.14,74.64 ,33.33
03,020,01,002,0104,165,965,7,972,1248,0,3,1,3,0,1,0,76.14,77.88 ,33.33
03,020,01,002,0104,166,684,9,693,942,0,3,1,3,0,1,0,76.14,73.57 ,33.33
03,020,01,002,0104,167,797,6,803,1075,0,3,1,3,0,1,0,76.14,74.70 ,33.33
03,020,01,002,0105,168,1166,14,1180,1435,0,3,1,3,0,1,0,76.14,82.23 ,33.33
03,020,01,002,0105,169,1249,13,1262,1691,0,3,1,3,0,1,0,76.14,74.63 ,33.33
03,020,01,002,0105,170,1294,9,1303,1664,0,3,1,3,0,1,0,76.14,78.31 ,33.33
03,020,01,002,0105,171,1039,7,1046,1352,0,3,1,3,0,1,0,76.14,77.37 ,33.33
03,020,01,002,0106,172,1069,11,1080,1429,0,3,1,3,0,1,0,76.14,75.58 ,33.33
03,020,01,002,0106,173,1067,7,1074,1445,0,3,1,3,0,1,0,76.14,74.33 ,33.33
03,020,01,002,0107,174,807,3,810,1030,0,3,1,3,0,1,0,76.14,78.64 ,33.33
03,020,01,002,0107,175,810,5,815,1034,0,3,1,3,0,1,0,76.14,78.82 ,33.33
03,020,01,002,0108,176,772,5,777,1037,0,3,1,3,0,1,0,76.14,74.93 ,33.33
03,020,01,002,0109,177,672,6,678,884,0,3,1,3,0,1,0,76.14,76.70 ,33.33
03,021,01,001,0001,1,1121,11,1132,1783,0,3,1,3,0,1,0,76.14,63.49 ,33.33
03,021,01,001,0001,2,1184,13,1197,1880,0,3,1,3,0,1,0,76.14,63.67 ,33.33
03,021,01,001,0001,3,1053,17,1070,1565,0,3,1,3,0,1,0,76.14,68.37 ,33.33
03,021,01,001,0002,4,1190,13,1203,1645,0,3,1,3,0,1,0,76.14,73.13 ,33.33
03,021,01,001,0002,5,938,13,951,1474,0,3,1,3,0,1,0,76.14,64.52 ,33.33
03,021,01,001,0003,6,741,7,748,1164,0,3,1,3,0,1,0,76.14,64.26 ,33.33
03,021,01,001,0003,7,822,7,829,1295,0,3,1,3,0,1,0,76.14,64.02 ,33.33
03,021,01,001,0004,8,892,11,903,1402,0,3,1,3,0,1,0,76.14,64.41 ,33.33
03,021,01,001,0004,9,1093,14,1107,1590,0,3,1,3,0,1,0,76.14,69.62 ,33.33
03,021,01,001,0004,10,831,6,837,1251,0,3,1,3,0,1,0,76.14,66.91 ,33.33
03,021,01,001,0005,11,783,10,793,1206,0,3,1,3,0,1,0,76.14,65.75 ,33.33
03,021,01,001,0005,12,1005,16,1021,1390,0,3,1,3,0,1,0,76.14,73.45 ,33.33
03,021,01,001,0005,13,851,4,855,1202,0,3,1,3,0,1,0,76.14,71.13 ,33.33
03,021,01,001,0006,14,1174,14,1188,1751,0,3,1,3,0,1,0,76.14,67.85 ,33.33
03,021,01,001,0007,15,613,9,622,970,0,3,1,3,0,1,0,76.14,64.12 ,33.33
03,021,01,001,0007,16,965,17,982,1505,0,3,1,3,0,1,0,76.14,65.25 ,33.33
03,021,01,001,0008,17,501,8,509,724,0,3,1,3,0,1,0,76.14,70.30 ,33.33
03,021,01,001,0008,18,863,6,869,1292,0,3,1,3,0,1,0,76.14,67.26 ,33.33
03,021,01,001,0009,19,761,6,767,1103,0,3,1,3,0,1,0,76.14,69.54 ,33.33
03,021,01,001,0009,20,575,15,590,885,0,3,1,3,0,1,0,76.14,66.67 ,33.33
03,021,01,001,0010,21,961,14,975,1434,0,3,1,3,0,1,0,76.14,67.99 ,33.33
03,021,01,001,0010,22,1064,4,1068,1560,0,3,1,3,0,1,0,76.14,68.46 ,33.33
03,021,01,001,0010,23,883,8,891,1313,0,3,1,3,0,1,0,76.14,67.86 ,33.33
03,021,01,001,0011,24,1111,14,1125,1741,0,3,1,3,0,1,0,76.14,64.62 ,33.33
03,021,01,001,0011,25,835,11,846,1223,0,3,1,3,0,1,0,76.14,69.17 ,33.33
03,021,01,001,0011,26,999,11,1010,1437,0,3,1,3,0,1,0,76.14,70.29 ,33.33
03,021,01,001,0012,27,693,4,697,1066,0,3,1,3,0,1,0,76.14,65.38 ,33.33
03,021,01,001,0012,28,547,2,549,813,0,3,1,3,0,1,0,76.14,67.53 ,33.33
03,021,01,001,0013,29,872,19,891,1301,0,3,1,3,0,1,0,76.14,68.49 ,33.33
03,021,01,001,0013,30,721,14,735,1125,0,3,1,3,0,1,0,76.14,65.33 ,33.33
03,021,01,001,0014,31,776,9,785,1158,0,3,1,3,0,1,0,76.14,67.79 ,33.33
03,021,01,001,0014,32,983,4,987,1405,0,3,1,3,0,1,0,76.14,70.25 ,33.33
03,021,01,001,0015,33,854,7,861,1110,0,3,1,3,0,1,0,76.14,77.57 ,33.33
03,021,01,001,0015,34,878,14,892,1140,0,3,1,3,0,1,0,76.14,78.25 ,33.33
03,021,01,001,0016,35,812,16,828,1046,0,3,1,3,0,1,0,76.14,79.16 ,33.33
03,021,01,001,0016,36,681,11,692,878,0,3,1,3,0,1,0,76.14,78.82 ,33.33
03,021,01,001,0017,37,1057,11,1068,1541,0,3,1,3,0,1,0,76.14,69.31 ,33.33
03,021,01,001,0017,38,1097,8,1105,1560,0,3,1,3,0,1,0,76.14,70.83 ,33.33
03,021,01,001,0018,39,947,6,953,1388,0,3,1,3,0,1,0,76.14,68.66 ,33.33
03,021,01,001,0018,40,1070,12,1082,1554,0,3,1,3,0,1,0,76.14,69.63 ,33.33
03,021,01,001,0019,41,1002,15,1017,1422,0,3,1,3,0,1,0,76.14,71.52 ,33.33
03,021,01,001,0019,42,789,7,796,1154,0,3,1,3,0,1,0,76.14,68.98 ,33.33
03,021,01,001,0020,43,800,14,814,1193,0,3,1,3,0,1,0,76.14,68.23 ,33.33
03,021,01,001,0020,44,787,11,798,1167,0,3,1,3,0,1,0,76.14,68.38 ,33.33
03,021,01,001,0020,45,754,8,762,1152,0,3,1,3,0,1,0,76.14,66.15 ,33.33
03,021,01,001,0021,46,1118,16,1134,1674,0,3,1,3,0,1,0,76.14,67.74 ,33.33
03,021,01,001,0022,47,699,5,704,1022,0,3,1,3,0,1,0,76.14,68.88 ,33.33
03,021,01,001,0023,48,576,12,588,871,0,3,1,3,0,1,0,76.14,67.51 ,33.33
03,021,01,001,0024,49,832,10,842,1309,0,3,1,3,0,1,0,76.14,64.32 ,33.33
03,021,01,001,0025,50,691,9,700,1077,0,3,1,3,0,1,0,76.14,65.00 ,33.33
03,021,01,001,0026,51,527,6,533,830,0,3,1,3,0,1,0,76.14,64.22 ,33.33
03,021,01,001,0027,52,613,9,622,908,0,3,1,3,0,1,0,76.14,68.50 ,33.33
03,021,01,001,0027,53,569,6,575,854,0,3,1,3,0,1,0,76.14,67.33 ,33.33
03,021,01,001,0028,54,898,12,910,1310,0,3,1,3,0,1,0,76.14,69.47 ,33.33
03,021,01,001,0028,55,887,7,894,1419,0,3,1,3,0,1,0,76.14,63.00 ,33.33
03,021,01,001,0028,56,1133,15,1148,1743,0,3,1,3,0,1,0,76.14,65.86 ,33.33
03,021,01,001,0029,57,795,7,802,1138,0,3,1,3,0,1,0,76.14,70.47 ,33.33
03,021,01,001,0029,58,815,9,824,1194,0,3,1,3,0,1,0,76.14,69.01 ,33.33
03,021,01,001,0030,59,1039,12,1051,1479,0,3,1,3,0,1,0,76.14,71.06 ,33.33
03,021,01,001,0030,60,847,16,863,1273,0,3,1,3,0,1,0,76.14,67.79 ,33.33
03,021,01,001,0031,61,989,11,1000,1510,0,3,1,3,0,1,0,76.14,66.23 ,33.33
03,021,01,001,0032,62,910,12,922,1287,0,3,1,3,0,1,0,76.14,71.64 ,33.33
03,021,01,001,0032,63,835,10,845,1247,0,3,1,3,0,1,0,76.14,67.76 ,33.33
03,021,01,001,0033,64,617,9,626,942,0,3,1,3,0,1,0,76.14,66.45 ,33.33
03,021,01,001,0033,65,664,8,672,986,0,3,1,3,0,1,0,76.14,68.15 ,33.33
03,021,01,001,0034,66,656,8,664,949,0,3,1,3,0,1,0,76.14,69.97 ,33.33
03,021,01,001,0034,67,766,11,777,1104,0,3,1,3,0,1,0,76.14,70.38 ,33.33
03,021,01,001,0034,68,984,13,997,1375,0,3,1,3,0,1,0,76.14,72.51 ,33.33
03,021,01,001,0035,69,1106,11,1117,1662,0,3,1,3,0,1,0,76.14,67.21 ,33.33
03,021,01,001,0036,70,1168,20,1188,1816,0,3,1,3,0,1,0,76.14,65.42 ,33.33
03,021,01,001,0037,71,973,13,986,1321,0,3,1,3,0,1,0,76.14,74.64 ,33.33
03,021,01,001,0037,72,1197,17,1214,1898,0,3,1,3,0,1,0,76.14,63.96 ,33.33
03,021,01,001,0037,73,988,15,1003,1545,0,3,1,3,0,1,0,76.14,64.92 ,33.33
03,021,01,001,0038,74,704,9,713,1029,0,3,1,3,0,1,0,76.14,69.29 ,33.33
03,021,01,001,0038,75,590,6,596,969,0,3,1,3,0,1,0,76.14,61.51 ,33.33
03,021,01,001,0039,76,725,6,731,1060,0,3,1,3,0,1,0,76.14,68.96 ,33.33
03,021,01,001,0040,77,828,11,839,1242,0,3,1,3,0,1,0,76.14,67.55 ,33.33
03,021,01,001,0041,78,585,5,590,871,0,3,1,3,0,1,0,76.14,67.74 ,33.33
03,021,01,001,0042,79,713,9,722,1087,0,3,1,3,0,1,0,76.14,66.42 ,33.33
03,021,01,001,0043,80,1252,13,1265,1905,0,3,1,3,0,1,0,76.14,66.40 ,33.33
03,021,01,001,0043,81,1208,14,1222,1808,0,3,1,3,0,1,0,76.14,67.59 ,33.33
03,021,01,001,0044,82,959,13,972,1404,0,3,1,3,0,1,0,76.14,69.23 ,33.33
03,021,01,001,0044,83,872,7,879,1314,0,3,1,3,0,1,0,76.14,66.89 ,33.33
03,021,01,001,0044,84,999,20,1019,1464,0,3,1,3,0,1,0,76.14,69.60 ,33.33
03,021,01,002,0045,85,973,15,988,1474,0,3,1,3,0,1,0,76.14,67.03 ,33.33
03,021,01,002,0045,86,995,20,1015,1430,0,3,1,3,0,1,0,76.14,70.98 ,33.33
03,021,01,002,0046,87,611,5,616,938,0,3,1,3,0,1,0,76.14,65.67 ,33.33
03,021,01,002,0046,88,685,7,692,1019,0,3,1,3,0,1,0,76.14,67.91 ,33.33
03,021,01,002,0047,89,874,10,884,1230,0,3,1,3,0,1,0,76.14,71.87 ,33.33
03,021,01,002,0047,90,935,9,944,1375,0,3,1,3,0,1,0,76.14,68.65 ,33.33
03,021,01,002,0047,91,977,13,990,1502,0,3,1,3,0,1,0,76.14,65.91 ,33.33
03,021,01,002,0048,92,798,11,809,1166,0,3,1,3,0,1,0,76.14,69.38 ,33.33
03,021,01,002,0049,93,943,12,955,1411,0,3,1,3,0,1,0,76.14,67.68 ,33.33
03,021,01,002,0050,94,854,14,868,1204,0,3,1,3,0,1,0,76.14,72.09 ,33.33
03,021,01,002,0051,95,948,11,959,1289,0,3,1,3,0,1,0,76.14,74.40 ,33.33
03,021,01,002,0052,96,1089,13,1102,1527,0,3,1,3,0,1,0,76.14,72.17 ,33.33
03,021,01,002,0053,97,723,9,732,1042,0,3,1,3,0,1,0,76.14,70.25 ,33.33
03,021,01,002,0054,98,809,13,822,1187,0,3,1,3,0,1,0,76.14,69.25 ,33.33
03,021,01,002,0054,99,749,6,755,1120,0,3,1,3,0,1,0,76.14,67.41 ,33.33
03,021,01,002,0054,100,727,5,732,1038,0,3,1,3,0,1,0,76.14,70.52 ,33.33
03,021,01,002,0055,101,696,7,703,1004,0,3,1,3,0,1,0,76.14,70.02 ,33.33
03,021,01,002,0055,102,1011,10,1021,1526,0,3,1,3,0,1,0,76.14,66.91 ,33.33
03,021,01,002,0056,103,731,5,736,1033,0,3,1,3,0,1,0,76.14,71.25 ,33.33
03,021,01,002,0056,104,718,6,724,1022,0,3,1,3,0,1,0,76.14,70.84 ,33.33
03,021,01,002,0057,105,904,8,912,1254,0,3,1,3,0,1,0,76.14,72.73 ,33.33
03,021,01,002,0057,106,1065,10,1075,1386,0,3,1,3,0,1,0,76.14,77.56 ,33.33
03,021,01,002,0058,107,722,7,729,1089,0,3,1,3,0,1,0,76.14,66.94 ,33.33
03,021,01,002,0058,108,913,5,918,1356,0,3,1,3,0,1,0,76.14,67.70 ,33.33
03,021,01,002,0059,109,1036,10,1046,1493,0,3,1,3,0,1,0,76.14,70.06 ,33.33
03,021,01,002,0059,110,1019,11,1030,1499,0,3,1,3,0,1,0,76.14,68.71 ,33.33
03,021,01,002,0060,111,1062,6,1068,1437,0,3,1,3,0,1,0,76.14,74.32 ,33.33
03,021,01,002,0060,112,1094,13,1107,1557,0,3,1,3,0,1,0,76.14,71.10 ,33.33
03,021,01,002,0061,113,983,12,995,1407,0,3,1,3,0,1,0,76.14,70.72 ,33.33
03,021,01,002,0061,114,1001,6,1007,1484,0,3,1,3,0,1,0,76.14,67.86 ,33.33
03,021,01,002,0061,115,1062,5,1067,1489,0,3,1,3,0,1,0,76.14,71.66 ,33.33
03,021,01,002,0062,116,1110,10,1120,1583,0,3,1,3,0,1,0,76.14,70.75 ,33.33
03,021,01,002,0062,117,982,12,994,1464,0,3,1,3,0,1,0,76.14,67.90 ,33.33
03,021,01,002,0063,118,678,5,683,959,0,3,1,3,0,1,0,76.14,71.22 ,33.33
03,021,01,002,0063,119,689,9,698,1042,0,3,1,3,0,1,0,76.14,66.99 ,33.33
03,021,01,002,0064,120,1302,11,1313,1776,0,3,1,3,0,1,0,76.14,73.93 ,33.33
03,021,01,002,0064,121,1298,16,1314,1920,0,3,1,3,0,1,0,76.14,68.44 ,33.33
03,021,01,002,0065,122,587,4,591,807,0,3,1,3,0,1,0,76.14,73.23 ,33.33
03,021,01,002,0065,123,866,9,875,1168,0,3,1,3,0,1,0,76.14,74.91 ,33.33
03,021,01,002,0066,124,1005,8,1013,1532,0,3,1,3,0,1,0,76.14,66.12 ,33.33
03,021,01,002,0066,125,1219,21,1240,1718,0,3,1,3,0,1,0,76.14,72.18 ,33.33
03,021,01,002,0067,126,987,14,1001,1540,0,3,1,3,0,1,0,76.14,65.00 ,33.33
03,021,01,002,0067,127,1303,18,1321,1927,0,3,1,3,0,1,0,76.14,68.55 ,33.33
03,021,01,002,0068,128,1055,11,1066,1454,0,3,1,3,0,1,0,76.14,73.31 ,33.33
03,021,01,002,0068,129,1077,15,1092,1465,0,3,1,3,0,1,0,76.14,74.54 ,33.33
03,021,01,002,0069,130,1154,15,1169,1607,0,3,1,3,0,1,0,76.14,72.74 ,33.33
03,021,01,002,0069,131,1127,10,1137,1596,0,3,1,3,0,1,0,76.14,71.24 ,33.33
03,021,01,002,0070,132,1080,6,1086,1549,0,3,1,3,0,1,0,76.14,70.11 ,33.33
03,021,01,002,0070,133,1001,14,1015,1497,0,3,1,3,0,1,0,76.14,67.80 ,33.33
03,021,01,002,0071,134,856,5,861,1227,0,3,1,3,0,1,0,76.14,70.17 ,33.33
03,021,01,002,0071,135,998,12,1010,1475,0,3,1,3,0,1,0,76.14,68.47 ,33.33
03,021,01,002,0071,136,917,9,926,1400,0,3,1,3,0,1,0,76.14,66.14 ,33.33
03,021,01,002,0072,137,1098,15,1113,1671,0,3,1,3,0,1,0,76.14,66.61 ,33.33
03,021,01,002,0072,138,1093,19,1112,1700,0,3,1,3,0,1,0,76.14,65.41 ,33.33
03,021,01,002,0073,139,619,3,622,919,0,3,1,3,0,1,0,76.14,67.68 ,33.33
03,021,01,002,0073,140,689,3,692,1051,0,3,1,3,0,1,0,76.14,65.84 ,33.33
03,021,01,002,0074,141,697,9,706,1003,0,3,1,3,0,1,0,76.14,70.39 ,33.33
03,021,01,002,0075,142,688,10,698,949,0,3,1,3,0,1,0,76.14,73.55 ,33.33
03,021,01,002,0076,143,794,7,801,1087,0,3,1,3,0,1,0,76.14,73.69 ,33.33
03,021,01,002,0076,144,622,6,628,919,0,3,1,3,0,1,0,76.14,68.34 ,33.33
03,021,01,002,0077,145,1081,10,1091,1552,0,3,1,3,0,1,0,76.14,70.30 ,33.33
03,021,01,002,0078,146,943,11,954,1377,0,3,1,3,0,1,0,76.14,69.28 ,33.33
03,021,01,002,0079,147,729,6,735,1047,0,3,1,3,0,1,0,76.14,70.20 ,33.33
03,021,01,002,0079,148,866,7,873,1234,0,3,1,3,0,1,0,76.14,70.75 ,33.33
03,021,01,002,0080,149,451,4,455,606,0,3,1,3,0,1,0,76.14,75.08 ,33.33
03,021,01,002,0081,150,401,9,410,588,0,3,1,3,0,1,0,76.14,69.73 ,33.33
03,021,01,002,0082,151,666,4,670,986,0,3,1,3,0,1,0,76.14,67.95 ,33.33
03,021,01,002,0083,152,495,3,498,708,0,3,1,3,0,1,0,76.14,70.34 ,33.33
03,021,01,002,0084,153,967,13,980,1398,0,3,1,3,0,1,0,76.14,70.10 ,33.33
03,021,01,002,0085,154,1169,9,1178,1699,0,3,1,3,0,1,0,76.14,69.33 ,33.33
03,021,01,002,0086,155,525,6,531,737,0,3,1,3,0,1,0,76.14,72.05 ,33.33
03,021,01,002,0087,156,1182,10,1192,1637,0,3,1,3,0,1,0,76.14,72.82 ,33.33
03,021,01,003,0088,157,555,8,563,788,0,3,1,3,0,1,0,76.14,71.45 ,33.33
03,021,01,003,0089,158,504,3,507,683,0,3,1,3,0,1,0,76.14,74.23 ,33.33
03,021,01,003,0090,159,461,9,470,666,0,3,1,3,0,1,0,76.14,70.57 ,33.33
03,021,01,003,0091,160,553,3,556,788,0,3,1,3,0,1,0,76.14,70.56 ,33.33
03,021,01,003,0092,161,545,4,549,841,0,3,1,3,0,1,0,76.14,65.28 ,33.33
03,021,01,003,0093,162,846,11,857,1159,0,3,1,3,0,1,0,76.14,73.94 ,33.33
03,021,01,003,0093,163,724,12,736,1009,0,3,1,3,0,1,0,76.14,72.94 ,33.33
03,021,01,003,0094,164,921,9,930,1370,0,3,1,3,0,1,0,76.14,67.88 ,33.33
03,021,01,003,0095,165,930,12,942,1321,0,3,1,3,0,1,0,76.14,71.31 ,33.33
03,021,01,003,0095,166,663,3,666,881,0,3,1,3,0,1,0,76.14,75.60 ,33.33
03,021,01,003,0096,167,582,4,586,867,0,3,1,3,0,1,0,76.14,67.59 ,33.33
03,021,01,003,0096,168,982,8,990,1386,0,3,1,3,0,1,0,76.14,71.43 ,33.33
03,021,01,003,0097,169,1045,14,1059,1556,0,3,1,3,0,1,0,76.14,68.06 ,33.33
03,021,01,003,0097,170,637,4,641,923,0,3,1,3,0,1,0,76.14,69.45 ,33.33
03,021,01,003,0098,171,748,6,754,1067,0,3,1,3,0,1,0,76.14,70.67 ,33.33
03,021,01,003,0098,172,817,12,829,1214,0,3,1,3,0,1,0,76.14,68.29 ,33.33
03,021,01,003,0099,173,790,14,804,1115,0,3,1,3,0,1,0,76.14,72.11 ,33.33
03,021,01,003,0100,174,678,12,690,938,0,3,1,3,0,1,0,76.14,73.56 ,33.33
03,021,01,003,0101,175,634,24,658,927,0,3,1,3,0,1,0,76.14,70.98 ,33.33
03,021,01,003,0102,176,669,7,676,1005,0,3,1,3,0,1,0,76.14,67.26 ,33.33
03,021,01,003,0103,177,408,8,416,569,0,3,1,3,0,1,0,76.14,73.11 ,33.33
03,021,01,003,0104,178,658,9,667,960,0,3,1,3,0,1,0,76.14,69.48 ,33.33
03,021,01,003,0105,179,431,10,441,633,0,3,1,3,0,1,0,76.14,69.67 ,33.33
03,021,01,003,0106,180,597,7,604,936,0,3,1,3,0,1,0,76.14,64.53 ,33.33
03,021,01,003,0107,181,530,6,536,812,0,3,1,3,0,1,0,76.14,66.01 ,33.33
03,021,01,003,0107,182,832,10,842,1302,0,3,1,3,0,1,0,76.14,64.67 ,33.33
03,021,01,003,0108,183,590,9,599,904,0,3,1,3,0,1,0,76.14,66.26 ,33.33
03,021,01,003,0109,184,416,7,423,604,0,3,1,3,0,1,0,76.14,70.03 ,33.33
03,021,01,003,0110,185,199,0,199,248,0,3,1,3,0,1,0,76.14,80.24 ,33.33
03,021,01,003,0111,186,346,2,348,466,0,3,1,3,0,1,0,76.14,74.68 ,33.33
03,021,01,003,0112,187,385,1,386,507,0,3,1,3,0,1,0,76.14,76.13 ,33.33
03,021,01,003,0113,188,1046,10,1056,1552,0,3,1,3,0,1,0,76.14,68.04 ,33.33
03,021,01,003,0114,189,217,3,220,306,0,3,1,3,0,1,0,76.14,71.90 ,33.33
03,021,01,003,0115,190,619,11,630,821,0,3,1,3,0,1,0,76.14,76.74 ,33.33
03,021,01,003,0116,191,669,9,678,1005,0,3,1,3,0,1,0,76.14,67.46 ,33.33
03,021,01,003,0117,192,845,10,855,1151,0,3,1,3,0,1,0,76.14,74.28 ,33.33
03,021,01,004,0118,193,654,6,660,958,0,3,1,3,0,1,0,76.14,68.89 ,33.33
03,021,01,004,0119,194,698,8,706,1051,0,3,1,3,0,1,0,76.14,67.17 ,33.33
03,021,01,004,0120,195,638,6,644,971,0,3,1,3,0,1,0,76.14,66.32 ,33.33
03,021,01,004,0121,196,822,7,829,1270,0,3,1,3,0,1,0,76.14,65.28 ,33.33
03,021,01,004,0122,197,679,9,688,985,0,3,1,3,0,1,0,76.14,69.85 ,33.33
03,021,01,004,0123,198,753,8,761,1143,0,3,1,3,0,1,0,76.14,66.58 ,33.33
03,021,01,004,0124,199,798,7,805,1203,0,3,1,3,0,1,0,76.14,66.92 ,33.33
03,021,01,004,0125,200,647,9,656,951,0,3,1,3,0,1,0,76.14,68.98 ,33.33
03,021,01,004,0126,201,846,13,859,1191,0,3,1,3,0,1,0,76.14,72.12 ,33.33
03,021,01,004,0127,202,740,5,745,1037,0,3,1,3,0,1,0,76.14,71.84 ,33.33
03,021,01,004,0128,203,519,6,525,809,0,3,1,3,0,1,0,76.14,64.89 ,33.33
03,021,01,004,0128,204,637,6,643,925,0,3,1,3,0,1,0,76.14,69.51 ,33.33
03,021,01,004,0129,205,680,5,685,1013,0,3,1,3,0,1,0,76.14,67.62 ,33.33
03,021,01,004,0129,206,696,4,700,1030,0,3,1,3,0,1,0,76.14,67.96 ,33.33
03,021,01,004,0130,207,677,12,689,973,0,3,1,3,0,1,0,76.14,70.81 ,33.33
03,021,01,004,0130,208,770,10,780,1067,0,3,1,3,0,1,0,76.14,73.10 ,33.33
03,021,01,004,0131,209,838,14,852,1327,0,3,1,3,0,1,0,76.14,64.20 ,33.33
03,021,01,004,0131,210,838,15,853,1093,0,3,1,3,0,1,0,76.14,78.04 ,33.33
03,021,01,004,0132,211,736,13,749,1136,0,3,1,3,0,1,0,76.14,65.93 ,33.33
03,021,01,004,0132,212,655,6,661,999,0,3,1,3,0,1,0,76.14,66.17 ,33.33
03,021,01,004,0133,213,692,6,698,1051,0,3,1,3,0,1,0,76.14,66.41 ,33.33
03,021,01,004,0133,214,678,10,688,966,0,3,1,3,0,1,0,76.14,71.22 ,33.33
03,021,01,004,0134,215,1002,9,1011,1418,0,3,1,3,0,1,0,76.14,71.30 ,33.33
03,021,01,004,0135,216,647,8,655,912,0,3,1,3,0,1,0,76.14,71.82 ,33.33
03,021,01,004,0135,217,653,7,660,1006,0,3,1,3,0,1,0,76.14,65.61 ,33.33
03,021,01,004,0136,218,940,9,949,1464,0,3,1,3,0,1,0,76.14,64.82 ,33.33
03,021,01,004,0136,219,1022,11,1033,1406,0,3,1,3,0,1,0,76.14,73.47 ,33.33
03,021,01,004,0137,220,778,11,789,1004,0,3,1,3,0,1,0,76.14,78.59 ,33.33
03,021,01,004,0138,221,458,5,463,608,0,3,1,3,0,1,0,76.14,76.15 ,33.33
03,021,01,004,0139,222,934,7,941,1369,0,3,1,3,0,1,0,76.14,68.74 ,33.33
03,021,01,004,0140,223,838,7,845,1168,0,3,1,3,0,1,0,76.14,72.35 ,33.33
03,021,01,004,0141,224,1036,24,1060,1477,0,3,1,3,0,1,0,76.14,71.77 ,33.33
03,021,01,004,0142,225,1037,8,1045,1360,0,3,1,3,0,1,0,76.14,76.84 ,33.33
03,021,01,004,0143,226,711,11,722,994,0,3,1,3,0,1,0,76.14,72.64 ,33.33
03,021,01,004,0144,227,666,6,672,944,0,3,1,3,0,1,0,76.14,71.19 ,33.33
03,021,01,004,0144,228,739,7,746,1020,0,3,1,3,0,1,0,76.14,73.14 ,33.33
03,021,01,004,0145,229,788,9,797,1117,0,3,1,3,0,1,0,76.14,71.35 ,33.33
03,021,01,004,0145,230,816,8,824,1149,0,3,1,3,0,1,0,76.14,71.71 ,33.33
03,021,01,004,0145,231,825,8,833,1202,0,3,1,3,0,1,0,76.14,69.30 ,33.33
03,021,01,004,0145,232,825,10,835,1212,0,3,1,3,0,1,0,76.14,68.89 ,33.33
03,021,01,004,0146,233,1060,15,1075,1544,0,3,1,3,0,1,0,76.14,69.62 ,33.33
03,021,01,004,0147,234,662,8,670,971,0,3,1,3,0,1,0,76.14,69.00 ,33.33
03,021,01,004,0147,235,695,8,703,1028,0,3,1,3,0,1,0,76.14,68.39 ,33.33
03,021,01,004,0148,236,1146,13,1159,1666,0,3,1,3,0,1,0,76.14,69.57 ,33.33
03,021,01,004,0149,237,938,11,949,1379,0,3,1,3,0,1,0,76.14,68.82 ,33.33
03,021,01,004,0150,238,1096,8,1104,1601,0,3,1,3,0,1,0,76.14,68.96 ,33.33
03,021,01,004,0151,239,617,7,624,955,0,3,1,3,0,1,0,76.14,65.34 ,33.33
03,021,01,004,0151,240,618,6,624,912,0,3,1,3,0,1,0,76.14,68.42 ,33.33
03,021,01,004,0152,241,722,4,726,1074,0,3,1,3,0,1,0,76.14,67.60 ,33.33
03,021,01,004,0152,242,739,7,746,1106,0,3,1,3,0,1,0,76.14,67.45 ,33.33
03,021,01,004,0152,243,797,12,809,1192,0,3,1,3,0,1,0,76.14,67.87 ,33.33
03,021,01,004,0153,244,818,7,825,1202,0,3,1,3,0,1,0,76.14,68.64 ,33.33
03,021,01,004,0153,245,900,10,910,1341,0,3,1,3,0,1,0,76.14,67.86 ,33.33
03,021,01,004,0153,246,1199,18,1217,1786,0,3,1,3,0,1,0,76.14,68.14 ,33.33
03,021,01,004,0154,247,1017,14,1031,1484,0,3,1,3,0,1,0,76.14,69.47 ,33.33
03,021,01,004,0154,248,1054,5,1059,1507,0,3,1,3,0,1,0,76.14,70.27 ,33.33
03,021,01,004,0155,249,873,8,881,1229,0,3,1,3,0,1,0,76.14,71.68 ,33.33
03,021,01,004,0156,250,919,13,932,1368,0,3,1,3,0,1,0,76.14,68.13 ,33.33
03,021,01,004,0157,251,920,10,930,1378,0,3,1,3,0,1,0,76.14,67.49 ,33.33
03,021,01,004,0157,252,924,7,931,1391,0,3,1,3,0,1,0,76.14,66.93 ,33.33
03,021,01,004,0157,253,1040,11,1051,1460,0,3,1,3,0,1,0,76.14,71.99 ,33.33
03,021,01,004,0158,254,822,8,830,1162,0,3,1,3,0,1,0,76.14,71.43 ,33.33
03,021,01,004,0158,255,942,9,951,1347,0,3,1,3,0,1,0,76.14,70.60 ,33.33
03,021,01,004,0158,256,1024,11,1035,1525,0,3,1,3,0,1,0,76.14,67.87 ,33.33
03,021,01,004,0158,257,981,16,997,1366,0,3,1,3,0,1,0,76.14,72.99 ,33.33
03,021,01,004,0159,258,850,17,867,1227,0,3,1,3,0,1,0,76.14,70.66 ,33.33
03,021,01,004,0159,259,614,7,621,962,0,3,1,3,0,1,0,76.14,64.55 ,33.33
03,021,01,004,0159,260,712,6,718,1008,0,3,1,3,0,1,0,76.14,71.23 ,33.33
03,021,01,004,0159,261,1026,11,1037,1549,0,3,1,3,0,1,0,76.14,66.95 ,33.33
03,021,01,005,0160,262,957,9,966,1348,0,3,1,3,0,1,0,76.14,71.66 ,33.33
03,021,01,005,0161,263,821,8,829,1136,0,3,1,3,0,1,0,76.14,72.98 ,33.33
03,021,01,005,0162,264,781,7,788,1127,0,3,1,3,0,1,0,76.14,69.92 ,33.33
03,021,01,005,0163,265,995,15,1010,1481,0,3,1,3,0,1,0,76.14,68.20 ,33.33
03,021,01,005,0164,266,543,3,546,795,0,3,1,3,0,1,0,76.14,68.68 ,33.33
03,021,01,005,0165,267,455,4,459,684,0,3,1,3,0,1,0,76.14,67.11 ,33.33
03,021,01,005,0166,268,329,2,331,485,0,3,1,3,0,1,0,76.14,68.25 ,33.33
03,021,01,005,0167,269,361,3,364,536,0,3,1,3,0,1,0,76.14,67.91 ,33.33
03,021,01,005,0168,270,916,6,922,1294,0,3,1,3,0,1,0,76.14,71.25 ,33.33
03,021,01,005,0169,271,302,3,305,431,0,3,1,3,0,1,0,76.14,70.77 ,33.33
03,021,01,005,0170,272,417,4,421,559,0,3,1,3,0,1,0,76.14,75.31 ,33.33
03,021,01,005,0171,273,427,5,432,589,0,3,1,3,0,1,0,76.14,73.34 ,33.33
03,021,01,005,0172,274,531,7,538,715,0,3,1,3,0,1,0,76.14,75.24 ,33.33
03,021,01,005,0173,275,536,4,540,766,0,3,1,3,0,1,0,76.14,70.50 ,33.33
03,021,01,005,0174,276,757,6,763,1138,0,3,1,3,0,1,0,76.14,67.05 ,33.33
03,021,01,005,0175,277,393,5,398,576,0,3,1,3,0,1,0,76.14,69.10 ,33.33
03,021,01,005,0176,278,462,5,467,657,0,3,1,3,0,1,0,76.14,71.08 ,33.33
03,021,01,005,0177,279,395,6,401,560,0,3,1,3,0,1,0,76.14,71.61 ,33.33
03,021,01,005,0178,280,454,6,460,705,0,3,1,3,0,1,0,76.14,65.25 ,33.33
03,021,01,005,0179,281,551,6,557,843,0,3,1,3,0,1,0,76.14,66.07 ,33.33
03,021,01,005,0180,282,586,9,595,844,0,3,1,3,0,1,0,76.14,70.50 ,33.33
03,021,01,005,0181,283,430,2,432,600,0,3,1,3,0,1,0,76.14,72.00 ,33.33
03,021,01,005,0182,284,645,7,652,987,0,3,1,3,0,1,0,76.14,66.06 ,33.33
03,021,01,005,0183,285,374,3,377,512,0,3,1,3,0,1,0,76.14,73.63 ,33.33
03,021,01,005,0184,286,352,7,359,512,0,3,1,3,0,1,0,76.14,70.12 ,33.33
03,021,01,005,0185,287,832,8,840,1233,0,3,1,3,0,1,0,76.14,68.13 ,33.33
03,021,01,005,0186,288,846,8,854,1312,0,3,1,3,0,1,0,76.14,65.09 ,33.33
03,021,01,005,0186,289,762,5,767,1094,0,3,1,3,0,1,0,76.14,70.11 ,33.33
03,021,01,005,0187,290,774,2,776,1096,0,3,1,3,0,1,0,76.14,70.80 ,33.33
03,021,01,005,0188,291,1012,13,1025,1510,0,3,1,3,0,1,0,76.14,67.88 ,33.33
03,021,01,005,0189,292,503,7,510,727,0,3,1,3,0,1,0,76.14,70.15 ,33.33
03,021,01,005,0190,293,563,9,572,830,0,3,1,3,0,1,0,76.14,68.92 ,33.33
03,021,01,005,0191,294,1065,8,1073,1609,0,3,1,3,0,1,0,76.14,66.69 ,33.33
03,021,01,005,0192,295,1253,10,1263,1756,0,3,1,3,0,1,0,76.14,71.92 ,33.33
03,021,01,005,0193,296,923,6,929,1330,0,3,1,3,0,1,0,76.14,69.85 ,33.33
03,021,01,005,0193,297,1191,9,1200,1769,0,3,1,3,0,1,0,76.14,67.83 ,33.33
03,021,01,006,0194,298,736,9,745,1089,0,3,1,3,0,1,0,76.14,68.41 ,33.33
03,021,01,006,0194,299,1072,13,1085,1560,0,3,1,3,0,1,0,76.14,69.55 ,33.33
03,021,01,006,0195,300,1344,24,1368,1947,0,3,1,3,0,1,0,76.14,70.26 ,33.33
03,021,01,006,0196,301,1314,17,1331,1820,0,3,1,3,0,1,0,76.14,73.13 ,33.33
03,021,01,006,0197,302,1113,13,1126,1543,0,3,1,3,0,1,0,76.14,72.97 ,33.33
03,021,01,006,0197,303,319,3,322,414,0,3,1,3,0,1,0,76.14,77.78 ,33.33
03,021,01,006,0198,304,897,11,908,1236,0,3,1,3,0,1,0,76.14,73.46 ,33.33
03,021,01,006,0198,305,788,13,801,1209,0,3,1,3,0,1,0,76.14,66.25 ,33.33
03,021,01,006,0199,306,1338,19,1357,1954,0,3,1,3,0,1,0,76.14,69.45 ,33.33
03,021,01,006,0199,307,903,11,914,1303,0,3,1,3,0,1,0,76.14,70.15 ,33.33
03,021,01,006,0200,308,716,6,722,949,0,3,1,3,0,1,0,76.14,76.08 ,33.33
03,021,01,006,0200,309,750,10,760,1065,0,3,1,3,0,1,0,76.14,71.36 ,33.33
03,021,01,006,0201,310,773,13,786,1229,0,3,1,3,0,1,0,76.14,63.95 ,33.33
03,021,01,006,0201,311,713,3,716,1178,0,3,1,3,0,1,0,76.14,60.78 ,33.33
03,021,01,006,0202,312,777,11,788,1159,0,3,1,3,0,1,0,76.14,67.99 ,33.33
03,021,01,006,0202,313,798,6,804,1203,0,3,1,3,0,1,0,76.14,66.83 ,33.33
03,021,01,006,0203,314,712,5,717,1044,0,3,1,3,0,1,0,76.14,68.68 ,33.33
03,021,01,006,0203,315,550,7,557,831,0,3,1,3,0,1,0,76.14,67.03 ,33.33
03,021,01,006,0204,316,665,5,670,992,0,3,1,3,0,1,0,76.14,67.54 ,33.33
03,021,01,006,0204,317,539,5,544,813,0,3,1,3,0,1,0,76.14,66.91 ,33.33
03,021,01,006,0205,318,959,11,970,1384,0,3,1,3,0,1,0,76.14,70.09 ,33.33
03,021,01,006,0205,319,827,11,838,1198,0,3,1,3,0,1,0,76.14,69.95 ,33.33
03,021,01,006,0205,320,901,15,916,1268,0,3,1,3,0,1,0,76.14,72.24 ,33.33
03,021,01,006,0206,321,349,3,352,468,0,3,1,3,0,1,0,76.14,75.21 ,33.33
03,021,01,006,0207,322,808,11,819,1092,0,3,1,3,0,1,0,76.14,75.00 ,33.33
03,021,01,006,0207,323,828,7,835,1246,0,3,1,3,0,1,0,76.14,67.01 ,33.33
03,021,01,006,0208,324,1063,10,1073,1545,0,3,1,3,0,1,0,76.14,69.45 ,33.33
03,021,01,006,0208,325,910,18,928,1306,0,3,1,3,0,1,0,76.14,71.06 ,33.33
03,021,01,006,0209,326,670,10,680,951,0,3,1,3,0,1,0,76.14,71.50 ,33.33
03,021,01,006,0210,327,1095,7,1102,1448,0,3,1,3,0,1,0,76.14,76.10 ,33.33
03,021,01,006,0211,328,870,11,881,1144,0,3,1,3,0,1,0,76.14,77.01 ,33.33
03,021,01,006,0212,329,790,7,797,1107,0,3,1,3,0,1,0,76.14,72.00 ,33.33
03,021,01,006,0212,330,937,15,952,1317,0,3,1,3,0,1,0,76.14,72.29 ,33.33
03,021,01,006,0213,331,592,13,605,790,0,3,1,3,0,1,0,76.14,76.58 ,33.33
03,021,01,006,0214,332,1242,12,1254,1708,0,3,1,3,0,1,0,76.14,73.42 ,33.33
03,021,01,006,0215,333,757,7,764,1059,0,3,1,3,0,1,0,76.14,72.14 ,33.33
03,021,01,006,0216,334,610,4,614,765,0,3,1,3,0,1,0,76.14,80.26 ,33.33
03,021,01,006,0217,335,722,7,729,1026,0,3,1,3,0,1,0,76.14,71.05 ,33.33
03,021,01,006,0218,336,1039,11,1050,1511,0,3,1,3,0,1,0,76.14,69.49 ,33.33
03,021,01,006,0219,337,375,6,381,476,0,3,1,3,0,1,0,76.14,80.04 ,33.33
03,021,01,006,0219,338,357,0,357,440,0,3,1,3,0,1,0,76.14,81.14 ,33.33
03,021,01,006,0220,339,804,17,821,1017,0,3,1,3,0,1,0,76.14,80.73 ,33.33
03,021,01,006,0221,340,579,7,586,763,0,3,1,3,0,1,0,76.14,76.80 ,33.33
03,021,01,006,0222,341,1030,14,1044,1423,0,3,1,3,0,1,0,76.14,73.37 ,33.33
03,021,01,006,0222,342,399,7,406,526,0,3,1,3,0,1,0,76.14,77.19 ,33.33
03,021,01,006,0223,343,436,3,439,556,0,3,1,3,0,1,0,76.14,78.96 ,33.33
03,021,01,006,0224,344,782,7,789,1039,0,3,1,3,0,1,0,76.14,75.94 ,33.33
03,021,01,006,0225,345,906,4,910,1245,0,3,1,3,0,1,0,76.14,73.09 ,33.33
03,021,01,006,0226,346,707,8,715,943,0,3,1,3,0,1,0,76.14,75.82 ,33.33
03,021,01,006,0227,347,422,5,427,558,0,3,1,3,0,1,0,76.14,76.52 ,33.33
03,021,01,006,0228,348,923,9,932,1236,0,3,1,3,0,1,0,76.14,75.40 ,33.33
03,021,01,006,0229,349,400,3,403,486,0,3,1,3,0,1,0,76.14,82.92 ,33.33
03,021,01,006,0230,350,1240,15,1255,1822,0,3,1,3,0,1,0,76.14,68.88 ,33.33
03,021,01,006,0231,351,857,9,866,1266,0,3,1,3,0,1,0,76.14,68.40 ,33.33
03,021,01,006,0231,352,719,10,729,1052,0,3,1,3,0,1,0,76.14,69.30 ,33.33
03,021,01,006,0232,353,1100,18,1118,1646,0,3,1,3,0,1,0,76.14,67.92 ,33.33
03,021,01,006,0232,354,438,9,447,636,0,3,1,3,0,1,0,76.14,70.28 ,33.33
03,021,01,006,0233,355,676,7,683,987,0,3,1,3,0,1,0,76.14,69.20 ,33.33
03,021,01,006,0233,356,610,14,624,885,0,3,1,3,0,1,0,76.14,70.51 ,33.33
03,021,01,006,0234,357,729,13,742,1076,0,3,1,3,0,1,0,76.14,68.96 ,33.33
03,021,01,006,0234,358,655,4,659,965,0,3,1,3,0,1,0,76.14,68.29 ,33.33
03,021,01,006,0235,359,812,14,826,1196,0,3,1,3,0,1,0,76.14,69.06 ,33.33
03,021,01,006,0235,360,735,7,742,1120,0,3,1,3,0,1,0,76.14,66.25 ,33.33
03,021,01,006,0236,361,930,11,941,1452,0,3,1,3,0,1,0,76.14,64.81 ,33.33
03,021,01,006,0236,362,1202,23,1225,1818,0,3,1,3,0,1,0,76.14,67.38 ,33.33
03,021,01,006,0236,363,1208,22,1230,1756,0,3,1,3,0,1,0,76.14,70.05 ,33.33
03,021,01,006,0237,364,1046,17,1063,1451,0,3,1,3,0,1,0,76.14,73.26 ,33.33
03,021,01,006,0237,365,1068,7,1075,1488,0,3,1,3,0,1,0,76.14,72.24 ,33.33
03,021,01,006,0237,366,1149,20,1169,1676,0,3,1,3,0,1,0,76.14,69.75 ,33.33
03,021,01,006,0238,367,923,12,935,1358,0,3,1,3,0,1,0,76.14,68.85 ,33.33
03,021,01,006,0238,368,1202,13,1215,1747,0,3,1,3,0,1,0,76.14,69.55 ,33.33
03,021,01,006,0239,369,670,3,673,952,0,3,1,3,0,1,0,76.14,70.69 ,33.33
03,021,01,006,0239,370,614,7,621,910,0,3,1,3,0,1,0,76.14,68.24 ,33.33
03,021,01,006,0240,371,858,17,875,1214,0,3,1,3,0,1,0,76.14,72.08 ,33.33
03,021,01,006,0240,372,835,4,839,1250,0,3,1,3,0,1,0,76.14,67.12 ,33.33
03,021,01,006,0241,373,1170,18,1188,1671,0,3,1,3,0,1,0,76.14,71.10 ,33.33
03,021,01,006,0241,374,902,9,911,1326,0,3,1,3,0,1,0,76.14,68.70 ,33.33
03,021,01,006,0241,375,869,12,881,1263,0,3,1,3,0,1,0,76.14,69.75 ,33.33
03,021,01,006,0241,376,728,5,733,1119,0,3,1,3,0,1,0,76.14,65.50 ,33.33
03,021,01,007,0242,377,558,6,564,862,0,3,1,3,0,1,0,76.14,65.43 ,33.33
03,021,01,007,0242,378,1762,11,1773,2802,0,3,1,3,0,1,0,76.14,63.28 ,33.33
03,021,01,007,0242,379,1472,15,1487,2391,0,3,1,3,0,1,0,76.14,62.19 ,33.33
03,021,01,007,0242,380,813,12,825,1379,0,3,1,3,0,1,0,76.14,59.83 ,33.33
03,021,01,007,0242,381,1316,12,1328,2265,0,3,1,3,0,1,0,76.14,58.63 ,33.33
03,021,01,007,0243,382,804,10,814,1162,0,3,1,3,0,1,0,76.14,70.05 ,33.33
03,021,01,007,0243,383,978,10,988,1420,0,3,1,3,0,1,0,76.14,69.58 ,33.33
03,021,01,007,0243,384,915,18,933,1362,0,3,1,3,0,1,0,76.14,68.50 ,33.33
03,021,01,007,0244,385,300,4,304,374,0,3,1,3,0,1,0,76.14,81.28 ,33.33
03,021,01,007,0245,386,345,8,353,488,0,3,1,3,0,1,0,76.14,72.34 ,33.33
03,021,01,007,0246,387,271,1,272,371,0,3,1,3,0,1,0,76.14,73.32 ,33.33
03,021,01,007,0247,388,253,2,255,399,0,3,1,3,0,1,0,76.14,63.91 ,33.33
03,021,01,007,0248,389,606,7,613,879,0,3,1,3,0,1,0,76.14,69.74 ,33.33
03,021,01,007,0249,390,843,18,861,1178,0,3,1,3,0,1,0,76.14,73.09 ,33.33
03,021,01,007,0249,391,777,7,784,1024,0,3,1,3,0,1,0,76.14,76.56 ,33.33
03,021,01,007,0250,392,777,6,783,1240,0,3,1,3,0,1,0,76.14,63.15 ,33.33
03,021,01,007,0250,393,523,4,527,690,0,3,1,3,0,1,0,76.14,76.38 ,33.33
03,021,01,007,0251,394,313,5,318,425,0,3,1,3,0,1,0,76.14,74.82 ,33.33
04,001,01,001,0001,1,946,10,956,1342,0,3,1,3,0,1,0,76.14,71.24 ,33.33
04,001,01,001,0002,2,607,4,611,862,0,3,1,3,0,1,0,76.14,70.88 ,33.33
04,001,01,001,0002,3,687,4,691,927,0,3,1,3,0,1,0,76.14,74.54 ,33.33
04,001,01,001,0003,4,792,8,800,1137,0,3,1,3,0,1,0,76.14,70.36 ,33.33
04,001,01,001,0003,5,873,8,881,1221,0,3,1,3,0,1,0,76.14,72.15 ,33.33
04,001,01,001,0004,6,855,10,865,1195,0,3,1,3,0,1,0,76.14,72.38 ,33.33
04,001,01,001,0005,7,585,9,594,844,0,3,1,3,0,1,0,76.14,70.38 ,33.33
04,001,01,001,0006,8,380,1,381,541,0,3,1,3,0,1,0,76.14,70.43 ,33.33
04,001,01,001,0007,9,688,14,702,1005,0,3,1,3,0,1,0,76.14,69.85 ,33.33
04,001,01,001,0008,10,307,4,311,472,0,3,1,3,0,1,0,76.14,65.89 ,33.33
04,001,01,002,0009,11,619,8,627,961,0,3,1,3,0,1,0,76.14,65.24 ,33.33
04,001,01,002,0010,12,784,8,792,1156,0,3,1,3,0,1,0,76.14,68.51 ,33.33
04,001,01,002,0011,13,626,10,636,886,0,3,1,3,0,1,0,76.14,71.78 ,33.33
04,001,01,002,0012,14,702,20,722,1112,0,3,1,3,0,1,0,76.14,64.93 ,33.33
04,001,01,002,0013,15,576,4,580,824,0,3,1,3,0,1,0,76.14,70.39 ,33.33
04,001,01,002,0014,16,263,2,265,402,0,3,1,3,0,1,0,76.14,65.92 ,33.33
04,001,01,003,0015,17,1085,13,1098,1497,0,3,1,3,0,1,0,76.14,73.35 ,33.33
04,001,01,003,0016,18,788,9,797,1055,0,3,1,3,0,1,0,76.14,75.55 ,33.33
04,001,01,003,0017,19,335,6,341,456,0,3,1,3,0,1,0,76.14,74.78 ,33.33
04,001,01,003,0018,20,304,1,305,434,0,3,1,3,0,1,0,76.14,70.28 ,33.33
04,001,01,003,0019,21,326,1,327,477,0,3,1,3,0,1,0,76.14,68.55 ,33.33
04,001,01,003,0020,22,788,6,794,1026,0,3,1,3,0,1,0,76.14,77.39 ,33.33
04,001,01,003,0021,23,556,5,561,709,0,3,1,3,0,1,0,76.14,79.13 ,33.33
04,001,01,003,0022,24,664,4,668,958,0,3,1,3,0,1,0,76.14,69.73 ,33.33
04,001,01,004,0023,25,1053,16,1069,1490,0,3,1,3,0,1,0,76.14,71.74 ,33.33
04,001,01,004,0024,26,444,7,451,620,0,3,1,3,0,1,0,76.14,72.74 ,33.33
04,001,01,004,0025,27,445,11,456,698,0,3,1,3,0,1,0,76.14,65.33 ,33.33
04,001,01,004,0026,28,306,4,310,445,0,3,1,3,0,1,0,76.14,69.66 ,33.33
04,001,01,004,0027,29,331,1,332,529,0,3,1,3,0,1,0,76.14,62.76 ,33.33
04,001,01,004,0028,30,356,3,359,531,0,3,1,3,0,1,0,76.14,67.61 ,33.33
04,001,01,004,0029,31,258,2,260,372,0,3,1,3,0,1,0,76.14,69.89 ,33.33
04,001,01,004,0030,32,389,6,395,589,0,3,1,3,0,1,0,76.14,67.06 ,33.33
04,001,01,005,0031,33,708,5,713,921,0,3,1,3,0,1,0,76.14,77.42 ,33.33
04,001,01,005,0032,34,267,1,268,387,0,3,1,3,0,1,0,76.14,69.25 ,33.33
04,001,01,005,0033,35,370,9,379,548,0,3,1,3,0,1,0,76.14,69.16 ,33.33
04,001,01,005,0034,36,272,2,274,373,0,3,1,3,0,1,0,76.14,73.46 ,33.33
04,001,01,005,0035,37,566,6,572,768,0,3,1,3,0,1,0,76.14,74.48 ,33.33
04,001,01,006,0036,38,33,0,33,82,0,3,1,3,0,1,0,76.14,40.24 ,33.33
04,002,01,001,0001,1,1297,18,1315,1508,0,3,1,3,0,1,0,76.14,87.20 ,33.33
04,002,01,001,0002,2,601,10,611,724,0,3,1,3,0,1,0,76.14,84.39 ,33.33
04,002,01,002,0003,3,420,4,424,515,0,3,1,3,0,1,0,76.14,82.33 ,33.33
04,002,01,002,0004,4,183,3,186,234,0,3,1,3,0,1,0,76.14,79.49 ,33.33
04,002,01,003,0005,5,177,0,177,219,0,3,1,3,0,1,0,76.14,80.82 ,33.33
04,002,01,003,0006,6,127,1,128,155,0,3,1,3,0,1,0,76.14,82.58 ,33.33
04,002,01,004,0007,7,308,4,312,426,0,3,1,3,0,1,0,76.14,73.24 ,33.33
